team,n,rank,w,d,l,gf,ga,gd,pts
Montrose,0,1,23,8,5,59,34,25,77
Peterhead,0,2,23,5,8,77,38,39,74
Stenhousem'r,0,3,16,8,12,58,48,10,56
Stirling,0,4,16,6,14,62,54,8,54
Clyde,0,5,14,10,12,52,49,3,52
Elgin,0,6,14,7,15,53,60,-7,49
Annan Athlet,0,7,12,11,13,48,41,7,47
Berwick,0,8,8,11,17,30,59,-29,35
Edinburgh Ci,0,9,7,10,19,36,60,-24,31
Cowdenbeath,0,10,4,10,22,23,55,-32,22
Montrose,1,1,24,7,5,61,35,26,79
Peterhead,1,2,24,4,8,78,38,40,76
Stenhousem'r,1,3,16,8,12,57,46,11,56
Stirling,1,4,16,6,14,60,53,7,54
Clyde,1,5,15,9,12,53,48,5,54
Elgin,1,6,14,6,16,54,62,-8,48
Annan Athlet,1,7,11,11,14,47,42,5,44
Berwick,1,8,8,10,18,29,60,-31,34
Edinburgh Ci,1,9,7,9,20,36,61,-25,30
Cowdenbeath,1,10,5,10,21,24,54,-30,25
Montrose,2,1,24,7,5,63,34,29,79
Peterhead,2,2,24,4,8,83,39,44,76
Stirling,2,3,17,6,13,64,52,12,57
Clyde,2,4,15,9,12,53,49,4,54
Stenhousem'r,2,5,15,8,13,56,50,6,53
Elgin,2,6,14,6,16,53,64,-11,48
Annan Athlet,2,7,12,11,13,49,42,7,47
Berwick,2,8,8,10,18,30,60,-30,34
Edinburgh Ci,2,9,7,9,20,37,66,-29,30
Cowdenbeath,2,10,4,10,22,24,56,-32,22
Peterhead,3,1,24,4,8,80,39,41,76
Montrose,3,2,23,7,6,60,37,23,76
Stirling,3,3,17,6,13,61,51,10,57
Stenhousem'r,3,4,15,8,13,55,47,8,53
Clyde,3,5,14,10,12,51,48,3,52
Elgin,3,6,15,6,15,56,61,-5,51
Annan Athlet,3,7,12,11,13,48,41,7,47
Berwick,3,8,8,11,17,29,58,-29,35
Edinburgh Ci,3,9,7,9,20,37,63,-26,30
Cowdenbeath,3,10,4,10,22,23,55,-32,22
Montrose,4,1,24,7,5,60,34,26,79
Peterhead,4,2,24,4,8,81,38,43,76
Stirling,4,3,16,7,13,60,51,9,55
Stenhousem'r,4,4,15,9,12,55,46,9,54
Clyde,4,5,14,10,12,52,49,3,52
Elgin,4,6,14,6,16,53,61,-8,48
Annan Athlet,4,7,12,11,13,49,41,8,47
Berwick,4,8,8,11,17,30,59,-29,35
Edinburgh Ci,4,9,7,9,20,36,64,-28,30
Cowdenbeath,4,10,4,10,22,23,56,-33,22
Montrose,5,1,24,7,5,63,35,28,79
Peterhead,5,2,24,4,8,79,38,41,76
Stenhousem'r,5,3,16,8,12,56,46,10,56
Stirling,5,4,16,6,14,60,52,8,54
Clyde,5,5,15,9,12,55,49,6,54
Elgin,5,6,14,6,16,54,64,-10,48
Annan Athlet,5,7,11,11,14,47,45,2,44
Berwick,5,8,8,10,18,30,62,-32,34
Edinburgh Ci,5,9,7,9,20,36,62,-26,30
Cowdenbeath,5,10,5,10,21,27,54,-27,25
Montrose,6,1,23,8,5,60,35,25,77
Peterhead,6,2,24,4,8,81,40,41,76
Stenhousem'r,6,3,16,8,12,57,47,10,56
Stirling,6,4,16,6,14,61,53,8,54
Clyde,6,5,15,9,12,52,48,4,54
Elgin,6,6,14,7,15,54,61,-7,49
Annan Athlet,6,7,11,12,13,47,41,6,45
Berwick,6,8,8,10,18,29,59,-30,34
Edinburgh Ci,6,9,7,9,20,38,64,-26,30
Cowdenbeath,6,10,4,11,21,23,54,-31,23
Montrose,7,1,24,7,5,60,34,26,79
Peterhead,7,2,23,5,8,79,40,39,74
Stirling,7,3,17,6,13,66,53,13,57
Stenhousem'r,7,4,15,8,13,57,52,5,53
Clyde,7,5,14,10,12,51,48,3,52
Elgin,7,6,14,6,16,53,61,-8,48
Annan Athlet,7,7,12,11,13,48,41,7,47
Berwick,7,8,8,11,17,29,58,-29,35
Edinburgh Ci,7,9,7,10,19,38,62,-24,31
Cowdenbeath,7,10,4,10,22,23,55,-32,22
Montrose,8,1,24,7,5,64,35,29,79
Peterhead,8,2,23,4,9,79,41,38,73
Stenhousem'r,8,3,16,8,12,58,47,11,56
Stirling,8,4,16,6,14,61,54,7,54
Clyde,8,5,15,9,12,53,49,4,54
Elgin,8,6,14,6,16,54,65,-11,48
Annan Athlet,8,7,12,11,13,49,42,7,47
Berwick,8,8,8,10,18,30,60,-30,34
Edinburgh Ci,8,9,8,9,19,39,62,-23,33
Cowdenbeath,8,10,4,10,22,24,56,-32,22
Peterhead,9,1,24,4,8,80,38,42,76
Montrose,9,2,23,7,6,60,36,24,76
Stirling,9,3,17,6,13,63,51,12,57
Stenhousem'r,9,4,15,8,13,55,49,6,53
Clyde,9,5,14,9,13,51,49,2,51
Elgin,9,6,15,6,15,55,61,-6,51
Annan Athlet,9,7,12,11,13,49,41,8,47
Berwick,9,8,9,10,17,30,58,-28,37
Edinburgh Ci,9,9,7,9,20,36,63,-27,30
Cowdenbeath,9,10,4,10,22,23,56,-33,22
Montrose,10,1,24,7,5,61,35,26,79
Peterhead,10,2,23,5,8,79,40,39,74
Stenhousem'r,10,3,16,8,12,56,46,10,56
Stirling,10,4,16,6,14,60,52,8,54
Clyde,10,5,15,9,12,54,49,5,54
Elgin,10,6,14,6,16,54,62,-8,48
Annan Athlet,10,7,11,12,13,48,42,6,45
Berwick,10,8,8,10,18,30,61,-31,34
Edinburgh Ci,10,9,7,10,19,38,62,-24,31
Cowdenbeath,10,10,4,11,21,24,55,-31,23
Peterhead,11,1,24,4,8,81,40,41,76
Montrose,11,2,23,7,6,59,36,23,76
Stirling,11,3,16,7,13,61,52,9,55
Stenhousem'r,11,4,15,9,12,56,47,9,54
Clyde,11,5,15,9,12,53,49,4,54
Elgin,11,6,15,6,15,55,60,-5,51
Annan Athlet,11,7,11,12,13,47,41,6,45
Berwick,11,8,8,10,18,30,60,-30,34
Edinburgh Ci,11,9,7,9,20,38,64,-26,30
Cowdenbeath,11,10,4,11,21,23,54,-31,23
Montrose,12,1,24,7,5,61,34,27,79
Peterhead,12,2,24,4,8,81,38,43,76
Stirling,12,3,17,6,13,61,51,10,57
Stenhousem'r,12,4,15,8,13,55,47,8,53
Clyde,12,5,14,9,13,51,49,2,51
Elgin,12,6,14,6,16,53,62,-9,48
Annan Athlet,12,7,11,11,14,47,43,4,44
Berwick,12,8,9,10,17,30,58,-28,37
Edinburgh Ci,12,9,7,9,20,36,64,-28,30
Cowdenbeath,12,10,5,10,21,25,54,-29,25
Montrose,13,1,24,7,5,60,34,26,79
Peterhead,13,2,24,4,8,83,38,45,76
Stirling,13,3,16,7,13,62,53,9,55
Stenhousem'r,13,4,15,9,12,57,48,9,54
Clyde,13,5,15,9,12,52,48,4,54
Elgin,13,6,14,6,16,53,61,-8,48
Annan Athlet,13,7,11,11,14,47,42,5,44
Berwick,13,8,8,10,18,29,59,-30,34
Edinburgh Ci,13,9,7,9,20,36,66,-30,30
Cowdenbeath,13,10,5,10,21,24,54,-30,25
Montrose,14,1,24,7,5,67,34,33,79
Peterhead,14,2,24,4,8,80,39,41,76
Stenhousem'r,14,3,16,8,12,56,46,10,56
Stirling,14,4,16,6,14,60,52,8,54
Clyde,14,5,14,10,12,53,50,3,52
Elgin,14,6,14,6,16,53,68,-15,48
Annan Athlet,14,7,11,11,14,48,43,5,44
Berwick,14,8,8,11,17,31,60,-29,35
Edinburgh Ci,14,9,7,9,20,37,63,-26,30
Cowdenbeath,14,10,5,10,21,25,55,-30,25
Montrose,15,1,24,7,5,62,35,27,79
Peterhead,15,2,24,4,8,82,38,44,76
Stenhousem'r,15,3,16,8,12,57,46,11,56
Stirling,15,4,16,6,14,60,53,7,54
Clyde,15,5,14,9,13,52,50,2,51
Elgin,15,6,14,6,16,54,63,-9,48
Annan Athlet,15,7,12,11,13,48,41,7,47
Berwick,15,8,9,10,17,31,59,-28,37
Edinburgh Ci,15,9,7,9,20,36,65,-29,30
Cowdenbeath,15,10,4,10,22,23,55,-32,22
Montrose,16,1,24,7,5,62,35,27,79
Peterhead,16,2,23,5,8,78,39,39,74
Stenhousem'r,16,3,16,8,12,56,46,10,56
Stirling,16,4,16,6,14,60,52,8,54
Clyde,16,5,14,10,12,52,49,3,52
Elgin,16,6,14,6,16,54,63,-9,48
Annan Athlet,16,7,11,12,13,47,41,6,45
Berwick,16,8,8,11,17,30,59,-29,35
Edinburgh Ci,16,9,7,10,19,37,61,-24,31
Cowdenbeath,16,10,4,11,21,23,54,-31,23
Montrose,17,1,23,8,5,60,35,25,77
Peterhead,17,2,24,4,8,79,38,41,76
Stirling,17,3,16,7,13,61,52,9,55
Stenhousem'r,17,4,15,9,12,56,47,9,54
Clyde,17,5,15,9,12,53,49,4,54
Elgin,17,6,14,7,15,54,61,-7,49
Annan Athlet,17,7,11,11,14,47,42,5,44
Berwick,17,8,8,10,18,30,60,-30,34
Edinburgh Ci,17,9,7,9,20,36,62,-26,30
Cowdenbeath,17,10,5,10,21,24,54,-30,25
Peterhead,18,1,24,4,8,78,38,40,76
Montrose,18,2,23,7,6,60,36,24,76
Stirling,18,3,17,6,13,61,51,10,57
Stenhousem'r,18,4,15,8,13,55,47,8,53
Clyde,18,5,14,10,12,52,49,3,52
Elgin,18,6,15,6,15,55,61,-6,51
Annan Athlet,18,7,12,11,13,48,41,7,47
Berwick,18,8,8,11,17,30,59,-29,35
Edinburgh Ci,18,9,7,9,20,36,61,-25,30
Cowdenbeath,18,10,4,10,22,23,55,-32,22
Montrose,19,1,24,7,5,61,34,27,79
Peterhead,19,2,24,4,8,80,40,40,76
Stirling,19,3,16,7,13,60,51,9,55
Stenhousem'r,19,4,15,9,12,55,46,9,54
Clyde,19,5,14,9,13,51,49,2,51
Elgin,19,6,14,6,16,53,62,-9,48
Annan Athlet,19,7,11,11,14,47,42,5,44
Berwick,19,8,9,10,17,30,58,-28,37
Edinburgh Ci,19,9,7,9,20,38,63,-25,30
Cowdenbeath,19,10,5,10,21,24,54,-30,25
Montrose,20,1,23,8,5,61,36,25,77
Peterhead,20,2,24,4,8,81,38,43,76
Stenhousem'r,20,3,16,8,12,57,46,11,56
Stirling,20,4,16,6,14,60,53,7,54
Clyde,20,5,14,9,13,51,51,0,51
Elgin,20,6,14,7,15,55,62,-7,49
Annan Athlet,20,7,11,12,13,48,42,6,45
Berwick,20,8,9,10,17,32,58,-26,37
Edinburgh Ci,20,9,7,9,20,36,64,-28,30
Cowdenbeath,20,10,4,11,21,24,55,-31,23
Montrose,21,1,24,7,5,61,34,27,79
Peterhead,21,2,24,4,8,80,38,42,76
Stirling,21,3,16,7,13,61,52,9,55
Stenhousem'r,21,4,15,9,12,56,47,9,54
Clyde,21,5,15,9,12,54,49,5,54
Elgin,21,6,14,6,16,53,62,-9,48
Annan Athlet,21,7,11,12,13,47,41,6,45
Berwick,21,8,8,10,18,30,61,-31,34
Edinburgh Ci,21,9,7,9,20,36,63,-27,30
Cowdenbeath,21,10,4,11,21,23,54,-31,23
Montrose,22,1,23,8,5,61,36,25,77
Peterhead,22,2,24,4,8,78,38,40,76
Stenhousem'r,22,3,16,8,12,56,46,10,56
Stirling,22,4,16,6,14,60,52,8,54
Clyde,22,5,14,10,12,51,48,3,52
Elgin,22,6,14,7,15,55,62,-7,49
Annan Athlet,22,7,11,11,14,47,43,4,44
Berwick,22,8,8,11,17,29,58,-29,35
Edinburgh Ci,22,9,7,9,20,36,61,-25,30
Cowdenbeath,22,10,5,10,21,25,54,-29,25
Montrose,23,1,24,7,5,63,35,28,79
Peterhead,23,2,24,4,8,78,38,40,76
Stirling,23,3,17,6,13,63,52,11,57
Clyde,23,4,15,9,12,55,48,7,54
Stenhousem'r,23,5,15,8,13,56,49,7,53
Elgin,23,6,14,6,16,54,64,-10,48
Annan Athlet,23,7,11,12,13,48,42,6,45
Berwick,23,8,8,10,18,29,62,-33,34
Edinburgh Ci,23,9,7,9,20,36,61,-25,30
Cowdenbeath,23,10,4,11,21,24,55,-31,23
Montrose,24,1,24,7,5,63,36,27,79
Peterhead,24,2,24,4,8,80,39,41,76
Stirling,24,3,16,7,13,60,51,9,55
Stenhousem'r,24,4,15,9,12,55,46,9,54
Clyde,24,5,15,9,12,56,50,6,54
Elgin,24,6,14,6,16,55,64,-9,48
Annan Athlet,24,7,11,11,14,47,43,4,44
Berwick,24,8,8,10,18,31,63,-32,34
Edinburgh Ci,24,9,7,9,20,37,63,-26,30
Cowdenbeath,24,10,5,10,21,25,54,-29,25
Montrose,25,1,24,7,5,60,34,26,79
Peterhead,25,2,24,4,8,80,40,40,76
Stirling,25,3,17,6,13,61,51,10,57
Clyde,25,4,15,9,12,54,50,4,54
Stenhousem'r,25,5,15,8,13,55,47,8,53
Elgin,25,6,14,6,16,53,61,-8,48
Annan Athlet,25,7,11,12,13,48,42,6,45
Berwick,25,8,8,10,18,31,61,-30,34
Edinburgh Ci,25,9,7,9,20,38,63,-25,30
Cowdenbeath,25,10,4,11,21,24,55,-31,23
Montrose,26,1,23,7,6,60,39,21,76
Peterhead,26,2,23,5,8,78,39,39,74
Stirling,26,3,17,6,13,62,52,10,57
Clyde,26,4,15,9,12,52,48,4,54
Stenhousem'r,26,5,15,8,13,56,48,8,53
Elgin,26,6,15,6,15,58,61,-3,51
Annan Athlet,26,7,11,11,14,48,43,5,44
Berwick,26,8,8,10,18,29,59,-30,34
Edinburgh Ci,26,9,7,10,19,37,61,-24,31
Cowdenbeath,26,10,5,10,21,25,55,-30,25
Montrose,27,1,24,7,5,64,36,28,79
Peterhead,27,2,23,4,9,78,40,38,73
Stirling,27,3,17,6,13,63,52,11,57
Clyde,27,4,15,9,12,53,48,5,54
Stenhousem'r,27,5,15,8,13,56,49,7,53
Elgin,27,6,14,6,16,55,65,-10,48
Annan Athlet,27,7,11,12,13,47,41,6,45
Berwick,27,8,8,10,18,29,60,-31,34
Edinburgh Ci,27,9,8,9,19,38,61,-23,33
Cowdenbeath,27,10,4,11,21,23,54,-31,23
Peterhead,28,1,24,4,8,81,39,42,76
Montrose,28,2,23,7,6,60,38,22,76
Stirling,28,3,16,7,13,63,54,9,55
Stenhousem'r,28,4,15,9,12,58,49,9,54
Clyde,28,5,15,9,12,55,48,7,54
Elgin,28,6,15,6,15,57,61,-4,51
Annan Athlet,28,7,12,11,13,49,41,8,47
Berwick,28,8,8,10,18,29,62,-33,34
Edinburgh Ci,28,9,7,9,20,37,64,-27,30
Cowdenbeath,28,10,4,10,22,23,56,-33,22
Peterhead,29,1,24,4,8,83,38,45,76
Montrose,29,2,23,7,6,62,38,24,76
Stirling,29,3,17,6,13,64,53,11,57
Clyde,29,4,15,9,12,56,49,7,54
Stenhousem'r,29,5,15,8,13,57,50,7,53
Elgin,29,6,15,6,15,57,63,-6,51
Annan Athlet,29,7,11,11,14,47,42,5,44
Berwick,29,8,8,10,18,30,63,-33,34
Edinburgh Ci,29,9,7,9,20,36,66,-30,30
Cowdenbeath,29,10,5,10,21,24,54,-30,25
Montrose,30,1,24,7,5,61,34,27,79
Peterhead,30,2,24,4,8,80,38,42,76
Stenhousem'r,30,3,16,8,12,58,47,11,56
Stirling,30,4,16,6,14,61,54,7,54
Clyde,30,5,14,10,12,52,49,3,52
Elgin,30,6,14,6,16,53,62,-9,48
Annan Athlet,30,7,11,11,14,48,45,3,44
Berwick,30,8,8,11,17,30,59,-29,35
Edinburgh Ci,30,9,7,9,20,36,63,-27,30
Cowdenbeath,30,10,5,10,21,27,55,-28,25
Montrose,31,1,24,7,5,61,35,26,79
Peterhead,31,2,24,4,8,86,39,47,76
Stirling,31,3,16,7,13,63,54,9,55
Stenhousem'r,31,4,15,9,12,58,49,9,54
Clyde,31,5,14,10,12,52,49,3,52
Elgin,31,6,14,6,16,54,62,-8,48
Annan Athlet,31,7,11,11,14,48,44,4,44
Berwick,31,8,8,11,17,30,59,-29,35
Edinburgh Ci,31,9,7,9,20,37,69,-32,30
Cowdenbeath,31,10,5,10,21,26,55,-29,25
Montrose,32,1,23,8,5,60,35,25,77
Peterhead,32,2,23,4,9,78,40,38,73
Stirling,32,3,17,6,13,62,52,10,57
Stenhousem'r,32,4,15,8,13,56,48,8,53
Clyde,32,5,14,9,13,53,51,2,51
Elgin,32,6,14,7,15,54,61,-7,49
Annan Athlet,32,7,11,11,14,47,43,4,44
Berwick,32,8,9,10,17,32,60,-28,37
Edinburgh Ci,32,9,8,9,19,38,61,-23,33
Cowdenbeath,32,10,5,10,21,25,54,-29,25
Montrose,33,1,24,7,5,61,35,26,79
Peterhead,33,2,24,4,8,79,38,41,76
Stirling,33,3,17,6,13,62,52,10,57
Clyde,33,4,15,9,12,55,48,7,54
Stenhousem'r,33,5,15,8,13,56,48,8,53
Elgin,33,6,14,6,16,54,62,-8,48
Annan Athlet,33,7,11,11,14,48,44,4,44
Berwick,33,8,8,10,18,29,62,-33,34
Edinburgh Ci,33,9,7,9,20,36,62,-26,30
Cowdenbeath,33,10,5,10,21,26,55,-29,25
Montrose,34,1,24,7,5,61,34,27,79
Peterhead,34,2,24,4,8,82,38,44,76
Stirling,34,3,17,6,13,62,51,11,57
Clyde,34,4,15,9,12,53,49,4,54
Stenhousem'r,34,5,15,8,13,55,48,7,53
Elgin,34,6,14,6,16,53,62,-9,48
Annan Athlet,34,7,11,12,13,48,42,6,45
Berwick,34,8,8,10,18,30,60,-30,34
Edinburgh Ci,34,9,7,9,20,36,65,-29,30
Cowdenbeath,34,10,4,11,21,24,55,-31,23
Montrose,35,1,23,8,5,59,34,25,77
Peterhead,35,2,24,4,8,79,38,41,76
Stirling,35,3,17,6,13,63,52,11,57
Stenhousem'r,35,4,15,8,13,56,49,7,53
Clyde,35,5,14,9,13,51,51,0,51
Elgin,35,6,14,7,15,53,60,-7,49
Annan Athlet,35,7,12,11,13,49,41,8,47
Berwick,35,8,9,10,17,32,58,-26,37
Edinburgh Ci,35,9,7,9,20,36,62,-26,30
Cowdenbeath,35,10,4,10,22,23,56,-33,22
Montrose,36,1,24,7,5,61,35,26,79
Peterhead,36,2,24,4,8,79,38,41,76
Stenhousem'r,36,3,16,8,12,57,46,11,56
Stirling,36,4,16,6,14,60,53,7,54
Clyde,36,5,14,10,12,51,48,3,52
Elgin,36,6,14,6,16,54,62,-8,48
Annan Athlet,36,7,12,11,13,49,42,7,47
Berwick,36,8,8,11,17,29,58,-29,35
Edinburgh Ci,36,9,7,9,20,36,62,-26,30
Cowdenbeath,36,10,4,10,22,24,56,-32,22
Montrose,37,1,24,7,5,63,35,28,79
Peterhead,37,2,23,5,8,77,38,39,74
Stirling,37,3,17,6,13,63,52,11,57
Stenhousem'r,37,4,15,8,13,56,49,7,53
Clyde,37,5,14,9,13,52,51,1,51
Elgin,37,6,14,6,16,54,64,-10,48
Annan Athlet,37,7,12,11,13,50,42,8,47
Berwick,37,8,9,10,17,32,59,-27,37
Edinburgh Ci,37,9,7,10,19,36,60,-24,31
Cowdenbeath,37,10,4,10,22,24,57,-33,22
Montrose,38,1,23,7,6,59,35,24,76
Peterhead,38,2,23,5,8,79,40,39,74
Stenhousem'r,38,3,16,8,12,56,46,10,56
Stirling,38,4,16,6,14,60,52,8,54
Clyde,38,5,14,10,12,52,49,3,52
Elgin,38,6,15,6,15,54,60,-6,51
Annan Athlet,38,7,11,11,14,48,44,4,44
Berwick,38,8,8,11,17,30,59,-29,35
Edinburgh Ci,38,9,7,10,19,38,62,-24,31
Cowdenbeath,38,10,5,10,21,26,55,-29,25
Montrose,39,1,23,7,6,59,37,22,76
Peterhead,39,2,23,4,9,77,39,38,73
Stenhousem'r,39,3,16,8,12,59,48,11,56
Stirling,39,4,16,6,14,62,55,7,54
Clyde,39,5,15,9,12,53,49,4,54
Elgin,39,6,15,6,15,56,60,-4,51
Annan Athlet,39,7,11,11,14,47,44,3,44
Berwick,39,8,8,10,18,30,60,-30,34
Edinburgh Ci,39,9,8,9,19,37,60,-23,33
Cowdenbeath,39,10,5,10,21,26,54,-28,25
Montrose,40,1,24,7,5,64,35,29,79
Peterhead,40,2,23,4,9,78,40,38,73
Stirling,40,3,17,6,13,63,52,11,57
Clyde,40,4,15,9,12,55,49,6,54
Stenhousem'r,40,5,15,8,13,56,49,7,53
Elgin,40,6,14,6,16,54,65,-11,48
Annan Athlet,40,7,11,11,14,47,42,5,44
Berwick,40,8,8,10,18,30,62,-32,34
Edinburgh Ci,40,9,8,9,19,38,61,-23,33
Cowdenbeath,40,10,5,10,21,24,54,-30,25
Peterhead,41,1,24,4,8,81,38,43,76
Montrose,41,2,23,7,6,59,36,23,76
Stirling,41,3,17,6,13,61,51,10,57
Clyde,41,4,15,9,12,55,51,4,54
Stenhousem'r,41,5,15,8,13,55,47,8,53
Elgin,41,6,15,6,15,55,60,-5,51
Annan Athlet,41,7,12,11,13,50,41,9,47
Berwick,41,8,8,10,18,32,62,-30,34
Edinburgh Ci,41,9,7,9,20,36,64,-28,30
Cowdenbeath,41,10,4,10,22,23,57,-34,22
Montrose,42,1,24,7,5,60,34,26,79
Peterhead,42,2,23,4,9,77,39,38,73
Stirling,42,3,17,6,13,62,51,11,57
Clyde,42,4,15,9,12,52,48,4,54
Stenhousem'r,42,5,15,8,13,55,48,7,53
Elgin,42,6,14,6,16,53,61,-8,48
Annan Athlet,42,7,12,11,13,49,41,8,47
Berwick,42,8,8,10,18,29,59,-30,34
Edinburgh Ci,42,9,8,9,19,37,60,-23,33
Cowdenbeath,42,10,4,10,22,23,56,-33,22
Montrose,43,1,24,7,5,62,34,28,79
Peterhead,43,2,24,4,8,79,38,41,76
Stenhousem'r,43,3,16,8,12,57,46,11,56
Stirling,43,4,16,6,14,60,53,7,54
Clyde,43,5,15,9,12,53,49,4,54
Elgin,43,6,14,6,16,53,63,-10,48
Annan Athlet,43,7,12,11,13,48,41,7,47
Berwick,43,8,8,10,18,30,60,-30,34
Edinburgh Ci,43,9,7,9,20,36,62,-26,30
Cowdenbeath,43,10,4,10,22,23,55,-32,22
Montrose,44,1,24,7,5,60,34,26,79
Peterhead,44,2,24,4,8,78,38,40,76
Stirling,44,3,17,6,13,63,52,11,57
Stenhousem'r,44,4,15,8,13,56,49,7,53
Clyde,44,5,14,10,12,53,50,3,52
Elgin,44,6,14,6,16,53,61,-8,48
Annan Athlet,44,7,12,11,13,49,42,7,47
Berwick,44,8,8,11,17,31,60,-29,35
Edinburgh Ci,44,9,7,9,20,36,61,-25,30
Cowdenbeath,44,10,4,10,22,24,56,-32,22
Montrose,45,1,23,8,5,61,36,25,77
Peterhead,45,2,24,4,8,78,38,40,76
Stenhousem'r,45,3,16,8,12,56,46,10,56
Stirling,45,4,16,6,14,60,52,8,54
Clyde,45,5,15,9,12,54,48,6,54
Elgin,45,6,14,7,15,55,62,-7,49
Annan Athlet,45,7,11,12,13,47,41,6,45
Berwick,45,8,8,10,18,29,61,-32,34
Edinburgh Ci,45,9,7,9,20,36,61,-25,30
Cowdenbeath,45,10,4,11,21,23,54,-31,23
Montrose,46,1,23,8,5,62,37,25,77
Peterhead,46,2,23,5,8,78,39,39,74
Stirling,46,3,17,6,13,61,51,10,57
Stenhousem'r,46,4,15,8,13,55,47,8,53
Clyde,46,5,14,9,13,51,51,0,51
Elgin,46,6,14,7,15,56,63,-7,49
Annan Athlet,46,7,11,11,14,47,45,2,44
Berwick,46,8,9,10,17,32,58,-26,37
Edinburgh Ci,46,9,7,10,19,37,61,-24,31
Cowdenbeath,46,10,5,10,21,27,54,-27,25
Montrose,47,1,24,7,5,62,34,28,79
Peterhead,47,2,24,4,8,79,38,41,76
Stirling,47,3,17,6,13,63,53,10,57
Clyde,47,4,15,9,12,55,49,6,54
Stenhousem'r,47,5,15,8,13,57,49,8,53
Elgin,47,6,14,6,16,53,63,-10,48
Annan Athlet,47,7,12,11,13,49,41,8,47
Berwick,47,8,8,10,18,30,62,-32,34
Edinburgh Ci,47,9,7,9,20,36,62,-26,30
Cowdenbeath,47,10,4,10,22,23,56,-33,22
Peterhead,48,1,24,4,8,80,39,41,76
Montrose,48,2,23,7,6,59,37,22,76
Stirling,48,3,16,7,13,61,52,9,55
Stenhousem'r,48,4,15,9,12,56,47,9,54
Clyde,48,5,14,10,12,51,48,3,52
Elgin,48,6,15,6,15,56,60,-4,51
Annan Athlet,48,7,11,11,14,47,45,2,44
Berwick,48,8,8,11,17,29,58,-29,35
Edinburgh Ci,48,9,7,9,20,37,63,-26,30
Cowdenbeath,48,10,5,10,21,27,54,-27,25
Montrose,49,1,23,8,5,60,35,25,77
Peterhead,49,2,24,4,8,79,39,40,76
Stirling,49,3,17,6,13,64,54,10,57
Clyde,49,4,15,9,12,53,49,4,54
Stenhousem'r,49,5,15,8,13,58,50,8,53
Elgin,49,6,14,7,15,54,61,-7,49
Annan Athlet,49,7,12,11,13,50,41,9,47
Berwick,49,8,8,10,18,30,60,-30,34
Edinburgh Ci,49,9,7,9,20,37,62,-25,30
Cowdenbeath,49,10,4,10,22,23,57,-34,22
Montrose,50,1,24,7,5,61,35,26,79
Peterhead,50,2,24,4,8,79,39,40,76
Stirling,50,3,17,6,13,63,51,12,57
Clyde,50,4,15,9,12,53,49,4,54
Stenhousem'r,50,5,15,8,13,55,49,6,53
Elgin,50,6,14,6,16,54,62,-8,48
Annan Athlet,50,7,11,12,13,49,43,6,45
Berwick,50,8,8,10,18,30,60,-30,34
Edinburgh Ci,50,9,7,9,20,37,62,-25,30
Cowdenbeath,50,10,4,11,21,25,56,-31,23
Montrose,51,1,23,8,5,62,37,25,77
Peterhead,51,2,24,4,8,78,38,40,76
Stenhousem'r,51,3,16,8,12,57,47,10,56
Stirling,51,4,16,6,14,61,53,8,54
Clyde,51,5,14,10,12,53,50,3,52
Elgin,51,6,14,7,15,56,63,-7,49
Annan Athlet,51,7,11,11,14,47,42,5,44
Berwick,51,8,8,11,17,31,60,-29,35
Edinburgh Ci,51,9,7,9,20,36,61,-25,30
Cowdenbeath,51,10,5,10,21,24,54,-30,25
Peterhead,52,1,24,4,8,80,40,40,76
Montrose,52,2,23,7,6,60,36,24,76
Stirling,52,3,16,7,13,61,52,9,55
Stenhousem'r,52,4,15,9,12,56,47,9,54
Clyde,52,5,14,10,12,51,48,3,52
Elgin,52,6,15,6,15,55,61,-6,51
Annan Athlet,52,7,11,12,13,49,43,6,45
Berwick,52,8,8,11,17,29,58,-29,35
Edinburgh Ci,52,9,7,9,20,38,63,-25,30
Cowdenbeath,52,10,4,11,21,25,56,-31,23
Montrose,53,1,24,7,5,62,36,26,79
Peterhead,53,2,24,4,8,80,39,41,76
Stirling,53,3,17,6,13,62,52,10,57
Clyde,53,4,15,9,12,53,49,4,54
Stenhousem'r,53,5,15,8,13,56,48,8,53
Elgin,53,6,14,6,16,55,63,-8,48
Annan Athlet,53,7,11,12,13,47,41,6,45
Berwick,53,8,8,10,18,30,60,-30,34
Edinburgh Ci,53,9,7,9,20,37,63,-26,30
Cowdenbeath,53,10,4,11,21,23,54,-31,23
Montrose,54,1,23,8,5,61,36,25,77
Peterhead,54,2,23,4,9,77,40,37,73
Stirling,54,3,17,6,13,62,52,10,57
Stenhousem'r,54,4,15,8,13,56,48,8,53
Clyde,54,5,14,10,12,51,48,3,52
Elgin,54,6,14,7,15,55,62,-7,49
Annan Athlet,54,7,11,11,14,48,43,5,44
Berwick,54,8,8,11,17,29,58,-29,35
Edinburgh Ci,54,9,8,9,19,38,60,-22,33
Cowdenbeath,54,10,5,10,21,25,55,-30,25
Montrose,55,1,24,7,5,60,34,26,79
Peterhead,55,2,24,4,8,80,38,42,76
Stirling,55,3,16,7,13,61,52,9,55
Stenhousem'r,55,4,15,9,12,56,47,9,54
Clyde,55,5,14,9,13,51,50,1,51
Elgin,55,6,14,6,16,53,61,-8,48
Annan Athlet,55,7,12,11,13,48,41,7,47
Berwick,55,8,9,10,17,31,58,-27,37
Edinburgh Ci,55,9,7,9,20,36,63,-27,30
Cowdenbeath,55,10,4,10,22,23,55,-32,22
Montrose,56,1,23,8,5,59,34,25,77
Peterhead,56,2,24,4,8,83,39,44,76
Stirling,56,3,17,6,13,63,52,11,57
Clyde,56,4,15,9,12,55,49,6,54
Stenhousem'r,56,5,15,8,13,56,49,7,53
Elgin,56,6,14,7,15,53,60,-7,49
Annan Athlet,56,7,11,11,14,48,43,5,44
Berwick,56,8,8,10,18,30,62,-32,34
Edinburgh Ci,56,9,7,9,20,37,66,-29,30
Cowdenbeath,56,10,5,10,21,25,55,-30,25
Montrose,57,1,24,7,5,62,34,28,79
Peterhead,57,2,24,4,8,80,40,40,76
Stirling,57,3,16,7,13,62,53,9,55
Stenhousem'r,57,4,15,9,12,57,48,9,54
Clyde,57,5,14,10,12,52,49,3,52
Elgin,57,6,14,6,16,53,63,-10,48
Annan Athlet,57,7,12,11,13,48,41,7,47
Berwick,57,8,8,11,17,30,59,-29,35
Edinburgh Ci,57,9,7,9,20,38,63,-25,30
Cowdenbeath,57,10,4,10,22,23,55,-32,22
Montrose,58,1,23,8,5,61,36,25,77
Peterhead,58,2,24,4,8,83,38,45,76
Stenhousem'r,58,3,16,8,12,56,46,10,56
Stirling,58,4,16,6,14,60,52,8,54
Clyde,58,5,15,9,12,54,49,5,54
Elgin,58,6,14,7,15,55,62,-7,49
Annan Athlet,58,7,11,11,14,48,43,5,44
Berwick,58,8,8,10,18,30,61,-31,34
Edinburgh Ci,58,9,7,9,20,36,66,-30,30
Cowdenbeath,58,10,5,10,21,25,55,-30,25
Montrose,59,1,24,7,5,61,35,26,79
Peterhead,59,2,23,5,8,78,39,39,74
Stirling,59,3,17,6,13,61,51,10,57
Clyde,59,4,15,9,12,55,49,6,54
Stenhousem'r,59,5,15,8,13,55,47,8,53
Elgin,59,6,14,6,16,54,62,-8,48
Annan Athlet,59,7,11,12,13,49,43,6,45
Berwick,59,8,8,10,18,30,62,-32,34
Edinburgh Ci,59,9,7,10,19,37,61,-24,31
Cowdenbeath,59,10,4,11,21,25,56,-31,23
Montrose,60,1,24,7,5,61,35,26,79
Peterhead,60,2,23,4,9,77,40,37,73
Stenhousem'r,60,3,16,8,12,59,49,10,56
Stirling,60,4,16,6,14,63,55,8,54
Clyde,60,5,15,9,12,54,50,4,54
Elgin,60,6,14,6,16,54,62,-8,48
Annan Athlet,60,7,11,11,14,47,42,5,44
Berwick,60,8,8,10,18,31,61,-30,34
Edinburgh Ci,60,9,8,9,19,38,60,-22,33
Cowdenbeath,60,10,5,10,21,24,54,-30,25
Montrose,61,1,24,7,5,63,35,28,79
Peterhead,61,2,24,4,8,82,38,44,76
Stirling,61,3,17,6,13,61,51,10,57
Stenhousem'r,61,4,15,8,13,55,47,8,53
Clyde,61,5,14,10,12,52,49,3,52
Elgin,61,6,14,6,16,54,64,-10,48
Annan Athlet,61,7,11,11,14,47,42,5,44
Berwick,61,8,8,11,17,30,59,-29,35
Edinburgh Ci,61,9,7,9,20,36,65,-29,30
Cowdenbeath,61,10,5,10,21,24,54,-30,25
Montrose,62,1,23,8,5,60,35,25,77
Peterhead,62,2,23,5,8,78,39,39,74
Stirling,62,3,17,6,13,62,51,11,57
Stenhousem'r,62,4,15,8,13,55,48,7,53
Clyde,62,5,14,9,13,51,49,2,51
Elgin,62,6,14,7,15,54,61,-7,49
Annan Athlet,62,7,11,12,13,47,41,6,45
Berwick,62,8,9,10,17,30,58,-28,37
Edinburgh Ci,62,9,7,10,19,37,61,-24,31
Cowdenbeath,62,10,4,11,21,23,54,-31,23
Montrose,63,1,23,8,5,59,34,25,77
Peterhead,63,2,23,4,9,78,40,38,73
Stirling,63,3,16,7,13,60,51,9,55
Stenhousem'r,63,4,15,9,12,55,46,9,54
Clyde,63,5,14,10,12,52,49,3,52
Elgin,63,6,14,7,15,53,60,-7,49
Annan Athlet,63,7,12,11,13,49,41,8,47
Berwick,63,8,8,11,17,30,59,-29,35
Edinburgh Ci,63,9,8,9,19,38,61,-23,33
Cowdenbeath,63,10,4,10,22,23,56,-33,22
Montrose,64,1,24,7,5,61,35,26,79
Peterhead,64,2,23,5,8,78,39,39,74
Stenhousem'r,64,3,16,8,12,57,46,11,56
Stirling,64,4,16,6,14,60,53,7,54
Clyde,64,5,14,9,13,52,51,1,51
Elgin,64,6,14,6,16,54,62,-8,48
Annan Athlet,64,7,11,11,14,47,43,4,44
Berwick,64,8,9,10,17,32,59,-27,37
Edinburgh Ci,64,9,7,10,19,37,61,-24,31
Cowdenbeath,64,10,5,10,21,25,54,-29,25
Montrose,65,1,24,7,5,62,35,27,79
Peterhead,65,2,24,4,8,79,38,41,76
Stirling,65,3,17,6,13,64,52,12,57
Clyde,65,4,15,9,12,53,49,4,54
Stenhousem'r,65,5,15,8,13,56,50,6,53
Elgin,65,6,14,6,16,54,63,-9,48
Annan Athlet,65,7,11,12,13,47,41,6,45
Berwick,65,8,8,10,18,30,60,-30,34
Edinburgh Ci,65,9,7,9,20,36,62,-26,30
Cowdenbeath,65,10,4,11,21,23,54,-31,23
Montrose,66,1,24,7,5,63,35,28,79
Peterhead,66,2,24,4,8,80,38,42,76
Stirling,66,3,17,6,13,62,52,10,57
Clyde,66,4,15,9,12,53,48,5,54
Stenhousem'r,66,5,15,8,13,56,48,8,53
Elgin,66,6,14,6,16,54,64,-10,48
Annan Athlet,66,7,12,11,13,51,41,10,47
Berwick,66,8,8,10,18,29,60,-31,34
Edinburgh Ci,66,9,7,9,20,36,63,-27,30
Cowdenbeath,66,10,4,10,22,23,58,-35,22
Montrose,67,1,24,7,5,62,35,27,79
Peterhead,67,2,24,4,8,80,39,41,76
Stirling,67,3,17,6,13,63,52,11,57
Clyde,67,4,15,9,12,53,48,5,54
Stenhousem'r,67,5,15,8,13,56,49,7,53
Elgin,67,6,14,6,16,54,63,-9,48
Annan Athlet,67,7,12,11,13,50,43,7,47
Berwick,67,8,8,10,18,29,60,-31,34
Edinburgh Ci,67,9,7,9,20,37,63,-26,30
Cowdenbeath,67,10,4,10,22,25,57,-32,22
Montrose,68,1,24,7,5,60,34,26,79
Peterhead,68,2,24,4,8,82,40,42,76
Stenhousem'r,68,3,16,8,12,58,47,11,56
Stirling,68,4,16,6,14,61,54,7,54
Clyde,68,5,15,9,12,52,48,4,54
Elgin,68,6,14,6,16,53,61,-8,48
Annan Athlet,68,7,12,11,13,50,41,9,47
Berwick,68,8,8,10,18,29,59,-30,34
Edinburgh Ci,68,9,7,9,20,38,65,-27,30
Cowdenbeath,68,10,4,10,22,23,57,-34,22
Montrose,69,1,24,7,5,63,35,28,79
Peterhead,69,2,23,5,8,78,39,39,74
Stirling,69,3,17,6,13,61,51,10,57
Clyde,69,4,15,9,12,53,48,5,54
Stenhousem'r,69,5,15,8,13,55,47,8,53
Elgin,69,6,14,6,16,54,64,-10,48
Annan Athlet,69,7,11,11,14,48,43,5,44
Berwick,69,8,8,10,18,29,60,-31,34
Edinburgh Ci,69,9,7,10,19,37,61,-24,31
Cowdenbeath,69,10,5,10,21,25,55,-30,25
Montrose,70,1,23,8,5,61,36,25,77
Peterhead,70,2,24,4,8,80,40,40,76
Stirling,70,3,17,6,13,62,52,10,57
Clyde,70,4,15,9,12,54,49,5,54
Stenhousem'r,70,5,15,8,13,56,48,8,53
Elgin,70,6,14,7,15,55,62,-7,49
Annan Athlet,70,7,11,12,13,47,41,6,45
Berwick,70,8,8,10,18,30,61,-31,34
Edinburgh Ci,70,9,7,9,20,38,63,-25,30
Cowdenbeath,70,10,4,11,21,23,54,-31,23
Peterhead,71,1,24,4,8,81,38,43,76
Montrose,71,2,23,7,6,59,36,23,76
Stirling,71,3,17,6,13,65,52,13,57
Clyde,71,4,15,9,12,53,48,5,54
Stenhousem'r,71,5,15,8,13,56,51,5,53
Elgin,71,6,15,6,15,55,60,-5,51
Annan Athlet,71,7,11,12,13,48,42,6,45
Berwick,71,8,8,10,18,29,60,-31,34
Edinburgh Ci,71,9,7,9,20,36,64,-28,30
Cowdenbeath,71,10,4,11,21,24,55,-31,23
Montrose,72,1,24,7,5,63,34,29,79
Peterhead,72,2,24,4,8,79,38,41,76
Stirling,72,3,16,7,13,61,52,9,55
Stenhousem'r,72,4,15,9,12,56,47,9,54
Clyde,72,5,15,9,12,55,48,7,54
Elgin,72,6,14,6,16,53,64,-11,48
Annan Athlet,72,7,11,12,13,49,43,6,45
Berwick,72,8,8,10,18,29,62,-33,34
Edinburgh Ci,72,9,7,9,20,36,62,-26,30
Cowdenbeath,72,10,4,11,21,25,56,-31,23
Montrose,73,1,24,7,5,61,34,27,79
Peterhead,73,2,24,4,8,84,39,45,76
Stenhousem'r,73,3,16,8,12,57,46,11,56
Stirling,73,4,16,6,14,60,53,7,54
Clyde,73,5,14,9,13,51,50,1,51
Elgin,73,6,14,6,16,53,62,-9,48
Annan Athlet,73,7,11,12,13,48,42,6,45
Berwick,73,8,9,10,17,31,58,-27,37
Edinburgh Ci,73,9,7,9,20,37,67,-30,30
Cowdenbeath,73,10,4,11,21,24,55,-31,23
Montrose,74,1,24,7,5,60,34,26,79
Peterhead,74,2,24,4,8,82,39,43,76
Stirling,74,3,16,7,13,60,51,9,55
Stenhousem'r,74,4,15,9,12,55,46,9,54
Clyde,74,5,15,9,12,54,48,6,54
Elgin,74,6,14,6,16,53,61,-8,48
Annan Athlet,74,7,11,11,14,48,44,4,44
Berwick,74,8,8,10,18,29,61,-32,34
Edinburgh Ci,74,9,7,9,20,37,65,-28,30
Cowdenbeath,74,10,5,10,21,26,55,-29,25
Montrose,75,1,24,7,5,62,34,28,79
Peterhead,75,2,24,4,8,84,38,46,76
Stenhousem'r,75,3,16,8,12,57,47,10,56
Stirling,75,4,16,6,14,61,53,8,54
Clyde,75,5,15,9,12,52,48,4,54
Elgin,75,6,14,6,16,53,63,-10,48
Annan Athlet,75,7,12,11,13,48,41,7,47
Berwick,75,8,8,10,18,29,59,-30,34
Edinburgh Ci,75,9,7,9,20,36,67,-31,30
Cowdenbeath,75,10,4,10,22,23,55,-32,22
Montrose,76,1,24,7,5,61,35,26,79
Peterhead,76,2,24,4,8,78,38,40,76
Stirling,76,3,17,6,13,64,51,13,57
Stenhousem'r,76,4,15,8,13,55,50,5,53
Clyde,76,5,14,10,12,52,49,3,52
Elgin,76,6,14,6,16,54,62,-8,48
Annan Athlet,76,7,12,11,13,49,42,7,47
Berwick,76,8,8,11,17,30,59,-29,35
Edinburgh Ci,76,9,7,9,20,36,61,-25,30
Cowdenbeath,76,10,4,10,22,24,56,-32,22
Montrose,77,1,23,8,5,60,35,25,77
Peterhead,77,2,24,4,8,79,38,41,76
Stirling,77,3,16,7,13,60,51,9,55
Stenhousem'r,77,4,15,9,12,55,46,9,54
Clyde,77,5,15,9,12,55,48,7,54
Elgin,77,6,14,7,15,54,61,-7,49
Annan Athlet,77,7,12,11,13,51,43,8,47
Berwick,77,8,8,10,18,29,62,-33,34
Edinburgh Ci,77,9,7,9,20,36,62,-26,30
Cowdenbeath,77,10,4,10,22,25,58,-33,22
Peterhead,78,1,24,4,8,79,38,41,76
Montrose,78,2,23,7,6,60,37,23,76
Stirling,78,3,17,6,13,62,52,10,57
Clyde,78,4,15,9,12,53,48,5,54
Stenhousem'r,78,5,15,8,13,56,48,8,53
Elgin,78,6,15,6,15,56,61,-5,51
Annan Athlet,78,7,11,12,13,48,42,6,45
Berwick,78,8,8,10,18,29,60,-31,34
Edinburgh Ci,78,9,7,9,20,36,62,-26,30
Cowdenbeath,78,10,4,11,21,24,55,-31,23
Montrose,79,1,23,8,5,61,36,25,77
Peterhead,79,2,24,4,8,80,38,42,76
Stenhousem'r,79,3,16,8,12,56,46,10,56
Stirling,79,4,16,6,14,60,52,8,54
Clyde,79,5,14,10,12,52,49,3,52
Elgin,79,6,14,7,15,55,62,-7,49
Annan Athlet,79,7,11,12,13,48,42,6,45
Berwick,79,8,8,11,17,30,59,-29,35
Edinburgh Ci,79,9,7,9,20,36,63,-27,30
Cowdenbeath,79,10,4,11,21,24,55,-31,23
Montrose,80,1,24,7,5,65,34,31,79
Peterhead,80,2,24,4,8,82,39,43,76
Stirling,80,3,16,7,13,61,52,9,55
Stenhousem'r,80,4,15,9,12,56,47,9,54
Clyde,80,5,15,9,12,54,48,6,54
Elgin,80,6,14,6,16,53,66,-13,48
Annan Athlet,80,7,11,11,14,47,42,5,44
Berwick,80,8,8,10,18,29,61,-32,34
Edinburgh Ci,80,9,7,9,20,37,65,-28,30
Cowdenbeath,80,10,5,10,21,24,54,-30,25
Montrose,81,1,24,7,5,64,35,29,79
Peterhead,81,2,24,4,8,80,38,42,76
Stirling,81,3,17,6,13,63,51,12,57
Clyde,81,4,15,9,12,55,49,6,54
Stenhousem'r,81,5,15,8,13,55,49,6,53
Elgin,81,6,14,6,16,54,65,-11,48
Annan Athlet,81,7,11,12,13,47,41,6,45
Berwick,81,8,8,10,18,30,62,-32,34
Edinburgh Ci,81,9,7,9,20,36,63,-27,30
Cowdenbeath,81,10,4,11,21,23,54,-31,23
Montrose,82,1,24,7,5,62,36,26,79
Peterhead,82,2,24,4,8,81,41,40,76
Stirling,82,3,17,6,13,65,54,11,57
Clyde,82,4,15,9,12,55,49,6,54
Stenhousem'r,82,5,15,8,13,58,51,7,53
Elgin,82,6,14,6,16,55,63,-8,48
Annan Athlet,82,7,12,11,13,48,41,7,47
Berwick,82,8,8,10,18,30,62,-32,34
Edinburgh Ci,82,9,7,9,20,39,64,-25,30
Cowdenbeath,82,10,4,10,22,23,55,-32,22
Montrose,83,1,24,7,5,62,35,27,79
Peterhead,83,2,23,5,8,77,38,39,74
Stirling,83,3,17,6,13,63,53,10,57
Clyde,83,4,15,9,12,53,48,5,54
Stenhousem'r,83,5,15,8,13,57,49,8,53
Elgin,83,6,14,6,16,54,63,-9,48
Annan Athlet,83,7,12,11,13,49,41,8,47
Berwick,83,8,8,10,18,29,60,-31,34
Edinburgh Ci,83,9,7,10,19,36,60,-24,31
Cowdenbeath,83,10,4,10,22,23,56,-33,22
Montrose,84,1,23,8,5,60,35,25,77
Peterhead,84,2,23,5,8,78,39,39,74
Stirling,84,3,16,7,13,63,54,9,55
Stenhousem'r,84,4,15,9,12,58,49,9,54
Clyde,84,5,15,9,12,54,49,5,54
Elgin,84,6,14,7,15,54,61,-7,49
Annan Athlet,84,7,12,11,13,49,41,8,47
Berwick,84,8,8,10,18,30,61,-31,34
Edinburgh Ci,84,9,7,10,19,37,61,-24,31
Cowdenbeath,84,10,4,10,22,23,56,-33,22
Montrose,85,1,23,8,5,61,36,25,77
Peterhead,85,2,23,5,8,79,40,39,74
Stirling,85,3,17,6,13,62,52,10,57
Clyde,85,4,15,9,12,53,48,5,54
Stenhousem'r,85,5,15,8,13,56,48,8,53
Elgin,85,6,14,7,15,55,62,-7,49
Annan Athlet,85,7,11,11,14,47,43,4,44
Berwick,85,8,8,10,18,29,60,-31,34
Edinburgh Ci,85,9,7,10,19,38,62,-24,31
Cowdenbeath,85,10,5,10,21,25,54,-29,25
Montrose,86,1,23,7,6,59,35,24,76
Peterhead,86,2,23,4,9,77,40,37,73
Stenhousem'r,86,3,16,8,12,59,49,10,56
Stirling,86,4,16,6,14,63,55,8,54
Clyde,86,5,15,9,12,53,48,5,54
Elgin,86,6,15,6,15,54,60,-6,51
Annan Athlet,86,7,12,11,13,50,41,9,47
Berwick,86,8,8,10,18,29,60,-31,34
Edinburgh Ci,86,9,8,9,19,38,60,-22,33
Cowdenbeath,86,10,4,10,22,23,57,-34,22
Montrose,87,1,23,8,5,60,35,25,77
Peterhead,87,2,24,4,8,80,39,41,76
Stirling,87,3,17,6,13,63,51,12,57
Stenhousem'r,87,4,15,8,13,55,49,6,53
Clyde,87,5,14,10,12,53,50,3,52
Elgin,87,6,14,7,15,54,61,-7,49
Annan Athlet,87,7,11,11,14,47,42,5,44
Berwick,87,8,8,11,17,31,60,-29,35
Edinburgh Ci,87,9,7,9,20,37,63,-26,30
Cowdenbeath,87,10,5,10,21,24,54,-30,25
Montrose,88,1,23,7,6,60,36,24,76
Peterhead,88,2,23,4,9,77,39,38,73
Stirling,88,3,17,6,13,62,52,10,57
Stenhousem'r,88,4,15,8,13,56,48,8,53
Clyde,88,5,14,9,13,51,50,1,51
Elgin,88,6,15,6,15,55,61,-6,51
Annan Athlet,88,7,11,11,14,47,44,3,44
Berwick,88,8,9,10,17,31,58,-27,37
Edinburgh Ci,88,9,8,9,19,37,60,-23,33
Cowdenbeath,88,10,5,10,21,26,54,-28,25
Montrose,89,1,23,8,5,60,35,25,77
Peterhead,89,2,24,4,8,79,38,41,76
Stirling,89,3,17,6,13,63,52,11,57
Clyde,89,4,15,9,12,53,49,4,54
Stenhousem'r,89,5,15,8,13,56,49,7,53
Elgin,89,6,14,7,15,54,61,-7,49
Annan Athlet,89,7,11,12,13,48,42,6,45
Berwick,89,8,8,10,18,30,60,-30,34
Edinburgh Ci,89,9,7,9,20,36,62,-26,30
Cowdenbeath,89,10,4,11,21,24,55,-31,23
Peterhead,90,1,24,4,8,80,39,41,76
Montrose,90,2,23,7,6,60,36,24,76
Stirling,90,3,16,7,13,64,55,9,55
Stenhousem'r,90,4,15,9,12,59,50,9,54
Clyde,90,5,15,9,12,53,49,4,54
Elgin,90,6,15,6,15,55,61,-6,51
Annan Athlet,90,7,12,11,13,49,42,7,47
Berwick,90,8,8,10,18,30,60,-30,34
Edinburgh Ci,90,9,7,9,20,37,63,-26,30
Cowdenbeath,90,10,4,10,22,24,56,-32,22
Montrose,91,1,24,7,5,60,34,26,79
Peterhead,91,2,24,4,8,78,38,40,76
Stenhousem'r,91,3,16,8,12,57,46,11,56
Stirling,91,4,16,6,14,60,53,7,54
Clyde,91,5,14,9,13,52,50,2,51
Elgin,91,6,14,6,16,53,61,-8,48
Annan Athlet,91,7,12,11,13,49,41,8,47
Berwick,91,8,9,10,17,31,59,-28,37
Edinburgh Ci,91,9,7,9,20,36,61,-25,30
Cowdenbeath,91,10,4,10,22,23,56,-33,22
Montrose,92,1,24,7,5,64,35,29,79
Peterhead,92,2,24,4,8,82,39,43,76
Stirling,92,3,17,6,13,61,51,10,57
Stenhousem'r,92,4,15,8,13,55,47,8,53
Clyde,92,5,14,10,12,53,50,3,52
Elgin,92,6,14,6,16,54,65,-11,48
Annan Athlet,92,7,12,11,13,49,42,7,47
Berwick,92,8,8,11,17,31,60,-29,35
Edinburgh Ci,92,9,7,9,20,37,65,-28,30
Cowdenbeath,92,10,4,10,22,24,56,-32,22
Montrose,93,1,24,7,5,60,34,26,79
Peterhead,93,2,24,4,8,82,39,43,76
Stenhousem'r,93,3,16,8,12,57,47,10,56
Stirling,93,4,16,6,14,61,53,8,54
Clyde,93,5,15,9,12,52,48,4,54
Elgin,93,6,14,6,16,53,61,-8,48
Annan Athlet,93,7,12,11,13,50,41,9,47
Berwick,93,8,8,10,18,29,59,-30,34
Edinburgh Ci,93,9,7,9,20,37,65,-28,30
Cowdenbeath,93,10,4,10,22,23,57,-34,22
Montrose,94,1,23,8,5,60,35,25,77
Peterhead,94,2,24,4,8,83,38,45,76
Stirling,94,3,17,6,13,61,51,10,57
Clyde,94,4,15,9,12,52,48,4,54
Stenhousem'r,94,5,15,8,13,55,47,8,53
Elgin,94,6,14,7,15,54,61,-7,49
Annan Athlet,94,7,12,11,13,48,41,7,47
Berwick,94,8,8,10,18,29,59,-30,34
Edinburgh Ci,94,9,7,9,20,36,66,-30,30
Cowdenbeath,94,10,4,10,22,23,55,-32,22
Montrose,95,1,24,7,5,61,34,27,79
Peterhead,95,2,24,4,8,82,38,44,76
Stirling,95,3,17,6,13,62,52,10,57
Clyde,95,4,15,9,12,54,48,6,54
Stenhousem'r,95,5,15,8,13,56,48,8,53
Elgin,95,6,14,6,16,53,62,-9,48
Annan Athlet,95,7,11,12,13,47,41,6,45
Berwick,95,8,8,10,18,29,61,-32,34
Edinburgh Ci,95,9,7,9,20,36,65,-29,30
Cowdenbeath,95,10,4,11,21,23,54,-31,23
Montrose,96,1,24,7,5,64,34,30,79
Peterhead,96,2,23,5,8,79,40,39,74
Stirling,96,3,16,7,13,62,53,9,55
Stenhousem'r,96,4,15,9,12,57,48,9,54
Clyde,96,5,15,9,12,53,49,4,54
Elgin,96,6,14,6,16,53,65,-12,48
Annan Athlet,96,7,12,11,13,49,41,8,47
Berwick,96,8,8,10,18,30,60,-30,34
Edinburgh Ci,96,9,7,10,19,38,62,-24,31
Cowdenbeath,96,10,4,10,22,23,56,-33,22
Montrose,97,1,23,8,5,60,35,25,77
Peterhead,97,2,24,4,8,81,39,42,76
Stirling,97,3,17,6,13,63,51,12,57
Clyde,97,4,15,9,12,55,49,6,54
Stenhousem'r,97,5,15,8,13,55,49,6,53
Elgin,97,6,14,7,15,54,61,-7,49
Annan Athlet,97,7,11,12,13,49,43,6,45
Berwick,97,8,8,10,18,30,62,-32,34
Edinburgh Ci,97,9,7,9,20,37,64,-27,30
Cowdenbeath,97,10,4,11,21,25,56,-31,23
Peterhead,98,1,24,4,8,83,38,45,76
Montrose,98,2,23,7,6,60,36,24,76
Stenhousem'r,98,3,16,8,12,57,47,10,56
Stirling,98,4,16,6,14,61,53,8,54
Clyde,98,5,15,9,12,54,48,6,54
Elgin,98,6,15,6,15,55,61,-6,51
Annan Athlet,98,7,11,12,13,47,41,6,45
Berwick,98,8,8,10,18,29,61,-32,34
Edinburgh Ci,98,9,7,9,20,36,66,-30,30
Cowdenbeath,98,10,4,11,21,23,54,-31,23
Montrose,99,1,24,7,5,62,36,26,79
Peterhead,99,2,23,5,8,77,38,39,74
Stenhousem'r,99,3,16,8,12,56,46,10,56
Stirling,99,4,16,6,14,60,52,8,54
Clyde,99,5,14,9,13,51,51,0,51
Elgin,99,6,14,6,16,55,63,-8,48
Annan Athlet,99,7,11,12,13,49,43,6,45
Berwick,99,8,9,10,17,32,58,-26,37
Edinburgh Ci,99,9,7,10,19,36,60,-24,31
Cowdenbeath,99,10,4,11,21,25,56,-31,23
Montrose,100,1,24,7,5,61,35,26,79
Peterhead,100,2,23,4,9,78,40,38,73
Stirling,100,3,16,7,13,61,52,9,55
Stenhousem'r,100,4,15,9,12,56,47,9,54
Clyde,100,5,14,10,12,53,50,3,52
Elgin,100,6,14,6,16,54,62,-8,48
Annan Athlet,100,7,12,11,13,50,43,7,47
Berwick,100,8,8,11,17,31,60,-29,35
Edinburgh Ci,100,9,8,9,19,38,61,-23,33
Cowdenbeath,100,10,4,10,22,25,57,-32,22
Montrose,101,1,24,7,5,61,34,27,79
Peterhead,101,2,23,5,8,79,40,39,74
Stenhousem'r,101,3,16,8,12,56,46,10,56
Stirling,101,4,16,6,14,60,52,8,54
Clyde,101,5,15,9,12,53,48,5,54
Elgin,101,6,14,6,16,53,62,-9,48
Annan Athlet,101,7,11,11,14,48,43,5,44
Berwick,101,8,8,10,18,29,60,-31,34
Edinburgh Ci,101,9,7,10,19,38,62,-24,31
Cowdenbeath,101,10,5,10,21,25,55,-30,25
Montrose,102,1,24,7,5,62,36,26,79
Peterhead,102,2,24,4,8,79,38,41,76
Stirling,102,3,17,6,13,64,54,10,57
Clyde,102,4,15,9,12,52,48,4,54
Stenhousem'r,102,5,15,8,13,58,50,8,53
Elgin,102,6,14,6,16,55,63,-8,48
Annan Athlet,102,7,12,11,13,50,41,9,47
Berwick,102,8,8,10,18,29,59,-30,34
Edinburgh Ci,102,9,7,9,20,36,62,-26,30
Cowdenbeath,102,10,4,10,22,23,57,-34,22
Montrose,103,1,24,7,5,62,35,27,79
Peterhead,103,2,24,4,8,78,38,40,76
Stirling,103,3,16,7,13,62,53,9,55
Stenhousem'r,103,4,15,9,12,57,48,9,54
Clyde,103,5,15,9,12,53,49,4,54
Elgin,103,6,14,6,16,54,63,-9,48
Annan Athlet,103,7,11,12,13,48,42,6,45
Berwick,103,8,8,10,18,30,60,-30,34
Edinburgh Ci,103,9,7,9,20,36,61,-25,30
Cowdenbeath,103,10,4,11,21,24,55,-31,23
Montrose,104,1,24,7,5,62,35,27,79
Peterhead,104,2,24,4,8,80,38,42,76
Stirling,104,3,17,6,13,63,53,10,57
Stenhousem'r,104,4,15,8,13,57,49,8,53
Clyde,104,5,14,9,13,52,50,2,51
Elgin,104,6,14,6,16,54,63,-9,48
Annan Athlet,104,7,11,12,13,47,41,6,45
Berwick,104,8,9,10,17,31,59,-28,37
Edinburgh Ci,104,9,7,9,20,36,63,-27,30
Cowdenbeath,104,10,4,11,21,23,54,-31,23
Montrose,105,1,24,7,5,61,34,27,79
Peterhead,105,2,24,4,8,79,38,41,76
Stirling,105,3,17,6,13,61,51,10,57
Clyde,105,4,15,9,12,52,48,4,54
Stenhousem'r,105,5,15,8,13,55,47,8,53
Elgin,105,6,14,6,16,53,62,-9,48
Annan Athlet,105,7,12,11,13,48,41,7,47
Berwick,105,8,8,10,18,29,59,-30,34
Edinburgh Ci,105,9,7,9,20,36,62,-26,30
Cowdenbeath,105,10,4,10,22,23,55,-32,22
Montrose,106,1,24,7,5,63,34,29,79
Peterhead,106,2,23,5,8,78,39,39,74
Stirling,106,3,16,7,13,63,54,9,55
Stenhousem'r,106,4,15,9,12,58,49,9,54
Clyde,106,5,15,9,12,55,50,5,54
Elgin,106,6,14,6,16,53,64,-11,48
Annan Athlet,106,7,11,12,13,48,42,6,45
Berwick,106,8,8,10,18,31,62,-31,34
Edinburgh Ci,106,9,7,10,19,37,61,-24,31
Cowdenbeath,106,10,4,11,21,24,55,-31,23
Peterhead,107,1,24,4,8,84,40,44,76
Montrose,107,2,23,7,6,63,40,23,76
Stirling,107,3,17,6,13,63,53,10,57
Clyde,107,4,15,9,12,53,49,4,54
Stenhousem'r,107,5,15,8,13,57,49,8,53
Elgin,107,6,15,6,15,59,64,-5,51
Annan Athlet,107,7,12,11,13,49,41,8,47
Berwick,107,8,8,10,18,30,60,-30,34
Edinburgh Ci,107,9,7,9,20,38,67,-29,30
Cowdenbeath,107,10,4,10,22,23,56,-33,22
Montrose,108,1,23,8,5,62,37,25,77
Peterhead,108,2,24,4,8,81,39,42,76
Stirling,108,3,16,7,13,61,52,9,55
Stenhousem'r,108,4,15,9,12,56,47,9,54
Clyde,108,5,15,9,12,54,48,6,54
Elgin,108,6,14,7,15,56,63,-7,49
Annan Athlet,108,7,11,12,13,48,42,6,45
Berwick,108,8,8,10,18,29,61,-32,34
Edinburgh Ci,108,9,7,9,20,37,64,-27,30
Cowdenbeath,108,10,4,11,21,24,55,-31,23
Montrose,109,1,23,8,5,61,36,25,77
Peterhead,109,2,24,4,8,83,38,45,76
Stirling,109,3,17,6,13,62,52,10,57
Clyde,109,4,15,9,12,52,48,4,54
Stenhousem'r,109,5,15,8,13,56,48,8,53
Elgin,109,6,14,7,15,55,62,-7,49
Annan Athlet,109,7,12,11,13,50,42,8,47
Berwick,109,8,8,10,18,29,59,-30,34
Edinburgh Ci,109,9,7,9,20,36,66,-30,30
Cowdenbeath,109,10,4,10,22,24,57,-33,22
Montrose,110,1,23,8,5,62,37,25,77
Peterhead,110,2,24,4,8,79,39,40,76
Stenhousem'r,110,3,16,8,12,56,46,10,56
Stirling,110,4,16,6,14,60,52,8,54
Clyde,110,5,14,10,12,53,50,3,52
Elgin,110,6,14,7,15,56,63,-7,49
Annan Athlet,110,7,12,11,13,48,41,7,47
Berwick,110,8,8,11,17,31,60,-29,35
Edinburgh Ci,110,9,7,9,20,37,62,-25,30
Cowdenbeath,110,10,4,10,22,23,55,-32,22
Montrose,111,1,24,7,5,61,34,27,79
Peterhead,111,2,24,4,8,80,38,42,76
Stenhousem'r,111,3,16,8,12,59,46,13,56
Clyde,111,4,15,9,12,55,48,7,54
Stirling,111,5,16,6,14,60,55,5,54
Elgin,111,6,14,6,16,53,62,-9,48
Annan Athlet,111,7,12,11,13,48,41,7,47
Berwick,111,8,8,10,18,29,62,-33,34
Edinburgh Ci,111,9,7,9,20,36,63,-27,30
Cowdenbeath,111,10,4,10,22,23,55,-32,22
Montrose,112,1,24,7,5,61,34,27,79
Peterhead,112,2,23,5,8,77,38,39,74
Stirling,112,3,17,6,13,62,51,11,57
Clyde,112,4,15,9,12,53,48,5,54
Stenhousem'r,112,5,15,8,13,55,48,7,53
Elgin,112,6,14,6,16,53,62,-9,48
Annan Athlet,112,7,12,11,13,49,41,8,47
Berwick,112,8,8,10,18,29,60,-31,34
Edinburgh Ci,112,9,7,10,19,36,60,-24,31
Cowdenbeath,112,10,4,10,22,23,56,-33,22
Montrose,113,1,24,7,5,62,35,27,79
Peterhead,113,2,24,4,8,78,38,40,76
Stirling,113,3,16,7,13,60,51,9,55
Stenhousem'r,113,4,15,9,12,55,46,9,54
Clyde,113,5,15,9,12,53,48,5,54
Elgin,113,6,14,6,16,54,63,-9,48
Annan Athlet,113,7,12,11,13,50,41,9,47
Berwick,113,8,8,10,18,29,60,-31,34
Edinburgh Ci,113,9,7,9,20,36,61,-25,30
Cowdenbeath,113,10,4,10,22,23,57,-34,22
Montrose,114,1,24,7,5,60,34,26,79
Peterhead,114,2,24,4,8,81,40,41,76
Stirling,114,3,17,6,13,63,51,12,57
Clyde,114,4,15,9,12,52,48,4,54
Stenhousem'r,114,5,15,8,13,55,49,6,53
Elgin,114,6,14,6,16,53,61,-8,48
Annan Athlet,114,7,11,11,14,47,42,5,44
Berwick,114,8,8,10,18,29,59,-30,34
Edinburgh Ci,114,9,7,9,20,38,64,-26,30
Cowdenbeath,114,10,5,10,21,24,54,-30,25
Montrose,115,1,24,7,5,61,35,26,79
Peterhead,115,2,24,4,8,78,38,40,76
Stenhousem'r,115,3,16,8,12,58,48,10,56
Stirling,115,4,16,6,14,62,54,8,54
Clyde,115,5,14,10,12,52,49,3,52
Elgin,115,6,14,6,16,54,62,-8,48
Annan Athlet,115,7,12,11,13,50,42,8,47
Berwick,115,8,8,11,17,30,59,-29,35
Edinburgh Ci,115,9,7,9,20,36,61,-25,30
Cowdenbeath,115,10,4,10,22,24,57,-33,22
Montrose,116,1,24,7,5,61,35,26,79
Peterhead,116,2,24,4,8,81,38,43,76
Stirling,116,3,17,6,13,62,51,11,57
Clyde,116,4,15,9,12,53,48,5,54
Stenhousem'r,116,5,15,8,13,55,48,7,53
Elgin,116,6,14,6,16,54,62,-8,48
Annan Athlet,116,7,11,11,14,47,42,5,44
Berwick,116,8,8,10,18,29,60,-31,34
Edinburgh Ci,116,9,7,9,20,36,64,-28,30
Cowdenbeath,116,10,5,10,21,24,54,-30,25
Montrose,117,1,23,8,5,60,35,25,77
Peterhead,117,2,23,5,8,77,38,39,74
Stenhousem'r,117,3,16,8,12,57,47,10,56
Stirling,117,4,16,6,14,61,53,8,54
Clyde,117,5,14,10,12,51,48,3,52
Elgin,117,6,14,7,15,54,61,-7,49
Annan Athlet,117,7,11,11,14,47,42,5,44
Berwick,117,8,8,11,17,29,58,-29,35
Edinburgh Ci,117,9,7,10,19,36,60,-24,31
Cowdenbeath,117,10,5,10,21,24,54,-30,25
Montrose,118,1,23,7,6,60,37,23,76
Peterhead,118,2,23,4,9,78,41,37,73
Stirling,118,3,17,6,13,63,52,11,57
Stenhousem'r,118,4,15,8,13,56,49,7,53
Clyde,118,5,14,10,12,52,49,3,52
Elgin,118,6,15,6,15,56,61,-5,51
Annan Athlet,118,7,11,12,13,49,43,6,45
Berwick,118,8,8,11,17,30,59,-29,35
Edinburgh Ci,118,9,8,9,19,39,61,-22,33
Cowdenbeath,118,10,4,11,21,25,56,-31,23
Montrose,119,1,23,8,5,60,35,25,77
Peterhead,119,2,23,5,8,79,40,39,74
Stirling,119,3,17,6,13,62,51,11,57
Stenhousem'r,119,4,15,8,13,55,48,7,53
Clyde,119,5,14,10,12,51,48,3,52
Elgin,119,6,14,7,15,54,61,-7,49
Annan Athlet,119,7,11,12,13,47,41,6,45
Berwick,119,8,8,11,17,29,58,-29,35
Edinburgh Ci,119,9,7,10,19,38,62,-24,31
Cowdenbeath,119,10,4,11,21,23,54,-31,23
Peterhead,120,1,24,4,8,81,40,41,76
Montrose,120,2,23,7,6,61,37,24,76
Stenhousem'r,120,3,16,8,12,57,47,10,56
Stirling,120,4,16,6,14,61,53,8,54
Clyde,120,5,14,9,13,52,50,2,51
Elgin,120,6,15,6,15,56,62,-6,51
Annan Athlet,120,7,12,11,13,48,41,7,47
Berwick,120,8,9,10,17,31,59,-28,37
Edinburgh Ci,120,9,7,9,20,38,64,-26,30
Cowdenbeath,120,10,4,10,22,23,55,-32,22
Montrose,121,1,23,7,6,59,35,24,76
Peterhead,121,2,23,4,9,77,40,37,73
Stenhousem'r,121,3,16,8,12,57,46,11,56
Stirling,121,4,16,6,14,60,53,7,54
Clyde,121,5,14,9,13,52,51,1,51
Elgin,121,6,15,6,15,54,60,-6,51
Annan Athlet,121,7,12,11,13,49,42,7,47
Berwick,121,8,9,10,17,32,59,-27,37
Edinburgh Ci,121,9,8,9,19,38,60,-22,33
Cowdenbeath,121,10,4,10,22,24,56,-32,22
Peterhead,122,1,24,4,8,79,38,41,76
Montrose,122,2,23,7,6,59,38,21,76
Stenhousem'r,122,3,16,8,12,58,46,12,56
Stirling,122,4,16,6,14,60,54,6,54
Clyde,122,5,14,9,13,51,51,0,51
Elgin,122,6,15,6,15,57,60,-3,51
Annan Athlet,122,7,11,11,14,48,43,5,44
Berwick,122,8,9,10,17,32,58,-26,37
Edinburgh Ci,122,9,7,9,20,36,62,-26,30
Cowdenbeath,122,10,5,10,21,25,55,-30,25
Montrose,123,1,24,7,5,61,35,26,79
Peterhead,123,2,24,4,8,81,39,42,76
Stirling,123,3,17,6,13,62,52,10,57
Clyde,123,4,15,9,12,54,49,5,54
Stenhousem'r,123,5,15,8,13,56,48,8,53
Elgin,123,6,14,6,16,54,62,-8,48
Annan Athlet,123,7,11,12,13,47,41,6,45
Berwick,123,8,8,10,18,30,61,-31,34
Edinburgh Ci,123,9,7,9,20,37,64,-27,30
Cowdenbeath,123,10,4,11,21,23,54,-31,23
Montrose,124,1,24,7,5,62,34,28,79
Peterhead,124,2,24,4,8,80,38,42,76
Stirling,124,3,17,6,13,61,51,10,57
Stenhousem'r,124,4,15,8,13,55,47,8,53
Clyde,124,5,14,10,12,51,48,3,52
Elgin,124,6,14,6,16,53,63,-10,48
Annan Athlet,124,7,11,11,14,47,43,4,44
Berwick,124,8,8,11,17,29,58,-29,35
Edinburgh Ci,124,9,7,9,20,36,63,-27,30
Cowdenbeath,124,10,5,10,21,25,54,-29,25
Montrose,125,1,23,8,5,61,36,25,77
Peterhead,125,2,24,4,8,80,39,41,76
Stirling,125,3,16,7,13,63,54,9,55
Stenhousem'r,125,4,15,9,12,58,49,9,54
Clyde,125,5,14,10,12,51,48,3,52
Elgin,125,6,14,7,15,55,62,-7,49
Annan Athlet,125,7,12,11,13,49,42,7,47
Berwick,125,8,8,11,17,29,58,-29,35
Edinburgh Ci,125,9,7,9,20,37,63,-26,30
Cowdenbeath,125,10,4,10,22,24,56,-32,22
Montrose,126,1,23,8,5,60,35,25,77
Peterhead,126,2,24,4,8,81,38,43,76
Stirling,126,3,16,7,13,61,52,9,55
Stenhousem'r,126,4,15,9,12,56,47,9,54
Clyde,126,5,15,9,12,53,49,4,54
Elgin,126,6,14,7,15,54,61,-7,49
Annan Athlet,126,7,11,12,13,48,42,6,45
Berwick,126,8,8,10,18,30,60,-30,34
Edinburgh Ci,126,9,7,9,20,36,64,-28,30
Cowdenbeath,126,10,4,11,21,24,55,-31,23
Peterhead,127,1,24,4,8,79,39,40,76
Montrose,127,2,23,7,6,60,36,24,76
Stenhousem'r,127,3,16,8,12,56,46,10,56
Stirling,127,4,16,6,14,60,52,8,54
Clyde,127,5,14,9,13,51,49,2,51
Elgin,127,6,15,6,15,55,61,-6,51
Annan Athlet,127,7,11,12,13,49,43,6,45
Berwick,127,8,9,10,17,30,58,-28,37
Edinburgh Ci,127,9,7,9,20,37,62,-25,30
Cowdenbeath,127,10,4,11,21,25,56,-31,23
Montrose,128,1,23,8,5,60,35,25,77
Peterhead,128,2,24,4,8,79,38,41,76
Stirling,128,3,17,6,13,62,51,11,57
Clyde,128,4,15,9,12,53,49,4,54
Stenhousem'r,128,5,15,8,13,55,48,7,53
Elgin,128,6,14,7,15,54,61,-7,49
Annan Athlet,128,7,11,12,13,48,42,6,45
Berwick,128,8,8,10,18,30,60,-30,34
Edinburgh Ci,128,9,7,9,20,36,62,-26,30
Cowdenbeath,128,10,4,11,21,24,55,-31,23
Montrose,129,1,24,7,5,61,34,27,79
Peterhead,129,2,24,4,8,81,39,42,76
Stenhousem'r,129,3,16,8,12,58,48,10,56
Stirling,129,4,16,6,14,62,54,8,54
Clyde,129,5,15,9,12,55,50,5,54
Elgin,129,6,14,6,16,53,62,-9,48
Annan Athlet,129,7,11,12,13,48,42,6,45
Berwick,129,8,8,10,18,31,62,-31,34
Edinburgh Ci,129,9,7,9,20,37,64,-27,30
Cowdenbeath,129,10,4,11,21,24,55,-31,23
Montrose,130,1,24,7,5,62,36,26,79
Peterhead,130,2,24,4,8,80,39,41,76
Stirling,130,3,17,6,13,61,51,10,57
Clyde,130,4,15,9,12,54,50,4,54
Stenhousem'r,130,5,15,8,13,55,47,8,53
Elgin,130,6,14,6,16,55,63,-8,48
Annan Athlet,130,7,11,12,13,48,42,6,45
Berwick,130,8,8,10,18,31,61,-30,34
Edinburgh Ci,130,9,7,9,20,37,63,-26,30
Cowdenbeath,130,10,4,11,21,24,55,-31,23
Peterhead,131,1,24,4,8,79,39,40,76
Montrose,131,2,23,7,6,59,36,23,76
Stirling,131,3,17,6,13,62,51,11,57
Stenhousem'r,131,4,15,8,13,55,48,7,53
Clyde,131,5,14,9,13,51,49,2,51
Elgin,131,6,15,6,15,55,60,-5,51
Annan Athlet,131,7,12,11,13,48,41,7,47
Berwick,131,8,9,10,17,30,58,-28,37
Edinburgh Ci,131,9,7,9,20,37,62,-25,30
Cowdenbeath,131,10,4,10,22,23,55,-32,22
Montrose,132,1,23,8,5,61,36,25,77
Peterhead,132,2,24,4,8,85,38,47,76
Stirling,132,3,16,7,13,60,51,9,55
Stenhousem'r,132,4,15,9,12,55,46,9,54
Clyde,132,5,14,10,12,52,49,3,52
Elgin,132,6,14,7,15,55,62,-7,49
Annan Athlet,132,7,12,11,13,48,41,7,47
Berwick,132,8,8,11,17,30,59,-29,35
Edinburgh Ci,132,9,7,9,20,36,68,-32,30
Cowdenbeath,132,10,4,10,22,23,55,-32,22
Montrose,133,1,24,7,5,60,34,26,79
Peterhead,133,2,23,5,8,78,39,39,74
Stenhousem'r,133,3,16,8,12,57,46,11,56
Stirling,133,4,16,6,14,60,53,7,54
Clyde,133,5,15,9,12,53,49,4,54
Elgin,133,6,14,6,16,53,61,-8,48
Annan Athlet,133,7,12,11,13,49,42,7,47
Berwick,133,8,8,10,18,30,60,-30,34
Edinburgh Ci,133,9,7,10,19,37,61,-24,31
Cowdenbeath,133,10,4,10,22,24,56,-32,22
Montrose,134,1,24,7,5,64,35,29,79
Peterhead,134,2,24,4,8,80,40,40,76
Stirling,134,3,17,6,13,64,53,11,57
Clyde,134,4,15,9,12,52,48,4,54
Stenhousem'r,134,5,15,8,13,57,50,7,53
Elgin,134,6,14,6,16,54,65,-11,48
Annan Athlet,134,7,11,11,14,47,42,5,44
Berwick,134,8,8,10,18,29,59,-30,34
Edinburgh Ci,134,9,7,9,20,38,63,-25,30
Cowdenbeath,134,10,5,10,21,24,54,-30,25
Montrose,135,1,24,7,5,61,34,27,79
Peterhead,135,2,24,4,8,80,38,42,76
Stirling,135,3,17,6,13,62,52,10,57
Clyde,135,4,15,9,12,55,49,6,54
Stenhousem'r,135,5,15,8,13,56,48,8,53
Elgin,135,6,14,6,16,53,62,-9,48
Annan Athlet,135,7,11,12,13,47,41,6,45
Berwick,135,8,8,10,18,30,62,-32,34
Edinburgh Ci,135,9,7,9,20,36,63,-27,30
Cowdenbeath,135,10,4,11,21,23,54,-31,23
Montrose,136,1,24,7,5,61,34,27,79
Peterhead,136,2,23,5,8,78,39,39,74
Stirling,136,3,17,6,13,64,51,13,57
Stenhousem'r,136,4,15,8,13,55,50,5,53
Clyde,136,5,14,9,13,52,50,2,51
Elgin,136,6,14,6,16,53,62,-9,48
Annan Athlet,136,7,11,12,13,48,42,6,45
Berwick,136,8,9,10,17,31,59,-28,37
Edinburgh Ci,136,9,7,10,19,37,61,-24,31
Cowdenbeath,136,10,4,11,21,24,55,-31,23
Montrose,137,1,23,7,6,62,38,24,76
Peterhead,137,2,23,5,8,79,40,39,74
Stirling,137,3,17,6,13,63,51,12,57
Clyde,137,4,15,9,12,56,48,8,54
Stenhousem'r,137,5,15,8,13,55,49,6,53
Elgin,137,6,15,6,15,57,63,-6,51
Annan Athlet,137,7,11,11,14,48,45,3,44
Berwick,137,8,8,10,18,29,63,-34,34
Edinburgh Ci,137,9,7,10,19,38,62,-24,31
Cowdenbeath,137,10,5,10,21,27,55,-28,25
Montrose,138,1,24,7,5,60,34,26,79
Peterhead,138,2,24,4,8,81,41,40,76
Stirling,138,3,17,6,13,64,52,12,57
Clyde,138,4,15,9,12,52,48,4,54
Stenhousem'r,138,5,15,8,13,56,50,6,53
Elgin,138,6,14,6,16,53,61,-8,48
Annan Athlet,138,7,11,11,14,48,43,5,44
Berwick,138,8,8,10,18,29,59,-30,34
Edinburgh Ci,138,9,7,9,20,39,64,-25,30
Cowdenbeath,138,10,5,10,21,25,55,-30,25
Montrose,139,1,24,7,5,62,36,26,79
Peterhead,139,2,24,4,8,79,39,40,76
Stirling,139,3,16,7,13,61,52,9,55
Stenhousem'r,139,4,15,9,12,56,47,9,54
Clyde,139,5,15,9,12,53,49,4,54
Elgin,139,6,14,6,16,55,63,-8,48
Annan Athlet,139,7,11,11,14,47,42,5,44
Berwick,139,8,8,10,18,30,60,-30,34
Edinburgh Ci,139,9,7,9,20,37,62,-25,30
Cowdenbeath,139,10,5,10,21,24,54,-30,25
Montrose,140,1,24,7,5,63,35,28,79
Peterhead,140,2,24,4,8,79,38,41,76
Stirling,140,3,17,6,13,62,51,11,57
Stenhousem'r,140,4,15,8,13,55,48,7,53
Clyde,140,5,14,10,12,51,48,3,52
Elgin,140,6,14,6,16,54,64,-10,48
Annan Athlet,140,7,11,12,13,48,42,6,45
Berwick,140,8,8,11,17,29,58,-29,35
Edinburgh Ci,140,9,7,9,20,36,62,-26,30
Cowdenbeath,140,10,4,11,21,24,55,-31,23
Montrose,141,1,24,7,5,63,35,28,79
Peterhead,141,2,24,4,8,80,38,42,76
Stenhousem'r,141,3,16,8,12,57,47,10,56
Stirling,141,4,16,6,14,61,53,8,54
Clyde,141,5,14,9,13,52,50,2,51
Elgin,141,6,14,6,16,54,64,-10,48
Annan Athlet,141,7,11,12,13,48,42,6,45
Berwick,141,8,9,10,17,31,59,-28,37
Edinburgh Ci,141,9,7,9,20,36,63,-27,30
Cowdenbeath,141,10,4,11,21,24,55,-31,23
Peterhead,142,1,24,4,8,80,38,42,76
Montrose,142,2,23,7,6,59,36,23,76
Stenhousem'r,142,3,16,8,12,58,47,11,56
Stirling,142,4,16,6,14,61,54,7,54
Clyde,142,5,15,9,12,53,49,4,54
Elgin,142,6,15,6,15,55,60,-5,51
Annan Athlet,142,7,12,11,13,48,41,7,47
Berwick,142,8,8,10,18,30,60,-30,34
Edinburgh Ci,142,9,7,9,20,36,63,-27,30
Cowdenbeath,142,10,4,10,22,23,55,-32,22
Montrose,143,1,23,8,5,60,35,25,77
Peterhead,143,2,24,4,8,80,39,41,76
Stirling,143,3,17,6,13,64,51,13,57
Clyde,143,4,15,9,12,55,48,7,54
Stenhousem'r,143,5,15,8,13,55,50,5,53
Elgin,143,6,14,7,15,54,61,-7,49
Annan Athlet,143,7,11,12,13,48,42,6,45
Berwick,143,8,8,10,18,29,62,-33,34
Edinburgh Ci,143,9,7,9,20,37,63,-26,30
Cowdenbeath,143,10,4,11,21,24,55,-31,23
Montrose,144,1,24,7,5,65,35,30,79
Peterhead,144,2,24,4,8,79,39,40,76
Stenhousem'r,144,3,16,8,12,58,48,10,56
Stirling,144,4,16,6,14,62,54,8,54
Clyde,144,5,15,9,12,54,48,6,54
Elgin,144,6,14,6,16,54,66,-12,48
Annan Athlet,144,7,11,12,13,47,41,6,45
Berwick,144,8,8,10,18,29,61,-32,34
Edinburgh Ci,144,9,7,9,20,37,62,-25,30
Cowdenbeath,144,10,4,11,21,23,54,-31,23
Montrose,145,1,24,7,5,61,35,26,79
Peterhead,145,2,24,4,8,80,39,41,76
Stirling,145,3,17,6,13,62,51,11,57
Clyde,145,4,15,9,12,54,48,6,54
Stenhousem'r,145,5,15,8,13,55,48,7,53
Elgin,145,6,14,6,16,54,62,-8,48
Annan Athlet,145,7,11,11,14,48,43,5,44
Berwick,145,8,8,10,18,29,61,-32,34
Edinburgh Ci,145,9,7,9,20,37,63,-26,30
Cowdenbeath,145,10,5,10,21,25,55,-30,25
Peterhead,146,1,24,4,8,81,39,42,76
Montrose,146,2,23,7,6,60,36,24,76
Stirling,146,3,17,6,13,63,52,11,57
Stenhousem'r,146,4,15,8,13,56,49,7,53
Clyde,146,5,14,9,13,52,50,2,51
Elgin,146,6,15,6,15,55,61,-6,51
Annan Athlet,146,7,11,12,13,47,41,6,45
Berwick,146,8,9,10,17,31,59,-28,37
Edinburgh Ci,146,9,7,9,20,37,64,-27,30
Cowdenbeath,146,10,4,11,21,23,54,-31,23
Montrose,147,1,24,7,5,63,35,28,79
Peterhead,147,2,23,5,8,79,40,39,74
Stirling,147,3,17,6,13,62,51,11,57
Clyde,147,4,15,9,12,53,49,4,54
Stenhousem'r,147,5,15,8,13,55,48,7,53
Elgin,147,6,14,6,16,54,64,-10,48
Annan Athlet,147,7,12,11,13,50,41,9,47
Berwick,147,8,8,10,18,30,60,-30,34
Edinburgh Ci,147,9,7,10,19,38,62,-24,31
Cowdenbeath,147,10,4,10,22,23,57,-34,22
Montrose,148,1,24,7,5,63,34,29,79
Peterhead,148,2,24,4,8,80,40,40,76
Stirling,148,3,17,6,13,62,51,11,57
Clyde,148,4,15,9,12,53,49,4,54
Stenhousem'r,148,5,15,8,13,55,48,7,53
Elgin,148,6,14,6,16,53,64,-11,48
Annan Athlet,148,7,11,12,13,48,42,6,45
Berwick,148,8,8,10,18,30,60,-30,34
Edinburgh Ci,148,9,7,9,20,38,63,-25,30
Cowdenbeath,148,10,4,11,21,24,55,-31,23
Montrose,149,1,24,7,5,61,34,27,79
Peterhead,149,2,24,4,8,83,38,45,76
Stirling,149,3,17,6,13,63,53,10,57
Clyde,149,4,15,9,12,53,48,5,54
Stenhousem'r,149,5,15,8,13,57,49,8,53
Elgin,149,6,14,6,16,53,62,-9,48
Annan Athlet,149,7,12,11,13,49,42,7,47
Berwick,149,8,8,10,18,29,60,-31,34
Edinburgh Ci,149,9,7,9,20,36,66,-30,30
Cowdenbeath,149,10,4,10,22,24,56,-32,22
Peterhead,150,1,24,4,8,79,38,41,76
Montrose,150,2,23,7,6,60,36,24,76
Stirling,150,3,16,7,13,60,51,9,55
Stenhousem'r,150,4,15,9,12,55,46,9,54
Clyde,150,5,15,9,12,55,50,5,54
Elgin,150,6,15,6,15,55,61,-6,51
Annan Athlet,150,7,12,11,13,50,43,7,47
Berwick,150,8,8,10,18,31,62,-31,34
Edinburgh Ci,150,9,7,9,20,36,62,-26,30
Cowdenbeath,150,10,4,10,22,25,57,-32,22
Montrose,151,1,24,7,5,61,34,27,79
Peterhead,151,2,23,4,9,78,41,37,73
Stenhousem'r,151,3,16,8,12,57,47,10,56
Stirling,151,4,16,6,14,61,53,8,54
Clyde,151,5,14,10,12,53,50,3,52
Elgin,151,6,14,6,16,53,62,-9,48
Annan Athlet,151,7,11,11,14,48,44,4,44
Berwick,151,8,8,11,17,31,60,-29,35
Edinburgh Ci,151,9,8,9,19,39,61,-22,33
Cowdenbeath,151,10,5,10,21,26,55,-29,25
Montrose,152,1,24,7,5,62,35,27,79
Peterhead,152,2,24,4,8,79,39,40,76
Stenhousem'r,152,3,16,8,12,56,46,10,56
Stirling,152,4,16,6,14,60,52,8,54
Clyde,152,5,15,9,12,53,48,5,54
Elgin,152,6,14,6,16,54,63,-9,48
Annan Athlet,152,7,11,12,13,48,42,6,45
Berwick,152,8,8,10,18,29,60,-31,34
Edinburgh Ci,152,9,7,9,20,37,62,-25,30
Cowdenbeath,152,10,4,11,21,24,55,-31,23
Montrose,153,1,23,8,5,59,34,25,77
Peterhead,153,2,24,4,8,79,38,41,76
Stenhousem'r,153,3,16,8,12,60,48,12,56
Stirling,153,4,16,6,14,62,56,6,54
Clyde,153,5,15,9,12,53,48,5,54
Elgin,153,6,14,7,15,53,60,-7,49
Annan Athlet,153,7,11,11,14,47,42,5,44
Berwick,153,8,8,10,18,29,60,-31,34
Edinburgh Ci,153,9,7,9,20,36,62,-26,30
Cowdenbeath,153,10,5,10,21,24,54,-30,25
Montrose,154,1,24,7,5,61,35,26,79
Peterhead,154,2,24,4,8,82,38,44,76
Stirling,154,3,16,7,13,61,52,9,55
Stenhousem'r,154,4,15,9,12,56,47,9,54
Clyde,154,5,14,10,12,52,49,3,52
Elgin,154,6,14,6,16,54,62,-8,48
Annan Athlet,154,7,12,11,13,48,41,7,47
Berwick,154,8,8,11,17,30,59,-29,35
Edinburgh Ci,154,9,7,9,20,36,65,-29,30
Cowdenbeath,154,10,4,10,22,23,55,-32,22
Montrose,155,1,23,8,5,61,36,25,77
Peterhead,155,2,23,4,9,80,43,37,73
Stirling,155,3,17,6,13,62,51,11,57
Clyde,155,4,15,9,12,55,48,7,54
Stenhousem'r,155,5,15,8,13,55,48,7,53
Elgin,155,6,14,7,15,55,62,-7,49
Annan Athlet,155,7,12,11,13,49,41,8,47
Berwick,155,8,8,10,18,29,62,-33,34
Edinburgh Ci,155,9,8,9,19,41,63,-22,33
Cowdenbeath,155,10,4,10,22,23,56,-33,22
Montrose,156,1,24,7,5,60,34,26,79
Peterhead,156,2,24,4,8,82,38,44,76
Stenhousem'r,156,3,16,8,12,56,46,10,56
Stirling,156,4,16,6,14,60,52,8,54
Clyde,156,5,15,9,12,53,48,5,54
Elgin,156,6,14,6,16,53,61,-8,48
Annan Athlet,156,7,12,11,13,48,41,7,47
Berwick,156,8,8,10,18,29,60,-31,34
Edinburgh Ci,156,9,7,9,20,36,65,-29,30
Cowdenbeath,156,10,4,10,22,23,55,-32,22
Montrose,157,1,24,7,5,60,34,26,79
Peterhead,157,2,24,4,8,82,38,44,76
Stenhousem'r,157,3,16,8,12,59,48,11,56
Stirling,157,4,16,6,14,62,55,7,54
Clyde,157,5,14,9,13,53,52,1,51
Elgin,157,6,14,6,16,53,61,-8,48
Annan Athlet,157,7,11,11,14,49,45,4,44
Berwick,157,8,9,10,17,33,60,-27,37
Edinburgh Ci,157,9,7,9,20,36,65,-29,30
Cowdenbeath,157,10,5,10,21,27,56,-29,25
Montrose,158,1,23,8,5,60,35,25,77
Peterhead,158,2,24,4,8,78,38,40,76
Stenhousem'r,158,3,16,8,12,57,47,10,56
Stirling,158,4,16,6,14,61,53,8,54
Clyde,158,5,14,10,12,53,50,3,52
Elgin,158,6,14,7,15,54,61,-7,49
Annan Athlet,158,7,12,11,13,48,41,7,47
Berwick,158,8,8,11,17,31,60,-29,35
Edinburgh Ci,158,9,7,9,20,36,61,-25,30
Cowdenbeath,158,10,4,10,22,23,55,-32,22
Montrose,159,1,23,8,5,60,35,25,77
Peterhead,159,2,24,4,8,79,39,40,76
Stirling,159,3,16,7,13,62,53,9,55
Stenhousem'r,159,4,15,9,12,57,48,9,54
Clyde,159,5,15,9,12,53,49,4,54
Elgin,159,6,14,7,15,54,61,-7,49
Annan Athlet,159,7,11,12,13,48,42,6,45
Berwick,159,8,8,10,18,30,60,-30,34
Edinburgh Ci,159,9,7,9,20,37,62,-25,30
Cowdenbeath,159,10,4,11,21,24,55,-31,23
Montrose,160,1,24,7,5,60,34,26,79
Peterhead,160,2,24,4,8,81,39,42,76
Stirling,160,3,16,7,13,61,52,9,55
Stenhousem'r,160,4,15,9,12,56,47,9,54
Clyde,160,5,14,10,12,53,50,3,52
Elgin,160,6,14,6,16,53,61,-8,48
Annan Athlet,160,7,11,11,14,47,43,4,44
Berwick,160,8,8,11,17,31,60,-29,35
Edinburgh Ci,160,9,7,9,20,37,64,-27,30
Cowdenbeath,160,10,5,10,21,25,54,-29,25
Montrose,161,1,23,8,5,60,35,25,77
Peterhead,161,2,24,4,8,79,39,40,76
Stenhousem'r,161,3,16,8,12,59,48,11,56
Stirling,161,4,16,6,14,62,55,7,54
Clyde,161,5,14,10,12,52,49,3,52
Elgin,161,6,14,7,15,54,61,-7,49
Annan Athlet,161,7,12,11,13,50,41,9,47
Berwick,161,8,8,11,17,30,59,-29,35
Edinburgh Ci,161,9,7,9,20,37,62,-25,30
Cowdenbeath,161,10,4,10,22,23,57,-34,22
Peterhead,162,1,24,4,8,79,38,41,76
Montrose,162,2,23,7,6,61,38,23,76
Stirling,162,3,16,7,13,63,54,9,55
Stenhousem'r,162,4,15,9,12,58,49,9,54
Clyde,162,5,15,9,12,54,50,4,54
Elgin,162,6,15,6,15,57,62,-5,51
Annan Athlet,162,7,11,11,14,49,44,5,44
Berwick,162,8,8,10,18,31,61,-30,34
Edinburgh Ci,162,9,7,9,20,36,62,-26,30
Cowdenbeath,162,10,5,10,21,26,56,-30,25
Montrose,163,1,24,7,5,60,34,26,79
Peterhead,163,2,24,4,8,82,38,44,76
Stirling,163,3,17,6,13,61,51,10,57
Stenhousem'r,163,4,15,8,13,55,47,8,53
Clyde,163,5,14,10,12,52,49,3,52
Elgin,163,6,14,6,16,53,61,-8,48
Annan Athlet,163,7,11,12,13,47,41,6,45
Berwick,163,8,8,11,17,30,59,-29,35
Edinburgh Ci,163,9,7,9,20,36,65,-29,30
Cowdenbeath,163,10,4,11,21,23,54,-31,23
Montrose,164,1,24,7,5,62,36,26,79
Peterhead,164,2,24,4,8,81,38,43,76
Stirling,164,3,17,6,13,63,52,11,57
Clyde,164,4,15,9,12,54,48,6,54
Stenhousem'r,164,5,15,8,13,56,49,7,53
Elgin,164,6,14,6,16,55,63,-8,48
Annan Athlet,164,7,12,11,13,49,42,7,47
Berwick,164,8,8,10,18,29,61,-32,34
Edinburgh Ci,164,9,7,9,20,36,64,-28,30
Cowdenbeath,164,10,4,10,22,24,56,-32,22
Montrose,165,1,24,7,5,62,35,27,79
Peterhead,165,2,24,4,8,82,39,43,76
Stirling,165,3,17,6,13,65,52,13,57
Clyde,165,4,15,9,12,54,49,5,54
Stenhousem'r,165,5,15,8,13,56,51,5,53
Elgin,165,6,14,6,16,54,63,-9,48
Annan Athlet,165,7,12,11,13,48,41,7,47
Berwick,165,8,8,10,18,30,61,-31,34
Edinburgh Ci,165,9,7,9,20,37,65,-28,30
Cowdenbeath,165,10,4,10,22,23,55,-32,22
Montrose,166,1,24,7,5,61,34,27,79
Peterhead,166,2,24,4,8,79,38,41,76
Stenhousem'r,166,3,16,8,12,58,48,10,56
Stirling,166,4,16,6,14,62,54,8,54
Clyde,166,5,14,10,12,51,48,3,52
Elgin,166,6,14,6,16,53,62,-9,48
Annan Athlet,166,7,11,11,14,47,42,5,44
Berwick,166,8,8,11,17,29,58,-29,35
Edinburgh Ci,166,9,7,9,20,36,62,-26,30
Cowdenbeath,166,10,5,10,21,24,54,-30,25
Montrose,167,1,24,7,5,63,35,28,79
Peterhead,167,2,24,4,8,79,39,40,76
Stirling,167,3,17,6,13,62,51,11,57
Clyde,167,4,15,9,12,53,48,5,54
Stenhousem'r,167,5,15,8,13,55,48,7,53
Elgin,167,6,14,6,16,54,64,-10,48
Annan Athlet,167,7,12,11,13,48,41,7,47
Berwick,167,8,8,10,18,29,60,-31,34
Edinburgh Ci,167,9,7,9,20,37,62,-25,30
Cowdenbeath,167,10,4,10,22,23,55,-32,22
Peterhead,168,1,24,4,8,81,38,43,76
Montrose,168,2,23,7,6,61,37,24,76
Stirling,168,3,17,6,13,62,52,10,57
Stenhousem'r,168,4,15,8,13,56,48,8,53
Clyde,168,5,14,9,13,52,50,2,51
Elgin,168,6,15,6,15,56,62,-6,51
Annan Athlet,168,7,11,12,13,49,43,6,45
Berwick,168,8,9,10,17,31,59,-28,37
Edinburgh Ci,168,9,7,9,20,36,64,-28,30
Cowdenbeath,168,10,4,11,21,25,56,-31,23
Montrose,169,1,24,7,5,61,35,26,79
Peterhead,169,2,24,4,8,80,38,42,76
Stirling,169,3,17,6,13,63,52,11,57
Clyde,169,4,15,9,12,56,49,7,54
Stenhousem'r,169,5,15,8,13,56,49,7,53
Elgin,169,6,14,6,16,54,62,-8,48
Annan Athlet,169,7,12,11,13,48,41,7,47
Berwick,169,8,8,10,18,30,63,-33,34
Edinburgh Ci,169,9,7,9,20,36,63,-27,30
Cowdenbeath,169,10,4,10,22,23,55,-32,22
Peterhead,170,1,24,4,8,80,38,42,76
Montrose,170,2,23,7,6,59,36,23,76
Stirling,170,3,17,6,13,62,52,10,57
Clyde,170,4,15,9,12,54,49,5,54
Stenhousem'r,170,5,15,8,13,56,48,8,53
Elgin,170,6,15,6,15,55,60,-5,51
Annan Athlet,170,7,11,11,14,47,42,5,44
Berwick,170,8,8,10,18,30,61,-31,34
Edinburgh Ci,170,9,7,9,20,36,63,-27,30
Cowdenbeath,170,10,5,10,21,24,54,-30,25
Montrose,171,1,23,8,5,59,34,25,77
Peterhead,171,2,24,4,8,79,39,40,76
Stirling,171,3,16,7,13,60,51,9,55
Stenhousem'r,171,4,15,9,12,55,46,9,54
Clyde,171,5,14,10,12,51,48,3,52
Elgin,171,6,14,7,15,53,60,-7,49
Annan Athlet,171,7,12,11,13,48,41,7,47
Berwick,171,8,8,11,17,29,58,-29,35
Edinburgh Ci,171,9,7,9,20,37,62,-25,30
Cowdenbeath,171,10,4,10,22,23,55,-32,22
Montrose,172,1,24,7,5,61,34,27,79
Peterhead,172,2,24,4,8,82,38,44,76
Stirling,172,3,17,6,13,62,52,10,57
Stenhousem'r,172,4,15,8,13,56,48,8,53
Clyde,172,5,14,10,12,51,48,3,52
Elgin,172,6,14,6,16,53,62,-9,48
Annan Athlet,172,7,12,11,13,48,41,7,47
Berwick,172,8,8,11,17,29,58,-29,35
Edinburgh Ci,172,9,7,9,20,36,65,-29,30
Cowdenbeath,172,10,4,10,22,23,55,-32,22
Montrose,173,1,24,7,5,61,34,27,79
Peterhead,173,2,24,4,8,81,38,43,76
Stirling,173,3,16,7,13,61,52,9,55
Stenhousem'r,173,4,15,9,12,56,47,9,54
Clyde,173,5,15,9,12,54,50,4,54
Elgin,173,6,14,6,16,53,62,-9,48
Annan Athlet,173,7,12,11,13,48,41,7,47
Berwick,173,8,8,10,18,31,61,-30,34
Edinburgh Ci,173,9,7,9,20,36,64,-28,30
Cowdenbeath,173,10,4,10,22,23,55,-32,22
Peterhead,174,1,24,4,8,81,39,42,76
Montrose,174,2,23,7,6,60,36,24,76
Stirling,174,3,17,6,13,62,52,10,57
Clyde,174,4,15,9,12,53,48,5,54
Stenhousem'r,174,5,15,8,13,56,48,8,53
Elgin,174,6,15,6,15,55,61,-6,51
Annan Athlet,174,7,12,11,13,49,42,7,47
Berwick,174,8,8,10,18,29,60,-31,34
Edinburgh Ci,174,9,7,9,20,37,64,-27,30
Cowdenbeath,174,10,4,10,22,24,56,-32,22
Peterhead,175,1,24,4,8,80,39,41,76
Montrose,175,2,23,7,6,60,36,24,76
Stirling,175,3,17,6,13,62,51,11,57
Clyde,175,4,15,9,12,55,49,6,54
Stenhousem'r,175,5,15,8,13,55,48,7,53
Elgin,175,6,15,6,15,55,61,-6,51
Annan Athlet,175,7,11,11,14,47,43,4,44
Berwick,175,8,8,10,18,30,62,-32,34
Edinburgh Ci,175,9,7,9,20,37,63,-26,30
Cowdenbeath,175,10,5,10,21,25,54,-29,25
Montrose,176,1,23,7,6,60,36,24,76
Peterhead,176,2,23,5,8,79,40,39,74
Stirling,176,3,17,6,13,62,51,11,57
Stenhousem'r,176,4,15,8,13,55,48,7,53
Clyde,176,5,14,10,12,53,50,3,52
Elgin,176,6,15,6,15,55,61,-6,51
Annan Athlet,176,7,12,11,13,49,42,7,47
Berwick,176,8,8,11,17,31,60,-29,35
Edinburgh Ci,176,9,7,10,19,38,62,-24,31
Cowdenbeath,176,10,4,10,22,24,56,-32,22
Montrose,177,1,24,7,5,61,34,27,79
Peterhead,177,2,24,4,8,83,39,44,76
Stirling,177,3,17,6,13,61,51,10,57
Stenhousem'r,177,4,15,8,13,55,47,8,53
Clyde,177,5,14,10,12,52,49,3,52
Elgin,177,6,14,6,16,53,62,-9,48
Annan Athlet,177,7,11,12,13,48,42,6,45
Berwick,177,8,8,11,17,30,59,-29,35
Edinburgh Ci,177,9,7,9,20,37,66,-29,30
Cowdenbeath,177,10,4,11,21,24,55,-31,23
Montrose,178,1,24,7,5,64,34,30,79
Peterhead,178,2,24,4,8,82,39,43,76
Stenhousem'r,178,3,16,8,12,59,49,10,56
Stirling,178,4,16,6,14,63,55,8,54
Clyde,178,5,15,9,12,53,49,4,54
Elgin,178,6,14,6,16,53,65,-12,48
Annan Athlet,178,7,11,12,13,47,41,6,45
Berwick,178,8,8,10,18,30,60,-30,34
Edinburgh Ci,178,9,7,9,20,37,65,-28,30
Cowdenbeath,178,10,4,11,21,23,54,-31,23
Montrose,179,1,24,7,5,60,34,26,79
Peterhead,179,2,24,4,8,80,39,41,76
Stenhousem'r,179,3,16,8,12,60,48,12,56
Stirling,179,4,16,6,14,62,56,6,54
Clyde,179,5,14,9,13,52,52,0,51
Elgin,179,6,14,6,16,53,61,-8,48
Annan Athlet,179,7,12,11,13,51,43,8,47
Berwick,179,8,9,10,17,33,59,-26,37
Edinburgh Ci,179,9,7,9,20,37,63,-26,30
Cowdenbeath,179,10,4,10,22,25,58,-33,22
Montrose,180,1,24,7,5,60,34,26,79
Peterhead,180,2,23,4,9,78,40,38,73
Stenhousem'r,180,3,16,8,12,57,47,10,56
Stirling,180,4,16,6,14,61,53,8,54
Clyde,180,5,15,9,12,55,50,5,54
Elgin,180,6,14,6,16,53,61,-8,48
Annan Athlet,180,7,11,12,13,49,43,6,45
Berwick,180,8,8,10,18,31,62,-31,34
Edinburgh Ci,180,9,8,9,19,38,61,-23,33
Cowdenbeath,180,10,4,11,21,25,56,-31,23
Montrose,181,1,23,8,5,61,36,25,77
Peterhead,181,2,24,4,8,80,40,40,76
Stirling,181,3,16,7,13,61,52,9,55
Stenhousem'r,181,4,15,9,12,56,47,9,54
Clyde,181,5,14,9,13,53,51,2,51
Elgin,181,6,14,7,15,55,62,-7,49
Annan Athlet,181,7,11,12,13,47,41,6,45
Berwick,181,8,9,10,17,32,60,-28,37
Edinburgh Ci,181,9,7,9,20,38,63,-25,30
Cowdenbeath,181,10,4,11,21,23,54,-31,23
Montrose,182,1,24,7,5,61,35,26,79
Peterhead,182,2,24,4,8,78,38,40,76
Stenhousem'r,182,3,16,8,12,57,46,11,56
Stirling,182,4,16,6,14,60,53,7,54
Clyde,182,5,14,9,13,52,50,2,51
Elgin,182,6,14,6,16,54,62,-8,48
Annan Athlet,182,7,11,12,13,48,42,6,45
Berwick,182,8,9,10,17,31,59,-28,37
Edinburgh Ci,182,9,7,9,20,36,61,-25,30
Cowdenbeath,182,10,4,11,21,24,55,-31,23
Montrose,183,1,24,7,5,61,34,27,79
Peterhead,183,2,24,4,8,82,38,44,76
Stirling,183,3,17,6,13,63,53,10,57
Clyde,183,4,15,9,12,53,48,5,54
Stenhousem'r,183,5,15,8,13,57,49,8,53
Elgin,183,6,14,6,16,53,62,-9,48
Annan Athlet,183,7,11,12,13,48,42,6,45
Berwick,183,8,8,10,18,29,60,-31,34
Edinburgh Ci,183,9,7,9,20,36,65,-29,30
Cowdenbeath,183,10,4,11,21,24,55,-31,23
Montrose,184,1,24,7,5,61,35,26,79
Peterhead,184,2,23,4,9,78,40,38,73
Stirling,184,3,17,6,13,63,51,12,57
Clyde,184,4,15,9,12,55,49,6,54
Stenhousem'r,184,5,15,8,13,55,49,6,53
Elgin,184,6,14,6,16,54,62,-8,48
Annan Athlet,184,7,12,11,13,50,42,8,47
Berwick,184,8,8,10,18,30,62,-32,34
Edinburgh Ci,184,9,8,9,19,38,61,-23,33
Cowdenbeath,184,10,4,10,22,24,57,-33,22
Montrose,185,1,24,7,5,64,36,28,79
Peterhead,185,2,24,4,8,81,39,42,76
Stenhousem'r,185,3,16,8,12,56,46,10,56
Stirling,185,4,16,6,14,60,52,8,54
Clyde,185,5,15,9,12,52,48,4,54
Elgin,185,6,14,6,16,55,65,-10,48
Annan Athlet,185,7,11,11,14,48,44,4,44
Berwick,185,8,8,10,18,29,59,-30,34
Edinburgh Ci,185,9,7,9,20,37,64,-27,30
Cowdenbeath,185,10,5,10,21,26,55,-29,25
Peterhead,186,1,24,4,8,86,39,47,76
Montrose,186,2,23,7,6,59,35,24,76
Stirling,186,3,16,7,13,62,53,9,55
Stenhousem'r,186,4,15,9,12,57,48,9,54
Clyde,186,5,15,9,12,53,48,5,54
Elgin,186,6,15,6,15,54,60,-6,51
Annan Athlet,186,7,11,11,14,47,44,3,44
Berwick,186,8,8,10,18,29,60,-31,34
Edinburgh Ci,186,9,7,9,20,37,69,-32,30
Cowdenbeath,186,10,5,10,21,26,54,-28,25
Montrose,187,1,24,7,5,61,34,27,79
Peterhead,187,2,24,4,8,78,38,40,76
Stirling,187,3,17,6,13,62,51,11,57
Stenhousem'r,187,4,15,8,13,55,48,7,53
Clyde,187,5,14,10,12,51,48,3,52
Elgin,187,6,14,6,16,53,62,-9,48
Annan Athlet,187,7,11,12,13,47,41,6,45
Berwick,187,8,8,11,17,29,58,-29,35
Edinburgh Ci,187,9,7,9,20,36,61,-25,30
Cowdenbeath,187,10,4,11,21,23,54,-31,23
Peterhead,188,1,24,4,8,80,38,42,76
Montrose,188,2,23,7,6,60,36,24,76
Stirling,188,3,17,6,13,64,53,11,57
Stenhousem'r,188,4,15,8,13,57,50,7,53
Clyde,188,5,14,10,12,53,50,3,52
Elgin,188,6,15,6,15,55,61,-6,51
Annan Athlet,188,7,11,12,13,50,44,6,45
Berwick,188,8,8,11,17,31,60,-29,35
Edinburgh Ci,188,9,7,9,20,36,63,-27,30
Cowdenbeath,188,10,4,11,21,26,57,-31,23
Peterhead,189,1,24,4,8,79,38,41,76
Montrose,189,2,23,7,6,60,36,24,76
Stenhousem'r,189,3,16,8,12,56,46,10,56
Stirling,189,4,16,6,14,60,52,8,54
Clyde,189,5,14,10,12,52,49,3,52
Elgin,189,6,15,6,15,55,61,-6,51
Annan Athlet,189,7,11,12,13,48,42,6,45
Berwick,189,8,8,11,17,30,59,-29,35
Edinburgh Ci,189,9,7,9,20,36,62,-26,30
Cowdenbeath,189,10,4,11,21,24,55,-31,23
Montrose,190,1,23,8,5,62,37,25,77
Peterhead,190,2,24,4,8,82,38,44,76
Stenhousem'r,190,3,16,8,12,58,47,11,56
Stirling,190,4,16,6,14,61,54,7,54
Clyde,190,5,14,9,13,52,50,2,51
Elgin,190,6,14,7,15,56,63,-7,49
Annan Athlet,190,7,11,12,13,47,41,6,45
Berwick,190,8,9,10,17,31,59,-28,37
Edinburgh Ci,190,9,7,9,20,36,65,-29,30
Cowdenbeath,190,10,4,11,21,23,54,-31,23
Peterhead,191,1,24,4,8,80,38,42,76
Montrose,191,2,23,7,6,60,36,24,76
Stirling,191,3,17,6,13,62,52,10,57
Stenhousem'r,191,4,15,8,13,56,48,8,53
Clyde,191,5,14,10,12,52,49,3,52
Elgin,191,6,15,6,15,55,61,-6,51
Annan Athlet,191,7,11,12,13,47,41,6,45
Berwick,191,8,8,11,17,30,59,-29,35
Edinburgh Ci,191,9,7,9,20,36,63,-27,30
Cowdenbeath,191,10,4,11,21,23,54,-31,23
Peterhead,192,1,24,4,8,80,38,42,76
Montrose,192,2,23,7,6,60,36,24,76
Stenhousem'r,192,3,16,8,12,57,46,11,56
Stirling,192,4,16,6,14,60,53,7,54
Clyde,192,5,15,9,12,54,48,6,54
Elgin,192,6,15,6,15,55,61,-6,51
Annan Athlet,192,7,12,11,13,48,41,7,47
Berwick,192,8,8,10,18,29,61,-32,34
Edinburgh Ci,192,9,7,9,20,36,63,-27,30
Cowdenbeath,192,10,4,10,22,23,55,-32,22
Peterhead,193,1,24,4,8,80,39,41,76
Montrose,193,2,23,7,6,60,37,23,76
Stirling,193,3,17,6,13,62,52,10,57
Stenhousem'r,193,4,15,8,13,56,48,8,53
Clyde,193,5,14,10,12,51,48,3,52
Elgin,193,6,15,6,15,56,61,-5,51
Annan Athlet,193,7,12,11,13,49,41,8,47
Berwick,193,8,8,11,17,29,58,-29,35
Edinburgh Ci,193,9,7,9,20,37,63,-26,30
Cowdenbeath,193,10,4,10,22,23,56,-33,22
Montrose,194,1,24,7,5,61,35,26,79
Peterhead,194,2,23,5,8,78,39,39,74
Stenhousem'r,194,3,16,8,12,60,48,12,56
Stirling,194,4,16,6,14,62,56,6,54
Clyde,194,5,15,9,12,52,48,4,54
Elgin,194,6,14,6,16,54,62,-8,48
Annan Athlet,194,7,11,12,13,47,41,6,45
Berwick,194,8,8,10,18,29,59,-30,34
Edinburgh Ci,194,9,7,10,19,37,61,-24,31
Cowdenbeath,194,10,4,11,21,23,54,-31,23
Montrose,195,1,24,7,5,60,34,26,79
Peterhead,195,2,24,4,8,79,39,40,76
Stenhousem'r,195,3,16,8,12,57,46,11,56
Stirling,195,4,16,6,14,60,53,7,54
Clyde,195,5,15,9,12,53,49,4,54
Elgin,195,6,14,6,16,53,61,-8,48
Annan Athlet,195,7,11,12,13,48,42,6,45
Berwick,195,8,8,10,18,30,60,-30,34
Edinburgh Ci,195,9,7,9,20,37,62,-25,30
Cowdenbeath,195,10,4,11,21,24,55,-31,23
Peterhead,196,1,24,4,8,79,38,41,76
Montrose,196,2,23,7,6,60,36,24,76
Stirling,196,3,17,6,13,62,52,10,57
Clyde,196,4,15,9,12,52,48,4,54
Stenhousem'r,196,5,15,8,13,56,48,8,53
Elgin,196,6,15,6,15,55,61,-6,51
Annan Athlet,196,7,11,11,14,47,42,5,44
Berwick,196,8,8,10,18,29,59,-30,34
Edinburgh Ci,196,9,7,9,20,36,62,-26,30
Cowdenbeath,196,10,5,10,21,24,54,-30,25
Montrose,197,1,24,7,5,60,34,26,79
Peterhead,197,2,23,5,8,79,40,39,74
Stenhousem'r,197,3,16,8,12,56,46,10,56
Stirling,197,4,16,6,14,60,52,8,54
Clyde,197,5,15,9,12,53,48,5,54
Elgin,197,6,14,6,16,53,61,-8,48
Annan Athlet,197,7,12,11,13,49,41,8,47
Berwick,197,8,8,10,18,29,60,-31,34
Edinburgh Ci,197,9,7,10,19,38,62,-24,31
Cowdenbeath,197,10,4,10,22,23,56,-33,22
Montrose,198,1,24,7,5,61,35,26,79
Peterhead,198,2,23,4,9,78,43,35,73
Stirling,198,3,17,6,13,63,51,12,57
Clyde,198,4,15,9,12,54,48,6,54
Stenhousem'r,198,5,15,8,13,55,49,6,53
Elgin,198,6,14,6,16,54,62,-8,48
Annan Athlet,198,7,11,11,14,48,43,5,44
Berwick,198,8,8,10,18,29,61,-32,34
Edinburgh Ci,198,9,8,9,19,41,61,-20,33
Cowdenbeath,198,10,5,10,21,25,55,-30,25
Montrose,199,1,24,7,5,61,35,26,79
Peterhead,199,2,24,4,8,82,39,43,76
Stirling,199,3,16,7,13,62,53,9,55
Stenhousem'r,199,4,15,9,12,57,48,9,54
Clyde,199,5,15,9,12,55,49,6,54
Elgin,199,6,14,6,16,54,62,-8,48
Annan Athlet,199,7,11,12,13,48,42,6,45
Berwick,199,8,8,10,18,30,62,-32,34
Edinburgh Ci,199,9,7,9,20,37,65,-28,30
Cowdenbeath,199,10,4,11,21,24,55,-31,23
Montrose,200,1,24,7,5,61,34,27,79
Peterhead,200,2,24,4,8,82,41,41,76
Stenhousem'r,200,3,16,8,12,59,48,11,56
Stirling,200,4,16,6,14,62,55,7,54
Clyde,200,5,14,10,12,52,49,3,52
Elgin,200,6,14,6,16,53,62,-9,48
Annan Athlet,200,7,11,11,14,47,43,4,44
Berwick,200,8,8,11,17,30,59,-29,35
Edinburgh Ci,200,9,7,9,20,39,65,-26,30
Cowdenbeath,200,10,5,10,21,25,54,-29,25
Montrose,201,1,24,7,5,61,34,27,79
Peterhead,201,2,24,4,8,78,38,40,76
Stirling,201,3,16,7,13,60,51,9,55
Stenhousem'r,201,4,15,9,12,55,46,9,54
Clyde,201,5,14,9,13,52,50,2,51
Elgin,201,6,14,6,16,53,62,-9,48
Annan Athlet,201,7,12,11,13,49,42,7,47
Berwick,201,8,9,10,17,31,59,-28,37
Edinburgh Ci,201,9,7,9,20,36,61,-25,30
Cowdenbeath,201,10,4,10,22,24,56,-32,22
Peterhead,202,1,24,4,8,80,39,41,76
Montrose,202,2,23,7,6,59,35,24,76
Stirling,202,3,17,6,13,62,51,11,57
Clyde,202,4,15,9,12,52,48,4,54
Stenhousem'r,202,5,15,8,13,55,48,7,53
Elgin,202,6,15,6,15,54,60,-6,51
Annan Athlet,202,7,11,12,13,48,42,6,45
Berwick,202,8,8,10,18,29,59,-30,34
Edinburgh Ci,202,9,7,9,20,37,63,-26,30
Cowdenbeath,202,10,4,11,21,24,55,-31,23
Montrose,203,1,24,7,5,62,35,27,79
Peterhead,203,2,24,4,8,80,38,42,76
Stirling,203,3,17,6,13,61,51,10,57
Clyde,203,4,15,9,12,52,48,4,54
Stenhousem'r,203,5,15,8,13,55,47,8,53
Elgin,203,6,14,6,16,54,63,-9,48
Annan Athlet,203,7,11,11,14,47,44,3,44
Berwick,203,8,8,10,18,29,59,-30,34
Edinburgh Ci,203,9,7,9,20,36,63,-27,30
Cowdenbeath,203,10,5,10,21,26,54,-28,25
Montrose,204,1,24,7,5,60,34,26,79
Peterhead,204,2,24,4,8,80,39,41,76
Stirling,204,3,16,7,13,62,53,9,55
Stenhousem'r,204,4,15,9,12,57,48,9,54
Clyde,204,5,14,9,13,52,51,1,51
Elgin,204,6,14,6,16,53,61,-8,48
Annan Athlet,204,7,11,12,13,49,43,6,45
Berwick,204,8,9,10,17,32,59,-27,37
Edinburgh Ci,204,9,7,9,20,37,63,-26,30
Cowdenbeath,204,10,4,11,21,25,56,-31,23
Peterhead,205,1,24,4,8,81,38,43,76
Montrose,205,2,23,7,6,60,36,24,76
Stirling,205,3,17,6,13,64,52,12,57
Clyde,205,4,15,9,12,56,49,7,54
Stenhousem'r,205,5,15,8,13,56,50,6,53
Elgin,205,6,15,6,15,55,61,-6,51
Annan Athlet,205,7,11,12,13,48,42,6,45
Berwick,205,8,8,10,18,30,63,-33,34
Edinburgh Ci,205,9,7,9,20,36,64,-28,30
Cowdenbeath,205,10,4,11,21,24,55,-31,23
Montrose,206,1,24,7,5,62,36,26,79
Peterhead,206,2,24,4,8,79,39,40,76
Stenhousem'r,206,3,16,8,12,56,46,10,56
Stirling,206,4,16,6,14,60,52,8,54
Clyde,206,5,15,9,12,54,48,6,54
Elgin,206,6,14,6,16,55,63,-8,48
Annan Athlet,206,7,11,12,13,47,41,6,45
Berwick,206,8,8,10,18,29,61,-32,34
Edinburgh Ci,206,9,7,9,20,37,62,-25,30
Cowdenbeath,206,10,4,11,21,23,54,-31,23
Montrose,207,1,24,7,5,61,35,26,79
Peterhead,207,2,24,4,8,80,38,42,76
Stirling,207,3,16,7,13,63,54,9,55
Stenhousem'r,207,4,15,9,12,58,49,9,54
Clyde,207,5,14,10,12,52,49,3,52
Elgin,207,6,14,6,16,54,62,-8,48
Annan Athlet,207,7,12,11,13,49,41,8,47
Berwick,207,8,8,11,17,30,59,-29,35
Edinburgh Ci,207,9,7,9,20,36,63,-27,30
Cowdenbeath,207,10,4,10,22,23,56,-33,22
Montrose,208,1,24,7,5,62,36,26,79
Peterhead,208,2,24,4,8,80,38,42,76
Stirling,208,3,17,6,13,64,51,13,57
Clyde,208,4,15,9,12,55,48,7,54
Stenhousem'r,208,5,15,8,13,55,50,5,53
Elgin,208,6,14,6,16,55,63,-8,48
Annan Athlet,208,7,12,11,13,48,41,7,47
Berwick,208,8,8,10,18,29,62,-33,34
Edinburgh Ci,208,9,7,9,20,36,63,-27,30
Cowdenbeath,208,10,4,10,22,23,55,-32,22
Montrose,209,1,24,7,5,63,35,28,79
Peterhead,209,2,24,4,8,83,38,45,76
Stirling,209,3,16,7,13,60,51,9,55
Stenhousem'r,209,4,15,9,12,55,46,9,54
Clyde,209,5,15,9,12,54,48,6,54
Elgin,209,6,14,6,16,54,64,-10,48
Annan Athlet,209,7,12,11,13,50,41,9,47
Berwick,209,8,8,10,18,29,61,-32,34
Edinburgh Ci,209,9,7,9,20,36,66,-30,30
Cowdenbeath,209,10,4,10,22,23,57,-34,22
Peterhead,210,1,24,4,8,81,40,41,76
Montrose,210,2,23,7,6,60,37,23,76
Stirling,210,3,16,7,13,62,53,9,55
Stenhousem'r,210,4,15,9,12,57,48,9,54
Clyde,210,5,15,9,12,53,49,4,54
Elgin,210,6,15,6,15,56,61,-5,51
Annan Athlet,210,7,12,11,13,49,41,8,47
Berwick,210,8,8,10,18,30,60,-30,34
Edinburgh Ci,210,9,7,9,20,38,64,-26,30
Cowdenbeath,210,10,4,10,22,23,56,-33,22
Montrose,211,1,24,7,5,65,35,30,79
Peterhead,211,2,24,4,8,81,40,41,76
Stenhousem'r,211,3,16,8,12,58,48,10,56
Stirling,211,4,16,6,14,62,54,8,54
Clyde,211,5,15,9,12,53,48,5,54
Elgin,211,6,14,6,16,54,66,-12,48
Annan Athlet,211,7,12,11,13,49,41,8,47
Berwick,211,8,8,10,18,29,60,-31,34
Edinburgh Ci,211,9,7,9,20,38,64,-26,30
Cowdenbeath,211,10,4,10,22,23,56,-33,22
Montrose,212,1,24,7,5,60,34,26,79
Peterhead,212,2,24,4,8,80,40,40,76
Stenhousem'r,212,3,16,8,12,58,47,11,56
Stirling,212,4,16,6,14,61,54,7,54
Clyde,212,5,14,10,12,53,50,3,52
Elgin,212,6,14,6,16,53,61,-8,48
Annan Athlet,212,7,11,11,14,48,43,5,44
Berwick,212,8,8,11,17,31,60,-29,35
Edinburgh Ci,212,9,7,9,20,38,63,-25,30
Cowdenbeath,212,10,5,10,21,25,55,-30,25
Montrose,213,1,24,7,5,62,34,28,79
Peterhead,213,2,24,4,8,79,39,40,76
Stirling,213,3,16,7,13,61,52,9,55
Stenhousem'r,213,4,15,9,12,56,47,9,54
Clyde,213,5,14,10,12,53,50,3,52
Elgin,213,6,14,6,16,53,63,-10,48
Annan Athlet,213,7,11,12,13,48,42,6,45
Berwick,213,8,8,11,17,31,60,-29,35
Edinburgh Ci,213,9,7,9,20,37,62,-25,30
Cowdenbeath,213,10,4,11,21,24,55,-31,23
Montrose,214,1,23,8,5,61,36,25,77
Peterhead,214,2,24,4,8,78,38,40,76
Stirling,214,3,16,7,13,60,51,9,55
Stenhousem'r,214,4,15,9,12,55,46,9,54
Clyde,214,5,15,9,12,55,49,6,54
Elgin,214,6,14,7,15,55,62,-7,49
Annan Athlet,214,7,12,11,13,49,41,8,47
Berwick,214,8,8,10,18,30,62,-32,34
Edinburgh Ci,214,9,7,9,20,36,61,-25,30
Cowdenbeath,214,10,4,10,22,23,56,-33,22
Montrose,215,1,24,7,5,63,35,28,79
Peterhead,215,2,23,5,8,79,40,39,74
Stenhousem'r,215,3,16,8,12,59,47,12,56
Stirling,215,4,16,6,14,61,55,6,54
Clyde,215,5,14,9,13,52,51,1,51
Elgin,215,6,14,6,16,54,64,-10,48
Annan Athlet,215,7,12,11,13,48,41,7,47
Berwick,215,8,9,10,17,32,59,-27,37
Edinburgh Ci,215,9,7,10,19,38,62,-24,31
Cowdenbeath,215,10,4,10,22,23,55,-32,22
Montrose,216,1,24,7,5,63,35,28,79
Peterhead,216,2,24,4,8,80,38,42,76
Stenhousem'r,216,3,16,8,12,57,47,10,56
Stirling,216,4,16,6,14,61,53,8,54
Clyde,216,5,15,9,12,55,51,4,54
Elgin,216,6,14,6,16,54,64,-10,48
Annan Athlet,216,7,11,11,14,47,44,3,44
Berwick,216,8,8,10,18,32,62,-30,34
Edinburgh Ci,216,9,7,9,20,36,63,-27,30
Cowdenbeath,216,10,5,10,21,26,54,-28,25
Peterhead,217,1,24,4,8,80,38,42,76
Montrose,217,2,23,7,6,61,40,21,76
Stirling,217,3,17,6,13,62,52,10,57
Stenhousem'r,217,4,15,8,13,56,48,8,53
Clyde,217,5,14,10,12,51,48,3,52
Elgin,217,6,15,6,15,59,62,-3,51
Annan Athlet,217,7,12,11,13,48,41,7,47
Berwick,217,8,8,11,17,29,58,-29,35
Edinburgh Ci,217,9,7,9,20,36,63,-27,30
Cowdenbeath,217,10,4,10,22,23,55,-32,22
Montrose,218,1,23,8,5,61,36,25,77
Peterhead,218,2,24,4,8,83,39,44,76
Stenhousem'r,218,3,16,8,12,59,46,13,56
Stirling,218,4,16,6,14,60,55,5,54
Clyde,218,5,15,9,12,52,48,4,54
Elgin,218,6,14,7,15,55,62,-7,49
Annan Athlet,218,7,11,11,14,47,43,4,44
Berwick,218,8,8,10,18,29,59,-30,34
Edinburgh Ci,218,9,7,9,20,37,66,-29,30
Cowdenbeath,218,10,5,10,21,25,54,-29,25
Montrose,219,1,24,7,5,62,34,28,79
Peterhead,219,2,24,4,8,80,38,42,76
Stenhousem'r,219,3,16,8,12,59,46,13,56
Stirling,219,4,16,6,14,60,55,5,54
Clyde,219,5,15,9,12,53,48,5,54
Elgin,219,6,14,6,16,53,63,-10,48
Annan Athlet,219,7,12,11,13,49,41,8,47
Berwick,219,8,8,10,18,29,60,-31,34
Edinburgh Ci,219,9,7,9,20,36,63,-27,30
Cowdenbeath,219,10,4,10,22,23,56,-33,22
Montrose,220,1,23,8,5,61,36,25,77
Peterhead,220,2,24,4,8,80,39,41,76
Stenhousem'r,220,3,16,8,12,58,47,11,56
Stirling,220,4,16,6,14,61,54,7,54
Clyde,220,5,15,9,12,55,48,7,54
Elgin,220,6,14,7,15,55,62,-7,49
Annan Athlet,220,7,12,11,13,50,42,8,47
Berwick,220,8,8,10,18,29,62,-33,34
Edinburgh Ci,220,9,7,9,20,37,63,-26,30
Cowdenbeath,220,10,4,10,22,24,57,-33,22
Montrose,221,1,24,7,5,63,35,28,79
Peterhead,221,2,23,4,9,79,41,38,73
Stirling,221,3,17,6,13,62,51,11,57
Clyde,221,4,15,9,12,55,48,7,54
Stenhousem'r,221,5,15,8,13,55,48,7,53
Elgin,221,6,14,6,16,54,64,-10,48
Annan Athlet,221,7,11,11,14,47,42,5,44
Berwick,221,8,8,10,18,29,62,-33,34
Edinburgh Ci,221,9,8,9,19,39,62,-23,33
Cowdenbeath,221,10,5,10,21,24,54,-30,25
Montrose,222,1,24,7,5,62,36,26,79
Peterhead,222,2,23,4,9,78,41,37,73
Stirling,222,3,17,6,13,63,51,12,57
Clyde,222,4,15,9,12,54,50,4,54
Stenhousem'r,222,5,15,8,13,55,49,6,53
Elgin,222,6,14,6,16,55,63,-8,48
Annan Athlet,222,7,12,11,13,50,42,8,47
Berwick,222,8,8,10,18,31,61,-30,34
Edinburgh Ci,222,9,8,9,19,39,61,-22,33
Cowdenbeath,222,10,4,10,22,24,57,-33,22
Peterhead,223,1,24,4,8,81,40,41,76
Montrose,223,2,23,7,6,59,35,24,76
Stirling,223,3,17,6,13,63,53,10,57
Stenhousem'r,223,4,15,8,13,57,49,8,53
Clyde,223,5,14,9,13,51,50,1,51
Elgin,223,6,15,6,15,54,60,-6,51
Annan Athlet,223,7,11,12,13,48,42,6,45
Berwick,223,8,9,10,17,31,58,-27,37
Edinburgh Ci,223,9,7,9,20,38,64,-26,30
Cowdenbeath,223,10,4,11,21,24,55,-31,23
Peterhead,224,1,24,4,8,81,39,42,76
Montrose,224,2,23,7,6,61,37,24,76
Stirling,224,3,16,7,13,62,53,9,55
Stenhousem'r,224,4,15,9,12,57,48,9,54
Clyde,224,5,15,9,12,53,49,4,54
Elgin,224,6,15,6,15,56,62,-6,51
Annan Athlet,224,7,11,12,13,49,43,6,45
Berwick,224,8,8,10,18,30,60,-30,34
Edinburgh Ci,224,9,7,9,20,37,64,-27,30
Cowdenbeath,224,10,4,11,21,25,56,-31,23
Montrose,225,1,24,7,5,60,34,26,79
Peterhead,225,2,24,4,8,81,38,43,76
Stenhousem'r,225,3,16,8,12,56,46,10,56
Stirling,225,4,16,6,14,60,52,8,54
Clyde,225,5,14,9,13,51,49,2,51
Elgin,225,6,14,6,16,53,61,-8,48
Annan Athlet,225,7,11,12,13,47,41,6,45
Berwick,225,8,9,10,17,30,58,-28,37
Edinburgh Ci,225,9,7,9,20,36,64,-28,30
Cowdenbeath,225,10,4,11,21,23,54,-31,23
Montrose,226,1,23,8,5,60,35,25,77
Peterhead,226,2,23,5,8,78,39,39,74
Stirling,226,3,16,7,13,62,53,9,55
Stenhousem'r,226,4,15,9,12,57,48,9,54
Clyde,226,5,14,10,12,52,49,3,52
Elgin,226,6,14,7,15,54,61,-7,49
Annan Athlet,226,7,11,12,13,47,41,6,45
Berwick,226,8,8,11,17,30,59,-29,35
Edinburgh Ci,226,9,7,10,19,37,61,-24,31
Cowdenbeath,226,10,4,11,21,23,54,-31,23
Montrose,227,1,24,7,5,61,34,27,79
Peterhead,227,2,23,5,8,80,41,39,74
Stirling,227,3,17,6,13,61,51,10,57
Stenhousem'r,227,4,15,8,13,55,47,8,53
Clyde,227,5,14,10,12,52,49,3,52
Elgin,227,6,14,6,16,53,62,-9,48
Annan Athlet,227,7,11,12,13,47,41,6,45
Berwick,227,8,8,11,17,30,59,-29,35
Edinburgh Ci,227,9,7,10,19,39,63,-24,31
Cowdenbeath,227,10,4,11,21,23,54,-31,23
Montrose,228,1,23,7,6,59,38,21,76
Peterhead,228,2,23,5,8,77,38,39,74
Stirling,228,3,17,6,13,63,51,12,57
Clyde,228,4,15,9,12,56,48,8,54
Stenhousem'r,228,5,15,8,13,55,49,6,53
Elgin,228,6,15,6,15,57,60,-3,51
Annan Athlet,228,7,11,11,14,49,44,5,44
Berwick,228,8,8,10,18,29,63,-34,34
Edinburgh Ci,228,9,7,10,19,36,60,-24,31
Cowdenbeath,228,10,5,10,21,26,56,-30,25
Montrose,229,1,24,7,5,60,34,26,79
Peterhead,229,2,24,4,8,78,38,40,76
Stirling,229,3,17,6,13,62,52,10,57
Clyde,229,4,15,9,12,54,48,6,54
Stenhousem'r,229,5,15,8,13,56,48,8,53
Elgin,229,6,14,6,16,53,61,-8,48
Annan Athlet,229,7,12,11,13,48,41,7,47
Berwick,229,8,8,10,18,29,61,-32,34
Edinburgh Ci,229,9,7,9,20,36,61,-25,30
Cowdenbeath,229,10,4,10,22,23,55,-32,22
Montrose,230,1,23,8,5,59,34,25,77
Peterhead,230,2,24,4,8,84,38,46,76
Stirling,230,3,16,7,13,62,53,9,55
Stenhousem'r,230,4,15,9,12,57,48,9,54
Clyde,230,5,14,10,12,52,49,3,52
Elgin,230,6,14,7,15,53,60,-7,49
Annan Athlet,230,7,11,11,14,48,43,5,44
Berwick,230,8,8,11,17,30,59,-29,35
Edinburgh Ci,230,9,7,9,20,36,67,-31,30
Cowdenbeath,230,10,5,10,21,25,55,-30,25
Peterhead,231,1,24,4,8,78,38,40,76
Montrose,231,2,23,7,6,59,35,24,76
Stirling,231,3,16,7,13,61,52,9,55
Stenhousem'r,231,4,15,9,12,56,47,9,54
Clyde,231,5,14,10,12,52,49,3,52
Elgin,231,6,15,6,15,54,60,-6,51
Annan Athlet,231,7,12,11,13,48,41,7,47
Berwick,231,8,8,11,17,30,59,-29,35
Edinburgh Ci,231,9,7,9,20,36,61,-25,30
Cowdenbeath,231,10,4,10,22,23,55,-32,22
Montrose,232,1,24,7,5,62,35,27,79
Peterhead,232,2,24,4,8,80,39,41,76
Stirling,232,3,17,6,13,62,52,10,57
Clyde,232,4,15,9,12,53,49,4,54
Stenhousem'r,232,5,15,8,13,56,48,8,53
Elgin,232,6,14,6,16,54,63,-9,48
Annan Athlet,232,7,11,12,13,47,41,6,45
Berwick,232,8,8,10,18,30,60,-30,34
Edinburgh Ci,232,9,7,9,20,37,63,-26,30
Cowdenbeath,232,10,4,11,21,23,54,-31,23
Montrose,233,1,24,7,5,62,34,28,79
Peterhead,233,2,23,4,9,78,40,38,73
Stirling,233,3,17,6,13,63,53,10,57
Stenhousem'r,233,4,15,8,13,57,49,8,53
Clyde,233,5,14,9,13,51,49,2,51
Elgin,233,6,14,6,16,53,63,-10,48
Annan Athlet,233,7,11,11,14,47,42,5,44
Berwick,233,8,9,10,17,30,58,-28,37
Edinburgh Ci,233,9,8,9,19,38,61,-23,33
Cowdenbeath,233,10,5,10,21,24,54,-30,25
Montrose,234,1,23,8,5,60,35,25,77
Peterhead,234,2,23,4,9,77,40,37,73
Stenhousem'r,234,3,16,8,12,57,47,10,56
Stirling,234,4,16,6,14,61,53,8,54
Clyde,234,5,14,10,12,52,49,3,52
Elgin,234,6,14,7,15,54,61,-7,49
Annan Athlet,234,7,11,11,14,47,42,5,44
Berwick,234,8,8,11,17,30,59,-29,35
Edinburgh Ci,234,9,8,9,19,38,60,-22,33
Cowdenbeath,234,10,5,10,21,24,54,-30,25
Montrose,235,1,24,7,5,63,35,28,79
Peterhead,235,2,24,4,8,82,38,44,76
Stirling,235,3,16,7,13,61,52,9,55
Stenhousem'r,235,4,15,9,12,56,47,9,54
Clyde,235,5,15,9,12,52,48,4,54
Elgin,235,6,14,6,16,54,64,-10,48
Annan Athlet,235,7,11,11,14,47,42,5,44
Berwick,235,8,8,10,18,29,59,-30,34
Edinburgh Ci,235,9,7,9,20,36,65,-29,30
Cowdenbeath,235,10,5,10,21,24,54,-30,25
Montrose,236,1,24,7,5,62,35,27,79
Peterhead,236,2,23,5,8,79,40,39,74
Stirling,236,3,17,6,13,64,52,12,57
Clyde,236,4,15,9,12,53,49,4,54
Stenhousem'r,236,5,15,8,13,56,50,6,53
Elgin,236,6,14,6,16,54,63,-9,48
Annan Athlet,236,7,11,12,13,47,41,6,45
Berwick,236,8,8,10,18,30,60,-30,34
Edinburgh Ci,236,9,7,10,19,38,62,-24,31
Cowdenbeath,236,10,4,11,21,23,54,-31,23
Montrose,237,1,23,8,5,60,35,25,77
Peterhead,237,2,24,4,8,83,38,45,76
Stirling,237,3,16,7,13,62,53,9,55
Stenhousem'r,237,4,15,9,12,57,48,9,54
Clyde,237,5,15,9,12,54,49,5,54
Elgin,237,6,14,7,15,54,61,-7,49
Annan Athlet,237,7,12,11,13,48,41,7,47
Berwick,237,8,8,10,18,30,61,-31,34
Edinburgh Ci,237,9,7,9,20,36,66,-30,30
Cowdenbeath,237,10,4,10,22,23,55,-32,22
Montrose,238,1,24,7,5,60,34,26,79
Peterhead,238,2,24,4,8,79,38,41,76
Stirling,238,3,17,6,13,63,53,10,57
Clyde,238,4,15,9,12,53,49,4,54
Stenhousem'r,238,5,15,8,13,57,49,8,53
Elgin,238,6,14,6,16,53,61,-8,48
Annan Athlet,238,7,11,12,13,48,42,6,45
Berwick,238,8,8,10,18,30,60,-30,34
Edinburgh Ci,238,9,7,9,20,36,62,-26,30
Cowdenbeath,238,10,4,11,21,24,55,-31,23
Montrose,239,1,24,7,5,61,35,26,79
Peterhead,239,2,24,4,8,80,38,42,76
Stirling,239,3,16,7,13,61,52,9,55
Stenhousem'r,239,4,15,9,12,56,47,9,54
Clyde,239,5,15,9,12,54,48,6,54
Elgin,239,6,14,6,16,54,62,-8,48
Annan Athlet,239,7,11,12,13,47,41,6,45
Berwick,239,8,8,10,18,29,61,-32,34
Edinburgh Ci,239,9,7,9,20,36,63,-27,30
Cowdenbeath,239,10,4,11,21,23,54,-31,23
Montrose,240,1,24,7,5,61,34,27,79
Peterhead,240,2,24,4,8,81,39,42,76
Stenhousem'r,240,3,16,8,12,57,47,10,56
Stirling,240,4,16,6,14,61,53,8,54
Clyde,240,5,15,9,12,53,49,4,54
Elgin,240,6,14,6,16,53,62,-9,48
Annan Athlet,240,7,11,12,13,48,42,6,45
Berwick,240,8,8,10,18,30,60,-30,34
Edinburgh Ci,240,9,7,9,20,37,64,-27,30
Cowdenbeath,240,10,4,11,21,24,55,-31,23
Peterhead,241,1,24,4,8,83,39,44,76
Montrose,241,2,23,7,6,59,37,22,76
Stenhousem'r,241,3,16,8,12,57,46,11,56
Stirling,241,4,16,6,14,60,53,7,54
Clyde,241,5,15,9,12,54,50,4,54
Elgin,241,6,15,6,15,56,60,-4,51
Annan Athlet,241,7,12,11,13,49,41,8,47
Berwick,241,8,8,10,18,31,61,-30,34
Edinburgh Ci,241,9,7,9,20,37,66,-29,30
Cowdenbeath,241,10,4,10,22,23,56,-33,22
Montrose,242,1,24,7,5,64,34,30,79
Peterhead,242,2,24,4,8,79,38,41,76
Stirling,242,3,17,6,13,64,54,10,57
Stenhousem'r,242,4,15,8,13,58,50,8,53
Clyde,242,5,14,9,13,51,49,2,51
Elgin,242,6,14,6,16,53,65,-12,48
Annan Athlet,242,7,11,12,13,49,43,6,45
Berwick,242,8,9,10,17,30,58,-28,37
Edinburgh Ci,242,9,7,9,20,36,62,-26,30
Cowdenbeath,242,10,4,11,21,25,56,-31,23
Montrose,243,1,24,7,5,62,35,27,79
Peterhead,243,2,23,5,8,79,40,39,74
Stenhousem'r,243,3,16,8,12,57,47,10,56
Stirling,243,4,16,6,14,61,53,8,54
Clyde,243,5,15,9,12,55,51,4,54
Elgin,243,6,14,6,16,54,63,-9,48
Annan Athlet,243,7,11,11,14,48,44,4,44
Berwick,243,8,8,10,18,32,62,-30,34
Edinburgh Ci,243,9,7,10,19,38,62,-24,31
Cowdenbeath,243,10,5,10,21,26,55,-29,25
Montrose,244,1,24,7,5,62,35,27,79
Peterhead,244,2,24,4,8,81,39,42,76
Stirling,244,3,17,6,13,62,52,10,57
Clyde,244,4,15,9,12,54,48,6,54
Stenhousem'r,244,5,15,8,13,56,48,8,53
Elgin,244,6,14,6,16,54,63,-9,48
Annan Athlet,244,7,12,11,13,49,42,7,47
Berwick,244,8,8,10,18,29,61,-32,34
Edinburgh Ci,244,9,7,9,20,37,64,-27,30
Cowdenbeath,244,10,4,10,22,24,56,-32,22
Montrose,245,1,23,7,6,60,36,24,76
Peterhead,245,2,23,5,8,77,38,39,74
Stirling,245,3,16,7,13,60,51,9,55
Stenhousem'r,245,4,15,9,12,55,46,9,54
Clyde,245,5,14,10,12,52,49,3,52
Elgin,245,6,15,6,15,55,61,-6,51
Annan Athlet,245,7,12,11,13,49,41,8,47
Berwick,245,8,8,11,17,30,59,-29,35
Edinburgh Ci,245,9,7,10,19,36,60,-24,31
Cowdenbeath,245,10,4,10,22,23,56,-33,22
Montrose,246,1,23,7,6,60,36,24,76
Peterhead,246,2,23,4,9,77,39,38,73
Stirling,246,3,17,6,13,62,52,10,57
Clyde,246,4,15,9,12,54,49,5,54
Stenhousem'r,246,5,15,8,13,56,48,8,53
Elgin,246,6,15,6,15,55,61,-6,51
Annan Athlet,246,7,11,12,13,49,43,6,45
Berwick,246,8,8,10,18,30,61,-31,34
Edinburgh Ci,246,9,8,9,19,37,60,-23,33
Cowdenbeath,246,10,4,11,21,25,56,-31,23
Montrose,247,1,23,8,5,59,34,25,77
Peterhead,247,2,24,4,8,79,39,40,76
Stenhousem'r,247,3,16,8,12,56,46,10,56
Stirling,247,4,16,6,14,60,52,8,54
Clyde,247,5,15,9,12,55,48,7,54
Elgin,247,6,14,7,15,53,60,-7,49
Annan Athlet,247,7,12,11,13,48,41,7,47
Berwick,247,8,8,10,18,29,62,-33,34
Edinburgh Ci,247,9,7,9,20,37,62,-25,30
Cowdenbeath,247,10,4,10,22,23,55,-32,22
Montrose,248,1,24,7,5,64,35,29,79
Peterhead,248,2,24,4,8,81,38,43,76
Stirling,248,3,17,6,13,62,51,11,57
Clyde,248,4,15,9,12,54,49,5,54
Stenhousem'r,248,5,15,8,13,55,48,7,53
Elgin,248,6,14,6,16,54,65,-11,48
Annan Athlet,248,7,11,11,14,47,43,4,44
Berwick,248,8,8,10,18,30,61,-31,34
Edinburgh Ci,248,9,7,9,20,36,64,-28,30
Cowdenbeath,248,10,5,10,21,25,54,-29,25
Montrose,249,1,24,7,5,62,36,26,79
Peterhead,249,2,24,4,8,80,38,42,76
Stenhousem'r,249,3,16,8,12,58,47,11,56
Stirling,249,4,16,6,14,61,54,7,54
Clyde,249,5,14,10,12,53,50,3,52
Elgin,249,6,14,6,16,55,63,-8,48
Annan Athlet,249,7,12,11,13,48,41,7,47
Berwick,249,8,8,11,17,31,60,-29,35
Edinburgh Ci,249,9,7,9,20,36,63,-27,30
Cowdenbeath,249,10,4,10,22,23,55,-32,22
Montrose,250,1,23,7,6,60,36,24,76
Peterhead,250,2,23,5,8,79,40,39,74
Stenhousem'r,250,3,16,8,12,58,47,11,56
Stirling,250,4,16,6,14,61,54,7,54
Clyde,250,5,14,9,13,51,50,1,51
Elgin,250,6,15,6,15,55,61,-6,51
Annan Athlet,250,7,11,11,14,47,43,4,44
Berwick,250,8,9,10,17,31,58,-27,37
Edinburgh Ci,250,9,7,10,19,38,62,-24,31
Cowdenbeath,250,10,5,10,21,25,54,-29,25
Montrose,251,1,23,8,5,59,34,25,77
Peterhead,251,2,24,4,8,78,38,40,76
Stirling,251,3,17,6,13,63,52,11,57
Stenhousem'r,251,4,15,8,13,56,49,7,53
Clyde,251,5,14,10,12,53,50,3,52
Elgin,251,6,14,7,15,53,60,-7,49
Annan Athlet,251,7,11,11,14,47,42,5,44
Berwick,251,8,8,11,17,31,60,-29,35
Edinburgh Ci,251,9,7,9,20,36,61,-25,30
Cowdenbeath,251,10,5,10,21,24,54,-30,25
Montrose,252,1,23,8,5,61,36,25,77
Peterhead,252,2,23,4,9,77,40,37,73
Stirling,252,3,16,7,13,60,51,9,55
Stenhousem'r,252,4,15,9,12,55,46,9,54
Clyde,252,5,15,9,12,53,48,5,54
Elgin,252,6,14,7,15,55,62,-7,49
Annan Athlet,252,7,11,12,13,47,41,6,45
Berwick,252,8,8,10,18,29,60,-31,34
Edinburgh Ci,252,9,8,9,19,38,60,-22,33
Cowdenbeath,252,10,4,11,21,23,54,-31,23
Montrose,253,1,24,7,5,61,34,27,79
Peterhead,253,2,24,4,8,80,39,41,76
Stirling,253,3,17,6,13,61,51,10,57
Clyde,253,4,15,9,12,52,48,4,54
Stenhousem'r,253,5,15,8,13,55,47,8,53
Elgin,253,6,14,6,16,53,62,-9,48
Annan Athlet,253,7,11,12,13,48,42,6,45
Berwick,253,8,8,10,18,29,59,-30,34
Edinburgh Ci,253,9,7,9,20,37,63,-26,30
Cowdenbeath,253,10,4,11,21,24,55,-31,23
Montrose,254,1,24,7,5,60,34,26,79
Peterhead,254,2,24,4,8,80,38,42,76
Stirling,254,3,17,6,13,63,51,12,57
Stenhousem'r,254,4,15,8,13,55,49,6,53
Clyde,254,5,14,10,12,53,50,3,52
Elgin,254,6,14,6,16,53,61,-8,48
Annan Athlet,254,7,12,11,13,49,41,8,47
Berwick,254,8,8,11,17,31,60,-29,35
Edinburgh Ci,254,9,7,9,20,36,63,-27,30
Cowdenbeath,254,10,4,10,22,23,56,-33,22
Montrose,255,1,24,7,5,60,34,26,79
Peterhead,255,2,23,4,9,77,39,38,73
Stirling,255,3,16,7,13,60,51,9,55
Stenhousem'r,255,4,15,9,12,55,46,9,54
Clyde,255,5,15,9,12,52,48,4,54
Elgin,255,6,14,6,16,53,61,-8,48
Annan Athlet,255,7,11,12,13,48,42,6,45
Berwick,255,8,8,10,18,29,59,-30,34
Edinburgh Ci,255,9,8,9,19,37,60,-23,33
Cowdenbeath,255,10,4,11,21,24,55,-31,23
Montrose,256,1,23,8,5,60,35,25,77
Peterhead,256,2,24,4,8,80,38,42,76
Stenhousem'r,256,3,16,8,12,59,48,11,56
Stirling,256,4,16,6,14,62,55,7,54
Clyde,256,5,15,9,12,53,48,5,54
Elgin,256,6,14,7,15,54,61,-7,49
Annan Athlet,256,7,11,11,14,47,43,4,44
Berwick,256,8,8,10,18,29,60,-31,34
Edinburgh Ci,256,9,7,9,20,36,63,-27,30
Cowdenbeath,256,10,5,10,21,25,54,-29,25
Peterhead,257,1,24,4,8,82,39,43,76
Montrose,257,2,23,7,6,60,36,24,76
Stirling,257,3,16,7,13,62,53,9,55
Stenhousem'r,257,4,15,9,12,57,48,9,54
Clyde,257,5,14,10,12,52,49,3,52
Elgin,257,6,15,6,15,55,61,-6,51
Annan Athlet,257,7,12,11,13,48,41,7,47
Berwick,257,8,8,11,17,30,59,-29,35
Edinburgh Ci,257,9,7,9,20,37,65,-28,30
Cowdenbeath,257,10,4,10,22,23,55,-32,22
Peterhead,258,1,24,4,8,83,40,43,76
Montrose,258,2,23,7,6,60,36,24,76
Stirling,258,3,17,6,13,62,51,11,57
Stenhousem'r,258,4,15,8,13,55,48,7,53
Clyde,258,5,14,10,12,52,49,3,52
Elgin,258,6,15,6,15,55,61,-6,51
Annan Athlet,258,7,12,11,13,48,41,7,47
Berwick,258,8,8,11,17,30,59,-29,35
Edinburgh Ci,258,9,7,9,20,38,66,-28,30
Cowdenbeath,258,10,4,10,22,23,55,-32,22
Montrose,259,1,24,7,5,62,35,27,79
Peterhead,259,2,24,4,8,82,38,44,76
Stirling,259,3,17,6,13,61,51,10,57
Stenhousem'r,259,4,15,8,13,55,47,8,53
Clyde,259,5,14,10,12,51,48,3,52
Elgin,259,6,14,6,16,54,63,-9,48
Annan Athlet,259,7,12,11,13,49,42,7,47
Berwick,259,8,8,11,17,29,58,-29,35
Edinburgh Ci,259,9,7,9,20,36,65,-29,30
Cowdenbeath,259,10,4,10,22,24,56,-32,22
Montrose,260,1,24,7,5,60,34,26,79
Peterhead,260,2,24,4,8,82,41,41,76
Stirling,260,3,16,7,13,60,51,9,55
Stenhousem'r,260,4,15,9,12,55,46,9,54
Clyde,260,5,15,9,12,54,49,5,54
Elgin,260,6,14,6,16,53,61,-8,48
Annan Athlet,260,7,11,11,14,48,43,5,44
Berwick,260,8,8,10,18,30,61,-31,34
Edinburgh Ci,260,9,7,9,20,39,65,-26,30
Cowdenbeath,260,10,5,10,21,25,55,-30,25
Peterhead,261,1,24,4,8,80,40,40,76
Montrose,261,2,23,7,6,59,36,23,76
Stirling,261,3,17,6,13,62,51,11,57
Clyde,261,4,15,9,12,53,48,5,54
Stenhousem'r,261,5,15,8,13,55,48,7,53
Elgin,261,6,15,6,15,55,60,-5,51
Annan Athlet,261,7,12,11,13,48,41,7,47
Berwick,261,8,8,10,18,29,60,-31,34
Edinburgh Ci,261,9,7,9,20,38,63,-25,30
Cowdenbeath,261,10,4,10,22,23,55,-32,22
Peterhead,262,1,24,4,8,79,39,40,76
Montrose,262,2,23,7,6,60,36,24,76
Stirling,262,3,17,6,13,63,51,12,57
Clyde,262,4,15,9,12,55,48,7,54
Stenhousem'r,262,5,15,8,13,55,49,6,53
Elgin,262,6,15,6,15,55,61,-6,51
Annan Athlet,262,7,12,11,13,48,41,7,47
Berwick,262,8,8,10,18,29,62,-33,34
Edinburgh Ci,262,9,7,9,20,37,62,-25,30
Cowdenbeath,262,10,4,10,22,23,55,-32,22
Montrose,263,1,23,8,5,60,35,25,77
Peterhead,263,2,23,4,9,77,40,37,73
Stirling,263,3,17,6,13,62,51,11,57
Clyde,263,4,15,9,12,54,48,6,54
Stenhousem'r,263,5,15,8,13,55,48,7,53
Elgin,263,6,14,7,15,54,61,-7,49
Annan Athlet,263,7,12,11,13,48,41,7,47
Berwick,263,8,8,10,18,29,61,-32,34
Edinburgh Ci,263,9,8,9,19,38,60,-22,33
Cowdenbeath,263,10,4,10,22,23,55,-32,22
Montrose,264,1,24,7,5,60,34,26,79
Peterhead,264,2,24,4,8,80,38,42,76
Stenhousem'r,264,3,16,8,12,57,46,11,56
Stirling,264,4,16,6,14,60,53,7,54
Clyde,264,5,15,9,12,54,48,6,54
Elgin,264,6,14,6,16,53,61,-8,48
Annan Athlet,264,7,12,11,13,50,43,7,47
Berwick,264,8,8,10,18,29,61,-32,34
Edinburgh Ci,264,9,7,9,20,36,63,-27,30
Cowdenbeath,264,10,4,10,22,25,57,-32,22
Montrose,265,1,23,8,5,60,35,25,77
Peterhead,265,2,23,4,9,78,40,38,73
Stirling,265,3,17,6,13,61,51,10,57
Clyde,265,4,15,9,12,54,48,6,54
Stenhousem'r,265,5,15,8,13,55,47,8,53
Elgin,265,6,14,7,15,54,61,-7,49
Annan Athlet,265,7,11,11,14,47,42,5,44
Berwick,265,8,8,10,18,29,61,-32,34
Edinburgh Ci,265,9,8,9,19,38,61,-23,33
Cowdenbeath,265,10,5,10,21,24,54,-30,25
Montrose,266,1,23,8,5,59,34,25,77
Peterhead,266,2,24,4,8,83,40,43,76
Stenhousem'r,266,3,16,8,12,58,47,11,56
Stirling,266,4,16,6,14,61,54,7,54
Clyde,266,5,14,10,12,51,48,3,52
Elgin,266,6,14,7,15,53,60,-7,49
Annan Athlet,266,7,11,12,13,47,41,6,45
Berwick,266,8,8,11,17,29,58,-29,35
Edinburgh Ci,266,9,7,9,20,38,66,-28,30
Cowdenbeath,266,10,4,11,21,23,54,-31,23
Montrose,267,1,24,7,5,61,35,26,79
Peterhead,267,2,23,5,8,78,39,39,74
Stirling,267,3,17,6,13,63,52,11,57
Clyde,267,4,15,9,12,53,48,5,54
Stenhousem'r,267,5,15,8,13,56,49,7,53
Elgin,267,6,14,6,16,54,62,-8,48
Annan Athlet,267,7,11,11,14,47,43,4,44
Berwick,267,8,8,10,18,29,60,-31,34
Edinburgh Ci,267,9,7,10,19,37,61,-24,31
Cowdenbeath,267,10,5,10,21,25,54,-29,25
Montrose,268,1,23,8,5,61,36,25,77
Peterhead,268,2,23,5,8,77,38,39,74
Stenhousem'r,268,3,16,8,12,57,47,10,56
Stirling,268,4,16,6,14,61,53,8,54
Clyde,268,5,15,9,12,53,48,5,54
Elgin,268,6,14,7,15,55,62,-7,49
Annan Athlet,268,7,11,12,13,49,43,6,45
Berwick,268,8,8,10,18,29,60,-31,34
Edinburgh Ci,268,9,7,10,19,36,60,-24,31
Cowdenbeath,268,10,4,11,21,25,56,-31,23
Montrose,269,1,24,7,5,62,34,28,79
Peterhead,269,2,24,4,8,79,39,40,76
Stirling,269,3,17,6,13,62,51,11,57
Stenhousem'r,269,4,15,8,13,55,48,7,53
Clyde,269,5,14,9,13,52,51,1,51
Elgin,269,6,14,6,16,53,63,-10,48
Annan Athlet,269,7,11,12,13,48,42,6,45
Berwick,269,8,9,10,17,32,59,-27,37
Edinburgh Ci,269,9,7,9,20,37,62,-25,30
Cowdenbeath,269,10,4,11,21,24,55,-31,23
Montrose,270,1,23,8,5,59,34,25,77
Peterhead,270,2,23,4,9,78,40,38,73
Stenhousem'r,270,3,16,8,12,57,46,11,56
Stirling,270,4,16,6,14,60,53,7,54
Clyde,270,5,14,10,12,52,49,3,52
Elgin,270,6,14,7,15,53,60,-7,49
Annan Athlet,270,7,12,11,13,48,41,7,47
Berwick,270,8,8,11,17,30,59,-29,35
Edinburgh Ci,270,9,8,9,19,38,61,-23,33
Cowdenbeath,270,10,4,10,22,23,55,-32,22
Montrose,271,1,24,7,5,61,34,27,79
Peterhead,271,2,24,4,8,79,38,41,76
Stenhousem'r,271,3,16,8,12,58,46,12,56
Stirling,271,4,16,6,14,60,54,6,54
Clyde,271,5,15,9,12,54,49,5,54
Elgin,271,6,14,6,16,53,62,-9,48
Annan Athlet,271,7,11,12,13,48,42,6,45
Berwick,271,8,8,10,18,30,61,-31,34
Edinburgh Ci,271,9,7,9,20,36,62,-26,30
Cowdenbeath,271,10,4,11,21,24,55,-31,23
Montrose,272,1,24,7,5,62,35,27,79
Peterhead,272,2,23,4,9,79,41,38,73
Stirling,272,3,16,7,13,61,52,9,55
Stenhousem'r,272,4,15,9,12,56,47,9,54
Clyde,272,5,15,9,12,55,48,7,54
Elgin,272,6,14,6,16,54,63,-9,48
Annan Athlet,272,7,11,11,14,48,44,4,44
Berwick,272,8,8,10,18,29,62,-33,34
Edinburgh Ci,272,9,8,9,19,39,62,-23,33
Cowdenbeath,272,10,5,10,21,26,55,-29,25
Montrose,273,1,24,7,5,61,35,26,79
Peterhead,273,2,24,4,8,80,38,42,76
Stirling,273,3,17,6,13,66,53,13,57
Stenhousem'r,273,4,15,8,13,57,52,5,53
Clyde,273,5,14,10,12,53,50,3,52
Elgin,273,6,14,6,16,54,62,-8,48
Annan Athlet,273,7,12,11,13,49,41,8,47
Berwick,273,8,8,11,17,31,60,-29,35
Edinburgh Ci,273,9,7,9,20,36,63,-27,30
Cowdenbeath,273,10,4,10,22,23,56,-33,22
Montrose,274,1,24,7,5,61,34,27,79
Peterhead,274,2,24,4,8,80,38,42,76
Stirling,274,3,17,6,13,63,52,11,57
Stenhousem'r,274,4,15,8,13,56,49,7,53
Clyde,274,5,14,10,12,52,49,3,52
Elgin,274,6,14,6,16,53,62,-9,48
Annan Athlet,274,7,11,11,14,47,44,3,44
Berwick,274,8,8,11,17,30,59,-29,35
Edinburgh Ci,274,9,7,9,20,36,63,-27,30
Cowdenbeath,274,10,5,10,21,26,54,-28,25
Montrose,275,1,24,7,5,62,35,27,79
Peterhead,275,2,24,4,8,80,38,42,76
Stirling,275,3,17,6,13,64,51,13,57
Clyde,275,4,15,9,12,54,48,6,54
Stenhousem'r,275,5,15,8,13,55,50,5,53
Elgin,275,6,14,6,16,54,63,-9,48
Annan Athlet,275,7,11,12,13,47,41,6,45
Berwick,275,8,8,10,18,29,61,-32,34
Edinburgh Ci,275,9,7,9,20,36,63,-27,30
Cowdenbeath,275,10,4,11,21,23,54,-31,23
Montrose,276,1,24,7,5,62,34,28,79
Peterhead,276,2,24,4,8,79,38,41,76
Stenhousem'r,276,3,16,8,12,56,46,10,56
Stirling,276,4,16,6,14,60,52,8,54
Clyde,276,5,15,9,12,53,48,5,54
Elgin,276,6,14,6,16,53,63,-10,48
Annan Athlet,276,7,11,12,13,47,41,6,45
Berwick,276,8,8,10,18,29,60,-31,34
Edinburgh Ci,276,9,7,9,20,36,62,-26,30
Cowdenbeath,276,10,4,11,21,23,54,-31,23
Montrose,277,1,23,8,5,61,36,25,77
Peterhead,277,2,24,4,8,78,38,40,76
Stenhousem'r,277,3,16,8,12,57,46,11,56
Stirling,277,4,16,6,14,60,53,7,54
Clyde,277,5,15,9,12,53,49,4,54
Elgin,277,6,14,7,15,55,62,-7,49
Annan Athlet,277,7,11,12,13,48,42,6,45
Berwick,277,8,8,10,18,30,60,-30,34
Edinburgh Ci,277,9,7,9,20,36,61,-25,30
Cowdenbeath,277,10,4,11,21,24,55,-31,23
Montrose,278,1,24,7,5,62,36,26,79
Peterhead,278,2,23,5,8,79,40,39,74
Stirling,278,3,17,6,13,63,51,12,57
Stenhousem'r,278,4,15,8,13,55,49,6,53
Clyde,278,5,14,10,12,52,49,3,52
Elgin,278,6,14,6,16,55,63,-8,48
Annan Athlet,278,7,11,11,14,47,42,5,44
Berwick,278,8,8,11,17,30,59,-29,35
Edinburgh Ci,278,9,7,10,19,38,62,-24,31
Cowdenbeath,278,10,5,10,21,24,54,-30,25
Montrose,279,1,24,7,5,60,34,26,79
Peterhead,279,2,24,4,8,80,38,42,76
Stirling,279,3,17,6,13,62,52,10,57
Clyde,279,4,15,9,12,53,48,5,54
Stenhousem'r,279,5,15,8,13,56,48,8,53
Elgin,279,6,14,6,16,53,61,-8,48
Annan Athlet,279,7,11,11,14,47,42,5,44
Berwick,279,8,8,10,18,29,60,-31,34
Edinburgh Ci,279,9,7,9,20,36,63,-27,30
Cowdenbeath,279,10,5,10,21,24,54,-30,25
Montrose,280,1,24,7,5,63,35,28,79
Peterhead,280,2,24,4,8,80,39,41,76
Stirling,280,3,17,6,13,63,53,10,57
Clyde,280,4,15,9,12,53,48,5,54
Stenhousem'r,280,5,15,8,13,57,49,8,53
Elgin,280,6,14,6,16,54,64,-10,48
Annan Athlet,280,7,12,11,13,48,41,7,47
Berwick,280,8,8,10,18,29,60,-31,34
Edinburgh Ci,280,9,7,9,20,37,63,-26,30
Cowdenbeath,280,10,4,10,22,23,55,-32,22
Montrose,281,1,24,7,5,62,35,27,79
Peterhead,281,2,24,4,8,78,38,40,76
Stenhousem'r,281,3,16,8,12,59,47,12,56
Stirling,281,4,16,6,14,61,55,6,54
Clyde,281,5,15,9,12,52,48,4,54
Elgin,281,6,14,6,16,54,63,-9,48
Annan Athlet,281,7,11,12,13,47,41,6,45
Berwick,281,8,8,10,18,29,59,-30,34
Edinburgh Ci,281,9,7,9,20,36,61,-25,30
Cowdenbeath,281,10,4,11,21,23,54,-31,23
Montrose,282,1,24,7,5,62,36,26,79
Peterhead,282,2,23,4,9,78,41,37,73
Stirling,282,3,17,6,13,64,52,12,57
Stenhousem'r,282,4,15,8,13,56,50,6,53
Clyde,282,5,14,10,12,51,48,3,52
Elgin,282,6,14,6,16,55,63,-8,48
Annan Athlet,282,7,12,11,13,48,41,7,47
Berwick,282,8,8,11,17,29,58,-29,35
Edinburgh Ci,282,9,8,9,19,39,61,-22,33
Cowdenbeath,282,10,4,10,22,23,55,-32,22
Montrose,283,1,23,8,5,60,35,25,77
Peterhead,283,2,24,4,8,80,40,40,76
Stirling,283,3,17,6,13,65,52,13,57
Clyde,283,4,15,9,12,53,49,4,54
Stenhousem'r,283,5,15,8,13,56,51,5,53
Elgin,283,6,14,7,15,54,61,-7,49
Annan Athlet,283,7,12,11,13,50,41,9,47
Berwick,283,8,8,10,18,30,60,-30,34
Edinburgh Ci,283,9,7,9,20,38,63,-25,30
Cowdenbeath,283,10,4,10,22,23,57,-34,22
Montrose,284,1,23,8,5,61,36,25,77
Peterhead,284,2,24,4,8,79,39,40,76
Stenhousem'r,284,3,16,8,12,59,49,10,56
Stirling,284,4,16,6,14,63,55,8,54
Clyde,284,5,15,9,12,52,48,4,54
Elgin,284,6,14,7,15,55,62,-7,49
Annan Athlet,284,7,11,12,13,48,42,6,45
Berwick,284,8,8,10,18,29,59,-30,34
Edinburgh Ci,284,9,7,9,20,37,62,-25,30
Cowdenbeath,284,10,4,11,21,24,55,-31,23
Peterhead,285,1,24,4,8,78,38,40,76
Montrose,285,2,23,7,6,61,37,24,76
Stirling,285,3,17,6,13,62,52,10,57
Stenhousem'r,285,4,15,8,13,56,48,8,53
Clyde,285,5,14,10,12,52,49,3,52
Elgin,285,6,15,6,15,56,62,-6,51
Annan Athlet,285,7,11,11,14,47,43,4,44
Berwick,285,8,8,11,17,30,59,-29,35
Edinburgh Ci,285,9,7,9,20,36,61,-25,30
Cowdenbeath,285,10,5,10,21,25,54,-29,25
Montrose,286,1,24,7,5,62,36,26,79
Peterhead,286,2,24,4,8,79,39,40,76
Stirling,286,3,17,6,13,61,51,10,57
Clyde,286,4,15,9,12,54,48,6,54
Stenhousem'r,286,5,15,8,13,55,47,8,53
Elgin,286,6,14,6,16,55,63,-8,48
Annan Athlet,286,7,12,11,13,50,42,8,47
Berwick,286,8,8,10,18,29,61,-32,34
Edinburgh Ci,286,9,7,9,20,37,62,-25,30
Cowdenbeath,286,10,4,10,22,24,57,-33,22
Montrose,287,1,24,7,5,61,35,26,79
Peterhead,287,2,24,4,8,79,39,40,76
Stirling,287,3,17,6,13,63,51,12,57
Clyde,287,4,15,9,12,55,48,7,54
Stenhousem'r,287,5,15,8,13,55,49,6,53
Elgin,287,6,14,6,16,54,62,-8,48
Annan Athlet,287,7,11,12,13,47,41,6,45
Berwick,287,8,8,10,18,29,62,-33,34
Edinburgh Ci,287,9,7,9,20,37,62,-25,30
Cowdenbeath,287,10,4,11,21,23,54,-31,23
Montrose,288,1,24,7,5,63,36,27,79
Peterhead,288,2,24,4,8,79,39,40,76
Stirling,288,3,17,6,13,63,53,10,57
Clyde,288,4,15,9,12,52,48,4,54
Stenhousem'r,288,5,15,8,13,57,49,8,53
Elgin,288,6,14,6,16,55,64,-9,48
Annan Athlet,288,7,11,12,13,48,42,6,45
Berwick,288,8,8,10,18,29,59,-30,34
Edinburgh Ci,288,9,7,9,20,37,62,-25,30
Cowdenbeath,288,10,4,11,21,24,55,-31,23
Montrose,289,1,24,7,5,63,37,26,79
Peterhead,289,2,24,4,8,79,38,41,76
Stirling,289,3,17,6,13,63,53,10,57
Stenhousem'r,289,4,15,8,13,57,49,8,53
Clyde,289,5,14,10,12,52,49,3,52
Elgin,289,6,14,6,16,56,64,-8,48
Annan Athlet,289,7,11,12,13,47,41,6,45
Berwick,289,8,8,11,17,30,59,-29,35
Edinburgh Ci,289,9,7,9,20,36,62,-26,30
Cowdenbeath,289,10,4,11,21,23,54,-31,23
Montrose,290,1,23,8,5,60,35,25,77
Peterhead,290,2,24,4,8,81,38,43,76
Stenhousem'r,290,3,16,8,12,58,48,10,56
Stirling,290,4,16,6,14,62,54,8,54
Clyde,290,5,15,9,12,52,48,4,54
Elgin,290,6,14,7,15,54,61,-7,49
Annan Athlet,290,7,11,12,13,47,41,6,45
Berwick,290,8,8,10,18,29,59,-30,34
Edinburgh Ci,290,9,7,9,20,36,64,-28,30
Cowdenbeath,290,10,4,11,21,23,54,-31,23
Montrose,291,1,23,8,5,60,35,25,77
Peterhead,291,2,24,4,8,80,39,41,76
Stenhousem'r,291,3,16,8,12,57,47,10,56
Stirling,291,4,16,6,14,61,53,8,54
Clyde,291,5,14,9,13,51,49,2,51
Elgin,291,6,14,7,15,54,61,-7,49
Annan Athlet,291,7,12,11,13,48,41,7,47
Berwick,291,8,9,10,17,30,58,-28,37
Edinburgh Ci,291,9,7,9,20,37,63,-26,30
Cowdenbeath,291,10,4,10,22,23,55,-32,22
Montrose,292,1,23,8,5,60,35,25,77
Peterhead,292,2,24,4,8,78,38,40,76
Stirling,292,3,17,6,13,61,51,10,57
Stenhousem'r,292,4,15,8,13,55,47,8,53
Clyde,292,5,14,9,13,51,49,2,51
Elgin,292,6,14,7,15,54,61,-7,49
Annan Athlet,292,7,12,11,13,50,41,9,47
Berwick,292,8,9,10,17,30,58,-28,37
Edinburgh Ci,292,9,7,9,20,36,61,-25,30
Cowdenbeath,292,10,4,10,22,23,57,-34,22
Montrose,293,1,24,7,5,61,35,26,79
Peterhead,293,2,24,4,8,79,39,40,76
Stirling,293,3,17,6,13,61,51,10,57
Clyde,293,4,15,9,12,53,48,5,54
Stenhousem'r,293,5,15,8,13,55,47,8,53
Elgin,293,6,14,6,16,54,62,-8,48
Annan Athlet,293,7,11,12,13,49,43,6,45
Berwick,293,8,8,10,18,29,60,-31,34
Edinburgh Ci,293,9,7,9,20,37,62,-25,30
Cowdenbeath,293,10,4,11,21,25,56,-31,23
Montrose,294,1,24,7,5,61,35,26,79
Peterhead,294,2,23,5,8,78,39,39,74
Stirling,294,3,17,6,13,63,52,11,57
Stenhousem'r,294,4,15,8,13,56,49,7,53
Clyde,294,5,14,9,13,51,49,2,51
Elgin,294,6,14,6,16,54,62,-8,48
Annan Athlet,294,7,12,11,13,48,41,7,47
Berwick,294,8,9,10,17,30,58,-28,37
Edinburgh Ci,294,9,7,10,19,37,61,-24,31
Cowdenbeath,294,10,4,10,22,23,55,-32,22
Peterhead,295,1,24,4,8,80,38,42,76
Montrose,295,2,23,7,6,59,36,23,76
Stirling,295,3,17,6,13,62,52,10,57
Clyde,295,4,15,9,12,54,48,6,54
Stenhousem'r,295,5,15,8,13,56,48,8,53
Elgin,295,6,15,6,15,55,60,-5,51
Annan Athlet,295,7,12,11,13,48,41,7,47
Berwick,295,8,8,10,18,29,61,-32,34
Edinburgh Ci,295,9,7,9,20,36,63,-27,30
Cowdenbeath,295,10,4,10,22,23,55,-32,22
Montrose,296,1,24,7,5,61,34,27,79
Peterhead,296,2,23,4,9,80,42,38,73
Stenhousem'r,296,3,16,8,12,58,46,12,56
Stirling,296,4,16,6,14,60,54,6,54
Clyde,296,5,14,10,12,52,49,3,52
Elgin,296,6,14,6,16,53,62,-9,48
Annan Athlet,296,7,12,11,13,50,42,8,47
Berwick,296,8,8,11,17,30,59,-29,35
Edinburgh Ci,296,9,8,9,19,40,63,-23,33
Cowdenbeath,296,10,4,10,22,24,57,-33,22
Montrose,297,1,24,7,5,64,36,28,79
Peterhead,297,2,24,4,8,81,38,43,76
Stenhousem'r,297,3,16,8,12,56,46,10,56
Stirling,297,4,16,6,14,60,52,8,54
Clyde,297,5,15,9,12,53,49,4,54
Elgin,297,6,14,6,16,55,65,-10,48
Annan Athlet,297,7,11,11,14,47,44,3,44
Berwick,297,8,8,10,18,30,60,-30,34
Edinburgh Ci,297,9,7,9,20,36,64,-28,30
Cowdenbeath,297,10,5,10,21,26,54,-28,25
Peterhead,298,1,24,4,8,78,38,40,76
Montrose,298,2,23,7,6,60,37,23,76
Stenhousem'r,298,3,16,8,12,57,47,10,56
Stirling,298,4,16,6,14,61,53,8,54
Clyde,298,5,14,9,13,52,50,2,51
Elgin,298,6,15,6,15,56,61,-5,51
Annan Athlet,298,7,11,11,14,47,44,3,44
Berwick,298,8,9,10,17,31,59,-28,37
Edinburgh Ci,298,9,7,9,20,36,61,-25,30
Cowdenbeath,298,10,5,10,21,26,54,-28,25
Montrose,299,1,24,7,5,60,34,26,79
Peterhead,299,2,24,4,8,78,38,40,76
Stirling,299,3,16,7,13,61,52,9,55
Stenhousem'r,299,4,15,9,12,56,47,9,54
Clyde,299,5,15,9,12,54,49,5,54
Elgin,299,6,14,6,16,53,61,-8,48
Annan Athlet,299,7,11,12,13,48,42,6,45
Berwick,299,8,8,10,18,30,61,-31,34
Edinburgh Ci,299,9,7,9,20,36,61,-25,30
Cowdenbeath,299,10,4,11,21,24,55,-31,23
Montrose,300,1,24,7,5,60,34,26,79
Peterhead,300,2,23,5,8,79,40,39,74
Stenhousem'r,300,3,16,8,12,57,47,10,56
Stirling,300,4,16,6,14,61,53,8,54
Clyde,300,5,15,9,12,54,49,5,54
Elgin,300,6,14,6,16,53,61,-8,48
Annan Athlet,300,7,11,12,13,47,41,6,45
Berwick,300,8,8,10,18,30,61,-31,34
Edinburgh Ci,300,9,7,10,19,38,62,-24,31
Cowdenbeath,300,10,4,11,21,23,54,-31,23
Montrose,301,1,24,7,5,61,34,27,79
Peterhead,301,2,24,4,8,81,38,43,76
Stirling,301,3,17,6,13,61,51,10,57
Clyde,301,4,15,9,12,52,48,4,54
Stenhousem'r,301,5,15,8,13,55,47,8,53
Elgin,301,6,14,6,16,53,62,-9,48
Annan Athlet,301,7,12,11,13,48,41,7,47
Berwick,301,8,8,10,18,29,59,-30,34
Edinburgh Ci,301,9,7,9,20,36,64,-28,30
Cowdenbeath,301,10,4,10,22,23,55,-32,22
Montrose,302,1,24,7,5,62,35,27,79
Peterhead,302,2,24,4,8,79,38,41,76
Stirling,302,3,17,6,13,64,52,12,57
Clyde,302,4,15,9,12,55,49,6,54
Stenhousem'r,302,5,15,8,13,56,50,6,53
Elgin,302,6,14,6,16,54,63,-9,48
Annan Athlet,302,7,11,12,13,47,41,6,45
Berwick,302,8,8,10,18,30,62,-32,34
Edinburgh Ci,302,9,7,9,20,36,62,-26,30
Cowdenbeath,302,10,4,11,21,23,54,-31,23
Montrose,303,1,24,7,5,61,34,27,79
Peterhead,303,2,24,4,8,79,39,40,76
Stenhousem'r,303,3,16,8,12,58,47,11,56
Stirling,303,4,16,6,14,61,54,7,54
Clyde,303,5,15,9,12,54,49,5,54
Elgin,303,6,14,6,16,53,62,-9,48
Annan Athlet,303,7,12,11,13,49,41,8,47
Berwick,303,8,8,10,18,30,61,-31,34
Edinburgh Ci,303,9,7,9,20,37,62,-25,30
Cowdenbeath,303,10,4,10,22,23,56,-33,22
Montrose,304,1,24,7,5,60,34,26,79
Peterhead,304,2,24,4,8,79,39,40,76
Stirling,304,3,17,6,13,62,52,10,57
Clyde,304,4,15,9,12,53,48,5,54
Stenhousem'r,304,5,15,8,13,56,48,8,53
Elgin,304,6,14,6,16,53,61,-8,48
Annan Athlet,304,7,11,12,13,49,43,6,45
Berwick,304,8,8,10,18,29,60,-31,34
Edinburgh Ci,304,9,7,9,20,37,62,-25,30
Cowdenbeath,304,10,4,11,21,25,56,-31,23
Montrose,305,1,24,7,5,60,34,26,79
Peterhead,305,2,24,4,8,83,38,45,76
Stirling,305,3,17,6,13,63,53,10,57
Clyde,305,4,15,9,12,55,50,5,54
Stenhousem'r,305,5,15,8,13,57,49,8,53
Elgin,305,6,14,6,16,53,61,-8,48
Annan Athlet,305,7,11,12,13,47,41,6,45
Berwick,305,8,8,10,18,31,62,-31,34
Edinburgh Ci,305,9,7,9,20,36,66,-30,30
Cowdenbeath,305,10,4,11,21,23,54,-31,23
Montrose,306,1,24,7,5,65,37,28,79
Peterhead,306,2,24,4,8,81,38,43,76
Stenhousem'r,306,3,16,8,12,57,47,10,56
Stirling,306,4,16,6,14,61,53,8,54
Clyde,306,5,15,9,12,54,49,5,54
Elgin,306,6,14,6,16,56,66,-10,48
Annan Athlet,306,7,11,12,13,49,43,6,45
Berwick,306,8,8,10,18,30,61,-31,34
Edinburgh Ci,306,9,7,9,20,36,64,-28,30
Cowdenbeath,306,10,4,11,21,25,56,-31,23
Montrose,307,1,23,7,6,59,36,23,76
Peterhead,307,2,23,4,9,77,39,38,73
Stenhousem'r,307,3,16,8,12,57,46,11,56
Stirling,307,4,16,6,14,60,53,7,54
Clyde,307,5,15,9,12,52,48,4,54
Elgin,307,6,15,6,15,55,60,-5,51
Annan Athlet,307,7,11,12,13,48,42,6,45
Berwick,307,8,8,10,18,29,59,-30,34
Edinburgh Ci,307,9,8,9,19,37,60,-23,33
Cowdenbeath,307,10,4,11,21,24,55,-31,23
Montrose,308,1,23,8,5,62,37,25,77
Peterhead,308,2,23,5,8,80,41,39,74
Stirling,308,3,17,6,13,64,53,11,57
Clyde,308,4,15,9,12,52,48,4,54
Stenhousem'r,308,5,15,8,13,57,50,7,53
Elgin,308,6,14,7,15,56,63,-7,49
Annan Athlet,308,7,11,11,14,47,42,5,44
Berwick,308,8,8,10,18,29,59,-30,34
Edinburgh Ci,308,9,7,10,19,39,63,-24,31
Cowdenbeath,308,10,5,10,21,24,54,-30,25
Montrose,309,1,24,7,5,61,34,27,79
Peterhead,309,2,24,4,8,82,38,44,76
Stirling,309,3,17,6,13,62,51,11,57
Stenhousem'r,309,4,15,8,13,55,48,7,53
Clyde,309,5,14,10,12,53,50,3,52
Elgin,309,6,14,6,16,53,62,-9,48
Annan Athlet,309,7,11,11,14,47,42,5,44
Berwick,309,8,8,11,17,31,60,-29,35
Edinburgh Ci,309,9,7,9,20,36,65,-29,30
Cowdenbeath,309,10,5,10,21,24,54,-30,25
Montrose,310,1,24,7,5,61,35,26,79
Peterhead,310,2,24,4,8,78,38,40,76
Stirling,310,3,17,6,13,63,52,11,57
Stenhousem'r,310,4,15,8,13,56,49,7,53
Clyde,310,5,14,9,13,53,51,2,51
Elgin,310,6,14,6,16,54,62,-8,48
Annan Athlet,310,7,11,11,14,49,44,5,44
Berwick,310,8,9,10,17,32,60,-28,37
Edinburgh Ci,310,9,7,9,20,36,61,-25,30
Cowdenbeath,310,10,5,10,21,26,56,-30,25
Montrose,311,1,24,7,5,60,34,26,79
Peterhead,311,2,24,4,8,79,38,41,76
Stirling,311,3,17,6,13,62,51,11,57
Stenhousem'r,311,4,15,8,13,55,48,7,53
Clyde,311,5,14,9,13,52,50,2,51
Elgin,311,6,14,6,16,53,61,-8,48
Annan Athlet,311,7,12,11,13,50,42,8,47
Berwick,311,8,9,10,17,31,59,-28,37
Edinburgh Ci,311,9,7,9,20,36,62,-26,30
Cowdenbeath,311,10,4,10,22,24,57,-33,22
Montrose,312,1,24,7,5,63,37,26,79
Peterhead,312,2,24,4,8,83,38,45,76
Stirling,312,3,17,6,13,62,51,11,57
Stenhousem'r,312,4,15,8,13,55,48,7,53
Clyde,312,5,14,9,13,51,53,-2,51
Elgin,312,6,14,6,16,56,64,-8,48
Annan Athlet,312,7,11,12,13,48,42,6,45
Berwick,312,8,9,10,17,34,58,-24,37
Edinburgh Ci,312,9,7,9,20,36,66,-30,30
Cowdenbeath,312,10,4,11,21,24,55,-31,23
Peterhead,313,1,24,4,8,79,38,41,76
Montrose,313,2,23,7,6,59,35,24,76
Stirling,313,3,17,6,13,62,51,11,57
Clyde,313,4,15,9,12,53,48,5,54
Stenhousem'r,313,5,15,8,13,55,48,7,53
Elgin,313,6,15,6,15,54,60,-6,51
Annan Athlet,313,7,11,12,13,48,42,6,45
Berwick,313,8,8,10,18,29,60,-31,34
Edinburgh Ci,313,9,7,9,20,36,62,-26,30
Cowdenbeath,313,10,4,11,21,24,55,-31,23
Montrose,314,1,24,7,5,63,34,29,79
Peterhead,314,2,24,4,8,80,39,41,76
Stirling,314,3,17,6,13,63,51,12,57
Clyde,314,4,15,9,12,53,48,5,54
Stenhousem'r,314,5,15,8,13,55,49,6,53
Elgin,314,6,14,6,16,53,64,-11,48
Annan Athlet,314,7,12,11,13,50,42,8,47
Berwick,314,8,8,10,18,29,60,-31,34
Edinburgh Ci,314,9,7,9,20,37,63,-26,30
Cowdenbeath,314,10,4,10,22,24,57,-33,22
Montrose,315,1,24,7,5,62,35,27,79
Peterhead,315,2,24,4,8,78,38,40,76
Stirling,315,3,16,7,13,61,52,9,55
Stenhousem'r,315,4,15,9,12,56,47,9,54
Clyde,315,5,14,9,13,51,51,0,51
Elgin,315,6,14,6,16,54,63,-9,48
Annan Athlet,315,7,12,11,13,49,42,7,47
Berwick,315,8,9,10,17,32,58,-26,37
Edinburgh Ci,315,9,7,9,20,36,61,-25,30
Cowdenbeath,315,10,4,10,22,24,56,-32,22
Montrose,316,1,24,7,5,62,35,27,79
Peterhead,316,2,23,5,8,79,40,39,74
Stirling,316,3,17,6,13,62,52,10,57
Stenhousem'r,316,4,15,8,13,56,48,8,53
Clyde,316,5,14,9,13,51,52,-1,51
Elgin,316,6,14,6,16,54,63,-9,48
Annan Athlet,316,7,12,11,13,50,42,8,47
Berwick,316,8,9,10,17,33,58,-25,37
Edinburgh Ci,316,9,7,10,19,38,62,-24,31
Cowdenbeath,316,10,4,10,22,24,57,-33,22
Montrose,317,1,24,7,5,62,35,27,79
Peterhead,317,2,24,4,8,78,38,40,76
Stirling,317,3,17,6,13,62,52,10,57
Clyde,317,4,15,9,12,53,49,4,54
Stenhousem'r,317,5,15,8,13,56,48,8,53
Elgin,317,6,14,6,16,54,63,-9,48
Annan Athlet,317,7,12,11,13,48,41,7,47
Berwick,317,8,8,10,18,30,60,-30,34
Edinburgh Ci,317,9,7,9,20,36,61,-25,30
Cowdenbeath,317,10,4,10,22,23,55,-32,22
Montrose,318,1,24,7,5,62,34,28,79
Peterhead,318,2,24,4,8,81,39,42,76
Stenhousem'r,318,3,16,8,12,58,48,10,56
Stirling,318,4,16,6,14,62,54,8,54
Clyde,318,5,15,9,12,53,48,5,54
Elgin,318,6,14,6,16,53,63,-10,48
Annan Athlet,318,7,12,11,13,48,41,7,47
Berwick,318,8,8,10,18,29,60,-31,34
Edinburgh Ci,318,9,7,9,20,37,64,-27,30
Cowdenbeath,318,10,4,10,22,23,55,-32,22
Montrose,319,1,24,7,5,62,34,28,79
Peterhead,319,2,24,4,8,78,38,40,76
Stirling,319,3,16,7,13,60,51,9,55
Stenhousem'r,319,4,15,9,12,55,46,9,54
Clyde,319,5,15,9,12,52,48,4,54
Elgin,319,6,14,6,16,53,63,-10,48
Annan Athlet,319,7,12,11,13,49,41,8,47
Berwick,319,8,8,10,18,29,59,-30,34
Edinburgh Ci,319,9,7,9,20,36,61,-25,30
Cowdenbeath,319,10,4,10,22,23,56,-33,22
Montrose,320,1,24,7,5,61,35,26,79
Peterhead,320,2,24,4,8,79,38,41,76
Stirling,320,3,16,7,13,61,52,9,55
Stenhousem'r,320,4,15,9,12,56,47,9,54
Clyde,320,5,15,9,12,54,49,5,54
Elgin,320,6,14,6,16,54,62,-8,48
Annan Athlet,320,7,11,12,13,47,41,6,45
Berwick,320,8,8,10,18,30,61,-31,34
Edinburgh Ci,320,9,7,9,20,36,62,-26,30
Cowdenbeath,320,10,4,11,21,23,54,-31,23
Peterhead,321,1,24,4,8,83,39,44,76
Montrose,321,2,23,7,6,60,36,24,76
Stirling,321,3,16,7,13,61,52,9,55
Stenhousem'r,321,4,15,9,12,56,47,9,54
Clyde,321,5,15,9,12,53,48,5,54
Elgin,321,6,15,6,15,55,61,-6,51
Annan Athlet,321,7,12,11,13,51,41,10,47
Berwick,321,8,8,10,18,29,60,-31,34
Edinburgh Ci,321,9,7,9,20,37,66,-29,30
Cowdenbeath,321,10,4,10,22,23,58,-35,22
Montrose,322,1,24,7,5,63,35,28,79
Peterhead,322,2,24,4,8,80,38,42,76
Stenhousem'r,322,3,16,8,12,58,47,11,56
Stirling,322,4,16,6,14,61,54,7,54
Clyde,322,5,14,10,12,53,50,3,52
Elgin,322,6,14,6,16,54,64,-10,48
Annan Athlet,322,7,11,12,13,48,42,6,45
Berwick,322,8,8,11,17,31,60,-29,35
Edinburgh Ci,322,9,7,9,20,36,63,-27,30
Cowdenbeath,322,10,4,11,21,24,55,-31,23
Montrose,323,1,23,8,5,59,34,25,77
Peterhead,323,2,24,4,8,80,39,41,76
Stirling,323,3,16,7,13,62,53,9,55
Stenhousem'r,323,4,15,9,12,57,48,9,54
Clyde,323,5,15,9,12,54,49,5,54
Elgin,323,6,14,7,15,53,60,-7,49
Annan Athlet,323,7,12,11,13,49,41,8,47
Berwick,323,8,8,10,18,30,61,-31,34
Edinburgh Ci,323,9,7,9,20,37,63,-26,30
Cowdenbeath,323,10,4,10,22,23,56,-33,22
Montrose,324,1,23,8,5,59,34,25,77
Peterhead,324,2,23,5,8,79,40,39,74
Stirling,324,3,17,6,13,62,51,11,57
Stenhousem'r,324,4,15,8,13,55,48,7,53
Clyde,324,5,14,10,12,52,49,3,52
Elgin,324,6,14,7,15,53,60,-7,49
Annan Athlet,324,7,11,11,14,47,43,4,44
Berwick,324,8,8,11,17,30,59,-29,35
Edinburgh Ci,324,9,7,10,19,38,62,-24,31
Cowdenbeath,324,10,5,10,21,25,54,-29,25
Montrose,325,1,23,8,5,60,35,25,77
Peterhead,325,2,24,4,8,81,40,41,76
Stenhousem'r,325,3,16,8,12,58,48,10,56
Stirling,325,4,16,6,14,62,54,8,54
Clyde,325,5,14,9,13,52,51,1,51
Elgin,325,6,14,7,15,54,61,-7,49
Annan Athlet,325,7,11,12,13,47,41,6,45
Berwick,325,8,9,10,17,32,59,-27,37
Edinburgh Ci,325,9,7,9,20,38,64,-26,30
Cowdenbeath,325,10,4,11,21,23,54,-31,23
Montrose,326,1,24,7,5,62,35,27,79
Peterhead,326,2,23,4,9,77,39,38,73
Stirling,326,3,16,7,13,61,52,9,55
Stenhousem'r,326,4,15,9,12,56,47,9,54
Clyde,326,5,15,9,12,54,50,4,54
Elgin,326,6,14,6,16,54,63,-9,48
Annan Athlet,326,7,11,12,13,47,41,6,45
Berwick,326,8,8,10,18,31,61,-30,34
Edinburgh Ci,326,9,8,9,19,37,60,-23,33
Cowdenbeath,326,10,4,11,21,23,54,-31,23
Montrose,327,1,24,7,5,64,34,30,79
Peterhead,327,2,24,4,8,80,40,40,76
Stirling,327,3,17,6,13,64,53,11,57
Stenhousem'r,327,4,15,8,13,57,50,7,53
Clyde,327,5,14,9,13,51,50,1,51
Elgin,327,6,14,6,16,53,65,-12,48
Annan Athlet,327,7,11,12,13,48,42,6,45
Berwick,327,8,9,10,17,31,58,-27,37
Edinburgh Ci,327,9,7,9,20,38,63,-25,30
Cowdenbeath,327,10,4,11,21,24,55,-31,23
Montrose,328,1,24,7,5,62,36,26,79
Peterhead,328,2,24,4,8,80,39,41,76
Stirling,328,3,17,6,13,63,51,12,57
Stenhousem'r,328,4,15,8,13,55,49,6,53
Clyde,328,5,14,10,12,52,49,3,52
Elgin,328,6,14,6,16,55,63,-8,48
Annan Athlet,328,7,12,11,13,49,41,8,47
Berwick,328,8,8,11,17,30,59,-29,35
Edinburgh Ci,328,9,7,9,20,37,63,-26,30
Cowdenbeath,328,10,4,10,22,23,56,-33,22
Peterhead,329,1,24,4,8,79,38,41,76
Montrose,329,2,23,7,6,60,38,22,76
Stirling,329,3,16,7,13,61,52,9,55
Stenhousem'r,329,4,15,9,12,56,47,9,54
Clyde,329,5,15,9,12,55,50,5,54
Elgin,329,6,15,6,15,57,61,-4,51
Annan Athlet,329,7,12,11,13,49,41,8,47
Berwick,329,8,8,10,18,31,62,-31,34
Edinburgh Ci,329,9,7,9,20,36,62,-26,30
Cowdenbeath,329,10,4,10,22,23,56,-33,22
Montrose,330,1,23,8,5,60,35,25,77
Peterhead,330,2,24,4,8,79,38,41,76
Stirling,330,3,16,7,13,62,53,9,55
Stenhousem'r,330,4,15,9,12,57,48,9,54
Clyde,330,5,14,10,12,52,49,3,52
Elgin,330,6,14,7,15,54,61,-7,49
Annan Athlet,330,7,11,11,14,49,44,5,44
Berwick,330,8,8,11,17,30,59,-29,35
Edinburgh Ci,330,9,7,9,20,36,62,-26,30
Cowdenbeath,330,10,5,10,21,26,56,-30,25
Montrose,331,1,24,7,5,65,34,31,79
Peterhead,331,2,24,4,8,81,38,43,76
Stenhousem'r,331,3,16,8,12,57,47,10,56
Stirling,331,4,16,6,14,61,53,8,54
Clyde,331,5,14,9,13,51,49,2,51
Elgin,331,6,14,6,16,53,66,-13,48
Annan Athlet,331,7,12,11,13,49,41,8,47
Berwick,331,8,9,10,17,30,58,-28,37
Edinburgh Ci,331,9,7,9,20,36,64,-28,30
Cowdenbeath,331,10,4,10,22,23,56,-33,22
Montrose,332,1,24,7,5,62,34,28,79
Peterhead,332,2,24,4,8,78,38,40,76
Stirling,332,3,17,6,13,61,51,10,57
Stenhousem'r,332,4,15,8,13,55,47,8,53
Clyde,332,5,14,9,13,51,50,1,51
Elgin,332,6,14,6,16,53,63,-10,48
Annan Athlet,332,7,12,11,13,48,41,7,47
Berwick,332,8,9,10,17,31,58,-27,37
Edinburgh Ci,332,9,7,9,20,36,61,-25,30
Cowdenbeath,332,10,4,10,22,23,55,-32,22
Montrose,333,1,23,8,5,60,35,25,77
Peterhead,333,2,24,4,8,78,38,40,76
Stirling,333,3,16,7,13,62,53,9,55
Stenhousem'r,333,4,15,9,12,57,48,9,54
Clyde,333,5,15,9,12,52,48,4,54
Elgin,333,6,14,7,15,54,61,-7,49
Annan Athlet,333,7,11,11,14,47,42,5,44
Berwick,333,8,8,10,18,29,59,-30,34
Edinburgh Ci,333,9,7,9,20,36,61,-25,30
Cowdenbeath,333,10,5,10,21,24,54,-30,25
Montrose,334,1,24,7,5,61,35,26,79
Peterhead,334,2,24,4,8,82,38,44,76
Stirling,334,3,17,6,13,63,52,11,57
Clyde,334,4,15,9,12,52,48,4,54
Stenhousem'r,334,5,15,8,13,56,49,7,53
Elgin,334,6,14,6,16,54,62,-8,48
Annan Athlet,334,7,11,12,13,48,42,6,45
Berwick,334,8,8,10,18,29,59,-30,34
Edinburgh Ci,334,9,7,9,20,36,65,-29,30
Cowdenbeath,334,10,4,11,21,24,55,-31,23
Montrose,335,1,24,7,5,62,35,27,79
Peterhead,335,2,24,4,8,78,38,40,76
Stenhousem'r,335,3,16,8,12,56,46,10,56
Stirling,335,4,16,6,14,60,52,8,54
Clyde,335,5,14,10,12,52,49,3,52
Elgin,335,6,14,6,16,54,63,-9,48
Annan Athlet,335,7,11,11,14,49,45,4,44
Berwick,335,8,8,11,17,30,59,-29,35
Edinburgh Ci,335,9,7,9,20,36,61,-25,30
Cowdenbeath,335,10,5,10,21,27,56,-29,25
Montrose,336,1,24,7,5,61,35,26,79
Peterhead,336,2,24,4,8,79,38,41,76
Stenhousem'r,336,3,16,8,12,58,47,11,56
Stirling,336,4,16,6,14,61,54,7,54
Clyde,336,5,14,10,12,51,48,3,52
Elgin,336,6,14,6,16,54,62,-8,48
Annan Athlet,336,7,12,11,13,49,42,7,47
Berwick,336,8,8,11,17,29,58,-29,35
Edinburgh Ci,336,9,7,9,20,36,62,-26,30
Cowdenbeath,336,10,4,10,22,24,56,-32,22
Montrose,337,1,24,7,5,61,35,26,79
Peterhead,337,2,24,4,8,80,39,41,76
Stenhousem'r,337,3,16,8,12,57,47,10,56
Stirling,337,4,16,6,14,61,53,8,54
Clyde,337,5,14,10,12,52,49,3,52
Elgin,337,6,14,6,16,54,62,-8,48
Annan Athlet,337,7,11,12,13,47,41,6,45
Berwick,337,8,8,11,17,30,59,-29,35
Edinburgh Ci,337,9,7,9,20,37,63,-26,30
Cowdenbeath,337,10,4,11,21,23,54,-31,23
Montrose,338,1,24,7,5,61,34,27,79
Peterhead,338,2,24,4,8,79,39,40,76
Stirling,338,3,16,7,13,60,51,9,55
Stenhousem'r,338,4,15,9,12,55,46,9,54
Clyde,338,5,14,10,12,52,49,3,52
Elgin,338,6,14,6,16,53,62,-9,48
Annan Athlet,338,7,11,11,14,47,42,5,44
Berwick,338,8,8,11,17,30,59,-29,35
Edinburgh Ci,338,9,7,9,20,37,62,-25,30
Cowdenbeath,338,10,5,10,21,24,54,-30,25
Montrose,339,1,24,7,5,62,35,27,79
Peterhead,339,2,24,4,8,82,38,44,76
Stirling,339,3,17,6,13,61,51,10,57
Clyde,339,4,15,9,12,55,48,7,54
Stenhousem'r,339,5,15,8,13,55,47,8,53
Elgin,339,6,14,6,16,54,63,-9,48
Annan Athlet,339,7,11,12,13,48,42,6,45
Berwick,339,8,8,10,18,29,62,-33,34
Edinburgh Ci,339,9,7,9,20,36,65,-29,30
Cowdenbeath,339,10,4,11,21,24,55,-31,23
Montrose,340,1,24,7,5,61,35,26,79
Peterhead,340,2,24,4,8,78,38,40,76
Stirling,340,3,17,6,13,61,51,10,57
Stenhousem'r,340,4,15,8,13,55,47,8,53
Clyde,340,5,14,9,13,51,49,2,51
Elgin,340,6,14,6,16,54,62,-8,48
Annan Athlet,340,7,11,11,14,48,43,5,44
Berwick,340,8,9,10,17,30,58,-28,37
Edinburgh Ci,340,9,7,9,20,36,61,-25,30
Cowdenbeath,340,10,5,10,21,25,55,-30,25
Montrose,341,1,23,8,5,60,35,25,77
Peterhead,341,2,24,4,8,79,38,41,76
Stirling,341,3,17,6,13,62,52,10,57
Clyde,341,4,15,9,12,53,49,4,54
Stenhousem'r,341,5,15,8,13,56,48,8,53
Elgin,341,6,14,7,15,54,61,-7,49
Annan Athlet,341,7,11,11,14,47,42,5,44
Berwick,341,8,8,10,18,30,60,-30,34
Edinburgh Ci,341,9,7,9,20,36,62,-26,30
Cowdenbeath,341,10,5,10,21,24,54,-30,25
Montrose,342,1,24,7,5,63,36,27,79
Peterhead,342,2,24,4,8,81,39,42,76
Stirling,342,3,17,6,13,61,51,10,57
Stenhousem'r,342,4,15,8,13,55,47,8,53
Clyde,342,5,14,10,12,52,49,3,52
Elgin,342,6,14,6,16,55,64,-9,48
Annan Athlet,342,7,12,11,13,49,41,8,47
Berwick,342,8,8,11,17,30,59,-29,35
Edinburgh Ci,342,9,7,9,20,37,64,-27,30
Cowdenbeath,342,10,4,10,22,23,56,-33,22
Montrose,343,1,24,7,5,63,37,26,79
Peterhead,343,2,23,5,8,77,38,39,74
Stirling,343,3,17,6,13,64,51,13,57
Clyde,343,4,15,9,12,53,49,4,54
Stenhousem'r,343,5,15,8,13,55,50,5,53
Elgin,343,6,14,6,16,56,64,-8,48
Annan Athlet,343,7,12,11,13,48,41,7,47
Berwick,343,8,8,10,18,30,60,-30,34
Edinburgh Ci,343,9,7,10,19,36,60,-24,31
Cowdenbeath,343,10,4,10,22,23,55,-32,22
Montrose,344,1,24,7,5,63,37,26,79
Peterhead,344,2,24,4,8,79,38,41,76
Stirling,344,3,17,6,13,63,53,10,57
Stenhousem'r,344,4,15,8,13,57,49,8,53
Clyde,344,5,14,9,13,52,50,2,51
Elgin,344,6,14,6,16,56,64,-8,48
Annan Athlet,344,7,12,11,13,49,41,8,47
Berwick,344,8,9,10,17,31,59,-28,37
Edinburgh Ci,344,9,7,9,20,36,62,-26,30
Cowdenbeath,344,10,4,10,22,23,56,-33,22
Montrose,345,1,24,7,5,62,35,27,79
Peterhead,345,2,23,5,8,78,39,39,74
Stirling,345,3,17,6,13,63,51,12,57
Clyde,345,4,15,9,12,54,49,5,54
Stenhousem'r,345,5,15,8,13,55,49,6,53
Elgin,345,6,14,6,16,54,63,-9,48
Annan Athlet,345,7,11,11,14,47,43,4,44
Berwick,345,8,8,10,18,30,61,-31,34
Edinburgh Ci,345,9,7,10,19,37,61,-24,31
Cowdenbeath,345,10,5,10,21,25,54,-29,25
Montrose,346,1,24,7,5,62,34,28,79
Peterhead,346,2,23,5,8,78,39,39,74
Stirling,346,3,17,6,13,61,51,10,57
Clyde,346,4,15,9,12,52,48,4,54
Stenhousem'r,346,5,15,8,13,55,47,8,53
Elgin,346,6,14,6,16,53,63,-10,48
Annan Athlet,346,7,12,11,13,50,42,8,47
Berwick,346,8,8,10,18,29,59,-30,34
Edinburgh Ci,346,9,7,10,19,37,61,-24,31
Cowdenbeath,346,10,4,10,22,24,57,-33,22
Montrose,347,1,24,7,5,61,34,27,79
Peterhead,347,2,24,4,8,81,40,41,76
Stirling,347,3,17,6,13,64,54,10,57
Stenhousem'r,347,4,15,8,13,58,50,8,53
Clyde,347,5,14,9,13,51,49,2,51
Elgin,347,6,14,6,16,53,62,-9,48
Annan Athlet,347,7,12,11,13,48,41,7,47
Berwick,347,8,9,10,17,30,58,-28,37
Edinburgh Ci,347,9,7,9,20,38,64,-26,30
Cowdenbeath,347,10,4,10,22,23,55,-32,22
Montrose,348,1,23,8,5,60,35,25,77
Peterhead,348,2,24,4,8,81,38,43,76
Stirling,348,3,16,7,13,62,53,9,55
Stenhousem'r,348,4,15,9,12,57,48,9,54
Clyde,348,5,14,9,13,52,50,2,51
Elgin,348,6,14,7,15,54,61,-7,49
Annan Athlet,348,7,11,12,13,48,42,6,45
Berwick,348,8,9,10,17,31,59,-28,37
Edinburgh Ci,348,9,7,9,20,36,64,-28,30
Cowdenbeath,348,10,4,11,21,24,55,-31,23
Montrose,349,1,24,7,5,64,36,28,79
Peterhead,349,2,24,4,8,82,39,43,76
Stirling,349,3,16,7,13,62,53,9,55
Stenhousem'r,349,4,15,9,12,57,48,9,54
Clyde,349,5,15,9,12,54,49,5,54
Elgin,349,6,14,6,16,55,65,-10,48
Annan Athlet,349,7,11,12,13,49,43,6,45
Berwick,349,8,8,10,18,30,61,-31,34
Edinburgh Ci,349,9,7,9,20,37,65,-28,30
Cowdenbeath,349,10,4,11,21,25,56,-31,23
Montrose,350,1,24,7,5,63,34,29,79
Peterhead,350,2,24,4,8,78,38,40,76
Stirling,350,3,17,6,13,63,51,12,57
Clyde,350,4,15,9,12,54,48,6,54
Stenhousem'r,350,5,15,8,13,55,49,6,53
Elgin,350,6,14,6,16,53,64,-11,48
Annan Athlet,350,7,12,11,13,51,43,8,47
Berwick,350,8,8,10,18,29,61,-32,34
Edinburgh Ci,350,9,7,9,20,36,61,-25,30
Cowdenbeath,350,10,4,10,22,25,58,-33,22
Montrose,351,1,23,8,5,59,34,25,77
Peterhead,351,2,23,4,9,79,41,38,73
Stirling,351,3,17,6,13,62,52,10,57
Clyde,351,4,15,9,12,55,50,5,54
Stenhousem'r,351,5,15,8,13,56,48,8,53
Elgin,351,6,14,7,15,53,60,-7,49
Annan Athlet,351,7,12,11,13,49,42,7,47
Berwick,351,8,8,10,18,31,62,-31,34
Edinburgh Ci,351,9,8,9,19,39,62,-23,33
Cowdenbeath,351,10,4,10,22,24,56,-32,22
Montrose,352,1,24,7,5,60,34,26,79
Peterhead,352,2,24,4,8,78,38,40,76
Stirling,352,3,17,6,13,64,51,13,57
Stenhousem'r,352,4,15,8,13,55,50,5,53
Clyde,352,5,14,10,12,51,48,3,52
Elgin,352,6,14,6,16,53,61,-8,48
Annan Athlet,352,7,12,11,13,50,41,9,47
Berwick,352,8,8,11,17,29,58,-29,35
Edinburgh Ci,352,9,7,9,20,36,61,-25,30
Cowdenbeath,352,10,4,10,22,23,57,-34,22
Montrose,353,1,23,8,5,60,35,25,77
Peterhead,353,2,24,4,8,82,39,43,76
Stenhousem'r,353,3,16,8,12,58,46,12,56
Stirling,353,4,16,6,14,60,54,6,54
Clyde,353,5,14,9,13,52,50,2,51
Elgin,353,6,14,7,15,54,61,-7,49
Annan Athlet,353,7,11,11,14,47,43,4,44
Berwick,353,8,9,10,17,31,59,-28,37
Edinburgh Ci,353,9,7,9,20,37,65,-28,30
Cowdenbeath,353,10,5,10,21,25,54,-29,25
Peterhead,354,1,24,4,8,79,38,41,76
Montrose,354,2,23,7,6,59,36,23,76
Stenhousem'r,354,3,16,8,12,57,46,11,56
Clyde,354,4,15,9,12,57,49,8,54
Stirling,354,5,16,6,14,60,53,7,54
Elgin,354,6,15,6,15,55,60,-5,51
Annan Athlet,354,7,11,11,14,47,43,4,44
Berwick,354,8,8,10,18,30,64,-34,34
Edinburgh Ci,354,9,7,9,20,36,62,-26,30
Cowdenbeath,354,10,5,10,21,25,54,-29,25
Peterhead,355,1,24,4,8,80,38,42,76
Montrose,355,2,23,7,6,59,35,24,76
Stirling,355,3,17,6,13,62,52,10,57
Stenhousem'r,355,4,15,8,13,56,48,8,53
Clyde,355,5,14,10,12,52,49,3,52
Elgin,355,6,15,6,15,54,60,-6,51
Annan Athlet,355,7,11,12,13,47,41,6,45
Berwick,355,8,8,11,17,30,59,-29,35
Edinburgh Ci,355,9,7,9,20,36,63,-27,30
Cowdenbeath,355,10,4,11,21,23,54,-31,23
Montrose,356,1,24,7,5,60,34,26,79
Peterhead,356,2,24,4,8,78,38,40,76
Stenhousem'r,356,3,16,8,12,58,46,12,56
Stirling,356,4,16,6,14,60,54,6,54
Clyde,356,5,15,9,12,54,49,5,54
Elgin,356,6,14,6,16,53,61,-8,48
Annan Athlet,356,7,12,11,13,48,41,7,47
Berwick,356,8,8,10,18,30,61,-31,34
Edinburgh Ci,356,9,7,9,20,36,61,-25,30
Cowdenbeath,356,10,4,10,22,23,55,-32,22
Montrose,357,1,23,8,5,60,35,25,77
Peterhead,357,2,24,4,8,81,38,43,76
Stenhousem'r,357,3,16,8,12,58,48,10,56
Stirling,357,4,16,6,14,62,54,8,54
Clyde,357,5,14,10,12,52,49,3,52
Elgin,357,6,14,7,15,54,61,-7,49
Annan Athlet,357,7,12,11,13,50,42,8,47
Berwick,357,8,8,11,17,30,59,-29,35
Edinburgh Ci,357,9,7,9,20,36,64,-28,30
Cowdenbeath,357,10,4,10,22,24,57,-33,22
Montrose,358,1,23,8,5,60,35,25,77
Peterhead,358,2,24,4,8,79,38,41,76
Stirling,358,3,17,6,13,64,54,10,57
Clyde,358,4,15,9,12,52,48,4,54
Stenhousem'r,358,5,15,8,13,58,50,8,53
Elgin,358,6,14,7,15,54,61,-7,49
Annan Athlet,358,7,11,12,13,48,42,6,45
Berwick,358,8,8,10,18,29,59,-30,34
Edinburgh Ci,358,9,7,9,20,36,62,-26,30
Cowdenbeath,358,10,4,11,21,24,55,-31,23
Montrose,359,1,24,7,5,62,34,28,79
Peterhead,359,2,24,4,8,81,38,43,76
Stirling,359,3,16,7,13,61,52,9,55
Stenhousem'r,359,4,15,9,12,56,47,9,54
Clyde,359,5,15,9,12,53,48,5,54
Elgin,359,6,14,6,16,53,63,-10,48
Annan Athlet,359,7,11,12,13,48,42,6,45
Berwick,359,8,8,10,18,29,60,-31,34
Edinburgh Ci,359,9,7,9,20,36,64,-28,30
Cowdenbeath,359,10,4,11,21,24,55,-31,23
Montrose,360,1,24,7,5,63,35,28,79
Peterhead,360,2,23,4,9,78,40,38,73
Stirling,360,3,17,6,13,63,53,10,57
Clyde,360,4,15,9,12,55,50,5,54
Stenhousem'r,360,5,15,8,13,57,49,8,53
Elgin,360,6,14,6,16,54,64,-10,48
Annan Athlet,360,7,12,11,13,49,41,8,47
Berwick,360,8,8,10,18,31,62,-31,34
Edinburgh Ci,360,9,8,9,19,38,61,-23,33
Cowdenbeath,360,10,4,10,22,23,56,-33,22
Montrose,361,1,24,7,5,63,34,29,79
Peterhead,361,2,24,4,8,80,39,41,76
Stirling,361,3,16,7,13,60,51,9,55
Stenhousem'r,361,4,15,9,12,55,46,9,54
Clyde,361,5,14,9,13,53,51,2,51
Elgin,361,6,14,6,16,53,64,-11,48
Annan Athlet,361,7,12,11,13,50,43,7,47
Berwick,361,8,9,10,17,32,60,-28,37
Edinburgh Ci,361,9,7,9,20,37,63,-26,30
Cowdenbeath,361,10,4,10,22,25,57,-32,22
Montrose,362,1,24,7,5,62,36,26,79
Peterhead,362,2,24,4,8,79,38,41,76
Stenhousem'r,362,3,16,8,12,56,46,10,56
Stirling,362,4,16,6,14,60,52,8,54
Clyde,362,5,15,9,12,53,49,4,54
Elgin,362,6,14,6,16,55,63,-8,48
Annan Athlet,362,7,11,12,13,48,42,6,45
Berwick,362,8,8,10,18,30,60,-30,34
Edinburgh Ci,362,9,7,9,20,36,62,-26,30
Cowdenbeath,362,10,4,11,21,24,55,-31,23
Montrose,363,1,24,7,5,61,35,26,79
Peterhead,363,2,24,4,8,81,40,41,76
Stirling,363,3,16,7,13,61,52,9,55
Stenhousem'r,363,4,15,9,12,56,47,9,54
Clyde,363,5,15,9,12,53,48,5,54
Elgin,363,6,14,6,16,54,62,-8,48
Annan Athlet,363,7,11,12,13,47,41,6,45
Berwick,363,8,8,10,18,29,60,-31,34
Edinburgh Ci,363,9,7,9,20,38,64,-26,30
Cowdenbeath,363,10,4,11,21,23,54,-31,23
Peterhead,364,1,24,4,8,78,38,40,76
Montrose,364,2,23,7,6,59,35,24,76
Stenhousem'r,364,3,16,8,12,57,47,10,56
Stirling,364,4,16,6,14,61,53,8,54
Clyde,364,5,14,9,13,51,51,0,51
Elgin,364,6,15,6,15,54,60,-6,51
Annan Athlet,364,7,12,11,13,48,41,7,47
Berwick,364,8,9,10,17,32,58,-26,37
Edinburgh Ci,364,9,7,9,20,36,61,-25,30
Cowdenbeath,364,10,4,10,22,23,55,-32,22
Montrose,365,1,24,7,5,63,35,28,79
Peterhead,365,2,24,4,8,80,38,42,76
Stirling,365,3,16,7,13,60,51,9,55
Stenhousem'r,365,4,15,9,12,55,46,9,54
Clyde,365,5,14,10,12,52,49,3,52
Elgin,365,6,14,6,16,54,64,-10,48
Annan Athlet,365,7,12,11,13,48,41,7,47
Berwick,365,8,8,11,17,30,59,-29,35
Edinburgh Ci,365,9,7,9,20,36,63,-27,30
Cowdenbeath,365,10,4,10,22,23,55,-32,22
Peterhead,366,1,24,4,8,81,38,43,76
Montrose,366,2,23,7,6,61,37,24,76
Stirling,366,3,17,6,13,61,51,10,57
Clyde,366,4,15,9,12,53,49,4,54
Stenhousem'r,366,5,15,8,13,55,47,8,53
Elgin,366,6,15,6,15,56,62,-6,51
Annan Athlet,366,7,11,12,13,48,42,6,45
Berwick,366,8,8,10,18,30,60,-30,34
Edinburgh Ci,366,9,7,9,20,36,64,-28,30
Cowdenbeath,366,10,4,11,21,24,55,-31,23
Peterhead,367,1,24,4,8,80,40,40,76
Montrose,367,2,23,7,6,60,36,24,76
Stirling,367,3,17,6,13,62,51,11,57
Clyde,367,4,15,9,12,55,51,4,54
Stenhousem'r,367,5,15,8,13,55,48,7,53
Elgin,367,6,15,6,15,55,61,-6,51
Annan Athlet,367,7,12,11,13,49,41,8,47
Berwick,367,8,8,10,18,32,62,-30,34
Edinburgh Ci,367,9,7,9,20,38,63,-25,30
Cowdenbeath,367,10,4,10,22,23,56,-33,22
Montrose,368,1,23,7,6,59,36,23,76
Peterhead,368,2,23,5,8,78,39,39,74
Stirling,368,3,17,6,13,64,52,12,57
Clyde,368,4,15,9,12,53,49,4,54
Stenhousem'r,368,5,15,8,13,56,50,6,53
Elgin,368,6,15,6,15,55,60,-5,51
Annan Athlet,368,7,12,11,13,49,42,7,47
Berwick,368,8,8,10,18,30,60,-30,34
Edinburgh Ci,368,9,7,10,19,37,61,-24,31
Cowdenbeath,368,10,4,10,22,24,56,-32,22
Montrose,369,1,23,8,5,60,35,25,77
Peterhead,369,2,24,4,8,79,38,41,76
Stenhousem'r,369,3,16,8,12,58,47,11,56
Stirling,369,4,16,6,14,61,54,7,54
Clyde,369,5,14,9,13,52,51,1,51
Elgin,369,6,14,7,15,54,61,-7,49
Annan Athlet,369,7,11,11,14,49,44,5,44
Berwick,369,8,9,10,17,32,59,-27,37
Edinburgh Ci,369,9,7,9,20,36,62,-26,30
Cowdenbeath,369,10,5,10,21,26,56,-30,25
Montrose,370,1,24,7,5,65,34,31,79
Peterhead,370,2,24,4,8,81,38,43,76
Stirling,370,3,16,7,13,61,52,9,55
Stenhousem'r,370,4,15,9,12,56,47,9,54
Clyde,370,5,15,9,12,52,48,4,54
Elgin,370,6,14,6,16,53,66,-13,48
Annan Athlet,370,7,12,11,13,50,42,8,47
Berwick,370,8,8,10,18,29,59,-30,34
Edinburgh Ci,370,9,7,9,20,36,64,-28,30
Cowdenbeath,370,10,4,10,22,24,57,-33,22
Montrose,371,1,24,7,5,63,35,28,79
Peterhead,371,2,24,4,8,82,39,43,76
Stirling,371,3,16,7,13,62,53,9,55
Stenhousem'r,371,4,15,9,12,57,48,9,54
Clyde,371,5,15,9,12,55,48,7,54
Elgin,371,6,14,6,16,54,64,-10,48
Annan Athlet,371,7,11,11,14,47,42,5,44
Berwick,371,8,8,10,18,29,62,-33,34
Edinburgh Ci,371,9,7,9,20,37,65,-28,30
Cowdenbeath,371,10,5,10,21,24,54,-30,25
Peterhead,372,1,24,4,8,80,38,42,76
Montrose,372,2,23,7,6,60,36,24,76
Stenhousem'r,372,3,16,8,12,57,46,11,56
Stirling,372,4,16,6,14,60,53,7,54
Clyde,372,5,15,9,12,52,48,4,54
Elgin,372,6,15,6,15,55,61,-6,51
Annan Athlet,372,7,11,12,13,48,42,6,45
Berwick,372,8,8,10,18,29,59,-30,34
Edinburgh Ci,372,9,7,9,20,36,63,-27,30
Cowdenbeath,372,10,4,11,21,24,55,-31,23
Montrose,373,1,24,7,5,62,35,27,79
Peterhead,373,2,23,5,8,80,41,39,74
Stirling,373,3,16,7,13,62,53,9,55
Stenhousem'r,373,4,15,9,12,57,48,9,54
Clyde,373,5,14,10,12,53,50,3,52
Elgin,373,6,14,6,16,54,63,-9,48
Annan Athlet,373,7,12,11,13,48,41,7,47
Berwick,373,8,8,11,17,31,60,-29,35
Edinburgh Ci,373,9,7,10,19,39,63,-24,31
Cowdenbeath,373,10,4,10,22,23,55,-32,22
Montrose,374,1,23,8,5,60,35,25,77
Peterhead,374,2,24,4,8,79,39,40,76
Stirling,374,3,16,7,13,60,51,9,55
Stenhousem'r,374,4,15,9,12,55,46,9,54
Clyde,374,5,14,9,13,53,51,2,51
Elgin,374,6,14,7,15,54,61,-7,49
Annan Athlet,374,7,12,11,13,50,41,9,47
Berwick,374,8,9,10,17,32,60,-28,37
Edinburgh Ci,374,9,7,9,20,37,62,-25,30
Cowdenbeath,374,10,4,10,22,23,57,-34,22
Montrose,375,1,24,7,5,61,35,26,79
Peterhead,375,2,24,4,8,81,40,41,76
Stirling,375,3,17,6,13,63,53,10,57
Clyde,375,4,15,9,12,54,48,6,54
Stenhousem'r,375,5,15,8,13,57,49,8,53
Elgin,375,6,14,6,16,54,62,-8,48
Annan Athlet,375,7,12,11,13,49,41,8,47
Berwick,375,8,8,10,18,29,61,-32,34
Edinburgh Ci,375,9,7,9,20,38,64,-26,30
Cowdenbeath,375,10,4,10,22,23,56,-33,22
Montrose,376,1,24,7,5,60,34,26,79
Peterhead,376,2,23,5,8,78,39,39,74
Stirling,376,3,16,7,13,62,53,9,55
Stenhousem'r,376,4,15,9,12,57,48,9,54
Clyde,376,5,15,9,12,54,48,6,54
Elgin,376,6,14,6,16,53,61,-8,48
Annan Athlet,376,7,11,12,13,49,43,6,45
Berwick,376,8,8,10,18,29,61,-32,34
Edinburgh Ci,376,9,7,10,19,37,61,-24,31
Cowdenbeath,376,10,4,11,21,25,56,-31,23
Montrose,377,1,24,7,5,61,34,27,79
Peterhead,377,2,24,4,8,79,39,40,76
Stirling,377,3,17,6,13,63,52,11,57
Stenhousem'r,377,4,15,8,13,56,49,7,53
Clyde,377,5,14,9,13,51,49,2,51
Elgin,377,6,14,6,16,53,62,-9,48
Annan Athlet,377,7,11,11,14,47,44,3,44
Berwick,377,8,9,10,17,30,58,-28,37
Edinburgh Ci,377,9,7,9,20,37,62,-25,30
Cowdenbeath,377,10,5,10,21,26,54,-28,25
Peterhead,378,1,24,4,8,80,38,42,76
Montrose,378,2,23,7,6,59,38,21,76
Stirling,378,3,16,7,13,60,51,9,55
Stenhousem'r,378,4,15,9,12,55,46,9,54
Clyde,378,5,14,10,12,51,48,3,52
Elgin,378,6,15,6,15,57,60,-3,51
Annan Athlet,378,7,11,11,14,48,43,5,44
Berwick,378,8,8,11,17,29,58,-29,35
Edinburgh Ci,378,9,7,9,20,36,63,-27,30
Cowdenbeath,378,10,5,10,21,25,55,-30,25
Montrose,379,1,23,8,5,60,35,25,77
Peterhead,379,2,24,4,8,83,38,45,76
Stirling,379,3,16,7,13,62,53,9,55
Stenhousem'r,379,4,15,9,12,57,48,9,54
Clyde,379,5,14,9,13,52,50,2,51
Elgin,379,6,14,7,15,54,61,-7,49
Annan Athlet,379,7,11,11,14,47,42,5,44
Berwick,379,8,9,10,17,31,59,-28,37
Edinburgh Ci,379,9,7,9,20,36,66,-30,30
Cowdenbeath,379,10,5,10,21,24,54,-30,25
Peterhead,380,1,24,4,8,79,38,41,76
Montrose,380,2,23,7,6,60,36,24,76
Stirling,380,3,16,7,13,62,53,9,55
Stenhousem'r,380,4,15,9,12,57,48,9,54
Clyde,380,5,15,9,12,52,48,4,54
Elgin,380,6,15,6,15,55,61,-6,51
Annan Athlet,380,7,11,11,14,47,43,4,44
Berwick,380,8,8,10,18,29,59,-30,34
Edinburgh Ci,380,9,7,9,20,36,62,-26,30
Cowdenbeath,380,10,5,10,21,25,54,-29,25
Montrose,381,1,24,7,5,62,35,27,79
Peterhead,381,2,24,4,8,81,39,42,76
Stirling,381,3,17,6,13,64,51,13,57
Clyde,381,4,15,9,12,52,48,4,54
Stenhousem'r,381,5,15,8,13,55,50,5,53
Elgin,381,6,14,6,16,54,63,-9,48
Annan Athlet,381,7,12,11,13,52,44,8,47
Berwick,381,8,8,10,18,29,59,-30,34
Edinburgh Ci,381,9,7,9,20,37,64,-27,30
Cowdenbeath,381,10,4,10,22,26,59,-33,22
Montrose,382,1,24,7,5,61,35,26,79
Peterhead,382,2,24,4,8,81,38,43,76
Stirling,382,3,16,7,13,61,52,9,55
Stenhousem'r,382,4,15,9,12,56,47,9,54
Clyde,382,5,14,10,12,51,48,3,52
Elgin,382,6,14,6,16,54,62,-8,48
Annan Athlet,382,7,11,12,13,48,42,6,45
Berwick,382,8,8,11,17,29,58,-29,35
Edinburgh Ci,382,9,7,9,20,36,64,-28,30
Cowdenbeath,382,10,4,11,21,24,55,-31,23
Montrose,383,1,24,7,5,62,35,27,79
Peterhead,383,2,24,4,8,79,38,41,76
Stirling,383,3,16,7,13,61,52,9,55
Stenhousem'r,383,4,15,9,12,56,47,9,54
Clyde,383,5,15,9,12,54,49,5,54
Elgin,383,6,14,6,16,54,63,-9,48
Annan Athlet,383,7,11,11,14,47,42,5,44
Berwick,383,8,8,10,18,30,61,-31,34
Edinburgh Ci,383,9,7,9,20,36,62,-26,30
Cowdenbeath,383,10,5,10,21,24,54,-30,25
Montrose,384,1,23,8,5,60,35,25,77
Peterhead,384,2,24,4,8,82,39,43,76
Stenhousem'r,384,3,16,8,12,57,47,10,56
Stirling,384,4,16,6,14,61,53,8,54
Clyde,384,5,14,10,12,52,49,3,52
Elgin,384,6,14,7,15,54,61,-7,49
Annan Athlet,384,7,11,11,14,47,42,5,44
Berwick,384,8,8,11,17,30,59,-29,35
Edinburgh Ci,384,9,7,9,20,37,65,-28,30
Cowdenbeath,384,10,5,10,21,24,54,-30,25
Montrose,385,1,24,7,5,67,35,32,79
Peterhead,385,2,24,4,8,78,38,40,76
Stenhousem'r,385,3,16,8,12,56,46,10,56
Stirling,385,4,16,6,14,60,52,8,54
Clyde,385,5,15,9,12,54,50,4,54
Elgin,385,6,14,6,16,54,68,-14,48
Annan Athlet,385,7,12,11,13,48,41,7,47
Berwick,385,8,8,10,18,31,61,-30,34
Edinburgh Ci,385,9,7,9,20,36,61,-25,30
Cowdenbeath,385,10,4,10,22,23,55,-32,22
Montrose,386,1,23,8,5,60,35,25,77
Peterhead,386,2,23,5,8,78,39,39,74
Stirling,386,3,17,6,13,61,51,10,57
Clyde,386,4,15,9,12,52,48,4,54
Stenhousem'r,386,5,15,8,13,55,47,8,53
Elgin,386,6,14,7,15,54,61,-7,49
Annan Athlet,386,7,11,12,13,49,43,6,45
Berwick,386,8,8,10,18,29,59,-30,34
Edinburgh Ci,386,9,7,10,19,37,61,-24,31
Cowdenbeath,386,10,4,11,21,25,56,-31,23
Montrose,387,1,23,8,5,60,35,25,77
Peterhead,387,2,24,4,8,80,38,42,76
Stirling,387,3,16,7,13,61,52,9,55
Stenhousem'r,387,4,15,9,12,56,47,9,54
Clyde,387,5,14,10,12,52,49,3,52
Elgin,387,6,14,7,15,54,61,-7,49
Annan Athlet,387,7,12,11,13,50,43,7,47
Berwick,387,8,8,11,17,30,59,-29,35
Edinburgh Ci,387,9,7,9,20,36,63,-27,30
Cowdenbeath,387,10,4,10,22,25,57,-32,22
Peterhead,388,1,24,4,8,80,39,41,76
Montrose,388,2,23,7,6,60,36,24,76
Stenhousem'r,388,3,16,8,12,56,46,10,56
Stirling,388,4,16,6,14,60,52,8,54
Clyde,388,5,14,10,12,52,49,3,52
Elgin,388,6,15,6,15,55,61,-6,51
Annan Athlet,388,7,11,12,13,47,41,6,45
Berwick,388,8,8,11,17,30,59,-29,35
Edinburgh Ci,388,9,7,9,20,37,63,-26,30
Cowdenbeath,388,10,4,11,21,23,54,-31,23
Montrose,389,1,24,7,5,61,35,26,79
Peterhead,389,2,24,4,8,80,40,40,76
Stirling,389,3,16,7,13,61,52,9,55
Stenhousem'r,389,4,15,9,12,56,47,9,54
Clyde,389,5,15,9,12,54,50,4,54
Elgin,389,6,14,6,16,54,62,-8,48
Annan Athlet,389,7,11,11,14,47,42,5,44
Berwick,389,8,8,10,18,31,61,-30,34
Edinburgh Ci,389,9,7,9,20,38,63,-25,30
Cowdenbeath,389,10,5,10,21,24,54,-30,25
Montrose,390,1,24,7,5,62,34,28,79
Peterhead,390,2,23,5,8,79,40,39,74
Stirling,390,3,17,6,13,62,52,10,57
Clyde,390,4,15,9,12,56,50,6,54
Stenhousem'r,390,5,15,8,13,56,48,8,53
Elgin,390,6,14,6,16,53,63,-10,48
Annan Athlet,390,7,11,11,14,47,44,3,44
Berwick,390,8,8,10,18,31,63,-32,34
Edinburgh Ci,390,9,7,10,19,38,62,-24,31
Cowdenbeath,390,10,5,10,21,26,54,-28,25
Montrose,391,1,24,7,5,62,34,28,79
Peterhead,391,2,24,4,8,81,39,42,76
Stirling,391,3,17,6,13,63,52,11,57
Clyde,391,4,15,9,12,54,48,6,54
Stenhousem'r,391,5,15,8,13,56,49,7,53
Elgin,391,6,14,6,16,53,63,-10,48
Annan Athlet,391,7,11,11,14,47,43,4,44
Berwick,391,8,8,10,18,29,61,-32,34
Edinburgh Ci,391,9,7,9,20,37,64,-27,30
Cowdenbeath,391,10,5,10,21,25,54,-29,25
Montrose,392,1,23,7,6,60,36,24,76
Peterhead,392,2,23,5,8,78,39,39,74
Stirling,392,3,16,7,13,60,51,9,55
Stenhousem'r,392,4,15,9,12,55,46,9,54
Clyde,392,5,15,9,12,52,48,4,54
Elgin,392,6,15,6,15,55,61,-6,51
Annan Athlet,392,7,12,11,13,49,42,7,47
Berwick,392,8,8,10,18,29,59,-30,34
Edinburgh Ci,392,9,7,10,19,37,61,-24,31
Cowdenbeath,392,10,4,10,22,24,56,-32,22
Montrose,393,1,24,7,5,63,34,29,79
Peterhead,393,2,24,4,8,82,39,43,76
Stenhousem'r,393,3,16,8,12,59,49,10,56
Stirling,393,4,16,6,14,63,55,8,54
Clyde,393,5,15,9,12,54,48,6,54
Elgin,393,6,14,6,16,53,64,-11,48
Annan Athlet,393,7,11,11,14,47,42,5,44
Berwick,393,8,8,10,18,29,61,-32,34
Edinburgh Ci,393,9,7,9,20,37,65,-28,30
Cowdenbeath,393,10,5,10,21,24,54,-30,25
Montrose,394,1,24,7,5,63,34,29,79
Peterhead,394,2,24,4,8,80,39,41,76
Stirling,394,3,17,6,13,61,51,10,57
Clyde,394,4,15,9,12,53,48,5,54
Stenhousem'r,394,5,15,8,13,55,47,8,53
Elgin,394,6,14,6,16,53,64,-11,48
Annan Athlet,394,7,11,12,13,47,41,6,45
Berwick,394,8,8,10,18,29,60,-31,34
Edinburgh Ci,394,9,7,9,20,37,63,-26,30
Cowdenbeath,394,10,4,11,21,23,54,-31,23
Peterhead,395,1,24,4,8,79,39,40,76
Montrose,395,2,23,7,6,60,37,23,76
Stirling,395,3,17,6,13,63,51,12,57
Clyde,395,4,15,9,12,53,49,4,54
Stenhousem'r,395,5,15,8,13,55,49,6,53
Elgin,395,6,15,6,15,56,61,-5,51
Annan Athlet,395,7,11,12,13,48,42,6,45
Berwick,395,8,8,10,18,30,60,-30,34
Edinburgh Ci,395,9,7,9,20,37,62,-25,30
Cowdenbeath,395,10,4,11,21,24,55,-31,23
Montrose,396,1,24,7,5,63,36,27,79
Peterhead,396,2,24,4,8,80,38,42,76
Stirling,396,3,17,6,13,61,51,10,57
Stenhousem'r,396,4,15,8,13,55,47,8,53
Clyde,396,5,14,10,12,52,49,3,52
Elgin,396,6,14,6,16,55,64,-9,48
Annan Athlet,396,7,12,11,13,48,41,7,47
Berwick,396,8,8,11,17,30,59,-29,35
Edinburgh Ci,396,9,7,9,20,36,63,-27,30
Cowdenbeath,396,10,4,10,22,23,55,-32,22
Montrose,397,1,24,7,5,60,34,26,79
Peterhead,397,2,23,5,8,79,40,39,74
Stirling,397,3,17,6,13,62,52,10,57
Clyde,397,4,15,9,12,53,48,5,54
Stenhousem'r,397,5,15,8,13,56,48,8,53
Elgin,397,6,14,6,16,53,61,-8,48
Annan Athlet,397,7,11,12,13,47,41,6,45
Berwick,397,8,8,10,18,29,60,-31,34
Edinburgh Ci,397,9,7,10,19,38,62,-24,31
Cowdenbeath,397,10,4,11,21,23,54,-31,23
Montrose,398,1,23,8,5,60,35,25,77
Peterhead,398,2,24,4,8,81,38,43,76
Stirling,398,3,17,6,13,64,52,12,57
Clyde,398,4,15,9,12,52,48,4,54
Stenhousem'r,398,5,15,8,13,56,50,6,53
Elgin,398,6,14,7,15,54,61,-7,49
Annan Athlet,398,7,11,12,13,48,42,6,45
Berwick,398,8,8,10,18,29,59,-30,34
Edinburgh Ci,398,9,7,9,20,36,64,-28,30
Cowdenbeath,398,10,4,11,21,24,55,-31,23
Montrose,399,1,24,7,5,61,35,26,79
Peterhead,399,2,24,4,8,82,41,41,76
Stenhousem'r,399,3,16,8,12,58,46,12,56
Stirling,399,4,16,6,14,60,54,6,54
Clyde,399,5,14,9,13,51,49,2,51
Elgin,399,6,14,6,16,54,62,-8,48
Annan Athlet,399,7,11,11,14,47,42,5,44
Berwick,399,8,9,10,17,30,58,-28,37
Edinburgh Ci,399,9,7,9,20,39,65,-26,30
Cowdenbeath,399,10,5,10,21,24,54,-30,25
Montrose,400,1,24,7,5,63,34,29,79
Peterhead,400,2,24,4,8,78,38,40,76
Stirling,400,3,17,6,13,61,51,10,57
Clyde,400,4,15,9,12,53,49,4,54
Stenhousem'r,400,5,15,8,13,55,47,8,53
Elgin,400,6,14,6,16,53,64,-11,48
Annan Athlet,400,7,11,11,14,47,43,4,44
Berwick,400,8,8,10,18,30,60,-30,34
Edinburgh Ci,400,9,7,9,20,36,61,-25,30
Cowdenbeath,400,10,5,10,21,25,54,-29,25
Peterhead,401,1,24,4,8,81,39,42,76
Montrose,401,2,23,7,6,60,36,24,76
Stirling,401,3,17,6,13,63,53,10,57
Clyde,401,4,15,9,12,54,48,6,54
Stenhousem'r,401,5,15,8,13,57,49,8,53
Elgin,401,6,15,6,15,55,61,-6,51
Annan Athlet,401,7,11,11,14,47,42,5,44
Berwick,401,8,8,10,18,29,61,-32,34
Edinburgh Ci,401,9,7,9,20,37,64,-27,30
Cowdenbeath,401,10,5,10,21,24,54,-30,25
Montrose,402,1,24,7,5,65,34,31,79
Peterhead,402,2,24,4,8,79,39,40,76
Stenhousem'r,402,3,16,8,12,57,47,10,56
Stirling,402,4,16,6,14,61,53,8,54
Clyde,402,5,15,9,12,56,49,7,54
Elgin,402,6,14,6,16,53,66,-13,48
Annan Athlet,402,7,11,11,14,47,42,5,44
Berwick,402,8,8,10,18,30,63,-33,34
Edinburgh Ci,402,9,7,9,20,37,62,-25,30
Cowdenbeath,402,10,5,10,21,24,54,-30,25
Montrose,403,1,23,8,5,61,36,25,77
Peterhead,403,2,24,4,8,78,38,40,76
Stenhousem'r,403,3,16,8,12,58,47,11,56
Stirling,403,4,16,6,14,61,54,7,54
Clyde,403,5,14,10,12,52,49,3,52
Elgin,403,6,14,7,15,55,62,-7,49
Annan Athlet,403,7,11,11,14,49,44,5,44
Berwick,403,8,8,11,17,30,59,-29,35
Edinburgh Ci,403,9,7,9,20,36,61,-25,30
Cowdenbeath,403,10,5,10,21,26,56,-30,25
Montrose,404,1,24,7,5,62,34,28,79
Peterhead,404,2,24,4,8,82,38,44,76
Stirling,404,3,17,6,13,62,51,11,57
Clyde,404,4,15,9,12,53,49,4,54
Stenhousem'r,404,5,15,8,13,55,48,7,53
Elgin,404,6,14,6,16,53,63,-10,48
Annan Athlet,404,7,11,11,14,47,42,5,44
Berwick,404,8,8,10,18,30,60,-30,34
Edinburgh Ci,404,9,7,9,20,36,65,-29,30
Cowdenbeath,404,10,5,10,21,24,54,-30,25
Montrose,405,1,24,7,5,62,35,27,79
Peterhead,405,2,24,4,8,79,38,41,76
Stirling,405,3,17,6,13,62,51,11,57
Stenhousem'r,405,4,15,8,13,55,48,7,53
Clyde,405,5,14,9,13,51,50,1,51
Elgin,405,6,14,6,16,54,63,-9,48
Annan Athlet,405,7,12,11,13,48,41,7,47
Berwick,405,8,9,10,17,31,58,-27,37
Edinburgh Ci,405,9,7,9,20,36,62,-26,30
Cowdenbeath,405,10,4,10,22,23,55,-32,22
Montrose,406,1,24,7,5,63,35,28,79
Peterhead,406,2,24,4,8,82,38,44,76
Stirling,406,3,17,6,13,62,52,10,57
Stenhousem'r,406,4,15,8,13,56,48,8,53
Clyde,406,5,14,10,12,52,49,3,52
Elgin,406,6,14,6,16,54,64,-10,48
Annan Athlet,406,7,11,12,13,49,43,6,45
Berwick,406,8,8,11,17,30,59,-29,35
Edinburgh Ci,406,9,7,9,20,36,65,-29,30
Cowdenbeath,406,10,4,11,21,25,56,-31,23
Montrose,407,1,24,7,5,61,34,27,79
Peterhead,407,2,24,4,8,80,40,40,76
Stenhousem'r,407,3,16,8,12,57,46,11,56
Stirling,407,4,16,6,14,60,53,7,54
Clyde,407,5,15,9,12,53,49,4,54
Elgin,407,6,14,6,16,53,62,-9,48
Annan Athlet,407,7,11,12,13,48,42,6,45
Berwick,407,8,8,10,18,30,60,-30,34
Edinburgh Ci,407,9,7,9,20,38,63,-25,30
Cowdenbeath,407,10,4,11,21,24,55,-31,23
Montrose,408,1,23,8,5,59,34,25,77
Peterhead,408,2,24,4,8,79,39,40,76
Stenhousem'r,408,3,16,8,12,57,47,10,56
Stirling,408,4,16,6,14,61,53,8,54
Clyde,408,5,15,9,12,53,48,5,54
Elgin,408,6,14,7,15,53,60,-7,49
Annan Athlet,408,7,11,12,13,47,41,6,45
Berwick,408,8,8,10,18,29,60,-31,34
Edinburgh Ci,408,9,7,9,20,37,62,-25,30
Cowdenbeath,408,10,4,11,21,23,54,-31,23
Montrose,409,1,24,7,5,61,35,26,79
Peterhead,409,2,23,4,9,78,41,37,73
Stirling,409,3,17,6,13,64,51,13,57
Stenhousem'r,409,4,15,8,13,55,50,5,53
Clyde,409,5,14,9,13,51,49,2,51
Elgin,409,6,14,6,16,54,62,-8,48
Annan Athlet,409,7,11,12,13,48,42,6,45
Berwick,409,8,9,10,17,30,58,-28,37
Edinburgh Ci,409,9,8,9,19,39,61,-22,33
Cowdenbeath,409,10,4,11,21,24,55,-31,23
Montrose,410,1,23,8,5,61,36,25,77
Peterhead,410,2,24,4,8,81,38,43,76
Stirling,410,3,17,6,13,61,51,10,57
Stenhousem'r,410,4,15,8,13,55,47,8,53
Clyde,410,5,14,10,12,53,50,3,52
Elgin,410,6,14,7,15,55,62,-7,49
Annan Athlet,410,7,12,11,13,49,41,8,47
Berwick,410,8,8,11,17,31,60,-29,35
Edinburgh Ci,410,9,7,9,20,36,64,-28,30
Cowdenbeath,410,10,4,10,22,23,56,-33,22
Montrose,411,1,24,7,5,61,35,26,79
Peterhead,411,2,24,4,8,82,38,44,76
Stenhousem'r,411,3,16,8,12,58,47,11,56
Stirling,411,4,16,6,14,61,54,7,54
Clyde,411,5,14,9,13,52,50,2,51
Elgin,411,6,14,6,16,54,62,-8,48
Annan Athlet,411,7,12,11,13,48,41,7,47
Berwick,411,8,9,10,17,31,59,-28,37
Edinburgh Ci,411,9,7,9,20,36,65,-29,30
Cowdenbeath,411,10,4,10,22,23,55,-32,22
Montrose,412,1,24,7,5,63,34,29,79
Peterhead,412,2,24,4,8,80,38,42,76
Stirling,412,3,17,6,13,62,52,10,57
Clyde,412,4,15,9,12,54,48,6,54
Stenhousem'r,412,5,15,8,13,56,48,8,53
Elgin,412,6,14,6,16,53,64,-11,48
Annan Athlet,412,7,12,11,13,49,41,8,47
Berwick,412,8,8,10,18,29,61,-32,34
Edinburgh Ci,412,9,7,9,20,36,63,-27,30
Cowdenbeath,412,10,4,10,22,23,56,-33,22
Montrose,413,1,24,7,5,62,36,26,79
Peterhead,413,2,23,4,9,77,39,38,73
Stirling,413,3,16,7,13,62,53,9,55
Stenhousem'r,413,4,15,9,12,57,48,9,54
Clyde,413,5,14,9,13,51,49,2,51
Elgin,413,6,14,6,16,55,63,-8,48
Annan Athlet,413,7,11,12,13,47,41,6,45
Berwick,413,8,9,10,17,30,58,-28,37
Edinburgh Ci,413,9,8,9,19,37,60,-23,33
Cowdenbeath,413,10,4,11,21,23,54,-31,23
Montrose,414,1,23,7,6,60,36,24,76
Peterhead,414,2,23,5,8,79,40,39,74
Stirling,414,3,17,6,13,63,51,12,57
Stenhousem'r,414,4,15,8,13,55,49,6,53
Clyde,414,5,14,10,12,52,49,3,52
Elgin,414,6,15,6,15,55,61,-6,51
Annan Athlet,414,7,11,11,14,48,44,4,44
Berwick,414,8,8,11,17,30,59,-29,35
Edinburgh Ci,414,9,7,10,19,38,62,-24,31
Cowdenbeath,414,10,5,10,21,26,55,-29,25
Peterhead,415,1,24,4,8,80,39,41,76
Montrose,415,2,23,7,6,61,37,24,76
Stenhousem'r,415,3,16,8,12,59,48,11,56
Stirling,415,4,16,6,14,62,55,7,54
Clyde,415,5,14,9,13,52,50,2,51
Elgin,415,6,15,6,15,56,62,-6,51
Annan Athlet,415,7,12,11,13,49,41,8,47
Berwick,415,8,9,10,17,31,59,-28,37
Edinburgh Ci,415,9,7,9,20,37,63,-26,30
Cowdenbeath,415,10,4,10,22,23,56,-33,22
Montrose,416,1,24,7,5,62,36,26,79
Peterhead,416,2,24,4,8,78,38,40,76
Stirling,416,3,17,6,13,64,52,12,57
Clyde,416,4,15,9,12,53,48,5,54
Stenhousem'r,416,5,15,8,13,56,50,6,53
Elgin,416,6,14,6,16,55,63,-8,48
Annan Athlet,416,7,11,11,14,48,44,4,44
Berwick,416,8,8,10,18,29,60,-31,34
Edinburgh Ci,416,9,7,9,20,36,61,-25,30
Cowdenbeath,416,10,5,10,21,26,55,-29,25
Peterhead,417,1,24,4,8,80,40,40,76
Montrose,417,2,23,7,6,61,37,24,76
Stirling,417,3,17,6,13,63,53,10,57
Clyde,417,4,15,9,12,52,48,4,54
Stenhousem'r,417,5,15,8,13,57,49,8,53
Elgin,417,6,15,6,15,56,62,-6,51
Annan Athlet,417,7,11,12,13,47,41,6,45
Berwick,417,8,8,10,18,29,59,-30,34
Edinburgh Ci,417,9,7,9,20,38,63,-25,30
Cowdenbeath,417,10,4,11,21,23,54,-31,23
Montrose,418,1,23,8,5,61,36,25,77
Peterhead,418,2,24,4,8,79,38,41,76
Stenhousem'r,418,3,16,8,12,58,47,11,56
Stirling,418,4,16,6,14,61,54,7,54
Clyde,418,5,14,9,13,51,50,1,51
Elgin,418,6,14,7,15,55,62,-7,49
Annan Athlet,418,7,11,12,13,48,42,6,45
Berwick,418,8,9,10,17,31,58,-27,37
Edinburgh Ci,418,9,7,9,20,36,62,-26,30
Cowdenbeath,418,10,4,11,21,24,55,-31,23
Montrose,419,1,24,7,5,62,35,27,79
Peterhead,419,2,24,4,8,79,38,41,76
Stirling,419,3,17,6,13,62,52,10,57
Clyde,419,4,15,9,12,55,48,7,54
Stenhousem'r,419,5,15,8,13,56,48,8,53
Elgin,419,6,14,6,16,54,63,-9,48
Annan Athlet,419,7,11,12,13,47,41,6,45
Berwick,419,8,8,10,18,29,62,-33,34
Edinburgh Ci,419,9,7,9,20,36,62,-26,30
Cowdenbeath,419,10,4,11,21,23,54,-31,23
Montrose,420,1,24,7,5,60,34,26,79
Peterhead,420,2,24,4,8,81,38,43,76
Stirling,420,3,17,6,13,61,51,10,57
Clyde,420,4,15,9,12,56,49,7,54
Stenhousem'r,420,5,15,8,13,55,47,8,53
Elgin,420,6,14,6,16,53,61,-8,48
Annan Athlet,420,7,11,11,14,48,44,4,44
Berwick,420,8,8,10,18,30,63,-33,34
Edinburgh Ci,420,9,7,9,20,36,64,-28,30
Cowdenbeath,420,10,5,10,21,26,55,-29,25
Montrose,421,1,24,7,5,62,35,27,79
Peterhead,421,2,24,4,8,79,38,41,76
Stirling,421,3,16,7,13,62,53,9,55
Stenhousem'r,421,4,15,9,12,57,48,9,54
Clyde,421,5,14,10,12,52,49,3,52
Elgin,421,6,14,6,16,54,63,-9,48
Annan Athlet,421,7,11,11,14,47,44,3,44
Berwick,421,8,8,11,17,30,59,-29,35
Edinburgh Ci,421,9,7,9,20,36,62,-26,30
Cowdenbeath,421,10,5,10,21,26,54,-28,25
Montrose,422,1,24,7,5,62,34,28,79
Peterhead,422,2,24,4,8,81,38,43,76
Stirling,422,3,16,7,13,60,51,9,55
Stenhousem'r,422,4,15,9,12,55,46,9,54
Clyde,422,5,15,9,12,54,48,6,54
Elgin,422,6,14,6,16,53,63,-10,48
Annan Athlet,422,7,11,11,14,47,44,3,44
Berwick,422,8,8,10,18,29,61,-32,34
Edinburgh Ci,422,9,7,9,20,36,64,-28,30
Cowdenbeath,422,10,5,10,21,26,54,-28,25
Montrose,423,1,23,8,5,59,34,25,77
Peterhead,423,2,24,4,8,80,39,41,76
Stirling,423,3,17,6,13,62,52,10,57
Stenhousem'r,423,4,15,8,13,56,48,8,53
Clyde,423,5,14,9,13,52,50,2,51
Elgin,423,6,14,7,15,53,60,-7,49
Annan Athlet,423,7,11,11,14,48,45,3,44
Berwick,423,8,9,10,17,31,59,-28,37
Edinburgh Ci,423,9,7,9,20,37,63,-26,30
Cowdenbeath,423,10,5,10,21,27,55,-28,25
Montrose,424,1,24,7,5,62,34,28,79
Peterhead,424,2,24,4,8,79,39,40,76
Stenhousem'r,424,3,16,8,12,57,47,10,56
Stirling,424,4,16,6,14,61,53,8,54
Clyde,424,5,15,9,12,54,49,5,54
Elgin,424,6,14,6,16,53,63,-10,48
Annan Athlet,424,7,12,11,13,52,43,9,47
Berwick,424,8,8,10,18,30,61,-31,34
Edinburgh Ci,424,9,7,9,20,37,62,-25,30
Cowdenbeath,424,10,4,10,22,25,59,-34,22
Montrose,425,1,24,7,5,62,34,28,79
Peterhead,425,2,24,4,8,81,38,43,76
Stenhousem'r,425,3,16,8,12,56,46,10,56
Stirling,425,4,16,6,14,60,52,8,54
Clyde,425,5,14,9,13,51,49,2,51
Elgin,425,6,14,6,16,53,63,-10,48
Annan Athlet,425,7,11,11,14,47,43,4,44
Berwick,425,8,9,10,17,30,58,-28,37
Edinburgh Ci,425,9,7,9,20,36,64,-28,30
Cowdenbeath,425,10,5,10,21,25,54,-29,25
Montrose,426,1,24,7,5,63,35,28,79
Peterhead,426,2,24,4,8,81,38,43,76
Stirling,426,3,17,6,13,62,52,10,57
Clyde,426,4,15,9,12,54,48,6,54
Stenhousem'r,426,5,15,8,13,56,48,8,53
Elgin,426,6,14,6,16,54,64,-10,48
Annan Athlet,426,7,12,11,13,48,41,7,47
Berwick,426,8,8,10,18,29,61,-32,34
Edinburgh Ci,426,9,7,9,20,36,64,-28,30
Cowdenbeath,426,10,4,10,22,23,55,-32,22
Peterhead,427,1,24,4,8,81,40,41,76
Montrose,427,2,23,7,6,60,36,24,76
Stirling,427,3,17,6,13,62,52,10,57
Stenhousem'r,427,4,15,8,13,56,48,8,53
Clyde,427,5,14,10,12,54,51,3,52
Elgin,427,6,15,6,15,55,61,-6,51
Annan Athlet,427,7,12,11,13,50,42,8,47
Berwick,427,8,8,11,17,32,61,-29,35
Edinburgh Ci,427,9,7,9,20,38,64,-26,30
Cowdenbeath,427,10,4,10,22,24,57,-33,22
Montrose,428,1,23,8,5,59,34,25,77
Peterhead,428,2,24,4,8,79,38,41,76
Stirling,428,3,17,6,13,62,52,10,57
Clyde,428,4,15,9,12,53,49,4,54
Stenhousem'r,428,5,15,8,13,56,48,8,53
Elgin,428,6,14,7,15,53,60,-7,49
Annan Athlet,428,7,12,11,13,48,41,7,47
Berwick,428,8,8,10,18,30,60,-30,34
Edinburgh Ci,428,9,7,9,20,36,62,-26,30
Cowdenbeath,428,10,4,10,22,23,55,-32,22
Montrose,429,1,24,7,5,61,35,26,79
Peterhead,429,2,24,4,8,79,39,40,76
Stenhousem'r,429,3,16,8,12,58,47,11,56
Stirling,429,4,16,6,14,61,54,7,54
Clyde,429,5,15,9,12,53,49,4,54
Elgin,429,6,14,6,16,54,62,-8,48
Annan Athlet,429,7,11,12,13,48,42,6,45
Berwick,429,8,8,10,18,30,60,-30,34
Edinburgh Ci,429,9,7,9,20,37,62,-25,30
Cowdenbeath,429,10,4,11,21,24,55,-31,23
Montrose,430,1,24,7,5,63,35,28,79
Peterhead,430,2,24,4,8,81,40,41,76
Stirling,430,3,17,6,13,63,52,11,57
Clyde,430,4,15,9,12,56,48,8,54
Stenhousem'r,430,5,15,8,13,56,49,7,53
Elgin,430,6,14,6,16,54,64,-10,48
Annan Athlet,430,7,12,11,13,48,41,7,47
Berwick,430,8,8,10,18,29,63,-34,34
Edinburgh Ci,430,9,7,9,20,38,64,-26,30
Cowdenbeath,430,10,4,10,22,23,55,-32,22
Montrose,431,1,24,7,5,60,34,26,79
Peterhead,431,2,23,5,8,77,38,39,74
Stirling,431,3,17,6,13,61,51,10,57
Clyde,431,4,15,9,12,55,48,7,54
Stenhousem'r,431,5,15,8,13,55,47,8,53
Elgin,431,6,14,6,16,53,61,-8,48
Annan Athlet,431,7,12,11,13,50,42,8,47
Berwick,431,8,8,10,18,29,62,-33,34
Edinburgh Ci,431,9,7,10,19,36,60,-24,31
Cowdenbeath,431,10,4,10,22,24,57,-33,22
Montrose,432,1,24,7,5,61,35,26,79
Peterhead,432,2,24,4,8,81,40,41,76
Stenhousem'r,432,3,16,8,12,57,47,10,56
Stirling,432,4,16,6,14,61,53,8,54
Clyde,432,5,15,9,12,55,48,7,54
Elgin,432,6,14,6,16,54,62,-8,48
Annan Athlet,432,7,11,11,14,47,43,4,44
Berwick,432,8,8,10,18,29,62,-33,34
Edinburgh Ci,432,9,7,9,20,38,64,-26,30
Cowdenbeath,432,10,5,10,21,25,54,-29,25
Montrose,433,1,24,7,5,64,37,27,79
Peterhead,433,2,24,4,8,78,38,40,76
Stenhousem'r,433,3,16,8,12,59,48,11,56
Stirling,433,4,16,6,14,62,55,7,54
Clyde,433,5,15,9,12,55,50,5,54
Elgin,433,6,14,6,16,56,65,-9,48
Annan Athlet,433,7,11,11,14,47,42,5,44
Berwick,433,8,8,10,18,31,62,-31,34
Edinburgh Ci,433,9,7,9,20,36,61,-25,30
Cowdenbeath,433,10,5,10,21,24,54,-30,25
Montrose,434,1,24,7,5,62,36,26,79
Peterhead,434,2,24,4,8,83,40,43,76
Stirling,434,3,17,6,13,62,52,10,57
Clyde,434,4,15,9,12,52,48,4,54
Stenhousem'r,434,5,15,8,13,56,48,8,53
Elgin,434,6,14,6,16,55,63,-8,48
Annan Athlet,434,7,11,11,14,48,43,5,44
Berwick,434,8,8,10,18,29,59,-30,34
Edinburgh Ci,434,9,7,9,20,38,66,-28,30
Cowdenbeath,434,10,5,10,21,25,55,-30,25
Montrose,435,1,24,7,5,60,34,26,79
Peterhead,435,2,24,4,8,79,38,41,76
Stirling,435,3,17,6,13,62,52,10,57
Clyde,435,4,15,9,12,53,49,4,54
Stenhousem'r,435,5,15,8,13,56,48,8,53
Elgin,435,6,14,6,16,53,61,-8,48
Annan Athlet,435,7,12,11,13,49,42,7,47
Berwick,435,8,8,10,18,30,60,-30,34
Edinburgh Ci,435,9,7,9,20,36,62,-26,30
Cowdenbeath,435,10,4,10,22,24,56,-32,22
Montrose,436,1,24,7,5,63,36,27,79
Peterhead,436,2,24,4,8,80,39,41,76
Stirling,436,3,17,6,13,62,52,10,57
Clyde,436,4,15,9,12,53,49,4,54
Stenhousem'r,436,5,15,8,13,56,48,8,53
Elgin,436,6,14,6,16,55,64,-9,48
Annan Athlet,436,7,12,11,13,48,41,7,47
Berwick,436,8,8,10,18,30,60,-30,34
Edinburgh Ci,436,9,7,9,20,37,63,-26,30
Cowdenbeath,436,10,4,10,22,23,55,-32,22
Montrose,437,1,24,7,5,62,36,26,79
Peterhead,437,2,24,4,8,78,38,40,76
Stenhousem'r,437,3,16,8,12,57,47,10,56
Stirling,437,4,16,6,14,61,53,8,54
Clyde,437,5,14,9,13,51,49,2,51
Elgin,437,6,14,6,16,55,63,-8,48
Annan Athlet,437,7,12,11,13,50,41,9,47
Berwick,437,8,9,10,17,30,58,-28,37
Edinburgh Ci,437,9,7,9,20,36,61,-25,30
Cowdenbeath,437,10,4,10,22,23,57,-34,22
Montrose,438,1,23,8,5,60,35,25,77
Peterhead,438,2,24,4,8,80,39,41,76
Stenhousem'r,438,3,16,8,12,58,47,11,56
Stirling,438,4,16,6,14,61,54,7,54
Clyde,438,5,14,9,13,52,51,1,51
Elgin,438,6,14,7,15,54,61,-7,49
Annan Athlet,438,7,12,11,13,50,41,9,47
Berwick,438,8,9,10,17,32,59,-27,37
Edinburgh Ci,438,9,7,9,20,37,63,-26,30
Cowdenbeath,438,10,4,10,22,23,57,-34,22
Montrose,439,1,24,7,5,61,35,26,79
Peterhead,439,2,24,4,8,78,38,40,76
Stirling,439,3,17,6,13,64,51,13,57
Clyde,439,4,15,9,12,53,49,4,54
Stenhousem'r,439,5,15,8,13,55,50,5,53
Elgin,439,6,14,6,16,54,62,-8,48
Annan Athlet,439,7,12,11,13,48,41,7,47
Berwick,439,8,8,10,18,30,60,-30,34
Edinburgh Ci,439,9,7,9,20,36,61,-25,30
Cowdenbeath,439,10,4,10,22,23,55,-32,22
Montrose,440,1,24,7,5,60,34,26,79
Peterhead,440,2,24,4,8,79,38,41,76
Stirling,440,3,16,7,13,62,53,9,55
Stenhousem'r,440,4,15,9,12,57,48,9,54
Clyde,440,5,15,9,12,54,49,5,54
Elgin,440,6,14,6,16,53,61,-8,48
Annan Athlet,440,7,12,11,13,49,42,7,47
Berwick,440,8,8,10,18,30,61,-31,34
Edinburgh Ci,440,9,7,9,20,36,62,-26,30
Cowdenbeath,440,10,4,10,22,24,56,-32,22
Montrose,441,1,24,7,5,62,35,27,79
Peterhead,441,2,23,5,8,79,40,39,74
Stenhousem'r,441,3,16,8,12,58,47,11,56
Stirling,441,4,16,6,14,61,54,7,54
Clyde,441,5,14,9,13,52,52,0,51
Elgin,441,6,14,6,16,54,63,-9,48
Annan Athlet,441,7,12,11,13,48,41,7,47
Berwick,441,8,9,10,17,33,59,-26,37
Edinburgh Ci,441,9,7,10,19,38,62,-24,31
Cowdenbeath,441,10,4,10,22,23,55,-32,22
Montrose,442,1,24,7,5,60,34,26,79
Peterhead,442,2,24,4,8,81,39,42,76
Stirling,442,3,16,7,13,60,51,9,55
Stenhousem'r,442,4,15,9,12,55,46,9,54
Clyde,442,5,15,9,12,54,49,5,54
Elgin,442,6,14,6,16,53,61,-8,48
Annan Athlet,442,7,11,12,13,48,42,6,45
Berwick,442,8,8,10,18,30,61,-31,34
Edinburgh Ci,442,9,7,9,20,37,64,-27,30
Cowdenbeath,442,10,4,11,21,24,55,-31,23
Montrose,443,1,24,7,5,63,36,27,79
Peterhead,443,2,24,4,8,81,38,43,76
Stenhousem'r,443,3,16,8,12,57,47,10,56
Stirling,443,4,16,6,14,61,53,8,54
Clyde,443,5,15,9,12,53,49,4,54
Elgin,443,6,14,6,16,55,64,-9,48
Annan Athlet,443,7,12,11,13,48,41,7,47
Berwick,443,8,8,10,18,30,60,-30,34
Edinburgh Ci,443,9,7,9,20,36,64,-28,30
Cowdenbeath,443,10,4,10,22,23,55,-32,22
Montrose,444,1,24,7,5,62,35,27,79
Peterhead,444,2,23,5,8,78,39,39,74
Stirling,444,3,17,6,13,63,52,11,57
Stenhousem'r,444,4,15,8,13,56,49,7,53
Clyde,444,5,14,10,12,53,50,3,52
Elgin,444,6,14,6,16,54,63,-9,48
Annan Athlet,444,7,11,12,13,47,41,6,45
Berwick,444,8,8,11,17,31,60,-29,35
Edinburgh Ci,444,9,7,10,19,37,61,-24,31
Cowdenbeath,444,10,4,11,21,23,54,-31,23
Montrose,445,1,23,8,5,59,34,25,77
Peterhead,445,2,24,4,8,81,39,42,76
Stirling,445,3,17,6,13,62,52,10,57
Clyde,445,4,15,9,12,53,49,4,54
Stenhousem'r,445,5,15,8,13,56,48,8,53
Elgin,445,6,14,7,15,53,60,-7,49
Annan Athlet,445,7,11,11,14,47,42,5,44
Berwick,445,8,8,10,18,30,60,-30,34
Edinburgh Ci,445,9,7,9,20,37,64,-27,30
Cowdenbeath,445,10,5,10,21,24,54,-30,25
Montrose,446,1,23,7,6,61,37,24,76
Peterhead,446,2,23,5,8,79,40,39,74
Stirling,446,3,16,7,13,61,52,9,55
Stenhousem'r,446,4,15,9,12,56,47,9,54
Clyde,446,5,15,9,12,54,48,6,54
Elgin,446,6,15,6,15,56,62,-6,51
Annan Athlet,446,7,11,11,14,48,43,5,44
Berwick,446,8,8,10,18,29,61,-32,34
Edinburgh Ci,446,9,7,10,19,38,62,-24,31
Cowdenbeath,446,10,5,10,21,25,55,-30,25
Montrose,447,1,24,7,5,60,34,26,79
Peterhead,447,2,24,4,8,78,38,40,76
Stirling,447,3,16,7,13,61,52,9,55
Stenhousem'r,447,4,15,9,12,56,47,9,54
Clyde,447,5,14,9,13,52,52,0,51
Elgin,447,6,14,6,16,53,61,-8,48
Annan Athlet,447,7,12,11,13,49,42,7,47
Berwick,447,8,9,10,17,33,59,-26,37
Edinburgh Ci,447,9,7,9,20,36,61,-25,30
Cowdenbeath,447,10,4,10,22,24,56,-32,22
Montrose,448,1,23,8,5,60,35,25,77
Peterhead,448,2,23,4,9,79,41,38,73
Stirling,448,3,16,7,13,61,52,9,55
Stenhousem'r,448,4,15,9,12,56,47,9,54
Clyde,448,5,14,10,12,52,49,3,52
Elgin,448,6,14,7,15,54,61,-7,49
Annan Athlet,448,7,11,12,13,47,41,6,45
Berwick,448,8,8,11,17,30,59,-29,35
Edinburgh Ci,448,9,8,9,19,39,62,-23,33
Cowdenbeath,448,10,4,11,21,23,54,-31,23
Montrose,449,1,24,7,5,63,35,28,79
Peterhead,449,2,23,5,8,79,40,39,74
Stirling,449,3,16,7,13,61,52,9,55
Stenhousem'r,449,4,15,9,12,56,47,9,54
Clyde,449,5,15,9,12,53,49,4,54
Elgin,449,6,14,6,16,54,64,-10,48
Annan Athlet,449,7,12,11,13,49,41,8,47
Berwick,449,8,8,10,18,30,60,-30,34
Edinburgh Ci,449,9,7,10,19,38,62,-24,31
Cowdenbeath,449,10,4,10,22,23,56,-33,22
Peterhead,450,1,24,4,8,84,39,45,76
Montrose,450,2,23,7,6,60,36,24,76
Stirling,450,3,16,7,13,62,53,9,55
Stenhousem'r,450,4,15,9,12,57,48,9,54
Clyde,450,5,15,9,12,52,48,4,54
Elgin,450,6,15,6,15,55,61,-6,51
Annan Athlet,450,7,12,11,13,48,41,7,47
Berwick,450,8,8,10,18,29,59,-30,34
Edinburgh Ci,450,9,7,9,20,37,67,-30,30
Cowdenbeath,450,10,4,10,22,23,55,-32,22
Montrose,451,1,23,7,6,60,36,24,76
Peterhead,451,2,23,5,8,78,39,39,74
Stirling,451,3,16,7,13,64,55,9,55
Stenhousem'r,451,4,15,9,12,59,50,9,54
Clyde,451,5,14,9,13,52,51,1,51
Elgin,451,6,15,6,15,55,61,-6,51
Annan Athlet,451,7,12,11,13,49,42,7,47
Berwick,451,8,9,10,17,32,59,-27,37
Edinburgh Ci,451,9,7,10,19,37,61,-24,31
Cowdenbeath,451,10,4,10,22,24,56,-32,22
Montrose,452,1,24,7,5,61,34,27,79
Peterhead,452,2,24,4,8,79,39,40,76
Stenhousem'r,452,3,16,8,12,56,46,10,56
Stirling,452,4,16,6,14,60,52,8,54
Clyde,452,5,15,9,12,54,48,6,54
Elgin,452,6,14,6,16,53,62,-9,48
Annan Athlet,452,7,12,11,13,48,41,7,47
Berwick,452,8,8,10,18,29,61,-32,34
Edinburgh Ci,452,9,7,9,20,37,62,-25,30
Cowdenbeath,452,10,4,10,22,23,55,-32,22
Montrose,453,1,23,8,5,60,35,25,77
Peterhead,453,2,23,5,8,80,41,39,74
Stirling,453,3,17,6,13,63,52,11,57
Clyde,453,4,15,9,12,53,49,4,54
Stenhousem'r,453,5,15,8,13,56,49,7,53
Elgin,453,6,14,7,15,54,61,-7,49
Annan Athlet,453,7,11,12,13,47,41,6,45
Berwick,453,8,8,10,18,30,60,-30,34
Edinburgh Ci,453,9,7,10,19,39,63,-24,31
Cowdenbeath,453,10,4,11,21,23,54,-31,23
Peterhead,454,1,24,4,8,80,39,41,76
Montrose,454,2,23,7,6,61,39,22,76
Stirling,454,3,17,6,13,63,53,10,57
Clyde,454,4,15,9,12,52,48,4,54
Stenhousem'r,454,5,15,8,13,57,49,8,53
Elgin,454,6,15,6,15,58,62,-4,51
Annan Athlet,454,7,12,11,13,49,42,7,47
Berwick,454,8,8,10,18,29,59,-30,34
Edinburgh Ci,454,9,7,9,20,37,63,-26,30
Cowdenbeath,454,10,4,10,22,24,56,-32,22
Montrose,455,1,24,7,5,62,35,27,79
Peterhead,455,2,24,4,8,79,38,41,76
Stirling,455,3,17,6,13,67,54,13,57
Clyde,455,4,15,9,12,56,48,8,54
Stenhousem'r,455,5,15,8,13,58,53,5,53
Elgin,455,6,14,6,16,54,63,-9,48
Annan Athlet,455,7,11,11,14,47,43,4,44
Berwick,455,8,8,10,18,29,63,-34,34
Edinburgh Ci,455,9,7,9,20,36,62,-26,30
Cowdenbeath,455,10,5,10,21,25,54,-29,25
Montrose,456,1,24,7,5,61,34,27,79
Peterhead,456,2,24,4,8,78,38,40,76
Stirling,456,3,17,6,13,61,51,10,57
Stenhousem'r,456,4,15,8,13,55,47,8,53
Clyde,456,5,14,10,12,52,49,3,52
Elgin,456,6,14,6,16,53,62,-9,48
Annan Athlet,456,7,12,11,13,50,41,9,47
Berwick,456,8,8,11,17,30,59,-29,35
Edinburgh Ci,456,9,7,9,20,36,61,-25,30
Cowdenbeath,456,10,4,10,22,23,57,-34,22
Peterhead,457,1,24,4,8,82,39,43,76
Montrose,457,2,23,7,6,60,36,24,76
Stirling,457,3,16,7,13,62,53,9,55
Stenhousem'r,457,4,15,9,12,57,48,9,54
Clyde,457,5,15,9,12,54,48,6,54
Elgin,457,6,15,6,15,55,61,-6,51
Annan Athlet,457,7,11,12,13,48,42,6,45
Berwick,457,8,8,10,18,29,61,-32,34
Edinburgh Ci,457,9,7,9,20,37,65,-28,30
Cowdenbeath,457,10,4,11,21,24,55,-31,23
Peterhead,458,1,24,4,8,79,39,40,76
Montrose,458,2,23,7,6,59,35,24,76
Stirling,458,3,17,6,13,64,51,13,57
Clyde,458,4,15,9,12,52,48,4,54
Stenhousem'r,458,5,15,8,13,55,50,5,53
Elgin,458,6,15,6,15,54,60,-6,51
Annan Athlet,458,7,12,11,13,49,41,8,47
Berwick,458,8,8,10,18,29,59,-30,34
Edinburgh Ci,458,9,7,9,20,37,62,-25,30
Cowdenbeath,458,10,4,10,22,23,56,-33,22
Montrose,459,1,23,8,5,60,35,25,77
Peterhead,459,2,24,4,8,81,39,42,76
Stenhousem'r,459,3,16,8,12,58,47,11,56
Stirling,459,4,16,6,14,61,54,7,54
Clyde,459,5,15,9,12,53,48,5,54
Elgin,459,6,14,7,15,54,61,-7,49
Annan Athlet,459,7,12,11,13,49,42,7,47
Berwick,459,8,8,10,18,29,60,-31,34
Edinburgh Ci,459,9,7,9,20,37,64,-27,30
Cowdenbeath,459,10,4,10,22,24,56,-32,22
Montrose,460,1,24,7,5,62,35,27,79
Peterhead,460,2,24,4,8,82,40,42,76
Stirling,460,3,17,6,13,62,52,10,57
Clyde,460,4,15,9,12,54,48,6,54
Stenhousem'r,460,5,15,8,13,56,48,8,53
Elgin,460,6,14,6,16,54,63,-9,48
Annan Athlet,460,7,11,11,14,47,42,5,44
Berwick,460,8,8,10,18,29,61,-32,34
Edinburgh Ci,460,9,7,9,20,38,65,-27,30
Cowdenbeath,460,10,5,10,21,24,54,-30,25
Peterhead,461,1,24,4,8,80,39,41,76
Montrose,461,2,23,7,6,59,35,24,76
Stirling,461,3,17,6,13,62,51,11,57
Stenhousem'r,461,4,15,8,13,55,48,7,53
Clyde,461,5,14,10,12,52,49,3,52
Elgin,461,6,15,6,15,54,60,-6,51
Annan Athlet,461,7,11,11,14,48,43,5,44
Berwick,461,8,8,11,17,30,59,-29,35
Edinburgh Ci,461,9,7,9,20,37,63,-26,30
Cowdenbeath,461,10,5,10,21,25,55,-30,25
Peterhead,462,1,24,4,8,83,38,45,76
Montrose,462,2,23,7,6,60,36,24,76
Stirling,462,3,17,6,13,62,52,10,57
Clyde,462,4,15,9,12,54,48,6,54
Stenhousem'r,462,5,15,8,13,56,48,8,53
Elgin,462,6,15,6,15,55,61,-6,51
Annan Athlet,462,7,12,11,13,49,41,8,47
Berwick,462,8,8,10,18,29,61,-32,34
Edinburgh Ci,462,9,7,9,20,36,66,-30,30
Cowdenbeath,462,10,4,10,22,23,56,-33,22
Montrose,463,1,24,7,5,63,35,28,79
Peterhead,463,2,24,4,8,82,39,43,76
Stirling,463,3,17,6,13,63,51,12,57
Stenhousem'r,463,4,15,8,13,55,49,6,53
Clyde,463,5,14,9,13,52,50,2,51
Elgin,463,6,14,6,16,54,64,-10,48
Annan Athlet,463,7,11,11,14,47,45,2,44
Berwick,463,8,9,10,17,31,59,-28,37
Edinburgh Ci,463,9,7,9,20,37,65,-28,30
Cowdenbeath,463,10,5,10,21,27,54,-27,25
Montrose,464,1,24,7,5,62,35,27,79
Peterhead,464,2,24,4,8,79,38,41,76
Stirling,464,3,17,6,13,61,51,10,57
Stenhousem'r,464,4,15,8,13,55,47,8,53
Clyde,464,5,14,10,12,51,48,3,52
Elgin,464,6,14,6,16,54,63,-9,48
Annan Athlet,464,7,12,11,13,48,41,7,47
Berwick,464,8,8,11,17,29,58,-29,35
Edinburgh Ci,464,9,7,9,20,36,62,-26,30
Cowdenbeath,464,10,4,10,22,23,55,-32,22
Montrose,465,1,24,7,5,63,36,27,79
Peterhead,465,2,23,5,8,78,39,39,74
Stirling,465,3,17,6,13,62,52,10,57
Clyde,465,4,15,9,12,52,48,4,54
Stenhousem'r,465,5,15,8,13,56,48,8,53
Elgin,465,6,14,6,16,55,64,-9,48
Annan Athlet,465,7,12,11,13,50,42,8,47
Berwick,465,8,8,10,18,29,59,-30,34
Edinburgh Ci,465,9,7,10,19,37,61,-24,31
Cowdenbeath,465,10,4,10,22,24,57,-33,22
Montrose,466,1,24,7,5,61,34,27,79
Peterhead,466,2,23,4,9,77,40,37,73
Stirling,466,3,16,7,13,63,54,9,55
Stenhousem'r,466,4,15,9,12,58,49,9,54
Clyde,466,5,15,9,12,53,49,4,54
Elgin,466,6,14,6,16,53,62,-9,48
Annan Athlet,466,7,12,11,13,50,41,9,47
Berwick,466,8,8,10,18,30,60,-30,34
Edinburgh Ci,466,9,8,9,19,38,60,-22,33
Cowdenbeath,466,10,4,10,22,23,57,-34,22
Montrose,467,1,24,7,5,63,36,27,79
Peterhead,467,2,24,4,8,83,41,42,76
Stirling,467,3,16,7,13,61,52,9,55
Stenhousem'r,467,4,15,9,12,56,47,9,54
Clyde,467,5,15,9,12,53,48,5,54
Elgin,467,6,14,6,16,55,64,-9,48
Annan Athlet,467,7,12,11,13,49,42,7,47
Berwick,467,8,8,10,18,29,60,-31,34
Edinburgh Ci,467,9,7,9,20,39,66,-27,30
Cowdenbeath,467,10,4,10,22,24,56,-32,22
Montrose,468,1,24,7,5,62,36,26,79
Peterhead,468,2,23,5,8,77,38,39,74
Stirling,468,3,17,6,13,64,53,11,57
Clyde,468,4,15,9,12,53,48,5,54
Stenhousem'r,468,5,15,8,13,57,50,7,53
Elgin,468,6,14,6,16,55,63,-8,48
Annan Athlet,468,7,12,11,13,50,41,9,47
Berwick,468,8,8,10,18,29,60,-31,34
Edinburgh Ci,468,9,7,10,19,36,60,-24,31
Cowdenbeath,468,10,4,10,22,23,57,-34,22
Montrose,469,1,24,7,5,62,34,28,79
Peterhead,469,2,24,4,8,78,38,40,76
Stirling,469,3,16,7,13,61,52,9,55
Stenhousem'r,469,4,15,9,12,56,47,9,54
Clyde,469,5,15,9,12,53,48,5,54
Elgin,469,6,14,6,16,53,63,-10,48
Annan Athlet,469,7,11,12,13,47,41,6,45
Berwick,469,8,8,10,18,29,60,-31,34
Edinburgh Ci,469,9,7,9,20,36,61,-25,30
Cowdenbeath,469,10,4,11,21,23,54,-31,23
Peterhead,470,1,24,4,8,80,38,42,76
Montrose,470,2,23,7,6,59,35,24,76
Stirling,470,3,17,6,13,62,52,10,57
Stenhousem'r,470,4,15,8,13,56,48,8,53
Clyde,470,5,14,10,12,52,49,3,52
Elgin,470,6,15,6,15,54,60,-6,51
Annan Athlet,470,7,12,11,13,49,42,7,47
Berwick,470,8,8,11,17,30,59,-29,35
Edinburgh Ci,470,9,7,9,20,36,63,-27,30
Cowdenbeath,470,10,4,10,22,24,56,-32,22
Montrose,471,1,23,8,5,61,36,25,77
Peterhead,471,2,24,4,8,82,38,44,76
Stirling,471,3,16,7,13,61,52,9,55
Stenhousem'r,471,4,15,9,12,56,47,9,54
Clyde,471,5,14,10,12,51,48,3,52
Elgin,471,6,14,7,15,55,62,-7,49
Annan Athlet,471,7,12,11,13,49,41,8,47
Berwick,471,8,8,11,17,29,58,-29,35
Edinburgh Ci,471,9,7,9,20,36,65,-29,30
Cowdenbeath,471,10,4,10,22,23,56,-33,22
Montrose,472,1,23,8,5,60,35,25,77
Peterhead,472,2,24,4,8,82,38,44,76
Stirling,472,3,16,7,13,60,51,9,55
Stenhousem'r,472,4,15,9,12,55,46,9,54
Clyde,472,5,14,10,12,52,49,3,52
Elgin,472,6,14,7,15,54,61,-7,49
Annan Athlet,472,7,12,11,13,49,41,8,47
Berwick,472,8,8,11,17,30,59,-29,35
Edinburgh Ci,472,9,7,9,20,36,65,-29,30
Cowdenbeath,472,10,4,10,22,23,56,-33,22
Montrose,473,1,24,7,5,60,34,26,79
Peterhead,473,2,24,4,8,83,39,44,76
Stirling,473,3,17,6,13,63,53,10,57
Clyde,473,4,15,9,12,54,48,6,54
Stenhousem'r,473,5,15,8,13,57,49,8,53
Elgin,473,6,14,6,16,53,61,-8,48
Annan Athlet,473,7,11,11,14,47,42,5,44
Berwick,473,8,8,10,18,29,61,-32,34
Edinburgh Ci,473,9,7,9,20,37,66,-29,30
Cowdenbeath,473,10,5,10,21,24,54,-30,25
Montrose,474,1,24,7,5,62,36,26,79
Peterhead,474,2,23,5,8,77,38,39,74
Stirling,474,3,17,6,13,63,53,10,57
Stenhousem'r,474,4,15,8,13,57,49,8,53
Clyde,474,5,14,9,13,51,50,1,51
Elgin,474,6,14,6,16,55,63,-8,48
Annan Athlet,474,7,11,12,13,47,41,6,45
Berwick,474,8,9,10,17,31,58,-27,37
Edinburgh Ci,474,9,7,10,19,36,60,-24,31
Cowdenbeath,474,10,4,11,21,23,54,-31,23
Peterhead,475,1,24,4,8,79,39,40,76
Montrose,475,2,23,7,6,60,36,24,76
Stirling,475,3,17,6,13,62,52,10,57
Stenhousem'r,475,4,15,8,13,56,48,8,53
Clyde,475,5,14,10,12,54,51,3,52
Elgin,475,6,15,6,15,55,61,-6,51
Annan Athlet,475,7,12,11,13,49,41,8,47
Berwick,475,8,8,11,17,32,61,-29,35
Edinburgh Ci,475,9,7,9,20,37,62,-25,30
Cowdenbeath,475,10,4,10,22,23,56,-33,22
Montrose,476,1,24,7,5,61,35,26,79
Peterhead,476,2,24,4,8,80,39,41,76
Stenhousem'r,476,3,16,8,12,60,46,14,56
Stirling,476,4,16,6,14,60,56,4,54
Clyde,476,5,15,9,12,52,48,4,54
Elgin,476,6,14,6,16,54,62,-8,48
Annan Athlet,476,7,11,12,13,47,41,6,45
Berwick,476,8,8,10,18,29,59,-30,34
Edinburgh Ci,476,9,7,9,20,37,63,-26,30
Cowdenbeath,476,10,4,11,21,23,54,-31,23
Montrose,477,1,24,7,5,64,36,28,79
Peterhead,477,2,24,4,8,79,38,41,76
Stirling,477,3,17,6,13,61,51,10,57
Clyde,477,4,15,9,12,55,49,6,54
Stenhousem'r,477,5,15,8,13,55,47,8,53
Elgin,477,6,14,6,16,55,65,-10,48
Annan Athlet,477,7,12,11,13,50,42,8,47
Berwick,477,8,8,10,18,30,62,-32,34
Edinburgh Ci,477,9,7,9,20,36,62,-26,30
Cowdenbeath,477,10,4,10,22,24,57,-33,22
Montrose,478,1,24,7,5,62,35,27,79
Peterhead,478,2,24,4,8,79,38,41,76
Stenhousem'r,478,3,16,8,12,58,46,12,56
Stirling,478,4,16,6,14,60,54,6,54
Clyde,478,5,15,9,12,54,49,5,54
Elgin,478,6,14,6,16,54,63,-9,48
Annan Athlet,478,7,11,11,14,47,43,4,44
Berwick,478,8,8,10,18,30,61,-31,34
Edinburgh Ci,478,9,7,9,20,36,62,-26,30
Cowdenbeath,478,10,5,10,21,25,54,-29,25
Montrose,479,1,24,7,5,61,34,27,79
Peterhead,479,2,24,4,8,84,38,46,76
Stirling,479,3,17,6,13,62,52,10,57
Clyde,479,4,15,9,12,55,49,6,54
Stenhousem'r,479,5,15,8,13,56,48,8,53
Elgin,479,6,14,6,16,53,62,-9,48
Annan Athlet,479,7,12,11,13,48,41,7,47
Berwick,479,8,8,10,18,30,62,-32,34
Edinburgh Ci,479,9,7,9,20,36,67,-31,30
Cowdenbeath,479,10,4,10,22,23,55,-32,22
Montrose,480,1,24,7,5,62,34,28,79
Peterhead,480,2,23,4,9,77,39,38,73
Stirling,480,3,16,7,13,61,52,9,55
Stenhousem'r,480,4,15,9,12,56,47,9,54
Clyde,480,5,14,10,12,53,50,3,52
Elgin,480,6,14,6,16,53,63,-10,48
Annan Athlet,480,7,11,11,14,47,43,4,44
Berwick,480,8,8,11,17,31,60,-29,35
Edinburgh Ci,480,9,8,9,19,37,60,-23,33
Cowdenbeath,480,10,5,10,21,25,54,-29,25
Peterhead,481,1,24,4,8,80,38,42,76
Montrose,481,2,23,7,6,59,35,24,76
Stirling,481,3,16,7,13,62,53,9,55
Stenhousem'r,481,4,15,9,12,57,48,9,54
Clyde,481,5,15,9,12,54,49,5,54
Elgin,481,6,15,6,15,54,60,-6,51
Annan Athlet,481,7,11,11,14,48,43,5,44
Berwick,481,8,8,10,18,30,61,-31,34
Edinburgh Ci,481,9,7,9,20,36,63,-27,30
Cowdenbeath,481,10,5,10,21,25,55,-30,25
Montrose,482,1,23,8,5,59,34,25,77
Peterhead,482,2,23,5,8,78,39,39,74
Stirling,482,3,17,6,13,62,52,10,57
Clyde,482,4,15,9,12,54,49,5,54
Stenhousem'r,482,5,15,8,13,56,48,8,53
Elgin,482,6,14,7,15,53,60,-7,49
Annan Athlet,482,7,11,12,13,48,42,6,45
Berwick,482,8,8,10,18,30,61,-31,34
Edinburgh Ci,482,9,7,10,19,37,61,-24,31
Cowdenbeath,482,10,4,11,21,24,55,-31,23
Montrose,483,1,23,8,5,62,37,25,77
Peterhead,483,2,24,4,8,78,38,40,76
Stirling,483,3,17,6,13,63,52,11,57
Clyde,483,4,15,9,12,53,48,5,54
Stenhousem'r,483,5,15,8,13,56,49,7,53
Elgin,483,6,14,7,15,56,63,-7,49
Annan Athlet,483,7,11,11,14,47,43,4,44
Berwick,483,8,8,10,18,29,60,-31,34
Edinburgh Ci,483,9,7,9,20,36,61,-25,30
Cowdenbeath,483,10,5,10,21,25,54,-29,25
Montrose,484,1,24,7,5,64,34,30,79
Peterhead,484,2,24,4,8,78,38,40,76
Stirling,484,3,17,6,13,66,53,13,57
Clyde,484,4,15,9,12,52,48,4,54
Stenhousem'r,484,5,15,8,13,57,52,5,53
Elgin,484,6,14,6,16,53,65,-12,48
Annan Athlet,484,7,11,11,14,48,44,4,44
Berwick,484,8,8,10,18,29,59,-30,34
Edinburgh Ci,484,9,7,9,20,36,61,-25,30
Cowdenbeath,484,10,5,10,21,26,55,-29,25
Montrose,485,1,24,7,5,61,34,27,79
Peterhead,485,2,24,4,8,78,38,40,76
Stirling,485,3,17,6,13,62,51,11,57
Clyde,485,4,15,9,12,53,48,5,54
Stenhousem'r,485,5,15,8,13,55,48,7,53
Elgin,485,6,14,6,16,53,62,-9,48
Annan Athlet,485,7,12,11,13,49,41,8,47
Berwick,485,8,8,10,18,29,60,-31,34
Edinburgh Ci,485,9,7,9,20,36,61,-25,30
Cowdenbeath,485,10,4,10,22,23,56,-33,22
Montrose,486,1,24,7,5,61,35,26,79
Peterhead,486,2,24,4,8,79,38,41,76
Stirling,486,3,16,7,13,61,52,9,55
Stenhousem'r,486,4,15,9,12,56,47,9,54
Clyde,486,5,15,9,12,52,48,4,54
Elgin,486,6,14,6,16,54,62,-8,48
Annan Athlet,486,7,11,11,14,47,43,4,44
Berwick,486,8,8,10,18,29,59,-30,34
Edinburgh Ci,486,9,7,9,20,36,62,-26,30
Cowdenbeath,486,10,5,10,21,25,54,-29,25
Montrose,487,1,23,7,6,59,35,24,76
Peterhead,487,2,23,5,8,80,41,39,74
Stirling,487,3,16,7,13,61,52,9,55
Stenhousem'r,487,4,15,9,12,56,47,9,54
Clyde,487,5,15,9,12,55,48,7,54
Elgin,487,6,15,6,15,54,60,-6,51
Annan Athlet,487,7,11,12,13,48,42,6,45
Berwick,487,8,8,10,18,29,62,-33,34
Edinburgh Ci,487,9,7,10,19,39,63,-24,31
Cowdenbeath,487,10,4,11,21,24,55,-31,23
Peterhead,488,1,24,4,8,79,39,40,76
Montrose,488,2,23,7,6,59,37,22,76
Stenhousem'r,488,3,16,8,12,59,47,12,56
Stirling,488,4,16,6,14,61,55,6,54
Clyde,488,5,14,9,13,51,49,2,51
Elgin,488,6,15,6,15,56,60,-4,51
Annan Athlet,488,7,11,11,14,47,42,5,44
Berwick,488,8,9,10,17,30,58,-28,37
Edinburgh Ci,488,9,7,9,20,37,62,-25,30
Cowdenbeath,488,10,5,10,21,24,54,-30,25
Montrose,489,1,24,7,5,63,36,27,79
Peterhead,489,2,24,4,8,81,40,41,76
Stirling,489,3,17,6,13,62,51,11,57
Stenhousem'r,489,4,15,8,13,55,48,7,53
Clyde,489,5,14,10,12,51,48,3,52
Elgin,489,6,14,6,16,55,64,-9,48
Annan Athlet,489,7,11,12,13,47,41,6,45
Berwick,489,8,8,11,17,29,58,-29,35
Edinburgh Ci,489,9,7,9,20,38,64,-26,30
Cowdenbeath,489,10,4,11,21,23,54,-31,23
Montrose,490,1,23,7,6,59,35,24,76
Peterhead,490,2,23,5,8,78,39,39,74
Stirling,490,3,16,7,13,61,52,9,55
Stenhousem'r,490,4,15,9,12,56,47,9,54
Clyde,490,5,14,9,13,52,51,1,51
Elgin,490,6,15,6,15,54,60,-6,51
Annan Athlet,490,7,11,12,13,47,41,6,45
Berwick,490,8,9,10,17,32,59,-27,37
Edinburgh Ci,490,9,7,10,19,37,61,-24,31
Cowdenbeath,490,10,4,11,21,23,54,-31,23
Montrose,491,1,24,7,5,60,34,26,79
Peterhead,491,2,24,4,8,79,39,40,76
Stirling,491,3,16,7,13,61,52,9,55
Stenhousem'r,491,4,15,9,12,56,47,9,54
Clyde,491,5,14,10,12,51,48,3,52
Elgin,491,6,14,6,16,53,61,-8,48
Annan Athlet,491,7,12,11,13,48,41,7,47
Berwick,491,8,8,11,17,29,58,-29,35
Edinburgh Ci,491,9,7,9,20,37,62,-25,30
Cowdenbeath,491,10,4,10,22,23,55,-32,22
Montrose,492,1,24,7,5,61,35,26,79
Peterhead,492,2,24,4,8,80,39,41,76
Stirling,492,3,17,6,13,61,51,10,57
Clyde,492,4,15,9,12,54,50,4,54
Stenhousem'r,492,5,15,8,13,55,47,8,53
Elgin,492,6,14,6,16,54,62,-8,48
Annan Athlet,492,7,12,11,13,50,42,8,47
Berwick,492,8,8,10,18,31,61,-30,34
Edinburgh Ci,492,9,7,9,20,37,63,-26,30
Cowdenbeath,492,10,4,10,22,24,57,-33,22
Montrose,493,1,24,7,5,60,34,26,79
Peterhead,493,2,24,4,8,82,38,44,76
Stirling,493,3,17,6,13,64,51,13,57
Clyde,493,4,15,9,12,53,49,4,54
Stenhousem'r,493,5,15,8,13,55,50,5,53
Elgin,493,6,14,6,16,53,61,-8,48
Annan Athlet,493,7,11,11,14,47,44,3,44
Berwick,493,8,8,10,18,30,60,-30,34
Edinburgh Ci,493,9,7,9,20,36,65,-29,30
Cowdenbeath,493,10,5,10,21,26,54,-28,25
Peterhead,494,1,24,4,8,79,38,41,76
Montrose,494,2,23,7,6,61,37,24,76
Stenhousem'r,494,3,16,8,12,56,46,10,56
Stirling,494,4,16,6,14,60,52,8,54
Clyde,494,5,15,9,12,55,49,6,54
Elgin,494,6,15,6,15,56,62,-6,51
Annan Athlet,494,7,11,12,13,49,43,6,45
Berwick,494,8,8,10,18,30,62,-32,34
Edinburgh Ci,494,9,7,9,20,36,62,-26,30
Cowdenbeath,494,10,4,11,21,25,56,-31,23
Montrose,495,1,23,8,5,62,37,25,77
Peterhead,495,2,24,4,8,82,39,43,76
Stirling,495,3,17,6,13,62,51,11,57
Stenhousem'r,495,4,15,8,13,55,48,7,53
Clyde,495,5,14,9,13,51,49,2,51
Elgin,495,6,14,7,15,56,63,-7,49
Annan Athlet,495,7,11,12,13,48,42,6,45
Berwick,495,8,9,10,17,30,58,-28,37
Edinburgh Ci,495,9,7,9,20,37,65,-28,30
Cowdenbeath,495,10,4,11,21,24,55,-31,23
Montrose,496,1,24,7,5,61,34,27,79
Peterhead,496,2,23,4,9,78,40,38,73
Stirling,496,3,17,6,13,62,51,11,57
Clyde,496,4,15,9,12,55,50,5,54
Stenhousem'r,496,5,15,8,13,55,48,7,53
Elgin,496,6,14,6,16,53,62,-9,48
Annan Athlet,496,7,11,11,14,47,42,5,44
Berwick,496,8,8,10,18,31,62,-31,34
Edinburgh Ci,496,9,8,9,19,38,61,-23,33
Cowdenbeath,496,10,5,10,21,24,54,-30,25
Peterhead,497,1,24,4,8,81,39,42,76
Montrose,497,2,23,7,6,59,35,24,76
Stirling,497,3,16,7,13,63,54,9,55
Stenhousem'r,497,4,15,9,12,58,49,9,54
Clyde,497,5,14,9,13,52,50,2,51
Elgin,497,6,15,6,15,54,60,-6,51
Annan Athlet,497,7,11,11,14,47,42,5,44
Berwick,497,8,9,10,17,31,59,-28,37
Edinburgh Ci,497,9,7,9,20,37,64,-27,30
Cowdenbeath,497,10,5,10,21,24,54,-30,25
Montrose,498,1,23,8,5,59,34,25,77
Peterhead,498,2,24,4,8,82,40,42,76
Stirling,498,3,17,6,13,64,52,12,57
Clyde,498,4,15,9,12,53,48,5,54
Stenhousem'r,498,5,15,8,13,56,50,6,53
Elgin,498,6,14,7,15,53,60,-7,49
Annan Athlet,498,7,11,11,14,49,44,5,44
Berwick,498,8,8,10,18,29,60,-31,34
Edinburgh Ci,498,9,7,9,20,38,65,-27,30
Cowdenbeath,498,10,5,10,21,26,56,-30,25
Montrose,499,1,23,8,5,61,36,25,77
Peterhead,499,2,24,4,8,82,38,44,76
Stenhousem'r,499,3,16,8,12,58,47,11,56
Stirling,499,4,16,6,14,61,54,7,54
Clyde,499,5,14,10,12,52,49,3,52
Elgin,499,6,14,7,15,55,62,-7,49
Annan Athlet,499,7,12,11,13,48,41,7,47
Berwick,499,8,8,11,17,30,59,-29,35
Edinburgh Ci,499,9,7,9,20,36,65,-29,30
Cowdenbeath,499,10,4,10,22,23,55,-32,22
Peterhead,500,1,24,4,8,83,39,44,76
Montrose,500,2,23,7,6,61,37,24,76
Stenhousem'r,500,3,16,8,12,57,47,10,56
Stirling,500,4,16,6,14,61,53,8,54
Clyde,500,5,14,10,12,52,49,3,52
Elgin,500,6,15,6,15,56,62,-6,51
Annan Athlet,500,7,11,11,14,48,44,4,44
Berwick,500,8,8,11,17,30,59,-29,35
Edinburgh Ci,500,9,7,9,20,37,66,-29,30
Cowdenbeath,500,10,5,10,21,26,55,-29,25
Peterhead,501,1,24,4,8,79,38,41,76
Montrose,501,2,23,7,6,60,36,24,76
Stirling,501,3,17,6,13,65,54,11,57
Clyde,501,4,15,9,12,53,48,5,54
Stenhousem'r,501,5,15,8,13,58,51,7,53
Elgin,501,6,15,6,15,55,61,-6,51
Annan Athlet,501,7,12,11,13,48,41,7,47
Berwick,501,8,8,10,18,29,60,-31,34
Edinburgh Ci,501,9,7,9,20,36,62,-26,30
Cowdenbeath,501,10,4,10,22,23,55,-32,22
Montrose,502,1,23,7,6,59,36,23,76
Peterhead,502,2,23,5,8,78,39,39,74
Stirling,502,3,17,6,13,64,51,13,57
Stenhousem'r,502,4,15,8,13,55,50,5,53
Clyde,502,5,14,9,13,53,51,2,51
Elgin,502,6,15,6,15,55,60,-5,51
Annan Athlet,502,7,11,12,13,48,42,6,45
Berwick,502,8,9,10,17,32,60,-28,37
Edinburgh Ci,502,9,7,10,19,37,61,-24,31
Cowdenbeath,502,10,4,11,21,24,55,-31,23
Montrose,503,1,24,7,5,63,35,28,79
Peterhead,503,2,24,4,8,80,38,42,76
Stirling,503,3,17,6,13,61,51,10,57
Clyde,503,4,15,9,12,54,49,5,54
Stenhousem'r,503,5,15,8,13,55,47,8,53
Elgin,503,6,14,6,16,54,64,-10,48
Annan Athlet,503,7,11,11,14,47,42,5,44
Berwick,503,8,8,10,18,30,61,-31,34
Edinburgh Ci,503,9,7,9,20,36,63,-27,30
Cowdenbeath,503,10,5,10,21,24,54,-30,25
Montrose,504,1,24,7,5,62,35,27,79
Peterhead,504,2,23,5,8,79,40,39,74
Stirling,504,3,17,6,13,63,51,12,57
Clyde,504,4,15,9,12,52,48,4,54
Stenhousem'r,504,5,15,8,13,55,49,6,53
Elgin,504,6,14,6,16,54,63,-9,48
Annan Athlet,504,7,11,12,13,47,41,6,45
Berwick,504,8,8,10,18,29,59,-30,34
Edinburgh Ci,504,9,7,10,19,38,62,-24,31
Cowdenbeath,504,10,4,11,21,23,54,-31,23
Montrose,505,1,24,7,5,61,34,27,79
Peterhead,505,2,24,4,8,86,38,48,76
Stirling,505,3,17,6,13,63,51,12,57
Clyde,505,4,15,9,12,54,50,4,54
Stenhousem'r,505,5,15,8,13,55,49,6,53
Elgin,505,6,14,6,16,53,62,-9,48
Annan Athlet,505,7,11,11,14,47,42,5,44
Berwick,505,8,8,10,18,31,61,-30,34
Edinburgh Ci,505,9,7,9,20,36,69,-33,30
Cowdenbeath,505,10,5,10,21,24,54,-30,25
Montrose,506,1,24,7,5,64,36,28,79
Peterhead,506,2,23,4,9,77,41,36,73
Stenhousem'r,506,3,16,8,12,58,47,11,56
Stirling,506,4,16,6,14,61,54,7,54
Clyde,506,5,15,9,12,54,49,5,54
Elgin,506,6,14,6,16,55,65,-10,48
Annan Athlet,506,7,12,11,13,50,42,8,47
Berwick,506,8,8,10,18,30,61,-31,34
Edinburgh Ci,506,9,8,9,19,39,60,-21,33
Cowdenbeath,506,10,4,10,22,24,57,-33,22
Montrose,507,1,24,7,5,63,34,29,79
Peterhead,507,2,24,4,8,82,39,43,76
Stenhousem'r,507,3,16,8,12,58,46,12,56
Stirling,507,4,16,6,14,60,54,6,54
Clyde,507,5,15,9,12,54,50,4,54
Elgin,507,6,14,6,16,53,64,-11,48
Annan Athlet,507,7,11,11,14,47,42,5,44
Berwick,507,8,8,10,18,31,61,-30,34
Edinburgh Ci,507,9,7,9,20,37,65,-28,30
Cowdenbeath,507,10,5,10,21,24,54,-30,25
Montrose,508,1,23,8,5,61,36,25,77
Peterhead,508,2,24,4,8,78,38,40,76
Stirling,508,3,17,6,13,63,51,12,57
Clyde,508,4,15,9,12,55,49,6,54
Stenhousem'r,508,5,15,8,13,55,49,6,53
Elgin,508,6,14,7,15,55,62,-7,49
Annan Athlet,508,7,12,11,13,48,41,7,47
Berwick,508,8,8,10,18,30,62,-32,34
Edinburgh Ci,508,9,7,9,20,36,61,-25,30
Cowdenbeath,508,10,4,10,22,23,55,-32,22
Montrose,509,1,24,7,5,63,34,29,79
Peterhead,509,2,24,4,8,80,38,42,76
Stirling,509,3,17,6,13,61,51,10,57
Stenhousem'r,509,4,15,8,13,55,47,8,53
Clyde,509,5,14,10,12,55,52,3,52
Elgin,509,6,14,6,16,53,64,-11,48
Annan Athlet,509,7,11,12,13,49,43,6,45
Berwick,509,8,8,11,17,33,62,-29,35
Edinburgh Ci,509,9,7,9,20,36,63,-27,30
Cowdenbeath,509,10,4,11,21,25,56,-31,23
Peterhead,510,1,24,4,8,82,38,44,76
Montrose,510,2,23,7,6,60,37,23,76
Stenhousem'r,510,3,16,8,12,56,46,10,56
Stirling,510,4,16,6,14,60,52,8,54
Clyde,510,5,14,10,12,54,51,3,52
Elgin,510,6,15,6,15,56,61,-5,51
Annan Athlet,510,7,12,11,13,49,42,7,47
Berwick,510,8,8,11,17,32,61,-29,35
Edinburgh Ci,510,9,7,9,20,36,65,-29,30
Cowdenbeath,510,10,4,10,22,24,56,-32,22
Montrose,511,1,24,7,5,63,34,29,79
Peterhead,511,2,23,5,8,78,39,39,74
Stirling,511,3,17,6,13,63,51,12,57
Stenhousem'r,511,4,15,8,13,55,49,6,53
Clyde,511,5,14,10,12,53,50,3,52
Elgin,511,6,14,6,16,53,64,-11,48
Annan Athlet,511,7,12,11,13,48,41,7,47
Berwick,511,8,8,11,17,31,60,-29,35
Edinburgh Ci,511,9,7,10,19,37,61,-24,31
Cowdenbeath,511,10,4,10,22,23,55,-32,22
Montrose,512,1,23,8,5,60,35,25,77
Peterhead,512,2,24,4,8,82,38,44,76
Stirling,512,3,16,7,13,61,52,9,55
Stenhousem'r,512,4,15,9,12,56,47,9,54
Clyde,512,5,14,9,13,51,49,2,51
Elgin,512,6,14,7,15,54,61,-7,49
Annan Athlet,512,7,12,11,13,49,42,7,47
Berwick,512,8,9,10,17,30,58,-28,37
Edinburgh Ci,512,9,7,9,20,36,65,-29,30
Cowdenbeath,512,10,4,10,22,24,56,-32,22
Montrose,513,1,24,7,5,62,34,28,79
Peterhead,513,2,24,4,8,81,39,42,76
Stirling,513,3,17,6,13,63,52,11,57
Clyde,513,4,15,9,12,55,49,6,54
Stenhousem'r,513,5,15,8,13,56,49,7,53
Elgin,513,6,14,6,16,53,63,-10,48
Annan Athlet,513,7,12,11,13,48,41,7,47
Berwick,513,8,8,10,18,30,62,-32,34
Edinburgh Ci,513,9,7,9,20,37,64,-27,30
Cowdenbeath,513,10,4,10,22,23,55,-32,22
Montrose,514,1,24,7,5,61,34,27,79
Peterhead,514,2,24,4,8,80,38,42,76
Stirling,514,3,16,7,13,61,52,9,55
Stenhousem'r,514,4,15,9,12,56,47,9,54
Clyde,514,5,15,9,12,55,50,5,54
Elgin,514,6,14,6,16,53,62,-9,48
Annan Athlet,514,7,12,11,13,48,41,7,47
Berwick,514,8,8,10,18,31,62,-31,34
Edinburgh Ci,514,9,7,9,20,36,63,-27,30
Cowdenbeath,514,10,4,10,22,23,55,-32,22
Montrose,515,1,23,8,5,61,36,25,77
Peterhead,515,2,23,5,8,77,38,39,74
Stirling,515,3,17,6,13,64,51,13,57
Clyde,515,4,15,9,12,52,48,4,54
Stenhousem'r,515,5,15,8,13,55,50,5,53
Elgin,515,6,14,7,15,55,62,-7,49
Annan Athlet,515,7,12,11,13,50,42,8,47
Berwick,515,8,8,10,18,29,59,-30,34
Edinburgh Ci,515,9,7,10,19,36,60,-24,31
Cowdenbeath,515,10,4,10,22,24,57,-33,22
Peterhead,516,1,24,4,8,79,38,41,76
Montrose,516,2,23,7,6,61,37,24,76
Stirling,516,3,17,6,13,63,53,10,57
Clyde,516,4,15,9,12,55,50,5,54
Stenhousem'r,516,5,15,8,13,57,49,8,53
Elgin,516,6,15,6,15,56,62,-6,51
Annan Athlet,516,7,11,12,13,48,42,6,45
Berwick,516,8,8,10,18,31,62,-31,34
Edinburgh Ci,516,9,7,9,20,36,62,-26,30
Cowdenbeath,516,10,4,11,21,24,55,-31,23
Montrose,517,1,24,7,5,60,34,26,79
Peterhead,517,2,23,5,8,77,38,39,74
Stirling,517,3,17,6,13,64,54,10,57
Clyde,517,4,15,9,12,56,48,8,54
Stenhousem'r,517,5,15,8,13,58,50,8,53
Elgin,517,6,14,6,16,53,61,-8,48
Annan Athlet,517,7,11,12,13,48,42,6,45
Berwick,517,8,8,10,18,29,63,-34,34
Edinburgh Ci,517,9,7,10,19,36,60,-24,31
Cowdenbeath,517,10,4,11,21,24,55,-31,23
Montrose,518,1,24,7,5,62,34,28,79
Peterhead,518,2,24,4,8,81,39,42,76
Stirling,518,3,16,7,13,62,53,9,55
Stenhousem'r,518,4,15,9,12,57,48,9,54
Clyde,518,5,14,10,12,53,50,3,52
Elgin,518,6,14,6,16,53,63,-10,48
Annan Athlet,518,7,12,11,13,48,41,7,47
Berwick,518,8,8,11,17,31,60,-29,35
Edinburgh Ci,518,9,7,9,20,37,64,-27,30
Cowdenbeath,518,10,4,10,22,23,55,-32,22
Montrose,519,1,24,7,5,63,35,28,79
Peterhead,519,2,23,4,9,77,40,37,73
Stirling,519,3,17,6,13,63,52,11,57
Stenhousem'r,519,4,15,8,13,56,49,7,53
Clyde,519,5,14,9,13,53,51,2,51
Elgin,519,6,14,6,16,54,64,-10,48
Annan Athlet,519,7,11,12,13,47,41,6,45
Berwick,519,8,9,10,17,32,60,-28,37
Edinburgh Ci,519,9,8,9,19,38,60,-22,33
Cowdenbeath,519,10,4,11,21,23,54,-31,23
Montrose,520,1,24,7,5,61,34,27,79
Peterhead,520,2,24,4,8,78,38,40,76
Stirling,520,3,16,7,13,61,52,9,55
Stenhousem'r,520,4,15,9,12,56,47,9,54
Clyde,520,5,14,9,13,53,51,2,51
Elgin,520,6,14,6,16,53,62,-9,48
Annan Athlet,520,7,11,11,14,48,43,5,44
Berwick,520,8,9,10,17,32,60,-28,37
Edinburgh Ci,520,9,7,9,20,36,61,-25,30
Cowdenbeath,520,10,5,10,21,25,55,-30,25
Montrose,521,1,24,7,5,62,34,28,79
Peterhead,521,2,23,4,9,79,42,37,73
Stirling,521,3,17,6,13,61,51,10,57
Stenhousem'r,521,4,15,8,13,55,47,8,53
Clyde,521,5,14,10,12,51,48,3,52
Elgin,521,6,14,6,16,53,63,-10,48
Annan Athlet,521,7,11,11,14,47,42,5,44
Berwick,521,8,8,11,17,29,58,-29,35
Edinburgh Ci,521,9,8,9,19,40,62,-22,33
Cowdenbeath,521,10,5,10,21,24,54,-30,25
Montrose,522,1,24,7,5,61,34,27,79
Peterhead,522,2,24,4,8,82,39,43,76
Stirling,522,3,16,7,13,61,52,9,55
Stenhousem'r,522,4,15,9,12,56,47,9,54
Clyde,522,5,15,9,12,54,49,5,54
Elgin,522,6,14,6,16,53,62,-9,48
Annan Athlet,522,7,11,12,13,50,44,6,45
Berwick,522,8,8,10,18,30,61,-31,34
Edinburgh Ci,522,9,7,9,20,37,65,-28,30
Cowdenbeath,522,10,4,11,21,26,57,-31,23
Montrose,523,1,23,8,5,59,34,25,77
Peterhead,523,2,24,4,8,80,39,41,76
Stirling,523,3,17,6,13,63,51,12,57
Clyde,523,4,15,9,12,55,49,6,54
Stenhousem'r,523,5,15,8,13,55,49,6,53
Elgin,523,6,14,7,15,53,60,-7,49
Annan Athlet,523,7,11,11,14,47,43,4,44
Berwick,523,8,8,10,18,30,62,-32,34
Edinburgh Ci,523,9,7,9,20,37,63,-26,30
Cowdenbeath,523,10,5,10,21,25,54,-29,25
Montrose,524,1,24,7,5,63,36,27,79
Peterhead,524,2,24,4,8,79,38,41,76
Stirling,524,3,17,6,13,65,53,12,57
Clyde,524,4,15,9,12,53,48,5,54
Stenhousem'r,524,5,15,8,13,57,51,6,53
Elgin,524,6,14,6,16,55,64,-9,48
Annan Athlet,524,7,11,11,14,47,42,5,44
Berwick,524,8,8,10,18,29,60,-31,34
Edinburgh Ci,524,9,7,9,20,36,62,-26,30
Cowdenbeath,524,10,5,10,21,24,54,-30,25
Peterhead,525,1,24,4,8,81,39,42,76
Montrose,525,2,23,7,6,61,37,24,76
Stirling,525,3,17,6,13,64,52,12,57
Clyde,525,4,15,9,12,53,49,4,54
Stenhousem'r,525,5,15,8,13,56,50,6,53
Elgin,525,6,15,6,15,56,62,-6,51
Annan Athlet,525,7,11,12,13,49,43,6,45
Berwick,525,8,8,10,18,30,60,-30,34
Edinburgh Ci,525,9,7,9,20,37,64,-27,30
Cowdenbeath,525,10,4,11,21,25,56,-31,23
Montrose,526,1,23,8,5,60,35,25,77
Peterhead,526,2,24,4,8,81,38,43,76
Stirling,526,3,16,7,13,62,53,9,55
Stenhousem'r,526,4,15,9,12,57,48,9,54
Clyde,526,5,15,9,12,56,49,7,54
Elgin,526,6,14,7,15,54,61,-7,49
Annan Athlet,526,7,11,12,13,49,43,6,45
Berwick,526,8,8,10,18,30,63,-33,34
Edinburgh Ci,526,9,7,9,20,36,64,-28,30
Cowdenbeath,526,10,4,11,21,25,56,-31,23
Peterhead,527,1,24,4,8,80,38,42,76
Montrose,527,2,23,7,6,60,36,24,76
Stenhousem'r,527,3,16,8,12,57,47,10,56
Stirling,527,4,16,6,14,61,53,8,54
Clyde,527,5,14,10,12,51,48,3,52
Elgin,527,6,15,6,15,55,61,-6,51
Annan Athlet,527,7,12,11,13,49,42,7,47
Berwick,527,8,8,11,17,29,58,-29,35
Edinburgh Ci,527,9,7,9,20,36,63,-27,30
Cowdenbeath,527,10,4,10,22,24,56,-32,22
Montrose,528,1,23,8,5,61,36,25,77
Peterhead,528,2,24,4,8,80,40,40,76
Stirling,528,3,17,6,13,62,52,10,57
Stenhousem'r,528,4,15,8,13,56,48,8,53
Clyde,528,5,14,9,13,52,51,1,51
Elgin,528,6,14,7,15,55,62,-7,49
Annan Athlet,528,7,12,11,13,48,41,7,47
Berwick,528,8,9,10,17,32,59,-27,37
Edinburgh Ci,528,9,7,9,20,38,63,-25,30
Cowdenbeath,528,10,4,10,22,23,55,-32,22
Peterhead,529,1,24,4,8,79,38,41,76
Montrose,529,2,23,7,6,59,35,24,76
Stenhousem'r,529,3,16,8,12,58,47,11,56
Stirling,529,4,16,6,14,61,54,7,54
Clyde,529,5,15,9,12,53,48,5,54
Elgin,529,6,15,6,15,54,60,-6,51
Annan Athlet,529,7,12,11,13,48,41,7,47
Berwick,529,8,8,10,18,29,60,-31,34
Edinburgh Ci,529,9,7,9,20,36,62,-26,30
Cowdenbeath,529,10,4,10,22,23,55,-32,22
Montrose,530,1,24,7,5,63,34,29,79
Peterhead,530,2,24,4,8,82,38,44,76
Stirling,530,3,16,7,13,61,52,9,55
Stenhousem'r,530,4,15,9,12,56,47,9,54
Clyde,530,5,14,9,13,51,49,2,51
Elgin,530,6,14,6,16,53,64,-11,48
Annan Athlet,530,7,12,11,13,49,42,7,47
Berwick,530,8,9,10,17,30,58,-28,37
Edinburgh Ci,530,9,7,9,20,36,65,-29,30
Cowdenbeath,530,10,4,10,22,24,56,-32,22
Peterhead,531,1,24,4,8,79,39,40,76
Montrose,531,2,23,7,6,60,36,24,76
Stenhousem'r,531,3,16,8,12,59,49,10,56
Stirling,531,4,16,6,14,63,55,8,54
Clyde,531,5,14,10,12,53,50,3,52
Elgin,531,6,15,6,15,55,61,-6,51
Annan Athlet,531,7,11,12,13,47,41,6,45
Berwick,531,8,8,11,17,31,60,-29,35
Edinburgh Ci,531,9,7,9,20,37,62,-25,30
Cowdenbeath,531,10,4,11,21,23,54,-31,23
Peterhead,532,1,24,4,8,79,38,41,76
Montrose,532,2,23,7,6,60,36,24,76
Stirling,532,3,17,6,13,62,52,10,57
Stenhousem'r,532,4,15,8,13,56,48,8,53
Clyde,532,5,14,10,12,51,48,3,52
Elgin,532,6,15,6,15,55,61,-6,51
Annan Athlet,532,7,11,11,14,48,43,5,44
Berwick,532,8,8,11,17,29,58,-29,35
Edinburgh Ci,532,9,7,9,20,36,62,-26,30
Cowdenbeath,532,10,5,10,21,25,55,-30,25
Montrose,533,1,24,7,5,61,35,26,79
Peterhead,533,2,24,4,8,79,38,41,76
Stirling,533,3,17,6,13,62,52,10,57
Clyde,533,4,15,9,12,52,48,4,54
Stenhousem'r,533,5,15,8,13,56,48,8,53
Elgin,533,6,14,6,16,54,62,-8,48
Annan Athlet,533,7,11,11,14,48,43,5,44
Berwick,533,8,8,10,18,29,59,-30,34
Edinburgh Ci,533,9,7,9,20,36,62,-26,30
Cowdenbeath,533,10,5,10,21,25,55,-30,25
Montrose,534,1,24,7,5,62,34,28,79
Peterhead,534,2,24,4,8,79,39,40,76
Stenhousem'r,534,3,16,8,12,56,46,10,56
Stirling,534,4,16,6,14,60,52,8,54
Clyde,534,5,15,9,12,54,49,5,54
Elgin,534,6,14,6,16,53,63,-10,48
Annan Athlet,534,7,11,11,14,47,43,4,44
Berwick,534,8,8,10,18,30,61,-31,34
Edinburgh Ci,534,9,7,9,20,37,62,-25,30
Cowdenbeath,534,10,5,10,21,25,54,-29,25
Montrose,535,1,24,7,5,64,35,29,79
Peterhead,535,2,24,4,8,81,39,42,76
Stenhousem'r,535,3,16,8,12,59,46,13,56
Stirling,535,4,16,6,14,60,55,5,54
Clyde,535,5,14,10,12,52,49,3,52
Elgin,535,6,14,6,16,54,65,-11,48
Annan Athlet,535,7,11,11,14,47,42,5,44
Berwick,535,8,8,11,17,30,59,-29,35
Edinburgh Ci,535,9,7,9,20,37,64,-27,30
Cowdenbeath,535,10,5,10,21,24,54,-30,25
Montrose,536,1,23,8,5,60,35,25,77
Peterhead,536,2,24,4,8,79,38,41,76
Stirling,536,3,17,6,13,62,52,10,57
Clyde,536,4,15,9,12,53,49,4,54
Stenhousem'r,536,5,15,8,13,56,48,8,53
Elgin,536,6,14,7,15,54,61,-7,49
Annan Athlet,536,7,11,11,14,47,44,3,44
Berwick,536,8,8,10,18,30,60,-30,34
Edinburgh Ci,536,9,7,9,20,36,62,-26,30
Cowdenbeath,536,10,5,10,21,26,54,-28,25
Montrose,537,1,23,8,5,60,35,25,77
Peterhead,537,2,24,4,8,79,38,41,76
Stirling,537,3,17,6,13,64,53,11,57
Clyde,537,4,15,9,12,54,50,4,54
Stenhousem'r,537,5,15,8,13,57,50,7,53
Elgin,537,6,14,7,15,54,61,-7,49
Annan Athlet,537,7,11,12,13,47,41,6,45
Berwick,537,8,8,10,18,31,61,-30,34
Edinburgh Ci,537,9,7,9,20,36,62,-26,30
Cowdenbeath,537,10,4,11,21,23,54,-31,23
Montrose,538,1,23,8,5,59,34,25,77
Peterhead,538,2,24,4,8,82,39,43,76
Stirling,538,3,17,6,13,62,51,11,57
Clyde,538,4,15,9,12,53,49,4,54
Stenhousem'r,538,5,15,8,13,55,48,7,53
Elgin,538,6,14,7,15,53,60,-7,49
Annan Athlet,538,7,11,11,14,47,43,4,44
Berwick,538,8,8,10,18,30,60,-30,34
Edinburgh Ci,538,9,7,9,20,37,65,-28,30
Cowdenbeath,538,10,5,10,21,25,54,-29,25
Montrose,539,1,24,7,5,61,34,27,79
Peterhead,539,2,24,4,8,80,39,41,76
Stirling,539,3,16,7,13,63,54,9,55
Stenhousem'r,539,4,15,9,12,58,49,9,54
Clyde,539,5,15,9,12,53,48,5,54
Elgin,539,6,14,6,16,53,62,-9,48
Annan Athlet,539,7,12,11,13,51,43,8,47
Berwick,539,8,8,10,18,29,60,-31,34
Edinburgh Ci,539,9,7,9,20,37,63,-26,30
Cowdenbeath,539,10,4,10,22,25,58,-33,22
Montrose,540,1,23,8,5,60,35,25,77
Peterhead,540,2,23,4,9,78,42,36,73
Stirling,540,3,17,6,13,62,51,11,57
Clyde,540,4,15,9,12,54,48,6,54
Stenhousem'r,540,5,15,8,13,55,48,7,53
Elgin,540,6,14,7,15,54,61,-7,49
Annan Athlet,540,7,12,11,13,49,41,8,47
Berwick,540,8,8,10,18,29,61,-32,34
Edinburgh Ci,540,9,8,9,19,40,61,-21,33
Cowdenbeath,540,10,4,10,22,23,56,-33,22
Montrose,541,1,23,8,5,61,36,25,77
Peterhead,541,2,24,4,8,79,39,40,76
Stirling,541,3,17,6,13,62,52,10,57
Stenhousem'r,541,4,15,8,13,56,48,8,53
Clyde,541,5,14,10,12,51,48,3,52
Elgin,541,6,14,7,15,55,62,-7,49
Annan Athlet,541,7,11,12,13,48,42,6,45
Berwick,541,8,8,11,17,29,58,-29,35
Edinburgh Ci,541,9,7,9,20,37,62,-25,30
Cowdenbeath,541,10,4,11,21,24,55,-31,23
Montrose,542,1,24,7,5,61,34,27,79
Peterhead,542,2,23,4,9,77,40,37,73
Stirling,542,3,16,7,13,61,52,9,55
Stenhousem'r,542,4,15,9,12,56,47,9,54
Clyde,542,5,15,9,12,54,49,5,54
Elgin,542,6,14,6,16,53,62,-9,48
Annan Athlet,542,7,11,11,14,48,43,5,44
Berwick,542,8,8,10,18,30,61,-31,34
Edinburgh Ci,542,9,8,9,19,38,60,-22,33
Cowdenbeath,542,10,5,10,21,25,55,-30,25
Montrose,543,1,24,7,5,62,34,28,79
Peterhead,543,2,24,4,8,78,38,40,76
Stirling,543,3,16,7,13,63,54,9,55
Stenhousem'r,543,4,15,9,12,58,49,9,54
Clyde,543,5,15,9,12,56,49,7,54
Elgin,543,6,14,6,16,53,63,-10,48
Annan Athlet,543,7,12,11,13,48,41,7,47
Berwick,543,8,8,10,18,30,63,-33,34
Edinburgh Ci,543,9,7,9,20,36,61,-25,30
Cowdenbeath,543,10,4,10,22,23,55,-32,22
Montrose,544,1,23,7,6,59,35,24,76
Peterhead,544,2,23,5,8,79,40,39,74
Stirling,544,3,16,7,13,60,51,9,55
Stenhousem'r,544,4,15,9,12,55,46,9,54
Clyde,544,5,15,9,12,54,50,4,54
Elgin,544,6,15,6,15,54,60,-6,51
Annan Athlet,544,7,11,12,13,48,42,6,45
Berwick,544,8,8,10,18,31,61,-30,34
Edinburgh Ci,544,9,7,10,19,38,62,-24,31
Cowdenbeath,544,10,4,11,21,24,55,-31,23
Montrose,545,1,23,8,5,61,36,25,77
Peterhead,545,2,23,5,8,78,39,39,74
Stirling,545,3,17,6,13,61,51,10,57
Stenhousem'r,545,4,15,8,13,55,47,8,53
Clyde,545,5,14,9,13,52,50,2,51
Elgin,545,6,14,7,15,55,62,-7,49
Annan Athlet,545,7,11,12,13,47,41,6,45
Berwick,545,8,9,10,17,31,59,-28,37
Edinburgh Ci,545,9,7,10,19,37,61,-24,31
Cowdenbeath,545,10,4,11,21,23,54,-31,23
Peterhead,546,1,24,4,8,82,39,43,76
Montrose,546,2,23,7,6,59,36,23,76
Stirling,546,3,17,6,13,63,52,11,57
Clyde,546,4,15,9,12,52,48,4,54
Stenhousem'r,546,5,15,8,13,56,49,7,53
Elgin,546,6,15,6,15,55,60,-5,51
Annan Athlet,546,7,12,11,13,49,42,7,47
Berwick,546,8,8,10,18,29,59,-30,34
Edinburgh Ci,546,9,7,9,20,37,65,-28,30
Cowdenbeath,546,10,4,10,22,24,56,-32,22
Montrose,547,1,24,7,5,60,34,26,79
Peterhead,547,2,23,5,8,79,40,39,74
Stirling,547,3,17,6,13,61,51,10,57
Stenhousem'r,547,4,15,8,13,55,47,8,53
Clyde,547,5,14,9,13,52,51,1,51
Elgin,547,6,14,6,16,53,61,-8,48
Annan Athlet,547,7,11,11,14,47,42,5,44
Berwick,547,8,9,10,17,32,59,-27,37
Edinburgh Ci,547,9,7,10,19,38,62,-24,31
Cowdenbeath,547,10,5,10,21,24,54,-30,25
Montrose,548,1,24,7,5,61,34,27,79
Peterhead,548,2,24,4,8,81,40,41,76
Stirling,548,3,16,7,13,63,54,9,55
Stenhousem'r,548,4,15,9,12,58,49,9,54
Clyde,548,5,14,10,12,53,50,3,52
Elgin,548,6,14,6,16,53,62,-9,48
Annan Athlet,548,7,11,11,14,47,43,4,44
Berwick,548,8,8,11,17,31,60,-29,35
Edinburgh Ci,548,9,7,9,20,38,64,-26,30
Cowdenbeath,548,10,5,10,21,25,54,-29,25
Montrose,549,1,24,7,5,63,35,28,79
Peterhead,549,2,24,4,8,81,40,41,76
Stirling,549,3,16,7,13,61,52,9,55
Stenhousem'r,549,4,15,9,12,56,47,9,54
Clyde,549,5,14,9,13,53,51,2,51
Elgin,549,6,14,6,16,54,64,-10,48
Annan Athlet,549,7,12,11,13,49,41,8,47
Berwick,549,8,9,10,17,32,60,-28,37
Edinburgh Ci,549,9,7,9,20,38,64,-26,30
Cowdenbeath,549,10,4,10,22,23,56,-33,22
Montrose,550,1,24,7,5,61,34,27,79
Peterhead,550,2,24,4,8,79,38,41,76
Stirling,550,3,17,6,13,65,53,12,57
Stenhousem'r,550,4,15,8,13,57,51,6,53
Clyde,550,5,14,10,12,53,50,3,52
Elgin,550,6,14,6,16,53,62,-9,48
Annan Athlet,550,7,12,11,13,50,43,7,47
Berwick,550,8,8,11,17,31,60,-29,35
Edinburgh Ci,550,9,7,9,20,36,62,-26,30
Cowdenbeath,550,10,4,10,22,25,57,-32,22
Montrose,551,1,24,7,5,64,36,28,79
Peterhead,551,2,24,4,8,83,38,45,76
Stirling,551,3,17,6,13,62,52,10,57
Stenhousem'r,551,4,15,8,13,56,48,8,53
Clyde,551,5,14,10,12,52,49,3,52
Elgin,551,6,14,6,16,55,65,-10,48
Annan Athlet,551,7,11,11,14,47,42,5,44
Berwick,551,8,8,11,17,30,59,-29,35
Edinburgh Ci,551,9,7,9,20,36,66,-30,30
Cowdenbeath,551,10,5,10,21,24,54,-30,25
Peterhead,552,1,24,4,8,84,39,45,76
Montrose,552,2,23,7,6,60,37,23,76
Stirling,552,3,17,6,13,63,52,11,57
Clyde,552,4,15,9,12,53,48,5,54
Stenhousem'r,552,5,15,8,13,56,49,7,53
Elgin,552,6,15,6,15,56,61,-5,51
Annan Athlet,552,7,12,11,13,50,41,9,47
Berwick,552,8,8,10,18,29,60,-31,34
Edinburgh Ci,552,9,7,9,20,37,67,-30,30
Cowdenbeath,552,10,4,10,22,23,57,-34,22
Montrose,553,1,24,7,5,62,34,28,79
Peterhead,553,2,24,4,8,78,38,40,76
Stirling,553,3,17,6,13,62,51,11,57
Clyde,553,4,15,9,12,53,48,5,54
Stenhousem'r,553,5,15,8,13,55,48,7,53
Elgin,553,6,14,6,16,53,63,-10,48
Annan Athlet,553,7,12,11,13,49,41,8,47
Berwick,553,8,8,10,18,29,60,-31,34
Edinburgh Ci,553,9,7,9,20,36,61,-25,30
Cowdenbeath,553,10,4,10,22,23,56,-33,22
Peterhead,554,1,24,4,8,80,39,41,76
Montrose,554,2,23,7,6,60,36,24,76
Stirling,554,3,17,6,13,62,51,11,57
Clyde,554,4,15,9,12,52,48,4,54
Stenhousem'r,554,5,15,8,13,55,48,7,53
Elgin,554,6,15,6,15,55,61,-6,51
Annan Athlet,554,7,12,11,13,49,41,8,47
Berwick,554,8,8,10,18,29,59,-30,34
Edinburgh Ci,554,9,7,9,20,37,63,-26,30
Cowdenbeath,554,10,4,10,22,23,56,-33,22
Montrose,555,1,23,8,5,61,36,25,77
Peterhead,555,2,24,4,8,80,38,42,76
Stirling,555,3,17,6,13,61,51,10,57
Stenhousem'r,555,4,15,8,13,55,47,8,53
Clyde,555,5,14,10,12,52,49,3,52
Elgin,555,6,14,7,15,55,62,-7,49
Annan Athlet,555,7,12,11,13,51,42,9,47
Berwick,555,8,8,11,17,30,59,-29,35
Edinburgh Ci,555,9,7,9,20,36,63,-27,30
Cowdenbeath,555,10,4,10,22,24,58,-34,22
Montrose,556,1,24,7,5,61,35,26,79
Peterhead,556,2,23,4,9,77,40,37,73
Stirling,556,3,17,6,13,64,52,12,57
Stenhousem'r,556,4,15,8,13,56,50,6,53
Clyde,556,5,14,9,13,51,52,-1,51
Elgin,556,6,14,6,16,54,62,-8,48
Annan Athlet,556,7,11,11,14,47,43,4,44
Berwick,556,8,9,10,17,33,58,-25,37
Edinburgh Ci,556,9,8,9,19,38,60,-22,33
Cowdenbeath,556,10,5,10,21,25,54,-29,25
Montrose,557,1,24,7,5,60,34,26,79
Peterhead,557,2,24,4,8,82,39,43,76
Stirling,557,3,16,7,13,62,53,9,55
Stenhousem'r,557,4,15,9,12,57,48,9,54
Clyde,557,5,14,10,12,52,49,3,52
Elgin,557,6,14,6,16,53,61,-8,48
Annan Athlet,557,7,12,11,13,48,41,7,47
Berwick,557,8,8,11,17,30,59,-29,35
Edinburgh Ci,557,9,7,9,20,37,65,-28,30
Cowdenbeath,557,10,4,10,22,23,55,-32,22
Montrose,558,1,24,7,5,62,36,26,79
Peterhead,558,2,24,4,8,82,38,44,76
Stirling,558,3,16,7,13,61,52,9,55
Stenhousem'r,558,4,15,9,12,56,47,9,54
Clyde,558,5,14,9,13,51,49,2,51
Elgin,558,6,14,6,16,55,63,-8,48
Annan Athlet,558,7,12,11,13,48,41,7,47
Berwick,558,8,9,10,17,30,58,-28,37
Edinburgh Ci,558,9,7,9,20,36,65,-29,30
Cowdenbeath,558,10,4,10,22,23,55,-32,22
Montrose,559,1,23,8,5,60,35,25,77
Peterhead,559,2,23,5,8,77,38,39,74
Stirling,559,3,16,7,13,60,51,9,55
Stenhousem'r,559,4,15,9,12,55,46,9,54
Clyde,559,5,14,10,12,51,48,3,52
Elgin,559,6,14,7,15,54,61,-7,49
Annan Athlet,559,7,12,11,13,48,41,7,47
Berwick,559,8,8,11,17,29,58,-29,35
Edinburgh Ci,559,9,7,10,19,36,60,-24,31
Cowdenbeath,559,10,4,10,22,23,55,-32,22
Peterhead,560,1,24,4,8,81,38,43,76
Montrose,560,2,23,7,6,62,38,24,76
Stirling,560,3,17,6,13,63,53,10,57
Clyde,560,4,15,9,12,53,48,5,54
Stenhousem'r,560,5,15,8,13,57,49,8,53
Elgin,560,6,15,6,15,57,63,-6,51
Annan Athlet,560,7,11,11,14,47,43,4,44
Berwick,560,8,8,10,18,29,60,-31,34
Edinburgh Ci,560,9,7,9,20,36,64,-28,30
Cowdenbeath,560,10,5,10,21,25,54,-29,25
Montrose,561,1,24,7,5,61,35,26,79
Peterhead,561,2,24,4,8,78,38,40,76
Stirling,561,3,17,6,13,62,51,11,57
Clyde,561,4,15,9,12,54,49,5,54
Stenhousem'r,561,5,15,8,13,55,48,7,53
Elgin,561,6,14,6,16,54,62,-8,48
Annan Athlet,561,7,11,11,14,47,43,4,44
Berwick,561,8,8,10,18,30,61,-31,34
Edinburgh Ci,561,9,7,9,20,36,61,-25,30
Cowdenbeath,561,10,5,10,21,25,54,-29,25
Montrose,562,1,24,7,5,60,34,26,79
Peterhead,562,2,24,4,8,81,38,43,76
Stirling,562,3,17,6,13,66,52,14,57
Stenhousem'r,562,4,15,8,13,56,52,4,53
Clyde,562,5,14,9,13,51,49,2,51
Elgin,562,6,14,6,16,53,61,-8,48
Annan Athlet,562,7,11,12,13,48,42,6,45
Berwick,562,8,9,10,17,30,58,-28,37
Edinburgh Ci,562,9,7,9,20,36,64,-28,30
Cowdenbeath,562,10,4,11,21,24,55,-31,23
Montrose,563,1,23,8,5,59,34,25,77
Peterhead,563,2,24,4,8,81,39,42,76
Stirling,563,3,17,6,13,62,52,10,57
Clyde,563,4,15,9,12,56,49,7,54
Stenhousem'r,563,5,15,8,13,56,48,8,53
Elgin,563,6,14,7,15,53,60,-7,49
Annan Athlet,563,7,11,12,13,47,41,6,45
Berwick,563,8,8,10,18,30,63,-33,34
Edinburgh Ci,563,9,7,9,20,37,64,-27,30
Cowdenbeath,563,10,4,11,21,23,54,-31,23
Montrose,564,1,24,7,5,64,35,29,79
Peterhead,564,2,24,4,8,79,38,41,76
Stirling,564,3,16,7,13,61,52,9,55
Stenhousem'r,564,4,15,9,12,56,47,9,54
Clyde,564,5,14,9,13,52,50,2,51
Elgin,564,6,14,6,16,54,65,-11,48
Annan Athlet,564,7,11,11,14,47,42,5,44
Berwick,564,8,9,10,17,31,59,-28,37
Edinburgh Ci,564,9,7,9,20,36,62,-26,30
Cowdenbeath,564,10,5,10,21,24,54,-30,25
Montrose,565,1,24,7,5,60,34,26,79
Peterhead,565,2,23,4,9,78,40,38,73
Stirling,565,3,16,7,13,61,52,9,55
Stenhousem'r,565,4,15,9,12,56,47,9,54
Clyde,565,5,14,10,12,52,49,3,52
Elgin,565,6,14,6,16,53,61,-8,48
Annan Athlet,565,7,11,12,13,47,41,6,45
Berwick,565,8,8,11,17,30,59,-29,35
Edinburgh Ci,565,9,8,9,19,38,61,-23,33
Cowdenbeath,565,10,4,11,21,23,54,-31,23
Montrose,566,1,24,7,5,61,35,26,79
Peterhead,566,2,24,4,8,82,38,44,76
Stenhousem'r,566,3,16,8,12,58,46,12,56
Stirling,566,4,16,6,14,60,54,6,54
Clyde,566,5,15,9,12,53,48,5,54
Elgin,566,6,14,6,16,54,62,-8,48
Annan Athlet,566,7,11,12,13,48,42,6,45
Berwick,566,8,8,10,18,29,60,-31,34
Edinburgh Ci,566,9,7,9,20,36,65,-29,30
Cowdenbeath,566,10,4,11,21,24,55,-31,23
Peterhead,567,1,24,4,8,81,38,43,76
Montrose,567,2,23,7,6,60,36,24,76
Stirling,567,3,16,7,13,61,52,9,55
Stenhousem'r,567,4,15,9,12,56,47,9,54
Clyde,567,5,14,10,12,53,50,3,52
Elgin,567,6,15,6,15,55,61,-6,51
Annan Athlet,567,7,12,11,13,49,42,7,47
Berwick,567,8,8,11,17,31,60,-29,35
Edinburgh Ci,567,9,7,9,20,36,64,-28,30
Cowdenbeath,567,10,4,10,22,24,56,-32,22
Montrose,568,1,24,7,5,62,36,26,79
Peterhead,568,2,24,4,8,82,38,44,76
Stirling,568,3,17,6,13,61,51,10,57
Clyde,568,4,15,9,12,54,48,6,54
Stenhousem'r,568,5,15,8,13,55,47,8,53
Elgin,568,6,14,6,16,55,63,-8,48
Annan Athlet,568,7,12,11,13,48,41,7,47
Berwick,568,8,8,10,18,29,61,-32,34
Edinburgh Ci,568,9,7,9,20,36,65,-29,30
Cowdenbeath,568,10,4,10,22,23,55,-32,22
Peterhead,569,1,24,4,8,80,38,42,76
Montrose,569,2,23,7,6,60,39,21,76
Stirling,569,3,17,6,13,62,52,10,57
Clyde,569,4,15,9,12,52,48,4,54
Stenhousem'r,569,5,15,8,13,56,48,8,53
Elgin,569,6,15,6,15,58,61,-3,51
Annan Athlet,569,7,11,11,14,47,43,4,44
Berwick,569,8,8,10,18,29,59,-30,34
Edinburgh Ci,569,9,7,9,20,36,63,-27,30
Cowdenbeath,569,10,5,10,21,25,54,-29,25
Montrose,570,1,23,8,5,61,36,25,77
Peterhead,570,2,24,4,8,80,38,42,76
Stirling,570,3,17,6,13,61,51,10,57
Stenhousem'r,570,4,15,8,13,55,47,8,53
Clyde,570,5,14,9,13,51,49,2,51
Elgin,570,6,14,7,15,55,62,-7,49
Annan Athlet,570,7,11,12,13,48,42,6,45
Berwick,570,8,9,10,17,30,58,-28,37
Edinburgh Ci,570,9,7,9,20,36,63,-27,30
Cowdenbeath,570,10,4,11,21,24,55,-31,23
Montrose,571,1,24,7,5,60,34,26,79
Peterhead,571,2,24,4,8,83,40,43,76
Stirling,571,3,16,7,13,61,52,9,55
Stenhousem'r,571,4,15,9,12,56,47,9,54
Clyde,571,5,14,10,12,53,50,3,52
Elgin,571,6,14,6,16,53,61,-8,48
Annan Athlet,571,7,12,11,13,49,42,7,47
Berwick,571,8,8,11,17,31,60,-29,35
Edinburgh Ci,571,9,7,9,20,38,66,-28,30
Cowdenbeath,571,10,4,10,22,24,56,-32,22
Peterhead,572,1,24,4,8,80,38,42,76
Montrose,572,2,23,7,6,59,35,24,76
Stirling,572,3,17,6,13,64,51,13,57
Clyde,572,4,15,9,12,56,49,7,54
Stenhousem'r,572,5,15,8,13,55,50,5,53
Elgin,572,6,15,6,15,54,60,-6,51
Annan Athlet,572,7,11,12,13,47,41,6,45
Berwick,572,8,8,10,18,30,63,-33,34
Edinburgh Ci,572,9,7,9,20,36,63,-27,30
Cowdenbeath,572,10,4,11,21,23,54,-31,23
Montrose,573,1,23,8,5,59,34,25,77
Peterhead,573,2,24,4,8,78,38,40,76
Stirling,573,3,16,7,13,61,52,9,55
Stenhousem'r,573,4,15,9,12,56,47,9,54
Clyde,573,5,14,9,13,52,50,2,51
Elgin,573,6,14,7,15,53,60,-7,49
Annan Athlet,573,7,11,12,13,49,43,6,45
Berwick,573,8,9,10,17,31,59,-28,37
Edinburgh Ci,573,9,7,9,20,36,61,-25,30
Cowdenbeath,573,10,4,11,21,25,56,-31,23
Montrose,574,1,23,7,6,59,36,23,76
Peterhead,574,2,23,5,8,78,39,39,74
Stirling,574,3,16,7,13,61,52,9,55
Stenhousem'r,574,4,15,9,12,56,47,9,54
Clyde,574,5,14,10,12,52,49,3,52
Elgin,574,6,15,6,15,55,60,-5,51
Annan Athlet,574,7,11,12,13,48,42,6,45
Berwick,574,8,8,11,17,30,59,-29,35
Edinburgh Ci,574,9,7,10,19,37,61,-24,31
Cowdenbeath,574,10,4,11,21,24,55,-31,23
Montrose,575,1,24,7,5,61,35,26,79
Peterhead,575,2,24,4,8,81,38,43,76
Stenhousem'r,575,3,16,8,12,57,46,11,56
Stirling,575,4,16,6,14,60,53,7,54
Clyde,575,5,15,9,12,55,48,7,54
Elgin,575,6,14,6,16,54,62,-8,48
Annan Athlet,575,7,12,11,13,50,41,9,47
Berwick,575,8,8,10,18,29,62,-33,34
Edinburgh Ci,575,9,7,9,20,36,64,-28,30
Cowdenbeath,575,10,4,10,22,23,57,-34,22
Peterhead,576,1,24,4,8,79,39,40,76
Montrose,576,2,23,7,6,60,38,22,76
Stirling,576,3,16,7,13,60,51,9,55
Stenhousem'r,576,4,15,9,12,55,46,9,54
Clyde,576,5,15,9,12,53,49,4,54
Elgin,576,6,15,6,15,57,61,-4,51
Annan Athlet,576,7,11,12,13,48,42,6,45
Berwick,576,8,8,10,18,30,60,-30,34
Edinburgh Ci,576,9,7,9,20,37,62,-25,30
Cowdenbeath,576,10,4,11,21,24,55,-31,23
Montrose,577,1,23,8,5,60,35,25,77
Peterhead,577,2,24,4,8,84,38,46,76
Stenhousem'r,577,3,16,8,12,56,46,10,56
Stirling,577,4,16,6,14,60,52,8,54
Clyde,577,5,14,9,13,51,52,-1,51
Elgin,577,6,14,7,15,54,61,-7,49
Annan Athlet,577,7,11,11,14,47,42,5,44
Berwick,577,8,9,10,17,33,58,-25,37
Edinburgh Ci,577,9,7,9,20,36,67,-31,30
Cowdenbeath,577,10,5,10,21,24,54,-30,25
Montrose,578,1,24,7,5,62,34,28,79
Peterhead,578,2,23,4,9,77,39,38,73
Stenhousem'r,578,3,16,8,12,56,46,10,56
Stirling,578,4,16,6,14,60,52,8,54
Clyde,578,5,14,9,13,51,50,1,51
Elgin,578,6,14,6,16,53,63,-10,48
Annan Athlet,578,7,11,11,14,47,42,5,44
Berwick,578,8,9,10,17,31,58,-27,37
Edinburgh Ci,578,9,8,9,19,37,60,-23,33
Cowdenbeath,578,10,5,10,21,24,54,-30,25
Montrose,579,1,23,8,5,59,34,25,77
Peterhead,579,2,23,5,8,77,38,39,74
Stirling,579,3,17,6,13,63,53,10,57
Clyde,579,4,15,9,12,52,48,4,54
Stenhousem'r,579,5,15,8,13,57,49,8,53
Elgin,579,6,14,7,15,53,60,-7,49
Annan Athlet,579,7,11,11,14,47,42,5,44
Berwick,579,8,8,10,18,29,59,-30,34
Edinburgh Ci,579,9,7,10,19,36,60,-24,31
Cowdenbeath,579,10,5,10,21,24,54,-30,25
Montrose,580,1,23,8,5,60,35,25,77
Peterhead,580,2,24,4,8,83,39,44,76
Stirling,580,3,17,6,13,61,51,10,57
Clyde,580,4,15,9,12,55,49,6,54
Stenhousem'r,580,5,15,8,13,55,47,8,53
Elgin,580,6,14,7,15,54,61,-7,49
Annan Athlet,580,7,12,11,13,49,42,7,47
Berwick,580,8,8,10,18,30,62,-32,34
Edinburgh Ci,580,9,7,9,20,37,66,-29,30
Cowdenbeath,580,10,4,10,22,24,56,-32,22
Montrose,581,1,23,8,5,59,34,25,77
Peterhead,581,2,23,5,8,81,42,39,74
Stirling,581,3,17,6,13,62,51,11,57
Clyde,581,4,15,9,12,54,49,5,54
Stenhousem'r,581,5,15,8,13,55,48,7,53
Elgin,581,6,14,7,15,53,60,-7,49
Annan Athlet,581,7,11,11,14,47,43,4,44
Berwick,581,8,8,10,18,30,61,-31,34
Edinburgh Ci,581,9,7,10,19,40,64,-24,31
Cowdenbeath,581,10,5,10,21,25,54,-29,25
Montrose,582,1,24,7,5,61,34,27,79
Peterhead,582,2,24,4,8,81,39,42,76
Stenhousem'r,582,3,16,8,12,56,46,10,56
Stirling,582,4,16,6,14,60,52,8,54
Clyde,582,5,15,9,12,54,49,5,54
Elgin,582,6,14,6,16,53,62,-9,48
Annan Athlet,582,7,11,11,14,49,45,4,44
Berwick,582,8,8,10,18,30,61,-31,34
Edinburgh Ci,582,9,7,9,20,37,64,-27,30
Cowdenbeath,582,10,5,10,21,27,56,-29,25
Montrose,583,1,24,7,5,61,35,26,79
Peterhead,583,2,23,5,8,79,40,39,74
Stenhousem'r,583,3,16,8,12,57,46,11,56
Stirling,583,4,16,6,14,60,53,7,54
Clyde,583,5,15,9,12,52,48,4,54
Elgin,583,6,14,6,16,54,62,-8,48
Annan Athlet,583,7,11,11,14,47,44,3,44
Berwick,583,8,8,10,18,29,59,-30,34
Edinburgh Ci,583,9,7,10,19,38,62,-24,31
Cowdenbeath,583,10,5,10,21,26,54,-28,25
Peterhead,584,1,24,4,8,82,39,43,76
Montrose,584,2,23,7,6,60,37,23,76
Stirling,584,3,17,6,13,63,52,11,57
Stenhousem'r,584,4,15,8,13,56,49,7,53
Clyde,584,5,14,9,13,51,49,2,51
Elgin,584,6,15,6,15,56,61,-5,51
Annan Athlet,584,7,12,11,13,48,41,7,47
Berwick,584,8,9,10,17,30,58,-28,37
Edinburgh Ci,584,9,7,9,20,37,65,-28,30
Cowdenbeath,584,10,4,10,22,23,55,-32,22
Peterhead,585,1,24,4,8,80,38,42,76
Montrose,585,2,23,7,6,59,35,24,76
Stenhousem'r,585,3,16,8,12,58,47,11,56
Stirling,585,4,16,6,14,61,54,7,54
Clyde,585,5,15,9,12,52,48,4,54
Elgin,585,6,15,6,15,54,60,-6,51
Annan Athlet,585,7,11,11,14,47,42,5,44
Berwick,585,8,8,10,18,29,59,-30,34
Edinburgh Ci,585,9,7,9,20,36,63,-27,30
Cowdenbeath,585,10,5,10,21,24,54,-30,25
Montrose,586,1,24,7,5,62,34,28,79
Peterhead,586,2,23,5,8,78,39,39,74
Stenhousem'r,586,3,16,8,12,57,47,10,56
Stirling,586,4,16,6,14,61,53,8,54
Clyde,586,5,15,9,12,54,48,6,54
Elgin,586,6,14,6,16,53,63,-10,48
Annan Athlet,586,7,12,11,13,49,42,7,47
Berwick,586,8,8,10,18,29,61,-32,34
Edinburgh Ci,586,9,7,10,19,37,61,-24,31
Cowdenbeath,586,10,4,10,22,24,56,-32,22
Montrose,587,1,24,7,5,60,34,26,79
Peterhead,587,2,23,5,8,80,41,39,74
Stenhousem'r,587,3,16,8,12,56,46,10,56
Stirling,587,4,16,6,14,60,52,8,54
Clyde,587,5,15,9,12,53,48,5,54
Elgin,587,6,14,6,16,53,61,-8,48
Annan Athlet,587,7,11,11,14,47,42,5,44
Berwick,587,8,8,10,18,29,60,-31,34
Edinburgh Ci,587,9,7,10,19,39,63,-24,31
Cowdenbeath,587,10,5,10,21,24,54,-30,25
Montrose,588,1,24,7,5,61,34,27,79
Peterhead,588,2,24,4,8,79,39,40,76
Stenhousem'r,588,3,16,8,12,57,46,11,56
Stirling,588,4,16,6,14,60,53,7,54
Clyde,588,5,15,9,12,53,48,5,54
Elgin,588,6,14,6,16,53,62,-9,48
Annan Athlet,588,7,11,12,13,47,41,6,45
Berwick,588,8,8,10,18,29,60,-31,34
Edinburgh Ci,588,9,7,9,20,37,62,-25,30
Cowdenbeath,588,10,4,11,21,23,54,-31,23
Montrose,589,1,24,7,5,60,34,26,79
Peterhead,589,2,24,4,8,81,39,42,76
Stirling,589,3,17,6,13,61,51,10,57
Clyde,589,4,15,9,12,54,48,6,54
Stenhousem'r,589,5,15,8,13,55,47,8,53
Elgin,589,6,14,6,16,53,61,-8,48
Annan Athlet,589,7,12,11,13,48,41,7,47
Berwick,589,8,8,10,18,29,61,-32,34
Edinburgh Ci,589,9,7,9,20,37,64,-27,30
Cowdenbeath,589,10,4,10,22,23,55,-32,22
Montrose,590,1,24,7,5,63,35,28,79
Peterhead,590,2,24,4,8,79,38,41,76
Stirling,590,3,17,6,13,66,51,15,57
Stenhousem'r,590,4,15,8,13,55,52,3,53
Clyde,590,5,14,9,13,51,49,2,51
Elgin,590,6,14,6,16,54,64,-10,48
Annan Athlet,590,7,11,12,13,47,41,6,45
Berwick,590,8,9,10,17,30,58,-28,37
Edinburgh Ci,590,9,7,9,20,36,62,-26,30
Cowdenbeath,590,10,4,11,21,23,54,-31,23
Peterhead,591,1,24,4,8,82,39,43,76
Montrose,591,2,23,7,6,59,35,24,76
Stenhousem'r,591,3,16,8,12,58,48,10,56
Stirling,591,4,16,6,14,62,54,8,54
Clyde,591,5,15,9,12,52,48,4,54
Elgin,591,6,15,6,15,54,60,-6,51
Annan Athlet,591,7,11,11,14,47,42,5,44
Berwick,591,8,8,10,18,29,59,-30,34
Edinburgh Ci,591,9,7,9,20,37,65,-28,30
Cowdenbeath,591,10,5,10,21,24,54,-30,25
Montrose,592,1,23,8,5,60,35,25,77
Peterhead,592,2,24,4,8,80,38,42,76
Stirling,592,3,17,6,13,63,52,11,57
Clyde,592,4,15,9,12,57,49,8,54
Stenhousem'r,592,5,15,8,13,56,49,7,53
Elgin,592,6,14,7,15,54,61,-7,49
Annan Athlet,592,7,12,11,13,49,42,7,47
Berwick,592,8,8,10,18,30,64,-34,34
Edinburgh Ci,592,9,7,9,20,36,63,-27,30
Cowdenbeath,592,10,4,10,22,24,56,-32,22
Montrose,593,1,24,7,5,61,34,27,79
Peterhead,593,2,24,4,8,78,38,40,76
Stenhousem'r,593,3,16,8,12,56,46,10,56
Stirling,593,4,16,6,14,60,52,8,54
Clyde,593,5,14,10,12,53,50,3,52
Elgin,593,6,14,6,16,53,62,-9,48
Annan Athlet,593,7,11,12,13,48,42,6,45
Berwick,593,8,8,11,17,31,60,-29,35
Edinburgh Ci,593,9,7,9,20,36,61,-25,30
Cowdenbeath,593,10,4,11,21,24,55,-31,23
Montrose,594,1,23,8,5,60,35,25,77
Peterhead,594,2,24,4,8,79,39,40,76
Stirling,594,3,17,6,13,61,51,10,57
Clyde,594,4,15,9,12,53,49,4,54
Stenhousem'r,594,5,15,8,13,55,47,8,53
Elgin,594,6,14,7,15,54,61,-7,49
Annan Athlet,594,7,11,11,14,48,43,5,44
Berwick,594,8,8,10,18,30,60,-30,34
Edinburgh Ci,594,9,7,9,20,37,62,-25,30
Cowdenbeath,594,10,5,10,21,25,55,-30,25
Montrose,595,1,24,7,5,64,34,30,79
Peterhead,595,2,24,4,8,82,38,44,76
Stirling,595,3,17,6,13,62,51,11,57
Clyde,595,4,15,9,12,53,48,5,54
Stenhousem'r,595,5,15,8,13,55,48,7,53
Elgin,595,6,14,6,16,53,65,-12,48
Annan Athlet,595,7,12,11,13,49,42,7,47
Berwick,595,8,8,10,18,29,60,-31,34
Edinburgh Ci,595,9,7,9,20,36,65,-29,30
Cowdenbeath,595,10,4,10,22,24,56,-32,22
Montrose,596,1,24,7,5,64,35,29,79
Peterhead,596,2,24,4,8,82,39,43,76
Stirling,596,3,17,6,13,64,52,12,57
Clyde,596,4,15,9,12,52,48,4,54
Stenhousem'r,596,5,15,8,13,56,50,6,53
Elgin,596,6,14,6,16,54,65,-11,48
Annan Athlet,596,7,11,12,13,49,43,6,45
Berwick,596,8,8,10,18,29,59,-30,34
Edinburgh Ci,596,9,7,9,20,37,65,-28,30
Cowdenbeath,596,10,4,11,21,25,56,-31,23
Montrose,597,1,23,8,5,61,36,25,77
Peterhead,597,2,24,4,8,78,38,40,76
Stenhousem'r,597,3,16,8,12,57,47,10,56
Stirling,597,4,16,6,14,61,53,8,54
Clyde,597,5,14,10,12,51,48,3,52
Elgin,597,6,14,7,15,55,62,-7,49
Annan Athlet,597,7,11,11,14,48,43,5,44
Berwick,597,8,8,11,17,29,58,-29,35
Edinburgh Ci,597,9,7,9,20,36,61,-25,30
Cowdenbeath,597,10,5,10,21,25,55,-30,25
Montrose,598,1,23,8,5,60,35,25,77
Peterhead,598,2,24,4,8,79,38,41,76
Stirling,598,3,17,6,13,64,52,12,57
Clyde,598,4,15,9,12,54,49,5,54
Stenhousem'r,598,5,15,8,13,56,50,6,53
Elgin,598,6,14,7,15,54,61,-7,49
Annan Athlet,598,7,12,11,13,48,41,7,47
Berwick,598,8,8,10,18,30,61,-31,34
Edinburgh Ci,598,9,7,9,20,36,62,-26,30
Cowdenbeath,598,10,4,10,22,23,55,-32,22
Montrose,599,1,23,8,5,60,35,25,77
Peterhead,599,2,24,4,8,79,38,41,76
Stenhousem'r,599,3,16,8,12,58,47,11,56
Stirling,599,4,16,6,14,61,54,7,54
Clyde,599,5,15,9,12,52,48,4,54
Elgin,599,6,14,7,15,54,61,-7,49
Annan Athlet,599,7,12,11,13,50,41,9,47
Berwick,599,8,8,10,18,29,59,-30,34
Edinburgh Ci,599,9,7,9,20,36,62,-26,30
Cowdenbeath,599,10,4,10,22,23,57,-34,22
Montrose,600,1,23,8,5,62,37,25,77
Peterhead,600,2,24,4,8,81,38,43,76
Stirling,600,3,17,6,13,63,51,12,57
Clyde,600,4,15,9,12,55,49,6,54
Stenhousem'r,600,5,15,8,13,55,49,6,53
Elgin,600,6,14,7,15,56,63,-7,49
Annan Athlet,600,7,11,11,14,47,43,4,44
Berwick,600,8,8,10,18,30,62,-32,34
Edinburgh Ci,600,9,7,9,20,36,64,-28,30
Cowdenbeath,600,10,5,10,21,25,54,-29,25
Montrose,601,1,24,7,5,62,34,28,79
Peterhead,601,2,24,4,8,78,38,40,76
Stenhousem'r,601,3,16,8,12,57,47,10,56
Stirling,601,4,16,6,14,61,53,8,54
Clyde,601,5,14,10,12,51,48,3,52
Elgin,601,6,14,6,16,53,63,-10,48
Annan Athlet,601,7,12,11,13,48,41,7,47
Berwick,601,8,8,11,17,29,58,-29,35
Edinburgh Ci,601,9,7,9,20,36,61,-25,30
Cowdenbeath,601,10,4,10,22,23,55,-32,22
Peterhead,602,1,24,4,8,80,38,42,76
Montrose,602,2,23,7,6,60,38,22,76
Stirling,602,3,17,6,13,63,53,10,57
Clyde,602,4,15,9,12,53,48,5,54
Stenhousem'r,602,5,15,8,13,57,49,8,53
Elgin,602,6,15,6,15,57,61,-4,51
Annan Athlet,602,7,12,11,13,50,41,9,47
Berwick,602,8,8,10,18,29,60,-31,34
Edinburgh Ci,602,9,7,9,20,36,63,-27,30
Cowdenbeath,602,10,4,10,22,23,57,-34,22
Montrose,603,1,23,8,5,61,36,25,77
Peterhead,603,2,24,4,8,80,39,41,76
Stirling,603,3,17,6,13,62,52,10,57
Stenhousem'r,603,4,15,8,13,56,48,8,53
Clyde,603,5,14,10,12,52,49,3,52
Elgin,603,6,14,7,15,55,62,-7,49
Annan Athlet,603,7,11,11,14,49,46,3,44
Berwick,603,8,8,11,17,30,59,-29,35
Edinburgh Ci,603,9,7,9,20,37,63,-26,30
Cowdenbeath,603,10,5,10,21,28,56,-28,25
Peterhead,604,1,24,4,8,78,38,40,76
Montrose,604,2,23,7,6,59,35,24,76
Stirling,604,3,17,6,13,61,51,10,57
Stenhousem'r,604,4,15,8,13,55,47,8,53
Clyde,604,5,14,9,13,51,49,2,51
Elgin,604,6,15,6,15,54,60,-6,51
Annan Athlet,604,7,12,11,13,48,41,7,47
Berwick,604,8,9,10,17,30,58,-28,37
Edinburgh Ci,604,9,7,9,20,36,61,-25,30
Cowdenbeath,604,10,4,10,22,23,55,-32,22
Montrose,605,1,24,7,5,61,35,26,79
Peterhead,605,2,23,5,8,79,40,39,74
Stenhousem'r,605,3,16,8,12,57,46,11,56
Stirling,605,4,16,6,14,60,53,7,54
Clyde,605,5,15,9,12,52,48,4,54
Elgin,605,6,14,6,16,54,62,-8,48
Annan Athlet,605,7,11,11,14,47,43,4,44
Berwick,605,8,8,10,18,29,59,-30,34
Edinburgh Ci,605,9,7,10,19,38,62,-24,31
Cowdenbeath,605,10,5,10,21,25,54,-29,25
Montrose,606,1,24,7,5,60,34,26,79
Peterhead,606,2,23,4,9,79,43,36,73
Stenhousem'r,606,3,16,8,12,58,47,11,56
Stirling,606,4,16,6,14,61,54,7,54
Clyde,606,5,15,9,12,53,49,4,54
Elgin,606,6,14,6,16,53,61,-8,48
Annan Athlet,606,7,11,11,14,47,42,5,44
Berwick,606,8,8,10,18,30,60,-30,34
Edinburgh Ci,606,9,8,9,19,41,62,-21,33
Cowdenbeath,606,10,5,10,21,24,54,-30,25
Peterhead,607,1,24,4,8,80,39,41,76
Montrose,607,2,23,7,6,59,36,23,76
Stirling,607,3,16,7,13,62,53,9,55
Stenhousem'r,607,4,15,9,12,57,48,9,54
Clyde,607,5,15,9,12,54,50,4,54
Elgin,607,6,15,6,15,55,60,-5,51
Annan Athlet,607,7,12,11,13,49,41,8,47
Berwick,607,8,8,10,18,31,61,-30,34
Edinburgh Ci,607,9,7,9,20,37,63,-26,30
Cowdenbeath,607,10,4,10,22,23,56,-33,22
Montrose,608,1,24,7,5,62,36,26,79
Peterhead,608,2,24,4,8,79,38,41,76
Stirling,608,3,17,6,13,62,52,10,57
Stenhousem'r,608,4,15,8,13,56,48,8,53
Clyde,608,5,14,10,12,53,50,3,52
Elgin,608,6,14,6,16,55,63,-8,48
Annan Athlet,608,7,11,11,14,47,43,4,44
Berwick,608,8,8,11,17,31,60,-29,35
Edinburgh Ci,608,9,7,9,20,36,62,-26,30
Cowdenbeath,608,10,5,10,21,25,54,-29,25
Montrose,609,1,24,7,5,60,34,26,79
Peterhead,609,2,24,4,8,80,38,42,76
Stirling,609,3,16,7,13,62,53,9,55
Stenhousem'r,609,4,15,9,12,57,48,9,54
Clyde,609,5,15,9,12,53,49,4,54
Elgin,609,6,14,6,16,53,61,-8,48
Annan Athlet,609,7,12,11,13,51,43,8,47
Berwick,609,8,8,10,18,30,60,-30,34
Edinburgh Ci,609,9,7,9,20,36,63,-27,30
Cowdenbeath,609,10,4,10,22,25,58,-33,22
Montrose,610,1,24,7,5,63,34,29,79
Peterhead,610,2,23,5,8,79,40,39,74
Stirling,610,3,16,7,13,60,51,9,55
Stenhousem'r,610,4,15,9,12,55,46,9,54
Clyde,610,5,14,9,13,52,53,-1,51
Elgin,610,6,14,6,16,53,64,-11,48
Annan Athlet,610,7,11,12,13,47,41,6,45
Berwick,610,8,9,10,17,34,59,-25,37
Edinburgh Ci,610,9,7,10,19,38,62,-24,31
Cowdenbeath,610,10,4,11,21,23,54,-31,23
Montrose,611,1,24,7,5,62,35,27,79
Peterhead,611,2,24,4,8,79,39,40,76
Stirling,611,3,16,7,13,60,51,9,55
Stenhousem'r,611,4,15,9,12,55,46,9,54
Clyde,611,5,15,9,12,53,48,5,54
Elgin,611,6,14,6,16,54,63,-9,48
Annan Athlet,611,7,12,11,13,48,41,7,47
Berwick,611,8,8,10,18,29,60,-31,34
Edinburgh Ci,611,9,7,9,20,37,62,-25,30
Cowdenbeath,611,10,4,10,22,23,55,-32,22
Montrose,612,1,24,7,5,62,34,28,79
Peterhead,612,2,24,4,8,80,39,41,76
Stirling,612,3,16,7,13,62,53,9,55
Stenhousem'r,612,4,15,9,12,57,48,9,54
Clyde,612,5,15,9,12,54,50,4,54
Elgin,612,6,14,6,16,53,63,-10,48
Annan Athlet,612,7,11,12,13,48,42,6,45
Berwick,612,8,8,10,18,31,61,-30,34
Edinburgh Ci,612,9,7,9,20,37,63,-26,30
Cowdenbeath,612,10,4,11,21,24,55,-31,23
Montrose,613,1,24,7,5,63,35,28,79
Peterhead,613,2,24,4,8,79,39,40,76
Stirling,613,3,17,6,13,61,51,10,57
Stenhousem'r,613,4,15,8,13,55,47,8,53
Clyde,613,5,14,9,13,52,50,2,51
Elgin,613,6,14,6,16,54,64,-10,48
Annan Athlet,613,7,12,11,13,48,41,7,47
Berwick,613,8,9,10,17,31,59,-28,37
Edinburgh Ci,613,9,7,9,20,37,62,-25,30
Cowdenbeath,613,10,4,10,22,23,55,-32,22
Montrose,614,1,24,7,5,63,34,29,79
Peterhead,614,2,24,4,8,82,39,43,76
Stirling,614,3,17,6,13,62,52,10,57
Clyde,614,4,15,9,12,53,48,5,54
Stenhousem'r,614,5,15,8,13,56,48,8,53
Elgin,614,6,14,6,16,53,64,-11,48
Annan Athlet,614,7,11,12,13,48,42,6,45
Berwick,614,8,8,10,18,29,60,-31,34
Edinburgh Ci,614,9,7,9,20,37,65,-28,30
Cowdenbeath,614,10,4,11,21,24,55,-31,23
Montrose,615,1,24,7,5,64,36,28,79
Peterhead,615,2,24,4,8,80,38,42,76
Stirling,615,3,17,6,13,61,51,10,57
Clyde,615,4,15,9,12,53,49,4,54
Stenhousem'r,615,5,15,8,13,55,47,8,53
Elgin,615,6,14,6,16,55,65,-10,48
Annan Athlet,615,7,11,11,14,47,42,5,44
Berwick,615,8,8,10,18,30,60,-30,34
Edinburgh Ci,615,9,7,9,20,36,63,-27,30
Cowdenbeath,615,10,5,10,21,24,54,-30,25
Montrose,616,1,24,7,5,61,35,26,79
Peterhead,616,2,23,5,8,78,39,39,74
Stenhousem'r,616,3,16,8,12,58,47,11,56
Stirling,616,4,16,6,14,61,54,7,54
Clyde,616,5,15,9,12,55,48,7,54
Elgin,616,6,14,6,16,54,62,-8,48
Annan Athlet,616,7,11,11,14,47,42,5,44
Berwick,616,8,8,10,18,29,62,-33,34
Edinburgh Ci,616,9,7,10,19,37,61,-24,31
Cowdenbeath,616,10,5,10,21,24,54,-30,25
Montrose,617,1,24,7,5,61,34,27,79
Peterhead,617,2,23,5,8,78,39,39,74
Stirling,617,3,16,7,13,61,52,9,55
Stenhousem'r,617,4,15,9,12,56,47,9,54
Clyde,617,5,14,10,12,52,49,3,52
Elgin,617,6,14,6,16,53,62,-9,48
Annan Athlet,617,7,11,11,14,48,44,4,44
Berwick,617,8,8,11,17,30,59,-29,35
Edinburgh Ci,617,9,7,10,19,37,61,-24,31
Cowdenbeath,617,10,5,10,21,26,55,-29,25
Montrose,618,1,24,7,5,61,34,27,79
Peterhead,618,2,23,4,9,79,41,38,73
Stirling,618,3,16,7,13,62,53,9,55
Stenhousem'r,618,4,15,9,12,57,48,9,54
Clyde,618,5,14,10,12,53,50,3,52
Elgin,618,6,14,6,16,53,62,-9,48
Annan Athlet,618,7,12,11,13,48,41,7,47
Berwick,618,8,8,11,17,31,60,-29,35
Edinburgh Ci,618,9,8,9,19,39,62,-23,33
Cowdenbeath,618,10,4,10,22,23,55,-32,22
Peterhead,619,1,24,4,8,80,38,42,76
Montrose,619,2,23,7,6,60,38,22,76
Stirling,619,3,17,6,13,62,51,11,57
Clyde,619,4,15,9,12,53,48,5,54
Stenhousem'r,619,5,15,8,13,55,48,7,53
Elgin,619,6,15,6,15,57,61,-4,51
Annan Athlet,619,7,11,11,14,47,42,5,44
Berwick,619,8,8,10,18,29,60,-31,34
Edinburgh Ci,619,9,7,9,20,36,63,-27,30
Cowdenbeath,619,10,5,10,21,24,54,-30,25
Montrose,620,1,23,8,5,61,36,25,77
Peterhead,620,2,24,4,8,82,39,43,76
Stirling,620,3,17,6,13,64,52,12,57
Stenhousem'r,620,4,15,8,13,56,50,6,53
Clyde,620,5,14,10,12,54,51,3,52
Elgin,620,6,14,7,15,55,62,-7,49
Annan Athlet,620,7,11,11,14,48,43,5,44
Berwick,620,8,8,11,17,32,61,-29,35
Edinburgh Ci,620,9,7,9,20,37,65,-28,30
Cowdenbeath,620,10,5,10,21,25,55,-30,25
Montrose,621,1,24,7,5,61,35,26,79
Peterhead,621,2,24,4,8,83,38,45,76
Stirling,621,3,17,6,13,63,51,12,57
Stenhousem'r,621,4,15,8,13,55,49,6,53
Clyde,621,5,14,9,13,51,50,1,51
Elgin,621,6,14,6,16,54,62,-8,48
Annan Athlet,621,7,12,11,13,48,41,7,47
Berwick,621,8,9,10,17,31,58,-27,37
Edinburgh Ci,621,9,7,9,20,36,66,-30,30
Cowdenbeath,621,10,4,10,22,23,55,-32,22
Montrose,622,1,23,7,6,60,36,24,76
Peterhead,622,2,23,4,9,78,41,37,73
Stirling,622,3,17,6,13,63,53,10,57
Clyde,622,4,15,9,12,54,48,6,54
Stenhousem'r,622,5,15,8,13,57,49,8,53
Elgin,622,6,15,6,15,55,61,-6,51
Annan Athlet,622,7,12,11,13,48,41,7,47
Berwick,622,8,8,10,18,29,61,-32,34
Edinburgh Ci,622,9,8,9,19,39,61,-22,33
Cowdenbeath,622,10,4,10,22,23,55,-32,22
Montrose,623,1,24,7,5,60,34,26,79
Peterhead,623,2,24,4,8,80,39,41,76
Stenhousem'r,623,3,16,8,12,57,46,11,56
Stirling,623,4,16,6,14,60,53,7,54
Clyde,623,5,14,9,13,51,49,2,51
Elgin,623,6,14,6,16,53,61,-8,48
Annan Athlet,623,7,11,11,14,47,42,5,44
Berwick,623,8,9,10,17,30,58,-28,37
Edinburgh Ci,623,9,7,9,20,37,63,-26,30
Cowdenbeath,623,10,5,10,21,24,54,-30,25
Peterhead,624,1,24,4,8,80,39,41,76
Montrose,624,2,23,7,6,59,35,24,76
Stenhousem'r,624,3,16,8,12,57,47,10,56
Stirling,624,4,16,6,14,61,53,8,54
Clyde,624,5,15,9,12,54,50,4,54
Elgin,624,6,15,6,15,54,60,-6,51
Annan Athlet,624,7,11,11,14,47,43,4,44
Berwick,624,8,8,10,18,31,61,-30,34
Edinburgh Ci,624,9,7,9,20,37,63,-26,30
Cowdenbeath,624,10,5,10,21,25,54,-29,25
Montrose,625,1,24,7,5,61,35,26,79
Peterhead,625,2,24,4,8,80,38,42,76
Stirling,625,3,16,7,13,61,52,9,55
Stenhousem'r,625,4,15,9,12,56,47,9,54
Clyde,625,5,14,10,12,52,49,3,52
Elgin,625,6,14,6,16,54,62,-8,48
Annan Athlet,625,7,12,11,13,49,42,7,47
Berwick,625,8,8,11,17,30,59,-29,35
Edinburgh Ci,625,9,7,9,20,36,63,-27,30
Cowdenbeath,625,10,4,10,22,24,56,-32,22
Montrose,626,1,24,7,5,62,34,28,79
Peterhead,626,2,24,4,8,81,39,42,76
Stenhousem'r,626,3,16,8,12,57,46,11,56
Stirling,626,4,16,6,14,60,53,7,54
Clyde,626,5,14,9,13,53,52,1,51
Elgin,626,6,14,6,16,53,63,-10,48
Annan Athlet,626,7,12,11,13,48,41,7,47
Berwick,626,8,9,10,17,33,60,-27,37
Edinburgh Ci,626,9,7,9,20,37,64,-27,30
Cowdenbeath,626,10,4,10,22,23,55,-32,22
Peterhead,627,1,24,4,8,78,38,40,76
Montrose,627,2,23,7,6,59,37,22,76
Stirling,627,3,17,6,13,63,52,11,57
Stenhousem'r,627,4,15,8,13,56,49,7,53
Clyde,627,5,14,9,13,52,50,2,51
Elgin,627,6,15,6,15,56,60,-4,51
Annan Athlet,627,7,12,11,13,48,41,7,47
Berwick,627,8,9,10,17,31,59,-28,37
Edinburgh Ci,627,9,7,9,20,36,61,-25,30
Cowdenbeath,627,10,4,10,22,23,55,-32,22
Montrose,628,1,24,7,5,64,36,28,79
Peterhead,628,2,23,5,8,79,40,39,74
Stenhousem'r,628,3,16,8,12,58,47,11,56
Stirling,628,4,16,6,14,61,54,7,54
Clyde,628,5,14,10,12,51,48,3,52
Elgin,628,6,14,6,16,55,65,-10,48
Annan Athlet,628,7,12,11,13,49,42,7,47
Berwick,628,8,8,11,17,29,58,-29,35
Edinburgh Ci,628,9,7,10,19,38,62,-24,31
Cowdenbeath,628,10,4,10,22,24,56,-32,22
Peterhead,629,1,24,4,8,80,38,42,76
Montrose,629,2,23,7,6,61,38,23,76
Stirling,629,3,17,6,13,62,51,11,57
Stenhousem'r,629,4,15,8,13,55,48,7,53
Clyde,629,5,14,9,13,51,50,1,51
Elgin,629,6,15,6,15,57,62,-5,51
Annan Athlet,629,7,11,11,14,48,43,5,44
Berwick,629,8,9,10,17,31,58,-27,37
Edinburgh Ci,629,9,7,9,20,36,63,-27,30
Cowdenbeath,629,10,5,10,21,25,55,-30,25
Montrose,630,1,24,7,5,62,35,27,79
Peterhead,630,2,23,4,9,78,41,37,73
Stirling,630,3,17,6,13,65,54,11,57
Stenhousem'r,630,4,15,8,13,58,51,7,53
Clyde,630,5,14,9,13,52,51,1,51
Elgin,630,6,14,6,16,54,63,-9,48
Annan Athlet,630,7,11,11,14,47,42,5,44
Berwick,630,8,9,10,17,32,59,-27,37
Edinburgh Ci,630,9,8,9,19,39,61,-22,33
Cowdenbeath,630,10,5,10,21,24,54,-30,25
Montrose,631,1,24,7,5,60,34,26,79
Peterhead,631,2,24,4,8,78,38,40,76
Stirling,631,3,17,6,13,62,52,10,57
Stenhousem'r,631,4,15,8,13,56,48,8,53
Clyde,631,5,14,9,13,54,52,2,51
Elgin,631,6,14,6,16,53,61,-8,48
Annan Athlet,631,7,11,11,14,48,43,5,44
Berwick,631,8,9,10,17,33,61,-28,37
Edinburgh Ci,631,9,7,9,20,36,61,-25,30
Cowdenbeath,631,10,5,10,21,25,55,-30,25
Peterhead,632,1,24,4,8,80,38,42,76
Montrose,632,2,23,7,6,61,37,24,76
Stenhousem'r,632,3,16,8,12,57,47,10,56
Stirling,632,4,16,6,14,61,53,8,54
Clyde,632,5,15,9,12,53,49,4,54
Elgin,632,6,15,6,15,56,62,-6,51
Annan Athlet,632,7,12,11,13,49,41,8,47
Berwick,632,8,8,10,18,30,60,-30,34
Edinburgh Ci,632,9,7,9,20,36,63,-27,30
Cowdenbeath,632,10,4,10,22,23,56,-33,22
Montrose,633,1,24,7,5,61,34,27,79
Peterhead,633,2,24,4,8,80,40,40,76
Stenhousem'r,633,3,16,8,12,56,46,10,56
Stirling,633,4,16,6,14,60,52,8,54
Clyde,633,5,14,9,13,51,51,0,51
Elgin,633,6,14,6,16,53,62,-9,48
Annan Athlet,633,7,11,11,14,48,45,3,44
Berwick,633,8,9,10,17,32,58,-26,37
Edinburgh Ci,633,9,7,9,20,38,63,-25,30
Cowdenbeath,633,10,5,10,21,27,55,-28,25
Montrose,634,1,24,7,5,63,34,29,79
Peterhead,634,2,24,4,8,80,38,42,76
Stirling,634,3,16,7,13,61,52,9,55
Stenhousem'r,634,4,15,9,12,56,47,9,54
Clyde,634,5,14,10,12,51,48,3,52
Elgin,634,6,14,6,16,53,64,-11,48
Annan Athlet,634,7,11,12,13,48,42,6,45
Berwick,634,8,8,11,17,29,58,-29,35
Edinburgh Ci,634,9,7,9,20,36,63,-27,30
Cowdenbeath,634,10,4,11,21,24,55,-31,23
Montrose,635,1,24,7,5,60,34,26,79
Peterhead,635,2,24,4,8,82,40,42,76
Stirling,635,3,16,7,13,62,53,9,55
Stenhousem'r,635,4,15,9,12,57,48,9,54
Clyde,635,5,15,9,12,52,48,4,54
Elgin,635,6,14,6,16,53,61,-8,48
Annan Athlet,635,7,12,11,13,52,41,11,47
Berwick,635,8,8,10,18,29,59,-30,34
Edinburgh Ci,635,9,7,9,20,38,65,-27,30
Cowdenbeath,635,10,4,10,22,23,59,-36,22
Montrose,636,1,24,7,5,62,34,28,79
Peterhead,636,2,23,5,8,78,39,39,74
Stirling,636,3,16,7,13,62,53,9,55
Stenhousem'r,636,4,15,9,12,57,48,9,54
Clyde,636,5,15,9,12,54,48,6,54
Elgin,636,6,14,6,16,53,63,-10,48
Annan Athlet,636,7,11,12,13,48,42,6,45
Berwick,636,8,8,10,18,29,61,-32,34
Edinburgh Ci,636,9,7,10,19,37,61,-24,31
Cowdenbeath,636,10,4,11,21,24,55,-31,23
Montrose,637,1,24,7,5,61,34,27,79
Peterhead,637,2,24,4,8,80,39,41,76
Stenhousem'r,637,3,16,8,12,56,46,10,56
Stirling,637,4,16,6,14,60,52,8,54
Clyde,637,5,14,10,12,51,48,3,52
Elgin,637,6,14,6,16,53,62,-9,48
Annan Athlet,637,7,11,12,13,47,41,6,45
Berwick,637,8,8,11,17,29,58,-29,35
Edinburgh Ci,637,9,7,9,20,37,63,-26,30
Cowdenbeath,637,10,4,11,21,23,54,-31,23
Montrose,638,1,24,7,5,61,35,26,79
Peterhead,638,2,24,4,8,78,38,40,76
Stirling,638,3,17,6,13,62,52,10,57
Stenhousem'r,638,4,15,8,13,56,48,8,53
Clyde,638,5,14,9,13,51,50,1,51
Elgin,638,6,14,6,16,54,62,-8,48
Annan Athlet,638,7,11,11,14,48,43,5,44
Berwick,638,8,9,10,17,31,58,-27,37
Edinburgh Ci,638,9,7,9,20,36,61,-25,30
Cowdenbeath,638,10,5,10,21,25,55,-30,25
Montrose,639,1,24,7,5,62,36,26,79
Peterhead,639,2,24,4,8,83,39,44,76
Stirling,639,3,17,6,13,64,51,13,57
Stenhousem'r,639,4,15,8,13,55,50,5,53
Clyde,639,5,14,10,12,53,50,3,52
Elgin,639,6,14,6,16,55,63,-8,48
Annan Athlet,639,7,11,11,14,47,42,5,44
Berwick,639,8,8,11,17,31,60,-29,35
Edinburgh Ci,639,9,7,9,20,37,66,-29,30
Cowdenbeath,639,10,5,10,21,24,54,-30,25
Montrose,640,1,24,7,5,61,35,26,79
Peterhead,640,2,24,4,8,81,39,42,76
Stenhousem'r,640,3,16,8,12,58,46,12,56
Stirling,640,4,16,6,14,60,54,6,54
Clyde,640,5,15,9,12,54,50,4,54
Elgin,640,6,14,6,16,54,62,-8,48
Annan Athlet,640,7,11,12,13,49,43,6,45
Berwick,640,8,8,10,18,31,61,-30,34
Edinburgh Ci,640,9,7,9,20,37,64,-27,30
Cowdenbeath,640,10,4,11,21,25,56,-31,23
Montrose,641,1,24,7,5,60,34,26,79
Peterhead,641,2,23,5,8,79,40,39,74
Stirling,641,3,17,6,13,63,52,11,57
Stenhousem'r,641,4,15,8,13,56,49,7,53
Clyde,641,5,14,10,12,51,48,3,52
Elgin,641,6,14,6,16,53,61,-8,48
Annan Athlet,641,7,11,11,14,48,43,5,44
Berwick,641,8,8,11,17,29,58,-29,35
Edinburgh Ci,641,9,7,10,19,38,62,-24,31
Cowdenbeath,641,10,5,10,21,25,55,-30,25
Montrose,642,1,24,7,5,62,36,26,79
Peterhead,642,2,23,5,8,78,39,39,74
Stirling,642,3,16,7,13,63,54,9,55
Stenhousem'r,642,4,15,9,12,58,49,9,54
Clyde,642,5,14,10,12,52,49,3,52
Elgin,642,6,14,6,16,55,63,-8,48
Annan Athlet,642,7,12,11,13,49,42,7,47
Berwick,642,8,8,11,17,30,59,-29,35
Edinburgh Ci,642,9,7,10,19,37,61,-24,31
Cowdenbeath,642,10,4,10,22,24,56,-32,22
Montrose,643,1,24,7,5,61,34,27,79
Peterhead,643,2,24,4,8,84,40,44,76
Stirling,643,3,17,6,13,65,53,12,57
Clyde,643,4,15,9,12,57,51,6,54
Stenhousem'r,643,5,15,8,13,57,51,6,53
Elgin,643,6,14,6,16,53,62,-9,48
Annan Athlet,643,7,11,11,14,48,43,5,44
Berwick,643,8,8,10,18,32,64,-32,34
Edinburgh Ci,643,9,7,9,20,38,67,-29,30
Cowdenbeath,643,10,5,10,21,25,55,-30,25
Montrose,644,1,23,8,5,60,35,25,77
Peterhead,644,2,24,4,8,84,39,45,76
Stenhousem'r,644,3,16,8,12,56,46,10,56
Stirling,644,4,16,6,14,60,52,8,54
Clyde,644,5,15,9,12,54,48,6,54
Elgin,644,6,14,7,15,54,61,-7,49
Annan Athlet,644,7,12,11,13,48,41,7,47
Berwick,644,8,8,10,18,29,61,-32,34
Edinburgh Ci,644,9,7,9,20,37,67,-30,30
Cowdenbeath,644,10,4,10,22,23,55,-32,22
Montrose,645,1,23,8,5,59,34,25,77
Peterhead,645,2,24,4,8,78,38,40,76
Stirling,645,3,16,7,13,61,52,9,55
Stenhousem'r,645,4,15,9,12,56,47,9,54
Clyde,645,5,15,9,12,53,48,5,54
Elgin,645,6,14,7,15,53,60,-7,49
Annan Athlet,645,7,11,11,14,49,45,4,44
Berwick,645,8,8,10,18,29,60,-31,34
Edinburgh Ci,645,9,7,9,20,36,61,-25,30
Cowdenbeath,645,10,5,10,21,27,56,-29,25
Montrose,646,1,24,7,5,62,35,27,79
Peterhead,646,2,24,4,8,81,39,42,76
Stirling,646,3,16,7,13,61,52,9,55
Stenhousem'r,646,4,15,9,12,56,47,9,54
Clyde,646,5,15,9,12,53,48,5,54
Elgin,646,6,14,6,16,54,63,-9,48
Annan Athlet,646,7,11,11,14,48,44,4,44
Berwick,646,8,8,10,18,29,60,-31,34
Edinburgh Ci,646,9,7,9,20,37,64,-27,30
Cowdenbeath,646,10,5,10,21,26,55,-29,25
Peterhead,647,1,24,4,8,78,38,40,76
Montrose,647,2,23,7,6,60,36,24,76
Stirling,647,3,17,6,13,64,51,13,57
Stenhousem'r,647,4,15,8,13,55,50,5,53
Clyde,647,5,14,9,13,51,51,0,51
Elgin,647,6,15,6,15,55,61,-6,51
Annan Athlet,647,7,11,11,14,47,43,4,44
Berwick,647,8,9,10,17,32,58,-26,37
Edinburgh Ci,647,9,7,9,20,36,61,-25,30
Cowdenbeath,647,10,5,10,21,25,54,-29,25
Montrose,648,1,24,7,5,62,34,28,79
Peterhead,648,2,24,4,8,82,38,44,76
Stirling,648,3,17,6,13,63,51,12,57
Clyde,648,4,15,9,12,55,48,7,54
Stenhousem'r,648,5,15,8,13,55,49,6,53
Elgin,648,6,14,6,16,53,63,-10,48
Annan Athlet,648,7,12,11,13,49,42,7,47
Berwick,648,8,8,10,18,29,62,-33,34
Edinburgh Ci,648,9,7,9,20,36,65,-29,30
Cowdenbeath,648,10,4,10,22,24,56,-32,22
Montrose,649,1,24,7,5,61,35,26,79
Peterhead,649,2,24,4,8,82,38,44,76
Stirling,649,3,17,6,13,63,51,12,57
Clyde,649,4,15,9,12,55,49,6,54
Stenhousem'r,649,5,15,8,13,55,49,6,53
Elgin,649,6,14,6,16,54,62,-8,48
Annan Athlet,649,7,11,12,13,48,42,6,45
Berwick,649,8,8,10,18,30,62,-32,34
Edinburgh Ci,649,9,7,9,20,36,65,-29,30
Cowdenbeath,649,10,4,11,21,24,55,-31,23
Montrose,650,1,24,7,5,61,35,26,79
Peterhead,650,2,23,5,8,78,39,39,74
Stirling,650,3,17,6,13,63,53,10,57
Clyde,650,4,15,9,12,52,48,4,54
Stenhousem'r,650,5,15,8,13,57,49,8,53
Elgin,650,6,14,6,16,54,62,-8,48
Annan Athlet,650,7,12,11,13,50,41,9,47
Berwick,650,8,8,10,18,29,59,-30,34
Edinburgh Ci,650,9,7,10,19,37,61,-24,31
Cowdenbeath,650,10,4,10,22,23,57,-34,22
Montrose,651,1,24,7,5,61,35,26,79
Peterhead,651,2,24,4,8,81,38,43,76
Stenhousem'r,651,3,16,8,12,57,46,11,56
Stirling,651,4,16,6,14,60,53,7,54
Clyde,651,5,15,9,12,52,48,4,54
Elgin,651,6,14,6,16,54,62,-8,48
Annan Athlet,651,7,12,11,13,48,41,7,47
Berwick,651,8,8,10,18,29,59,-30,34
Edinburgh Ci,651,9,7,9,20,36,64,-28,30
Cowdenbeath,651,10,4,10,22,23,55,-32,22
Montrose,652,1,24,7,5,61,34,27,79
Peterhead,652,2,23,5,8,79,40,39,74
Stenhousem'r,652,3,16,8,12,56,46,10,56
Stirling,652,4,16,6,14,60,52,8,54
Clyde,652,5,15,9,12,52,48,4,54
Elgin,652,6,14,6,16,53,62,-9,48
Annan Athlet,652,7,11,12,13,48,42,6,45
Berwick,652,8,8,10,18,29,59,-30,34
Edinburgh Ci,652,9,7,10,19,38,62,-24,31
Cowdenbeath,652,10,4,11,21,24,55,-31,23
Montrose,653,1,24,7,5,64,35,29,79
Peterhead,653,2,24,4,8,80,38,42,76
Stirling,653,3,17,6,13,62,52,10,57
Stenhousem'r,653,4,15,8,13,56,48,8,53
Clyde,653,5,14,9,13,53,51,2,51
Elgin,653,6,14,6,16,54,65,-11,48
Annan Athlet,653,7,12,11,13,51,41,10,47
Berwick,653,8,9,10,17,32,60,-28,37
Edinburgh Ci,653,9,7,9,20,36,63,-27,30
Cowdenbeath,653,10,4,10,22,23,58,-35,22
Peterhead,654,1,24,4,8,81,39,42,76
Montrose,654,2,23,7,6,61,37,24,76
Stirling,654,3,17,6,13,62,51,11,57
Stenhousem'r,654,4,15,8,13,55,48,7,53
Clyde,654,5,14,9,13,53,51,2,51
Elgin,654,6,15,6,15,56,62,-6,51
Annan Athlet,654,7,12,11,13,50,42,8,47
Berwick,654,8,9,10,17,32,60,-28,37
Edinburgh Ci,654,9,7,9,20,37,64,-27,30
Cowdenbeath,654,10,4,10,22,24,57,-33,22
Montrose,655,1,23,8,5,60,35,25,77
Peterhead,655,2,24,4,8,79,38,41,76
Stenhousem'r,655,3,16,8,12,58,46,12,56
Stirling,655,4,16,6,14,60,54,6,54
Clyde,655,5,15,9,12,52,48,4,54
Elgin,655,6,14,7,15,54,61,-7,49
Annan Athlet,655,7,11,12,13,48,42,6,45
Berwick,655,8,8,10,18,29,59,-30,34
Edinburgh Ci,655,9,7,9,20,36,62,-26,30
Cowdenbeath,655,10,4,11,21,24,55,-31,23
Montrose,656,1,24,7,5,60,34,26,79
Peterhead,656,2,24,4,8,79,39,40,76
Stirling,656,3,16,7,13,61,52,9,55
Stenhousem'r,656,4,15,9,12,56,47,9,54
Clyde,656,5,14,9,13,52,50,2,51
Elgin,656,6,14,6,16,53,61,-8,48
Annan Athlet,656,7,11,12,13,48,42,6,45
Berwick,656,8,9,10,17,31,59,-28,37
Edinburgh Ci,656,9,7,9,20,37,62,-25,30
Cowdenbeath,656,10,4,11,21,24,55,-31,23
Montrose,657,1,24,7,5,61,35,26,79
Peterhead,657,2,23,5,8,77,38,39,74
Stenhousem'r,657,3,16,8,12,58,48,10,56
Stirling,657,4,16,6,14,62,54,8,54
Clyde,657,5,15,9,12,54,49,5,54
Elgin,657,6,14,6,16,54,62,-8,48
Annan Athlet,657,7,12,11,13,52,43,9,47
Berwick,657,8,8,10,18,30,61,-31,34
Edinburgh Ci,657,9,7,10,19,36,60,-24,31
Cowdenbeath,657,10,4,10,22,25,59,-34,22
Montrose,658,1,24,7,5,63,34,29,79
Peterhead,658,2,24,4,8,85,39,46,76
Stirling,658,3,17,6,13,64,52,12,57
Stenhousem'r,658,4,15,8,13,56,50,6,53
Clyde,658,5,14,9,13,52,50,2,51
Elgin,658,6,14,6,16,53,64,-11,48
Annan Athlet,658,7,11,12,13,47,41,6,45
Berwick,658,8,9,10,17,31,59,-28,37
Edinburgh Ci,658,9,7,9,20,37,68,-31,30
Cowdenbeath,658,10,4,11,21,23,54,-31,23
Montrose,659,1,24,7,5,60,34,26,79
Peterhead,659,2,23,4,9,78,40,38,73
Stirling,659,3,17,6,13,63,51,12,57
Clyde,659,4,15,9,12,52,48,4,54
Stenhousem'r,659,5,15,8,13,55,49,6,53
Elgin,659,6,14,6,16,53,61,-8,48
Annan Athlet,659,7,11,12,13,47,41,6,45
Berwick,659,8,8,10,18,29,59,-30,34
Edinburgh Ci,659,9,8,9,19,38,61,-23,33
Cowdenbeath,659,10,4,11,21,23,54,-31,23
Montrose,660,1,24,7,5,62,34,28,79
Peterhead,660,2,23,4,9,77,39,38,73
Stenhousem'r,660,3,16,8,12,57,47,10,56
Stirling,660,4,16,6,14,61,53,8,54
Clyde,660,5,15,9,12,54,48,6,54
Elgin,660,6,14,6,16,53,63,-10,48
Annan Athlet,660,7,11,11,14,48,43,5,44
Berwick,660,8,8,10,18,29,61,-32,34
Edinburgh Ci,660,9,8,9,19,37,60,-23,33
Cowdenbeath,660,10,5,10,21,25,55,-30,25
Montrose,661,1,24,7,5,61,35,26,79
Peterhead,661,2,24,4,8,79,38,41,76
Stirling,661,3,16,7,13,61,52,9,55
Stenhousem'r,661,4,15,9,12,56,47,9,54
Clyde,661,5,15,9,12,54,48,6,54
Elgin,661,6,14,6,16,54,62,-8,48
Annan Athlet,661,7,11,11,14,47,43,4,44
Berwick,661,8,8,10,18,29,61,-32,34
Edinburgh Ci,661,9,7,9,20,36,62,-26,30
Cowdenbeath,661,10,5,10,21,25,54,-29,25
Montrose,662,1,23,8,5,61,36,25,77
Peterhead,662,2,24,4,8,80,39,41,76
Stenhousem'r,662,3,16,8,12,57,46,11,56
Stirling,662,4,16,6,14,60,53,7,54
Clyde,662,5,15,9,12,53,49,4,54
Elgin,662,6,14,7,15,55,62,-7,49
Annan Athlet,662,7,11,11,14,47,42,5,44
Berwick,662,8,8,10,18,30,60,-30,34
Edinburgh Ci,662,9,7,9,20,37,63,-26,30
Cowdenbeath,662,10,5,10,21,24,54,-30,25
Montrose,663,1,23,7,6,60,36,24,76
Peterhead,663,2,23,5,8,78,39,39,74
Stirling,663,3,16,7,13,62,53,9,55
Stenhousem'r,663,4,15,9,12,57,48,9,54
Clyde,663,5,14,10,12,52,49,3,52
Elgin,663,6,15,6,15,55,61,-6,51
Annan Athlet,663,7,12,11,13,48,41,7,47
Berwick,663,8,8,11,17,30,59,-29,35
Edinburgh Ci,663,9,7,10,19,37,61,-24,31
Cowdenbeath,663,10,4,10,22,23,55,-32,22
Montrose,664,1,24,7,5,60,34,26,79
Peterhead,664,2,24,4,8,80,39,41,76
Stirling,664,3,16,7,13,61,52,9,55
Stenhousem'r,664,4,15,9,12,56,47,9,54
Clyde,664,5,15,9,12,53,49,4,54
Elgin,664,6,14,6,16,53,61,-8,48
Annan Athlet,664,7,12,11,13,49,42,7,47
Berwick,664,8,8,10,18,30,60,-30,34
Edinburgh Ci,664,9,7,9,20,37,63,-26,30
Cowdenbeath,664,10,4,10,22,24,56,-32,22
Montrose,665,1,24,7,5,60,34,26,79
Peterhead,665,2,23,5,8,77,38,39,74
Stirling,665,3,16,7,13,62,53,9,55
Stenhousem'r,665,4,15,9,12,57,48,9,54
Clyde,665,5,14,10,12,53,50,3,52
Elgin,665,6,14,6,16,53,61,-8,48
Annan Athlet,665,7,11,12,13,47,41,6,45
Berwick,665,8,8,11,17,31,60,-29,35
Edinburgh Ci,665,9,7,10,19,36,60,-24,31
Cowdenbeath,665,10,4,11,21,23,54,-31,23
Montrose,666,1,23,8,5,59,34,25,77
Peterhead,666,2,23,5,8,78,39,39,74
Stenhousem'r,666,3,16,8,12,57,46,11,56
Stirling,666,4,16,6,14,60,53,7,54
Clyde,666,5,15,9,12,54,50,4,54
Elgin,666,6,14,7,15,53,60,-7,49
Annan Athlet,666,7,12,11,13,49,41,8,47
Berwick,666,8,8,10,18,31,61,-30,34
Edinburgh Ci,666,9,7,10,19,37,61,-24,31
Cowdenbeath,666,10,4,10,22,23,56,-33,22
Montrose,667,1,24,7,5,61,35,26,79
Peterhead,667,2,24,4,8,80,40,40,76
Stirling,667,3,17,6,13,63,52,11,57
Stenhousem'r,667,4,15,8,13,56,49,7,53
Clyde,667,5,14,10,12,52,49,3,52
Elgin,667,6,14,6,16,54,62,-8,48
Annan Athlet,667,7,12,11,13,48,41,7,47
Berwick,667,8,8,11,17,30,59,-29,35
Edinburgh Ci,667,9,7,9,20,38,63,-25,30
Cowdenbeath,667,10,4,10,22,23,55,-32,22
Peterhead,668,1,24,4,8,80,39,41,76
Montrose,668,2,23,7,6,59,35,24,76
Stirling,668,3,17,6,13,64,52,12,57
Stenhousem'r,668,4,15,8,13,56,50,6,53
Clyde,668,5,14,9,13,51,49,2,51
Elgin,668,6,15,6,15,54,60,-6,51
Annan Athlet,668,7,11,11,14,47,42,5,44
Berwick,668,8,9,10,17,30,58,-28,37
Edinburgh Ci,668,9,7,9,20,37,63,-26,30
Cowdenbeath,668,10,5,10,21,24,54,-30,25
Montrose,669,1,23,8,5,61,36,25,77
Peterhead,669,2,24,4,8,79,38,41,76
Stirling,669,3,16,7,13,61,52,9,55
Stenhousem'r,669,4,15,9,12,56,47,9,54
Clyde,669,5,14,9,13,52,50,2,51
Elgin,669,6,14,7,15,55,62,-7,49
Annan Athlet,669,7,12,11,13,48,41,7,47
Berwick,669,8,9,10,17,31,59,-28,37
Edinburgh Ci,669,9,7,9,20,36,62,-26,30
Cowdenbeath,669,10,4,10,22,23,55,-32,22
Montrose,670,1,24,7,5,62,35,27,79
Peterhead,670,2,24,4,8,80,39,41,76
Stirling,670,3,17,6,13,62,52,10,57
Stenhousem'r,670,4,15,8,13,56,48,8,53
Clyde,670,5,14,10,12,53,50,3,52
Elgin,670,6,14,6,16,54,63,-9,48
Annan Athlet,670,7,12,11,13,48,41,7,47
Berwick,670,8,8,11,17,31,60,-29,35
Edinburgh Ci,670,9,7,9,20,37,63,-26,30
Cowdenbeath,670,10,4,10,22,23,55,-32,22
Montrose,671,1,24,7,5,60,34,26,79
Peterhead,671,2,24,4,8,79,38,41,76
Stirling,671,3,17,6,13,61,51,10,57
Clyde,671,4,15,9,12,53,49,4,54
Stenhousem'r,671,5,15,8,13,55,47,8,53
Elgin,671,6,14,6,16,53,61,-8,48
Annan Athlet,671,7,11,12,13,49,43,6,45
Berwick,671,8,8,10,18,30,60,-30,34
Edinburgh Ci,671,9,7,9,20,36,62,-26,30
Cowdenbeath,671,10,4,11,21,25,56,-31,23
Montrose,672,1,23,8,5,61,36,25,77
Peterhead,672,2,24,4,8,80,40,40,76
Stirling,672,3,17,6,13,62,51,11,57
Stenhousem'r,672,4,15,8,13,55,48,7,53
Clyde,672,5,14,10,12,52,49,3,52
Elgin,672,6,14,7,15,55,62,-7,49
Annan Athlet,672,7,11,11,14,47,42,5,44
Berwick,672,8,8,11,17,30,59,-29,35
Edinburgh Ci,672,9,7,9,20,38,63,-25,30
Cowdenbeath,672,10,5,10,21,24,54,-30,25
Montrose,673,1,24,7,5,64,36,28,79
Peterhead,673,2,24,4,8,81,40,41,76
Stirling,673,3,16,7,13,61,52,9,55
Stenhousem'r,673,4,15,9,12,56,47,9,54
Clyde,673,5,14,9,13,52,50,2,51
Elgin,673,6,14,6,16,55,65,-10,48
Annan Athlet,673,7,12,11,13,50,42,8,47
Berwick,673,8,9,10,17,31,59,-28,37
Edinburgh Ci,673,9,7,9,20,38,64,-26,30
Cowdenbeath,673,10,4,10,22,24,57,-33,22
Montrose,674,1,23,7,6,59,35,24,76
Peterhead,674,2,23,4,9,78,40,38,73
Stenhousem'r,674,3,16,8,12,57,46,11,56
Stirling,674,4,16,6,14,60,53,7,54
Clyde,674,5,14,10,12,51,48,3,52
Elgin,674,6,15,6,15,54,60,-6,51
Annan Athlet,674,7,11,11,14,47,43,4,44
Berwick,674,8,8,11,17,29,58,-29,35
Edinburgh Ci,674,9,8,9,19,38,61,-23,33
Cowdenbeath,674,10,5,10,21,25,54,-29,25
Montrose,675,1,24,7,5,61,34,27,79
Peterhead,675,2,24,4,8,78,38,40,76
Stirling,675,3,16,7,13,61,52,9,55
Stenhousem'r,675,4,15,9,12,56,47,9,54
Clyde,675,5,15,9,12,53,49,4,54
Elgin,675,6,14,6,16,53,62,-9,48
Annan Athlet,675,7,12,11,13,49,41,8,47
Berwick,675,8,8,10,18,30,60,-30,34
Edinburgh Ci,675,9,7,9,20,36,61,-25,30
Cowdenbeath,675,10,4,10,22,23,56,-33,22
Montrose,676,1,24,7,5,62,35,27,79
Peterhead,676,2,24,4,8,81,38,43,76
Stenhousem'r,676,3,16,8,12,60,48,12,56
Stirling,676,4,16,6,14,62,56,6,54
Clyde,676,5,15,9,12,52,48,4,54
Elgin,676,6,14,6,16,54,63,-9,48
Annan Athlet,676,7,11,11,14,47,42,5,44
Berwick,676,8,8,10,18,29,59,-30,34
Edinburgh Ci,676,9,7,9,20,36,64,-28,30
Cowdenbeath,676,10,5,10,21,24,54,-30,25
Montrose,677,1,24,7,5,61,34,27,79
Peterhead,677,2,24,4,8,82,40,42,76
Stirling,677,3,16,7,13,60,51,9,55
Stenhousem'r,677,4,15,9,12,55,46,9,54
Clyde,677,5,15,9,12,52,48,4,54
Elgin,677,6,14,6,16,53,62,-9,48
Annan Athlet,677,7,11,12,13,48,42,6,45
Berwick,677,8,8,10,18,29,59,-30,34
Edinburgh Ci,677,9,7,9,20,38,65,-27,30
Cowdenbeath,677,10,4,11,21,24,55,-31,23
Montrose,678,1,23,8,5,59,34,25,77
Peterhead,678,2,24,4,8,79,39,40,76
Stirling,678,3,17,6,13,63,52,11,57
Clyde,678,4,15,9,12,54,49,5,54
Stenhousem'r,678,5,15,8,13,56,49,7,53
Elgin,678,6,14,7,15,53,60,-7,49
Annan Athlet,678,7,12,11,13,48,41,7,47
Berwick,678,8,8,10,18,30,61,-31,34
Edinburgh Ci,678,9,7,9,20,37,62,-25,30
Cowdenbeath,678,10,4,10,22,23,55,-32,22
Montrose,679,1,24,7,5,61,34,27,79
Peterhead,679,2,24,4,8,80,38,42,76
Stirling,679,3,16,7,13,60,51,9,55
Stenhousem'r,679,4,15,9,12,55,46,9,54
Clyde,679,5,14,9,13,52,50,2,51
Elgin,679,6,14,6,16,53,62,-9,48
Annan Athlet,679,7,12,11,13,48,41,7,47
Berwick,679,8,9,10,17,31,59,-28,37
Edinburgh Ci,679,9,7,9,20,36,63,-27,30
Cowdenbeath,679,10,4,10,22,23,55,-32,22
Montrose,680,1,23,8,5,60,35,25,77
Peterhead,680,2,24,4,8,80,39,41,76
Stirling,680,3,16,7,13,60,51,9,55
Stenhousem'r,680,4,15,9,12,55,46,9,54
Clyde,680,5,14,10,12,52,49,3,52
Elgin,680,6,14,7,15,54,61,-7,49
Annan Athlet,680,7,11,12,13,47,41,6,45
Berwick,680,8,8,11,17,30,59,-29,35
Edinburgh Ci,680,9,7,9,20,37,63,-26,30
Cowdenbeath,680,10,4,11,21,23,54,-31,23
Montrose,681,1,24,7,5,61,35,26,79
Peterhead,681,2,24,4,8,84,39,45,76
Stenhousem'r,681,3,16,8,12,59,46,13,56
Stirling,681,4,16,6,14,60,55,5,54
Clyde,681,5,15,9,12,52,48,4,54
Elgin,681,6,14,6,16,54,62,-8,48
Annan Athlet,681,7,12,11,13,51,41,10,47
Berwick,681,8,8,10,18,29,59,-30,34
Edinburgh Ci,681,9,7,9,20,37,67,-30,30
Cowdenbeath,681,10,4,10,22,23,58,-35,22
Montrose,682,1,24,7,5,62,36,26,79
Peterhead,682,2,23,4,9,78,41,37,73
Stirling,682,3,17,6,13,61,51,10,57
Clyde,682,4,15,9,12,53,48,5,54
Stenhousem'r,682,5,15,8,13,55,47,8,53
Elgin,682,6,14,6,16,55,63,-8,48
Annan Athlet,682,7,11,11,14,48,43,5,44
Berwick,682,8,8,10,18,29,60,-31,34
Edinburgh Ci,682,9,8,9,19,39,61,-22,33
Cowdenbeath,682,10,5,10,21,25,55,-30,25
Montrose,683,1,24,7,5,62,34,28,79
Peterhead,683,2,24,4,8,79,38,41,76
Stirling,683,3,16,7,13,61,52,9,55
Stenhousem'r,683,4,15,9,12,56,47,9,54
Clyde,683,5,14,9,13,52,50,2,51
Elgin,683,6,14,6,16,53,63,-10,48
Annan Athlet,683,7,11,12,13,49,43,6,45
Berwick,683,8,9,10,17,31,59,-28,37
Edinburgh Ci,683,9,7,9,20,36,62,-26,30
Cowdenbeath,683,10,4,11,21,25,56,-31,23
Montrose,684,1,24,7,5,61,34,27,79
Peterhead,684,2,24,4,8,80,38,42,76
Stirling,684,3,17,6,13,63,52,11,57
Stenhousem'r,684,4,15,8,13,56,49,7,53
Clyde,684,5,14,9,13,52,50,2,51
Elgin,684,6,14,6,16,53,62,-9,48
Annan Athlet,684,7,12,11,13,49,42,7,47
Berwick,684,8,9,10,17,31,59,-28,37
Edinburgh Ci,684,9,7,9,20,36,63,-27,30
Cowdenbeath,684,10,4,10,22,24,56,-32,22
Montrose,685,1,24,7,5,60,34,26,79
Peterhead,685,2,24,4,8,81,39,42,76
Stenhousem'r,685,3,16,8,12,57,47,10,56
Stirling,685,4,16,6,14,61,53,8,54
Clyde,685,5,15,9,12,54,49,5,54
Elgin,685,6,14,6,16,53,61,-8,48
Annan Athlet,685,7,11,12,13,47,41,6,45
Berwick,685,8,8,10,18,30,61,-31,34
Edinburgh Ci,685,9,7,9,20,37,64,-27,30
Cowdenbeath,685,10,4,11,21,23,54,-31,23
Montrose,686,1,24,7,5,63,35,28,79
Peterhead,686,2,23,4,9,78,41,37,73
Stenhousem'r,686,3,16,8,12,57,47,10,56
Stirling,686,4,16,6,14,61,53,8,54
Clyde,686,5,15,9,12,53,48,5,54
Elgin,686,6,14,6,16,54,64,-10,48
Annan Athlet,686,7,12,11,13,49,41,8,47
Berwick,686,8,8,10,18,29,60,-31,34
Edinburgh Ci,686,9,8,9,19,39,61,-22,33
Cowdenbeath,686,10,4,10,22,23,56,-33,22
Montrose,687,1,24,7,5,63,34,29,79
Peterhead,687,2,24,4,8,80,38,42,76
Stirling,687,3,17,6,13,62,51,11,57
Clyde,687,4,15,9,12,55,49,6,54
Stenhousem'r,687,5,15,8,13,55,48,7,53
Elgin,687,6,14,6,16,53,64,-11,48
Annan Athlet,687,7,12,11,13,50,41,9,47
Berwick,687,8,8,10,18,30,62,-32,34
Edinburgh Ci,687,9,7,9,20,36,63,-27,30
Cowdenbeath,687,10,4,10,22,23,57,-34,22
Montrose,688,1,24,7,5,61,34,27,79
Peterhead,688,2,24,4,8,79,38,41,76
Stenhousem'r,688,3,16,8,12,58,46,12,56
Stirling,688,4,16,6,14,60,54,6,54
Clyde,688,5,14,10,12,52,49,3,52
Elgin,688,6,14,6,16,53,62,-9,48
Annan Athlet,688,7,11,12,13,47,41,6,45
Berwick,688,8,8,11,17,30,59,-29,35
Edinburgh Ci,688,9,7,9,20,36,62,-26,30
Cowdenbeath,688,10,4,11,21,23,54,-31,23
Peterhead,689,1,24,4,8,80,39,41,76
Montrose,689,2,23,7,6,60,37,23,76
Stenhousem'r,689,3,16,8,12,57,47,10,56
Stirling,689,4,16,6,14,61,53,8,54
Clyde,689,5,15,9,12,52,48,4,54
Elgin,689,6,15,6,15,56,61,-5,51
Annan Athlet,689,7,11,11,14,47,43,4,44
Berwick,689,8,8,10,18,29,59,-30,34
Edinburgh Ci,689,9,7,9,20,37,63,-26,30
Cowdenbeath,689,10,5,10,21,25,54,-29,25
Montrose,690,1,23,8,5,59,34,25,77
Peterhead,690,2,24,4,8,78,38,40,76
Stenhousem'r,690,3,16,8,12,59,47,12,56
Stirling,690,4,16,6,14,61,55,6,54
Clyde,690,5,14,9,13,51,49,2,51
Elgin,690,6,14,7,15,53,60,-7,49
Annan Athlet,690,7,11,11,14,47,43,4,44
Berwick,690,8,9,10,17,30,58,-28,37
Edinburgh Ci,690,9,7,9,20,36,61,-25,30
Cowdenbeath,690,10,5,10,21,25,54,-29,25
Montrose,691,1,24,7,5,62,34,28,79
Peterhead,691,2,23,5,8,79,40,39,74
Stirling,691,3,17,6,13,62,52,10,57
Stenhousem'r,691,4,15,8,13,56,48,8,53
Clyde,691,5,14,9,13,53,51,2,51
Elgin,691,6,14,6,16,53,63,-10,48
Annan Athlet,691,7,12,11,13,49,42,7,47
Berwick,691,8,9,10,17,32,60,-28,37
Edinburgh Ci,691,9,7,10,19,38,62,-24,31
Cowdenbeath,691,10,4,10,22,24,56,-32,22
Montrose,692,1,24,7,5,61,34,27,79
Peterhead,692,2,24,4,8,80,38,42,76
Stirling,692,3,17,6,13,61,51,10,57
Stenhousem'r,692,4,15,8,13,55,47,8,53
Clyde,692,5,14,9,13,52,50,2,51
Elgin,692,6,14,6,16,53,62,-9,48
Annan Athlet,692,7,12,11,13,48,41,7,47
Berwick,692,8,9,10,17,31,59,-28,37
Edinburgh Ci,692,9,7,9,20,36,63,-27,30
Cowdenbeath,692,10,4,10,22,23,55,-32,22
Montrose,693,1,24,7,5,61,35,26,79
Peterhead,693,2,24,4,8,82,38,44,76
Stirling,693,3,17,6,13,61,51,10,57
Clyde,693,4,15,9,12,53,48,5,54
Stenhousem'r,693,5,15,8,13,55,47,8,53
Elgin,693,6,14,6,16,54,62,-8,48
Annan Athlet,693,7,12,11,13,49,41,8,47
Berwick,693,8,8,10,18,29,60,-31,34
Edinburgh Ci,693,9,7,9,20,36,65,-29,30
Cowdenbeath,693,10,4,10,22,23,56,-33,22
Montrose,694,1,24,7,5,63,35,28,79
Peterhead,694,2,24,4,8,78,38,40,76
Stirling,694,3,17,6,13,63,52,11,57
Stenhousem'r,694,4,15,8,13,56,49,7,53
Clyde,694,5,14,10,12,51,48,3,52
Elgin,694,6,14,6,16,54,64,-10,48
Annan Athlet,694,7,11,12,13,48,42,6,45
Berwick,694,8,8,11,17,29,58,-29,35
Edinburgh Ci,694,9,7,9,20,36,61,-25,30
Cowdenbeath,694,10,4,11,21,24,55,-31,23
Montrose,695,1,24,7,5,61,34,27,79
Peterhead,695,2,24,4,8,84,38,46,76
Stirling,695,3,17,6,13,62,51,11,57
Clyde,695,4,15,9,12,52,48,4,54
Stenhousem'r,695,5,15,8,13,55,48,7,53
Elgin,695,6,14,6,16,53,62,-9,48
Annan Athlet,695,7,11,12,13,49,43,6,45
Berwick,695,8,8,10,18,29,59,-30,34
Edinburgh Ci,695,9,7,9,20,36,67,-31,30
Cowdenbeath,695,10,4,11,21,25,56,-31,23
Montrose,696,1,24,7,5,62,35,27,79
Peterhead,696,2,24,4,8,82,38,44,76
Stirling,696,3,16,7,13,61,52,9,55
Stenhousem'r,696,4,15,9,12,56,47,9,54
Clyde,696,5,14,9,13,51,49,2,51
Elgin,696,6,14,6,16,54,63,-9,48
Annan Athlet,696,7,11,11,14,47,42,5,44
Berwick,696,8,9,10,17,30,58,-28,37
Edinburgh Ci,696,9,7,9,20,36,65,-29,30
Cowdenbeath,696,10,5,10,21,24,54,-30,25
Montrose,697,1,23,8,5,59,34,25,77
Peterhead,697,2,24,4,8,82,41,41,76
Stirling,697,3,17,6,13,62,51,11,57
Clyde,697,4,15,9,12,55,49,6,54
Stenhousem'r,697,5,15,8,13,55,48,7,53
Elgin,697,6,14,7,15,53,60,-7,49
Annan Athlet,697,7,11,11,14,48,43,5,44
Berwick,697,8,8,10,18,30,62,-32,34
Edinburgh Ci,697,9,7,9,20,39,65,-26,30
Cowdenbeath,697,10,5,10,21,25,55,-30,25
Montrose,698,1,23,8,5,59,34,25,77
Peterhead,698,2,23,5,8,78,39,39,74
Stirling,698,3,16,7,13,60,51,9,55
Stenhousem'r,698,4,15,9,12,55,46,9,54
Clyde,698,5,14,10,12,53,50,3,52
Elgin,698,6,14,7,15,53,60,-7,49
Annan Athlet,698,7,11,11,14,47,42,5,44
Berwick,698,8,8,11,17,31,60,-29,35
Edinburgh Ci,698,9,7,10,19,37,61,-24,31
Cowdenbeath,698,10,5,10,21,24,54,-30,25
Peterhead,699,1,24,4,8,79,39,40,76
Montrose,699,2,23,7,6,59,35,24,76
Stirling,699,3,17,6,13,63,51,12,57
Clyde,699,4,15,9,12,54,48,6,54
Stenhousem'r,699,5,15,8,13,55,49,6,53
Elgin,699,6,15,6,15,54,60,-6,51
Annan Athlet,699,7,11,11,14,47,42,5,44
Berwick,699,8,8,10,18,29,61,-32,34
Edinburgh Ci,699,9,7,9,20,37,62,-25,30
Cowdenbeath,699,10,5,10,21,24,54,-30,25
Montrose,700,1,23,7,6,60,36,24,76
Peterhead,700,2,23,5,8,79,40,39,74
Stenhousem'r,700,3,16,8,12,59,48,11,56
Stirling,700,4,16,6,14,62,55,7,54
Clyde,700,5,15,9,12,55,48,7,54
Elgin,700,6,15,6,15,55,61,-6,51
Annan Athlet,700,7,12,11,13,48,41,7,47
Berwick,700,8,8,10,18,29,62,-33,34
Edinburgh Ci,700,9,7,10,19,38,62,-24,31
Cowdenbeath,700,10,4,10,22,23,55,-32,22
Montrose,701,1,24,7,5,61,35,26,79
Peterhead,701,2,24,4,8,82,39,43,76
Stirling,701,3,17,6,13,62,51,11,57
Clyde,701,4,15,9,12,54,49,5,54
Stenhousem'r,701,5,15,8,13,55,48,7,53
Elgin,701,6,14,6,16,54,62,-8,48
Annan Athlet,701,7,11,12,13,48,42,6,45
Berwick,701,8,8,10,18,30,61,-31,34
Edinburgh Ci,701,9,7,9,20,37,65,-28,30
Cowdenbeath,701,10,4,11,21,24,55,-31,23
Montrose,702,1,24,7,5,61,35,26,79
Peterhead,702,2,24,4,8,79,39,40,76
Stenhousem'r,702,3,16,8,12,57,46,11,56
Stirling,702,4,16,6,14,60,53,7,54
Clyde,702,5,15,9,12,52,48,4,54
Elgin,702,6,14,6,16,54,62,-8,48
Annan Athlet,702,7,11,11,14,47,42,5,44
Berwick,702,8,8,10,18,29,59,-30,34
Edinburgh Ci,702,9,7,9,20,37,62,-25,30
Cowdenbeath,702,10,5,10,21,24,54,-30,25
Montrose,703,1,24,7,5,62,35,27,79
Peterhead,703,2,24,4,8,80,38,42,76
Stenhousem'r,703,3,16,8,12,56,46,10,56
Stirling,703,4,16,6,14,60,52,8,54
Clyde,703,5,14,9,13,51,50,1,51
Elgin,703,6,14,6,16,54,63,-9,48
Annan Athlet,703,7,11,11,14,47,42,5,44
Berwick,703,8,9,10,17,31,58,-27,37
Edinburgh Ci,703,9,7,9,20,36,63,-27,30
Cowdenbeath,703,10,5,10,21,24,54,-30,25
Montrose,704,1,23,8,5,62,37,25,77
Peterhead,704,2,23,4,9,78,40,38,73
Stirling,704,3,17,6,13,62,52,10,57
Clyde,704,4,15,9,12,54,50,4,54
Stenhousem'r,704,5,15,8,13,56,48,8,53
Elgin,704,6,14,7,15,56,63,-7,49
Annan Athlet,704,7,11,12,13,49,43,6,45
Berwick,704,8,8,10,18,31,61,-30,34
Edinburgh Ci,704,9,8,9,19,38,61,-23,33
Cowdenbeath,704,10,4,11,21,25,56,-31,23
Montrose,705,1,23,8,5,60,35,25,77
Peterhead,705,2,24,4,8,78,38,40,76
Stirling,705,3,16,7,13,60,51,9,55
Stenhousem'r,705,4,15,9,12,55,46,9,54
Clyde,705,5,15,9,12,52,48,4,54
Elgin,705,6,14,7,15,54,61,-7,49
Annan Athlet,705,7,11,11,14,47,42,5,44
Berwick,705,8,8,10,18,29,59,-30,34
Edinburgh Ci,705,9,7,9,20,36,61,-25,30
Cowdenbeath,705,10,5,10,21,24,54,-30,25
Montrose,706,1,24,7,5,61,35,26,79
Peterhead,706,2,24,4,8,79,38,41,76
Stirling,706,3,17,6,13,61,51,10,57
Clyde,706,4,15,9,12,54,49,5,54
Stenhousem'r,706,5,15,8,13,55,47,8,53
Elgin,706,6,14,6,16,54,62,-8,48
Annan Athlet,706,7,11,11,14,48,45,3,44
Berwick,706,8,8,10,18,30,61,-31,34
Edinburgh Ci,706,9,7,9,20,36,62,-26,30
Cowdenbeath,706,10,5,10,21,27,55,-28,25
Montrose,707,1,24,7,5,61,34,27,79
Peterhead,707,2,23,5,8,78,39,39,74
Stirling,707,3,17,6,13,62,51,11,57
Clyde,707,4,15,9,12,53,49,4,54
Stenhousem'r,707,5,15,8,13,55,48,7,53
Elgin,707,6,14,6,16,53,62,-9,48
Annan Athlet,707,7,11,11,14,47,43,4,44
Berwick,707,8,8,10,18,30,60,-30,34
Edinburgh Ci,707,9,7,10,19,37,61,-24,31
Cowdenbeath,707,10,5,10,21,25,54,-29,25
Montrose,708,1,24,7,5,61,34,27,79
Peterhead,708,2,24,4,8,79,39,40,76
Stenhousem'r,708,3,16,8,12,57,47,10,56
Stirling,708,4,16,6,14,61,53,8,54
Clyde,708,5,15,9,12,56,48,8,54
Elgin,708,6,14,6,16,53,62,-9,48
Annan Athlet,708,7,11,12,13,48,42,6,45
Berwick,708,8,8,10,18,29,63,-34,34
Edinburgh Ci,708,9,7,9,20,37,62,-25,30
Cowdenbeath,708,10,4,11,21,24,55,-31,23
Montrose,709,1,24,7,5,61,34,27,79
Peterhead,709,2,24,4,8,80,38,42,76
Stenhousem'r,709,3,16,8,12,56,46,10,56
Stirling,709,4,16,6,14,60,52,8,54
Clyde,709,5,15,9,12,54,49,5,54
Elgin,709,6,14,6,16,53,62,-9,48
Annan Athlet,709,7,12,11,13,52,41,11,47
Berwick,709,8,8,10,18,30,61,-31,34
Edinburgh Ci,709,9,7,9,20,36,63,-27,30
Cowdenbeath,709,10,4,10,22,23,59,-36,22
Montrose,710,1,23,7,6,59,38,21,76
Peterhead,710,2,23,5,8,79,40,39,74
Stirling,710,3,16,7,13,62,53,9,55
Stenhousem'r,710,4,15,9,12,57,48,9,54
Clyde,710,5,15,9,12,52,48,4,54
Elgin,710,6,15,6,15,57,60,-3,51
Annan Athlet,710,7,12,11,13,48,41,7,47
Berwick,710,8,8,10,18,29,59,-30,34
Edinburgh Ci,710,9,7,10,19,38,62,-24,31
Cowdenbeath,710,10,4,10,22,23,55,-32,22
Montrose,711,1,23,7,6,59,36,23,76
Peterhead,711,2,23,5,8,78,39,39,74
Stirling,711,3,16,7,13,62,53,9,55
Stenhousem'r,711,4,15,9,12,57,48,9,54
Clyde,711,5,15,9,12,54,48,6,54
Elgin,711,6,15,6,15,55,60,-5,51
Annan Athlet,711,7,12,11,13,50,42,8,47
Berwick,711,8,8,10,18,29,61,-32,34
Edinburgh Ci,711,9,7,10,19,37,61,-24,31
Cowdenbeath,711,10,4,10,22,24,57,-33,22
Montrose,712,1,23,8,5,60,35,25,77
Peterhead,712,2,23,5,8,78,39,39,74
Stenhousem'r,712,3,16,8,12,58,48,10,56
Stirling,712,4,16,6,14,62,54,8,54
Clyde,712,5,14,10,12,52,49,3,52
Elgin,712,6,14,7,15,54,61,-7,49
Annan Athlet,712,7,11,11,14,47,42,5,44
Berwick,712,8,8,11,17,30,59,-29,35
Edinburgh Ci,712,9,7,10,19,37,61,-24,31
Cowdenbeath,712,10,5,10,21,24,54,-30,25
Montrose,713,1,24,7,5,62,35,27,79
Peterhead,713,2,24,4,8,80,38,42,76
Stirling,713,3,17,6,13,61,51,10,57
Stenhousem'r,713,4,15,8,13,55,47,8,53
Clyde,713,5,14,9,13,52,51,1,51
Elgin,713,6,14,6,16,54,63,-9,48
Annan Athlet,713,7,11,12,13,48,42,6,45
Berwick,713,8,9,10,17,32,59,-27,37
Edinburgh Ci,713,9,7,9,20,36,63,-27,30
Cowdenbeath,713,10,4,11,21,24,55,-31,23
Peterhead,714,1,24,4,8,83,38,45,76
Montrose,714,2,23,7,6,59,38,21,76
Stirling,714,3,16,7,13,61,52,9,55
Stenhousem'r,714,4,15,9,12,56,47,9,54
Clyde,714,5,15,9,12,54,50,4,54
Elgin,714,6,15,6,15,57,60,-3,51
Annan Athlet,714,7,11,12,13,48,42,6,45
Berwick,714,8,8,10,18,31,61,-30,34
Edinburgh Ci,714,9,7,9,20,36,66,-30,30
Cowdenbeath,714,10,4,11,21,24,55,-31,23
Montrose,715,1,24,7,5,63,35,28,79
Peterhead,715,2,24,4,8,79,38,41,76
Stenhousem'r,715,3,16,8,12,59,49,10,56
Stirling,715,4,16,6,14,63,55,8,54
Clyde,715,5,15,9,12,53,49,4,54
Elgin,715,6,14,6,16,54,64,-10,48
Annan Athlet,715,7,11,11,14,49,44,5,44
Berwick,715,8,8,10,18,30,60,-30,34
Edinburgh Ci,715,9,7,9,20,36,62,-26,30
Cowdenbeath,715,10,5,10,21,26,56,-30,25
Montrose,716,1,23,8,5,60,35,25,77
Peterhead,716,2,23,5,8,78,39,39,74
Stirling,716,3,16,7,13,61,52,9,55
Stenhousem'r,716,4,15,9,12,56,47,9,54
Clyde,716,5,15,9,12,52,48,4,54
Elgin,716,6,14,7,15,54,61,-7,49
Annan Athlet,716,7,11,11,14,48,44,4,44
Berwick,716,8,8,10,18,29,59,-30,34
Edinburgh Ci,716,9,7,10,19,37,61,-24,31
Cowdenbeath,716,10,5,10,21,26,55,-29,25
Montrose,717,1,24,7,5,62,34,28,79
Peterhead,717,2,23,5,8,77,38,39,74
Stirling,717,3,17,6,13,62,52,10,57
Clyde,717,4,15,9,12,56,48,8,54
Stenhousem'r,717,5,15,8,13,56,48,8,53
Elgin,717,6,14,6,16,53,63,-10,48
Annan Athlet,717,7,11,12,13,48,42,6,45
Berwick,717,8,8,10,18,29,63,-34,34
Edinburgh Ci,717,9,7,10,19,36,60,-24,31
Cowdenbeath,717,10,4,11,21,24,55,-31,23
Peterhead,718,1,24,4,8,78,38,40,76
Montrose,718,2,23,7,6,60,40,20,76
Stirling,718,3,16,7,13,61,52,9,55
Stenhousem'r,718,4,15,9,12,56,47,9,54
Clyde,718,5,15,9,12,54,50,4,54
Elgin,718,6,15,6,15,59,61,-2,51
Annan Athlet,718,7,11,12,13,47,41,6,45
Berwick,718,8,8,10,18,31,61,-30,34
Edinburgh Ci,718,9,7,9,20,36,61,-25,30
Cowdenbeath,718,10,4,11,21,23,54,-31,23
Montrose,719,1,24,7,5,60,34,26,79
Peterhead,719,2,24,4,8,78,38,40,76
Stenhousem'r,719,3,16,8,12,59,46,13,56
Stirling,719,4,16,6,14,60,55,5,54
Clyde,719,5,14,10,12,52,49,3,52
Elgin,719,6,14,6,16,53,61,-8,48
Annan Athlet,719,7,11,12,13,47,41,6,45
Berwick,719,8,8,11,17,30,59,-29,35
Edinburgh Ci,719,9,7,9,20,36,61,-25,30
Cowdenbeath,719,10,4,11,21,23,54,-31,23
Peterhead,720,1,24,4,8,80,39,41,76
Montrose,720,2,23,7,6,59,36,23,76
Stirling,720,3,17,6,13,61,51,10,57
Clyde,720,4,15,9,12,53,48,5,54
Stenhousem'r,720,5,15,8,13,55,47,8,53
Elgin,720,6,15,6,15,55,60,-5,51
Annan Athlet,720,7,11,11,14,48,44,4,44
Berwick,720,8,8,10,18,29,60,-31,34
Edinburgh Ci,720,9,7,9,20,37,63,-26,30
Cowdenbeath,720,10,5,10,21,26,55,-29,25
Peterhead,721,1,24,4,8,81,41,40,76
Montrose,721,2,23,7,6,60,36,24,76
Stirling,721,3,17,6,13,62,52,10,57
Stenhousem'r,721,4,15,8,13,56,48,8,53
Clyde,721,5,14,10,12,54,51,3,52
Elgin,721,6,15,6,15,55,61,-6,51
Annan Athlet,721,7,11,12,13,49,43,6,45
Berwick,721,8,8,11,17,32,61,-29,35
Edinburgh Ci,721,9,7,9,20,39,64,-25,30
Cowdenbeath,721,10,4,11,21,25,56,-31,23
Montrose,722,1,24,7,5,61,34,27,79
Peterhead,722,2,24,4,8,78,38,40,76
Stirling,722,3,17,6,13,63,52,11,57
Clyde,722,4,15,9,12,53,49,4,54
Stenhousem'r,722,5,15,8,13,56,49,7,53
Elgin,722,6,14,6,16,53,62,-9,48
Annan Athlet,722,7,11,11,14,47,42,5,44
Berwick,722,8,8,10,18,30,60,-30,34
Edinburgh Ci,722,9,7,9,20,36,61,-25,30
Cowdenbeath,722,10,5,10,21,24,54,-30,25
Montrose,723,1,24,7,5,62,35,27,79
Peterhead,723,2,24,4,8,81,38,43,76
Stirling,723,3,17,6,13,63,52,11,57
Clyde,723,4,15,9,12,54,48,6,54
Stenhousem'r,723,5,15,8,13,56,49,7,53
Elgin,723,6,14,6,16,54,63,-9,48
Annan Athlet,723,7,11,12,13,49,43,6,45
Berwick,723,8,8,10,18,29,61,-32,34
Edinburgh Ci,723,9,7,9,20,36,64,-28,30
Cowdenbeath,723,10,4,11,21,25,56,-31,23
Montrose,724,1,24,7,5,60,34,26,79
Peterhead,724,2,24,4,8,81,39,42,76
Stirling,724,3,16,7,13,61,52,9,55
Stenhousem'r,724,4,15,9,12,56,47,9,54
Clyde,724,5,15,9,12,53,49,4,54
Elgin,724,6,14,6,16,53,61,-8,48
Annan Athlet,724,7,11,11,14,48,43,5,44
Berwick,724,8,8,10,18,30,60,-30,34
Edinburgh Ci,724,9,7,9,20,37,64,-27,30
Cowdenbeath,724,10,5,10,21,25,55,-30,25
Montrose,725,1,24,7,5,61,34,27,79
Peterhead,725,2,23,4,9,77,41,36,73
Stirling,725,3,16,7,13,61,52,9,55
Stenhousem'r,725,4,15,9,12,56,47,9,54
Clyde,725,5,15,9,12,52,48,4,54
Elgin,725,6,14,6,16,53,62,-9,48
Annan Athlet,725,7,11,12,13,47,41,6,45
Berwick,725,8,8,10,18,29,59,-30,34
Edinburgh Ci,725,9,8,9,19,39,60,-21,33
Cowdenbeath,725,10,4,11,21,23,54,-31,23
Peterhead,726,1,24,4,8,80,39,41,76
Montrose,726,2,23,7,6,60,36,24,76
Stirling,726,3,16,7,13,61,52,9,55
Stenhousem'r,726,4,15,9,12,56,47,9,54
Clyde,726,5,15,9,12,54,49,5,54
Elgin,726,6,15,6,15,55,61,-6,51
Annan Athlet,726,7,12,11,13,48,41,7,47
Berwick,726,8,8,10,18,30,61,-31,34
Edinburgh Ci,726,9,7,9,20,37,63,-26,30
Cowdenbeath,726,10,4,10,22,23,55,-32,22
Montrose,727,1,24,7,5,62,34,28,79
Peterhead,727,2,24,4,8,79,38,41,76
Stirling,727,3,17,6,13,61,51,10,57
Clyde,727,4,15,9,12,55,51,4,54
Stenhousem'r,727,5,15,8,13,55,47,8,53
Elgin,727,6,14,6,16,53,63,-10,48
Annan Athlet,727,7,11,11,14,47,44,3,44
Berwick,727,8,8,10,18,32,62,-30,34
Edinburgh Ci,727,9,7,9,20,36,62,-26,30
Cowdenbeath,727,10,5,10,21,26,54,-28,25
Montrose,728,1,24,7,5,64,35,29,79
Peterhead,728,2,24,4,8,81,40,41,76
Stenhousem'r,728,3,16,8,12,58,47,11,56
Stirling,728,4,16,6,14,61,54,7,54
Clyde,728,5,15,9,12,54,48,6,54
Elgin,728,6,14,6,16,54,65,-11,48
Annan Athlet,728,7,11,11,14,47,42,5,44
Berwick,728,8,8,10,18,29,61,-32,34
Edinburgh Ci,728,9,7,9,20,38,64,-26,30
Cowdenbeath,728,10,5,10,21,24,54,-30,25
Peterhead,729,1,24,4,8,81,38,43,76
Montrose,729,2,23,7,6,60,36,24,76
Stirling,729,3,17,6,13,64,52,12,57
Clyde,729,4,15,9,12,53,48,5,54
Stenhousem'r,729,5,15,8,13,56,50,6,53
Elgin,729,6,15,6,15,55,61,-6,51
Annan Athlet,729,7,12,11,13,49,41,8,47
Berwick,729,8,8,10,18,29,60,-31,34
Edinburgh Ci,729,9,7,9,20,36,64,-28,30
Cowdenbeath,729,10,4,10,22,23,56,-33,22
Montrose,730,1,24,7,5,62,35,27,79
Peterhead,730,2,24,4,8,81,39,42,76
Stenhousem'r,730,3,16,8,12,60,49,11,56
Stirling,730,4,16,6,14,63,56,7,54
Clyde,730,5,14,10,12,51,48,3,52
Elgin,730,6,14,6,16,54,63,-9,48
Annan Athlet,730,7,11,12,13,48,42,6,45
Berwick,730,8,8,11,17,29,58,-29,35
Edinburgh Ci,730,9,7,9,20,37,64,-27,30
Cowdenbeath,730,10,4,11,21,24,55,-31,23
Peterhead,731,1,24,4,8,79,38,41,76
Montrose,731,2,23,7,6,59,35,24,76
Stirling,731,3,17,6,13,63,51,12,57
Stenhousem'r,731,4,15,8,13,55,49,6,53
Clyde,731,5,14,10,12,52,49,3,52
Elgin,731,6,15,6,15,54,60,-6,51
Annan Athlet,731,7,11,11,14,48,43,5,44
Berwick,731,8,8,11,17,30,59,-29,35
Edinburgh Ci,731,9,7,9,20,36,62,-26,30
Cowdenbeath,731,10,5,10,21,25,55,-30,25
Peterhead,732,1,24,4,8,79,39,40,76
Montrose,732,2,23,7,6,60,37,23,76
Stirling,732,3,17,6,13,64,52,12,57
Stenhousem'r,732,4,15,8,13,56,50,6,53
Clyde,732,5,14,10,12,51,48,3,52
Elgin,732,6,15,6,15,56,61,-5,51
Annan Athlet,732,7,11,12,13,49,43,6,45
Berwick,732,8,8,11,17,29,58,-29,35
Edinburgh Ci,732,9,7,9,20,37,62,-25,30
Cowdenbeath,732,10,4,11,21,25,56,-31,23
Peterhead,733,1,24,4,8,81,38,43,76
Montrose,733,2,23,7,6,60,36,24,76
Stirling,733,3,17,6,13,62,51,11,57
Clyde,733,4,15,9,12,54,49,5,54
Stenhousem'r,733,5,15,8,13,55,48,7,53
Elgin,733,6,15,6,15,55,61,-6,51
Annan Athlet,733,7,12,11,13,48,41,7,47
Berwick,733,8,8,10,18,30,61,-31,34
Edinburgh Ci,733,9,7,9,20,36,64,-28,30
Cowdenbeath,733,10,4,10,22,23,55,-32,22
Montrose,734,1,24,7,5,61,34,27,79
Peterhead,734,2,23,4,9,78,40,38,73
Stenhousem'r,734,3,16,8,12,56,46,10,56
Stirling,734,4,16,6,14,60,52,8,54
Clyde,734,5,15,9,12,56,49,7,54
Elgin,734,6,14,6,16,53,62,-9,48
Annan Athlet,734,7,11,12,13,48,42,6,45
Berwick,734,8,8,10,18,30,63,-33,34
Edinburgh Ci,734,9,8,9,19,38,61,-23,33
Cowdenbeath,734,10,4,11,21,24,55,-31,23
Montrose,735,1,23,8,5,60,35,25,77
Peterhead,735,2,24,4,8,80,39,41,76
Stirling,735,3,17,6,13,61,51,10,57
Clyde,735,4,15,9,12,53,48,5,54
Stenhousem'r,735,5,15,8,13,55,47,8,53
Elgin,735,6,14,7,15,54,61,-7,49
Annan Athlet,735,7,11,12,13,47,41,6,45
Berwick,735,8,8,10,18,29,60,-31,34
Edinburgh Ci,735,9,7,9,20,37,63,-26,30
Cowdenbeath,735,10,4,11,21,23,54,-31,23
Peterhead,736,1,24,4,8,81,38,43,76
Montrose,736,2,23,7,6,59,35,24,76
Stirling,736,3,17,6,13,62,52,10,57
Clyde,736,4,15,9,12,54,48,6,54
Stenhousem'r,736,5,15,8,13,56,48,8,53
Elgin,736,6,15,6,15,54,60,-6,51
Annan Athlet,736,7,11,11,14,48,43,5,44
Berwick,736,8,8,10,18,29,61,-32,34
Edinburgh Ci,736,9,7,9,20,36,64,-28,30
Cowdenbeath,736,10,5,10,21,25,55,-30,25
Peterhead,737,1,24,4,8,80,38,42,76
Montrose,737,2,23,7,6,59,37,22,76
Stirling,737,3,17,6,13,62,52,10,57
Stenhousem'r,737,4,15,8,13,56,48,8,53
Clyde,737,5,14,9,13,52,50,2,51
Elgin,737,6,15,6,15,56,60,-4,51
Annan Athlet,737,7,12,11,13,49,42,7,47
Berwick,737,8,9,10,17,31,59,-28,37
Edinburgh Ci,737,9,7,9,20,36,63,-27,30
Cowdenbeath,737,10,4,10,22,24,56,-32,22
Montrose,738,1,24,7,5,63,36,27,79
Peterhead,738,2,24,4,8,80,38,42,76
Stirling,738,3,16,7,13,64,55,9,55
Stenhousem'r,738,4,15,9,12,59,50,9,54
Clyde,738,5,15,9,12,53,49,4,54
Elgin,738,6,14,6,16,55,64,-9,48
Annan Athlet,738,7,12,11,13,49,42,7,47
Berwick,738,8,8,10,18,30,60,-30,34
Edinburgh Ci,738,9,7,9,20,36,63,-27,30
Cowdenbeath,738,10,4,10,22,24,56,-32,22
Montrose,739,1,23,7,6,60,36,24,76
Peterhead,739,2,23,5,8,78,39,39,74
Stirling,739,3,17,6,13,62,52,10,57
Clyde,739,4,15,9,12,52,48,4,54
Stenhousem'r,739,5,15,8,13,56,48,8,53
Elgin,739,6,15,6,15,55,61,-6,51
Annan Athlet,739,7,11,12,13,47,41,6,45
Berwick,739,8,8,10,18,29,59,-30,34
Edinburgh Ci,739,9,7,10,19,37,61,-24,31
Cowdenbeath,739,10,4,11,21,23,54,-31,23
Montrose,740,1,23,8,5,60,35,25,77
Peterhead,740,2,24,4,8,81,38,43,76
Stirling,740,3,17,6,13,62,51,11,57
Clyde,740,4,15,9,12,54,48,6,54
Stenhousem'r,740,5,15,8,13,55,48,7,53
Elgin,740,6,14,7,15,54,61,-7,49
Annan Athlet,740,7,11,12,13,47,41,6,45
Berwick,740,8,8,10,18,29,61,-32,34
Edinburgh Ci,740,9,7,9,20,36,64,-28,30
Cowdenbeath,740,10,4,11,21,23,54,-31,23
Montrose,741,1,24,7,5,62,35,27,79
Peterhead,741,2,24,4,8,82,38,44,76
Stenhousem'r,741,3,16,8,12,58,47,11,56
Stirling,741,4,16,6,14,61,54,7,54
Clyde,741,5,14,10,12,51,48,3,52
Elgin,741,6,14,6,16,54,63,-9,48
Annan Athlet,741,7,12,11,13,49,41,8,47
Berwick,741,8,8,11,17,29,58,-29,35
Edinburgh Ci,741,9,7,9,20,36,65,-29,30
Cowdenbeath,741,10,4,10,22,23,56,-33,22
Montrose,742,1,24,7,5,61,35,26,79
Peterhead,742,2,24,4,8,83,38,45,76
Stirling,742,3,17,6,13,63,53,10,57
Stenhousem'r,742,4,15,8,13,57,49,8,53
Clyde,742,5,14,9,13,51,50,1,51
Elgin,742,6,14,6,16,54,62,-8,48
Annan Athlet,742,7,11,11,14,47,43,4,44
Berwick,742,8,9,10,17,31,58,-27,37
Edinburgh Ci,742,9,7,9,20,36,66,-30,30
Cowdenbeath,742,10,5,10,21,25,54,-29,25
Montrose,743,1,24,7,5,63,37,26,79
Peterhead,743,2,23,5,8,78,39,39,74
Stenhousem'r,743,3,16,8,12,57,47,10,56
Stirling,743,4,16,6,14,61,53,8,54
Clyde,743,5,14,9,13,51,49,2,51
Elgin,743,6,14,6,16,56,64,-8,48
Annan Athlet,743,7,11,11,14,48,43,5,44
Berwick,743,8,9,10,17,30,58,-28,37
Edinburgh Ci,743,9,7,10,19,37,61,-24,31
Cowdenbeath,743,10,5,10,21,25,55,-30,25
Montrose,744,1,23,8,5,60,35,25,77
Peterhead,744,2,24,4,8,80,39,41,76
Stirling,744,3,17,6,13,63,53,10,57
Clyde,744,4,15,9,12,53,48,5,54
Stenhousem'r,744,5,15,8,13,57,49,8,53
Elgin,744,6,14,7,15,54,61,-7,49
Annan Athlet,744,7,12,11,13,48,41,7,47
Berwick,744,8,8,10,18,29,60,-31,34
Edinburgh Ci,744,9,7,9,20,37,63,-26,30
Cowdenbeath,744,10,4,10,22,23,55,-32,22
Peterhead,745,1,24,4,8,79,38,41,76
Montrose,745,2,23,7,6,61,37,24,76
Stirling,745,3,17,6,13,62,52,10,57
Clyde,745,4,15,9,12,53,48,5,54
Stenhousem'r,745,5,15,8,13,56,48,8,53
Elgin,745,6,15,6,15,56,62,-6,51
Annan Athlet,745,7,11,12,13,48,42,6,45
Berwick,745,8,8,10,18,29,60,-31,34
Edinburgh Ci,745,9,7,9,20,36,62,-26,30
Cowdenbeath,745,10,4,11,21,24,55,-31,23
Montrose,746,1,24,7,5,62,35,27,79
Peterhead,746,2,24,4,8,78,38,40,76
Stirling,746,3,16,7,13,61,52,9,55
Stenhousem'r,746,4,15,9,12,56,47,9,54
Clyde,746,5,15,9,12,53,49,4,54
Elgin,746,6,14,6,16,54,63,-9,48
Annan Athlet,746,7,11,12,13,48,42,6,45
Berwick,746,8,8,10,18,30,60,-30,34
Edinburgh Ci,746,9,7,9,20,36,61,-25,30
Cowdenbeath,746,10,4,11,21,24,55,-31,23
Montrose,747,1,23,8,5,60,35,25,77
Peterhead,747,2,24,4,8,80,38,42,76
Stenhousem'r,747,3,16,8,12,58,48,10,56
Stirling,747,4,16,6,14,62,54,8,54
Clyde,747,5,15,9,12,53,48,5,54
Elgin,747,6,14,7,15,54,61,-7,49
Annan Athlet,747,7,12,11,13,50,43,7,47
Berwick,747,8,8,10,18,29,60,-31,34
Edinburgh Ci,747,9,7,9,20,36,63,-27,30
Cowdenbeath,747,10,4,10,22,25,57,-32,22
Montrose,748,1,23,8,5,59,34,25,77
Peterhead,748,2,23,5,8,78,39,39,74
Stirling,748,3,16,7,13,62,53,9,55
Stenhousem'r,748,4,15,9,12,57,48,9,54
Clyde,748,5,14,9,13,51,50,1,51
Elgin,748,6,14,7,15,53,60,-7,49
Annan Athlet,748,7,12,11,13,51,43,8,47
Berwick,748,8,9,10,17,31,58,-27,37
Edinburgh Ci,748,9,7,10,19,37,61,-24,31
Cowdenbeath,748,10,4,10,22,25,58,-33,22
Montrose,749,1,24,7,5,62,35,27,79
Peterhead,749,2,24,4,8,80,38,42,76
Stirling,749,3,17,6,13,64,53,11,57
Clyde,749,4,15,9,12,52,48,4,54
Stenhousem'r,749,5,15,8,13,57,50,7,53
Elgin,749,6,14,6,16,54,63,-9,48
Annan Athlet,749,7,12,11,13,49,41,8,47
Berwick,749,8,8,10,18,29,59,-30,34
Edinburgh Ci,749,9,7,9,20,36,63,-27,30
Cowdenbeath,749,10,4,10,22,23,56,-33,22
Montrose,750,1,24,7,5,61,35,26,79
Peterhead,750,2,23,5,8,78,39,39,74
Stirling,750,3,16,7,13,61,52,9,55
Stenhousem'r,750,4,15,9,12,56,47,9,54
Clyde,750,5,14,10,12,52,49,3,52
Elgin,750,6,14,6,16,54,62,-8,48
Annan Athlet,750,7,11,11,14,47,42,5,44
Berwick,750,8,8,11,17,30,59,-29,35
Edinburgh Ci,750,9,7,10,19,37,61,-24,31
Cowdenbeath,750,10,5,10,21,24,54,-30,25
Montrose,751,1,24,7,5,62,35,27,79
Peterhead,751,2,23,5,8,78,39,39,74
Stirling,751,3,16,7,13,62,53,9,55
Stenhousem'r,751,4,15,9,12,57,48,9,54
Clyde,751,5,15,9,12,53,49,4,54
Elgin,751,6,14,6,16,54,63,-9,48
Annan Athlet,751,7,11,12,13,48,42,6,45
Berwick,751,8,8,10,18,30,60,-30,34
Edinburgh Ci,751,9,7,10,19,37,61,-24,31
Cowdenbeath,751,10,4,11,21,24,55,-31,23
Montrose,752,1,24,7,5,62,34,28,79
Peterhead,752,2,23,5,8,78,39,39,74
Stirling,752,3,17,6,13,63,52,11,57
Clyde,752,4,15,9,12,55,48,7,54
Stenhousem'r,752,5,15,8,13,56,49,7,53
Elgin,752,6,14,6,16,53,63,-10,48
Annan Athlet,752,7,12,11,13,48,41,7,47
Berwick,752,8,8,10,18,29,62,-33,34
Edinburgh Ci,752,9,7,10,19,37,61,-24,31
Cowdenbeath,752,10,4,10,22,23,55,-32,22
Montrose,753,1,24,7,5,64,36,28,79
Peterhead,753,2,24,4,8,79,38,41,76
Stenhousem'r,753,3,16,8,12,57,47,10,56
Stirling,753,4,16,6,14,61,53,8,54
Clyde,753,5,15,9,12,55,49,6,54
Elgin,753,6,14,6,16,55,65,-10,48
Annan Athlet,753,7,11,11,14,48,43,5,44
Berwick,753,8,8,10,18,30,62,-32,34
Edinburgh Ci,753,9,7,9,20,36,62,-26,30
Cowdenbeath,753,10,5,10,21,25,55,-30,25
Montrose,754,1,24,7,5,62,35,27,79
Peterhead,754,2,24,4,8,79,38,41,76
Stenhousem'r,754,3,16,8,12,57,47,10,56
Stirling,754,4,16,6,14,61,53,8,54
Clyde,754,5,15,9,12,55,49,6,54
Elgin,754,6,14,6,16,54,63,-9,48
Annan Athlet,754,7,11,11,14,47,43,4,44
Berwick,754,8,8,10,18,30,62,-32,34
Edinburgh Ci,754,9,7,9,20,36,62,-26,30
Cowdenbeath,754,10,5,10,21,25,54,-29,25
Peterhead,755,1,24,4,8,80,39,41,76
Montrose,755,2,23,7,6,60,36,24,76
Stenhousem'r,755,3,16,8,12,56,46,10,56
Stirling,755,4,16,6,14,60,52,8,54
Clyde,755,5,15,9,12,52,48,4,54
Elgin,755,6,15,6,15,55,61,-6,51
Annan Athlet,755,7,11,11,14,47,42,5,44
Berwick,755,8,8,10,18,29,59,-30,34
Edinburgh Ci,755,9,7,9,20,37,63,-26,30
Cowdenbeath,755,10,5,10,21,24,54,-30,25
Montrose,756,1,23,8,5,59,34,25,77
Peterhead,756,2,24,4,8,82,39,43,76
Stirling,756,3,17,6,13,62,51,11,57
Stenhousem'r,756,4,15,8,13,55,48,7,53
Clyde,756,5,14,10,12,51,48,3,52
Elgin,756,6,14,7,15,53,60,-7,49
Annan Athlet,756,7,11,12,13,47,41,6,45
Berwick,756,8,8,11,17,29,58,-29,35
Edinburgh Ci,756,9,7,9,20,37,65,-28,30
Cowdenbeath,756,10,4,11,21,23,54,-31,23
Montrose,757,1,23,8,5,60,35,25,77
Peterhead,757,2,24,4,8,80,39,41,76
Stirling,757,3,17,6,13,62,51,11,57
Clyde,757,4,15,9,12,54,49,5,54
Stenhousem'r,757,5,15,8,13,55,48,7,53
Elgin,757,6,14,7,15,54,61,-7,49
Annan Athlet,757,7,12,11,13,49,42,7,47
Berwick,757,8,8,10,18,30,61,-31,34
Edinburgh Ci,757,9,7,9,20,37,63,-26,30
Cowdenbeath,757,10,4,10,22,24,56,-32,22
Peterhead,758,1,24,4,8,81,39,42,76
Montrose,758,2,23,7,6,60,36,24,76
Stirling,758,3,17,6,13,63,51,12,57
Clyde,758,4,15,9,12,53,49,4,54
Stenhousem'r,758,5,15,8,13,55,49,6,53
Elgin,758,6,15,6,15,55,61,-6,51
Annan Athlet,758,7,11,11,14,47,42,5,44
Berwick,758,8,8,10,18,30,60,-30,34
Edinburgh Ci,758,9,7,9,20,37,64,-27,30
Cowdenbeath,758,10,5,10,21,24,54,-30,25
Montrose,759,1,24,7,5,64,34,30,79
Peterhead,759,2,23,5,8,79,40,39,74
Stenhousem'r,759,3,16,8,12,58,47,11,56
Stirling,759,4,16,6,14,61,54,7,54
Clyde,759,5,15,9,12,54,50,4,54
Elgin,759,6,14,6,16,53,65,-12,48
Annan Athlet,759,7,11,11,14,47,44,3,44
Berwick,759,8,8,10,18,31,61,-30,34
Edinburgh Ci,759,9,7,10,19,38,62,-24,31
Cowdenbeath,759,10,5,10,21,26,54,-28,25
Peterhead,760,1,24,4,8,82,39,43,76
Montrose,760,2,23,7,6,61,38,23,76
Stenhousem'r,760,3,16,8,12,57,47,10,56
Stirling,760,4,16,6,14,61,53,8,54
Clyde,760,5,15,9,12,53,48,5,54
Elgin,760,6,15,6,15,57,62,-5,51
Annan Athlet,760,7,11,11,14,48,43,5,44
Berwick,760,8,8,10,18,29,60,-31,34
Edinburgh Ci,760,9,7,9,20,37,65,-28,30
Cowdenbeath,760,10,5,10,21,25,55,-30,25
Montrose,761,1,24,7,5,60,34,26,79
Peterhead,761,2,24,4,8,79,38,41,76
Stirling,761,3,17,6,13,63,51,12,57
Stenhousem'r,761,4,15,8,13,55,49,6,53
Clyde,761,5,14,9,13,52,50,2,51
Elgin,761,6,14,6,16,53,61,-8,48
Annan Athlet,761,7,12,11,13,49,42,7,47
Berwick,761,8,9,10,17,31,59,-28,37
Edinburgh Ci,761,9,7,9,20,36,62,-26,30
Cowdenbeath,761,10,4,10,22,24,56,-32,22
Montrose,762,1,24,7,5,64,34,30,79
Peterhead,762,2,24,4,8,81,39,42,76
Stirling,762,3,16,7,13,61,52,9,55
Stenhousem'r,762,4,15,9,12,56,47,9,54
Clyde,762,5,14,10,12,53,50,3,52
Elgin,762,6,14,6,16,53,65,-12,48
Annan Athlet,762,7,12,11,13,49,42,7,47
Berwick,762,8,8,11,17,31,60,-29,35
Edinburgh Ci,762,9,7,9,20,37,64,-27,30
Cowdenbeath,762,10,4,10,22,24,56,-32,22
Montrose,763,1,23,8,5,61,36,25,77
Peterhead,763,2,24,4,8,79,38,41,76
Stirling,763,3,17,6,13,64,52,12,57
Stenhousem'r,763,4,15,8,13,56,50,6,53
Clyde,763,5,14,9,13,53,51,2,51
Elgin,763,6,14,7,15,55,62,-7,49
Annan Athlet,763,7,11,12,13,48,42,6,45
Berwick,763,8,9,10,17,32,60,-28,37
Edinburgh Ci,763,9,7,9,20,36,62,-26,30
Cowdenbeath,763,10,4,11,21,24,55,-31,23
Montrose,764,1,24,7,5,63,34,29,79
Peterhead,764,2,24,4,8,81,39,42,76
Stirling,764,3,17,6,13,61,51,10,57
Stenhousem'r,764,4,15,8,13,55,47,8,53
Clyde,764,5,14,10,12,53,50,3,52
Elgin,764,6,14,6,16,53,64,-11,48
Annan Athlet,764,7,12,11,13,48,41,7,47
Berwick,764,8,8,11,17,31,60,-29,35
Edinburgh Ci,764,9,7,9,20,37,64,-27,30
Cowdenbeath,764,10,4,10,22,23,55,-32,22
Montrose,765,1,24,7,5,62,35,27,79
Peterhead,765,2,24,4,8,79,38,41,76
Stirling,765,3,17,6,13,61,51,10,57
Clyde,765,4,15,9,12,54,50,4,54
Stenhousem'r,765,5,15,8,13,55,47,8,53
Elgin,765,6,14,6,16,54,63,-9,48
Annan Athlet,765,7,11,12,13,47,41,6,45
Berwick,765,8,8,10,18,31,61,-30,34
Edinburgh Ci,765,9,7,9,20,36,62,-26,30
Cowdenbeath,765,10,4,11,21,23,54,-31,23
Montrose,766,1,24,7,5,61,35,26,79
Peterhead,766,2,24,4,8,79,38,41,76
Stirling,766,3,17,6,13,62,52,10,57
Clyde,766,4,15,9,12,56,50,6,54
Stenhousem'r,766,5,15,8,13,56,48,8,53
Elgin,766,6,14,6,16,54,62,-8,48
Annan Athlet,766,7,11,11,14,48,43,5,44
Berwick,766,8,8,10,18,31,63,-32,34
Edinburgh Ci,766,9,7,9,20,36,62,-26,30
Cowdenbeath,766,10,5,10,21,25,55,-30,25
Montrose,767,1,24,7,5,60,34,26,79
Peterhead,767,2,24,4,8,79,38,41,76
Stirling,767,3,17,6,13,63,52,11,57
Clyde,767,4,15,9,12,54,48,6,54
Stenhousem'r,767,5,15,8,13,56,49,7,53
Elgin,767,6,14,6,16,53,61,-8,48
Annan Athlet,767,7,12,11,13,49,41,8,47
Berwick,767,8,8,10,18,29,61,-32,34
Edinburgh Ci,767,9,7,9,20,36,62,-26,30
Cowdenbeath,767,10,4,10,22,23,56,-33,22
Peterhead,768,1,24,4,8,81,38,43,76
Montrose,768,2,23,7,6,59,37,22,76
Stirling,768,3,17,6,13,62,51,11,57
Clyde,768,4,15,9,12,53,48,5,54
Stenhousem'r,768,5,15,8,13,55,48,7,53
Elgin,768,6,15,6,15,56,60,-4,51
Annan Athlet,768,7,11,12,13,48,42,6,45
Berwick,768,8,8,10,18,29,60,-31,34
Edinburgh Ci,768,9,7,9,20,36,64,-28,30
Cowdenbeath,768,10,4,11,21,24,55,-31,23
Montrose,769,1,24,7,5,62,36,26,79
Peterhead,769,2,23,5,8,80,41,39,74
Stirling,769,3,16,7,13,62,53,9,55
Stenhousem'r,769,4,15,9,12,57,48,9,54
Clyde,769,5,15,9,12,52,48,4,54
Elgin,769,6,14,6,16,55,63,-8,48
Annan Athlet,769,7,12,11,13,48,41,7,47
Berwick,769,8,8,10,18,29,59,-30,34
Edinburgh Ci,769,9,7,10,19,39,63,-24,31
Cowdenbeath,769,10,4,10,22,23,55,-32,22
Montrose,770,1,24,7,5,61,35,26,79
Peterhead,770,2,24,4,8,82,38,44,76
Stirling,770,3,16,7,13,61,52,9,55
Stenhousem'r,770,4,15,9,12,56,47,9,54
Clyde,770,5,14,9,13,51,49,2,51
Elgin,770,6,14,6,16,54,62,-8,48
Annan Athlet,770,7,12,11,13,48,41,7,47
Berwick,770,8,9,10,17,30,58,-28,37
Edinburgh Ci,770,9,7,9,20,36,65,-29,30
Cowdenbeath,770,10,4,10,22,23,55,-32,22
Montrose,771,1,24,7,5,60,34,26,79
Peterhead,771,2,24,4,8,81,39,42,76
Stenhousem'r,771,3,16,8,12,58,48,10,56
Stirling,771,4,16,6,14,62,54,8,54
Clyde,771,5,14,10,12,54,51,3,52
Elgin,771,6,14,6,16,53,61,-8,48
Annan Athlet,771,7,12,11,13,48,41,7,47
Berwick,771,8,8,11,17,32,61,-29,35
Edinburgh Ci,771,9,7,9,20,37,64,-27,30
Cowdenbeath,771,10,4,10,22,23,55,-32,22
Montrose,772,1,24,7,5,60,34,26,79
Peterhead,772,2,24,4,8,81,39,42,76
Stirling,772,3,16,7,13,61,52,9,55
Stenhousem'r,772,4,15,9,12,56,47,9,54
Clyde,772,5,15,9,12,52,48,4,54
Elgin,772,6,14,6,16,53,61,-8,48
Annan Athlet,772,7,12,11,13,51,42,9,47
Berwick,772,8,8,10,18,29,59,-30,34
Edinburgh Ci,772,9,7,9,20,37,64,-27,30
Cowdenbeath,772,10,4,10,22,24,58,-34,22
Montrose,773,1,24,7,5,62,35,27,79
Peterhead,773,2,23,4,9,80,42,38,73
Stirling,773,3,17,6,13,65,53,12,57
Stenhousem'r,773,4,15,8,13,57,51,6,53
Clyde,773,5,14,10,12,53,50,3,52
Elgin,773,6,14,6,16,54,63,-9,48
Annan Athlet,773,7,11,12,13,47,41,6,45
Berwick,773,8,8,11,17,31,60,-29,35
Edinburgh Ci,773,9,8,9,19,40,63,-23,33
Cowdenbeath,773,10,4,11,21,23,54,-31,23
Montrose,774,1,24,7,5,61,35,26,79
Peterhead,774,2,24,4,8,79,39,40,76
Stirling,774,3,16,7,13,63,54,9,55
Stenhousem'r,774,4,15,9,12,58,49,9,54
Clyde,774,5,15,9,12,52,48,4,54
Elgin,774,6,14,6,16,54,62,-8,48
Annan Athlet,774,7,11,12,13,48,42,6,45
Berwick,774,8,8,10,18,29,59,-30,34
Edinburgh Ci,774,9,7,9,20,37,62,-25,30
Cowdenbeath,774,10,4,11,21,24,55,-31,23
Montrose,775,1,24,7,5,62,36,26,79
Peterhead,775,2,23,5,8,78,39,39,74
Stirling,775,3,16,7,13,61,52,9,55
Stenhousem'r,775,4,15,9,12,56,47,9,54
Clyde,775,5,14,10,12,52,49,3,52
Elgin,775,6,14,6,16,55,63,-8,48
Annan Athlet,775,7,11,12,13,48,42,6,45
Berwick,775,8,8,11,17,30,59,-29,35
Edinburgh Ci,775,9,7,10,19,37,61,-24,31
Cowdenbeath,775,10,4,11,21,24,55,-31,23
Montrose,776,1,24,7,5,66,34,32,79
Peterhead,776,2,24,4,8,78,38,40,76
Stirling,776,3,16,7,13,61,52,9,55
Stenhousem'r,776,4,15,9,12,56,47,9,54
Clyde,776,5,15,9,12,54,49,5,54
Elgin,776,6,14,6,16,53,67,-14,48
Annan Athlet,776,7,11,11,14,47,42,5,44
Berwick,776,8,8,10,18,30,61,-31,34
Edinburgh Ci,776,9,7,9,20,36,61,-25,30
Cowdenbeath,776,10,5,10,21,24,54,-30,25
Montrose,777,1,24,7,5,61,34,27,79
Peterhead,777,2,24,4,8,79,39,40,76
Stirling,777,3,17,6,13,62,52,10,57
Clyde,777,4,15,9,12,53,48,5,54
Stenhousem'r,777,5,15,8,13,56,48,8,53
Elgin,777,6,14,6,16,53,62,-9,48
Annan Athlet,777,7,11,12,13,49,43,6,45
Berwick,777,8,8,10,18,29,60,-31,34
Edinburgh Ci,777,9,7,9,20,37,62,-25,30
Cowdenbeath,777,10,4,11,21,25,56,-31,23
Montrose,778,1,23,8,5,60,35,25,77
Peterhead,778,2,24,4,8,82,39,43,76
Stirling,778,3,17,6,13,63,53,10,57
Clyde,778,4,15,9,12,54,48,6,54
Stenhousem'r,778,5,15,8,13,57,49,8,53
Elgin,778,6,14,7,15,54,61,-7,49
Annan Athlet,778,7,11,12,13,47,41,6,45
Berwick,778,8,8,10,18,29,61,-32,34
Edinburgh Ci,778,9,7,9,20,37,65,-28,30
Cowdenbeath,778,10,4,11,21,23,54,-31,23
Peterhead,779,1,24,4,8,80,38,42,76
Montrose,779,2,23,7,6,59,38,21,76
Stirling,779,3,17,6,13,62,51,11,57
Stenhousem'r,779,4,15,8,13,55,48,7,53
Clyde,779,5,14,10,12,52,49,3,52
Elgin,779,6,15,6,15,57,60,-3,51
Annan Athlet,779,7,12,11,13,48,41,7,47
Berwick,779,8,8,11,17,30,59,-29,35
Edinburgh Ci,779,9,7,9,20,36,63,-27,30
Cowdenbeath,779,10,4,10,22,23,55,-32,22
Montrose,780,1,24,7,5,65,35,30,79
Peterhead,780,2,23,4,9,77,40,37,73
Stenhousem'r,780,3,16,8,12,57,46,11,56
Stirling,780,4,16,6,14,60,53,7,54
Clyde,780,5,15,9,12,52,48,4,54
Elgin,780,6,14,6,16,54,66,-12,48
Annan Athlet,780,7,11,11,14,49,44,5,44
Berwick,780,8,8,10,18,29,59,-30,34
Edinburgh Ci,780,9,8,9,19,38,60,-22,33
Cowdenbeath,780,10,5,10,21,26,56,-30,25
Peterhead,781,1,24,4,8,80,40,40,76
Montrose,781,2,23,7,6,60,36,24,76
Stenhousem'r,781,3,16,8,12,58,46,12,56
Stirling,781,4,16,6,14,60,54,6,54
Clyde,781,5,15,9,12,54,48,6,54
Elgin,781,6,15,6,15,55,61,-6,51
Annan Athlet,781,7,12,11,13,48,41,7,47
Berwick,781,8,8,10,18,29,61,-32,34
Edinburgh Ci,781,9,7,9,20,38,63,-25,30
Cowdenbeath,781,10,4,10,22,23,55,-32,22
Montrose,782,1,24,7,5,62,35,27,79
Peterhead,782,2,23,5,8,77,38,39,74
Stirling,782,3,17,6,13,64,53,11,57
Stenhousem'r,782,4,15,8,13,57,50,7,53
Clyde,782,5,14,9,13,53,51,2,51
Elgin,782,6,14,6,16,54,63,-9,48
Annan Athlet,782,7,11,12,13,49,43,6,45
Berwick,782,8,9,10,17,32,60,-28,37
Edinburgh Ci,782,9,7,10,19,36,60,-24,31
Cowdenbeath,782,10,4,11,21,25,56,-31,23
Montrose,783,1,23,7,6,59,35,24,76
Peterhead,783,2,23,5,8,80,41,39,74
Stirling,783,3,16,7,13,62,53,9,55
Stenhousem'r,783,4,15,9,12,57,48,9,54
Clyde,783,5,15,9,12,55,49,6,54
Elgin,783,6,15,6,15,54,60,-6,51
Annan Athlet,783,7,11,11,14,47,43,4,44
Berwick,783,8,8,10,18,30,62,-32,34
Edinburgh Ci,783,9,7,10,19,39,63,-24,31
Cowdenbeath,783,10,5,10,21,25,54,-29,25
Montrose,784,1,24,7,5,61,34,27,79
Peterhead,784,2,24,4,8,81,38,43,76
Stirling,784,3,17,6,13,63,52,11,57
Clyde,784,4,15,9,12,53,49,4,54
Stenhousem'r,784,5,15,8,13,56,49,7,53
Elgin,784,6,14,6,16,53,62,-9,48
Annan Athlet,784,7,11,12,13,47,41,6,45
Berwick,784,8,8,10,18,30,60,-30,34
Edinburgh Ci,784,9,7,9,20,36,64,-28,30
Cowdenbeath,784,10,4,11,21,23,54,-31,23
Montrose,785,1,24,7,5,62,36,26,79
Peterhead,785,2,24,4,8,79,39,40,76
Stirling,785,3,17,6,13,63,52,11,57
Stenhousem'r,785,4,15,8,13,56,49,7,53
Clyde,785,5,14,9,13,52,50,2,51
Elgin,785,6,14,6,16,55,63,-8,48
Annan Athlet,785,7,11,12,13,47,41,6,45
Berwick,785,8,9,10,17,31,59,-28,37
Edinburgh Ci,785,9,7,9,20,37,62,-25,30
Cowdenbeath,785,10,4,11,21,23,54,-31,23
Montrose,786,1,23,8,5,60,35,25,77
Peterhead,786,2,24,4,8,78,38,40,76
Stirling,786,3,17,6,13,62,51,11,57
Stenhousem'r,786,4,15,8,13,55,48,7,53
Clyde,786,5,14,10,12,53,50,3,52
Elgin,786,6,14,7,15,54,61,-7,49
Annan Athlet,786,7,11,12,13,48,42,6,45
Berwick,786,8,8,11,17,31,60,-29,35
Edinburgh Ci,786,9,7,9,20,36,61,-25,30
Cowdenbeath,786,10,4,11,21,24,55,-31,23
Montrose,787,1,23,8,5,60,35,25,77
Peterhead,787,2,23,4,9,80,42,38,73
Stirling,787,3,17,6,13,64,53,11,57
Clyde,787,4,15,9,12,53,48,5,54
Stenhousem'r,787,5,15,8,13,57,50,7,53
Elgin,787,6,14,7,15,54,61,-7,49
Annan Athlet,787,7,11,11,14,47,42,5,44
Berwick,787,8,8,10,18,29,60,-31,34
Edinburgh Ci,787,9,8,9,19,40,63,-23,33
Cowdenbeath,787,10,5,10,21,24,54,-30,25
Montrose,788,1,24,7,5,61,34,27,79
Peterhead,788,2,24,4,8,79,39,40,76
Stirling,788,3,17,6,13,62,51,11,57
Clyde,788,4,15,9,12,53,48,5,54
Stenhousem'r,788,5,15,8,13,55,48,7,53
Elgin,788,6,14,6,16,53,62,-9,48
Annan Athlet,788,7,11,11,14,48,43,5,44
Berwick,788,8,8,10,18,29,60,-31,34
Edinburgh Ci,788,9,7,9,20,37,62,-25,30
Cowdenbeath,788,10,5,10,21,25,55,-30,25
Montrose,789,1,24,7,5,62,34,28,79
Peterhead,789,2,24,4,8,80,38,42,76
Stirling,789,3,17,6,13,63,51,12,57
Stenhousem'r,789,4,15,8,13,55,49,6,53
Clyde,789,5,14,9,13,52,50,2,51
Elgin,789,6,14,6,16,53,63,-10,48
Annan Athlet,789,7,11,11,14,47,42,5,44
Berwick,789,8,9,10,17,31,59,-28,37
Edinburgh Ci,789,9,7,9,20,36,63,-27,30
Cowdenbeath,789,10,5,10,21,24,54,-30,25
Montrose,790,1,24,7,5,60,34,26,79
Peterhead,790,2,24,4,8,83,40,43,76
Stenhousem'r,790,3,16,8,12,57,46,11,56
Stirling,790,4,16,6,14,60,53,7,54
Clyde,790,5,15,9,12,54,48,6,54
Elgin,790,6,14,6,16,53,61,-8,48
Annan Athlet,790,7,11,11,14,47,42,5,44
Berwick,790,8,8,10,18,29,61,-32,34
Edinburgh Ci,790,9,7,9,20,38,66,-28,30
Cowdenbeath,790,10,5,10,21,24,54,-30,25
Montrose,791,1,24,7,5,62,35,27,79
Peterhead,791,2,24,4,8,79,38,41,76
Stirling,791,3,16,7,13,60,51,9,55
Stenhousem'r,791,4,15,9,12,55,46,9,54
Clyde,791,5,14,9,13,53,51,2,51
Elgin,791,6,14,6,16,54,63,-9,48
Annan Athlet,791,7,12,11,13,49,41,8,47
Berwick,791,8,9,10,17,32,60,-28,37
Edinburgh Ci,791,9,7,9,20,36,62,-26,30
Cowdenbeath,791,10,4,10,22,23,56,-33,22
Montrose,792,1,24,7,5,61,34,27,79
Peterhead,792,2,23,5,8,78,39,39,74
Stirling,792,3,17,6,13,61,51,10,57
Stenhousem'r,792,4,15,8,13,55,47,8,53
Clyde,792,5,14,10,12,51,48,3,52
Elgin,792,6,14,6,16,53,62,-9,48
Annan Athlet,792,7,11,12,13,50,44,6,45
Berwick,792,8,8,11,17,29,58,-29,35
Edinburgh Ci,792,9,7,10,19,37,61,-24,31
Cowdenbeath,792,10,4,11,21,26,57,-31,23
Montrose,793,1,24,7,5,63,34,29,79
Peterhead,793,2,24,4,8,80,39,41,76
Stirling,793,3,16,7,13,61,52,9,55
Stenhousem'r,793,4,15,9,12,56,47,9,54
Clyde,793,5,14,10,12,52,49,3,52
Elgin,793,6,14,6,16,53,64,-11,48
Annan Athlet,793,7,12,11,13,50,41,9,47
Berwick,793,8,8,11,17,30,59,-29,35
Edinburgh Ci,793,9,7,9,20,37,63,-26,30
Cowdenbeath,793,10,4,10,22,23,57,-34,22
Peterhead,794,1,24,4,8,80,39,41,76
Montrose,794,2,23,7,6,59,35,24,76
Stirling,794,3,17,6,13,63,53,10,57
Clyde,794,4,15,9,12,53,48,5,54
Stenhousem'r,794,5,15,8,13,57,49,8,53
Elgin,794,6,15,6,15,54,60,-6,51
Annan Athlet,794,7,11,11,14,47,42,5,44
Berwick,794,8,8,10,18,29,60,-31,34
Edinburgh Ci,794,9,7,9,20,37,63,-26,30
Cowdenbeath,794,10,5,10,21,24,54,-30,25
Montrose,795,1,24,7,5,63,34,29,79
Peterhead,795,2,24,4,8,78,38,40,76
Stenhousem'r,795,3,16,8,12,58,48,10,56
Stirling,795,4,16,6,14,62,54,8,54
Clyde,795,5,15,9,12,53,48,5,54
Elgin,795,6,14,6,16,53,64,-11,48
Annan Athlet,795,7,11,11,14,47,42,5,44
Berwick,795,8,8,10,18,29,60,-31,34
Edinburgh Ci,795,9,7,9,20,36,61,-25,30
Cowdenbeath,795,10,5,10,21,24,54,-30,25
Montrose,796,1,24,7,5,61,35,26,79
Peterhead,796,2,24,4,8,81,40,41,76
Stirling,796,3,17,6,13,63,53,10,57
Clyde,796,4,15,9,12,52,48,4,54
Stenhousem'r,796,5,15,8,13,57,49,8,53
Elgin,796,6,14,6,16,54,62,-8,48
Annan Athlet,796,7,11,11,14,47,42,5,44
Berwick,796,8,8,10,18,29,59,-30,34
Edinburgh Ci,796,9,7,9,20,38,64,-26,30
Cowdenbeath,796,10,5,10,21,24,54,-30,25
Montrose,797,1,24,7,5,61,34,27,79
Peterhead,797,2,24,4,8,82,39,43,76
Stirling,797,3,16,7,13,61,52,9,55
Stenhousem'r,797,4,15,9,12,56,47,9,54
Clyde,797,5,15,9,12,54,48,6,54
Elgin,797,6,14,6,16,53,62,-9,48
Annan Athlet,797,7,11,11,14,47,42,5,44
Berwick,797,8,8,10,18,29,61,-32,34
Edinburgh Ci,797,9,7,9,20,37,65,-28,30
Cowdenbeath,797,10,5,10,21,24,54,-30,25
Montrose,798,1,24,7,5,61,34,27,79
Peterhead,798,2,24,4,8,78,38,40,76
Stirling,798,3,17,6,13,62,52,10,57
Clyde,798,4,15,9,12,53,48,5,54
Stenhousem'r,798,5,15,8,13,56,48,8,53
Elgin,798,6,14,6,16,53,62,-9,48
Annan Athlet,798,7,11,12,13,48,42,6,45
Berwick,798,8,8,10,18,29,60,-31,34
Edinburgh Ci,798,9,7,9,20,36,61,-25,30
Cowdenbeath,798,10,4,11,21,24,55,-31,23
Montrose,799,1,24,7,5,61,35,26,79
Peterhead,799,2,24,4,8,81,41,40,76
Stirling,799,3,17,6,13,63,53,10,57
Clyde,799,4,15,9,12,52,48,4,54
Stenhousem'r,799,5,15,8,13,57,49,8,53
Elgin,799,6,14,6,16,54,62,-8,48
Annan Athlet,799,7,12,11,13,48,41,7,47
Berwick,799,8,8,10,18,29,59,-30,34
Edinburgh Ci,799,9,7,9,20,39,64,-25,30
Cowdenbeath,799,10,4,10,22,23,55,-32,22
Montrose,800,1,23,8,5,60,35,25,77
Peterhead,800,2,24,4,8,79,38,41,76
Stirling,800,3,17,6,13,63,51,12,57
Clyde,800,4,15,9,12,53,48,5,54
Stenhousem'r,800,5,15,8,13,55,49,6,53
Elgin,800,6,14,7,15,54,61,-7,49
Annan Athlet,800,7,12,11,13,49,42,7,47
Berwick,800,8,8,10,18,29,60,-31,34
Edinburgh Ci,800,9,7,9,20,36,62,-26,30
Cowdenbeath,800,10,4,10,22,24,56,-32,22
Peterhead,801,1,24,4,8,78,38,40,76
Montrose,801,2,23,7,6,60,36,24,76
Stirling,801,3,17,6,13,65,52,13,57
Stenhousem'r,801,4,15,8,13,56,51,5,53
Clyde,801,5,14,9,13,53,51,2,51
Elgin,801,6,15,6,15,55,61,-6,51
Annan Athlet,801,7,11,12,13,48,42,6,45
Berwick,801,8,9,10,17,32,60,-28,37
Edinburgh Ci,801,9,7,9,20,36,61,-25,30
Cowdenbeath,801,10,4,11,21,24,55,-31,23
Montrose,802,1,24,7,5,63,34,29,79
Peterhead,802,2,24,4,8,80,38,42,76
Stenhousem'r,802,3,16,8,12,58,47,11,56
Stirling,802,4,16,6,14,61,54,7,54
Clyde,802,5,14,10,12,53,50,3,52
Elgin,802,6,14,6,16,53,64,-11,48
Annan Athlet,802,7,11,12,13,48,42,6,45
Berwick,802,8,8,11,17,31,60,-29,35
Edinburgh Ci,802,9,7,9,20,36,63,-27,30
Cowdenbeath,802,10,4,11,21,24,55,-31,23
Montrose,803,1,24,7,5,60,34,26,79
Peterhead,803,2,23,5,8,77,38,39,74
Stenhousem'r,803,3,16,8,12,56,46,10,56
Stirling,803,4,16,6,14,60,52,8,54
Clyde,803,5,15,9,12,54,48,6,54
Elgin,803,6,14,6,16,53,61,-8,48
Annan Athlet,803,7,12,11,13,48,41,7,47
Berwick,803,8,8,10,18,29,61,-32,34
Edinburgh Ci,803,9,7,10,19,36,60,-24,31
Cowdenbeath,803,10,4,10,22,23,55,-32,22
Montrose,804,1,24,7,5,60,34,26,79
Peterhead,804,2,24,4,8,80,38,42,76
Stirling,804,3,16,7,13,61,52,9,55
Stenhousem'r,804,4,15,9,12,56,47,9,54
Clyde,804,5,15,9,12,53,49,4,54
Elgin,804,6,14,6,16,53,61,-8,48
Annan Athlet,804,7,12,11,13,49,41,8,47
Berwick,804,8,8,10,18,30,60,-30,34
Edinburgh Ci,804,9,7,9,20,36,63,-27,30
Cowdenbeath,804,10,4,10,22,23,56,-33,22
Montrose,805,1,23,8,5,60,35,25,77
Peterhead,805,2,23,4,9,77,39,38,73
Stirling,805,3,17,6,13,61,51,10,57
Stenhousem'r,805,4,15,8,13,55,47,8,53
Clyde,805,5,14,10,12,53,50,3,52
Elgin,805,6,14,7,15,54,61,-7,49
Annan Athlet,805,7,12,11,13,49,42,7,47
Berwick,805,8,8,11,17,31,60,-29,35
Edinburgh Ci,805,9,8,9,19,37,60,-23,33
Cowdenbeath,805,10,4,10,22,24,56,-32,22
Montrose,806,1,24,7,5,61,34,27,79
Peterhead,806,2,24,4,8,83,40,43,76
Stirling,806,3,17,6,13,62,51,11,57
Stenhousem'r,806,4,15,8,13,55,48,7,53
Clyde,806,5,14,10,12,52,49,3,52
Elgin,806,6,14,6,16,53,62,-9,48
Annan Athlet,806,7,12,11,13,49,42,7,47
Berwick,806,8,8,11,17,30,59,-29,35
Edinburgh Ci,806,9,7,9,20,38,66,-28,30
Cowdenbeath,806,10,4,10,22,24,56,-32,22
Montrose,807,1,24,7,5,62,35,27,79
Peterhead,807,2,24,4,8,82,40,42,76
Stirling,807,3,16,7,13,61,52,9,55
Stenhousem'r,807,4,15,9,12,56,47,9,54
Clyde,807,5,14,10,12,56,53,3,52
Elgin,807,6,14,6,16,54,63,-9,48
Annan Athlet,807,7,11,11,14,48,43,5,44
Berwick,807,8,8,11,17,34,63,-29,35
Edinburgh Ci,807,9,7,9,20,38,65,-27,30
Cowdenbeath,807,10,5,10,21,25,55,-30,25
Montrose,808,1,24,7,5,61,35,26,79
Peterhead,808,2,23,5,8,79,40,39,74
Stirling,808,3,16,7,13,60,51,9,55
Stenhousem'r,808,4,15,9,12,55,46,9,54
Clyde,808,5,14,10,12,54,51,3,52
Elgin,808,6,14,6,16,54,62,-8,48
Annan Athlet,808,7,11,12,13,47,41,6,45
Berwick,808,8,8,11,17,32,61,-29,35
Edinburgh Ci,808,9,7,10,19,38,62,-24,31
Cowdenbeath,808,10,4,11,21,23,54,-31,23
Peterhead,809,1,24,4,8,81,39,42,76
Montrose,809,2,23,7,6,59,37,22,76
Stirling,809,3,16,7,13,61,52,9,55
Stenhousem'r,809,4,15,9,12,56,47,9,54
Clyde,809,5,15,9,12,52,48,4,54
Elgin,809,6,15,6,15,56,60,-4,51
Annan Athlet,809,7,11,11,14,49,45,4,44
Berwick,809,8,8,10,18,29,59,-30,34
Edinburgh Ci,809,9,7,9,20,37,64,-27,30
Cowdenbeath,809,10,5,10,21,27,56,-29,25
Peterhead,810,1,24,4,8,79,39,40,76
Montrose,810,2,23,7,6,59,36,23,76
Stirling,810,3,17,6,13,61,51,10,57
Clyde,810,4,15,9,12,52,48,4,54
Stenhousem'r,810,5,15,8,13,55,47,8,53
Elgin,810,6,15,6,15,55,60,-5,51
Annan Athlet,810,7,12,11,13,48,41,7,47
Berwick,810,8,8,10,18,29,59,-30,34
Edinburgh Ci,810,9,7,9,20,37,62,-25,30
Cowdenbeath,810,10,4,10,22,23,55,-32,22
Montrose,811,1,24,7,5,61,35,26,79
Peterhead,811,2,24,4,8,84,40,44,76
Stirling,811,3,16,7,13,63,54,9,55
Stenhousem'r,811,4,15,9,12,58,49,9,54
Clyde,811,5,15,9,12,54,49,5,54
Elgin,811,6,14,6,16,54,62,-8,48
Annan Athlet,811,7,11,11,14,47,42,5,44
Berwick,811,8,8,10,18,30,61,-31,34
Edinburgh Ci,811,9,7,9,20,38,67,-29,30
Cowdenbeath,811,10,5,10,21,24,54,-30,25
Montrose,812,1,23,8,5,60,35,25,77
Peterhead,812,2,24,4,8,80,39,41,76
Stirling,812,3,16,7,13,61,52,9,55
Stenhousem'r,812,4,15,9,12,56,47,9,54
Clyde,812,5,14,10,12,52,49,3,52
Elgin,812,6,14,7,15,54,61,-7,49
Annan Athlet,812,7,11,12,13,49,43,6,45
Berwick,812,8,8,11,17,30,59,-29,35
Edinburgh Ci,812,9,7,9,20,37,63,-26,30
Cowdenbeath,812,10,4,11,21,25,56,-31,23
Montrose,813,1,23,8,5,60,35,25,77
Peterhead,813,2,24,4,8,80,38,42,76
Stirling,813,3,17,6,13,62,51,11,57
Stenhousem'r,813,4,15,8,13,55,48,7,53
Clyde,813,5,14,9,13,52,50,2,51
Elgin,813,6,14,7,15,54,61,-7,49
Annan Athlet,813,7,12,11,13,51,43,8,47
Berwick,813,8,9,10,17,31,59,-28,37
Edinburgh Ci,813,9,7,9,20,36,63,-27,30
Cowdenbeath,813,10,4,10,22,25,58,-33,22
Montrose,814,1,24,7,5,63,35,28,79
Peterhead,814,2,24,4,8,80,38,42,76
Stirling,814,3,16,7,13,61,52,9,55
Stenhousem'r,814,4,15,9,12,56,47,9,54
Clyde,814,5,14,9,13,52,50,2,51
Elgin,814,6,14,6,16,54,64,-10,48
Annan Athlet,814,7,11,11,14,49,44,5,44
Berwick,814,8,9,10,17,31,59,-28,37
Edinburgh Ci,814,9,7,9,20,36,63,-27,30
Cowdenbeath,814,10,5,10,21,26,56,-30,25
Montrose,815,1,24,7,5,62,35,27,79
Peterhead,815,2,24,4,8,79,38,41,76
Stenhousem'r,815,3,16,8,12,57,47,10,56
Stirling,815,4,16,6,14,61,53,8,54
Clyde,815,5,15,9,12,52,48,4,54
Elgin,815,6,14,6,16,54,63,-9,48
Annan Athlet,815,7,12,11,13,50,41,9,47
Berwick,815,8,8,10,18,29,59,-30,34
Edinburgh Ci,815,9,7,9,20,36,62,-26,30
Cowdenbeath,815,10,4,10,22,23,57,-34,22
Montrose,816,1,24,7,5,61,35,26,79
Peterhead,816,2,24,4,8,80,40,40,76
Stirling,816,3,17,6,13,64,52,12,57
Clyde,816,4,15,9,12,52,48,4,54
Stenhousem'r,816,5,15,8,13,56,50,6,53
Elgin,816,6,14,6,16,54,62,-8,48
Annan Athlet,816,7,11,12,13,48,42,6,45
Berwick,816,8,8,10,18,29,59,-30,34
Edinburgh Ci,816,9,7,9,20,38,63,-25,30
Cowdenbeath,816,10,4,11,21,24,55,-31,23
Montrose,817,1,24,7,5,62,36,26,79
Peterhead,817,2,24,4,8,81,41,40,76
Stenhousem'r,817,3,16,8,12,56,46,10,56
Stirling,817,4,16,6,14,60,52,8,54
Clyde,817,5,15,9,12,54,49,5,54
Elgin,817,6,14,6,16,55,63,-8,48
Annan Athlet,817,7,11,12,13,47,41,6,45
Berwick,817,8,8,10,18,30,61,-31,34
Edinburgh Ci,817,9,7,9,20,39,64,-25,30
Cowdenbeath,817,10,4,11,21,23,54,-31,23
Montrose,818,1,24,7,5,60,34,26,79
Peterhead,818,2,23,5,8,77,38,39,74
Stirling,818,3,17,6,13,63,52,11,57
Stenhousem'r,818,4,15,8,13,56,49,7,53
Clyde,818,5,14,9,13,51,49,2,51
Elgin,818,6,14,6,16,53,61,-8,48
Annan Athlet,818,7,11,11,14,48,43,5,44
Berwick,818,8,9,10,17,30,58,-28,37
Edinburgh Ci,818,9,7,10,19,36,60,-24,31
Cowdenbeath,818,10,5,10,21,25,55,-30,25
Montrose,819,1,23,8,5,59,34,25,77
Peterhead,819,2,24,4,8,79,39,40,76
Stirling,819,3,16,7,13,61,52,9,55
Stenhousem'r,819,4,15,9,12,56,47,9,54
Clyde,819,5,15,9,12,53,48,5,54
Elgin,819,6,14,7,15,53,60,-7,49
Annan Athlet,819,7,12,11,13,49,42,7,47
Berwick,819,8,8,10,18,29,60,-31,34
Edinburgh Ci,819,9,7,9,20,37,62,-25,30
Cowdenbeath,819,10,4,10,22,24,56,-32,22
Montrose,820,1,24,7,5,62,35,27,79
Peterhead,820,2,24,4,8,78,38,40,76
Stenhousem'r,820,3,16,8,12,59,47,12,56
Stirling,820,4,16,6,14,61,55,6,54
Clyde,820,5,14,10,12,52,49,3,52
Elgin,820,6,14,6,16,54,63,-9,48
Annan Athlet,820,7,11,11,14,48,44,4,44
Berwick,820,8,8,11,17,30,59,-29,35
Edinburgh Ci,820,9,7,9,20,36,61,-25,30
Cowdenbeath,820,10,5,10,21,26,55,-29,25
Montrose,821,1,24,7,5,61,35,26,79
Peterhead,821,2,23,5,8,78,39,39,74
Stirling,821,3,16,7,13,60,51,9,55
Stenhousem'r,821,4,15,9,12,55,46,9,54
Clyde,821,5,14,10,12,53,50,3,52
Elgin,821,6,14,6,16,54,62,-8,48
Annan Athlet,821,7,12,11,13,49,41,8,47
Berwick,821,8,8,11,17,31,60,-29,35
Edinburgh Ci,821,9,7,10,19,37,61,-24,31
Cowdenbeath,821,10,4,10,22,23,56,-33,22
Montrose,822,1,23,8,5,62,37,25,77
Peterhead,822,2,24,4,8,82,38,44,76
Stirling,822,3,17,6,13,63,52,11,57
Clyde,822,4,15,9,12,52,48,4,54
Stenhousem'r,822,5,15,8,13,56,49,7,53
Elgin,822,6,14,7,15,56,63,-7,49
Annan Athlet,822,7,12,11,13,50,42,8,47
Berwick,822,8,8,10,18,29,59,-30,34
Edinburgh Ci,822,9,7,9,20,36,65,-29,30
Cowdenbeath,822,10,4,10,22,24,57,-33,22
Montrose,823,1,24,7,5,61,35,26,79
Peterhead,823,2,23,4,9,77,39,38,73
Stenhousem'r,823,3,16,8,12,57,46,11,56
Stirling,823,4,16,6,14,60,53,7,54
Clyde,823,5,15,9,12,54,49,5,54
Elgin,823,6,14,6,16,54,62,-8,48
Annan Athlet,823,7,12,11,13,49,42,7,47
Berwick,823,8,8,10,18,30,61,-31,34
Edinburgh Ci,823,9,8,9,19,37,60,-23,33
Cowdenbeath,823,10,4,10,22,24,56,-32,22
Montrose,824,1,24,7,5,64,35,29,79
Peterhead,824,2,24,4,8,80,39,41,76
Stenhousem'r,824,3,16,8,12,58,46,12,56
Stirling,824,4,16,6,14,60,54,6,54
Clyde,824,5,14,9,13,51,49,2,51
Elgin,824,6,14,6,16,54,65,-11,48
Annan Athlet,824,7,12,11,13,49,41,8,47
Berwick,824,8,9,10,17,30,58,-28,37
Edinburgh Ci,824,9,7,9,20,37,63,-26,30
Cowdenbeath,824,10,4,10,22,23,56,-33,22
Peterhead,825,1,24,4,8,80,39,41,76
Montrose,825,2,23,7,6,60,36,24,76
Stirling,825,3,17,6,13,64,53,11,57
Stenhousem'r,825,4,15,8,13,57,50,7,53
Clyde,825,5,14,9,13,51,49,2,51
Elgin,825,6,15,6,15,55,61,-6,51
Annan Athlet,825,7,11,12,13,47,41,6,45
Berwick,825,8,9,10,17,30,58,-28,37
Edinburgh Ci,825,9,7,9,20,37,63,-26,30
Cowdenbeath,825,10,4,11,21,23,54,-31,23
Montrose,826,1,23,8,5,61,36,25,77
Peterhead,826,2,24,4,8,79,39,40,76
Stenhousem'r,826,3,16,8,12,57,46,11,56
Stirling,826,4,16,6,14,60,53,7,54
Clyde,826,5,15,9,12,52,48,4,54
Elgin,826,6,14,7,15,55,62,-7,49
Annan Athlet,826,7,12,11,13,49,41,8,47
Berwick,826,8,8,10,18,29,59,-30,34
Edinburgh Ci,826,9,7,9,20,37,62,-25,30
Cowdenbeath,826,10,4,10,22,23,56,-33,22
Montrose,827,1,23,8,5,62,37,25,77
Peterhead,827,2,23,5,8,79,40,39,74
Stirling,827,3,16,7,13,62,53,9,55
Stenhousem'r,827,4,15,9,12,57,48,9,54
Clyde,827,5,15,9,12,53,48,5,54
Elgin,827,6,14,7,15,56,63,-7,49
Annan Athlet,827,7,11,11,14,47,43,4,44
Berwick,827,8,8,10,18,29,60,-31,34
Edinburgh Ci,827,9,7,10,19,38,62,-24,31
Cowdenbeath,827,10,5,10,21,25,54,-29,25
Montrose,828,1,24,7,5,61,34,27,79
Peterhead,828,2,24,4,8,80,39,41,76
Stirling,828,3,17,6,13,64,52,12,57
Stenhousem'r,828,4,15,8,13,56,50,6,53
Clyde,828,5,14,10,12,52,49,3,52
Elgin,828,6,14,6,16,53,62,-9,48
Annan Athlet,828,7,12,11,13,49,42,7,47
Berwick,828,8,8,11,17,30,59,-29,35
Edinburgh Ci,828,9,7,9,20,37,63,-26,30
Cowdenbeath,828,10,4,10,22,24,56,-32,22
Montrose,829,1,24,7,5,61,35,26,79
Peterhead,829,2,24,4,8,79,38,41,76
Stirling,829,3,16,7,13,63,54,9,55
Stenhousem'r,829,4,15,9,12,58,49,9,54
Clyde,829,5,14,9,13,51,51,0,51
Elgin,829,6,14,6,16,54,62,-8,48
Annan Athlet,829,7,11,12,13,48,42,6,45
Berwick,829,8,9,10,17,32,58,-26,37
Edinburgh Ci,829,9,7,9,20,36,62,-26,30
Cowdenbeath,829,10,4,11,21,24,55,-31,23
Montrose,830,1,24,7,5,64,35,29,79
Peterhead,830,2,23,5,8,78,39,39,74
Stirling,830,3,17,6,13,62,52,10,57
Stenhousem'r,830,4,15,8,13,56,48,8,53
Clyde,830,5,14,10,12,52,49,3,52
Elgin,830,6,14,6,16,54,65,-11,48
Annan Athlet,830,7,11,11,14,47,42,5,44
Berwick,830,8,8,11,17,30,59,-29,35
Edinburgh Ci,830,9,7,10,19,37,61,-24,31
Cowdenbeath,830,10,5,10,21,24,54,-30,25
Montrose,831,1,23,8,5,62,37,25,77
Peterhead,831,2,24,4,8,81,39,42,76
Stirling,831,3,17,6,13,67,52,15,57
Clyde,831,4,15,9,12,52,48,4,54
Stenhousem'r,831,5,15,8,13,56,53,3,53
Elgin,831,6,14,7,15,56,63,-7,49
Annan Athlet,831,7,11,11,14,47,42,5,44
Berwick,831,8,8,10,18,29,59,-30,34
Edinburgh Ci,831,9,7,9,20,37,64,-27,30
Cowdenbeath,831,10,5,10,21,24,54,-30,25
Montrose,832,1,24,7,5,61,34,27,79
Peterhead,832,2,24,4,8,80,38,42,76
Stirling,832,3,16,7,13,61,52,9,55
Stenhousem'r,832,4,15,9,12,56,47,9,54
Clyde,832,5,14,10,12,52,49,3,52
Elgin,832,6,14,6,16,53,62,-9,48
Annan Athlet,832,7,11,12,13,48,42,6,45
Berwick,832,8,8,11,17,30,59,-29,35
Edinburgh Ci,832,9,7,9,20,36,63,-27,30
Cowdenbeath,832,10,4,11,21,24,55,-31,23
Montrose,833,1,24,7,5,60,34,26,79
Peterhead,833,2,24,4,8,80,38,42,76
Stirling,833,3,17,6,13,62,52,10,57
Clyde,833,4,15,9,12,54,48,6,54
Stenhousem'r,833,5,15,8,13,56,48,8,53
Elgin,833,6,14,6,16,53,61,-8,48
Annan Athlet,833,7,11,11,14,47,43,4,44
Berwick,833,8,8,10,18,29,61,-32,34
Edinburgh Ci,833,9,7,9,20,36,63,-27,30
Cowdenbeath,833,10,5,10,21,25,54,-29,25
Montrose,834,1,23,8,5,60,35,25,77
Peterhead,834,2,24,4,8,79,39,40,76
Stenhousem'r,834,3,16,8,12,60,46,14,56
Stirling,834,4,16,6,14,60,56,4,54
Clyde,834,5,14,9,13,51,49,2,51
Elgin,834,6,14,7,15,54,61,-7,49
Annan Athlet,834,7,12,11,13,49,41,8,47
Berwick,834,8,9,10,17,30,58,-28,37
Edinburgh Ci,834,9,7,9,20,37,62,-25,30
Cowdenbeath,834,10,4,10,22,23,56,-33,22
Montrose,835,1,23,7,6,59,35,24,76
Peterhead,835,2,23,5,8,78,39,39,74
Stirling,835,3,17,6,13,64,51,13,57
Stenhousem'r,835,4,15,8,13,55,50,5,53
Clyde,835,5,14,10,12,51,48,3,52
Elgin,835,6,15,6,15,54,60,-6,51
Annan Athlet,835,7,11,11,14,47,42,5,44
Berwick,835,8,8,11,17,29,58,-29,35
Edinburgh Ci,835,9,7,10,19,37,61,-24,31
Cowdenbeath,835,10,5,10,21,24,54,-30,25
Montrose,836,1,24,7,5,63,35,28,79
Peterhead,836,2,24,4,8,80,38,42,76
Stenhousem'r,836,3,16,8,12,60,47,13,56
Stirling,836,4,16,6,14,61,56,5,54
Clyde,836,5,14,10,12,54,51,3,52
Elgin,836,6,14,6,16,54,64,-10,48
Annan Athlet,836,7,11,11,14,47,42,5,44
Berwick,836,8,8,11,17,32,61,-29,35
Edinburgh Ci,836,9,7,9,20,36,63,-27,30
Cowdenbeath,836,10,5,10,21,24,54,-30,25
Montrose,837,1,24,7,5,62,35,27,79
Peterhead,837,2,24,4,8,80,38,42,76
Stenhousem'r,837,3,16,8,12,58,48,10,56
Stirling,837,4,16,6,14,62,54,8,54
Clyde,837,5,15,9,12,54,48,6,54
Elgin,837,6,14,6,16,54,63,-9,48
Annan Athlet,837,7,11,11,14,47,43,4,44
Berwick,837,8,8,10,18,29,61,-32,34
Edinburgh Ci,837,9,7,9,20,36,63,-27,30
Cowdenbeath,837,10,5,10,21,25,54,-29,25
Montrose,838,1,24,7,5,61,34,27,79
Peterhead,838,2,24,4,8,79,39,40,76
Stenhousem'r,838,3,16,8,12,56,46,10,56
Stirling,838,4,16,6,14,60,52,8,54
Clyde,838,5,14,10,12,52,49,3,52
Elgin,838,6,14,6,16,53,62,-9,48
Annan Athlet,838,7,11,12,13,48,42,6,45
Berwick,838,8,8,11,17,30,59,-29,35
Edinburgh Ci,838,9,7,9,20,37,62,-25,30
Cowdenbeath,838,10,4,11,21,24,55,-31,23
Montrose,839,1,24,7,5,60,34,26,79
Peterhead,839,2,24,4,8,84,41,43,76
Stirling,839,3,16,7,13,62,53,9,55
Stenhousem'r,839,4,15,9,12,57,48,9,54
Clyde,839,5,14,10,12,51,48,3,52
Elgin,839,6,14,6,16,53,61,-8,48
Annan Athlet,839,7,11,11,14,47,42,5,44
Berwick,839,8,8,11,17,29,58,-29,35
Edinburgh Ci,839,9,7,9,20,39,67,-28,30
Cowdenbeath,839,10,5,10,21,24,54,-30,25
Montrose,840,1,24,7,5,65,35,30,79
Peterhead,840,2,24,4,8,81,39,42,76
Stenhousem'r,840,3,16,8,12,58,48,10,56
Stirling,840,4,16,6,14,62,54,8,54
Clyde,840,5,15,9,12,54,48,6,54
Elgin,840,6,14,6,16,54,66,-12,48
Annan Athlet,840,7,12,11,13,48,41,7,47
Berwick,840,8,8,10,18,29,61,-32,34
Edinburgh Ci,840,9,7,9,20,37,64,-27,30
Cowdenbeath,840,10,4,10,22,23,55,-32,22
Montrose,841,1,24,7,5,62,35,27,79
Peterhead,841,2,23,5,8,79,40,39,74
Stirling,841,3,16,7,13,62,53,9,55
Stenhousem'r,841,4,15,9,12,57,48,9,54
Clyde,841,5,15,9,12,55,49,6,54
Elgin,841,6,14,6,16,54,63,-9,48
Annan Athlet,841,7,12,11,13,48,41,7,47
Berwick,841,8,8,10,18,30,62,-32,34
Edinburgh Ci,841,9,7,10,19,38,62,-24,31
Cowdenbeath,841,10,4,10,22,23,55,-32,22
Montrose,842,1,23,8,5,61,36,25,77
Peterhead,842,2,24,4,8,80,38,42,76
Stirling,842,3,16,7,13,61,52,9,55
Stenhousem'r,842,4,15,9,12,56,47,9,54
Clyde,842,5,14,10,12,52,49,3,52
Elgin,842,6,14,7,15,55,62,-7,49
Annan Athlet,842,7,11,12,13,48,42,6,45
Berwick,842,8,8,11,17,30,59,-29,35
Edinburgh Ci,842,9,7,9,20,36,63,-27,30
Cowdenbeath,842,10,4,11,21,24,55,-31,23
Montrose,843,1,24,7,5,62,35,27,79
Peterhead,843,2,23,5,8,78,39,39,74
Stirling,843,3,17,6,13,62,51,11,57
Stenhousem'r,843,4,15,8,13,55,48,7,53
Clyde,843,5,14,9,13,52,50,2,51
Elgin,843,6,14,6,16,54,63,-9,48
Annan Athlet,843,7,11,11,14,47,42,5,44
Berwick,843,8,9,10,17,31,59,-28,37
Edinburgh Ci,843,9,7,10,19,37,61,-24,31
Cowdenbeath,843,10,5,10,21,24,54,-30,25
Montrose,844,1,23,8,5,61,36,25,77
Peterhead,844,2,24,4,8,79,38,41,76
Stirling,844,3,16,7,13,61,52,9,55
Stenhousem'r,844,4,15,9,12,56,47,9,54
Clyde,844,5,14,10,12,53,50,3,52
Elgin,844,6,14,7,15,55,62,-7,49
Annan Athlet,844,7,12,11,13,48,41,7,47
Berwick,844,8,8,11,17,31,60,-29,35
Edinburgh Ci,844,9,7,9,20,36,62,-26,30
Cowdenbeath,844,10,4,10,22,23,55,-32,22
Montrose,845,1,23,7,6,59,35,24,76
Peterhead,845,2,23,4,9,79,41,38,73
Stirling,845,3,17,6,13,66,54,12,57
Stenhousem'r,845,4,15,8,13,58,52,6,53
Clyde,845,5,14,10,12,52,49,3,52
Elgin,845,6,15,6,15,54,60,-6,51
Annan Athlet,845,7,11,12,13,47,41,6,45
Berwick,845,8,8,11,17,30,59,-29,35
Edinburgh Ci,845,9,8,9,19,39,62,-23,33
Cowdenbeath,845,10,4,11,21,23,54,-31,23
Peterhead,846,1,24,4,8,81,41,40,76
Montrose,846,2,23,7,6,60,36,24,76
Stenhousem'r,846,3,16,8,12,56,46,10,56
Stirling,846,4,16,6,14,60,52,8,54
Clyde,846,5,15,9,12,53,49,4,54
Elgin,846,6,15,6,15,55,61,-6,51
Annan Athlet,846,7,11,12,13,49,43,6,45
Berwick,846,8,8,10,18,30,60,-30,34
Edinburgh Ci,846,9,7,9,20,39,64,-25,30
Cowdenbeath,846,10,4,11,21,25,56,-31,23
Montrose,847,1,24,7,5,62,35,27,79
Peterhead,847,2,23,5,8,79,40,39,74
Stenhousem'r,847,3,16,8,12,58,47,11,56
Stirling,847,4,16,6,14,61,54,7,54
Clyde,847,5,14,9,13,52,50,2,51
Elgin,847,6,14,6,16,54,63,-9,48
Annan Athlet,847,7,11,12,13,47,41,6,45
Berwick,847,8,9,10,17,31,59,-28,37
Edinburgh Ci,847,9,7,10,19,38,62,-24,31
Cowdenbeath,847,10,4,11,21,23,54,-31,23
Montrose,848,1,24,7,5,62,35,27,79
Peterhead,848,2,24,4,8,81,38,43,76
Stirling,848,3,17,6,13,62,52,10,57
Clyde,848,4,15,9,12,55,49,6,54
Stenhousem'r,848,5,15,8,13,56,48,8,53
Elgin,848,6,14,6,16,54,63,-9,48
Annan Athlet,848,7,11,12,13,47,41,6,45
Berwick,848,8,8,10,18,30,62,-32,34
Edinburgh Ci,848,9,7,9,20,36,64,-28,30
Cowdenbeath,848,10,4,11,21,23,54,-31,23
Montrose,849,1,24,7,5,61,34,27,79
Peterhead,849,2,24,4,8,80,39,41,76
Stirling,849,3,17,6,13,63,52,11,57
Stenhousem'r,849,4,15,8,13,56,49,7,53
Clyde,849,5,14,9,13,51,49,2,51
Elgin,849,6,14,6,16,53,62,-9,48
Annan Athlet,849,7,11,11,14,47,42,5,44
Berwick,849,8,9,10,17,30,58,-28,37
Edinburgh Ci,849,9,7,9,20,37,63,-26,30
Cowdenbeath,849,10,5,10,21,24,54,-30,25
Montrose,850,1,23,8,5,59,34,25,77
Peterhead,850,2,24,4,8,80,38,42,76
Stirling,850,3,17,6,13,61,51,10,57
Stenhousem'r,850,4,15,8,13,55,47,8,53
Clyde,850,5,14,9,13,52,50,2,51
Elgin,850,6,14,7,15,53,60,-7,49
Annan Athlet,850,7,11,12,13,48,42,6,45
Berwick,850,8,9,10,17,31,59,-28,37
Edinburgh Ci,850,9,7,9,20,36,63,-27,30
Cowdenbeath,850,10,4,11,21,24,55,-31,23
Peterhead,851,1,24,4,8,81,39,42,76
Montrose,851,2,23,7,6,60,36,24,76
Stirling,851,3,16,7,13,61,52,9,55
Stenhousem'r,851,4,15,9,12,56,47,9,54
Clyde,851,5,14,10,12,51,48,3,52
Elgin,851,6,15,6,15,55,61,-6,51
Annan Athlet,851,7,11,12,13,49,43,6,45
Berwick,851,8,8,11,17,29,58,-29,35
Edinburgh Ci,851,9,7,9,20,37,64,-27,30
Cowdenbeath,851,10,4,11,21,25,56,-31,23
Montrose,852,1,24,7,5,63,35,28,79
Peterhead,852,2,24,4,8,79,39,40,76
Stirling,852,3,17,6,13,63,52,11,57
Clyde,852,4,15,9,12,54,48,6,54
Stenhousem'r,852,5,15,8,13,56,49,7,53
Elgin,852,6,14,6,16,54,64,-10,48
Annan Athlet,852,7,11,11,14,48,43,5,44
Berwick,852,8,8,10,18,29,61,-32,34
Edinburgh Ci,852,9,7,9,20,37,62,-25,30
Cowdenbeath,852,10,5,10,21,25,55,-30,25
Montrose,853,1,24,7,5,63,35,28,79
Peterhead,853,2,24,4,8,84,38,46,76
Stirling,853,3,17,6,13,62,52,10,57
Clyde,853,4,15,9,12,55,49,6,54
Stenhousem'r,853,5,15,8,13,56,48,8,53
Elgin,853,6,14,6,16,54,64,-10,48
Annan Athlet,853,7,12,11,13,49,41,8,47
Berwick,853,8,8,10,18,30,62,-32,34
Edinburgh Ci,853,9,7,9,20,36,67,-31,30
Cowdenbeath,853,10,4,10,22,23,56,-33,22
Montrose,854,1,24,7,5,61,35,26,79
Peterhead,854,2,24,4,8,79,39,40,76
Stirling,854,3,17,6,13,64,52,12,57
Clyde,854,4,15,9,12,52,48,4,54
Stenhousem'r,854,5,15,8,13,56,50,6,53
Elgin,854,6,14,6,16,54,62,-8,48
Annan Athlet,854,7,11,11,14,48,43,5,44
Berwick,854,8,8,10,18,29,59,-30,34
Edinburgh Ci,854,9,7,9,20,37,62,-25,30
Cowdenbeath,854,10,5,10,21,25,55,-30,25
Montrose,855,1,24,7,5,62,36,26,79
Peterhead,855,2,24,4,8,80,38,42,76
Stenhousem'r,855,3,16,8,12,57,47,10,56
Stirling,855,4,16,6,14,61,53,8,54
Clyde,855,5,15,9,12,54,49,5,54
Elgin,855,6,14,6,16,55,63,-8,48
Annan Athlet,855,7,12,11,13,49,41,8,47
Berwick,855,8,8,10,18,30,61,-31,34
Edinburgh Ci,855,9,7,9,20,36,63,-27,30
Cowdenbeath,855,10,4,10,22,23,56,-33,22
Montrose,856,1,23,8,5,59,34,25,77
Peterhead,856,2,24,4,8,80,38,42,76
Stenhousem'r,856,3,16,8,12,56,46,10,56
Stirling,856,4,16,6,14,60,52,8,54
Clyde,856,5,14,10,12,51,48,3,52
Elgin,856,6,14,7,15,53,60,-7,49
Annan Athlet,856,7,11,11,14,48,43,5,44
Berwick,856,8,8,11,17,29,58,-29,35
Edinburgh Ci,856,9,7,9,20,36,63,-27,30
Cowdenbeath,856,10,5,10,21,25,55,-30,25
Montrose,857,1,23,8,5,59,34,25,77
Peterhead,857,2,23,5,8,78,39,39,74
Stirling,857,3,17,6,13,64,54,10,57
Stenhousem'r,857,4,15,8,13,58,50,8,53
Clyde,857,5,14,10,12,52,49,3,52
Elgin,857,6,14,7,15,53,60,-7,49
Annan Athlet,857,7,11,11,14,47,42,5,44
Berwick,857,8,8,11,17,30,59,-29,35
Edinburgh Ci,857,9,7,10,19,37,61,-24,31
Cowdenbeath,857,10,5,10,21,24,54,-30,25
Montrose,858,1,23,8,5,60,35,25,77
Peterhead,858,2,24,4,8,78,38,40,76
Stenhousem'r,858,3,16,8,12,57,47,10,56
Stirling,858,4,16,6,14,61,53,8,54
Clyde,858,5,15,9,12,53,48,5,54
Elgin,858,6,14,7,15,54,61,-7,49
Annan Athlet,858,7,11,11,14,49,44,5,44
Berwick,858,8,8,10,18,29,60,-31,34
Edinburgh Ci,858,9,7,9,20,36,61,-25,30
Cowdenbeath,858,10,5,10,21,26,56,-30,25
Montrose,859,1,24,7,5,61,35,26,79
Peterhead,859,2,23,5,8,78,39,39,74
Stirling,859,3,16,7,13,61,52,9,55
Stenhousem'r,859,4,15,9,12,56,47,9,54
Clyde,859,5,15,9,12,56,49,7,54
Elgin,859,6,14,6,16,54,62,-8,48
Annan Athlet,859,7,11,12,13,48,42,6,45
Berwick,859,8,8,10,18,30,63,-33,34
Edinburgh Ci,859,9,7,10,19,37,61,-24,31
Cowdenbeath,859,10,4,11,21,24,55,-31,23
Montrose,860,1,24,7,5,62,34,28,79
Peterhead,860,2,23,4,9,77,40,37,73
Stirling,860,3,16,7,13,60,51,9,55
Stenhousem'r,860,4,15,9,12,55,46,9,54
Clyde,860,5,15,9,12,55,48,7,54
Elgin,860,6,14,6,16,53,63,-10,48
Annan Athlet,860,7,11,12,13,48,42,6,45
Berwick,860,8,8,10,18,29,62,-33,34
Edinburgh Ci,860,9,8,9,19,38,60,-22,33
Cowdenbeath,860,10,4,11,21,24,55,-31,23
Montrose,861,1,24,7,5,63,36,27,79
Peterhead,861,2,24,4,8,78,38,40,76
Stenhousem'r,861,3,16,8,12,57,46,11,56
Stirling,861,4,16,6,14,60,53,7,54
Clyde,861,5,15,9,12,55,48,7,54
Elgin,861,6,14,6,16,55,64,-9,48
Annan Athlet,861,7,11,12,13,47,41,6,45
Berwick,861,8,8,10,18,29,62,-33,34
Edinburgh Ci,861,9,7,9,20,36,61,-25,30
Cowdenbeath,861,10,4,11,21,23,54,-31,23
Peterhead,862,1,24,4,8,83,39,44,76
Montrose,862,2,23,7,6,60,36,24,76
Stirling,862,3,16,7,13,61,52,9,55
Stenhousem'r,862,4,15,9,12,56,47,9,54
Clyde,862,5,14,10,12,52,49,3,52
Elgin,862,6,15,6,15,55,61,-6,51
Annan Athlet,862,7,11,12,13,47,41,6,45
Berwick,862,8,8,11,17,30,59,-29,35
Edinburgh Ci,862,9,7,9,20,37,66,-29,30
Cowdenbeath,862,10,4,11,21,23,54,-31,23
Montrose,863,1,23,7,6,59,37,22,76
Peterhead,863,2,23,4,9,77,40,37,73
Stenhousem'r,863,3,16,8,12,56,46,10,56
Stirling,863,4,16,6,14,60,52,8,54
Clyde,863,5,15,9,12,56,48,8,54
Elgin,863,6,15,6,15,56,60,-4,51
Annan Athlet,863,7,11,11,14,47,43,4,44
Berwick,863,8,8,10,18,29,63,-34,34
Edinburgh Ci,863,9,8,9,19,38,60,-22,33
Cowdenbeath,863,10,5,10,21,25,54,-29,25
Montrose,864,1,23,7,6,60,36,24,76
Peterhead,864,2,23,4,9,77,40,37,73
Stenhousem'r,864,3,16,8,12,56,46,10,56
Stirling,864,4,16,6,14,60,52,8,54
Clyde,864,5,14,10,12,53,50,3,52
Elgin,864,6,15,6,15,55,61,-6,51
Annan Athlet,864,7,12,11,13,49,42,7,47
Berwick,864,8,8,11,17,31,60,-29,35
Edinburgh Ci,864,9,8,9,19,38,60,-22,33
Cowdenbeath,864,10,4,10,22,24,56,-32,22
Montrose,865,1,24,7,5,62,34,28,79
Peterhead,865,2,23,5,8,78,39,39,74
Stenhousem'r,865,3,16,8,12,57,47,10,56
Stirling,865,4,16,6,14,61,53,8,54
Clyde,865,5,15,9,12,53,49,4,54
Elgin,865,6,14,6,16,53,63,-10,48
Annan Athlet,865,7,12,11,13,48,41,7,47
Berwick,865,8,8,10,18,30,60,-30,34
Edinburgh Ci,865,9,7,10,19,37,61,-24,31
Cowdenbeath,865,10,4,10,22,23,55,-32,22
Montrose,866,1,24,7,5,62,34,28,79
Peterhead,866,2,24,4,8,81,38,43,76
Stirling,866,3,17,6,13,62,51,11,57
Clyde,866,4,15,9,12,52,48,4,54
Stenhousem'r,866,5,15,8,13,55,48,7,53
Elgin,866,6,14,6,16,53,63,-10,48
Annan Athlet,866,7,12,11,13,48,41,7,47
Berwick,866,8,8,10,18,29,59,-30,34
Edinburgh Ci,866,9,7,9,20,36,64,-28,30
Cowdenbeath,866,10,4,10,22,23,55,-32,22
Montrose,867,1,24,7,5,63,35,28,79
Peterhead,867,2,23,5,8,78,39,39,74
Stenhousem'r,867,3,16,8,12,59,46,13,56
Stirling,867,4,16,6,14,60,55,5,54
Clyde,867,5,15,9,12,54,49,5,54
Elgin,867,6,14,6,16,54,64,-10,48
Annan Athlet,867,7,11,11,14,49,44,5,44
Berwick,867,8,8,10,18,30,61,-31,34
Edinburgh Ci,867,9,7,10,19,37,61,-24,31
Cowdenbeath,867,10,5,10,21,26,56,-30,25
Peterhead,868,1,24,4,8,79,39,40,76
Montrose,868,2,23,7,6,59,36,23,76
Stirling,868,3,17,6,13,63,53,10,57
Clyde,868,4,15,9,12,56,49,7,54
Stenhousem'r,868,5,15,8,13,57,49,8,53
Elgin,868,6,15,6,15,55,60,-5,51
Annan Athlet,868,7,11,12,13,47,41,6,45
Berwick,868,8,8,10,18,30,63,-33,34
Edinburgh Ci,868,9,7,9,20,37,62,-25,30
Cowdenbeath,868,10,4,11,21,23,54,-31,23
Peterhead,869,1,24,4,8,81,38,43,76
Montrose,869,2,23,7,6,59,35,24,76
Stenhousem'r,869,3,16,8,12,57,47,10,56
Stirling,869,4,16,6,14,61,53,8,54
Clyde,869,5,15,9,12,56,48,8,54
Elgin,869,6,15,6,15,54,60,-6,51
Annan Athlet,869,7,11,11,14,48,43,5,44
Berwick,869,8,8,10,18,29,63,-34,34
Edinburgh Ci,869,9,7,9,20,36,64,-28,30
Cowdenbeath,869,10,5,10,21,25,55,-30,25
Montrose,870,1,24,7,5,62,34,28,79
Peterhead,870,2,23,4,9,79,43,36,73
Stirling,870,3,17,6,13,61,51,10,57
Clyde,870,4,15,9,12,53,48,5,54
Stenhousem'r,870,5,15,8,13,55,47,8,53
Elgin,870,6,14,6,16,53,63,-10,48
Annan Athlet,870,7,12,11,13,51,44,7,47
Berwick,870,8,8,10,18,29,60,-31,34
Edinburgh Ci,870,9,8,9,19,41,62,-21,33
Cowdenbeath,870,10,4,10,22,26,58,-32,22
Montrose,871,1,24,7,5,61,35,26,79
Peterhead,871,2,24,4,8,78,38,40,76
Stirling,871,3,17,6,13,62,52,10,57
Stenhousem'r,871,4,15,8,13,56,48,8,53
Clyde,871,5,14,9,13,51,49,2,51
Elgin,871,6,14,6,16,54,62,-8,48
Annan Athlet,871,7,11,12,13,47,41,6,45
Berwick,871,8,9,10,17,30,58,-28,37
Edinburgh Ci,871,9,7,9,20,36,61,-25,30
Cowdenbeath,871,10,4,11,21,23,54,-31,23
Montrose,872,1,23,7,6,59,36,23,76
Peterhead,872,2,23,5,8,78,39,39,74
Stenhousem'r,872,3,16,8,12,58,47,11,56
Stirling,872,4,16,6,14,61,54,7,54
Clyde,872,5,14,10,12,52,49,3,52
Elgin,872,6,15,6,15,55,60,-5,51
Annan Athlet,872,7,12,11,13,49,41,8,47
Berwick,872,8,8,11,17,30,59,-29,35
Edinburgh Ci,872,9,7,10,19,37,61,-24,31
Cowdenbeath,872,10,4,10,22,23,56,-33,22
Montrose,873,1,24,7,5,63,36,27,79
Peterhead,873,2,24,4,8,81,40,41,76
Stenhousem'r,873,3,16,8,12,60,47,13,56
Stirling,873,4,16,6,14,61,56,5,54
Clyde,873,5,14,9,13,51,49,2,51
Elgin,873,6,14,6,16,55,64,-9,48
Annan Athlet,873,7,11,11,14,47,43,4,44
Berwick,873,8,9,10,17,30,58,-28,37
Edinburgh Ci,873,9,7,9,20,38,64,-26,30
Cowdenbeath,873,10,5,10,21,25,54,-29,25
Montrose,874,1,24,7,5,63,36,27,79
Peterhead,874,2,24,4,8,81,40,41,76
Stirling,874,3,17,6,13,65,52,13,57
Clyde,874,4,15,9,12,55,51,4,54
Stenhousem'r,874,5,15,8,13,56,51,5,53
Elgin,874,6,14,6,16,55,64,-9,48
Annan Athlet,874,7,11,12,13,48,42,6,45
Berwick,874,8,8,10,18,32,62,-30,34
Edinburgh Ci,874,9,7,9,20,38,64,-26,30
Cowdenbeath,874,10,4,11,21,24,55,-31,23
Montrose,875,1,24,7,5,62,36,26,79
Peterhead,875,2,24,4,8,80,40,40,76
Stirling,875,3,16,7,13,62,53,9,55
Stenhousem'r,875,4,15,9,12,57,48,9,54
Clyde,875,5,14,9,13,52,50,2,51
Elgin,875,6,14,6,16,55,63,-8,48
Annan Athlet,875,7,11,11,14,48,43,5,44
Berwick,875,8,9,10,17,31,59,-28,37
Edinburgh Ci,875,9,7,9,20,38,63,-25,30
Cowdenbeath,875,10,5,10,21,25,55,-30,25
Montrose,876,1,24,7,5,63,36,27,79
Peterhead,876,2,23,5,8,78,39,39,74
Stirling,876,3,17,6,13,62,52,10,57
Clyde,876,4,15,9,12,53,48,5,54
Stenhousem'r,876,5,15,8,13,56,48,8,53
Elgin,876,6,14,6,16,55,64,-9,48
Annan Athlet,876,7,11,12,13,48,42,6,45
Berwick,876,8,8,10,18,29,60,-31,34
Edinburgh Ci,876,9,7,10,19,37,61,-24,31
Cowdenbeath,876,10,4,11,21,24,55,-31,23
Montrose,877,1,24,7,5,60,34,26,79
Peterhead,877,2,24,4,8,80,38,42,76
Stirling,877,3,16,7,13,61,52,9,55
Stenhousem'r,877,4,15,9,12,56,47,9,54
Clyde,877,5,15,9,12,54,48,6,54
Elgin,877,6,14,6,16,53,61,-8,48
Annan Athlet,877,7,11,12,13,49,43,6,45
Berwick,877,8,8,10,18,29,61,-32,34
Edinburgh Ci,877,9,7,9,20,36,63,-27,30
Cowdenbeath,877,10,4,11,21,25,56,-31,23
Montrose,878,1,23,8,5,60,35,25,77
Peterhead,878,2,24,4,8,79,38,41,76
Stirling,878,3,17,6,13,63,51,12,57
Clyde,878,4,15,9,12,53,49,4,54
Stenhousem'r,878,5,15,8,13,55,49,6,53
Elgin,878,6,14,7,15,54,61,-7,49
Annan Athlet,878,7,11,12,13,47,41,6,45
Berwick,878,8,8,10,18,30,60,-30,34
Edinburgh Ci,878,9,7,9,20,36,62,-26,30
Cowdenbeath,878,10,4,11,21,23,54,-31,23
Montrose,879,1,24,7,5,61,35,26,79
Peterhead,879,2,24,4,8,81,39,42,76
Stirling,879,3,17,6,13,61,51,10,57
Clyde,879,4,15,9,12,53,48,5,54
Stenhousem'r,879,5,15,8,13,55,47,8,53
Elgin,879,6,14,6,16,54,62,-8,48
Annan Athlet,879,7,11,11,14,47,43,4,44
Berwick,879,8,8,10,18,29,60,-31,34
Edinburgh Ci,879,9,7,9,20,37,64,-27,30
Cowdenbeath,879,10,5,10,21,25,54,-29,25
Montrose,880,1,24,7,5,61,34,27,79
Peterhead,880,2,23,5,8,78,39,39,74
Stirling,880,3,16,7,13,61,52,9,55
Stenhousem'r,880,4,15,9,12,56,47,9,54
Clyde,880,5,14,10,12,52,49,3,52
Elgin,880,6,14,6,16,53,62,-9,48
Annan Athlet,880,7,12,11,13,49,42,7,47
Berwick,880,8,8,11,17,30,59,-29,35
Edinburgh Ci,880,9,7,10,19,37,61,-24,31
Cowdenbeath,880,10,4,10,22,24,56,-32,22
Montrose,881,1,24,7,5,60,34,26,79
Peterhead,881,2,24,4,8,79,39,40,76
Stirling,881,3,17,6,13,63,52,11,57
Clyde,881,4,15,9,12,54,49,5,54
Stenhousem'r,881,5,15,8,13,56,49,7,53
Elgin,881,6,14,6,16,53,61,-8,48
Annan Athlet,881,7,12,11,13,49,41,8,47
Berwick,881,8,8,10,18,30,61,-31,34
Edinburgh Ci,881,9,7,9,20,37,62,-25,30
Cowdenbeath,881,10,4,10,22,23,56,-33,22
Montrose,882,1,24,7,5,61,35,26,79
Peterhead,882,2,23,4,9,78,40,38,73
Stenhousem'r,882,3,16,8,12,56,46,10,56
Stirling,882,4,16,6,14,60,52,8,54
Clyde,882,5,15,9,12,53,48,5,54
Elgin,882,6,14,6,16,54,62,-8,48
Annan Athlet,882,7,11,12,13,48,42,6,45
Berwick,882,8,8,10,18,29,60,-31,34
Edinburgh Ci,882,9,8,9,19,38,61,-23,33
Cowdenbeath,882,10,4,11,21,24,55,-31,23
Peterhead,883,1,24,4,8,79,38,41,76
Montrose,883,2,23,7,6,60,37,23,76
Stirling,883,3,17,6,13,62,52,10,57
Stenhousem'r,883,4,15,8,13,56,48,8,53
Clyde,883,5,14,10,12,53,50,3,52
Elgin,883,6,15,6,15,56,61,-5,51
Annan Athlet,883,7,12,11,13,48,41,7,47
Berwick,883,8,8,11,17,31,60,-29,35
Edinburgh Ci,883,9,7,9,20,36,62,-26,30
Cowdenbeath,883,10,4,10,22,23,55,-32,22
Montrose,884,1,24,7,5,62,35,27,79
Peterhead,884,2,24,4,8,81,39,42,76
Stirling,884,3,16,7,13,61,52,9,55
Stenhousem'r,884,4,15,9,12,56,47,9,54
Clyde,884,5,15,9,12,53,49,4,54
Elgin,884,6,14,6,16,54,63,-9,48
Annan Athlet,884,7,12,11,13,49,41,8,47
Berwick,884,8,8,10,18,30,60,-30,34
Edinburgh Ci,884,9,7,9,20,37,64,-27,30
Cowdenbeath,884,10,4,10,22,23,56,-33,22
Montrose,885,1,23,8,5,61,36,25,77
Peterhead,885,2,24,4,8,83,39,44,76
Stirling,885,3,17,6,13,62,51,11,57
Stenhousem'r,885,4,15,8,13,55,48,7,53
Clyde,885,5,14,9,13,52,50,2,51
Elgin,885,6,14,7,15,55,62,-7,49
Annan Athlet,885,7,11,11,14,47,42,5,44
Berwick,885,8,9,10,17,31,59,-28,37
Edinburgh Ci,885,9,7,9,20,37,66,-29,30
Cowdenbeath,885,10,5,10,21,24,54,-30,25
Montrose,886,1,24,7,5,60,34,26,79
Peterhead,886,2,23,5,8,78,39,39,74
Stenhousem'r,886,3,16,8,12,58,48,10,56
Stirling,886,4,16,6,14,62,54,8,54
Clyde,886,5,15,9,12,52,48,4,54
Elgin,886,6,14,6,16,53,61,-8,48
Annan Athlet,886,7,12,11,13,48,41,7,47
Berwick,886,8,8,10,18,29,59,-30,34
Edinburgh Ci,886,9,7,10,19,37,61,-24,31
Cowdenbeath,886,10,4,10,22,23,55,-32,22
Montrose,887,1,24,7,5,60,34,26,79
Peterhead,887,2,24,4,8,79,38,41,76
Stenhousem'r,887,3,16,8,12,57,46,11,56
Stirling,887,4,16,6,14,60,53,7,54
Clyde,887,5,15,9,12,55,49,6,54
Elgin,887,6,14,6,16,53,61,-8,48
Annan Athlet,887,7,12,11,13,51,42,9,47
Berwick,887,8,8,10,18,30,62,-32,34
Edinburgh Ci,887,9,7,9,20,36,62,-26,30
Cowdenbeath,887,10,4,10,22,24,58,-34,22
Montrose,888,1,24,7,5,60,34,26,79
Peterhead,888,2,24,4,8,78,38,40,76
Stirling,888,3,17,6,13,67,53,14,57
Clyde,888,4,15,9,12,53,48,5,54
Stenhousem'r,888,5,15,8,13,57,53,4,53
Elgin,888,6,14,6,16,53,61,-8,48
Annan Athlet,888,7,12,11,13,49,41,8,47
Berwick,888,8,8,10,18,29,60,-31,34
Edinburgh Ci,888,9,7,9,20,36,61,-25,30
Cowdenbeath,888,10,4,10,22,23,56,-33,22
Montrose,889,1,23,8,5,59,34,25,77
Peterhead,889,2,24,4,8,84,38,46,76
Stirling,889,3,17,6,13,62,52,10,57
Stenhousem'r,889,4,15,8,13,56,48,8,53
Clyde,889,5,14,9,13,51,50,1,51
Elgin,889,6,14,7,15,53,60,-7,49
Annan Athlet,889,7,11,11,14,48,43,5,44
Berwick,889,8,9,10,17,31,58,-27,37
Edinburgh Ci,889,9,7,9,20,36,67,-31,30
Cowdenbeath,889,10,5,10,21,25,55,-30,25
Montrose,890,1,24,7,5,63,35,28,79
Peterhead,890,2,24,4,8,79,38,41,76
Stenhousem'r,890,3,16,8,12,57,47,10,56
Stirling,890,4,16,6,14,61,53,8,54
Clyde,890,5,15,9,12,55,49,6,54
Elgin,890,6,14,6,16,54,64,-10,48
Annan Athlet,890,7,12,11,13,50,43,7,47
Berwick,890,8,8,10,18,30,62,-32,34
Edinburgh Ci,890,9,7,9,20,36,62,-26,30
Cowdenbeath,890,10,4,10,22,25,57,-32,22
Montrose,891,1,24,7,5,62,35,27,79
Peterhead,891,2,24,4,8,80,39,41,76
Stirling,891,3,16,7,13,63,54,9,55
Stenhousem'r,891,4,15,9,12,58,49,9,54
Clyde,891,5,14,9,13,52,50,2,51
Elgin,891,6,14,6,16,54,63,-9,48
Annan Athlet,891,7,11,12,13,47,41,6,45
Berwick,891,8,9,10,17,31,59,-28,37
Edinburgh Ci,891,9,7,9,20,37,63,-26,30
Cowdenbeath,891,10,4,11,21,23,54,-31,23
Montrose,892,1,24,7,5,60,34,26,79
Peterhead,892,2,24,4,8,83,39,44,76
Stirling,892,3,17,6,13,62,52,10,57
Stenhousem'r,892,4,15,8,13,56,48,8,53
Clyde,892,5,14,10,12,52,49,3,52
Elgin,892,6,14,6,16,53,61,-8,48
Annan Athlet,892,7,12,11,13,48,41,7,47
Berwick,892,8,8,11,17,30,59,-29,35
Edinburgh Ci,892,9,7,9,20,37,66,-29,30
Cowdenbeath,892,10,4,10,22,23,55,-32,22
Montrose,893,1,24,7,5,62,36,26,79
Peterhead,893,2,24,4,8,79,39,40,76
Stenhousem'r,893,3,16,8,12,58,46,12,56
Stirling,893,4,16,6,14,60,54,6,54
Clyde,893,5,14,9,13,51,50,1,51
Elgin,893,6,14,6,16,55,63,-8,48
Annan Athlet,893,7,12,11,13,48,41,7,47
Berwick,893,8,9,10,17,31,58,-27,37
Edinburgh Ci,893,9,7,9,20,37,62,-25,30
Cowdenbeath,893,10,4,10,22,23,55,-32,22
Montrose,894,1,23,8,5,60,35,25,77
Peterhead,894,2,24,4,8,80,39,41,76
Stirling,894,3,17,6,13,63,52,11,57
Clyde,894,4,15,9,12,53,48,5,54
Stenhousem'r,894,5,15,8,13,56,49,7,53
Elgin,894,6,14,7,15,54,61,-7,49
Annan Athlet,894,7,11,11,14,48,43,5,44
Berwick,894,8,8,10,18,29,60,-31,34
Edinburgh Ci,894,9,7,9,20,37,63,-26,30
Cowdenbeath,894,10,5,10,21,25,55,-30,25
Montrose,895,1,23,8,5,60,35,25,77
Peterhead,895,2,24,4,8,78,38,40,76
Stirling,895,3,17,6,13,64,52,12,57
Stenhousem'r,895,4,15,8,13,56,50,6,53
Clyde,895,5,14,10,12,52,49,3,52
Elgin,895,6,14,7,15,54,61,-7,49
Annan Athlet,895,7,12,11,13,49,42,7,47
Berwick,895,8,8,11,17,30,59,-29,35
Edinburgh Ci,895,9,7,9,20,36,61,-25,30
Cowdenbeath,895,10,4,10,22,24,56,-32,22
Montrose,896,1,24,7,5,60,34,26,79
Peterhead,896,2,24,4,8,78,38,40,76
Stirling,896,3,17,6,13,62,52,10,57
Clyde,896,4,15,9,12,55,51,4,54
Stenhousem'r,896,5,15,8,13,56,48,8,53
Elgin,896,6,14,6,16,53,61,-8,48
Annan Athlet,896,7,11,12,13,48,42,6,45
Berwick,896,8,8,10,18,32,62,-30,34
Edinburgh Ci,896,9,7,9,20,36,61,-25,30
Cowdenbeath,896,10,4,11,21,24,55,-31,23
Montrose,897,1,23,8,5,61,36,25,77
Peterhead,897,2,24,4,8,80,38,42,76
Stirling,897,3,16,7,13,61,52,9,55
Stenhousem'r,897,4,15,9,12,56,47,9,54
Clyde,897,5,14,10,12,51,48,3,52
Elgin,897,6,14,7,15,55,62,-7,49
Annan Athlet,897,7,11,11,14,48,44,4,44
Berwick,897,8,8,11,17,29,58,-29,35
Edinburgh Ci,897,9,7,9,20,36,63,-27,30
Cowdenbeath,897,10,5,10,21,26,55,-29,25
Montrose,898,1,23,8,5,60,35,25,77
Peterhead,898,2,24,4,8,81,39,42,76
Stirling,898,3,17,6,13,64,51,13,57
Clyde,898,4,15,9,12,53,49,4,54
Stenhousem'r,898,5,15,8,13,55,50,5,53
Elgin,898,6,14,7,15,54,61,-7,49
Annan Athlet,898,7,12,11,13,48,41,7,47
Berwick,898,8,8,10,18,30,60,-30,34
Edinburgh Ci,898,9,7,9,20,37,64,-27,30
Cowdenbeath,898,10,4,10,22,23,55,-32,22
Montrose,899,1,24,7,5,61,35,26,79
Peterhead,899,2,24,4,8,86,40,46,76
Stirling,899,3,17,6,13,62,52,10,57
Clyde,899,4,15,9,12,53,49,4,54
Stenhousem'r,899,5,15,8,13,56,48,8,53
Elgin,899,6,14,6,16,54,62,-8,48
Annan Athlet,899,7,12,11,13,49,41,8,47
Berwick,899,8,8,10,18,30,60,-30,34
Edinburgh Ci,899,9,7,9,20,38,69,-31,30
Cowdenbeath,899,10,4,10,22,23,56,-33,22
Montrose,900,1,24,7,5,62,34,28,79
Peterhead,900,2,23,5,8,79,40,39,74
Stenhousem'r,900,3,16,8,12,57,46,11,56
Stirling,900,4,16,6,14,60,53,7,54
Clyde,900,5,15,9,12,53,49,4,54
Elgin,900,6,14,6,16,53,63,-10,48
Annan Athlet,900,7,12,11,13,49,41,8,47
Berwick,900,8,8,10,18,30,60,-30,34
Edinburgh Ci,900,9,7,10,19,38,62,-24,31
Cowdenbeath,900,10,4,10,22,23,56,-33,22
Montrose,901,1,24,7,5,62,34,28,79
Peterhead,901,2,23,5,8,79,40,39,74
Stirling,901,3,17,6,13,63,52,11,57
Clyde,901,4,15,9,12,53,48,5,54
Stenhousem'r,901,5,15,8,13,56,49,7,53
Elgin,901,6,14,6,16,53,63,-10,48
Annan Athlet,901,7,11,11,14,47,42,5,44
Berwick,901,8,8,10,18,29,60,-31,34
Edinburgh Ci,901,9,7,10,19,38,62,-24,31
Cowdenbeath,901,10,5,10,21,24,54,-30,25
Montrose,902,1,24,7,5,62,35,27,79
Peterhead,902,2,24,4,8,81,40,41,76
Stirling,902,3,17,6,13,65,52,13,57
Clyde,902,4,15,9,12,55,48,7,54
Stenhousem'r,902,5,15,8,13,56,51,5,53
Elgin,902,6,14,6,16,54,63,-9,48
Annan Athlet,902,7,12,11,13,48,41,7,47
Berwick,902,8,8,10,18,29,62,-33,34
Edinburgh Ci,902,9,7,9,20,38,64,-26,30
Cowdenbeath,902,10,4,10,22,23,55,-32,22
Montrose,903,1,24,7,5,63,35,28,79
Peterhead,903,2,23,5,8,78,39,39,74
Stirling,903,3,17,6,13,62,51,11,57
Stenhousem'r,903,4,15,8,13,55,48,7,53
Clyde,903,5,14,10,12,52,49,3,52
Elgin,903,6,14,6,16,54,64,-10,48
Annan Athlet,903,7,11,11,14,47,42,5,44
Berwick,903,8,8,11,17,30,59,-29,35
Edinburgh Ci,903,9,7,10,19,37,61,-24,31
Cowdenbeath,903,10,5,10,21,24,54,-30,25
Montrose,904,1,23,8,5,59,34,25,77
Peterhead,904,2,24,4,8,79,38,41,76
Stirling,904,3,16,7,13,62,53,9,55
Stenhousem'r,904,4,15,9,12,57,48,9,54
Clyde,904,5,14,9,13,51,49,2,51
Elgin,904,6,14,7,15,53,60,-7,49
Annan Athlet,904,7,12,11,13,50,42,8,47
Berwick,904,8,9,10,17,30,58,-28,37
Edinburgh Ci,904,9,7,9,20,36,62,-26,30
Cowdenbeath,904,10,4,10,22,24,57,-33,22
Montrose,905,1,23,8,5,60,35,25,77
Peterhead,905,2,24,4,8,79,38,41,76
Stirling,905,3,17,6,13,61,51,10,57
Stenhousem'r,905,4,15,8,13,55,47,8,53
Clyde,905,5,14,10,12,52,49,3,52
Elgin,905,6,14,7,15,54,61,-7,49
Annan Athlet,905,7,12,11,13,51,43,8,47
Berwick,905,8,8,11,17,30,59,-29,35
Edinburgh Ci,905,9,7,9,20,36,62,-26,30
Cowdenbeath,905,10,4,10,22,25,58,-33,22
Montrose,906,1,23,8,5,59,34,25,77
Peterhead,906,2,24,4,8,80,38,42,76
Stirling,906,3,16,7,13,63,54,9,55
Stenhousem'r,906,4,15,9,12,58,49,9,54
Clyde,906,5,15,9,12,53,49,4,54
Elgin,906,6,14,7,15,53,60,-7,49
Annan Athlet,906,7,11,12,13,47,41,6,45
Berwick,906,8,8,10,18,30,60,-30,34
Edinburgh Ci,906,9,7,9,20,36,63,-27,30
Cowdenbeath,906,10,4,11,21,23,54,-31,23
Montrose,907,1,24,7,5,61,35,26,79
Peterhead,907,2,24,4,8,85,39,46,76
Stirling,907,3,17,6,13,64,54,10,57
Clyde,907,4,15,9,12,55,51,4,54
Stenhousem'r,907,5,15,8,13,58,50,8,53
Elgin,907,6,14,6,16,54,62,-8,48
Annan Athlet,907,7,12,11,13,49,42,7,47
Berwick,907,8,8,10,18,32,62,-30,34
Edinburgh Ci,907,9,7,9,20,37,68,-31,30
Cowdenbeath,907,10,4,10,22,24,56,-32,22
Montrose,908,1,24,7,5,62,34,28,79
Peterhead,908,2,24,4,8,80,40,40,76
Stirling,908,3,17,6,13,62,52,10,57
Stenhousem'r,908,4,15,8,13,56,48,8,53
Clyde,908,5,14,9,13,52,51,1,51
Elgin,908,6,14,6,16,53,63,-10,48
Annan Athlet,908,7,11,11,14,47,42,5,44
Berwick,908,8,9,10,17,32,59,-27,37
Edinburgh Ci,908,9,7,9,20,38,63,-25,30
Cowdenbeath,908,10,5,10,21,24,54,-30,25
Montrose,909,1,24,7,5,62,35,27,79
Peterhead,909,2,24,4,8,79,38,41,76
Stenhousem'r,909,3,16,8,12,58,47,11,56
Stirling,909,4,16,6,14,61,54,7,54
Clyde,909,5,15,9,12,54,48,6,54
Elgin,909,6,14,6,16,54,63,-9,48
Annan Athlet,909,7,11,12,13,47,41,6,45
Berwick,909,8,8,10,18,29,61,-32,34
Edinburgh Ci,909,9,7,9,20,36,62,-26,30
Cowdenbeath,909,10,4,11,21,23,54,-31,23
Montrose,910,1,23,7,6,59,36,23,76
Peterhead,910,2,23,5,8,77,38,39,74
Stirling,910,3,17,6,13,61,51,10,57
Clyde,910,4,15,9,12,53,48,5,54
Stenhousem'r,910,5,15,8,13,55,47,8,53
Elgin,910,6,15,6,15,55,60,-5,51
Annan Athlet,910,7,12,11,13,49,42,7,47
Berwick,910,8,8,10,18,29,60,-31,34
Edinburgh Ci,910,9,7,10,19,36,60,-24,31
Cowdenbeath,910,10,4,10,22,24,56,-32,22
Montrose,911,1,24,7,5,62,35,27,79
Peterhead,911,2,24,4,8,80,40,40,76
Stirling,911,3,17,6,13,64,54,10,57
Clyde,911,4,15,9,12,57,48,9,54
Stenhousem'r,911,5,15,8,13,58,50,8,53
Elgin,911,6,14,6,16,54,63,-9,48
Annan Athlet,911,7,11,11,14,47,43,4,44
Berwick,911,8,8,10,18,29,64,-35,34
Edinburgh Ci,911,9,7,9,20,38,63,-25,30
Cowdenbeath,911,10,5,10,21,25,54,-29,25
Montrose,912,1,23,7,6,59,35,24,76
Peterhead,912,2,23,5,8,78,39,39,74
Stirling,912,3,16,7,13,61,52,9,55
Stenhousem'r,912,4,15,9,12,56,47,9,54
Clyde,912,5,15,9,12,53,48,5,54
Elgin,912,6,15,6,15,54,60,-6,51
Annan Athlet,912,7,11,12,13,47,41,6,45
Berwick,912,8,8,10,18,29,60,-31,34
Edinburgh Ci,912,9,7,10,19,37,61,-24,31
Cowdenbeath,912,10,4,11,21,23,54,-31,23
Montrose,913,1,24,7,5,63,37,26,79
Peterhead,913,2,24,4,8,79,39,40,76
Stenhousem'r,913,3,16,8,12,58,47,11,56
Stirling,913,4,16,6,14,61,54,7,54
Clyde,913,5,14,10,12,52,49,3,52
Elgin,913,6,14,6,16,56,64,-8,48
Annan Athlet,913,7,12,11,13,50,41,9,47
Berwick,913,8,8,11,17,30,59,-29,35
Edinburgh Ci,913,9,7,9,20,37,62,-25,30
Cowdenbeath,913,10,4,10,22,23,57,-34,22
Montrose,914,1,24,7,5,63,34,29,79
Peterhead,914,2,24,4,8,78,38,40,76
Stirling,914,3,17,6,13,64,51,13,57
Clyde,914,4,15,9,12,53,49,4,54
Stenhousem'r,914,5,15,8,13,55,50,5,53
Elgin,914,6,14,6,16,53,64,-11,48
Annan Athlet,914,7,12,11,13,48,41,7,47
Berwick,914,8,8,10,18,30,60,-30,34
Edinburgh Ci,914,9,7,9,20,36,61,-25,30
Cowdenbeath,914,10,4,10,22,23,55,-32,22
Peterhead,915,1,24,4,8,81,39,42,76
Montrose,915,2,23,7,6,60,36,24,76
Stenhousem'r,915,3,16,8,12,58,48,10,56
Stirling,915,4,16,6,14,62,54,8,54
Clyde,915,5,15,9,12,56,48,8,54
Elgin,915,6,15,6,15,55,61,-6,51
Annan Athlet,915,7,11,12,13,47,41,6,45
Berwick,915,8,8,10,18,29,63,-34,34
Edinburgh Ci,915,9,7,9,20,37,64,-27,30
Cowdenbeath,915,10,4,11,21,23,54,-31,23
Montrose,916,1,23,8,5,60,35,25,77
Peterhead,916,2,24,4,8,80,38,42,76
Stirling,916,3,17,6,13,63,51,12,57
Stenhousem'r,916,4,15,8,13,55,49,6,53
Clyde,916,5,14,10,12,52,49,3,52
Elgin,916,6,14,7,15,54,61,-7,49
Annan Athlet,916,7,12,11,13,49,41,8,47
Berwick,916,8,8,11,17,30,59,-29,35
Edinburgh Ci,916,9,7,9,20,36,63,-27,30
Cowdenbeath,916,10,4,10,22,23,56,-33,22
Montrose,917,1,24,7,5,62,34,28,79
Peterhead,917,2,24,4,8,79,39,40,76
Stenhousem'r,917,3,16,8,12,56,46,10,56
Stirling,917,4,16,6,14,60,52,8,54
Clyde,917,5,15,9,12,53,48,5,54
Elgin,917,6,14,6,16,53,63,-10,48
Annan Athlet,917,7,11,12,13,47,41,6,45
Berwick,917,8,8,10,18,29,60,-31,34
Edinburgh Ci,917,9,7,9,20,37,62,-25,30
Cowdenbeath,917,10,4,11,21,23,54,-31,23
Montrose,918,1,23,8,5,62,37,25,77
Peterhead,918,2,24,4,8,81,39,42,76
Stirling,918,3,17,6,13,61,51,10,57
Stenhousem'r,918,4,15,8,13,55,47,8,53
Clyde,918,5,14,9,13,52,51,1,51
Elgin,918,6,14,7,15,56,63,-7,49
Annan Athlet,918,7,12,11,13,49,42,7,47
Berwick,918,8,9,10,17,32,59,-27,37
Edinburgh Ci,918,9,7,9,20,37,64,-27,30
Cowdenbeath,918,10,4,10,22,24,56,-32,22
Montrose,919,1,23,8,5,59,34,25,77
Peterhead,919,2,24,4,8,80,39,41,76
Stirling,919,3,17,6,13,61,51,10,57
Stenhousem'r,919,4,15,8,13,55,47,8,53
Clyde,919,5,14,9,13,53,52,1,51
Elgin,919,6,14,7,15,53,60,-7,49
Annan Athlet,919,7,11,11,14,49,44,5,44
Berwick,919,8,9,10,17,33,60,-27,37
Edinburgh Ci,919,9,7,9,20,37,63,-26,30
Cowdenbeath,919,10,5,10,21,26,56,-30,25
Montrose,920,1,24,7,5,61,35,26,79
Peterhead,920,2,24,4,8,79,39,40,76
Stirling,920,3,17,6,13,63,51,12,57
Stenhousem'r,920,4,15,8,13,55,49,6,53
Clyde,920,5,14,10,12,53,50,3,52
Elgin,920,6,14,6,16,54,62,-8,48
Annan Athlet,920,7,11,12,13,48,42,6,45
Berwick,920,8,8,11,17,31,60,-29,35
Edinburgh Ci,920,9,7,9,20,37,62,-25,30
Cowdenbeath,920,10,4,11,21,24,55,-31,23
Montrose,921,1,24,7,5,63,36,27,79
Peterhead,921,2,24,4,8,84,38,46,76
Stirling,921,3,17,6,13,62,51,11,57
Clyde,921,4,15,9,12,56,49,7,54
Stenhousem'r,921,5,15,8,13,55,48,7,53
Elgin,921,6,14,6,16,55,64,-9,48
Annan Athlet,921,7,11,12,13,47,41,6,45
Berwick,921,8,8,10,18,30,63,-33,34
Edinburgh Ci,921,9,7,9,20,36,67,-31,30
Cowdenbeath,921,10,4,11,21,23,54,-31,23
Montrose,922,1,23,8,5,60,35,25,77
Peterhead,922,2,24,4,8,79,39,40,76
Stirling,922,3,16,7,13,62,53,9,55
Stenhousem'r,922,4,15,9,12,57,48,9,54
Clyde,922,5,14,10,12,52,49,3,52
Elgin,922,6,14,7,15,54,61,-7,49
Annan Athlet,922,7,12,11,13,50,42,8,47
Berwick,922,8,8,11,17,30,59,-29,35
Edinburgh Ci,922,9,7,9,20,37,62,-25,30
Cowdenbeath,922,10,4,10,22,24,57,-33,22
Montrose,923,1,24,7,5,61,35,26,79
Peterhead,923,2,23,4,9,77,40,37,73
Stirling,923,3,17,6,13,63,52,11,57
Clyde,923,4,15,9,12,53,48,5,54
Stenhousem'r,923,5,15,8,13,56,49,7,53
Elgin,923,6,14,6,16,54,62,-8,48
Annan Athlet,923,7,12,11,13,49,42,7,47
Berwick,923,8,8,10,18,29,60,-31,34
Edinburgh Ci,923,9,8,9,19,38,60,-22,33
Cowdenbeath,923,10,4,10,22,24,56,-32,22
Montrose,924,1,24,7,5,62,36,26,79
Peterhead,924,2,24,4,8,82,39,43,76
Stirling,924,3,16,7,13,62,53,9,55
Stenhousem'r,924,4,15,9,12,57,48,9,54
Clyde,924,5,15,9,12,53,48,5,54
Elgin,924,6,14,6,16,55,63,-8,48
Annan Athlet,924,7,12,11,13,49,41,8,47
Berwick,924,8,8,10,18,29,60,-31,34
Edinburgh Ci,924,9,7,9,20,37,65,-28,30
Cowdenbeath,924,10,4,10,22,23,56,-33,22
Montrose,925,1,23,7,6,59,36,23,76
Peterhead,925,2,23,4,9,78,40,38,73
Stirling,925,3,17,6,13,62,52,10,57
Stenhousem'r,925,4,15,8,13,56,48,8,53
Clyde,925,5,14,9,13,52,50,2,51
Elgin,925,6,15,6,15,55,60,-5,51
Annan Athlet,925,7,11,12,13,47,41,6,45
Berwick,925,8,9,10,17,31,59,-28,37
Edinburgh Ci,925,9,8,9,19,38,61,-23,33
Cowdenbeath,925,10,4,11,21,23,54,-31,23
Montrose,926,1,23,8,5,61,36,25,77
Peterhead,926,2,24,4,8,80,38,42,76
Stenhousem'r,926,3,16,8,12,57,47,10,56
Stirling,926,4,16,6,14,61,53,8,54
Clyde,926,5,15,9,12,53,49,4,54
Elgin,926,6,14,7,15,55,62,-7,49
Annan Athlet,926,7,11,11,14,47,42,5,44
Berwick,926,8,8,10,18,30,60,-30,34
Edinburgh Ci,926,9,7,9,20,36,63,-27,30
Cowdenbeath,926,10,5,10,21,24,54,-30,25
Montrose,927,1,24,7,5,63,35,28,79
Peterhead,927,2,23,5,8,78,39,39,74
Stenhousem'r,927,3,16,8,12,57,46,11,56
Stirling,927,4,16,6,14,60,53,7,54
Clyde,927,5,15,9,12,53,49,4,54
Elgin,927,6,14,6,16,54,64,-10,48
Annan Athlet,927,7,11,12,13,49,43,6,45
Berwick,927,8,8,10,18,30,60,-30,34
Edinburgh Ci,927,9,7,10,19,37,61,-24,31
Cowdenbeath,927,10,4,11,21,25,56,-31,23
Montrose,928,1,24,7,5,65,34,31,79
Peterhead,928,2,24,4,8,79,39,40,76
Stirling,928,3,17,6,13,63,51,12,57
Stenhousem'r,928,4,15,8,13,55,49,6,53
Clyde,928,5,14,10,12,52,49,3,52
Elgin,928,6,14,6,16,53,66,-13,48
Annan Athlet,928,7,11,12,13,48,42,6,45
Berwick,928,8,8,11,17,30,59,-29,35
Edinburgh Ci,928,9,7,9,20,37,62,-25,30
Cowdenbeath,928,10,4,11,21,24,55,-31,23
Montrose,929,1,24,7,5,60,34,26,79
Peterhead,929,2,23,4,9,78,41,37,73
Stirling,929,3,16,7,13,61,52,9,55
Stenhousem'r,929,4,15,9,12,56,47,9,54
Clyde,929,5,14,9,13,51,50,1,51
Elgin,929,6,14,6,16,53,61,-8,48
Annan Athlet,929,7,11,11,14,47,42,5,44
Berwick,929,8,9,10,17,31,58,-27,37
Edinburgh Ci,929,9,8,9,19,39,61,-22,33
Cowdenbeath,929,10,5,10,21,24,54,-30,25
Montrose,930,1,24,7,5,62,34,28,79
Peterhead,930,2,24,4,8,84,38,46,76
Stirling,930,3,17,6,13,63,53,10,57
Clyde,930,4,15,9,12,53,49,4,54
Stenhousem'r,930,5,15,8,13,57,49,8,53
Elgin,930,6,14,6,16,53,63,-10,48
Annan Athlet,930,7,12,11,13,49,41,8,47
Berwick,930,8,8,10,18,30,60,-30,34
Edinburgh Ci,930,9,7,9,20,36,67,-31,30
Cowdenbeath,930,10,4,10,22,23,56,-33,22
Montrose,931,1,23,7,6,59,35,24,76
Peterhead,931,2,23,4,9,77,40,37,73
Stirling,931,3,16,7,13,60,51,9,55
Clyde,931,4,15,9,12,58,49,9,54
Stenhousem'r,931,5,15,9,12,55,46,9,54
Elgin,931,6,15,6,15,54,60,-6,51
Annan Athlet,931,7,12,11,13,49,41,8,47
Berwick,931,8,8,10,18,30,65,-35,34
Edinburgh Ci,931,9,8,9,19,38,60,-22,33
Cowdenbeath,931,10,4,10,22,23,56,-33,22
Montrose,932,1,24,7,5,60,34,26,79
Peterhead,932,2,23,4,9,78,40,38,73
Stirling,932,3,17,6,13,61,51,10,57
Clyde,932,4,15,9,12,53,48,5,54
Stenhousem'r,932,5,15,8,13,55,47,8,53
Elgin,932,6,14,6,16,53,61,-8,48
Annan Athlet,932,7,11,12,13,48,42,6,45
Berwick,932,8,8,10,18,29,60,-31,34
Edinburgh Ci,932,9,8,9,19,38,61,-23,33
Cowdenbeath,932,10,4,11,21,24,55,-31,23
Montrose,933,1,23,7,6,60,38,22,76
Peterhead,933,2,23,5,8,78,39,39,74
Stirling,933,3,16,7,13,61,52,9,55
Stenhousem'r,933,4,15,9,12,56,47,9,54
Clyde,933,5,15,9,12,53,48,5,54
Elgin,933,6,15,6,15,57,61,-4,51
Annan Athlet,933,7,11,11,14,49,44,5,44
Berwick,933,8,8,10,18,29,60,-31,34
Edinburgh Ci,933,9,7,10,19,37,61,-24,31
Cowdenbeath,933,10,5,10,21,26,56,-30,25
Montrose,934,1,23,8,5,61,36,25,77
Peterhead,934,2,24,4,8,79,39,40,76
Stirling,934,3,17,6,13,62,51,11,57
Clyde,934,4,15,9,12,53,48,5,54
Stenhousem'r,934,5,15,8,13,55,48,7,53
Elgin,934,6,14,7,15,55,62,-7,49
Annan Athlet,934,7,11,12,13,48,42,6,45
Berwick,934,8,8,10,18,29,60,-31,34
Edinburgh Ci,934,9,7,9,20,37,62,-25,30
Cowdenbeath,934,10,4,11,21,24,55,-31,23
Montrose,935,1,24,7,5,62,35,27,79
Peterhead,935,2,24,4,8,81,39,42,76
Stirling,935,3,16,7,13,61,52,9,55
Stenhousem'r,935,4,15,9,12,56,47,9,54
Clyde,935,5,14,9,13,52,50,2,51
Elgin,935,6,14,6,16,54,63,-9,48
Annan Athlet,935,7,11,12,13,48,42,6,45
Berwick,935,8,9,10,17,31,59,-28,37
Edinburgh Ci,935,9,7,9,20,37,64,-27,30
Cowdenbeath,935,10,4,11,21,24,55,-31,23
Montrose,936,1,24,7,5,63,35,28,79
Peterhead,936,2,24,4,8,79,39,40,76
Stirling,936,3,16,7,13,60,51,9,55
Stenhousem'r,936,4,15,9,12,55,46,9,54
Clyde,936,5,15,9,12,54,48,6,54
Elgin,936,6,14,6,16,54,64,-10,48
Annan Athlet,936,7,12,11,13,49,41,8,47
Berwick,936,8,8,10,18,29,61,-32,34
Edinburgh Ci,936,9,7,9,20,37,62,-25,30
Cowdenbeath,936,10,4,10,22,23,56,-33,22
Peterhead,937,1,24,4,8,78,38,40,76
Montrose,937,2,23,7,6,60,38,22,76
Stenhousem'r,937,3,16,8,12,57,46,11,56
Stirling,937,4,16,6,14,60,53,7,54
Clyde,937,5,15,9,12,54,49,5,54
Elgin,937,6,15,6,15,57,61,-4,51
Annan Athlet,937,7,12,11,13,51,41,10,47
Berwick,937,8,8,10,18,30,61,-31,34
Edinburgh Ci,937,9,7,9,20,36,61,-25,30
Cowdenbeath,937,10,4,10,22,23,58,-35,22
Montrose,938,1,24,7,5,61,34,27,79
Peterhead,938,2,23,4,9,78,41,37,73
Stirling,938,3,17,6,13,62,52,10,57
Clyde,938,4,15,9,12,52,48,4,54
Stenhousem'r,938,5,15,8,13,56,48,8,53
Elgin,938,6,14,6,16,53,62,-9,48
Annan Athlet,938,7,11,11,14,47,42,5,44
Berwick,938,8,8,10,18,29,59,-30,34
Edinburgh Ci,938,9,8,9,19,39,61,-22,33
Cowdenbeath,938,10,5,10,21,24,54,-30,25
Peterhead,939,1,24,4,8,78,38,40,76
Montrose,939,2,23,7,6,61,37,24,76
Stirling,939,3,16,7,13,60,51,9,55
Stenhousem'r,939,4,15,9,12,55,46,9,54
Clyde,939,5,15,9,12,53,49,4,54
Elgin,939,6,15,6,15,56,62,-6,51
Annan Athlet,939,7,12,11,13,50,41,9,47
Berwick,939,8,8,10,18,30,60,-30,34
Edinburgh Ci,939,9,7,9,20,36,61,-25,30
Cowdenbeath,939,10,4,10,22,23,57,-34,22
Montrose,940,1,23,8,5,60,35,25,77
Peterhead,940,2,23,4,9,78,40,38,73
Stirling,940,3,17,6,13,69,51,18,57
Clyde,940,4,15,9,12,54,49,5,54
Stenhousem'r,940,5,15,8,13,55,55,0,53
Elgin,940,6,14,7,15,54,61,-7,49
Annan Athlet,940,7,11,12,13,47,41,6,45
Berwick,940,8,8,10,18,30,61,-31,34
Edinburgh Ci,940,9,8,9,19,38,61,-23,33
Cowdenbeath,940,10,4,11,21,23,54,-31,23
Montrose,941,1,24,7,5,60,34,26,79
Peterhead,941,2,23,4,9,78,41,37,73
Stirling,941,3,17,6,13,64,54,10,57
Clyde,941,4,15,9,12,52,48,4,54
Stenhousem'r,941,5,15,8,13,58,50,8,53
Elgin,941,6,14,6,16,53,61,-8,48
Annan Athlet,941,7,12,11,13,50,42,8,47
Berwick,941,8,8,10,18,29,59,-30,34
Edinburgh Ci,941,9,8,9,19,39,61,-22,33
Cowdenbeath,941,10,4,10,22,24,57,-33,22
Montrose,942,1,24,7,5,62,34,28,79
Peterhead,942,2,24,4,8,81,39,42,76
Stenhousem'r,942,3,16,8,12,59,46,13,56
Clyde,942,4,15,9,12,54,48,6,54
Stirling,942,5,16,6,14,60,55,5,54
Elgin,942,6,14,6,16,53,63,-10,48
Annan Athlet,942,7,11,12,13,48,42,6,45
Berwick,942,8,8,10,18,29,61,-32,34
Edinburgh Ci,942,9,7,9,20,37,64,-27,30
Cowdenbeath,942,10,4,11,21,24,55,-31,23
Montrose,943,1,24,7,5,62,35,27,79
Peterhead,943,2,23,5,8,79,40,39,74
Stirling,943,3,17,6,13,63,52,11,57
Clyde,943,4,15,9,12,54,48,6,54
Stenhousem'r,943,5,15,8,13,56,49,7,53
Elgin,943,6,14,6,16,54,63,-9,48
Annan Athlet,943,7,12,11,13,48,41,7,47
Berwick,943,8,8,10,18,29,61,-32,34
Edinburgh Ci,943,9,7,10,19,38,62,-24,31
Cowdenbeath,943,10,4,10,22,23,55,-32,22
Peterhead,944,1,24,4,8,82,40,42,76
Montrose,944,2,23,7,6,59,35,24,76
Stenhousem'r,944,3,16,8,12,57,46,11,56
Stirling,944,4,16,6,14,60,53,7,54
Clyde,944,5,15,9,12,53,48,5,54
Elgin,944,6,15,6,15,54,60,-6,51
Annan Athlet,944,7,11,12,13,48,42,6,45
Berwick,944,8,8,10,18,29,60,-31,34
Edinburgh Ci,944,9,7,9,20,38,65,-27,30
Cowdenbeath,944,10,4,11,21,24,55,-31,23
Montrose,945,1,24,7,5,61,34,27,79
Peterhead,945,2,24,4,8,81,38,43,76
Stirling,945,3,16,7,13,61,52,9,55
Stenhousem'r,945,4,15,9,12,56,47,9,54
Clyde,945,5,15,9,12,54,49,5,54
Elgin,945,6,14,6,16,53,62,-9,48
Annan Athlet,945,7,12,11,13,49,42,7,47
Berwick,945,8,8,10,18,30,61,-31,34
Edinburgh Ci,945,9,7,9,20,36,64,-28,30
Cowdenbeath,945,10,4,10,22,24,56,-32,22
Montrose,946,1,24,7,5,63,37,26,79
Peterhead,946,2,24,4,8,78,38,40,76
Stirling,946,3,16,7,13,62,53,9,55
Stenhousem'r,946,4,15,9,12,57,48,9,54
Clyde,946,5,14,9,13,51,49,2,51
Elgin,946,6,14,6,16,56,64,-8,48
Annan Athlet,946,7,11,11,14,47,42,5,44
Berwick,946,8,9,10,17,30,58,-28,37
Edinburgh Ci,946,9,7,9,20,36,61,-25,30
Cowdenbeath,946,10,5,10,21,24,54,-30,25
Peterhead,947,1,24,4,8,82,38,44,76
Montrose,947,2,23,7,6,60,36,24,76
Stenhousem'r,947,3,16,8,12,57,47,10,56
Stirling,947,4,16,6,14,61,53,8,54
Clyde,947,5,14,10,12,52,49,3,52
Elgin,947,6,15,6,15,55,61,-6,51
Annan Athlet,947,7,11,11,14,47,42,5,44
Berwick,947,8,8,11,17,30,59,-29,35
Edinburgh Ci,947,9,7,9,20,36,65,-29,30
Cowdenbeath,947,10,5,10,21,24,54,-30,25
Montrose,948,1,24,7,5,62,34,28,79
Peterhead,948,2,24,4,8,81,39,42,76
Stirling,948,3,17,6,13,61,51,10,57
Stenhousem'r,948,4,15,8,13,55,47,8,53
Clyde,948,5,14,9,13,52,52,0,51
Elgin,948,6,14,6,16,53,63,-10,48
Annan Athlet,948,7,12,11,13,49,41,8,47
Berwick,948,8,9,10,17,33,59,-26,37
Edinburgh Ci,948,9,7,9,20,37,64,-27,30
Cowdenbeath,948,10,4,10,22,23,56,-33,22
Montrose,949,1,23,8,5,60,35,25,77
Peterhead,949,2,24,4,8,81,39,42,76
Stirling,949,3,17,6,13,62,52,10,57
Clyde,949,4,15,9,12,54,49,5,54
Stenhousem'r,949,5,15,8,13,56,48,8,53
Elgin,949,6,14,7,15,54,61,-7,49
Annan Athlet,949,7,12,11,13,49,41,8,47
Berwick,949,8,8,10,18,30,61,-31,34
Edinburgh Ci,949,9,7,9,20,37,64,-27,30
Cowdenbeath,949,10,4,10,22,23,56,-33,22
Peterhead,950,1,24,4,8,79,39,40,76
Montrose,950,2,23,7,6,60,36,24,76
Stirling,950,3,17,6,13,62,52,10,57
Clyde,950,4,15,9,12,55,49,6,54
Stenhousem'r,950,5,15,8,13,56,48,8,53
Elgin,950,6,15,6,15,55,61,-6,51
Annan Athlet,950,7,11,12,13,49,43,6,45
Berwick,950,8,8,10,18,30,62,-32,34
Edinburgh Ci,950,9,7,9,20,37,62,-25,30
Cowdenbeath,950,10,4,11,21,25,56,-31,23
Montrose,951,1,24,7,5,61,35,26,79
Peterhead,951,2,24,4,8,82,38,44,76
Stirling,951,3,17,6,13,62,51,11,57
Clyde,951,4,15,9,12,56,50,6,54
Stenhousem'r,951,5,15,8,13,55,48,7,53
Elgin,951,6,14,6,16,54,62,-8,48
Annan Athlet,951,7,11,11,14,47,42,5,44
Berwick,951,8,8,10,18,31,63,-32,34
Edinburgh Ci,951,9,7,9,20,36,65,-29,30
Cowdenbeath,951,10,5,10,21,24,54,-30,25
Montrose,952,1,24,7,5,60,34,26,79
Peterhead,952,2,24,4,8,80,38,42,76
Stirling,952,3,16,7,13,62,53,9,55
Stenhousem'r,952,4,15,9,12,57,48,9,54
Clyde,952,5,14,9,13,52,50,2,51
Elgin,952,6,14,6,16,53,61,-8,48
Annan Athlet,952,7,12,11,13,50,42,8,47
Berwick,952,8,9,10,17,31,59,-28,37
Edinburgh Ci,952,9,7,9,20,36,63,-27,30
Cowdenbeath,952,10,4,10,22,24,57,-33,22
Montrose,953,1,23,7,6,60,39,21,76
Peterhead,953,2,23,5,8,79,40,39,74
Stirling,953,3,17,6,13,63,51,12,57
Clyde,953,4,15,9,12,54,49,5,54
Stenhousem'r,953,5,15,8,13,55,49,6,53
Elgin,953,6,15,6,15,58,61,-3,51
Annan Athlet,953,7,11,12,13,47,41,6,45
Berwick,953,8,8,10,18,30,61,-31,34
Edinburgh Ci,953,9,7,10,19,38,62,-24,31
Cowdenbeath,953,10,4,11,21,23,54,-31,23
Montrose,954,1,24,7,5,63,36,27,79
Peterhead,954,2,24,4,8,79,38,41,76
Stirling,954,3,17,6,13,62,52,10,57
Stenhousem'r,954,4,15,8,13,56,48,8,53
Clyde,954,5,14,9,13,51,49,2,51
Elgin,954,6,14,6,16,55,64,-9,48
Annan Athlet,954,7,12,11,13,48,41,7,47
Berwick,954,8,9,10,17,30,58,-28,37
Edinburgh Ci,954,9,7,9,20,36,62,-26,30
Cowdenbeath,954,10,4,10,22,23,55,-32,22
Peterhead,955,1,24,4,8,82,38,44,76
Montrose,955,2,23,7,6,61,37,24,76
Stirling,955,3,17,6,13,62,51,11,57
Stenhousem'r,955,4,15,8,13,55,48,7,53
Clyde,955,5,14,10,12,51,48,3,52
Elgin,955,6,15,6,15,56,62,-6,51
Annan Athlet,955,7,11,12,13,48,42,6,45
Berwick,955,8,8,11,17,29,58,-29,35
Edinburgh Ci,955,9,7,9,20,36,65,-29,30
Cowdenbeath,955,10,4,11,21,24,55,-31,23
Montrose,956,1,24,7,5,61,35,26,79
Peterhead,956,2,24,4,8,81,38,43,76
Stirling,956,3,16,7,13,62,53,9,55
Stenhousem'r,956,4,15,9,12,57,48,9,54
Clyde,956,5,15,9,12,55,48,7,54
Elgin,956,6,14,6,16,54,62,-8,48
Annan Athlet,956,7,12,11,13,48,41,7,47
Berwick,956,8,8,10,18,29,62,-33,34
Edinburgh Ci,956,9,7,9,20,36,64,-28,30
Cowdenbeath,956,10,4,10,22,23,55,-32,22
Montrose,957,1,24,7,5,62,34,28,79
Peterhead,957,2,24,4,8,81,40,41,76
Stenhousem'r,957,3,16,8,12,56,46,10,56
Stirling,957,4,16,6,14,60,52,8,54
Clyde,957,5,15,9,12,56,49,7,54
Elgin,957,6,14,6,16,53,63,-10,48
Annan Athlet,957,7,11,12,13,48,42,6,45
Berwick,957,8,8,10,18,30,63,-33,34
Edinburgh Ci,957,9,7,9,20,38,64,-26,30
Cowdenbeath,957,10,4,11,21,24,55,-31,23
Montrose,958,1,24,7,5,61,34,27,79
Peterhead,958,2,24,4,8,80,38,42,76
Stirling,958,3,17,6,13,62,51,11,57
Clyde,958,4,15,9,12,56,48,8,54
Stenhousem'r,958,5,15,8,13,55,48,7,53
Elgin,958,6,14,6,16,53,62,-9,48
Annan Athlet,958,7,11,12,13,47,41,6,45
Berwick,958,8,8,10,18,29,63,-34,34
Edinburgh Ci,958,9,7,9,20,36,63,-27,30
Cowdenbeath,958,10,4,11,21,23,54,-31,23
Montrose,959,1,24,7,5,62,36,26,79
Peterhead,959,2,24,4,8,79,38,41,76
Stirling,959,3,16,7,13,62,53,9,55
Stenhousem'r,959,4,15,9,12,57,48,9,54
Clyde,959,5,15,9,12,56,49,7,54
Elgin,959,6,14,6,16,55,63,-8,48
Annan Athlet,959,7,11,11,14,48,43,5,44
Berwick,959,8,8,10,18,30,63,-33,34
Edinburgh Ci,959,9,7,9,20,36,62,-26,30
Cowdenbeath,959,10,5,10,21,25,55,-30,25
Montrose,960,1,24,7,5,61,34,27,79
Peterhead,960,2,24,4,8,81,39,42,76
Stirling,960,3,16,7,13,60,51,9,55
Stenhousem'r,960,4,15,9,12,55,46,9,54
Clyde,960,5,15,9,12,55,50,5,54
Elgin,960,6,14,6,16,53,62,-9,48
Annan Athlet,960,7,11,12,13,48,42,6,45
Berwick,960,8,8,10,18,31,62,-31,34
Edinburgh Ci,960,9,7,9,20,37,64,-27,30
Cowdenbeath,960,10,4,11,21,24,55,-31,23
Montrose,961,1,24,7,5,62,34,28,79
Peterhead,961,2,24,4,8,81,38,43,76
Stirling,961,3,17,6,13,63,53,10,57
Stenhousem'r,961,4,15,8,13,57,49,8,53
Clyde,961,5,14,10,12,52,49,3,52
Elgin,961,6,14,6,16,53,63,-10,48
Annan Athlet,961,7,12,11,13,49,42,7,47
Berwick,961,8,8,11,17,30,59,-29,35
Edinburgh Ci,961,9,7,9,20,36,64,-28,30
Cowdenbeath,961,10,4,10,22,24,56,-32,22
Montrose,962,1,24,7,5,62,36,26,79
Peterhead,962,2,24,4,8,78,38,40,76
Stenhousem'r,962,3,16,8,12,57,47,10,56
Stirling,962,4,16,6,14,61,53,8,54
Clyde,962,5,14,10,12,53,50,3,52
Elgin,962,6,14,6,16,55,63,-8,48
Annan Athlet,962,7,12,11,13,48,41,7,47
Berwick,962,8,8,11,17,31,60,-29,35
Edinburgh Ci,962,9,7,9,20,36,61,-25,30
Cowdenbeath,962,10,4,10,22,23,55,-32,22
Peterhead,963,1,24,4,8,81,38,43,76
Montrose,963,2,23,7,6,59,35,24,76
Stirling,963,3,17,6,13,64,53,11,57
Clyde,963,4,15,9,12,52,48,4,54
Stenhousem'r,963,5,15,8,13,57,50,7,53
Elgin,963,6,15,6,15,54,60,-6,51
Annan Athlet,963,7,11,12,13,48,42,6,45
Berwick,963,8,8,10,18,29,59,-30,34
Edinburgh Ci,963,9,7,9,20,36,64,-28,30
Cowdenbeath,963,10,4,11,21,24,55,-31,23
Montrose,964,1,24,7,5,64,35,29,79
Peterhead,964,2,24,4,8,84,39,45,76
Stirling,964,3,17,6,13,63,52,11,57
Stenhousem'r,964,4,15,8,13,56,49,7,53
Clyde,964,5,14,9,13,52,50,2,51
Elgin,964,6,14,6,16,54,65,-11,48
Annan Athlet,964,7,11,11,14,47,42,5,44
Berwick,964,8,9,10,17,31,59,-28,37
Edinburgh Ci,964,9,7,9,20,37,67,-30,30
Cowdenbeath,964,10,5,10,21,24,54,-30,25
Montrose,965,1,24,7,5,60,34,26,79
Peterhead,965,2,23,5,8,77,38,39,74
Stirling,965,3,16,7,13,61,52,9,55
Stenhousem'r,965,4,15,9,12,56,47,9,54
Clyde,965,5,15,9,12,55,50,5,54
Elgin,965,6,14,6,16,53,61,-8,48
Annan Athlet,965,7,11,12,13,47,41,6,45
Berwick,965,8,8,10,18,31,62,-31,34
Edinburgh Ci,965,9,7,10,19,36,60,-24,31
Cowdenbeath,965,10,4,11,21,23,54,-31,23
Montrose,966,1,24,7,5,60,34,26,79
Peterhead,966,2,24,4,8,79,39,40,76
Stenhousem'r,966,3,16,8,12,58,47,11,56
Stirling,966,4,16,6,14,61,54,7,54
Clyde,966,5,14,10,12,52,49,3,52
Elgin,966,6,14,6,16,53,61,-8,48
Annan Athlet,966,7,11,11,14,48,43,5,44
Berwick,966,8,8,11,17,30,59,-29,35
Edinburgh Ci,966,9,7,9,20,37,62,-25,30
Cowdenbeath,966,10,5,10,21,25,55,-30,25
Montrose,967,1,23,7,6,59,35,24,76
Peterhead,967,2,23,4,9,78,41,37,73
Stenhousem'r,967,3,16,8,12,57,47,10,56
Stirling,967,4,16,6,14,61,53,8,54
Clyde,967,5,14,10,12,51,48,3,52
Elgin,967,6,15,6,15,54,60,-6,51
Annan Athlet,967,7,12,11,13,49,42,7,47
Berwick,967,8,8,11,17,29,58,-29,35
Edinburgh Ci,967,9,8,9,19,39,61,-22,33
Cowdenbeath,967,10,4,10,22,24,56,-32,22
Montrose,968,1,24,7,5,63,36,27,79
Peterhead,968,2,24,4,8,83,38,45,76
Stirling,968,3,17,6,13,64,53,11,57
Clyde,968,4,15,9,12,54,50,4,54
Stenhousem'r,968,5,15,8,13,57,50,7,53
Elgin,968,6,14,6,16,55,64,-9,48
Annan Athlet,968,7,12,11,13,50,41,9,47
Berwick,968,8,8,10,18,31,61,-30,34
Edinburgh Ci,968,9,7,9,20,36,66,-30,30
Cowdenbeath,968,10,4,10,22,23,57,-34,22
Montrose,969,1,24,7,5,62,34,28,79
Peterhead,969,2,24,4,8,80,40,40,76
Stenhousem'r,969,3,16,8,12,58,48,10,56
Stirling,969,4,16,6,14,62,54,8,54
Clyde,969,5,15,9,12,55,49,6,54
Elgin,969,6,14,6,16,53,63,-10,48
Annan Athlet,969,7,12,11,13,49,42,7,47
Berwick,969,8,8,10,18,30,62,-32,34
Edinburgh Ci,969,9,7,9,20,38,63,-25,30
Cowdenbeath,969,10,4,10,22,24,56,-32,22
Montrose,970,1,24,7,5,61,34,27,79
Peterhead,970,2,24,4,8,79,38,41,76
Stenhousem'r,970,3,16,8,12,59,49,10,56
Stirling,970,4,16,6,14,63,55,8,54
Clyde,970,5,15,9,12,53,48,5,54
Elgin,970,6,14,6,16,53,62,-9,48
Annan Athlet,970,7,11,11,14,48,45,3,44
Berwick,970,8,8,10,18,29,60,-31,34
Edinburgh Ci,970,9,7,9,20,36,62,-26,30
Cowdenbeath,970,10,5,10,21,27,55,-28,25
Montrose,971,1,24,7,5,63,35,28,79
Peterhead,971,2,24,4,8,79,38,41,76
Stenhousem'r,971,3,16,8,12,56,46,10,56
Stirling,971,4,16,6,14,60,52,8,54
Clyde,971,5,15,9,12,54,48,6,54
Elgin,971,6,14,6,16,54,64,-10,48
Annan Athlet,971,7,12,11,13,50,43,7,47
Berwick,971,8,8,10,18,29,61,-32,34
Edinburgh Ci,971,9,7,9,20,36,62,-26,30
Cowdenbeath,971,10,4,10,22,25,57,-32,22
Peterhead,972,1,24,4,8,81,38,43,76
Montrose,972,2,23,7,6,59,35,24,76
Stirling,972,3,17,6,13,62,51,11,57
Stenhousem'r,972,4,15,8,13,55,48,7,53
Clyde,972,5,14,10,12,52,49,3,52
Elgin,972,6,15,6,15,54,60,-6,51
Annan Athlet,972,7,11,12,13,48,42,6,45
Berwick,972,8,8,11,17,30,59,-29,35
Edinburgh Ci,972,9,7,9,20,36,64,-28,30
Cowdenbeath,972,10,4,11,21,24,55,-31,23
Montrose,973,1,24,7,5,61,35,26,79
Peterhead,973,2,24,4,8,79,38,41,76
Stirling,973,3,16,7,13,62,53,9,55
Stenhousem'r,973,4,15,9,12,57,48,9,54
Clyde,973,5,15,9,12,53,48,5,54
Elgin,973,6,14,6,16,54,62,-8,48
Annan Athlet,973,7,12,11,13,52,43,9,47
Berwick,973,8,8,10,18,29,60,-31,34
Edinburgh Ci,973,9,7,9,20,36,62,-26,30
Cowdenbeath,973,10,4,10,22,25,59,-34,22
Montrose,974,1,23,8,5,59,34,25,77
Peterhead,974,2,24,4,8,79,38,41,76
Stirling,974,3,17,6,13,62,52,10,57
Clyde,974,4,15,9,12,52,48,4,54
Stenhousem'r,974,5,15,8,13,56,48,8,53
Elgin,974,6,14,7,15,53,60,-7,49
Annan Athlet,974,7,11,11,14,47,43,4,44
Berwick,974,8,8,10,18,29,59,-30,34
Edinburgh Ci,974,9,7,9,20,36,62,-26,30
Cowdenbeath,974,10,5,10,21,25,54,-29,25
Peterhead,975,1,24,4,8,80,39,41,76
Montrose,975,2,23,7,6,60,37,23,76
Stirling,975,3,16,7,13,60,51,9,55
Stenhousem'r,975,4,15,9,12,55,46,9,54
Clyde,975,5,14,9,13,53,51,2,51
Elgin,975,6,15,6,15,56,61,-5,51
Annan Athlet,975,7,11,11,14,48,43,5,44
Berwick,975,8,9,10,17,32,60,-28,37
Edinburgh Ci,975,9,7,9,20,37,63,-26,30
Cowdenbeath,975,10,5,10,21,25,55,-30,25
Montrose,976,1,24,7,5,61,34,27,79
Peterhead,976,2,24,4,8,80,38,42,76
Stirling,976,3,16,7,13,61,52,9,55
Stenhousem'r,976,4,15,9,12,56,47,9,54
Clyde,976,5,15,9,12,52,48,4,54
Elgin,976,6,14,6,16,53,62,-9,48
Annan Athlet,976,7,11,11,14,47,42,5,44
Berwick,976,8,8,10,18,29,59,-30,34
Edinburgh Ci,976,9,7,9,20,36,63,-27,30
Cowdenbeath,976,10,5,10,21,24,54,-30,25
Montrose,977,1,24,7,5,62,35,27,79
Peterhead,977,2,24,4,8,79,39,40,76
Stirling,977,3,16,7,13,61,52,9,55
Stenhousem'r,977,4,15,9,12,56,47,9,54
Clyde,977,5,15,9,12,53,49,4,54
Elgin,977,6,14,6,16,54,63,-9,48
Annan Athlet,977,7,12,11,13,49,41,8,47
Berwick,977,8,8,10,18,30,60,-30,34
Edinburgh Ci,977,9,7,9,20,37,62,-25,30
Cowdenbeath,977,10,4,10,22,23,56,-33,22
Montrose,978,1,24,7,5,61,34,27,79
Peterhead,978,2,24,4,8,80,39,41,76
Stirling,978,3,16,7,13,61,52,9,55
Stenhousem'r,978,4,15,9,12,56,47,9,54
Clyde,978,5,15,9,12,53,49,4,54
Elgin,978,6,14,6,16,53,62,-9,48
Annan Athlet,978,7,11,12,13,47,41,6,45
Berwick,978,8,8,10,18,30,60,-30,34
Edinburgh Ci,978,9,7,9,20,37,63,-26,30
Cowdenbeath,978,10,4,11,21,23,54,-31,23
Montrose,979,1,23,8,5,60,35,25,77
Peterhead,979,2,23,5,8,78,39,39,74
Stirling,979,3,17,6,13,62,51,11,57
Stenhousem'r,979,4,15,8,13,55,48,7,53
Clyde,979,5,14,10,12,52,49,3,52
Elgin,979,6,14,7,15,54,61,-7,49
Annan Athlet,979,7,12,11,13,48,41,7,47
Berwick,979,8,8,11,17,30,59,-29,35
Edinburgh Ci,979,9,7,10,19,37,61,-24,31
Cowdenbeath,979,10,4,10,22,23,55,-32,22
Peterhead,980,1,24,4,8,80,38,42,76
Montrose,980,2,23,7,6,59,36,23,76
Stirling,980,3,17,6,13,61,51,10,57
Stenhousem'r,980,4,15,8,13,55,47,8,53
Clyde,980,5,14,9,13,52,50,2,51
Elgin,980,6,15,6,15,55,60,-5,51
Annan Athlet,980,7,12,11,13,48,41,7,47
Berwick,980,8,9,10,17,31,59,-28,37
Edinburgh Ci,980,9,7,9,20,36,63,-27,30
Cowdenbeath,980,10,4,10,22,23,55,-32,22
Peterhead,981,1,24,4,8,79,38,41,76
Montrose,981,2,23,7,6,61,37,24,76
Stirling,981,3,17,6,13,62,51,11,57
Clyde,981,4,15,9,12,53,48,5,54
Stenhousem'r,981,5,15,8,13,55,48,7,53
Elgin,981,6,15,6,15,56,62,-6,51
Annan Athlet,981,7,12,11,13,49,41,8,47
Berwick,981,8,8,10,18,29,60,-31,34
Edinburgh Ci,981,9,7,9,20,36,62,-26,30
Cowdenbeath,981,10,4,10,22,23,56,-33,22
Peterhead,982,1,24,4,8,81,40,41,76
Montrose,982,2,23,7,6,59,35,24,76
Stirling,982,3,17,6,13,61,51,10,57
Stenhousem'r,982,4,15,8,13,55,47,8,53
Clyde,982,5,14,9,13,51,51,0,51
Elgin,982,6,15,6,15,54,60,-6,51
Annan Athlet,982,7,11,11,14,48,44,4,44
Berwick,982,8,9,10,17,32,58,-26,37
Edinburgh Ci,982,9,7,9,20,38,64,-26,30
Cowdenbeath,982,10,5,10,21,26,55,-29,25
Peterhead,983,1,24,4,8,80,40,40,76
Montrose,983,2,23,7,6,60,36,24,76
Stenhousem'r,983,3,16,8,12,57,47,10,56
Stirling,983,4,16,6,14,61,53,8,54
Clyde,983,5,15,9,12,52,48,4,54
Elgin,983,6,15,6,15,55,61,-6,51
Annan Athlet,983,7,12,11,13,50,41,9,47
Berwick,983,8,8,10,18,29,59,-30,34
Edinburgh Ci,983,9,7,9,20,38,63,-25,30
Cowdenbeath,983,10,4,10,22,23,57,-34,22
Montrose,984,1,24,7,5,61,35,26,79
Peterhead,984,2,24,4,8,80,39,41,76
Stirling,984,3,17,6,13,63,53,10,57
Clyde,984,4,15,9,12,56,49,7,54
Stenhousem'r,984,5,15,8,13,57,49,8,53
Elgin,984,6,14,6,16,54,62,-8,48
Annan Athlet,984,7,11,12,13,48,42,6,45
Berwick,984,8,8,10,18,30,63,-33,34
Edinburgh Ci,984,9,7,9,20,37,63,-26,30
Cowdenbeath,984,10,4,11,21,24,55,-31,23
Montrose,985,1,24,7,5,62,35,27,79
Peterhead,985,2,24,4,8,80,38,42,76
Stirling,985,3,17,6,13,64,51,13,57
Stenhousem'r,985,4,15,8,13,55,50,5,53
Clyde,985,5,14,9,13,53,51,2,51
Elgin,985,6,14,6,16,54,63,-9,48
Annan Athlet,985,7,11,12,13,47,41,6,45
Berwick,985,8,9,10,17,32,60,-28,37
Edinburgh Ci,985,9,7,9,20,36,63,-27,30
Cowdenbeath,985,10,4,11,21,23,54,-31,23
Montrose,986,1,24,7,5,63,35,28,79
Peterhead,986,2,24,4,8,79,38,41,76
Stirling,986,3,17,6,13,65,55,10,57
Stenhousem'r,986,4,15,8,13,59,51,8,53
Clyde,986,5,14,9,13,51,49,2,51
Elgin,986,6,14,6,16,54,64,-10,48
Annan Athlet,986,7,12,11,13,48,41,7,47
Berwick,986,8,9,10,17,30,58,-28,37
Edinburgh Ci,986,9,7,9,20,36,62,-26,30
Cowdenbeath,986,10,4,10,22,23,55,-32,22
Peterhead,987,1,24,4,8,78,38,40,76
Montrose,987,2,23,7,6,60,36,24,76
Stirling,987,3,16,7,13,60,51,9,55
Stenhousem'r,987,4,15,9,12,55,46,9,54
Clyde,987,5,15,9,12,53,48,5,54
Elgin,987,6,15,6,15,55,61,-6,51
Annan Athlet,987,7,12,11,13,50,43,7,47
Berwick,987,8,8,10,18,29,60,-31,34
Edinburgh Ci,987,9,7,9,20,36,61,-25,30
Cowdenbeath,987,10,4,10,22,25,57,-32,22
Montrose,988,1,24,7,5,62,36,26,79
Peterhead,988,2,24,4,8,81,39,42,76
Stirling,988,3,17,6,13,65,52,13,57
Clyde,988,4,15,9,12,54,49,5,54
Stenhousem'r,988,5,15,8,13,56,51,5,53
Elgin,988,6,14,6,16,55,63,-8,48
Annan Athlet,988,7,11,11,14,47,45,2,44
Berwick,988,8,8,10,18,30,61,-31,34
Edinburgh Ci,988,9,7,9,20,37,64,-27,30
Cowdenbeath,988,10,5,10,21,27,54,-27,25
Montrose,989,1,23,8,5,61,36,25,77
Peterhead,989,2,24,4,8,80,38,42,76
Stenhousem'r,989,3,16,8,12,58,48,10,56
Stirling,989,4,16,6,14,62,54,8,54
Clyde,989,5,15,9,12,53,48,5,54
Elgin,989,6,14,7,15,55,62,-7,49
Annan Athlet,989,7,12,11,13,50,43,7,47
Berwick,989,8,8,10,18,29,60,-31,34
Edinburgh Ci,989,9,7,9,20,36,63,-27,30
Cowdenbeath,989,10,4,10,22,25,57,-32,22
Montrose,990,1,24,7,5,62,36,26,79
Peterhead,990,2,23,5,8,77,38,39,74
Stirling,990,3,16,7,13,62,53,9,55
Stenhousem'r,990,4,15,9,12,57,48,9,54
Clyde,990,5,14,10,12,51,48,3,52
Elgin,990,6,14,6,16,55,63,-8,48
Annan Athlet,990,7,11,11,14,48,43,5,44
Berwick,990,8,8,11,17,29,58,-29,35
Edinburgh Ci,990,9,7,10,19,36,60,-24,31
Cowdenbeath,990,10,5,10,21,25,55,-30,25
Montrose,991,1,24,7,5,63,35,28,79
Peterhead,991,2,23,5,8,77,38,39,74
Stirling,991,3,17,6,13,63,53,10,57
Clyde,991,4,15,9,12,53,48,5,54
Stenhousem'r,991,5,15,8,13,57,49,8,53
Elgin,991,6,14,6,16,54,64,-10,48
Annan Athlet,991,7,11,12,13,49,43,6,45
Berwick,991,8,8,10,18,29,60,-31,34
Edinburgh Ci,991,9,7,10,19,36,60,-24,31
Cowdenbeath,991,10,4,11,21,25,56,-31,23
Peterhead,992,1,24,4,8,78,38,40,76
Montrose,992,2,23,7,6,60,37,23,76
Stirling,992,3,17,6,13,63,51,12,57
Clyde,992,4,15,9,12,56,50,6,54
Stenhousem'r,992,5,15,8,13,55,49,6,53
Elgin,992,6,15,6,15,56,61,-5,51
Annan Athlet,992,7,11,12,13,49,43,6,45
Berwick,992,8,8,10,18,31,63,-32,34
Edinburgh Ci,992,9,7,9,20,36,61,-25,30
Cowdenbeath,992,10,4,11,21,25,56,-31,23
Montrose,993,1,23,8,5,61,36,25,77
Peterhead,993,2,24,4,8,80,38,42,76
Stenhousem'r,993,3,16,8,12,56,46,10,56
Stirling,993,4,16,6,14,60,52,8,54
Clyde,993,5,14,9,13,52,50,2,51
Elgin,993,6,14,7,15,55,62,-7,49
Annan Athlet,993,7,11,11,14,49,44,5,44
Berwick,993,8,9,10,17,31,59,-28,37
Edinburgh Ci,993,9,7,9,20,36,63,-27,30
Cowdenbeath,993,10,5,10,21,26,56,-30,25
Peterhead,994,1,24,4,8,78,38,40,76
Montrose,994,2,23,7,6,60,36,24,76
Stirling,994,3,17,6,13,64,53,11,57
Clyde,994,4,15,9,12,54,48,6,54
Stenhousem'r,994,5,15,8,13,57,50,7,53
Elgin,994,6,15,6,15,55,61,-6,51
Annan Athlet,994,7,11,12,13,49,43,6,45
Berwick,994,8,8,10,18,29,61,-32,34
Edinburgh Ci,994,9,7,9,20,36,61,-25,30
Cowdenbeath,994,10,4,11,21,25,56,-31,23
Montrose,995,1,24,7,5,62,34,28,79
Peterhead,995,2,24,4,8,79,39,40,76
Stirling,995,3,16,7,13,60,51,9,55
Stenhousem'r,995,4,15,9,12,55,46,9,54
Clyde,995,5,15,9,12,52,48,4,54
Elgin,995,6,14,6,16,53,63,-10,48
Annan Athlet,995,7,12,11,13,49,42,7,47
Berwick,995,8,8,10,18,29,59,-30,34
Edinburgh Ci,995,9,7,9,20,37,62,-25,30
Cowdenbeath,995,10,4,10,22,24,56,-32,22
Montrose,996,1,24,7,5,61,35,26,79
Peterhead,996,2,24,4,8,79,39,40,76
Stirling,996,3,17,6,13,63,53,10,57
Clyde,996,4,15,9,12,54,50,4,54
Stenhousem'r,996,5,15,8,13,57,49,8,53
Elgin,996,6,14,6,16,54,62,-8,48
Annan Athlet,996,7,11,11,14,49,44,5,44
Berwick,996,8,8,10,18,31,61,-30,34
Edinburgh Ci,996,9,7,9,20,37,62,-25,30
Cowdenbeath,996,10,5,10,21,26,56,-30,25
Montrose,997,1,23,8,5,59,34,25,77
Peterhead,997,2,24,4,8,80,38,42,76
Stirling,997,3,17,6,13,64,53,11,57
Clyde,997,4,15,9,12,54,50,4,54
Stenhousem'r,997,5,15,8,13,57,50,7,53
Elgin,997,6,14,7,15,53,60,-7,49
Annan Athlet,997,7,12,11,13,48,41,7,47
Berwick,997,8,8,10,18,31,61,-30,34
Edinburgh Ci,997,9,7,9,20,36,63,-27,30
Cowdenbeath,997,10,4,10,22,23,55,-32,22
Montrose,998,1,24,7,5,62,35,27,79
Peterhead,998,2,24,4,8,82,40,42,76
Stirling,998,3,17,6,13,63,53,10,57
Clyde,998,4,15,9,12,55,49,6,54
Stenhousem'r,998,5,15,8,13,57,49,8,53
Elgin,998,6,14,6,16,54,63,-9,48
Annan Athlet,998,7,12,11,13,49,42,7,47
Berwick,998,8,8,10,18,30,62,-32,34
Edinburgh Ci,998,9,7,9,20,38,65,-27,30
Cowdenbeath,998,10,4,10,22,24,56,-32,22
Montrose,999,1,24,7,5,61,34,27,79
Peterhead,999,2,23,5,8,79,40,39,74
Stenhousem'r,999,3,16,8,12,56,46,10,56
Stirling,999,4,16,6,14,60,52,8,54
Clyde,999,5,14,9,13,51,50,1,51
Elgin,999,6,14,6,16,53,62,-9,48
Annan Athlet,999,7,11,11,14,47,42,5,44
Berwick,999,8,9,10,17,31,58,-27,37
Edinburgh Ci,999,9,7,10,19,38,62,-24,31
Cowdenbeath,999,10,5,10,21,24,54,-30,25
Peterhead,1000,1,24,4,8,80,38,42,76
Montrose,1000,2,23,7,6,60,36,24,76
Stirling,1000,3,17,6,13,64,52,12,57
Clyde,1000,4,15,9,12,53,49,4,54
Stenhousem'r,1000,5,15,8,13,56,50,6,53
Elgin,1000,6,15,6,15,55,61,-6,51
Annan Athlet,1000,7,11,12,13,48,42,6,45
Berwick,1000,8,8,10,18,30,60,-30,34
Edinburgh Ci,1000,9,7,9,20,36,63,-27,30
Cowdenbeath,1000,10,4,11,21,24,55,-31,23
Peterhead,1001,1,24,4,8,81,38,43,76
Montrose,1001,2,23,7,6,59,37,22,76
Stirling,1001,3,17,6,13,61,51,10,57
Stenhousem'r,1001,4,15,8,13,55,47,8,53
Clyde,1001,5,14,9,13,51,49,2,51
Elgin,1001,6,15,6,15,56,60,-4,51
Annan Athlet,1001,7,11,12,13,47,41,6,45
Berwick,1001,8,9,10,17,30,58,-28,37
Edinburgh Ci,1001,9,7,9,20,36,64,-28,30
Cowdenbeath,1001,10,4,11,21,23,54,-31,23
Montrose,1002,1,23,7,6,60,36,24,76
Peterhead,1002,2,23,5,8,81,42,39,74
Stirling,1002,3,16,7,13,61,52,9,55
Stenhousem'r,1002,4,15,9,12,56,47,9,54
Clyde,1002,5,14,10,12,52,49,3,52
Elgin,1002,6,15,6,15,55,61,-6,51
Annan Athlet,1002,7,11,12,13,47,41,6,45
Berwick,1002,8,8,11,17,30,59,-29,35
Edinburgh Ci,1002,9,7,10,19,40,64,-24,31
Cowdenbeath,1002,10,4,11,21,23,54,-31,23
Montrose,1003,1,23,8,5,59,34,25,77
Peterhead,1003,2,24,4,8,81,41,40,76
Stirling,1003,3,17,6,13,66,53,13,57
Clyde,1003,4,15,9,12,52,48,4,54
Stenhousem'r,1003,5,15,8,13,57,52,5,53
Elgin,1003,6,14,7,15,53,60,-7,49
Annan Athlet,1003,7,12,11,13,49,42,7,47
Berwick,1003,8,8,10,18,29,59,-30,34
Edinburgh Ci,1003,9,7,9,20,39,64,-25,30
Cowdenbeath,1003,10,4,10,22,24,56,-32,22
Montrose,1004,1,23,8,5,61,36,25,77
Peterhead,1004,2,24,4,8,82,39,43,76
Stirling,1004,3,16,7,13,62,53,9,55
Stenhousem'r,1004,4,15,9,12,57,48,9,54
Clyde,1004,5,15,9,12,53,49,4,54
Elgin,1004,6,14,7,15,55,62,-7,49
Annan Athlet,1004,7,11,12,13,49,43,6,45
Berwick,1004,8,8,10,18,30,60,-30,34
Edinburgh Ci,1004,9,7,9,20,37,65,-28,30
Cowdenbeath,1004,10,4,11,21,25,56,-31,23
Montrose,1005,1,23,8,5,59,34,25,77
Peterhead,1005,2,24,4,8,79,39,40,76
Stirling,1005,3,17,6,13,63,53,10,57
Clyde,1005,4,15,9,12,55,50,5,54
Stenhousem'r,1005,5,15,8,13,57,49,8,53
Elgin,1005,6,14,7,15,53,60,-7,49
Annan Athlet,1005,7,11,12,13,49,43,6,45
Berwick,1005,8,8,10,18,31,62,-31,34
Edinburgh Ci,1005,9,7,9,20,37,62,-25,30
Cowdenbeath,1005,10,4,11,21,25,56,-31,23
Montrose,1006,1,23,8,5,59,34,25,77
Peterhead,1006,2,24,4,8,82,41,41,76
Stirling,1006,3,16,7,13,61,52,9,55
Clyde,1006,4,15,9,12,58,49,9,54
Stenhousem'r,1006,5,15,9,12,56,47,9,54
Elgin,1006,6,14,7,15,53,60,-7,49
Annan Athlet,1006,7,11,11,14,47,44,3,44
Berwick,1006,8,8,10,18,30,65,-35,34
Edinburgh Ci,1006,9,7,9,20,39,65,-26,30
Cowdenbeath,1006,10,5,10,21,26,54,-28,25
Montrose,1007,1,24,7,5,61,34,27,79
Peterhead,1007,2,24,4,8,82,38,44,76
Stirling,1007,3,17,6,13,64,53,11,57
Stenhousem'r,1007,4,15,8,13,57,50,7,53
Clyde,1007,5,14,9,13,52,51,1,51
Elgin,1007,6,14,6,16,53,62,-9,48
Annan Athlet,1007,7,12,11,13,50,41,9,47
Berwick,1007,8,9,10,17,32,59,-27,37
Edinburgh Ci,1007,9,7,9,20,36,65,-29,30
Cowdenbeath,1007,10,4,10,22,23,57,-34,22
Montrose,1008,1,24,7,5,61,34,27,79
Peterhead,1008,2,24,4,8,80,40,40,76
Stirling,1008,3,17,6,13,66,52,14,57
Clyde,1008,4,15,9,12,55,48,7,54
Stenhousem'r,1008,5,15,8,13,56,52,4,53
Elgin,1008,6,14,6,16,53,62,-9,48
Annan Athlet,1008,7,12,11,13,49,42,7,47
Berwick,1008,8,8,10,18,29,62,-33,34
Edinburgh Ci,1008,9,7,9,20,38,63,-25,30
Cowdenbeath,1008,10,4,10,22,24,56,-32,22
Montrose,1009,1,23,8,5,60,35,25,77
Peterhead,1009,2,23,4,9,78,40,38,73
Stenhousem'r,1009,3,16,8,12,56,46,10,56
Stirling,1009,4,16,6,14,60,52,8,54
Clyde,1009,5,14,9,13,52,52,0,51
Elgin,1009,6,14,7,15,54,61,-7,49
Annan Athlet,1009,7,11,11,14,47,44,3,44
Berwick,1009,8,9,10,17,33,59,-26,37
Edinburgh Ci,1009,9,8,9,19,38,61,-23,33
Cowdenbeath,1009,10,5,10,21,26,54,-28,25
Peterhead,1010,1,24,4,8,79,38,41,76
Montrose,1010,2,23,7,6,61,38,23,76
Stenhousem'r,1010,3,16,8,12,56,46,10,56
Stirling,1010,4,16,6,14,60,52,8,54
Clyde,1010,5,14,10,12,52,49,3,52
Elgin,1010,6,15,6,15,57,62,-5,51
Annan Athlet,1010,7,12,11,13,48,41,7,47
Berwick,1010,8,8,11,17,30,59,-29,35
Edinburgh Ci,1010,9,7,9,20,36,62,-26,30
Cowdenbeath,1010,10,4,10,22,23,55,-32,22
Montrose,1011,1,24,7,5,63,34,29,79
Peterhead,1011,2,24,4,8,81,39,42,76
Stirling,1011,3,16,7,13,62,53,9,55
Stenhousem'r,1011,4,15,9,12,57,48,9,54
Clyde,1011,5,14,10,12,52,49,3,52
Elgin,1011,6,14,6,16,53,64,-11,48
Annan Athlet,1011,7,12,11,13,49,41,8,47
Berwick,1011,8,8,11,17,30,59,-29,35
Edinburgh Ci,1011,9,7,9,20,37,64,-27,30
Cowdenbeath,1011,10,4,10,22,23,56,-33,22
Montrose,1012,1,24,7,5,61,34,27,79
Peterhead,1012,2,24,4,8,79,38,41,76
Stirling,1012,3,16,7,13,60,51,9,55
Stenhousem'r,1012,4,15,9,12,55,46,9,54
Clyde,1012,5,15,9,12,52,48,4,54
Elgin,1012,6,14,6,16,53,62,-9,48
Annan Athlet,1012,7,11,12,13,48,42,6,45
Berwick,1012,8,8,10,18,29,59,-30,34
Edinburgh Ci,1012,9,7,9,20,36,62,-26,30
Cowdenbeath,1012,10,4,11,21,24,55,-31,23
Montrose,1013,1,23,8,5,59,34,25,77
Peterhead,1013,2,24,4,8,82,38,44,76
Stirling,1013,3,17,6,13,64,52,12,57
Stenhousem'r,1013,4,15,8,13,56,50,6,53
Clyde,1013,5,14,9,13,52,50,2,51
Elgin,1013,6,14,7,15,53,60,-7,49
Annan Athlet,1013,7,12,11,13,48,41,7,47
Berwick,1013,8,9,10,17,31,59,-28,37
Edinburgh Ci,1013,9,7,9,20,36,65,-29,30
Cowdenbeath,1013,10,4,10,22,23,55,-32,22
Montrose,1014,1,24,7,5,62,35,27,79
Peterhead,1014,2,24,4,8,81,39,42,76
Stirling,1014,3,16,7,13,62,53,9,55
Stenhousem'r,1014,4,15,9,12,57,48,9,54
Clyde,1014,5,15,9,12,52,48,4,54
Elgin,1014,6,14,6,16,54,63,-9,48
Annan Athlet,1014,7,12,11,13,50,42,8,47
Berwick,1014,8,8,10,18,29,59,-30,34
Edinburgh Ci,1014,9,7,9,20,37,64,-27,30
Cowdenbeath,1014,10,4,10,22,24,57,-33,22
Montrose,1015,1,24,7,5,64,36,28,79
Peterhead,1015,2,23,4,9,77,40,37,73
Stenhousem'r,1015,3,16,8,12,57,47,10,56
Stirling,1015,4,16,6,14,61,53,8,54
Clyde,1015,5,14,10,12,52,49,3,52
Elgin,1015,6,14,6,16,55,65,-10,48
Annan Athlet,1015,7,12,11,13,49,41,8,47
Berwick,1015,8,8,11,17,30,59,-29,35
Edinburgh Ci,1015,9,8,9,19,38,60,-22,33
Cowdenbeath,1015,10,4,10,22,23,56,-33,22
Montrose,1016,1,24,7,5,62,35,27,79
Peterhead,1016,2,24,4,8,81,38,43,76
Stirling,1016,3,17,6,13,62,51,11,57
Stenhousem'r,1016,4,15,8,13,55,48,7,53
Clyde,1016,5,14,10,12,53,50,3,52
Elgin,1016,6,14,6,16,54,63,-9,48
Annan Athlet,1016,7,12,11,13,49,42,7,47
Berwick,1016,8,8,11,17,31,60,-29,35
Edinburgh Ci,1016,9,7,9,20,36,64,-28,30
Cowdenbeath,1016,10,4,10,22,24,56,-32,22
Montrose,1017,1,24,7,5,62,36,26,79
Peterhead,1017,2,24,4,8,79,38,41,76
Stirling,1017,3,17,6,13,64,53,11,57
Clyde,1017,4,15,9,12,53,48,5,54
Stenhousem'r,1017,5,15,8,13,57,50,7,53
Elgin,1017,6,14,6,16,55,63,-8,48
Annan Athlet,1017,7,11,12,13,49,43,6,45
Berwick,1017,8,8,10,18,29,60,-31,34
Edinburgh Ci,1017,9,7,9,20,36,62,-26,30
Cowdenbeath,1017,10,4,11,21,25,56,-31,23
Montrose,1018,1,24,7,5,61,35,26,79
Peterhead,1018,2,24,4,8,80,39,41,76
Stirling,1018,3,17,6,13,62,52,10,57
Clyde,1018,4,15,9,12,55,48,7,54
Stenhousem'r,1018,5,15,8,13,56,48,8,53
Elgin,1018,6,14,6,16,54,62,-8,48
Annan Athlet,1018,7,11,11,14,47,43,4,44
Berwick,1018,8,8,10,18,29,62,-33,34
Edinburgh Ci,1018,9,7,9,20,37,63,-26,30
Cowdenbeath,1018,10,5,10,21,25,54,-29,25
Montrose,1019,1,24,7,5,61,34,27,79
Peterhead,1019,2,24,4,8,78,38,40,76
Stenhousem'r,1019,3,16,8,12,57,47,10,56
Stirling,1019,4,16,6,14,61,53,8,54
Clyde,1019,5,15,9,12,55,49,6,54
Elgin,1019,6,14,6,16,53,62,-9,48
Annan Athlet,1019,7,11,12,13,48,42,6,45
Berwick,1019,8,8,10,18,30,62,-32,34
Edinburgh Ci,1019,9,7,9,20,36,61,-25,30
Cowdenbeath,1019,10,4,11,21,24,55,-31,23
Montrose,1020,1,24,7,5,61,34,27,79
Peterhead,1020,2,24,4,8,81,38,43,76
Stirling,1020,3,17,6,13,63,53,10,57
Clyde,1020,4,15,9,12,54,50,4,54
Stenhousem'r,1020,5,15,8,13,57,49,8,53
Elgin,1020,6,14,6,16,53,62,-9,48
Annan Athlet,1020,7,11,12,13,48,42,6,45
Berwick,1020,8,8,10,18,31,61,-30,34
Edinburgh Ci,1020,9,7,9,20,36,64,-28,30
Cowdenbeath,1020,10,4,11,21,24,55,-31,23
Montrose,1021,1,23,8,5,59,34,25,77
Peterhead,1021,2,24,4,8,79,38,41,76
Stenhousem'r,1021,3,16,8,12,57,47,10,56
Stirling,1021,4,16,6,14,61,53,8,54
Clyde,1021,5,14,9,13,51,49,2,51
Elgin,1021,6,14,7,15,53,60,-7,49
Annan Athlet,1021,7,11,12,13,48,42,6,45
Berwick,1021,8,9,10,17,30,58,-28,37
Edinburgh Ci,1021,9,7,9,20,36,62,-26,30
Cowdenbeath,1021,10,4,11,21,24,55,-31,23
Montrose,1022,1,24,7,5,62,34,28,79
Peterhead,1022,2,24,4,8,80,39,41,76
Stirling,1022,3,17,6,13,61,51,10,57
Clyde,1022,4,15,9,12,55,49,6,54
Stenhousem'r,1022,5,15,8,13,55,47,8,53
Elgin,1022,6,14,6,16,53,63,-10,48
Annan Athlet,1022,7,11,12,13,47,41,6,45
Berwick,1022,8,8,10,18,30,62,-32,34
Edinburgh Ci,1022,9,7,9,20,37,63,-26,30
Cowdenbeath,1022,10,4,11,21,23,54,-31,23
Montrose,1023,1,24,7,5,62,36,26,79
Peterhead,1023,2,24,4,8,81,38,43,76
Stenhousem'r,1023,3,16,8,12,57,47,10,56
Stirling,1023,4,16,6,14,61,53,8,54
Clyde,1023,5,15,9,12,53,48,5,54
Elgin,1023,6,14,6,16,55,63,-8,48
Annan Athlet,1023,7,11,11,14,48,43,5,44
Berwick,1023,8,8,10,18,29,60,-31,34
Edinburgh Ci,1023,9,7,9,20,36,64,-28,30
Cowdenbeath,1023,10,5,10,21,25,55,-30,25
Peterhead,1024,1,24,4,8,81,39,42,76
Montrose,1024,2,23,7,6,60,38,22,76
Stenhousem'r,1024,3,16,8,12,57,47,10,56
Stirling,1024,4,16,6,14,61,53,8,54
Clyde,1024,5,15,9,12,53,49,4,54
Elgin,1024,6,15,6,15,57,61,-4,51
Annan Athlet,1024,7,11,12,13,48,42,6,45
Berwick,1024,8,8,10,18,30,60,-30,34
Edinburgh Ci,1024,9,7,9,20,37,64,-27,30
Cowdenbeath,1024,10,4,11,21,24,55,-31,23
Montrose,1025,1,24,7,5,62,34,28,79
Peterhead,1025,2,24,4,8,82,39,43,76
Stirling,1025,3,16,7,13,63,54,9,55
Stenhousem'r,1025,4,15,9,12,58,49,9,54
Clyde,1025,5,14,10,12,51,48,3,52
Elgin,1025,6,14,6,16,53,63,-10,48
Annan Athlet,1025,7,11,11,14,47,42,5,44
Berwick,1025,8,8,11,17,29,58,-29,35
Edinburgh Ci,1025,9,7,9,20,37,65,-28,30
Cowdenbeath,1025,10,5,10,21,24,54,-30,25
Peterhead,1026,1,24,4,8,78,38,40,76
Montrose,1026,2,23,7,6,59,37,22,76
Stenhousem'r,1026,3,16,8,12,56,46,10,56
Stirling,1026,4,16,6,14,60,52,8,54
Clyde,1026,5,14,10,12,52,49,3,52
Elgin,1026,6,15,6,15,56,60,-4,51
Annan Athlet,1026,7,11,12,13,48,42,6,45
Berwick,1026,8,8,11,17,30,59,-29,35
Edinburgh Ci,1026,9,7,9,20,36,61,-25,30
Cowdenbeath,1026,10,4,11,21,24,55,-31,23
Montrose,1027,1,24,7,5,61,34,27,79
Peterhead,1027,2,24,4,8,79,39,40,76
Stenhousem'r,1027,3,16,8,12,57,47,10,56
Stirling,1027,4,16,6,14,61,53,8,54
Clyde,1027,5,15,9,12,53,48,5,54
Elgin,1027,6,14,6,16,53,62,-9,48
Annan Athlet,1027,7,11,12,13,48,42,6,45
Berwick,1027,8,8,10,18,29,60,-31,34
Edinburgh Ci,1027,9,7,9,20,37,62,-25,30
Cowdenbeath,1027,10,4,11,21,24,55,-31,23
Montrose,1028,1,24,7,5,63,34,29,79
Peterhead,1028,2,24,4,8,80,38,42,76
Stirling,1028,3,16,7,13,63,54,9,55
Stenhousem'r,1028,4,15,9,12,58,49,9,54
Clyde,1028,5,14,10,12,51,48,3,52
Elgin,1028,6,14,6,16,53,64,-11,48
Annan Athlet,1028,7,11,11,14,48,44,4,44
Berwick,1028,8,8,11,17,29,58,-29,35
Edinburgh Ci,1028,9,7,9,20,36,63,-27,30
Cowdenbeath,1028,10,5,10,21,26,55,-29,25
Montrose,1029,1,23,8,5,59,34,25,77
Peterhead,1029,2,23,5,8,79,40,39,74
Stenhousem'r,1029,3,16,8,12,56,46,10,56
Stirling,1029,4,16,6,14,60,52,8,54
Clyde,1029,5,15,9,12,53,49,4,54
Elgin,1029,6,14,7,15,53,60,-7,49
Annan Athlet,1029,7,11,11,14,47,43,4,44
Berwick,1029,8,8,10,18,30,60,-30,34
Edinburgh Ci,1029,9,7,10,19,38,62,-24,31
Cowdenbeath,1029,10,5,10,21,25,54,-29,25
Montrose,1030,1,24,7,5,64,37,27,79
Peterhead,1030,2,24,4,8,79,39,40,76
Stenhousem'r,1030,3,16,8,12,58,48,10,56
Stirling,1030,4,16,6,14,62,54,8,54
Clyde,1030,5,15,9,12,53,48,5,54
Elgin,1030,6,14,6,16,56,65,-9,48
Annan Athlet,1030,7,11,12,13,48,42,6,45
Berwick,1030,8,8,10,18,29,60,-31,34
Edinburgh Ci,1030,9,7,9,20,37,62,-25,30
Cowdenbeath,1030,10,4,11,21,24,55,-31,23
Montrose,1031,1,24,7,5,60,34,26,79
Peterhead,1031,2,23,4,9,78,40,38,73
Stenhousem'r,1031,3,16,8,12,57,47,10,56
Stirling,1031,4,16,6,14,61,53,8,54
Clyde,1031,5,15,9,12,52,48,4,54
Elgin,1031,6,14,6,16,53,61,-8,48
Annan Athlet,1031,7,11,12,13,47,41,6,45
Berwick,1031,8,8,10,18,29,59,-30,34
Edinburgh Ci,1031,9,8,9,19,38,61,-23,33
Cowdenbeath,1031,10,4,11,21,23,54,-31,23
Montrose,1032,1,24,7,5,61,35,26,79
Peterhead,1032,2,23,4,9,78,40,38,73
Stirling,1032,3,16,7,13,62,53,9,55
Stenhousem'r,1032,4,15,9,12,57,48,9,54
Clyde,1032,5,14,9,13,52,51,1,51
Elgin,1032,6,14,6,16,54,62,-8,48
Annan Athlet,1032,7,11,11,14,47,45,2,44
Berwick,1032,8,9,10,17,32,59,-27,37
Edinburgh Ci,1032,9,8,9,19,38,61,-23,33
Cowdenbeath,1032,10,5,10,21,27,54,-27,25
Montrose,1033,1,23,8,5,62,37,25,77
Peterhead,1033,2,24,4,8,79,38,41,76
Stenhousem'r,1033,3,16,8,12,57,46,11,56
Stirling,1033,4,16,6,14,60,53,7,54
Clyde,1033,5,15,9,12,54,49,5,54
Elgin,1033,6,14,7,15,56,63,-7,49
Annan Athlet,1033,7,11,12,13,47,41,6,45
Berwick,1033,8,8,10,18,30,61,-31,34
Edinburgh Ci,1033,9,7,9,20,36,62,-26,30
Cowdenbeath,1033,10,4,11,21,23,54,-31,23
Peterhead,1034,1,24,4,8,78,38,40,76
Montrose,1034,2,23,7,6,59,35,24,76
Stirling,1034,3,17,6,13,63,52,11,57
Clyde,1034,4,15,9,12,58,48,10,54
Stenhousem'r,1034,5,15,8,13,56,49,7,53
Elgin,1034,6,15,6,15,54,60,-6,51
Annan Athlet,1034,7,11,12,13,48,42,6,45
Berwick,1034,8,8,10,18,29,65,-36,34
Edinburgh Ci,1034,9,7,9,20,36,61,-25,30
Cowdenbeath,1034,10,4,11,21,24,55,-31,23
Montrose,1035,1,23,8,5,59,34,25,77
Peterhead,1035,2,24,4,8,82,38,44,76
Stirling,1035,3,16,7,13,61,52,9,55
Stenhousem'r,1035,4,15,9,12,56,47,9,54
Clyde,1035,5,14,10,12,52,49,3,52
Elgin,1035,6,14,7,15,53,60,-7,49
Annan Athlet,1035,7,11,11,14,47,42,5,44
Berwick,1035,8,8,11,17,30,59,-29,35
Edinburgh Ci,1035,9,7,9,20,36,65,-29,30
Cowdenbeath,1035,10,5,10,21,24,54,-30,25
Montrose,1036,1,23,8,5,61,36,25,77
Peterhead,1036,2,24,4,8,79,39,40,76
Stirling,1036,3,17,6,13,62,52,10,57
Stenhousem'r,1036,4,15,8,13,56,48,8,53
Clyde,1036,5,14,10,12,53,50,3,52
Elgin,1036,6,14,7,15,55,62,-7,49
Annan Athlet,1036,7,12,11,13,50,42,8,47
Berwick,1036,8,8,11,17,31,60,-29,35
Edinburgh Ci,1036,9,7,9,20,37,62,-25,30
Cowdenbeath,1036,10,4,10,22,24,57,-33,22
Montrose,1037,1,23,8,5,60,35,25,77
Peterhead,1037,2,24,4,8,80,38,42,76
Stirling,1037,3,17,6,13,62,52,10,57
Clyde,1037,4,15,9,12,55,50,5,54
Stenhousem'r,1037,5,15,8,13,56,48,8,53
Elgin,1037,6,14,7,15,54,61,-7,49
Annan Athlet,1037,7,12,11,13,48,41,7,47
Berwick,1037,8,8,10,18,31,62,-31,34
Edinburgh Ci,1037,9,7,9,20,36,63,-27,30
Cowdenbeath,1037,10,4,10,22,23,55,-32,22
Montrose,1038,1,24,7,5,63,37,26,79
Peterhead,1038,2,24,4,8,82,39,43,76
Stirling,1038,3,16,7,13,62,53,9,55
Stenhousem'r,1038,4,15,9,12,57,48,9,54
Clyde,1038,5,15,9,12,54,48,6,54
Elgin,1038,6,14,6,16,56,64,-8,48
Annan Athlet,1038,7,11,11,14,49,44,5,44
Berwick,1038,8,8,10,18,29,61,-32,34
Edinburgh Ci,1038,9,7,9,20,37,65,-28,30
Cowdenbeath,1038,10,5,10,21,26,56,-30,25
Montrose,1039,1,23,8,5,61,36,25,77
Peterhead,1039,2,24,4,8,81,39,42,76
Stirling,1039,3,16,7,13,61,52,9,55
Stenhousem'r,1039,4,15,9,12,56,47,9,54
Clyde,1039,5,15,9,12,55,48,7,54
Elgin,1039,6,14,7,15,55,62,-7,49
Annan Athlet,1039,7,11,12,13,48,42,6,45
Berwick,1039,8,8,10,18,29,62,-33,34
Edinburgh Ci,1039,9,7,9,20,37,64,-27,30
Cowdenbeath,1039,10,4,11,21,24,55,-31,23
Peterhead,1040,1,24,4,8,79,39,40,76
Montrose,1040,2,23,7,6,60,36,24,76
Stirling,1040,3,17,6,13,63,52,11,57
Stenhousem'r,1040,4,15,8,13,56,49,7,53
Clyde,1040,5,14,10,12,53,50,3,52
Elgin,1040,6,15,6,15,55,61,-6,51
Annan Athlet,1040,7,11,11,14,48,44,4,44
Berwick,1040,8,8,11,17,31,60,-29,35
Edinburgh Ci,1040,9,7,9,20,37,62,-25,30
Cowdenbeath,1040,10,5,10,21,26,55,-29,25
Montrose,1041,1,23,7,6,60,36,24,76
Peterhead,1041,2,23,4,9,77,40,37,73
Stirling,1041,3,17,6,13,62,52,10,57
Stenhousem'r,1041,4,15,8,13,56,48,8,53
Clyde,1041,5,14,10,12,53,50,3,52
Elgin,1041,6,15,6,15,55,61,-6,51
Annan Athlet,1041,7,12,11,13,49,41,8,47
Berwick,1041,8,8,11,17,31,60,-29,35
Edinburgh Ci,1041,9,8,9,19,38,60,-22,33
Cowdenbeath,1041,10,4,10,22,23,56,-33,22
Montrose,1042,1,23,8,5,61,36,25,77
Peterhead,1042,2,23,4,9,77,40,37,73
Stirling,1042,3,17,6,13,62,52,10,57
Stenhousem'r,1042,4,15,8,13,56,48,8,53
Clyde,1042,5,14,9,13,51,51,0,51
Elgin,1042,6,14,7,15,55,62,-7,49
Annan Athlet,1042,7,12,11,13,48,41,7,47
Berwick,1042,8,9,10,17,32,58,-26,37
Edinburgh Ci,1042,9,8,9,19,38,60,-22,33
Cowdenbeath,1042,10,4,10,22,23,55,-32,22
Montrose,1043,1,23,8,5,61,36,25,77
Peterhead,1043,2,24,4,8,79,39,40,76
Stirling,1043,3,17,6,13,62,51,11,57
Stenhousem'r,1043,4,15,8,13,55,48,7,53
Clyde,1043,5,14,9,13,51,49,2,51
Elgin,1043,6,14,7,15,55,62,-7,49
Annan Athlet,1043,7,12,11,13,49,42,7,47
Berwick,1043,8,9,10,17,30,58,-28,37
Edinburgh Ci,1043,9,7,9,20,37,62,-25,30
Cowdenbeath,1043,10,4,10,22,24,56,-32,22
Montrose,1044,1,24,7,5,61,35,26,79
Peterhead,1044,2,24,4,8,79,39,40,76
Stenhousem'r,1044,3,16,8,12,56,46,10,56
Stirling,1044,4,16,6,14,60,52,8,54
Clyde,1044,5,15,9,12,52,48,4,54
Elgin,1044,6,14,6,16,54,62,-8,48
Annan Athlet,1044,7,12,11,13,50,41,9,47
Berwick,1044,8,8,10,18,29,59,-30,34
Edinburgh Ci,1044,9,7,9,20,37,62,-25,30
Cowdenbeath,1044,10,4,10,22,23,57,-34,22
Montrose,1045,1,23,8,5,60,35,25,77
Peterhead,1045,2,24,4,8,79,38,41,76
Stirling,1045,3,17,6,13,63,52,11,57
Clyde,1045,4,15,9,12,55,48,7,54
Stenhousem'r,1045,5,15,8,13,56,49,7,53
Elgin,1045,6,14,7,15,54,61,-7,49
Annan Athlet,1045,7,11,11,14,47,43,4,44
Berwick,1045,8,8,10,18,29,62,-33,34
Edinburgh Ci,1045,9,7,9,20,36,62,-26,30
Cowdenbeath,1045,10,5,10,21,25,54,-29,25
Montrose,1046,1,23,8,5,60,35,25,77
Peterhead,1046,2,24,4,8,78,38,40,76
Stenhousem'r,1046,3,16,8,12,56,46,10,56
Stirling,1046,4,16,6,14,60,52,8,54
Clyde,1046,5,15,9,12,52,48,4,54
Elgin,1046,6,14,7,15,54,61,-7,49
Annan Athlet,1046,7,11,12,13,47,41,6,45
Berwick,1046,8,8,10,18,29,59,-30,34
Edinburgh Ci,1046,9,7,9,20,36,61,-25,30
Cowdenbeath,1046,10,4,11,21,23,54,-31,23
Montrose,1047,1,24,7,5,65,34,31,79
Peterhead,1047,2,23,5,8,79,40,39,74
Stirling,1047,3,17,6,13,62,51,11,57
Clyde,1047,4,15,9,12,55,50,5,54
Stenhousem'r,1047,5,15,8,13,55,48,7,53
Elgin,1047,6,14,6,16,53,66,-13,48
Annan Athlet,1047,7,11,11,14,47,42,5,44
Berwick,1047,8,8,10,18,31,62,-31,34
Edinburgh Ci,1047,9,7,10,19,38,62,-24,31
Cowdenbeath,1047,10,5,10,21,24,54,-30,25
Montrose,1048,1,24,7,5,61,34,27,79
Peterhead,1048,2,23,5,8,78,39,39,74
Stirling,1048,3,16,7,13,61,52,9,55
Stenhousem'r,1048,4,15,9,12,56,47,9,54
Clyde,1048,5,14,9,13,52,50,2,51
Elgin,1048,6,14,6,16,53,62,-9,48
Annan Athlet,1048,7,12,11,13,50,43,7,47
Berwick,1048,8,9,10,17,31,59,-28,37
Edinburgh Ci,1048,9,7,10,19,37,61,-24,31
Cowdenbeath,1048,10,4,10,22,25,57,-32,22
Montrose,1049,1,24,7,5,61,35,26,79
Peterhead,1049,2,24,4,8,80,40,40,76
Stirling,1049,3,17,6,13,61,51,10,57
Clyde,1049,4,15,9,12,55,51,4,54
Stenhousem'r,1049,5,15,8,13,55,47,8,53
Elgin,1049,6,14,6,16,54,62,-8,48
Annan Athlet,1049,7,11,11,14,47,43,4,44
Berwick,1049,8,8,10,18,32,62,-30,34
Edinburgh Ci,1049,9,7,9,20,38,63,-25,30
Cowdenbeath,1049,10,5,10,21,25,54,-29,25
Montrose,1050,1,23,8,5,59,34,25,77
Peterhead,1050,2,24,4,8,80,38,42,76
Stirling,1050,3,17,6,13,61,51,10,57
Clyde,1050,4,15,9,12,53,49,4,54
Stenhousem'r,1050,5,15,8,13,55,47,8,53
Elgin,1050,6,14,7,15,53,60,-7,49
Annan Athlet,1050,7,12,11,13,49,41,8,47
Berwick,1050,8,8,10,18,30,60,-30,34
Edinburgh Ci,1050,9,7,9,20,36,63,-27,30
Cowdenbeath,1050,10,4,10,22,23,56,-33,22
Montrose,1051,1,24,7,5,62,36,26,79
Peterhead,1051,2,24,4,8,78,38,40,76
Stirling,1051,3,17,6,13,61,51,10,57
Stenhousem'r,1051,4,15,8,13,55,47,8,53
Clyde,1051,5,14,9,13,51,49,2,51
Elgin,1051,6,14,6,16,55,63,-8,48
Annan Athlet,1051,7,12,11,13,48,41,7,47
Berwick,1051,8,9,10,17,30,58,-28,37
Edinburgh Ci,1051,9,7,9,20,36,61,-25,30
Cowdenbeath,1051,10,4,10,22,23,55,-32,22
Montrose,1052,1,24,7,5,64,34,30,79
Peterhead,1052,2,24,4,8,81,38,43,76
Stirling,1052,3,17,6,13,63,52,11,57
Clyde,1052,4,15,9,12,54,49,5,54
Stenhousem'r,1052,5,15,8,13,56,49,7,53
Elgin,1052,6,14,6,16,53,65,-12,48
Annan Athlet,1052,7,11,11,14,47,45,2,44
Berwick,1052,8,8,10,18,30,61,-31,34
Edinburgh Ci,1052,9,7,9,20,36,64,-28,30
Cowdenbeath,1052,10,5,10,21,27,54,-27,25
Montrose,1053,1,24,7,5,60,34,26,79
Peterhead,1053,2,24,4,8,80,38,42,76
Stirling,1053,3,16,7,13,61,52,9,55
Stenhousem'r,1053,4,15,9,12,56,47,9,54
Clyde,1053,5,15,9,12,53,48,5,54
Elgin,1053,6,14,6,16,53,61,-8,48
Annan Athlet,1053,7,11,11,14,47,43,4,44
Berwick,1053,8,8,10,18,29,60,-31,34
Edinburgh Ci,1053,9,7,9,20,36,63,-27,30
Cowdenbeath,1053,10,5,10,21,25,54,-29,25
Montrose,1054,1,24,7,5,63,34,29,79
Peterhead,1054,2,23,5,8,78,39,39,74
Stirling,1054,3,17,6,13,62,52,10,57
Clyde,1054,4,15,9,12,57,50,7,54
Stenhousem'r,1054,5,15,8,13,56,48,8,53
Elgin,1054,6,14,6,16,53,64,-11,48
Annan Athlet,1054,7,11,12,13,48,42,6,45
Berwick,1054,8,8,10,18,31,64,-33,34
Edinburgh Ci,1054,9,7,10,19,37,61,-24,31
Cowdenbeath,1054,10,4,11,21,24,55,-31,23
Montrose,1055,1,24,7,5,60,34,26,79
Peterhead,1055,2,24,4,8,79,38,41,76
Stirling,1055,3,16,7,13,60,51,9,55
Stenhousem'r,1055,4,15,9,12,55,46,9,54
Clyde,1055,5,15,9,12,53,49,4,54
Elgin,1055,6,14,6,16,53,61,-8,48
Annan Athlet,1055,7,11,11,14,47,43,4,44
Berwick,1055,8,8,10,18,30,60,-30,34
Edinburgh Ci,1055,9,7,9,20,36,62,-26,30
Cowdenbeath,1055,10,5,10,21,25,54,-29,25
Montrose,1056,1,24,7,5,65,35,30,79
Peterhead,1056,2,24,4,8,81,38,43,76
Stirling,1056,3,16,7,13,61,52,9,55
Stenhousem'r,1056,4,15,9,12,56,47,9,54
Clyde,1056,5,15,9,12,52,48,4,54
Elgin,1056,6,14,6,16,54,66,-12,48
Annan Athlet,1056,7,12,11,13,48,41,7,47
Berwick,1056,8,8,10,18,29,59,-30,34
Edinburgh Ci,1056,9,7,9,20,36,64,-28,30
Cowdenbeath,1056,10,4,10,22,23,55,-32,22
Montrose,1057,1,24,7,5,64,36,28,79
Peterhead,1057,2,24,4,8,80,39,41,76
Stenhousem'r,1057,3,16,8,12,59,49,10,56
Stirling,1057,4,16,6,14,63,55,8,54
Clyde,1057,5,15,9,12,52,48,4,54
Elgin,1057,6,14,6,16,55,65,-10,48
Annan Athlet,1057,7,12,11,13,49,41,8,47
Berwick,1057,8,8,10,18,29,59,-30,34
Edinburgh Ci,1057,9,7,9,20,37,63,-26,30
Cowdenbeath,1057,10,4,10,22,23,56,-33,22
Montrose,1058,1,24,7,5,60,34,26,79
Peterhead,1058,2,23,4,9,78,40,38,73
Stirling,1058,3,16,7,13,61,52,9,55
Stenhousem'r,1058,4,15,9,12,56,47,9,54
Clyde,1058,5,14,10,12,52,49,3,52
Elgin,1058,6,14,6,16,53,61,-8,48
Annan Athlet,1058,7,12,11,13,50,41,9,47
Berwick,1058,8,8,11,17,30,59,-29,35
Edinburgh Ci,1058,9,8,9,19,38,61,-23,33
Cowdenbeath,1058,10,4,10,22,23,57,-34,22
Montrose,1059,1,23,8,5,60,35,25,77
Peterhead,1059,2,23,5,8,78,39,39,74
Stirling,1059,3,17,6,13,64,52,12,57
Clyde,1059,4,15,9,12,55,48,7,54
Stenhousem'r,1059,5,15,8,13,56,50,6,53
Elgin,1059,6,14,7,15,54,61,-7,49
Annan Athlet,1059,7,12,11,13,48,41,7,47
Berwick,1059,8,8,10,18,29,62,-33,34
Edinburgh Ci,1059,9,7,10,19,37,61,-24,31
Cowdenbeath,1059,10,4,10,22,23,55,-32,22
Montrose,1060,1,24,7,5,63,34,29,79
Peterhead,1060,2,24,4,8,81,38,43,76
Stirling,1060,3,16,7,13,62,53,9,55
Stenhousem'r,1060,4,15,9,12,57,48,9,54
Clyde,1060,5,15,9,12,52,48,4,54
Elgin,1060,6,14,6,16,53,64,-11,48
Annan Athlet,1060,7,12,11,13,49,41,8,47
Berwick,1060,8,8,10,18,29,59,-30,34
Edinburgh Ci,1060,9,7,9,20,36,64,-28,30
Cowdenbeath,1060,10,4,10,22,23,56,-33,22
Montrose,1061,1,24,7,5,60,34,26,79
Peterhead,1061,2,24,4,8,80,39,41,76
Stirling,1061,3,17,6,13,63,51,12,57
Stenhousem'r,1061,4,15,8,13,55,49,6,53
Clyde,1061,5,14,9,13,51,50,1,51
Elgin,1061,6,14,6,16,53,61,-8,48
Annan Athlet,1061,7,11,12,13,47,41,6,45
Berwick,1061,8,9,10,17,31,58,-27,37
Edinburgh Ci,1061,9,7,9,20,37,63,-26,30
Cowdenbeath,1061,10,4,11,21,23,54,-31,23
Montrose,1062,1,24,7,5,62,34,28,79
Peterhead,1062,2,24,4,8,80,38,42,76
Stenhousem'r,1062,3,16,8,12,57,46,11,56
Stirling,1062,4,16,6,14,60,53,7,54
Clyde,1062,5,14,10,12,51,48,3,52
Elgin,1062,6,14,6,16,53,63,-10,48
Annan Athlet,1062,7,12,11,13,50,41,9,47
Berwick,1062,8,8,11,17,29,58,-29,35
Edinburgh Ci,1062,9,7,9,20,36,63,-27,30
Cowdenbeath,1062,10,4,10,22,23,57,-34,22
Montrose,1063,1,24,7,5,63,35,28,79
Peterhead,1063,2,23,5,8,78,39,39,74
Stirling,1063,3,17,6,13,63,52,11,57
Stenhousem'r,1063,4,15,8,13,56,49,7,53
Clyde,1063,5,14,10,12,52,49,3,52
Elgin,1063,6,14,6,16,54,64,-10,48
Annan Athlet,1063,7,11,12,13,50,44,6,45
Berwick,1063,8,8,11,17,30,59,-29,35
Edinburgh Ci,1063,9,7,10,19,37,61,-24,31
Cowdenbeath,1063,10,4,11,21,26,57,-31,23
Peterhead,1064,1,24,4,8,79,38,41,76
Montrose,1064,2,23,7,6,60,37,23,76
Stirling,1064,3,16,7,13,61,52,9,55
Stenhousem'r,1064,4,15,9,12,56,47,9,54
Clyde,1064,5,14,10,12,52,49,3,52
Elgin,1064,6,15,6,15,56,61,-5,51
Annan Athlet,1064,7,11,12,13,48,42,6,45
Berwick,1064,8,8,11,17,30,59,-29,35
Edinburgh Ci,1064,9,7,9,20,36,62,-26,30
Cowdenbeath,1064,10,4,11,21,24,55,-31,23
Montrose,1065,1,24,7,5,62,35,27,79
Peterhead,1065,2,24,4,8,79,39,40,76
Stirling,1065,3,17,6,13,62,52,10,57
Stenhousem'r,1065,4,15,8,13,56,48,8,53
Clyde,1065,5,14,10,12,51,48,3,52
Elgin,1065,6,14,6,16,54,63,-9,48
Annan Athlet,1065,7,12,11,13,49,42,7,47
Berwick,1065,8,8,11,17,29,58,-29,35
Edinburgh Ci,1065,9,7,9,20,37,62,-25,30
Cowdenbeath,1065,10,4,10,22,24,56,-32,22
Montrose,1066,1,24,7,5,60,34,26,79
Peterhead,1066,2,24,4,8,80,40,40,76
Stenhousem'r,1066,3,16,8,12,57,47,10,56
Stirling,1066,4,16,6,14,61,53,8,54
Clyde,1066,5,15,9,12,52,48,4,54
Elgin,1066,6,14,6,16,53,61,-8,48
Annan Athlet,1066,7,11,12,13,48,42,6,45
Berwick,1066,8,8,10,18,29,59,-30,34
Edinburgh Ci,1066,9,7,9,20,38,63,-25,30
Cowdenbeath,1066,10,4,11,21,24,55,-31,23
Montrose,1067,1,23,8,5,62,37,25,77
Peterhead,1067,2,23,5,8,77,38,39,74
Stenhousem'r,1067,3,16,8,12,59,49,10,56
Stirling,1067,4,16,6,14,63,55,8,54
Clyde,1067,5,15,9,12,57,49,8,54
Elgin,1067,6,14,7,15,56,63,-7,49
Annan Athlet,1067,7,11,11,14,47,43,4,44
Berwick,1067,8,8,10,18,30,64,-34,34
Edinburgh Ci,1067,9,7,10,19,36,60,-24,31
Cowdenbeath,1067,10,5,10,21,25,54,-29,25
Montrose,1068,1,24,7,5,66,34,32,79
Peterhead,1068,2,24,4,8,79,38,41,76
Stenhousem'r,1068,3,16,8,12,60,49,11,56
Stirling,1068,4,16,6,14,63,56,7,54
Clyde,1068,5,14,10,12,52,49,3,52
Elgin,1068,6,14,6,16,53,67,-14,48
Annan Athlet,1068,7,11,11,14,48,43,5,44
Berwick,1068,8,8,11,17,30,59,-29,35
Edinburgh Ci,1068,9,7,9,20,36,62,-26,30
Cowdenbeath,1068,10,5,10,21,25,55,-30,25
Montrose,1069,1,23,8,5,61,36,25,77
Peterhead,1069,2,24,4,8,80,39,41,76
Stenhousem'r,1069,3,16,8,12,57,46,11,56
Stirling,1069,4,16,6,14,60,53,7,54
Clyde,1069,5,15,9,12,54,48,6,54
Elgin,1069,6,14,7,15,55,62,-7,49
Annan Athlet,1069,7,11,12,13,48,42,6,45
Berwick,1069,8,8,10,18,29,61,-32,34
Edinburgh Ci,1069,9,7,9,20,37,63,-26,30
Cowdenbeath,1069,10,4,11,21,24,55,-31,23
Montrose,1070,1,24,7,5,63,37,26,79
Peterhead,1070,2,24,4,8,82,39,43,76
Stirling,1070,3,17,6,13,63,52,11,57
Stenhousem'r,1070,4,15,8,13,56,49,7,53
Clyde,1070,5,14,10,12,52,49,3,52
Elgin,1070,6,14,6,16,56,64,-8,48
Annan Athlet,1070,7,11,12,13,48,42,6,45
Berwick,1070,8,8,11,17,30,59,-29,35
Edinburgh Ci,1070,9,7,9,20,37,65,-28,30
Cowdenbeath,1070,10,4,11,21,24,55,-31,23
Peterhead,1071,1,24,4,8,79,38,41,76
Montrose,1071,2,23,7,6,59,35,24,76
Stirling,1071,3,17,6,13,62,51,11,57
Stenhousem'r,1071,4,15,8,13,55,48,7,53
Clyde,1071,5,14,10,12,52,49,3,52
Elgin,1071,6,15,6,15,54,60,-6,51
Annan Athlet,1071,7,12,11,13,49,42,7,47
Berwick,1071,8,8,11,17,30,59,-29,35
Edinburgh Ci,1071,9,7,9,20,36,62,-26,30
Cowdenbeath,1071,10,4,10,22,24,56,-32,22
Montrose,1072,1,24,7,5,61,35,26,79
Peterhead,1072,2,24,4,8,81,38,43,76
Stirling,1072,3,17,6,13,61,51,10,57
Stenhousem'r,1072,4,15,8,13,55,47,8,53
Clyde,1072,5,14,10,12,53,50,3,52
Elgin,1072,6,14,6,16,54,62,-8,48
Annan Athlet,1072,7,11,11,14,47,43,4,44
Berwick,1072,8,8,11,17,31,60,-29,35
Edinburgh Ci,1072,9,7,9,20,36,64,-28,30
Cowdenbeath,1072,10,5,10,21,25,54,-29,25
Montrose,1073,1,23,8,5,61,36,25,77
Peterhead,1073,2,24,4,8,79,38,41,76
Stirling,1073,3,16,7,13,60,51,9,55
Stenhousem'r,1073,4,15,9,12,55,46,9,54
Clyde,1073,5,14,9,13,51,51,0,51
Elgin,1073,6,14,7,15,55,62,-7,49
Annan Athlet,1073,7,11,11,14,47,42,5,44
Berwick,1073,8,9,10,17,32,58,-26,37
Edinburgh Ci,1073,9,7,9,20,36,62,-26,30
Cowdenbeath,1073,10,5,10,21,24,54,-30,25
Montrose,1074,1,24,7,5,61,35,26,79
Peterhead,1074,2,24,4,8,79,38,41,76
Stirling,1074,3,17,6,13,63,53,10,57
Stenhousem'r,1074,4,15,8,13,57,49,8,53
Clyde,1074,5,14,9,13,52,50,2,51
Elgin,1074,6,14,6,16,54,62,-8,48
Annan Athlet,1074,7,11,12,13,47,41,6,45
Berwick,1074,8,9,10,17,31,59,-28,37
Edinburgh Ci,1074,9,7,9,20,36,62,-26,30
Cowdenbeath,1074,10,4,11,21,23,54,-31,23
Montrose,1075,1,24,7,5,63,34,29,79
Peterhead,1075,2,24,4,8,79,38,41,76
Stirling,1075,3,17,6,13,61,51,10,57
Clyde,1075,4,15,9,12,53,48,5,54
Stenhousem'r,1075,5,15,8,13,55,47,8,53
Elgin,1075,6,14,6,16,53,64,-11,48
Annan Athlet,1075,7,11,11,14,48,43,5,44
Berwick,1075,8,8,10,18,29,60,-31,34
Edinburgh Ci,1075,9,7,9,20,36,62,-26,30
Cowdenbeath,1075,10,5,10,21,25,55,-30,25
Montrose,1076,1,24,7,5,60,34,26,79
Peterhead,1076,2,24,4,8,82,39,43,76
Stenhousem'r,1076,3,16,8,12,58,48,10,56
Stirling,1076,4,16,6,14,62,54,8,54
Clyde,1076,5,14,10,12,53,50,3,52
Elgin,1076,6,14,6,16,53,61,-8,48
Annan Athlet,1076,7,11,11,14,47,42,5,44
Berwick,1076,8,8,11,17,31,60,-29,35
Edinburgh Ci,1076,9,7,9,20,37,65,-28,30
Cowdenbeath,1076,10,5,10,21,24,54,-30,25
Montrose,1077,1,24,7,5,60,34,26,79
Peterhead,1077,2,24,4,8,79,38,41,76
Stenhousem'r,1077,3,16,8,12,58,47,11,56
Stirling,1077,4,16,6,14,61,54,7,54
Clyde,1077,5,15,9,12,54,48,6,54
Elgin,1077,6,14,6,16,53,61,-8,48
Annan Athlet,1077,7,11,11,14,47,43,4,44
Berwick,1077,8,8,10,18,29,61,-32,34
Edinburgh Ci,1077,9,7,9,20,36,62,-26,30
Cowdenbeath,1077,10,5,10,21,25,54,-29,25
Montrose,1078,1,24,7,5,63,34,29,79
Peterhead,1078,2,24,4,8,81,39,42,76
Stenhousem'r,1078,3,16,8,12,58,48,10,56
Clyde,1078,4,15,9,12,58,49,9,54
Stirling,1078,5,16,6,14,62,54,8,54
Elgin,1078,6,14,6,16,53,64,-11,48
Annan Athlet,1078,7,11,11,14,49,44,5,44
Berwick,1078,8,8,10,18,30,65,-35,34
Edinburgh Ci,1078,9,7,9,20,37,64,-27,30
Cowdenbeath,1078,10,5,10,21,26,56,-30,25
Montrose,1079,1,23,8,5,59,34,25,77
Peterhead,1079,2,24,4,8,79,38,41,76
Stirling,1079,3,17,6,13,62,51,11,57
Clyde,1079,4,15,9,12,54,48,6,54
Stenhousem'r,1079,5,15,8,13,55,48,7,53
Elgin,1079,6,14,7,15,53,60,-7,49
Annan Athlet,1079,7,11,11,14,47,42,5,44
Berwick,1079,8,8,10,18,29,61,-32,34
Edinburgh Ci,1079,9,7,9,20,36,62,-26,30
Cowdenbeath,1079,10,5,10,21,24,54,-30,25
Peterhead,1080,1,24,4,8,79,38,41,76
Montrose,1080,2,23,7,6,59,36,23,76
Stirling,1080,3,16,7,13,61,52,9,55
Stenhousem'r,1080,4,15,9,12,56,47,9,54
Clyde,1080,5,14,9,13,52,50,2,51
Elgin,1080,6,15,6,15,55,60,-5,51
Annan Athlet,1080,7,11,11,14,48,44,4,44
Berwick,1080,8,9,10,17,31,59,-28,37
Edinburgh Ci,1080,9,7,9,20,36,62,-26,30
Cowdenbeath,1080,10,5,10,21,26,55,-29,25
Montrose,1081,1,24,7,5,61,35,26,79
Peterhead,1081,2,24,4,8,79,38,41,76
Stirling,1081,3,17,6,13,64,51,13,57
Clyde,1081,4,15,9,12,53,49,4,54
Stenhousem'r,1081,5,15,8,13,55,50,5,53
Elgin,1081,6,14,6,16,54,62,-8,48
Annan Athlet,1081,7,11,12,13,47,41,6,45
Berwick,1081,8,8,10,18,30,60,-30,34
Edinburgh Ci,1081,9,7,9,20,36,62,-26,30
Cowdenbeath,1081,10,4,11,21,23,54,-31,23
Peterhead,1082,1,24,4,8,80,38,42,76
Montrose,1082,2,23,7,6,59,35,24,76
Stirling,1082,3,17,6,13,64,53,11,57
Clyde,1082,4,15,9,12,54,48,6,54
Stenhousem'r,1082,5,15,8,13,57,50,7,53
Elgin,1082,6,15,6,15,54,60,-6,51
Annan Athlet,1082,7,11,11,14,47,42,5,44
Berwick,1082,8,8,10,18,29,61,-32,34
Edinburgh Ci,1082,9,7,9,20,36,63,-27,30
Cowdenbeath,1082,10,5,10,21,24,54,-30,25
Montrose,1083,1,24,7,5,60,34,26,79
Peterhead,1083,2,23,5,8,77,38,39,74
Stirling,1083,3,17,6,13,62,52,10,57
Clyde,1083,4,15,9,12,57,48,9,54
Stenhousem'r,1083,5,15,8,13,56,48,8,53
Elgin,1083,6,14,6,16,53,61,-8,48
Annan Athlet,1083,7,11,11,14,48,44,4,44
Berwick,1083,8,8,10,18,29,64,-35,34
Edinburgh Ci,1083,9,7,10,19,36,60,-24,31
Cowdenbeath,1083,10,5,10,21,26,55,-29,25
Peterhead,1084,1,24,4,8,80,39,41,76
Montrose,1084,2,23,7,6,60,37,23,76
Stenhousem'r,1084,3,16,8,12,57,46,11,56
Stirling,1084,4,16,6,14,60,53,7,54
Clyde,1084,5,15,9,12,53,48,5,54
Elgin,1084,6,15,6,15,56,61,-5,51
Annan Athlet,1084,7,11,12,13,48,42,6,45
Berwick,1084,8,8,10,18,29,60,-31,34
Edinburgh Ci,1084,9,7,9,20,37,63,-26,30
Cowdenbeath,1084,10,4,11,21,24,55,-31,23
Montrose,1085,1,24,7,5,65,35,30,79
Peterhead,1085,2,23,5,8,77,38,39,74
Stirling,1085,3,17,6,13,64,51,13,57
Stenhousem'r,1085,4,15,8,13,55,50,5,53
Clyde,1085,5,14,10,12,51,48,3,52
Elgin,1085,6,14,6,16,54,66,-12,48
Annan Athlet,1085,7,12,11,13,48,41,7,47
Berwick,1085,8,8,11,17,29,58,-29,35
Edinburgh Ci,1085,9,7,10,19,36,60,-24,31
Cowdenbeath,1085,10,4,10,22,23,55,-32,22
Montrose,1086,1,23,8,5,61,36,25,77
Peterhead,1086,2,24,4,8,81,38,43,76
Stirling,1086,3,17,6,13,62,52,10,57
Stenhousem'r,1086,4,15,8,13,56,48,8,53
Clyde,1086,5,14,10,12,52,49,3,52
Elgin,1086,6,14,7,15,55,62,-7,49
Annan Athlet,1086,7,11,11,14,47,42,5,44
Berwick,1086,8,8,11,17,30,59,-29,35
Edinburgh Ci,1086,9,7,9,20,36,64,-28,30
Cowdenbeath,1086,10,5,10,21,24,54,-30,25
Peterhead,1087,1,24,4,8,80,38,42,76
Montrose,1087,2,23,7,6,59,35,24,76
Stirling,1087,3,17,6,13,62,51,11,57
Stenhousem'r,1087,4,15,8,13,55,48,7,53
Clyde,1087,5,14,10,12,53,50,3,52
Elgin,1087,6,15,6,15,54,60,-6,51
Annan Athlet,1087,7,11,11,14,47,43,4,44
Berwick,1087,8,8,11,17,31,60,-29,35
Edinburgh Ci,1087,9,7,9,20,36,63,-27,30
Cowdenbeath,1087,10,5,10,21,25,54,-29,25
Montrose,1088,1,24,7,5,61,34,27,79
Peterhead,1088,2,23,5,8,78,39,39,74
Stenhousem'r,1088,3,16,8,12,56,46,10,56
Stirling,1088,4,16,6,14,60,52,8,54
Clyde,1088,5,15,9,12,54,48,6,54
Elgin,1088,6,14,6,16,53,62,-9,48
Annan Athlet,1088,7,11,11,14,47,42,5,44
Berwick,1088,8,8,10,18,29,61,-32,34
Edinburgh Ci,1088,9,7,10,19,37,61,-24,31
Cowdenbeath,1088,10,5,10,21,24,54,-30,25
Montrose,1089,1,24,7,5,60,34,26,79
Peterhead,1089,2,24,4,8,81,38,43,76
Stirling,1089,3,17,6,13,62,51,11,57
Stenhousem'r,1089,4,15,8,13,55,48,7,53
Clyde,1089,5,14,10,12,52,49,3,52
Elgin,1089,6,14,6,16,53,61,-8,48
Annan Athlet,1089,7,12,11,13,49,41,8,47
Berwick,1089,8,8,11,17,30,59,-29,35
Edinburgh Ci,1089,9,7,9,20,36,64,-28,30
Cowdenbeath,1089,10,4,10,22,23,56,-33,22
Montrose,1090,1,24,7,5,65,36,29,79
Peterhead,1090,2,24,4,8,79,38,41,76
Stirling,1090,3,17,6,13,63,52,11,57
Stenhousem'r,1090,4,15,8,13,56,49,7,53
Clyde,1090,5,14,10,12,52,49,3,52
Elgin,1090,6,14,6,16,55,66,-11,48
Annan Athlet,1090,7,12,11,13,50,43,7,47
Berwick,1090,8,8,11,17,30,59,-29,35
Edinburgh Ci,1090,9,7,9,20,36,62,-26,30
Cowdenbeath,1090,10,4,10,22,25,57,-32,22
Montrose,1091,1,24,7,5,61,34,27,79
Peterhead,1091,2,24,4,8,81,38,43,76
Stenhousem'r,1091,3,16,8,12,58,46,12,56
Stirling,1091,4,16,6,14,60,54,6,54
Clyde,1091,5,14,10,12,53,50,3,52
Elgin,1091,6,14,6,16,53,62,-9,48
Annan Athlet,1091,7,11,11,14,47,43,4,44
Berwick,1091,8,8,11,17,31,60,-29,35
Edinburgh Ci,1091,9,7,9,20,36,64,-28,30
Cowdenbeath,1091,10,5,10,21,25,54,-29,25
Peterhead,1092,1,24,4,8,81,39,42,76
Montrose,1092,2,23,7,6,60,36,24,76
Stirling,1092,3,17,6,13,62,52,10,57
Stenhousem'r,1092,4,15,8,13,56,48,8,53
Clyde,1092,5,14,10,12,51,48,3,52
Elgin,1092,6,15,6,15,55,61,-6,51
Annan Athlet,1092,7,12,11,13,48,41,7,47
Berwick,1092,8,8,11,17,29,58,-29,35
Edinburgh Ci,1092,9,7,9,20,37,64,-27,30
Cowdenbeath,1092,10,4,10,22,23,55,-32,22
Peterhead,1093,1,24,4,8,81,40,41,76
Montrose,1093,2,23,7,6,59,35,24,76
Stirling,1093,3,17,6,13,63,53,10,57
Clyde,1093,4,15,9,12,53,49,4,54
Stenhousem'r,1093,5,15,8,13,57,49,8,53
Elgin,1093,6,15,6,15,54,60,-6,51
Annan Athlet,1093,7,11,11,14,47,42,5,44
Berwick,1093,8,8,10,18,30,60,-30,34
Edinburgh Ci,1093,9,7,9,20,38,64,-26,30
Cowdenbeath,1093,10,5,10,21,24,54,-30,25
Peterhead,1094,1,24,4,8,80,38,42,76
Montrose,1094,2,23,7,6,59,37,22,76
Stirling,1094,3,17,6,13,64,52,12,57
Stenhousem'r,1094,4,15,8,13,56,50,6,53
Clyde,1094,5,14,10,12,52,49,3,52
Elgin,1094,6,15,6,15,56,60,-4,51
Annan Athlet,1094,7,11,11,14,48,43,5,44
Berwick,1094,8,8,11,17,30,59,-29,35
Edinburgh Ci,1094,9,7,9,20,36,63,-27,30
Cowdenbeath,1094,10,5,10,21,25,55,-30,25
Montrose,1095,1,24,7,5,61,34,27,79
Peterhead,1095,2,24,4,8,78,38,40,76
Stenhousem'r,1095,3,16,8,12,58,46,12,56
Stirling,1095,4,16,6,14,60,54,6,54
Clyde,1095,5,14,10,12,52,49,3,52
Elgin,1095,6,14,6,16,53,62,-9,48
Annan Athlet,1095,7,11,12,13,49,43,6,45
Berwick,1095,8,8,11,17,30,59,-29,35
Edinburgh Ci,1095,9,7,9,20,36,61,-25,30
Cowdenbeath,1095,10,4,11,21,25,56,-31,23
Montrose,1096,1,24,7,5,61,35,26,79
Peterhead,1096,2,23,4,9,78,40,38,73
Stirling,1096,3,17,6,13,61,51,10,57
Clyde,1096,4,15,9,12,54,50,4,54
Stenhousem'r,1096,5,15,8,13,55,47,8,53
Elgin,1096,6,14,6,16,54,62,-8,48
Annan Athlet,1096,7,11,11,14,48,43,5,44
Berwick,1096,8,8,10,18,31,61,-30,34
Edinburgh Ci,1096,9,8,9,19,38,61,-23,33
Cowdenbeath,1096,10,5,10,21,25,55,-30,25
Montrose,1097,1,24,7,5,61,35,26,79
Peterhead,1097,2,24,4,8,80,38,42,76
Stirling,1097,3,17,6,13,62,51,11,57
Clyde,1097,4,15,9,12,52,48,4,54
Stenhousem'r,1097,5,15,8,13,55,48,7,53
Elgin,1097,6,14,6,16,54,62,-8,48
Annan Athlet,1097,7,12,11,13,49,41,8,47
Berwick,1097,8,8,10,18,29,59,-30,34
Edinburgh Ci,1097,9,7,9,20,36,63,-27,30
Cowdenbeath,1097,10,4,10,22,23,56,-33,22
Montrose,1098,1,24,7,5,62,34,28,79
Peterhead,1098,2,23,5,8,77,38,39,74
Stirling,1098,3,16,7,13,61,52,9,55
Stenhousem'r,1098,4,15,9,12,56,47,9,54
Clyde,1098,5,14,10,12,53,50,3,52
Elgin,1098,6,14,6,16,53,63,-10,48
Annan Athlet,1098,7,12,11,13,49,41,8,47
Berwick,1098,8,8,11,17,31,60,-29,35
Edinburgh Ci,1098,9,7,10,19,36,60,-24,31
Cowdenbeath,1098,10,4,10,22,23,56,-33,22
Montrose,1099,1,24,7,5,61,34,27,79
Peterhead,1099,2,23,5,8,78,39,39,74
Stenhousem'r,1099,3,16,8,12,57,47,10,56
Stirling,1099,4,16,6,14,61,53,8,54
Clyde,1099,5,14,10,12,52,49,3,52
Elgin,1099,6,14,6,16,53,62,-9,48
Annan Athlet,1099,7,11,11,14,48,43,5,44
Berwick,1099,8,8,11,17,30,59,-29,35
Edinburgh Ci,1099,9,7,10,19,37,61,-24,31
Cowdenbeath,1099,10,5,10,21,25,55,-30,25
Montrose,1100,1,24,7,5,63,35,28,79
Peterhead,1100,2,23,4,9,78,40,38,73
Stirling,1100,3,16,7,13,61,52,9,55
Stenhousem'r,1100,4,15,9,12,56,47,9,54
Clyde,1100,5,14,10,12,52,49,3,52
Elgin,1100,6,14,6,16,54,64,-10,48
Annan Athlet,1100,7,12,11,13,50,43,7,47
Berwick,1100,8,8,11,17,30,59,-29,35
Edinburgh Ci,1100,9,8,9,19,38,61,-23,33
Cowdenbeath,1100,10,4,10,22,25,57,-32,22
Montrose,1101,1,24,7,5,61,34,27,79
Peterhead,1101,2,24,4,8,80,38,42,76
Stirling,1101,3,17,6,13,61,51,10,57
Stenhousem'r,1101,4,15,8,13,55,47,8,53
Clyde,1101,5,14,10,12,52,49,3,52
Elgin,1101,6,14,6,16,53,62,-9,48
Annan Athlet,1101,7,11,11,14,47,42,5,44
Berwick,1101,8,8,11,17,30,59,-29,35
Edinburgh Ci,1101,9,7,9,20,36,63,-27,30
Cowdenbeath,1101,10,5,10,21,24,54,-30,25
Montrose,1102,1,24,7,5,62,34,28,79
Peterhead,1102,2,24,4,8,79,38,41,76
Stirling,1102,3,16,7,13,63,54,9,55
Stenhousem'r,1102,4,15,9,12,58,49,9,54
Clyde,1102,5,15,9,12,54,50,4,54
Elgin,1102,6,14,6,16,53,63,-10,48
Annan Athlet,1102,7,11,12,13,49,43,6,45
Berwick,1102,8,8,10,18,31,61,-30,34
Edinburgh Ci,1102,9,7,9,20,36,62,-26,30
Cowdenbeath,1102,10,4,11,21,25,56,-31,23
Montrose,1103,1,24,7,5,61,34,27,79
Peterhead,1103,2,24,4,8,80,39,41,76
Stirling,1103,3,17,6,13,62,51,11,57
Clyde,1103,4,15,9,12,52,48,4,54
Stenhousem'r,1103,5,15,8,13,55,48,7,53
Elgin,1103,6,14,6,16,53,62,-9,48
Annan Athlet,1103,7,11,12,13,47,41,6,45
Berwick,1103,8,8,10,18,29,59,-30,34
Edinburgh Ci,1103,9,7,9,20,37,63,-26,30
Cowdenbeath,1103,10,4,11,21,23,54,-31,23
Montrose,1104,1,24,7,5,62,35,27,79
Peterhead,1104,2,24,4,8,79,38,41,76
Stenhousem'r,1104,3,16,8,12,56,46,10,56
Stirling,1104,4,16,6,14,60,52,8,54
Clyde,1104,5,15,9,12,52,48,4,54
Elgin,1104,6,14,6,16,54,63,-9,48
Annan Athlet,1104,7,12,11,13,50,42,8,47
Berwick,1104,8,8,10,18,29,59,-30,34
Edinburgh Ci,1104,9,7,9,20,36,62,-26,30
Cowdenbeath,1104,10,4,10,22,24,57,-33,22
Peterhead,1105,1,24,4,8,79,39,40,76
Montrose,1105,2,23,7,6,61,38,23,76
Stenhousem'r,1105,3,16,8,12,57,47,10,56
Stirling,1105,4,16,6,14,61,53,8,54
Clyde,1105,5,15,9,12,54,48,6,54
Elgin,1105,6,15,6,15,57,62,-5,51
Annan Athlet,1105,7,11,11,14,47,44,3,44
Berwick,1105,8,8,10,18,29,61,-32,34
Edinburgh Ci,1105,9,7,9,20,37,62,-25,30
Cowdenbeath,1105,10,5,10,21,26,54,-28,25
Montrose,1106,1,23,8,5,60,35,25,77
Peterhead,1106,2,24,4,8,80,38,42,76
Stirling,1106,3,17,6,13,62,51,11,57
Stenhousem'r,1106,4,15,8,13,55,48,7,53
Clyde,1106,5,14,10,12,53,50,3,52
Elgin,1106,6,14,7,15,54,61,-7,49
Annan Athlet,1106,7,12,11,13,51,42,9,47
Berwick,1106,8,8,11,17,31,60,-29,35
Edinburgh Ci,1106,9,7,9,20,36,63,-27,30
Cowdenbeath,1106,10,4,10,22,24,58,-34,22
Montrose,1107,1,24,7,5,60,34,26,79
Peterhead,1107,2,24,4,8,82,38,44,76
Stenhousem'r,1107,3,16,8,12,57,46,11,56
Stirling,1107,4,16,6,14,60,53,7,54
Clyde,1107,5,15,9,12,52,48,4,54
Elgin,1107,6,14,6,16,53,61,-8,48
Annan Athlet,1107,7,11,11,14,47,42,5,44
Berwick,1107,8,8,10,18,29,59,-30,34
Edinburgh Ci,1107,9,7,9,20,36,65,-29,30
Cowdenbeath,1107,10,5,10,21,24,54,-30,25
Montrose,1108,1,23,8,5,61,36,25,77
Peterhead,1108,2,24,4,8,80,39,41,76
Stirling,1108,3,16,7,13,61,52,9,55
Stenhousem'r,1108,4,15,9,12,56,47,9,54
Clyde,1108,5,14,10,12,51,48,3,52
Elgin,1108,6,14,7,15,55,62,-7,49
Annan Athlet,1108,7,11,11,14,47,44,3,44
Berwick,1108,8,8,11,17,29,58,-29,35
Edinburgh Ci,1108,9,7,9,20,37,63,-26,30
Cowdenbeath,1108,10,5,10,21,26,54,-28,25
Montrose,1109,1,24,7,5,60,34,26,79
Peterhead,1109,2,24,4,8,79,38,41,76
Stirling,1109,3,17,6,13,63,53,10,57
Stenhousem'r,1109,4,15,8,13,57,49,8,53
Clyde,1109,5,14,10,12,52,49,3,52
Elgin,1109,6,14,6,16,53,61,-8,48
Annan Athlet,1109,7,11,12,13,48,42,6,45
Berwick,1109,8,8,11,17,30,59,-29,35
Edinburgh Ci,1109,9,7,9,20,36,62,-26,30
Cowdenbeath,1109,10,4,11,21,24,55,-31,23
Peterhead,1110,1,24,4,8,80,39,41,76
Montrose,1110,2,23,7,6,59,36,23,76
Stenhousem'r,1110,3,16,8,12,57,47,10,56
Stirling,1110,4,16,6,14,61,53,8,54
Clyde,1110,5,14,10,12,52,49,3,52
Elgin,1110,6,15,6,15,55,60,-5,51
Annan Athlet,1110,7,11,11,14,48,43,5,44
Berwick,1110,8,8,11,17,30,59,-29,35
Edinburgh Ci,1110,9,7,9,20,37,63,-26,30
Cowdenbeath,1110,10,5,10,21,25,55,-30,25
Montrose,1111,1,24,7,5,62,34,28,79
Peterhead,1111,2,23,4,9,77,39,38,73
Stenhousem'r,1111,3,16,8,12,57,47,10,56
Stirling,1111,4,16,6,14,61,53,8,54
Clyde,1111,5,15,9,12,52,48,4,54
Elgin,1111,6,14,6,16,53,63,-10,48
Annan Athlet,1111,7,11,11,14,49,45,4,44
Berwick,1111,8,8,10,18,29,59,-30,34
Edinburgh Ci,1111,9,8,9,19,37,60,-23,33
Cowdenbeath,1111,10,5,10,21,27,56,-29,25
Montrose,1112,1,24,7,5,61,34,27,79
Peterhead,1112,2,24,4,8,80,38,42,76
Stirling,1112,3,17,6,13,64,51,13,57
Stenhousem'r,1112,4,15,8,13,55,50,5,53
Clyde,1112,5,14,9,13,52,50,2,51
Elgin,1112,6,14,6,16,53,62,-9,48
Annan Athlet,1112,7,11,11,14,47,42,5,44
Berwick,1112,8,9,10,17,31,59,-28,37
Edinburgh Ci,1112,9,7,9,20,36,63,-27,30
Cowdenbeath,1112,10,5,10,21,24,54,-30,25
Peterhead,1113,1,24,4,8,82,38,44,76
Montrose,1113,2,23,7,6,61,37,24,76
Stenhousem'r,1113,3,16,8,12,57,47,10,56
Stirling,1113,4,16,6,14,61,53,8,54
Clyde,1113,5,15,9,12,52,48,4,54
Elgin,1113,6,15,6,15,56,62,-6,51
Annan Athlet,1113,7,11,11,14,48,44,4,44
Berwick,1113,8,8,10,18,29,59,-30,34
Edinburgh Ci,1113,9,7,9,20,36,65,-29,30
Cowdenbeath,1113,10,5,10,21,26,55,-29,25
Montrose,1114,1,24,7,5,61,34,27,79
Peterhead,1114,2,24,4,8,81,38,43,76
Stirling,1114,3,16,7,13,61,52,9,55
Stenhousem'r,1114,4,15,9,12,56,47,9,54
Clyde,1114,5,14,10,12,51,48,3,52
Elgin,1114,6,14,6,16,53,62,-9,48
Annan Athlet,1114,7,11,12,13,48,42,6,45
Berwick,1114,8,8,11,17,29,58,-29,35
Edinburgh Ci,1114,9,7,9,20,36,64,-28,30
Cowdenbeath,1114,10,4,11,21,24,55,-31,23
Montrose,1115,1,24,7,5,61,35,26,79
Peterhead,1115,2,24,4,8,81,39,42,76
Stirling,1115,3,17,6,13,63,51,12,57
Clyde,1115,4,15,9,12,54,48,6,54
Stenhousem'r,1115,5,15,8,13,55,49,6,53
Elgin,1115,6,14,6,16,54,62,-8,48
Annan Athlet,1115,7,12,11,13,49,42,7,47
Berwick,1115,8,8,10,18,29,61,-32,34
Edinburgh Ci,1115,9,7,9,20,37,64,-27,30
Cowdenbeath,1115,10,4,10,22,24,56,-32,22
Montrose,1116,1,24,7,5,61,34,27,79
Peterhead,1116,2,24,4,8,79,38,41,76
Stirling,1116,3,17,6,13,63,51,12,57
Clyde,1116,4,15,9,12,53,48,5,54
Stenhousem'r,1116,5,15,8,13,55,49,6,53
Elgin,1116,6,14,6,16,53,62,-9,48
Annan Athlet,1116,7,11,11,14,47,42,5,44
Berwick,1116,8,8,10,18,29,60,-31,34
Edinburgh Ci,1116,9,7,9,20,36,62,-26,30
Cowdenbeath,1116,10,5,10,21,24,54,-30,25
Montrose,1117,1,24,7,5,63,35,28,79
Peterhead,1117,2,24,4,8,80,38,42,76
Stirling,1117,3,17,6,13,63,52,11,57
Clyde,1117,4,15,9,12,58,49,9,54
Stenhousem'r,1117,5,15,8,13,56,49,7,53
Elgin,1117,6,14,6,16,54,64,-10,48
Annan Athlet,1117,7,12,11,13,48,41,7,47
Berwick,1117,8,8,10,18,30,65,-35,34
Edinburgh Ci,1117,9,7,9,20,36,63,-27,30
Cowdenbeath,1117,10,4,10,22,23,55,-32,22
Montrose,1118,1,23,7,6,61,37,24,76
Peterhead,1118,2,23,5,8,78,39,39,74
Stirling,1118,3,17,6,13,63,53,10,57
Clyde,1118,4,15,9,12,54,49,5,54
Stenhousem'r,1118,5,15,8,13,57,49,8,53
Elgin,1118,6,15,6,15,56,62,-6,51
Annan Athlet,1118,7,11,11,14,48,43,5,44
Berwick,1118,8,8,10,18,30,61,-31,34
Edinburgh Ci,1118,9,7,10,19,37,61,-24,31
Cowdenbeath,1118,10,5,10,21,25,55,-30,25
Montrose,1119,1,23,8,5,60,35,25,77
Peterhead,1119,2,24,4,8,78,38,40,76
Stenhousem'r,1119,3,16,8,12,57,46,11,56
Stirling,1119,4,16,6,14,60,53,7,54
Clyde,1119,5,15,9,12,55,50,5,54
Elgin,1119,6,14,7,15,54,61,-7,49
Annan Athlet,1119,7,11,11,14,48,43,5,44
Berwick,1119,8,8,10,18,31,62,-31,34
Edinburgh Ci,1119,9,7,9,20,36,61,-25,30
Cowdenbeath,1119,10,5,10,21,25,55,-30,25
Montrose,1120,1,24,7,5,62,34,28,79
Peterhead,1120,2,24,4,8,78,38,40,76
Stenhousem'r,1120,3,16,8,12,58,48,10,56
Stirling,1120,4,16,6,14,62,54,8,54
Clyde,1120,5,14,10,12,51,48,3,52
Elgin,1120,6,14,6,16,53,63,-10,48
Annan Athlet,1120,7,12,11,13,48,41,7,47
Berwick,1120,8,8,11,17,29,58,-29,35
Edinburgh Ci,1120,9,7,9,20,36,61,-25,30
Cowdenbeath,1120,10,4,10,22,23,55,-32,22
Montrose,1121,1,23,8,5,60,35,25,77
Peterhead,1121,2,24,4,8,79,39,40,76
Stenhousem'r,1121,3,16,8,12,58,47,11,56
Stirling,1121,4,16,6,14,61,54,7,54
Clyde,1121,5,15,9,12,55,49,6,54
Elgin,1121,6,14,7,15,54,61,-7,49
Annan Athlet,1121,7,11,12,13,47,41,6,45
Berwick,1121,8,8,10,18,30,62,-32,34
Edinburgh Ci,1121,9,7,9,20,37,62,-25,30
Cowdenbeath,1121,10,4,11,21,23,54,-31,23
Montrose,1122,1,23,7,6,62,38,24,76
Peterhead,1122,2,23,5,8,78,39,39,74
Stirling,1122,3,17,6,13,64,51,13,57
Clyde,1122,4,15,9,12,54,48,6,54
Stenhousem'r,1122,5,15,8,13,55,50,5,53
Elgin,1122,6,15,6,15,57,63,-6,51
Annan Athlet,1122,7,11,11,14,48,43,5,44
Berwick,1122,8,8,10,18,29,61,-32,34
Edinburgh Ci,1122,9,7,10,19,37,61,-24,31
Cowdenbeath,1122,10,5,10,21,25,55,-30,25
Montrose,1123,1,24,7,5,63,35,28,79
Peterhead,1123,2,24,4,8,80,38,42,76
Stirling,1123,3,17,6,13,62,52,10,57
Stenhousem'r,1123,4,15,8,13,56,48,8,53
Clyde,1123,5,14,9,13,51,49,2,51
Elgin,1123,6,14,6,16,54,64,-10,48
Annan Athlet,1123,7,11,12,13,48,42,6,45
Berwick,1123,8,9,10,17,30,58,-28,37
Edinburgh Ci,1123,9,7,9,20,36,63,-27,30
Cowdenbeath,1123,10,4,11,21,24,55,-31,23
Montrose,1124,1,23,8,5,60,35,25,77
Peterhead,1124,2,24,4,8,79,39,40,76
Stirling,1124,3,16,7,13,61,52,9,55
Stenhousem'r,1124,4,15,9,12,56,47,9,54
Clyde,1124,5,15,9,12,56,50,6,54
Elgin,1124,6,14,7,15,54,61,-7,49
Annan Athlet,1124,7,12,11,13,49,42,7,47
Berwick,1124,8,8,10,18,31,63,-32,34
Edinburgh Ci,1124,9,7,9,20,37,62,-25,30
Cowdenbeath,1124,10,4,10,22,24,56,-32,22
Montrose,1125,1,24,7,5,61,34,27,79
Peterhead,1125,2,23,4,9,77,39,38,73
Stenhousem'r,1125,3,16,8,12,57,47,10,56
Stirling,1125,4,16,6,14,61,53,8,54
Clyde,1125,5,15,9,12,52,48,4,54
Elgin,1125,6,14,6,16,53,62,-9,48
Annan Athlet,1125,7,12,11,13,49,42,7,47
Berwick,1125,8,8,10,18,29,59,-30,34
Edinburgh Ci,1125,9,8,9,19,37,60,-23,33
Cowdenbeath,1125,10,4,10,22,24,56,-32,22
Montrose,1126,1,24,7,5,62,35,27,79
Peterhead,1126,2,24,4,8,79,38,41,76
Stirling,1126,3,16,7,13,61,52,9,55
Stenhousem'r,1126,4,15,9,12,56,47,9,54
Clyde,1126,5,14,9,13,51,49,2,51
Elgin,1126,6,14,6,16,54,63,-9,48
Annan Athlet,1126,7,11,11,14,47,42,5,44
Berwick,1126,8,9,10,17,30,58,-28,37
Edinburgh Ci,1126,9,7,9,20,36,62,-26,30
Cowdenbeath,1126,10,5,10,21,24,54,-30,25
Montrose,1127,1,23,7,6,59,37,22,76
Peterhead,1127,2,23,4,9,78,40,38,73
Stirling,1127,3,16,7,13,62,53,9,55
Stenhousem'r,1127,4,15,9,12,57,48,9,54
Clyde,1127,5,15,9,12,55,49,6,54
Elgin,1127,6,15,6,15,56,60,-4,51
Annan Athlet,1127,7,11,11,14,49,45,4,44
Berwick,1127,8,8,10,18,30,62,-32,34
Edinburgh Ci,1127,9,8,9,19,38,61,-23,33
Cowdenbeath,1127,10,5,10,21,27,56,-29,25
Montrose,1128,1,24,7,5,60,34,26,79
Peterhead,1128,2,24,4,8,78,38,40,76
Stirling,1128,3,16,7,13,62,53,9,55
Stenhousem'r,1128,4,15,9,12,57,48,9,54
Clyde,1128,5,15,9,12,54,49,5,54
Elgin,1128,6,14,6,16,53,61,-8,48
Annan Athlet,1128,7,12,11,13,48,41,7,47
Berwick,1128,8,8,10,18,30,61,-31,34
Edinburgh Ci,1128,9,7,9,20,36,61,-25,30
Cowdenbeath,1128,10,4,10,22,23,55,-32,22
Peterhead,1129,1,24,4,8,80,38,42,76
Montrose,1129,2,23,7,6,60,36,24,76
Stenhousem'r,1129,3,16,8,12,56,46,10,56
Stirling,1129,4,16,6,14,60,52,8,54
Clyde,1129,5,14,9,13,51,49,2,51
Elgin,1129,6,15,6,15,55,61,-6,51
Annan Athlet,1129,7,11,11,14,47,42,5,44
Berwick,1129,8,9,10,17,30,58,-28,37
Edinburgh Ci,1129,9,7,9,20,36,63,-27,30
Cowdenbeath,1129,10,5,10,21,24,54,-30,25
Montrose,1130,1,24,7,5,62,34,28,79
Peterhead,1130,2,24,4,8,80,38,42,76
Stirling,1130,3,17,6,13,61,51,10,57
Clyde,1130,4,15,9,12,52,48,4,54
Stenhousem'r,1130,5,15,8,13,55,47,8,53
Elgin,1130,6,14,6,16,53,63,-10,48
Annan Athlet,1130,7,11,11,14,48,43,5,44
Berwick,1130,8,8,10,18,29,59,-30,34
Edinburgh Ci,1130,9,7,9,20,36,63,-27,30
Cowdenbeath,1130,10,5,10,21,25,55,-30,25
Montrose,1131,1,24,7,5,61,34,27,79
Peterhead,1131,2,24,4,8,80,38,42,76
Stirling,1131,3,16,7,13,60,51,9,55
Stenhousem'r,1131,4,15,9,12,55,46,9,54
Clyde,1131,5,15,9,12,52,48,4,54
Elgin,1131,6,14,6,16,53,62,-9,48
Annan Athlet,1131,7,11,11,14,48,45,3,44
Berwick,1131,8,8,10,18,29,59,-30,34
Edinburgh Ci,1131,9,7,9,20,36,63,-27,30
Cowdenbeath,1131,10,5,10,21,27,55,-28,25
Montrose,1132,1,24,7,5,65,35,30,79
Peterhead,1132,2,24,4,8,80,38,42,76
Stirling,1132,3,17,6,13,64,54,10,57
Clyde,1132,4,15,9,12,55,51,4,54
Stenhousem'r,1132,5,15,8,13,58,50,8,53
Elgin,1132,6,14,6,16,54,66,-12,48
Annan Athlet,1132,7,11,11,14,48,43,5,44
Berwick,1132,8,8,10,18,32,62,-30,34
Edinburgh Ci,1132,9,7,9,20,36,63,-27,30
Cowdenbeath,1132,10,5,10,21,25,55,-30,25
Montrose,1133,1,23,7,6,59,36,23,76
Peterhead,1133,2,23,4,9,78,40,38,73
Stirling,1133,3,17,6,13,63,52,11,57
Clyde,1133,4,15,9,12,52,48,4,54
Stenhousem'r,1133,5,15,8,13,56,49,7,53
Elgin,1133,6,15,6,15,55,60,-5,51
Annan Athlet,1133,7,11,12,13,48,42,6,45
Berwick,1133,8,8,10,18,29,59,-30,34
Edinburgh Ci,1133,9,8,9,19,38,61,-23,33
Cowdenbeath,1133,10,4,11,21,24,55,-31,23
Montrose,1134,1,24,7,5,63,34,29,79
Peterhead,1134,2,24,4,8,79,38,41,76
Stirling,1134,3,17,6,13,62,51,11,57
Stenhousem'r,1134,4,15,8,13,55,48,7,53
Clyde,1134,5,14,9,13,52,50,2,51
Elgin,1134,6,14,6,16,53,64,-11,48
Annan Athlet,1134,7,11,12,13,49,43,6,45
Berwick,1134,8,9,10,17,31,59,-28,37
Edinburgh Ci,1134,9,7,9,20,36,62,-26,30
Cowdenbeath,1134,10,4,11,21,25,56,-31,23
Montrose,1135,1,24,7,5,61,35,26,79
Peterhead,1135,2,24,4,8,80,38,42,76
Stirling,1135,3,17,6,13,64,52,12,57
Clyde,1135,4,15,9,12,53,48,5,54
Stenhousem'r,1135,5,15,8,13,56,50,6,53
Elgin,1135,6,14,6,16,54,62,-8,48
Annan Athlet,1135,7,11,11,14,48,44,4,44
Berwick,1135,8,8,10,18,29,60,-31,34
Edinburgh Ci,1135,9,7,9,20,36,63,-27,30
Cowdenbeath,1135,10,5,10,21,26,55,-29,25
Montrose,1136,1,24,7,5,63,34,29,79
Peterhead,1136,2,24,4,8,80,38,42,76
Stirling,1136,3,17,6,13,62,52,10,57
Stenhousem'r,1136,4,15,8,13,56,48,8,53
Clyde,1136,5,14,9,13,52,51,1,51
Elgin,1136,6,14,6,16,53,64,-11,48
Annan Athlet,1136,7,12,11,13,48,41,7,47
Berwick,1136,8,9,10,17,32,59,-27,37
Edinburgh Ci,1136,9,7,9,20,36,63,-27,30
Cowdenbeath,1136,10,4,10,22,23,55,-32,22
Montrose,1137,1,24,7,5,60,34,26,79
Peterhead,1137,2,24,4,8,79,39,40,76
Stenhousem'r,1137,3,16,8,12,59,48,11,56
Stirling,1137,4,16,6,14,62,55,7,54
Clyde,1137,5,15,9,12,53,48,5,54
Elgin,1137,6,14,6,16,53,61,-8,48
Annan Athlet,1137,7,11,12,13,49,43,6,45
Berwick,1137,8,8,10,18,29,60,-31,34
Edinburgh Ci,1137,9,7,9,20,37,62,-25,30
Cowdenbeath,1137,10,4,11,21,25,56,-31,23
Montrose,1138,1,24,7,5,61,35,26,79
Peterhead,1138,2,23,4,9,77,40,37,73
Stirling,1138,3,17,6,13,62,52,10,57
Stenhousem'r,1138,4,15,8,13,56,48,8,53
Clyde,1138,5,14,9,13,53,54,-1,51
Elgin,1138,6,14,6,16,54,62,-8,48
Annan Athlet,1138,7,11,12,13,47,41,6,45
Berwick,1138,8,9,10,17,35,60,-25,37
Edinburgh Ci,1138,9,8,9,19,38,60,-22,33
Cowdenbeath,1138,10,4,11,21,23,54,-31,23
Montrose,1139,1,24,7,5,61,35,26,79
Peterhead,1139,2,24,4,8,79,38,41,76
Stirling,1139,3,17,6,13,63,52,11,57
Clyde,1139,4,15,9,12,53,49,4,54
Stenhousem'r,1139,5,15,8,13,56,49,7,53
Elgin,1139,6,14,6,16,54,62,-8,48
Annan Athlet,1139,7,11,12,13,47,41,6,45
Berwick,1139,8,8,10,18,30,60,-30,34
Edinburgh Ci,1139,9,7,9,20,36,62,-26,30
Cowdenbeath,1139,10,4,11,21,23,54,-31,23
Montrose,1140,1,24,7,5,61,34,27,79
Peterhead,1140,2,23,4,9,77,39,38,73
Stenhousem'r,1140,3,16,8,12,57,47,10,56
Stirling,1140,4,16,6,14,61,53,8,54
Clyde,1140,5,15,9,12,54,48,6,54
Elgin,1140,6,14,6,16,53,62,-9,48
Annan Athlet,1140,7,11,11,14,48,43,5,44
Berwick,1140,8,8,10,18,29,61,-32,34
Edinburgh Ci,1140,9,8,9,19,37,60,-23,33
Cowdenbeath,1140,10,5,10,21,25,55,-30,25
Montrose,1141,1,23,8,5,59,34,25,77
Peterhead,1141,2,23,5,8,78,39,39,74
Stirling,1141,3,17,6,13,63,52,11,57
Clyde,1141,4,15,9,12,56,49,7,54
Stenhousem'r,1141,5,15,8,13,56,49,7,53
Elgin,1141,6,14,7,15,53,60,-7,49
Annan Athlet,1141,7,11,11,14,48,44,4,44
Berwick,1141,8,8,10,18,30,63,-33,34
Edinburgh Ci,1141,9,7,10,19,37,61,-24,31
Cowdenbeath,1141,10,5,10,21,26,55,-29,25
Montrose,1142,1,24,7,5,60,34,26,79
Peterhead,1142,2,24,4,8,80,39,41,76
Stirling,1142,3,17,6,13,62,52,10,57
Clyde,1142,4,15,9,12,54,49,5,54
Stenhousem'r,1142,5,15,8,13,56,48,8,53
Elgin,1142,6,14,6,16,53,61,-8,48
Annan Athlet,1142,7,12,11,13,48,41,7,47
Berwick,1142,8,8,10,18,30,61,-31,34
Edinburgh Ci,1142,9,7,9,20,37,63,-26,30
Cowdenbeath,1142,10,4,10,22,23,55,-32,22
Peterhead,1143,1,24,4,8,80,38,42,76
Montrose,1143,2,23,7,6,59,37,22,76
Stirling,1143,3,17,6,13,62,51,11,57
Stenhousem'r,1143,4,15,8,13,55,48,7,53
Clyde,1143,5,14,9,13,51,49,2,51
Elgin,1143,6,15,6,15,56,60,-4,51
Annan Athlet,1143,7,11,11,14,47,42,5,44
Berwick,1143,8,9,10,17,30,58,-28,37
Edinburgh Ci,1143,9,7,9,20,36,63,-27,30
Cowdenbeath,1143,10,5,10,21,24,54,-30,25
Montrose,1144,1,24,7,5,61,34,27,79
Peterhead,1144,2,24,4,8,82,38,44,76
Stirling,1144,3,17,6,13,62,52,10,57
Clyde,1144,4,15,9,12,52,48,4,54
Stenhousem'r,1144,5,15,8,13,56,48,8,53
Elgin,1144,6,14,6,16,53,62,-9,48
Annan Athlet,1144,7,11,12,13,48,42,6,45
Berwick,1144,8,8,10,18,29,59,-30,34
Edinburgh Ci,1144,9,7,9,20,36,65,-29,30
Cowdenbeath,1144,10,4,11,21,24,55,-31,23
Montrose,1145,1,24,7,5,62,34,28,79
Peterhead,1145,2,23,5,8,79,40,39,74
Stirling,1145,3,17,6,13,63,52,11,57
Stenhousem'r,1145,4,15,8,13,56,49,7,53
Clyde,1145,5,14,9,13,52,50,2,51
Elgin,1145,6,14,6,16,53,63,-10,48
Annan Athlet,1145,7,12,11,13,49,42,7,47
Berwick,1145,8,9,10,17,31,59,-28,37
Edinburgh Ci,1145,9,7,10,19,38,62,-24,31
Cowdenbeath,1145,10,4,10,22,24,56,-32,22
Montrose,1146,1,23,8,5,61,36,25,77
Peterhead,1146,2,23,4,9,78,40,38,73
Stirling,1146,3,16,7,13,61,52,9,55
Stenhousem'r,1146,4,15,9,12,56,47,9,54
Clyde,1146,5,15,9,12,53,48,5,54
Elgin,1146,6,14,7,15,55,62,-7,49
Annan Athlet,1146,7,11,12,13,48,42,6,45
Berwick,1146,8,8,10,18,29,60,-31,34
Edinburgh Ci,1146,9,8,9,19,38,61,-23,33
Cowdenbeath,1146,10,4,11,21,24,55,-31,23
Montrose,1147,1,24,7,5,61,35,26,79
Peterhead,1147,2,24,4,8,81,39,42,76
Stirling,1147,3,16,7,13,60,51,9,55
Stenhousem'r,1147,4,15,9,12,55,46,9,54
Clyde,1147,5,15,9,12,52,48,4,54
Elgin,1147,6,14,6,16,54,62,-8,48
Annan Athlet,1147,7,11,11,14,48,43,5,44
Berwick,1147,8,8,10,18,29,59,-30,34
Edinburgh Ci,1147,9,7,9,20,37,64,-27,30
Cowdenbeath,1147,10,5,10,21,25,55,-30,25
Montrose,1148,1,24,7,5,62,35,27,79
Peterhead,1148,2,24,4,8,79,39,40,76
Stirling,1148,3,17,6,13,63,51,12,57
Clyde,1148,4,15,9,12,53,48,5,54
Stenhousem'r,1148,5,15,8,13,55,49,6,53
Elgin,1148,6,14,6,16,54,63,-9,48
Annan Athlet,1148,7,11,11,14,47,42,5,44
Berwick,1148,8,8,10,18,29,60,-31,34
Edinburgh Ci,1148,9,7,9,20,37,62,-25,30
Cowdenbeath,1148,10,5,10,21,24,54,-30,25
Montrose,1149,1,24,7,5,61,35,26,79
Peterhead,1149,2,24,4,8,82,41,41,76
Stirling,1149,3,17,6,13,62,52,10,57
Clyde,1149,4,15,9,12,53,48,5,54
Stenhousem'r,1149,5,15,8,13,56,48,8,53
Elgin,1149,6,14,6,16,54,62,-8,48
Annan Athlet,1149,7,12,11,13,48,41,7,47
Berwick,1149,8,8,10,18,29,60,-31,34
Edinburgh Ci,1149,9,7,9,20,39,65,-26,30
Cowdenbeath,1149,10,4,10,22,23,55,-32,22
Montrose,1150,1,24,7,5,61,35,26,79
Peterhead,1150,2,24,4,8,80,38,42,76
Stirling,1150,3,16,7,13,61,52,9,55
Stenhousem'r,1150,4,15,9,12,56,47,9,54
Clyde,1150,5,14,10,12,52,49,3,52
Elgin,1150,6,14,6,16,54,62,-8,48
Annan Athlet,1150,7,11,12,13,47,41,6,45
Berwick,1150,8,8,11,17,30,59,-29,35
Edinburgh Ci,1150,9,7,9,20,36,63,-27,30
Cowdenbeath,1150,10,4,11,21,23,54,-31,23
Montrose,1151,1,24,7,5,60,34,26,79
Peterhead,1151,2,24,4,8,82,38,44,76
Stirling,1151,3,16,7,13,62,53,9,55
Stenhousem'r,1151,4,15,9,12,57,48,9,54
Clyde,1151,5,14,10,12,52,49,3,52
Elgin,1151,6,14,6,16,53,61,-8,48
Annan Athlet,1151,7,11,12,13,47,41,6,45
Berwick,1151,8,8,11,17,30,59,-29,35
Edinburgh Ci,1151,9,7,9,20,36,65,-29,30
Cowdenbeath,1151,10,4,11,21,23,54,-31,23
Montrose,1152,1,24,7,5,62,34,28,79
Peterhead,1152,2,24,4,8,79,38,41,76
Stirling,1152,3,17,6,13,63,53,10,57
Clyde,1152,4,15,9,12,54,49,5,54
Stenhousem'r,1152,5,15,8,13,57,49,8,53
Elgin,1152,6,14,6,16,53,63,-10,48
Annan Athlet,1152,7,11,12,13,47,41,6,45
Berwick,1152,8,8,10,18,30,61,-31,34
Edinburgh Ci,1152,9,7,9,20,36,62,-26,30
Cowdenbeath,1152,10,4,11,21,23,54,-31,23
Montrose,1153,1,23,8,5,61,36,25,77
Peterhead,1153,2,23,4,9,79,41,38,73
Stirling,1153,3,17,6,13,62,51,11,57
Stenhousem'r,1153,4,15,8,13,55,48,7,53
Clyde,1153,5,14,10,12,52,49,3,52
Elgin,1153,6,14,7,15,55,62,-7,49
Annan Athlet,1153,7,11,11,14,47,43,4,44
Berwick,1153,8,8,11,17,30,59,-29,35
Edinburgh Ci,1153,9,8,9,19,39,62,-23,33
Cowdenbeath,1153,10,5,10,21,25,54,-29,25
Montrose,1154,1,24,7,5,61,35,26,79
Peterhead,1154,2,23,5,8,78,39,39,74
Stenhousem'r,1154,3,16,8,12,57,46,11,56
Stirling,1154,4,16,6,14,60,53,7,54
Clyde,1154,5,15,9,12,55,50,5,54
Elgin,1154,6,14,6,16,54,62,-8,48
Annan Athlet,1154,7,11,12,13,48,42,6,45
Berwick,1154,8,8,10,18,31,62,-31,34
Edinburgh Ci,1154,9,7,10,19,37,61,-24,31
Cowdenbeath,1154,10,4,11,21,24,55,-31,23
Montrose,1155,1,24,7,5,62,35,27,79
Peterhead,1155,2,24,4,8,82,40,42,76
Stirling,1155,3,17,6,13,62,51,11,57
Stenhousem'r,1155,4,15,8,13,55,48,7,53
Clyde,1155,5,14,9,13,51,49,2,51
Elgin,1155,6,14,6,16,54,63,-9,48
Annan Athlet,1155,7,12,11,13,49,41,8,47
Berwick,1155,8,9,10,17,30,58,-28,37
Edinburgh Ci,1155,9,7,9,20,38,65,-27,30
Cowdenbeath,1155,10,4,10,22,23,56,-33,22
Montrose,1156,1,24,7,5,60,34,26,79
Peterhead,1156,2,23,4,9,77,40,37,73
Stirling,1156,3,17,6,13,63,52,11,57
Clyde,1156,4,15,9,12,53,48,5,54
Stenhousem'r,1156,5,15,8,13,56,49,7,53
Elgin,1156,6,14,6,16,53,61,-8,48
Annan Athlet,1156,7,11,11,14,48,43,5,44
Berwick,1156,8,8,10,18,29,60,-31,34
Edinburgh Ci,1156,9,8,9,19,38,60,-22,33
Cowdenbeath,1156,10,5,10,21,25,55,-30,25
Montrose,1157,1,24,7,5,63,34,29,79
Peterhead,1157,2,23,4,9,78,40,38,73
Stirling,1157,3,16,7,13,63,54,9,55
Stenhousem'r,1157,4,15,9,12,58,49,9,54
Clyde,1157,5,15,9,12,53,49,4,54
Elgin,1157,6,14,6,16,53,64,-11,48
Annan Athlet,1157,7,11,11,14,47,42,5,44
Berwick,1157,8,8,10,18,30,60,-30,34
Edinburgh Ci,1157,9,8,9,19,38,61,-23,33
Cowdenbeath,1157,10,5,10,21,24,54,-30,25
Montrose,1158,1,24,7,5,61,35,26,79
Peterhead,1158,2,24,4,8,78,38,40,76
Stenhousem'r,1158,3,16,8,12,59,47,12,56
Clyde,1158,4,15,9,12,55,48,7,54
Stirling,1158,5,16,6,14,61,55,6,54
Elgin,1158,6,14,6,16,54,62,-8,48
Annan Athlet,1158,7,12,11,13,48,41,7,47
Berwick,1158,8,8,10,18,29,62,-33,34
Edinburgh Ci,1158,9,7,9,20,36,61,-25,30
Cowdenbeath,1158,10,4,10,22,23,55,-32,22
Montrose,1159,1,24,7,5,63,36,27,79
Peterhead,1159,2,24,4,8,78,38,40,76
Stenhousem'r,1159,3,16,8,12,58,46,12,56
Stirling,1159,4,16,6,14,60,54,6,54
Clyde,1159,5,15,9,12,53,49,4,54
Elgin,1159,6,14,6,16,55,64,-9,48
Annan Athlet,1159,7,11,12,13,51,45,6,45
Berwick,1159,8,8,10,18,30,60,-30,34
Edinburgh Ci,1159,9,7,9,20,36,61,-25,30
Cowdenbeath,1159,10,4,11,21,27,58,-31,23
Montrose,1160,1,24,7,5,61,34,27,79
Peterhead,1160,2,24,4,8,80,40,40,76
Stirling,1160,3,17,6,13,64,53,11,57
Clyde,1160,4,15,9,12,52,48,4,54
Stenhousem'r,1160,5,15,8,13,57,50,7,53
Elgin,1160,6,14,6,16,53,62,-9,48
Annan Athlet,1160,7,11,12,13,48,42,6,45
Berwick,1160,8,8,10,18,29,59,-30,34
Edinburgh Ci,1160,9,7,9,20,38,63,-25,30
Cowdenbeath,1160,10,4,11,21,24,55,-31,23
Peterhead,1161,1,24,4,8,79,39,40,76
Montrose,1161,2,23,7,6,59,35,24,76
Stirling,1161,3,16,7,13,61,52,9,55
Stenhousem'r,1161,4,15,9,12,56,47,9,54
Clyde,1161,5,14,9,13,53,51,2,51
Elgin,1161,6,15,6,15,54,60,-6,51
Annan Athlet,1161,7,11,12,13,48,42,6,45
Berwick,1161,8,9,10,17,32,60,-28,37
Edinburgh Ci,1161,9,7,9,20,37,62,-25,30
Cowdenbeath,1161,10,4,11,21,24,55,-31,23
Montrose,1162,1,24,7,5,61,34,27,79
Peterhead,1162,2,23,5,8,79,40,39,74
Stirling,1162,3,17,6,13,62,51,11,57
Clyde,1162,4,15,9,12,54,49,5,54
Stenhousem'r,1162,5,15,8,13,55,48,7,53
Elgin,1162,6,14,6,16,53,62,-9,48
Annan Athlet,1162,7,12,11,13,49,42,7,47
Berwick,1162,8,8,10,18,30,61,-31,34
Edinburgh Ci,1162,9,7,10,19,38,62,-24,31
Cowdenbeath,1162,10,4,10,22,24,56,-32,22
Peterhead,1163,1,24,4,8,80,40,40,76
Montrose,1163,2,23,7,6,59,35,24,76
Stirling,1163,3,17,6,13,62,51,11,57
Stenhousem'r,1163,4,15,8,13,55,48,7,53
Clyde,1163,5,14,10,12,52,49,3,52
Elgin,1163,6,15,6,15,54,60,-6,51
Annan Athlet,1163,7,12,11,13,48,41,7,47
Berwick,1163,8,8,11,17,30,59,-29,35
Edinburgh Ci,1163,9,7,9,20,38,63,-25,30
Cowdenbeath,1163,10,4,10,22,23,55,-32,22
Peterhead,1164,1,24,4,8,78,38,40,76
Montrose,1164,2,23,7,6,59,35,24,76
Stirling,1164,3,17,6,13,61,51,10,57
Stenhousem'r,1164,4,15,8,13,55,47,8,53
Clyde,1164,5,14,9,13,51,49,2,51
Elgin,1164,6,15,6,15,54,60,-6,51
Annan Athlet,1164,7,12,11,13,49,41,8,47
Berwick,1164,8,9,10,17,30,58,-28,37
Edinburgh Ci,1164,9,7,9,20,36,61,-25,30
Cowdenbeath,1164,10,4,10,22,23,56,-33,22
Montrose,1165,1,23,8,5,61,36,25,77
Peterhead,1165,2,24,4,8,78,38,40,76
Stirling,1165,3,16,7,13,62,53,9,55
Stenhousem'r,1165,4,15,9,12,57,48,9,54
Clyde,1165,5,14,9,13,51,50,1,51
Elgin,1165,6,14,7,15,55,62,-7,49
Annan Athlet,1165,7,12,11,13,48,41,7,47
Berwick,1165,8,9,10,17,31,58,-27,37
Edinburgh Ci,1165,9,7,9,20,36,61,-25,30
Cowdenbeath,1165,10,4,10,22,23,55,-32,22
Montrose,1166,1,24,7,5,62,34,28,79
Peterhead,1166,2,24,4,8,79,38,41,76
Stenhousem'r,1166,3,16,8,12,57,47,10,56
Stirling,1166,4,16,6,14,61,53,8,54
Clyde,1166,5,15,9,12,52,48,4,54
Elgin,1166,6,14,6,16,53,63,-10,48
Annan Athlet,1166,7,11,12,13,47,41,6,45
Berwick,1166,8,8,10,18,29,59,-30,34
Edinburgh Ci,1166,9,7,9,20,36,62,-26,30
Cowdenbeath,1166,10,4,11,21,23,54,-31,23
Montrose,1167,1,24,7,5,62,35,27,79
Peterhead,1167,2,24,4,8,80,39,41,76
Stenhousem'r,1167,3,16,8,12,58,47,11,56
Stirling,1167,4,16,6,14,61,54,7,54
Clyde,1167,5,15,9,12,53,48,5,54
Elgin,1167,6,14,6,16,54,63,-9,48
Annan Athlet,1167,7,11,12,13,47,41,6,45
Berwick,1167,8,8,10,18,29,60,-31,34
Edinburgh Ci,1167,9,7,9,20,37,63,-26,30
Cowdenbeath,1167,10,4,11,21,23,54,-31,23
Montrose,1168,1,24,7,5,60,34,26,79
Peterhead,1168,2,24,4,8,81,39,42,76
Stirling,1168,3,16,7,13,61,52,9,55
Stenhousem'r,1168,4,15,9,12,56,47,9,54
Clyde,1168,5,14,10,12,51,48,3,52
Elgin,1168,6,14,6,16,53,61,-8,48
Annan Athlet,1168,7,11,11,14,48,43,5,44
Berwick,1168,8,8,11,17,29,58,-29,35
Edinburgh Ci,1168,9,7,9,20,37,64,-27,30
Cowdenbeath,1168,10,5,10,21,25,55,-30,25
Montrose,1169,1,24,7,5,61,35,26,79
Peterhead,1169,2,24,4,8,80,38,42,76
Stenhousem'r,1169,3,16,8,12,57,47,10,56
Stirling,1169,4,16,6,14,61,53,8,54
Clyde,1169,5,15,9,12,54,49,5,54
Elgin,1169,6,14,6,16,54,62,-8,48
Annan Athlet,1169,7,11,12,13,48,42,6,45
Berwick,1169,8,8,10,18,30,61,-31,34
Edinburgh Ci,1169,9,7,9,20,36,63,-27,30
Cowdenbeath,1169,10,4,11,21,24,55,-31,23
Montrose,1170,1,24,7,5,60,34,26,79
Peterhead,1170,2,24,4,8,80,39,41,76
Stirling,1170,3,17,6,13,62,52,10,57
Clyde,1170,4,15,9,12,54,49,5,54
Stenhousem'r,1170,5,15,8,13,56,48,8,53
Elgin,1170,6,14,6,16,53,61,-8,48
Annan Athlet,1170,7,12,11,13,48,41,7,47
Berwick,1170,8,8,10,18,30,61,-31,34
Edinburgh Ci,1170,9,7,9,20,37,63,-26,30
Cowdenbeath,1170,10,4,10,22,23,55,-32,22
Montrose,1171,1,24,7,5,62,36,26,79
Peterhead,1171,2,24,4,8,81,38,43,76
Stenhousem'r,1171,3,16,8,12,58,47,11,56
Stirling,1171,4,16,6,14,61,54,7,54
Clyde,1171,5,15,9,12,54,48,6,54
Elgin,1171,6,14,6,16,55,63,-8,48
Annan Athlet,1171,7,12,11,13,48,41,7,47
Berwick,1171,8,8,10,18,29,61,-32,34
Edinburgh Ci,1171,9,7,9,20,36,64,-28,30
Cowdenbeath,1171,10,4,10,22,23,55,-32,22
Peterhead,1172,1,24,4,8,80,39,41,76
Montrose,1172,2,23,7,6,61,37,24,76
Stirling,1172,3,16,7,13,61,52,9,55
Stenhousem'r,1172,4,15,9,12,56,47,9,54
Clyde,1172,5,15,9,12,56,49,7,54
Elgin,1172,6,15,6,15,56,62,-6,51
Annan Athlet,1172,7,11,12,13,48,42,6,45
Berwick,1172,8,8,10,18,30,63,-33,34
Edinburgh Ci,1172,9,7,9,20,37,63,-26,30
Cowdenbeath,1172,10,4,11,21,24,55,-31,23
Montrose,1173,1,24,7,5,62,34,28,79
Peterhead,1173,2,24,4,8,80,39,41,76
Stenhousem'r,1173,3,16,8,12,57,47,10,56
Stirling,1173,4,16,6,14,61,53,8,54
Clyde,1173,5,15,9,12,52,48,4,54
Elgin,1173,6,14,6,16,53,63,-10,48
Annan Athlet,1173,7,12,11,13,49,41,8,47
Berwick,1173,8,8,10,18,29,59,-30,34
Edinburgh Ci,1173,9,7,9,20,37,63,-26,30
Cowdenbeath,1173,10,4,10,22,23,56,-33,22
Montrose,1174,1,24,7,5,64,35,29,79
Peterhead,1174,2,23,5,8,77,38,39,74
Stirling,1174,3,16,7,13,60,51,9,55
Stenhousem'r,1174,4,15,9,12,55,46,9,54
Clyde,1174,5,14,10,12,54,51,3,52
Elgin,1174,6,14,6,16,54,65,-11,48
Annan Athlet,1174,7,11,11,14,47,43,4,44
Berwick,1174,8,8,11,17,32,61,-29,35
Edinburgh Ci,1174,9,7,10,19,36,60,-24,31
Cowdenbeath,1174,10,5,10,21,25,54,-29,25
Montrose,1175,1,24,7,5,62,34,28,79
Peterhead,1175,2,24,4,8,81,40,41,76
Stirling,1175,3,16,7,13,62,53,9,55
Stenhousem'r,1175,4,15,9,12,57,48,9,54
Clyde,1175,5,15,9,12,52,48,4,54
Elgin,1175,6,14,6,16,53,63,-10,48
Annan Athlet,1175,7,11,12,13,47,41,6,45
Berwick,1175,8,8,10,18,29,59,-30,34
Edinburgh Ci,1175,9,7,9,20,38,64,-26,30
Cowdenbeath,1175,10,4,11,21,23,54,-31,23
Montrose,1176,1,23,7,6,59,36,23,76
Peterhead,1176,2,23,4,9,77,39,38,73
Stenhousem'r,1176,3,16,8,12,56,46,10,56
Stirling,1176,4,16,6,14,60,52,8,54
Clyde,1176,5,14,10,12,53,50,3,52
Elgin,1176,6,15,6,15,55,60,-5,51
Annan Athlet,1176,7,12,11,13,48,41,7,47
Berwick,1176,8,8,11,17,31,60,-29,35
Edinburgh Ci,1176,9,8,9,19,37,60,-23,33
Cowdenbeath,1176,10,4,10,22,23,55,-32,22
Peterhead,1177,1,24,4,8,80,38,42,76
Montrose,1177,2,23,7,6,60,36,24,76
Stirling,1177,3,17,6,13,61,51,10,57
Clyde,1177,4,15,9,12,54,49,5,54
Stenhousem'r,1177,5,15,8,13,55,47,8,53
Elgin,1177,6,15,6,15,55,61,-6,51
Annan Athlet,1177,7,12,11,13,49,41,8,47
Berwick,1177,8,8,10,18,30,61,-31,34
Edinburgh Ci,1177,9,7,9,20,36,63,-27,30
Cowdenbeath,1177,10,4,10,22,23,56,-33,22
Montrose,1178,1,24,7,5,63,35,28,79
Peterhead,1178,2,24,4,8,80,39,41,76
Stenhousem'r,1178,3,16,8,12,57,47,10,56
Stirling,1178,4,16,6,14,61,53,8,54
Clyde,1178,5,15,9,12,55,49,6,54
Elgin,1178,6,14,6,16,54,64,-10,48
Annan Athlet,1178,7,12,11,13,49,42,7,47
Berwick,1178,8,8,10,18,30,62,-32,34
Edinburgh Ci,1178,9,7,9,20,37,63,-26,30
Cowdenbeath,1178,10,4,10,22,24,56,-32,22
Montrose,1179,1,24,7,5,62,34,28,79
Peterhead,1179,2,24,4,8,78,38,40,76
Stirling,1179,3,17,6,13,62,52,10,57
Clyde,1179,4,15,9,12,54,49,5,54
Stenhousem'r,1179,5,15,8,13,56,48,8,53
Elgin,1179,6,14,6,16,53,63,-10,48
Annan Athlet,1179,7,11,11,14,49,45,4,44
Berwick,1179,8,8,10,18,30,61,-31,34
Edinburgh Ci,1179,9,7,9,20,36,61,-25,30
Cowdenbeath,1179,10,5,10,21,27,56,-29,25
Montrose,1180,1,24,7,5,61,35,26,79
Peterhead,1180,2,24,4,8,78,38,40,76
Stirling,1180,3,17,6,13,62,52,10,57
Stenhousem'r,1180,4,15,8,13,56,48,8,53
Clyde,1180,5,14,10,12,53,50,3,52
Elgin,1180,6,14,6,16,54,62,-8,48
Annan Athlet,1180,7,12,11,13,49,41,8,47
Berwick,1180,8,8,11,17,31,60,-29,35
Edinburgh Ci,1180,9,7,9,20,36,61,-25,30
Cowdenbeath,1180,10,4,10,22,23,56,-33,22
Montrose,1181,1,24,7,5,62,36,26,79
Peterhead,1181,2,24,4,8,80,38,42,76
Stenhousem'r,1181,3,16,8,12,59,48,11,56
Stirling,1181,4,16,6,14,62,55,7,54
Clyde,1181,5,15,9,12,52,48,4,54
Elgin,1181,6,14,6,16,55,63,-8,48
Annan Athlet,1181,7,11,11,14,47,43,4,44
Berwick,1181,8,8,10,18,29,59,-30,34
Edinburgh Ci,1181,9,7,9,20,36,63,-27,30
Cowdenbeath,1181,10,5,10,21,25,54,-29,25
Montrose,1182,1,23,8,5,61,36,25,77
Peterhead,1182,2,23,4,9,77,40,37,73
Stirling,1182,3,17,6,13,61,51,10,57
Clyde,1182,4,15,9,12,52,48,4,54
Stenhousem'r,1182,5,15,8,13,55,47,8,53
Elgin,1182,6,14,7,15,55,62,-7,49
Annan Athlet,1182,7,11,12,13,49,43,6,45
Berwick,1182,8,8,10,18,29,59,-30,34
Edinburgh Ci,1182,9,8,9,19,38,60,-22,33
Cowdenbeath,1182,10,4,11,21,25,56,-31,23
Montrose,1183,1,24,7,5,62,35,27,79
Peterhead,1183,2,23,5,8,78,39,39,74
Stirling,1183,3,16,7,13,61,52,9,55
Stenhousem'r,1183,4,15,9,12,56,47,9,54
Clyde,1183,5,15,9,12,52,48,4,54
Elgin,1183,6,14,6,16,54,63,-9,48
Annan Athlet,1183,7,11,12,13,47,41,6,45
Berwick,1183,8,8,10,18,29,59,-30,34
Edinburgh Ci,1183,9,7,10,19,37,61,-24,31
Cowdenbeath,1183,10,4,11,21,23,54,-31,23
Montrose,1184,1,24,7,5,64,36,28,79
Peterhead,1184,2,24,4,8,82,40,42,76
Stirling,1184,3,17,6,13,63,52,11,57
Clyde,1184,4,15,9,12,54,49,5,54
Stenhousem'r,1184,5,15,8,13,56,49,7,53
Elgin,1184,6,14,6,16,55,65,-10,48
Annan Athlet,1184,7,11,12,13,48,42,6,45
Berwick,1184,8,8,10,18,30,61,-31,34
Edinburgh Ci,1184,9,7,9,20,38,65,-27,30
Cowdenbeath,1184,10,4,11,21,24,55,-31,23
Peterhead,1185,1,24,4,8,81,39,42,76
Montrose,1185,2,23,7,6,60,37,23,76
Stirling,1185,3,17,6,13,62,51,11,57
Clyde,1185,4,15,9,12,54,48,6,54
Stenhousem'r,1185,5,15,8,13,55,48,7,53
Elgin,1185,6,15,6,15,56,61,-5,51
Annan Athlet,1185,7,11,12,13,48,42,6,45
Berwick,1185,8,8,10,18,29,61,-32,34
Edinburgh Ci,1185,9,7,9,20,37,64,-27,30
Cowdenbeath,1185,10,4,11,21,24,55,-31,23
Montrose,1186,1,24,7,5,61,34,27,79
Peterhead,1186,2,24,4,8,80,38,42,76
Stirling,1186,3,17,6,13,61,51,10,57
Clyde,1186,4,15,9,12,52,48,4,54
Stenhousem'r,1186,5,15,8,13,55,47,8,53
Elgin,1186,6,14,6,16,53,62,-9,48
Annan Athlet,1186,7,11,12,13,48,42,6,45
Berwick,1186,8,8,10,18,29,59,-30,34
Edinburgh Ci,1186,9,7,9,20,36,63,-27,30
Cowdenbeath,1186,10,4,11,21,24,55,-31,23
Montrose,1187,1,24,7,5,61,35,26,79
Peterhead,1187,2,24,4,8,80,38,42,76
Stirling,1187,3,17,6,13,62,51,11,57
Clyde,1187,4,15,9,12,55,50,5,54
Stenhousem'r,1187,5,15,8,13,55,48,7,53
Elgin,1187,6,14,6,16,54,62,-8,48
Annan Athlet,1187,7,12,11,13,52,41,11,47
Berwick,1187,8,8,10,18,31,62,-31,34
Edinburgh Ci,1187,9,7,9,20,36,63,-27,30
Cowdenbeath,1187,10,4,10,22,23,59,-36,22
Montrose,1188,1,24,7,5,61,34,27,79
Peterhead,1188,2,24,4,8,79,39,40,76
Stirling,1188,3,16,7,13,61,52,9,55
Stenhousem'r,1188,4,15,9,12,56,47,9,54
Clyde,1188,5,15,9,12,53,48,5,54
Elgin,1188,6,14,6,16,53,62,-9,48
Annan Athlet,1188,7,11,11,14,47,42,5,44
Berwick,1188,8,8,10,18,29,60,-31,34
Edinburgh Ci,1188,9,7,9,20,37,62,-25,30
Cowdenbeath,1188,10,5,10,21,24,54,-30,25
Montrose,1189,1,23,8,5,60,35,25,77
Peterhead,1189,2,23,5,8,77,38,39,74
Stirling,1189,3,16,7,13,63,54,9,55
Stenhousem'r,1189,4,15,9,12,58,49,9,54
Clyde,1189,5,15,9,12,54,48,6,54
Elgin,1189,6,14,7,15,54,61,-7,49
Annan Athlet,1189,7,12,11,13,50,42,8,47
Berwick,1189,8,8,10,18,29,61,-32,34
Edinburgh Ci,1189,9,7,10,19,36,60,-24,31
Cowdenbeath,1189,10,4,10,22,24,57,-33,22
Montrose,1190,1,24,7,5,62,34,28,79
Peterhead,1190,2,24,4,8,80,39,41,76
Stirling,1190,3,17,6,13,61,51,10,57
Clyde,1190,4,15,9,12,55,49,6,54
Stenhousem'r,1190,5,15,8,13,55,47,8,53
Elgin,1190,6,14,6,16,53,63,-10,48
Annan Athlet,1190,7,11,12,13,47,41,6,45
Berwick,1190,8,8,10,18,30,62,-32,34
Edinburgh Ci,1190,9,7,9,20,37,63,-26,30
Cowdenbeath,1190,10,4,11,21,23,54,-31,23
Peterhead,1191,1,24,4,8,83,38,45,76
Montrose,1191,2,23,7,6,60,38,22,76
Stirling,1191,3,16,7,13,60,51,9,55
Stenhousem'r,1191,4,15,9,12,55,46,9,54
Clyde,1191,5,15,9,12,52,48,4,54
Elgin,1191,6,15,6,15,57,61,-4,51
Annan Athlet,1191,7,11,12,13,47,41,6,45
Berwick,1191,8,8,10,18,29,59,-30,34
Edinburgh Ci,1191,9,7,9,20,36,66,-30,30
Cowdenbeath,1191,10,4,11,21,23,54,-31,23
Montrose,1192,1,24,7,5,63,36,27,79
Peterhead,1192,2,23,5,8,78,39,39,74
Stirling,1192,3,17,6,13,62,51,11,57
Clyde,1192,4,15,9,12,52,48,4,54
Stenhousem'r,1192,5,15,8,13,55,48,7,53
Elgin,1192,6,14,6,16,55,64,-9,48
Annan Athlet,1192,7,11,11,14,47,42,5,44
Berwick,1192,8,8,10,18,29,59,-30,34
Edinburgh Ci,1192,9,7,10,19,37,61,-24,31
Cowdenbeath,1192,10,5,10,21,24,54,-30,25
Peterhead,1193,1,24,4,8,80,39,41,76
Montrose,1193,2,23,7,6,60,36,24,76
Stirling,1193,3,17,6,13,63,53,10,57
Clyde,1193,4,15,9,12,55,48,7,54
Stenhousem'r,1193,5,15,8,13,57,49,8,53
Elgin,1193,6,15,6,15,55,61,-6,51
Annan Athlet,1193,7,12,11,13,49,42,7,47
Berwick,1193,8,8,10,18,29,62,-33,34
Edinburgh Ci,1193,9,7,9,20,37,63,-26,30
Cowdenbeath,1193,10,4,10,22,24,56,-32,22
Montrose,1194,1,24,7,5,61,34,27,79
Peterhead,1194,2,24,4,8,80,40,40,76
Stenhousem'r,1194,3,16,8,12,59,49,10,56
Stirling,1194,4,16,6,14,63,55,8,54
Clyde,1194,5,15,9,12,54,49,5,54
Elgin,1194,6,14,6,16,53,62,-9,48
Annan Athlet,1194,7,11,11,14,47,42,5,44
Berwick,1194,8,8,10,18,30,61,-31,34
Edinburgh Ci,1194,9,7,9,20,38,63,-25,30
Cowdenbeath,1194,10,5,10,21,24,54,-30,25
Montrose,1195,1,23,8,5,61,36,25,77
Peterhead,1195,2,24,4,8,78,38,40,76
Stirling,1195,3,17,6,13,61,51,10,57
Clyde,1195,4,15,9,12,57,49,8,54
Stenhousem'r,1195,5,15,8,13,55,47,8,53
Elgin,1195,6,14,7,15,55,62,-7,49
Annan Athlet,1195,7,12,11,13,50,41,9,47
Berwick,1195,8,8,10,18,30,64,-34,34
Edinburgh Ci,1195,9,7,9,20,36,61,-25,30
Cowdenbeath,1195,10,4,10,22,23,57,-34,22
Montrose,1196,1,24,7,5,64,34,30,79
Peterhead,1196,2,24,4,8,81,38,43,76
Stirling,1196,3,17,6,13,61,51,10,57
Clyde,1196,4,15,9,12,53,49,4,54
Stenhousem'r,1196,5,15,8,13,55,47,8,53
Elgin,1196,6,14,6,16,53,65,-12,48
Annan Athlet,1196,7,11,11,14,47,42,5,44
Berwick,1196,8,8,10,18,30,60,-30,34
Edinburgh Ci,1196,9,7,9,20,36,64,-28,30
Cowdenbeath,1196,10,5,10,21,24,54,-30,25
Montrose,1197,1,24,7,5,62,34,28,79
Peterhead,1197,2,24,4,8,83,38,45,76
Stirling,1197,3,17,6,13,62,52,10,57
Stenhousem'r,1197,4,15,8,13,56,48,8,53
Clyde,1197,5,14,9,13,51,49,2,51
Elgin,1197,6,14,6,16,53,63,-10,48
Annan Athlet,1197,7,12,11,13,49,41,8,47
Berwick,1197,8,9,10,17,30,58,-28,37
Edinburgh Ci,1197,9,7,9,20,36,66,-30,30
Cowdenbeath,1197,10,4,10,22,23,56,-33,22
Montrose,1198,1,24,7,5,61,35,26,79
Peterhead,1198,2,23,5,8,78,39,39,74
Stirling,1198,3,16,7,13,60,51,9,55
Stenhousem'r,1198,4,15,9,12,55,46,9,54
Clyde,1198,5,14,10,12,52,49,3,52
Elgin,1198,6,14,6,16,54,62,-8,48
Annan Athlet,1198,7,12,11,13,48,41,7,47
Berwick,1198,8,8,11,17,30,59,-29,35
Edinburgh Ci,1198,9,7,10,19,37,61,-24,31
Cowdenbeath,1198,10,4,10,22,23,55,-32,22
Montrose,1199,1,23,8,5,60,35,25,77
Peterhead,1199,2,24,4,8,83,38,45,76
Stirling,1199,3,17,6,13,65,53,12,57
Stenhousem'r,1199,4,15,8,13,57,51,6,53
Clyde,1199,5,14,10,12,52,49,3,52
Elgin,1199,6,14,7,15,54,61,-7,49
Annan Athlet,1199,7,11,12,13,48,42,6,45
Berwick,1199,8,8,11,17,30,59,-29,35
Edinburgh Ci,1199,9,7,9,20,36,66,-30,30
Cowdenbeath,1199,10,4,11,21,24,55,-31,23
Montrose,1200,1,23,7,6,59,35,24,76
Peterhead,1200,2,23,4,9,78,40,38,73
Stirling,1200,3,16,7,13,61,52,9,55
Stenhousem'r,1200,4,15,9,12,56,47,9,54
Clyde,1200,5,15,9,12,54,49,5,54
Elgin,1200,6,15,6,15,54,60,-6,51
Annan Athlet,1200,7,11,12,13,47,41,6,45
Berwick,1200,8,8,10,18,30,61,-31,34
Edinburgh Ci,1200,9,8,9,19,38,61,-23,33
Cowdenbeath,1200,10,4,11,21,23,54,-31,23
Montrose,1201,1,24,7,5,62,34,28,79
Peterhead,1201,2,24,4,8,80,38,42,76
Stenhousem'r,1201,3,16,8,12,57,47,10,56
Stirling,1201,4,16,6,14,61,53,8,54
Clyde,1201,5,15,9,12,53,49,4,54
Elgin,1201,6,14,6,16,53,63,-10,48
Annan Athlet,1201,7,11,12,13,47,41,6,45
Berwick,1201,8,8,10,18,30,60,-30,34
Edinburgh Ci,1201,9,7,9,20,36,63,-27,30
Cowdenbeath,1201,10,4,11,21,23,54,-31,23
Montrose,1202,1,23,8,5,59,34,25,77
Peterhead,1202,2,23,5,8,78,39,39,74
Stenhousem'r,1202,3,16,8,12,57,47,10,56
Stirling,1202,4,16,6,14,61,53,8,54
Clyde,1202,5,15,9,12,52,48,4,54
Elgin,1202,6,14,7,15,53,60,-7,49
Annan Athlet,1202,7,12,11,13,50,41,9,47
Berwick,1202,8,8,10,18,29,59,-30,34
Edinburgh Ci,1202,9,7,10,19,37,61,-24,31
Cowdenbeath,1202,10,4,10,22,23,57,-34,22
Peterhead,1203,1,24,4,8,80,40,40,76
Montrose,1203,2,23,7,6,59,35,24,76
Stirling,1203,3,16,7,13,61,52,9,55
Stenhousem'r,1203,4,15,9,12,56,47,9,54
Clyde,1203,5,14,10,12,53,50,3,52
Elgin,1203,6,15,6,15,54,60,-6,51
Annan Athlet,1203,7,11,12,13,49,43,6,45
Berwick,1203,8,8,11,17,31,60,-29,35
Edinburgh Ci,1203,9,7,9,20,38,63,-25,30
Cowdenbeath,1203,10,4,11,21,25,56,-31,23
Montrose,1204,1,23,8,5,60,35,25,77
Peterhead,1204,2,24,4,8,80,39,41,76
Stenhousem'r,1204,3,16,8,12,56,46,10,56
Stirling,1204,4,16,6,14,60,52,8,54
Clyde,1204,5,14,10,12,52,49,3,52
Elgin,1204,6,14,7,15,54,61,-7,49
Annan Athlet,1204,7,11,12,13,48,42,6,45
Berwick,1204,8,8,11,17,30,59,-29,35
Edinburgh Ci,1204,9,7,9,20,37,63,-26,30
Cowdenbeath,1204,10,4,11,21,24,55,-31,23
Montrose,1205,1,24,7,5,62,35,27,79
Peterhead,1205,2,24,4,8,81,39,42,76
Stirling,1205,3,17,6,13,63,52,11,57
Clyde,1205,4,15,9,12,54,48,6,54
Stenhousem'r,1205,5,15,8,13,56,49,7,53
Elgin,1205,6,14,6,16,54,63,-9,48
Annan Athlet,1205,7,11,12,13,47,41,6,45
Berwick,1205,8,8,10,18,29,61,-32,34
Edinburgh Ci,1205,9,7,9,20,37,64,-27,30
Cowdenbeath,1205,10,4,11,21,23,54,-31,23
Montrose,1206,1,24,7,5,61,35,26,79
Peterhead,1206,2,24,4,8,80,39,41,76
Stirling,1206,3,16,7,13,61,52,9,55
Stenhousem'r,1206,4,15,9,12,56,47,9,54
Clyde,1206,5,14,10,12,52,49,3,52
Elgin,1206,6,14,6,16,54,62,-8,48
Annan Athlet,1206,7,12,11,13,49,42,7,47
Berwick,1206,8,8,11,17,30,59,-29,35
Edinburgh Ci,1206,9,7,9,20,37,63,-26,30
Cowdenbeath,1206,10,4,10,22,24,56,-32,22
Montrose,1207,1,23,7,6,59,35,24,76
Peterhead,1207,2,23,5,8,78,39,39,74
Stirling,1207,3,17,6,13,66,52,14,57
Clyde,1207,4,15,9,12,52,48,4,54
Stenhousem'r,1207,5,15,8,13,56,52,4,53
Elgin,1207,6,15,6,15,54,60,-6,51
Annan Athlet,1207,7,11,11,14,47,42,5,44
Berwick,1207,8,8,10,18,29,59,-30,34
Edinburgh Ci,1207,9,7,10,19,37,61,-24,31
Cowdenbeath,1207,10,5,10,21,24,54,-30,25
Montrose,1208,1,24,7,5,60,34,26,79
Peterhead,1208,2,24,4,8,80,38,42,76
Stenhousem'r,1208,3,16,8,12,58,46,12,56
Stirling,1208,4,16,6,14,60,54,6,54
Clyde,1208,5,14,9,13,51,51,0,51
Elgin,1208,6,14,6,16,53,61,-8,48
Annan Athlet,1208,7,11,12,13,47,41,6,45
Berwick,1208,8,9,10,17,32,58,-26,37
Edinburgh Ci,1208,9,7,9,20,36,63,-27,30
Cowdenbeath,1208,10,4,11,21,23,54,-31,23
Montrose,1209,1,24,7,5,60,34,26,79
Peterhead,1209,2,24,4,8,81,39,42,76
Stirling,1209,3,17,6,13,64,52,12,57
Clyde,1209,4,15,9,12,54,49,5,54
Stenhousem'r,1209,5,15,8,13,56,50,6,53
Elgin,1209,6,14,6,16,53,61,-8,48
Annan Athlet,1209,7,11,11,14,48,43,5,44
Berwick,1209,8,8,10,18,30,61,-31,34
Edinburgh Ci,1209,9,7,9,20,37,64,-27,30
Cowdenbeath,1209,10,5,10,21,25,55,-30,25
Peterhead,1210,1,24,4,8,79,39,40,76
Montrose,1210,2,23,7,6,59,35,24,76
Stirling,1210,3,17,6,13,61,51,10,57
Clyde,1210,4,15,9,12,54,48,6,54
Stenhousem'r,1210,5,15,8,13,55,47,8,53
Elgin,1210,6,15,6,15,54,60,-6,51
Annan Athlet,1210,7,12,11,13,50,41,9,47
Berwick,1210,8,8,10,18,29,61,-32,34
Edinburgh Ci,1210,9,7,9,20,37,62,-25,30
Cowdenbeath,1210,10,4,10,22,23,57,-34,22
Montrose,1211,1,23,8,5,61,36,25,77
Peterhead,1211,2,24,4,8,80,39,41,76
Stenhousem'r,1211,3,16,8,12,58,47,11,56
Stirling,1211,4,16,6,14,61,54,7,54
Clyde,1211,5,14,10,12,53,50,3,52
Elgin,1211,6,14,7,15,55,62,-7,49
Annan Athlet,1211,7,12,11,13,49,42,7,47
Berwick,1211,8,8,11,17,31,60,-29,35
Edinburgh Ci,1211,9,7,9,20,37,63,-26,30
Cowdenbeath,1211,10,4,10,22,24,56,-32,22
Montrose,1212,1,24,7,5,60,34,26,79
Peterhead,1212,2,24,4,8,83,40,43,76
Stenhousem'r,1212,3,16,8,12,59,46,13,56
Stirling,1212,4,16,6,14,60,55,5,54
Clyde,1212,5,15,9,12,52,48,4,54
Elgin,1212,6,14,6,16,53,61,-8,48
Annan Athlet,1212,7,12,11,13,49,42,7,47
Berwick,1212,8,8,10,18,29,59,-30,34
Edinburgh Ci,1212,9,7,9,20,38,66,-28,30
Cowdenbeath,1212,10,4,10,22,24,56,-32,22
Peterhead,1213,1,24,4,8,79,39,40,76
Montrose,1213,2,23,7,6,61,38,23,76
Stirling,1213,3,16,7,13,60,51,9,55
Stenhousem'r,1213,4,15,9,12,55,46,9,54
Clyde,1213,5,15,9,12,53,49,4,54
Elgin,1213,6,15,6,15,57,62,-5,51
Annan Athlet,1213,7,11,11,14,48,43,5,44
Berwick,1213,8,8,10,18,30,60,-30,34
Edinburgh Ci,1213,9,7,9,20,37,62,-25,30
Cowdenbeath,1213,10,5,10,21,25,55,-30,25
Montrose,1214,1,24,7,5,61,35,26,79
Peterhead,1214,2,24,4,8,79,38,41,76
Stenhousem'r,1214,3,16,8,12,56,46,10,56
Stirling,1214,4,16,6,14,60,52,8,54
Clyde,1214,5,15,9,12,53,48,5,54
Elgin,1214,6,14,6,16,54,62,-8,48
Annan Athlet,1214,7,12,11,13,48,41,7,47
Berwick,1214,8,8,10,18,29,60,-31,34
Edinburgh Ci,1214,9,7,9,20,36,62,-26,30
Cowdenbeath,1214,10,4,10,22,23,55,-32,22
Montrose,1215,1,24,7,5,60,34,26,79
Peterhead,1215,2,24,4,8,81,38,43,76
Stenhousem'r,1215,3,16,8,12,58,46,12,56
Stirling,1215,4,16,6,14,60,54,6,54
Clyde,1215,5,14,10,12,52,49,3,52
Elgin,1215,6,14,6,16,53,61,-8,48
Annan Athlet,1215,7,11,11,14,47,42,5,44
Berwick,1215,8,8,11,17,30,59,-29,35
Edinburgh Ci,1215,9,7,9,20,36,64,-28,30
Cowdenbeath,1215,10,5,10,21,24,54,-30,25
Montrose,1216,1,24,7,5,61,34,27,79
Peterhead,1216,2,24,4,8,79,38,41,76
Stenhousem'r,1216,3,16,8,12,58,48,10,56
Stirling,1216,4,16,6,14,62,54,8,54
Clyde,1216,5,15,9,12,54,50,4,54
Elgin,1216,6,14,6,16,53,62,-9,48
Annan Athlet,1216,7,11,11,14,47,42,5,44
Berwick,1216,8,8,10,18,31,61,-30,34
Edinburgh Ci,1216,9,7,9,20,36,62,-26,30
Cowdenbeath,1216,10,5,10,21,24,54,-30,25
Montrose,1217,1,24,7,5,61,34,27,79
Peterhead,1217,2,24,4,8,80,39,41,76
Stirling,1217,3,16,7,13,62,53,9,55
Stenhousem'r,1217,4,15,9,12,57,48,9,54
Clyde,1217,5,15,9,12,53,48,5,54
Elgin,1217,6,14,6,16,53,62,-9,48
Annan Athlet,1217,7,12,11,13,48,41,7,47
Berwick,1217,8,8,10,18,29,60,-31,34
Edinburgh Ci,1217,9,7,9,20,37,63,-26,30
Cowdenbeath,1217,10,4,10,22,23,55,-32,22
Montrose,1218,1,24,7,5,62,35,27,79
Peterhead,1218,2,24,4,8,80,38,42,76
Stirling,1218,3,17,6,13,62,52,10,57
Clyde,1218,4,15,9,12,54,49,5,54
Stenhousem'r,1218,5,15,8,13,56,48,8,53
Elgin,1218,6,14,6,16,54,63,-9,48
Annan Athlet,1218,7,11,12,13,48,42,6,45
Berwick,1218,8,8,10,18,30,61,-31,34
Edinburgh Ci,1218,9,7,9,20,36,63,-27,30
Cowdenbeath,1218,10,4,11,21,24,55,-31,23
Montrose,1219,1,23,8,5,62,37,25,77
Peterhead,1219,2,24,4,8,83,38,45,76
Stenhousem'r,1219,3,16,8,12,56,46,10,56
Stirling,1219,4,16,6,14,60,52,8,54
Clyde,1219,5,15,9,12,56,48,8,54
Elgin,1219,6,14,7,15,56,63,-7,49
Annan Athlet,1219,7,11,12,13,48,42,6,45
Berwick,1219,8,8,10,18,29,63,-34,34
Edinburgh Ci,1219,9,7,9,20,36,66,-30,30
Cowdenbeath,1219,10,4,11,21,24,55,-31,23
Montrose,1220,1,24,7,5,62,34,28,79
Peterhead,1220,2,23,4,9,77,39,38,73
Stirling,1220,3,17,6,13,62,51,11,57
Stenhousem'r,1220,4,15,8,13,55,48,7,53
Clyde,1220,5,14,10,12,51,48,3,52
Elgin,1220,6,14,6,16,53,63,-10,48
Annan Athlet,1220,7,11,12,13,48,42,6,45
Berwick,1220,8,8,11,17,29,58,-29,35
Edinburgh Ci,1220,9,8,9,19,37,60,-23,33
Cowdenbeath,1220,10,4,11,21,24,55,-31,23
Montrose,1221,1,23,8,5,59,34,25,77
Peterhead,1221,2,23,5,8,78,39,39,74
Stirling,1221,3,16,7,13,60,51,9,55
Stenhousem'r,1221,4,15,9,12,55,46,9,54
Clyde,1221,5,15,9,12,55,48,7,54
Elgin,1221,6,14,7,15,53,60,-7,49
Annan Athlet,1221,7,12,11,13,50,42,8,47
Berwick,1221,8,8,10,18,29,62,-33,34
Edinburgh Ci,1221,9,7,10,19,37,61,-24,31
Cowdenbeath,1221,10,4,10,22,24,57,-33,22
Montrose,1222,1,23,8,5,60,35,25,77
Peterhead,1222,2,24,4,8,81,39,42,76
Stirling,1222,3,17,6,13,63,53,10,57
Stenhousem'r,1222,4,15,8,13,57,49,8,53
Clyde,1222,5,14,10,12,51,48,3,52
Elgin,1222,6,14,7,15,54,61,-7,49
Annan Athlet,1222,7,12,11,13,48,41,7,47
Berwick,1222,8,8,11,17,29,58,-29,35
Edinburgh Ci,1222,9,7,9,20,37,64,-27,30
Cowdenbeath,1222,10,4,10,22,23,55,-32,22
Montrose,1223,1,23,8,5,59,34,25,77
Peterhead,1223,2,24,4,8,80,39,41,76
Stirling,1223,3,17,6,13,63,53,10,57
Clyde,1223,4,15,9,12,52,48,4,54
Stenhousem'r,1223,5,15,8,13,57,49,8,53
Elgin,1223,6,14,7,15,53,60,-7,49
Annan Athlet,1223,7,12,11,13,50,41,9,47
Berwick,1223,8,8,10,18,29,59,-30,34
Edinburgh Ci,1223,9,7,9,20,37,63,-26,30
Cowdenbeath,1223,10,4,10,22,23,57,-34,22
Montrose,1224,1,24,7,5,61,35,26,79
Peterhead,1224,2,24,4,8,82,40,42,76
Stirling,1224,3,16,7,13,61,52,9,55
Stenhousem'r,1224,4,15,9,12,56,47,9,54
Clyde,1224,5,15,9,12,54,48,6,54
Elgin,1224,6,14,6,16,54,62,-8,48
Annan Athlet,1224,7,11,12,13,47,41,6,45
Berwick,1224,8,8,10,18,29,61,-32,34
Edinburgh Ci,1224,9,7,9,20,38,65,-27,30
Cowdenbeath,1224,10,4,11,21,23,54,-31,23
Montrose,1225,1,24,7,5,65,34,31,79
Peterhead,1225,2,24,4,8,82,40,42,76
Stenhousem'r,1225,3,16,8,12,58,48,10,56
Stirling,1225,4,16,6,14,62,54,8,54
Clyde,1225,5,14,9,13,51,49,2,51
Elgin,1225,6,14,6,16,53,66,-13,48
Annan Athlet,1225,7,12,11,13,50,41,9,47
Berwick,1225,8,9,10,17,30,58,-28,37
Edinburgh Ci,1225,9,7,9,20,38,65,-27,30
Cowdenbeath,1225,10,4,10,22,23,57,-34,22
Montrose,1226,1,24,7,5,61,34,27,79
Peterhead,1226,2,24,4,8,80,40,40,76
Stenhousem'r,1226,3,16,8,12,57,47,10,56
Stirling,1226,4,16,6,14,61,53,8,54
Clyde,1226,5,14,9,13,51,50,1,51
Elgin,1226,6,14,6,16,53,62,-9,48
Annan Athlet,1226,7,11,11,14,47,42,5,44
Berwick,1226,8,9,10,17,31,58,-27,37
Edinburgh Ci,1226,9,7,9,20,38,63,-25,30
Cowdenbeath,1226,10,5,10,21,24,54,-30,25
Peterhead,1227,1,24,4,8,81,39,42,76
Montrose,1227,2,23,7,6,59,36,23,76
Stirling,1227,3,17,6,13,63,53,10,57
Clyde,1227,4,15,9,12,54,50,4,54
Stenhousem'r,1227,5,15,8,13,57,49,8,53
Elgin,1227,6,15,6,15,55,60,-5,51
Annan Athlet,1227,7,12,11,13,48,41,7,47
Berwick,1227,8,8,10,18,31,61,-30,34
Edinburgh Ci,1227,9,7,9,20,37,64,-27,30
Cowdenbeath,1227,10,4,10,22,23,55,-32,22
Montrose,1228,1,24,7,5,65,36,29,79
Peterhead,1228,2,23,5,8,78,39,39,74
Stenhousem'r,1228,3,16,8,12,57,47,10,56
Stirling,1228,4,16,6,14,61,53,8,54
Clyde,1228,5,15,9,12,52,48,4,54
Elgin,1228,6,14,6,16,55,66,-11,48
Annan Athlet,1228,7,11,11,14,48,43,5,44
Berwick,1228,8,8,10,18,29,59,-30,34
Edinburgh Ci,1228,9,7,10,19,37,61,-24,31
Cowdenbeath,1228,10,5,10,21,25,55,-30,25
Montrose,1229,1,24,7,5,63,35,28,79
Peterhead,1229,2,24,4,8,82,39,43,76
Stirling,1229,3,17,6,13,63,52,11,57
Clyde,1229,4,15,9,12,57,49,8,54
Stenhousem'r,1229,5,15,8,13,56,49,7,53
Elgin,1229,6,14,6,16,54,64,-10,48
Annan Athlet,1229,7,12,11,13,48,41,7,47
Berwick,1229,8,8,10,18,30,64,-34,34
Edinburgh Ci,1229,9,7,9,20,37,65,-28,30
Cowdenbeath,1229,10,4,10,22,23,55,-32,22
Montrose,1230,1,24,7,5,62,35,27,79
Peterhead,1230,2,24,4,8,81,39,42,76
Stenhousem'r,1230,3,16,8,12,58,46,12,56
Stirling,1230,4,16,6,14,60,54,6,54
Clyde,1230,5,14,9,13,52,50,2,51
Elgin,1230,6,14,6,16,54,63,-9,48
Annan Athlet,1230,7,12,11,13,49,41,8,47
Berwick,1230,8,9,10,17,31,59,-28,37
Edinburgh Ci,1230,9,7,9,20,37,64,-27,30
Cowdenbeath,1230,10,4,10,22,23,56,-33,22
Montrose,1231,1,24,7,5,60,34,26,79
Peterhead,1231,2,24,4,8,83,38,45,76
Stirling,1231,3,17,6,13,64,52,12,57
Stenhousem'r,1231,4,15,8,13,56,50,6,53
Clyde,1231,5,14,10,12,51,48,3,52
Elgin,1231,6,14,6,16,53,61,-8,48
Annan Athlet,1231,7,11,12,13,48,42,6,45
Berwick,1231,8,8,11,17,29,58,-29,35
Edinburgh Ci,1231,9,7,9,20,36,66,-30,30
Cowdenbeath,1231,10,4,11,21,24,55,-31,23
Montrose,1232,1,23,8,5,59,34,25,77
Peterhead,1232,2,24,4,8,80,38,42,76
Stirling,1232,3,17,6,13,62,51,11,57
Clyde,1232,4,15,9,12,53,49,4,54
Stenhousem'r,1232,5,15,8,13,55,48,7,53
Elgin,1232,6,14,7,15,53,60,-7,49
Annan Athlet,1232,7,12,11,13,48,41,7,47
Berwick,1232,8,8,10,18,30,60,-30,34
Edinburgh Ci,1232,9,7,9,20,36,63,-27,30
Cowdenbeath,1232,10,4,10,22,23,55,-32,22
Montrose,1233,1,23,8,5,60,35,25,77
Peterhead,1233,2,24,4,8,78,38,40,76
Stirling,1233,3,16,7,13,62,53,9,55
Stenhousem'r,1233,4,15,9,12,57,48,9,54
Clyde,1233,5,15,9,12,53,48,5,54
Elgin,1233,6,14,7,15,54,61,-7,49
Annan Athlet,1233,7,11,12,13,48,42,6,45
Berwick,1233,8,8,10,18,29,60,-31,34
Edinburgh Ci,1233,9,7,9,20,36,61,-25,30
Cowdenbeath,1233,10,4,11,21,24,55,-31,23
Montrose,1234,1,24,7,5,61,34,27,79
Peterhead,1234,2,23,5,8,77,38,39,74
Stenhousem'r,1234,3,16,8,12,57,47,10,56
Stirling,1234,4,16,6,14,61,53,8,54
Clyde,1234,5,15,9,12,55,50,5,54
Elgin,1234,6,14,6,16,53,62,-9,48
Annan Athlet,1234,7,12,11,13,49,41,8,47
Berwick,1234,8,8,10,18,31,62,-31,34
Edinburgh Ci,1234,9,7,10,19,36,60,-24,31
Cowdenbeath,1234,10,4,10,22,23,56,-33,22
Montrose,1235,1,23,7,6,60,38,22,76
Peterhead,1235,2,23,4,9,77,39,38,73
Stirling,1235,3,17,6,13,62,52,10,57
Clyde,1235,4,15,9,12,53,48,5,54
Stenhousem'r,1235,5,15,8,13,56,48,8,53
Elgin,1235,6,15,6,15,57,61,-4,51
Annan Athlet,1235,7,11,12,13,47,41,6,45
Berwick,1235,8,8,10,18,29,60,-31,34
Edinburgh Ci,1235,9,8,9,19,37,60,-23,33
Cowdenbeath,1235,10,4,11,21,23,54,-31,23
Montrose,1236,1,24,7,5,60,34,26,79
Peterhead,1236,2,23,5,8,79,40,39,74
Stenhousem'r,1236,3,16,8,12,56,46,10,56
Stirling,1236,4,16,6,14,60,52,8,54
Clyde,1236,5,14,9,13,51,50,1,51
Elgin,1236,6,14,6,16,53,61,-8,48
Annan Athlet,1236,7,11,11,14,48,43,5,44
Berwick,1236,8,9,10,17,31,58,-27,37
Edinburgh Ci,1236,9,7,10,19,38,62,-24,31
Cowdenbeath,1236,10,5,10,21,25,55,-30,25
Montrose,1237,1,24,7,5,60,34,26,79
Peterhead,1237,2,23,4,9,77,40,37,73
Stirling,1237,3,17,6,13,63,52,11,57
Clyde,1237,4,15,9,12,54,49,5,54
Stenhousem'r,1237,5,15,8,13,56,49,7,53
Elgin,1237,6,14,6,16,53,61,-8,48
Annan Athlet,1237,7,12,11,13,49,42,7,47
Berwick,1237,8,8,10,18,30,61,-31,34
Edinburgh Ci,1237,9,8,9,19,38,60,-22,33
Cowdenbeath,1237,10,4,10,22,24,56,-32,22
Peterhead,1238,1,24,4,8,81,38,43,76
Montrose,1238,2,23,7,6,59,36,23,76
Stirling,1238,3,17,6,13,63,52,11,57
Clyde,1238,4,15,9,12,52,48,4,54
Stenhousem'r,1238,5,15,8,13,56,49,7,53
Elgin,1238,6,15,6,15,55,60,-5,51
Annan Athlet,1238,7,12,11,13,48,41,7,47
Berwick,1238,8,8,10,18,29,59,-30,34
Edinburgh Ci,1238,9,7,9,20,36,64,-28,30
Cowdenbeath,1238,10,4,10,22,23,55,-32,22
Montrose,1239,1,23,8,5,60,35,25,77
Peterhead,1239,2,24,4,8,79,38,41,76
Stirling,1239,3,16,7,13,60,51,9,55
Stenhousem'r,1239,4,15,9,12,55,46,9,54
Clyde,1239,5,14,10,12,52,49,3,52
Elgin,1239,6,14,7,15,54,61,-7,49
Annan Athlet,1239,7,11,12,13,47,41,6,45
Berwick,1239,8,8,11,17,30,59,-29,35
Edinburgh Ci,1239,9,7,9,20,36,62,-26,30
Cowdenbeath,1239,10,4,11,21,23,54,-31,23
Montrose,1240,1,24,7,5,61,34,27,79
Peterhead,1240,2,24,4,8,79,38,41,76
Stenhousem'r,1240,3,16,8,12,57,46,11,56
Stirling,1240,4,16,6,14,60,53,7,54
Clyde,1240,5,15,9,12,54,50,4,54
Elgin,1240,6,14,6,16,53,62,-9,48
Annan Athlet,1240,7,12,11,13,48,41,7,47
Berwick,1240,8,8,10,18,31,61,-30,34
Edinburgh Ci,1240,9,7,9,20,36,62,-26,30
Cowdenbeath,1240,10,4,10,22,23,55,-32,22
Montrose,1241,1,24,7,5,60,34,26,79
Peterhead,1241,2,24,4,8,78,38,40,76
Stenhousem'r,1241,3,16,8,12,57,47,10,56
Stirling,1241,4,16,6,14,61,53,8,54
Clyde,1241,5,14,10,12,51,48,3,52
Elgin,1241,6,14,6,16,53,61,-8,48
Annan Athlet,1241,7,12,11,13,49,42,7,47
Berwick,1241,8,8,11,17,29,58,-29,35
Edinburgh Ci,1241,9,7,9,20,36,61,-25,30
Cowdenbeath,1241,10,4,10,22,24,56,-32,22
Peterhead,1242,1,24,4,8,81,40,41,76
Montrose,1242,2,23,7,6,59,37,22,76
Stirling,1242,3,16,7,13,60,51,9,55
Stenhousem'r,1242,4,15,9,12,55,46,9,54
Clyde,1242,5,15,9,12,52,48,4,54
Elgin,1242,6,15,6,15,56,60,-4,51
Annan Athlet,1242,7,11,11,14,47,45,2,44
Berwick,1242,8,8,10,18,29,59,-30,34
Edinburgh Ci,1242,9,7,9,20,38,64,-26,30
Cowdenbeath,1242,10,5,10,21,27,54,-27,25
Montrose,1243,1,23,8,5,59,34,25,77
Peterhead,1243,2,24,4,8,78,38,40,76
Stirling,1243,3,17,6,13,61,51,10,57
Clyde,1243,4,15,9,12,54,49,5,54
Stenhousem'r,1243,5,15,8,13,55,47,8,53
Elgin,1243,6,14,7,15,53,60,-7,49
Annan Athlet,1243,7,11,12,13,48,42,6,45
Berwick,1243,8,8,10,18,30,61,-31,34
Edinburgh Ci,1243,9,7,9,20,36,61,-25,30
Cowdenbeath,1243,10,4,11,21,24,55,-31,23
Montrose,1244,1,24,7,5,61,35,26,79
Peterhead,1244,2,24,4,8,81,38,43,76
Stenhousem'r,1244,3,16,8,12,57,46,11,56
Stirling,1244,4,16,6,14,60,53,7,54
Clyde,1244,5,15,9,12,53,48,5,54
Elgin,1244,6,14,6,16,54,62,-8,48
Annan Athlet,1244,7,11,12,13,48,42,6,45
Berwick,1244,8,8,10,18,29,60,-31,34
Edinburgh Ci,1244,9,7,9,20,36,64,-28,30
Cowdenbeath,1244,10,4,11,21,24,55,-31,23
Peterhead,1245,1,24,4,8,78,38,40,76
Montrose,1245,2,23,7,6,59,35,24,76
Stirling,1245,3,17,6,13,64,52,12,57
Stenhousem'r,1245,4,15,8,13,56,50,6,53
Clyde,1245,5,14,9,13,51,50,1,51
Elgin,1245,6,15,6,15,54,60,-6,51
Annan Athlet,1245,7,12,11,13,48,41,7,47
Berwick,1245,8,9,10,17,31,58,-27,37
Edinburgh Ci,1245,9,7,9,20,36,61,-25,30
Cowdenbeath,1245,10,4,10,22,23,55,-32,22
Montrose,1246,1,24,7,5,60,34,26,79
Peterhead,1246,2,24,4,8,84,40,44,76
Stenhousem'r,1246,3,16,8,12,58,47,11,56
Stirling,1246,4,16,6,14,61,54,7,54
Clyde,1246,5,14,10,12,52,49,3,52
Elgin,1246,6,14,6,16,53,61,-8,48
Annan Athlet,1246,7,12,11,13,48,41,7,47
Berwick,1246,8,8,11,17,30,59,-29,35
Edinburgh Ci,1246,9,7,9,20,38,67,-29,30
Cowdenbeath,1246,10,4,10,22,23,55,-32,22
Montrose,1247,1,24,7,5,61,34,27,79
Peterhead,1247,2,24,4,8,80,38,42,76
Stirling,1247,3,16,7,13,61,52,9,55
Stenhousem'r,1247,4,15,9,12,56,47,9,54
Clyde,1247,5,15,9,12,52,48,4,54
Elgin,1247,6,14,6,16,53,62,-9,48
Annan Athlet,1247,7,11,12,13,47,41,6,45
Berwick,1247,8,8,10,18,29,59,-30,34
Edinburgh Ci,1247,9,7,9,20,36,63,-27,30
Cowdenbeath,1247,10,4,11,21,23,54,-31,23
Montrose,1248,1,24,7,5,61,35,26,79
Peterhead,1248,2,24,4,8,79,38,41,76
Stenhousem'r,1248,3,16,8,12,59,47,12,56
Stirling,1248,4,16,6,14,61,55,6,54
Clyde,1248,5,14,10,12,51,48,3,52
Elgin,1248,6,14,6,16,54,62,-8,48
Annan Athlet,1248,7,11,11,14,47,42,5,44
Berwick,1248,8,8,11,17,29,58,-29,35
Edinburgh Ci,1248,9,7,9,20,36,62,-26,30
Cowdenbeath,1248,10,5,10,21,24,54,-30,25
Peterhead,1249,1,24,4,8,82,38,44,76
Montrose,1249,2,23,7,6,59,35,24,76
Stirling,1249,3,17,6,13,62,52,10,57
Clyde,1249,4,15,9,12,52,48,4,54
Stenhousem'r,1249,5,15,8,13,56,48,8,53
Elgin,1249,6,15,6,15,54,60,-6,51
Annan Athlet,1249,7,11,12,13,47,41,6,45
Berwick,1249,8,8,10,18,29,59,-30,34
Edinburgh Ci,1249,9,7,9,20,36,65,-29,30
Cowdenbeath,1249,10,4,11,21,23,54,-31,23
Montrose,1250,1,24,7,5,61,34,27,79
Peterhead,1250,2,24,4,8,79,39,40,76
Stirling,1250,3,16,7,13,61,52,9,55
Stenhousem'r,1250,4,15,9,12,56,47,9,54
Clyde,1250,5,15,9,12,54,49,5,54
Elgin,1250,6,14,6,16,53,62,-9,48
Annan Athlet,1250,7,12,11,13,48,41,7,47
Berwick,1250,8,8,10,18,30,61,-31,34
Edinburgh Ci,1250,9,7,9,20,37,62,-25,30
Cowdenbeath,1250,10,4,10,22,23,55,-32,22
Montrose,1251,1,24,7,5,62,36,26,79
Peterhead,1251,2,24,4,8,79,39,40,76
Stirling,1251,3,16,7,13,62,53,9,55
Stenhousem'r,1251,4,15,9,12,57,48,9,54
Clyde,1251,5,14,9,13,51,49,2,51
Elgin,1251,6,14,6,16,55,63,-8,48
Annan Athlet,1251,7,11,11,14,47,42,5,44
Berwick,1251,8,9,10,17,30,58,-28,37
Edinburgh Ci,1251,9,7,9,20,37,62,-25,30
Cowdenbeath,1251,10,5,10,21,24,54,-30,25
Peterhead,1252,1,24,4,8,80,38,42,76
Montrose,1252,2,23,7,6,59,36,23,76
Stirling,1252,3,17,6,13,66,53,13,57
Clyde,1252,4,15,9,12,53,48,5,54
Stenhousem'r,1252,5,15,8,13,57,52,5,53
Elgin,1252,6,15,6,15,55,60,-5,51
Annan Athlet,1252,7,11,11,14,47,42,5,44
Berwick,1252,8,8,10,18,29,60,-31,34
Edinburgh Ci,1252,9,7,9,20,36,63,-27,30
Cowdenbeath,1252,10,5,10,21,24,54,-30,25
Peterhead,1253,1,24,4,8,80,39,41,76
Montrose,1253,2,23,7,6,60,37,23,76
Stirling,1253,3,17,6,13,63,51,12,57
Clyde,1253,4,15,9,12,53,48,5,54
Stenhousem'r,1253,5,15,8,13,55,49,6,53
Elgin,1253,6,15,6,15,56,61,-5,51
Annan Athlet,1253,7,11,12,13,48,42,6,45
Berwick,1253,8,8,10,18,29,60,-31,34
Edinburgh Ci,1253,9,7,9,20,37,63,-26,30
Cowdenbeath,1253,10,4,11,21,24,55,-31,23
Montrose,1254,1,24,7,5,61,34,27,79
Peterhead,1254,2,24,4,8,79,38,41,76
Stenhousem'r,1254,3,16,8,12,57,47,10,56
Stirling,1254,4,16,6,14,61,53,8,54
Clyde,1254,5,15,9,12,53,48,5,54
Elgin,1254,6,14,6,16,53,62,-9,48
Annan Athlet,1254,7,11,11,14,47,43,4,44
Berwick,1254,8,8,10,18,29,60,-31,34
Edinburgh Ci,1254,9,7,9,20,36,62,-26,30
Cowdenbeath,1254,10,5,10,21,25,54,-29,25
Montrose,1255,1,24,7,5,60,34,26,79
Peterhead,1255,2,24,4,8,82,38,44,76
Stirling,1255,3,17,6,13,64,53,11,57
Stenhousem'r,1255,4,15,8,13,57,50,7,53
Clyde,1255,5,14,10,12,52,49,3,52
Elgin,1255,6,14,6,16,53,61,-8,48
Annan Athlet,1255,7,11,12,13,47,41,6,45
Berwick,1255,8,8,11,17,30,59,-29,35
Edinburgh Ci,1255,9,7,9,20,36,65,-29,30
Cowdenbeath,1255,10,4,11,21,23,54,-31,23
Montrose,1256,1,24,7,5,60,34,26,79
Peterhead,1256,2,24,4,8,84,39,45,76
Stirling,1256,3,16,7,13,62,53,9,55
Stenhousem'r,1256,4,15,9,12,57,48,9,54
Clyde,1256,5,14,10,12,51,48,3,52
Elgin,1256,6,14,6,16,53,61,-8,48
Annan Athlet,1256,7,12,11,13,48,41,7,47
Berwick,1256,8,8,11,17,29,58,-29,35
Edinburgh Ci,1256,9,7,9,20,37,67,-30,30
Cowdenbeath,1256,10,4,10,22,23,55,-32,22
Montrose,1257,1,24,7,5,64,36,28,79
Peterhead,1257,2,24,4,8,79,38,41,76
Stenhousem'r,1257,3,16,8,12,56,46,10,56
Stirling,1257,4,16,6,14,60,52,8,54
Clyde,1257,5,15,9,12,53,48,5,54
Elgin,1257,6,14,6,16,55,65,-10,48
Annan Athlet,1257,7,12,11,13,51,41,10,47
Berwick,1257,8,8,10,18,29,60,-31,34
Edinburgh Ci,1257,9,7,9,20,36,62,-26,30
Cowdenbeath,1257,10,4,10,22,23,58,-35,22
Montrose,1258,1,23,8,5,60,35,25,77
Peterhead,1258,2,23,5,8,79,40,39,74
Stirling,1258,3,16,7,13,64,55,9,55
Stenhousem'r,1258,4,15,9,12,59,50,9,54
Clyde,1258,5,15,9,12,53,48,5,54
Elgin,1258,6,14,7,15,54,61,-7,49
Annan Athlet,1258,7,11,11,14,48,44,4,44
Berwick,1258,8,8,10,18,29,60,-31,34
Edinburgh Ci,1258,9,7,10,19,38,62,-24,31
Cowdenbeath,1258,10,5,10,21,26,55,-29,25
Montrose,1259,1,24,7,5,61,35,26,79
Peterhead,1259,2,24,4,8,80,40,40,76
Stenhousem'r,1259,3,16,8,12,57,47,10,56
Stirling,1259,4,16,6,14,61,53,8,54
Clyde,1259,5,14,10,12,52,49,3,52
Elgin,1259,6,14,6,16,54,62,-8,48
Annan Athlet,1259,7,11,12,13,47,41,6,45
Berwick,1259,8,8,11,17,30,59,-29,35
Edinburgh Ci,1259,9,7,9,20,38,63,-25,30
Cowdenbeath,1259,10,4,11,21,23,54,-31,23
Montrose,1260,1,23,8,5,59,34,25,77
Peterhead,1260,2,24,4,8,79,38,41,76
Stenhousem'r,1260,3,16,8,12,57,47,10,56
Stirling,1260,4,16,6,14,61,53,8,54
Clyde,1260,5,14,10,12,53,50,3,52
Elgin,1260,6,14,7,15,53,60,-7,49
Annan Athlet,1260,7,12,11,13,48,41,7,47
Berwick,1260,8,8,11,17,31,60,-29,35
Edinburgh Ci,1260,9,7,9,20,36,62,-26,30
Cowdenbeath,1260,10,4,10,22,23,55,-32,22
Montrose,1261,1,24,7,5,63,35,28,79
Peterhead,1261,2,23,5,8,80,41,39,74
Stirling,1261,3,17,6,13,62,52,10,57
Clyde,1261,4,15,9,12,54,48,6,54
Stenhousem'r,1261,5,15,8,13,56,48,8,53
Elgin,1261,6,14,6,16,54,64,-10,48
Annan Athlet,1261,7,12,11,13,48,41,7,47
Berwick,1261,8,8,10,18,29,61,-32,34
Edinburgh Ci,1261,9,7,10,19,39,63,-24,31
Cowdenbeath,1261,10,4,10,22,23,55,-32,22
Montrose,1262,1,24,7,5,63,36,27,79
Peterhead,1262,2,24,4,8,79,39,40,76
Stirling,1262,3,16,7,13,61,52,9,55
Stenhousem'r,1262,4,15,9,12,56,47,9,54
Clyde,1262,5,14,9,13,51,50,1,51
Elgin,1262,6,14,6,16,55,64,-9,48
Annan Athlet,1262,7,12,11,13,48,41,7,47
Berwick,1262,8,9,10,17,31,58,-27,37
Edinburgh Ci,1262,9,7,9,20,37,62,-25,30
Cowdenbeath,1262,10,4,10,22,23,55,-32,22
Montrose,1263,1,23,8,5,60,35,25,77
Peterhead,1263,2,24,4,8,80,38,42,76
Stirling,1263,3,17,6,13,62,51,11,57
Stenhousem'r,1263,4,15,8,13,55,48,7,53
Clyde,1263,5,14,10,12,51,48,3,52
Elgin,1263,6,14,7,15,54,61,-7,49
Annan Athlet,1263,7,11,11,14,47,42,5,44
Berwick,1263,8,8,11,17,29,58,-29,35
Edinburgh Ci,1263,9,7,9,20,36,63,-27,30
Cowdenbeath,1263,10,5,10,21,24,54,-30,25
Montrose,1264,1,23,7,6,61,37,24,76
Peterhead,1264,2,23,5,8,77,38,39,74
Stenhousem'r,1264,3,16,8,12,58,46,12,56
Stirling,1264,4,16,6,14,60,54,6,54
Clyde,1264,5,15,9,12,54,49,5,54
Elgin,1264,6,15,6,15,56,62,-6,51
Annan Athlet,1264,7,11,11,14,47,42,5,44
Berwick,1264,8,8,10,18,30,61,-31,34
Edinburgh Ci,1264,9,7,10,19,36,60,-24,31
Cowdenbeath,1264,10,5,10,21,24,54,-30,25
Montrose,1265,1,23,8,5,60,35,25,77
Peterhead,1265,2,24,4,8,81,38,43,76
Stirling,1265,3,17,6,13,64,53,11,57
Stenhousem'r,1265,4,15,8,13,57,50,7,53
Clyde,1265,5,14,10,12,52,49,3,52
Elgin,1265,6,14,7,15,54,61,-7,49
Annan Athlet,1265,7,12,11,13,48,41,7,47
Berwick,1265,8,8,11,17,30,59,-29,35
Edinburgh Ci,1265,9,7,9,20,36,64,-28,30
Cowdenbeath,1265,10,4,10,22,23,55,-32,22
Montrose,1266,1,23,8,5,60,35,25,77
Peterhead,1266,2,24,4,8,78,38,40,76
Stirling,1266,3,17,6,13,62,52,10,57
Stenhousem'r,1266,4,15,8,13,56,48,8,53
Clyde,1266,5,14,10,12,52,49,3,52
Elgin,1266,6,14,7,15,54,61,-7,49
Annan Athlet,1266,7,11,12,13,48,42,6,45
Berwick,1266,8,8,11,17,30,59,-29,35
Edinburgh Ci,1266,9,7,9,20,36,61,-25,30
Cowdenbeath,1266,10,4,11,21,24,55,-31,23
Peterhead,1267,1,24,4,8,80,39,41,76
Montrose,1267,2,23,7,6,59,35,24,76
Stirling,1267,3,17,6,13,63,52,11,57
Stenhousem'r,1267,4,15,8,13,56,49,7,53
Clyde,1267,5,14,9,13,51,51,0,51
Elgin,1267,6,15,6,15,54,60,-6,51
Annan Athlet,1267,7,11,12,13,48,42,6,45
Berwick,1267,8,9,10,17,32,58,-26,37
Edinburgh Ci,1267,9,7,9,20,37,63,-26,30
Cowdenbeath,1267,10,4,11,21,24,55,-31,23
Montrose,1268,1,24,7,5,61,34,27,79
Peterhead,1268,2,24,4,8,82,38,44,76
Stirling,1268,3,17,6,13,67,55,12,57
Clyde,1268,4,15,9,12,54,48,6,54
Stenhousem'r,1268,5,15,8,13,59,53,6,53
Elgin,1268,6,14,6,16,53,62,-9,48
Annan Athlet,1268,7,11,11,14,47,43,4,44
Berwick,1268,8,8,10,18,29,61,-32,34
Edinburgh Ci,1268,9,7,9,20,36,65,-29,30
Cowdenbeath,1268,10,5,10,21,25,54,-29,25
Montrose,1269,1,24,7,5,61,35,26,79
Peterhead,1269,2,24,4,8,81,39,42,76
Stirling,1269,3,16,7,13,65,56,9,55
Stenhousem'r,1269,4,15,9,12,60,51,9,54
Clyde,1269,5,15,9,12,52,48,4,54
Elgin,1269,6,14,6,16,54,62,-8,48
Annan Athlet,1269,7,11,12,13,47,41,6,45
Berwick,1269,8,8,10,18,29,59,-30,34
Edinburgh Ci,1269,9,7,9,20,37,64,-27,30
Cowdenbeath,1269,10,4,11,21,23,54,-31,23
Peterhead,1270,1,24,4,8,79,39,40,76
Montrose,1270,2,23,7,6,59,35,24,76
Stirling,1270,3,17,6,13,64,51,13,57
Clyde,1270,4,15,9,12,53,48,5,54
Stenhousem'r,1270,5,15,8,13,55,50,5,53
Elgin,1270,6,15,6,15,54,60,-6,51
Annan Athlet,1270,7,11,12,13,48,42,6,45
Berwick,1270,8,8,10,18,29,60,-31,34
Edinburgh Ci,1270,9,7,9,20,37,62,-25,30
Cowdenbeath,1270,10,4,11,21,24,55,-31,23
Montrose,1271,1,24,7,5,61,35,26,79
Peterhead,1271,2,24,4,8,78,38,40,76
Stirling,1271,3,17,6,13,65,51,14,57
Clyde,1271,4,15,9,12,52,48,4,54
Stenhousem'r,1271,5,15,8,13,55,51,4,53
Elgin,1271,6,14,6,16,54,62,-8,48
Annan Athlet,1271,7,12,11,13,48,41,7,47
Berwick,1271,8,8,10,18,29,59,-30,34
Edinburgh Ci,1271,9,7,9,20,36,61,-25,30
Cowdenbeath,1271,10,4,10,22,23,55,-32,22
Montrose,1272,1,24,7,5,62,35,27,79
Peterhead,1272,2,24,4,8,81,38,43,76
Stirling,1272,3,17,6,13,63,53,10,57
Clyde,1272,4,15,9,12,53,48,5,54
Stenhousem'r,1272,5,15,8,13,57,49,8,53
Elgin,1272,6,14,6,16,54,63,-9,48
Annan Athlet,1272,7,12,11,13,51,43,8,47
Berwick,1272,8,8,10,18,29,60,-31,34
Edinburgh Ci,1272,9,7,9,20,36,64,-28,30
Cowdenbeath,1272,10,4,10,22,25,58,-33,22
Peterhead,1273,1,24,4,8,83,39,44,76
Montrose,1273,2,23,7,6,59,35,24,76
Stirling,1273,3,16,7,13,62,53,9,55
Stenhousem'r,1273,4,15,9,12,57,48,9,54
Clyde,1273,5,15,9,12,53,48,5,54
Elgin,1273,6,15,6,15,54,60,-6,51
Annan Athlet,1273,7,11,12,13,48,42,6,45
Berwick,1273,8,8,10,18,29,60,-31,34
Edinburgh Ci,1273,9,7,9,20,37,66,-29,30
Cowdenbeath,1273,10,4,11,21,24,55,-31,23
Montrose,1274,1,23,7,6,61,37,24,76
Peterhead,1274,2,23,5,8,77,38,39,74
Stirling,1274,3,17,6,13,66,51,15,57
Clyde,1274,4,15,9,12,53,49,4,54
Stenhousem'r,1274,5,15,8,13,55,52,3,53
Elgin,1274,6,15,6,15,56,62,-6,51
Annan Athlet,1274,7,11,12,13,50,44,6,45
Berwick,1274,8,8,10,18,30,60,-30,34
Edinburgh Ci,1274,9,7,10,19,36,60,-24,31
Cowdenbeath,1274,10,4,11,21,26,57,-31,23
Montrose,1275,1,24,7,5,62,34,28,79
Peterhead,1275,2,24,4,8,80,39,41,76
Stirling,1275,3,17,6,13,61,51,10,57
Stenhousem'r,1275,4,15,8,13,55,47,8,53
Clyde,1275,5,14,9,13,51,49,2,51
Elgin,1275,6,14,6,16,53,63,-10,48
Annan Athlet,1275,7,11,12,13,47,41,6,45
Berwick,1275,8,9,10,17,30,58,-28,37
Edinburgh Ci,1275,9,7,9,20,37,63,-26,30
Cowdenbeath,1275,10,4,11,21,23,54,-31,23
Montrose,1276,1,24,7,5,64,35,29,79
Peterhead,1276,2,24,4,8,82,40,42,76
Stenhousem'r,1276,3,16,8,12,58,48,10,56
Stirling,1276,4,16,6,14,62,54,8,54
Clyde,1276,5,14,10,12,52,49,3,52
Elgin,1276,6,14,6,16,54,65,-11,48
Annan Athlet,1276,7,11,11,14,47,43,4,44
Berwick,1276,8,8,11,17,30,59,-29,35
Edinburgh Ci,1276,9,7,9,20,38,65,-27,30
Cowdenbeath,1276,10,5,10,21,25,54,-29,25
Montrose,1277,1,24,7,5,62,34,28,79
Peterhead,1277,2,24,4,8,80,38,42,76
Stirling,1277,3,16,7,13,61,52,9,55
Stenhousem'r,1277,4,15,9,12,56,47,9,54
Clyde,1277,5,14,10,12,51,48,3,52
Elgin,1277,6,14,6,16,53,63,-10,48
Annan Athlet,1277,7,11,12,13,48,42,6,45
Berwick,1277,8,8,11,17,29,58,-29,35
Edinburgh Ci,1277,9,7,9,20,36,63,-27,30
Cowdenbeath,1277,10,4,11,21,24,55,-31,23
Peterhead,1278,1,24,4,8,80,40,40,76
Montrose,1278,2,23,7,6,59,35,24,76
Stenhousem'r,1278,3,16,8,12,58,46,12,56
Stirling,1278,4,16,6,14,60,54,6,54
Clyde,1278,5,15,9,12,53,49,4,54
Elgin,1278,6,15,6,15,54,60,-6,51
Annan Athlet,1278,7,11,11,14,47,45,2,44
Berwick,1278,8,8,10,18,30,60,-30,34
Edinburgh Ci,1278,9,7,9,20,38,63,-25,30
Cowdenbeath,1278,10,5,10,21,27,54,-27,25
Peterhead,1279,1,24,4,8,82,38,44,76
Montrose,1279,2,23,7,6,59,35,24,76
Stirling,1279,3,17,6,13,63,51,12,57
Clyde,1279,4,15,9,12,55,49,6,54
Stenhousem'r,1279,5,15,8,13,55,49,6,53
Elgin,1279,6,15,6,15,54,60,-6,51
Annan Athlet,1279,7,11,11,14,47,43,4,44
Berwick,1279,8,8,10,18,30,62,-32,34
Edinburgh Ci,1279,9,7,9,20,36,65,-29,30
Cowdenbeath,1279,10,5,10,21,25,54,-29,25
Montrose,1280,1,24,7,5,62,35,27,79
Peterhead,1280,2,24,4,8,79,38,41,76
Stirling,1280,3,17,6,13,64,53,11,57
Clyde,1280,4,15,9,12,52,48,4,54
Stenhousem'r,1280,5,15,8,13,57,50,7,53
Elgin,1280,6,14,6,16,54,63,-9,48
Annan Athlet,1280,7,12,11,13,49,42,7,47
Berwick,1280,8,8,10,18,29,59,-30,34
Edinburgh Ci,1280,9,7,9,20,36,62,-26,30
Cowdenbeath,1280,10,4,10,22,24,56,-32,22
Montrose,1281,1,24,7,5,63,34,29,79
Peterhead,1281,2,24,4,8,81,40,41,76
Stenhousem'r,1281,3,16,8,12,57,46,11,56
Stirling,1281,4,16,6,14,60,53,7,54
Clyde,1281,5,14,9,13,51,50,1,51
Elgin,1281,6,14,6,16,53,64,-11,48
Annan Athlet,1281,7,12,11,13,49,42,7,47
Berwick,1281,8,9,10,17,31,58,-27,37
Edinburgh Ci,1281,9,7,9,20,38,64,-26,30
Cowdenbeath,1281,10,4,10,22,24,56,-32,22
Montrose,1282,1,23,8,5,61,36,25,77
Peterhead,1282,2,24,4,8,80,38,42,76
Stenhousem'r,1282,3,16,8,12,56,46,10,56
Stirling,1282,4,16,6,14,60,52,8,54
Clyde,1282,5,15,9,12,53,49,4,54
Elgin,1282,6,14,7,15,55,62,-7,49
Annan Athlet,1282,7,11,11,14,47,42,5,44
Berwick,1282,8,8,10,18,30,60,-30,34
Edinburgh Ci,1282,9,7,9,20,36,63,-27,30
Cowdenbeath,1282,10,5,10,21,24,54,-30,25
Montrose,1283,1,24,7,5,61,35,26,79
Peterhead,1283,2,23,5,8,78,39,39,74
Stirling,1283,3,17,6,13,61,51,10,57
Clyde,1283,4,15,9,12,52,48,4,54
Stenhousem'r,1283,5,15,8,13,55,47,8,53
Elgin,1283,6,14,6,16,54,62,-8,48
Annan Athlet,1283,7,11,12,13,47,41,6,45
Berwick,1283,8,8,10,18,29,59,-30,34
Edinburgh Ci,1283,9,7,10,19,37,61,-24,31
Cowdenbeath,1283,10,4,11,21,23,54,-31,23
Montrose,1284,1,24,7,5,61,35,26,79
Peterhead,1284,2,24,4,8,79,38,41,76
Stirling,1284,3,17,6,13,63,51,12,57
Clyde,1284,4,15,9,12,54,48,6,54
Stenhousem'r,1284,5,15,8,13,55,49,6,53
Elgin,1284,6,14,6,16,54,62,-8,48
Annan Athlet,1284,7,11,12,13,49,43,6,45
Berwick,1284,8,8,10,18,29,61,-32,34
Edinburgh Ci,1284,9,7,9,20,36,62,-26,30
Cowdenbeath,1284,10,4,11,21,25,56,-31,23
Montrose,1285,1,24,7,5,62,34,28,79
Peterhead,1285,2,24,4,8,79,38,41,76
Stirling,1285,3,17,6,13,63,52,11,57
Clyde,1285,4,15,9,12,54,49,5,54
Stenhousem'r,1285,5,15,8,13,56,49,7,53
Elgin,1285,6,14,6,16,53,63,-10,48
Annan Athlet,1285,7,11,11,14,48,43,5,44
Berwick,1285,8,8,10,18,30,61,-31,34
Edinburgh Ci,1285,9,7,9,20,36,62,-26,30
Cowdenbeath,1285,10,5,10,21,25,55,-30,25
Montrose,1286,1,24,7,5,60,34,26,79
Peterhead,1286,2,24,4,8,80,39,41,76
Stirling,1286,3,16,7,13,61,52,9,55
Stenhousem'r,1286,4,15,9,12,56,47,9,54
Clyde,1286,5,14,9,13,51,49,2,51
Elgin,1286,6,14,6,16,53,61,-8,48
Annan Athlet,1286,7,12,11,13,49,41,8,47
Berwick,1286,8,9,10,17,30,58,-28,37
Edinburgh Ci,1286,9,7,9,20,37,63,-26,30
Cowdenbeath,1286,10,4,10,22,23,56,-33,22
Montrose,1287,1,24,7,5,63,36,27,79
Peterhead,1287,2,24,4,8,78,38,40,76
Stirling,1287,3,17,6,13,64,51,13,57
Clyde,1287,4,15,9,12,53,48,5,54
Stenhousem'r,1287,5,15,8,13,55,50,5,53
Elgin,1287,6,14,6,16,55,64,-9,48
Annan Athlet,1287,7,11,11,14,47,44,3,44
Berwick,1287,8,8,10,18,29,60,-31,34
Edinburgh Ci,1287,9,7,9,20,36,61,-25,30
Cowdenbeath,1287,10,5,10,21,26,54,-28,25
Montrose,1288,1,24,7,5,60,34,26,79
Peterhead,1288,2,23,5,8,77,38,39,74
Stirling,1288,3,16,7,13,61,52,9,55
Stenhousem'r,1288,4,15,9,12,56,47,9,54
Clyde,1288,5,14,10,12,52,49,3,52
Elgin,1288,6,14,6,16,53,61,-8,48
Annan Athlet,1288,7,11,12,13,47,41,6,45
Berwick,1288,8,8,11,17,30,59,-29,35
Edinburgh Ci,1288,9,7,10,19,36,60,-24,31
Cowdenbeath,1288,10,4,11,21,23,54,-31,23
Peterhead,1289,1,24,4,8,81,38,43,76
Montrose,1289,2,23,7,6,59,36,23,76
Stirling,1289,3,17,6,13,61,51,10,57
Stenhousem'r,1289,4,15,8,13,55,47,8,53
Clyde,1289,5,14,10,12,53,50,3,52
Elgin,1289,6,15,6,15,55,60,-5,51
Annan Athlet,1289,7,12,11,13,48,41,7,47
Berwick,1289,8,8,11,17,31,60,-29,35
Edinburgh Ci,1289,9,7,9,20,36,64,-28,30
Cowdenbeath,1289,10,4,10,22,23,55,-32,22
Montrose,1290,1,24,7,5,62,35,27,79
Peterhead,1290,2,24,4,8,78,38,40,76
Stirling,1290,3,17,6,13,64,51,13,57
Stenhousem'r,1290,4,15,8,13,55,50,5,53
Clyde,1290,5,14,10,12,52,49,3,52
Elgin,1290,6,14,6,16,54,63,-9,48
Annan Athlet,1290,7,11,11,14,47,42,5,44
Berwick,1290,8,8,11,17,30,59,-29,35
Edinburgh Ci,1290,9,7,9,20,36,61,-25,30
Cowdenbeath,1290,10,5,10,21,24,54,-30,25
Montrose,1291,1,24,7,5,61,34,27,79
Peterhead,1291,2,23,5,8,78,39,39,74
Stirling,1291,3,17,6,13,64,52,12,57
Clyde,1291,4,15,9,12,53,48,5,54
Stenhousem'r,1291,5,15,8,13,56,50,6,53
Elgin,1291,6,14,6,16,53,62,-9,48
Annan Athlet,1291,7,11,12,13,48,42,6,45
Berwick,1291,8,8,10,18,29,60,-31,34
Edinburgh Ci,1291,9,7,10,19,37,61,-24,31
Cowdenbeath,1291,10,4,11,21,24,55,-31,23
Montrose,1292,1,24,7,5,61,34,27,79
Peterhead,1292,2,24,4,8,79,38,41,76
Stirling,1292,3,17,6,13,62,52,10,57
Clyde,1292,4,15,9,12,54,49,5,54
Stenhousem'r,1292,5,15,8,13,56,48,8,53
Elgin,1292,6,14,6,16,53,62,-9,48
Annan Athlet,1292,7,11,11,14,48,43,5,44
Berwick,1292,8,8,10,18,30,61,-31,34
Edinburgh Ci,1292,9,7,9,20,36,62,-26,30
Cowdenbeath,1292,10,5,10,21,25,55,-30,25
Montrose,1293,1,23,8,5,60,35,25,77
Peterhead,1293,2,24,4,8,80,39,41,76
Stirling,1293,3,16,7,13,62,53,9,55
Stenhousem'r,1293,4,15,9,12,57,48,9,54
Clyde,1293,5,14,9,13,53,51,2,51
Elgin,1293,6,14,7,15,54,61,-7,49
Annan Athlet,1293,7,11,11,14,47,43,4,44
Berwick,1293,8,9,10,17,32,60,-28,37
Edinburgh Ci,1293,9,7,9,20,37,63,-26,30
Cowdenbeath,1293,10,5,10,21,25,54,-29,25
Montrose,1294,1,23,8,5,61,36,25,77
Peterhead,1294,2,23,4,9,78,40,38,73
Stirling,1294,3,16,7,13,61,52,9,55
Stenhousem'r,1294,4,15,9,12,56,47,9,54
Clyde,1294,5,15,9,12,53,49,4,54
Elgin,1294,6,14,7,15,55,62,-7,49
Annan Athlet,1294,7,11,11,14,47,42,5,44
Berwick,1294,8,8,10,18,30,60,-30,34
Edinburgh Ci,1294,9,8,9,19,38,61,-23,33
Cowdenbeath,1294,10,5,10,21,24,54,-30,25
Peterhead,1295,1,24,4,8,84,38,46,76
Montrose,1295,2,23,7,6,61,37,24,76
Stirling,1295,3,16,7,13,60,51,9,55
Stenhousem'r,1295,4,15,9,12,55,46,9,54
Clyde,1295,5,15,9,12,52,48,4,54
Elgin,1295,6,15,6,15,56,62,-6,51
Annan Athlet,1295,7,11,11,14,48,43,5,44
Berwick,1295,8,8,10,18,29,59,-30,34
Edinburgh Ci,1295,9,7,9,20,36,67,-31,30
Cowdenbeath,1295,10,5,10,21,25,55,-30,25
Montrose,1296,1,23,8,5,59,34,25,77
Peterhead,1296,2,24,4,8,81,39,42,76
Stirling,1296,3,17,6,13,63,53,10,57
Stenhousem'r,1296,4,15,8,13,57,49,8,53
Clyde,1296,5,14,10,12,52,49,3,52
Elgin,1296,6,14,7,15,53,60,-7,49
Annan Athlet,1296,7,11,11,14,47,44,3,44
Berwick,1296,8,8,11,17,30,59,-29,35
Edinburgh Ci,1296,9,7,9,20,37,64,-27,30
Cowdenbeath,1296,10,5,10,21,26,54,-28,25
Peterhead,1297,1,24,4,8,80,39,41,76
Montrose,1297,2,23,7,6,59,36,23,76
Stirling,1297,3,17,6,13,61,51,10,57
Clyde,1297,4,15,9,12,54,50,4,54
Stenhousem'r,1297,5,15,8,13,55,47,8,53
Elgin,1297,6,15,6,15,55,60,-5,51
Annan Athlet,1297,7,11,11,14,49,44,5,44
Berwick,1297,8,8,10,18,31,61,-30,34
Edinburgh Ci,1297,9,7,9,20,37,63,-26,30
Cowdenbeath,1297,10,5,10,21,26,56,-30,25
Peterhead,1298,1,24,4,8,80,40,40,76
Montrose,1298,2,23,7,6,61,37,24,76
Stirling,1298,3,17,6,13,64,52,12,57
Stenhousem'r,1298,4,15,8,13,56,50,6,53
Clyde,1298,5,14,9,13,51,49,2,51
Elgin,1298,6,15,6,15,56,62,-6,51
Annan Athlet,1298,7,12,11,13,49,41,8,47
Berwick,1298,8,9,10,17,30,58,-28,37
Edinburgh Ci,1298,9,7,9,20,38,63,-25,30
Cowdenbeath,1298,10,4,10,22,23,56,-33,22
Peterhead,1299,1,24,4,8,80,38,42,76
Montrose,1299,2,23,7,6,59,35,24,76
Stirling,1299,3,17,6,13,64,51,13,57
Stenhousem'r,1299,4,15,8,13,55,50,5,53
Clyde,1299,5,14,9,13,53,51,2,51
Elgin,1299,6,15,6,15,54,60,-6,51
Annan Athlet,1299,7,11,12,13,47,41,6,45
Berwick,1299,8,9,10,17,32,60,-28,37
Edinburgh Ci,1299,9,7,9,20,36,63,-27,30
Cowdenbeath,1299,10,4,11,21,23,54,-31,23
Montrose,1300,1,23,8,5,60,35,25,77
Peterhead,1300,2,24,4,8,79,39,40,76
Stirling,1300,3,17,6,13,62,51,11,57
Clyde,1300,4,15,9,12,53,49,4,54
Stenhousem'r,1300,5,15,8,13,55,48,7,53
Elgin,1300,6,14,7,15,54,61,-7,49
Annan Athlet,1300,7,11,12,13,48,42,6,45
Berwick,1300,8,8,10,18,30,60,-30,34
Edinburgh Ci,1300,9,7,9,20,37,62,-25,30
Cowdenbeath,1300,10,4,11,21,24,55,-31,23
Montrose,1301,1,24,7,5,61,35,26,79
Peterhead,1301,2,24,4,8,79,38,41,76
Stenhousem'r,1301,3,16,8,12,57,46,11,56
Stirling,1301,4,16,6,14,60,53,7,54
Clyde,1301,5,14,10,12,53,50,3,52
Elgin,1301,6,14,6,16,54,62,-8,48
Annan Athlet,1301,7,12,11,13,48,41,7,47
Berwick,1301,8,8,11,17,31,60,-29,35
Edinburgh Ci,1301,9,7,9,20,36,62,-26,30
Cowdenbeath,1301,10,4,10,22,23,55,-32,22
Peterhead,1302,1,24,4,8,80,39,41,76
Montrose,1302,2,23,7,6,59,35,24,76
Stirling,1302,3,16,7,13,60,51,9,55
Stenhousem'r,1302,4,15,9,12,55,46,9,54
Clyde,1302,5,14,10,12,53,50,3,52
Elgin,1302,6,15,6,15,54,60,-6,51
Annan Athlet,1302,7,12,11,13,48,41,7,47
Berwick,1302,8,8,11,17,31,60,-29,35
Edinburgh Ci,1302,9,7,9,20,37,63,-26,30
Cowdenbeath,1302,10,4,10,22,23,55,-32,22
Montrose,1303,1,24,7,5,61,34,27,79
Peterhead,1303,2,24,4,8,80,38,42,76
Stirling,1303,3,16,7,13,61,52,9,55
Stenhousem'r,1303,4,15,9,12,56,47,9,54
Clyde,1303,5,15,9,12,54,48,6,54
Elgin,1303,6,14,6,16,53,62,-9,48
Annan Athlet,1303,7,11,11,14,48,43,5,44
Berwick,1303,8,8,10,18,29,61,-32,34
Edinburgh Ci,1303,9,7,9,20,36,63,-27,30
Cowdenbeath,1303,10,5,10,21,25,55,-30,25
Montrose,1304,1,24,7,5,61,34,27,79
Peterhead,1304,2,23,4,9,81,43,38,73
Stenhousem'r,1304,3,16,8,12,61,50,11,56
Stirling,1304,4,16,6,14,64,57,7,54
Clyde,1304,5,14,9,13,51,49,2,51
Elgin,1304,6,14,6,16,53,62,-9,48
Annan Athlet,1304,7,11,12,13,47,41,6,45
Berwick,1304,8,9,10,17,30,58,-28,37
Edinburgh Ci,1304,9,8,9,19,41,64,-23,33
Cowdenbeath,1304,10,4,11,21,23,54,-31,23
Peterhead,1305,1,24,4,8,79,38,41,76
Montrose,1305,2,23,7,6,60,36,24,76
Stenhousem'r,1305,3,16,8,12,57,47,10,56
Stirling,1305,4,16,6,14,61,53,8,54
Clyde,1305,5,15,9,12,54,49,5,54
Elgin,1305,6,15,6,15,55,61,-6,51
Annan Athlet,1305,7,12,11,13,48,41,7,47
Berwick,1305,8,8,10,18,30,61,-31,34
Edinburgh Ci,1305,9,7,9,20,36,62,-26,30
Cowdenbeath,1305,10,4,10,22,23,55,-32,22
Montrose,1306,1,24,7,5,62,35,27,79
Peterhead,1306,2,24,4,8,79,39,40,76
Stenhousem'r,1306,3,16,8,12,57,46,11,56
Stirling,1306,4,16,6,14,60,53,7,54
Clyde,1306,5,15,9,12,55,49,6,54
Elgin,1306,6,14,6,16,54,63,-9,48
Annan Athlet,1306,7,11,11,14,48,43,5,44
Berwick,1306,8,8,10,18,30,62,-32,34
Edinburgh Ci,1306,9,7,9,20,37,62,-25,30
Cowdenbeath,1306,10,5,10,21,25,55,-30,25
Montrose,1307,1,23,8,5,61,36,25,77
Peterhead,1307,2,23,5,8,77,38,39,74
Stirling,1307,3,17,6,13,63,53,10,57
Clyde,1307,4,15,9,12,52,48,4,54
Stenhousem'r,1307,5,15,8,13,57,49,8,53
Elgin,1307,6,14,7,15,55,62,-7,49
Annan Athlet,1307,7,11,11,14,47,42,5,44
Berwick,1307,8,8,10,18,29,59,-30,34
Edinburgh Ci,1307,9,7,10,19,36,60,-24,31
Cowdenbeath,1307,10,5,10,21,24,54,-30,25
Peterhead,1308,1,24,4,8,82,38,44,76
Montrose,1308,2,23,7,6,59,36,23,76
Stirling,1308,3,17,6,13,63,52,11,57
Stenhousem'r,1308,4,15,8,13,56,49,7,53
Clyde,1308,5,14,10,12,54,51,3,52
Elgin,1308,6,15,6,15,55,60,-5,51
Annan Athlet,1308,7,12,11,13,51,42,9,47
Berwick,1308,8,8,11,17,32,61,-29,35
Edinburgh Ci,1308,9,7,9,20,36,65,-29,30
Cowdenbeath,1308,10,4,10,22,24,58,-34,22
Peterhead,1309,1,24,4,8,82,39,43,76
Montrose,1309,2,23,7,6,59,36,23,76
Stenhousem'r,1309,3,16,8,12,58,48,10,56
Stirling,1309,4,16,6,14,62,54,8,54
Clyde,1309,5,14,10,12,51,48,3,52
Elgin,1309,6,15,6,15,55,60,-5,51
Annan Athlet,1309,7,11,11,14,48,43,5,44
Berwick,1309,8,8,11,17,29,58,-29,35
Edinburgh Ci,1309,9,7,9,20,37,65,-28,30
Cowdenbeath,1309,10,5,10,21,25,55,-30,25
Montrose,1310,1,23,7,6,60,36,24,76
Peterhead,1310,2,23,5,8,79,40,39,74
Stirling,1310,3,16,7,13,63,54,9,55
Stenhousem'r,1310,4,15,9,12,58,49,9,54
Clyde,1310,5,15,9,12,52,48,4,54
Elgin,1310,6,15,6,15,55,61,-6,51
Annan Athlet,1310,7,11,12,13,47,41,6,45
Berwick,1310,8,8,10,18,29,59,-30,34
Edinburgh Ci,1310,9,7,10,19,38,62,-24,31
Cowdenbeath,1310,10,4,11,21,23,54,-31,23
Montrose,1311,1,24,7,5,60,34,26,79
Peterhead,1311,2,24,4,8,81,40,41,76
Stenhousem'r,1311,3,16,8,12,58,48,10,56
Stirling,1311,4,16,6,14,62,54,8,54
Clyde,1311,5,15,9,12,54,50,4,54
Elgin,1311,6,14,6,16,53,61,-8,48
Annan Athlet,1311,7,11,11,14,47,42,5,44
Berwick,1311,8,8,10,18,31,61,-30,34
Edinburgh Ci,1311,9,7,9,20,38,64,-26,30
Cowdenbeath,1311,10,5,10,21,24,54,-30,25
Montrose,1312,1,24,7,5,63,37,26,79
Peterhead,1312,2,23,5,8,78,39,39,74
Stirling,1312,3,17,6,13,63,53,10,57
Stenhousem'r,1312,4,15,8,13,57,49,8,53
Clyde,1312,5,14,10,12,53,50,3,52
Elgin,1312,6,14,6,16,56,64,-8,48
Annan Athlet,1312,7,11,12,13,48,42,6,45
Berwick,1312,8,8,11,17,31,60,-29,35
Edinburgh Ci,1312,9,7,10,19,37,61,-24,31
Cowdenbeath,1312,10,4,11,21,24,55,-31,23
Montrose,1313,1,24,7,5,60,34,26,79
Peterhead,1313,2,24,4,8,79,39,40,76
Stenhousem'r,1313,3,16,8,12,57,47,10,56
Stirling,1313,4,16,6,14,61,53,8,54
Clyde,1313,5,14,9,13,51,49,2,51
Elgin,1313,6,14,6,16,53,61,-8,48
Annan Athlet,1313,7,11,11,14,48,43,5,44
Berwick,1313,8,9,10,17,30,58,-28,37
Edinburgh Ci,1313,9,7,9,20,37,62,-25,30
Cowdenbeath,1313,10,5,10,21,25,55,-30,25
Montrose,1314,1,24,7,5,62,34,28,79
Peterhead,1314,2,24,4,8,80,38,42,76
Stirling,1314,3,17,6,13,63,53,10,57
Clyde,1314,4,15,9,12,55,49,6,54
Stenhousem'r,1314,5,15,8,13,57,49,8,53
Elgin,1314,6,14,6,16,53,63,-10,48
Annan Athlet,1314,7,11,11,14,47,43,4,44
Berwick,1314,8,8,10,18,30,62,-32,34
Edinburgh Ci,1314,9,7,9,20,36,63,-27,30
Cowdenbeath,1314,10,5,10,21,25,54,-29,25
Montrose,1315,1,24,7,5,64,34,30,79
Peterhead,1315,2,24,4,8,80,38,42,76
Stenhousem'r,1315,3,16,8,12,57,47,10,56
Stirling,1315,4,16,6,14,61,53,8,54
Clyde,1315,5,15,9,12,54,49,5,54
Elgin,1315,6,14,6,16,53,65,-12,48
Annan Athlet,1315,7,11,12,13,48,42,6,45
Berwick,1315,8,8,10,18,30,61,-31,34
Edinburgh Ci,1315,9,7,9,20,36,63,-27,30
Cowdenbeath,1315,10,4,11,21,24,55,-31,23
Montrose,1316,1,24,7,5,61,34,27,79
Peterhead,1316,2,24,4,8,79,38,41,76
Stirling,1316,3,17,6,13,63,52,11,57
Clyde,1316,4,15,9,12,52,48,4,54
Stenhousem'r,1316,5,15,8,13,56,49,7,53
Elgin,1316,6,14,6,16,53,62,-9,48
Annan Athlet,1316,7,11,12,13,47,41,6,45
Berwick,1316,8,8,10,18,29,59,-30,34
Edinburgh Ci,1316,9,7,9,20,36,62,-26,30
Cowdenbeath,1316,10,4,11,21,23,54,-31,23
Montrose,1317,1,23,8,5,60,35,25,77
Peterhead,1317,2,23,4,9,77,39,38,73
Stenhousem'r,1317,3,16,8,12,57,46,11,56
Stirling,1317,4,16,6,14,60,53,7,54
Clyde,1317,5,15,9,12,53,49,4,54
Elgin,1317,6,14,7,15,54,61,-7,49
Annan Athlet,1317,7,12,11,13,50,42,8,47
Berwick,1317,8,8,10,18,30,60,-30,34
Edinburgh Ci,1317,9,8,9,19,37,60,-23,33
Cowdenbeath,1317,10,4,10,22,24,57,-33,22
Montrose,1318,1,24,7,5,65,35,30,79
Peterhead,1318,2,24,4,8,78,38,40,76
Stirling,1318,3,17,6,13,62,51,11,57
Clyde,1318,4,15,9,12,53,48,5,54
Stenhousem'r,1318,5,15,8,13,55,48,7,53
Elgin,1318,6,14,6,16,54,66,-12,48
Annan Athlet,1318,7,11,11,14,47,42,5,44
Berwick,1318,8,8,10,18,29,60,-31,34
Edinburgh Ci,1318,9,7,9,20,36,61,-25,30
Cowdenbeath,1318,10,5,10,21,24,54,-30,25
Montrose,1319,1,24,7,5,61,35,26,79
Peterhead,1319,2,24,4,8,82,39,43,76
Stirling,1319,3,17,6,13,62,52,10,57
Stenhousem'r,1319,4,15,8,13,56,48,8,53
Clyde,1319,5,14,10,12,52,49,3,52
Elgin,1319,6,14,6,16,54,62,-8,48
Annan Athlet,1319,7,12,11,13,48,41,7,47
Berwick,1319,8,8,11,17,30,59,-29,35
Edinburgh Ci,1319,9,7,9,20,37,65,-28,30
Cowdenbeath,1319,10,4,10,22,23,55,-32,22
Peterhead,1320,1,24,4,8,79,38,41,76
Montrose,1320,2,23,7,6,61,37,24,76
Stirling,1320,3,17,6,13,61,51,10,57
Clyde,1320,4,15,9,12,52,48,4,54
Stenhousem'r,1320,5,15,8,13,55,47,8,53
Elgin,1320,6,15,6,15,56,62,-6,51
Annan Athlet,1320,7,12,11,13,48,41,7,47
Berwick,1320,8,8,10,18,29,59,-30,34
Edinburgh Ci,1320,9,7,9,20,36,62,-26,30
Cowdenbeath,1320,10,4,10,22,23,55,-32,22
Montrose,1321,1,24,7,5,61,35,26,79
Peterhead,1321,2,24,4,8,81,39,42,76
Stenhousem'r,1321,3,16,8,12,57,47,10,56
Stirling,1321,4,16,6,14,61,53,8,54
Clyde,1321,5,15,9,12,53,49,4,54
Elgin,1321,6,14,6,16,54,62,-8,48
Annan Athlet,1321,7,11,11,14,48,44,4,44
Berwick,1321,8,8,10,18,30,60,-30,34
Edinburgh Ci,1321,9,7,9,20,37,64,-27,30
Cowdenbeath,1321,10,5,10,21,26,55,-29,25
Montrose,1322,1,24,7,5,62,34,28,79
Peterhead,1322,2,24,4,8,79,38,41,76
Stirling,1322,3,16,7,13,62,53,9,55
Stenhousem'r,1322,4,15,9,12,57,48,9,54
Clyde,1322,5,14,10,12,51,48,3,52
Elgin,1322,6,14,6,16,53,63,-10,48
Annan Athlet,1322,7,12,11,13,48,41,7,47
Berwick,1322,8,8,11,17,29,58,-29,35
Edinburgh Ci,1322,9,7,9,20,36,62,-26,30
Cowdenbeath,1322,10,4,10,22,23,55,-32,22
Montrose,1323,1,24,7,5,62,36,26,79
Peterhead,1323,2,24,4,8,79,39,40,76
Stenhousem'r,1323,3,16,8,12,59,48,11,56
Stirling,1323,4,16,6,14,62,55,7,54
Clyde,1323,5,15,9,12,53,49,4,54
Elgin,1323,6,14,6,16,55,63,-8,48
Annan Athlet,1323,7,11,12,13,49,43,6,45
Berwick,1323,8,8,10,18,30,60,-30,34
Edinburgh Ci,1323,9,7,9,20,37,62,-25,30
Cowdenbeath,1323,10,4,11,21,25,56,-31,23
Montrose,1324,1,24,7,5,63,35,28,79
Peterhead,1324,2,24,4,8,81,39,42,76
Stirling,1324,3,17,6,13,62,51,11,57
Stenhousem'r,1324,4,15,8,13,55,48,7,53
Clyde,1324,5,14,10,12,53,50,3,52
Elgin,1324,6,14,6,16,54,64,-10,48
Annan Athlet,1324,7,12,11,13,49,42,7,47
Berwick,1324,8,8,11,17,31,60,-29,35
Edinburgh Ci,1324,9,7,9,20,37,64,-27,30
Cowdenbeath,1324,10,4,10,22,24,56,-32,22
Peterhead,1325,1,24,4,8,80,39,41,76
Montrose,1325,2,23,7,6,59,35,24,76
Stirling,1325,3,17,6,13,62,51,11,57
Clyde,1325,4,15,9,12,53,48,5,54
Stenhousem'r,1325,5,15,8,13,55,48,7,53
Elgin,1325,6,15,6,15,54,60,-6,51
Annan Athlet,1325,7,11,12,13,47,41,6,45
Berwick,1325,8,8,10,18,29,60,-31,34
Edinburgh Ci,1325,9,7,9,20,37,63,-26,30
Cowdenbeath,1325,10,4,11,21,23,54,-31,23
Montrose,1326,1,24,7,5,62,35,27,79
Peterhead,1326,2,24,4,8,79,38,41,76
Stenhousem'r,1326,3,16,8,12,59,49,10,56
Stirling,1326,4,16,6,14,63,55,8,54
Clyde,1326,5,15,9,12,53,49,4,54
Elgin,1326,6,14,6,16,54,63,-9,48
Annan Athlet,1326,7,12,11,13,49,42,7,47
Berwick,1326,8,8,10,18,30,60,-30,34
Edinburgh Ci,1326,9,7,9,20,36,62,-26,30
Cowdenbeath,1326,10,4,10,22,24,56,-32,22
Montrose,1327,1,23,8,5,61,36,25,77
Peterhead,1327,2,24,4,8,80,38,42,76
Stirling,1327,3,16,7,13,61,52,9,55
Stenhousem'r,1327,4,15,9,12,56,47,9,54
Clyde,1327,5,15,9,12,52,48,4,54
Elgin,1327,6,14,7,15,55,62,-7,49
Annan Athlet,1327,7,11,12,13,47,41,6,45
Berwick,1327,8,8,10,18,29,59,-30,34
Edinburgh Ci,1327,9,7,9,20,36,63,-27,30
Cowdenbeath,1327,10,4,11,21,23,54,-31,23
Montrose,1328,1,23,8,5,61,36,25,77
Peterhead,1328,2,24,4,8,85,39,46,76
Stirling,1328,3,16,7,13,60,51,9,55
Stenhousem'r,1328,4,15,9,12,55,46,9,54
Clyde,1328,5,15,9,12,53,49,4,54
Elgin,1328,6,14,7,15,55,62,-7,49
Annan Athlet,1328,7,11,11,14,47,42,5,44
Berwick,1328,8,8,10,18,30,60,-30,34
Edinburgh Ci,1328,9,7,9,20,37,68,-31,30
Cowdenbeath,1328,10,5,10,21,24,54,-30,25
Montrose,1329,1,24,7,5,66,35,31,79
Peterhead,1329,2,24,4,8,81,38,43,76
Stirling,1329,3,16,7,13,60,51,9,55
Stenhousem'r,1329,4,15,9,12,55,46,9,54
Clyde,1329,5,15,9,12,52,48,4,54
Elgin,1329,6,14,6,16,54,67,-13,48
Annan Athlet,1329,7,11,12,13,48,42,6,45
Berwick,1329,8,8,10,18,29,59,-30,34
Edinburgh Ci,1329,9,7,9,20,36,64,-28,30
Cowdenbeath,1329,10,4,11,21,24,55,-31,23
Montrose,1330,1,23,7,6,60,36,24,76
Peterhead,1330,2,23,5,8,80,41,39,74
Stirling,1330,3,17,6,13,64,51,13,57
Clyde,1330,4,15,9,12,53,48,5,54
Stenhousem'r,1330,5,15,8,13,55,50,5,53
Elgin,1330,6,15,6,15,55,61,-6,51
Annan Athlet,1330,7,11,11,14,48,43,5,44
Berwick,1330,8,8,10,18,29,60,-31,34
Edinburgh Ci,1330,9,7,10,19,39,63,-24,31
Cowdenbeath,1330,10,5,10,21,25,55,-30,25
Montrose,1331,1,23,8,5,60,35,25,77
Peterhead,1331,2,24,4,8,81,40,41,76
Stirling,1331,3,17,6,13,61,51,10,57
Stenhousem'r,1331,4,15,8,13,55,47,8,53
Clyde,1331,5,14,10,12,52,49,3,52
Elgin,1331,6,14,7,15,54,61,-7,49
Annan Athlet,1331,7,11,12,13,47,41,6,45
Berwick,1331,8,8,11,17,30,59,-29,35
Edinburgh Ci,1331,9,7,9,20,38,64,-26,30
Cowdenbeath,1331,10,4,11,21,23,54,-31,23
Montrose,1332,1,23,8,5,60,35,25,77
Peterhead,1332,2,24,4,8,81,39,42,76
Stirling,1332,3,17,6,13,64,51,13,57
Clyde,1332,4,15,9,12,53,48,5,54
Stenhousem'r,1332,5,15,8,13,55,50,5,53
Elgin,1332,6,14,7,15,54,61,-7,49
Annan Athlet,1332,7,11,11,14,48,44,4,44
Berwick,1332,8,8,10,18,29,60,-31,34
Edinburgh Ci,1332,9,7,9,20,37,64,-27,30
Cowdenbeath,1332,10,5,10,21,26,55,-29,25
Montrose,1333,1,24,7,5,60,34,26,79
Peterhead,1333,2,24,4,8,80,40,40,76
Stirling,1333,3,17,6,13,63,51,12,57
Clyde,1333,4,15,9,12,52,48,4,54
Stenhousem'r,1333,5,15,8,13,55,49,6,53
Elgin,1333,6,14,6,16,53,61,-8,48
Annan Athlet,1333,7,11,11,14,48,44,4,44
Berwick,1333,8,8,10,18,29,59,-30,34
Edinburgh Ci,1333,9,7,9,20,38,63,-25,30
Cowdenbeath,1333,10,5,10,21,26,55,-29,25
Montrose,1334,1,23,8,5,61,36,25,77
Peterhead,1334,2,24,4,8,79,39,40,76
Stirling,1334,3,17,6,13,62,51,11,57
Clyde,1334,4,15,9,12,55,48,7,54
Stenhousem'r,1334,5,15,8,13,55,48,7,53
Elgin,1334,6,14,7,15,55,62,-7,49
Annan Athlet,1334,7,11,11,14,49,44,5,44
Berwick,1334,8,8,10,18,29,62,-33,34
Edinburgh Ci,1334,9,7,9,20,37,62,-25,30
Cowdenbeath,1334,10,5,10,21,26,56,-30,25
Montrose,1335,1,24,7,5,61,35,26,79
Peterhead,1335,2,24,4,8,78,38,40,76
Stenhousem'r,1335,3,16,8,12,57,46,11,56
Stirling,1335,4,16,6,14,60,53,7,54
Clyde,1335,5,15,9,12,53,48,5,54
Elgin,1335,6,14,6,16,54,62,-8,48
Annan Athlet,1335,7,12,11,13,50,41,9,47
Berwick,1335,8,8,10,18,29,60,-31,34
Edinburgh Ci,1335,9,7,9,20,36,61,-25,30
Cowdenbeath,1335,10,4,10,22,23,57,-34,22
Montrose,1336,1,23,8,5,61,36,25,77
Peterhead,1336,2,24,4,8,80,39,41,76
Stirling,1336,3,17,6,13,62,52,10,57
Clyde,1336,4,15,9,12,54,48,6,54
Stenhousem'r,1336,5,15,8,13,56,48,8,53
Elgin,1336,6,14,7,15,55,62,-7,49
Annan Athlet,1336,7,11,11,14,49,46,3,44
Berwick,1336,8,8,10,18,29,61,-32,34
Edinburgh Ci,1336,9,7,9,20,37,63,-26,30
Cowdenbeath,1336,10,5,10,21,28,56,-28,25
Peterhead,1337,1,24,4,8,79,38,41,76
Montrose,1337,2,23,7,6,59,35,24,76
Stirling,1337,3,16,7,13,62,53,9,55
Stenhousem'r,1337,4,15,9,12,57,48,9,54
Clyde,1337,5,14,10,12,51,48,3,52
Elgin,1337,6,15,6,15,54,60,-6,51
Annan Athlet,1337,7,12,11,13,50,42,8,47
Berwick,1337,8,8,11,17,29,58,-29,35
Edinburgh Ci,1337,9,7,9,20,36,62,-26,30
Cowdenbeath,1337,10,4,10,22,24,57,-33,22
Montrose,1338,1,24,7,5,61,35,26,79
Peterhead,1338,2,23,5,8,79,40,39,74
Stirling,1338,3,17,6,13,65,53,12,57
Clyde,1338,4,15,9,12,57,50,7,54
Stenhousem'r,1338,5,15,8,13,57,51,6,53
Elgin,1338,6,14,6,16,54,62,-8,48
Annan Athlet,1338,7,11,11,14,47,43,4,44
Berwick,1338,8,8,10,18,31,64,-33,34
Edinburgh Ci,1338,9,7,10,19,38,62,-24,31
Cowdenbeath,1338,10,5,10,21,25,54,-29,25
Montrose,1339,1,23,8,5,62,37,25,77
Peterhead,1339,2,23,4,9,77,39,38,73
Stirling,1339,3,17,6,13,62,51,11,57
Stenhousem'r,1339,4,15,8,13,55,48,7,53
Clyde,1339,5,14,9,13,51,50,1,51
Elgin,1339,6,14,7,15,56,63,-7,49
Annan Athlet,1339,7,11,12,13,47,41,6,45
Berwick,1339,8,9,10,17,31,58,-27,37
Edinburgh Ci,1339,9,8,9,19,37,60,-23,33
Cowdenbeath,1339,10,4,11,21,23,54,-31,23
Montrose,1340,1,24,7,5,64,35,29,79
Peterhead,1340,2,24,4,8,81,39,42,76
Stenhousem'r,1340,3,16,8,12,60,48,12,56
Stirling,1340,4,16,6,14,62,56,6,54
Clyde,1340,5,15,9,12,52,48,4,54
Elgin,1340,6,14,6,16,54,65,-11,48
Annan Athlet,1340,7,12,11,13,48,41,7,47
Berwick,1340,8,8,10,18,29,59,-30,34
Edinburgh Ci,1340,9,7,9,20,37,64,-27,30
Cowdenbeath,1340,10,4,10,22,23,55,-32,22
Montrose,1341,1,24,7,5,61,35,26,79
Peterhead,1341,2,23,4,9,77,39,38,73
Stirling,1341,3,17,6,13,62,52,10,57
Stenhousem'r,1341,4,15,8,13,56,48,8,53
Clyde,1341,5,14,10,12,54,51,3,52
Elgin,1341,6,14,6,16,54,62,-8,48
Annan Athlet,1341,7,11,11,14,47,44,3,44
Berwick,1341,8,8,11,17,32,61,-29,35
Edinburgh Ci,1341,9,8,9,19,37,60,-23,33
Cowdenbeath,1341,10,5,10,21,26,54,-28,25
Montrose,1342,1,24,7,5,64,35,29,79
Peterhead,1342,2,24,4,8,79,38,41,76
Stenhousem'r,1342,3,16,8,12,58,47,11,56
Stirling,1342,4,16,6,14,61,54,7,54
Clyde,1342,5,14,10,12,52,49,3,52
Elgin,1342,6,14,6,16,54,65,-11,48
Annan Athlet,1342,7,12,11,13,53,43,10,47
Berwick,1342,8,8,11,17,30,59,-29,35
Edinburgh Ci,1342,9,7,9,20,36,62,-26,30
Cowdenbeath,1342,10,4,10,22,25,60,-35,22
Montrose,1343,1,24,7,5,60,34,26,79
Peterhead,1343,2,24,4,8,79,39,40,76
Stirling,1343,3,17,6,13,62,52,10,57
Clyde,1343,4,15,9,12,53,48,5,54
Stenhousem'r,1343,5,15,8,13,56,48,8,53
Elgin,1343,6,14,6,16,53,61,-8,48
Annan Athlet,1343,7,12,11,13,49,42,7,47
Berwick,1343,8,8,10,18,29,60,-31,34
Edinburgh Ci,1343,9,7,9,20,37,62,-25,30
Cowdenbeath,1343,10,4,10,22,24,56,-32,22
Montrose,1344,1,24,7,5,62,35,27,79
Peterhead,1344,2,24,4,8,81,38,43,76
Stenhousem'r,1344,3,16,8,12,57,46,11,56
Stirling,1344,4,16,6,14,60,53,7,54
Clyde,1344,5,15,9,12,53,49,4,54
Elgin,1344,6,14,6,16,54,63,-9,48
Annan Athlet,1344,7,12,11,13,49,41,8,47
Berwick,1344,8,8,10,18,30,60,-30,34
Edinburgh Ci,1344,9,7,9,20,36,64,-28,30
Cowdenbeath,1344,10,4,10,22,23,56,-33,22
Montrose,1345,1,23,7,6,59,35,24,76
Peterhead,1345,2,23,4,9,77,40,37,73
Stirling,1345,3,17,6,13,61,51,10,57
Stenhousem'r,1345,4,15,8,13,55,47,8,53
Clyde,1345,5,14,10,12,54,51,3,52
Elgin,1345,6,15,6,15,54,60,-6,51
Annan Athlet,1345,7,11,12,13,48,42,6,45
Berwick,1345,8,8,11,17,32,61,-29,35
Edinburgh Ci,1345,9,8,9,19,38,60,-22,33
Cowdenbeath,1345,10,4,11,21,24,55,-31,23
Montrose,1346,1,24,7,5,65,36,29,79
Peterhead,1346,2,23,5,8,77,38,39,74
Stirling,1346,3,17,6,13,62,51,11,57
Clyde,1346,4,15,9,12,52,48,4,54
Stenhousem'r,1346,5,15,8,13,55,48,7,53
Elgin,1346,6,14,6,16,55,66,-11,48
Annan Athlet,1346,7,12,11,13,48,41,7,47
Berwick,1346,8,8,10,18,29,59,-30,34
Edinburgh Ci,1346,9,7,10,19,36,60,-24,31
Cowdenbeath,1346,10,4,10,22,23,55,-32,22
Montrose,1347,1,24,7,5,62,35,27,79
Peterhead,1347,2,24,4,8,80,38,42,76
Stirling,1347,3,16,7,13,62,53,9,55
Stenhousem'r,1347,4,15,9,12,57,48,9,54
Clyde,1347,5,14,10,12,51,48,3,52
Elgin,1347,6,14,6,16,54,63,-9,48
Annan Athlet,1347,7,11,11,14,47,42,5,44
Berwick,1347,8,8,11,17,29,58,-29,35
Edinburgh Ci,1347,9,7,9,20,36,63,-27,30
Cowdenbeath,1347,10,5,10,21,24,54,-30,25
Montrose,1348,1,24,7,5,63,36,27,79
Peterhead,1348,2,23,5,8,78,39,39,74
Stenhousem'r,1348,3,16,8,12,57,46,11,56
Stirling,1348,4,16,6,14,60,53,7,54
Clyde,1348,5,15,9,12,53,48,5,54
Elgin,1348,6,14,6,16,55,64,-9,48
Annan Athlet,1348,7,12,11,13,49,42,7,47
Berwick,1348,8,8,10,18,29,60,-31,34
Edinburgh Ci,1348,9,7,10,19,37,61,-24,31
Cowdenbeath,1348,10,4,10,22,24,56,-32,22
Montrose,1349,1,23,8,5,61,36,25,77
Peterhead,1349,2,24,4,8,80,40,40,76
Stirling,1349,3,17,6,13,62,52,10,57
Clyde,1349,4,15,9,12,52,48,4,54
Stenhousem'r,1349,5,15,8,13,56,48,8,53
Elgin,1349,6,14,7,15,55,62,-7,49
Annan Athlet,1349,7,11,12,13,48,42,6,45
Berwick,1349,8,8,10,18,29,59,-30,34
Edinburgh Ci,1349,9,7,9,20,38,63,-25,30
Cowdenbeath,1349,10,4,11,21,24,55,-31,23
Montrose,1350,1,24,7,5,63,34,29,79
Peterhead,1350,2,24,4,8,81,38,43,76
Stirling,1350,3,16,7,13,60,51,9,55
Stenhousem'r,1350,4,15,9,12,55,46,9,54
Clyde,1350,5,14,9,13,51,50,1,51
Elgin,1350,6,14,6,16,53,64,-11,48
Annan Athlet,1350,7,11,11,14,48,43,5,44
Berwick,1350,8,9,10,17,31,58,-27,37
Edinburgh Ci,1350,9,7,9,20,36,64,-28,30
Cowdenbeath,1350,10,5,10,21,25,55,-30,25
Montrose,1351,1,24,7,5,60,34,26,79
Peterhead,1351,2,24,4,8,79,39,40,76
Stirling,1351,3,17,6,13,63,53,10,57
Clyde,1351,4,15,9,12,55,49,6,54
Stenhousem'r,1351,5,15,8,13,57,49,8,53
Elgin,1351,6,14,6,16,53,61,-8,48
Annan Athlet,1351,7,11,11,14,49,44,5,44
Berwick,1351,8,8,10,18,30,62,-32,34
Edinburgh Ci,1351,9,7,9,20,37,62,-25,30
Cowdenbeath,1351,10,5,10,21,26,56,-30,25
Montrose,1352,1,24,7,5,61,35,26,79
Peterhead,1352,2,24,4,8,79,39,40,76
Stirling,1352,3,17,6,13,61,51,10,57
Clyde,1352,4,15,9,12,54,48,6,54
Stenhousem'r,1352,5,15,8,13,55,47,8,53
Elgin,1352,6,14,6,16,54,62,-8,48
Annan Athlet,1352,7,11,12,13,47,41,6,45
Berwick,1352,8,8,10,18,29,61,-32,34
Edinburgh Ci,1352,9,7,9,20,37,62,-25,30
Cowdenbeath,1352,10,4,11,21,23,54,-31,23
Montrose,1353,1,24,7,5,63,35,28,79
Peterhead,1353,2,24,4,8,79,39,40,76
Stenhousem'r,1353,3,16,8,12,57,46,11,56
Stirling,1353,4,16,6,14,60,53,7,54
Clyde,1353,5,15,9,12,52,48,4,54
Elgin,1353,6,14,6,16,54,64,-10,48
Annan Athlet,1353,7,11,11,14,47,42,5,44
Berwick,1353,8,8,10,18,29,59,-30,34
Edinburgh Ci,1353,9,7,9,20,37,62,-25,30
Cowdenbeath,1353,10,5,10,21,24,54,-30,25
Montrose,1354,1,24,7,5,62,34,28,79
Peterhead,1354,2,24,4,8,79,39,40,76
Stenhousem'r,1354,3,16,8,12,57,46,11,56
Stirling,1354,4,16,6,14,60,53,7,54
Clyde,1354,5,14,9,13,53,51,2,51
Elgin,1354,6,14,6,16,53,63,-10,48
Annan Athlet,1354,7,11,11,14,48,43,5,44
Berwick,1354,8,9,10,17,32,60,-28,37
Edinburgh Ci,1354,9,7,9,20,37,62,-25,30
Cowdenbeath,1354,10,5,10,21,25,55,-30,25
Montrose,1355,1,24,7,5,61,34,27,79
Peterhead,1355,2,24,4,8,82,40,42,76
Stirling,1355,3,17,6,13,62,52,10,57
Clyde,1355,4,15,9,12,54,48,6,54
Stenhousem'r,1355,5,15,8,13,56,48,8,53
Elgin,1355,6,14,6,16,53,62,-9,48
Annan Athlet,1355,7,11,11,14,47,45,2,44
Berwick,1355,8,8,10,18,29,61,-32,34
Edinburgh Ci,1355,9,7,9,20,38,65,-27,30
Cowdenbeath,1355,10,5,10,21,27,54,-27,25
Peterhead,1356,1,24,4,8,79,38,41,76
Montrose,1356,2,23,7,6,59,35,24,76
Stirling,1356,3,17,6,13,63,51,12,57
Clyde,1356,4,15,9,12,57,48,9,54
Stenhousem'r,1356,5,15,8,13,55,49,6,53
Elgin,1356,6,15,6,15,54,60,-6,51
Annan Athlet,1356,7,11,11,14,47,42,5,44
Berwick,1356,8,8,10,18,29,64,-35,34
Edinburgh Ci,1356,9,7,9,20,36,62,-26,30
Cowdenbeath,1356,10,5,10,21,24,54,-30,25
Montrose,1357,1,24,7,5,61,35,26,79
Peterhead,1357,2,23,5,8,79,40,39,74
Stirling,1357,3,17,6,13,63,53,10,57
Clyde,1357,4,15,9,12,55,48,7,54
Stenhousem'r,1357,5,15,8,13,57,49,8,53
Elgin,1357,6,14,6,16,54,62,-8,48
Annan Athlet,1357,7,12,11,13,50,42,8,47
Berwick,1357,8,8,10,18,29,62,-33,34
Edinburgh Ci,1357,9,7,10,19,38,62,-24,31
Cowdenbeath,1357,10,4,10,22,24,57,-33,22
Montrose,1358,1,24,7,5,63,34,29,79
Peterhead,1358,2,24,4,8,80,38,42,76
Stirling,1358,3,16,7,13,60,51,9,55
Stenhousem'r,1358,4,15,9,12,55,46,9,54
Clyde,1358,5,15,9,12,54,49,5,54
Elgin,1358,6,14,6,16,53,64,-11,48
Annan Athlet,1358,7,11,11,14,48,43,5,44
Berwick,1358,8,8,10,18,30,61,-31,34
Edinburgh Ci,1358,9,7,9,20,36,63,-27,30
Cowdenbeath,1358,10,5,10,21,25,55,-30,25
Montrose,1359,1,24,7,5,66,35,31,79
Peterhead,1359,2,24,4,8,81,38,43,76
Stirling,1359,3,17,6,13,62,51,11,57
Clyde,1359,4,15,9,12,54,50,4,54
Stenhousem'r,1359,5,15,8,13,55,48,7,53
Elgin,1359,6,14,6,16,54,67,-13,48
Annan Athlet,1359,7,11,11,14,47,42,5,44
Berwick,1359,8,8,10,18,31,61,-30,34
Edinburgh Ci,1359,9,7,9,20,36,64,-28,30
Cowdenbeath,1359,10,5,10,21,24,54,-30,25
Montrose,1360,1,24,7,5,63,34,29,79
Peterhead,1360,2,24,4,8,80,38,42,76
Stenhousem'r,1360,3,16,8,12,56,46,10,56
Stirling,1360,4,16,6,14,60,52,8,54
Clyde,1360,5,14,9,13,52,51,1,51
Elgin,1360,6,14,6,16,53,64,-11,48
Annan Athlet,1360,7,12,11,13,48,41,7,47
Berwick,1360,8,9,10,17,32,59,-27,37
Edinburgh Ci,1360,9,7,9,20,36,63,-27,30
Cowdenbeath,1360,10,4,10,22,23,55,-32,22
Montrose,1361,1,24,7,5,63,34,29,79
Peterhead,1361,2,24,4,8,81,38,43,76
Stirling,1361,3,17,6,13,61,51,10,57
Clyde,1361,4,15,9,12,53,48,5,54
Stenhousem'r,1361,5,15,8,13,55,47,8,53
Elgin,1361,6,14,6,16,53,64,-11,48
Annan Athlet,1361,7,11,12,13,49,43,6,45
Berwick,1361,8,8,10,18,29,60,-31,34
Edinburgh Ci,1361,9,7,9,20,36,64,-28,30
Cowdenbeath,1361,10,4,11,21,25,56,-31,23
Montrose,1362,1,24,7,5,61,35,26,79
Peterhead,1362,2,24,4,8,79,39,40,76
Stirling,1362,3,17,6,13,63,53,10,57
Clyde,1362,4,15,9,12,52,48,4,54
Stenhousem'r,1362,5,15,8,13,57,49,8,53
Elgin,1362,6,14,6,16,54,62,-8,48
Annan Athlet,1362,7,11,11,14,48,43,5,44
Berwick,1362,8,8,10,18,29,59,-30,34
Edinburgh Ci,1362,9,7,9,20,37,62,-25,30
Cowdenbeath,1362,10,5,10,21,25,55,-30,25
Montrose,1363,1,23,8,5,60,35,25,77
Peterhead,1363,2,24,4,8,83,38,45,76
Stirling,1363,3,17,6,13,62,52,10,57
Stenhousem'r,1363,4,15,8,13,56,48,8,53
Clyde,1363,5,14,10,12,53,50,3,52
Elgin,1363,6,14,7,15,54,61,-7,49
Annan Athlet,1363,7,11,11,14,47,42,5,44
Berwick,1363,8,8,11,17,31,60,-29,35
Edinburgh Ci,1363,9,7,9,20,36,66,-30,30
Cowdenbeath,1363,10,5,10,21,24,54,-30,25
Montrose,1364,1,24,7,5,60,34,26,79
Peterhead,1364,2,24,4,8,79,38,41,76
Stirling,1364,3,17,6,13,62,51,11,57
Stenhousem'r,1364,4,15,8,13,55,48,7,53
Clyde,1364,5,14,10,12,52,49,3,52
Elgin,1364,6,14,6,16,53,61,-8,48
Annan Athlet,1364,7,11,12,13,47,41,6,45
Berwick,1364,8,8,11,17,30,59,-29,35
Edinburgh Ci,1364,9,7,9,20,36,62,-26,30
Cowdenbeath,1364,10,4,11,21,23,54,-31,23
Montrose,1365,1,24,7,5,63,37,26,79
Peterhead,1365,2,24,4,8,80,39,41,76
Stenhousem'r,1365,3,16,8,12,60,47,13,56
Stirling,1365,4,16,6,14,61,56,5,54
Clyde,1365,5,14,9,13,52,50,2,51
Elgin,1365,6,14,6,16,56,64,-8,48
Annan Athlet,1365,7,12,11,13,49,41,8,47
Berwick,1365,8,9,10,17,31,59,-28,37
Edinburgh Ci,1365,9,7,9,20,37,63,-26,30
Cowdenbeath,1365,10,4,10,22,23,56,-33,22
Montrose,1366,1,24,7,5,61,34,27,79
Peterhead,1366,2,24,4,8,81,38,43,76
Stirling,1366,3,16,7,13,61,52,9,55
Stenhousem'r,1366,4,15,9,12,56,47,9,54
Clyde,1366,5,15,9,12,53,49,4,54
Elgin,1366,6,14,6,16,53,62,-9,48
Annan Athlet,1366,7,11,11,14,48,43,5,44
Berwick,1366,8,8,10,18,30,60,-30,34
Edinburgh Ci,1366,9,7,9,20,36,64,-28,30
Cowdenbeath,1366,10,5,10,21,25,55,-30,25
Montrose,1367,1,24,7,5,61,34,27,79
Peterhead,1367,2,23,4,9,79,41,38,73
Stirling,1367,3,17,6,13,63,52,11,57
Stenhousem'r,1367,4,15,8,13,56,49,7,53
Clyde,1367,5,14,10,12,53,50,3,52
Elgin,1367,6,14,6,16,53,62,-9,48
Annan Athlet,1367,7,11,11,14,48,43,5,44
Berwick,1367,8,8,11,17,31,60,-29,35
Edinburgh Ci,1367,9,8,9,19,39,62,-23,33
Cowdenbeath,1367,10,5,10,21,25,55,-30,25
Montrose,1368,1,24,7,5,61,34,27,79
Peterhead,1368,2,23,5,8,79,40,39,74
Stirling,1368,3,16,7,13,60,51,9,55
Stenhousem'r,1368,4,15,9,12,55,46,9,54
Clyde,1368,5,14,10,12,52,49,3,52
Elgin,1368,6,14,6,16,53,62,-9,48
Annan Athlet,1368,7,11,12,13,47,41,6,45
Berwick,1368,8,8,11,17,30,59,-29,35
Edinburgh Ci,1368,9,7,10,19,38,62,-24,31
Cowdenbeath,1368,10,4,11,21,23,54,-31,23
Montrose,1369,1,23,8,5,60,35,25,77
Peterhead,1369,2,23,4,9,78,40,38,73
Stirling,1369,3,17,6,13,61,51,10,57
Stenhousem'r,1369,4,15,8,13,55,47,8,53
Clyde,1369,5,14,10,12,51,48,3,52
Elgin,1369,6,14,7,15,54,61,-7,49
Annan Athlet,1369,7,11,11,14,48,43,5,44
Berwick,1369,8,8,11,17,29,58,-29,35
Edinburgh Ci,1369,9,8,9,19,38,61,-23,33
Cowdenbeath,1369,10,5,10,21,25,55,-30,25
Montrose,1370,1,24,7,5,61,35,26,79
Peterhead,1370,2,24,4,8,78,38,40,76
Stirling,1370,3,16,7,13,62,53,9,55
Stenhousem'r,1370,4,15,9,12,57,48,9,54
Clyde,1370,5,15,9,12,52,48,4,54
Elgin,1370,6,14,6,16,54,62,-8,48
Annan Athlet,1370,7,11,12,13,48,42,6,45
Berwick,1370,8,8,10,18,29,59,-30,34
Edinburgh Ci,1370,9,7,9,20,36,61,-25,30
Cowdenbeath,1370,10,4,11,21,24,55,-31,23
Peterhead,1371,1,24,4,8,80,40,40,76
Montrose,1371,2,23,7,6,60,38,22,76
Stenhousem'r,1371,3,16,8,12,56,46,10,56
Stirling,1371,4,16,6,14,60,52,8,54
Clyde,1371,5,14,9,13,52,50,2,51
Elgin,1371,6,15,6,15,57,61,-4,51
Annan Athlet,1371,7,11,12,13,47,41,6,45
Berwick,1371,8,9,10,17,31,59,-28,37
Edinburgh Ci,1371,9,7,9,20,38,63,-25,30
Cowdenbeath,1371,10,4,11,21,23,54,-31,23
Montrose,1372,1,23,7,6,60,36,24,76
Peterhead,1372,2,23,5,8,77,38,39,74
Stirling,1372,3,17,6,13,63,53,10,57
Stenhousem'r,1372,4,15,8,13,57,49,8,53
Clyde,1372,5,14,10,12,52,49,3,52
Elgin,1372,6,15,6,15,55,61,-6,51
Annan Athlet,1372,7,12,11,13,50,41,9,47
Berwick,1372,8,8,11,17,30,59,-29,35
Edinburgh Ci,1372,9,7,10,19,36,60,-24,31
Cowdenbeath,1372,10,4,10,22,23,57,-34,22
Montrose,1373,1,23,7,6,60,36,24,76
Peterhead,1373,2,23,5,8,79,40,39,74
Stenhousem'r,1373,3,16,8,12,57,46,11,56
Stirling,1373,4,16,6,14,60,53,7,54
Clyde,1373,5,14,10,12,53,50,3,52
Elgin,1373,6,15,6,15,55,61,-6,51
Annan Athlet,1373,7,12,11,13,49,41,8,47
Berwick,1373,8,8,11,17,31,60,-29,35
Edinburgh Ci,1373,9,7,10,19,38,62,-24,31
Cowdenbeath,1373,10,4,10,22,23,56,-33,22
Montrose,1374,1,24,7,5,61,35,26,79
Peterhead,1374,2,24,4,8,78,38,40,76
Stirling,1374,3,16,7,13,60,51,9,55
Stenhousem'r,1374,4,15,9,12,55,46,9,54
Clyde,1374,5,14,10,12,52,49,3,52
Elgin,1374,6,14,6,16,54,62,-8,48
Annan Athlet,1374,7,12,11,13,48,41,7,47
Berwick,1374,8,8,11,17,30,59,-29,35
Edinburgh Ci,1374,9,7,9,20,36,61,-25,30
Cowdenbeath,1374,10,4,10,22,23,55,-32,22
Montrose,1375,1,23,8,5,60,35,25,77
Peterhead,1375,2,24,4,8,81,39,42,76
Stenhousem'r,1375,3,16,8,12,56,46,10,56
Stirling,1375,4,16,6,14,60,52,8,54
Clyde,1375,5,14,10,12,52,49,3,52
Elgin,1375,6,14,7,15,54,61,-7,49
Annan Athlet,1375,7,11,12,13,49,43,6,45
Berwick,1375,8,8,11,17,30,59,-29,35
Edinburgh Ci,1375,9,7,9,20,37,64,-27,30
Cowdenbeath,1375,10,4,11,21,25,56,-31,23
Montrose,1376,1,23,8,5,59,34,25,77
Peterhead,1376,2,24,4,8,79,38,41,76
Stenhousem'r,1376,3,16,8,12,60,47,13,56
Stirling,1376,4,16,6,14,61,56,5,54
Clyde,1376,5,15,9,12,54,49,5,54
Elgin,1376,6,14,7,15,53,60,-7,49
Annan Athlet,1376,7,11,11,14,47,45,2,44
Berwick,1376,8,8,10,18,30,61,-31,34
Edinburgh Ci,1376,9,7,9,20,36,62,-26,30
Cowdenbeath,1376,10,5,10,21,27,54,-27,25
Montrose,1377,1,24,7,5,60,34,26,79
Peterhead,1377,2,24,4,8,80,38,42,76
Stirling,1377,3,17,6,13,63,53,10,57
Stenhousem'r,1377,4,15,8,13,57,49,8,53
Clyde,1377,5,14,9,13,52,51,1,51
Elgin,1377,6,14,6,16,53,61,-8,48
Annan Athlet,1377,7,12,11,13,48,41,7,47
Berwick,1377,8,9,10,17,32,59,-27,37
Edinburgh Ci,1377,9,7,9,20,36,63,-27,30
Cowdenbeath,1377,10,4,10,22,23,55,-32,22
Montrose,1378,1,23,8,5,61,36,25,77
Peterhead,1378,2,24,4,8,79,38,41,76
Stirling,1378,3,16,7,13,61,52,9,55
Stenhousem'r,1378,4,15,9,12,56,47,9,54
Clyde,1378,5,15,9,12,53,49,4,54
Elgin,1378,6,14,7,15,55,62,-7,49
Annan Athlet,1378,7,11,11,14,48,43,5,44
Berwick,1378,8,8,10,18,30,60,-30,34
Edinburgh Ci,1378,9,7,9,20,36,62,-26,30
Cowdenbeath,1378,10,5,10,21,25,55,-30,25
Montrose,1379,1,23,8,5,59,34,25,77
Peterhead,1379,2,24,4,8,84,38,46,76
Stirling,1379,3,16,7,13,62,53,9,55
Stenhousem'r,1379,4,15,9,12,57,48,9,54
Clyde,1379,5,14,9,13,51,50,1,51
Elgin,1379,6,14,7,15,53,60,-7,49
Annan Athlet,1379,7,11,11,14,47,42,5,44
Berwick,1379,8,9,10,17,31,58,-27,37
Edinburgh Ci,1379,9,7,9,20,36,67,-31,30
Cowdenbeath,1379,10,5,10,21,24,54,-30,25
Montrose,1380,1,24,7,5,62,36,26,79
Peterhead,1380,2,24,4,8,81,38,43,76
Stirling,1380,3,17,6,13,61,51,10,57
Stenhousem'r,1380,4,15,8,13,55,47,8,53
Clyde,1380,5,14,9,13,52,52,0,51
Elgin,1380,6,14,6,16,55,63,-8,48
Annan Athlet,1380,7,11,11,14,47,43,4,44
Berwick,1380,8,9,10,17,33,59,-26,37
Edinburgh Ci,1380,9,7,9,20,36,64,-28,30
Cowdenbeath,1380,10,5,10,21,25,54,-29,25
Montrose,1381,1,24,7,5,61,35,26,79
Peterhead,1381,2,24,4,8,83,38,45,76
Stirling,1381,3,16,7,13,62,53,9,55
Stenhousem'r,1381,4,15,9,12,57,48,9,54
Clyde,1381,5,14,9,13,53,52,1,51
Elgin,1381,6,14,6,16,54,62,-8,48
Annan Athlet,1381,7,11,12,13,49,43,6,45
Berwick,1381,8,9,10,17,33,60,-27,37
Edinburgh Ci,1381,9,7,9,20,36,66,-30,30
Cowdenbeath,1381,10,4,11,21,25,56,-31,23
Montrose,1382,1,24,7,5,61,35,26,79
Peterhead,1382,2,24,4,8,81,38,43,76
Stirling,1382,3,17,6,13,62,51,11,57
Clyde,1382,4,15,9,12,55,48,7,54
Stenhousem'r,1382,5,15,8,13,55,48,7,53
Elgin,1382,6,14,6,16,54,62,-8,48
Annan Athlet,1382,7,12,11,13,49,42,7,47
Berwick,1382,8,8,10,18,29,62,-33,34
Edinburgh Ci,1382,9,7,9,20,36,64,-28,30
Cowdenbeath,1382,10,4,10,22,24,56,-32,22
Montrose,1383,1,23,8,5,60,35,25,77
Peterhead,1383,2,24,4,8,83,38,45,76
Stenhousem'r,1383,3,16,8,12,57,46,11,56
Stirling,1383,4,16,6,14,60,53,7,54
Clyde,1383,5,14,10,12,52,49,3,52
Elgin,1383,6,14,7,15,54,61,-7,49
Annan Athlet,1383,7,11,12,13,48,42,6,45
Berwick,1383,8,8,11,17,30,59,-29,35
Edinburgh Ci,1383,9,7,9,20,36,66,-30,30
Cowdenbeath,1383,10,4,11,21,24,55,-31,23
Peterhead,1384,1,24,4,8,83,38,45,76
Montrose,1384,2,23,7,6,59,35,24,76
Stenhousem'r,1384,3,16,8,12,57,47,10,56
Stirling,1384,4,16,6,14,61,53,8,54
Clyde,1384,5,15,9,12,52,48,4,54
Elgin,1384,6,15,6,15,54,60,-6,51
Annan Athlet,1384,7,11,11,14,48,43,5,44
Berwick,1384,8,8,10,18,29,59,-30,34
Edinburgh Ci,1384,9,7,9,20,36,66,-30,30
Cowdenbeath,1384,10,5,10,21,25,55,-30,25
Montrose,1385,1,24,7,5,60,34,26,79
Peterhead,1385,2,24,4,8,80,40,40,76
Stenhousem'r,1385,3,16,8,12,56,46,10,56
Stirling,1385,4,16,6,14,60,52,8,54
Clyde,1385,5,15,9,12,57,49,8,54
Elgin,1385,6,14,6,16,53,61,-8,48
Annan Athlet,1385,7,11,11,14,47,42,5,44
Berwick,1385,8,8,10,18,30,64,-34,34
Edinburgh Ci,1385,9,7,9,20,38,63,-25,30
Cowdenbeath,1385,10,5,10,21,24,54,-30,25
Montrose,1386,1,23,7,6,59,35,24,76
Peterhead,1386,2,23,5,8,79,40,39,74
Stirling,1386,3,17,6,13,62,51,11,57
Stenhousem'r,1386,4,15,8,13,55,48,7,53
Clyde,1386,5,14,9,13,51,49,2,51
Elgin,1386,6,15,6,15,54,60,-6,51
Annan Athlet,1386,7,11,12,13,47,41,6,45
Berwick,1386,8,9,10,17,30,58,-28,37
Edinburgh Ci,1386,9,7,10,19,38,62,-24,31
Cowdenbeath,1386,10,4,11,21,23,54,-31,23
Montrose,1387,1,24,7,5,61,35,26,79
Peterhead,1387,2,23,5,8,79,40,39,74
Stirling,1387,3,17,6,13,63,51,12,57
Stenhousem'r,1387,4,15,8,13,55,49,6,53
Clyde,1387,5,14,10,12,52,49,3,52
Elgin,1387,6,14,6,16,54,62,-8,48
Annan Athlet,1387,7,11,12,13,49,43,6,45
Berwick,1387,8,8,11,17,30,59,-29,35
Edinburgh Ci,1387,9,7,10,19,38,62,-24,31
Cowdenbeath,1387,10,4,11,21,25,56,-31,23
Montrose,1388,1,24,7,5,60,34,26,79
Peterhead,1388,2,24,4,8,79,38,41,76
Stirling,1388,3,17,6,13,62,51,11,57
Stenhousem'r,1388,4,15,8,13,55,48,7,53
Clyde,1388,5,14,9,13,52,51,1,51
Elgin,1388,6,14,6,16,53,61,-8,48
Annan Athlet,1388,7,11,12,13,48,42,6,45
Berwick,1388,8,9,10,17,32,59,-27,37
Edinburgh Ci,1388,9,7,9,20,36,62,-26,30
Cowdenbeath,1388,10,4,11,21,24,55,-31,23
Montrose,1389,1,23,8,5,62,37,25,77
Peterhead,1389,2,24,4,8,80,38,42,76
Stirling,1389,3,17,6,13,61,51,10,57
Stenhousem'r,1389,4,15,8,13,55,47,8,53
Clyde,1389,5,14,9,13,51,49,2,51
Elgin,1389,6,14,7,15,56,63,-7,49
Annan Athlet,1389,7,11,12,13,49,43,6,45
Berwick,1389,8,9,10,17,30,58,-28,37
Edinburgh Ci,1389,9,7,9,20,36,63,-27,30
Cowdenbeath,1389,10,4,11,21,25,56,-31,23
Montrose,1390,1,24,7,5,62,34,28,79
Peterhead,1390,2,24,4,8,80,39,41,76
Stirling,1390,3,16,7,13,60,51,9,55
Stenhousem'r,1390,4,15,9,12,55,46,9,54
Clyde,1390,5,15,9,12,56,48,8,54
Elgin,1390,6,14,6,16,53,63,-10,48
Annan Athlet,1390,7,12,11,13,51,41,10,47
Berwick,1390,8,8,10,18,29,63,-34,34
Edinburgh Ci,1390,9,7,9,20,37,63,-26,30
Cowdenbeath,1390,10,4,10,22,23,58,-35,22
Montrose,1391,1,23,8,5,59,34,25,77
Peterhead,1391,2,24,4,8,79,38,41,76
Stirling,1391,3,17,6,13,63,52,11,57
Clyde,1391,4,15,9,12,53,48,5,54
Stenhousem'r,1391,5,15,8,13,56,49,7,53
Elgin,1391,6,14,7,15,53,60,-7,49
Annan Athlet,1391,7,11,12,13,48,42,6,45
Berwick,1391,8,8,10,18,29,60,-31,34
Edinburgh Ci,1391,9,7,9,20,36,62,-26,30
Cowdenbeath,1391,10,4,11,21,24,55,-31,23
Montrose,1392,1,23,8,5,59,34,25,77
Peterhead,1392,2,23,4,9,77,39,38,73
Stirling,1392,3,17,6,13,62,52,10,57
Clyde,1392,4,15,9,12,54,49,5,54
Stenhousem'r,1392,5,15,8,13,56,48,8,53
Elgin,1392,6,14,7,15,53,60,-7,49
Annan Athlet,1392,7,11,11,14,48,44,4,44
Berwick,1392,8,8,10,18,30,61,-31,34
Edinburgh Ci,1392,9,8,9,19,37,60,-23,33
Cowdenbeath,1392,10,5,10,21,26,55,-29,25
Peterhead,1393,1,24,4,8,80,38,42,76
Montrose,1393,2,23,7,6,59,36,23,76
Stirling,1393,3,17,6,13,62,52,10,57
Clyde,1393,4,15,9,12,53,48,5,54
Stenhousem'r,1393,5,15,8,13,56,48,8,53
Elgin,1393,6,15,6,15,55,60,-5,51
Annan Athlet,1393,7,11,12,13,49,43,6,45
Berwick,1393,8,8,10,18,29,60,-31,34
Edinburgh Ci,1393,9,7,9,20,36,63,-27,30
Cowdenbeath,1393,10,4,11,21,25,56,-31,23
Montrose,1394,1,24,7,5,60,34,26,79
Peterhead,1394,2,23,5,8,78,39,39,74
Stenhousem'r,1394,3,16,8,12,57,47,10,56
Stirling,1394,4,16,6,14,61,53,8,54
Clyde,1394,5,14,10,12,52,49,3,52
Elgin,1394,6,14,6,16,53,61,-8,48
Annan Athlet,1394,7,11,12,13,47,41,6,45
Berwick,1394,8,8,11,17,30,59,-29,35
Edinburgh Ci,1394,9,7,10,19,37,61,-24,31
Cowdenbeath,1394,10,4,11,21,23,54,-31,23
Montrose,1395,1,24,7,5,63,34,29,79
Peterhead,1395,2,23,5,8,77,38,39,74
Stenhousem'r,1395,3,16,8,12,57,47,10,56
Stirling,1395,4,16,6,14,61,53,8,54
Clyde,1395,5,14,9,13,51,49,2,51
Elgin,1395,6,14,6,16,53,64,-11,48
Annan Athlet,1395,7,12,11,13,48,41,7,47
Berwick,1395,8,9,10,17,30,58,-28,37
Edinburgh Ci,1395,9,7,10,19,36,60,-24,31
Cowdenbeath,1395,10,4,10,22,23,55,-32,22
Peterhead,1396,1,24,4,8,80,40,40,76
Montrose,1396,2,23,7,6,59,36,23,76
Stenhousem'r,1396,3,16,8,12,58,46,12,56
Stirling,1396,4,16,6,14,60,54,6,54
Clyde,1396,5,14,10,12,52,49,3,52
Elgin,1396,6,15,6,15,55,60,-5,51
Annan Athlet,1396,7,11,11,14,47,42,5,44
Berwick,1396,8,8,11,17,30,59,-29,35
Edinburgh Ci,1396,9,7,9,20,38,63,-25,30
Cowdenbeath,1396,10,5,10,21,24,54,-30,25
Montrose,1397,1,24,7,5,63,35,28,79
Peterhead,1397,2,24,4,8,78,38,40,76
Stirling,1397,3,16,7,13,60,51,9,55
Stenhousem'r,1397,4,15,9,12,55,46,9,54
Clyde,1397,5,15,9,12,54,48,6,54
Elgin,1397,6,14,6,16,54,64,-10,48
Annan Athlet,1397,7,12,11,13,50,43,7,47
Berwick,1397,8,8,10,18,29,61,-32,34
Edinburgh Ci,1397,9,7,9,20,36,61,-25,30
Cowdenbeath,1397,10,4,10,22,25,57,-32,22
Montrose,1398,1,24,7,5,62,34,28,79
Peterhead,1398,2,24,4,8,81,39,42,76
Stirling,1398,3,16,7,13,60,51,9,55
Stenhousem'r,1398,4,15,9,12,55,46,9,54
Clyde,1398,5,15,9,12,54,48,6,54
Elgin,1398,6,14,6,16,53,63,-10,48
Annan Athlet,1398,7,12,11,13,48,41,7,47
Berwick,1398,8,8,10,18,29,61,-32,34
Edinburgh Ci,1398,9,7,9,20,37,64,-27,30
Cowdenbeath,1398,10,4,10,22,23,55,-32,22
Montrose,1399,1,23,8,5,61,36,25,77
Peterhead,1399,2,24,4,8,80,39,41,76
Stirling,1399,3,17,6,13,63,53,10,57
Clyde,1399,4,15,9,12,54,49,5,54
Stenhousem'r,1399,5,15,8,13,57,49,8,53
Elgin,1399,6,14,7,15,55,62,-7,49
Annan Athlet,1399,7,11,11,14,48,43,5,44
Berwick,1399,8,8,10,18,30,61,-31,34
Edinburgh Ci,1399,9,7,9,20,37,63,-26,30
Cowdenbeath,1399,10,5,10,21,25,55,-30,25
Montrose,1400,1,24,7,5,62,34,28,79
Peterhead,1400,2,24,4,8,83,39,44,76
Stenhousem'r,1400,3,16,8,12,58,48,10,56
Stirling,1400,4,16,6,14,62,54,8,54
Clyde,1400,5,14,9,13,51,49,2,51
Elgin,1400,6,14,6,16,53,63,-10,48
Annan Athlet,1400,7,11,11,14,47,42,5,44
Berwick,1400,8,9,10,17,30,58,-28,37
Edinburgh Ci,1400,9,7,9,20,37,66,-29,30
Cowdenbeath,1400,10,5,10,21,24,54,-30,25
Montrose,1401,1,24,7,5,61,35,26,79
Peterhead,1401,2,24,4,8,81,39,42,76
Stirling,1401,3,17,6,13,62,51,11,57
Clyde,1401,4,15,9,12,54,49,5,54
Stenhousem'r,1401,5,15,8,13,55,48,7,53
Elgin,1401,6,14,6,16,54,62,-8,48
Annan Athlet,1401,7,11,11,14,47,42,5,44
Berwick,1401,8,8,10,18,30,61,-31,34
Edinburgh Ci,1401,9,7,9,20,37,64,-27,30
Cowdenbeath,1401,10,5,10,21,24,54,-30,25
Montrose,1402,1,24,7,5,64,35,29,79
Peterhead,1402,2,23,5,8,78,39,39,74
Stirling,1402,3,17,6,13,62,51,11,57
Stenhousem'r,1402,4,15,8,13,55,48,7,53
Clyde,1402,5,14,10,12,52,49,3,52
Elgin,1402,6,14,6,16,54,65,-11,48
Annan Athlet,1402,7,12,11,13,48,41,7,47
Berwick,1402,8,8,11,17,30,59,-29,35
Edinburgh Ci,1402,9,7,10,19,37,61,-24,31
Cowdenbeath,1402,10,4,10,22,23,55,-32,22
Montrose,1403,1,24,7,5,62,34,28,79
Peterhead,1403,2,24,4,8,78,38,40,76
Stirling,1403,3,17,6,13,63,53,10,57
Clyde,1403,4,15,9,12,53,49,4,54
Stenhousem'r,1403,5,15,8,13,57,49,8,53
Elgin,1403,6,14,6,16,53,63,-10,48
Annan Athlet,1403,7,11,12,13,48,42,6,45
Berwick,1403,8,8,10,18,30,60,-30,34
Edinburgh Ci,1403,9,7,9,20,36,61,-25,30
Cowdenbeath,1403,10,4,11,21,24,55,-31,23
Montrose,1404,1,23,8,5,59,34,25,77
Peterhead,1404,2,24,4,8,80,39,41,76
Stirling,1404,3,17,6,13,62,51,11,57
Clyde,1404,4,15,9,12,58,49,9,54
Stenhousem'r,1404,5,15,8,13,55,48,7,53
Elgin,1404,6,14,7,15,53,60,-7,49
Annan Athlet,1404,7,12,11,13,49,41,8,47
Berwick,1404,8,8,10,18,30,65,-35,34
Edinburgh Ci,1404,9,7,9,20,37,63,-26,30
Cowdenbeath,1404,10,4,10,22,23,56,-33,22
Peterhead,1405,1,24,4,8,81,39,42,76
Montrose,1405,2,23,7,6,59,35,24,76
Stirling,1405,3,17,6,13,63,51,12,57
Stenhousem'r,1405,4,15,8,13,55,49,6,53
Clyde,1405,5,14,9,13,51,49,2,51
Elgin,1405,6,15,6,15,54,60,-6,51
Annan Athlet,1405,7,12,11,13,48,41,7,47
Berwick,1405,8,9,10,17,30,58,-28,37
Edinburgh Ci,1405,9,7,9,20,37,64,-27,30
Cowdenbeath,1405,10,4,10,22,23,55,-32,22
Montrose,1406,1,24,7,5,64,37,27,79
Peterhead,1406,2,24,4,8,80,38,42,76
Stenhousem'r,1406,3,16,8,12,56,46,10,56
Stirling,1406,4,16,6,14,60,52,8,54
Clyde,1406,5,15,9,12,53,48,5,54
Elgin,1406,6,14,6,16,56,65,-9,48
Annan Athlet,1406,7,11,12,13,48,42,6,45
Berwick,1406,8,8,10,18,29,60,-31,34
Edinburgh Ci,1406,9,7,9,20,36,63,-27,30
Cowdenbeath,1406,10,4,11,21,24,55,-31,23
Montrose,1407,1,24,7,5,62,34,28,79
Peterhead,1407,2,24,4,8,80,38,42,76
Stenhousem'r,1407,3,16,8,12,56,46,10,56
Stirling,1407,4,16,6,14,60,52,8,54
Clyde,1407,5,15,9,12,55,51,4,54
Elgin,1407,6,14,6,16,53,63,-10,48
Annan Athlet,1407,7,11,12,13,47,41,6,45
Berwick,1407,8,8,10,18,32,62,-30,34
Edinburgh Ci,1407,9,7,9,20,36,63,-27,30
Cowdenbeath,1407,10,4,11,21,23,54,-31,23
Montrose,1408,1,24,7,5,61,35,26,79
Peterhead,1408,2,24,4,8,78,38,40,76
Stirling,1408,3,16,7,13,60,51,9,55
Stenhousem'r,1408,4,15,9,12,55,46,9,54
Clyde,1408,5,15,9,12,53,48,5,54
Elgin,1408,6,14,6,16,54,62,-8,48
Annan Athlet,1408,7,12,11,13,49,42,7,47
Berwick,1408,8,8,10,18,29,60,-31,34
Edinburgh Ci,1408,9,7,9,20,36,61,-25,30
Cowdenbeath,1408,10,4,10,22,24,56,-32,22
Peterhead,1409,1,24,4,8,83,40,43,76
Montrose,1409,2,23,7,6,59,35,24,76
Stirling,1409,3,16,7,13,61,52,9,55
Stenhousem'r,1409,4,15,9,12,56,47,9,54
Clyde,1409,5,15,9,12,53,49,4,54
Elgin,1409,6,15,6,15,54,60,-6,51
Annan Athlet,1409,7,12,11,13,48,41,7,47
Berwick,1409,8,8,10,18,30,60,-30,34
Edinburgh Ci,1409,9,7,9,20,38,66,-28,30
Cowdenbeath,1409,10,4,10,22,23,55,-32,22
Montrose,1410,1,24,7,5,61,34,27,79
Peterhead,1410,2,24,4,8,82,38,44,76
Stenhousem'r,1410,3,16,8,12,57,47,10,56
Stirling,1410,4,16,6,14,61,53,8,54
Clyde,1410,5,15,9,12,53,48,5,54
Elgin,1410,6,14,6,16,53,62,-9,48
Annan Athlet,1410,7,12,11,13,49,42,7,47
Berwick,1410,8,8,10,18,29,60,-31,34
Edinburgh Ci,1410,9,7,9,20,36,65,-29,30
Cowdenbeath,1410,10,4,10,22,24,56,-32,22
Peterhead,1411,1,24,4,8,82,39,43,76
Montrose,1411,2,23,7,6,59,35,24,76
Stenhousem'r,1411,3,16,8,12,58,47,11,56
Stirling,1411,4,16,6,14,61,54,7,54
Clyde,1411,5,15,9,12,54,49,5,54
Elgin,1411,6,15,6,15,54,60,-6,51
Annan Athlet,1411,7,12,11,13,48,41,7,47
Berwick,1411,8,8,10,18,30,61,-31,34
Edinburgh Ci,1411,9,7,9,20,37,65,-28,30
Cowdenbeath,1411,10,4,10,22,23,55,-32,22
Montrose,1412,1,24,7,5,61,34,27,79
Peterhead,1412,2,24,4,8,80,40,40,76
Stirling,1412,3,16,7,13,61,52,9,55
Stenhousem'r,1412,4,15,9,12,56,47,9,54
Clyde,1412,5,14,10,12,52,49,3,52
Elgin,1412,6,14,6,16,53,62,-9,48
Annan Athlet,1412,7,12,11,13,48,41,7,47
Berwick,1412,8,8,11,17,30,59,-29,35
Edinburgh Ci,1412,9,7,9,20,38,63,-25,30
Cowdenbeath,1412,10,4,10,22,23,55,-32,22
Montrose,1413,1,24,7,5,61,35,26,79
Peterhead,1413,2,24,4,8,80,39,41,76
Stenhousem'r,1413,3,16,8,12,58,47,11,56
Stirling,1413,4,16,6,14,61,54,7,54
Clyde,1413,5,14,9,13,51,49,2,51
Elgin,1413,6,14,6,16,54,62,-8,48
Annan Athlet,1413,7,12,11,13,48,41,7,47
Berwick,1413,8,9,10,17,30,58,-28,37
Edinburgh Ci,1413,9,7,9,20,37,63,-26,30
Cowdenbeath,1413,10,4,10,22,23,55,-32,22
Montrose,1414,1,23,8,5,60,35,25,77
Peterhead,1414,2,24,4,8,78,38,40,76
Stirling,1414,3,17,6,13,61,51,10,57
Clyde,1414,4,15,9,12,52,48,4,54
Stenhousem'r,1414,5,15,8,13,55,47,8,53
Elgin,1414,6,14,7,15,54,61,-7,49
Annan Athlet,1414,7,12,11,13,49,41,8,47
Berwick,1414,8,8,10,18,29,59,-30,34
Edinburgh Ci,1414,9,7,9,20,36,61,-25,30
Cowdenbeath,1414,10,4,10,22,23,56,-33,22
Montrose,1415,1,23,8,5,61,36,25,77
Peterhead,1415,2,24,4,8,81,38,43,76
Stenhousem'r,1415,3,16,8,12,58,46,12,56
Stirling,1415,4,16,6,14,60,54,6,54
Clyde,1415,5,15,9,12,53,49,4,54
Elgin,1415,6,14,7,15,55,62,-7,49
Annan Athlet,1415,7,11,12,13,47,41,6,45
Berwick,1415,8,8,10,18,30,60,-30,34
Edinburgh Ci,1415,9,7,9,20,36,64,-28,30
Cowdenbeath,1415,10,4,11,21,23,54,-31,23
Montrose,1416,1,23,8,5,62,37,25,77
Peterhead,1416,2,24,4,8,78,38,40,76
Stirling,1416,3,17,6,13,62,52,10,57
Clyde,1416,4,15,9,12,52,48,4,54
Stenhousem'r,1416,5,15,8,13,56,48,8,53
Elgin,1416,6,14,7,15,56,63,-7,49
Annan Athlet,1416,7,11,12,13,48,42,6,45
Berwick,1416,8,8,10,18,29,59,-30,34
Edinburgh Ci,1416,9,7,9,20,36,61,-25,30
Cowdenbeath,1416,10,4,11,21,24,55,-31,23
Peterhead,1417,1,24,4,8,81,40,41,76
Montrose,1417,2,23,7,6,60,36,24,76
Stirling,1417,3,16,7,13,61,52,9,55
Stenhousem'r,1417,4,15,9,12,56,47,9,54
Clyde,1417,5,14,10,12,52,49,3,52
Elgin,1417,6,15,6,15,55,61,-6,51
Annan Athlet,1417,7,12,11,13,48,41,7,47
Berwick,1417,8,8,11,17,30,59,-29,35
Edinburgh Ci,1417,9,7,9,20,38,64,-26,30
Cowdenbeath,1417,10,4,10,22,23,55,-32,22
Montrose,1418,1,24,7,5,63,35,28,79
Peterhead,1418,2,23,5,8,79,40,39,74
Stenhousem'r,1418,3,16,8,12,58,46,12,56
Stirling,1418,4,16,6,14,60,54,6,54
Clyde,1418,5,14,10,12,54,51,3,52
Elgin,1418,6,14,6,16,54,64,-10,48
Annan Athlet,1418,7,11,12,13,48,42,6,45
Berwick,1418,8,8,11,17,32,61,-29,35
Edinburgh Ci,1418,9,7,10,19,38,62,-24,31
Cowdenbeath,1418,10,4,11,21,24,55,-31,23
Montrose,1419,1,24,7,5,61,35,26,79
Peterhead,1419,2,24,4,8,79,39,40,76
Stirling,1419,3,17,6,13,62,51,11,57
Stenhousem'r,1419,4,15,8,13,55,48,7,53
Clyde,1419,5,14,9,13,51,49,2,51
Elgin,1419,6,14,6,16,54,62,-8,48
Annan Athlet,1419,7,12,11,13,48,41,7,47
Berwick,1419,8,9,10,17,30,58,-28,37
Edinburgh Ci,1419,9,7,9,20,37,62,-25,30
Cowdenbeath,1419,10,4,10,22,23,55,-32,22
Montrose,1420,1,24,7,5,64,34,30,79
Peterhead,1420,2,24,4,8,84,39,45,76
Stirling,1420,3,17,6,13,62,52,10,57
Clyde,1420,4,15,9,12,54,48,6,54
Stenhousem'r,1420,5,15,8,13,56,48,8,53
Elgin,1420,6,14,6,16,53,65,-12,48
Annan Athlet,1420,7,11,11,14,48,43,5,44
Berwick,1420,8,8,10,18,29,61,-32,34
Edinburgh Ci,1420,9,7,9,20,37,67,-30,30
Cowdenbeath,1420,10,5,10,21,25,55,-30,25
Peterhead,1421,1,24,4,8,80,38,42,76
Montrose,1421,2,23,7,6,59,35,24,76
Stirling,1421,3,17,6,13,61,51,10,57
Stenhousem'r,1421,4,15,8,13,55,47,8,53
Clyde,1421,5,14,10,12,53,50,3,52
Elgin,1421,6,15,6,15,54,60,-6,51
Annan Athlet,1421,7,11,12,13,47,41,6,45
Berwick,1421,8,8,11,17,31,60,-29,35
Edinburgh Ci,1421,9,7,9,20,36,63,-27,30
Cowdenbeath,1421,10,4,11,21,23,54,-31,23
Montrose,1422,1,23,8,5,60,35,25,77
Peterhead,1422,2,23,4,9,78,40,38,73
Stenhousem'r,1422,3,16,8,12,57,46,11,56
Stirling,1422,4,16,6,14,60,53,7,54
Clyde,1422,5,15,9,12,53,49,4,54
Elgin,1422,6,14,7,15,54,61,-7,49
Annan Athlet,1422,7,11,11,14,47,42,5,44
Berwick,1422,8,8,10,18,30,60,-30,34
Edinburgh Ci,1422,9,8,9,19,38,61,-23,33
Cowdenbeath,1422,10,5,10,21,24,54,-30,25
Montrose,1423,1,24,7,5,61,34,27,79
Peterhead,1423,2,24,4,8,81,41,40,76
Stirling,1423,3,16,7,13,60,51,9,55
Stenhousem'r,1423,4,15,9,12,55,46,9,54
Clyde,1423,5,15,9,12,53,49,4,54
Elgin,1423,6,14,6,16,53,62,-9,48
Annan Athlet,1423,7,11,11,14,47,42,5,44
Berwick,1423,8,8,10,18,30,60,-30,34
Edinburgh Ci,1423,9,7,9,20,39,64,-25,30
Cowdenbeath,1423,10,5,10,21,24,54,-30,25
Montrose,1424,1,24,7,5,62,36,26,79
Peterhead,1424,2,24,4,8,80,39,41,76
Stirling,1424,3,17,6,13,61,51,10,57
Clyde,1424,4,15,9,12,53,48,5,54
Stenhousem'r,1424,5,15,8,13,55,47,8,53
Elgin,1424,6,14,6,16,55,63,-8,48
Annan Athlet,1424,7,11,11,14,47,42,5,44
Berwick,1424,8,8,10,18,29,60,-31,34
Edinburgh Ci,1424,9,7,9,20,37,63,-26,30
Cowdenbeath,1424,10,5,10,21,24,54,-30,25
Peterhead,1425,1,24,4,8,79,38,41,76
Montrose,1425,2,23,7,6,59,35,24,76
Stirling,1425,3,17,6,13,61,51,10,57
Stenhousem'r,1425,4,15,8,13,55,47,8,53
Clyde,1425,5,14,9,13,52,50,2,51
Elgin,1425,6,15,6,15,54,60,-6,51
Annan Athlet,1425,7,12,11,13,48,41,7,47
Berwick,1425,8,9,10,17,31,59,-28,37
Edinburgh Ci,1425,9,7,9,20,36,62,-26,30
Cowdenbeath,1425,10,4,10,22,23,55,-32,22
Montrose,1426,1,24,7,5,63,35,28,79
Peterhead,1426,2,24,4,8,78,38,40,76
Stirling,1426,3,17,6,13,61,51,10,57
Stenhousem'r,1426,4,15,8,13,55,47,8,53
Clyde,1426,5,14,10,12,52,49,3,52
Elgin,1426,6,14,6,16,54,64,-10,48
Annan Athlet,1426,7,11,11,14,48,43,5,44
Berwick,1426,8,8,11,17,30,59,-29,35
Edinburgh Ci,1426,9,7,9,20,36,61,-25,30
Cowdenbeath,1426,10,5,10,21,25,55,-30,25
Montrose,1427,1,23,7,6,60,36,24,76
Peterhead,1427,2,23,5,8,78,39,39,74
Stenhousem'r,1427,3,16,8,12,59,48,11,56
Stirling,1427,4,16,6,14,62,55,7,54
Clyde,1427,5,15,9,12,52,48,4,54
Elgin,1427,6,15,6,15,55,61,-6,51
Annan Athlet,1427,7,11,11,14,47,42,5,44
Berwick,1427,8,8,10,18,29,59,-30,34
Edinburgh Ci,1427,9,7,10,19,37,61,-24,31
Cowdenbeath,1427,10,5,10,21,24,54,-30,25
Montrose,1428,1,23,8,5,60,35,25,77
Peterhead,1428,2,24,4,8,80,39,41,76
Stirling,1428,3,17,6,13,64,51,13,57
Clyde,1428,4,15,9,12,54,49,5,54
Stenhousem'r,1428,5,15,8,13,55,50,5,53
Elgin,1428,6,14,7,15,54,61,-7,49
Annan Athlet,1428,7,11,11,14,48,43,5,44
Berwick,1428,8,8,10,18,30,61,-31,34
Edinburgh Ci,1428,9,7,9,20,37,63,-26,30
Cowdenbeath,1428,10,5,10,21,25,55,-30,25
Montrose,1429,1,24,7,5,61,34,27,79
Peterhead,1429,2,23,5,8,81,42,39,74
Stenhousem'r,1429,3,16,8,12,58,48,10,56
Stirling,1429,4,16,6,14,62,54,8,54
Clyde,1429,5,15,9,12,56,49,7,54
Elgin,1429,6,14,6,16,53,62,-9,48
Annan Athlet,1429,7,11,11,14,47,44,3,44
Berwick,1429,8,8,10,18,30,63,-33,34
Edinburgh Ci,1429,9,7,10,19,40,64,-24,31
Cowdenbeath,1429,10,5,10,21,26,54,-28,25
Peterhead,1430,1,24,4,8,78,38,40,76
Montrose,1430,2,23,7,6,59,35,24,76
Stenhousem'r,1430,3,16,8,12,57,47,10,56
Stirling,1430,4,16,6,14,61,53,8,54
Clyde,1430,5,15,9,12,53,49,4,54
Elgin,1430,6,15,6,15,54,60,-6,51
Annan Athlet,1430,7,11,12,13,47,41,6,45
Berwick,1430,8,8,10,18,30,60,-30,34
Edinburgh Ci,1430,9,7,9,20,36,61,-25,30
Cowdenbeath,1430,10,4,11,21,23,54,-31,23
Peterhead,1431,1,24,4,8,79,39,40,76
Montrose,1431,2,23,7,6,59,36,23,76
Stirling,1431,3,16,7,13,62,53,9,55
Stenhousem'r,1431,4,15,9,12,57,48,9,54
Clyde,1431,5,15,9,12,53,48,5,54
Elgin,1431,6,15,6,15,55,60,-5,51
Annan Athlet,1431,7,11,12,13,48,42,6,45
Berwick,1431,8,8,10,18,29,60,-31,34
Edinburgh Ci,1431,9,7,9,20,37,62,-25,30
Cowdenbeath,1431,10,4,11,21,24,55,-31,23
Montrose,1432,1,24,7,5,62,34,28,79
Peterhead,1432,2,24,4,8,79,38,41,76
Stirling,1432,3,17,6,13,63,51,12,57
Stenhousem'r,1432,4,15,8,13,55,49,6,53
Clyde,1432,5,14,10,12,52,49,3,52
Elgin,1432,6,14,6,16,53,63,-10,48
Annan Athlet,1432,7,12,11,13,49,42,7,47
Berwick,1432,8,8,11,17,30,59,-29,35
Edinburgh Ci,1432,9,7,9,20,36,62,-26,30
Cowdenbeath,1432,10,4,10,22,24,56,-32,22
Montrose,1433,1,24,7,5,61,34,27,79
Peterhead,1433,2,23,4,9,77,40,37,73
Stenhousem'r,1433,3,16,8,12,57,46,11,56
Stirling,1433,4,16,6,14,60,53,7,54
Clyde,1433,5,14,10,12,52,49,3,52
Elgin,1433,6,14,6,16,53,62,-9,48
Annan Athlet,1433,7,11,11,14,47,44,3,44
Berwick,1433,8,8,11,17,30,59,-29,35
Edinburgh Ci,1433,9,8,9,19,38,60,-22,33
Cowdenbeath,1433,10,5,10,21,26,54,-28,25
Montrose,1434,1,23,8,5,59,34,25,77
Peterhead,1434,2,24,4,8,80,39,41,76
Stenhousem'r,1434,3,16,8,12,59,48,11,56
Stirling,1434,4,16,6,14,62,55,7,54
Clyde,1434,5,14,10,12,52,49,3,52
Elgin,1434,6,14,7,15,53,60,-7,49
Annan Athlet,1434,7,12,11,13,48,41,7,47
Berwick,1434,8,8,11,17,30,59,-29,35
Edinburgh Ci,1434,9,7,9,20,37,63,-26,30
Cowdenbeath,1434,10,4,10,22,23,55,-32,22
Montrose,1435,1,23,7,6,59,35,24,76
Peterhead,1435,2,23,5,8,78,39,39,74
Stirling,1435,3,17,6,13,65,54,11,57
Clyde,1435,4,15,9,12,56,50,6,54
Stenhousem'r,1435,5,15,8,13,58,51,7,53
Elgin,1435,6,15,6,15,54,60,-6,51
Annan Athlet,1435,7,11,11,14,48,43,5,44
Berwick,1435,8,8,10,18,31,63,-32,34
Edinburgh Ci,1435,9,7,10,19,37,61,-24,31
Cowdenbeath,1435,10,5,10,21,25,55,-30,25
Montrose,1436,1,23,8,5,60,35,25,77
Peterhead,1436,2,24,4,8,78,38,40,76
Stirling,1436,3,17,6,13,63,51,12,57
Stenhousem'r,1436,4,15,8,13,55,49,6,53
Clyde,1436,5,14,9,13,51,51,0,51
Elgin,1436,6,14,7,15,54,61,-7,49
Annan Athlet,1436,7,12,11,13,48,41,7,47
Berwick,1436,8,9,10,17,32,58,-26,37
Edinburgh Ci,1436,9,7,9,20,36,61,-25,30
Cowdenbeath,1436,10,4,10,22,23,55,-32,22
Montrose,1437,1,24,7,5,61,35,26,79
Peterhead,1437,2,24,4,8,80,39,41,76
Stirling,1437,3,17,6,13,62,52,10,57
Clyde,1437,4,15,9,12,53,49,4,54
Stenhousem'r,1437,5,15,8,13,56,48,8,53
Elgin,1437,6,14,6,16,54,62,-8,48
Annan Athlet,1437,7,12,11,13,51,41,10,47
Berwick,1437,8,8,10,18,30,60,-30,34
Edinburgh Ci,1437,9,7,9,20,37,63,-26,30
Cowdenbeath,1437,10,4,10,22,23,58,-35,22
Peterhead,1438,1,24,4,8,80,38,42,76
Montrose,1438,2,23,7,6,59,35,24,76
Stirling,1438,3,16,7,13,60,51,9,55
Stenhousem'r,1438,4,15,9,12,55,46,9,54
Clyde,1438,5,15,9,12,56,49,7,54
Elgin,1438,6,15,6,15,54,60,-6,51
Annan Athlet,1438,7,11,11,14,47,42,5,44
Berwick,1438,8,8,10,18,30,63,-33,34
Edinburgh Ci,1438,9,7,9,20,36,63,-27,30
Cowdenbeath,1438,10,5,10,21,24,54,-30,25
Montrose,1439,1,24,7,5,61,34,27,79
Peterhead,1439,2,23,5,8,79,40,39,74
Stenhousem'r,1439,3,16,8,12,56,46,10,56
Stirling,1439,4,16,6,14,60,52,8,54
Clyde,1439,5,14,10,12,51,48,3,52
Elgin,1439,6,14,6,16,53,62,-9,48
Annan Athlet,1439,7,12,11,13,48,41,7,47
Berwick,1439,8,8,11,17,29,58,-29,35
Edinburgh Ci,1439,9,7,10,19,38,62,-24,31
Cowdenbeath,1439,10,4,10,22,23,55,-32,22
Montrose,1440,1,23,8,5,59,34,25,77
Peterhead,1440,2,24,4,8,79,38,41,76
Stirling,1440,3,16,7,13,62,53,9,55
Stenhousem'r,1440,4,15,9,12,57,48,9,54
Clyde,1440,5,15,9,12,52,48,4,54
Elgin,1440,6,14,7,15,53,60,-7,49
Annan Athlet,1440,7,11,12,13,47,41,6,45
Berwick,1440,8,8,10,18,29,59,-30,34
Edinburgh Ci,1440,9,7,9,20,36,62,-26,30
Cowdenbeath,1440,10,4,11,21,23,54,-31,23
Montrose,1441,1,24,7,5,61,35,26,79
Peterhead,1441,2,24,4,8,79,38,41,76
Stirling,1441,3,17,6,13,63,52,11,57
Clyde,1441,4,15,9,12,54,49,5,54
Stenhousem'r,1441,5,15,8,13,56,49,7,53
Elgin,1441,6,14,6,16,54,62,-8,48
Annan Athlet,1441,7,12,11,13,50,43,7,47
Berwick,1441,8,8,10,18,30,61,-31,34
Edinburgh Ci,1441,9,7,9,20,36,62,-26,30
Cowdenbeath,1441,10,4,10,22,25,57,-32,22
Montrose,1442,1,24,7,5,61,35,26,79
Peterhead,1442,2,23,5,8,79,40,39,74
Stirling,1442,3,17,6,13,61,51,10,57
Stenhousem'r,1442,4,15,8,13,55,47,8,53
Clyde,1442,5,14,9,13,52,50,2,51
Elgin,1442,6,14,6,16,54,62,-8,48
Annan Athlet,1442,7,12,11,13,51,41,10,47
Berwick,1442,8,9,10,17,31,59,-28,37
Edinburgh Ci,1442,9,7,10,19,38,62,-24,31
Cowdenbeath,1442,10,4,10,22,23,58,-35,22
Montrose,1443,1,23,8,5,60,35,25,77
Peterhead,1443,2,24,4,8,80,38,42,76
Stirling,1443,3,17,6,13,65,52,13,57
Clyde,1443,4,15,9,12,52,48,4,54
Stenhousem'r,1443,5,15,8,13,56,51,5,53
Elgin,1443,6,14,7,15,54,61,-7,49
Annan Athlet,1443,7,12,11,13,48,41,7,47
Berwick,1443,8,8,10,18,29,59,-30,34
Edinburgh Ci,1443,9,7,9,20,36,63,-27,30
Cowdenbeath,1443,10,4,10,22,23,55,-32,22
Montrose,1444,1,23,8,5,61,36,25,77
Peterhead,1444,2,24,4,8,82,39,43,76
Stirling,1444,3,17,6,13,62,51,11,57
Clyde,1444,4,15,9,12,53,48,5,54
Stenhousem'r,1444,5,15,8,13,55,48,7,53
Elgin,1444,6,14,7,15,55,62,-7,49
Annan Athlet,1444,7,11,11,14,47,42,5,44
Berwick,1444,8,8,10,18,29,60,-31,34
Edinburgh Ci,1444,9,7,9,20,37,65,-28,30
Cowdenbeath,1444,10,5,10,21,24,54,-30,25
Montrose,1445,1,24,7,5,63,35,28,79
Peterhead,1445,2,23,5,8,78,39,39,74
Stirling,1445,3,17,6,13,62,52,10,57
Stenhousem'r,1445,4,15,8,13,56,48,8,53
Clyde,1445,5,14,10,12,53,50,3,52
Elgin,1445,6,14,6,16,54,64,-10,48
Annan Athlet,1445,7,11,11,14,48,45,3,44
Berwick,1445,8,8,11,17,31,60,-29,35
Edinburgh Ci,1445,9,7,10,19,37,61,-24,31
Cowdenbeath,1445,10,5,10,21,27,55,-28,25
Montrose,1446,1,24,7,5,61,35,26,79
Peterhead,1446,2,24,4,8,83,39,44,76
Stirling,1446,3,17,6,13,64,54,10,57
Stenhousem'r,1446,4,15,8,13,58,50,8,53
Clyde,1446,5,14,10,12,52,49,3,52
Elgin,1446,6,14,6,16,54,62,-8,48
Annan Athlet,1446,7,12,11,13,49,41,8,47
Berwick,1446,8,8,11,17,30,59,-29,35
Edinburgh Ci,1446,9,7,9,20,37,66,-29,30
Cowdenbeath,1446,10,4,10,22,23,56,-33,22
Montrose,1447,1,23,8,5,60,35,25,77
Peterhead,1447,2,24,4,8,81,41,40,76
Stenhousem'r,1447,3,16,8,12,57,46,11,56
Stirling,1447,4,16,6,14,60,53,7,54
Clyde,1447,5,15,9,12,55,49,6,54
Elgin,1447,6,14,7,15,54,61,-7,49
Annan Athlet,1447,7,11,12,13,48,42,6,45
Berwick,1447,8,8,10,18,30,62,-32,34
Edinburgh Ci,1447,9,7,9,20,39,64,-25,30
Cowdenbeath,1447,10,4,11,21,24,55,-31,23
Montrose,1448,1,24,7,5,61,35,26,79
Peterhead,1448,2,23,5,8,77,38,39,74
Stirling,1448,3,17,6,13,63,51,12,57
Stenhousem'r,1448,4,15,8,13,55,49,6,53
Clyde,1448,5,14,9,13,52,50,2,51
Elgin,1448,6,14,6,16,54,62,-8,48
Annan Athlet,1448,7,11,11,14,47,42,5,44
Berwick,1448,8,9,10,17,31,59,-28,37
Edinburgh Ci,1448,9,7,10,19,36,60,-24,31
Cowdenbeath,1448,10,5,10,21,24,54,-30,25
Montrose,1449,1,23,7,6,59,35,24,76
Peterhead,1449,2,23,5,8,77,38,39,74
Stirling,1449,3,17,6,13,62,52,10,57
Stenhousem'r,1449,4,15,8,13,56,48,8,53
Clyde,1449,5,14,9,13,52,50,2,51
Elgin,1449,6,15,6,15,54,60,-6,51
Annan Athlet,1449,7,11,11,14,47,43,4,44
Berwick,1449,8,9,10,17,31,59,-28,37
Edinburgh Ci,1449,9,7,10,19,36,60,-24,31
Cowdenbeath,1449,10,5,10,21,25,54,-29,25
Montrose,1450,1,24,7,5,60,34,26,79
Peterhead,1450,2,24,4,8,78,38,40,76
Stenhousem'r,1450,3,16,8,12,57,47,10,56
Stirling,1450,4,16,6,14,61,53,8,54
Clyde,1450,5,14,10,12,51,48,3,52
Elgin,1450,6,14,6,16,53,61,-8,48
Annan Athlet,1450,7,11,12,13,48,42,6,45
Berwick,1450,8,8,11,17,29,58,-29,35
Edinburgh Ci,1450,9,7,9,20,36,61,-25,30
Cowdenbeath,1450,10,4,11,21,24,55,-31,23
Montrose,1451,1,23,8,5,61,36,25,77
Peterhead,1451,2,24,4,8,79,38,41,76
Stenhousem'r,1451,3,16,8,12,59,46,13,56
Stirling,1451,4,16,6,14,60,55,5,54
Clyde,1451,5,14,10,12,52,49,3,52
Elgin,1451,6,14,7,15,55,62,-7,49
Annan Athlet,1451,7,12,11,13,48,41,7,47
Berwick,1451,8,8,11,17,30,59,-29,35
Edinburgh Ci,1451,9,7,9,20,36,62,-26,30
Cowdenbeath,1451,10,4,10,22,23,55,-32,22
Montrose,1452,1,24,7,5,63,34,29,79
Peterhead,1452,2,24,4,8,83,38,45,76
Stirling,1452,3,17,6,13,63,52,11,57
Stenhousem'r,1452,4,15,8,13,56,49,7,53
Clyde,1452,5,14,10,12,52,49,3,52
Elgin,1452,6,14,6,16,53,64,-11,48
Annan Athlet,1452,7,11,12,13,47,41,6,45
Berwick,1452,8,8,11,17,30,59,-29,35
Edinburgh Ci,1452,9,7,9,20,36,66,-30,30
Cowdenbeath,1452,10,4,11,21,23,54,-31,23
Montrose,1453,1,24,7,5,63,34,29,79
Peterhead,1453,2,24,4,8,81,38,43,76
Stirling,1453,3,17,6,13,61,51,10,57
Stenhousem'r,1453,4,15,8,13,55,47,8,53
Clyde,1453,5,14,9,13,51,49,2,51
Elgin,1453,6,14,6,16,53,64,-11,48
Annan Athlet,1453,7,12,11,13,49,41,8,47
Berwick,1453,8,9,10,17,30,58,-28,37
Edinburgh Ci,1453,9,7,9,20,36,64,-28,30
Cowdenbeath,1453,10,4,10,22,23,56,-33,22
Montrose,1454,1,23,8,5,61,36,25,77
Peterhead,1454,2,24,4,8,80,38,42,76
Stenhousem'r,1454,3,16,8,12,56,46,10,56
Stirling,1454,4,16,6,14,60,52,8,54
Clyde,1454,5,14,10,12,52,49,3,52
Elgin,1454,6,14,7,15,55,62,-7,49
Annan Athlet,1454,7,12,11,13,49,42,7,47
Berwick,1454,8,8,11,17,30,59,-29,35
Edinburgh Ci,1454,9,7,9,20,36,63,-27,30
Cowdenbeath,1454,10,4,10,22,24,56,-32,22
Montrose,1455,1,24,7,5,61,35,26,79
Peterhead,1455,2,24,4,8,78,38,40,76
Stirling,1455,3,17,6,13,63,53,10,57
Clyde,1455,4,15,9,12,53,48,5,54
Stenhousem'r,1455,5,15,8,13,57,49,8,53
Elgin,1455,6,14,6,16,54,62,-8,48
Annan Athlet,1455,7,11,12,13,47,41,6,45
Berwick,1455,8,8,10,18,29,60,-31,34
Edinburgh Ci,1455,9,7,9,20,36,61,-25,30
Cowdenbeath,1455,10,4,11,21,23,54,-31,23
Peterhead,1456,1,24,4,8,82,40,42,76
Montrose,1456,2,23,7,6,62,38,24,76
Stirling,1456,3,17,6,13,64,51,13,57
Stenhousem'r,1456,4,15,8,13,55,50,5,53
Clyde,1456,5,14,9,13,51,49,2,51
Elgin,1456,6,15,6,15,57,63,-6,51
Annan Athlet,1456,7,11,11,14,47,42,5,44
Berwick,1456,8,9,10,17,30,58,-28,37
Edinburgh Ci,1456,9,7,9,20,38,65,-27,30
Cowdenbeath,1456,10,5,10,21,24,54,-30,25
Montrose,1457,1,24,7,5,61,35,26,79
Peterhead,1457,2,24,4,8,78,38,40,76
Stirling,1457,3,17,6,13,65,51,14,57
Stenhousem'r,1457,4,15,8,13,55,51,4,53
Clyde,1457,5,14,10,12,51,48,3,52
Elgin,1457,6,14,6,16,54,62,-8,48
Annan Athlet,1457,7,12,11,13,48,41,7,47
Berwick,1457,8,8,11,17,29,58,-29,35
Edinburgh Ci,1457,9,7,9,20,36,61,-25,30
Cowdenbeath,1457,10,4,10,22,23,55,-32,22
Montrose,1458,1,24,7,5,61,34,27,79
Peterhead,1458,2,23,4,9,78,40,38,73
Stirling,1458,3,17,6,13,62,52,10,57
Clyde,1458,4,15,9,12,54,48,6,54
Stenhousem'r,1458,5,15,8,13,56,48,8,53
Elgin,1458,6,14,6,16,53,62,-9,48
Annan Athlet,1458,7,11,11,14,49,44,5,44
Berwick,1458,8,8,10,18,29,61,-32,34
Edinburgh Ci,1458,9,8,9,19,38,61,-23,33
Cowdenbeath,1458,10,5,10,21,26,56,-30,25
Peterhead,1459,1,24,4,8,81,40,41,76
Montrose,1459,2,23,7,6,61,37,24,76
Stenhousem'r,1459,3,16,8,12,57,47,10,56
Stirling,1459,4,16,6,14,61,53,8,54
Clyde,1459,5,15,9,12,53,48,5,54
Elgin,1459,6,15,6,15,56,62,-6,51
Annan Athlet,1459,7,11,12,13,47,41,6,45
Berwick,1459,8,8,10,18,29,60,-31,34
Edinburgh Ci,1459,9,7,9,20,38,64,-26,30
Cowdenbeath,1459,10,4,11,21,23,54,-31,23
Montrose,1460,1,24,7,5,61,35,26,79
Peterhead,1460,2,23,4,9,78,40,38,73
Stirling,1460,3,16,7,13,60,51,9,55
Stenhousem'r,1460,4,15,9,12,55,46,9,54
Clyde,1460,5,15,9,12,52,48,4,54
Elgin,1460,6,14,6,16,54,62,-8,48
Annan Athlet,1460,7,12,11,13,49,41,8,47
Berwick,1460,8,8,10,18,29,59,-30,34
Edinburgh Ci,1460,9,8,9,19,38,61,-23,33
Cowdenbeath,1460,10,4,10,22,23,56,-33,22
Montrose,1461,1,24,7,5,61,34,27,79
Peterhead,1461,2,23,4,9,78,40,38,73
Stenhousem'r,1461,3,16,8,12,57,47,10,56
Stirling,1461,4,16,6,14,61,53,8,54
Clyde,1461,5,15,9,12,53,49,4,54
Elgin,1461,6,14,6,16,53,62,-9,48
Annan Athlet,1461,7,12,11,13,50,43,7,47
Berwick,1461,8,8,10,18,30,60,-30,34
Edinburgh Ci,1461,9,8,9,19,38,61,-23,33
Cowdenbeath,1461,10,4,10,22,25,57,-32,22
Peterhead,1462,1,24,4,8,80,38,42,76
Montrose,1462,2,23,7,6,62,38,24,76
Stirling,1462,3,16,7,13,60,51,9,55
Stenhousem'r,1462,4,15,9,12,55,46,9,54
Clyde,1462,5,14,10,12,52,49,3,52
Elgin,1462,6,15,6,15,57,63,-6,51
Annan Athlet,1462,7,12,11,13,48,41,7,47
Berwick,1462,8,8,11,17,30,59,-29,35
Edinburgh Ci,1462,9,7,9,20,36,63,-27,30
Cowdenbeath,1462,10,4,10,22,23,55,-32,22
Montrose,1463,1,24,7,5,61,34,27,79
Peterhead,1463,2,24,4,8,79,38,41,76
Stirling,1463,3,16,7,13,62,53,9,55
Stenhousem'r,1463,4,15,9,12,57,48,9,54
Clyde,1463,5,14,9,13,52,50,2,51
Elgin,1463,6,14,6,16,53,62,-9,48
Annan Athlet,1463,7,12,11,13,48,41,7,47
Berwick,1463,8,9,10,17,31,59,-28,37
Edinburgh Ci,1463,9,7,9,20,36,62,-26,30
Cowdenbeath,1463,10,4,10,22,23,55,-32,22
Montrose,1464,1,23,7,6,59,35,24,76
Peterhead,1464,2,23,4,9,78,40,38,73
Stirling,1464,3,16,7,13,62,53,9,55
Stenhousem'r,1464,4,15,9,12,57,48,9,54
Clyde,1464,5,15,9,12,54,49,5,54
Elgin,1464,6,15,6,15,54,60,-6,51
Annan Athlet,1464,7,12,11,13,49,41,8,47
Berwick,1464,8,8,10,18,30,61,-31,34
Edinburgh Ci,1464,9,8,9,19,38,61,-23,33
Cowdenbeath,1464,10,4,10,22,23,56,-33,22
Montrose,1465,1,24,7,5,60,34,26,79
Peterhead,1465,2,24,4,8,79,39,40,76
Stirling,1465,3,17,6,13,64,52,12,57
Stenhousem'r,1465,4,15,8,13,56,50,6,53
Clyde,1465,5,14,10,12,51,48,3,52
Elgin,1465,6,14,6,16,53,61,-8,48
Annan Athlet,1465,7,11,12,13,47,41,6,45
Berwick,1465,8,8,11,17,29,58,-29,35
Edinburgh Ci,1465,9,7,9,20,37,62,-25,30
Cowdenbeath,1465,10,4,11,21,23,54,-31,23
Montrose,1466,1,24,7,5,60,34,26,79
Peterhead,1466,2,24,4,8,80,38,42,76
Stirling,1466,3,16,7,13,61,52,9,55
Stenhousem'r,1466,4,15,9,12,56,47,9,54
Clyde,1466,5,15,9,12,54,49,5,54
Elgin,1466,6,14,6,16,53,61,-8,48
Annan Athlet,1466,7,12,11,13,48,41,7,47
Berwick,1466,8,8,10,18,30,61,-31,34
Edinburgh Ci,1466,9,7,9,20,36,63,-27,30
Cowdenbeath,1466,10,4,10,22,23,55,-32,22
Montrose,1467,1,24,7,5,62,34,28,79
Peterhead,1467,2,23,5,8,78,39,39,74
Stirling,1467,3,17,6,13,65,52,13,57
Clyde,1467,4,15,9,12,54,48,6,54
Stenhousem'r,1467,5,15,8,13,56,51,5,53
Elgin,1467,6,14,6,16,53,63,-10,48
Annan Athlet,1467,7,11,11,14,47,42,5,44
Berwick,1467,8,8,10,18,29,61,-32,34
Edinburgh Ci,1467,9,7,10,19,37,61,-24,31
Cowdenbeath,1467,10,5,10,21,24,54,-30,25
Montrose,1468,1,24,7,5,62,35,27,79
Peterhead,1468,2,24,4,8,80,39,41,76
Stenhousem'r,1468,3,16,8,12,58,48,10,56
Stirling,1468,4,16,6,14,62,54,8,54
Clyde,1468,5,14,9,13,51,50,1,51
Elgin,1468,6,14,6,16,54,63,-9,48
Annan Athlet,1468,7,11,12,13,48,42,6,45
Berwick,1468,8,9,10,17,31,58,-27,37
Edinburgh Ci,1468,9,7,9,20,37,63,-26,30
Cowdenbeath,1468,10,4,11,21,24,55,-31,23
Montrose,1469,1,24,7,5,62,34,28,79
Peterhead,1469,2,23,5,8,79,40,39,74
Stirling,1469,3,17,6,13,61,51,10,57
Stenhousem'r,1469,4,15,8,13,55,47,8,53
Clyde,1469,5,14,9,13,52,51,1,51
Elgin,1469,6,14,6,16,53,63,-10,48
Annan Athlet,1469,7,12,11,13,48,41,7,47
Berwick,1469,8,9,10,17,32,59,-27,37
Edinburgh Ci,1469,9,7,10,19,38,62,-24,31
Cowdenbeath,1469,10,4,10,22,23,55,-32,22
Montrose,1470,1,24,7,5,62,34,28,79
Peterhead,1470,2,24,4,8,82,40,42,76
Stirling,1470,3,16,7,13,61,52,9,55
Stenhousem'r,1470,4,15,9,12,56,47,9,54
Clyde,1470,5,15,9,12,53,48,5,54
Elgin,1470,6,14,6,16,53,63,-10,48
Annan Athlet,1470,7,11,12,13,49,43,6,45
Berwick,1470,8,8,10,18,29,60,-31,34
Edinburgh Ci,1470,9,7,9,20,38,65,-27,30
Cowdenbeath,1470,10,4,11,21,25,56,-31,23
Peterhead,1471,1,24,4,8,79,39,40,76
Montrose,1471,2,23,7,6,59,35,24,76
Stirling,1471,3,16,7,13,64,55,9,55
Stenhousem'r,1471,4,15,9,12,59,50,9,54
Clyde,1471,5,15,9,12,53,48,5,54
Elgin,1471,6,15,6,15,54,60,-6,51
Annan Athlet,1471,7,11,12,13,48,42,6,45
Berwick,1471,8,8,10,18,29,60,-31,34
Edinburgh Ci,1471,9,7,9,20,37,62,-25,30
Cowdenbeath,1471,10,4,11,21,24,55,-31,23
Montrose,1472,1,24,7,5,62,35,27,79
Peterhead,1472,2,23,4,9,77,40,37,73
Stirling,1472,3,17,6,13,64,53,11,57
Clyde,1472,4,15,9,12,52,48,4,54
Stenhousem'r,1472,5,15,8,13,57,50,7,53
Elgin,1472,6,14,6,16,54,63,-9,48
Annan Athlet,1472,7,11,11,14,47,43,4,44
Berwick,1472,8,8,10,18,29,59,-30,34
Edinburgh Ci,1472,9,8,9,19,38,60,-22,33
Cowdenbeath,1472,10,5,10,21,25,54,-29,25
Montrose,1473,1,24,7,5,60,34,26,79
Peterhead,1473,2,24,4,8,79,38,41,76
Stenhousem'r,1473,3,16,8,12,56,46,10,56
Stirling,1473,4,16,6,14,60,52,8,54
Clyde,1473,5,14,9,13,51,49,2,51
Elgin,1473,6,14,6,16,53,61,-8,48
Annan Athlet,1473,7,11,12,13,47,41,6,45
Berwick,1473,8,9,10,17,30,58,-28,37
Edinburgh Ci,1473,9,7,9,20,36,62,-26,30
Cowdenbeath,1473,10,4,11,21,23,54,-31,23
Montrose,1474,1,24,7,5,62,34,28,79
Peterhead,1474,2,24,4,8,79,38,41,76
Stirling,1474,3,17,6,13,61,51,10,57
Clyde,1474,4,15,9,12,55,48,7,54
Stenhousem'r,1474,5,15,8,13,55,47,8,53
Elgin,1474,6,14,6,16,53,63,-10,48
Annan Athlet,1474,7,11,11,14,48,43,5,44
Berwick,1474,8,8,10,18,29,62,-33,34
Edinburgh Ci,1474,9,7,9,20,36,62,-26,30
Cowdenbeath,1474,10,5,10,21,25,55,-30,25
Montrose,1475,1,24,7,5,60,34,26,79
Peterhead,1475,2,24,4,8,78,38,40,76
Stirling,1475,3,16,7,13,61,52,9,55
Stenhousem'r,1475,4,15,9,12,56,47,9,54
Clyde,1475,5,15,9,12,53,48,5,54
Elgin,1475,6,14,6,16,53,61,-8,48
Annan Athlet,1475,7,12,11,13,48,41,7,47
Berwick,1475,8,8,10,18,29,60,-31,34
Edinburgh Ci,1475,9,7,9,20,36,61,-25,30
Cowdenbeath,1475,10,4,10,22,23,55,-32,22
Montrose,1476,1,24,7,5,62,36,26,79
Peterhead,1476,2,24,4,8,81,39,42,76
Stirling,1476,3,17,6,13,62,51,11,57
Clyde,1476,4,15,9,12,54,49,5,54
Stenhousem'r,1476,5,15,8,13,55,48,7,53
Elgin,1476,6,14,6,16,55,63,-8,48
Annan Athlet,1476,7,12,11,13,48,41,7,47
Berwick,1476,8,8,10,18,30,61,-31,34
Edinburgh Ci,1476,9,7,9,20,37,64,-27,30
Cowdenbeath,1476,10,4,10,22,23,55,-32,22
Montrose,1477,1,24,7,5,61,35,26,79
Peterhead,1477,2,24,4,8,81,39,42,76
Stirling,1477,3,17,6,13,62,52,10,57
Stenhousem'r,1477,4,15,8,13,56,48,8,53
Clyde,1477,5,14,9,13,52,50,2,51
Elgin,1477,6,14,6,16,54,62,-8,48
Annan Athlet,1477,7,11,11,14,48,44,4,44
Berwick,1477,8,9,10,17,31,59,-28,37
Edinburgh Ci,1477,9,7,9,20,37,64,-27,30
Cowdenbeath,1477,10,5,10,21,26,55,-29,25
Montrose,1478,1,24,7,5,63,34,29,79
Peterhead,1478,2,24,4,8,80,38,42,76
Stirling,1478,3,16,7,13,62,53,9,55
Stenhousem'r,1478,4,15,9,12,57,48,9,54
Clyde,1478,5,14,10,12,52,49,3,52
Elgin,1478,6,14,6,16,53,64,-11,48
Annan Athlet,1478,7,11,11,14,48,43,5,44
Berwick,1478,8,8,11,17,30,59,-29,35
Edinburgh Ci,1478,9,7,9,20,36,63,-27,30
Cowdenbeath,1478,10,5,10,21,25,55,-30,25
Montrose,1479,1,24,7,5,62,34,28,79
Peterhead,1479,2,24,4,8,81,38,43,76
Stirling,1479,3,17,6,13,63,53,10,57
Stenhousem'r,1479,4,15,8,13,57,49,8,53
Clyde,1479,5,14,9,13,51,49,2,51
Elgin,1479,6,14,6,16,53,63,-10,48
Annan Athlet,1479,7,11,11,14,47,42,5,44
Berwick,1479,8,9,10,17,30,58,-28,37
Edinburgh Ci,1479,9,7,9,20,36,64,-28,30
Cowdenbeath,1479,10,5,10,21,24,54,-30,25
Montrose,1480,1,24,7,5,60,34,26,79
Peterhead,1480,2,24,4,8,78,38,40,76
Stirling,1480,3,17,6,13,62,51,11,57
Stenhousem'r,1480,4,15,8,13,55,48,7,53
Clyde,1480,5,14,10,12,51,48,3,52
Elgin,1480,6,14,6,16,53,61,-8,48
Annan Athlet,1480,7,11,11,14,48,43,5,44
Berwick,1480,8,8,11,17,29,58,-29,35
Edinburgh Ci,1480,9,7,9,20,36,61,-25,30
Cowdenbeath,1480,10,5,10,21,25,55,-30,25
Montrose,1481,1,24,7,5,63,35,28,79
Peterhead,1481,2,24,4,8,80,38,42,76
Stirling,1481,3,17,6,13,63,53,10,57
Clyde,1481,4,15,9,12,53,49,4,54
Stenhousem'r,1481,5,15,8,13,57,49,8,53
Elgin,1481,6,14,6,16,54,64,-10,48
Annan Athlet,1481,7,11,12,13,47,41,6,45
Berwick,1481,8,8,10,18,30,60,-30,34
Edinburgh Ci,1481,9,7,9,20,36,63,-27,30
Cowdenbeath,1481,10,4,11,21,23,54,-31,23
Montrose,1482,1,24,7,5,63,34,29,79
Peterhead,1482,2,24,4,8,79,39,40,76
Stenhousem'r,1482,3,16,8,12,57,47,10,56
Stirling,1482,4,16,6,14,61,53,8,54
Clyde,1482,5,15,9,12,53,49,4,54
Elgin,1482,6,14,6,16,53,64,-11,48
Annan Athlet,1482,7,11,11,14,48,43,5,44
Berwick,1482,8,8,10,18,30,60,-30,34
Edinburgh Ci,1482,9,7,9,20,37,62,-25,30
Cowdenbeath,1482,10,5,10,21,25,55,-30,25
Montrose,1483,1,24,7,5,60,34,26,79
Peterhead,1483,2,24,4,8,80,38,42,76
Stirling,1483,3,17,6,13,64,51,13,57
Clyde,1483,4,15,9,12,55,49,6,54
Stenhousem'r,1483,5,15,8,13,55,50,5,53
Elgin,1483,6,14,6,16,53,61,-8,48
Annan Athlet,1483,7,11,11,14,48,43,5,44
Berwick,1483,8,8,10,18,30,62,-32,34
Edinburgh Ci,1483,9,7,9,20,36,63,-27,30
Cowdenbeath,1483,10,5,10,21,25,55,-30,25
Montrose,1484,1,24,7,5,62,36,26,79
Peterhead,1484,2,24,4,8,82,40,42,76
Stenhousem'r,1484,3,16,8,12,57,46,11,56
Stirling,1484,4,16,6,14,60,53,7,54
Clyde,1484,5,15,9,12,55,48,7,54
Elgin,1484,6,14,6,16,55,63,-8,48
Annan Athlet,1484,7,11,12,13,48,42,6,45
Berwick,1484,8,8,10,18,29,62,-33,34
Edinburgh Ci,1484,9,7,9,20,38,65,-27,30
Cowdenbeath,1484,10,4,11,21,24,55,-31,23
Peterhead,1485,1,24,4,8,80,38,42,76
Montrose,1485,2,23,7,6,60,37,23,76
Stirling,1485,3,17,6,13,62,52,10,57
Clyde,1485,4,15,9,12,56,51,5,54
Stenhousem'r,1485,5,15,8,13,56,48,8,53
Elgin,1485,6,15,6,15,56,61,-5,51
Annan Athlet,1485,7,12,11,13,50,42,8,47
Berwick,1485,8,8,10,18,32,63,-31,34
Edinburgh Ci,1485,9,7,9,20,36,63,-27,30
Cowdenbeath,1485,10,4,10,22,24,57,-33,22
Montrose,1486,1,24,7,5,61,35,26,79
Peterhead,1486,2,24,4,8,80,38,42,76
Stirling,1486,3,17,6,13,63,53,10,57
Clyde,1486,4,15,9,12,52,48,4,54
Stenhousem'r,1486,5,15,8,13,57,49,8,53
Elgin,1486,6,14,6,16,54,62,-8,48
Annan Athlet,1486,7,12,11,13,49,41,8,47
Berwick,1486,8,8,10,18,29,59,-30,34
Edinburgh Ci,1486,9,7,9,20,36,63,-27,30
Cowdenbeath,1486,10,4,10,22,23,56,-33,22
Peterhead,1487,1,24,4,8,80,39,41,76
Montrose,1487,2,23,7,6,60,37,23,76
Stenhousem'r,1487,3,16,8,12,58,46,12,56
Stirling,1487,4,16,6,14,60,54,6,54
Clyde,1487,5,15,9,12,53,48,5,54
Elgin,1487,6,15,6,15,56,61,-5,51
Annan Athlet,1487,7,12,11,13,48,41,7,47
Berwick,1487,8,8,10,18,29,60,-31,34
Edinburgh Ci,1487,9,7,9,20,37,63,-26,30
Cowdenbeath,1487,10,4,10,22,23,55,-32,22
Montrose,1488,1,24,7,5,61,34,27,79
Peterhead,1488,2,24,4,8,80,39,41,76
Stenhousem'r,1488,3,16,8,12,57,46,11,56
Stirling,1488,4,16,6,14,60,53,7,54
Clyde,1488,5,15,9,12,52,48,4,54
Elgin,1488,6,14,6,16,53,62,-9,48
Annan Athlet,1488,7,11,11,14,48,43,5,44
Berwick,1488,8,8,10,18,29,59,-30,34
Edinburgh Ci,1488,9,7,9,20,37,63,-26,30
Cowdenbeath,1488,10,5,10,21,25,55,-30,25
Peterhead,1489,1,24,4,8,79,38,41,76
Montrose,1489,2,23,7,6,60,36,24,76
Stirling,1489,3,17,6,13,63,53,10,57
Stenhousem'r,1489,4,15,8,13,57,49,8,53
Clyde,1489,5,14,9,13,52,50,2,51
Elgin,1489,6,15,6,15,55,61,-6,51
Annan Athlet,1489,7,11,11,14,47,44,3,44
Berwick,1489,8,9,10,17,31,59,-28,37
Edinburgh Ci,1489,9,7,9,20,36,62,-26,30
Cowdenbeath,1489,10,5,10,21,26,54,-28,25
Montrose,1490,1,23,8,5,60,35,25,77
Peterhead,1490,2,23,4,9,77,39,38,73
Stirling,1490,3,17,6,13,61,51,10,57
Stenhousem'r,1490,4,15,8,13,55,47,8,53
Clyde,1490,5,14,9,13,52,50,2,51
Elgin,1490,6,14,7,15,54,61,-7,49
Annan Athlet,1490,7,12,11,13,49,41,8,47
Berwick,1490,8,9,10,17,31,59,-28,37
Edinburgh Ci,1490,9,8,9,19,37,60,-23,33
Cowdenbeath,1490,10,4,10,22,23,56,-33,22
Montrose,1491,1,24,7,5,61,35,26,79
Peterhead,1491,2,23,5,8,77,38,39,74
Stenhousem'r,1491,3,16,8,12,57,47,10,56
Stirling,1491,4,16,6,14,61,53,8,54
Clyde,1491,5,14,9,13,51,49,2,51
Elgin,1491,6,14,6,16,54,62,-8,48
Annan Athlet,1491,7,11,12,13,48,42,6,45
Berwick,1491,8,9,10,17,30,58,-28,37
Edinburgh Ci,1491,9,7,10,19,36,60,-24,31
Cowdenbeath,1491,10,4,11,21,24,55,-31,23
Montrose,1492,1,24,7,5,62,34,28,79
Peterhead,1492,2,23,5,8,78,39,39,74
Stirling,1492,3,16,7,13,62,53,9,55
Stenhousem'r,1492,4,15,9,12,57,48,9,54
Clyde,1492,5,15,9,12,54,50,4,54
Elgin,1492,6,14,6,16,53,63,-10,48
Annan Athlet,1492,7,11,11,14,48,43,5,44
Berwick,1492,8,8,10,18,31,61,-30,34
Edinburgh Ci,1492,9,7,10,19,37,61,-24,31
Cowdenbeath,1492,10,5,10,21,25,55,-30,25
Montrose,1493,1,24,7,5,64,35,29,79
Peterhead,1493,2,23,5,8,81,42,39,74
Stirling,1493,3,17,6,13,64,52,12,57
Stenhousem'r,1493,4,15,8,13,56,50,6,53
Clyde,1493,5,14,10,12,53,50,3,52
Elgin,1493,6,14,6,16,54,65,-11,48
Annan Athlet,1493,7,12,11,13,50,42,8,47
Berwick,1493,8,8,11,17,31,60,-29,35
Edinburgh Ci,1493,9,7,10,19,40,64,-24,31
Cowdenbeath,1493,10,4,10,22,24,57,-33,22
Peterhead,1494,1,24,4,8,78,38,40,76
Montrose,1494,2,23,7,6,60,36,24,76
Stenhousem'r,1494,3,16,8,12,58,47,11,56
Stirling,1494,4,16,6,14,61,54,7,54
Clyde,1494,5,15,9,12,54,50,4,54
Elgin,1494,6,15,6,15,55,61,-6,51
Annan Athlet,1494,7,11,11,14,48,43,5,44
Berwick,1494,8,8,10,18,31,61,-30,34
Edinburgh Ci,1494,9,7,9,20,36,61,-25,30
Cowdenbeath,1494,10,5,10,21,25,55,-30,25
Montrose,1495,1,24,7,5,61,35,26,79
Peterhead,1495,2,23,5,8,78,39,39,74
Stirling,1495,3,17,6,13,63,51,12,57
Clyde,1495,4,15,9,12,54,48,6,54
Stenhousem'r,1495,5,15,8,13,55,49,6,53
Elgin,1495,6,14,6,16,54,62,-8,48
Annan Athlet,1495,7,11,12,13,48,42,6,45
Berwick,1495,8,8,10,18,29,61,-32,34
Edinburgh Ci,1495,9,7,10,19,37,61,-24,31
Cowdenbeath,1495,10,4,11,21,24,55,-31,23
Montrose,1496,1,24,7,5,63,35,28,79
Peterhead,1496,2,24,4,8,79,39,40,76
Stirling,1496,3,17,6,13,64,54,10,57
Stenhousem'r,1496,4,15,8,13,58,50,8,53
Clyde,1496,5,14,10,12,51,48,3,52
Elgin,1496,6,14,6,16,54,64,-10,48
Annan Athlet,1496,7,11,11,14,47,43,4,44
Berwick,1496,8,8,11,17,29,58,-29,35
Edinburgh Ci,1496,9,7,9,20,37,62,-25,30
Cowdenbeath,1496,10,5,10,21,25,54,-29,25
Montrose,1497,1,24,7,5,61,34,27,79
Peterhead,1497,2,23,5,8,79,40,39,74
Stirling,1497,3,16,7,13,61,52,9,55
Stenhousem'r,1497,4,15,9,12,56,47,9,54
Clyde,1497,5,15,9,12,52,48,4,54
Elgin,1497,6,14,6,16,53,62,-9,48
Annan Athlet,1497,7,11,11,14,47,42,5,44
Berwick,1497,8,8,10,18,29,59,-30,34
Edinburgh Ci,1497,9,7,10,19,38,62,-24,31
Cowdenbeath,1497,10,5,10,21,24,54,-30,25
Montrose,1498,1,23,8,5,60,35,25,77
Peterhead,1498,2,23,5,8,77,38,39,74
Stirling,1498,3,17,6,13,66,53,13,57
Stenhousem'r,1498,4,15,8,13,57,52,5,53
Clyde,1498,5,14,10,12,51,48,3,52
Elgin,1498,6,14,7,15,54,61,-7,49
Annan Athlet,1498,7,11,11,14,47,43,4,44
Berwick,1498,8,8,11,17,29,58,-29,35
Edinburgh Ci,1498,9,7,10,19,36,60,-24,31
Cowdenbeath,1498,10,5,10,21,25,54,-29,25
Montrose,1499,1,24,7,5,60,34,26,79
Peterhead,1499,2,23,4,9,78,40,38,73
Stirling,1499,3,17,6,13,63,52,11,57
Stenhousem'r,1499,4,15,8,13,56,49,7,53
Clyde,1499,5,14,10,12,52,49,3,52
Elgin,1499,6,14,6,16,53,61,-8,48
Annan Athlet,1499,7,11,11,14,47,42,5,44
Berwick,1499,8,8,11,17,30,59,-29,35
Edinburgh Ci,1499,9,8,9,19,38,61,-23,33
Cowdenbeath,1499,10,5,10,21,24,54,-30,25
Montrose,1500,1,24,7,5,62,36,26,79
Peterhead,1500,2,24,4,8,80,38,42,76
Stenhousem'r,1500,3,16,8,12,58,47,11,56
Stirling,1500,4,16,6,14,61,54,7,54
Clyde,1500,5,15,9,12,55,51,4,54
Elgin,1500,6,14,6,16,55,63,-8,48
Annan Athlet,1500,7,12,11,13,48,41,7,47
Berwick,1500,8,8,10,18,32,62,-30,34
Edinburgh Ci,1500,9,7,9,20,36,63,-27,30
Cowdenbeath,1500,10,4,10,22,23,55,-32,22
Montrose,1501,1,23,8,5,61,36,25,77
Peterhead,1501,2,24,4,8,79,39,40,76
Stirling,1501,3,17,6,13,62,52,10,57
Clyde,1501,4,15,9,12,53,48,5,54
Stenhousem'r,1501,5,15,8,13,56,48,8,53
Elgin,1501,6,14,7,15,55,62,-7,49
Annan Athlet,1501,7,12,11,13,48,41,7,47
Berwick,1501,8,8,10,18,29,60,-31,34
Edinburgh Ci,1501,9,7,9,20,37,62,-25,30
Cowdenbeath,1501,10,4,10,22,23,55,-32,22
Montrose,1502,1,24,7,5,62,35,27,79
Peterhead,1502,2,24,4,8,81,41,40,76
Stenhousem'r,1502,3,16,8,12,59,48,11,56
Stirling,1502,4,16,6,14,62,55,7,54
Clyde,1502,5,14,10,12,52,49,3,52
Elgin,1502,6,14,6,16,54,63,-9,48
Annan Athlet,1502,7,11,11,14,47,43,4,44
Berwick,1502,8,8,11,17,30,59,-29,35
Edinburgh Ci,1502,9,7,9,20,39,64,-25,30
Cowdenbeath,1502,10,5,10,21,25,54,-29,25
Peterhead,1503,1,24,4,8,78,38,40,76
Montrose,1503,2,23,7,6,59,36,23,76
Stirling,1503,3,16,7,13,61,52,9,55
Stenhousem'r,1503,4,15,9,12,56,47,9,54
Clyde,1503,5,14,9,13,53,51,2,51
Elgin,1503,6,15,6,15,55,60,-5,51
Annan Athlet,1503,7,11,11,14,47,42,5,44
Berwick,1503,8,9,10,17,32,60,-28,37
Edinburgh Ci,1503,9,7,9,20,36,61,-25,30
Cowdenbeath,1503,10,5,10,21,24,54,-30,25
Montrose,1504,1,23,8,5,61,36,25,77
Peterhead,1504,2,24,4,8,80,40,40,76
Stirling,1504,3,17,6,13,66,52,14,57
Stenhousem'r,1504,4,15,8,13,56,52,4,53
Clyde,1504,5,14,9,13,52,50,2,51
Elgin,1504,6,14,7,15,55,62,-7,49
Annan Athlet,1504,7,11,11,14,47,42,5,44
Berwick,1504,8,9,10,17,31,59,-28,37
Edinburgh Ci,1504,9,7,9,20,38,63,-25,30
Cowdenbeath,1504,10,5,10,21,24,54,-30,25
Montrose,1505,1,24,7,5,62,34,28,79
Peterhead,1505,2,24,4,8,79,38,41,76
Stirling,1505,3,16,7,13,61,52,9,55
Stenhousem'r,1505,4,15,9,12,56,47,9,54
Clyde,1505,5,15,9,12,53,48,5,54
Elgin,1505,6,14,6,16,53,63,-10,48
Annan Athlet,1505,7,11,12,13,48,42,6,45
Berwick,1505,8,8,10,18,29,60,-31,34
Edinburgh Ci,1505,9,7,9,20,36,62,-26,30
Cowdenbeath,1505,10,4,11,21,24,55,-31,23
Montrose,1506,1,24,7,5,62,36,26,79
Peterhead,1506,2,23,5,8,78,39,39,74
Stenhousem'r,1506,3,16,8,12,58,48,10,56
Stirling,1506,4,16,6,14,62,54,8,54
Clyde,1506,5,14,9,13,52,50,2,51
Elgin,1506,6,14,6,16,55,63,-8,48
Annan Athlet,1506,7,11,11,14,47,43,4,44
Berwick,1506,8,9,10,17,31,59,-28,37
Edinburgh Ci,1506,9,7,10,19,37,61,-24,31
Cowdenbeath,1506,10,5,10,21,25,54,-29,25
Montrose,1507,1,24,7,5,61,35,26,79
Peterhead,1507,2,23,5,8,78,39,39,74
Stirling,1507,3,17,6,13,61,51,10,57
Stenhousem'r,1507,4,15,8,13,55,47,8,53
Clyde,1507,5,14,9,13,51,49,2,51
Elgin,1507,6,14,6,16,54,62,-8,48
Annan Athlet,1507,7,12,11,13,50,42,8,47
Berwick,1507,8,9,10,17,30,58,-28,37
Edinburgh Ci,1507,9,7,10,19,37,61,-24,31
Cowdenbeath,1507,10,4,10,22,24,57,-33,22
Montrose,1508,1,23,7,6,59,36,23,76
Peterhead,1508,2,23,5,8,78,39,39,74
Stirling,1508,3,17,6,13,65,53,12,57
Clyde,1508,4,15,9,12,52,48,4,54
Stenhousem'r,1508,5,15,8,13,57,51,6,53
Elgin,1508,6,15,6,15,55,60,-5,51
Annan Athlet,1508,7,11,12,13,48,42,6,45
Berwick,1508,8,8,10,18,29,59,-30,34
Edinburgh Ci,1508,9,7,10,19,37,61,-24,31
Cowdenbeath,1508,10,4,11,21,24,55,-31,23
Montrose,1509,1,24,7,5,60,34,26,79
Peterhead,1509,2,24,4,8,81,39,42,76
Stenhousem'r,1509,3,16,8,12,56,46,10,56
Stirling,1509,4,16,6,14,60,52,8,54
Clyde,1509,5,14,10,12,53,50,3,52
Elgin,1509,6,14,6,16,53,61,-8,48
Annan Athlet,1509,7,12,11,13,49,41,8,47
Berwick,1509,8,8,11,17,31,60,-29,35
Edinburgh Ci,1509,9,7,9,20,37,64,-27,30
Cowdenbeath,1509,10,4,10,22,23,56,-33,22
Montrose,1510,1,23,8,5,60,35,25,77
Peterhead,1510,2,24,4,8,78,38,40,76
Stirling,1510,3,16,7,13,60,51,9,55
Stenhousem'r,1510,4,15,9,12,55,46,9,54
Clyde,1510,5,15,9,12,55,48,7,54
Elgin,1510,6,14,7,15,54,61,-7,49
Annan Athlet,1510,7,11,12,13,48,42,6,45
Berwick,1510,8,8,10,18,29,62,-33,34
Edinburgh Ci,1510,9,7,9,20,36,61,-25,30
Cowdenbeath,1510,10,4,11,21,24,55,-31,23
Montrose,1511,1,24,7,5,62,36,26,79
Peterhead,1511,2,24,4,8,84,41,43,76
Stirling,1511,3,16,7,13,62,53,9,55
Stenhousem'r,1511,4,15,9,12,57,48,9,54
Clyde,1511,5,14,9,13,53,51,2,51
Elgin,1511,6,14,6,16,55,63,-8,48
Annan Athlet,1511,7,11,12,13,48,42,6,45
Berwick,1511,8,9,10,17,32,60,-28,37
Edinburgh Ci,1511,9,7,9,20,39,67,-28,30
Cowdenbeath,1511,10,4,11,21,24,55,-31,23
Peterhead,1512,1,24,4,8,79,39,40,76
Montrose,1512,2,23,7,6,61,37,24,76
Stirling,1512,3,17,6,13,63,51,12,57
Clyde,1512,4,15,9,12,54,50,4,54
Stenhousem'r,1512,5,15,8,13,55,49,6,53
Elgin,1512,6,15,6,15,56,62,-6,51
Annan Athlet,1512,7,12,11,13,49,41,8,47
Berwick,1512,8,8,10,18,31,61,-30,34
Edinburgh Ci,1512,9,7,9,20,37,62,-25,30
Cowdenbeath,1512,10,4,10,22,23,56,-33,22
Montrose,1513,1,24,7,5,62,35,27,79
Peterhead,1513,2,23,5,8,78,39,39,74
Stirling,1513,3,16,7,13,60,51,9,55
Stenhousem'r,1513,4,15,9,12,55,46,9,54
Clyde,1513,5,15,9,12,53,48,5,54
Elgin,1513,6,14,6,16,54,63,-9,48
Annan Athlet,1513,7,11,11,14,47,43,4,44
Berwick,1513,8,8,10,18,29,60,-31,34
Edinburgh Ci,1513,9,7,10,19,37,61,-24,31
Cowdenbeath,1513,10,5,10,21,25,54,-29,25
Peterhead,1514,1,24,4,8,81,38,43,76
Montrose,1514,2,23,7,6,60,36,24,76
Stirling,1514,3,16,7,13,61,52,9,55
Stenhousem'r,1514,4,15,9,12,56,47,9,54
Clyde,1514,5,14,10,12,53,50,3,52
Elgin,1514,6,15,6,15,55,61,-6,51
Annan Athlet,1514,7,11,11,14,50,45,5,44
Berwick,1514,8,8,11,17,31,60,-29,35
Edinburgh Ci,1514,9,7,9,20,36,64,-28,30
Cowdenbeath,1514,10,5,10,21,27,57,-30,25
Montrose,1515,1,23,8,5,60,35,25,77
Peterhead,1515,2,24,4,8,80,38,42,76
Stirling,1515,3,16,7,13,62,53,9,55
Stenhousem'r,1515,4,15,9,12,57,48,9,54
Clyde,1515,5,15,9,12,53,49,4,54
Elgin,1515,6,14,7,15,54,61,-7,49
Annan Athlet,1515,7,11,11,14,47,43,4,44
Berwick,1515,8,8,10,18,30,60,-30,34
Edinburgh Ci,1515,9,7,9,20,36,63,-27,30
Cowdenbeath,1515,10,5,10,21,25,54,-29,25
Montrose,1516,1,24,7,5,61,34,27,79
Peterhead,1516,2,24,4,8,81,39,42,76
Stirling,1516,3,16,7,13,61,52,9,55
Stenhousem'r,1516,4,15,9,12,56,47,9,54
Clyde,1516,5,15,9,12,53,49,4,54
Elgin,1516,6,14,6,16,53,62,-9,48
Annan Athlet,1516,7,11,11,14,47,42,5,44
Berwick,1516,8,8,10,18,30,60,-30,34
Edinburgh Ci,1516,9,7,9,20,37,64,-27,30
Cowdenbeath,1516,10,5,10,21,24,54,-30,25
Montrose,1517,1,24,7,5,60,34,26,79
Peterhead,1517,2,24,4,8,82,39,43,76
Stirling,1517,3,17,6,13,62,52,10,57
Stenhousem'r,1517,4,15,8,13,56,48,8,53
Clyde,1517,5,14,10,12,53,50,3,52
Elgin,1517,6,14,6,16,53,61,-8,48
Annan Athlet,1517,7,11,12,13,47,41,6,45
Berwick,1517,8,8,11,17,31,60,-29,35
Edinburgh Ci,1517,9,7,9,20,37,65,-28,30
Cowdenbeath,1517,10,4,11,21,23,54,-31,23
Montrose,1518,1,24,7,5,60,34,26,79
Peterhead,1518,2,24,4,8,80,40,40,76
Stirling,1518,3,17,6,13,64,52,12,57
Stenhousem'r,1518,4,15,8,13,56,50,6,53
Clyde,1518,5,14,10,12,51,48,3,52
Elgin,1518,6,14,6,16,53,61,-8,48
Annan Athlet,1518,7,11,12,13,48,42,6,45
Berwick,1518,8,8,11,17,29,58,-29,35
Edinburgh Ci,1518,9,7,9,20,38,63,-25,30
Cowdenbeath,1518,10,4,11,21,24,55,-31,23
Montrose,1519,1,24,7,5,66,34,32,79
Peterhead,1519,2,23,5,8,79,40,39,74
Stirling,1519,3,16,7,13,62,53,9,55
Stenhousem'r,1519,4,15,9,12,57,48,9,54
Clyde,1519,5,15,9,12,54,49,5,54
Elgin,1519,6,14,6,16,53,67,-14,48
Annan Athlet,1519,7,11,11,14,47,42,5,44
Berwick,1519,8,8,10,18,30,61,-31,34
Edinburgh Ci,1519,9,7,10,19,38,62,-24,31
Cowdenbeath,1519,10,5,10,21,24,54,-30,25
Montrose,1520,1,24,7,5,62,36,26,79
Peterhead,1520,2,23,5,8,78,39,39,74
Stirling,1520,3,17,6,13,61,51,10,57
Clyde,1520,4,15,9,12,53,48,5,54
Stenhousem'r,1520,5,15,8,13,55,47,8,53
Elgin,1520,6,14,6,16,55,63,-8,48
Annan Athlet,1520,7,11,11,14,47,42,5,44
Berwick,1520,8,8,10,18,29,60,-31,34
Edinburgh Ci,1520,9,7,10,19,37,61,-24,31
Cowdenbeath,1520,10,5,10,21,24,54,-30,25
Montrose,1521,1,23,8,5,59,34,25,77
Peterhead,1521,2,23,5,8,78,39,39,74
Stirling,1521,3,17,6,13,62,52,10,57
Clyde,1521,4,15,9,12,53,49,4,54
Stenhousem'r,1521,5,15,8,13,56,48,8,53
Elgin,1521,6,14,7,15,53,60,-7,49
Annan Athlet,1521,7,12,11,13,48,41,7,47
Berwick,1521,8,8,10,18,30,60,-30,34
Edinburgh Ci,1521,9,7,10,19,37,61,-24,31
Cowdenbeath,1521,10,4,10,22,23,55,-32,22
Montrose,1522,1,24,7,5,60,34,26,79
Peterhead,1522,2,24,4,8,79,39,40,76
Stirling,1522,3,16,7,13,61,52,9,55
Stenhousem'r,1522,4,15,9,12,56,47,9,54
Clyde,1522,5,15,9,12,55,49,6,54
Elgin,1522,6,14,6,16,53,61,-8,48
Annan Athlet,1522,7,11,12,13,48,42,6,45
Berwick,1522,8,8,10,18,30,62,-32,34
Edinburgh Ci,1522,9,7,9,20,37,62,-25,30
Cowdenbeath,1522,10,4,11,21,24,55,-31,23
Montrose,1523,1,23,8,5,61,36,25,77
Peterhead,1523,2,24,4,8,80,40,40,76
Stirling,1523,3,17,6,13,62,51,11,57
Stenhousem'r,1523,4,15,8,13,55,48,7,53
Clyde,1523,5,14,10,12,52,49,3,52
Elgin,1523,6,14,7,15,55,62,-7,49
Annan Athlet,1523,7,12,11,13,51,41,10,47
Berwick,1523,8,8,11,17,30,59,-29,35
Edinburgh Ci,1523,9,7,9,20,38,63,-25,30
Cowdenbeath,1523,10,4,10,22,23,58,-35,22
Peterhead,1524,1,24,4,8,79,39,40,76
Montrose,1524,2,23,7,6,60,36,24,76
Stirling,1524,3,16,7,13,61,52,9,55
Stenhousem'r,1524,4,15,9,12,56,47,9,54
Clyde,1524,5,15,9,12,54,49,5,54
Elgin,1524,6,15,6,15,55,61,-6,51
Annan Athlet,1524,7,12,11,13,49,41,8,47
Berwick,1524,8,8,10,18,30,61,-31,34
Edinburgh Ci,1524,9,7,9,20,37,62,-25,30
Cowdenbeath,1524,10,4,10,22,23,56,-33,22
Montrose,1525,1,24,7,5,63,35,28,79
Peterhead,1525,2,24,4,8,81,40,41,76
Stirling,1525,3,16,7,13,61,52,9,55
Stenhousem'r,1525,4,15,9,12,56,47,9,54
Clyde,1525,5,14,10,12,51,48,3,52
Elgin,1525,6,14,6,16,54,64,-10,48
Annan Athlet,1525,7,12,11,13,49,42,7,47
Berwick,1525,8,8,11,17,29,58,-29,35
Edinburgh Ci,1525,9,7,9,20,38,64,-26,30
Cowdenbeath,1525,10,4,10,22,24,56,-32,22
Montrose,1526,1,24,7,5,61,35,26,79
Peterhead,1526,2,23,4,9,77,39,38,73
Stirling,1526,3,17,6,13,61,51,10,57
Clyde,1526,4,15,9,12,55,49,6,54
Stenhousem'r,1526,5,15,8,13,55,47,8,53
Elgin,1526,6,14,6,16,54,62,-8,48
Annan Athlet,1526,7,11,11,14,47,42,5,44
Berwick,1526,8,8,10,18,30,62,-32,34
Edinburgh Ci,1526,9,8,9,19,37,60,-23,33
Cowdenbeath,1526,10,5,10,21,24,54,-30,25
Montrose,1527,1,23,8,5,61,36,25,77
Peterhead,1527,2,24,4,8,79,38,41,76
Stirling,1527,3,16,7,13,60,51,9,55
Stenhousem'r,1527,4,15,9,12,55,46,9,54
Clyde,1527,5,15,9,12,53,49,4,54
Elgin,1527,6,14,7,15,55,62,-7,49
Annan Athlet,1527,7,12,11,13,50,43,7,47
Berwick,1527,8,8,10,18,30,60,-30,34
Edinburgh Ci,1527,9,7,9,20,36,62,-26,30
Cowdenbeath,1527,10,4,10,22,25,57,-32,22
Montrose,1528,1,23,8,5,60,35,25,77
Peterhead,1528,2,24,4,8,79,38,41,76
Stirling,1528,3,17,6,13,64,53,11,57
Stenhousem'r,1528,4,15,8,13,57,50,7,53
Clyde,1528,5,14,10,12,53,50,3,52
Elgin,1528,6,14,7,15,54,61,-7,49
Annan Athlet,1528,7,11,11,14,48,44,4,44
Berwick,1528,8,8,11,17,31,60,-29,35
Edinburgh Ci,1528,9,7,9,20,36,62,-26,30
Cowdenbeath,1528,10,5,10,21,26,55,-29,25
Montrose,1529,1,23,8,5,62,37,25,77
Peterhead,1529,2,23,4,9,77,39,38,73
Stirling,1529,3,17,6,13,63,53,10,57
Stenhousem'r,1529,4,15,8,13,57,49,8,53
Clyde,1529,5,14,10,12,52,49,3,52
Elgin,1529,6,14,7,15,56,63,-7,49
Annan Athlet,1529,7,12,11,13,50,43,7,47
Berwick,1529,8,8,11,17,30,59,-29,35
Edinburgh Ci,1529,9,8,9,19,37,60,-23,33
Cowdenbeath,1529,10,4,10,22,25,57,-32,22
Montrose,1530,1,24,7,5,61,34,27,79
Peterhead,1530,2,24,4,8,81,39,42,76
Stirling,1530,3,16,7,13,61,52,9,55
Stenhousem'r,1530,4,15,9,12,56,47,9,54
Clyde,1530,5,15,9,12,53,49,4,54
Elgin,1530,6,14,6,16,53,62,-9,48
Annan Athlet,1530,7,11,11,14,47,42,5,44
Berwick,1530,8,8,10,18,30,60,-30,34
Edinburgh Ci,1530,9,7,9,20,37,64,-27,30
Cowdenbeath,1530,10,5,10,21,24,54,-30,25
Montrose,1531,1,24,7,5,60,34,26,79
Peterhead,1531,2,24,4,8,78,38,40,76
Stenhousem'r,1531,3,16,8,12,61,49,12,56
Stirling,1531,4,16,6,14,63,57,6,54
Clyde,1531,5,15,9,12,55,49,6,54
Elgin,1531,6,14,6,16,53,61,-8,48
Annan Athlet,1531,7,12,11,13,49,42,7,47
Berwick,1531,8,8,10,18,30,62,-32,34
Edinburgh Ci,1531,9,7,9,20,36,61,-25,30
Cowdenbeath,1531,10,4,10,22,24,56,-32,22
Peterhead,1532,1,24,4,8,78,38,40,76
Montrose,1532,2,23,7,6,61,39,22,76
Stirling,1532,3,17,6,13,64,52,12,57
Clyde,1532,4,15,9,12,54,48,6,54
Stenhousem'r,1532,5,15,8,13,56,50,6,53
Elgin,1532,6,15,6,15,58,62,-4,51
Annan Athlet,1532,7,12,11,13,49,42,7,47
Berwick,1532,8,8,10,18,29,61,-32,34
Edinburgh Ci,1532,9,7,9,20,36,61,-25,30
Cowdenbeath,1532,10,4,10,22,24,56,-32,22
Montrose,1533,1,24,7,5,61,34,27,79
Peterhead,1533,2,24,4,8,80,39,41,76
Stenhousem'r,1533,3,16,8,12,60,48,12,56
Stirling,1533,4,16,6,14,62,56,6,54
Clyde,1533,5,15,9,12,54,50,4,54
Elgin,1533,6,14,6,16,53,62,-9,48
Annan Athlet,1533,7,11,11,14,47,43,4,44
Berwick,1533,8,8,10,18,31,61,-30,34
Edinburgh Ci,1533,9,7,9,20,37,63,-26,30
Cowdenbeath,1533,10,5,10,21,25,54,-29,25
Montrose,1534,1,23,8,5,60,35,25,77
Peterhead,1534,2,23,5,8,77,38,39,74
Stenhousem'r,1534,3,16,8,12,58,48,10,56
Stirling,1534,4,16,6,14,62,54,8,54
Clyde,1534,5,15,9,12,52,48,4,54
Elgin,1534,6,14,7,15,54,61,-7,49
Annan Athlet,1534,7,11,11,14,47,44,3,44
Berwick,1534,8,8,10,18,29,59,-30,34
Edinburgh Ci,1534,9,7,10,19,36,60,-24,31
Cowdenbeath,1534,10,5,10,21,26,54,-28,25
Montrose,1535,1,24,7,5,60,34,26,79
Peterhead,1535,2,24,4,8,81,38,43,76
Stirling,1535,3,17,6,13,62,52,10,57
Clyde,1535,4,15,9,12,55,51,4,54
Stenhousem'r,1535,5,15,8,13,56,48,8,53
Elgin,1535,6,14,6,16,53,61,-8,48
Annan Athlet,1535,7,11,12,13,48,42,6,45
Berwick,1535,8,8,10,18,32,62,-30,34
Edinburgh Ci,1535,9,7,9,20,36,64,-28,30
Cowdenbeath,1535,10,4,11,21,24,55,-31,23
Montrose,1536,1,24,7,5,60,34,26,79
Peterhead,1536,2,23,5,8,77,38,39,74
Stirling,1536,3,17,6,13,62,51,11,57
Stenhousem'r,1536,4,15,8,13,55,48,7,53
Clyde,1536,5,14,9,13,51,49,2,51
Elgin,1536,6,14,6,16,53,61,-8,48
Annan Athlet,1536,7,11,11,14,47,44,3,44
Berwick,1536,8,9,10,17,30,58,-28,37
Edinburgh Ci,1536,9,7,10,19,36,60,-24,31
Cowdenbeath,1536,10,5,10,21,26,54,-28,25
Montrose,1537,1,24,7,5,62,36,26,79
Peterhead,1537,2,24,4,8,78,38,40,76
Stenhousem'r,1537,3,16,8,12,57,46,11,56
Stirling,1537,4,16,6,14,60,53,7,54
Clyde,1537,5,15,9,12,53,48,5,54
Elgin,1537,6,14,6,16,55,63,-8,48
Annan Athlet,1537,7,12,11,13,48,41,7,47
Berwick,1537,8,8,10,18,29,60,-31,34
Edinburgh Ci,1537,9,7,9,20,36,61,-25,30
Cowdenbeath,1537,10,4,10,22,23,55,-32,22
Montrose,1538,1,23,8,5,61,36,25,77
Peterhead,1538,2,24,4,8,78,38,40,76
Stirling,1538,3,17,6,13,63,51,12,57
Clyde,1538,4,15,9,12,55,48,7,54
Stenhousem'r,1538,5,15,8,13,55,49,6,53
Elgin,1538,6,14,7,15,55,62,-7,49
Annan Athlet,1538,7,12,11,13,49,41,8,47
Berwick,1538,8,8,10,18,29,62,-33,34
Edinburgh Ci,1538,9,7,9,20,36,61,-25,30
Cowdenbeath,1538,10,4,10,22,23,56,-33,22
Montrose,1539,1,24,7,5,63,35,28,79
Peterhead,1539,2,24,4,8,81,38,43,76
Stirling,1539,3,17,6,13,65,51,14,57
Clyde,1539,4,15,9,12,52,48,4,54
Stenhousem'r,1539,5,15,8,13,55,51,4,53
Elgin,1539,6,14,6,16,54,64,-10,48
Annan Athlet,1539,7,12,11,13,48,41,7,47
Berwick,1539,8,8,10,18,29,59,-30,34
Edinburgh Ci,1539,9,7,9,20,36,64,-28,30
Cowdenbeath,1539,10,4,10,22,23,55,-32,22
Montrose,1540,1,23,7,6,59,36,23,76
Peterhead,1540,2,23,5,8,77,38,39,74
Stirling,1540,3,16,7,13,61,52,9,55
Stenhousem'r,1540,4,15,9,12,56,47,9,54
Clyde,1540,5,15,9,12,55,49,6,54
Elgin,1540,6,15,6,15,55,60,-5,51
Annan Athlet,1540,7,11,12,13,47,41,6,45
Berwick,1540,8,8,10,18,30,62,-32,34
Edinburgh Ci,1540,9,7,10,19,36,60,-24,31
Cowdenbeath,1540,10,4,11,21,23,54,-31,23
Montrose,1541,1,24,7,5,62,35,27,79
Peterhead,1541,2,23,4,9,78,40,38,73
Stirling,1541,3,16,7,13,61,52,9,55
Stenhousem'r,1541,4,15,9,12,56,47,9,54
Clyde,1541,5,14,9,13,51,49,2,51
Elgin,1541,6,14,6,16,54,63,-9,48
Annan Athlet,1541,7,11,11,14,47,43,4,44
Berwick,1541,8,9,10,17,30,58,-28,37
Edinburgh Ci,1541,9,8,9,19,38,61,-23,33
Cowdenbeath,1541,10,5,10,21,25,54,-29,25
Montrose,1542,1,24,7,5,63,35,28,79
Peterhead,1542,2,24,4,8,78,38,40,76
Stenhousem'r,1542,3,16,8,12,56,46,10,56
Stirling,1542,4,16,6,14,60,52,8,54
Clyde,1542,5,15,9,12,53,48,5,54
Elgin,1542,6,14,6,16,54,64,-10,48
Annan Athlet,1542,7,12,11,13,48,41,7,47
Berwick,1542,8,8,10,18,29,60,-31,34
Edinburgh Ci,1542,9,7,9,20,36,61,-25,30
Cowdenbeath,1542,10,4,10,22,23,55,-32,22
Montrose,1543,1,24,7,5,64,34,30,79
Peterhead,1543,2,24,4,8,79,39,40,76
Stirling,1543,3,17,6,13,62,51,11,57
Stenhousem'r,1543,4,15,8,13,55,48,7,53
Clyde,1543,5,14,10,12,51,48,3,52
Elgin,1543,6,14,6,16,53,65,-12,48
Annan Athlet,1543,7,11,11,14,47,42,5,44
Berwick,1543,8,8,11,17,29,58,-29,35
Edinburgh Ci,1543,9,7,9,20,37,62,-25,30
Cowdenbeath,1543,10,5,10,21,24,54,-30,25
Montrose,1544,1,24,7,5,62,35,27,79
Peterhead,1544,2,23,5,8,78,39,39,74
Stirling,1544,3,17,6,13,64,51,13,57
Clyde,1544,4,15,9,12,53,49,4,54
Stenhousem'r,1544,5,15,8,13,55,50,5,53
Elgin,1544,6,14,6,16,54,63,-9,48
Annan Athlet,1544,7,11,11,14,47,43,4,44
Berwick,1544,8,8,10,18,30,60,-30,34
Edinburgh Ci,1544,9,7,10,19,37,61,-24,31
Cowdenbeath,1544,10,5,10,21,25,54,-29,25
Montrose,1545,1,23,8,5,61,36,25,77
Peterhead,1545,2,23,4,9,77,39,38,73
Stirling,1545,3,17,6,13,61,51,10,57
Stenhousem'r,1545,4,15,8,13,55,47,8,53
Clyde,1545,5,14,9,13,51,49,2,51
Elgin,1545,6,14,7,15,55,62,-7,49
Annan Athlet,1545,7,12,11,13,48,41,7,47
Berwick,1545,8,9,10,17,30,58,-28,37
Edinburgh Ci,1545,9,8,9,19,37,60,-23,33
Cowdenbeath,1545,10,4,10,22,23,55,-32,22
Montrose,1546,1,24,7,5,63,36,27,79
Peterhead,1546,2,23,4,9,77,39,38,73
Stirling,1546,3,16,7,13,60,51,9,55
Stenhousem'r,1546,4,15,9,12,55,46,9,54
Clyde,1546,5,14,10,12,52,49,3,52
Elgin,1546,6,14,6,16,55,64,-9,48
Annan Athlet,1546,7,11,12,13,48,42,6,45
Berwick,1546,8,8,11,17,30,59,-29,35
Edinburgh Ci,1546,9,8,9,19,37,60,-23,33
Cowdenbeath,1546,10,4,11,21,24,55,-31,23
Montrose,1547,1,24,7,5,66,35,31,79
Peterhead,1547,2,24,4,8,81,40,41,76
Stirling,1547,3,17,6,13,62,51,11,57
Stenhousem'r,1547,4,15,8,13,55,48,7,53
Clyde,1547,5,14,9,13,52,51,1,51
Elgin,1547,6,14,6,16,54,67,-13,48
Annan Athlet,1547,7,12,11,13,48,41,7,47
Berwick,1547,8,9,10,17,32,59,-27,37
Edinburgh Ci,1547,9,7,9,20,38,64,-26,30
Cowdenbeath,1547,10,4,10,22,23,55,-32,22
Montrose,1548,1,23,8,5,60,35,25,77
Peterhead,1548,2,24,4,8,81,40,41,76
Stirling,1548,3,17,6,13,63,53,10,57
Clyde,1548,4,15,9,12,54,48,6,54
Stenhousem'r,1548,5,15,8,13,57,49,8,53
Elgin,1548,6,14,7,15,54,61,-7,49
Annan Athlet,1548,7,11,12,13,48,42,6,45
Berwick,1548,8,8,10,18,29,61,-32,34
Edinburgh Ci,1548,9,7,9,20,38,64,-26,30
Cowdenbeath,1548,10,4,11,21,24,55,-31,23
Montrose,1549,1,24,7,5,61,35,26,79
Peterhead,1549,2,24,4,8,79,39,40,76
Stirling,1549,3,16,7,13,61,52,9,55
Stenhousem'r,1549,4,15,9,12,56,47,9,54
Clyde,1549,5,15,9,12,53,49,4,54
Elgin,1549,6,14,6,16,54,62,-8,48
Annan Athlet,1549,7,11,11,14,47,42,5,44
Berwick,1549,8,8,10,18,30,60,-30,34
Edinburgh Ci,1549,9,7,9,20,37,62,-25,30
Cowdenbeath,1549,10,5,10,21,24,54,-30,25
Montrose,1550,1,24,7,5,62,34,28,79
Peterhead,1550,2,24,4,8,83,38,45,76
Stirling,1550,3,17,6,13,63,51,12,57
Stenhousem'r,1550,4,15,8,13,55,49,6,53
Clyde,1550,5,14,9,13,51,49,2,51
Elgin,1550,6,14,6,16,53,63,-10,48
Annan Athlet,1550,7,11,11,14,47,42,5,44
Berwick,1550,8,9,10,17,30,58,-28,37
Edinburgh Ci,1550,9,7,9,20,36,66,-30,30
Cowdenbeath,1550,10,5,10,21,24,54,-30,25
Montrose,1551,1,23,8,5,59,34,25,77
Peterhead,1551,2,24,4,8,79,39,40,76
Stirling,1551,3,16,7,13,60,51,9,55
Stenhousem'r,1551,4,15,9,12,55,46,9,54
Clyde,1551,5,14,9,13,52,50,2,51
Elgin,1551,6,14,7,15,53,60,-7,49
Annan Athlet,1551,7,11,12,13,48,42,6,45
Berwick,1551,8,9,10,17,31,59,-28,37
Edinburgh Ci,1551,9,7,9,20,37,62,-25,30
Cowdenbeath,1551,10,4,11,21,24,55,-31,23
Peterhead,1552,1,24,4,8,83,38,45,76
Montrose,1552,2,23,7,6,61,38,23,76
Stenhousem'r,1552,3,16,8,12,57,47,10,56
Stirling,1552,4,16,6,14,61,53,8,54
Clyde,1552,5,14,10,12,52,49,3,52
Elgin,1552,6,15,6,15,57,62,-5,51
Annan Athlet,1552,7,12,11,13,49,42,7,47
Berwick,1552,8,8,11,17,30,59,-29,35
Edinburgh Ci,1552,9,7,9,20,36,66,-30,30
Cowdenbeath,1552,10,4,10,22,24,56,-32,22
Montrose,1553,1,24,7,5,62,34,28,79
Peterhead,1553,2,23,4,9,77,39,38,73
Stirling,1553,3,17,6,13,62,51,11,57
Stenhousem'r,1553,4,15,8,13,55,48,7,53
Clyde,1553,5,14,9,13,52,50,2,51
Elgin,1553,6,14,6,16,53,63,-10,48
Annan Athlet,1553,7,11,11,14,47,42,5,44
Berwick,1553,8,9,10,17,31,59,-28,37
Edinburgh Ci,1553,9,8,9,19,37,60,-23,33
Cowdenbeath,1553,10,5,10,21,24,54,-30,25
Montrose,1554,1,24,7,5,65,36,29,79
Peterhead,1554,2,23,4,9,79,41,38,73
Stirling,1554,3,16,7,13,61,52,9,55
Stenhousem'r,1554,4,15,9,12,56,47,9,54
Clyde,1554,5,15,9,12,52,48,4,54
Elgin,1554,6,14,6,16,55,66,-11,48
Annan Athlet,1554,7,11,12,13,48,42,6,45
Berwick,1554,8,8,10,18,29,59,-30,34
Edinburgh Ci,1554,9,8,9,19,39,62,-23,33
Cowdenbeath,1554,10,4,11,21,24,55,-31,23
Montrose,1555,1,24,7,5,62,36,26,79
Peterhead,1555,2,24,4,8,81,39,42,76
Stirling,1555,3,16,7,13,63,54,9,55
Stenhousem'r,1555,4,15,9,12,58,49,9,54
Clyde,1555,5,15,9,12,53,49,4,54
Elgin,1555,6,14,6,16,55,63,-8,48
Annan Athlet,1555,7,11,11,14,48,43,5,44
Berwick,1555,8,8,10,18,30,60,-30,34
Edinburgh Ci,1555,9,7,9,20,37,64,-27,30
Cowdenbeath,1555,10,5,10,21,25,55,-30,25
Montrose,1556,1,24,7,5,60,34,26,79
Peterhead,1556,2,24,4,8,79,39,40,76
Stirling,1556,3,17,6,13,62,51,11,57
Clyde,1556,4,15,9,12,53,48,5,54
Stenhousem'r,1556,5,15,8,13,55,48,7,53
Elgin,1556,6,14,6,16,53,61,-8,48
Annan Athlet,1556,7,12,11,13,48,41,7,47
Berwick,1556,8,8,10,18,29,60,-31,34
Edinburgh Ci,1556,9,7,9,20,37,62,-25,30
Cowdenbeath,1556,10,4,10,22,23,55,-32,22
Peterhead,1557,1,24,4,8,80,38,42,76
Montrose,1557,2,23,7,6,60,36,24,76
Stenhousem'r,1557,3,16,8,12,58,47,11,56
Stirling,1557,4,16,6,14,61,54,7,54
Clyde,1557,5,14,9,13,52,50,2,51
Elgin,1557,6,15,6,15,55,61,-6,51
Annan Athlet,1557,7,12,11,13,49,41,8,47
Berwick,1557,8,9,10,17,31,59,-28,37
Edinburgh Ci,1557,9,7,9,20,36,63,-27,30
Cowdenbeath,1557,10,4,10,22,23,56,-33,22
Montrose,1558,1,23,8,5,59,34,25,77
Peterhead,1558,2,24,4,8,82,42,40,76
Stirling,1558,3,16,7,13,61,52,9,55
Stenhousem'r,1558,4,15,9,12,56,47,9,54
Clyde,1558,5,14,9,13,52,50,2,51
Elgin,1558,6,14,7,15,53,60,-7,49
Annan Athlet,1558,7,12,11,13,48,41,7,47
Berwick,1558,8,9,10,17,31,59,-28,37
Edinburgh Ci,1558,9,7,9,20,40,65,-25,30
Cowdenbeath,1558,10,4,10,22,23,55,-32,22
Montrose,1559,1,23,8,5,59,34,25,77
Peterhead,1559,2,23,5,8,77,38,39,74
Stirling,1559,3,17,6,13,62,52,10,57
Clyde,1559,4,15,9,12,54,50,4,54
Stenhousem'r,1559,5,15,8,13,56,48,8,53
Elgin,1559,6,14,7,15,53,60,-7,49
Annan Athlet,1559,7,11,12,13,48,42,6,45
Berwick,1559,8,8,10,18,31,61,-30,34
Edinburgh Ci,1559,9,7,10,19,36,60,-24,31
Cowdenbeath,1559,10,4,11,21,24,55,-31,23
Montrose,1560,1,24,7,5,61,34,27,79
Peterhead,1560,2,24,4,8,81,40,41,76
Stenhousem'r,1560,3,16,8,12,57,46,11,56
Clyde,1560,4,15,9,12,56,48,8,54
Stirling,1560,5,16,6,14,60,53,7,54
Elgin,1560,6,14,6,16,53,62,-9,48
Annan Athlet,1560,7,12,11,13,50,41,9,47
Berwick,1560,8,8,10,18,29,63,-34,34
Edinburgh Ci,1560,9,7,9,20,38,64,-26,30
Cowdenbeath,1560,10,4,10,22,23,57,-34,22
Montrose,1561,1,24,7,5,61,35,26,79
Peterhead,1561,2,23,5,8,78,39,39,74
Stirling,1561,3,17,6,13,61,51,10,57
Clyde,1561,4,15,9,12,54,49,5,54
Stenhousem'r,1561,5,15,8,13,55,47,8,53
Elgin,1561,6,14,6,16,54,62,-8,48
Annan Athlet,1561,7,11,12,13,48,42,6,45
Berwick,1561,8,8,10,18,30,61,-31,34
Edinburgh Ci,1561,9,7,10,19,37,61,-24,31
Cowdenbeath,1561,10,4,11,21,24,55,-31,23
Montrose,1562,1,23,7,6,59,35,24,76
Peterhead,1562,2,23,5,8,78,39,39,74
Stirling,1562,3,17,6,13,62,52,10,57
Clyde,1562,4,15,9,12,52,48,4,54
Stenhousem'r,1562,5,15,8,13,56,48,8,53
Elgin,1562,6,15,6,15,54,60,-6,51
Annan Athlet,1562,7,11,12,13,48,42,6,45
Berwick,1562,8,8,10,18,29,59,-30,34
Edinburgh Ci,1562,9,7,10,19,37,61,-24,31
Cowdenbeath,1562,10,4,11,21,24,55,-31,23
Peterhead,1563,1,24,4,8,82,38,44,76
Montrose,1563,2,23,7,6,60,36,24,76
Stenhousem'r,1563,3,16,8,12,57,47,10,56
Stirling,1563,4,16,6,14,61,53,8,54
Clyde,1563,5,15,9,12,53,49,4,54
Elgin,1563,6,15,6,15,55,61,-6,51
Annan Athlet,1563,7,11,12,13,48,42,6,45
Berwick,1563,8,8,10,18,30,60,-30,34
Edinburgh Ci,1563,9,7,9,20,36,65,-29,30
Cowdenbeath,1563,10,4,11,21,24,55,-31,23
Montrose,1564,1,24,7,5,62,35,27,79
Peterhead,1564,2,24,4,8,83,39,44,76
Stenhousem'r,1564,3,16,8,12,57,47,10,56
Stirling,1564,4,16,6,14,61,53,8,54
Clyde,1564,5,15,9,12,54,48,6,54
Elgin,1564,6,14,6,16,54,63,-9,48
Annan Athlet,1564,7,11,12,13,49,43,6,45
Berwick,1564,8,8,10,18,29,61,-32,34
Edinburgh Ci,1564,9,7,9,20,37,66,-29,30
Cowdenbeath,1564,10,4,11,21,25,56,-31,23
Montrose,1565,1,24,7,5,61,35,26,79
Peterhead,1565,2,23,5,8,77,38,39,74
Stenhousem'r,1565,3,16,8,12,56,46,10,56
Stirling,1565,4,16,6,14,60,52,8,54
Clyde,1565,5,15,9,12,54,50,4,54
Elgin,1565,6,14,6,16,54,62,-8,48
Annan Athlet,1565,7,12,11,13,50,42,8,47
Berwick,1565,8,8,10,18,31,61,-30,34
Edinburgh Ci,1565,9,7,10,19,36,60,-24,31
Cowdenbeath,1565,10,4,10,22,24,57,-33,22
Montrose,1566,1,23,8,5,61,36,25,77
Peterhead,1566,2,24,4,8,81,38,43,76
Stirling,1566,3,16,7,13,62,53,9,55
Stenhousem'r,1566,4,15,9,12,57,48,9,54
Clyde,1566,5,15,9,12,55,48,7,54
Elgin,1566,6,14,7,15,55,62,-7,49
Annan Athlet,1566,7,12,11,13,50,43,7,47
Berwick,1566,8,8,10,18,29,62,-33,34
Edinburgh Ci,1566,9,7,9,20,36,64,-28,30
Cowdenbeath,1566,10,4,10,22,25,57,-32,22
Montrose,1567,1,24,7,5,61,35,26,79
Peterhead,1567,2,24,4,8,81,41,40,76
Stenhousem'r,1567,3,16,8,12,57,47,10,56
Stirling,1567,4,16,6,14,61,53,8,54
Clyde,1567,5,14,10,12,53,50,3,52
Elgin,1567,6,14,6,16,54,62,-8,48
Annan Athlet,1567,7,11,11,14,47,42,5,44
Berwick,1567,8,8,11,17,31,60,-29,35
Edinburgh Ci,1567,9,7,9,20,39,64,-25,30
Cowdenbeath,1567,10,5,10,21,24,54,-30,25
Peterhead,1568,1,24,4,8,82,40,42,76
Montrose,1568,2,23,7,6,60,36,24,76
Stenhousem'r,1568,3,16,8,12,57,47,10,56
Stirling,1568,4,16,6,14,61,53,8,54
Clyde,1568,5,15,9,12,53,49,4,54
Elgin,1568,6,15,6,15,55,61,-6,51
Annan Athlet,1568,7,12,11,13,49,42,7,47
Berwick,1568,8,8,10,18,30,60,-30,34
Edinburgh Ci,1568,9,7,9,20,38,65,-27,30
Cowdenbeath,1568,10,4,10,22,24,56,-32,22
Montrose,1569,1,23,8,5,61,36,25,77
Peterhead,1569,2,23,4,9,78,40,38,73
Stirling,1569,3,17,6,13,61,51,10,57
Stenhousem'r,1569,4,15,8,13,55,47,8,53
Clyde,1569,5,14,9,13,53,51,2,51
Elgin,1569,6,14,7,15,55,62,-7,49
Annan Athlet,1569,7,11,11,14,48,44,4,44
Berwick,1569,8,9,10,17,32,60,-28,37
Edinburgh Ci,1569,9,8,9,19,38,61,-23,33
Cowdenbeath,1569,10,5,10,21,26,55,-29,25
Montrose,1570,1,24,7,5,64,36,28,79
Peterhead,1570,2,24,4,8,79,39,40,76
Stirling,1570,3,16,7,13,62,53,9,55
Stenhousem'r,1570,4,15,9,12,57,48,9,54
Clyde,1570,5,15,9,12,53,48,5,54
Elgin,1570,6,14,6,16,55,65,-10,48
Annan Athlet,1570,7,11,12,13,47,41,6,45
Berwick,1570,8,8,10,18,29,60,-31,34
Edinburgh Ci,1570,9,7,9,20,37,62,-25,30
Cowdenbeath,1570,10,4,11,21,23,54,-31,23
Montrose,1571,1,24,7,5,60,34,26,79
Peterhead,1571,2,24,4,8,81,41,40,76
Stenhousem'r,1571,3,16,8,12,59,48,11,56
Stirling,1571,4,16,6,14,62,55,7,54
Clyde,1571,5,15,9,12,54,49,5,54
Elgin,1571,6,14,6,16,53,61,-8,48
Annan Athlet,1571,7,12,11,13,49,42,7,47
Berwick,1571,8,8,10,18,30,61,-31,34
Edinburgh Ci,1571,9,7,9,20,39,64,-25,30
Cowdenbeath,1571,10,4,10,22,24,56,-32,22
Montrose,1572,1,24,7,5,61,34,27,79
Peterhead,1572,2,24,4,8,80,39,41,76
Stenhousem'r,1572,3,16,8,12,56,46,10,56
Stirling,1572,4,16,6,14,60,52,8,54
Clyde,1572,5,15,9,12,52,48,4,54
Elgin,1572,6,14,6,16,53,62,-9,48
Annan Athlet,1572,7,11,11,14,47,42,5,44
Berwick,1572,8,8,10,18,29,59,-30,34
Edinburgh Ci,1572,9,7,9,20,37,63,-26,30
Cowdenbeath,1572,10,5,10,21,24,54,-30,25
Montrose,1573,1,24,7,5,61,35,26,79
Peterhead,1573,2,24,4,8,79,38,41,76
Stirling,1573,3,17,6,13,65,53,12,57
Clyde,1573,4,15,9,12,52,48,4,54
Stenhousem'r,1573,5,15,8,13,57,51,6,53
Elgin,1573,6,14,6,16,54,62,-8,48
Annan Athlet,1573,7,11,12,13,48,42,6,45
Berwick,1573,8,8,10,18,29,59,-30,34
Edinburgh Ci,1573,9,7,9,20,36,62,-26,30
Cowdenbeath,1573,10,4,11,21,24,55,-31,23
Montrose,1574,1,24,7,5,62,35,27,79
Peterhead,1574,2,24,4,8,82,39,43,76
Stirling,1574,3,16,7,13,60,51,9,55
Stenhousem'r,1574,4,15,9,12,55,46,9,54
Clyde,1574,5,15,9,12,53,49,4,54
Elgin,1574,6,14,6,16,54,63,-9,48
Annan Athlet,1574,7,12,11,13,48,41,7,47
Berwick,1574,8,8,10,18,30,60,-30,34
Edinburgh Ci,1574,9,7,9,20,37,65,-28,30
Cowdenbeath,1574,10,4,10,22,23,55,-32,22
Montrose,1575,1,24,7,5,62,36,26,79
Peterhead,1575,2,24,4,8,78,38,40,76
Stirling,1575,3,17,6,13,63,51,12,57
Stenhousem'r,1575,4,15,8,13,55,49,6,53
Clyde,1575,5,14,9,13,52,50,2,51
Elgin,1575,6,14,6,16,55,63,-8,48
Annan Athlet,1575,7,11,11,14,47,42,5,44
Berwick,1575,8,9,10,17,31,59,-28,37
Edinburgh Ci,1575,9,7,9,20,36,61,-25,30
Cowdenbeath,1575,10,5,10,21,24,54,-30,25
Montrose,1576,1,24,7,5,62,35,27,79
Peterhead,1576,2,24,4,8,80,38,42,76
Stirling,1576,3,16,7,13,61,52,9,55
Stenhousem'r,1576,4,15,9,12,56,47,9,54
Clyde,1576,5,14,10,12,51,48,3,52
Elgin,1576,6,14,6,16,54,63,-9,48
Annan Athlet,1576,7,11,12,13,48,42,6,45
Berwick,1576,8,8,11,17,29,58,-29,35
Edinburgh Ci,1576,9,7,9,20,36,63,-27,30
Cowdenbeath,1576,10,4,11,21,24,55,-31,23
Montrose,1577,1,23,8,5,60,35,25,77
Peterhead,1577,2,23,5,8,79,40,39,74
Stirling,1577,3,17,6,13,61,51,10,57
Clyde,1577,4,15,9,12,52,48,4,54
Stenhousem'r,1577,5,15,8,13,55,47,8,53
Elgin,1577,6,14,7,15,54,61,-7,49
Annan Athlet,1577,7,11,12,13,47,41,6,45
Berwick,1577,8,8,10,18,29,59,-30,34
Edinburgh Ci,1577,9,7,10,19,38,62,-24,31
Cowdenbeath,1577,10,4,11,21,23,54,-31,23
Montrose,1578,1,24,7,5,63,35,28,79
Peterhead,1578,2,24,4,8,80,40,40,76
Stirling,1578,3,17,6,13,62,51,11,57
Clyde,1578,4,15,9,12,53,49,4,54
Stenhousem'r,1578,5,15,8,13,55,48,7,53
Elgin,1578,6,14,6,16,54,64,-10,48
Annan Athlet,1578,7,11,12,13,48,42,6,45
Berwick,1578,8,8,10,18,30,60,-30,34
Edinburgh Ci,1578,9,7,9,20,38,63,-25,30
Cowdenbeath,1578,10,4,11,21,24,55,-31,23
Peterhead,1579,1,24,4,8,80,38,42,76
Montrose,1579,2,23,7,6,59,35,24,76
Stirling,1579,3,16,7,13,61,52,9,55
Stenhousem'r,1579,4,15,9,12,56,47,9,54
Clyde,1579,5,14,9,13,51,49,2,51
Elgin,1579,6,15,6,15,54,60,-6,51
Annan Athlet,1579,7,12,11,13,48,41,7,47
Berwick,1579,8,9,10,17,30,58,-28,37
Edinburgh Ci,1579,9,7,9,20,36,63,-27,30
Cowdenbeath,1579,10,4,10,22,23,55,-32,22
Montrose,1580,1,24,7,5,61,35,26,79
Peterhead,1580,2,24,4,8,81,38,43,76
Stirling,1580,3,16,7,13,61,52,9,55
Stenhousem'r,1580,4,15,9,12,56,47,9,54
Clyde,1580,5,15,9,12,55,50,5,54
Elgin,1580,6,14,6,16,54,62,-8,48
Annan Athlet,1580,7,12,11,13,50,41,9,47
Berwick,1580,8,8,10,18,31,62,-31,34
Edinburgh Ci,1580,9,7,9,20,36,64,-28,30
Cowdenbeath,1580,10,4,10,22,23,57,-34,22
Montrose,1581,1,24,7,5,62,36,26,79
Peterhead,1581,2,24,4,8,84,38,46,76
Stirling,1581,3,17,6,13,63,52,11,57
Stenhousem'r,1581,4,15,8,13,56,49,7,53
Clyde,1581,5,14,10,12,53,50,3,52
Elgin,1581,6,14,6,16,55,63,-8,48
Annan Athlet,1581,7,12,11,13,49,41,8,47
Berwick,1581,8,8,11,17,31,60,-29,35
Edinburgh Ci,1581,9,7,9,20,36,67,-31,30
Cowdenbeath,1581,10,4,10,22,23,56,-33,22
Montrose,1582,1,23,8,5,61,36,25,77
Peterhead,1582,2,24,4,8,78,38,40,76
Stenhousem'r,1582,3,16,8,12,57,47,10,56
Stirling,1582,4,16,6,14,61,53,8,54
Clyde,1582,5,14,9,13,51,50,1,51
Elgin,1582,6,14,7,15,55,62,-7,49
Annan Athlet,1582,7,12,11,13,48,41,7,47
Berwick,1582,8,9,10,17,31,58,-27,37
Edinburgh Ci,1582,9,7,9,20,36,61,-25,30
Cowdenbeath,1582,10,4,10,22,23,55,-32,22
Peterhead,1583,1,24,4,8,81,38,43,76
Montrose,1583,2,23,7,6,60,36,24,76
Stirling,1583,3,17,6,13,62,51,11,57
Stenhousem'r,1583,4,15,8,13,55,48,7,53
Clyde,1583,5,14,9,13,51,49,2,51
Elgin,1583,6,15,6,15,55,61,-6,51
Annan Athlet,1583,7,11,11,14,47,44,3,44
Berwick,1583,8,9,10,17,30,58,-28,37
Edinburgh Ci,1583,9,7,9,20,36,64,-28,30
Cowdenbeath,1583,10,5,10,21,26,54,-28,25
Peterhead,1584,1,24,4,8,81,41,40,76
Montrose,1584,2,23,7,6,60,38,22,76
Stirling,1584,3,17,6,13,63,52,11,57
Stenhousem'r,1584,4,15,8,13,56,49,7,53
Clyde,1584,5,14,9,13,52,50,2,51
Elgin,1584,6,15,6,15,57,61,-4,51
Annan Athlet,1584,7,12,11,13,50,43,7,47
Berwick,1584,8,9,10,17,31,59,-28,37
Edinburgh Ci,1584,9,7,9,20,39,64,-25,30
Cowdenbeath,1584,10,4,10,22,25,57,-32,22
Montrose,1585,1,23,8,5,61,36,25,77
Peterhead,1585,2,24,4,8,81,40,41,76
Stenhousem'r,1585,3,16,8,12,57,47,10,56
Stirling,1585,4,16,6,14,61,53,8,54
Clyde,1585,5,15,9,12,53,49,4,54
Elgin,1585,6,14,7,15,55,62,-7,49
Annan Athlet,1585,7,11,12,13,49,43,6,45
Berwick,1585,8,8,10,18,30,60,-30,34
Edinburgh Ci,1585,9,7,9,20,38,64,-26,30
Cowdenbeath,1585,10,4,11,21,25,56,-31,23
Montrose,1586,1,24,7,5,60,34,26,79
Peterhead,1586,2,24,4,8,81,39,42,76
Stenhousem'r,1586,3,16,8,12,57,47,10,56
Stirling,1586,4,16,6,14,61,53,8,54
Clyde,1586,5,15,9,12,54,50,4,54
Elgin,1586,6,14,6,16,53,61,-8,48
Annan Athlet,1586,7,11,12,13,47,41,6,45
Berwick,1586,8,8,10,18,31,61,-30,34
Edinburgh Ci,1586,9,7,9,20,37,64,-27,30
Cowdenbeath,1586,10,4,11,21,23,54,-31,23
Montrose,1587,1,24,7,5,61,34,27,79
Peterhead,1587,2,24,4,8,81,38,43,76
Stirling,1587,3,17,6,13,62,51,11,57
Stenhousem'r,1587,4,15,8,13,55,48,7,53
Clyde,1587,5,14,9,13,52,51,1,51
Elgin,1587,6,14,6,16,53,62,-9,48
Annan Athlet,1587,7,12,11,13,48,41,7,47
Berwick,1587,8,9,10,17,32,59,-27,37
Edinburgh Ci,1587,9,7,9,20,36,64,-28,30
Cowdenbeath,1587,10,4,10,22,23,55,-32,22
Montrose,1588,1,23,8,5,59,34,25,77
Peterhead,1588,2,24,4,8,78,38,40,76
Stenhousem'r,1588,3,16,8,12,57,47,10,56
Stirling,1588,4,16,6,14,61,53,8,54
Clyde,1588,5,14,10,12,52,49,3,52
Elgin,1588,6,14,7,15,53,60,-7,49
Annan Athlet,1588,7,11,12,13,47,41,6,45
Berwick,1588,8,8,11,17,30,59,-29,35
Edinburgh Ci,1588,9,7,9,20,36,61,-25,30
Cowdenbeath,1588,10,4,11,21,23,54,-31,23
Montrose,1589,1,24,7,5,63,35,28,79
Peterhead,1589,2,24,4,8,82,39,43,76
Stirling,1589,3,16,7,13,60,51,9,55
Stenhousem'r,1589,4,15,9,12,55,46,9,54
Clyde,1589,5,15,9,12,53,48,5,54
Elgin,1589,6,14,6,16,54,64,-10,48
Annan Athlet,1589,7,11,12,13,47,41,6,45
Berwick,1589,8,8,10,18,29,60,-31,34
Edinburgh Ci,1589,9,7,9,20,37,65,-28,30
Cowdenbeath,1589,10,4,11,21,23,54,-31,23
Montrose,1590,1,24,7,5,61,35,26,79
Peterhead,1590,2,24,4,8,79,39,40,76
Stirling,1590,3,17,6,13,62,52,10,57
Stenhousem'r,1590,4,15,8,13,56,48,8,53
Clyde,1590,5,14,9,13,51,49,2,51
Elgin,1590,6,14,6,16,54,62,-8,48
Annan Athlet,1590,7,11,12,13,47,41,6,45
Berwick,1590,8,9,10,17,30,58,-28,37
Edinburgh Ci,1590,9,7,9,20,37,62,-25,30
Cowdenbeath,1590,10,4,11,21,23,54,-31,23
Montrose,1591,1,24,7,5,61,34,27,79
Peterhead,1591,2,24,4,8,79,39,40,76
Stenhousem'r,1591,3,16,8,12,56,46,10,56
Stirling,1591,4,16,6,14,60,52,8,54
Clyde,1591,5,14,9,13,51,51,0,51
Elgin,1591,6,14,6,16,53,62,-9,48
Annan Athlet,1591,7,11,12,13,48,42,6,45
Berwick,1591,8,9,10,17,32,58,-26,37
Edinburgh Ci,1591,9,7,9,20,37,62,-25,30
Cowdenbeath,1591,10,4,11,21,24,55,-31,23
Montrose,1592,1,24,7,5,61,35,26,79
Peterhead,1592,2,24,4,8,81,39,42,76
Stirling,1592,3,17,6,13,63,53,10,57
Clyde,1592,4,15,9,12,53,48,5,54
Stenhousem'r,1592,5,15,8,13,57,49,8,53
Elgin,1592,6,14,6,16,54,62,-8,48
Annan Athlet,1592,7,11,11,14,49,45,4,44
Berwick,1592,8,8,10,18,29,60,-31,34
Edinburgh Ci,1592,9,7,9,20,37,64,-27,30
Cowdenbeath,1592,10,5,10,21,27,56,-29,25
Montrose,1593,1,23,8,5,60,35,25,77
Peterhead,1593,2,24,4,8,82,39,43,76
Stirling,1593,3,17,6,13,63,51,12,57
Clyde,1593,4,15,9,12,54,50,4,54
Stenhousem'r,1593,5,15,8,13,55,49,6,53
Elgin,1593,6,14,7,15,54,61,-7,49
Annan Athlet,1593,7,11,12,13,49,43,6,45
Berwick,1593,8,8,10,18,31,61,-30,34
Edinburgh Ci,1593,9,7,9,20,37,65,-28,30
Cowdenbeath,1593,10,4,11,21,25,56,-31,23
Peterhead,1594,1,24,4,8,78,38,40,76
Montrose,1594,2,23,7,6,61,37,24,76
Stirling,1594,3,17,6,13,62,52,10,57
Stenhousem'r,1594,4,15,8,13,56,48,8,53
Clyde,1594,5,14,9,13,51,49,2,51
Elgin,1594,6,15,6,15,56,62,-6,51
Annan Athlet,1594,7,11,12,13,48,42,6,45
Berwick,1594,8,9,10,17,30,58,-28,37
Edinburgh Ci,1594,9,7,9,20,36,61,-25,30
Cowdenbeath,1594,10,4,11,21,24,55,-31,23
Montrose,1595,1,24,7,5,61,34,27,79
Peterhead,1595,2,24,4,8,80,39,41,76
Stirling,1595,3,17,6,13,62,52,10,57
Clyde,1595,4,15,9,12,54,49,5,54
Stenhousem'r,1595,5,15,8,13,56,48,8,53
Elgin,1595,6,14,6,16,53,62,-9,48
Annan Athlet,1595,7,12,11,13,48,41,7,47
Berwick,1595,8,8,10,18,30,61,-31,34
Edinburgh Ci,1595,9,7,9,20,37,63,-26,30
Cowdenbeath,1595,10,4,10,22,23,55,-32,22
Peterhead,1596,1,24,4,8,80,40,40,76
Montrose,1596,2,23,7,6,60,36,24,76
Stirling,1596,3,16,7,13,62,53,9,55
Stenhousem'r,1596,4,15,9,12,57,48,9,54
Clyde,1596,5,15,9,12,55,49,6,54
Elgin,1596,6,15,6,15,55,61,-6,51
Annan Athlet,1596,7,11,12,13,48,42,6,45
Berwick,1596,8,8,10,18,30,62,-32,34
Edinburgh Ci,1596,9,7,9,20,38,63,-25,30
Cowdenbeath,1596,10,4,11,21,24,55,-31,23
Montrose,1597,1,23,7,6,59,37,22,76
Peterhead,1597,2,23,5,8,78,39,39,74
Stirling,1597,3,16,7,13,61,52,9,55
Stenhousem'r,1597,4,15,9,12,56,47,9,54
Clyde,1597,5,14,9,13,52,50,2,51
Elgin,1597,6,15,6,15,56,60,-4,51
Annan Athlet,1597,7,11,11,14,47,42,5,44
Berwick,1597,8,9,10,17,31,59,-28,37
Edinburgh Ci,1597,9,7,10,19,37,61,-24,31
Cowdenbeath,1597,10,5,10,21,24,54,-30,25
Peterhead,1598,1,24,4,8,81,38,43,76
Montrose,1598,2,23,7,6,60,36,24,76
Stenhousem'r,1598,3,16,8,12,57,47,10,56
Stirling,1598,4,16,6,14,61,53,8,54
Clyde,1598,5,15,9,12,54,50,4,54
Elgin,1598,6,15,6,15,55,61,-6,51
Annan Athlet,1598,7,11,12,13,48,42,6,45
Berwick,1598,8,8,10,18,31,61,-30,34
Edinburgh Ci,1598,9,7,9,20,36,64,-28,30
Cowdenbeath,1598,10,4,11,21,24,55,-31,23
Montrose,1599,1,23,8,5,60,35,25,77
Peterhead,1599,2,24,4,8,81,38,43,76
Stirling,1599,3,17,6,13,62,52,10,57
Stenhousem'r,1599,4,15,8,13,56,48,8,53
Clyde,1599,5,14,10,12,51,48,3,52
Elgin,1599,6,14,7,15,54,61,-7,49
Annan Athlet,1599,7,12,11,13,49,41,8,47
Berwick,1599,8,8,11,17,29,58,-29,35
Edinburgh Ci,1599,9,7,9,20,36,64,-28,30
Cowdenbeath,1599,10,4,10,22,23,56,-33,22
Montrose,1600,1,24,7,5,61,34,27,79
Peterhead,1600,2,24,4,8,79,38,41,76
Stirling,1600,3,16,7,13,60,51,9,55
Stenhousem'r,1600,4,15,9,12,55,46,9,54
Clyde,1600,5,14,9,13,52,50,2,51
Elgin,1600,6,14,6,16,53,62,-9,48
Annan Athlet,1600,7,11,11,14,48,43,5,44
Berwick,1600,8,9,10,17,31,59,-28,37
Edinburgh Ci,1600,9,7,9,20,36,62,-26,30
Cowdenbeath,1600,10,5,10,21,25,55,-30,25
Montrose,1601,1,24,7,5,64,34,30,79
Peterhead,1601,2,24,4,8,81,39,42,76
Stenhousem'r,1601,3,16,8,12,58,48,10,56
Stirling,1601,4,16,6,14,62,54,8,54
Clyde,1601,5,14,9,13,52,51,1,51
Elgin,1601,6,14,6,16,53,65,-12,48
Annan Athlet,1601,7,11,12,13,49,43,6,45
Berwick,1601,8,9,10,17,32,59,-27,37
Edinburgh Ci,1601,9,7,9,20,37,64,-27,30
Cowdenbeath,1601,10,4,11,21,25,56,-31,23
Montrose,1602,1,23,8,5,61,36,25,77
Peterhead,1602,2,24,4,8,81,38,43,76
Stirling,1602,3,17,6,13,62,52,10,57
Stenhousem'r,1602,4,15,8,13,56,48,8,53
Clyde,1602,5,14,9,13,51,49,2,51
Elgin,1602,6,14,7,15,55,62,-7,49
Annan Athlet,1602,7,12,11,13,49,41,8,47
Berwick,1602,8,9,10,17,30,58,-28,37
Edinburgh Ci,1602,9,7,9,20,36,64,-28,30
Cowdenbeath,1602,10,4,10,22,23,56,-33,22
Montrose,1603,1,24,7,5,63,35,28,79
Peterhead,1603,2,24,4,8,82,38,44,76
Stirling,1603,3,17,6,13,63,51,12,57
Clyde,1603,4,15,9,12,52,48,4,54
Stenhousem'r,1603,5,15,8,13,55,49,6,53
Elgin,1603,6,14,6,16,54,64,-10,48
Annan Athlet,1603,7,11,12,13,49,43,6,45
Berwick,1603,8,8,10,18,29,59,-30,34
Edinburgh Ci,1603,9,7,9,20,36,65,-29,30
Cowdenbeath,1603,10,4,11,21,25,56,-31,23
Montrose,1604,1,24,7,5,61,34,27,79
Peterhead,1604,2,24,4,8,79,38,41,76
Stirling,1604,3,16,7,13,62,53,9,55
Stenhousem'r,1604,4,15,9,12,57,48,9,54
Clyde,1604,5,15,9,12,53,48,5,54
Elgin,1604,6,14,6,16,53,62,-9,48
Annan Athlet,1604,7,12,11,13,48,41,7,47
Berwick,1604,8,8,10,18,29,60,-31,34
Edinburgh Ci,1604,9,7,9,20,36,62,-26,30
Cowdenbeath,1604,10,4,10,22,23,55,-32,22
Montrose,1605,1,24,7,5,60,34,26,79
Peterhead,1605,2,24,4,8,79,39,40,76
Stirling,1605,3,16,7,13,61,52,9,55
Stenhousem'r,1605,4,15,9,12,56,47,9,54
Clyde,1605,5,15,9,12,53,49,4,54
Elgin,1605,6,14,6,16,53,61,-8,48
Annan Athlet,1605,7,11,12,13,47,41,6,45
Berwick,1605,8,8,10,18,30,60,-30,34
Edinburgh Ci,1605,9,7,9,20,37,62,-25,30
Cowdenbeath,1605,10,4,11,21,23,54,-31,23
Montrose,1606,1,24,7,5,63,36,27,79
Peterhead,1606,2,24,4,8,80,39,41,76
Stirling,1606,3,16,7,13,60,51,9,55
Stenhousem'r,1606,4,15,9,12,55,46,9,54
Clyde,1606,5,15,9,12,53,48,5,54
Elgin,1606,6,14,6,16,55,64,-9,48
Annan Athlet,1606,7,11,11,14,47,42,5,44
Berwick,1606,8,8,10,18,29,60,-31,34
Edinburgh Ci,1606,9,7,9,20,37,63,-26,30
Cowdenbeath,1606,10,5,10,21,24,54,-30,25
Montrose,1607,1,24,7,5,61,35,26,79
Peterhead,1607,2,24,4,8,79,38,41,76
Stirling,1607,3,17,6,13,61,51,10,57
Clyde,1607,4,15,9,12,52,48,4,54
Stenhousem'r,1607,5,15,8,13,55,47,8,53
Elgin,1607,6,14,6,16,54,62,-8,48
Annan Athlet,1607,7,12,11,13,48,41,7,47
Berwick,1607,8,8,10,18,29,59,-30,34
Edinburgh Ci,1607,9,7,9,20,36,62,-26,30
Cowdenbeath,1607,10,4,10,22,23,55,-32,22
Montrose,1608,1,24,7,5,63,34,29,79
Peterhead,1608,2,23,5,8,78,39,39,74
Stirling,1608,3,17,6,13,62,52,10,57
Clyde,1608,4,15,9,12,52,48,4,54
Stenhousem'r,1608,5,15,8,13,56,48,8,53
Elgin,1608,6,14,6,16,53,64,-11,48
Annan Athlet,1608,7,12,11,13,49,41,8,47
Berwick,1608,8,8,10,18,29,59,-30,34
Edinburgh Ci,1608,9,7,10,19,37,61,-24,31
Cowdenbeath,1608,10,4,10,22,23,56,-33,22
Montrose,1609,1,23,8,5,60,35,25,77
Peterhead,1609,2,24,4,8,80,39,41,76
Stirling,1609,3,17,6,13,62,51,11,57
Clyde,1609,4,15,9,12,54,50,4,54
Stenhousem'r,1609,5,15,8,13,55,48,7,53
Elgin,1609,6,14,7,15,54,61,-7,49
Annan Athlet,1609,7,12,11,13,49,42,7,47
Berwick,1609,8,8,10,18,31,61,-30,34
Edinburgh Ci,1609,9,7,9,20,37,63,-26,30
Cowdenbeath,1609,10,4,10,22,24,56,-32,22
Montrose,1610,1,24,7,5,60,34,26,79
Peterhead,1610,2,24,4,8,79,38,41,76
Stirling,1610,3,16,7,13,62,53,9,55
Stenhousem'r,1610,4,15,9,12,57,48,9,54
Clyde,1610,5,15,9,12,53,49,4,54
Elgin,1610,6,14,6,16,53,61,-8,48
Annan Athlet,1610,7,11,12,13,47,41,6,45
Berwick,1610,8,8,10,18,30,60,-30,34
Edinburgh Ci,1610,9,7,9,20,36,62,-26,30
Cowdenbeath,1610,10,4,11,21,23,54,-31,23
Montrose,1611,1,24,7,5,60,34,26,79
Peterhead,1611,2,23,5,8,80,41,39,74
Stirling,1611,3,17,6,13,62,51,11,57
Stenhousem'r,1611,4,15,8,13,55,48,7,53
Clyde,1611,5,14,9,13,53,51,2,51
Elgin,1611,6,14,6,16,53,61,-8,48
Annan Athlet,1611,7,11,12,13,48,42,6,45
Berwick,1611,8,9,10,17,32,60,-28,37
Edinburgh Ci,1611,9,7,10,19,39,63,-24,31
Cowdenbeath,1611,10,4,11,21,24,55,-31,23
Montrose,1612,1,24,7,5,61,35,26,79
Peterhead,1612,2,24,4,8,81,38,43,76
Stirling,1612,3,16,7,13,61,52,9,55
Stenhousem'r,1612,4,15,9,12,56,47,9,54
Clyde,1612,5,14,10,12,53,50,3,52
Elgin,1612,6,14,6,16,54,62,-8,48
Annan Athlet,1612,7,11,11,14,47,43,4,44
Berwick,1612,8,8,11,17,31,60,-29,35
Edinburgh Ci,1612,9,7,9,20,36,64,-28,30
Cowdenbeath,1612,10,5,10,21,25,54,-29,25
Montrose,1613,1,24,7,5,62,35,27,79
Peterhead,1613,2,24,4,8,82,39,43,76
Stenhousem'r,1613,3,16,8,12,58,47,11,56
Stirling,1613,4,16,6,14,61,54,7,54
Clyde,1613,5,14,9,13,52,50,2,51
Elgin,1613,6,14,6,16,54,63,-9,48
Annan Athlet,1613,7,11,11,14,47,42,5,44
Berwick,1613,8,9,10,17,31,59,-28,37
Edinburgh Ci,1613,9,7,9,20,37,65,-28,30
Cowdenbeath,1613,10,5,10,21,24,54,-30,25
Montrose,1614,1,23,8,5,60,35,25,77
Peterhead,1614,2,24,4,8,79,39,40,76
Stenhousem'r,1614,3,16,8,12,56,46,10,56
Stirling,1614,4,16,6,14,60,52,8,54
Clyde,1614,5,14,9,13,52,51,1,51
Elgin,1614,6,14,7,15,54,61,-7,49
Annan Athlet,1614,7,11,11,14,47,44,3,44
Berwick,1614,8,9,10,17,32,59,-27,37
Edinburgh Ci,1614,9,7,9,20,37,62,-25,30
Cowdenbeath,1614,10,5,10,21,26,54,-28,25
Montrose,1615,1,24,7,5,61,34,27,79
Peterhead,1615,2,24,4,8,79,39,40,76
Stirling,1615,3,17,6,13,64,52,12,57
Clyde,1615,4,15,9,12,54,48,6,54
Stenhousem'r,1615,5,15,8,13,56,50,6,53
Elgin,1615,6,14,6,16,53,62,-9,48
Annan Athlet,1615,7,11,11,14,47,42,5,44
Berwick,1615,8,8,10,18,29,61,-32,34
Edinburgh Ci,1615,9,7,9,20,37,62,-25,30
Cowdenbeath,1615,10,5,10,21,24,54,-30,25
Montrose,1616,1,23,7,6,59,35,24,76
Peterhead,1616,2,23,5,8,77,38,39,74
Stirling,1616,3,17,6,13,61,51,10,57
Clyde,1616,4,15,9,12,55,48,7,54
Stenhousem'r,1616,5,15,8,13,55,47,8,53
Elgin,1616,6,15,6,15,54,60,-6,51
Annan Athlet,1616,7,12,11,13,49,41,8,47
Berwick,1616,8,8,10,18,29,62,-33,34
Edinburgh Ci,1616,9,7,10,19,36,60,-24,31
Cowdenbeath,1616,10,4,10,22,23,56,-33,22
Montrose,1617,1,23,8,5,61,36,25,77
Peterhead,1617,2,24,4,8,80,39,41,76
Stirling,1617,3,17,6,13,62,52,10,57
Clyde,1617,4,15,9,12,54,49,5,54
Stenhousem'r,1617,5,15,8,13,56,48,8,53
Elgin,1617,6,14,7,15,55,62,-7,49
Annan Athlet,1617,7,11,12,13,47,41,6,45
Berwick,1617,8,8,10,18,30,61,-31,34
Edinburgh Ci,1617,9,7,9,20,37,63,-26,30
Cowdenbeath,1617,10,4,11,21,23,54,-31,23
Montrose,1618,1,24,7,5,61,34,27,79
Peterhead,1618,2,24,4,8,79,38,41,76
Stirling,1618,3,17,6,13,63,53,10,57
Clyde,1618,4,15,9,12,52,48,4,54
Stenhousem'r,1618,5,15,8,13,57,49,8,53
Elgin,1618,6,14,6,16,53,62,-9,48
Annan Athlet,1618,7,12,11,13,49,41,8,47
Berwick,1618,8,8,10,18,29,59,-30,34
Edinburgh Ci,1618,9,7,9,20,36,62,-26,30
Cowdenbeath,1618,10,4,10,22,23,56,-33,22
Montrose,1619,1,24,7,5,60,34,26,79
Peterhead,1619,2,24,4,8,80,39,41,76
Stirling,1619,3,17,6,13,62,52,10,57
Clyde,1619,4,15,9,12,54,48,6,54
Stenhousem'r,1619,5,15,8,13,56,48,8,53
Elgin,1619,6,14,6,16,53,61,-8,48
Annan Athlet,1619,7,12,11,13,48,41,7,47
Berwick,1619,8,8,10,18,29,61,-32,34
Edinburgh Ci,1619,9,7,9,20,37,63,-26,30
Cowdenbeath,1619,10,4,10,22,23,55,-32,22
Montrose,1620,1,23,8,5,59,34,25,77
Peterhead,1620,2,24,4,8,79,39,40,76
Stirling,1620,3,17,6,13,62,51,11,57
Stenhousem'r,1620,4,15,8,13,55,48,7,53
Clyde,1620,5,14,10,12,52,49,3,52
Elgin,1620,6,14,7,15,53,60,-7,49
Annan Athlet,1620,7,11,11,14,47,42,5,44
Berwick,1620,8,8,11,17,30,59,-29,35
Edinburgh Ci,1620,9,7,9,20,37,62,-25,30
Cowdenbeath,1620,10,5,10,21,24,54,-30,25
Montrose,1621,1,24,7,5,61,34,27,79
Peterhead,1621,2,24,4,8,79,39,40,76
Stirling,1621,3,17,6,13,64,51,13,57
Stenhousem'r,1621,4,15,8,13,55,50,5,53
Clyde,1621,5,14,10,12,52,49,3,52
Elgin,1621,6,14,6,16,53,62,-9,48
Annan Athlet,1621,7,12,11,13,50,42,8,47
Berwick,1621,8,8,11,17,30,59,-29,35
Edinburgh Ci,1621,9,7,9,20,37,62,-25,30
Cowdenbeath,1621,10,4,10,22,24,57,-33,22
Montrose,1622,1,23,8,5,60,35,25,77
Peterhead,1622,2,23,5,8,78,39,39,74
Stirling,1622,3,16,7,13,61,52,9,55
Stenhousem'r,1622,4,15,9,12,56,47,9,54
Clyde,1622,5,14,10,12,52,49,3,52
Elgin,1622,6,14,7,15,54,61,-7,49
Annan Athlet,1622,7,11,12,13,48,42,6,45
Berwick,1622,8,8,11,17,30,59,-29,35
Edinburgh Ci,1622,9,7,10,19,37,61,-24,31
Cowdenbeath,1622,10,4,11,21,24,55,-31,23
Montrose,1623,1,23,8,5,60,35,25,77
Peterhead,1623,2,23,4,9,78,40,38,73
Stirling,1623,3,17,6,13,63,52,11,57
Clyde,1623,4,15,9,12,52,48,4,54
Stenhousem'r,1623,5,15,8,13,56,49,7,53
Elgin,1623,6,14,7,15,54,61,-7,49
Annan Athlet,1623,7,11,11,14,47,43,4,44
Berwick,1623,8,8,10,18,29,59,-30,34
Edinburgh Ci,1623,9,8,9,19,38,61,-23,33
Cowdenbeath,1623,10,5,10,21,25,54,-29,25
Peterhead,1624,1,24,4,8,80,38,42,76
Montrose,1624,2,23,7,6,60,36,24,76
Stirling,1624,3,16,7,13,60,51,9,55
Stenhousem'r,1624,4,15,9,12,55,46,9,54
Clyde,1624,5,15,9,12,53,49,4,54
Elgin,1624,6,15,6,15,55,61,-6,51
Annan Athlet,1624,7,12,11,13,50,41,9,47
Berwick,1624,8,8,10,18,30,60,-30,34
Edinburgh Ci,1624,9,7,9,20,36,63,-27,30
Cowdenbeath,1624,10,4,10,22,23,57,-34,22
Montrose,1625,1,24,7,5,61,35,26,79
Peterhead,1625,2,24,4,8,79,39,40,76
Stirling,1625,3,17,6,13,63,53,10,57
Clyde,1625,4,15,9,12,53,48,5,54
Stenhousem'r,1625,5,15,8,13,57,49,8,53
Elgin,1625,6,14,6,16,54,62,-8,48
Annan Athlet,1625,7,12,11,13,48,41,7,47
Berwick,1625,8,8,10,18,29,60,-31,34
Edinburgh Ci,1625,9,7,9,20,37,62,-25,30
Cowdenbeath,1625,10,4,10,22,23,55,-32,22
Peterhead,1626,1,24,4,8,78,38,40,76
Montrose,1626,2,23,7,6,59,35,24,76
Stenhousem'r,1626,3,16,8,12,57,47,10,56
Stirling,1626,4,16,6,14,61,53,8,54
Clyde,1626,5,14,9,13,51,50,1,51
Elgin,1626,6,15,6,15,54,60,-6,51
Annan Athlet,1626,7,11,12,13,47,41,6,45
Berwick,1626,8,9,10,17,31,58,-27,37
Edinburgh Ci,1626,9,7,9,20,36,61,-25,30
Cowdenbeath,1626,10,4,11,21,23,54,-31,23
Montrose,1627,1,24,7,5,62,34,28,79
Peterhead,1627,2,23,5,8,78,39,39,74
Stirling,1627,3,17,6,13,62,52,10,57
Stenhousem'r,1627,4,15,8,13,56,48,8,53
Clyde,1627,5,14,9,13,51,49,2,51
Elgin,1627,6,14,6,16,53,63,-10,48
Annan Athlet,1627,7,12,11,13,50,43,7,47
Berwick,1627,8,9,10,17,30,58,-28,37
Edinburgh Ci,1627,9,7,10,19,37,61,-24,31
Cowdenbeath,1627,10,4,10,22,25,57,-32,22
Montrose,1628,1,24,7,5,62,35,27,79
Peterhead,1628,2,24,4,8,84,38,46,76
Stirling,1628,3,17,6,13,64,52,12,57
Stenhousem'r,1628,4,15,8,13,56,50,6,53
Clyde,1628,5,14,10,12,52,49,3,52
Elgin,1628,6,14,6,16,54,63,-9,48
Annan Athlet,1628,7,12,11,13,48,41,7,47
Berwick,1628,8,8,11,17,30,59,-29,35
Edinburgh Ci,1628,9,7,9,20,36,67,-31,30
Cowdenbeath,1628,10,4,10,22,23,55,-32,22
Peterhead,1629,1,24,4,8,84,40,44,76
Montrose,1629,2,23,7,6,60,36,24,76
Stirling,1629,3,17,6,13,65,54,11,57
Clyde,1629,4,15,9,12,52,48,4,54
Stenhousem'r,1629,5,15,8,13,58,51,7,53
Elgin,1629,6,15,6,15,55,61,-6,51
Annan Athlet,1629,7,11,11,14,47,42,5,44
Berwick,1629,8,8,10,18,29,59,-30,34
Edinburgh Ci,1629,9,7,9,20,38,67,-29,30
Cowdenbeath,1629,10,5,10,21,24,54,-30,25
Montrose,1630,1,24,7,5,60,34,26,79
Peterhead,1630,2,24,4,8,83,38,45,76
Stenhousem'r,1630,3,16,8,12,57,47,10,56
Stirling,1630,4,16,6,14,61,53,8,54
Clyde,1630,5,15,9,12,53,49,4,54
Elgin,1630,6,14,6,16,53,61,-8,48
Annan Athlet,1630,7,11,11,14,48,44,4,44
Berwick,1630,8,8,10,18,30,60,-30,34
Edinburgh Ci,1630,9,7,9,20,36,66,-30,30
Cowdenbeath,1630,10,5,10,21,26,55,-29,25
Montrose,1631,1,24,7,5,61,34,27,79
Peterhead,1631,2,24,4,8,82,39,43,76
Stirling,1631,3,17,6,13,62,52,10,57
Clyde,1631,4,15,9,12,54,50,4,54
Stenhousem'r,1631,5,15,8,13,56,48,8,53
Elgin,1631,6,14,6,16,53,62,-9,48
Annan Athlet,1631,7,11,11,14,48,43,5,44
Berwick,1631,8,8,10,18,31,61,-30,34
Edinburgh Ci,1631,9,7,9,20,37,65,-28,30
Cowdenbeath,1631,10,5,10,21,25,55,-30,25
Montrose,1632,1,24,7,5,62,35,27,79
Peterhead,1632,2,24,4,8,80,38,42,76
Stirling,1632,3,17,6,13,62,52,10,57
Stenhousem'r,1632,4,15,8,13,56,48,8,53
Clyde,1632,5,14,10,12,53,50,3,52
Elgin,1632,6,14,6,16,54,63,-9,48
Annan Athlet,1632,7,11,11,14,47,45,2,44
Berwick,1632,8,8,11,17,31,60,-29,35
Edinburgh Ci,1632,9,7,9,20,36,63,-27,30
Cowdenbeath,1632,10,5,10,21,27,54,-27,25
Montrose,1633,1,24,7,5,61,35,26,79
Peterhead,1633,2,24,4,8,82,39,43,76
Stirling,1633,3,17,6,13,61,51,10,57
Clyde,1633,4,15,9,12,53,48,5,54
Stenhousem'r,1633,5,15,8,13,55,47,8,53
Elgin,1633,6,14,6,16,54,62,-8,48
Annan Athlet,1633,7,12,11,13,50,41,9,47
Berwick,1633,8,8,10,18,29,60,-31,34
Edinburgh Ci,1633,9,7,9,20,37,65,-28,30
Cowdenbeath,1633,10,4,10,22,23,57,-34,22
Montrose,1634,1,24,7,5,62,36,26,79
Peterhead,1634,2,24,4,8,80,38,42,76
Stenhousem'r,1634,3,16,8,12,58,47,11,56
Stirling,1634,4,16,6,14,61,54,7,54
Clyde,1634,5,15,9,12,52,48,4,54
Elgin,1634,6,14,6,16,55,63,-8,48
Annan Athlet,1634,7,12,11,13,49,41,8,47
Berwick,1634,8,8,10,18,29,59,-30,34
Edinburgh Ci,1634,9,7,9,20,36,63,-27,30
Cowdenbeath,1634,10,4,10,22,23,56,-33,22
Montrose,1635,1,24,7,5,62,36,26,79
Peterhead,1635,2,24,4,8,81,38,43,76
Stirling,1635,3,17,6,13,63,52,11,57
Clyde,1635,4,15,9,12,52,48,4,54
Stenhousem'r,1635,5,15,8,13,56,49,7,53
Elgin,1635,6,14,6,16,55,63,-8,48
Annan Athlet,1635,7,11,12,13,47,41,6,45
Berwick,1635,8,8,10,18,29,59,-30,34
Edinburgh Ci,1635,9,7,9,20,36,64,-28,30
Cowdenbeath,1635,10,4,11,21,23,54,-31,23
Montrose,1636,1,24,7,5,62,34,28,79
Peterhead,1636,2,24,4,8,84,40,44,76
Stenhousem'r,1636,3,16,8,12,58,47,11,56
Stirling,1636,4,16,6,14,61,54,7,54
Clyde,1636,5,14,9,13,52,50,2,51
Elgin,1636,6,14,6,16,53,63,-10,48
Annan Athlet,1636,7,12,11,13,49,42,7,47
Berwick,1636,8,9,10,17,31,59,-28,37
Edinburgh Ci,1636,9,7,9,20,38,67,-29,30
Cowdenbeath,1636,10,4,10,22,24,56,-32,22
Montrose,1637,1,24,7,5,63,34,29,79
Peterhead,1637,2,24,4,8,81,38,43,76
Stirling,1637,3,17,6,13,63,52,11,57
Stenhousem'r,1637,4,15,8,13,56,49,7,53
Clyde,1637,5,14,10,12,51,48,3,52
Elgin,1637,6,14,6,16,53,64,-11,48
Annan Athlet,1637,7,11,11,14,47,42,5,44
Berwick,1637,8,8,11,17,29,58,-29,35
Edinburgh Ci,1637,9,7,9,20,36,64,-28,30
Cowdenbeath,1637,10,5,10,21,24,54,-30,25
Montrose,1638,1,24,7,5,64,34,30,79
Peterhead,1638,2,24,4,8,82,39,43,76
Stirling,1638,3,17,6,13,63,51,12,57
Stenhousem'r,1638,4,15,8,13,55,49,6,53
Clyde,1638,5,14,9,13,52,50,2,51
Elgin,1638,6,14,6,16,53,65,-12,48
Annan Athlet,1638,7,11,12,13,48,42,6,45
Berwick,1638,8,9,10,17,31,59,-28,37
Edinburgh Ci,1638,9,7,9,20,37,65,-28,30
Cowdenbeath,1638,10,4,11,21,24,55,-31,23
Montrose,1639,1,24,7,5,60,34,26,79
Peterhead,1639,2,24,4,8,79,39,40,76
Stenhousem'r,1639,3,16,8,12,57,47,10,56
Stirling,1639,4,16,6,14,61,53,8,54
Clyde,1639,5,15,9,12,53,48,5,54
Elgin,1639,6,14,6,16,53,61,-8,48
Annan Athlet,1639,7,11,12,13,48,42,6,45
Berwick,1639,8,8,10,18,29,60,-31,34
Edinburgh Ci,1639,9,7,9,20,37,62,-25,30
Cowdenbeath,1639,10,4,11,21,24,55,-31,23
Montrose,1640,1,24,7,5,62,34,28,79
Peterhead,1640,2,24,4,8,80,39,41,76
Stirling,1640,3,16,7,13,63,54,9,55
Stenhousem'r,1640,4,15,9,12,58,49,9,54
Clyde,1640,5,15,9,12,54,49,5,54
Elgin,1640,6,14,6,16,53,63,-10,48
Annan Athlet,1640,7,11,11,14,48,43,5,44
Berwick,1640,8,8,10,18,30,61,-31,34
Edinburgh Ci,1640,9,7,9,20,37,63,-26,30
Cowdenbeath,1640,10,5,10,21,25,55,-30,25
Montrose,1641,1,24,7,5,61,34,27,79
Peterhead,1641,2,24,4,8,79,39,40,76
Stenhousem'r,1641,3,16,8,12,58,46,12,56
Stirling,1641,4,16,6,14,60,54,6,54
Clyde,1641,5,14,9,13,51,49,2,51
Elgin,1641,6,14,6,16,53,62,-9,48
Annan Athlet,1641,7,12,11,13,50,43,7,47
Berwick,1641,8,9,10,17,30,58,-28,37
Edinburgh Ci,1641,9,7,9,20,37,62,-25,30
Cowdenbeath,1641,10,4,10,22,25,57,-32,22
Montrose,1642,1,24,7,5,60,34,26,79
Peterhead,1642,2,24,4,8,82,39,43,76
Stirling,1642,3,17,6,13,62,52,10,57
Stenhousem'r,1642,4,15,8,13,56,48,8,53
Clyde,1642,5,14,10,12,54,51,3,52
Elgin,1642,6,14,6,16,53,61,-8,48
Annan Athlet,1642,7,11,12,13,47,41,6,45
Berwick,1642,8,8,11,17,32,61,-29,35
Edinburgh Ci,1642,9,7,9,20,37,65,-28,30
Cowdenbeath,1642,10,4,11,21,23,54,-31,23
Peterhead,1643,1,24,4,8,81,38,43,76
Montrose,1643,2,23,7,6,59,36,23,76
Stirling,1643,3,16,7,13,61,52,9,55
Stenhousem'r,1643,4,15,9,12,56,47,9,54
Clyde,1643,5,14,10,12,52,49,3,52
Elgin,1643,6,15,6,15,55,60,-5,51
Annan Athlet,1643,7,12,11,13,49,42,7,47
Berwick,1643,8,8,11,17,30,59,-29,35
Edinburgh Ci,1643,9,7,9,20,36,64,-28,30
Cowdenbeath,1643,10,4,10,22,24,56,-32,22
Peterhead,1644,1,24,4,8,81,40,41,76
Montrose,1644,2,23,7,6,59,35,24,76
Stirling,1644,3,16,7,13,62,53,9,55
Stenhousem'r,1644,4,15,9,12,57,48,9,54
Clyde,1644,5,14,9,13,51,49,2,51
Elgin,1644,6,15,6,15,54,60,-6,51
Annan Athlet,1644,7,11,12,13,49,43,6,45
Berwick,1644,8,9,10,17,30,58,-28,37
Edinburgh Ci,1644,9,7,9,20,38,64,-26,30
Cowdenbeath,1644,10,4,11,21,25,56,-31,23
Montrose,1645,1,24,7,5,62,35,27,79
Peterhead,1645,2,24,4,8,83,39,44,76
Stirling,1645,3,17,6,13,62,52,10,57
Clyde,1645,4,15,9,12,57,49,8,54
Stenhousem'r,1645,5,15,8,13,56,48,8,53
Elgin,1645,6,14,6,16,54,63,-9,48
Annan Athlet,1645,7,11,11,14,48,43,5,44
Berwick,1645,8,8,10,18,30,64,-34,34
Edinburgh Ci,1645,9,7,9,20,37,66,-29,30
Cowdenbeath,1645,10,5,10,21,25,55,-30,25
Peterhead,1646,1,24,4,8,79,38,41,76
Montrose,1646,2,23,7,6,59,36,23,76
Stenhousem'r,1646,3,16,8,12,59,47,12,56
Stirling,1646,4,16,6,14,61,55,6,54
Clyde,1646,5,15,9,12,53,49,4,54
Elgin,1646,6,15,6,15,55,60,-5,51
Annan Athlet,1646,7,11,11,14,48,43,5,44
Berwick,1646,8,8,10,18,30,60,-30,34
Edinburgh Ci,1646,9,7,9,20,36,62,-26,30
Cowdenbeath,1646,10,5,10,21,25,55,-30,25
Montrose,1647,1,24,7,5,61,35,26,79
Peterhead,1647,2,24,4,8,79,38,41,76
Stenhousem'r,1647,3,16,8,12,58,48,10,56
Stirling,1647,4,16,6,14,62,54,8,54
Clyde,1647,5,14,9,13,51,51,0,51
Elgin,1647,6,14,6,16,54,62,-8,48
Annan Athlet,1647,7,12,11,13,49,42,7,47
Berwick,1647,8,9,10,17,32,58,-26,37
Edinburgh Ci,1647,9,7,9,20,36,62,-26,30
Cowdenbeath,1647,10,4,10,22,24,56,-32,22
Montrose,1648,1,24,7,5,60,34,26,79
Peterhead,1648,2,23,5,8,77,38,39,74
Stirling,1648,3,16,7,13,61,52,9,55
Stenhousem'r,1648,4,15,9,12,56,47,9,54
Clyde,1648,5,14,10,12,51,48,3,52
Elgin,1648,6,14,6,16,53,61,-8,48
Annan Athlet,1648,7,12,11,13,49,41,8,47
Berwick,1648,8,8,11,17,29,58,-29,35
Edinburgh Ci,1648,9,7,10,19,36,60,-24,31
Cowdenbeath,1648,10,4,10,22,23,56,-33,22
Montrose,1649,1,24,7,5,63,34,29,79
Peterhead,1649,2,24,4,8,78,38,40,76
Stirling,1649,3,17,6,13,64,53,11,57
Stenhousem'r,1649,4,15,8,13,57,50,7,53
Clyde,1649,5,14,10,12,53,50,3,52
Elgin,1649,6,14,6,16,53,64,-11,48
Annan Athlet,1649,7,11,12,13,47,41,6,45
Berwick,1649,8,8,11,17,31,60,-29,35
Edinburgh Ci,1649,9,7,9,20,36,61,-25,30
Cowdenbeath,1649,10,4,11,21,23,54,-31,23
Montrose,1650,1,24,7,5,61,35,26,79
Peterhead,1650,2,24,4,8,79,38,41,76
Stirling,1650,3,16,7,13,63,54,9,55
Stenhousem'r,1650,4,15,9,12,58,49,9,54
Clyde,1650,5,15,9,12,52,48,4,54
Elgin,1650,6,14,6,16,54,62,-8,48
Annan Athlet,1650,7,11,11,14,47,43,4,44
Berwick,1650,8,8,10,18,29,59,-30,34
Edinburgh Ci,1650,9,7,9,20,36,62,-26,30
Cowdenbeath,1650,10,5,10,21,25,54,-29,25
Montrose,1651,1,24,7,5,61,34,27,79
Peterhead,1651,2,24,4,8,81,38,43,76
Stenhousem'r,1651,3,16,8,12,57,46,11,56
Stirling,1651,4,16,6,14,60,53,7,54
Clyde,1651,5,14,10,12,51,48,3,52
Elgin,1651,6,14,6,16,53,62,-9,48
Annan Athlet,1651,7,12,11,13,48,41,7,47
Berwick,1651,8,8,11,17,29,58,-29,35
Edinburgh Ci,1651,9,7,9,20,36,64,-28,30
Cowdenbeath,1651,10,4,10,22,23,55,-32,22
Montrose,1652,1,23,8,5,60,35,25,77
Peterhead,1652,2,24,4,8,80,38,42,76
Stenhousem'r,1652,3,16,8,12,56,46,10,56
Stirling,1652,4,16,6,14,60,52,8,54
Clyde,1652,5,14,10,12,53,50,3,52
Elgin,1652,6,14,7,15,54,61,-7,49
Annan Athlet,1652,7,12,11,13,50,43,7,47
Berwick,1652,8,8,11,17,31,60,-29,35
Edinburgh Ci,1652,9,7,9,20,36,63,-27,30
Cowdenbeath,1652,10,4,10,22,25,57,-32,22
Montrose,1653,1,24,7,5,62,34,28,79
Peterhead,1653,2,24,4,8,79,38,41,76
Stirling,1653,3,17,6,13,63,53,10,57
Clyde,1653,4,15,9,12,54,48,6,54
Stenhousem'r,1653,5,15,8,13,57,49,8,53
Elgin,1653,6,14,6,16,53,63,-10,48
Annan Athlet,1653,7,11,12,13,48,42,6,45
Berwick,1653,8,8,10,18,29,61,-32,34
Edinburgh Ci,1653,9,7,9,20,36,62,-26,30
Cowdenbeath,1653,10,4,11,21,24,55,-31,23
Montrose,1654,1,24,7,5,61,35,26,79
Peterhead,1654,2,24,4,8,81,39,42,76
Stirling,1654,3,17,6,13,63,53,10,57
Stenhousem'r,1654,4,15,8,13,57,49,8,53
Clyde,1654,5,14,10,12,53,50,3,52
Elgin,1654,6,14,6,16,54,62,-8,48
Annan Athlet,1654,7,11,11,14,49,44,5,44
Berwick,1654,8,8,11,17,31,60,-29,35
Edinburgh Ci,1654,9,7,9,20,37,64,-27,30
Cowdenbeath,1654,10,5,10,21,26,56,-30,25
Montrose,1655,1,23,8,5,61,36,25,77
Peterhead,1655,2,23,5,8,78,39,39,74
Stirling,1655,3,17,6,13,65,51,14,57
Clyde,1655,4,15,9,12,52,48,4,54
Stenhousem'r,1655,5,15,8,13,55,51,4,53
Elgin,1655,6,14,7,15,55,62,-7,49
Annan Athlet,1655,7,11,11,14,47,43,4,44
Berwick,1655,8,8,10,18,29,59,-30,34
Edinburgh Ci,1655,9,7,10,19,37,61,-24,31
Cowdenbeath,1655,10,5,10,21,25,54,-29,25
Montrose,1656,1,24,7,5,61,35,26,79
Peterhead,1656,2,24,4,8,79,38,41,76
Stirling,1656,3,17,6,13,63,51,12,57
Stenhousem'r,1656,4,15,8,13,55,49,6,53
Clyde,1656,5,14,9,13,53,52,1,51
Elgin,1656,6,14,6,16,54,62,-8,48
Annan Athlet,1656,7,11,12,13,47,41,6,45
Berwick,1656,8,9,10,17,33,60,-27,37
Edinburgh Ci,1656,9,7,9,20,36,62,-26,30
Cowdenbeath,1656,10,4,11,21,23,54,-31,23
Montrose,1657,1,23,8,5,62,37,25,77
Peterhead,1657,2,24,4,8,78,38,40,76
Stirling,1657,3,17,6,13,63,51,12,57
Stenhousem'r,1657,4,15,8,13,55,49,6,53
Clyde,1657,5,14,9,13,51,49,2,51
Elgin,1657,6,14,7,15,56,63,-7,49
Annan Athlet,1657,7,11,12,13,49,43,6,45
Berwick,1657,8,9,10,17,30,58,-28,37
Edinburgh Ci,1657,9,7,9,20,36,61,-25,30
Cowdenbeath,1657,10,4,11,21,25,56,-31,23
Peterhead,1658,1,24,4,8,83,39,44,76
Montrose,1658,2,23,7,6,61,37,24,76
Stirling,1658,3,17,6,13,62,51,11,57
Clyde,1658,4,15,9,12,53,49,4,54
Stenhousem'r,1658,5,15,8,13,55,48,7,53
Elgin,1658,6,15,6,15,56,62,-6,51
Annan Athlet,1658,7,11,12,13,47,41,6,45
Berwick,1658,8,8,10,18,30,60,-30,34
Edinburgh Ci,1658,9,7,9,20,37,66,-29,30
Cowdenbeath,1658,10,4,11,21,23,54,-31,23
Montrose,1659,1,23,8,5,60,35,25,77
Peterhead,1659,2,24,4,8,84,38,46,76
Stirling,1659,3,16,7,13,60,51,9,55
Stenhousem'r,1659,4,15,9,12,55,46,9,54
Clyde,1659,5,14,10,12,52,49,3,52
Elgin,1659,6,14,7,15,54,61,-7,49
Annan Athlet,1659,7,12,11,13,50,42,8,47
Berwick,1659,8,8,11,17,30,59,-29,35
Edinburgh Ci,1659,9,7,9,20,36,67,-31,30
Cowdenbeath,1659,10,4,10,22,24,57,-33,22
Montrose,1660,1,24,7,5,60,34,26,79
Peterhead,1660,2,23,5,8,79,40,39,74
Stenhousem'r,1660,3,16,8,12,58,48,10,56
Stirling,1660,4,16,6,14,62,54,8,54
Clyde,1660,5,14,10,12,53,50,3,52
Elgin,1660,6,14,6,16,53,61,-8,48
Annan Athlet,1660,7,12,11,13,49,42,7,47
Berwick,1660,8,8,11,17,31,60,-29,35
Edinburgh Ci,1660,9,7,10,19,38,62,-24,31
Cowdenbeath,1660,10,4,10,22,24,56,-32,22
Montrose,1661,1,24,7,5,60,34,26,79
Peterhead,1661,2,24,4,8,82,38,44,76
Stirling,1661,3,17,6,13,62,51,11,57
Clyde,1661,4,15,9,12,53,49,4,54
Stenhousem'r,1661,5,15,8,13,55,48,7,53
Elgin,1661,6,14,6,16,53,61,-8,48
Annan Athlet,1661,7,12,11,13,48,41,7,47
Berwick,1661,8,8,10,18,30,60,-30,34
Edinburgh Ci,1661,9,7,9,20,36,65,-29,30
Cowdenbeath,1661,10,4,10,22,23,55,-32,22
Montrose,1662,1,24,7,5,61,35,26,79
Peterhead,1662,2,24,4,8,81,40,41,76
Stirling,1662,3,17,6,13,61,51,10,57
Stenhousem'r,1662,4,15,8,13,55,47,8,53
Clyde,1662,5,14,9,13,53,51,2,51
Elgin,1662,6,14,6,16,54,62,-8,48
Annan Athlet,1662,7,12,11,13,49,41,8,47
Berwick,1662,8,9,10,17,32,60,-28,37
Edinburgh Ci,1662,9,7,9,20,38,64,-26,30
Cowdenbeath,1662,10,4,10,22,23,56,-33,22
Montrose,1663,1,24,7,5,65,34,31,79
Peterhead,1663,2,24,4,8,80,39,41,76
Stenhousem'r,1663,3,16,8,12,57,47,10,56
Stirling,1663,4,16,6,14,61,53,8,54
Clyde,1663,5,15,9,12,53,49,4,54
Elgin,1663,6,14,6,16,53,66,-13,48
Annan Athlet,1663,7,12,11,13,49,41,8,47
Berwick,1663,8,8,10,18,30,60,-30,34
Edinburgh Ci,1663,9,7,9,20,37,63,-26,30
Cowdenbeath,1663,10,4,10,22,23,56,-33,22
Montrose,1664,1,23,8,5,60,35,25,77
Peterhead,1664,2,24,4,8,78,38,40,76
Stenhousem'r,1664,3,16,8,12,56,46,10,56
Stirling,1664,4,16,6,14,60,52,8,54
Clyde,1664,5,14,10,12,52,49,3,52
Elgin,1664,6,14,7,15,54,61,-7,49
Annan Athlet,1664,7,11,11,14,47,42,5,44
Berwick,1664,8,8,11,17,30,59,-29,35
Edinburgh Ci,1664,9,7,9,20,36,61,-25,30
Cowdenbeath,1664,10,5,10,21,24,54,-30,25
Montrose,1665,1,24,7,5,61,34,27,79
Peterhead,1665,2,24,4,8,82,39,43,76
Stirling,1665,3,17,6,13,62,52,10,57
Stenhousem'r,1665,4,15,8,13,56,48,8,53
Clyde,1665,5,14,10,12,51,48,3,52
Elgin,1665,6,14,6,16,53,62,-9,48
Annan Athlet,1665,7,12,11,13,49,41,8,47
Berwick,1665,8,8,11,17,29,58,-29,35
Edinburgh Ci,1665,9,7,9,20,37,65,-28,30
Cowdenbeath,1665,10,4,10,22,23,56,-33,22
Montrose,1666,1,24,7,5,62,34,28,79
Peterhead,1666,2,24,4,8,79,39,40,76
Stirling,1666,3,17,6,13,61,51,10,57
Clyde,1666,4,15,9,12,53,49,4,54
Stenhousem'r,1666,5,15,8,13,55,47,8,53
Elgin,1666,6,14,6,16,53,63,-10,48
Annan Athlet,1666,7,11,12,13,47,41,6,45
Berwick,1666,8,8,10,18,30,60,-30,34
Edinburgh Ci,1666,9,7,9,20,37,62,-25,30
Cowdenbeath,1666,10,4,11,21,23,54,-31,23
Montrose,1667,1,24,7,5,62,35,27,79
Peterhead,1667,2,24,4,8,82,39,43,76
Stenhousem'r,1667,3,16,8,12,58,46,12,56
Stirling,1667,4,16,6,14,60,54,6,54
Clyde,1667,5,14,10,12,51,48,3,52
Elgin,1667,6,14,6,16,54,63,-9,48
Annan Athlet,1667,7,11,12,13,48,42,6,45
Berwick,1667,8,8,11,17,29,58,-29,35
Edinburgh Ci,1667,9,7,9,20,37,65,-28,30
Cowdenbeath,1667,10,4,11,21,24,55,-31,23
Montrose,1668,1,24,7,5,61,34,27,79
Peterhead,1668,2,24,4,8,80,38,42,76
Stirling,1668,3,16,7,13,60,51,9,55
Stenhousem'r,1668,4,15,9,12,55,46,9,54
Clyde,1668,5,14,10,12,51,48,3,52
Elgin,1668,6,14,6,16,53,62,-9,48
Annan Athlet,1668,7,11,11,14,47,42,5,44
Berwick,1668,8,8,11,17,29,58,-29,35
Edinburgh Ci,1668,9,7,9,20,36,63,-27,30
Cowdenbeath,1668,10,5,10,21,24,54,-30,25
Peterhead,1669,1,24,4,8,80,38,42,76
Montrose,1669,2,23,7,6,59,36,23,76
Stenhousem'r,1669,3,16,8,12,59,48,11,56
Stirling,1669,4,16,6,14,62,55,7,54
Clyde,1669,5,14,10,12,52,49,3,52
Elgin,1669,6,15,6,15,55,60,-5,51
Annan Athlet,1669,7,12,11,13,48,41,7,47
Berwick,1669,8,8,11,17,30,59,-29,35
Edinburgh Ci,1669,9,7,9,20,36,63,-27,30
Cowdenbeath,1669,10,4,10,22,23,55,-32,22
Montrose,1670,1,24,7,5,65,34,31,79
Peterhead,1670,2,24,4,8,84,39,45,76
Stirling,1670,3,17,6,13,61,51,10,57
Clyde,1670,4,15,9,12,54,48,6,54
Stenhousem'r,1670,5,15,8,13,55,47,8,53
Elgin,1670,6,14,6,16,53,66,-13,48
Annan Athlet,1670,7,11,12,13,48,42,6,45
Berwick,1670,8,8,10,18,29,61,-32,34
Edinburgh Ci,1670,9,7,9,20,37,67,-30,30
Cowdenbeath,1670,10,4,11,21,24,55,-31,23
Montrose,1671,1,24,7,5,61,34,27,79
Peterhead,1671,2,24,4,8,80,38,42,76
Stirling,1671,3,16,7,13,60,51,9,55
Stenhousem'r,1671,4,15,9,12,55,46,9,54
Clyde,1671,5,15,9,12,53,49,4,54
Elgin,1671,6,14,6,16,53,62,-9,48
Annan Athlet,1671,7,11,12,13,48,42,6,45
Berwick,1671,8,8,10,18,30,60,-30,34
Edinburgh Ci,1671,9,7,9,20,36,63,-27,30
Cowdenbeath,1671,10,4,11,21,24,55,-31,23
Montrose,1672,1,24,7,5,64,34,30,79
Peterhead,1672,2,24,4,8,80,40,40,76
Stenhousem'r,1672,3,16,8,12,59,47,12,56
Stirling,1672,4,16,6,14,61,55,6,54
Clyde,1672,5,15,9,12,54,48,6,54
Elgin,1672,6,14,6,16,53,65,-12,48
Annan Athlet,1672,7,11,12,13,48,42,6,45
Berwick,1672,8,8,10,18,29,61,-32,34
Edinburgh Ci,1672,9,7,9,20,38,63,-25,30
Cowdenbeath,1672,10,4,11,21,24,55,-31,23
Montrose,1673,1,24,7,5,61,34,27,79
Peterhead,1673,2,24,4,8,82,39,43,76
Stenhousem'r,1673,3,16,8,12,59,46,13,56
Stirling,1673,4,16,6,14,60,55,5,54
Clyde,1673,5,14,9,13,51,49,2,51
Elgin,1673,6,14,6,16,53,62,-9,48
Annan Athlet,1673,7,12,11,13,50,43,7,47
Berwick,1673,8,9,10,17,30,58,-28,37
Edinburgh Ci,1673,9,7,9,20,37,65,-28,30
Cowdenbeath,1673,10,4,10,22,25,57,-32,22
Peterhead,1674,1,24,4,8,79,38,41,76
Montrose,1674,2,23,7,6,59,35,24,76
Stirling,1674,3,17,6,13,61,51,10,57
Clyde,1674,4,15,9,12,55,50,5,54
Stenhousem'r,1674,5,15,8,13,55,47,8,53
Elgin,1674,6,15,6,15,54,60,-6,51
Annan Athlet,1674,7,12,11,13,52,44,8,47
Berwick,1674,8,8,10,18,31,62,-31,34
Edinburgh Ci,1674,9,7,9,20,36,62,-26,30
Cowdenbeath,1674,10,4,10,22,26,59,-33,22
Montrose,1675,1,24,7,5,62,35,27,79
Peterhead,1675,2,24,4,8,82,38,44,76
Stirling,1675,3,16,7,13,62,53,9,55
Stenhousem'r,1675,4,15,9,12,57,48,9,54
Clyde,1675,5,15,9,12,53,48,5,54
Elgin,1675,6,14,6,16,54,63,-9,48
Annan Athlet,1675,7,12,11,13,48,41,7,47
Berwick,1675,8,8,10,18,29,60,-31,34
Edinburgh Ci,1675,9,7,9,20,36,65,-29,30
Cowdenbeath,1675,10,4,10,22,23,55,-32,22
Montrose,1676,1,24,7,5,62,35,27,79
Peterhead,1676,2,24,4,8,80,38,42,76
Stirling,1676,3,17,6,13,61,51,10,57
Clyde,1676,4,15,9,12,53,48,5,54
Stenhousem'r,1676,5,15,8,13,55,47,8,53
Elgin,1676,6,14,6,16,54,63,-9,48
Annan Athlet,1676,7,11,11,14,47,44,3,44
Berwick,1676,8,8,10,18,29,60,-31,34
Edinburgh Ci,1676,9,7,9,20,36,63,-27,30
Cowdenbeath,1676,10,5,10,21,26,54,-28,25
Montrose,1677,1,24,7,5,62,34,28,79
Peterhead,1677,2,24,4,8,79,38,41,76
Stenhousem'r,1677,3,16,8,12,58,47,11,56
Stirling,1677,4,16,6,14,61,54,7,54
Clyde,1677,5,15,9,12,53,48,5,54
Elgin,1677,6,14,6,16,53,63,-10,48
Annan Athlet,1677,7,12,11,13,48,41,7,47
Berwick,1677,8,8,10,18,29,60,-31,34
Edinburgh Ci,1677,9,7,9,20,36,62,-26,30
Cowdenbeath,1677,10,4,10,22,23,55,-32,22
Montrose,1678,1,23,8,5,60,35,25,77
Peterhead,1678,2,24,4,8,80,40,40,76
Stenhousem'r,1678,3,16,8,12,56,46,10,56
Stirling,1678,4,16,6,14,60,52,8,54
Clyde,1678,5,15,9,12,54,49,5,54
Elgin,1678,6,14,7,15,54,61,-7,49
Annan Athlet,1678,7,12,11,13,48,41,7,47
Berwick,1678,8,8,10,18,30,61,-31,34
Edinburgh Ci,1678,9,7,9,20,38,63,-25,30
Cowdenbeath,1678,10,4,10,22,23,55,-32,22
Montrose,1679,1,23,8,5,59,34,25,77
Peterhead,1679,2,23,4,9,78,40,38,73
Stirling,1679,3,17,6,13,62,52,10,57
Stenhousem'r,1679,4,15,8,13,56,48,8,53
Clyde,1679,5,14,9,13,51,51,0,51
Elgin,1679,6,14,7,15,53,60,-7,49
Annan Athlet,1679,7,11,12,13,49,43,6,45
Berwick,1679,8,9,10,17,32,58,-26,37
Edinburgh Ci,1679,9,8,9,19,38,61,-23,33
Cowdenbeath,1679,10,4,11,21,25,56,-31,23
Montrose,1680,1,23,8,5,60,35,25,77
Peterhead,1680,2,24,4,8,79,38,41,76
Stenhousem'r,1680,3,16,8,12,57,47,10,56
Stirling,1680,4,16,6,14,61,53,8,54
Clyde,1680,5,14,10,12,53,50,3,52
Elgin,1680,6,14,7,15,54,61,-7,49
Annan Athlet,1680,7,12,11,13,48,41,7,47
Berwick,1680,8,8,11,17,31,60,-29,35
Edinburgh Ci,1680,9,7,9,20,36,62,-26,30
Cowdenbeath,1680,10,4,10,22,23,55,-32,22
Montrose,1681,1,23,8,5,60,35,25,77
Peterhead,1681,2,24,4,8,82,41,41,76
Stirling,1681,3,16,7,13,61,52,9,55
Stenhousem'r,1681,4,15,9,12,56,47,9,54
Clyde,1681,5,15,9,12,52,48,4,54
Elgin,1681,6,14,7,15,54,61,-7,49
Annan Athlet,1681,7,11,12,13,47,41,6,45
Berwick,1681,8,8,10,18,29,59,-30,34
Edinburgh Ci,1681,9,7,9,20,39,65,-26,30
Cowdenbeath,1681,10,4,11,21,23,54,-31,23
Montrose,1682,1,24,7,5,62,35,27,79
Peterhead,1682,2,24,4,8,79,38,41,76
Stirling,1682,3,17,6,13,63,53,10,57
Clyde,1682,4,15,9,12,53,49,4,54
Stenhousem'r,1682,5,15,8,13,57,49,8,53
Elgin,1682,6,14,6,16,54,63,-9,48
Annan Athlet,1682,7,11,12,13,49,43,6,45
Berwick,1682,8,8,10,18,30,60,-30,34
Edinburgh Ci,1682,9,7,9,20,36,62,-26,30
Cowdenbeath,1682,10,4,11,21,25,56,-31,23
Montrose,1683,1,24,7,5,63,35,28,79
Peterhead,1683,2,24,4,8,83,38,45,76
Stirling,1683,3,17,6,13,62,52,10,57
Clyde,1683,4,15,9,12,53,49,4,54
Stenhousem'r,1683,5,15,8,13,56,48,8,53
Elgin,1683,6,14,6,16,54,64,-10,48
Annan Athlet,1683,7,11,11,14,47,44,3,44
Berwick,1683,8,8,10,18,30,60,-30,34
Edinburgh Ci,1683,9,7,9,20,36,66,-30,30
Cowdenbeath,1683,10,5,10,21,26,54,-28,25
Montrose,1684,1,24,7,5,62,35,27,79
Peterhead,1684,2,24,4,8,79,38,41,76
Stirling,1684,3,17,6,13,63,53,10,57
Clyde,1684,4,15,9,12,52,48,4,54
Stenhousem'r,1684,5,15,8,13,57,49,8,53
Elgin,1684,6,14,6,16,54,63,-9,48
Annan Athlet,1684,7,11,12,13,49,43,6,45
Berwick,1684,8,8,10,18,29,59,-30,34
Edinburgh Ci,1684,9,7,9,20,36,62,-26,30
Cowdenbeath,1684,10,4,11,21,25,56,-31,23
Peterhead,1685,1,24,4,8,80,40,40,76
Montrose,1685,2,23,7,6,59,36,23,76
Stenhousem'r,1685,3,16,8,12,58,47,11,56
Stirling,1685,4,16,6,14,61,54,7,54
Clyde,1685,5,14,9,13,51,49,2,51
Elgin,1685,6,15,6,15,55,60,-5,51
Annan Athlet,1685,7,11,12,13,47,41,6,45
Berwick,1685,8,9,10,17,30,58,-28,37
Edinburgh Ci,1685,9,7,9,20,38,63,-25,30
Cowdenbeath,1685,10,4,11,21,23,54,-31,23
Peterhead,1686,1,24,4,8,79,39,40,76
Montrose,1686,2,23,7,6,59,35,24,76
Stirling,1686,3,17,6,13,62,52,10,57
Clyde,1686,4,15,9,12,53,48,5,54
Stenhousem'r,1686,5,15,8,13,56,48,8,53
Elgin,1686,6,15,6,15,54,60,-6,51
Annan Athlet,1686,7,11,11,14,47,44,3,44
Berwick,1686,8,8,10,18,29,60,-31,34
Edinburgh Ci,1686,9,7,9,20,37,62,-25,30
Cowdenbeath,1686,10,5,10,21,26,54,-28,25
Montrose,1687,1,24,7,5,63,35,28,79
Peterhead,1687,2,24,4,8,81,38,43,76
Stirling,1687,3,17,6,13,63,51,12,57
Clyde,1687,4,15,9,12,57,51,6,54
Stenhousem'r,1687,5,15,8,13,55,49,6,53
Elgin,1687,6,14,6,16,54,64,-10,48
Annan Athlet,1687,7,12,11,13,48,41,7,47
Berwick,1687,8,8,10,18,32,64,-32,34
Edinburgh Ci,1687,9,7,9,20,36,64,-28,30
Cowdenbeath,1687,10,4,10,22,23,55,-32,22
Peterhead,1688,1,24,4,8,80,39,41,76
Montrose,1688,2,23,7,6,60,36,24,76
Stenhousem'r,1688,3,16,8,12,58,48,10,56
Stirling,1688,4,16,6,14,62,54,8,54
Clyde,1688,5,15,9,12,53,49,4,54
Elgin,1688,6,15,6,15,55,61,-6,51
Annan Athlet,1688,7,12,11,13,50,43,7,47
Berwick,1688,8,8,10,18,30,60,-30,34
Edinburgh Ci,1688,9,7,9,20,37,63,-26,30
Cowdenbeath,1688,10,4,10,22,25,57,-32,22
Montrose,1689,1,24,7,5,62,35,27,79
Peterhead,1689,2,24,4,8,80,38,42,76
Stenhousem'r,1689,3,16,8,12,58,46,12,56
Stirling,1689,4,16,6,14,60,54,6,54
Clyde,1689,5,15,9,12,54,50,4,54
Elgin,1689,6,14,6,16,54,63,-9,48
Annan Athlet,1689,7,11,12,13,50,44,6,45
Berwick,1689,8,8,10,18,31,61,-30,34
Edinburgh Ci,1689,9,7,9,20,36,63,-27,30
Cowdenbeath,1689,10,4,11,21,26,57,-31,23
Montrose,1690,1,24,7,5,63,35,28,79
Peterhead,1690,2,24,4,8,81,39,42,76
Stenhousem'r,1690,3,16,8,12,58,46,12,56
Stirling,1690,4,16,6,14,60,54,6,54
Clyde,1690,5,15,9,12,53,49,4,54
Elgin,1690,6,14,6,16,54,64,-10,48
Annan Athlet,1690,7,11,12,13,49,43,6,45
Berwick,1690,8,8,10,18,30,60,-30,34
Edinburgh Ci,1690,9,7,9,20,37,64,-27,30
Cowdenbeath,1690,10,4,11,21,25,56,-31,23
Montrose,1691,1,24,7,5,64,35,29,79
Peterhead,1691,2,24,4,8,81,39,42,76
Stirling,1691,3,17,6,13,64,51,13,57
Stenhousem'r,1691,4,15,8,13,55,50,5,53
Clyde,1691,5,14,9,13,52,50,2,51
Elgin,1691,6,14,6,16,54,65,-11,48
Annan Athlet,1691,7,12,11,13,51,41,10,47
Berwick,1691,8,9,10,17,31,59,-28,37
Edinburgh Ci,1691,9,7,9,20,37,64,-27,30
Cowdenbeath,1691,10,4,10,22,23,58,-35,22
Montrose,1692,1,24,7,5,62,34,28,79
Peterhead,1692,2,24,4,8,81,38,43,76
Stirling,1692,3,17,6,13,62,52,10,57
Clyde,1692,4,15,9,12,53,49,4,54
Stenhousem'r,1692,5,15,8,13,56,48,8,53
Elgin,1692,6,14,6,16,53,63,-10,48
Annan Athlet,1692,7,11,12,13,47,41,6,45
Berwick,1692,8,8,10,18,30,60,-30,34
Edinburgh Ci,1692,9,7,9,20,36,64,-28,30
Cowdenbeath,1692,10,4,11,21,23,54,-31,23
Montrose,1693,1,24,7,5,63,35,28,79
Peterhead,1693,2,24,4,8,81,39,42,76
Stirling,1693,3,17,6,13,62,52,10,57
Stenhousem'r,1693,4,15,8,13,56,48,8,53
Clyde,1693,5,14,10,12,52,49,3,52
Elgin,1693,6,14,6,16,54,64,-10,48
Annan Athlet,1693,7,11,11,14,47,43,4,44
Berwick,1693,8,8,11,17,30,59,-29,35
Edinburgh Ci,1693,9,7,9,20,37,64,-27,30
Cowdenbeath,1693,10,5,10,21,25,54,-29,25
Montrose,1694,1,24,7,5,62,34,28,79
Peterhead,1694,2,24,4,8,85,38,47,76
Stenhousem'r,1694,3,16,8,12,58,47,11,56
Stirling,1694,4,16,6,14,61,54,7,54
Clyde,1694,5,15,9,12,54,48,6,54
Elgin,1694,6,14,6,16,53,63,-10,48
Annan Athlet,1694,7,12,11,13,49,42,7,47
Berwick,1694,8,8,10,18,29,61,-32,34
Edinburgh Ci,1694,9,7,9,20,36,68,-32,30
Cowdenbeath,1694,10,4,10,22,24,56,-32,22
Montrose,1695,1,24,7,5,62,34,28,79
Peterhead,1695,2,23,5,8,78,39,39,74
Stirling,1695,3,17,6,13,63,52,11,57
Clyde,1695,4,15,9,12,54,49,5,54
Stenhousem'r,1695,5,15,8,13,56,49,7,53
Elgin,1695,6,14,6,16,53,63,-10,48
Annan Athlet,1695,7,12,11,13,49,42,7,47
Berwick,1695,8,8,10,18,30,61,-31,34
Edinburgh Ci,1695,9,7,10,19,37,61,-24,31
Cowdenbeath,1695,10,4,10,22,24,56,-32,22
Montrose,1696,1,23,8,5,60,35,25,77
Peterhead,1696,2,24,4,8,78,38,40,76
Stirling,1696,3,17,6,13,62,51,11,57
Clyde,1696,4,15,9,12,52,48,4,54
Stenhousem'r,1696,5,15,8,13,55,48,7,53
Elgin,1696,6,14,7,15,54,61,-7,49
Annan Athlet,1696,7,12,11,13,50,42,8,47
Berwick,1696,8,8,10,18,29,59,-30,34
Edinburgh Ci,1696,9,7,9,20,36,61,-25,30
Cowdenbeath,1696,10,4,10,22,24,57,-33,22
Montrose,1697,1,24,7,5,65,35,30,79
Peterhead,1697,2,24,4,8,81,40,41,76
Stirling,1697,3,16,7,13,62,53,9,55
Stenhousem'r,1697,4,15,9,12,57,48,9,54
Clyde,1697,5,14,10,12,52,49,3,52
Elgin,1697,6,14,6,16,54,66,-12,48
Annan Athlet,1697,7,11,11,14,47,42,5,44
Berwick,1697,8,8,11,17,30,59,-29,35
Edinburgh Ci,1697,9,7,9,20,38,64,-26,30
Cowdenbeath,1697,10,5,10,21,24,54,-30,25
Montrose,1698,1,23,7,6,59,37,22,76
Peterhead,1698,2,23,5,8,78,39,39,74
Stirling,1698,3,17,6,13,61,51,10,57
Clyde,1698,4,15,9,12,53,48,5,54
Stenhousem'r,1698,5,15,8,13,55,47,8,53
Elgin,1698,6,15,6,15,56,60,-4,51
Annan Athlet,1698,7,11,11,14,48,43,5,44
Berwick,1698,8,8,10,18,29,60,-31,34
Edinburgh Ci,1698,9,7,10,19,37,61,-24,31
Cowdenbeath,1698,10,5,10,21,25,55,-30,25
Montrose,1699,1,24,7,5,62,34,28,79
Peterhead,1699,2,24,4,8,80,38,42,76
Stirling,1699,3,17,6,13,62,51,11,57
Clyde,1699,4,15,9,12,53,49,4,54
Stenhousem'r,1699,5,15,8,13,55,48,7,53
Elgin,1699,6,14,6,16,53,63,-10,48
Annan Athlet,1699,7,11,11,14,48,44,4,44
Berwick,1699,8,8,10,18,30,60,-30,34
Edinburgh Ci,1699,9,7,9,20,36,63,-27,30
Cowdenbeath,1699,10,5,10,21,26,55,-29,25
Montrose,1700,1,23,8,5,59,34,25,77
Peterhead,1700,2,24,4,8,83,39,44,76
Stirling,1700,3,17,6,13,63,52,11,57
Stenhousem'r,1700,4,15,8,13,56,49,7,53
Clyde,1700,5,14,9,13,52,50,2,51
Elgin,1700,6,14,7,15,53,60,-7,49
Annan Athlet,1700,7,12,11,13,48,41,7,47
Berwick,1700,8,9,10,17,31,59,-28,37
Edinburgh Ci,1700,9,7,9,20,37,66,-29,30
Cowdenbeath,1700,10,4,10,22,23,55,-32,22
Montrose,1701,1,23,7,6,60,39,21,76
Peterhead,1701,2,23,4,9,77,40,37,73
Stirling,1701,3,17,6,13,62,51,11,57
Clyde,1701,4,15,9,12,53,48,5,54
Stenhousem'r,1701,5,15,8,13,55,48,7,53
Elgin,1701,6,15,6,15,58,61,-3,51
Annan Athlet,1701,7,12,11,13,49,42,7,47
Berwick,1701,8,8,10,18,29,60,-31,34
Edinburgh Ci,1701,9,8,9,19,38,60,-22,33
Cowdenbeath,1701,10,4,10,22,24,56,-32,22
Montrose,1702,1,24,7,5,61,34,27,79
Peterhead,1702,2,24,4,8,83,39,44,76
Stenhousem'r,1702,3,16,8,12,59,48,11,56
Stirling,1702,4,16,6,14,62,55,7,54
Clyde,1702,5,14,10,12,53,50,3,52
Elgin,1702,6,14,6,16,53,62,-9,48
Annan Athlet,1702,7,11,12,13,48,42,6,45
Berwick,1702,8,8,11,17,31,60,-29,35
Edinburgh Ci,1702,9,7,9,20,37,66,-29,30
Cowdenbeath,1702,10,4,11,21,24,55,-31,23
Montrose,1703,1,24,7,5,62,34,28,79
Peterhead,1703,2,24,4,8,82,38,44,76
Stirling,1703,3,16,7,13,61,52,9,55
Stenhousem'r,1703,4,15,9,12,56,47,9,54
Clyde,1703,5,15,9,12,54,49,5,54
Elgin,1703,6,14,6,16,53,63,-10,48
Annan Athlet,1703,7,12,11,13,49,42,7,47
Berwick,1703,8,8,10,18,30,61,-31,34
Edinburgh Ci,1703,9,7,9,20,36,65,-29,30
Cowdenbeath,1703,10,4,10,22,24,56,-32,22
Peterhead,1704,1,24,4,8,81,40,41,76
Montrose,1704,2,23,7,6,59,35,24,76
Stirling,1704,3,17,6,13,63,53,10,57
Clyde,1704,4,15,9,12,53,49,4,54
Stenhousem'r,1704,5,15,8,13,57,49,8,53
Elgin,1704,6,15,6,15,54,60,-6,51
Annan Athlet,1704,7,12,11,13,49,42,7,47
Berwick,1704,8,8,10,18,30,60,-30,34
Edinburgh Ci,1704,9,7,9,20,38,64,-26,30
Cowdenbeath,1704,10,4,10,22,24,56,-32,22
Montrose,1705,1,24,7,5,61,34,27,79
Peterhead,1705,2,24,4,8,80,40,40,76
Stirling,1705,3,17,6,13,62,51,11,57
Clyde,1705,4,15,9,12,55,48,7,54
Stenhousem'r,1705,5,15,8,13,55,48,7,53
Elgin,1705,6,14,6,16,53,62,-9,48
Annan Athlet,1705,7,12,11,13,48,41,7,47
Berwick,1705,8,8,10,18,29,62,-33,34
Edinburgh Ci,1705,9,7,9,20,38,63,-25,30
Cowdenbeath,1705,10,4,10,22,23,55,-32,22
Montrose,1706,1,24,7,5,62,35,27,79
Peterhead,1706,2,24,4,8,79,39,40,76
Stenhousem'r,1706,3,16,8,12,56,46,10,56
Stirling,1706,4,16,6,14,60,52,8,54
Clyde,1706,5,15,9,12,53,48,5,54
Elgin,1706,6,14,6,16,54,63,-9,48
Annan Athlet,1706,7,12,11,13,49,41,8,47
Berwick,1706,8,8,10,18,29,60,-31,34
Edinburgh Ci,1706,9,7,9,20,37,62,-25,30
Cowdenbeath,1706,10,4,10,22,23,56,-33,22
Montrose,1707,1,24,7,5,64,35,29,79
Peterhead,1707,2,23,5,8,78,39,39,74
Stenhousem'r,1707,3,16,8,12,57,47,10,56
Stirling,1707,4,16,6,14,61,53,8,54
Clyde,1707,5,15,9,12,53,49,4,54
Elgin,1707,6,14,6,16,54,65,-11,48
Annan Athlet,1707,7,11,11,14,47,42,5,44
Berwick,1707,8,8,10,18,30,60,-30,34
Edinburgh Ci,1707,9,7,10,19,37,61,-24,31
Cowdenbeath,1707,10,5,10,21,24,54,-30,25
Montrose,1708,1,23,8,5,59,34,25,77
Peterhead,1708,2,23,5,8,78,39,39,74
Stirling,1708,3,16,7,13,60,51,9,55
Stenhousem'r,1708,4,15,9,12,55,46,9,54
Clyde,1708,5,15,9,12,53,49,4,54
Elgin,1708,6,14,7,15,53,60,-7,49
Annan Athlet,1708,7,11,12,13,48,42,6,45
Berwick,1708,8,8,10,18,30,60,-30,34
Edinburgh Ci,1708,9,7,10,19,37,61,-24,31
Cowdenbeath,1708,10,4,11,21,24,55,-31,23
Peterhead,1709,1,24,4,8,81,39,42,76
Montrose,1709,2,23,7,6,60,36,24,76
Stirling,1709,3,16,7,13,63,54,9,55
Stenhousem'r,1709,4,15,9,12,58,49,9,54
Clyde,1709,5,14,10,12,52,49,3,52
Elgin,1709,6,15,6,15,55,61,-6,51
Annan Athlet,1709,7,12,11,13,49,41,8,47
Berwick,1709,8,8,11,17,30,59,-29,35
Edinburgh Ci,1709,9,7,9,20,37,64,-27,30
Cowdenbeath,1709,10,4,10,22,23,56,-33,22
Montrose,1710,1,24,7,5,61,34,27,79
Peterhead,1710,2,23,5,8,78,39,39,74
Stirling,1710,3,17,6,13,62,52,10,57
Stenhousem'r,1710,4,15,8,13,56,48,8,53
Clyde,1710,5,14,10,12,52,49,3,52
Elgin,1710,6,14,6,16,53,62,-9,48
Annan Athlet,1710,7,12,11,13,48,41,7,47
Berwick,1710,8,8,11,17,30,59,-29,35
Edinburgh Ci,1710,9,7,10,19,37,61,-24,31
Cowdenbeath,1710,10,4,10,22,23,55,-32,22
Peterhead,1711,1,24,4,8,79,39,40,76
Montrose,1711,2,23,7,6,60,39,21,76
Stirling,1711,3,16,7,13,61,52,9,55
Stenhousem'r,1711,4,15,9,12,56,47,9,54
Clyde,1711,5,14,10,12,52,49,3,52
Elgin,1711,6,15,6,15,58,61,-3,51
Annan Athlet,1711,7,11,12,13,47,41,6,45
Berwick,1711,8,8,11,17,30,59,-29,35
Edinburgh Ci,1711,9,7,9,20,37,62,-25,30
Cowdenbeath,1711,10,4,11,21,23,54,-31,23
Montrose,1712,1,24,7,5,61,35,26,79
Peterhead,1712,2,24,4,8,81,39,42,76
Stirling,1712,3,16,7,13,63,54,9,55
Stenhousem'r,1712,4,15,9,12,58,49,9,54
Clyde,1712,5,15,9,12,52,48,4,54
Elgin,1712,6,14,6,16,54,62,-8,48
Annan Athlet,1712,7,12,11,13,50,42,8,47
Berwick,1712,8,8,10,18,29,59,-30,34
Edinburgh Ci,1712,9,7,9,20,37,64,-27,30
Cowdenbeath,1712,10,4,10,22,24,57,-33,22
Montrose,1713,1,24,7,5,61,35,26,79
Peterhead,1713,2,24,4,8,79,39,40,76
Stirling,1713,3,16,7,13,60,51,9,55
Stenhousem'r,1713,4,15,9,12,55,46,9,54
Clyde,1713,5,14,10,12,54,51,3,52
Elgin,1713,6,14,6,16,54,62,-8,48
Annan Athlet,1713,7,12,11,13,48,41,7,47
Berwick,1713,8,8,11,17,32,61,-29,35
Edinburgh Ci,1713,9,7,9,20,37,62,-25,30
Cowdenbeath,1713,10,4,10,22,23,55,-32,22
Montrose,1714,1,24,7,5,61,35,26,79
Peterhead,1714,2,24,4,8,78,38,40,76
Stirling,1714,3,16,7,13,62,53,9,55
Stenhousem'r,1714,4,15,9,12,57,48,9,54
Clyde,1714,5,15,9,12,56,48,8,54
Elgin,1714,6,14,6,16,54,62,-8,48
Annan Athlet,1714,7,11,11,14,47,42,5,44
Berwick,1714,8,8,10,18,29,63,-34,34
Edinburgh Ci,1714,9,7,9,20,36,61,-25,30
Cowdenbeath,1714,10,5,10,21,24,54,-30,25
Montrose,1715,1,23,8,5,60,35,25,77
Peterhead,1715,2,24,4,8,80,39,41,76
Stirling,1715,3,17,6,13,62,52,10,57
Clyde,1715,4,15,9,12,52,48,4,54
Stenhousem'r,1715,5,15,8,13,56,48,8,53
Elgin,1715,6,14,7,15,54,61,-7,49
Annan Athlet,1715,7,11,11,14,48,43,5,44
Berwick,1715,8,8,10,18,29,59,-30,34
Edinburgh Ci,1715,9,7,9,20,37,63,-26,30
Cowdenbeath,1715,10,5,10,21,25,55,-30,25
Montrose,1716,1,24,7,5,60,34,26,79
Peterhead,1716,2,24,4,8,79,39,40,76
Stirling,1716,3,17,6,13,63,51,12,57
Stenhousem'r,1716,4,15,8,13,55,49,6,53
Clyde,1716,5,14,10,12,52,49,3,52
Elgin,1716,6,14,6,16,53,61,-8,48
Annan Athlet,1716,7,11,12,13,49,43,6,45
Berwick,1716,8,8,11,17,30,59,-29,35
Edinburgh Ci,1716,9,7,9,20,37,62,-25,30
Cowdenbeath,1716,10,4,11,21,25,56,-31,23
Montrose,1717,1,24,7,5,62,34,28,79
Peterhead,1717,2,24,4,8,80,40,40,76
Stirling,1717,3,17,6,13,63,51,12,57
Clyde,1717,4,15,9,12,55,49,6,54
Stenhousem'r,1717,5,15,8,13,55,49,6,53
Elgin,1717,6,14,6,16,53,63,-10,48
Annan Athlet,1717,7,11,12,13,47,41,6,45
Berwick,1717,8,8,10,18,30,62,-32,34
Edinburgh Ci,1717,9,7,9,20,38,63,-25,30
Cowdenbeath,1717,10,4,11,21,23,54,-31,23
Montrose,1718,1,24,7,5,62,34,28,79
Peterhead,1718,2,24,4,8,81,39,42,76
Stenhousem'r,1718,3,16,8,12,58,48,10,56
Stirling,1718,4,16,6,14,62,54,8,54
Clyde,1718,5,15,9,12,53,48,5,54
Elgin,1718,6,14,6,16,53,63,-10,48
Annan Athlet,1718,7,11,11,14,48,43,5,44
Berwick,1718,8,8,10,18,29,60,-31,34
Edinburgh Ci,1718,9,7,9,20,37,64,-27,30
Cowdenbeath,1718,10,5,10,21,25,55,-30,25
Montrose,1719,1,24,7,5,62,36,26,79
Peterhead,1719,2,24,4,8,80,38,42,76
Stenhousem'r,1719,3,16,8,12,56,46,10,56
Stirling,1719,4,16,6,14,60,52,8,54
Clyde,1719,5,15,9,12,53,48,5,54
Elgin,1719,6,14,6,16,55,63,-8,48
Annan Athlet,1719,7,11,11,14,49,45,4,44
Berwick,1719,8,8,10,18,29,60,-31,34
Edinburgh Ci,1719,9,7,9,20,36,63,-27,30
Cowdenbeath,1719,10,5,10,21,27,56,-29,25
Montrose,1720,1,24,7,5,62,35,27,79
Peterhead,1720,2,24,4,8,79,38,41,76
Stenhousem'r,1720,3,16,8,12,57,47,10,56
Stirling,1720,4,16,6,14,61,53,8,54
Clyde,1720,5,15,9,12,53,48,5,54
Elgin,1720,6,14,6,16,54,63,-9,48
Annan Athlet,1720,7,12,11,13,49,41,8,47
Berwick,1720,8,8,10,18,29,60,-31,34
Edinburgh Ci,1720,9,7,9,20,36,62,-26,30
Cowdenbeath,1720,10,4,10,22,23,56,-33,22
Montrose,1721,1,24,7,5,62,35,27,79
Peterhead,1721,2,24,4,8,84,39,45,76
Stirling,1721,3,16,7,13,61,52,9,55
Stenhousem'r,1721,4,15,9,12,56,47,9,54
Clyde,1721,5,15,9,12,53,48,5,54
Elgin,1721,6,14,6,16,54,63,-9,48
Annan Athlet,1721,7,11,12,13,48,42,6,45
Berwick,1721,8,8,10,18,29,60,-31,34
Edinburgh Ci,1721,9,7,9,20,37,67,-30,30
Cowdenbeath,1721,10,4,11,21,24,55,-31,23
Montrose,1722,1,24,7,5,62,34,28,79
Peterhead,1722,2,24,4,8,78,38,40,76
Stirling,1722,3,17,6,13,63,52,11,57
Stenhousem'r,1722,4,15,8,13,56,49,7,53
Clyde,1722,5,14,10,12,51,48,3,52
Elgin,1722,6,14,6,16,53,63,-10,48
Annan Athlet,1722,7,11,12,13,47,41,6,45
Berwick,1722,8,8,11,17,29,58,-29,35
Edinburgh Ci,1722,9,7,9,20,36,61,-25,30
Cowdenbeath,1722,10,4,11,21,23,54,-31,23
Montrose,1723,1,23,8,5,61,36,25,77
Peterhead,1723,2,24,4,8,80,39,41,76
Stenhousem'r,1723,3,16,8,12,60,48,12,56
Stirling,1723,4,16,6,14,62,56,6,54
Clyde,1723,5,14,10,12,52,49,3,52
Elgin,1723,6,14,7,15,55,62,-7,49
Annan Athlet,1723,7,11,12,13,48,42,6,45
Berwick,1723,8,8,11,17,30,59,-29,35
Edinburgh Ci,1723,9,7,9,20,37,63,-26,30
Cowdenbeath,1723,10,4,11,21,24,55,-31,23
Peterhead,1724,1,24,4,8,78,38,40,76
Montrose,1724,2,23,7,6,60,38,22,76
Stirling,1724,3,17,6,13,62,52,10,57
Clyde,1724,4,15,9,12,55,48,7,54
Stenhousem'r,1724,5,15,8,13,56,48,8,53
Elgin,1724,6,15,6,15,57,61,-4,51
Annan Athlet,1724,7,11,11,14,48,43,5,44
Berwick,1724,8,8,10,18,29,62,-33,34
Edinburgh Ci,1724,9,7,9,20,36,61,-25,30
Cowdenbeath,1724,10,5,10,21,25,55,-30,25
Montrose,1725,1,24,7,5,60,34,26,79
Peterhead,1725,2,24,4,8,82,39,43,76
Stenhousem'r,1725,3,16,8,12,57,46,11,56
Stirling,1725,4,16,6,14,60,53,7,54
Clyde,1725,5,15,9,12,53,49,4,54
Elgin,1725,6,14,6,16,53,61,-8,48
Annan Athlet,1725,7,12,11,13,49,41,8,47
Berwick,1725,8,8,10,18,30,60,-30,34
Edinburgh Ci,1725,9,7,9,20,37,65,-28,30
Cowdenbeath,1725,10,4,10,22,23,56,-33,22
Montrose,1726,1,24,7,5,63,35,28,79
Peterhead,1726,2,24,4,8,82,38,44,76
Stenhousem'r,1726,3,16,8,12,57,47,10,56
Stirling,1726,4,16,6,14,61,53,8,54
Clyde,1726,5,15,9,12,54,49,5,54
Elgin,1726,6,14,6,16,54,64,-10,48
Annan Athlet,1726,7,11,11,14,47,42,5,44
Berwick,1726,8,8,10,18,30,61,-31,34
Edinburgh Ci,1726,9,7,9,20,36,65,-29,30
Cowdenbeath,1726,10,5,10,21,24,54,-30,25
Montrose,1727,1,23,8,5,61,36,25,77
Peterhead,1727,2,23,5,8,78,39,39,74
Stirling,1727,3,17,6,13,62,51,11,57
Clyde,1727,4,15,9,12,54,49,5,54
Stenhousem'r,1727,5,15,8,13,55,48,7,53
Elgin,1727,6,14,7,15,55,62,-7,49
Annan Athlet,1727,7,12,11,13,49,42,7,47
Berwick,1727,8,8,10,18,30,61,-31,34
Edinburgh Ci,1727,9,7,10,19,37,61,-24,31
Cowdenbeath,1727,10,4,10,22,24,56,-32,22
Montrose,1728,1,24,7,5,61,34,27,79
Peterhead,1728,2,24,4,8,82,38,44,76
Stirling,1728,3,17,6,13,63,53,10,57
Stenhousem'r,1728,4,15,8,13,57,49,8,53
Clyde,1728,5,14,10,12,52,49,3,52
Elgin,1728,6,14,6,16,53,62,-9,48
Annan Athlet,1728,7,11,12,13,47,41,6,45
Berwick,1728,8,8,11,17,30,59,-29,35
Edinburgh Ci,1728,9,7,9,20,36,65,-29,30
Cowdenbeath,1728,10,4,11,21,23,54,-31,23
Montrose,1729,1,24,7,5,62,35,27,79
Peterhead,1729,2,24,4,8,79,38,41,76
Stirling,1729,3,17,6,13,64,51,13,57
Stenhousem'r,1729,4,15,8,13,55,50,5,53
Clyde,1729,5,14,10,12,52,49,3,52
Elgin,1729,6,14,6,16,54,63,-9,48
Annan Athlet,1729,7,12,11,13,48,41,7,47
Berwick,1729,8,8,11,17,30,59,-29,35
Edinburgh Ci,1729,9,7,9,20,36,62,-26,30
Cowdenbeath,1729,10,4,10,22,23,55,-32,22
Montrose,1730,1,23,8,5,62,37,25,77
Peterhead,1730,2,23,5,8,78,39,39,74
Stirling,1730,3,16,7,13,61,52,9,55
Stenhousem'r,1730,4,15,9,12,56,47,9,54
Clyde,1730,5,14,10,12,52,49,3,52
Elgin,1730,6,14,7,15,56,63,-7,49
Annan Athlet,1730,7,12,11,13,51,43,8,47
Berwick,1730,8,8,11,17,30,59,-29,35
Edinburgh Ci,1730,9,7,10,19,37,61,-24,31
Cowdenbeath,1730,10,4,10,22,25,58,-33,22
Peterhead,1731,1,24,4,8,80,40,40,76
Montrose,1731,2,23,7,6,60,36,24,76
Stirling,1731,3,17,6,13,64,54,10,57
Stenhousem'r,1731,4,15,8,13,58,50,8,53
Clyde,1731,5,14,9,13,51,49,2,51
Elgin,1731,6,15,6,15,55,61,-6,51
Annan Athlet,1731,7,11,11,14,47,43,4,44
Berwick,1731,8,9,10,17,30,58,-28,37
Edinburgh Ci,1731,9,7,9,20,38,63,-25,30
Cowdenbeath,1731,10,5,10,21,25,54,-29,25
Montrose,1732,1,23,7,6,59,35,24,76
Peterhead,1732,2,23,5,8,78,39,39,74
Stirling,1732,3,16,7,13,62,53,9,55
Stenhousem'r,1732,4,15,9,12,57,48,9,54
Clyde,1732,5,15,9,12,53,48,5,54
Elgin,1732,6,15,6,15,54,60,-6,51
Annan Athlet,1732,7,12,11,13,52,42,10,47
Berwick,1732,8,8,10,18,29,60,-31,34
Edinburgh Ci,1732,9,7,10,19,37,61,-24,31
Cowdenbeath,1732,10,4,10,22,24,59,-35,22
Montrose,1733,1,23,8,5,61,36,25,77
Peterhead,1733,2,24,4,8,78,38,40,76
Stirling,1733,3,16,7,13,61,52,9,55
Stenhousem'r,1733,4,15,9,12,56,47,9,54
Clyde,1733,5,15,9,12,53,49,4,54
Elgin,1733,6,14,7,15,55,62,-7,49
Annan Athlet,1733,7,12,11,13,50,41,9,47
Berwick,1733,8,8,10,18,30,60,-30,34
Edinburgh Ci,1733,9,7,9,20,36,61,-25,30
Cowdenbeath,1733,10,4,10,22,23,57,-34,22
Montrose,1734,1,23,8,5,60,35,25,77
Peterhead,1734,2,24,4,8,80,40,40,76
Stirling,1734,3,16,7,13,61,52,9,55
Stenhousem'r,1734,4,15,9,12,56,47,9,54
Clyde,1734,5,15,9,12,53,48,5,54
Elgin,1734,6,14,7,15,54,61,-7,49
Annan Athlet,1734,7,11,12,13,47,41,6,45
Berwick,1734,8,8,10,18,29,60,-31,34
Edinburgh Ci,1734,9,7,9,20,38,63,-25,30
Cowdenbeath,1734,10,4,11,21,23,54,-31,23
Montrose,1735,1,24,7,5,62,34,28,79
Peterhead,1735,2,24,4,8,78,38,40,76
Stenhousem'r,1735,3,16,8,12,59,48,11,56
Stirling,1735,4,16,6,14,62,55,7,54
Clyde,1735,5,15,9,12,53,48,5,54
Elgin,1735,6,14,6,16,53,63,-10,48
Annan Athlet,1735,7,11,12,13,47,41,6,45
Berwick,1735,8,8,10,18,29,60,-31,34
Edinburgh Ci,1735,9,7,9,20,36,61,-25,30
Cowdenbeath,1735,10,4,11,21,23,54,-31,23
Montrose,1736,1,23,8,5,60,35,25,77
Peterhead,1736,2,23,4,9,77,39,38,73
Stenhousem'r,1736,3,16,8,12,57,46,11,56
Stirling,1736,4,16,6,14,60,53,7,54
Clyde,1736,5,14,9,13,51,49,2,51
Elgin,1736,6,14,7,15,54,61,-7,49
Annan Athlet,1736,7,12,11,13,51,42,9,47
Berwick,1736,8,9,10,17,30,58,-28,37
Edinburgh Ci,1736,9,8,9,19,37,60,-23,33
Cowdenbeath,1736,10,4,10,22,24,58,-34,22
Montrose,1737,1,23,8,5,60,35,25,77
Peterhead,1737,2,24,4,8,79,39,40,76
Stirling,1737,3,17,6,13,64,52,12,57
Clyde,1737,4,15,9,12,52,48,4,54
Stenhousem'r,1737,5,15,8,13,56,50,6,53
Elgin,1737,6,14,7,15,54,61,-7,49
Annan Athlet,1737,7,12,11,13,48,41,7,47
Berwick,1737,8,8,10,18,29,59,-30,34
Edinburgh Ci,1737,9,7,9,20,37,62,-25,30
Cowdenbeath,1737,10,4,10,22,23,55,-32,22
Montrose,1738,1,24,7,5,63,36,27,79
Peterhead,1738,2,24,4,8,80,40,40,76
Stirling,1738,3,17,6,13,64,52,12,57
Clyde,1738,4,15,9,12,56,49,7,54
Stenhousem'r,1738,5,15,8,13,56,50,6,53
Elgin,1738,6,14,6,16,55,64,-9,48
Annan Athlet,1738,7,11,11,14,48,43,5,44
Berwick,1738,8,8,10,18,30,63,-33,34
Edinburgh Ci,1738,9,7,9,20,38,63,-25,30
Cowdenbeath,1738,10,5,10,21,25,55,-30,25
Montrose,1739,1,24,7,5,63,36,27,79
Peterhead,1739,2,24,4,8,80,39,41,76
Stirling,1739,3,17,6,13,61,51,10,57
Stenhousem'r,1739,4,15,8,13,55,47,8,53
Clyde,1739,5,14,10,12,52,49,3,52
Elgin,1739,6,14,6,16,55,64,-9,48
Annan Athlet,1739,7,11,12,13,47,41,6,45
Berwick,1739,8,8,11,17,30,59,-29,35
Edinburgh Ci,1739,9,7,9,20,37,63,-26,30
Cowdenbeath,1739,10,4,11,21,23,54,-31,23
Montrose,1740,1,24,7,5,61,35,26,79
Peterhead,1740,2,24,4,8,78,38,40,76
Stirling,1740,3,17,6,13,62,51,11,57
Clyde,1740,4,15,9,12,52,48,4,54
Stenhousem'r,1740,5,15,8,13,55,48,7,53
Elgin,1740,6,14,6,16,54,62,-8,48
Annan Athlet,1740,7,11,11,14,47,42,5,44
Berwick,1740,8,8,10,18,29,59,-30,34
Edinburgh Ci,1740,9,7,9,20,36,61,-25,30
Cowdenbeath,1740,10,5,10,21,24,54,-30,25
Peterhead,1741,1,24,4,8,81,38,43,76
Montrose,1741,2,23,7,6,59,36,23,76
Stenhousem'r,1741,3,16,8,12,56,46,10,56
Stirling,1741,4,16,6,14,60,52,8,54
Clyde,1741,5,14,9,13,52,51,1,51
Elgin,1741,6,15,6,15,55,60,-5,51
Annan Athlet,1741,7,11,11,14,48,43,5,44
Berwick,1741,8,9,10,17,32,59,-27,37
Edinburgh Ci,1741,9,7,9,20,36,64,-28,30
Cowdenbeath,1741,10,5,10,21,25,55,-30,25
Montrose,1742,1,23,7,6,59,35,24,76
Peterhead,1742,2,23,4,9,77,39,38,73
Stirling,1742,3,16,7,13,61,52,9,55
Stenhousem'r,1742,4,15,9,12,56,47,9,54
Clyde,1742,5,15,9,12,53,48,5,54
Elgin,1742,6,15,6,15,54,60,-6,51
Annan Athlet,1742,7,11,11,14,47,43,4,44
Berwick,1742,8,8,10,18,29,60,-31,34
Edinburgh Ci,1742,9,8,9,19,37,60,-23,33
Cowdenbeath,1742,10,5,10,21,25,54,-29,25
Montrose,1743,1,24,7,5,60,34,26,79
Peterhead,1743,2,24,4,8,80,39,41,76
Stirling,1743,3,17,6,13,62,52,10,57
Clyde,1743,4,15,9,12,55,51,4,54
Stenhousem'r,1743,5,15,8,13,56,48,8,53
Elgin,1743,6,14,6,16,53,61,-8,48
Annan Athlet,1743,7,12,11,13,49,41,8,47
Berwick,1743,8,8,10,18,32,62,-30,34
Edinburgh Ci,1743,9,7,9,20,37,63,-26,30
Cowdenbeath,1743,10,4,10,22,23,56,-33,22
Peterhead,1744,1,24,4,8,80,40,40,76
Montrose,1744,2,23,7,6,59,36,23,76
Stenhousem'r,1744,3,16,8,12,58,48,10,56
Stirling,1744,4,16,6,14,62,54,8,54
Clyde,1744,5,15,9,12,55,48,7,54
Elgin,1744,6,15,6,15,55,60,-5,51
Annan Athlet,1744,7,11,12,13,47,41,6,45
Berwick,1744,8,8,10,18,29,62,-33,34
Edinburgh Ci,1744,9,7,9,20,38,63,-25,30
Cowdenbeath,1744,10,4,11,21,23,54,-31,23
Montrose,1745,1,24,7,5,62,34,28,79
Peterhead,1745,2,23,5,8,78,39,39,74
Stirling,1745,3,16,7,13,63,54,9,55
Stenhousem'r,1745,4,15,9,12,58,49,9,54
Clyde,1745,5,15,9,12,55,49,6,54
Elgin,1745,6,14,6,16,53,63,-10,48
Annan Athlet,1745,7,12,11,13,48,41,7,47
Berwick,1745,8,8,10,18,30,62,-32,34
Edinburgh Ci,1745,9,7,10,19,37,61,-24,31
Cowdenbeath,1745,10,4,10,22,23,55,-32,22
Montrose,1746,1,23,8,5,60,35,25,77
Peterhead,1746,2,23,4,9,79,41,38,73
Stirling,1746,3,17,6,13,65,54,11,57
Clyde,1746,4,15,9,12,54,49,5,54
Stenhousem'r,1746,5,15,8,13,58,51,7,53
Elgin,1746,6,14,7,15,54,61,-7,49
Annan Athlet,1746,7,12,11,13,49,41,8,47
Berwick,1746,8,8,10,18,30,61,-31,34
Edinburgh Ci,1746,9,8,9,19,39,62,-23,33
Cowdenbeath,1746,10,4,10,22,23,56,-33,22
Montrose,1747,1,24,7,5,61,34,27,79
Peterhead,1747,2,23,5,8,80,41,39,74
Stirling,1747,3,17,6,13,62,51,11,57
Clyde,1747,4,15,9,12,52,48,4,54
Stenhousem'r,1747,5,15,8,13,55,48,7,53
Elgin,1747,6,14,6,16,53,62,-9,48
Annan Athlet,1747,7,11,12,13,47,41,6,45
Berwick,1747,8,8,10,18,29,59,-30,34
Edinburgh Ci,1747,9,7,10,19,39,63,-24,31
Cowdenbeath,1747,10,4,11,21,23,54,-31,23
Montrose,1748,1,24,7,5,60,34,26,79
Peterhead,1748,2,23,5,8,78,39,39,74
Stirling,1748,3,16,7,13,62,53,9,55
Stenhousem'r,1748,4,15,9,12,57,48,9,54
Clyde,1748,5,15,9,12,54,48,6,54
Elgin,1748,6,14,6,16,53,61,-8,48
Annan Athlet,1748,7,12,11,13,49,42,7,47
Berwick,1748,8,8,10,18,29,61,-32,34
Edinburgh Ci,1748,9,7,10,19,37,61,-24,31
Cowdenbeath,1748,10,4,10,22,24,56,-32,22
Peterhead,1749,1,24,4,8,82,39,43,76
Montrose,1749,2,23,7,6,61,37,24,76
Stirling,1749,3,16,7,13,62,53,9,55
Stenhousem'r,1749,4,15,9,12,57,48,9,54
Clyde,1749,5,15,9,12,54,50,4,54
Elgin,1749,6,15,6,15,56,62,-6,51
Annan Athlet,1749,7,12,11,13,48,41,7,47
Berwick,1749,8,8,10,18,31,61,-30,34
Edinburgh Ci,1749,9,7,9,20,37,65,-28,30
Cowdenbeath,1749,10,4,10,22,23,55,-32,22
Montrose,1750,1,24,7,5,61,35,26,79
Peterhead,1750,2,23,5,8,78,39,39,74
Stenhousem'r,1750,3,16,8,12,58,47,11,56
Stirling,1750,4,16,6,14,61,54,7,54
Clyde,1750,5,15,9,12,52,48,4,54
Elgin,1750,6,14,6,16,54,62,-8,48
Annan Athlet,1750,7,12,11,13,48,41,7,47
Berwick,1750,8,8,10,18,29,59,-30,34
Edinburgh Ci,1750,9,7,10,19,37,61,-24,31
Cowdenbeath,1750,10,4,10,22,23,55,-32,22
Peterhead,1751,1,24,4,8,80,38,42,76
Montrose,1751,2,23,7,6,59,36,23,76
Stenhousem'r,1751,3,16,8,12,58,48,10,56
Stirling,1751,4,16,6,14,62,54,8,54
Clyde,1751,5,14,10,12,51,48,3,52
Elgin,1751,6,15,6,15,55,60,-5,51
Annan Athlet,1751,7,12,11,13,48,41,7,47
Berwick,1751,8,8,11,17,29,58,-29,35
Edinburgh Ci,1751,9,7,9,20,36,63,-27,30
Cowdenbeath,1751,10,4,10,22,23,55,-32,22
Montrose,1752,1,24,7,5,60,34,26,79
Peterhead,1752,2,23,5,8,77,38,39,74
Stirling,1752,3,17,6,13,62,52,10,57
Stenhousem'r,1752,4,15,8,13,56,48,8,53
Clyde,1752,5,14,9,13,53,51,2,51
Elgin,1752,6,14,6,16,53,61,-8,48
Annan Athlet,1752,7,12,11,13,49,42,7,47
Berwick,1752,8,9,10,17,32,60,-28,37
Edinburgh Ci,1752,9,7,10,19,36,60,-24,31
Cowdenbeath,1752,10,4,10,22,24,56,-32,22
Peterhead,1753,1,24,4,8,83,39,44,76
Montrose,1753,2,23,7,6,60,39,21,76
Stirling,1753,3,17,6,13,62,52,10,57
Stenhousem'r,1753,4,15,8,13,56,48,8,53
Clyde,1753,5,14,9,13,51,51,0,51
Elgin,1753,6,15,6,15,58,61,-3,51
Annan Athlet,1753,7,11,11,14,47,42,5,44
Berwick,1753,8,9,10,17,32,58,-26,37
Edinburgh Ci,1753,9,7,9,20,37,66,-29,30
Cowdenbeath,1753,10,5,10,21,24,54,-30,25
Montrose,1754,1,24,7,5,61,34,27,79
Peterhead,1754,2,24,4,8,82,38,44,76
Stirling,1754,3,17,6,13,62,52,10,57
Clyde,1754,4,15,9,12,55,48,7,54
Stenhousem'r,1754,5,15,8,13,56,48,8,53
Elgin,1754,6,14,6,16,53,62,-9,48
Annan Athlet,1754,7,12,11,13,49,42,7,47
Berwick,1754,8,8,10,18,29,62,-33,34
Edinburgh Ci,1754,9,7,9,20,36,65,-29,30
Cowdenbeath,1754,10,4,10,22,24,56,-32,22
Peterhead,1755,1,24,4,8,80,39,41,76
Montrose,1755,2,23,7,6,59,35,24,76
Stenhousem'r,1755,3,16,8,12,57,47,10,56
Stirling,1755,4,16,6,14,61,53,8,54
Clyde,1755,5,14,10,12,52,49,3,52
Elgin,1755,6,15,6,15,54,60,-6,51
Annan Athlet,1755,7,11,12,13,48,42,6,45
Berwick,1755,8,8,11,17,30,59,-29,35
Edinburgh Ci,1755,9,7,9,20,37,63,-26,30
Cowdenbeath,1755,10,4,11,21,24,55,-31,23
Montrose,1756,1,24,7,5,61,34,27,79
Peterhead,1756,2,24,4,8,78,38,40,76
Stirling,1756,3,17,6,13,63,52,11,57
Clyde,1756,4,15,9,12,52,48,4,54
Stenhousem'r,1756,5,15,8,13,56,49,7,53
Elgin,1756,6,14,6,16,53,62,-9,48
Annan Athlet,1756,7,11,12,13,47,41,6,45
Berwick,1756,8,8,10,18,29,59,-30,34
Edinburgh Ci,1756,9,7,9,20,36,61,-25,30
Cowdenbeath,1756,10,4,11,21,23,54,-31,23
Peterhead,1757,1,24,4,8,79,38,41,76
Montrose,1757,2,23,7,6,59,36,23,76
Stirling,1757,3,16,7,13,62,53,9,55
Stenhousem'r,1757,4,15,9,12,57,48,9,54
Clyde,1757,5,14,9,13,52,50,2,51
Elgin,1757,6,15,6,15,55,60,-5,51
Annan Athlet,1757,7,12,11,13,49,42,7,47
Berwick,1757,8,9,10,17,31,59,-28,37
Edinburgh Ci,1757,9,7,9,20,36,62,-26,30
Cowdenbeath,1757,10,4,10,22,24,56,-32,22
Montrose,1758,1,24,7,5,61,34,27,79
Peterhead,1758,2,23,5,8,78,39,39,74
Stirling,1758,3,17,6,13,63,51,12,57
Clyde,1758,4,15,9,12,53,48,5,54
Stenhousem'r,1758,5,15,8,13,55,49,6,53
Elgin,1758,6,14,6,16,53,62,-9,48
Annan Athlet,1758,7,11,12,13,47,41,6,45
Berwick,1758,8,8,10,18,29,60,-31,34
Edinburgh Ci,1758,9,7,10,19,37,61,-24,31
Cowdenbeath,1758,10,4,11,21,23,54,-31,23
Montrose,1759,1,24,7,5,63,36,27,79
Peterhead,1759,2,23,4,9,77,39,38,73
Stenhousem'r,1759,3,16,8,12,57,46,11,56
Stirling,1759,4,16,6,14,60,53,7,54
Clyde,1759,5,15,9,12,55,48,7,54
Elgin,1759,6,14,6,16,55,64,-9,48
Annan Athlet,1759,7,11,12,13,47,41,6,45
Berwick,1759,8,8,10,18,29,62,-33,34
Edinburgh Ci,1759,9,8,9,19,37,60,-23,33
Cowdenbeath,1759,10,4,11,21,23,54,-31,23
Montrose,1760,1,24,7,5,62,34,28,79
Peterhead,1760,2,24,4,8,80,38,42,76
Stirling,1760,3,17,6,13,61,51,10,57
Stenhousem'r,1760,4,15,8,13,55,47,8,53
Clyde,1760,5,14,10,12,52,49,3,52
Elgin,1760,6,14,6,16,53,63,-10,48
Annan Athlet,1760,7,12,11,13,49,42,7,47
Berwick,1760,8,8,11,17,30,59,-29,35
Edinburgh Ci,1760,9,7,9,20,36,63,-27,30
Cowdenbeath,1760,10,4,10,22,24,56,-32,22
Montrose,1761,1,24,7,5,60,34,26,79
Peterhead,1761,2,24,4,8,78,38,40,76
Stirling,1761,3,17,6,13,63,51,12,57
Clyde,1761,4,15,9,12,54,49,5,54
Stenhousem'r,1761,5,15,8,13,55,49,6,53
Elgin,1761,6,14,6,16,53,61,-8,48
Annan Athlet,1761,7,11,11,14,47,42,5,44
Berwick,1761,8,8,10,18,30,61,-31,34
Edinburgh Ci,1761,9,7,9,20,36,61,-25,30
Cowdenbeath,1761,10,5,10,21,24,54,-30,25
Montrose,1762,1,24,7,5,65,36,29,79
Peterhead,1762,2,24,4,8,78,38,40,76
Stirling,1762,3,16,7,13,62,53,9,55
Stenhousem'r,1762,4,15,9,12,57,48,9,54
Clyde,1762,5,15,9,12,52,48,4,54
Elgin,1762,6,14,6,16,55,66,-11,48
Annan Athlet,1762,7,12,11,13,48,41,7,47
Berwick,1762,8,8,10,18,29,59,-30,34
Edinburgh Ci,1762,9,7,9,20,36,61,-25,30
Cowdenbeath,1762,10,4,10,22,23,55,-32,22
Montrose,1763,1,24,7,5,64,35,29,79
Peterhead,1763,2,23,4,9,77,39,38,73
Stirling,1763,3,17,6,13,65,54,11,57
Clyde,1763,4,15,9,12,57,48,9,54
Stenhousem'r,1763,5,15,8,13,58,51,7,53
Elgin,1763,6,14,6,16,54,65,-11,48
Annan Athlet,1763,7,11,11,14,47,43,4,44
Berwick,1763,8,8,10,18,29,64,-35,34
Edinburgh Ci,1763,9,8,9,19,37,60,-23,33
Cowdenbeath,1763,10,5,10,21,25,54,-29,25
Montrose,1764,1,24,7,5,62,34,28,79
Peterhead,1764,2,24,4,8,79,39,40,76
Stirling,1764,3,16,7,13,60,51,9,55
Stenhousem'r,1764,4,15,9,12,55,46,9,54
Clyde,1764,5,14,9,13,51,49,2,51
Elgin,1764,6,14,6,16,53,63,-10,48
Annan Athlet,1764,7,11,12,13,47,41,6,45
Berwick,1764,8,9,10,17,30,58,-28,37
Edinburgh Ci,1764,9,7,9,20,37,62,-25,30
Cowdenbeath,1764,10,4,11,21,23,54,-31,23
Montrose,1765,1,24,7,5,61,34,27,79
Peterhead,1765,2,24,4,8,78,38,40,76
Stenhousem'r,1765,3,16,8,12,56,46,10,56
Stirling,1765,4,16,6,14,60,52,8,54
Clyde,1765,5,14,9,13,52,51,1,51
Elgin,1765,6,14,6,16,53,62,-9,48
Annan Athlet,1765,7,12,11,13,48,41,7,47
Berwick,1765,8,9,10,17,32,59,-27,37
Edinburgh Ci,1765,9,7,9,20,36,61,-25,30
Cowdenbeath,1765,10,4,10,22,23,55,-32,22
Montrose,1766,1,24,7,5,60,34,26,79
Peterhead,1766,2,23,5,8,77,38,39,74
Stirling,1766,3,16,7,13,62,53,9,55
Stenhousem'r,1766,4,15,9,12,57,48,9,54
Clyde,1766,5,14,10,12,52,49,3,52
Elgin,1766,6,14,6,16,53,61,-8,48
Annan Athlet,1766,7,11,12,13,48,42,6,45
Berwick,1766,8,8,11,17,30,59,-29,35
Edinburgh Ci,1766,9,7,10,19,36,60,-24,31
Cowdenbeath,1766,10,4,11,21,24,55,-31,23
Montrose,1767,1,24,7,5,62,34,28,79
Peterhead,1767,2,24,4,8,81,39,42,76
Stenhousem'r,1767,3,16,8,12,57,47,10,56
Stirling,1767,4,16,6,14,61,53,8,54
Clyde,1767,5,15,9,12,54,49,5,54
Elgin,1767,6,14,6,16,53,63,-10,48
Annan Athlet,1767,7,11,12,13,48,42,6,45
Berwick,1767,8,8,10,18,30,61,-31,34
Edinburgh Ci,1767,9,7,9,20,37,64,-27,30
Cowdenbeath,1767,10,4,11,21,24,55,-31,23
Montrose,1768,1,24,7,5,62,35,27,79
Peterhead,1768,2,24,4,8,80,39,41,76
Stenhousem'r,1768,3,16,8,12,58,46,12,56
Stirling,1768,4,16,6,14,60,54,6,54
Clyde,1768,5,15,9,12,53,48,5,54
Elgin,1768,6,14,6,16,54,63,-9,48
Annan Athlet,1768,7,12,11,13,50,43,7,47
Berwick,1768,8,8,10,18,29,60,-31,34
Edinburgh Ci,1768,9,7,9,20,37,63,-26,30
Cowdenbeath,1768,10,4,10,22,25,57,-32,22
Montrose,1769,1,23,8,5,59,34,25,77
Peterhead,1769,2,24,4,8,83,38,45,76
Stirling,1769,3,17,6,13,65,52,13,57
Stenhousem'r,1769,4,15,8,13,56,51,5,53
Clyde,1769,5,14,9,13,51,49,2,51
Elgin,1769,6,14,7,15,53,60,-7,49
Annan Athlet,1769,7,11,11,14,48,43,5,44
Berwick,1769,8,9,10,17,30,58,-28,37
Edinburgh Ci,1769,9,7,9,20,36,66,-30,30
Cowdenbeath,1769,10,5,10,21,25,55,-30,25
Montrose,1770,1,24,7,5,63,35,28,79
Peterhead,1770,2,24,4,8,83,39,44,76
Stenhousem'r,1770,3,16,8,12,56,46,10,56
Stirling,1770,4,16,6,14,60,52,8,54
Clyde,1770,5,14,10,12,52,49,3,52
Elgin,1770,6,14,6,16,54,64,-10,48
Annan Athlet,1770,7,12,11,13,48,41,7,47
Berwick,1770,8,8,11,17,30,59,-29,35
Edinburgh Ci,1770,9,7,9,20,37,66,-29,30
Cowdenbeath,1770,10,4,10,22,23,55,-32,22
Peterhead,1771,1,24,4,8,83,38,45,76
Montrose,1771,2,23,7,6,60,37,23,76
Stirling,1771,3,17,6,13,64,51,13,57
Stenhousem'r,1771,4,15,8,13,55,50,5,53
Clyde,1771,5,14,10,12,51,48,3,52
Elgin,1771,6,15,6,15,56,61,-5,51
Annan Athlet,1771,7,12,11,13,51,42,9,47
Berwick,1771,8,8,11,17,29,58,-29,35
Edinburgh Ci,1771,9,7,9,20,36,66,-30,30
Cowdenbeath,1771,10,4,10,22,24,58,-34,22
Montrose,1772,1,23,7,6,60,36,24,76
Peterhead,1772,2,23,5,8,77,38,39,74
Stenhousem'r,1772,3,16,8,12,57,47,10,56
Stirling,1772,4,16,6,14,61,53,8,54
Clyde,1772,5,15,9,12,52,48,4,54
Elgin,1772,6,15,6,15,55,61,-6,51
Annan Athlet,1772,7,11,12,13,47,41,6,45
Berwick,1772,8,8,10,18,29,59,-30,34
Edinburgh Ci,1772,9,7,10,19,36,60,-24,31
Cowdenbeath,1772,10,4,11,21,23,54,-31,23
Montrose,1773,1,23,8,5,59,34,25,77
Peterhead,1773,2,24,4,8,81,38,43,76
Stirling,1773,3,16,7,13,62,53,9,55
Stenhousem'r,1773,4,15,9,12,57,48,9,54
Clyde,1773,5,14,10,12,52,49,3,52
Elgin,1773,6,14,7,15,53,60,-7,49
Annan Athlet,1773,7,12,11,13,49,41,8,47
Berwick,1773,8,8,11,17,30,59,-29,35
Edinburgh Ci,1773,9,7,9,20,36,64,-28,30
Cowdenbeath,1773,10,4,10,22,23,56,-33,22
Montrose,1774,1,23,8,5,59,34,25,77
Peterhead,1774,2,24,4,8,80,38,42,76
Stirling,1774,3,16,7,13,61,52,9,55
Stenhousem'r,1774,4,15,9,12,56,47,9,54
Clyde,1774,5,15,9,12,54,49,5,54
Elgin,1774,6,14,7,15,53,60,-7,49
Annan Athlet,1774,7,11,12,13,47,41,6,45
Berwick,1774,8,8,10,18,30,61,-31,34
Edinburgh Ci,1774,9,7,9,20,36,63,-27,30
Cowdenbeath,1774,10,4,11,21,23,54,-31,23
Montrose,1775,1,23,8,5,60,35,25,77
Peterhead,1775,2,24,4,8,82,38,44,76
Stirling,1775,3,17,6,13,64,51,13,57
Stenhousem'r,1775,4,15,8,13,55,50,5,53
Clyde,1775,5,14,10,12,51,48,3,52
Elgin,1775,6,14,7,15,54,61,-7,49
Annan Athlet,1775,7,11,11,14,47,43,4,44
Berwick,1775,8,8,11,17,29,58,-29,35
Edinburgh Ci,1775,9,7,9,20,36,65,-29,30
Cowdenbeath,1775,10,5,10,21,25,54,-29,25
Montrose,1776,1,24,7,5,62,34,28,79
Peterhead,1776,2,24,4,8,78,38,40,76
Stenhousem'r,1776,3,16,8,12,57,47,10,56
Stirling,1776,4,16,6,14,61,53,8,54
Clyde,1776,5,15,9,12,54,48,6,54
Elgin,1776,6,14,6,16,53,63,-10,48
Annan Athlet,1776,7,11,11,14,47,42,5,44
Berwick,1776,8,8,10,18,29,61,-32,34
Edinburgh Ci,1776,9,7,9,20,36,61,-25,30
Cowdenbeath,1776,10,5,10,21,24,54,-30,25
Montrose,1777,1,24,7,5,60,34,26,79
Peterhead,1777,2,24,4,8,80,38,42,76
Stirling,1777,3,16,7,13,60,51,9,55
Stenhousem'r,1777,4,15,9,12,55,46,9,54
Clyde,1777,5,14,9,13,53,52,1,51
Elgin,1777,6,14,6,16,53,61,-8,48
Annan Athlet,1777,7,12,11,13,48,41,7,47
Berwick,1777,8,9,10,17,33,60,-27,37
Edinburgh Ci,1777,9,7,9,20,36,63,-27,30
Cowdenbeath,1777,10,4,10,22,23,55,-32,22
Montrose,1778,1,24,7,5,62,35,27,79
Peterhead,1778,2,24,4,8,81,38,43,76
Stirling,1778,3,17,6,13,62,52,10,57
Clyde,1778,4,15,9,12,53,48,5,54
Stenhousem'r,1778,5,15,8,13,56,48,8,53
Elgin,1778,6,14,6,16,54,63,-9,48
Annan Athlet,1778,7,12,11,13,48,41,7,47
Berwick,1778,8,8,10,18,29,60,-31,34
Edinburgh Ci,1778,9,7,9,20,36,64,-28,30
Cowdenbeath,1778,10,4,10,22,23,55,-32,22
Montrose,1779,1,23,7,6,59,35,24,76
Peterhead,1779,2,23,5,8,77,38,39,74
Stenhousem'r,1779,3,16,8,12,57,47,10,56
Stirling,1779,4,16,6,14,61,53,8,54
Clyde,1779,5,15,9,12,54,48,6,54
Elgin,1779,6,15,6,15,54,60,-6,51
Annan Athlet,1779,7,11,12,13,48,42,6,45
Berwick,1779,8,8,10,18,29,61,-32,34
Edinburgh Ci,1779,9,7,10,19,36,60,-24,31
Cowdenbeath,1779,10,4,11,21,24,55,-31,23
Montrose,1780,1,23,8,5,59,34,25,77
Peterhead,1780,2,24,4,8,79,39,40,76
Stirling,1780,3,17,6,13,64,53,11,57
Clyde,1780,4,15,9,12,54,48,6,54
Stenhousem'r,1780,5,15,8,13,57,50,7,53
Elgin,1780,6,14,7,15,53,60,-7,49
Annan Athlet,1780,7,11,11,14,47,42,5,44
Berwick,1780,8,8,10,18,29,61,-32,34
Edinburgh Ci,1780,9,7,9,20,37,62,-25,30
Cowdenbeath,1780,10,5,10,21,24,54,-30,25
Montrose,1781,1,24,7,5,61,35,26,79
Peterhead,1781,2,24,4,8,79,39,40,76
Stenhousem'r,1781,3,16,8,12,57,47,10,56
Stirling,1781,4,16,6,14,61,53,8,54
Clyde,1781,5,15,9,12,54,48,6,54
Elgin,1781,6,14,6,16,54,62,-8,48
Annan Athlet,1781,7,11,12,13,49,43,6,45
Berwick,1781,8,8,10,18,29,61,-32,34
Edinburgh Ci,1781,9,7,9,20,37,62,-25,30
Cowdenbeath,1781,10,4,11,21,25,56,-31,23
Montrose,1782,1,24,7,5,62,34,28,79
Peterhead,1782,2,24,4,8,81,39,42,76
Stirling,1782,3,17,6,13,64,53,11,57
Clyde,1782,4,15,9,12,53,48,5,54
Stenhousem'r,1782,5,15,8,13,57,50,7,53
Elgin,1782,6,14,6,16,53,63,-10,48
Annan Athlet,1782,7,11,11,14,47,44,3,44
Berwick,1782,8,8,10,18,29,60,-31,34
Edinburgh Ci,1782,9,7,9,20,37,64,-27,30
Cowdenbeath,1782,10,5,10,21,26,54,-28,25
Peterhead,1783,1,24,4,8,79,38,41,76
Montrose,1783,2,23,7,6,60,37,23,76
Stenhousem'r,1783,3,16,8,12,57,47,10,56
Stirling,1783,4,16,6,14,61,53,8,54
Clyde,1783,5,15,9,12,52,48,4,54
Elgin,1783,6,15,6,15,56,61,-5,51
Annan Athlet,1783,7,12,11,13,49,41,8,47
Berwick,1783,8,8,10,18,29,59,-30,34
Edinburgh Ci,1783,9,7,9,20,36,62,-26,30
Cowdenbeath,1783,10,4,10,22,23,56,-33,22
Montrose,1784,1,23,8,5,59,34,25,77
Peterhead,1784,2,24,4,8,83,38,45,76
Stirling,1784,3,17,6,13,63,53,10,57
Clyde,1784,4,15,9,12,53,48,5,54
Stenhousem'r,1784,5,15,8,13,57,49,8,53
Elgin,1784,6,14,7,15,53,60,-7,49
Annan Athlet,1784,7,12,11,13,50,42,8,47
Berwick,1784,8,8,10,18,29,60,-31,34
Edinburgh Ci,1784,9,7,9,20,36,66,-30,30
Cowdenbeath,1784,10,4,10,22,24,57,-33,22
Montrose,1785,1,24,7,5,62,34,28,79
Peterhead,1785,2,23,4,9,78,40,38,73
Stirling,1785,3,17,6,13,63,52,11,57
Stenhousem'r,1785,4,15,8,13,56,49,7,53
Clyde,1785,5,14,9,13,51,49,2,51
Elgin,1785,6,14,6,16,53,63,-10,48
Annan Athlet,1785,7,11,11,14,49,45,4,44
Berwick,1785,8,9,10,17,30,58,-28,37
Edinburgh Ci,1785,9,8,9,19,38,61,-23,33
Cowdenbeath,1785,10,5,10,21,27,56,-29,25
Montrose,1786,1,24,7,5,62,36,26,79
Peterhead,1786,2,24,4,8,80,39,41,76
Stirling,1786,3,17,6,13,67,53,14,57
Stenhousem'r,1786,4,15,8,13,57,53,4,53
Clyde,1786,5,14,10,12,51,48,3,52
Elgin,1786,6,14,6,16,55,63,-8,48
Annan Athlet,1786,7,11,12,13,47,41,6,45
Berwick,1786,8,8,11,17,29,58,-29,35
Edinburgh Ci,1786,9,7,9,20,37,63,-26,30
Cowdenbeath,1786,10,4,11,21,23,54,-31,23
Montrose,1787,1,24,7,5,61,35,26,79
Peterhead,1787,2,23,4,9,79,41,38,73
Stirling,1787,3,17,6,13,61,51,10,57
Clyde,1787,4,15,9,12,53,48,5,54
Stenhousem'r,1787,5,15,8,13,55,47,8,53
Elgin,1787,6,14,6,16,54,62,-8,48
Annan Athlet,1787,7,11,11,14,48,43,5,44
Berwick,1787,8,8,10,18,29,60,-31,34
Edinburgh Ci,1787,9,8,9,19,39,62,-23,33
Cowdenbeath,1787,10,5,10,21,25,55,-30,25
Montrose,1788,1,24,7,5,60,34,26,79
Peterhead,1788,2,24,4,8,82,38,44,76
Stirling,1788,3,17,6,13,64,52,12,57
Stenhousem'r,1788,4,15,8,13,56,50,6,53
Clyde,1788,5,14,10,12,52,49,3,52
Elgin,1788,6,14,6,16,53,61,-8,48
Annan Athlet,1788,7,11,12,13,47,41,6,45
Berwick,1788,8,8,11,17,30,59,-29,35
Edinburgh Ci,1788,9,7,9,20,36,65,-29,30
Cowdenbeath,1788,10,4,11,21,23,54,-31,23
Peterhead,1789,1,24,4,8,80,39,41,76
Montrose,1789,2,23,7,6,59,36,23,76
Stirling,1789,3,17,6,13,63,53,10,57
Stenhousem'r,1789,4,15,8,13,57,49,8,53
Clyde,1789,5,14,10,12,52,49,3,52
Elgin,1789,6,15,6,15,55,60,-5,51
Annan Athlet,1789,7,12,11,13,50,41,9,47
Berwick,1789,8,8,11,17,30,59,-29,35
Edinburgh Ci,1789,9,7,9,20,37,63,-26,30
Cowdenbeath,1789,10,4,10,22,23,57,-34,22
Montrose,1790,1,24,7,5,64,35,29,79
Peterhead,1790,2,24,4,8,80,38,42,76
Stenhousem'r,1790,3,16,8,12,57,47,10,56
Stirling,1790,4,16,6,14,61,53,8,54
Clyde,1790,5,14,10,12,52,49,3,52
Elgin,1790,6,14,6,16,54,65,-11,48
Annan Athlet,1790,7,11,11,14,47,42,5,44
Berwick,1790,8,8,11,17,30,59,-29,35
Edinburgh Ci,1790,9,7,9,20,36,63,-27,30
Cowdenbeath,1790,10,5,10,21,24,54,-30,25
Montrose,1791,1,24,7,5,62,35,27,79
Peterhead,1791,2,24,4,8,80,39,41,76
Stirling,1791,3,17,6,13,64,52,12,57
Clyde,1791,4,15,9,12,52,48,4,54
Stenhousem'r,1791,5,15,8,13,56,50,6,53
Elgin,1791,6,14,6,16,54,63,-9,48
Annan Athlet,1791,7,11,12,13,48,42,6,45
Berwick,1791,8,8,10,18,29,59,-30,34
Edinburgh Ci,1791,9,7,9,20,37,63,-26,30
Cowdenbeath,1791,10,4,11,21,24,55,-31,23
Montrose,1792,1,24,7,5,62,35,27,79
Peterhead,1792,2,23,5,8,80,41,39,74
Stenhousem'r,1792,3,16,8,12,57,47,10,56
Stirling,1792,4,16,6,14,61,53,8,54
Clyde,1792,5,15,9,12,53,49,4,54
Elgin,1792,6,14,6,16,54,63,-9,48
Annan Athlet,1792,7,12,11,13,50,43,7,47
Berwick,1792,8,8,10,18,30,60,-30,34
Edinburgh Ci,1792,9,7,10,19,39,63,-24,31
Cowdenbeath,1792,10,4,10,22,25,57,-32,22
Montrose,1793,1,24,7,5,62,35,27,79
Peterhead,1793,2,24,4,8,80,38,42,76
Stenhousem'r,1793,3,16,8,12,59,46,13,56
Stirling,1793,4,16,6,14,60,55,5,54
Clyde,1793,5,15,9,12,54,49,5,54
Elgin,1793,6,14,6,16,54,63,-9,48
Annan Athlet,1793,7,11,11,14,47,43,4,44
Berwick,1793,8,8,10,18,30,61,-31,34
Edinburgh Ci,1793,9,7,9,20,36,63,-27,30
Cowdenbeath,1793,10,5,10,21,25,54,-29,25
Montrose,1794,1,24,7,5,62,35,27,79
Peterhead,1794,2,24,4,8,79,38,41,76
Stenhousem'r,1794,3,16,8,12,57,47,10,56
Stirling,1794,4,16,6,14,61,53,8,54
Clyde,1794,5,14,9,13,51,49,2,51
Elgin,1794,6,14,6,16,54,63,-9,48
Annan Athlet,1794,7,11,12,13,48,42,6,45
Berwick,1794,8,9,10,17,30,58,-28,37
Edinburgh Ci,1794,9,7,9,20,36,62,-26,30
Cowdenbeath,1794,10,4,11,21,24,55,-31,23
Montrose,1795,1,23,8,5,59,34,25,77
Peterhead,1795,2,23,4,9,79,42,37,73
Stirling,1795,3,17,6,13,61,51,10,57
Clyde,1795,4,15,9,12,55,48,7,54
Stenhousem'r,1795,5,15,8,13,55,47,8,53
Elgin,1795,6,14,7,15,53,60,-7,49
Annan Athlet,1795,7,12,11,13,49,42,7,47
Berwick,1795,8,8,10,18,29,62,-33,34
Edinburgh Ci,1795,9,8,9,19,40,62,-22,33
Cowdenbeath,1795,10,4,10,22,24,56,-32,22
Montrose,1796,1,24,7,5,60,34,26,79
Peterhead,1796,2,24,4,8,80,39,41,76
Stirling,1796,3,17,6,13,62,52,10,57
Clyde,1796,4,15,9,12,53,48,5,54
Stenhousem'r,1796,5,15,8,13,56,48,8,53
Elgin,1796,6,14,6,16,53,61,-8,48
Annan Athlet,1796,7,11,12,13,50,44,6,45
Berwick,1796,8,8,10,18,29,60,-31,34
Edinburgh Ci,1796,9,7,9,20,37,63,-26,30
Cowdenbeath,1796,10,4,11,21,26,57,-31,23
Montrose,1797,1,24,7,5,61,34,27,79
Peterhead,1797,2,24,4,8,81,38,43,76
Stirling,1797,3,17,6,13,61,51,10,57
Clyde,1797,4,15,9,12,54,48,6,54
Stenhousem'r,1797,5,15,8,13,55,47,8,53
Elgin,1797,6,14,6,16,53,62,-9,48
Annan Athlet,1797,7,11,12,13,48,42,6,45
Berwick,1797,8,8,10,18,29,61,-32,34
Edinburgh Ci,1797,9,7,9,20,36,64,-28,30
Cowdenbeath,1797,10,4,11,21,24,55,-31,23
Montrose,1798,1,23,8,5,59,34,25,77
Peterhead,1798,2,24,4,8,80,39,41,76
Stirling,1798,3,17,6,13,62,52,10,57
Clyde,1798,4,15,9,12,53,49,4,54
Stenhousem'r,1798,5,15,8,13,56,48,8,53
Elgin,1798,6,14,7,15,53,60,-7,49
Annan Athlet,1798,7,12,11,13,49,42,7,47
Berwick,1798,8,8,10,18,30,60,-30,34
Edinburgh Ci,1798,9,7,9,20,37,63,-26,30
Cowdenbeath,1798,10,4,10,22,24,56,-32,22
Montrose,1799,1,23,8,5,59,34,25,77
Peterhead,1799,2,24,4,8,81,38,43,76
Stirling,1799,3,16,7,13,60,51,9,55
Stenhousem'r,1799,4,15,9,12,55,46,9,54
Clyde,1799,5,14,9,13,51,50,1,51
Elgin,1799,6,14,7,15,53,60,-7,49
Annan Athlet,1799,7,11,12,13,49,43,6,45
Berwick,1799,8,9,10,17,31,58,-27,37
Edinburgh Ci,1799,9,7,9,20,36,64,-28,30
Cowdenbeath,1799,10,4,11,21,25,56,-31,23
Montrose,1800,1,24,7,5,62,35,27,79
Peterhead,1800,2,24,4,8,84,39,45,76
Stenhousem'r,1800,3,16,8,12,56,46,10,56
Stirling,1800,4,16,6,14,60,52,8,54
Clyde,1800,5,15,9,12,54,48,6,54
Elgin,1800,6,14,6,16,54,63,-9,48
Annan Athlet,1800,7,11,12,13,48,42,6,45
Berwick,1800,8,8,10,18,29,61,-32,34
Edinburgh Ci,1800,9,7,9,20,37,67,-30,30
Cowdenbeath,1800,10,4,11,21,24,55,-31,23
Montrose,1801,1,23,8,5,60,35,25,77
Peterhead,1801,2,24,4,8,79,39,40,76
Stenhousem'r,1801,3,16,8,12,57,47,10,56
Stirling,1801,4,16,6,14,61,53,8,54
Clyde,1801,5,14,10,12,53,50,3,52
Elgin,1801,6,14,7,15,54,61,-7,49
Annan Athlet,1801,7,11,11,14,47,43,4,44
Berwick,1801,8,8,11,17,31,60,-29,35
Edinburgh Ci,1801,9,7,9,20,37,62,-25,30
Cowdenbeath,1801,10,5,10,21,25,54,-29,25
Montrose,1802,1,24,7,5,63,34,29,79
Peterhead,1802,2,24,4,8,79,39,40,76
Stenhousem'r,1802,3,16,8,12,57,47,10,56
Stirling,1802,4,16,6,14,61,53,8,54
Clyde,1802,5,14,9,13,52,50,2,51
Elgin,1802,6,14,6,16,53,64,-11,48
Annan Athlet,1802,7,11,11,14,49,44,5,44
Berwick,1802,8,9,10,17,31,59,-28,37
Edinburgh Ci,1802,9,7,9,20,37,62,-25,30
Cowdenbeath,1802,10,5,10,21,26,56,-30,25
Montrose,1803,1,23,8,5,61,36,25,77
Peterhead,1803,2,24,4,8,80,39,41,76
Stirling,1803,3,17,6,13,61,51,10,57
Stenhousem'r,1803,4,15,8,13,55,47,8,53
Clyde,1803,5,14,10,12,51,48,3,52
Elgin,1803,6,14,7,15,55,62,-7,49
Annan Athlet,1803,7,11,12,13,47,41,6,45
Berwick,1803,8,8,11,17,29,58,-29,35
Edinburgh Ci,1803,9,7,9,20,37,63,-26,30
Cowdenbeath,1803,10,4,11,21,23,54,-31,23
Montrose,1804,1,23,7,6,59,36,23,76
Peterhead,1804,2,23,5,8,78,39,39,74
Stirling,1804,3,17,6,13,62,52,10,57
Clyde,1804,4,15,9,12,52,48,4,54
Stenhousem'r,1804,5,15,8,13,56,48,8,53
Elgin,1804,6,15,6,15,55,60,-5,51
Annan Athlet,1804,7,11,11,14,48,43,5,44
Berwick,1804,8,8,10,18,29,59,-30,34
Edinburgh Ci,1804,9,7,10,19,37,61,-24,31
Cowdenbeath,1804,10,5,10,21,25,55,-30,25
Montrose,1805,1,24,7,5,64,34,30,79
Peterhead,1805,2,23,4,9,78,40,38,73
Stirling,1805,3,16,7,13,60,51,9,55
Stenhousem'r,1805,4,15,9,12,55,46,9,54
Clyde,1805,5,15,9,12,55,51,4,54
Elgin,1805,6,14,6,16,53,65,-12,48
Annan Athlet,1805,7,11,12,13,48,42,6,45
Berwick,1805,8,8,10,18,32,62,-30,34
Edinburgh Ci,1805,9,8,9,19,38,61,-23,33
Cowdenbeath,1805,10,4,11,21,24,55,-31,23
Montrose,1806,1,23,8,5,60,35,25,77
Peterhead,1806,2,24,4,8,80,39,41,76
Stenhousem'r,1806,3,16,8,12,57,47,10,56
Stirling,1806,4,16,6,14,61,53,8,54
Clyde,1806,5,15,9,12,52,48,4,54
Elgin,1806,6,14,7,15,54,61,-7,49
Annan Athlet,1806,7,12,11,13,52,41,11,47
Berwick,1806,8,8,10,18,29,59,-30,34
Edinburgh Ci,1806,9,7,9,20,37,63,-26,30
Cowdenbeath,1806,10,4,10,22,23,59,-36,22
Montrose,1807,1,24,7,5,65,35,30,79
Peterhead,1807,2,24,4,8,79,39,40,76
Stenhousem'r,1807,3,16,8,12,57,46,11,56
Stirling,1807,4,16,6,14,60,53,7,54
Clyde,1807,5,15,9,12,53,48,5,54
Elgin,1807,6,14,6,16,54,66,-12,48
Annan Athlet,1807,7,11,11,14,47,42,5,44
Berwick,1807,8,8,10,18,29,60,-31,34
Edinburgh Ci,1807,9,7,9,20,37,62,-25,30
Cowdenbeath,1807,10,5,10,21,24,54,-30,25
Montrose,1808,1,23,8,5,59,34,25,77
Peterhead,1808,2,24,4,8,80,38,42,76
Stirling,1808,3,16,7,13,60,51,9,55
Stenhousem'r,1808,4,15,9,12,55,46,9,54
Clyde,1808,5,14,10,12,52,49,3,52
Elgin,1808,6,14,7,15,53,60,-7,49
Annan Athlet,1808,7,12,11,13,48,41,7,47
Berwick,1808,8,8,11,17,30,59,-29,35
Edinburgh Ci,1808,9,7,9,20,36,63,-27,30
Cowdenbeath,1808,10,4,10,22,23,55,-32,22
Montrose,1809,1,24,7,5,60,34,26,79
Peterhead,1809,2,24,4,8,80,38,42,76
Stenhousem'r,1809,3,16,8,12,57,47,10,56
Stirling,1809,4,16,6,14,61,53,8,54
Clyde,1809,5,14,10,12,52,49,3,52
Elgin,1809,6,14,6,16,53,61,-8,48
Annan Athlet,1809,7,11,12,13,48,42,6,45
Berwick,1809,8,8,11,17,30,59,-29,35
Edinburgh Ci,1809,9,7,9,20,36,63,-27,30
Cowdenbeath,1809,10,4,11,21,24,55,-31,23
Montrose,1810,1,23,7,6,59,37,22,76
Peterhead,1810,2,23,5,8,78,39,39,74
Stenhousem'r,1810,3,16,8,12,57,47,10,56
Stirling,1810,4,16,6,14,61,53,8,54
Clyde,1810,5,14,10,12,51,48,3,52
Elgin,1810,6,15,6,15,56,60,-4,51
Annan Athlet,1810,7,11,12,13,48,42,6,45
Berwick,1810,8,8,11,17,29,58,-29,35
Edinburgh Ci,1810,9,7,10,19,37,61,-24,31
Cowdenbeath,1810,10,4,11,21,24,55,-31,23
Peterhead,1811,1,24,4,8,82,38,44,76
Montrose,1811,2,23,7,6,59,35,24,76
Stirling,1811,3,16,7,13,61,52,9,55
Stenhousem'r,1811,4,15,9,12,56,47,9,54
Clyde,1811,5,14,9,13,53,51,2,51
Elgin,1811,6,15,6,15,54,60,-6,51
Annan Athlet,1811,7,11,11,14,47,43,4,44
Berwick,1811,8,9,10,17,32,60,-28,37
Edinburgh Ci,1811,9,7,9,20,36,65,-29,30
Cowdenbeath,1811,10,5,10,21,25,54,-29,25
Montrose,1812,1,23,8,5,62,37,25,77
Peterhead,1812,2,24,4,8,80,38,42,76
Stirling,1812,3,17,6,13,63,53,10,57
Stenhousem'r,1812,4,15,8,13,57,49,8,53
Clyde,1812,5,14,9,13,52,50,2,51
Elgin,1812,6,14,7,15,56,63,-7,49
Annan Athlet,1812,7,12,11,13,48,41,7,47
Berwick,1812,8,9,10,17,31,59,-28,37
Edinburgh Ci,1812,9,7,9,20,36,63,-27,30
Cowdenbeath,1812,10,4,10,22,23,55,-32,22
Montrose,1813,1,24,7,5,64,35,29,79
Peterhead,1813,2,24,4,8,80,38,42,76
Stenhousem'r,1813,3,16,8,12,57,46,11,56
Stirling,1813,4,16,6,14,60,53,7,54
Clyde,1813,5,15,9,12,55,49,6,54
Elgin,1813,6,14,6,16,54,65,-11,48
Annan Athlet,1813,7,11,11,14,47,42,5,44
Berwick,1813,8,8,10,18,30,62,-32,34
Edinburgh Ci,1813,9,7,9,20,36,63,-27,30
Cowdenbeath,1813,10,5,10,21,24,54,-30,25
Montrose,1814,1,23,7,6,61,37,24,76
Peterhead,1814,2,23,4,9,78,40,38,73
Stirling,1814,3,17,6,13,63,51,12,57
Stenhousem'r,1814,4,15,8,13,55,49,6,53
Clyde,1814,5,14,9,13,52,50,2,51
Elgin,1814,6,15,6,15,56,62,-6,51
Annan Athlet,1814,7,12,11,13,48,41,7,47
Berwick,1814,8,9,10,17,31,59,-28,37
Edinburgh Ci,1814,9,8,9,19,38,61,-23,33
Cowdenbeath,1814,10,4,10,22,23,55,-32,22
Montrose,1815,1,23,8,5,60,35,25,77
Peterhead,1815,2,23,4,9,77,39,38,73
Stirling,1815,3,16,7,13,62,53,9,55
Stenhousem'r,1815,4,15,9,12,57,48,9,54
Clyde,1815,5,14,9,13,51,50,1,51
Elgin,1815,6,14,7,15,54,61,-7,49
Annan Athlet,1815,7,12,11,13,48,41,7,47
Berwick,1815,8,9,10,17,31,58,-27,37
Edinburgh Ci,1815,9,8,9,19,37,60,-23,33
Cowdenbeath,1815,10,4,10,22,23,55,-32,22
Montrose,1816,1,24,7,5,62,36,26,79
Peterhead,1816,2,23,5,8,78,39,39,74
Stenhousem'r,1816,3,16,8,12,58,46,12,56
Stirling,1816,4,16,6,14,60,54,6,54
Clyde,1816,5,15,9,12,52,48,4,54
Elgin,1816,6,14,6,16,55,63,-8,48
Annan Athlet,1816,7,11,12,13,47,41,6,45
Berwick,1816,8,8,10,18,29,59,-30,34
Edinburgh Ci,1816,9,7,10,19,37,61,-24,31
Cowdenbeath,1816,10,4,11,21,23,54,-31,23
Montrose,1817,1,23,8,5,61,36,25,77
Peterhead,1817,2,23,4,9,77,39,38,73
Stirling,1817,3,16,7,13,62,53,9,55
Stenhousem'r,1817,4,15,9,12,57,48,9,54
Clyde,1817,5,15,9,12,56,49,7,54
Elgin,1817,6,14,7,15,55,62,-7,49
Annan Athlet,1817,7,11,12,13,48,42,6,45
Berwick,1817,8,8,10,18,30,63,-33,34
Edinburgh Ci,1817,9,8,9,19,37,60,-23,33
Cowdenbeath,1817,10,4,11,21,24,55,-31,23
Montrose,1818,1,23,8,5,60,35,25,77
Peterhead,1818,2,24,4,8,85,39,46,76
Stenhousem'r,1818,3,16,8,12,57,46,11,56
Stirling,1818,4,16,6,14,60,53,7,54
Clyde,1818,5,15,9,12,53,48,5,54
Elgin,1818,6,14,7,15,54,61,-7,49
Annan Athlet,1818,7,11,12,13,47,41,6,45
Berwick,1818,8,8,10,18,29,60,-31,34
Edinburgh Ci,1818,9,7,9,20,37,68,-31,30
Cowdenbeath,1818,10,4,11,21,23,54,-31,23
Montrose,1819,1,24,7,5,63,34,29,79
Peterhead,1819,2,24,4,8,79,38,41,76
Stenhousem'r,1819,3,16,8,12,58,47,11,56
Stirling,1819,4,16,6,14,61,54,7,54
Clyde,1819,5,14,10,12,52,49,3,52
Elgin,1819,6,14,6,16,53,64,-11,48
Annan Athlet,1819,7,12,11,13,50,41,9,47
Berwick,1819,8,8,11,17,30,59,-29,35
Edinburgh Ci,1819,9,7,9,20,36,62,-26,30
Cowdenbeath,1819,10,4,10,22,23,57,-34,22
Montrose,1820,1,24,7,5,62,35,27,79
Peterhead,1820,2,24,4,8,80,39,41,76
Stirling,1820,3,17,6,13,63,52,11,57
Stenhousem'r,1820,4,15,8,13,56,49,7,53
Clyde,1820,5,14,9,13,51,49,2,51
Elgin,1820,6,14,6,16,54,63,-9,48
Annan Athlet,1820,7,11,12,13,47,41,6,45
Berwick,1820,8,9,10,17,30,58,-28,37
Edinburgh Ci,1820,9,7,9,20,37,63,-26,30
Cowdenbeath,1820,10,4,11,21,23,54,-31,23
Montrose,1821,1,24,7,5,60,34,26,79
Peterhead,1821,2,24,4,8,78,38,40,76
Stirling,1821,3,17,6,13,62,52,10,57
Clyde,1821,4,15,9,12,54,49,5,54
Stenhousem'r,1821,5,15,8,13,56,48,8,53
Elgin,1821,6,14,6,16,53,61,-8,48
Annan Athlet,1821,7,11,12,13,47,41,6,45
Berwick,1821,8,8,10,18,30,61,-31,34
Edinburgh Ci,1821,9,7,9,20,36,61,-25,30
Cowdenbeath,1821,10,4,11,21,23,54,-31,23
Montrose,1822,1,24,7,5,62,36,26,79
Peterhead,1822,2,24,4,8,78,38,40,76
Stirling,1822,3,16,7,13,62,53,9,55
Stenhousem'r,1822,4,15,9,12,57,48,9,54
Clyde,1822,5,15,9,12,57,49,8,54
Elgin,1822,6,14,6,16,55,63,-8,48
Annan Athlet,1822,7,11,11,14,47,43,4,44
Berwick,1822,8,8,10,18,30,64,-34,34
Edinburgh Ci,1822,9,7,9,20,36,61,-25,30
Cowdenbeath,1822,10,5,10,21,25,54,-29,25
Montrose,1823,1,23,8,5,60,35,25,77
Peterhead,1823,2,24,4,8,81,39,42,76
Stirling,1823,3,16,7,13,60,51,9,55
Stenhousem'r,1823,4,15,9,12,55,46,9,54
Clyde,1823,5,14,10,12,53,50,3,52
Elgin,1823,6,14,7,15,54,61,-7,49
Annan Athlet,1823,7,12,11,13,48,41,7,47
Berwick,1823,8,8,11,17,31,60,-29,35
Edinburgh Ci,1823,9,7,9,20,37,64,-27,30
Cowdenbeath,1823,10,4,10,22,23,55,-32,22
Montrose,1824,1,24,7,5,60,34,26,79
Peterhead,1824,2,24,4,8,81,39,42,76
Stirling,1824,3,16,7,13,61,52,9,55
Stenhousem'r,1824,4,15,9,12,56,47,9,54
Clyde,1824,5,15,9,12,55,48,7,54
Elgin,1824,6,14,6,16,53,61,-8,48
Annan Athlet,1824,7,12,11,13,50,43,7,47
Berwick,1824,8,8,10,18,29,62,-33,34
Edinburgh Ci,1824,9,7,9,20,37,64,-27,30
Cowdenbeath,1824,10,4,10,22,25,57,-32,22
Montrose,1825,1,24,7,5,62,36,26,79
Peterhead,1825,2,24,4,8,83,38,45,76
Stenhousem'r,1825,3,16,8,12,56,46,10,56
Stirling,1825,4,16,6,14,60,52,8,54
Clyde,1825,5,15,9,12,53,49,4,54
Elgin,1825,6,14,6,16,55,63,-8,48
Annan Athlet,1825,7,11,11,14,47,42,5,44
Berwick,1825,8,8,10,18,30,60,-30,34
Edinburgh Ci,1825,9,7,9,20,36,66,-30,30
Cowdenbeath,1825,10,5,10,21,24,54,-30,25
Montrose,1826,1,24,7,5,63,34,29,79
Peterhead,1826,2,24,4,8,81,39,42,76
Stirling,1826,3,17,6,13,62,51,11,57
Clyde,1826,4,15,9,12,52,48,4,54
Stenhousem'r,1826,5,15,8,13,55,48,7,53
Elgin,1826,6,14,6,16,53,64,-11,48
Annan Athlet,1826,7,11,12,13,48,42,6,45
Berwick,1826,8,8,10,18,29,59,-30,34
Edinburgh Ci,1826,9,7,9,20,37,64,-27,30
Cowdenbeath,1826,10,4,11,21,24,55,-31,23
Peterhead,1827,1,24,4,8,82,39,43,76
Montrose,1827,2,23,7,6,59,36,23,76
Stenhousem'r,1827,3,16,8,12,57,47,10,56
Stirling,1827,4,16,6,14,61,53,8,54
Clyde,1827,5,14,10,12,53,50,3,52
Elgin,1827,6,15,6,15,55,60,-5,51
Annan Athlet,1827,7,11,12,13,47,41,6,45
Berwick,1827,8,8,11,17,31,60,-29,35
Edinburgh Ci,1827,9,7,9,20,37,65,-28,30
Cowdenbeath,1827,10,4,11,21,23,54,-31,23
Peterhead,1828,1,24,4,8,81,38,43,76
Montrose,1828,2,23,7,6,59,37,22,76
Stenhousem'r,1828,3,16,8,12,57,47,10,56
Stirling,1828,4,16,6,14,61,53,8,54
Clyde,1828,5,15,9,12,54,49,5,54
Elgin,1828,6,15,6,15,56,60,-4,51
Annan Athlet,1828,7,11,11,14,47,43,4,44
Berwick,1828,8,8,10,18,30,61,-31,34
Edinburgh Ci,1828,9,7,9,20,36,64,-28,30
Cowdenbeath,1828,10,5,10,21,25,54,-29,25
Peterhead,1829,1,24,4,8,80,38,42,76
Montrose,1829,2,23,7,6,59,36,23,76
Stirling,1829,3,16,7,13,62,53,9,55
Stenhousem'r,1829,4,15,9,12,57,48,9,54
Clyde,1829,5,14,9,13,52,51,1,51
Elgin,1829,6,15,6,15,55,60,-5,51
Annan Athlet,1829,7,11,12,13,48,42,6,45
Berwick,1829,8,9,10,17,32,59,-27,37
Edinburgh Ci,1829,9,7,9,20,36,63,-27,30
Cowdenbeath,1829,10,4,11,21,24,55,-31,23
Montrose,1830,1,24,7,5,60,34,26,79
Peterhead,1830,2,24,4,8,80,38,42,76
Stirling,1830,3,17,6,13,64,52,12,57
Clyde,1830,4,15,9,12,55,49,6,54
Stenhousem'r,1830,5,15,8,13,56,50,6,53
Elgin,1830,6,14,6,16,53,61,-8,48
Annan Athlet,1830,7,12,11,13,48,41,7,47
Berwick,1830,8,8,10,18,30,62,-32,34
Edinburgh Ci,1830,9,7,9,20,36,63,-27,30
Cowdenbeath,1830,10,4,10,22,23,55,-32,22
Peterhead,1831,1,24,4,8,80,39,41,76
Montrose,1831,2,23,7,6,59,38,21,76
Stirling,1831,3,17,6,13,62,51,11,57
Clyde,1831,4,15,9,12,54,50,4,54
Stenhousem'r,1831,5,15,8,13,55,48,7,53
Elgin,1831,6,15,6,15,57,60,-3,51
Annan Athlet,1831,7,11,12,13,48,42,6,45
Berwick,1831,8,8,10,18,31,61,-30,34
Edinburgh Ci,1831,9,7,9,20,37,63,-26,30
Cowdenbeath,1831,10,4,11,21,24,55,-31,23
Montrose,1832,1,24,7,5,61,35,26,79
Peterhead,1832,2,24,4,8,81,41,40,76
Stirling,1832,3,17,6,13,61,51,10,57
Clyde,1832,4,15,9,12,54,49,5,54
Stenhousem'r,1832,5,15,8,13,55,47,8,53
Elgin,1832,6,14,6,16,54,62,-8,48
Annan Athlet,1832,7,11,12,13,47,41,6,45
Berwick,1832,8,8,10,18,30,61,-31,34
Edinburgh Ci,1832,9,7,9,20,39,64,-25,30
Cowdenbeath,1832,10,4,11,21,23,54,-31,23
Montrose,1833,1,24,7,5,61,35,26,79
Peterhead,1833,2,23,4,9,77,39,38,73
Stirling,1833,3,17,6,13,64,51,13,57
Stenhousem'r,1833,4,15,8,13,55,50,5,53
Clyde,1833,5,14,9,13,51,49,2,51
Elgin,1833,6,14,6,16,54,62,-8,48
Annan Athlet,1833,7,11,11,14,48,44,4,44
Berwick,1833,8,9,10,17,30,58,-28,37
Edinburgh Ci,1833,9,8,9,19,37,60,-23,33
Cowdenbeath,1833,10,5,10,21,26,55,-29,25
Montrose,1834,1,23,8,5,60,35,25,77
Peterhead,1834,2,24,4,8,80,38,42,76
Stirling,1834,3,17,6,13,61,51,10,57
Clyde,1834,4,15,9,12,54,48,6,54
Stenhousem'r,1834,5,15,8,13,55,47,8,53
Elgin,1834,6,14,7,15,54,61,-7,49
Annan Athlet,1834,7,12,11,13,48,41,7,47
Berwick,1834,8,8,10,18,29,61,-32,34
Edinburgh Ci,1834,9,7,9,20,36,63,-27,30
Cowdenbeath,1834,10,4,10,22,23,55,-32,22
Montrose,1835,1,24,7,5,62,34,28,79
Peterhead,1835,2,23,5,8,77,38,39,74
Stirling,1835,3,17,6,13,64,51,13,57
Clyde,1835,4,15,9,12,52,48,4,54
Stenhousem'r,1835,5,15,8,13,55,50,5,53
Elgin,1835,6,14,6,16,53,63,-10,48
Annan Athlet,1835,7,11,12,13,49,43,6,45
Berwick,1835,8,8,10,18,29,59,-30,34
Edinburgh Ci,1835,9,7,10,19,36,60,-24,31
Cowdenbeath,1835,10,4,11,21,25,56,-31,23
Montrose,1836,1,24,7,5,61,34,27,79
Peterhead,1836,2,23,4,9,78,40,38,73
Stirling,1836,3,17,6,13,63,52,11,57
Clyde,1836,4,15,9,12,53,48,5,54
Stenhousem'r,1836,5,15,8,13,56,49,7,53
Elgin,1836,6,14,6,16,53,62,-9,48
Annan Athlet,1836,7,11,11,14,47,43,4,44
Berwick,1836,8,8,10,18,29,60,-31,34
Edinburgh Ci,1836,9,8,9,19,38,61,-23,33
Cowdenbeath,1836,10,5,10,21,25,54,-29,25
Peterhead,1837,1,24,4,8,82,39,43,76
Montrose,1837,2,23,7,6,59,36,23,76
Stirling,1837,3,17,6,13,62,51,11,57
Stenhousem'r,1837,4,15,8,13,55,48,7,53
Clyde,1837,5,14,9,13,52,50,2,51
Elgin,1837,6,15,6,15,55,60,-5,51
Annan Athlet,1837,7,11,11,14,47,42,5,44
Berwick,1837,8,9,10,17,31,59,-28,37
Edinburgh Ci,1837,9,7,9,20,37,65,-28,30
Cowdenbeath,1837,10,5,10,21,24,54,-30,25
Montrose,1838,1,23,8,5,60,35,25,77
Peterhead,1838,2,24,4,8,79,38,41,76
Stirling,1838,3,17,6,13,65,52,13,57
Stenhousem'r,1838,4,15,8,13,56,51,5,53
Clyde,1838,5,14,9,13,51,51,0,51
Elgin,1838,6,14,7,15,54,61,-7,49
Annan Athlet,1838,7,11,11,14,49,44,5,44
Berwick,1838,8,9,10,17,32,58,-26,37
Edinburgh Ci,1838,9,7,9,20,36,62,-26,30
Cowdenbeath,1838,10,5,10,21,26,56,-30,25
Montrose,1839,1,24,7,5,62,34,28,79
Peterhead,1839,2,24,4,8,78,38,40,76
Stenhousem'r,1839,3,16,8,12,56,46,10,56
Stirling,1839,4,16,6,14,60,52,8,54
Clyde,1839,5,15,9,12,52,48,4,54
Elgin,1839,6,14,6,16,53,63,-10,48
Annan Athlet,1839,7,11,11,14,47,42,5,44
Berwick,1839,8,8,10,18,29,59,-30,34
Edinburgh Ci,1839,9,7,9,20,36,61,-25,30
Cowdenbeath,1839,10,5,10,21,24,54,-30,25
Montrose,1840,1,23,8,5,61,36,25,77
Peterhead,1840,2,24,4,8,80,38,42,76
Stirling,1840,3,17,6,13,62,52,10,57
Clyde,1840,4,15,9,12,55,48,7,54
Stenhousem'r,1840,5,15,8,13,56,48,8,53
Elgin,1840,6,14,7,15,55,62,-7,49
Annan Athlet,1840,7,12,11,13,48,41,7,47
Berwick,1840,8,8,10,18,29,62,-33,34
Edinburgh Ci,1840,9,7,9,20,36,63,-27,30
Cowdenbeath,1840,10,4,10,22,23,55,-32,22
Peterhead,1841,1,24,4,8,81,38,43,76
Montrose,1841,2,23,7,6,60,36,24,76
Stirling,1841,3,16,7,13,62,53,9,55
Stenhousem'r,1841,4,15,9,12,57,48,9,54
Clyde,1841,5,14,10,12,52,49,3,52
Elgin,1841,6,15,6,15,55,61,-6,51
Annan Athlet,1841,7,11,12,13,49,43,6,45
Berwick,1841,8,8,11,17,30,59,-29,35
Edinburgh Ci,1841,9,7,9,20,36,64,-28,30
Cowdenbeath,1841,10,4,11,21,25,56,-31,23
Montrose,1842,1,23,8,5,60,35,25,77
Peterhead,1842,2,24,4,8,80,38,42,76
Stirling,1842,3,17,6,13,61,51,10,57
Clyde,1842,4,15,9,12,54,50,4,54
Stenhousem'r,1842,5,15,8,13,55,47,8,53
Elgin,1842,6,14,7,15,54,61,-7,49
Annan Athlet,1842,7,11,11,14,47,42,5,44
Berwick,1842,8,8,10,18,31,61,-30,34
Edinburgh Ci,1842,9,7,9,20,36,63,-27,30
Cowdenbeath,1842,10,5,10,21,24,54,-30,25
Montrose,1843,1,24,7,5,61,35,26,79
Peterhead,1843,2,24,4,8,80,38,42,76
Stenhousem'r,1843,3,16,8,12,58,48,10,56
Stirling,1843,4,16,6,14,62,54,8,54
Clyde,1843,5,15,9,12,52,48,4,54
Elgin,1843,6,14,6,16,54,62,-8,48
Annan Athlet,1843,7,11,11,14,48,44,4,44
Berwick,1843,8,8,10,18,29,59,-30,34
Edinburgh Ci,1843,9,7,9,20,36,63,-27,30
Cowdenbeath,1843,10,5,10,21,26,55,-29,25
Montrose,1844,1,23,8,5,59,34,25,77
Peterhead,1844,2,24,4,8,79,38,41,76
Stenhousem'r,1844,3,16,8,12,58,46,12,56
Stirling,1844,4,16,6,14,60,54,6,54
Clyde,1844,5,14,9,13,51,51,0,51
Elgin,1844,6,14,7,15,53,60,-7,49
Annan Athlet,1844,7,11,11,14,48,44,4,44
Berwick,1844,8,9,10,17,32,58,-26,37
Edinburgh Ci,1844,9,7,9,20,36,62,-26,30
Cowdenbeath,1844,10,5,10,21,26,55,-29,25
Montrose,1845,1,24,7,5,62,35,27,79
Peterhead,1845,2,24,4,8,81,38,43,76
Stirling,1845,3,17,6,13,62,52,10,57
Stenhousem'r,1845,4,15,8,13,56,48,8,53
Clyde,1845,5,14,10,12,52,49,3,52
Elgin,1845,6,14,6,16,54,63,-9,48
Annan Athlet,1845,7,11,11,14,47,42,5,44
Berwick,1845,8,8,11,17,30,59,-29,35
Edinburgh Ci,1845,9,7,9,20,36,64,-28,30
Cowdenbeath,1845,10,5,10,21,24,54,-30,25
Montrose,1846,1,24,7,5,63,35,28,79
Peterhead,1846,2,24,4,8,80,39,41,76
Stenhousem'r,1846,3,16,8,12,57,46,11,56
Stirling,1846,4,16,6,14,60,53,7,54
Clyde,1846,5,15,9,12,54,49,5,54
Elgin,1846,6,14,6,16,54,64,-10,48
Annan Athlet,1846,7,11,12,13,47,41,6,45
Berwick,1846,8,8,10,18,30,61,-31,34
Edinburgh Ci,1846,9,7,9,20,37,63,-26,30
Cowdenbeath,1846,10,4,11,21,23,54,-31,23
Montrose,1847,1,24,7,5,62,34,28,79
Peterhead,1847,2,23,4,9,77,41,36,73
Stirling,1847,3,17,6,13,63,51,12,57
Clyde,1847,4,15,9,12,52,48,4,54
Stenhousem'r,1847,5,15,8,13,55,49,6,53
Elgin,1847,6,14,6,16,53,63,-10,48
Annan Athlet,1847,7,11,11,14,48,43,5,44
Berwick,1847,8,8,10,18,29,59,-30,34
Edinburgh Ci,1847,9,8,9,19,39,60,-21,33
Cowdenbeath,1847,10,5,10,21,25,55,-30,25
Montrose,1848,1,24,7,5,60,34,26,79
Peterhead,1848,2,24,4,8,80,38,42,76
Stirling,1848,3,16,7,13,60,51,9,55
Stenhousem'r,1848,4,15,9,12,55,46,9,54
Clyde,1848,5,15,9,12,54,48,6,54
Elgin,1848,6,14,6,16,53,61,-8,48
Annan Athlet,1848,7,12,11,13,50,41,9,47
Berwick,1848,8,8,10,18,29,61,-32,34
Edinburgh Ci,1848,9,7,9,20,36,63,-27,30
Cowdenbeath,1848,10,4,10,22,23,57,-34,22
Peterhead,1849,1,24,4,8,81,38,43,76
Montrose,1849,2,23,7,6,61,37,24,76
Stenhousem'r,1849,3,16,8,12,56,46,10,56
Stirling,1849,4,16,6,14,60,52,8,54
Clyde,1849,5,14,10,12,52,49,3,52
Elgin,1849,6,15,6,15,56,62,-6,51
Annan Athlet,1849,7,11,12,13,48,42,6,45
Berwick,1849,8,8,11,17,30,59,-29,35
Edinburgh Ci,1849,9,7,9,20,36,64,-28,30
Cowdenbeath,1849,10,4,11,21,24,55,-31,23
Montrose,1850,1,24,7,5,66,35,31,79
Peterhead,1850,2,23,5,8,77,38,39,74
Stirling,1850,3,16,7,13,61,52,9,55
Stenhousem'r,1850,4,15,9,12,56,47,9,54
Clyde,1850,5,15,9,12,53,49,4,54
Elgin,1850,6,14,6,16,54,67,-13,48
Annan Athlet,1850,7,11,12,13,48,42,6,45
Berwick,1850,8,8,10,18,30,60,-30,34
Edinburgh Ci,1850,9,7,10,19,36,60,-24,31
Cowdenbeath,1850,10,4,11,21,24,55,-31,23
Montrose,1851,1,24,7,5,63,35,28,79
Peterhead,1851,2,24,4,8,79,38,41,76
Stenhousem'r,1851,3,16,8,12,57,46,11,56
Stirling,1851,4,16,6,14,60,53,7,54
Clyde,1851,5,15,9,12,54,49,5,54
Elgin,1851,6,14,6,16,54,64,-10,48
Annan Athlet,1851,7,12,11,13,51,41,10,47
Berwick,1851,8,8,10,18,30,61,-31,34
Edinburgh Ci,1851,9,7,9,20,36,62,-26,30
Cowdenbeath,1851,10,4,10,22,23,58,-35,22
Montrose,1852,1,23,8,5,61,36,25,77
Peterhead,1852,2,24,4,8,80,38,42,76
Stirling,1852,3,17,6,13,66,52,14,57
Stenhousem'r,1852,4,15,8,13,56,52,4,53
Clyde,1852,5,14,10,12,51,48,3,52
Elgin,1852,6,14,7,15,55,62,-7,49
Annan Athlet,1852,7,12,11,13,49,41,8,47
Berwick,1852,8,8,11,17,29,58,-29,35
Edinburgh Ci,1852,9,7,9,20,36,63,-27,30
Cowdenbeath,1852,10,4,10,22,23,56,-33,22
Montrose,1853,1,24,7,5,62,35,27,79
Peterhead,1853,2,24,4,8,80,39,41,76
Stirling,1853,3,17,6,13,62,52,10,57
Clyde,1853,4,15,9,12,52,48,4,54
Stenhousem'r,1853,5,15,8,13,56,48,8,53
Elgin,1853,6,14,6,16,54,63,-9,48
Annan Athlet,1853,7,12,11,13,49,42,7,47
Berwick,1853,8,8,10,18,29,59,-30,34
Edinburgh Ci,1853,9,7,9,20,37,63,-26,30
Cowdenbeath,1853,10,4,10,22,24,56,-32,22
Peterhead,1854,1,24,4,8,79,38,41,76
Montrose,1854,2,23,7,6,60,36,24,76
Stirling,1854,3,17,6,13,61,51,10,57
Clyde,1854,4,15,9,12,53,48,5,54
Stenhousem'r,1854,5,15,8,13,55,47,8,53
Elgin,1854,6,15,6,15,55,61,-6,51
Annan Athlet,1854,7,11,11,14,49,44,5,44
Berwick,1854,8,8,10,18,29,60,-31,34
Edinburgh Ci,1854,9,7,9,20,36,62,-26,30
Cowdenbeath,1854,10,5,10,21,26,56,-30,25
Montrose,1855,1,24,7,5,61,34,27,79
Peterhead,1855,2,24,4,8,79,39,40,76
Stenhousem'r,1855,3,16,8,12,57,46,11,56
Stirling,1855,4,16,6,14,60,53,7,54
Clyde,1855,5,14,10,12,51,48,3,52
Elgin,1855,6,14,6,16,53,62,-9,48
Annan Athlet,1855,7,11,11,14,50,47,3,44
Berwick,1855,8,8,11,17,29,58,-29,35
Edinburgh Ci,1855,9,7,9,20,37,62,-25,30
Cowdenbeath,1855,10,5,10,21,29,57,-28,25
Montrose,1856,1,24,7,5,66,34,32,79
Peterhead,1856,2,23,4,9,77,40,37,73
Stirling,1856,3,17,6,13,63,52,11,57
Stenhousem'r,1856,4,15,8,13,56,49,7,53
Clyde,1856,5,14,9,13,51,49,2,51
Elgin,1856,6,14,6,16,53,67,-14,48
Annan Athlet,1856,7,12,11,13,48,41,7,47
Berwick,1856,8,9,10,17,30,58,-28,37
Edinburgh Ci,1856,9,8,9,19,38,60,-22,33
Cowdenbeath,1856,10,4,10,22,23,55,-32,22
Montrose,1857,1,23,7,6,59,35,24,76
Peterhead,1857,2,23,5,8,78,39,39,74
Stirling,1857,3,16,7,13,61,52,9,55
Stenhousem'r,1857,4,15,9,12,56,47,9,54
Clyde,1857,5,15,9,12,54,49,5,54
Elgin,1857,6,15,6,15,54,60,-6,51
Annan Athlet,1857,7,11,11,14,48,44,4,44
Berwick,1857,8,8,10,18,30,61,-31,34
Edinburgh Ci,1857,9,7,10,19,37,61,-24,31
Cowdenbeath,1857,10,5,10,21,26,55,-29,25
Peterhead,1858,1,24,4,8,83,40,43,76
Montrose,1858,2,23,7,6,62,38,24,76
Stirling,1858,3,16,7,13,61,52,9,55
Stenhousem'r,1858,4,15,9,12,56,47,9,54
Clyde,1858,5,15,9,12,53,48,5,54
Elgin,1858,6,15,6,15,57,63,-6,51
Annan Athlet,1858,7,12,11,13,48,41,7,47
Berwick,1858,8,8,10,18,29,60,-31,34
Edinburgh Ci,1858,9,7,9,20,38,66,-28,30
Cowdenbeath,1858,10,4,10,22,23,55,-32,22
Montrose,1859,1,24,7,5,64,34,30,79
Peterhead,1859,2,24,4,8,82,40,42,76
Stirling,1859,3,16,7,13,61,52,9,55
Stenhousem'r,1859,4,15,9,12,56,47,9,54
Clyde,1859,5,14,9,13,52,50,2,51
Elgin,1859,6,14,6,16,53,65,-12,48
Annan Athlet,1859,7,11,11,14,47,44,3,44
Berwick,1859,8,9,10,17,31,59,-28,37
Edinburgh Ci,1859,9,7,9,20,38,65,-27,30
Cowdenbeath,1859,10,5,10,21,26,54,-28,25
Montrose,1860,1,23,8,5,60,35,25,77
Peterhead,1860,2,23,5,8,78,39,39,74
Stirling,1860,3,16,7,13,61,52,9,55
Stenhousem'r,1860,4,15,9,12,56,47,9,54
Clyde,1860,5,15,9,12,53,48,5,54
Elgin,1860,6,14,7,15,54,61,-7,49
Annan Athlet,1860,7,11,11,14,47,42,5,44
Berwick,1860,8,8,10,18,29,60,-31,34
Edinburgh Ci,1860,9,7,10,19,37,61,-24,31
Cowdenbeath,1860,10,5,10,21,24,54,-30,25
Montrose,1861,1,24,7,5,61,35,26,79
Peterhead,1861,2,24,4,8,82,40,42,76
Stenhousem'r,1861,3,16,8,12,57,47,10,56
Stirling,1861,4,16,6,14,61,53,8,54
Clyde,1861,5,15,9,12,56,49,7,54
Elgin,1861,6,14,6,16,54,62,-8,48
Annan Athlet,1861,7,11,11,14,48,43,5,44
Berwick,1861,8,8,10,18,30,63,-33,34
Edinburgh Ci,1861,9,7,9,20,38,65,-27,30
Cowdenbeath,1861,10,5,10,21,25,55,-30,25
Montrose,1862,1,24,7,5,63,35,28,79
Peterhead,1862,2,23,5,8,80,41,39,74
Stirling,1862,3,17,6,13,62,51,11,57
Clyde,1862,4,15,9,12,53,48,5,54
Stenhousem'r,1862,5,15,8,13,55,48,7,53
Elgin,1862,6,14,6,16,54,64,-10,48
Annan Athlet,1862,7,11,12,13,48,42,6,45
Berwick,1862,8,8,10,18,29,60,-31,34
Edinburgh Ci,1862,9,7,10,19,39,63,-24,31
Cowdenbeath,1862,10,4,11,21,24,55,-31,23
Montrose,1863,1,24,7,5,62,34,28,79
Peterhead,1863,2,24,4,8,80,40,40,76
Stirling,1863,3,17,6,13,61,51,10,57
Clyde,1863,4,15,9,12,53,49,4,54
Stenhousem'r,1863,5,15,8,13,55,47,8,53
Elgin,1863,6,14,6,16,53,63,-10,48
Annan Athlet,1863,7,11,12,13,47,41,6,45
Berwick,1863,8,8,10,18,30,60,-30,34
Edinburgh Ci,1863,9,7,9,20,38,63,-25,30
Cowdenbeath,1863,10,4,11,21,23,54,-31,23
Montrose,1864,1,24,7,5,64,36,28,79
Peterhead,1864,2,24,4,8,82,38,44,76
Stirling,1864,3,16,7,13,63,54,9,55
Stenhousem'r,1864,4,15,9,12,58,49,9,54
Clyde,1864,5,15,9,12,54,49,5,54
Elgin,1864,6,14,6,16,55,65,-10,48
Annan Athlet,1864,7,11,11,14,47,46,1,44
Berwick,1864,8,8,10,18,30,61,-31,34
Edinburgh Ci,1864,9,7,9,20,36,65,-29,30
Cowdenbeath,1864,10,5,10,21,28,54,-26,25
Peterhead,1865,1,24,4,8,80,39,41,76
Montrose,1865,2,23,7,6,59,35,24,76
Stirling,1865,3,16,7,13,61,52,9,55
Stenhousem'r,1865,4,15,9,12,56,47,9,54
Clyde,1865,5,15,9,12,54,48,6,54
Elgin,1865,6,15,6,15,54,60,-6,51
Annan Athlet,1865,7,11,11,14,47,42,5,44
Berwick,1865,8,8,10,18,29,61,-32,34
Edinburgh Ci,1865,9,7,9,20,37,63,-26,30
Cowdenbeath,1865,10,5,10,21,24,54,-30,25
Montrose,1866,1,24,7,5,63,35,28,79
Peterhead,1866,2,24,4,8,80,40,40,76
Stenhousem'r,1866,3,16,8,12,60,47,13,56
Stirling,1866,4,16,6,14,61,56,5,54
Clyde,1866,5,15,9,12,52,48,4,54
Elgin,1866,6,14,6,16,54,64,-10,48
Annan Athlet,1866,7,11,11,14,47,42,5,44
Berwick,1866,8,8,10,18,29,59,-30,34
Edinburgh Ci,1866,9,7,9,20,38,63,-25,30
Cowdenbeath,1866,10,5,10,21,24,54,-30,25
Montrose,1867,1,23,8,5,60,35,25,77
Peterhead,1867,2,24,4,8,82,39,43,76
Stenhousem'r,1867,3,16,8,12,59,48,11,56
Stirling,1867,4,16,6,14,62,55,7,54
Clyde,1867,5,14,10,12,52,49,3,52
Elgin,1867,6,14,7,15,54,61,-7,49
Annan Athlet,1867,7,12,11,13,48,41,7,47
Berwick,1867,8,8,11,17,30,59,-29,35
Edinburgh Ci,1867,9,7,9,20,37,65,-28,30
Cowdenbeath,1867,10,4,10,22,23,55,-32,22
Peterhead,1868,1,24,4,8,80,40,40,76
Montrose,1868,2,23,7,6,59,35,24,76
Stenhousem'r,1868,3,16,8,12,57,46,11,56
Stirling,1868,4,16,6,14,60,53,7,54
Clyde,1868,5,14,9,13,51,49,2,51
Elgin,1868,6,15,6,15,54,60,-6,51
Annan Athlet,1868,7,11,12,13,48,42,6,45
Berwick,1868,8,9,10,17,30,58,-28,37
Edinburgh Ci,1868,9,7,9,20,38,63,-25,30
Cowdenbeath,1868,10,4,11,21,24,55,-31,23
Montrose,1869,1,24,7,5,62,35,27,79
Peterhead,1869,2,24,4,8,81,41,40,76
Stirling,1869,3,17,6,13,63,51,12,57
Clyde,1869,4,15,9,12,52,48,4,54
Stenhousem'r,1869,5,15,8,13,55,49,6,53
Elgin,1869,6,14,6,16,54,63,-9,48
Annan Athlet,1869,7,11,12,13,48,42,6,45
Berwick,1869,8,8,10,18,29,59,-30,34
Edinburgh Ci,1869,9,7,9,20,39,64,-25,30
Cowdenbeath,1869,10,4,11,21,24,55,-31,23
Montrose,1870,1,24,7,5,60,34,26,79
Peterhead,1870,2,24,4,8,79,39,40,76
Stirling,1870,3,17,6,13,63,53,10,57
Stenhousem'r,1870,4,15,8,13,57,49,8,53
Clyde,1870,5,14,10,12,53,50,3,52
Elgin,1870,6,14,6,16,53,61,-8,48
Annan Athlet,1870,7,11,11,14,47,42,5,44
Berwick,1870,8,8,11,17,31,60,-29,35
Edinburgh Ci,1870,9,7,9,20,37,62,-25,30
Cowdenbeath,1870,10,5,10,21,24,54,-30,25
Montrose,1871,1,24,7,5,61,34,27,79
Peterhead,1871,2,24,4,8,81,39,42,76
Stenhousem'r,1871,3,16,8,12,56,46,10,56
Stirling,1871,4,16,6,14,60,52,8,54
Clyde,1871,5,14,10,12,52,49,3,52
Elgin,1871,6,14,6,16,53,62,-9,48
Annan Athlet,1871,7,11,12,13,50,44,6,45
Berwick,1871,8,8,11,17,30,59,-29,35
Edinburgh Ci,1871,9,7,9,20,37,64,-27,30
Cowdenbeath,1871,10,4,11,21,26,57,-31,23
Montrose,1872,1,24,7,5,62,34,28,79
Peterhead,1872,2,23,5,8,79,40,39,74
Stirling,1872,3,16,7,13,62,53,9,55
Stenhousem'r,1872,4,15,9,12,57,48,9,54
Clyde,1872,5,15,9,12,52,48,4,54
Elgin,1872,6,14,6,16,53,63,-10,48
Annan Athlet,1872,7,11,11,14,47,44,3,44
Berwick,1872,8,8,10,18,29,59,-30,34
Edinburgh Ci,1872,9,7,10,19,38,62,-24,31
Cowdenbeath,1872,10,5,10,21,26,54,-28,25
Peterhead,1873,1,24,4,8,79,38,41,76
Montrose,1873,2,23,7,6,60,36,24,76
Stirling,1873,3,17,6,13,63,53,10,57
Clyde,1873,4,15,9,12,54,48,6,54
Stenhousem'r,1873,5,15,8,13,57,49,8,53
Elgin,1873,6,15,6,15,55,61,-6,51
Annan Athlet,1873,7,11,12,13,47,41,6,45
Berwick,1873,8,8,10,18,29,61,-32,34
Edinburgh Ci,1873,9,7,9,20,36,62,-26,30
Cowdenbeath,1873,10,4,11,21,23,54,-31,23
Montrose,1874,1,24,7,5,63,35,28,79
Peterhead,1874,2,23,5,8,79,40,39,74
Stirling,1874,3,16,7,13,61,52,9,55
Stenhousem'r,1874,4,15,9,12,56,47,9,54
Clyde,1874,5,14,10,12,52,49,3,52
Elgin,1874,6,14,6,16,54,64,-10,48
Annan Athlet,1874,7,11,12,13,47,41,6,45
Berwick,1874,8,8,11,17,30,59,-29,35
Edinburgh Ci,1874,9,7,10,19,38,62,-24,31
Cowdenbeath,1874,10,4,11,21,23,54,-31,23
Montrose,1875,1,24,7,5,62,34,28,79
Peterhead,1875,2,24,4,8,79,38,41,76
Stenhousem'r,1875,3,16,8,12,58,48,10,56
Stirling,1875,4,16,6,14,62,54,8,54
Clyde,1875,5,14,9,13,51,49,2,51
Elgin,1875,6,14,6,16,53,63,-10,48
Annan Athlet,1875,7,11,11,14,48,43,5,44
Berwick,1875,8,9,10,17,30,58,-28,37
Edinburgh Ci,1875,9,7,9,20,36,62,-26,30
Cowdenbeath,1875,10,5,10,21,25,55,-30,25
Montrose,1876,1,23,8,5,59,34,25,77
Peterhead,1876,2,24,4,8,83,41,42,76
Stirling,1876,3,16,7,13,60,51,9,55
Stenhousem'r,1876,4,15,9,12,55,46,9,54
Clyde,1876,5,15,9,12,53,49,4,54
Elgin,1876,6,14,7,15,53,60,-7,49
Annan Athlet,1876,7,12,11,13,49,42,7,47
Berwick,1876,8,8,10,18,30,60,-30,34
Edinburgh Ci,1876,9,7,9,20,39,66,-27,30
Cowdenbeath,1876,10,4,10,22,24,56,-32,22
Peterhead,1877,1,24,4,8,79,39,40,76
Montrose,1877,2,23,7,6,60,36,24,76
Stirling,1877,3,16,7,13,61,52,9,55
Stenhousem'r,1877,4,15,9,12,56,47,9,54
Clyde,1877,5,14,9,13,53,51,2,51
Elgin,1877,6,15,6,15,55,61,-6,51
Annan Athlet,1877,7,11,11,14,48,43,5,44
Berwick,1877,8,9,10,17,32,60,-28,37
Edinburgh Ci,1877,9,7,9,20,37,62,-25,30
Cowdenbeath,1877,10,5,10,21,25,55,-30,25
Montrose,1878,1,23,8,5,60,35,25,77
Peterhead,1878,2,24,4,8,78,38,40,76
Stenhousem'r,1878,3,16,8,12,57,46,11,56
Stirling,1878,4,16,6,14,60,53,7,54
Clyde,1878,5,15,9,12,52,48,4,54
Elgin,1878,6,14,7,15,54,61,-7,49
Annan Athlet,1878,7,11,11,14,47,42,5,44
Berwick,1878,8,8,10,18,29,59,-30,34
Edinburgh Ci,1878,9,7,9,20,36,61,-25,30
Cowdenbeath,1878,10,5,10,21,24,54,-30,25
Montrose,1879,1,24,7,5,61,35,26,79
Peterhead,1879,2,23,4,9,77,40,37,73
Stirling,1879,3,16,7,13,60,51,9,55
Stenhousem'r,1879,4,15,9,12,55,46,9,54
Clyde,1879,5,15,9,12,53,49,4,54
Elgin,1879,6,14,6,16,54,62,-8,48
Annan Athlet,1879,7,12,11,13,49,41,8,47
Berwick,1879,8,8,10,18,30,60,-30,34
Edinburgh Ci,1879,9,8,9,19,38,60,-22,33
Cowdenbeath,1879,10,4,10,22,23,56,-33,22
Montrose,1880,1,23,8,5,60,35,25,77
Peterhead,1880,2,24,4,8,80,40,40,76
Stirling,1880,3,17,6,13,63,53,10,57
Stenhousem'r,1880,4,15,8,13,57,49,8,53
Clyde,1880,5,14,10,12,52,49,3,52
Elgin,1880,6,14,7,15,54,61,-7,49
Annan Athlet,1880,7,12,11,13,48,41,7,47
Berwick,1880,8,8,11,17,30,59,-29,35
Edinburgh Ci,1880,9,7,9,20,38,63,-25,30
Cowdenbeath,1880,10,4,10,22,23,55,-32,22
Montrose,1881,1,23,8,5,61,36,25,77
Peterhead,1881,2,23,4,9,77,39,38,73
Stirling,1881,3,16,7,13,61,52,9,55
Stenhousem'r,1881,4,15,9,12,56,47,9,54
Clyde,1881,5,15,9,12,53,49,4,54
Elgin,1881,6,14,7,15,55,62,-7,49
Annan Athlet,1881,7,11,12,13,48,42,6,45
Berwick,1881,8,8,10,18,30,60,-30,34
Edinburgh Ci,1881,9,8,9,19,37,60,-23,33
Cowdenbeath,1881,10,4,11,21,24,55,-31,23
Montrose,1882,1,24,7,5,60,34,26,79
Peterhead,1882,2,24,4,8,78,38,40,76
Stirling,1882,3,17,6,13,62,52,10,57
Clyde,1882,4,15,9,12,53,48,5,54
Stenhousem'r,1882,5,15,8,13,56,48,8,53
Elgin,1882,6,14,6,16,53,61,-8,48
Annan Athlet,1882,7,11,12,13,48,42,6,45
Berwick,1882,8,8,10,18,29,60,-31,34
Edinburgh Ci,1882,9,7,9,20,36,61,-25,30
Cowdenbeath,1882,10,4,11,21,24,55,-31,23
Montrose,1883,1,24,7,5,63,35,28,79
Peterhead,1883,2,24,4,8,80,38,42,76
Stenhousem'r,1883,3,16,8,12,57,47,10,56
Stirling,1883,4,16,6,14,61,53,8,54
Clyde,1883,5,15,9,12,53,49,4,54
Elgin,1883,6,14,6,16,54,64,-10,48
Annan Athlet,1883,7,11,12,13,48,42,6,45
Berwick,1883,8,8,10,18,30,60,-30,34
Edinburgh Ci,1883,9,7,9,20,36,63,-27,30
Cowdenbeath,1883,10,4,11,21,24,55,-31,23
Montrose,1884,1,23,8,5,60,35,25,77
Peterhead,1884,2,23,4,9,79,41,38,73
Stirling,1884,3,17,6,13,63,52,11,57
Clyde,1884,4,15,9,12,52,48,4,54
Stenhousem'r,1884,5,15,8,13,56,49,7,53
Elgin,1884,6,14,7,15,54,61,-7,49
Annan Athlet,1884,7,11,12,13,48,42,6,45
Berwick,1884,8,8,10,18,29,59,-30,34
Edinburgh Ci,1884,9,8,9,19,39,62,-23,33
Cowdenbeath,1884,10,4,11,21,24,55,-31,23
Montrose,1885,1,24,7,5,61,34,27,79
Peterhead,1885,2,23,4,9,77,39,38,73
Stirling,1885,3,16,7,13,62,53,9,55
Stenhousem'r,1885,4,15,9,12,57,48,9,54
Clyde,1885,5,14,9,13,51,49,2,51
Elgin,1885,6,14,6,16,53,62,-9,48
Annan Athlet,1885,7,12,11,13,48,41,7,47
Berwick,1885,8,9,10,17,30,58,-28,37
Edinburgh Ci,1885,9,8,9,19,37,60,-23,33
Cowdenbeath,1885,10,4,10,22,23,55,-32,22
Peterhead,1886,1,24,4,8,80,38,42,76
Montrose,1886,2,23,7,6,61,37,24,76
Stenhousem'r,1886,3,16,8,12,57,46,11,56
Stirling,1886,4,16,6,14,60,53,7,54
Clyde,1886,5,15,9,12,54,48,6,54
Elgin,1886,6,15,6,15,56,62,-6,51
Annan Athlet,1886,7,12,11,13,48,41,7,47
Berwick,1886,8,8,10,18,29,61,-32,34
Edinburgh Ci,1886,9,7,9,20,36,63,-27,30
Cowdenbeath,1886,10,4,10,22,23,55,-32,22
Montrose,1887,1,24,7,5,60,34,26,79
Peterhead,1887,2,24,4,8,81,39,42,76
Stirling,1887,3,17,6,13,63,53,10,57
Clyde,1887,4,15,9,12,53,48,5,54
Stenhousem'r,1887,5,15,8,13,57,49,8,53
Elgin,1887,6,14,6,16,53,61,-8,48
Annan Athlet,1887,7,12,11,13,48,41,7,47
Berwick,1887,8,8,10,18,29,60,-31,34
Edinburgh Ci,1887,9,7,9,20,37,64,-27,30
Cowdenbeath,1887,10,4,10,22,23,55,-32,22
Montrose,1888,1,24,7,5,63,36,27,79
Peterhead,1888,2,24,4,8,81,38,43,76
Stirling,1888,3,16,7,13,60,51,9,55
Stenhousem'r,1888,4,15,9,12,55,46,9,54
Clyde,1888,5,14,10,12,52,49,3,52
Elgin,1888,6,14,6,16,55,64,-9,48
Annan Athlet,1888,7,12,11,13,48,41,7,47
Berwick,1888,8,8,11,17,30,59,-29,35
Edinburgh Ci,1888,9,7,9,20,36,64,-28,30
Cowdenbeath,1888,10,4,10,22,23,55,-32,22
Montrose,1889,1,24,7,5,60,34,26,79
Peterhead,1889,2,24,4,8,78,38,40,76
Stirling,1889,3,17,6,13,62,52,10,57
Clyde,1889,4,15,9,12,53,49,4,54
Stenhousem'r,1889,5,15,8,13,56,48,8,53
Elgin,1889,6,14,6,16,53,61,-8,48
Annan Athlet,1889,7,11,11,14,47,42,5,44
Berwick,1889,8,8,10,18,30,60,-30,34
Edinburgh Ci,1889,9,7,9,20,36,61,-25,30
Cowdenbeath,1889,10,5,10,21,24,54,-30,25
Montrose,1890,1,24,7,5,61,34,27,79
Peterhead,1890,2,24,4,8,84,39,45,76
Stirling,1890,3,16,7,13,63,54,9,55
Stenhousem'r,1890,4,15,9,12,58,49,9,54
Clyde,1890,5,14,9,13,51,49,2,51
Elgin,1890,6,14,6,16,53,62,-9,48
Annan Athlet,1890,7,11,12,13,47,41,6,45
Berwick,1890,8,9,10,17,30,58,-28,37
Edinburgh Ci,1890,9,7,9,20,37,67,-30,30
Cowdenbeath,1890,10,4,11,21,23,54,-31,23
Montrose,1891,1,23,7,6,60,38,22,76
Peterhead,1891,2,23,5,8,79,40,39,74
Stirling,1891,3,16,7,13,63,54,9,55
Stenhousem'r,1891,4,15,9,12,58,49,9,54
Clyde,1891,5,14,10,12,52,49,3,52
Elgin,1891,6,15,6,15,57,61,-4,51
Annan Athlet,1891,7,11,11,14,47,42,5,44
Berwick,1891,8,8,11,17,30,59,-29,35
Edinburgh Ci,1891,9,7,10,19,38,62,-24,31
Cowdenbeath,1891,10,5,10,21,24,54,-30,25
Montrose,1892,1,23,8,5,61,36,25,77
Peterhead,1892,2,23,4,9,77,40,37,73
Stenhousem'r,1892,3,16,8,12,57,46,11,56
Stirling,1892,4,16,6,14,60,53,7,54
Clyde,1892,5,15,9,12,55,50,5,54
Elgin,1892,6,14,7,15,55,62,-7,49
Annan Athlet,1892,7,12,11,13,49,41,8,47
Berwick,1892,8,8,10,18,31,62,-31,34
Edinburgh Ci,1892,9,8,9,19,38,60,-22,33
Cowdenbeath,1892,10,4,10,22,23,56,-33,22
Peterhead,1893,1,24,4,8,81,38,43,76
Montrose,1893,2,23,7,6,61,37,24,76
Stirling,1893,3,17,6,13,63,52,11,57
Stenhousem'r,1893,4,15,8,13,56,49,7,53
Clyde,1893,5,14,9,13,51,49,2,51
Elgin,1893,6,15,6,15,56,62,-6,51
Annan Athlet,1893,7,11,12,13,48,42,6,45
Berwick,1893,8,9,10,17,30,58,-28,37
Edinburgh Ci,1893,9,7,9,20,36,64,-28,30
Cowdenbeath,1893,10,4,11,21,24,55,-31,23
Montrose,1894,1,23,8,5,59,34,25,77
Peterhead,1894,2,24,4,8,80,39,41,76
Stirling,1894,3,17,6,13,64,51,13,57
Clyde,1894,4,15,9,12,55,48,7,54
Stenhousem'r,1894,5,15,8,13,55,50,5,53
Elgin,1894,6,14,7,15,53,60,-7,49
Annan Athlet,1894,7,11,11,14,48,43,5,44
Berwick,1894,8,8,10,18,29,62,-33,34
Edinburgh Ci,1894,9,7,9,20,37,63,-26,30
Cowdenbeath,1894,10,5,10,21,25,55,-30,25
Montrose,1895,1,23,8,5,60,35,25,77
Peterhead,1895,2,24,4,8,80,38,42,76
Stirling,1895,3,17,6,13,63,52,11,57
Clyde,1895,4,15,9,12,54,48,6,54
Stenhousem'r,1895,5,15,8,13,56,49,7,53
Elgin,1895,6,14,7,15,54,61,-7,49
Annan Athlet,1895,7,12,11,13,49,41,8,47
Berwick,1895,8,8,10,18,29,61,-32,34
Edinburgh Ci,1895,9,7,9,20,36,63,-27,30
Cowdenbeath,1895,10,4,10,22,23,56,-33,22
Montrose,1896,1,23,7,6,59,35,24,76
Peterhead,1896,2,23,5,8,78,39,39,74
Stirling,1896,3,16,7,13,60,51,9,55
Stenhousem'r,1896,4,15,9,12,55,46,9,54
Clyde,1896,5,14,9,13,53,52,1,51
Elgin,1896,6,15,6,15,54,60,-6,51
Annan Athlet,1896,7,11,11,14,48,44,4,44
Berwick,1896,8,9,10,17,33,60,-27,37
Edinburgh Ci,1896,9,7,10,19,37,61,-24,31
Cowdenbeath,1896,10,5,10,21,26,55,-29,25
Peterhead,1897,1,24,4,8,81,39,42,76
Montrose,1897,2,23,7,6,59,35,24,76
Stirling,1897,3,17,6,13,63,53,10,57
Stenhousem'r,1897,4,15,8,13,57,49,8,53
Clyde,1897,5,14,9,13,51,51,0,51
Elgin,1897,6,15,6,15,54,60,-6,51
Annan Athlet,1897,7,11,12,13,48,42,6,45
Berwick,1897,8,9,10,17,32,58,-26,37
Edinburgh Ci,1897,9,7,9,20,37,64,-27,30
Cowdenbeath,1897,10,4,11,21,24,55,-31,23
Montrose,1898,1,23,7,6,60,36,24,76
Peterhead,1898,2,23,5,8,77,38,39,74
Stirling,1898,3,17,6,13,62,52,10,57
Clyde,1898,4,15,9,12,54,50,4,54
Stenhousem'r,1898,5,15,8,13,56,48,8,53
Elgin,1898,6,15,6,15,55,61,-6,51
Annan Athlet,1898,7,11,11,14,48,44,4,44
Berwick,1898,8,8,10,18,31,61,-30,34
Edinburgh Ci,1898,9,7,10,19,36,60,-24,31
Cowdenbeath,1898,10,5,10,21,26,55,-29,25
Peterhead,1899,1,24,4,8,80,40,40,76
Montrose,1899,2,23,7,6,59,35,24,76
Stirling,1899,3,17,6,13,63,52,11,57
Clyde,1899,4,15,9,12,52,48,4,54
Stenhousem'r,1899,5,15,8,13,56,49,7,53
Elgin,1899,6,15,6,15,54,60,-6,51
Annan Athlet,1899,7,12,11,13,49,42,7,47
Berwick,1899,8,8,10,18,29,59,-30,34
Edinburgh Ci,1899,9,7,9,20,38,63,-25,30
Cowdenbeath,1899,10,4,10,22,24,56,-32,22
Montrose,1900,1,24,7,5,61,35,26,79
Peterhead,1900,2,23,4,9,78,40,38,73
Stenhousem'r,1900,3,16,8,12,56,46,10,56
Stirling,1900,4,16,6,14,60,52,8,54
Clyde,1900,5,14,10,12,52,49,3,52
Elgin,1900,6,14,6,16,54,62,-8,48
Annan Athlet,1900,7,11,12,13,47,41,6,45
Berwick,1900,8,8,11,17,30,59,-29,35
Edinburgh Ci,1900,9,8,9,19,38,61,-23,33
Cowdenbeath,1900,10,4,11,21,23,54,-31,23
Montrose,1901,1,24,7,5,63,35,28,79
Peterhead,1901,2,24,4,8,85,40,45,76
Stenhousem'r,1901,3,16,8,12,60,46,14,56
Stirling,1901,4,16,6,14,60,56,4,54
Clyde,1901,5,15,9,12,53,49,4,54
Elgin,1901,6,14,6,16,54,64,-10,48
Annan Athlet,1901,7,11,12,13,48,42,6,45
Berwick,1901,8,8,10,18,30,60,-30,34
Edinburgh Ci,1901,9,7,9,20,38,68,-30,30
Cowdenbeath,1901,10,4,11,21,24,55,-31,23
Montrose,1902,1,23,8,5,60,35,25,77
Peterhead,1902,2,23,5,8,78,39,39,74
Stirling,1902,3,17,6,13,64,51,13,57
Clyde,1902,4,15,9,12,53,49,4,54
Stenhousem'r,1902,5,15,8,13,55,50,5,53
Elgin,1902,6,14,7,15,54,61,-7,49
Annan Athlet,1902,7,11,12,13,49,43,6,45
Berwick,1902,8,8,10,18,30,60,-30,34
Edinburgh Ci,1902,9,7,10,19,37,61,-24,31
Cowdenbeath,1902,10,4,11,21,25,56,-31,23
Montrose,1903,1,24,7,5,61,35,26,79
Peterhead,1903,2,24,4,8,79,39,40,76
Stenhousem'r,1903,3,16,8,12,56,46,10,56
Stirling,1903,4,16,6,14,60,52,8,54
Clyde,1903,5,15,9,12,52,48,4,54
Elgin,1903,6,14,6,16,54,62,-8,48
Annan Athlet,1903,7,11,11,14,48,44,4,44
Berwick,1903,8,8,10,18,29,59,-30,34
Edinburgh Ci,1903,9,7,9,20,37,62,-25,30
Cowdenbeath,1903,10,5,10,21,26,55,-29,25
Montrose,1904,1,23,8,5,59,34,25,77
Peterhead,1904,2,23,5,8,78,39,39,74
Stirling,1904,3,17,6,13,64,53,11,57
Clyde,1904,4,15,9,12,54,48,6,54
Stenhousem'r,1904,5,15,8,13,57,50,7,53
Elgin,1904,6,14,7,15,53,60,-7,49
Annan Athlet,1904,7,11,12,13,49,43,6,45
Berwick,1904,8,8,10,18,29,61,-32,34
Edinburgh Ci,1904,9,7,10,19,37,61,-24,31
Cowdenbeath,1904,10,4,11,21,25,56,-31,23
Montrose,1905,1,24,7,5,62,36,26,79
Peterhead,1905,2,23,5,8,78,39,39,74
Stirling,1905,3,17,6,13,62,52,10,57
Stenhousem'r,1905,4,15,8,13,56,48,8,53
Clyde,1905,5,14,9,13,53,51,2,51
Elgin,1905,6,14,6,16,55,63,-8,48
Annan Athlet,1905,7,12,11,13,49,42,7,47
Berwick,1905,8,9,10,17,32,60,-28,37
Edinburgh Ci,1905,9,7,10,19,37,61,-24,31
Cowdenbeath,1905,10,4,10,22,24,56,-32,22
Montrose,1906,1,23,8,5,60,35,25,77
Peterhead,1906,2,23,4,9,79,41,38,73
Stirling,1906,3,17,6,13,64,53,11,57
Clyde,1906,4,15,9,12,54,49,5,54
Stenhousem'r,1906,5,15,8,13,57,50,7,53
Elgin,1906,6,14,7,15,54,61,-7,49
Annan Athlet,1906,7,11,12,13,49,43,6,45
Berwick,1906,8,8,10,18,30,61,-31,34
Edinburgh Ci,1906,9,8,9,19,39,62,-23,33
Cowdenbeath,1906,10,4,11,21,25,56,-31,23
Montrose,1907,1,23,8,5,59,34,25,77
Peterhead,1907,2,24,4,8,79,38,41,76
Stirling,1907,3,17,6,13,62,51,11,57
Stenhousem'r,1907,4,15,8,13,55,48,7,53
Clyde,1907,5,14,9,13,51,49,2,51
Elgin,1907,6,14,7,15,53,60,-7,49
Annan Athlet,1907,7,12,11,13,48,41,7,47
Berwick,1907,8,9,10,17,30,58,-28,37
Edinburgh Ci,1907,9,7,9,20,36,62,-26,30
Cowdenbeath,1907,10,4,10,22,23,55,-32,22
Montrose,1908,1,23,7,6,59,35,24,76
Peterhead,1908,2,23,4,9,78,40,38,73
Stirling,1908,3,17,6,13,62,52,10,57
Clyde,1908,4,15,9,12,54,48,6,54
Stenhousem'r,1908,5,15,8,13,56,48,8,53
Elgin,1908,6,15,6,15,54,60,-6,51
Annan Athlet,1908,7,12,11,13,50,43,7,47
Berwick,1908,8,8,10,18,29,61,-32,34
Edinburgh Ci,1908,9,8,9,19,38,61,-23,33
Cowdenbeath,1908,10,4,10,22,25,57,-32,22
Montrose,1909,1,23,7,6,60,37,23,76
Peterhead,1909,2,23,4,9,78,40,38,73
Stirling,1909,3,17,6,13,62,51,11,57
Clyde,1909,4,15,9,12,53,48,5,54
Stenhousem'r,1909,5,15,8,13,55,48,7,53
Elgin,1909,6,15,6,15,56,61,-5,51
Annan Athlet,1909,7,11,11,14,47,43,4,44
Berwick,1909,8,8,10,18,29,60,-31,34
Edinburgh Ci,1909,9,8,9,19,38,61,-23,33
Cowdenbeath,1909,10,5,10,21,25,54,-29,25
Montrose,1910,1,24,7,5,64,34,30,79
Peterhead,1910,2,24,4,8,80,38,42,76
Stirling,1910,3,17,6,13,62,51,11,57
Clyde,1910,4,15,9,12,58,48,10,54
Stenhousem'r,1910,5,15,8,13,55,48,7,53
Elgin,1910,6,14,6,16,53,65,-12,48
Annan Athlet,1910,7,11,12,13,48,42,6,45
Berwick,1910,8,8,10,18,29,65,-36,34
Edinburgh Ci,1910,9,7,9,20,36,63,-27,30
Cowdenbeath,1910,10,4,11,21,24,55,-31,23
Montrose,1911,1,24,7,5,63,34,29,79
Peterhead,1911,2,24,4,8,80,38,42,76
Stirling,1911,3,17,6,13,63,53,10,57
Clyde,1911,4,15,9,12,53,48,5,54
Stenhousem'r,1911,5,15,8,13,57,49,8,53
Elgin,1911,6,14,6,16,53,64,-11,48
Annan Athlet,1911,7,11,12,13,47,41,6,45
Berwick,1911,8,8,10,18,29,60,-31,34
Edinburgh Ci,1911,9,7,9,20,36,63,-27,30
Cowdenbeath,1911,10,4,11,21,23,54,-31,23
Montrose,1912,1,24,7,5,64,34,30,79
Peterhead,1912,2,24,4,8,81,38,43,76
Stenhousem'r,1912,3,16,8,12,59,49,10,56
Stirling,1912,4,16,6,14,63,55,8,54
Clyde,1912,5,14,9,13,51,49,2,51
Elgin,1912,6,14,6,16,53,65,-12,48
Annan Athlet,1912,7,12,11,13,48,41,7,47
Berwick,1912,8,9,10,17,30,58,-28,37
Edinburgh Ci,1912,9,7,9,20,36,64,-28,30
Cowdenbeath,1912,10,4,10,22,23,55,-32,22
Montrose,1913,1,24,7,5,60,34,26,79
Peterhead,1913,2,23,4,9,77,39,38,73
Stenhousem'r,1913,3,16,8,12,56,46,10,56
Stirling,1913,4,16,6,14,60,52,8,54
Clyde,1913,5,14,9,13,52,50,2,51
Elgin,1913,6,14,6,16,53,61,-8,48
Annan Athlet,1913,7,11,12,13,47,41,6,45
Berwick,1913,8,9,10,17,31,59,-28,37
Edinburgh Ci,1913,9,8,9,19,37,60,-23,33
Cowdenbeath,1913,10,4,11,21,23,54,-31,23
Peterhead,1914,1,24,4,8,81,38,43,76
Montrose,1914,2,23,7,6,60,37,23,76
Stirling,1914,3,17,6,13,62,52,10,57
Clyde,1914,4,15,9,12,54,48,6,54
Stenhousem'r,1914,5,15,8,13,56,48,8,53
Elgin,1914,6,15,6,15,56,61,-5,51
Annan Athlet,1914,7,11,11,14,48,43,5,44
Berwick,1914,8,8,10,18,29,61,-32,34
Edinburgh Ci,1914,9,7,9,20,36,64,-28,30
Cowdenbeath,1914,10,5,10,21,25,55,-30,25
Montrose,1915,1,24,7,5,62,34,28,79
Peterhead,1915,2,23,5,8,78,39,39,74
Stirling,1915,3,17,6,13,61,51,10,57
Clyde,1915,4,15,9,12,53,49,4,54
Stenhousem'r,1915,5,15,8,13,55,47,8,53
Elgin,1915,6,14,6,16,53,63,-10,48
Annan Athlet,1915,7,12,11,13,50,41,9,47
Berwick,1915,8,8,10,18,30,60,-30,34
Edinburgh Ci,1915,9,7,10,19,37,61,-24,31
Cowdenbeath,1915,10,4,10,22,23,57,-34,22
Montrose,1916,1,24,7,5,61,35,26,79
Peterhead,1916,2,24,4,8,80,39,41,76
Stirling,1916,3,17,6,13,61,51,10,57
Clyde,1916,4,15,9,12,54,50,4,54
Stenhousem'r,1916,5,15,8,13,55,47,8,53
Elgin,1916,6,14,6,16,54,62,-8,48
Annan Athlet,1916,7,12,11,13,49,42,7,47
Berwick,1916,8,8,10,18,31,61,-30,34
Edinburgh Ci,1916,9,7,9,20,37,63,-26,30
Cowdenbeath,1916,10,4,10,22,24,56,-32,22
Peterhead,1917,1,24,4,8,80,39,41,76
Montrose,1917,2,23,7,6,59,36,23,76
Stirling,1917,3,17,6,13,64,52,12,57
Stenhousem'r,1917,4,15,8,13,56,50,6,53
Clyde,1917,5,14,9,13,53,52,1,51
Elgin,1917,6,15,6,15,55,60,-5,51
Annan Athlet,1917,7,11,12,13,47,41,6,45
Berwick,1917,8,9,10,17,33,60,-27,37
Edinburgh Ci,1917,9,7,9,20,37,63,-26,30
Cowdenbeath,1917,10,4,11,21,23,54,-31,23
Montrose,1918,1,24,7,5,62,35,27,79
Peterhead,1918,2,23,4,9,78,40,38,73
Stenhousem'r,1918,3,16,8,12,58,47,11,56
Stirling,1918,4,16,6,14,61,54,7,54
Clyde,1918,5,15,9,12,54,50,4,54
Elgin,1918,6,14,6,16,54,63,-9,48
Annan Athlet,1918,7,11,12,13,48,42,6,45
Berwick,1918,8,8,10,18,31,61,-30,34
Edinburgh Ci,1918,9,8,9,19,38,61,-23,33
Cowdenbeath,1918,10,4,11,21,24,55,-31,23
Montrose,1919,1,24,7,5,61,35,26,79
Peterhead,1919,2,24,4,8,80,39,41,76
Stirling,1919,3,17,6,13,61,51,10,57
Stenhousem'r,1919,4,15,8,13,55,47,8,53
Clyde,1919,5,14,10,12,52,49,3,52
Elgin,1919,6,14,6,16,54,62,-8,48
Annan Athlet,1919,7,12,11,13,49,41,8,47
Berwick,1919,8,8,11,17,30,59,-29,35
Edinburgh Ci,1919,9,7,9,20,37,63,-26,30
Cowdenbeath,1919,10,4,10,22,23,56,-33,22
Montrose,1920,1,23,8,5,59,34,25,77
Peterhead,1920,2,24,4,8,79,38,41,76
Stirling,1920,3,17,6,13,62,52,10,57
Clyde,1920,4,15,9,12,53,49,4,54
Stenhousem'r,1920,5,15,8,13,56,48,8,53
Elgin,1920,6,14,7,15,53,60,-7,49
Annan Athlet,1920,7,11,12,13,47,41,6,45
Berwick,1920,8,8,10,18,30,60,-30,34
Edinburgh Ci,1920,9,7,9,20,36,62,-26,30
Cowdenbeath,1920,10,4,11,21,23,54,-31,23
Montrose,1921,1,23,8,5,62,37,25,77
Peterhead,1921,2,24,4,8,79,38,41,76
Stirling,1921,3,17,6,13,63,53,10,57
Stenhousem'r,1921,4,15,8,13,57,49,8,53
Clyde,1921,5,14,9,13,51,51,0,51
Elgin,1921,6,14,7,15,56,63,-7,49
Annan Athlet,1921,7,12,11,13,48,41,7,47
Berwick,1921,8,9,10,17,32,58,-26,37
Edinburgh Ci,1921,9,7,9,20,36,62,-26,30
Cowdenbeath,1921,10,4,10,22,23,55,-32,22
Montrose,1922,1,24,7,5,62,35,27,79
Peterhead,1922,2,24,4,8,80,39,41,76
Stirling,1922,3,17,6,13,62,52,10,57
Clyde,1922,4,15,9,12,54,49,5,54
Stenhousem'r,1922,5,15,8,13,56,48,8,53
Elgin,1922,6,14,6,16,54,63,-9,48
Annan Athlet,1922,7,11,12,13,48,42,6,45
Berwick,1922,8,8,10,18,30,61,-31,34
Edinburgh Ci,1922,9,7,9,20,37,63,-26,30
Cowdenbeath,1922,10,4,11,21,24,55,-31,23
Montrose,1923,1,23,8,5,60,35,25,77
Peterhead,1923,2,24,4,8,84,39,45,76
Stirling,1923,3,16,7,13,61,52,9,55
Stenhousem'r,1923,4,15,9,12,56,47,9,54
Clyde,1923,5,15,9,12,52,48,4,54
Elgin,1923,6,14,7,15,54,61,-7,49
Annan Athlet,1923,7,12,11,13,50,41,9,47
Berwick,1923,8,8,10,18,29,59,-30,34
Edinburgh Ci,1923,9,7,9,20,37,67,-30,30
Cowdenbeath,1923,10,4,10,22,23,57,-34,22
Montrose,1924,1,23,8,5,61,36,25,77
Peterhead,1924,2,24,4,8,79,39,40,76
Stenhousem'r,1924,3,16,8,12,56,46,10,56
Stirling,1924,4,16,6,14,60,52,8,54
Clyde,1924,5,14,9,13,51,51,0,51
Elgin,1924,6,14,7,15,55,62,-7,49
Annan Athlet,1924,7,11,11,14,47,43,4,44
Berwick,1924,8,9,10,17,32,58,-26,37
Edinburgh Ci,1924,9,7,9,20,37,62,-25,30
Cowdenbeath,1924,10,5,10,21,25,54,-29,25
Peterhead,1925,1,24,4,8,80,38,42,76
Montrose,1925,2,23,7,6,60,37,23,76
Stirling,1925,3,17,6,13,62,52,10,57
Clyde,1925,4,15,9,12,53,49,4,54
Stenhousem'r,1925,5,15,8,13,56,48,8,53
Elgin,1925,6,15,6,15,56,61,-5,51
Annan Athlet,1925,7,11,12,13,47,41,6,45
Berwick,1925,8,8,10,18,30,60,-30,34
Edinburgh Ci,1925,9,7,9,20,36,63,-27,30
Cowdenbeath,1925,10,4,11,21,23,54,-31,23
Montrose,1926,1,24,7,5,69,34,35,79
Peterhead,1926,2,24,4,8,78,38,40,76
Stirling,1926,3,17,6,13,64,52,12,57
Clyde,1926,4,15,9,12,53,48,5,54
Stenhousem'r,1926,5,15,8,13,56,50,6,53
Elgin,1926,6,14,6,16,53,70,-17,48
Annan Athlet,1926,7,12,11,13,48,41,7,47
Berwick,1926,8,8,10,18,29,60,-31,34
Edinburgh Ci,1926,9,7,9,20,36,61,-25,30
Cowdenbeath,1926,10,4,10,22,23,55,-32,22
Montrose,1927,1,24,7,5,60,34,26,79
Peterhead,1927,2,23,5,8,79,40,39,74
Stirling,1927,3,17,6,13,62,51,11,57
Clyde,1927,4,15,9,12,55,51,4,54
Stenhousem'r,1927,5,15,8,13,55,48,7,53
Elgin,1927,6,14,6,16,53,61,-8,48
Annan Athlet,1927,7,12,11,13,50,43,7,47
Berwick,1927,8,8,10,18,32,62,-30,34
Edinburgh Ci,1927,9,7,10,19,38,62,-24,31
Cowdenbeath,1927,10,4,10,22,25,57,-32,22
Montrose,1928,1,23,8,5,59,34,25,77
Peterhead,1928,2,24,4,8,78,38,40,76
Stirling,1928,3,17,6,13,65,52,13,57
Stenhousem'r,1928,4,15,8,13,56,51,5,53
Clyde,1928,5,14,10,12,52,49,3,52
Elgin,1928,6,14,7,15,53,60,-7,49
Annan Athlet,1928,7,12,11,13,49,42,7,47
Berwick,1928,8,8,11,17,30,59,-29,35
Edinburgh Ci,1928,9,7,9,20,36,61,-25,30
Cowdenbeath,1928,10,4,10,22,24,56,-32,22
Montrose,1929,1,23,8,5,61,36,25,77
Peterhead,1929,2,24,4,8,81,38,43,76
Stenhousem'r,1929,3,16,8,12,56,46,10,56
Stirling,1929,4,16,6,14,60,52,8,54
Clyde,1929,5,15,9,12,52,48,4,54
Elgin,1929,6,14,7,15,55,62,-7,49
Annan Athlet,1929,7,11,12,13,47,41,6,45
Berwick,1929,8,8,10,18,29,59,-30,34
Edinburgh Ci,1929,9,7,9,20,36,64,-28,30
Cowdenbeath,1929,10,4,11,21,23,54,-31,23
Peterhead,1930,1,24,4,8,81,40,41,76
Montrose,1930,2,23,7,6,60,37,23,76
Stenhousem'r,1930,3,16,8,12,56,46,10,56
Stirling,1930,4,16,6,14,60,52,8,54
Clyde,1930,5,14,9,13,52,50,2,51
Elgin,1930,6,15,6,15,56,61,-5,51
Annan Athlet,1930,7,11,11,14,47,43,4,44
Berwick,1930,8,9,10,17,31,59,-28,37
Edinburgh Ci,1930,9,7,9,20,38,64,-26,30
Cowdenbeath,1930,10,5,10,21,25,54,-29,25
Montrose,1931,1,24,7,5,62,36,26,79
Peterhead,1931,2,24,4,8,78,38,40,76
Stirling,1931,3,17,6,13,63,51,12,57
Clyde,1931,4,15,9,12,54,48,6,54
Stenhousem'r,1931,5,15,8,13,55,49,6,53
Elgin,1931,6,14,6,16,55,63,-8,48
Annan Athlet,1931,7,11,12,13,47,41,6,45
Berwick,1931,8,8,10,18,29,61,-32,34
Edinburgh Ci,1931,9,7,9,20,36,61,-25,30
Cowdenbeath,1931,10,4,11,21,23,54,-31,23
Peterhead,1932,1,24,4,8,82,38,44,76
Montrose,1932,2,23,7,6,60,36,24,76
Stirling,1932,3,16,7,13,61,52,9,55
Stenhousem'r,1932,4,15,9,12,56,47,9,54
Clyde,1932,5,15,9,12,53,48,5,54
Elgin,1932,6,15,6,15,55,61,-6,51
Annan Athlet,1932,7,11,11,14,47,43,4,44
Berwick,1932,8,8,10,18,29,60,-31,34
Edinburgh Ci,1932,9,7,9,20,36,65,-29,30
Cowdenbeath,1932,10,5,10,21,25,54,-29,25
Montrose,1933,1,24,7,5,61,35,26,79
Peterhead,1933,2,24,4,8,79,39,40,76
Stirling,1933,3,16,7,13,60,51,9,55
Stenhousem'r,1933,4,15,9,12,55,46,9,54
Clyde,1933,5,14,9,13,53,53,0,51
Elgin,1933,6,14,6,16,54,62,-8,48
Annan Athlet,1933,7,12,11,13,49,42,7,47
Berwick,1933,8,9,10,17,34,60,-26,37
Edinburgh Ci,1933,9,7,9,20,37,62,-25,30
Cowdenbeath,1933,10,4,10,22,24,56,-32,22
Montrose,1934,1,23,7,6,60,36,24,76
Peterhead,1934,2,23,5,8,77,38,39,74
Stirling,1934,3,17,6,13,65,51,14,57
Clyde,1934,4,15,9,12,53,49,4,54
Stenhousem'r,1934,5,15,8,13,55,51,4,53
Elgin,1934,6,15,6,15,55,61,-6,51
Annan Athlet,1934,7,12,11,13,48,41,7,47
Berwick,1934,8,8,10,18,30,60,-30,34
Edinburgh Ci,1934,9,7,10,19,36,60,-24,31
Cowdenbeath,1934,10,4,10,22,23,55,-32,22
Montrose,1935,1,23,8,5,60,35,25,77
Peterhead,1935,2,23,4,9,78,40,38,73
Stirling,1935,3,17,6,13,66,51,15,57
Clyde,1935,4,15,9,12,53,49,4,54
Stenhousem'r,1935,5,15,8,13,55,52,3,53
Elgin,1935,6,14,7,15,54,61,-7,49
Annan Athlet,1935,7,11,11,14,47,42,5,44
Berwick,1935,8,8,10,18,30,60,-30,34
Edinburgh Ci,1935,9,8,9,19,38,61,-23,33
Cowdenbeath,1935,10,5,10,21,24,54,-30,25
Montrose,1936,1,24,7,5,60,34,26,79
Peterhead,1936,2,24,4,8,79,38,41,76
Stirling,1936,3,17,6,13,62,52,10,57
Clyde,1936,4,15,9,12,53,48,5,54
Stenhousem'r,1936,5,15,8,13,56,48,8,53
Elgin,1936,6,14,6,16,53,61,-8,48
Annan Athlet,1936,7,11,12,13,49,43,6,45
Berwick,1936,8,8,10,18,29,60,-31,34
Edinburgh Ci,1936,9,7,9,20,36,62,-26,30
Cowdenbeath,1936,10,4,11,21,25,56,-31,23
Montrose,1937,1,24,7,5,63,34,29,79
Peterhead,1937,2,24,4,8,81,40,41,76
Stirling,1937,3,17,6,13,63,53,10,57
Clyde,1937,4,15,9,12,52,48,4,54
Stenhousem'r,1937,5,15,8,13,57,49,8,53
Elgin,1937,6,14,6,16,53,64,-11,48
Annan Athlet,1937,7,12,11,13,48,41,7,47
Berwick,1937,8,8,10,18,29,59,-30,34
Edinburgh Ci,1937,9,7,9,20,38,64,-26,30
Cowdenbeath,1937,10,4,10,22,23,55,-32,22
Montrose,1938,1,24,7,5,61,34,27,79
Peterhead,1938,2,24,4,8,79,38,41,76
Stirling,1938,3,17,6,13,62,52,10,57
Stenhousem'r,1938,4,15,8,13,56,48,8,53
Clyde,1938,5,14,10,12,52,49,3,52
Elgin,1938,6,14,6,16,53,62,-9,48
Annan Athlet,1938,7,11,12,13,48,42,6,45
Berwick,1938,8,8,11,17,30,59,-29,35
Edinburgh Ci,1938,9,7,9,20,36,62,-26,30
Cowdenbeath,1938,10,4,11,21,24,55,-31,23
Montrose,1939,1,23,8,5,60,35,25,77
Peterhead,1939,2,24,4,8,81,39,42,76
Stirling,1939,3,17,6,13,64,52,12,57
Stenhousem'r,1939,4,15,8,13,56,50,6,53
Clyde,1939,5,14,9,13,51,52,-1,51
Elgin,1939,6,14,7,15,54,61,-7,49
Annan Athlet,1939,7,11,12,13,47,41,6,45
Berwick,1939,8,9,10,17,33,58,-25,37
Edinburgh Ci,1939,9,7,9,20,37,64,-27,30
Cowdenbeath,1939,10,4,11,21,23,54,-31,23
Montrose,1940,1,24,7,5,61,35,26,79
Peterhead,1940,2,23,5,8,78,39,39,74
Stirling,1940,3,17,6,13,62,52,10,57
Clyde,1940,4,15,9,12,55,48,7,54
Stenhousem'r,1940,5,15,8,13,56,48,8,53
Elgin,1940,6,14,6,16,54,62,-8,48
Annan Athlet,1940,7,12,11,13,48,41,7,47
Berwick,1940,8,8,10,18,29,62,-33,34
Edinburgh Ci,1940,9,7,10,19,37,61,-24,31
Cowdenbeath,1940,10,4,10,22,23,55,-32,22
Montrose,1941,1,24,7,5,61,34,27,79
Peterhead,1941,2,24,4,8,81,38,43,76
Stirling,1941,3,17,6,13,62,52,10,57
Clyde,1941,4,15,9,12,53,49,4,54
Stenhousem'r,1941,5,15,8,13,56,48,8,53
Elgin,1941,6,14,6,16,53,62,-9,48
Annan Athlet,1941,7,11,11,14,47,43,4,44
Berwick,1941,8,8,10,18,30,60,-30,34
Edinburgh Ci,1941,9,7,9,20,36,64,-28,30
Cowdenbeath,1941,10,5,10,21,25,54,-29,25
Montrose,1942,1,23,8,5,59,34,25,77
Peterhead,1942,2,24,4,8,79,39,40,76
Stirling,1942,3,17,6,13,64,52,12,57
Clyde,1942,4,15,9,12,56,48,8,54
Stenhousem'r,1942,5,15,8,13,56,50,6,53
Elgin,1942,6,14,7,15,53,60,-7,49
Annan Athlet,1942,7,11,12,13,47,41,6,45
Berwick,1942,8,8,10,18,29,63,-34,34
Edinburgh Ci,1942,9,7,9,20,37,62,-25,30
Cowdenbeath,1942,10,4,11,21,23,54,-31,23
Montrose,1943,1,24,7,5,60,34,26,79
Peterhead,1943,2,24,4,8,80,39,41,76
Stirling,1943,3,16,7,13,62,53,9,55
Stenhousem'r,1943,4,15,9,12,57,48,9,54
Clyde,1943,5,15,9,12,55,51,4,54
Elgin,1943,6,14,6,16,53,61,-8,48
Annan Athlet,1943,7,11,11,14,49,44,5,44
Berwick,1943,8,8,10,18,32,62,-30,34
Edinburgh Ci,1943,9,7,9,20,37,63,-26,30
Cowdenbeath,1943,10,5,10,21,26,56,-30,25
Peterhead,1944,1,24,4,8,81,39,42,76
Montrose,1944,2,23,7,6,60,36,24,76
Stirling,1944,3,17,6,13,63,51,12,57
Clyde,1944,4,15,9,12,53,49,4,54
Stenhousem'r,1944,5,15,8,13,55,49,6,53
Elgin,1944,6,15,6,15,55,61,-6,51
Annan Athlet,1944,7,12,11,13,49,41,8,47
Berwick,1944,8,8,10,18,30,60,-30,34
Edinburgh Ci,1944,9,7,9,20,37,64,-27,30
Cowdenbeath,1944,10,4,10,22,23,56,-33,22
Montrose,1945,1,24,7,5,63,35,28,79
Peterhead,1945,2,24,4,8,80,38,42,76
Stirling,1945,3,16,7,13,61,52,9,55
Stenhousem'r,1945,4,15,9,12,56,47,9,54
Clyde,1945,5,15,9,12,52,48,4,54
Elgin,1945,6,14,6,16,54,64,-10,48
Annan Athlet,1945,7,11,11,14,47,42,5,44
Berwick,1945,8,8,10,18,29,59,-30,34
Edinburgh Ci,1945,9,7,9,20,36,63,-27,30
Cowdenbeath,1945,10,5,10,21,24,54,-30,25
Montrose,1946,1,23,8,5,60,35,25,77
Peterhead,1946,2,24,4,8,80,38,42,76
Stenhousem'r,1946,3,16,8,12,56,46,10,56
Stirling,1946,4,16,6,14,60,52,8,54
Clyde,1946,5,15,9,12,55,49,6,54
Elgin,1946,6,14,7,15,54,61,-7,49
Annan Athlet,1946,7,11,11,14,47,42,5,44
Berwick,1946,8,8,10,18,30,62,-32,34
Edinburgh Ci,1946,9,7,9,20,36,63,-27,30
Cowdenbeath,1946,10,5,10,21,24,54,-30,25
Montrose,1947,1,24,7,5,62,36,26,79
Peterhead,1947,2,24,4,8,80,38,42,76
Stenhousem'r,1947,3,16,8,12,56,46,10,56
Stirling,1947,4,16,6,14,60,52,8,54
Clyde,1947,5,14,10,12,51,48,3,52
Elgin,1947,6,14,6,16,55,63,-8,48
Annan Athlet,1947,7,12,11,13,50,42,8,47
Berwick,1947,8,8,11,17,29,58,-29,35
Edinburgh Ci,1947,9,7,9,20,36,63,-27,30
Cowdenbeath,1947,10,4,10,22,24,57,-33,22
Montrose,1948,1,24,7,5,60,34,26,79
Peterhead,1948,2,24,4,8,78,38,40,76
Stirling,1948,3,17,6,13,63,51,12,57
Stenhousem'r,1948,4,15,8,13,55,49,6,53
Clyde,1948,5,14,9,13,52,52,0,51
Elgin,1948,6,14,6,16,53,61,-8,48
Annan Athlet,1948,7,11,11,14,48,43,5,44
Berwick,1948,8,9,10,17,33,59,-26,37
Edinburgh Ci,1948,9,7,9,20,36,61,-25,30
Cowdenbeath,1948,10,5,10,21,25,55,-30,25
Montrose,1949,1,23,7,6,59,36,23,76
Peterhead,1949,2,23,5,8,78,39,39,74
Stirling,1949,3,16,7,13,61,52,9,55
Stenhousem'r,1949,4,15,9,12,56,47,9,54
Clyde,1949,5,15,9,12,55,49,6,54
Elgin,1949,6,15,6,15,55,60,-5,51
Annan Athlet,1949,7,11,12,13,47,41,6,45
Berwick,1949,8,8,10,18,30,62,-32,34
Edinburgh Ci,1949,9,7,10,19,37,61,-24,31
Cowdenbeath,1949,10,4,11,21,23,54,-31,23
Peterhead,1950,1,24,4,8,82,38,44,76
Montrose,1950,2,23,7,6,60,36,24,76
Stenhousem'r,1950,3,16,8,12,57,47,10,56
Stirling,1950,4,16,6,14,61,53,8,54
Clyde,1950,5,15,9,12,52,48,4,54
Elgin,1950,6,15,6,15,55,61,-6,51
Annan Athlet,1950,7,12,11,13,48,41,7,47
Berwick,1950,8,8,10,18,29,59,-30,34
Edinburgh Ci,1950,9,7,9,20,36,65,-29,30
Cowdenbeath,1950,10,4,10,22,23,55,-32,22
Montrose,1951,1,24,7,5,61,35,26,79
Peterhead,1951,2,23,4,9,78,40,38,73
Stirling,1951,3,17,6,13,61,51,10,57
Clyde,1951,4,15,9,12,53,48,5,54
Stenhousem'r,1951,5,15,8,13,55,47,8,53
Elgin,1951,6,14,6,16,54,62,-8,48
Annan Athlet,1951,7,11,11,14,48,45,3,44
Berwick,1951,8,8,10,18,29,60,-31,34
Edinburgh Ci,1951,9,8,9,19,38,61,-23,33
Cowdenbeath,1951,10,5,10,21,27,55,-28,25
Montrose,1952,1,24,7,5,60,34,26,79
Peterhead,1952,2,23,5,8,78,39,39,74
Stirling,1952,3,17,6,13,62,52,10,57
Clyde,1952,4,15,9,12,53,48,5,54
Stenhousem'r,1952,5,15,8,13,56,48,8,53
Elgin,1952,6,14,6,16,53,61,-8,48
Annan Athlet,1952,7,12,11,13,49,41,8,47
Berwick,1952,8,8,10,18,29,60,-31,34
Edinburgh Ci,1952,9,7,10,19,37,61,-24,31
Cowdenbeath,1952,10,4,10,22,23,56,-33,22
Montrose,1953,1,23,8,5,60,35,25,77
Peterhead,1953,2,24,4,8,81,38,43,76
Stirling,1953,3,17,6,13,63,52,11,57
Stenhousem'r,1953,4,15,8,13,56,49,7,53
Clyde,1953,5,14,9,13,51,49,2,51
Elgin,1953,6,14,7,15,54,61,-7,49
Annan Athlet,1953,7,12,11,13,50,42,8,47
Berwick,1953,8,9,10,17,30,58,-28,37
Edinburgh Ci,1953,9,7,9,20,36,64,-28,30
Cowdenbeath,1953,10,4,10,22,24,57,-33,22
Montrose,1954,1,24,7,5,60,34,26,79
Peterhead,1954,2,23,4,9,77,40,37,73
Stirling,1954,3,16,7,13,61,52,9,55
Stenhousem'r,1954,4,15,9,12,56,47,9,54
Clyde,1954,5,14,9,13,51,49,2,51
Elgin,1954,6,14,6,16,53,61,-8,48
Annan Athlet,1954,7,12,11,13,49,42,7,47
Berwick,1954,8,9,10,17,30,58,-28,37
Edinburgh Ci,1954,9,8,9,19,38,60,-22,33
Cowdenbeath,1954,10,4,10,22,24,56,-32,22
Peterhead,1955,1,24,4,8,79,39,40,76
Montrose,1955,2,23,7,6,59,35,24,76
Stenhousem'r,1955,3,16,8,12,58,47,11,56
Stirling,1955,4,16,6,14,61,54,7,54
Clyde,1955,5,15,9,12,53,48,5,54
Elgin,1955,6,15,6,15,54,60,-6,51
Annan Athlet,1955,7,11,12,13,49,43,6,45
Berwick,1955,8,8,10,18,29,60,-31,34
Edinburgh Ci,1955,9,7,9,20,37,62,-25,30
Cowdenbeath,1955,10,4,11,21,25,56,-31,23
Montrose,1956,1,24,7,5,60,34,26,79
Peterhead,1956,2,24,4,8,80,38,42,76
Stirling,1956,3,17,6,13,64,51,13,57
Clyde,1956,4,15,9,12,56,48,8,54
Stenhousem'r,1956,5,15,8,13,55,50,5,53
Elgin,1956,6,14,6,16,53,61,-8,48
Annan Athlet,1956,7,11,12,13,48,42,6,45
Berwick,1956,8,8,10,18,29,63,-34,34
Edinburgh Ci,1956,9,7,9,20,36,63,-27,30
Cowdenbeath,1956,10,4,11,21,24,55,-31,23
Peterhead,1957,1,24,4,8,80,39,41,76
Montrose,1957,2,23,7,6,59,36,23,76
Stenhousem'r,1957,3,16,8,12,59,48,11,56
Stirling,1957,4,16,6,14,62,55,7,54
Clyde,1957,5,14,10,12,52,49,3,52
Elgin,1957,6,15,6,15,55,60,-5,51
Annan Athlet,1957,7,11,11,14,47,45,2,44
Berwick,1957,8,8,11,17,30,59,-29,35
Edinburgh Ci,1957,9,7,9,20,37,63,-26,30
Cowdenbeath,1957,10,5,10,21,27,54,-27,25
Peterhead,1958,1,24,4,8,78,38,40,76
Montrose,1958,2,23,7,6,60,36,24,76
Stenhousem'r,1958,3,16,8,12,57,47,10,56
Stirling,1958,4,16,6,14,61,53,8,54
Clyde,1958,5,15,9,12,52,48,4,54
Elgin,1958,6,15,6,15,55,61,-6,51
Annan Athlet,1958,7,12,11,13,50,41,9,47
Berwick,1958,8,8,10,18,29,59,-30,34
Edinburgh Ci,1958,9,7,9,20,36,61,-25,30
Cowdenbeath,1958,10,4,10,22,23,57,-34,22
Montrose,1959,1,24,7,5,63,35,28,79
Peterhead,1959,2,24,4,8,81,38,43,76
Stirling,1959,3,16,7,13,61,52,9,55
Stenhousem'r,1959,4,15,9,12,56,47,9,54
Clyde,1959,5,14,9,13,51,49,2,51
Elgin,1959,6,14,6,16,54,64,-10,48
Annan Athlet,1959,7,12,11,13,49,41,8,47
Berwick,1959,8,9,10,17,30,58,-28,37
Edinburgh Ci,1959,9,7,9,20,36,64,-28,30
Cowdenbeath,1959,10,4,10,22,23,56,-33,22
Montrose,1960,1,23,8,5,60,35,25,77
Peterhead,1960,2,24,4,8,82,40,42,76
Stirling,1960,3,16,7,13,61,52,9,55
Stenhousem'r,1960,4,15,9,12,56,47,9,54
Clyde,1960,5,14,9,13,52,50,2,51
Elgin,1960,6,14,7,15,54,61,-7,49
Annan Athlet,1960,7,11,11,14,47,43,4,44
Berwick,1960,8,9,10,17,31,59,-28,37
Edinburgh Ci,1960,9,7,9,20,38,65,-27,30
Cowdenbeath,1960,10,5,10,21,25,54,-29,25
Montrose,1961,1,24,7,5,63,35,28,79
Peterhead,1961,2,24,4,8,79,38,41,76
Stirling,1961,3,17,6,13,62,52,10,57
Clyde,1961,4,15,9,12,53,48,5,54
Stenhousem'r,1961,5,15,8,13,56,48,8,53
Elgin,1961,6,14,6,16,54,64,-10,48
Annan Athlet,1961,7,11,11,14,48,43,5,44
Berwick,1961,8,8,10,18,29,60,-31,34
Edinburgh Ci,1961,9,7,9,20,36,62,-26,30
Cowdenbeath,1961,10,5,10,21,25,55,-30,25
Montrose,1962,1,24,7,5,61,35,26,79
Peterhead,1962,2,23,5,8,77,38,39,74
Stirling,1962,3,17,6,13,61,51,10,57
Clyde,1962,4,15,9,12,54,48,6,54
Stenhousem'r,1962,5,15,8,13,55,47,8,53
Elgin,1962,6,14,6,16,54,62,-8,48
Annan Athlet,1962,7,12,11,13,49,42,7,47
Berwick,1962,8,8,10,18,29,61,-32,34
Edinburgh Ci,1962,9,7,10,19,36,60,-24,31
Cowdenbeath,1962,10,4,10,22,24,56,-32,22
Montrose,1963,1,23,7,6,60,38,22,76
Peterhead,1963,2,23,5,8,77,38,39,74
Stirling,1963,3,17,6,13,63,52,11,57
Clyde,1963,4,15,9,12,52,48,4,54
Stenhousem'r,1963,5,15,8,13,56,49,7,53
Elgin,1963,6,15,6,15,57,61,-4,51
Annan Athlet,1963,7,11,12,13,48,42,6,45
Berwick,1963,8,8,10,18,29,59,-30,34
Edinburgh Ci,1963,9,7,10,19,36,60,-24,31
Cowdenbeath,1963,10,4,11,21,24,55,-31,23
Montrose,1964,1,24,7,5,61,34,27,79
Peterhead,1964,2,24,4,8,81,38,43,76
Stirling,1964,3,17,6,13,62,52,10,57
Clyde,1964,4,15,9,12,53,48,5,54
Stenhousem'r,1964,5,15,8,13,56,48,8,53
Elgin,1964,6,14,6,16,53,62,-9,48
Annan Athlet,1964,7,11,11,14,48,43,5,44
Berwick,1964,8,8,10,18,29,60,-31,34
Edinburgh Ci,1964,9,7,9,20,36,64,-28,30
Cowdenbeath,1964,10,5,10,21,25,55,-30,25
Montrose,1965,1,23,7,6,60,36,24,76
Peterhead,1965,2,23,5,8,78,39,39,74
Stirling,1965,3,17,6,13,62,51,11,57
Clyde,1965,4,15,9,12,52,48,4,54
Stenhousem'r,1965,5,15,8,13,55,48,7,53
Elgin,1965,6,15,6,15,55,61,-6,51
Annan Athlet,1965,7,11,11,14,47,42,5,44
Berwick,1965,8,8,10,18,29,59,-30,34
Edinburgh Ci,1965,9,7,10,19,37,61,-24,31
Cowdenbeath,1965,10,5,10,21,24,54,-30,25
Montrose,1966,1,24,7,5,63,34,29,79
Peterhead,1966,2,24,4,8,81,38,43,76
Stirling,1966,3,17,6,13,62,51,11,57
Stenhousem'r,1966,4,15,8,13,55,48,7,53
Clyde,1966,5,14,9,13,51,49,2,51
Elgin,1966,6,14,6,16,53,64,-11,48
Annan Athlet,1966,7,12,11,13,50,42,8,47
Berwick,1966,8,9,10,17,30,58,-28,37
Edinburgh Ci,1966,9,7,9,20,36,64,-28,30
Cowdenbeath,1966,10,4,10,22,24,57,-33,22
Montrose,1967,1,23,8,5,60,35,25,77
Peterhead,1967,2,24,4,8,79,38,41,76
Stirling,1967,3,17,6,13,63,52,11,57
Clyde,1967,4,15,9,12,53,48,5,54
Stenhousem'r,1967,5,15,8,13,56,49,7,53
Elgin,1967,6,14,7,15,54,61,-7,49
Annan Athlet,1967,7,11,11,14,48,43,5,44
Berwick,1967,8,8,10,18,29,60,-31,34
Edinburgh Ci,1967,9,7,9,20,36,62,-26,30
Cowdenbeath,1967,10,5,10,21,25,55,-30,25
Peterhead,1968,1,24,4,8,83,39,44,76
Montrose,1968,2,23,7,6,59,35,24,76
Stirling,1968,3,17,6,13,64,51,13,57
Clyde,1968,4,15,9,12,54,49,5,54
Stenhousem'r,1968,5,15,8,13,55,50,5,53
Elgin,1968,6,15,6,15,54,60,-6,51
Annan Athlet,1968,7,12,11,13,49,42,7,47
Berwick,1968,8,8,10,18,30,61,-31,34
Edinburgh Ci,1968,9,7,9,20,37,66,-29,30
Cowdenbeath,1968,10,4,10,22,24,56,-32,22
Montrose,1969,1,24,7,5,61,35,26,79
Peterhead,1969,2,24,4,8,84,39,45,76
Stenhousem'r,1969,3,16,8,12,57,47,10,56
Stirling,1969,4,16,6,14,61,53,8,54
Clyde,1969,5,15,9,12,55,48,7,54
Elgin,1969,6,14,6,16,54,62,-8,48
Annan Athlet,1969,7,11,12,13,48,42,6,45
Berwick,1969,8,8,10,18,29,62,-33,34
Edinburgh Ci,1969,9,7,9,20,37,67,-30,30
Cowdenbeath,1969,10,4,11,21,24,55,-31,23
Montrose,1970,1,23,8,5,61,36,25,77
Peterhead,1970,2,23,4,9,77,39,38,73
Stirling,1970,3,16,7,13,62,53,9,55
Stenhousem'r,1970,4,15,9,12,57,48,9,54
Clyde,1970,5,14,9,13,51,50,1,51
Elgin,1970,6,14,7,15,55,62,-7,49
Annan Athlet,1970,7,11,12,13,50,44,6,45
Berwick,1970,8,9,10,17,31,58,-27,37
Edinburgh Ci,1970,9,8,9,19,37,60,-23,33
Cowdenbeath,1970,10,4,11,21,26,57,-31,23
Montrose,1971,1,24,7,5,63,35,28,79
Peterhead,1971,2,24,4,8,80,38,42,76
Stirling,1971,3,17,6,13,63,51,12,57
Stenhousem'r,1971,4,15,8,13,55,49,6,53
Clyde,1971,5,14,9,13,51,49,2,51
Elgin,1971,6,14,6,16,54,64,-10,48
Annan Athlet,1971,7,11,11,14,47,42,5,44
Berwick,1971,8,9,10,17,30,58,-28,37
Edinburgh Ci,1971,9,7,9,20,36,63,-27,30
Cowdenbeath,1971,10,5,10,21,24,54,-30,25
Montrose,1972,1,24,7,5,64,36,28,79
Peterhead,1972,2,24,4,8,78,38,40,76
Stenhousem'r,1972,3,16,8,12,57,46,11,56
Stirling,1972,4,16,6,14,60,53,7,54
Clyde,1972,5,15,9,12,54,49,5,54
Elgin,1972,6,14,6,16,55,65,-10,48
Annan Athlet,1972,7,11,11,14,47,43,4,44
Berwick,1972,8,8,10,18,30,61,-31,34
Edinburgh Ci,1972,9,7,9,20,36,61,-25,30
Cowdenbeath,1972,10,5,10,21,25,54,-29,25
Montrose,1973,1,24,7,5,64,35,29,79
Peterhead,1973,2,23,4,9,79,41,38,73
Stirling,1973,3,16,7,13,61,52,9,55
Stenhousem'r,1973,4,15,9,12,56,47,9,54
Clyde,1973,5,15,9,12,55,51,4,54
Elgin,1973,6,14,6,16,54,65,-11,48
Annan Athlet,1973,7,12,11,13,48,41,7,47
Berwick,1973,8,8,10,18,32,62,-30,34
Edinburgh Ci,1973,9,8,9,19,39,62,-23,33
Cowdenbeath,1973,10,4,10,22,23,55,-32,22
Montrose,1974,1,23,8,5,60,35,25,77
Peterhead,1974,2,23,4,9,77,40,37,73
Stenhousem'r,1974,3,16,8,12,57,46,11,56
Stirling,1974,4,16,6,14,60,53,7,54
Clyde,1974,5,14,10,12,52,49,3,52
Elgin,1974,6,14,7,15,54,61,-7,49
Annan Athlet,1974,7,12,11,13,48,41,7,47
Berwick,1974,8,8,11,17,30,59,-29,35
Edinburgh Ci,1974,9,8,9,19,38,60,-22,33
Cowdenbeath,1974,10,4,10,22,23,55,-32,22
Montrose,1975,1,23,8,5,60,35,25,77
Peterhead,1975,2,23,4,9,77,40,37,73
Stenhousem'r,1975,3,16,8,12,57,47,10,56
Stirling,1975,4,16,6,14,61,53,8,54
Clyde,1975,5,14,9,13,52,50,2,51
Elgin,1975,6,14,7,15,54,61,-7,49
Annan Athlet,1975,7,12,11,13,50,43,7,47
Berwick,1975,8,9,10,17,31,59,-28,37
Edinburgh Ci,1975,9,8,9,19,38,60,-22,33
Cowdenbeath,1975,10,4,10,22,25,57,-32,22
Peterhead,1976,1,24,4,8,82,40,42,76
Montrose,1976,2,23,7,6,60,37,23,76
Stirling,1976,3,17,6,13,63,51,12,57
Clyde,1976,4,15,9,12,55,51,4,54
Stenhousem'r,1976,5,15,8,13,55,49,6,53
Elgin,1976,6,15,6,15,56,61,-5,51
Annan Athlet,1976,7,12,11,13,50,41,9,47
Berwick,1976,8,8,10,18,32,62,-30,34
Edinburgh Ci,1976,9,7,9,20,38,65,-27,30
Cowdenbeath,1976,10,4,10,22,23,57,-34,22
Peterhead,1977,1,24,4,8,82,38,44,76
Montrose,1977,2,23,7,6,62,38,24,76
Stirling,1977,3,17,6,13,63,52,11,57
Clyde,1977,4,15,9,12,53,48,5,54
Stenhousem'r,1977,5,15,8,13,56,49,7,53
Elgin,1977,6,15,6,15,57,63,-6,51
Annan Athlet,1977,7,12,11,13,49,41,8,47
Berwick,1977,8,8,10,18,29,60,-31,34
Edinburgh Ci,1977,9,7,9,20,36,65,-29,30
Cowdenbeath,1977,10,4,10,22,23,56,-33,22
Montrose,1978,1,23,7,6,60,36,24,76
Peterhead,1978,2,23,5,8,77,38,39,74
Stenhousem'r,1978,3,16,8,12,58,48,10,56
Stirling,1978,4,16,6,14,62,54,8,54
Clyde,1978,5,15,9,12,52,48,4,54
Elgin,1978,6,15,6,15,55,61,-6,51
Annan Athlet,1978,7,12,11,13,49,42,7,47
Berwick,1978,8,8,10,18,29,59,-30,34
Edinburgh Ci,1978,9,7,10,19,36,60,-24,31
Cowdenbeath,1978,10,4,10,22,24,56,-32,22
Montrose,1979,1,24,7,5,60,34,26,79
Peterhead,1979,2,24,4,8,80,39,41,76
Stenhousem'r,1979,3,16,8,12,56,46,10,56
Stirling,1979,4,16,6,14,60,52,8,54
Clyde,1979,5,15,9,12,52,48,4,54
Elgin,1979,6,14,6,16,53,61,-8,48
Annan Athlet,1979,7,12,11,13,48,41,7,47
Berwick,1979,8,8,10,18,29,59,-30,34
Edinburgh Ci,1979,9,7,9,20,37,63,-26,30
Cowdenbeath,1979,10,4,10,22,23,55,-32,22
Montrose,1980,1,24,7,5,63,34,29,79
Peterhead,1980,2,23,5,8,79,40,39,74
Stenhousem'r,1980,3,16,8,12,59,46,13,56
Stirling,1980,4,16,6,14,60,55,5,54
Clyde,1980,5,15,9,12,53,48,5,54
Elgin,1980,6,14,6,16,53,64,-11,48
Annan Athlet,1980,7,12,11,13,48,41,7,47
Berwick,1980,8,8,10,18,29,60,-31,34
Edinburgh Ci,1980,9,7,10,19,38,62,-24,31
Cowdenbeath,1980,10,4,10,22,23,55,-32,22
Montrose,1981,1,24,7,5,67,35,32,79
Peterhead,1981,2,24,4,8,81,38,43,76
Stirling,1981,3,16,7,13,62,53,9,55
Stenhousem'r,1981,4,15,9,12,57,48,9,54
Clyde,1981,5,14,10,12,52,49,3,52
Elgin,1981,6,14,6,16,54,68,-14,48
Annan Athlet,1981,7,11,12,13,47,41,6,45
Berwick,1981,8,8,11,17,30,59,-29,35
Edinburgh Ci,1981,9,7,9,20,36,64,-28,30
Cowdenbeath,1981,10,4,11,21,23,54,-31,23
Peterhead,1982,1,24,4,8,81,38,43,76
Montrose,1982,2,23,7,6,60,37,23,76
Stirling,1982,3,17,6,13,63,51,12,57
Stenhousem'r,1982,4,15,8,13,55,49,6,53
Clyde,1982,5,14,9,13,51,50,1,51
Elgin,1982,6,15,6,15,56,61,-5,51
Annan Athlet,1982,7,12,11,13,51,44,7,47
Berwick,1982,8,9,10,17,31,58,-27,37
Edinburgh Ci,1982,9,7,9,20,36,64,-28,30
Cowdenbeath,1982,10,4,10,22,26,58,-32,22
Peterhead,1983,1,24,4,8,78,38,40,76
Montrose,1983,2,23,7,6,59,36,23,76
Stirling,1983,3,17,6,13,64,51,13,57
Clyde,1983,4,15,9,12,53,49,4,54
Stenhousem'r,1983,5,15,8,13,55,50,5,53
Elgin,1983,6,15,6,15,55,60,-5,51
Annan Athlet,1983,7,12,11,13,49,42,7,47
Berwick,1983,8,8,10,18,30,60,-30,34
Edinburgh Ci,1983,9,7,9,20,36,61,-25,30
Cowdenbeath,1983,10,4,10,22,24,56,-32,22
Montrose,1984,1,24,7,5,61,34,27,79
Peterhead,1984,2,24,4,8,80,40,40,76
Stirling,1984,3,17,6,13,64,54,10,57
Clyde,1984,4,15,9,12,54,48,6,54
Stenhousem'r,1984,5,15,8,13,58,50,8,53
Elgin,1984,6,14,6,16,53,62,-9,48
Annan Athlet,1984,7,12,11,13,49,41,8,47
Berwick,1984,8,8,10,18,29,61,-32,34
Edinburgh Ci,1984,9,7,9,20,38,63,-25,30
Cowdenbeath,1984,10,4,10,22,23,56,-33,22
Montrose,1985,1,24,7,5,62,35,27,79
Peterhead,1985,2,24,4,8,79,38,41,76
Stirling,1985,3,17,6,13,63,51,12,57
Clyde,1985,4,15,9,12,53,48,5,54
Stenhousem'r,1985,5,15,8,13,55,49,6,53
Elgin,1985,6,14,6,16,54,63,-9,48
Annan Athlet,1985,7,11,12,13,48,42,6,45
Berwick,1985,8,8,10,18,29,60,-31,34
Edinburgh Ci,1985,9,7,9,20,36,62,-26,30
Cowdenbeath,1985,10,4,11,21,24,55,-31,23
Montrose,1986,1,24,7,5,61,35,26,79
Peterhead,1986,2,24,4,8,79,39,40,76
Stirling,1986,3,16,7,13,62,53,9,55
Stenhousem'r,1986,4,15,9,12,57,48,9,54
Clyde,1986,5,14,10,12,52,49,3,52
Elgin,1986,6,14,6,16,54,62,-8,48
Annan Athlet,1986,7,11,12,13,48,42,6,45
Berwick,1986,8,8,11,17,30,59,-29,35
Edinburgh Ci,1986,9,7,9,20,37,62,-25,30
Cowdenbeath,1986,10,4,11,21,24,55,-31,23
Montrose,1987,1,24,7,5,62,34,28,79
Peterhead,1987,2,23,4,9,77,42,35,73
Stirling,1987,3,17,6,13,62,52,10,57
Stenhousem'r,1987,4,15,8,13,56,48,8,53
Clyde,1987,5,14,9,13,52,51,1,51
Elgin,1987,6,14,6,16,53,63,-10,48
Annan Athlet,1987,7,11,11,14,48,43,5,44
Berwick,1987,8,9,10,17,32,59,-27,37
Edinburgh Ci,1987,9,8,9,19,40,60,-20,33
Cowdenbeath,1987,10,5,10,21,25,55,-30,25
Montrose,1988,1,24,7,5,60,34,26,79
Peterhead,1988,2,23,5,8,77,38,39,74
Stirling,1988,3,17,6,13,62,52,10,57
Clyde,1988,4,15,9,12,55,49,6,54
Stenhousem'r,1988,5,15,8,13,56,48,8,53
Elgin,1988,6,14,6,16,53,61,-8,48
Annan Athlet,1988,7,12,11,13,49,41,8,47
Berwick,1988,8,8,10,18,30,62,-32,34
Edinburgh Ci,1988,9,7,10,19,36,60,-24,31
Cowdenbeath,1988,10,4,10,22,23,56,-33,22
Montrose,1989,1,24,7,5,62,34,28,79
Peterhead,1989,2,24,4,8,78,38,40,76
Stirling,1989,3,16,7,13,61,52,9,55
Stenhousem'r,1989,4,15,9,12,56,47,9,54
Clyde,1989,5,15,9,12,52,48,4,54
Elgin,1989,6,14,6,16,53,63,-10,48
Annan Athlet,1989,7,12,11,13,49,42,7,47
Berwick,1989,8,8,10,18,29,59,-30,34
Edinburgh Ci,1989,9,7,9,20,36,61,-25,30
Cowdenbeath,1989,10,4,10,22,24,56,-32,22
Montrose,1990,1,23,8,5,60,35,25,77
Peterhead,1990,2,24,4,8,79,39,40,76
Stirling,1990,3,17,6,13,64,51,13,57
Stenhousem'r,1990,4,15,8,13,55,50,5,53
Clyde,1990,5,14,9,13,52,50,2,51
Elgin,1990,6,14,7,15,54,61,-7,49
Annan Athlet,1990,7,12,11,13,49,41,8,47
Berwick,1990,8,9,10,17,31,59,-28,37
Edinburgh Ci,1990,9,7,9,20,37,62,-25,30
Cowdenbeath,1990,10,4,10,22,23,56,-33,22
Montrose,1991,1,24,7,5,63,34,29,79
Peterhead,1991,2,24,4,8,80,39,41,76
Stirling,1991,3,17,6,13,61,51,10,57
Clyde,1991,4,15,9,12,53,48,5,54
Stenhousem'r,1991,5,15,8,13,55,47,8,53
Elgin,1991,6,14,6,16,53,64,-11,48
Annan Athlet,1991,7,11,11,14,47,43,4,44
Berwick,1991,8,8,10,18,29,60,-31,34
Edinburgh Ci,1991,9,7,9,20,37,63,-26,30
Cowdenbeath,1991,10,5,10,21,25,54,-29,25
Montrose,1992,1,24,7,5,63,34,29,79
Peterhead,1992,2,24,4,8,82,38,44,76
Stirling,1992,3,17,6,13,62,52,10,57
Clyde,1992,4,15,9,12,55,48,7,54
Stenhousem'r,1992,5,15,8,13,56,48,8,53
Elgin,1992,6,14,6,16,53,64,-11,48
Annan Athlet,1992,7,12,11,13,49,41,8,47
Berwick,1992,8,8,10,18,29,62,-33,34
Edinburgh Ci,1992,9,7,9,20,36,65,-29,30
Cowdenbeath,1992,10,4,10,22,23,56,-33,22
Montrose,1993,1,24,7,5,61,35,26,79
Peterhead,1993,2,23,5,8,77,38,39,74
Stirling,1993,3,17,6,13,61,51,10,57
Stenhousem'r,1993,4,15,8,13,55,47,8,53
Clyde,1993,5,14,9,13,53,51,2,51
Elgin,1993,6,14,6,16,54,62,-8,48
Annan Athlet,1993,7,11,11,14,47,42,5,44
Berwick,1993,8,9,10,17,32,60,-28,37
Edinburgh Ci,1993,9,7,10,19,36,60,-24,31
Cowdenbeath,1993,10,5,10,21,24,54,-30,25
Montrose,1994,1,24,7,5,62,36,26,79
Peterhead,1994,2,24,4,8,81,38,43,76
Stirling,1994,3,17,6,13,64,52,12,57
Stenhousem'r,1994,4,15,8,13,56,50,6,53
Clyde,1994,5,14,10,12,52,49,3,52
Elgin,1994,6,14,6,16,55,63,-8,48
Annan Athlet,1994,7,12,11,13,48,41,7,47
Berwick,1994,8,8,11,17,30,59,-29,35
Edinburgh Ci,1994,9,7,9,20,36,64,-28,30
Cowdenbeath,1994,10,4,10,22,23,55,-32,22
Montrose,1995,1,23,8,5,60,35,25,77
Peterhead,1995,2,24,4,8,79,38,41,76
Stenhousem'r,1995,3,16,8,12,57,47,10,56
Stirling,1995,4,16,6,14,61,53,8,54
Clyde,1995,5,15,9,12,53,49,4,54
Elgin,1995,6,14,7,15,54,61,-7,49
Annan Athlet,1995,7,11,12,13,47,41,6,45
Berwick,1995,8,8,10,18,30,60,-30,34
Edinburgh Ci,1995,9,7,9,20,36,62,-26,30
Cowdenbeath,1995,10,4,11,21,23,54,-31,23
Peterhead,1996,1,24,4,8,85,38,47,76
Montrose,1996,2,23,7,6,60,38,22,76
Stirling,1996,3,17,6,13,63,52,11,57
Clyde,1996,4,15,9,12,53,49,4,54
Stenhousem'r,1996,5,15,8,13,56,49,7,53
Elgin,1996,6,15,6,15,57,61,-4,51
Annan Athlet,1996,7,11,11,14,48,43,5,44
Berwick,1996,8,8,10,18,30,60,-30,34
Edinburgh Ci,1996,9,7,9,20,36,68,-32,30
Cowdenbeath,1996,10,5,10,21,25,55,-30,25
Montrose,1997,1,24,7,5,63,35,28,79
Peterhead,1997,2,24,4,8,80,39,41,76
Stirling,1997,3,17,6,13,63,52,11,57
Stenhousem'r,1997,4,15,8,13,56,49,7,53
Clyde,1997,5,14,9,13,52,50,2,51
Elgin,1997,6,14,6,16,54,64,-10,48
Annan Athlet,1997,7,11,12,13,47,41,6,45
Berwick,1997,8,9,10,17,31,59,-28,37
Edinburgh Ci,1997,9,7,9,20,37,63,-26,30
Cowdenbeath,1997,10,4,11,21,23,54,-31,23
Montrose,1998,1,24,7,5,61,35,26,79
Peterhead,1998,2,24,4,8,78,38,40,76
Stirling,1998,3,16,7,13,61,52,9,55
Stenhousem'r,1998,4,15,9,12,56,47,9,54
Clyde,1998,5,15,9,12,54,49,5,54
Elgin,1998,6,14,6,16,54,62,-8,48
Annan Athlet,1998,7,12,11,13,49,42,7,47
Berwick,1998,8,8,10,18,30,61,-31,34
Edinburgh Ci,1998,9,7,9,20,36,61,-25,30
Cowdenbeath,1998,10,4,10,22,24,56,-32,22
Montrose,1999,1,24,7,5,61,35,26,79
Peterhead,1999,2,24,4,8,82,41,41,76
Stenhousem'r,1999,3,16,8,12,59,48,11,56
Stirling,1999,4,16,6,14,62,55,7,54
Clyde,1999,5,15,9,12,52,48,4,54
Elgin,1999,6,14,6,16,54,62,-8,48
Annan Athlet,1999,7,11,12,13,48,42,6,45
Berwick,1999,8,8,10,18,29,59,-30,34
Edinburgh Ci,1999,9,7,9,20,39,65,-26,30
Cowdenbeath,1999,10,4,11,21,24,55,-31,23
Montrose,2000,1,23,8,5,60,35,25,77
Peterhead,2000,2,23,4,9,78,40,38,73
Stirling,2000,3,17,6,13,62,51,11,57
Stenhousem'r,2000,4,15,8,13,55,48,7,53
Clyde,2000,5,14,10,12,52,49,3,52
Elgin,2000,6,14,7,15,54,61,-7,49
Annan Athlet,2000,7,11,11,14,47,42,5,44
Berwick,2000,8,8,11,17,30,59,-29,35
Edinburgh Ci,2000,9,8,9,19,38,61,-23,33
Cowdenbeath,2000,10,5,10,21,24,54,-30,25
Montrose,2001,1,23,8,5,60,35,25,77
Peterhead,2001,2,24,4,8,80,39,41,76
Stenhousem'r,2001,3,16,8,12,57,46,11,56
Stirling,2001,4,16,6,14,60,53,7,54
Clyde,2001,5,14,10,12,51,48,3,52
Elgin,2001,6,14,7,15,54,61,-7,49
Annan Athlet,2001,7,11,11,14,48,43,5,44
Berwick,2001,8,8,11,17,29,58,-29,35
Edinburgh Ci,2001,9,7,9,20,37,63,-26,30
Cowdenbeath,2001,10,5,10,21,25,55,-30,25
Montrose,2002,1,24,7,5,62,34,28,79
Peterhead,2002,2,24,4,8,80,38,42,76
Stirling,2002,3,17,6,13,61,51,10,57
Clyde,2002,4,15,9,12,52,48,4,54
Stenhousem'r,2002,5,15,8,13,55,47,8,53
Elgin,2002,6,14,6,16,53,63,-10,48
Annan Athlet,2002,7,12,11,13,48,41,7,47
Berwick,2002,8,8,10,18,29,59,-30,34
Edinburgh Ci,2002,9,7,9,20,36,63,-27,30
Cowdenbeath,2002,10,4,10,22,23,55,-32,22
Montrose,2003,1,23,8,5,61,36,25,77
Peterhead,2003,2,24,4,8,79,38,41,76
Stirling,2003,3,17,6,13,64,51,13,57
Clyde,2003,4,15,9,12,52,48,4,54
Stenhousem'r,2003,5,15,8,13,55,50,5,53
Elgin,2003,6,14,7,15,55,62,-7,49
Annan Athlet,2003,7,12,11,13,48,41,7,47
Berwick,2003,8,8,10,18,29,59,-30,34
Edinburgh Ci,2003,9,7,9,20,36,62,-26,30
Cowdenbeath,2003,10,4,10,22,23,55,-32,22
Montrose,2004,1,23,8,5,59,34,25,77
Peterhead,2004,2,24,4,8,81,38,43,76
Stirling,2004,3,17,6,13,63,53,10,57
Stenhousem'r,2004,4,15,8,13,57,49,8,53
Clyde,2004,5,14,9,13,52,53,-1,51
Elgin,2004,6,14,7,15,53,60,-7,49
Annan Athlet,2004,7,12,11,13,49,41,8,47
Berwick,2004,8,9,10,17,34,59,-25,37
Edinburgh Ci,2004,9,7,9,20,36,64,-28,30
Cowdenbeath,2004,10,4,10,22,23,56,-33,22
Montrose,2005,1,23,8,5,60,35,25,77
Peterhead,2005,2,23,5,8,79,40,39,74
Stenhousem'r,2005,3,16,8,12,57,47,10,56
Stirling,2005,4,16,6,14,61,53,8,54
Clyde,2005,5,15,9,12,53,48,5,54
Elgin,2005,6,14,7,15,54,61,-7,49
Annan Athlet,2005,7,11,12,13,48,42,6,45
Berwick,2005,8,8,10,18,29,60,-31,34
Edinburgh Ci,2005,9,7,10,19,38,62,-24,31
Cowdenbeath,2005,10,4,11,21,24,55,-31,23
Montrose,2006,1,24,7,5,62,36,26,79
Peterhead,2006,2,24,4,8,85,38,47,76
Stirling,2006,3,17,6,13,63,51,12,57
Clyde,2006,4,15,9,12,53,49,4,54
Stenhousem'r,2006,5,15,8,13,55,49,6,53
Elgin,2006,6,14,6,16,55,63,-8,48
Annan Athlet,2006,7,12,11,13,50,42,8,47
Berwick,2006,8,8,10,18,30,60,-30,34
Edinburgh Ci,2006,9,7,9,20,36,68,-32,30
Cowdenbeath,2006,10,4,10,22,24,57,-33,22
Montrose,2007,1,24,7,5,65,35,30,79
Peterhead,2007,2,24,4,8,80,39,41,76
Stenhousem'r,2007,3,16,8,12,58,46,12,56
Stirling,2007,4,16,6,14,60,54,6,54
Clyde,2007,5,14,9,13,51,50,1,51
Elgin,2007,6,14,6,16,54,66,-12,48
Annan Athlet,2007,7,11,12,13,49,43,6,45
Berwick,2007,8,9,10,17,31,58,-27,37
Edinburgh Ci,2007,9,7,9,20,37,63,-26,30
Cowdenbeath,2007,10,4,11,21,25,56,-31,23
Montrose,2008,1,24,7,5,61,34,27,79
Peterhead,2008,2,24,4,8,81,39,42,76
Stirling,2008,3,16,7,13,60,51,9,55
Stenhousem'r,2008,4,15,9,12,55,46,9,54
Clyde,2008,5,15,9,12,53,49,4,54
Elgin,2008,6,14,6,16,53,62,-9,48
Annan Athlet,2008,7,12,11,13,48,41,7,47
Berwick,2008,8,8,10,18,30,60,-30,34
Edinburgh Ci,2008,9,7,9,20,37,64,-27,30
Cowdenbeath,2008,10,4,10,22,23,55,-32,22
Peterhead,2009,1,24,4,8,78,38,40,76
Montrose,2009,2,23,7,6,59,37,22,76
Stirling,2009,3,17,6,13,61,51,10,57
Clyde,2009,4,15,9,12,54,50,4,54
Stenhousem'r,2009,5,15,8,13,55,47,8,53
Elgin,2009,6,15,6,15,56,60,-4,51
Annan Athlet,2009,7,12,11,13,50,42,8,47
Berwick,2009,8,8,10,18,31,61,-30,34
Edinburgh Ci,2009,9,7,9,20,36,61,-25,30
Cowdenbeath,2009,10,4,10,22,24,57,-33,22
Montrose,2010,1,24,7,5,63,35,28,79
Peterhead,2010,2,24,4,8,79,39,40,76
Stirling,2010,3,16,7,13,61,52,9,55
Stenhousem'r,2010,4,15,9,12,56,47,9,54
Clyde,2010,5,15,9,12,56,48,8,54
Elgin,2010,6,14,6,16,54,64,-10,48
Annan Athlet,2010,7,12,11,13,48,41,7,47
Berwick,2010,8,8,10,18,29,63,-34,34
Edinburgh Ci,2010,9,7,9,20,37,62,-25,30
Cowdenbeath,2010,10,4,10,22,23,55,-32,22
Peterhead,2011,1,24,4,8,78,38,40,76
Montrose,2011,2,23,7,6,60,36,24,76
Stirling,2011,3,17,6,13,64,52,12,57
Stenhousem'r,2011,4,15,8,13,56,50,6,53
Clyde,2011,5,14,10,12,52,49,3,52
Elgin,2011,6,15,6,15,55,61,-6,51
Annan Athlet,2011,7,12,11,13,48,41,7,47
Berwick,2011,8,8,11,17,30,59,-29,35
Edinburgh Ci,2011,9,7,9,20,36,61,-25,30
Cowdenbeath,2011,10,4,10,22,23,55,-32,22
Montrose,2012,1,24,7,5,61,35,26,79
Peterhead,2012,2,24,4,8,78,38,40,76
Stirling,2012,3,17,6,13,62,52,10,57
Stenhousem'r,2012,4,15,8,13,56,48,8,53
Clyde,2012,5,14,10,12,52,49,3,52
Elgin,2012,6,14,6,16,54,62,-8,48
Annan Athlet,2012,7,11,11,14,47,42,5,44
Berwick,2012,8,8,11,17,30,59,-29,35
Edinburgh Ci,2012,9,7,9,20,36,61,-25,30
Cowdenbeath,2012,10,5,10,21,24,54,-30,25
Peterhead,2013,1,24,4,8,81,39,42,76
Montrose,2013,2,23,7,6,60,37,23,76
Stirling,2013,3,17,6,13,63,53,10,57
Stenhousem'r,2013,4,15,8,13,57,49,8,53
Clyde,2013,5,14,10,12,51,48,3,52
Elgin,2013,6,15,6,15,56,61,-5,51
Annan Athlet,2013,7,11,12,13,48,42,6,45
Berwick,2013,8,8,11,17,29,58,-29,35
Edinburgh Ci,2013,9,7,9,20,37,64,-27,30
Cowdenbeath,2013,10,4,11,21,24,55,-31,23
Montrose,2014,1,24,7,5,60,34,26,79
Peterhead,2014,2,24,4,8,81,39,42,76
Stirling,2014,3,16,7,13,61,52,9,55
Stenhousem'r,2014,4,15,9,12,56,47,9,54
Clyde,2014,5,15,9,12,54,49,5,54
Elgin,2014,6,14,6,16,53,61,-8,48
Annan Athlet,2014,7,11,12,13,49,43,6,45
Berwick,2014,8,8,10,18,30,61,-31,34
Edinburgh Ci,2014,9,7,9,20,37,64,-27,30
Cowdenbeath,2014,10,4,11,21,25,56,-31,23
Montrose,2015,1,23,8,5,60,35,25,77
Peterhead,2015,2,24,4,8,79,39,40,76
Stenhousem'r,2015,3,16,8,12,58,47,11,56
Stirling,2015,4,16,6,14,61,54,7,54
Clyde,2015,5,14,10,12,52,49,3,52
Elgin,2015,6,14,7,15,54,61,-7,49
Annan Athlet,2015,7,11,12,13,48,42,6,45
Berwick,2015,8,8,11,17,30,59,-29,35
Edinburgh Ci,2015,9,7,9,20,37,62,-25,30
Cowdenbeath,2015,10,4,11,21,24,55,-31,23
Montrose,2016,1,24,7,5,61,35,26,79
Peterhead,2016,2,24,4,8,83,41,42,76
Stirling,2016,3,17,6,13,63,52,11,57
Stenhousem'r,2016,4,15,8,13,56,49,7,53
Clyde,2016,5,14,10,12,52,49,3,52
Elgin,2016,6,14,6,16,54,62,-8,48
Annan Athlet,2016,7,12,11,13,50,42,8,47
Berwick,2016,8,8,11,17,30,59,-29,35
Edinburgh Ci,2016,9,7,9,20,39,66,-27,30
Cowdenbeath,2016,10,4,10,22,24,57,-33,22
Montrose,2017,1,24,7,5,61,35,26,79
Peterhead,2017,2,23,5,8,78,39,39,74
Stirling,2017,3,16,7,13,63,54,9,55
Stenhousem'r,2017,4,15,9,12,58,49,9,54
Clyde,2017,5,14,10,12,51,48,3,52
Elgin,2017,6,14,6,16,54,62,-8,48
Annan Athlet,2017,7,11,12,13,48,42,6,45
Berwick,2017,8,8,11,17,29,58,-29,35
Edinburgh Ci,2017,9,7,10,19,37,61,-24,31
Cowdenbeath,2017,10,4,11,21,24,55,-31,23
Montrose,2018,1,24,7,5,61,34,27,79
Peterhead,2018,2,24,4,8,82,38,44,76
Stirling,2018,3,16,7,13,61,52,9,55
Stenhousem'r,2018,4,15,9,12,56,47,9,54
Clyde,2018,5,15,9,12,54,48,6,54
Elgin,2018,6,14,6,16,53,62,-9,48
Annan Athlet,2018,7,12,11,13,49,41,8,47
Berwick,2018,8,8,10,18,29,61,-32,34
Edinburgh Ci,2018,9,7,9,20,36,65,-29,30
Cowdenbeath,2018,10,4,10,22,23,56,-33,22
Peterhead,2019,1,24,4,8,80,39,41,76
Montrose,2019,2,23,7,6,60,37,23,76
Stenhousem'r,2019,3,16,8,12,59,46,13,56
Stirling,2019,4,16,6,14,60,55,5,54
Clyde,2019,5,14,9,13,53,51,2,51
Elgin,2019,6,15,6,15,56,61,-5,51
Annan Athlet,2019,7,11,12,13,47,41,6,45
Berwick,2019,8,9,10,17,32,60,-28,37
Edinburgh Ci,2019,9,7,9,20,37,63,-26,30
Cowdenbeath,2019,10,4,11,21,23,54,-31,23
Montrose,2020,1,24,7,5,60,34,26,79
Peterhead,2020,2,24,4,8,81,39,42,76
Stirling,2020,3,17,6,13,62,52,10,57
Clyde,2020,4,15,9,12,54,48,6,54
Stenhousem'r,2020,5,15,8,13,56,48,8,53
Elgin,2020,6,14,6,16,53,61,-8,48
Annan Athlet,2020,7,12,11,13,48,41,7,47
Berwick,2020,8,8,10,18,29,61,-32,34
Edinburgh Ci,2020,9,7,9,20,37,64,-27,30
Cowdenbeath,2020,10,4,10,22,23,55,-32,22
Montrose,2021,1,24,7,5,62,34,28,79
Peterhead,2021,2,23,5,8,77,38,39,74
Stenhousem'r,2021,3,16,8,12,57,46,11,56
Stirling,2021,4,16,6,14,60,53,7,54
Clyde,2021,5,15,9,12,54,48,6,54
Elgin,2021,6,14,6,16,53,63,-10,48
Annan Athlet,2021,7,11,12,13,48,42,6,45
Berwick,2021,8,8,10,18,29,61,-32,34
Edinburgh Ci,2021,9,7,10,19,36,60,-24,31
Cowdenbeath,2021,10,4,11,21,24,55,-31,23
Peterhead,2022,1,24,4,8,80,38,42,76
Montrose,2022,2,23,7,6,60,36,24,76
Stirling,2022,3,17,6,13,62,52,10,57
Stenhousem'r,2022,4,15,8,13,56,48,8,53
Clyde,2022,5,14,9,13,51,49,2,51
Elgin,2022,6,15,6,15,55,61,-6,51
Annan Athlet,2022,7,11,11,14,47,44,3,44
Berwick,2022,8,9,10,17,30,58,-28,37
Edinburgh Ci,2022,9,7,9,20,36,63,-27,30
Cowdenbeath,2022,10,5,10,21,26,54,-28,25
Montrose,2023,1,24,7,5,63,34,29,79
Peterhead,2023,2,24,4,8,79,39,40,76
Stirling,2023,3,16,7,13,60,51,9,55
Stenhousem'r,2023,4,15,9,12,55,46,9,54
Clyde,2023,5,15,9,12,52,48,4,54
Elgin,2023,6,14,6,16,53,64,-11,48
Annan Athlet,2023,7,11,12,13,47,41,6,45
Berwick,2023,8,8,10,18,29,59,-30,34
Edinburgh Ci,2023,9,7,9,20,37,62,-25,30
Cowdenbeath,2023,10,4,11,21,23,54,-31,23
Montrose,2024,1,24,7,5,62,35,27,79
Peterhead,2024,2,24,4,8,79,39,40,76
Stenhousem'r,2024,3,16,8,12,58,47,11,56
Stirling,2024,4,16,6,14,61,54,7,54
Clyde,2024,5,14,10,12,51,48,3,52
Elgin,2024,6,14,6,16,54,63,-9,48
Annan Athlet,2024,7,11,11,14,48,44,4,44
Berwick,2024,8,8,11,17,29,58,-29,35
Edinburgh Ci,2024,9,7,9,20,37,62,-25,30
Cowdenbeath,2024,10,5,10,21,26,55,-29,25
Montrose,2025,1,24,7,5,62,35,27,79
Peterhead,2025,2,24,4,8,80,38,42,76
Stirling,2025,3,17,6,13,63,52,11,57
Clyde,2025,4,15,9,12,55,49,6,54
Stenhousem'r,2025,5,15,8,13,56,49,7,53
Elgin,2025,6,14,6,16,54,63,-9,48
Annan Athlet,2025,7,12,11,13,48,41,7,47
Berwick,2025,8,8,10,18,30,62,-32,34
Edinburgh Ci,2025,9,7,9,20,36,63,-27,30
Cowdenbeath,2025,10,4,10,22,23,55,-32,22
Montrose,2026,1,24,7,5,62,34,28,79
Peterhead,2026,2,23,4,9,77,39,38,73
Stirling,2026,3,17,6,13,62,52,10,57
Clyde,2026,4,15,9,12,52,48,4,54
Stenhousem'r,2026,5,15,8,13,56,48,8,53
Elgin,2026,6,14,6,16,53,63,-10,48
Annan Athlet,2026,7,11,11,14,49,44,5,44
Berwick,2026,8,8,10,18,29,59,-30,34
Edinburgh Ci,2026,9,8,9,19,37,60,-23,33
Cowdenbeath,2026,10,5,10,21,26,56,-30,25
Montrose,2027,1,24,7,5,61,34,27,79
Peterhead,2027,2,24,4,8,82,40,42,76
Stirling,2027,3,16,7,13,62,53,9,55
Stenhousem'r,2027,4,15,9,12,57,48,9,54
Clyde,2027,5,14,10,12,52,49,3,52
Elgin,2027,6,14,6,16,53,62,-9,48
Annan Athlet,2027,7,12,11,13,49,41,8,47
Berwick,2027,8,8,11,17,30,59,-29,35
Edinburgh Ci,2027,9,7,9,20,38,65,-27,30
Cowdenbeath,2027,10,4,10,22,23,56,-33,22
Peterhead,2028,1,24,4,8,82,40,42,76
Montrose,2028,2,23,7,6,61,37,24,76
Stirling,2028,3,17,6,13,62,52,10,57
Clyde,2028,4,15,9,12,54,48,6,54
Stenhousem'r,2028,5,15,8,13,56,48,8,53
Elgin,2028,6,15,6,15,56,62,-6,51
Annan Athlet,2028,7,11,12,13,47,41,6,45
Berwick,2028,8,8,10,18,29,61,-32,34
Edinburgh Ci,2028,9,7,9,20,38,65,-27,30
Cowdenbeath,2028,10,4,11,21,23,54,-31,23
Montrose,2029,1,24,7,5,63,36,27,79
Peterhead,2029,2,24,4,8,80,39,41,76
Stenhousem'r,2029,3,16,8,12,57,46,11,56
Stirling,2029,4,16,6,14,60,53,7,54
Clyde,2029,5,14,10,12,52,49,3,52
Elgin,2029,6,14,6,16,55,64,-9,48
Annan Athlet,2029,7,12,11,13,49,41,8,47
Berwick,2029,8,8,11,17,30,59,-29,35
Edinburgh Ci,2029,9,7,9,20,37,63,-26,30
Cowdenbeath,2029,10,4,10,22,23,56,-33,22
Montrose,2030,1,23,8,5,60,35,25,77
Peterhead,2030,2,23,5,8,78,39,39,74
Stirling,2030,3,16,7,13,61,52,9,55
Stenhousem'r,2030,4,15,9,12,56,47,9,54
Clyde,2030,5,14,10,12,53,50,3,52
Elgin,2030,6,14,7,15,54,61,-7,49
Annan Athlet,2030,7,12,11,13,50,42,8,47
Berwick,2030,8,8,11,17,31,60,-29,35
Edinburgh Ci,2030,9,7,10,19,37,61,-24,31
Cowdenbeath,2030,10,4,10,22,24,57,-33,22
Montrose,2031,1,24,7,5,61,34,27,79
Peterhead,2031,2,23,5,8,78,39,39,74
Stenhousem'r,2031,3,16,8,12,57,46,11,56
Stirling,2031,4,16,6,14,60,53,7,54
Clyde,2031,5,15,9,12,54,48,6,54
Elgin,2031,6,14,6,16,53,62,-9,48
Annan Athlet,2031,7,11,12,13,48,42,6,45
Berwick,2031,8,8,10,18,29,61,-32,34
Edinburgh Ci,2031,9,7,10,19,37,61,-24,31
Cowdenbeath,2031,10,4,11,21,24,55,-31,23
Montrose,2032,1,23,8,5,60,35,25,77
Peterhead,2032,2,23,4,9,78,40,38,73
Stirling,2032,3,17,6,13,64,51,13,57
Clyde,2032,4,15,9,12,55,50,5,54
Stenhousem'r,2032,5,15,8,13,55,50,5,53
Elgin,2032,6,14,7,15,54,61,-7,49
Annan Athlet,2032,7,11,11,14,48,43,5,44
Berwick,2032,8,8,10,18,31,62,-31,34
Edinburgh Ci,2032,9,8,9,19,38,61,-23,33
Cowdenbeath,2032,10,5,10,21,25,55,-30,25
Montrose,2033,1,24,7,5,61,35,26,79
Peterhead,2033,2,24,4,8,81,38,43,76
Stenhousem'r,2033,3,16,8,12,58,47,11,56
Stirling,2033,4,16,6,14,61,54,7,54
Clyde,2033,5,15,9,12,54,48,6,54
Elgin,2033,6,14,6,16,54,62,-8,48
Annan Athlet,2033,7,12,11,13,49,42,7,47
Berwick,2033,8,8,10,18,29,61,-32,34
Edinburgh Ci,2033,9,7,9,20,36,64,-28,30
Cowdenbeath,2033,10,4,10,22,24,56,-32,22
Montrose,2034,1,24,7,5,62,36,26,79
Peterhead,2034,2,24,4,8,84,40,44,76
Stenhousem'r,2034,3,16,8,12,59,47,12,56
Stirling,2034,4,16,6,14,61,55,6,54
Clyde,2034,5,14,10,12,52,49,3,52
Elgin,2034,6,14,6,16,55,63,-8,48
Annan Athlet,2034,7,12,11,13,48,41,7,47
Berwick,2034,8,8,11,17,30,59,-29,35
Edinburgh Ci,2034,9,7,9,20,38,67,-29,30
Cowdenbeath,2034,10,4,10,22,23,55,-32,22
Montrose,2035,1,24,7,5,61,35,26,79
Peterhead,2035,2,24,4,8,80,38,42,76
Stirling,2035,3,17,6,13,62,52,10,57
Clyde,2035,4,15,9,12,53,48,5,54
Stenhousem'r,2035,5,15,8,13,56,48,8,53
Elgin,2035,6,14,6,16,54,62,-8,48
Annan Athlet,2035,7,12,11,13,50,42,8,47
Berwick,2035,8,8,10,18,29,60,-31,34
Edinburgh Ci,2035,9,7,9,20,36,63,-27,30
Cowdenbeath,2035,10,4,10,22,24,57,-33,22
Montrose,2036,1,24,7,5,62,34,28,79
Peterhead,2036,2,23,5,8,77,38,39,74
Stirling,2036,3,17,6,13,62,52,10,57
Stenhousem'r,2036,4,15,8,13,56,48,8,53
Clyde,2036,5,14,9,13,51,49,2,51
Elgin,2036,6,14,6,16,53,63,-10,48
Annan Athlet,2036,7,11,11,14,47,45,2,44
Berwick,2036,8,9,10,17,30,58,-28,37
Edinburgh Ci,2036,9,7,10,19,36,60,-24,31
Cowdenbeath,2036,10,5,10,21,27,54,-27,25
Peterhead,2037,1,24,4,8,83,38,45,76
Montrose,2037,2,23,7,6,59,37,22,76
Stirling,2037,3,16,7,13,62,53,9,55
Stenhousem'r,2037,4,15,9,12,57,48,9,54
Clyde,2037,5,14,10,12,52,49,3,52
Elgin,2037,6,15,6,15,56,60,-4,51
Annan Athlet,2037,7,11,11,14,47,42,5,44
Berwick,2037,8,8,11,17,30,59,-29,35
Edinburgh Ci,2037,9,7,9,20,36,66,-30,30
Cowdenbeath,2037,10,5,10,21,24,54,-30,25
Montrose,2038,1,24,7,5,62,35,27,79
Peterhead,2038,2,24,4,8,82,39,43,76
Stirling,2038,3,16,7,13,60,51,9,55
Stenhousem'r,2038,4,15,9,12,55,46,9,54
Clyde,2038,5,14,10,12,52,49,3,52
Elgin,2038,6,14,6,16,54,63,-9,48
Annan Athlet,2038,7,11,11,14,47,42,5,44
Berwick,2038,8,8,11,17,30,59,-29,35
Edinburgh Ci,2038,9,7,9,20,37,65,-28,30
Cowdenbeath,2038,10,5,10,21,24,54,-30,25
Montrose,2039,1,24,7,5,61,35,26,79
Peterhead,2039,2,24,4,8,79,38,41,76
Stirling,2039,3,17,6,13,62,51,11,57
Clyde,2039,4,15,9,12,52,48,4,54
Stenhousem'r,2039,5,15,8,13,55,48,7,53
Elgin,2039,6,14,6,16,54,62,-8,48
Annan Athlet,2039,7,11,12,13,48,42,6,45
Berwick,2039,8,8,10,18,29,59,-30,34
Edinburgh Ci,2039,9,7,9,20,36,62,-26,30
Cowdenbeath,2039,10,4,11,21,24,55,-31,23
Montrose,2040,1,23,8,5,60,35,25,77
Peterhead,2040,2,24,4,8,81,40,41,76
Stenhousem'r,2040,3,16,8,12,58,48,10,56
Stirling,2040,4,16,6,14,62,54,8,54
Clyde,2040,5,14,10,12,52,49,3,52
Elgin,2040,6,14,7,15,54,61,-7,49
Annan Athlet,2040,7,11,12,13,48,42,6,45
Berwick,2040,8,8,11,17,30,59,-29,35
Edinburgh Ci,2040,9,7,9,20,38,64,-26,30
Cowdenbeath,2040,10,4,11,21,24,55,-31,23
Montrose,2041,1,23,8,5,59,34,25,77
Peterhead,2041,2,24,4,8,80,39,41,76
Stirling,2041,3,17,6,13,62,52,10,57
Stenhousem'r,2041,4,15,8,13,56,48,8,53
Clyde,2041,5,14,9,13,52,50,2,51
Elgin,2041,6,14,7,15,53,60,-7,49
Annan Athlet,2041,7,11,11,14,48,43,5,44
Berwick,2041,8,9,10,17,31,59,-28,37
Edinburgh Ci,2041,9,7,9,20,37,63,-26,30
Cowdenbeath,2041,10,5,10,21,25,55,-30,25
Montrose,2042,1,23,8,5,60,35,25,77
Peterhead,2042,2,24,4,8,79,38,41,76
Stenhousem'r,2042,3,16,8,12,57,47,10,56
Stirling,2042,4,16,6,14,61,53,8,54
Clyde,2042,5,14,9,13,51,49,2,51
Elgin,2042,6,14,7,15,54,61,-7,49
Annan Athlet,2042,7,11,12,13,47,41,6,45
Berwick,2042,8,9,10,17,30,58,-28,37
Edinburgh Ci,2042,9,7,9,20,36,62,-26,30
Cowdenbeath,2042,10,4,11,21,23,54,-31,23
Montrose,2043,1,23,8,5,60,35,25,77
Peterhead,2043,2,23,5,8,78,39,39,74
Stirling,2043,3,16,7,13,62,53,9,55
Stenhousem'r,2043,4,15,9,12,57,48,9,54
Clyde,2043,5,14,9,13,51,50,1,51
Elgin,2043,6,14,7,15,54,61,-7,49
Annan Athlet,2043,7,11,11,14,47,43,4,44
Berwick,2043,8,9,10,17,31,58,-27,37
Edinburgh Ci,2043,9,7,10,19,37,61,-24,31
Cowdenbeath,2043,10,5,10,21,25,54,-29,25
Montrose,2044,1,24,7,5,61,34,27,79
Peterhead,2044,2,24,4,8,79,38,41,76
Stirling,2044,3,16,7,13,61,52,9,55
Stenhousem'r,2044,4,15,9,12,56,47,9,54
Clyde,2044,5,14,9,13,51,49,2,51
Elgin,2044,6,14,6,16,53,62,-9,48
Annan Athlet,2044,7,11,11,14,47,45,2,44
Berwick,2044,8,9,10,17,30,58,-28,37
Edinburgh Ci,2044,9,7,9,20,36,62,-26,30
Cowdenbeath,2044,10,5,10,21,27,54,-27,25
Peterhead,2045,1,24,4,8,80,39,41,76
Montrose,2045,2,23,7,6,60,37,23,76
Stirling,2045,3,17,6,13,62,52,10,57
Clyde,2045,4,15,9,12,54,48,6,54
Stenhousem'r,2045,5,15,8,13,56,48,8,53
Elgin,2045,6,15,6,15,56,61,-5,51
Annan Athlet,2045,7,11,11,14,47,42,5,44
Berwick,2045,8,8,10,18,29,61,-32,34
Edinburgh Ci,2045,9,7,9,20,37,63,-26,30
Cowdenbeath,2045,10,5,10,21,24,54,-30,25
Montrose,2046,1,23,8,5,60,35,25,77
Peterhead,2046,2,24,4,8,80,39,41,76
Stirling,2046,3,17,6,13,62,51,11,57
Clyde,2046,4,15,9,12,53,48,5,54
Stenhousem'r,2046,5,15,8,13,55,48,7,53
Elgin,2046,6,14,7,15,54,61,-7,49
Annan Athlet,2046,7,11,11,14,47,42,5,44
Berwick,2046,8,8,10,18,29,60,-31,34
Edinburgh Ci,2046,9,7,9,20,37,63,-26,30
Cowdenbeath,2046,10,5,10,21,24,54,-30,25
Montrose,2047,1,23,8,5,60,35,25,77
Peterhead,2047,2,23,4,9,79,41,38,73
Stirling,2047,3,17,6,13,63,51,12,57
Clyde,2047,4,15,9,12,53,49,4,54
Stenhousem'r,2047,5,15,8,13,55,49,6,53
Elgin,2047,6,14,7,15,54,61,-7,49
Annan Athlet,2047,7,11,12,13,48,42,6,45
Berwick,2047,8,8,10,18,30,60,-30,34
Edinburgh Ci,2047,9,8,9,19,39,62,-23,33
Cowdenbeath,2047,10,4,11,21,24,55,-31,23
Peterhead,2048,1,24,4,8,80,39,41,76
Montrose,2048,2,23,7,6,60,37,23,76
Stirling,2048,3,17,6,13,61,51,10,57
Clyde,2048,4,15,9,12,53,48,5,54
Stenhousem'r,2048,5,15,8,13,55,47,8,53
Elgin,2048,6,15,6,15,56,61,-5,51
Annan Athlet,2048,7,12,11,13,49,42,7,47
Berwick,2048,8,8,10,18,29,60,-31,34
Edinburgh Ci,2048,9,7,9,20,37,63,-26,30
Cowdenbeath,2048,10,4,10,22,24,56,-32,22
Montrose,2049,1,24,7,5,62,34,28,79
Peterhead,2049,2,24,4,8,79,38,41,76
Stenhousem'r,2049,3,16,8,12,59,49,10,56
Stirling,2049,4,16,6,14,63,55,8,54
Clyde,2049,5,14,9,13,52,51,1,51
Elgin,2049,6,14,6,16,53,63,-10,48
Annan Athlet,2049,7,12,11,13,50,43,7,47
Berwick,2049,8,9,10,17,32,59,-27,37
Edinburgh Ci,2049,9,7,9,20,36,62,-26,30
Cowdenbeath,2049,10,4,10,22,25,57,-32,22
Montrose,2050,1,24,7,5,63,35,28,79
Peterhead,2050,2,24,4,8,82,40,42,76
Stirling,2050,3,17,6,13,62,51,11,57
Stenhousem'r,2050,4,15,8,13,55,48,7,53
Clyde,2050,5,14,10,12,53,50,3,52
Elgin,2050,6,14,6,16,54,64,-10,48
Annan Athlet,2050,7,11,12,13,47,41,6,45
Berwick,2050,8,8,11,17,31,60,-29,35
Edinburgh Ci,2050,9,7,9,20,38,65,-27,30
Cowdenbeath,2050,10,4,11,21,23,54,-31,23
Montrose,2051,1,23,7,6,61,37,24,76
Peterhead,2051,2,23,4,9,78,40,38,73
Stirling,2051,3,17,6,13,62,52,10,57
Stenhousem'r,2051,4,15,8,13,56,48,8,53
Clyde,2051,5,14,9,13,51,49,2,51
Elgin,2051,6,15,6,15,56,62,-6,51
Annan Athlet,2051,7,11,11,14,47,43,4,44
Berwick,2051,8,9,10,17,30,58,-28,37
Edinburgh Ci,2051,9,8,9,19,38,61,-23,33
Cowdenbeath,2051,10,5,10,21,25,54,-29,25
Montrose,2052,1,23,8,5,59,34,25,77
Peterhead,2052,2,24,4,8,80,39,41,76
Stirling,2052,3,17,6,13,63,51,12,57
Clyde,2052,4,15,9,12,53,49,4,54
Stenhousem'r,2052,5,15,8,13,55,49,6,53
Elgin,2052,6,14,7,15,53,60,-7,49
Annan Athlet,2052,7,11,11,14,47,43,4,44
Berwick,2052,8,8,10,18,30,60,-30,34
Edinburgh Ci,2052,9,7,9,20,37,63,-26,30
Cowdenbeath,2052,10,5,10,21,25,54,-29,25
Peterhead,2053,1,24,4,8,80,40,40,76
Montrose,2053,2,23,7,6,59,36,23,76
Stenhousem'r,2053,3,16,8,12,61,47,14,56
Stirling,2053,4,16,6,14,61,57,4,54
Clyde,2053,5,15,9,12,53,49,4,54
Elgin,2053,6,15,6,15,55,60,-5,51
Annan Athlet,2053,7,12,11,13,48,41,7,47
Berwick,2053,8,8,10,18,30,60,-30,34
Edinburgh Ci,2053,9,7,9,20,38,63,-25,30
Cowdenbeath,2053,10,4,10,22,23,55,-32,22
Montrose,2054,1,23,8,5,60,35,25,77
Peterhead,2054,2,23,4,9,78,40,38,73
Stirling,2054,3,17,6,13,62,52,10,57
Stenhousem'r,2054,4,15,8,13,56,48,8,53
Clyde,2054,5,14,10,12,51,48,3,52
Elgin,2054,6,14,7,15,54,61,-7,49
Annan Athlet,2054,7,11,11,14,47,42,5,44
Berwick,2054,8,8,11,17,29,58,-29,35
Edinburgh Ci,2054,9,8,9,19,38,61,-23,33
Cowdenbeath,2054,10,5,10,21,24,54,-30,25
Montrose,2055,1,24,7,5,61,35,26,79
Peterhead,2055,2,23,5,8,78,39,39,74
Stenhousem'r,2055,3,16,8,12,56,46,10,56
Stirling,2055,4,16,6,14,60,52,8,54
Clyde,2055,5,14,10,12,53,50,3,52
Elgin,2055,6,14,6,16,54,62,-8,48
Annan Athlet,2055,7,11,11,14,48,43,5,44
Berwick,2055,8,8,11,17,31,60,-29,35
Edinburgh Ci,2055,9,7,10,19,37,61,-24,31
Cowdenbeath,2055,10,5,10,21,25,55,-30,25
Peterhead,2056,1,24,4,8,79,38,41,76
Montrose,2056,2,23,7,6,59,35,24,76
Stirling,2056,3,17,6,13,61,51,10,57
Stenhousem'r,2056,4,15,8,13,55,47,8,53
Clyde,2056,5,14,10,12,52,49,3,52
Elgin,2056,6,15,6,15,54,60,-6,51
Annan Athlet,2056,7,11,12,13,48,42,6,45
Berwick,2056,8,8,11,17,30,59,-29,35
Edinburgh Ci,2056,9,7,9,20,36,62,-26,30
Cowdenbeath,2056,10,4,11,21,24,55,-31,23
Montrose,2057,1,24,7,5,61,34,27,79
Peterhead,2057,2,24,4,8,80,39,41,76
Stenhousem'r,2057,3,16,8,12,56,46,10,56
Stirling,2057,4,16,6,14,60,52,8,54
Clyde,2057,5,15,9,12,54,48,6,54
Elgin,2057,6,14,6,16,53,62,-9,48
Annan Athlet,2057,7,12,11,13,48,41,7,47
Berwick,2057,8,8,10,18,29,61,-32,34
Edinburgh Ci,2057,9,7,9,20,37,63,-26,30
Cowdenbeath,2057,10,4,10,22,23,55,-32,22
Montrose,2058,1,24,7,5,60,34,26,79
Peterhead,2058,2,23,5,8,79,40,39,74
Stirling,2058,3,16,7,13,60,51,9,55
Stenhousem'r,2058,4,15,9,12,55,46,9,54
Clyde,2058,5,14,9,13,53,52,1,51
Elgin,2058,6,14,6,16,53,61,-8,48
Annan Athlet,2058,7,12,11,13,50,41,9,47
Berwick,2058,8,9,10,17,33,60,-27,37
Edinburgh Ci,2058,9,7,10,19,38,62,-24,31
Cowdenbeath,2058,10,4,10,22,23,57,-34,22
Montrose,2059,1,24,7,5,64,34,30,79
Peterhead,2059,2,24,4,8,79,39,40,76
Stirling,2059,3,16,7,13,61,52,9,55
Stenhousem'r,2059,4,15,9,12,56,47,9,54
Clyde,2059,5,14,10,12,52,49,3,52
Elgin,2059,6,14,6,16,53,65,-12,48
Annan Athlet,2059,7,12,11,13,48,41,7,47
Berwick,2059,8,8,11,17,30,59,-29,35
Edinburgh Ci,2059,9,7,9,20,37,62,-25,30
Cowdenbeath,2059,10,4,10,22,23,55,-32,22
Montrose,2060,1,23,8,5,61,36,25,77
Peterhead,2060,2,23,5,8,77,38,39,74
Stirling,2060,3,17,6,13,61,51,10,57
Clyde,2060,4,15,9,12,55,48,7,54
Stenhousem'r,2060,5,15,8,13,55,47,8,53
Elgin,2060,6,14,7,15,55,62,-7,49
Annan Athlet,2060,7,12,11,13,48,41,7,47
Berwick,2060,8,8,10,18,29,62,-33,34
Edinburgh Ci,2060,9,7,10,19,36,60,-24,31
Cowdenbeath,2060,10,4,10,22,23,55,-32,22
Montrose,2061,1,24,7,5,63,36,27,79
Peterhead,2061,2,24,4,8,78,38,40,76
Stirling,2061,3,17,6,13,63,52,11,57
Stenhousem'r,2061,4,15,8,13,56,49,7,53
Clyde,2061,5,14,9,13,52,50,2,51
Elgin,2061,6,14,6,16,55,64,-9,48
Annan Athlet,2061,7,12,11,13,48,41,7,47
Berwick,2061,8,9,10,17,31,59,-28,37
Edinburgh Ci,2061,9,7,9,20,36,61,-25,30
Cowdenbeath,2061,10,4,10,22,23,55,-32,22
Montrose,2062,1,24,7,5,61,35,26,79
Peterhead,2062,2,24,4,8,80,40,40,76
Stirling,2062,3,17,6,13,64,52,12,57
Clyde,2062,4,15,9,12,53,48,5,54
Stenhousem'r,2062,5,15,8,13,56,50,6,53
Elgin,2062,6,14,6,16,54,62,-8,48
Annan Athlet,2062,7,11,12,13,48,42,6,45
Berwick,2062,8,8,10,18,29,60,-31,34
Edinburgh Ci,2062,9,7,9,20,38,63,-25,30
Cowdenbeath,2062,10,4,11,21,24,55,-31,23
Montrose,2063,1,24,7,5,61,35,26,79
Peterhead,2063,2,24,4,8,79,38,41,76
Stenhousem'r,2063,3,16,8,12,56,46,10,56
Stirling,2063,4,16,6,14,60,52,8,54
Clyde,2063,5,15,9,12,52,48,4,54
Elgin,2063,6,14,6,16,54,62,-8,48
Annan Athlet,2063,7,11,11,14,49,44,5,44
Berwick,2063,8,8,10,18,29,59,-30,34
Edinburgh Ci,2063,9,7,9,20,36,62,-26,30
Cowdenbeath,2063,10,5,10,21,26,56,-30,25
Montrose,2064,1,23,8,5,61,36,25,77
Peterhead,2064,2,24,4,8,80,38,42,76
Stirling,2064,3,17,6,13,62,51,11,57
Stenhousem'r,2064,4,15,8,13,55,48,7,53
Clyde,2064,5,14,9,13,52,51,1,51
Elgin,2064,6,14,7,15,55,62,-7,49
Annan Athlet,2064,7,11,11,14,47,42,5,44
Berwick,2064,8,9,10,17,32,59,-27,37
Edinburgh Ci,2064,9,7,9,20,36,63,-27,30
Cowdenbeath,2064,10,5,10,21,24,54,-30,25
Montrose,2065,1,24,7,5,62,36,26,79
Peterhead,2065,2,24,4,8,79,39,40,76
Stirling,2065,3,16,7,13,61,52,9,55
Stenhousem'r,2065,4,15,9,12,56,47,9,54
Clyde,2065,5,15,9,12,52,48,4,54
Elgin,2065,6,14,6,16,55,63,-8,48
Annan Athlet,2065,7,11,12,13,47,41,6,45
Berwick,2065,8,8,10,18,29,59,-30,34
Edinburgh Ci,2065,9,7,9,20,37,62,-25,30
Cowdenbeath,2065,10,4,11,21,23,54,-31,23
Montrose,2066,1,23,7,6,61,37,24,76
Peterhead,2066,2,23,4,9,78,40,38,73
Stenhousem'r,2066,3,16,8,12,57,46,11,56
Stirling,2066,4,16,6,14,60,53,7,54
Clyde,2066,5,15,9,12,53,48,5,54
Elgin,2066,6,15,6,15,56,62,-6,51
Annan Athlet,2066,7,11,11,14,47,42,5,44
Berwick,2066,8,8,10,18,29,60,-31,34
Edinburgh Ci,2066,9,8,9,19,38,61,-23,33
Cowdenbeath,2066,10,5,10,21,24,54,-30,25
Montrose,2067,1,24,7,5,61,35,26,79
Peterhead,2067,2,24,4,8,84,38,46,76
Stenhousem'r,2067,3,16,8,12,61,49,12,56
Stirling,2067,4,16,6,14,63,57,6,54
Clyde,2067,5,14,9,13,51,49,2,51
Elgin,2067,6,14,6,16,54,62,-8,48
Annan Athlet,2067,7,11,12,13,47,41,6,45
Berwick,2067,8,9,10,17,30,58,-28,37
Edinburgh Ci,2067,9,7,9,20,36,67,-31,30
Cowdenbeath,2067,10,4,11,21,23,54,-31,23
Montrose,2068,1,23,7,6,60,36,24,76
Peterhead,2068,2,23,4,9,77,39,38,73
Stenhousem'r,2068,3,16,8,12,57,47,10,56
Stirling,2068,4,16,6,14,61,53,8,54
Clyde,2068,5,15,9,12,56,50,6,54
Elgin,2068,6,15,6,15,55,61,-6,51
Annan Athlet,2068,7,11,11,14,48,43,5,44
Berwick,2068,8,8,10,18,31,63,-32,34
Edinburgh Ci,2068,9,8,9,19,37,60,-23,33
Cowdenbeath,2068,10,5,10,21,25,55,-30,25
Montrose,2069,1,24,7,5,61,34,27,79
Peterhead,2069,2,24,4,8,80,38,42,76
Stirling,2069,3,17,6,13,62,51,11,57
Stenhousem'r,2069,4,15,8,13,55,48,7,53
Clyde,2069,5,14,9,13,52,50,2,51
Elgin,2069,6,14,6,16,53,62,-9,48
Annan Athlet,2069,7,12,11,13,49,41,8,47
Berwick,2069,8,9,10,17,31,59,-28,37
Edinburgh Ci,2069,9,7,9,20,36,63,-27,30
Cowdenbeath,2069,10,4,10,22,23,56,-33,22
Peterhead,2070,1,24,4,8,82,40,42,76
Montrose,2070,2,23,7,6,59,35,24,76
Stirling,2070,3,16,7,13,62,53,9,55
Stenhousem'r,2070,4,15,9,12,57,48,9,54
Clyde,2070,5,15,9,12,52,48,4,54
Elgin,2070,6,15,6,15,54,60,-6,51
Annan Athlet,2070,7,11,12,13,47,41,6,45
Berwick,2070,8,8,10,18,29,59,-30,34
Edinburgh Ci,2070,9,7,9,20,38,65,-27,30
Cowdenbeath,2070,10,4,11,21,23,54,-31,23
Montrose,2071,1,24,7,5,62,36,26,79
Peterhead,2071,2,23,5,8,79,40,39,74
Stirling,2071,3,16,7,13,61,52,9,55
Stenhousem'r,2071,4,15,9,12,56,47,9,54
Clyde,2071,5,14,10,12,52,49,3,52
Elgin,2071,6,14,6,16,55,63,-8,48
Annan Athlet,2071,7,11,12,13,47,41,6,45
Berwick,2071,8,8,11,17,30,59,-29,35
Edinburgh Ci,2071,9,7,10,19,38,62,-24,31
Cowdenbeath,2071,10,4,11,21,23,54,-31,23
Montrose,2072,1,23,8,5,61,36,25,77
Peterhead,2072,2,24,4,8,80,39,41,76
Stirling,2072,3,16,7,13,61,52,9,55
Stenhousem'r,2072,4,15,9,12,56,47,9,54
Clyde,2072,5,15,9,12,54,48,6,54
Elgin,2072,6,14,7,15,55,62,-7,49
Annan Athlet,2072,7,12,11,13,49,42,7,47
Berwick,2072,8,8,10,18,29,61,-32,34
Edinburgh Ci,2072,9,7,9,20,37,63,-26,30
Cowdenbeath,2072,10,4,10,22,24,56,-32,22
Montrose,2073,1,24,7,5,61,34,27,79
Peterhead,2073,2,24,4,8,80,40,40,76
Stirling,2073,3,17,6,13,61,51,10,57
Clyde,2073,4,15,9,12,53,48,5,54
Stenhousem'r,2073,5,15,8,13,55,47,8,53
Elgin,2073,6,14,6,16,53,62,-9,48
Annan Athlet,2073,7,12,11,13,48,41,7,47
Berwick,2073,8,8,10,18,29,60,-31,34
Edinburgh Ci,2073,9,7,9,20,38,63,-25,30
Cowdenbeath,2073,10,4,10,22,23,55,-32,22
Montrose,2074,1,23,7,6,60,37,23,76
Peterhead,2074,2,23,5,8,77,38,39,74
Stirling,2074,3,17,6,13,62,52,10,57
Stenhousem'r,2074,4,15,8,13,56,48,8,53
Clyde,2074,5,14,10,12,53,50,3,52
Elgin,2074,6,15,6,15,56,61,-5,51
Annan Athlet,2074,7,11,11,14,47,43,4,44
Berwick,2074,8,8,11,17,31,60,-29,35
Edinburgh Ci,2074,9,7,10,19,36,60,-24,31
Cowdenbeath,2074,10,5,10,21,25,54,-29,25
Montrose,2075,1,24,7,5,61,35,26,79
Peterhead,2075,2,24,4,8,79,39,40,76
Stirling,2075,3,17,6,13,63,53,10,57
Stenhousem'r,2075,4,15,8,13,57,49,8,53
Clyde,2075,5,14,9,13,52,50,2,51
Elgin,2075,6,14,6,16,54,62,-8,48
Annan Athlet,2075,7,11,11,14,47,42,5,44
Berwick,2075,8,9,10,17,31,59,-28,37
Edinburgh Ci,2075,9,7,9,20,37,62,-25,30
Cowdenbeath,2075,10,5,10,21,24,54,-30,25
Montrose,2076,1,23,8,5,59,34,25,77
Peterhead,2076,2,23,5,8,78,39,39,74
Stirling,2076,3,17,6,13,62,52,10,57
Stenhousem'r,2076,4,15,8,13,56,48,8,53
Clyde,2076,5,14,9,13,51,50,1,51
Elgin,2076,6,14,7,15,53,60,-7,49
Annan Athlet,2076,7,12,11,13,49,42,7,47
Berwick,2076,8,9,10,17,31,58,-27,37
Edinburgh Ci,2076,9,7,10,19,37,61,-24,31
Cowdenbeath,2076,10,4,10,22,24,56,-32,22
Montrose,2077,1,24,7,5,62,36,26,79
Peterhead,2077,2,24,4,8,82,39,43,76
Stirling,2077,3,16,7,13,62,53,9,55
Stenhousem'r,2077,4,15,9,12,57,48,9,54
Clyde,2077,5,15,9,12,53,48,5,54
Elgin,2077,6,14,6,16,55,63,-8,48
Annan Athlet,2077,7,11,11,14,47,42,5,44
Berwick,2077,8,8,10,18,29,60,-31,34
Edinburgh Ci,2077,9,7,9,20,37,65,-28,30
Cowdenbeath,2077,10,5,10,21,24,54,-30,25
Montrose,2078,1,24,7,5,60,34,26,79
Peterhead,2078,2,24,4,8,82,40,42,76
Stirling,2078,3,16,7,13,61,52,9,55
Stenhousem'r,2078,4,15,9,12,56,47,9,54
Clyde,2078,5,15,9,12,53,49,4,54
Elgin,2078,6,14,6,16,53,61,-8,48
Annan Athlet,2078,7,11,11,14,48,43,5,44
Berwick,2078,8,8,10,18,30,60,-30,34
Edinburgh Ci,2078,9,7,9,20,38,65,-27,30
Cowdenbeath,2078,10,5,10,21,25,55,-30,25
Peterhead,2079,1,24,4,8,81,39,42,76
Montrose,2079,2,23,7,6,59,35,24,76
Stirling,2079,3,17,6,13,62,51,11,57
Clyde,2079,4,15,9,12,53,48,5,54
Stenhousem'r,2079,5,15,8,13,55,48,7,53
Elgin,2079,6,15,6,15,54,60,-6,51
Annan Athlet,2079,7,12,11,13,49,41,8,47
Berwick,2079,8,8,10,18,29,60,-31,34
Edinburgh Ci,2079,9,7,9,20,37,64,-27,30
Cowdenbeath,2079,10,4,10,22,23,56,-33,22
Montrose,2080,1,24,7,5,62,34,28,79
Peterhead,2080,2,24,4,8,82,40,42,76
Stenhousem'r,2080,3,16,8,12,57,47,10,56
Clyde,2080,4,15,9,12,58,48,10,54
Stirling,2080,5,16,6,14,61,53,8,54
Elgin,2080,6,14,6,16,53,63,-10,48
Annan Athlet,2080,7,11,11,14,47,43,4,44
Berwick,2080,8,8,10,18,29,65,-36,34
Edinburgh Ci,2080,9,7,9,20,38,65,-27,30
Cowdenbeath,2080,10,5,10,21,25,54,-29,25
Montrose,2081,1,23,8,5,61,36,25,77
Peterhead,2081,2,24,4,8,79,38,41,76
Stirling,2081,3,16,7,13,62,53,9,55
Stenhousem'r,2081,4,15,9,12,57,48,9,54
Clyde,2081,5,15,9,12,53,48,5,54
Elgin,2081,6,14,7,15,55,62,-7,49
Annan Athlet,2081,7,11,11,14,48,43,5,44
Berwick,2081,8,8,10,18,29,60,-31,34
Edinburgh Ci,2081,9,7,9,20,36,62,-26,30
Cowdenbeath,2081,10,5,10,21,25,55,-30,25
Montrose,2082,1,24,7,5,62,35,27,79
Peterhead,2082,2,24,4,8,78,38,40,76
Stirling,2082,3,17,6,13,63,51,12,57
Clyde,2082,4,15,9,12,52,48,4,54
Stenhousem'r,2082,5,15,8,13,55,49,6,53
Elgin,2082,6,14,6,16,54,63,-9,48
Annan Athlet,2082,7,11,12,13,48,42,6,45
Berwick,2082,8,8,10,18,29,59,-30,34
Edinburgh Ci,2082,9,7,9,20,36,61,-25,30
Cowdenbeath,2082,10,4,11,21,24,55,-31,23
Montrose,2083,1,23,8,5,62,37,25,77
Peterhead,2083,2,24,4,8,80,38,42,76
Stirling,2083,3,17,6,13,62,52,10,57
Stenhousem'r,2083,4,15,8,13,56,48,8,53
Clyde,2083,5,14,9,13,52,50,2,51
Elgin,2083,6,14,7,15,56,63,-7,49
Annan Athlet,2083,7,11,11,14,47,42,5,44
Berwick,2083,8,9,10,17,31,59,-28,37
Edinburgh Ci,2083,9,7,9,20,36,63,-27,30
Cowdenbeath,2083,10,5,10,21,24,54,-30,25
Montrose,2084,1,23,8,5,61,36,25,77
Peterhead,2084,2,24,4,8,82,38,44,76
Stirling,2084,3,17,6,13,63,52,11,57
Clyde,2084,4,15,9,12,54,48,6,54
Stenhousem'r,2084,5,15,8,13,56,49,7,53
Elgin,2084,6,14,7,15,55,62,-7,49
Annan Athlet,2084,7,11,12,13,48,42,6,45
Berwick,2084,8,8,10,18,29,61,-32,34
Edinburgh Ci,2084,9,7,9,20,36,65,-29,30
Cowdenbeath,2084,10,4,11,21,24,55,-31,23
Peterhead,2085,1,24,4,8,82,39,43,76
Montrose,2085,2,23,7,6,59,35,24,76
Stirling,2085,3,17,6,13,61,51,10,57
Clyde,2085,4,15,9,12,52,48,4,54
Stenhousem'r,2085,5,15,8,13,55,47,8,53
Elgin,2085,6,15,6,15,54,60,-6,51
Annan Athlet,2085,7,12,11,13,50,42,8,47
Berwick,2085,8,8,10,18,29,59,-30,34
Edinburgh Ci,2085,9,7,9,20,37,65,-28,30
Cowdenbeath,2085,10,4,10,22,24,57,-33,22
Montrose,2086,1,24,7,5,62,35,27,79
Peterhead,2086,2,24,4,8,79,38,41,76
Stirling,2086,3,16,7,13,60,51,9,55
Stenhousem'r,2086,4,15,9,12,55,46,9,54
Clyde,2086,5,15,9,12,53,48,5,54
Elgin,2086,6,14,6,16,54,63,-9,48
Annan Athlet,2086,7,11,11,14,48,43,5,44
Berwick,2086,8,8,10,18,29,60,-31,34
Edinburgh Ci,2086,9,7,9,20,36,62,-26,30
Cowdenbeath,2086,10,5,10,21,25,55,-30,25
Montrose,2087,1,24,7,5,63,34,29,79
Peterhead,2087,2,23,4,9,78,40,38,73
Stenhousem'r,2087,3,16,8,12,57,47,10,56
Stirling,2087,4,16,6,14,61,53,8,54
Clyde,2087,5,15,9,12,52,48,4,54
Elgin,2087,6,14,6,16,53,64,-11,48
Annan Athlet,2087,7,11,11,14,49,44,5,44
Berwick,2087,8,8,10,18,29,59,-30,34
Edinburgh Ci,2087,9,8,9,19,38,61,-23,33
Cowdenbeath,2087,10,5,10,21,26,56,-30,25
Montrose,2088,1,23,7,6,59,37,22,76
Peterhead,2088,2,23,4,9,78,40,38,73
Stirling,2088,3,17,6,13,64,52,12,57
Stenhousem'r,2088,4,15,8,13,56,50,6,53
Clyde,2088,5,14,10,12,52,49,3,52
Elgin,2088,6,15,6,15,56,60,-4,51
Annan Athlet,2088,7,12,11,13,52,41,11,47
Berwick,2088,8,8,11,17,30,59,-29,35
Edinburgh Ci,2088,9,8,9,19,38,61,-23,33
Cowdenbeath,2088,10,4,10,22,23,59,-36,22
Montrose,2089,1,24,7,5,62,34,28,79
Peterhead,2089,2,24,4,8,79,38,41,76
Stirling,2089,3,17,6,13,63,51,12,57
Clyde,2089,4,15,9,12,53,48,5,54
Stenhousem'r,2089,5,15,8,13,55,49,6,53
Elgin,2089,6,14,6,16,53,63,-10,48
Annan Athlet,2089,7,11,11,14,48,43,5,44
Berwick,2089,8,8,10,18,29,60,-31,34
Edinburgh Ci,2089,9,7,9,20,36,62,-26,30
Cowdenbeath,2089,10,5,10,21,25,55,-30,25
Montrose,2090,1,24,7,5,62,34,28,79
Peterhead,2090,2,24,4,8,78,38,40,76
Stirling,2090,3,17,6,13,63,51,12,57
Clyde,2090,4,15,9,12,54,49,5,54
Stenhousem'r,2090,5,15,8,13,55,49,6,53
Elgin,2090,6,14,6,16,53,63,-10,48
Annan Athlet,2090,7,12,11,13,48,41,7,47
Berwick,2090,8,8,10,18,30,61,-31,34
Edinburgh Ci,2090,9,7,9,20,36,61,-25,30
Cowdenbeath,2090,10,4,10,22,23,55,-32,22
Montrose,2091,1,23,7,6,61,38,23,76
Peterhead,2091,2,23,5,8,78,39,39,74
Stirling,2091,3,16,7,13,62,53,9,55
Stenhousem'r,2091,4,15,9,12,57,48,9,54
Clyde,2091,5,15,9,12,56,48,8,54
Elgin,2091,6,15,6,15,57,62,-5,51
Annan Athlet,2091,7,11,11,14,49,44,5,44
Berwick,2091,8,8,10,18,29,63,-34,34
Edinburgh Ci,2091,9,7,10,19,37,61,-24,31
Cowdenbeath,2091,10,5,10,21,26,56,-30,25
Montrose,2092,1,24,7,5,62,35,27,79
Peterhead,2092,2,24,4,8,81,39,42,76
Stirling,2092,3,17,6,13,64,52,12,57
Stenhousem'r,2092,4,15,8,13,56,50,6,53
Clyde,2092,5,14,10,12,53,50,3,52
Elgin,2092,6,14,6,16,54,63,-9,48
Annan Athlet,2092,7,12,11,13,49,41,8,47
Berwick,2092,8,8,11,17,31,60,-29,35
Edinburgh Ci,2092,9,7,9,20,37,64,-27,30
Cowdenbeath,2092,10,4,10,22,23,56,-33,22
Peterhead,2093,1,24,4,8,83,41,42,76
Montrose,2093,2,23,7,6,59,36,23,76
Stirling,2093,3,16,7,13,62,53,9,55
Stenhousem'r,2093,4,15,9,12,57,48,9,54
Clyde,2093,5,14,10,12,51,48,3,52
Elgin,2093,6,15,6,15,55,60,-5,51
Annan Athlet,2093,7,11,12,13,48,42,6,45
Berwick,2093,8,8,11,17,29,58,-29,35
Edinburgh Ci,2093,9,7,9,20,39,66,-27,30
Cowdenbeath,2093,10,4,11,21,24,55,-31,23
Montrose,2094,1,24,7,5,60,34,26,79
Peterhead,2094,2,24,4,8,78,38,40,76
Stirling,2094,3,16,7,13,62,53,9,55
Stenhousem'r,2094,4,15,9,12,57,48,9,54
Clyde,2094,5,14,9,13,52,50,2,51
Elgin,2094,6,14,6,16,53,61,-8,48
Annan Athlet,2094,7,11,11,14,47,45,2,44
Berwick,2094,8,9,10,17,31,59,-28,37
Edinburgh Ci,2094,9,7,9,20,36,61,-25,30
Cowdenbeath,2094,10,5,10,21,27,54,-27,25
Montrose,2095,1,24,7,5,64,36,28,79
Peterhead,2095,2,24,4,8,82,39,43,76
Stenhousem'r,2095,3,16,8,12,58,48,10,56
Stirling,2095,4,16,6,14,62,54,8,54
Clyde,2095,5,15,9,12,55,49,6,54
Elgin,2095,6,14,6,16,55,65,-10,48
Annan Athlet,2095,7,11,11,14,47,42,5,44
Berwick,2095,8,8,10,18,30,62,-32,34
Edinburgh Ci,2095,9,7,9,20,37,65,-28,30
Cowdenbeath,2095,10,5,10,21,24,54,-30,25
Peterhead,2096,1,24,4,8,81,39,42,76
Montrose,2096,2,23,7,6,59,37,22,76
Stirling,2096,3,17,6,13,61,51,10,57
Clyde,2096,4,15,9,12,53,48,5,54
Stenhousem'r,2096,5,15,8,13,55,47,8,53
Elgin,2096,6,15,6,15,56,60,-4,51
Annan Athlet,2096,7,11,11,14,47,42,5,44
Berwick,2096,8,8,10,18,29,60,-31,34
Edinburgh Ci,2096,9,7,9,20,37,64,-27,30
Cowdenbeath,2096,10,5,10,21,24,54,-30,25
Montrose,2097,1,23,7,6,62,38,24,76
Peterhead,2097,2,23,5,8,78,39,39,74
Stirling,2097,3,17,6,13,63,53,10,57
Stenhousem'r,2097,4,15,8,13,57,49,8,53
Clyde,2097,5,14,10,12,51,48,3,52
Elgin,2097,6,15,6,15,57,63,-6,51
Annan Athlet,2097,7,12,11,13,50,43,7,47
Berwick,2097,8,8,11,17,29,58,-29,35
Edinburgh Ci,2097,9,7,10,19,37,61,-24,31
Cowdenbeath,2097,10,4,10,22,25,57,-32,22
Montrose,2098,1,24,7,5,63,34,29,79
Peterhead,2098,2,23,5,8,79,40,39,74
Stirling,2098,3,16,7,13,61,52,9,55
Stenhousem'r,2098,4,15,9,12,56,47,9,54
Clyde,2098,5,14,9,13,51,49,2,51
Elgin,2098,6,14,6,16,53,64,-11,48
Annan Athlet,2098,7,11,11,14,47,42,5,44
Berwick,2098,8,9,10,17,30,58,-28,37
Edinburgh Ci,2098,9,7,10,19,38,62,-24,31
Cowdenbeath,2098,10,5,10,21,24,54,-30,25
Montrose,2099,1,23,8,5,60,35,25,77
Peterhead,2099,2,24,4,8,81,39,42,76
Stirling,2099,3,16,7,13,61,52,9,55
Stenhousem'r,2099,4,15,9,12,56,47,9,54
Clyde,2099,5,15,9,12,54,49,5,54
Elgin,2099,6,14,7,15,54,61,-7,49
Annan Athlet,2099,7,12,11,13,49,42,7,47
Berwick,2099,8,8,10,18,30,61,-31,34
Edinburgh Ci,2099,9,7,9,20,37,64,-27,30
Cowdenbeath,2099,10,4,10,22,24,56,-32,22
Montrose,2100,1,23,8,5,61,36,25,77
Peterhead,2100,2,24,4,8,79,38,41,76
Stirling,2100,3,17,6,13,63,53,10,57
Clyde,2100,4,15,9,12,53,49,4,54
Stenhousem'r,2100,5,15,8,13,57,49,8,53
Elgin,2100,6,14,7,15,55,62,-7,49
Annan Athlet,2100,7,12,11,13,48,41,7,47
Berwick,2100,8,8,10,18,30,60,-30,34
Edinburgh Ci,2100,9,7,9,20,36,62,-26,30
Cowdenbeath,2100,10,4,10,22,23,55,-32,22
Montrose,2101,1,24,7,5,62,34,28,79
Peterhead,2101,2,23,5,8,80,41,39,74
Stirling,2101,3,17,6,13,64,54,10,57
Stenhousem'r,2101,4,15,8,13,58,50,8,53
Clyde,2101,5,14,9,13,52,51,1,51
Elgin,2101,6,14,6,16,53,63,-10,48
Annan Athlet,2101,7,11,12,13,48,42,6,45
Berwick,2101,8,9,10,17,32,59,-27,37
Edinburgh Ci,2101,9,7,10,19,39,63,-24,31
Cowdenbeath,2101,10,4,11,21,24,55,-31,23
Montrose,2102,1,24,7,5,61,34,27,79
Peterhead,2102,2,24,4,8,82,39,43,76
Stirling,2102,3,17,6,13,64,52,12,57
Clyde,2102,4,15,9,12,52,48,4,54
Stenhousem'r,2102,5,15,8,13,56,50,6,53
Elgin,2102,6,14,6,16,53,62,-9,48
Annan Athlet,2102,7,11,12,13,49,43,6,45
Berwick,2102,8,8,10,18,29,59,-30,34
Edinburgh Ci,2102,9,7,9,20,37,65,-28,30
Cowdenbeath,2102,10,4,11,21,25,56,-31,23
Montrose,2103,1,23,8,5,60,35,25,77
Peterhead,2103,2,24,4,8,79,38,41,76
Stirling,2103,3,16,7,13,61,52,9,55
Stenhousem'r,2103,4,15,9,12,56,47,9,54
Clyde,2103,5,14,9,13,51,49,2,51
Elgin,2103,6,14,7,15,54,61,-7,49
Annan Athlet,2103,7,11,12,13,48,42,6,45
Berwick,2103,8,9,10,17,30,58,-28,37
Edinburgh Ci,2103,9,7,9,20,36,62,-26,30
Cowdenbeath,2103,10,4,11,21,24,55,-31,23
Montrose,2104,1,24,7,5,62,34,28,79
Peterhead,2104,2,23,5,8,79,40,39,74
Stirling,2104,3,17,6,13,63,53,10,57
Stenhousem'r,2104,4,15,8,13,57,49,8,53
Clyde,2104,5,14,9,13,51,50,1,51
Elgin,2104,6,14,6,16,53,63,-10,48
Annan Athlet,2104,7,11,12,13,47,41,6,45
Berwick,2104,8,9,10,17,31,58,-27,37
Edinburgh Ci,2104,9,7,10,19,38,62,-24,31
Cowdenbeath,2104,10,4,11,21,23,54,-31,23
Peterhead,2105,1,24,4,8,82,38,44,76
Montrose,2105,2,23,7,6,60,36,24,76
Stenhousem'r,2105,3,16,8,12,57,47,10,56
Stirling,2105,4,16,6,14,61,53,8,54
Clyde,2105,5,15,9,12,53,48,5,54
Elgin,2105,6,15,6,15,55,61,-6,51
Annan Athlet,2105,7,12,11,13,49,42,7,47
Berwick,2105,8,8,10,18,29,60,-31,34
Edinburgh Ci,2105,9,7,9,20,36,65,-29,30
Cowdenbeath,2105,10,4,10,22,24,56,-32,22
Montrose,2106,1,23,8,5,62,37,25,77
Peterhead,2106,2,24,4,8,82,38,44,76
Stenhousem'r,2106,3,16,8,12,58,47,11,56
Stirling,2106,4,16,6,14,61,54,7,54
Clyde,2106,5,15,9,12,54,49,5,54
Elgin,2106,6,14,7,15,56,63,-7,49
Annan Athlet,2106,7,11,12,13,49,43,6,45
Berwick,2106,8,8,10,18,30,61,-31,34
Edinburgh Ci,2106,9,7,9,20,36,65,-29,30
Cowdenbeath,2106,10,4,11,21,25,56,-31,23
Montrose,2107,1,24,7,5,62,34,28,79
Peterhead,2107,2,24,4,8,81,39,42,76
Stirling,2107,3,17,6,13,65,52,13,57
Stenhousem'r,2107,4,15,8,13,56,51,5,53
Clyde,2107,5,14,9,13,52,50,2,51
Elgin,2107,6,14,6,16,53,63,-10,48
Annan Athlet,2107,7,12,11,13,49,42,7,47
Berwick,2107,8,9,10,17,31,59,-28,37
Edinburgh Ci,2107,9,7,9,20,37,64,-27,30
Cowdenbeath,2107,10,4,10,22,24,56,-32,22
Montrose,2108,1,23,8,5,60,35,25,77
Peterhead,2108,2,24,4,8,82,39,43,76
Stenhousem'r,2108,3,16,8,12,57,46,11,56
Stirling,2108,4,16,6,14,60,53,7,54
Clyde,2108,5,14,9,13,51,49,2,51
Elgin,2108,6,14,7,15,54,61,-7,49
Annan Athlet,2108,7,11,11,14,47,43,4,44
Berwick,2108,8,9,10,17,30,58,-28,37
Edinburgh Ci,2108,9,7,9,20,37,65,-28,30
Cowdenbeath,2108,10,5,10,21,25,54,-29,25
Montrose,2109,1,24,7,5,62,34,28,79
Peterhead,2109,2,23,4,9,77,40,37,73
Stirling,2109,3,17,6,13,65,52,13,57
Stenhousem'r,2109,4,15,8,13,56,51,5,53
Clyde,2109,5,14,10,12,52,49,3,52
Elgin,2109,6,14,6,16,53,63,-10,48
Annan Athlet,2109,7,11,12,13,48,42,6,45
Berwick,2109,8,8,11,17,30,59,-29,35
Edinburgh Ci,2109,9,8,9,19,38,60,-22,33
Cowdenbeath,2109,10,4,11,21,24,55,-31,23
Montrose,2110,1,24,7,5,61,35,26,79
Peterhead,2110,2,24,4,8,83,39,44,76
Stirling,2110,3,16,7,13,60,51,9,55
Stenhousem'r,2110,4,15,9,12,55,46,9,54
Clyde,2110,5,15,9,12,52,48,4,54
Elgin,2110,6,14,6,16,54,62,-8,48
Annan Athlet,2110,7,11,12,13,49,43,6,45
Berwick,2110,8,8,10,18,29,59,-30,34
Edinburgh Ci,2110,9,7,9,20,37,66,-29,30
Cowdenbeath,2110,10,4,11,21,25,56,-31,23
Montrose,2111,1,23,7,6,60,36,24,76
Peterhead,2111,2,23,5,8,78,39,39,74
Stirling,2111,3,17,6,13,63,51,12,57
Stenhousem'r,2111,4,15,8,13,55,49,6,53
Clyde,2111,5,14,9,13,52,50,2,51
Elgin,2111,6,15,6,15,55,61,-6,51
Annan Athlet,2111,7,11,12,13,48,42,6,45
Berwick,2111,8,9,10,17,31,59,-28,37
Edinburgh Ci,2111,9,7,10,19,37,61,-24,31
Cowdenbeath,2111,10,4,11,21,24,55,-31,23
Montrose,2112,1,24,7,5,61,34,27,79
Peterhead,2112,2,24,4,8,80,38,42,76
Stirling,2112,3,16,7,13,61,52,9,55
Stenhousem'r,2112,4,15,9,12,56,47,9,54
Clyde,2112,5,14,10,12,53,50,3,52
Elgin,2112,6,14,6,16,53,62,-9,48
Annan Athlet,2112,7,11,11,14,47,42,5,44
Berwick,2112,8,8,11,17,31,60,-29,35
Edinburgh Ci,2112,9,7,9,20,36,63,-27,30
Cowdenbeath,2112,10,5,10,21,24,54,-30,25
Montrose,2113,1,24,7,5,60,34,26,79
Peterhead,2113,2,24,4,8,80,38,42,76
Stenhousem'r,2113,3,16,8,12,56,46,10,56
Stirling,2113,4,16,6,14,60,52,8,54
Clyde,2113,5,14,10,12,52,49,3,52
Elgin,2113,6,14,6,16,53,61,-8,48
Annan Athlet,2113,7,11,12,13,47,41,6,45
Berwick,2113,8,8,11,17,30,59,-29,35
Edinburgh Ci,2113,9,7,9,20,36,63,-27,30
Cowdenbeath,2113,10,4,11,21,23,54,-31,23
Montrose,2114,1,24,7,5,62,35,27,79
Peterhead,2114,2,24,4,8,81,38,43,76
Stenhousem'r,2114,3,16,8,12,57,47,10,56
Stirling,2114,4,16,6,14,61,53,8,54
Clyde,2114,5,14,10,12,53,50,3,52
Elgin,2114,6,14,6,16,54,63,-9,48
Annan Athlet,2114,7,11,12,13,48,42,6,45
Berwick,2114,8,8,11,17,31,60,-29,35
Edinburgh Ci,2114,9,7,9,20,36,64,-28,30
Cowdenbeath,2114,10,4,11,21,24,55,-31,23
Montrose,2115,1,24,7,5,63,35,28,79
Peterhead,2115,2,23,5,8,79,40,39,74
Stenhousem'r,2115,3,16,8,12,57,46,11,56
Stirling,2115,4,16,6,14,60,53,7,54
Clyde,2115,5,14,10,12,53,50,3,52
Elgin,2115,6,14,6,16,54,64,-10,48
Annan Athlet,2115,7,11,12,13,47,41,6,45
Berwick,2115,8,8,11,17,31,60,-29,35
Edinburgh Ci,2115,9,7,10,19,38,62,-24,31
Cowdenbeath,2115,10,4,11,21,23,54,-31,23
Montrose,2116,1,23,8,5,59,34,25,77
Peterhead,2116,2,23,5,8,78,39,39,74
Stirling,2116,3,17,6,13,63,51,12,57
Clyde,2116,4,15,9,12,52,48,4,54
Stenhousem'r,2116,5,15,8,13,55,49,6,53
Elgin,2116,6,14,7,15,53,60,-7,49
Annan Athlet,2116,7,11,12,13,47,41,6,45
Berwick,2116,8,8,10,18,29,59,-30,34
Edinburgh Ci,2116,9,7,10,19,37,61,-24,31
Cowdenbeath,2116,10,4,11,21,23,54,-31,23
Montrose,2117,1,23,8,5,60,35,25,77
Peterhead,2117,2,24,4,8,79,38,41,76
Stirling,2117,3,16,7,13,61,52,9,55
Stenhousem'r,2117,4,15,9,12,56,47,9,54
Clyde,2117,5,15,9,12,53,49,4,54
Elgin,2117,6,14,7,15,54,61,-7,49
Annan Athlet,2117,7,12,11,13,51,44,7,47
Berwick,2117,8,8,10,18,30,60,-30,34
Edinburgh Ci,2117,9,7,9,20,36,62,-26,30
Cowdenbeath,2117,10,4,10,22,26,58,-32,22
Montrose,2118,1,23,8,5,60,35,25,77
Peterhead,2118,2,24,4,8,82,39,43,76
Stenhousem'r,2118,3,16,8,12,56,46,10,56
Stirling,2118,4,16,6,14,60,52,8,54
Clyde,2118,5,15,9,12,53,48,5,54
Elgin,2118,6,14,7,15,54,61,-7,49
Annan Athlet,2118,7,12,11,13,50,41,9,47
Berwick,2118,8,8,10,18,29,60,-31,34
Edinburgh Ci,2118,9,7,9,20,37,65,-28,30
Cowdenbeath,2118,10,4,10,22,23,57,-34,22
Montrose,2119,1,23,8,5,60,35,25,77
Peterhead,2119,2,24,4,8,80,38,42,76
Stenhousem'r,2119,3,16,8,12,58,47,11,56
Stirling,2119,4,16,6,14,61,54,7,54
Clyde,2119,5,15,9,12,53,49,4,54
Elgin,2119,6,14,7,15,54,61,-7,49
Annan Athlet,2119,7,12,11,13,48,41,7,47
Berwick,2119,8,8,10,18,30,60,-30,34
Edinburgh Ci,2119,9,7,9,20,36,63,-27,30
Cowdenbeath,2119,10,4,10,22,23,55,-32,22
Montrose,2120,1,24,7,5,62,35,27,79
Peterhead,2120,2,24,4,8,79,39,40,76
Stirling,2120,3,17,6,13,64,52,12,57
Stenhousem'r,2120,4,15,8,13,56,50,6,53
Clyde,2120,5,14,9,13,52,50,2,51
Elgin,2120,6,14,6,16,54,63,-9,48
Annan Athlet,2120,7,11,11,14,47,43,4,44
Berwick,2120,8,9,10,17,31,59,-28,37
Edinburgh Ci,2120,9,7,9,20,37,62,-25,30
Cowdenbeath,2120,10,5,10,21,25,54,-29,25
Montrose,2121,1,24,7,5,62,36,26,79
Peterhead,2121,2,24,4,8,81,38,43,76
Stenhousem'r,2121,3,16,8,12,59,46,13,56
Stirling,2121,4,16,6,14,60,55,5,54
Clyde,2121,5,14,10,12,51,48,3,52
Elgin,2121,6,14,6,16,55,63,-8,48
Annan Athlet,2121,7,11,12,13,48,42,6,45
Berwick,2121,8,8,11,17,29,58,-29,35
Edinburgh Ci,2121,9,7,9,20,36,64,-28,30
Cowdenbeath,2121,10,4,11,21,24,55,-31,23
Montrose,2122,1,24,7,5,60,34,26,79
Peterhead,2122,2,24,4,8,80,40,40,76
Stenhousem'r,2122,3,16,8,12,58,47,11,56
Stirling,2122,4,16,6,14,61,54,7,54
Clyde,2122,5,14,9,13,53,52,1,51
Elgin,2122,6,14,6,16,53,61,-8,48
Annan Athlet,2122,7,12,11,13,48,41,7,47
Berwick,2122,8,9,10,17,33,60,-27,37
Edinburgh Ci,2122,9,7,9,20,38,63,-25,30
Cowdenbeath,2122,10,4,10,22,23,55,-32,22
Montrose,2123,1,24,7,5,61,35,26,79
Peterhead,2123,2,23,4,9,77,39,38,73
Stenhousem'r,2123,3,16,8,12,58,47,11,56
Stirling,2123,4,16,6,14,61,54,7,54
Clyde,2123,5,14,9,13,51,50,1,51
Elgin,2123,6,14,6,16,54,62,-8,48
Annan Athlet,2123,7,12,11,13,48,41,7,47
Berwick,2123,8,9,10,17,31,58,-27,37
Edinburgh Ci,2123,9,8,9,19,37,60,-23,33
Cowdenbeath,2123,10,4,10,22,23,55,-32,22
Montrose,2124,1,24,7,5,61,35,26,79
Peterhead,2124,2,24,4,8,81,38,43,76
Stirling,2124,3,16,7,13,61,52,9,55
Stenhousem'r,2124,4,15,9,12,56,47,9,54
Clyde,2124,5,14,10,12,53,50,3,52
Elgin,2124,6,14,6,16,54,62,-8,48
Annan Athlet,2124,7,12,11,13,48,41,7,47
Berwick,2124,8,8,11,17,31,60,-29,35
Edinburgh Ci,2124,9,7,9,20,36,64,-28,30
Cowdenbeath,2124,10,4,10,22,23,55,-32,22
Montrose,2125,1,24,7,5,61,34,27,79
Peterhead,2125,2,24,4,8,78,38,40,76
Stenhousem'r,2125,3,16,8,12,57,47,10,56
Stirling,2125,4,16,6,14,61,53,8,54
Clyde,2125,5,14,9,13,52,50,2,51
Elgin,2125,6,14,6,16,53,62,-9,48
Annan Athlet,2125,7,11,11,14,48,43,5,44
Berwick,2125,8,9,10,17,31,59,-28,37
Edinburgh Ci,2125,9,7,9,20,36,61,-25,30
Cowdenbeath,2125,10,5,10,21,25,55,-30,25
Montrose,2126,1,24,7,5,61,35,26,79
Peterhead,2126,2,24,4,8,79,38,41,76
Stenhousem'r,2126,3,16,8,12,58,48,10,56
Stirling,2126,4,16,6,14,62,54,8,54
Clyde,2126,5,15,9,12,53,49,4,54
Elgin,2126,6,14,6,16,54,62,-8,48
Annan Athlet,2126,7,12,11,13,49,41,8,47
Berwick,2126,8,8,10,18,30,60,-30,34
Edinburgh Ci,2126,9,7,9,20,36,62,-26,30
Cowdenbeath,2126,10,4,10,22,23,56,-33,22
Peterhead,2127,1,24,4,8,79,38,41,76
Montrose,2127,2,23,7,6,60,37,23,76
Stirling,2127,3,17,6,13,61,51,10,57
Clyde,2127,4,15,9,12,54,49,5,54
Stenhousem'r,2127,5,15,8,13,55,47,8,53
Elgin,2127,6,15,6,15,56,61,-5,51
Annan Athlet,2127,7,11,11,14,47,42,5,44
Berwick,2127,8,8,10,18,30,61,-31,34
Edinburgh Ci,2127,9,7,9,20,36,62,-26,30
Cowdenbeath,2127,10,5,10,21,24,54,-30,25
Montrose,2128,1,24,7,5,62,35,27,79
Peterhead,2128,2,24,4,8,82,38,44,76
Stenhousem'r,2128,3,16,8,12,60,46,14,56
Stirling,2128,4,16,6,14,60,56,4,54
Clyde,2128,5,14,10,12,51,48,3,52
Elgin,2128,6,14,6,16,54,63,-9,48
Annan Athlet,2128,7,11,11,14,47,43,4,44
Berwick,2128,8,8,11,17,29,58,-29,35
Edinburgh Ci,2128,9,7,9,20,36,65,-29,30
Cowdenbeath,2128,10,5,10,21,25,54,-29,25
Peterhead,2129,1,24,4,8,79,38,41,76
Montrose,2129,2,23,7,6,59,36,23,76
Stenhousem'r,2129,3,16,8,12,56,46,10,56
Stirling,2129,4,16,6,14,60,52,8,54
Clyde,2129,5,15,9,12,52,48,4,54
Elgin,2129,6,15,6,15,55,60,-5,51
Annan Athlet,2129,7,11,12,13,48,42,6,45
Berwick,2129,8,8,10,18,29,59,-30,34
Edinburgh Ci,2129,9,7,9,20,36,62,-26,30
Cowdenbeath,2129,10,4,11,21,24,55,-31,23
Montrose,2130,1,24,7,5,62,34,28,79
Peterhead,2130,2,24,4,8,79,38,41,76
Stirling,2130,3,17,6,13,63,53,10,57
Clyde,2130,4,15,9,12,53,49,4,54
Stenhousem'r,2130,5,15,8,13,57,49,8,53
Elgin,2130,6,14,6,16,53,63,-10,48
Annan Athlet,2130,7,11,11,14,48,44,4,44
Berwick,2130,8,8,10,18,30,60,-30,34
Edinburgh Ci,2130,9,7,9,20,36,62,-26,30
Cowdenbeath,2130,10,5,10,21,26,55,-29,25
Peterhead,2131,1,24,4,8,80,40,40,76
Montrose,2131,2,23,7,6,59,35,24,76
Stirling,2131,3,16,7,13,61,52,9,55
Stenhousem'r,2131,4,15,9,12,56,47,9,54
Clyde,2131,5,15,9,12,54,48,6,54
Elgin,2131,6,15,6,15,54,60,-6,51
Annan Athlet,2131,7,11,11,14,47,42,5,44
Berwick,2131,8,8,10,18,29,61,-32,34
Edinburgh Ci,2131,9,7,9,20,38,63,-25,30
Cowdenbeath,2131,10,5,10,21,24,54,-30,25
Peterhead,2132,1,24,4,8,81,39,42,76
Montrose,2132,2,23,7,6,60,36,24,76
Stenhousem'r,2132,3,16,8,12,56,46,10,56
Stirling,2132,4,16,6,14,60,52,8,54
Clyde,2132,5,15,9,12,55,49,6,54
Elgin,2132,6,15,6,15,55,61,-6,51
Annan Athlet,2132,7,11,12,13,48,42,6,45
Berwick,2132,8,8,10,18,30,62,-32,34
Edinburgh Ci,2132,9,7,9,20,37,64,-27,30
Cowdenbeath,2132,10,4,11,21,24,55,-31,23
Montrose,2133,1,24,7,5,60,34,26,79
Peterhead,2133,2,23,4,9,78,40,38,73
Stirling,2133,3,17,6,13,61,51,10,57
Clyde,2133,4,15,9,12,55,49,6,54
Stenhousem'r,2133,5,15,8,13,55,47,8,53
Elgin,2133,6,14,6,16,53,61,-8,48
Annan Athlet,2133,7,11,11,14,47,43,4,44
Berwick,2133,8,8,10,18,30,62,-32,34
Edinburgh Ci,2133,9,8,9,19,38,61,-23,33
Cowdenbeath,2133,10,5,10,21,25,54,-29,25
Montrose,2134,1,23,8,5,61,36,25,77
Peterhead,2134,2,23,5,8,79,40,39,74
Stirling,2134,3,17,6,13,62,51,11,57
Clyde,2134,4,15,9,12,52,48,4,54
Stenhousem'r,2134,5,15,8,13,55,48,7,53
Elgin,2134,6,14,7,15,55,62,-7,49
Annan Athlet,2134,7,12,11,13,51,43,8,47
Berwick,2134,8,8,10,18,29,59,-30,34
Edinburgh Ci,2134,9,7,10,19,38,62,-24,31
Cowdenbeath,2134,10,4,10,22,25,58,-33,22
Montrose,2135,1,24,7,5,61,34,27,79
Peterhead,2135,2,24,4,8,82,38,44,76
Stirling,2135,3,17,6,13,65,52,13,57
Stenhousem'r,2135,4,15,8,13,56,51,5,53
Clyde,2135,5,14,10,12,52,49,3,52
Elgin,2135,6,14,6,16,53,62,-9,48
Annan Athlet,2135,7,11,11,14,47,42,5,44
Berwick,2135,8,8,11,17,30,59,-29,35
Edinburgh Ci,2135,9,7,9,20,36,65,-29,30
Cowdenbeath,2135,10,5,10,21,24,54,-30,25
Montrose,2136,1,24,7,5,62,35,27,79
Peterhead,2136,2,23,4,9,78,40,38,73
Stenhousem'r,2136,3,16,8,12,57,47,10,56
Stirling,2136,4,16,6,14,61,53,8,54
Clyde,2136,5,14,10,12,51,48,3,52
Elgin,2136,6,14,6,16,54,63,-9,48
Annan Athlet,2136,7,11,11,14,47,43,4,44
Berwick,2136,8,8,11,17,29,58,-29,35
Edinburgh Ci,2136,9,8,9,19,38,61,-23,33
Cowdenbeath,2136,10,5,10,21,25,54,-29,25
Montrose,2137,1,23,8,5,59,34,25,77
Peterhead,2137,2,24,4,8,78,38,40,76
Stirling,2137,3,17,6,13,61,51,10,57
Clyde,2137,4,15,9,12,52,48,4,54
Stenhousem'r,2137,5,15,8,13,55,47,8,53
Elgin,2137,6,14,7,15,53,60,-7,49
Annan Athlet,2137,7,12,11,13,49,42,7,47
Berwick,2137,8,8,10,18,29,59,-30,34
Edinburgh Ci,2137,9,7,9,20,36,61,-25,30
Cowdenbeath,2137,10,4,10,22,24,56,-32,22
Montrose,2138,1,23,8,5,59,34,25,77
Peterhead,2138,2,23,5,8,77,38,39,74
Stirling,2138,3,17,6,13,62,51,11,57
Stenhousem'r,2138,4,15,8,13,55,48,7,53
Clyde,2138,5,14,10,12,52,49,3,52
Elgin,2138,6,14,7,15,53,60,-7,49
Annan Athlet,2138,7,12,11,13,49,42,7,47
Berwick,2138,8,8,11,17,30,59,-29,35
Edinburgh Ci,2138,9,7,10,19,36,60,-24,31
Cowdenbeath,2138,10,4,10,22,24,56,-32,22
Montrose,2139,1,23,7,6,62,38,24,76
Peterhead,2139,2,23,4,9,77,39,38,73
Stenhousem'r,2139,3,16,8,12,57,47,10,56
Stirling,2139,4,16,6,14,61,53,8,54
Clyde,2139,5,15,9,12,53,48,5,54
Elgin,2139,6,15,6,15,57,63,-6,51
Annan Athlet,2139,7,11,12,13,49,43,6,45
Berwick,2139,8,8,10,18,29,60,-31,34
Edinburgh Ci,2139,9,8,9,19,37,60,-23,33
Cowdenbeath,2139,10,4,11,21,25,56,-31,23
Montrose,2140,1,23,8,5,61,36,25,77
Peterhead,2140,2,23,5,8,77,38,39,74
Stirling,2140,3,17,6,13,62,52,10,57
Clyde,2140,4,15,9,12,55,48,7,54
Stenhousem'r,2140,5,15,8,13,56,48,8,53
Elgin,2140,6,14,7,15,55,62,-7,49
Annan Athlet,2140,7,11,11,14,48,43,5,44
Berwick,2140,8,8,10,18,29,62,-33,34
Edinburgh Ci,2140,9,7,10,19,36,60,-24,31
Cowdenbeath,2140,10,5,10,21,25,55,-30,25
Montrose,2141,1,24,7,5,60,34,26,79
Peterhead,2141,2,24,4,8,80,38,42,76
Stenhousem'r,2141,3,16,8,12,56,46,10,56
Stirling,2141,4,16,6,14,60,52,8,54
Clyde,2141,5,15,9,12,53,48,5,54
Elgin,2141,6,14,6,16,53,61,-8,48
Annan Athlet,2141,7,11,11,14,49,44,5,44
Berwick,2141,8,8,10,18,29,60,-31,34
Edinburgh Ci,2141,9,7,9,20,36,63,-27,30
Cowdenbeath,2141,10,5,10,21,26,56,-30,25
Montrose,2142,1,24,7,5,60,34,26,79
Peterhead,2142,2,24,4,8,80,39,41,76
Stenhousem'r,2142,3,16,8,12,58,46,12,56
Stirling,2142,4,16,6,14,60,54,6,54
Clyde,2142,5,14,9,13,51,49,2,51
Elgin,2142,6,14,6,16,53,61,-8,48
Annan Athlet,2142,7,12,11,13,48,41,7,47
Berwick,2142,8,9,10,17,30,58,-28,37
Edinburgh Ci,2142,9,7,9,20,37,63,-26,30
Cowdenbeath,2142,10,4,10,22,23,55,-32,22
Montrose,2143,1,24,7,5,62,34,28,79
Peterhead,2143,2,24,4,8,81,39,42,76
Stirling,2143,3,17,6,13,62,51,11,57
Stenhousem'r,2143,4,15,8,13,55,48,7,53
Clyde,2143,5,14,10,12,51,48,3,52
Elgin,2143,6,14,6,16,53,63,-10,48
Annan Athlet,2143,7,11,11,14,47,43,4,44
Berwick,2143,8,8,11,17,29,58,-29,35
Edinburgh Ci,2143,9,7,9,20,37,64,-27,30
Cowdenbeath,2143,10,5,10,21,25,54,-29,25
Montrose,2144,1,24,7,5,61,34,27,79
Peterhead,2144,2,24,4,8,79,39,40,76
Stirling,2144,3,16,7,13,62,53,9,55
Stenhousem'r,2144,4,15,9,12,57,48,9,54
Clyde,2144,5,15,9,12,52,48,4,54
Elgin,2144,6,14,6,16,53,62,-9,48
Annan Athlet,2144,7,11,11,14,49,44,5,44
Berwick,2144,8,8,10,18,29,59,-30,34
Edinburgh Ci,2144,9,7,9,20,37,62,-25,30
Cowdenbeath,2144,10,5,10,21,26,56,-30,25
Montrose,2145,1,23,8,5,60,35,25,77
Peterhead,2145,2,24,4,8,79,38,41,76
Stirling,2145,3,17,6,13,64,51,13,57
Clyde,2145,4,15,9,12,56,49,7,54
Stenhousem'r,2145,5,15,8,13,55,50,5,53
Elgin,2145,6,14,7,15,54,61,-7,49
Annan Athlet,2145,7,12,11,13,49,41,8,47
Berwick,2145,8,8,10,18,30,63,-33,34
Edinburgh Ci,2145,9,7,9,20,36,62,-26,30
Cowdenbeath,2145,10,4,10,22,23,56,-33,22
Peterhead,2146,1,24,4,8,82,39,43,76
Montrose,2146,2,23,7,6,60,36,24,76
Stirling,2146,3,17,6,13,63,52,11,57
Stenhousem'r,2146,4,15,8,13,56,49,7,53
Clyde,2146,5,14,10,12,51,48,3,52
Elgin,2146,6,15,6,15,55,61,-6,51
Annan Athlet,2146,7,12,11,13,52,41,11,47
Berwick,2146,8,8,11,17,29,58,-29,35
Edinburgh Ci,2146,9,7,9,20,37,65,-28,30
Cowdenbeath,2146,10,4,10,22,23,59,-36,22
Montrose,2147,1,24,7,5,60,34,26,79
Peterhead,2147,2,24,4,8,78,38,40,76
Stirling,2147,3,17,6,13,65,52,13,57
Stenhousem'r,2147,4,15,8,13,56,51,5,53
Clyde,2147,5,14,10,12,53,50,3,52
Elgin,2147,6,14,6,16,53,61,-8,48
Annan Athlet,2147,7,11,12,13,48,42,6,45
Berwick,2147,8,8,11,17,31,60,-29,35
Edinburgh Ci,2147,9,7,9,20,36,61,-25,30
Cowdenbeath,2147,10,4,11,21,24,55,-31,23
Montrose,2148,1,23,7,6,59,35,24,76
Peterhead,2148,2,23,5,8,79,40,39,74
Stenhousem'r,2148,3,16,8,12,57,47,10,56
Stirling,2148,4,16,6,14,61,53,8,54
Clyde,2148,5,15,9,12,53,48,5,54
Elgin,2148,6,15,6,15,54,60,-6,51
Annan Athlet,2148,7,12,11,13,49,41,8,47
Berwick,2148,8,8,10,18,29,60,-31,34
Edinburgh Ci,2148,9,7,10,19,38,62,-24,31
Cowdenbeath,2148,10,4,10,22,23,56,-33,22
Montrose,2149,1,23,8,5,61,36,25,77
Peterhead,2149,2,24,4,8,83,38,45,76
Stirling,2149,3,17,6,13,61,51,10,57
Stenhousem'r,2149,4,15,8,13,55,47,8,53
Clyde,2149,5,14,10,12,53,50,3,52
Elgin,2149,6,14,7,15,55,62,-7,49
Annan Athlet,2149,7,12,11,13,50,41,9,47
Berwick,2149,8,8,11,17,31,60,-29,35
Edinburgh Ci,2149,9,7,9,20,36,66,-30,30
Cowdenbeath,2149,10,4,10,22,23,57,-34,22
Montrose,2150,1,24,7,5,64,34,30,79
Peterhead,2150,2,24,4,8,81,39,42,76
Stirling,2150,3,16,7,13,61,52,9,55
Stenhousem'r,2150,4,15,9,12,56,47,9,54
Clyde,2150,5,14,10,12,53,50,3,52
Elgin,2150,6,14,6,16,53,65,-12,48
Annan Athlet,2150,7,12,11,13,49,41,8,47
Berwick,2150,8,8,11,17,31,60,-29,35
Edinburgh Ci,2150,9,7,9,20,37,64,-27,30
Cowdenbeath,2150,10,4,10,22,23,56,-33,22
Montrose,2151,1,23,8,5,62,37,25,77
Peterhead,2151,2,24,4,8,79,38,41,76
Stenhousem'r,2151,3,16,8,12,57,46,11,56
Stirling,2151,4,16,6,14,60,53,7,54
Clyde,2151,5,14,9,13,51,50,1,51
Elgin,2151,6,14,7,15,56,63,-7,49
Annan Athlet,2151,7,11,11,14,47,43,4,44
Berwick,2151,8,9,10,17,31,58,-27,37
Edinburgh Ci,2151,9,7,9,20,36,62,-26,30
Cowdenbeath,2151,10,5,10,21,25,54,-29,25
Peterhead,2152,1,24,4,8,79,39,40,76
Montrose,2152,2,23,7,6,60,37,23,76
Stenhousem'r,2152,3,16,8,12,57,47,10,56
Stirling,2152,4,16,6,14,61,53,8,54
Clyde,2152,5,15,9,12,53,48,5,54
Elgin,2152,6,15,6,15,56,61,-5,51
Annan Athlet,2152,7,12,11,13,49,41,8,47
Berwick,2152,8,8,10,18,29,60,-31,34
Edinburgh Ci,2152,9,7,9,20,37,62,-25,30
Cowdenbeath,2152,10,4,10,22,23,56,-33,22
Montrose,2153,1,24,7,5,62,35,27,79
Peterhead,2153,2,24,4,8,79,39,40,76
Stenhousem'r,2153,3,16,8,12,56,46,10,56
Stirling,2153,4,16,6,14,60,52,8,54
Clyde,2153,5,14,10,12,53,50,3,52
Elgin,2153,6,14,6,16,54,63,-9,48
Annan Athlet,2153,7,12,11,13,53,41,12,47
Berwick,2153,8,8,11,17,31,60,-29,35
Edinburgh Ci,2153,9,7,9,20,37,62,-25,30
Cowdenbeath,2153,10,4,10,22,23,60,-37,22
Montrose,2154,1,23,8,5,61,36,25,77
Peterhead,2154,2,23,4,9,79,41,38,73
Stirling,2154,3,16,7,13,61,52,9,55
Stenhousem'r,2154,4,15,9,12,56,47,9,54
Clyde,2154,5,14,10,12,52,49,3,52
Elgin,2154,6,14,7,15,55,62,-7,49
Annan Athlet,2154,7,11,12,13,48,42,6,45
Berwick,2154,8,8,11,17,30,59,-29,35
Edinburgh Ci,2154,9,8,9,19,39,62,-23,33
Cowdenbeath,2154,10,4,11,21,24,55,-31,23
Montrose,2155,1,24,7,5,61,34,27,79
Peterhead,2155,2,24,4,8,82,40,42,76
Stirling,2155,3,17,6,13,63,52,11,57
Clyde,2155,4,15,9,12,55,50,5,54
Stenhousem'r,2155,5,15,8,13,56,49,7,53
Elgin,2155,6,14,6,16,53,62,-9,48
Annan Athlet,2155,7,11,12,13,47,41,6,45
Berwick,2155,8,8,10,18,31,62,-31,34
Edinburgh Ci,2155,9,7,9,20,38,65,-27,30
Cowdenbeath,2155,10,4,11,21,23,54,-31,23
Montrose,2156,1,24,7,5,61,34,27,79
Peterhead,2156,2,24,4,8,80,39,41,76
Stirling,2156,3,16,7,13,61,52,9,55
Stenhousem'r,2156,4,15,9,12,56,47,9,54
Clyde,2156,5,14,9,13,52,50,2,51
Elgin,2156,6,14,6,16,53,62,-9,48
Annan Athlet,2156,7,11,12,13,49,43,6,45
Berwick,2156,8,9,10,17,31,59,-28,37
Edinburgh Ci,2156,9,7,9,20,37,63,-26,30
Cowdenbeath,2156,10,4,11,21,25,56,-31,23
Montrose,2157,1,23,8,5,60,35,25,77
Peterhead,2157,2,24,4,8,84,39,45,76
Stenhousem'r,2157,3,16,8,12,56,46,10,56
Stirling,2157,4,16,6,14,60,52,8,54
Clyde,2157,5,15,9,12,55,51,4,54
Elgin,2157,6,14,7,15,54,61,-7,49
Annan Athlet,2157,7,11,12,13,48,42,6,45
Berwick,2157,8,8,10,18,32,62,-30,34
Edinburgh Ci,2157,9,7,9,20,37,67,-30,30
Cowdenbeath,2157,10,4,11,21,24,55,-31,23
Montrose,2158,1,24,7,5,62,35,27,79
Peterhead,2158,2,23,5,8,77,38,39,74
Stirling,2158,3,17,6,13,64,52,12,57
Stenhousem'r,2158,4,15,8,13,56,50,6,53
Clyde,2158,5,14,9,13,52,50,2,51
Elgin,2158,6,14,6,16,54,63,-9,48
Annan Athlet,2158,7,12,11,13,48,41,7,47
Berwick,2158,8,9,10,17,31,59,-28,37
Edinburgh Ci,2158,9,7,10,19,36,60,-24,31
Cowdenbeath,2158,10,4,10,22,23,55,-32,22
Montrose,2159,1,24,7,5,63,36,27,79
Peterhead,2159,2,24,4,8,81,38,43,76
Stirling,2159,3,17,6,13,62,51,11,57
Clyde,2159,4,15,9,12,53,49,4,54
Stenhousem'r,2159,5,15,8,13,55,48,7,53
Elgin,2159,6,14,6,16,55,64,-9,48
Annan Athlet,2159,7,11,12,13,47,41,6,45
Berwick,2159,8,8,10,18,30,60,-30,34
Edinburgh Ci,2159,9,7,9,20,36,64,-28,30
Cowdenbeath,2159,10,4,11,21,23,54,-31,23
Montrose,2160,1,23,8,5,60,35,25,77
Peterhead,2160,2,24,4,8,81,38,43,76
Stirling,2160,3,16,7,13,62,53,9,55
Stenhousem'r,2160,4,15,9,12,57,48,9,54
Clyde,2160,5,15,9,12,54,48,6,54
Elgin,2160,6,14,7,15,54,61,-7,49
Annan Athlet,2160,7,12,11,13,50,41,9,47
Berwick,2160,8,8,10,18,29,61,-32,34
Edinburgh Ci,2160,9,7,9,20,36,64,-28,30
Cowdenbeath,2160,10,4,10,22,23,57,-34,22
Montrose,2161,1,24,7,5,63,35,28,79
Peterhead,2161,2,24,4,8,80,39,41,76
Stirling,2161,3,17,6,13,64,53,11,57
Clyde,2161,4,15,9,12,54,49,5,54
Stenhousem'r,2161,5,15,8,13,57,50,7,53
Elgin,2161,6,14,6,16,54,64,-10,48
Annan Athlet,2161,7,12,11,13,49,42,7,47
Berwick,2161,8,8,10,18,30,61,-31,34
Edinburgh Ci,2161,9,7,9,20,37,63,-26,30
Cowdenbeath,2161,10,4,10,22,24,56,-32,22
Peterhead,2162,1,24,4,8,83,38,45,76
Montrose,2162,2,23,7,6,60,36,24,76
Stirling,2162,3,17,6,13,62,52,10,57
Clyde,2162,4,15,9,12,52,48,4,54
Stenhousem'r,2162,5,15,8,13,56,48,8,53
Elgin,2162,6,15,6,15,55,61,-6,51
Annan Athlet,2162,7,11,11,14,48,44,4,44
Berwick,2162,8,8,10,18,29,59,-30,34
Edinburgh Ci,2162,9,7,9,20,36,66,-30,30
Cowdenbeath,2162,10,5,10,21,26,55,-29,25
Montrose,2163,1,23,8,5,60,35,25,77
Peterhead,2163,2,24,4,8,82,39,43,76
Stirling,2163,3,16,7,13,61,52,9,55
Stenhousem'r,2163,4,15,9,12,56,47,9,54
Clyde,2163,5,15,9,12,54,50,4,54
Elgin,2163,6,14,7,15,54,61,-7,49
Annan Athlet,2163,7,11,11,14,48,45,3,44
Berwick,2163,8,8,10,18,31,61,-30,34
Edinburgh Ci,2163,9,7,9,20,37,65,-28,30
Cowdenbeath,2163,10,5,10,21,27,55,-28,25
Montrose,2164,1,23,8,5,59,34,25,77
Peterhead,2164,2,24,4,8,82,39,43,76
Stirling,2164,3,16,7,13,62,53,9,55
Stenhousem'r,2164,4,15,9,12,57,48,9,54
Clyde,2164,5,14,10,12,52,49,3,52
Elgin,2164,6,14,7,15,53,60,-7,49
Annan Athlet,2164,7,11,12,13,47,41,6,45
Berwick,2164,8,8,11,17,30,59,-29,35
Edinburgh Ci,2164,9,7,9,20,37,65,-28,30
Cowdenbeath,2164,10,4,11,21,23,54,-31,23
Montrose,2165,1,24,7,5,62,34,28,79
Peterhead,2165,2,23,5,8,79,40,39,74
Stirling,2165,3,16,7,13,61,52,9,55
Stenhousem'r,2165,4,15,9,12,56,47,9,54
Clyde,2165,5,15,9,12,53,49,4,54
Elgin,2165,6,14,6,16,53,63,-10,48
Annan Athlet,2165,7,12,11,13,51,43,8,47
Berwick,2165,8,8,10,18,30,60,-30,34
Edinburgh Ci,2165,9,7,10,19,38,62,-24,31
Cowdenbeath,2165,10,4,10,22,25,58,-33,22
Montrose,2166,1,24,7,5,61,35,26,79
Peterhead,2166,2,24,4,8,79,38,41,76
Stirling,2166,3,17,6,13,63,52,11,57
Stenhousem'r,2166,4,15,8,13,56,49,7,53
Clyde,2166,5,14,9,13,52,50,2,51
Elgin,2166,6,14,6,16,54,62,-8,48
Annan Athlet,2166,7,12,11,13,48,41,7,47
Berwick,2166,8,9,10,17,31,59,-28,37
Edinburgh Ci,2166,9,7,9,20,36,62,-26,30
Cowdenbeath,2166,10,4,10,22,23,55,-32,22
Peterhead,2167,1,24,4,8,79,39,40,76
Montrose,2167,2,23,7,6,59,36,23,76
Stirling,2167,3,17,6,13,63,52,11,57
Clyde,2167,4,15,9,12,53,49,4,54
Stenhousem'r,2167,5,15,8,13,56,49,7,53
Elgin,2167,6,15,6,15,55,60,-5,51
Annan Athlet,2167,7,12,11,13,48,41,7,47
Berwick,2167,8,8,10,18,30,60,-30,34
Edinburgh Ci,2167,9,7,9,20,37,62,-25,30
Cowdenbeath,2167,10,4,10,22,23,55,-32,22
Montrose,2168,1,23,8,5,59,34,25,77
Peterhead,2168,2,24,4,8,81,39,42,76
Stirling,2168,3,16,7,13,61,52,9,55
Stenhousem'r,2168,4,15,9,12,56,47,9,54
Clyde,2168,5,15,9,12,54,49,5,54
Elgin,2168,6,14,7,15,53,60,-7,49
Annan Athlet,2168,7,12,11,13,52,41,11,47
Berwick,2168,8,8,10,18,30,61,-31,34
Edinburgh Ci,2168,9,7,9,20,37,64,-27,30
Cowdenbeath,2168,10,4,10,22,23,59,-36,22
Montrose,2169,1,24,7,5,62,34,28,79
Peterhead,2169,2,23,5,8,77,38,39,74
Stenhousem'r,2169,3,16,8,12,58,47,11,56
Stirling,2169,4,16,6,14,61,54,7,54
Clyde,2169,5,15,9,12,54,49,5,54
Elgin,2169,6,14,6,16,53,63,-10,48
Annan Athlet,2169,7,12,11,13,49,41,8,47
Berwick,2169,8,8,10,18,30,61,-31,34
Edinburgh Ci,2169,9,7,10,19,36,60,-24,31
Cowdenbeath,2169,10,4,10,22,23,56,-33,22
Montrose,2170,1,24,7,5,62,34,28,79
Peterhead,2170,2,23,5,8,78,39,39,74
Stenhousem'r,2170,3,16,8,12,57,47,10,56
Stirling,2170,4,16,6,14,61,53,8,54
Clyde,2170,5,14,10,12,52,49,3,52
Elgin,2170,6,14,6,16,53,63,-10,48
Annan Athlet,2170,7,11,12,13,47,41,6,45
Berwick,2170,8,8,11,17,30,59,-29,35
Edinburgh Ci,2170,9,7,10,19,37,61,-24,31
Cowdenbeath,2170,10,4,11,21,23,54,-31,23
Montrose,2171,1,24,7,5,60,34,26,79
Peterhead,2171,2,24,4,8,80,38,42,76
Stirling,2171,3,17,6,13,62,51,11,57
Clyde,2171,4,15,9,12,52,48,4,54
Stenhousem'r,2171,5,15,8,13,55,48,7,53
Elgin,2171,6,14,6,16,53,61,-8,48
Annan Athlet,2171,7,11,12,13,49,43,6,45
Berwick,2171,8,8,10,18,29,59,-30,34
Edinburgh Ci,2171,9,7,9,20,36,63,-27,30
Cowdenbeath,2171,10,4,11,21,25,56,-31,23
Montrose,2172,1,24,7,5,62,35,27,79
Peterhead,2172,2,24,4,8,80,39,41,76
Stirling,2172,3,17,6,13,62,51,11,57
Stenhousem'r,2172,4,15,8,13,55,48,7,53
Clyde,2172,5,14,10,12,53,50,3,52
Elgin,2172,6,14,6,16,54,63,-9,48
Annan Athlet,2172,7,12,11,13,50,43,7,47
Berwick,2172,8,8,11,17,31,60,-29,35
Edinburgh Ci,2172,9,7,9,20,37,63,-26,30
Cowdenbeath,2172,10,4,10,22,25,57,-32,22
Peterhead,2173,1,24,4,8,81,39,42,76
Montrose,2173,2,23,7,6,60,36,24,76
Stenhousem'r,2173,3,16,8,12,58,47,11,56
Stirling,2173,4,16,6,14,61,54,7,54
Clyde,2173,5,15,9,12,53,48,5,54
Elgin,2173,6,15,6,15,55,61,-6,51
Annan Athlet,2173,7,11,12,13,47,41,6,45
Berwick,2173,8,8,10,18,29,60,-31,34
Edinburgh Ci,2173,9,7,9,20,37,64,-27,30
Cowdenbeath,2173,10,4,11,21,23,54,-31,23
Montrose,2174,1,24,7,5,62,36,26,79
Peterhead,2174,2,24,4,8,80,39,41,76
Stenhousem'r,2174,3,16,8,12,57,47,10,56
Stirling,2174,4,16,6,14,61,53,8,54
Clyde,2174,5,15,9,12,53,49,4,54
Elgin,2174,6,14,6,16,55,63,-8,48
Annan Athlet,2174,7,12,11,13,49,42,7,47
Berwick,2174,8,8,10,18,30,60,-30,34
Edinburgh Ci,2174,9,7,9,20,37,63,-26,30
Cowdenbeath,2174,10,4,10,22,24,56,-32,22
Montrose,2175,1,24,7,5,61,35,26,79
Peterhead,2175,2,24,4,8,78,38,40,76
Stirling,2175,3,16,7,13,63,54,9,55
Stenhousem'r,2175,4,15,9,12,58,49,9,54
Clyde,2175,5,14,9,13,52,51,1,51
Elgin,2175,6,14,6,16,54,62,-8,48
Annan Athlet,2175,7,11,12,13,48,42,6,45
Berwick,2175,8,9,10,17,32,59,-27,37
Edinburgh Ci,2175,9,7,9,20,36,61,-25,30
Cowdenbeath,2175,10,4,11,21,24,55,-31,23
Montrose,2176,1,24,7,5,61,35,26,79
Peterhead,2176,2,24,4,8,78,38,40,76
Stirling,2176,3,16,7,13,60,51,9,55
Stenhousem'r,2176,4,15,9,12,55,46,9,54
Clyde,2176,5,15,9,12,52,48,4,54
Elgin,2176,6,14,6,16,54,62,-8,48
Annan Athlet,2176,7,11,12,13,48,42,6,45
Berwick,2176,8,8,10,18,29,59,-30,34
Edinburgh Ci,2176,9,7,9,20,36,61,-25,30
Cowdenbeath,2176,10,4,11,21,24,55,-31,23
Montrose,2177,1,24,7,5,60,34,26,79
Peterhead,2177,2,23,4,9,77,39,38,73
Stirling,2177,3,17,6,13,64,51,13,57
Stenhousem'r,2177,4,15,8,13,55,50,5,53
Clyde,2177,5,14,9,13,52,50,2,51
Elgin,2177,6,14,6,16,53,61,-8,48
Annan Athlet,2177,7,11,12,13,49,43,6,45
Berwick,2177,8,9,10,17,31,59,-28,37
Edinburgh Ci,2177,9,8,9,19,37,60,-23,33
Cowdenbeath,2177,10,4,11,21,25,56,-31,23
Montrose,2178,1,24,7,5,61,34,27,79
Peterhead,2178,2,23,4,9,78,40,38,73
Stirling,2178,3,16,7,13,61,52,9,55
Stenhousem'r,2178,4,15,9,12,56,47,9,54
Clyde,2178,5,14,10,12,51,48,3,52
Elgin,2178,6,14,6,16,53,62,-9,48
Annan Athlet,2178,7,11,11,14,47,42,5,44
Berwick,2178,8,8,11,17,29,58,-29,35
Edinburgh Ci,2178,9,8,9,19,38,61,-23,33
Cowdenbeath,2178,10,5,10,21,24,54,-30,25
Montrose,2179,1,24,7,5,60,34,26,79
Peterhead,2179,2,23,5,8,79,40,39,74
Stenhousem'r,2179,3,16,8,12,57,47,10,56
Stirling,2179,4,16,6,14,61,53,8,54
Clyde,2179,5,14,10,12,51,48,3,52
Elgin,2179,6,14,6,16,53,61,-8,48
Annan Athlet,2179,7,11,12,13,48,42,6,45
Berwick,2179,8,8,11,17,29,58,-29,35
Edinburgh Ci,2179,9,7,10,19,38,62,-24,31
Cowdenbeath,2179,10,4,11,21,24,55,-31,23
Montrose,2180,1,23,8,5,60,35,25,77
Peterhead,2180,2,24,4,8,81,39,42,76
Stirling,2180,3,16,7,13,61,52,9,55
Stenhousem'r,2180,4,15,9,12,56,47,9,54
Clyde,2180,5,14,10,12,53,50,3,52
Elgin,2180,6,14,7,15,54,61,-7,49
Annan Athlet,2180,7,11,12,13,47,41,6,45
Berwick,2180,8,8,11,17,31,60,-29,35
Edinburgh Ci,2180,9,7,9,20,37,64,-27,30
Cowdenbeath,2180,10,4,11,21,23,54,-31,23
Montrose,2181,1,24,7,5,62,35,27,79
Peterhead,2181,2,24,4,8,80,38,42,76
Stirling,2181,3,17,6,13,65,52,13,57
Stenhousem'r,2181,4,15,8,13,56,51,5,53
Clyde,2181,5,14,10,12,51,48,3,52
Elgin,2181,6,14,6,16,54,63,-9,48
Annan Athlet,2181,7,12,11,13,50,41,9,47
Berwick,2181,8,8,11,17,29,58,-29,35
Edinburgh Ci,2181,9,7,9,20,36,63,-27,30
Cowdenbeath,2181,10,4,10,22,23,57,-34,22
Montrose,2182,1,23,8,5,60,35,25,77
Peterhead,2182,2,23,5,8,78,39,39,74
Stirling,2182,3,17,6,13,62,51,11,57
Stenhousem'r,2182,4,15,8,13,55,48,7,53
Clyde,2182,5,14,9,13,51,49,2,51
Elgin,2182,6,14,7,15,54,61,-7,49
Annan Athlet,2182,7,12,11,13,48,41,7,47
Berwick,2182,8,9,10,17,30,58,-28,37
Edinburgh Ci,2182,9,7,10,19,37,61,-24,31
Cowdenbeath,2182,10,4,10,22,23,55,-32,22
Montrose,2183,1,23,8,5,59,34,25,77
Peterhead,2183,2,24,4,8,79,39,40,76
Stirling,2183,3,17,6,13,63,52,11,57
Stenhousem'r,2183,4,15,8,13,56,49,7,53
Clyde,2183,5,14,10,12,52,49,3,52
Elgin,2183,6,14,7,15,53,60,-7,49
Annan Athlet,2183,7,11,11,14,48,43,5,44
Berwick,2183,8,8,11,17,30,59,-29,35
Edinburgh Ci,2183,9,7,9,20,37,62,-25,30
Cowdenbeath,2183,10,5,10,21,25,55,-30,25
Montrose,2184,1,24,7,5,60,34,26,79
Peterhead,2184,2,24,4,8,80,40,40,76
Stirling,2184,3,16,7,13,60,51,9,55
Stenhousem'r,2184,4,15,9,12,55,46,9,54
Clyde,2184,5,15,9,12,52,48,4,54
Elgin,2184,6,14,6,16,53,61,-8,48
Annan Athlet,2184,7,12,11,13,49,41,8,47
Berwick,2184,8,8,10,18,29,59,-30,34
Edinburgh Ci,2184,9,7,9,20,38,63,-25,30
Cowdenbeath,2184,10,4,10,22,23,56,-33,22
Montrose,2185,1,24,7,5,63,36,27,79
Peterhead,2185,2,24,4,8,84,39,45,76
Stirling,2185,3,16,7,13,61,52,9,55
Stenhousem'r,2185,4,15,9,12,56,47,9,54
Clyde,2185,5,14,10,12,52,49,3,52
Elgin,2185,6,14,6,16,55,64,-9,48
Annan Athlet,2185,7,11,11,14,47,42,5,44
Berwick,2185,8,8,11,17,30,59,-29,35
Edinburgh Ci,2185,9,7,9,20,37,67,-30,30
Cowdenbeath,2185,10,5,10,21,24,54,-30,25
Montrose,2186,1,24,7,5,61,35,26,79
Peterhead,2186,2,24,4,8,81,38,43,76
Stirling,2186,3,16,7,13,61,52,9,55
Stenhousem'r,2186,4,15,9,12,56,47,9,54
Clyde,2186,5,15,9,12,56,51,5,54
Elgin,2186,6,14,6,16,54,62,-8,48
Annan Athlet,2186,7,11,12,13,48,42,6,45
Berwick,2186,8,8,10,18,32,63,-31,34
Edinburgh Ci,2186,9,7,9,20,36,64,-28,30
Cowdenbeath,2186,10,4,11,21,24,55,-31,23
Montrose,2187,1,23,8,5,61,36,25,77
Peterhead,2187,2,24,4,8,79,39,40,76
Stenhousem'r,2187,3,16,8,12,58,47,11,56
Stirling,2187,4,16,6,14,61,54,7,54
Clyde,2187,5,15,9,12,54,49,5,54
Elgin,2187,6,14,7,15,55,62,-7,49
Annan Athlet,2187,7,11,11,14,48,45,3,44
Berwick,2187,8,8,10,18,30,61,-31,34
Edinburgh Ci,2187,9,7,9,20,37,62,-25,30
Cowdenbeath,2187,10,5,10,21,27,55,-28,25
Montrose,2188,1,24,7,5,62,34,28,79
Peterhead,2188,2,24,4,8,82,40,42,76
Stirling,2188,3,17,6,13,61,51,10,57
Clyde,2188,4,15,9,12,53,48,5,54
Stenhousem'r,2188,5,15,8,13,55,47,8,53
Elgin,2188,6,14,6,16,53,63,-10,48
Annan Athlet,2188,7,12,11,13,49,42,7,47
Berwick,2188,8,8,10,18,29,60,-31,34
Edinburgh Ci,2188,9,7,9,20,38,65,-27,30
Cowdenbeath,2188,10,4,10,22,24,56,-32,22
Montrose,2189,1,23,8,5,60,35,25,77
Peterhead,2189,2,23,4,9,79,42,37,73
Stirling,2189,3,17,6,13,63,53,10,57
Stenhousem'r,2189,4,15,8,13,57,49,8,53
Clyde,2189,5,14,9,13,52,50,2,51
Elgin,2189,6,14,7,15,54,61,-7,49
Annan Athlet,2189,7,11,11,14,47,42,5,44
Berwick,2189,8,9,10,17,31,59,-28,37
Edinburgh Ci,2189,9,8,9,19,40,62,-22,33
Cowdenbeath,2189,10,5,10,21,24,54,-30,25
Montrose,2190,1,24,7,5,62,35,27,79
Peterhead,2190,2,24,4,8,80,39,41,76
Stenhousem'r,2190,3,16,8,12,58,46,12,56
Stirling,2190,4,16,6,14,60,54,6,54
Clyde,2190,5,14,10,12,51,48,3,52
Elgin,2190,6,14,6,16,54,63,-9,48
Annan Athlet,2190,7,11,12,13,47,41,6,45
Berwick,2190,8,8,11,17,29,58,-29,35
Edinburgh Ci,2190,9,7,9,20,37,63,-26,30
Cowdenbeath,2190,10,4,11,21,23,54,-31,23
Montrose,2191,1,24,7,5,66,36,30,79
Peterhead,2191,2,24,4,8,80,38,42,76
Stirling,2191,3,16,7,13,61,52,9,55
Stenhousem'r,2191,4,15,9,12,56,47,9,54
Clyde,2191,5,14,9,13,51,49,2,51
Elgin,2191,6,14,6,16,55,67,-12,48
Annan Athlet,2191,7,11,12,13,48,42,6,45
Berwick,2191,8,9,10,17,30,58,-28,37
Edinburgh Ci,2191,9,7,9,20,36,63,-27,30
Cowdenbeath,2191,10,4,11,21,24,55,-31,23
Montrose,2192,1,24,7,5,60,34,26,79
Peterhead,2192,2,23,5,8,78,39,39,74
Stirling,2192,3,17,6,13,63,53,10,57
Clyde,2192,4,15,9,12,52,48,4,54
Stenhousem'r,2192,5,15,8,13,57,49,8,53
Elgin,2192,6,14,6,16,53,61,-8,48
Annan Athlet,2192,7,12,11,13,49,42,7,47
Berwick,2192,8,8,10,18,29,59,-30,34
Edinburgh Ci,2192,9,7,10,19,37,61,-24,31
Cowdenbeath,2192,10,4,10,22,24,56,-32,22
Montrose,2193,1,24,7,5,62,35,27,79
Peterhead,2193,2,23,4,9,77,39,38,73
Stirling,2193,3,16,7,13,62,53,9,55
Stenhousem'r,2193,4,15,9,12,57,48,9,54
Clyde,2193,5,14,9,13,52,50,2,51
Elgin,2193,6,14,6,16,54,63,-9,48
Annan Athlet,2193,7,11,11,14,49,44,5,44
Berwick,2193,8,9,10,17,31,59,-28,37
Edinburgh Ci,2193,9,8,9,19,37,60,-23,33
Cowdenbeath,2193,10,5,10,21,26,56,-30,25
Montrose,2194,1,23,7,6,60,36,24,76
Peterhead,2194,2,23,5,8,78,39,39,74
Stirling,2194,3,16,7,13,61,52,9,55
Stenhousem'r,2194,4,15,9,12,56,47,9,54
Clyde,2194,5,15,9,12,52,48,4,54
Elgin,2194,6,15,6,15,55,61,-6,51
Annan Athlet,2194,7,12,11,13,49,42,7,47
Berwick,2194,8,8,10,18,29,59,-30,34
Edinburgh Ci,2194,9,7,10,19,37,61,-24,31
Cowdenbeath,2194,10,4,10,22,24,56,-32,22
Peterhead,2195,1,24,4,8,83,40,43,76
Montrose,2195,2,23,7,6,61,38,23,76
Stirling,2195,3,16,7,13,61,52,9,55
Stenhousem'r,2195,4,15,9,12,56,47,9,54
Clyde,2195,5,14,9,13,51,49,2,51
Elgin,2195,6,15,6,15,57,62,-5,51
Annan Athlet,2195,7,11,12,13,47,41,6,45
Berwick,2195,8,9,10,17,30,58,-28,37
Edinburgh Ci,2195,9,7,9,20,38,66,-28,30
Cowdenbeath,2195,10,4,11,21,23,54,-31,23
Montrose,2196,1,24,7,5,62,34,28,79
Peterhead,2196,2,24,4,8,80,38,42,76
Stirling,2196,3,16,7,13,60,51,9,55
Stenhousem'r,2196,4,15,9,12,55,46,9,54
Clyde,2196,5,14,10,12,54,51,3,52
Elgin,2196,6,14,6,16,53,63,-10,48
Annan Athlet,2196,7,11,12,13,47,41,6,45
Berwick,2196,8,8,11,17,32,61,-29,35
Edinburgh Ci,2196,9,7,9,20,36,63,-27,30
Cowdenbeath,2196,10,4,11,21,23,54,-31,23
Montrose,2197,1,24,7,5,64,36,28,79
Peterhead,2197,2,24,4,8,80,39,41,76
Stirling,2197,3,16,7,13,61,52,9,55
Stenhousem'r,2197,4,15,9,12,56,47,9,54
Clyde,2197,5,15,9,12,54,48,6,54
Elgin,2197,6,14,6,16,55,65,-10,48
Annan Athlet,2197,7,12,11,13,50,41,9,47
Berwick,2197,8,8,10,18,29,61,-32,34
Edinburgh Ci,2197,9,7,9,20,37,63,-26,30
Cowdenbeath,2197,10,4,10,22,23,57,-34,22
Montrose,2198,1,23,8,5,60,35,25,77
Peterhead,2198,2,24,4,8,80,39,41,76
Stenhousem'r,2198,3,16,8,12,58,48,10,56
Stirling,2198,4,16,6,14,62,54,8,54
Clyde,2198,5,15,9,12,54,49,5,54
Elgin,2198,6,14,7,15,54,61,-7,49
Annan Athlet,2198,7,12,11,13,49,42,7,47
Berwick,2198,8,8,10,18,30,61,-31,34
Edinburgh Ci,2198,9,7,9,20,37,63,-26,30
Cowdenbeath,2198,10,4,10,22,24,56,-32,22
Montrose,2199,1,24,7,5,61,35,26,79
Peterhead,2199,2,24,4,8,81,39,42,76
Stenhousem'r,2199,3,16,8,12,56,46,10,56
Stirling,2199,4,16,6,14,60,52,8,54
Clyde,2199,5,15,9,12,53,48,5,54
Elgin,2199,6,14,6,16,54,62,-8,48
Annan Athlet,2199,7,11,11,14,48,44,4,44
Berwick,2199,8,8,10,18,29,60,-31,34
Edinburgh Ci,2199,9,7,9,20,37,64,-27,30
Cowdenbeath,2199,10,5,10,21,26,55,-29,25
Montrose,2200,1,24,7,5,60,34,26,79
Peterhead,2200,2,24,4,8,81,39,42,76
Stirling,2200,3,17,6,13,64,53,11,57
Clyde,2200,4,15,9,12,55,50,5,54
Stenhousem'r,2200,5,15,8,13,57,50,7,53
Elgin,2200,6,14,6,16,53,61,-8,48
Annan Athlet,2200,7,11,12,13,49,43,6,45
Berwick,2200,8,8,10,18,31,62,-31,34
Edinburgh Ci,2200,9,7,9,20,37,64,-27,30
Cowdenbeath,2200,10,4,11,21,25,56,-31,23
Montrose,2201,1,23,8,5,60,35,25,77
Peterhead,2201,2,24,4,8,82,39,43,76
Stenhousem'r,2201,3,16,8,12,57,47,10,56
Stirling,2201,4,16,6,14,61,53,8,54
Clyde,2201,5,14,10,12,51,48,3,52
Elgin,2201,6,14,7,15,54,61,-7,49
Annan Athlet,2201,7,12,11,13,49,42,7,47
Berwick,2201,8,8,11,17,29,58,-29,35
Edinburgh Ci,2201,9,7,9,20,37,65,-28,30
Cowdenbeath,2201,10,4,10,22,24,56,-32,22
Montrose,2202,1,24,7,5,61,34,27,79
Peterhead,2202,2,24,4,8,80,39,41,76
Stirling,2202,3,17,6,13,63,52,11,57
Stenhousem'r,2202,4,15,8,13,56,49,7,53
Clyde,2202,5,14,9,13,51,49,2,51
Elgin,2202,6,14,6,16,53,62,-9,48
Annan Athlet,2202,7,11,12,13,49,43,6,45
Berwick,2202,8,9,10,17,30,58,-28,37
Edinburgh Ci,2202,9,7,9,20,37,63,-26,30
Cowdenbeath,2202,10,4,11,21,25,56,-31,23
Montrose,2203,1,24,7,5,61,35,26,79
Peterhead,2203,2,23,5,8,77,38,39,74
Stirling,2203,3,17,6,13,61,51,10,57
Clyde,2203,4,15,9,12,55,48,7,54
Stenhousem'r,2203,5,15,8,13,55,47,8,53
Elgin,2203,6,14,6,16,54,62,-8,48
Annan Athlet,2203,7,12,11,13,49,41,8,47
Berwick,2203,8,8,10,18,29,62,-33,34
Edinburgh Ci,2203,9,7,10,19,36,60,-24,31
Cowdenbeath,2203,10,4,10,22,23,56,-33,22
Montrose,2204,1,23,8,5,61,36,25,77
Peterhead,2204,2,24,4,8,80,38,42,76
Stenhousem'r,2204,3,16,8,12,56,46,10,56
Stirling,2204,4,16,6,14,60,52,8,54
Clyde,2204,5,15,9,12,55,48,7,54
Elgin,2204,6,14,7,15,55,62,-7,49
Annan Athlet,2204,7,11,12,13,48,42,6,45
Berwick,2204,8,8,10,18,29,62,-33,34
Edinburgh Ci,2204,9,7,9,20,36,63,-27,30
Cowdenbeath,2204,10,4,11,21,24,55,-31,23
Montrose,2205,1,23,8,5,61,36,25,77
Peterhead,2205,2,23,5,8,79,40,39,74
Stirling,2205,3,17,6,13,61,51,10,57
Clyde,2205,4,15,9,12,55,48,7,54
Stenhousem'r,2205,5,15,8,13,55,47,8,53
Elgin,2205,6,14,7,15,55,62,-7,49
Annan Athlet,2205,7,12,11,13,48,41,7,47
Berwick,2205,8,8,10,18,29,62,-33,34
Edinburgh Ci,2205,9,7,10,19,38,62,-24,31
Cowdenbeath,2205,10,4,10,22,23,55,-32,22
Montrose,2206,1,24,7,5,61,34,27,79
Peterhead,2206,2,24,4,8,80,39,41,76
Stenhousem'r,2206,3,16,8,12,58,47,11,56
Stirling,2206,4,16,6,14,61,54,7,54
Clyde,2206,5,14,10,12,52,49,3,52
Elgin,2206,6,14,6,16,53,62,-9,48
Annan Athlet,2206,7,12,11,13,49,41,8,47
Berwick,2206,8,8,11,17,30,59,-29,35
Edinburgh Ci,2206,9,7,9,20,37,63,-26,30
Cowdenbeath,2206,10,4,10,22,23,56,-33,22
Montrose,2207,1,24,7,5,63,34,29,79
Peterhead,2207,2,23,4,9,78,40,38,73
Stirling,2207,3,17,6,13,61,51,10,57
Clyde,2207,4,15,9,12,54,48,6,54
Stenhousem'r,2207,5,15,8,13,55,47,8,53
Elgin,2207,6,14,6,16,53,64,-11,48
Annan Athlet,2207,7,12,11,13,49,41,8,47
Berwick,2207,8,8,10,18,29,61,-32,34
Edinburgh Ci,2207,9,8,9,19,38,61,-23,33
Cowdenbeath,2207,10,4,10,22,23,56,-33,22
Montrose,2208,1,24,7,5,65,34,31,79
Peterhead,2208,2,24,4,8,83,39,44,76
Stirling,2208,3,17,6,13,62,52,10,57
Stenhousem'r,2208,4,15,8,13,56,48,8,53
Clyde,2208,5,14,10,12,52,49,3,52
Elgin,2208,6,14,6,16,53,66,-13,48
Annan Athlet,2208,7,11,12,13,49,43,6,45
Berwick,2208,8,8,11,17,30,59,-29,35
Edinburgh Ci,2208,9,7,9,20,37,66,-29,30
Cowdenbeath,2208,10,4,11,21,25,56,-31,23
Montrose,2209,1,24,7,5,62,35,27,79
Peterhead,2209,2,24,4,8,79,39,40,76
Stirling,2209,3,16,7,13,65,56,9,55
Stenhousem'r,2209,4,15,9,12,60,51,9,54
Clyde,2209,5,15,9,12,53,49,4,54
Elgin,2209,6,14,6,16,54,63,-9,48
Annan Athlet,2209,7,11,11,14,47,43,4,44
Berwick,2209,8,8,10,18,30,60,-30,34
Edinburgh Ci,2209,9,7,9,20,37,62,-25,30
Cowdenbeath,2209,10,5,10,21,25,54,-29,25
Montrose,2210,1,24,7,5,60,34,26,79
Peterhead,2210,2,24,4,8,81,40,41,76
Stirling,2210,3,17,6,13,62,52,10,57
Clyde,2210,4,15,9,12,53,48,5,54
Stenhousem'r,2210,5,15,8,13,56,48,8,53
Elgin,2210,6,14,6,16,53,61,-8,48
Annan Athlet,2210,7,11,12,13,47,41,6,45
Berwick,2210,8,8,10,18,29,60,-31,34
Edinburgh Ci,2210,9,7,9,20,38,64,-26,30
Cowdenbeath,2210,10,4,11,21,23,54,-31,23
Montrose,2211,1,24,7,5,62,36,26,79
Peterhead,2211,2,24,4,8,79,39,40,76
Stenhousem'r,2211,3,16,8,12,57,46,11,56
Stirling,2211,4,16,6,14,60,53,7,54
Clyde,2211,5,14,9,13,52,51,1,51
Elgin,2211,6,14,6,16,55,63,-8,48
Annan Athlet,2211,7,11,11,14,48,43,5,44
Berwick,2211,8,9,10,17,32,59,-27,37
Edinburgh Ci,2211,9,7,9,20,37,62,-25,30
Cowdenbeath,2211,10,5,10,21,25,55,-30,25
Montrose,2212,1,24,7,5,61,34,27,79
Peterhead,2212,2,24,4,8,79,38,41,76
Stirling,2212,3,17,6,13,62,51,11,57
Clyde,2212,4,15,9,12,55,48,7,54
Stenhousem'r,2212,5,15,8,13,55,48,7,53
Elgin,2212,6,14,6,16,53,62,-9,48
Annan Athlet,2212,7,12,11,13,50,43,7,47
Berwick,2212,8,8,10,18,29,62,-33,34
Edinburgh Ci,2212,9,7,9,20,36,62,-26,30
Cowdenbeath,2212,10,4,10,22,25,57,-32,22
Montrose,2213,1,24,7,5,62,34,28,79
Peterhead,2213,2,24,4,8,80,40,40,76
Stirling,2213,3,17,6,13,62,52,10,57
Clyde,2213,4,15,9,12,53,48,5,54
Stenhousem'r,2213,5,15,8,13,56,48,8,53
Elgin,2213,6,14,6,16,53,63,-10,48
Annan Athlet,2213,7,11,11,14,47,43,4,44
Berwick,2213,8,8,10,18,29,60,-31,34
Edinburgh Ci,2213,9,7,9,20,38,63,-25,30
Cowdenbeath,2213,10,5,10,21,25,54,-29,25
Montrose,2214,1,24,7,5,61,35,26,79
Peterhead,2214,2,24,4,8,79,39,40,76
Stenhousem'r,2214,3,16,8,12,59,47,12,56
Stirling,2214,4,16,6,14,61,55,6,54
Clyde,2214,5,15,9,12,52,48,4,54
Elgin,2214,6,14,6,16,54,62,-8,48
Annan Athlet,2214,7,12,11,13,49,41,8,47
Berwick,2214,8,8,10,18,29,59,-30,34
Edinburgh Ci,2214,9,7,9,20,37,62,-25,30
Cowdenbeath,2214,10,4,10,22,23,56,-33,22
Peterhead,2215,1,24,4,8,82,39,43,76
Montrose,2215,2,23,7,6,60,36,24,76
Stirling,2215,3,17,6,13,61,51,10,57
Clyde,2215,4,15,9,12,53,48,5,54
Stenhousem'r,2215,5,15,8,13,55,47,8,53
Elgin,2215,6,15,6,15,55,61,-6,51
Annan Athlet,2215,7,12,11,13,48,41,7,47
Berwick,2215,8,8,10,18,29,60,-31,34
Edinburgh Ci,2215,9,7,9,20,37,65,-28,30
Cowdenbeath,2215,10,4,10,22,23,55,-32,22
Montrose,2216,1,23,8,5,60,35,25,77
Peterhead,2216,2,24,4,8,78,38,40,76
Stirling,2216,3,17,6,13,62,52,10,57
Stenhousem'r,2216,4,15,8,13,56,48,8,53
Clyde,2216,5,14,10,12,51,48,3,52
Elgin,2216,6,14,7,15,54,61,-7,49
Annan Athlet,2216,7,11,11,14,48,44,4,44
Berwick,2216,8,8,11,17,29,58,-29,35
Edinburgh Ci,2216,9,7,9,20,36,61,-25,30
Cowdenbeath,2216,10,5,10,21,26,55,-29,25
Montrose,2217,1,24,7,5,61,34,27,79
Peterhead,2217,2,23,5,8,78,39,39,74
Stirling,2217,3,17,6,13,65,51,14,57
Stenhousem'r,2217,4,15,8,13,55,51,4,53
Clyde,2217,5,14,10,12,51,48,3,52
Elgin,2217,6,14,6,16,53,62,-9,48
Annan Athlet,2217,7,11,11,14,47,43,4,44
Berwick,2217,8,8,11,17,29,58,-29,35
Edinburgh Ci,2217,9,7,10,19,37,61,-24,31
Cowdenbeath,2217,10,5,10,21,25,54,-29,25
Montrose,2218,1,24,7,5,60,34,26,79
Peterhead,2218,2,24,4,8,79,39,40,76
Stirling,2218,3,17,6,13,64,51,13,57
Clyde,2218,4,15,9,12,53,48,5,54
Stenhousem'r,2218,5,15,8,13,55,50,5,53
Elgin,2218,6,14,6,16,53,61,-8,48
Annan Athlet,2218,7,11,11,14,47,44,3,44
Berwick,2218,8,8,10,18,29,60,-31,34
Edinburgh Ci,2218,9,7,9,20,37,62,-25,30
Cowdenbeath,2218,10,5,10,21,26,54,-28,25
Montrose,2219,1,24,7,5,60,34,26,79
Peterhead,2219,2,24,4,8,80,38,42,76
Stirling,2219,3,17,6,13,61,51,10,57
Stenhousem'r,2219,4,15,8,13,55,47,8,53
Clyde,2219,5,14,9,13,53,52,1,51
Elgin,2219,6,14,6,16,53,61,-8,48
Annan Athlet,2219,7,12,11,13,48,41,7,47
Berwick,2219,8,9,10,17,33,60,-27,37
Edinburgh Ci,2219,9,7,9,20,36,63,-27,30
Cowdenbeath,2219,10,4,10,22,23,55,-32,22
Montrose,2220,1,24,7,5,63,35,28,79
Peterhead,2220,2,24,4,8,79,39,40,76
Stirling,2220,3,17,6,13,61,51,10,57
Clyde,2220,4,15,9,12,52,48,4,54
Stenhousem'r,2220,5,15,8,13,55,47,8,53
Elgin,2220,6,14,6,16,54,64,-10,48
Annan Athlet,2220,7,11,11,14,47,42,5,44
Berwick,2220,8,8,10,18,29,59,-30,34
Edinburgh Ci,2220,9,7,9,20,37,62,-25,30
Cowdenbeath,2220,10,5,10,21,24,54,-30,25
Montrose,2221,1,24,7,5,60,34,26,79
Peterhead,2221,2,23,5,8,78,39,39,74
Stenhousem'r,2221,3,16,8,12,57,47,10,56
Stirling,2221,4,16,6,14,61,53,8,54
Clyde,2221,5,15,9,12,54,49,5,54
Elgin,2221,6,14,6,16,53,61,-8,48
Annan Athlet,2221,7,12,11,13,48,41,7,47
Berwick,2221,8,8,10,18,30,61,-31,34
Edinburgh Ci,2221,9,7,10,19,37,61,-24,31
Cowdenbeath,2221,10,4,10,22,23,55,-32,22
Montrose,2222,1,24,7,5,63,34,29,79
Peterhead,2222,2,23,5,8,78,39,39,74
Stirling,2222,3,16,7,13,61,52,9,55
Stenhousem'r,2222,4,15,9,12,56,47,9,54
Clyde,2222,5,15,9,12,55,48,7,54
Elgin,2222,6,14,6,16,53,64,-11,48
Annan Athlet,2222,7,11,12,13,50,44,6,45
Berwick,2222,8,8,10,18,29,62,-33,34
Edinburgh Ci,2222,9,7,10,19,37,61,-24,31
Cowdenbeath,2222,10,4,11,21,26,57,-31,23
Montrose,2223,1,23,7,6,60,37,23,76
Peterhead,2223,2,23,5,8,78,39,39,74
Stirling,2223,3,16,7,13,61,52,9,55
Stenhousem'r,2223,4,15,9,12,56,47,9,54
Clyde,2223,5,15,9,12,54,50,4,54
Elgin,2223,6,15,6,15,56,61,-5,51
Annan Athlet,2223,7,11,11,14,48,44,4,44
Berwick,2223,8,8,10,18,31,61,-30,34
Edinburgh Ci,2223,9,7,10,19,37,61,-24,31
Cowdenbeath,2223,10,5,10,21,26,55,-29,25
Montrose,2224,1,24,7,5,63,35,28,79
Peterhead,2224,2,24,4,8,82,39,43,76
Stirling,2224,3,17,6,13,62,51,11,57
Stenhousem'r,2224,4,15,8,13,55,48,7,53
Clyde,2224,5,14,10,12,52,49,3,52
Elgin,2224,6,14,6,16,54,64,-10,48
Annan Athlet,2224,7,11,12,13,48,42,6,45
Berwick,2224,8,8,11,17,30,59,-29,35
Edinburgh Ci,2224,9,7,9,20,37,65,-28,30
Cowdenbeath,2224,10,4,11,21,24,55,-31,23
Montrose,2225,1,24,7,5,60,34,26,79
Peterhead,2225,2,23,4,9,78,41,37,73
Stenhousem'r,2225,3,16,8,12,56,46,10,56
Stirling,2225,4,16,6,14,60,52,8,54
Clyde,2225,5,15,9,12,54,49,5,54
Elgin,2225,6,14,6,16,53,61,-8,48
Annan Athlet,2225,7,11,11,14,47,42,5,44
Berwick,2225,8,8,10,18,30,61,-31,34
Edinburgh Ci,2225,9,8,9,19,39,61,-22,33
Cowdenbeath,2225,10,5,10,21,24,54,-30,25
Montrose,2226,1,24,7,5,64,34,30,79
Peterhead,2226,2,24,4,8,80,40,40,76
Stirling,2226,3,17,6,13,63,53,10,57
Clyde,2226,4,15,9,12,52,48,4,54
Stenhousem'r,2226,5,15,8,13,57,49,8,53
Elgin,2226,6,14,6,16,53,65,-12,48
Annan Athlet,2226,7,11,11,14,47,42,5,44
Berwick,2226,8,8,10,18,29,59,-30,34
Edinburgh Ci,2226,9,7,9,20,38,63,-25,30
Cowdenbeath,2226,10,5,10,21,24,54,-30,25
Montrose,2227,1,24,7,5,65,34,31,79
Peterhead,2227,2,24,4,8,78,38,40,76
Stirling,2227,3,17,6,13,62,51,11,57
Stenhousem'r,2227,4,15,8,13,55,48,7,53
Clyde,2227,5,14,10,12,53,50,3,52
Elgin,2227,6,14,6,16,53,66,-13,48
Annan Athlet,2227,7,12,11,13,50,41,9,47
Berwick,2227,8,8,11,17,31,60,-29,35
Edinburgh Ci,2227,9,7,9,20,36,61,-25,30
Cowdenbeath,2227,10,4,10,22,23,57,-34,22
Peterhead,2228,1,24,4,8,79,38,41,76
Montrose,2228,2,23,7,6,59,35,24,76
Stirling,2228,3,17,6,13,62,52,10,57
Clyde,2228,4,15,9,12,54,49,5,54
Stenhousem'r,2228,5,15,8,13,56,48,8,53
Elgin,2228,6,15,6,15,54,60,-6,51
Annan Athlet,2228,7,12,11,13,48,41,7,47
Berwick,2228,8,8,10,18,30,61,-31,34
Edinburgh Ci,2228,9,7,9,20,36,62,-26,30
Cowdenbeath,2228,10,4,10,22,23,55,-32,22
Montrose,2229,1,24,7,5,63,35,28,79
Peterhead,2229,2,24,4,8,83,38,45,76
Stirling,2229,3,17,6,13,62,52,10,57
Clyde,2229,4,15,9,12,54,49,5,54
Stenhousem'r,2229,5,15,8,13,56,48,8,53
Elgin,2229,6,14,6,16,54,64,-10,48
Annan Athlet,2229,7,12,11,13,48,41,7,47
Berwick,2229,8,8,10,18,30,61,-31,34
Edinburgh Ci,2229,9,7,9,20,36,66,-30,30
Cowdenbeath,2229,10,4,10,22,23,55,-32,22
Montrose,2230,1,24,7,5,62,35,27,79
Peterhead,2230,2,24,4,8,82,40,42,76
Stirling,2230,3,16,7,13,63,54,9,55
Stenhousem'r,2230,4,15,9,12,58,49,9,54
Clyde,2230,5,15,9,12,54,48,6,54
Elgin,2230,6,14,6,16,54,63,-9,48
Annan Athlet,2230,7,11,11,14,47,42,5,44
Berwick,2230,8,8,10,18,29,61,-32,34
Edinburgh Ci,2230,9,7,9,20,38,65,-27,30
Cowdenbeath,2230,10,5,10,21,24,54,-30,25
Montrose,2231,1,23,8,5,61,36,25,77
Peterhead,2231,2,24,4,8,79,39,40,76
Stirling,2231,3,17,6,13,61,51,10,57
Clyde,2231,4,15,9,12,53,48,5,54
Stenhousem'r,2231,5,15,8,13,55,47,8,53
Elgin,2231,6,14,7,15,55,62,-7,49
Annan Athlet,2231,7,12,11,13,48,41,7,47
Berwick,2231,8,8,10,18,29,60,-31,34
Edinburgh Ci,2231,9,7,9,20,37,62,-25,30
Cowdenbeath,2231,10,4,10,22,23,55,-32,22
Montrose,2232,1,24,7,5,61,34,27,79
Peterhead,2232,2,24,4,8,80,38,42,76
Stirling,2232,3,17,6,13,62,52,10,57
Clyde,2232,4,15,9,12,53,49,4,54
Stenhousem'r,2232,5,15,8,13,56,48,8,53
Elgin,2232,6,14,6,16,53,62,-9,48
Annan Athlet,2232,7,12,11,13,50,43,7,47
Berwick,2232,8,8,10,18,30,60,-30,34
Edinburgh Ci,2232,9,7,9,20,36,63,-27,30
Cowdenbeath,2232,10,4,10,22,25,57,-32,22
Montrose,2233,1,23,8,5,61,36,25,77
Peterhead,2233,2,23,5,8,78,39,39,74
Stirling,2233,3,16,7,13,62,53,9,55
Stenhousem'r,2233,4,15,9,12,57,48,9,54
Clyde,2233,5,15,9,12,54,48,6,54
Elgin,2233,6,14,7,15,55,62,-7,49
Annan Athlet,2233,7,11,12,13,48,42,6,45
Berwick,2233,8,8,10,18,29,61,-32,34
Edinburgh Ci,2233,9,7,10,19,37,61,-24,31
Cowdenbeath,2233,10,4,11,21,24,55,-31,23
Montrose,2234,1,23,8,5,60,35,25,77
Peterhead,2234,2,24,4,8,82,38,44,76
Stenhousem'r,2234,3,16,8,12,57,47,10,56
Stirling,2234,4,16,6,14,61,53,8,54
Clyde,2234,5,15,9,12,55,48,7,54
Elgin,2234,6,14,7,15,54,61,-7,49
Annan Athlet,2234,7,12,11,13,50,42,8,47
Berwick,2234,8,8,10,18,29,62,-33,34
Edinburgh Ci,2234,9,7,9,20,36,65,-29,30
Cowdenbeath,2234,10,4,10,22,24,57,-33,22
Montrose,2235,1,24,7,5,61,34,27,79
Peterhead,2235,2,23,4,9,79,41,38,73
Stirling,2235,3,17,6,13,63,52,11,57
Clyde,2235,4,15,9,12,54,49,5,54
Stenhousem'r,2235,5,15,8,13,56,49,7,53
Elgin,2235,6,14,6,16,53,62,-9,48
Annan Athlet,2235,7,11,11,14,47,42,5,44
Berwick,2235,8,8,10,18,30,61,-31,34
Edinburgh Ci,2235,9,8,9,19,39,62,-23,33
Cowdenbeath,2235,10,5,10,21,24,54,-30,25
Montrose,2236,1,23,8,5,61,36,25,77
Peterhead,2236,2,24,4,8,79,39,40,76
Stenhousem'r,2236,3,16,8,12,57,47,10,56
Stirling,2236,4,16,6,14,61,53,8,54
Clyde,2236,5,15,9,12,53,49,4,54
Elgin,2236,6,14,7,15,55,62,-7,49
Annan Athlet,2236,7,12,11,13,50,41,9,47
Berwick,2236,8,8,10,18,30,60,-30,34
Edinburgh Ci,2236,9,7,9,20,37,62,-25,30
Cowdenbeath,2236,10,4,10,22,23,57,-34,22
Montrose,2237,1,24,7,5,63,34,29,79
Peterhead,2237,2,24,4,8,80,38,42,76
Stirling,2237,3,17,6,13,61,51,10,57
Clyde,2237,4,15,9,12,55,48,7,54
Stenhousem'r,2237,5,15,8,13,55,47,8,53
Elgin,2237,6,14,6,16,53,64,-11,48
Annan Athlet,2237,7,11,11,14,48,43,5,44
Berwick,2237,8,8,10,18,29,62,-33,34
Edinburgh Ci,2237,9,7,9,20,36,63,-27,30
Cowdenbeath,2237,10,5,10,21,25,55,-30,25
Montrose,2238,1,24,7,5,64,37,27,79
Peterhead,2238,2,24,4,8,79,39,40,76
Stirling,2238,3,17,6,13,64,53,11,57
Clyde,2238,4,15,9,12,55,49,6,54
Stenhousem'r,2238,5,15,8,13,57,50,7,53
Elgin,2238,6,14,6,16,56,65,-9,48
Annan Athlet,2238,7,12,11,13,48,41,7,47
Berwick,2238,8,8,10,18,30,62,-32,34
Edinburgh Ci,2238,9,7,9,20,37,62,-25,30
Cowdenbeath,2238,10,4,10,22,23,55,-32,22
Montrose,2239,1,24,7,5,60,34,26,79
Peterhead,2239,2,24,4,8,79,39,40,76
Stirling,2239,3,17,6,13,62,52,10,57
Clyde,2239,4,15,9,12,53,49,4,54
Stenhousem'r,2239,5,15,8,13,56,48,8,53
Elgin,2239,6,14,6,16,53,61,-8,48
Annan Athlet,2239,7,12,11,13,51,41,10,47
Berwick,2239,8,8,10,18,30,60,-30,34
Edinburgh Ci,2239,9,7,9,20,37,62,-25,30
Cowdenbeath,2239,10,4,10,22,23,58,-35,22
Peterhead,2240,1,24,4,8,83,38,45,76
Montrose,2240,2,23,7,6,61,37,24,76
Stirling,2240,3,17,6,13,61,51,10,57
Stenhousem'r,2240,4,15,8,13,55,47,8,53
Clyde,2240,5,14,10,12,52,49,3,52
Elgin,2240,6,15,6,15,56,62,-6,51
Annan Athlet,2240,7,11,12,13,47,41,6,45
Berwick,2240,8,8,11,17,30,59,-29,35
Edinburgh Ci,2240,9,7,9,20,36,66,-30,30
Cowdenbeath,2240,10,4,11,21,23,54,-31,23
Montrose,2241,1,23,8,5,60,35,25,77
Peterhead,2241,2,23,4,9,77,40,37,73
Stirling,2241,3,17,6,13,61,51,10,57
Clyde,2241,4,15,9,12,56,49,7,54
Stenhousem'r,2241,5,15,8,13,55,47,8,53
Elgin,2241,6,14,7,15,54,61,-7,49
Annan Athlet,2241,7,11,12,13,48,42,6,45
Berwick,2241,8,8,10,18,30,63,-33,34
Edinburgh Ci,2241,9,8,9,19,38,60,-22,33
Cowdenbeath,2241,10,4,11,21,24,55,-31,23
Montrose,2242,1,23,8,5,60,35,25,77
Peterhead,2242,2,24,4,8,79,39,40,76
Stenhousem'r,2242,3,16,8,12,58,47,11,56
Stirling,2242,4,16,6,14,61,54,7,54
Clyde,2242,5,14,10,12,53,50,3,52
Elgin,2242,6,14,7,15,54,61,-7,49
Annan Athlet,2242,7,11,11,14,48,43,5,44
Berwick,2242,8,8,11,17,31,60,-29,35
Edinburgh Ci,2242,9,7,9,20,37,62,-25,30
Cowdenbeath,2242,10,5,10,21,25,55,-30,25
Peterhead,2243,1,24,4,8,80,38,42,76
Montrose,2243,2,23,7,6,59,35,24,76
Stirling,2243,3,17,6,13,61,51,10,57
Stenhousem'r,2243,4,15,8,13,55,47,8,53
Clyde,2243,5,14,10,12,54,51,3,52
Elgin,2243,6,15,6,15,54,60,-6,51
Annan Athlet,2243,7,12,11,13,49,41,8,47
Berwick,2243,8,8,11,17,32,61,-29,35
Edinburgh Ci,2243,9,7,9,20,36,63,-27,30
Cowdenbeath,2243,10,4,10,22,23,56,-33,22
Peterhead,2244,1,24,4,8,79,38,41,76
Montrose,2244,2,23,7,6,60,36,24,76
Stenhousem'r,2244,3,16,8,12,56,46,10,56
Stirling,2244,4,16,6,14,60,52,8,54
Clyde,2244,5,15,9,12,54,49,5,54
Elgin,2244,6,15,6,15,55,61,-6,51
Annan Athlet,2244,7,12,11,13,49,41,8,47
Berwick,2244,8,8,10,18,30,61,-31,34
Edinburgh Ci,2244,9,7,9,20,36,62,-26,30
Cowdenbeath,2244,10,4,10,22,23,56,-33,22
Montrose,2245,1,23,8,5,59,34,25,77
Peterhead,2245,2,24,4,8,82,38,44,76
Stirling,2245,3,16,7,13,62,53,9,55
Stenhousem'r,2245,4,15,9,12,57,48,9,54
Clyde,2245,5,14,10,12,53,50,3,52
Elgin,2245,6,14,7,15,53,60,-7,49
Annan Athlet,2245,7,11,12,13,47,41,6,45
Berwick,2245,8,8,11,17,31,60,-29,35
Edinburgh Ci,2245,9,7,9,20,36,65,-29,30
Cowdenbeath,2245,10,4,11,21,23,54,-31,23
Montrose,2246,1,23,8,5,60,35,25,77
Peterhead,2246,2,24,4,8,80,39,41,76
Stirling,2246,3,17,6,13,63,52,11,57
Clyde,2246,4,15,9,12,53,48,5,54
Stenhousem'r,2246,5,15,8,13,56,49,7,53
Elgin,2246,6,14,7,15,54,61,-7,49
Annan Athlet,2246,7,12,11,13,48,41,7,47
Berwick,2246,8,8,10,18,29,60,-31,34
Edinburgh Ci,2246,9,7,9,20,37,63,-26,30
Cowdenbeath,2246,10,4,10,22,23,55,-32,22
Montrose,2247,1,23,8,5,60,35,25,77
Peterhead,2247,2,23,5,8,79,40,39,74
Stirling,2247,3,16,7,13,61,52,9,55
Stenhousem'r,2247,4,15,9,12,56,47,9,54
Clyde,2247,5,14,10,12,54,51,3,52
Elgin,2247,6,14,7,15,54,61,-7,49
Annan Athlet,2247,7,11,12,13,48,42,6,45
Berwick,2247,8,8,11,17,32,61,-29,35
Edinburgh Ci,2247,9,7,10,19,38,62,-24,31
Cowdenbeath,2247,10,4,11,21,24,55,-31,23
Montrose,2248,1,24,7,5,64,35,29,79
Peterhead,2248,2,24,4,8,80,38,42,76
Stenhousem'r,2248,3,16,8,12,57,47,10,56
Stirling,2248,4,16,6,14,61,53,8,54
Clyde,2248,5,14,9,13,52,50,2,51
Elgin,2248,6,14,6,16,54,65,-11,48
Annan Athlet,2248,7,12,11,13,49,42,7,47
Berwick,2248,8,9,10,17,31,59,-28,37
Edinburgh Ci,2248,9,7,9,20,36,63,-27,30
Cowdenbeath,2248,10,4,10,22,24,56,-32,22
Montrose,2249,1,24,7,5,63,34,29,79
Peterhead,2249,2,24,4,8,78,38,40,76
Stirling,2249,3,16,7,13,61,52,9,55
Stenhousem'r,2249,4,15,9,12,56,47,9,54
Clyde,2249,5,15,9,12,54,48,6,54
Elgin,2249,6,14,6,16,53,64,-11,48
Annan Athlet,2249,7,11,12,13,48,42,6,45
Berwick,2249,8,8,10,18,29,61,-32,34
Edinburgh Ci,2249,9,7,9,20,36,61,-25,30
Cowdenbeath,2249,10,4,11,21,24,55,-31,23
Peterhead,2250,1,24,4,8,80,38,42,76
Montrose,2250,2,23,7,6,60,36,24,76
Stirling,2250,3,17,6,13,61,51,10,57
Clyde,2250,4,15,9,12,53,49,4,54
Stenhousem'r,2250,5,15,8,13,55,47,8,53
Elgin,2250,6,15,6,15,55,61,-6,51
Annan Athlet,2250,7,11,12,13,48,42,6,45
Berwick,2250,8,8,10,18,30,60,-30,34
Edinburgh Ci,2250,9,7,9,20,36,63,-27,30
Cowdenbeath,2250,10,4,11,21,24,55,-31,23
Montrose,2251,1,24,7,5,60,34,26,79
Peterhead,2251,2,23,4,9,77,39,38,73
Stirling,2251,3,17,6,13,63,53,10,57
Clyde,2251,4,15,9,12,55,48,7,54
Stenhousem'r,2251,5,15,8,13,57,49,8,53
Elgin,2251,6,14,6,16,53,61,-8,48
Annan Athlet,2251,7,11,12,13,48,42,6,45
Berwick,2251,8,8,10,18,29,62,-33,34
Edinburgh Ci,2251,9,8,9,19,37,60,-23,33
Cowdenbeath,2251,10,4,11,21,24,55,-31,23
Montrose,2252,1,24,7,5,61,34,27,79
Peterhead,2252,2,24,4,8,81,38,43,76
Stenhousem'r,2252,3,16,8,12,57,47,10,56
Stirling,2252,4,16,6,14,61,53,8,54
Clyde,2252,5,15,9,12,55,48,7,54
Elgin,2252,6,14,6,16,53,62,-9,48
Annan Athlet,2252,7,11,12,13,47,41,6,45
Berwick,2252,8,8,10,18,29,62,-33,34
Edinburgh Ci,2252,9,7,9,20,36,64,-28,30
Cowdenbeath,2252,10,4,11,21,23,54,-31,23
Montrose,2253,1,24,7,5,61,35,26,79
Peterhead,2253,2,24,4,8,79,38,41,76
Stirling,2253,3,16,7,13,61,52,9,55
Stenhousem'r,2253,4,15,9,12,56,47,9,54
Clyde,2253,5,15,9,12,54,48,6,54
Elgin,2253,6,14,6,16,54,62,-8,48
Annan Athlet,2253,7,11,11,14,47,43,4,44
Berwick,2253,8,8,10,18,29,61,-32,34
Edinburgh Ci,2253,9,7,9,20,36,62,-26,30
Cowdenbeath,2253,10,5,10,21,25,54,-29,25
Montrose,2254,1,23,8,5,62,37,25,77
Peterhead,2254,2,24,4,8,80,39,41,76
Stirling,2254,3,17,6,13,63,53,10,57
Clyde,2254,4,15,9,12,52,48,4,54
Stenhousem'r,2254,5,15,8,13,57,49,8,53
Elgin,2254,6,14,7,15,56,63,-7,49
Annan Athlet,2254,7,12,11,13,48,41,7,47
Berwick,2254,8,8,10,18,29,59,-30,34
Edinburgh Ci,2254,9,7,9,20,37,63,-26,30
Cowdenbeath,2254,10,4,10,22,23,55,-32,22
Montrose,2255,1,23,8,5,62,37,25,77
Peterhead,2255,2,24,4,8,80,38,42,76
Stirling,2255,3,17,6,13,63,51,12,57
Clyde,2255,4,15,9,12,53,48,5,54
Stenhousem'r,2255,5,15,8,13,55,49,6,53
Elgin,2255,6,14,7,15,56,63,-7,49
Annan Athlet,2255,7,12,11,13,48,41,7,47
Berwick,2255,8,8,10,18,29,60,-31,34
Edinburgh Ci,2255,9,7,9,20,36,63,-27,30
Cowdenbeath,2255,10,4,10,22,23,55,-32,22
Peterhead,2256,1,24,4,8,82,41,41,76
Montrose,2256,2,23,7,6,59,37,22,76
Stirling,2256,3,17,6,13,63,51,12,57
Clyde,2256,4,15,9,12,54,49,5,54
Stenhousem'r,2256,5,15,8,13,55,49,6,53
Elgin,2256,6,15,6,15,56,60,-4,51
Annan Athlet,2256,7,12,11,13,49,42,7,47
Berwick,2256,8,8,10,18,30,61,-31,34
Edinburgh Ci,2256,9,7,9,20,39,65,-26,30
Cowdenbeath,2256,10,4,10,22,24,56,-32,22
Montrose,2257,1,24,7,5,61,34,27,79
Peterhead,2257,2,23,5,8,78,39,39,74
Stirling,2257,3,17,6,13,63,51,12,57
Clyde,2257,4,15,9,12,53,48,5,54
Stenhousem'r,2257,5,15,8,13,55,49,6,53
Elgin,2257,6,14,6,16,53,62,-9,48
Annan Athlet,2257,7,11,11,14,48,43,5,44
Berwick,2257,8,8,10,18,29,60,-31,34
Edinburgh Ci,2257,9,7,10,19,37,61,-24,31
Cowdenbeath,2257,10,5,10,21,25,55,-30,25
Montrose,2258,1,24,7,5,61,35,26,79
Peterhead,2258,2,24,4,8,83,40,43,76
Stirling,2258,3,16,7,13,63,54,9,55
Stenhousem'r,2258,4,15,9,12,58,49,9,54
Clyde,2258,5,15,9,12,53,49,4,54
Elgin,2258,6,14,6,16,54,62,-8,48
Annan Athlet,2258,7,12,11,13,48,41,7,47
Berwick,2258,8,8,10,18,30,60,-30,34
Edinburgh Ci,2258,9,7,9,20,38,66,-28,30
Cowdenbeath,2258,10,4,10,22,23,55,-32,22
Montrose,2259,1,24,7,5,61,35,26,79
Peterhead,2259,2,24,4,8,79,39,40,76
Stenhousem'r,2259,3,16,8,12,59,47,12,56
Stirling,2259,4,16,6,14,61,55,6,54
Clyde,2259,5,14,9,13,51,50,1,51
Elgin,2259,6,14,6,16,54,62,-8,48
Annan Athlet,2259,7,12,11,13,48,41,7,47
Berwick,2259,8,9,10,17,31,58,-27,37
Edinburgh Ci,2259,9,7,9,20,37,62,-25,30
Cowdenbeath,2259,10,4,10,22,23,55,-32,22
Montrose,2260,1,23,7,6,60,36,24,76
Peterhead,2260,2,23,5,8,78,39,39,74
Stirling,2260,3,17,6,13,63,53,10,57
Clyde,2260,4,15,9,12,54,48,6,54
Stenhousem'r,2260,5,15,8,13,57,49,8,53
Elgin,2260,6,15,6,15,55,61,-6,51
Annan Athlet,2260,7,11,12,13,49,43,6,45
Berwick,2260,8,8,10,18,29,61,-32,34
Edinburgh Ci,2260,9,7,10,19,37,61,-24,31
Cowdenbeath,2260,10,4,11,21,25,56,-31,23
Montrose,2261,1,24,7,5,61,35,26,79
Peterhead,2261,2,24,4,8,82,38,44,76
Stirling,2261,3,17,6,13,64,53,11,57
Stenhousem'r,2261,4,15,8,13,57,50,7,53
Clyde,2261,5,14,10,12,51,48,3,52
Elgin,2261,6,14,6,16,54,62,-8,48
Annan Athlet,2261,7,11,11,14,47,42,5,44
Berwick,2261,8,8,11,17,29,58,-29,35
Edinburgh Ci,2261,9,7,9,20,36,65,-29,30
Cowdenbeath,2261,10,5,10,21,24,54,-30,25
Peterhead,2262,1,24,4,8,81,40,41,76
Montrose,2262,2,23,7,6,59,35,24,76
Stenhousem'r,2262,3,16,8,12,57,47,10,56
Clyde,2262,4,15,9,12,57,48,9,54
Stirling,2262,5,16,6,14,61,53,8,54
Elgin,2262,6,15,6,15,54,60,-6,51
Annan Athlet,2262,7,11,11,14,47,42,5,44
Berwick,2262,8,8,10,18,29,64,-35,34
Edinburgh Ci,2262,9,7,9,20,38,64,-26,30
Cowdenbeath,2262,10,5,10,21,24,54,-30,25
Montrose,2263,1,24,7,5,62,35,27,79
Peterhead,2263,2,24,4,8,81,39,42,76
Stirling,2263,3,17,6,13,63,52,11,57
Clyde,2263,4,15,9,12,53,49,4,54
Stenhousem'r,2263,5,15,8,13,56,49,7,53
Elgin,2263,6,14,6,16,54,63,-9,48
Annan Athlet,2263,7,11,12,13,48,42,6,45
Berwick,2263,8,8,10,18,30,60,-30,34
Edinburgh Ci,2263,9,7,9,20,37,64,-27,30
Cowdenbeath,2263,10,4,11,21,24,55,-31,23
Montrose,2264,1,23,7,6,59,35,24,76
Peterhead,2264,2,23,4,9,79,41,38,73
Stirling,2264,3,17,6,13,63,52,11,57
Clyde,2264,4,15,9,12,54,49,5,54
Stenhousem'r,2264,5,15,8,13,56,49,7,53
Elgin,2264,6,15,6,15,54,60,-6,51
Annan Athlet,2264,7,11,11,14,48,45,3,44
Berwick,2264,8,8,10,18,30,61,-31,34
Edinburgh Ci,2264,9,8,9,19,39,62,-23,33
Cowdenbeath,2264,10,5,10,21,27,55,-28,25
Montrose,2265,1,23,8,5,60,35,25,77
Peterhead,2265,2,24,4,8,78,38,40,76
Stirling,2265,3,17,6,13,61,51,10,57
Stenhousem'r,2265,4,15,8,13,55,47,8,53
Clyde,2265,5,14,10,12,52,49,3,52
Elgin,2265,6,14,7,15,54,61,-7,49
Annan Athlet,2265,7,11,12,13,48,42,6,45
Berwick,2265,8,8,11,17,30,59,-29,35
Edinburgh Ci,2265,9,7,9,20,36,61,-25,30
Cowdenbeath,2265,10,4,11,21,24,55,-31,23
Peterhead,2266,1,24,4,8,80,38,42,76
Montrose,2266,2,23,7,6,60,36,24,76
Stirling,2266,3,16,7,13,61,52,9,55
Stenhousem'r,2266,4,15,9,12,56,47,9,54
Clyde,2266,5,15,9,12,54,48,6,54
Elgin,2266,6,15,6,15,55,61,-6,51
Annan Athlet,2266,7,12,11,13,49,42,7,47
Berwick,2266,8,8,10,18,29,61,-32,34
Edinburgh Ci,2266,9,7,9,20,36,63,-27,30
Cowdenbeath,2266,10,4,10,22,24,56,-32,22
Montrose,2267,1,24,7,5,62,34,28,79
Peterhead,2267,2,24,4,8,82,40,42,76
Stirling,2267,3,17,6,13,62,52,10,57
Clyde,2267,4,15,9,12,53,49,4,54
Stenhousem'r,2267,5,15,8,13,56,48,8,53
Elgin,2267,6,14,6,16,53,63,-10,48
Annan Athlet,2267,7,11,11,14,49,44,5,44
Berwick,2267,8,8,10,18,30,60,-30,34
Edinburgh Ci,2267,9,7,9,20,38,65,-27,30
Cowdenbeath,2267,10,5,10,21,26,56,-30,25
Montrose,2268,1,23,8,5,60,35,25,77
Peterhead,2268,2,24,4,8,81,39,42,76
Stirling,2268,3,17,6,13,61,51,10,57
Stenhousem'r,2268,4,15,8,13,55,47,8,53
Clyde,2268,5,14,10,12,52,49,3,52
Elgin,2268,6,14,7,15,54,61,-7,49
Annan Athlet,2268,7,11,11,14,47,42,5,44
Berwick,2268,8,8,11,17,30,59,-29,35
Edinburgh Ci,2268,9,7,9,20,37,64,-27,30
Cowdenbeath,2268,10,5,10,21,24,54,-30,25
Montrose,2269,1,23,8,5,59,34,25,77
Peterhead,2269,2,24,4,8,78,38,40,76
Stenhousem'r,2269,3,16,8,12,56,46,10,56
Stirling,2269,4,16,6,14,60,52,8,54
Clyde,2269,5,14,10,12,52,49,3,52
Elgin,2269,6,14,7,15,53,60,-7,49
Annan Athlet,2269,7,12,11,13,50,43,7,47
Berwick,2269,8,8,11,17,30,59,-29,35
Edinburgh Ci,2269,9,7,9,20,36,61,-25,30
Cowdenbeath,2269,10,4,10,22,25,57,-32,22
Peterhead,2270,1,24,4,8,79,39,40,76
Montrose,2270,2,23,7,6,59,35,24,76
Stirling,2270,3,17,6,13,64,53,11,57
Stenhousem'r,2270,4,15,8,13,57,50,7,53
Clyde,2270,5,14,10,12,52,49,3,52
Elgin,2270,6,15,6,15,54,60,-6,51
Annan Athlet,2270,7,11,11,14,48,45,3,44
Berwick,2270,8,8,11,17,30,59,-29,35
Edinburgh Ci,2270,9,7,9,20,37,62,-25,30
Cowdenbeath,2270,10,5,10,21,27,55,-28,25
Montrose,2271,1,24,7,5,60,34,26,79
Peterhead,2271,2,24,4,8,79,38,41,76
Stirling,2271,3,17,6,13,61,51,10,57
Stenhousem'r,2271,4,15,8,13,55,47,8,53
Clyde,2271,5,14,10,12,52,49,3,52
Elgin,2271,6,14,6,16,53,61,-8,48
Annan Athlet,2271,7,12,11,13,49,41,8,47
Berwick,2271,8,8,11,17,30,59,-29,35
Edinburgh Ci,2271,9,7,9,20,36,62,-26,30
Cowdenbeath,2271,10,4,10,22,23,56,-33,22
Montrose,2272,1,24,7,5,61,35,26,79
Peterhead,2272,2,24,4,8,79,39,40,76
Stirling,2272,3,17,6,13,64,54,10,57
Stenhousem'r,2272,4,15,8,13,58,50,8,53
Clyde,2272,5,14,10,12,52,49,3,52
Elgin,2272,6,14,6,16,54,62,-8,48
Annan Athlet,2272,7,12,11,13,49,42,7,47
Berwick,2272,8,8,11,17,30,59,-29,35
Edinburgh Ci,2272,9,7,9,20,37,62,-25,30
Cowdenbeath,2272,10,4,10,22,24,56,-32,22
Montrose,2273,1,24,7,5,66,37,29,79
Peterhead,2273,2,24,4,8,80,38,42,76
Stirling,2273,3,17,6,13,64,53,11,57
Stenhousem'r,2273,4,15,8,13,57,50,7,53
Clyde,2273,5,14,10,12,52,49,3,52
Elgin,2273,6,14,6,16,56,67,-11,48
Annan Athlet,2273,7,12,11,13,49,41,8,47
Berwick,2273,8,8,11,17,30,59,-29,35
Edinburgh Ci,2273,9,7,9,20,36,63,-27,30
Cowdenbeath,2273,10,4,10,22,23,56,-33,22
Montrose,2274,1,23,7,6,59,35,24,76
Peterhead,2274,2,23,5,8,78,39,39,74
Stenhousem'r,2274,3,16,8,12,58,47,11,56
Stirling,2274,4,16,6,14,61,54,7,54
Clyde,2274,5,14,10,12,52,49,3,52
Elgin,2274,6,15,6,15,54,60,-6,51
Annan Athlet,2274,7,12,11,13,49,41,8,47
Berwick,2274,8,8,11,17,30,59,-29,35
Edinburgh Ci,2274,9,7,10,19,37,61,-24,31
Cowdenbeath,2274,10,4,10,22,23,56,-33,22
Montrose,2275,1,24,7,5,60,34,26,79
Peterhead,2275,2,24,4,8,79,39,40,76
Stirling,2275,3,16,7,13,61,52,9,55
Stenhousem'r,2275,4,15,9,12,56,47,9,54
Clyde,2275,5,14,9,13,52,51,1,51
Elgin,2275,6,14,6,16,53,61,-8,48
Annan Athlet,2275,7,12,11,13,49,42,7,47
Berwick,2275,8,9,10,17,32,59,-27,37
Edinburgh Ci,2275,9,7,9,20,37,62,-25,30
Cowdenbeath,2275,10,4,10,22,24,56,-32,22
Montrose,2276,1,24,7,5,62,34,28,79
Peterhead,2276,2,24,4,8,80,38,42,76
Stirling,2276,3,17,6,13,63,51,12,57
Stenhousem'r,2276,4,15,8,13,55,49,6,53
Clyde,2276,5,14,10,12,51,48,3,52
Elgin,2276,6,14,6,16,53,63,-10,48
Annan Athlet,2276,7,11,11,14,47,42,5,44
Berwick,2276,8,8,11,17,29,58,-29,35
Edinburgh Ci,2276,9,7,9,20,36,63,-27,30
Cowdenbeath,2276,10,5,10,21,24,54,-30,25
Peterhead,2277,1,24,4,8,85,39,46,76
Montrose,2277,2,23,7,6,60,36,24,76
Stenhousem'r,2277,3,16,8,12,57,46,11,56
Stirling,2277,4,16,6,14,60,53,7,54
Clyde,2277,5,15,9,12,54,48,6,54
Elgin,2277,6,15,6,15,55,61,-6,51
Annan Athlet,2277,7,11,11,14,48,44,4,44
Berwick,2277,8,8,10,18,29,61,-32,34
Edinburgh Ci,2277,9,7,9,20,37,68,-31,30
Cowdenbeath,2277,10,5,10,21,26,55,-29,25
Montrose,2278,1,23,7,6,61,38,23,76
Peterhead,2278,2,23,5,8,80,41,39,74
Stirling,2278,3,17,6,13,61,51,10,57
Clyde,2278,4,15,9,12,53,48,5,54
Stenhousem'r,2278,5,15,8,13,55,47,8,53
Elgin,2278,6,15,6,15,57,62,-5,51
Annan Athlet,2278,7,12,11,13,48,41,7,47
Berwick,2278,8,8,10,18,29,60,-31,34
Edinburgh Ci,2278,9,7,10,19,39,63,-24,31
Cowdenbeath,2278,10,4,10,22,23,55,-32,22
Montrose,2279,1,23,8,5,60,35,25,77
Peterhead,2279,2,23,4,9,79,41,38,73
Stenhousem'r,2279,3,16,8,12,57,47,10,56
Stirling,2279,4,16,6,14,61,53,8,54
Clyde,2279,5,15,9,12,53,48,5,54
Elgin,2279,6,14,7,15,54,61,-7,49
Annan Athlet,2279,7,12,11,13,48,41,7,47
Berwick,2279,8,8,10,18,29,60,-31,34
Edinburgh Ci,2279,9,8,9,19,39,62,-23,33
Cowdenbeath,2279,10,4,10,22,23,55,-32,22
Montrose,2280,1,24,7,5,63,37,26,79
Peterhead,2280,2,24,4,8,81,39,42,76
Stirling,2280,3,16,7,13,61,52,9,55
Stenhousem'r,2280,4,15,9,12,56,47,9,54
Clyde,2280,5,14,10,12,51,48,3,52
Elgin,2280,6,14,6,16,56,64,-8,48
Annan Athlet,2280,7,11,12,13,48,42,6,45
Berwick,2280,8,8,11,17,29,58,-29,35
Edinburgh Ci,2280,9,7,9,20,37,64,-27,30
Cowdenbeath,2280,10,4,11,21,24,55,-31,23
Montrose,2281,1,24,7,5,62,34,28,79
Peterhead,2281,2,24,4,8,82,39,43,76
Stirling,2281,3,17,6,13,61,51,10,57
Stenhousem'r,2281,4,15,8,13,55,47,8,53
Clyde,2281,5,14,9,13,52,50,2,51
Elgin,2281,6,14,6,16,53,63,-10,48
Annan Athlet,2281,7,12,11,13,48,41,7,47
Berwick,2281,8,9,10,17,31,59,-28,37
Edinburgh Ci,2281,9,7,9,20,37,65,-28,30
Cowdenbeath,2281,10,4,10,22,23,55,-32,22
Montrose,2282,1,23,8,5,61,36,25,77
Peterhead,2282,2,24,4,8,82,38,44,76
Stirling,2282,3,16,7,13,61,52,9,55
Stenhousem'r,2282,4,15,9,12,56,47,9,54
Clyde,2282,5,14,9,13,51,49,2,51
Elgin,2282,6,14,7,15,55,62,-7,49
Annan Athlet,2282,7,12,11,13,49,41,8,47
Berwick,2282,8,9,10,17,30,58,-28,37
Edinburgh Ci,2282,9,7,9,20,36,65,-29,30
Cowdenbeath,2282,10,4,10,22,23,56,-33,22
Montrose,2283,1,24,7,5,61,34,27,79
Peterhead,2283,2,24,4,8,82,39,43,76
Stirling,2283,3,17,6,13,62,52,10,57
Stenhousem'r,2283,4,15,8,13,56,48,8,53
Clyde,2283,5,14,10,12,52,49,3,52
Elgin,2283,6,14,6,16,53,62,-9,48
Annan Athlet,2283,7,11,11,14,47,43,4,44
Berwick,2283,8,8,11,17,30,59,-29,35
Edinburgh Ci,2283,9,7,9,20,37,65,-28,30
Cowdenbeath,2283,10,5,10,21,25,54,-29,25
Montrose,2284,1,23,8,5,62,37,25,77
Peterhead,2284,2,23,5,8,78,39,39,74
Stirling,2284,3,17,6,13,63,51,12,57
Clyde,2284,4,15,9,12,54,48,6,54
Stenhousem'r,2284,5,15,8,13,55,49,6,53
Elgin,2284,6,14,7,15,56,63,-7,49
Annan Athlet,2284,7,11,12,13,47,41,6,45
Berwick,2284,8,8,10,18,29,61,-32,34
Edinburgh Ci,2284,9,7,10,19,37,61,-24,31
Cowdenbeath,2284,10,4,11,21,23,54,-31,23
Montrose,2285,1,24,7,5,61,34,27,79
Peterhead,2285,2,24,4,8,81,40,41,76
Stenhousem'r,2285,3,16,8,12,56,46,10,56
Stirling,2285,4,16,6,14,60,52,8,54
Clyde,2285,5,15,9,12,55,48,7,54
Elgin,2285,6,14,6,16,53,62,-9,48
Annan Athlet,2285,7,11,11,14,47,44,3,44
Berwick,2285,8,8,10,18,29,62,-33,34
Edinburgh Ci,2285,9,7,9,20,38,64,-26,30
Cowdenbeath,2285,10,5,10,21,26,54,-28,25
Montrose,2286,1,24,7,5,62,34,28,79
Peterhead,2286,2,24,4,8,82,41,41,76
Stirling,2286,3,17,6,13,61,51,10,57
Clyde,2286,4,15,9,12,54,48,6,54
Stenhousem'r,2286,5,15,8,13,55,47,8,53
Elgin,2286,6,14,6,16,53,63,-10,48
Annan Athlet,2286,7,11,11,14,47,44,3,44
Berwick,2286,8,8,10,18,29,61,-32,34
Edinburgh Ci,2286,9,7,9,20,39,65,-26,30
Cowdenbeath,2286,10,5,10,21,26,54,-28,25
Montrose,2287,1,24,7,5,63,36,27,79
Peterhead,2287,2,23,5,8,78,39,39,74
Stirling,2287,3,17,6,13,62,52,10,57
Stenhousem'r,2287,4,15,8,13,56,48,8,53
Clyde,2287,5,14,9,13,52,51,1,51
Elgin,2287,6,14,6,16,55,64,-9,48
Annan Athlet,2287,7,12,11,13,48,41,7,47
Berwick,2287,8,9,10,17,32,59,-27,37
Edinburgh Ci,2287,9,7,10,19,37,61,-24,31
Cowdenbeath,2287,10,4,10,22,23,55,-32,22
Montrose,2288,1,24,7,5,61,34,27,79
Peterhead,2288,2,24,4,8,79,39,40,76
Stirling,2288,3,17,6,13,64,51,13,57
Stenhousem'r,2288,4,15,8,13,55,50,5,53
Clyde,2288,5,14,9,13,51,49,2,51
Elgin,2288,6,14,6,16,53,62,-9,48
Annan Athlet,2288,7,12,11,13,48,41,7,47
Berwick,2288,8,9,10,17,30,58,-28,37
Edinburgh Ci,2288,9,7,9,20,37,62,-25,30
Cowdenbeath,2288,10,4,10,22,23,55,-32,22
Montrose,2289,1,24,7,5,61,35,26,79
Peterhead,2289,2,24,4,8,80,40,40,76
Stenhousem'r,2289,3,16,8,12,57,47,10,56
Stirling,2289,4,16,6,14,61,53,8,54
Clyde,2289,5,14,9,13,54,53,1,51
Elgin,2289,6,14,6,16,54,62,-8,48
Annan Athlet,2289,7,12,11,13,49,42,7,47
Berwick,2289,8,9,10,17,34,61,-27,37
Edinburgh Ci,2289,9,7,9,20,38,63,-25,30
Cowdenbeath,2289,10,4,10,22,24,56,-32,22
Montrose,2290,1,23,8,5,60,35,25,77
Peterhead,2290,2,24,4,8,78,38,40,76
Stirling,2290,3,17,6,13,61,51,10,57
Clyde,2290,4,15,9,12,52,48,4,54
Stenhousem'r,2290,5,15,8,13,55,47,8,53
Elgin,2290,6,14,7,15,54,61,-7,49
Annan Athlet,2290,7,12,11,13,50,41,9,47
Berwick,2290,8,8,10,18,29,59,-30,34
Edinburgh Ci,2290,9,7,9,20,36,61,-25,30
Cowdenbeath,2290,10,4,10,22,23,57,-34,22
Montrose,2291,1,23,7,6,59,35,24,76
Peterhead,2291,2,23,5,8,77,38,39,74
Stenhousem'r,2291,3,16,8,12,56,46,10,56
Stirling,2291,4,16,6,14,60,52,8,54
Clyde,2291,5,15,9,12,52,48,4,54
Elgin,2291,6,15,6,15,54,60,-6,51
Annan Athlet,2291,7,12,11,13,48,41,7,47
Berwick,2291,8,8,10,18,29,59,-30,34
Edinburgh Ci,2291,9,7,10,19,36,60,-24,31
Cowdenbeath,2291,10,4,10,22,23,55,-32,22
Montrose,2292,1,24,7,5,60,34,26,79
Peterhead,2292,2,24,4,8,83,39,44,76
Stirling,2292,3,17,6,13,61,51,10,57
Stenhousem'r,2292,4,15,8,13,55,47,8,53
Clyde,2292,5,14,9,13,51,49,2,51
Elgin,2292,6,14,6,16,53,61,-8,48
Annan Athlet,2292,7,11,12,13,47,41,6,45
Berwick,2292,8,9,10,17,30,58,-28,37
Edinburgh Ci,2292,9,7,9,20,37,66,-29,30
Cowdenbeath,2292,10,4,11,21,23,54,-31,23
Montrose,2293,1,24,7,5,61,34,27,79
Peterhead,2293,2,23,4,9,78,43,35,73
Stenhousem'r,2293,3,16,8,12,58,48,10,56
Stirling,2293,4,16,6,14,62,54,8,54
Clyde,2293,5,15,9,12,55,49,6,54
Elgin,2293,6,14,6,16,53,62,-9,48
Annan Athlet,2293,7,11,12,13,48,42,6,45
Berwick,2293,8,8,10,18,30,62,-32,34
Edinburgh Ci,2293,9,8,9,19,41,61,-20,33
Cowdenbeath,2293,10,4,11,21,24,55,-31,23
Montrose,2294,1,24,7,5,60,34,26,79
Peterhead,2294,2,24,4,8,80,39,41,76
Stirling,2294,3,16,7,13,61,52,9,55
Stenhousem'r,2294,4,15,9,12,56,47,9,54
Clyde,2294,5,15,9,12,54,48,6,54
Elgin,2294,6,14,6,16,53,61,-8,48
Annan Athlet,2294,7,11,12,13,48,42,6,45
Berwick,2294,8,8,10,18,29,61,-32,34
Edinburgh Ci,2294,9,7,9,20,37,63,-26,30
Cowdenbeath,2294,10,4,11,21,24,55,-31,23
Montrose,2295,1,24,7,5,61,35,26,79
Peterhead,2295,2,24,4,8,81,38,43,76
Stirling,2295,3,17,6,13,62,52,10,57
Stenhousem'r,2295,4,15,8,13,56,48,8,53
Clyde,2295,5,14,10,12,51,48,3,52
Elgin,2295,6,14,6,16,54,62,-8,48
Annan Athlet,2295,7,12,11,13,49,42,7,47
Berwick,2295,8,8,11,17,29,58,-29,35
Edinburgh Ci,2295,9,7,9,20,36,64,-28,30
Cowdenbeath,2295,10,4,10,22,24,56,-32,22
Peterhead,2296,1,24,4,8,78,38,40,76
Montrose,2296,2,23,7,6,60,36,24,76
Stenhousem'r,2296,3,16,8,12,56,46,10,56
Stirling,2296,4,16,6,14,60,52,8,54
Clyde,2296,5,14,9,13,53,51,2,51
Elgin,2296,6,15,6,15,55,61,-6,51
Annan Athlet,2296,7,11,11,14,48,43,5,44
Berwick,2296,8,9,10,17,32,60,-28,37
Edinburgh Ci,2296,9,7,9,20,36,61,-25,30
Cowdenbeath,2296,10,5,10,21,25,55,-30,25
Montrose,2297,1,23,8,5,61,36,25,77
Peterhead,2297,2,24,4,8,81,39,42,76
Stirling,2297,3,16,7,13,60,51,9,55
Stenhousem'r,2297,4,15,9,12,55,46,9,54
Clyde,2297,5,15,9,12,53,48,5,54
Elgin,2297,6,14,7,15,55,62,-7,49
Annan Athlet,2297,7,12,11,13,49,42,7,47
Berwick,2297,8,8,10,18,29,60,-31,34
Edinburgh Ci,2297,9,7,9,20,37,64,-27,30
Cowdenbeath,2297,10,4,10,22,24,56,-32,22
Montrose,2298,1,23,8,5,59,34,25,77
Peterhead,2298,2,24,4,8,79,38,41,76
Stirling,2298,3,17,6,13,62,52,10,57
Clyde,2298,4,15,9,12,53,49,4,54
Stenhousem'r,2298,5,15,8,13,56,48,8,53
Elgin,2298,6,14,7,15,53,60,-7,49
Annan Athlet,2298,7,11,11,14,47,43,4,44
Berwick,2298,8,8,10,18,30,60,-30,34
Edinburgh Ci,2298,9,7,9,20,36,62,-26,30
Cowdenbeath,2298,10,5,10,21,25,54,-29,25
Montrose,2299,1,24,7,5,62,35,27,79
Peterhead,2299,2,24,4,8,80,38,42,76
Stirling,2299,3,16,7,13,60,51,9,55
Stenhousem'r,2299,4,15,9,12,55,46,9,54
Clyde,2299,5,14,10,12,52,49,3,52
Elgin,2299,6,14,6,16,54,63,-9,48
Annan Athlet,2299,7,12,11,13,50,42,8,47
Berwick,2299,8,8,11,17,30,59,-29,35
Edinburgh Ci,2299,9,7,9,20,36,63,-27,30
Cowdenbeath,2299,10,4,10,22,24,57,-33,22
Montrose,2300,1,24,7,5,61,35,26,79
Peterhead,2300,2,24,4,8,80,38,42,76
Stirling,2300,3,17,6,13,61,51,10,57
Stenhousem'r,2300,4,15,8,13,55,47,8,53
Clyde,2300,5,14,9,13,53,51,2,51
Elgin,2300,6,14,6,16,54,62,-8,48
Annan Athlet,2300,7,12,11,13,49,42,7,47
Berwick,2300,8,9,10,17,32,60,-28,37
Edinburgh Ci,2300,9,7,9,20,36,63,-27,30
Cowdenbeath,2300,10,4,10,22,24,56,-32,22
Montrose,2301,1,24,7,5,61,34,27,79
Peterhead,2301,2,24,4,8,84,39,45,76
Stirling,2301,3,16,7,13,61,52,9,55
Stenhousem'r,2301,4,15,9,12,56,47,9,54
Clyde,2301,5,15,9,12,52,48,4,54
Elgin,2301,6,14,6,16,53,62,-9,48
Annan Athlet,2301,7,11,12,13,47,41,6,45
Berwick,2301,8,8,10,18,29,59,-30,34
Edinburgh Ci,2301,9,7,9,20,37,67,-30,30
Cowdenbeath,2301,10,4,11,21,23,54,-31,23
Peterhead,2302,1,24,4,8,79,39,40,76
Montrose,2302,2,23,7,6,59,36,23,76
Stirling,2302,3,16,7,13,61,52,9,55
Stenhousem'r,2302,4,15,9,12,56,47,9,54
Clyde,2302,5,15,9,12,55,50,5,54
Elgin,2302,6,15,6,15,55,60,-5,51
Annan Athlet,2302,7,11,11,14,47,42,5,44
Berwick,2302,8,8,10,18,31,62,-31,34
Edinburgh Ci,2302,9,7,9,20,37,62,-25,30
Cowdenbeath,2302,10,5,10,21,24,54,-30,25
Montrose,2303,1,24,7,5,64,35,29,79
Peterhead,2303,2,24,4,8,80,38,42,76
Stirling,2303,3,17,6,13,64,51,13,57
Clyde,2303,4,15,9,12,55,50,5,54
Stenhousem'r,2303,5,15,8,13,55,50,5,53
Elgin,2303,6,14,6,16,54,65,-11,48
Annan Athlet,2303,7,12,11,13,49,41,8,47
Berwick,2303,8,8,10,18,31,62,-31,34
Edinburgh Ci,2303,9,7,9,20,36,63,-27,30
Cowdenbeath,2303,10,4,10,22,23,56,-33,22
Montrose,2304,1,24,7,5,61,34,27,79
Peterhead,2304,2,24,4,8,80,38,42,76
Stirling,2304,3,17,6,13,61,51,10,57
Clyde,2304,4,15,9,12,54,49,5,54
Stenhousem'r,2304,5,15,8,13,55,47,8,53
Elgin,2304,6,14,6,16,53,62,-9,48
Annan Athlet,2304,7,12,11,13,48,41,7,47
Berwick,2304,8,8,10,18,30,61,-31,34
Edinburgh Ci,2304,9,7,9,20,36,63,-27,30
Cowdenbeath,2304,10,4,10,22,23,55,-32,22
Montrose,2305,1,24,7,5,61,34,27,79
Peterhead,2305,2,24,4,8,81,39,42,76
Stirling,2305,3,17,6,13,63,53,10,57
Stenhousem'r,2305,4,15,8,13,57,49,8,53
Clyde,2305,5,14,10,12,51,48,3,52
Elgin,2305,6,14,6,16,53,62,-9,48
Annan Athlet,2305,7,12,11,13,50,42,8,47
Berwick,2305,8,8,11,17,29,58,-29,35
Edinburgh Ci,2305,9,7,9,20,37,64,-27,30
Cowdenbeath,2305,10,4,10,22,24,57,-33,22
Montrose,2306,1,24,7,5,63,35,28,79
Peterhead,2306,2,24,4,8,80,38,42,76
Stenhousem'r,2306,3,16,8,12,59,47,12,56
Stirling,2306,4,16,6,14,61,55,6,54
Clyde,2306,5,15,9,12,54,49,5,54
Elgin,2306,6,14,6,16,54,64,-10,48
Annan Athlet,2306,7,12,11,13,49,42,7,47
Berwick,2306,8,8,10,18,30,61,-31,34
Edinburgh Ci,2306,9,7,9,20,36,63,-27,30
Cowdenbeath,2306,10,4,10,22,24,56,-32,22
Montrose,2307,1,23,8,5,60,35,25,77
Peterhead,2307,2,23,5,8,77,38,39,74
Stirling,2307,3,17,6,13,61,51,10,57
Stenhousem'r,2307,4,15,8,13,55,47,8,53
Clyde,2307,5,14,10,12,53,50,3,52
Elgin,2307,6,14,7,15,54,61,-7,49
Annan Athlet,2307,7,11,11,14,47,42,5,44
Berwick,2307,8,8,11,17,31,60,-29,35
Edinburgh Ci,2307,9,7,10,19,36,60,-24,31
Cowdenbeath,2307,10,5,10,21,24,54,-30,25
Montrose,2308,1,24,7,5,60,34,26,79
Peterhead,2308,2,23,5,8,78,39,39,74
Stirling,2308,3,17,6,13,61,51,10,57
Clyde,2308,4,15,9,12,53,48,5,54
Stenhousem'r,2308,5,15,8,13,55,47,8,53
Elgin,2308,6,14,6,16,53,61,-8,48
Annan Athlet,2308,7,11,11,14,47,42,5,44
Berwick,2308,8,8,10,18,29,60,-31,34
Edinburgh Ci,2308,9,7,10,19,37,61,-24,31
Cowdenbeath,2308,10,5,10,21,24,54,-30,25
Montrose,2309,1,24,7,5,60,34,26,79
Peterhead,2309,2,24,4,8,80,38,42,76
Stirling,2309,3,16,7,13,60,51,9,55
Stenhousem'r,2309,4,15,9,12,55,46,9,54
Clyde,2309,5,14,10,12,52,49,3,52
Elgin,2309,6,14,6,16,53,61,-8,48
Annan Athlet,2309,7,11,12,13,48,42,6,45
Berwick,2309,8,8,11,17,30,59,-29,35
Edinburgh Ci,2309,9,7,9,20,36,63,-27,30
Cowdenbeath,2309,10,4,11,21,24,55,-31,23
Montrose,2310,1,24,7,5,60,34,26,79
Peterhead,2310,2,24,4,8,80,38,42,76
Stirling,2310,3,17,6,13,62,52,10,57
Clyde,2310,4,15,9,12,54,48,6,54
Stenhousem'r,2310,5,15,8,13,56,48,8,53
Elgin,2310,6,14,6,16,53,61,-8,48
Annan Athlet,2310,7,11,12,13,48,42,6,45
Berwick,2310,8,8,10,18,29,61,-32,34
Edinburgh Ci,2310,9,7,9,20,36,63,-27,30
Cowdenbeath,2310,10,4,11,21,24,55,-31,23
Montrose,2311,1,23,7,6,59,36,23,76
Peterhead,2311,2,23,4,9,77,39,38,73
Stenhousem'r,2311,3,16,8,12,56,46,10,56
Stirling,2311,4,16,6,14,60,52,8,54
Clyde,2311,5,14,10,12,52,49,3,52
Elgin,2311,6,15,6,15,55,60,-5,51
Annan Athlet,2311,7,12,11,13,48,41,7,47
Berwick,2311,8,8,11,17,30,59,-29,35
Edinburgh Ci,2311,9,8,9,19,37,60,-23,33
Cowdenbeath,2311,10,4,10,22,23,55,-32,22
Montrose,2312,1,24,7,5,60,34,26,79
Peterhead,2312,2,24,4,8,80,38,42,76
Stirling,2312,3,16,7,13,60,51,9,55
Stenhousem'r,2312,4,15,9,12,55,46,9,54
Clyde,2312,5,15,9,12,54,50,4,54
Elgin,2312,6,14,6,16,53,61,-8,48
Annan Athlet,2312,7,11,12,13,47,41,6,45
Berwick,2312,8,8,10,18,31,61,-30,34
Edinburgh Ci,2312,9,7,9,20,36,63,-27,30
Cowdenbeath,2312,10,4,11,21,23,54,-31,23
Montrose,2313,1,24,7,5,61,35,26,79
Peterhead,2313,2,24,4,8,80,39,41,76
Stirling,2313,3,17,6,13,62,52,10,57
Clyde,2313,4,15,9,12,52,48,4,54
Stenhousem'r,2313,5,15,8,13,56,48,8,53
Elgin,2313,6,14,6,16,54,62,-8,48
Annan Athlet,2313,7,12,11,13,50,41,9,47
Berwick,2313,8,8,10,18,29,59,-30,34
Edinburgh Ci,2313,9,7,9,20,37,63,-26,30
Cowdenbeath,2313,10,4,10,22,23,57,-34,22
Montrose,2314,1,24,7,5,62,35,27,79
Peterhead,2314,2,23,5,8,78,39,39,74
Stirling,2314,3,16,7,13,60,51,9,55
Stenhousem'r,2314,4,15,9,12,55,46,9,54
Clyde,2314,5,14,10,12,52,49,3,52
Elgin,2314,6,14,6,16,54,63,-9,48
Annan Athlet,2314,7,11,12,13,47,41,6,45
Berwick,2314,8,8,11,17,30,59,-29,35
Edinburgh Ci,2314,9,7,10,19,37,61,-24,31
Cowdenbeath,2314,10,4,11,21,23,54,-31,23
Montrose,2315,1,24,7,5,63,35,28,79
Peterhead,2315,2,24,4,8,82,38,44,76
Stirling,2315,3,17,6,13,65,52,13,57
Stenhousem'r,2315,4,15,8,13,56,51,5,53
Clyde,2315,5,14,9,13,51,49,2,51
Elgin,2315,6,14,6,16,54,64,-10,48
Annan Athlet,2315,7,11,11,14,48,43,5,44
Berwick,2315,8,9,10,17,30,58,-28,37
Edinburgh Ci,2315,9,7,9,20,36,65,-29,30
Cowdenbeath,2315,10,5,10,21,25,55,-30,25
Peterhead,2316,1,24,4,8,79,38,41,76
Montrose,2316,2,23,7,6,61,37,24,76
Stenhousem'r,2316,3,16,8,12,59,47,12,56
Stirling,2316,4,16,6,14,61,55,6,54
Clyde,2316,5,14,9,13,51,49,2,51
Elgin,2316,6,15,6,15,56,62,-6,51
Annan Athlet,2316,7,11,12,13,47,41,6,45
Berwick,2316,8,9,10,17,30,58,-28,37
Edinburgh Ci,2316,9,7,9,20,36,62,-26,30
Cowdenbeath,2316,10,4,11,21,23,54,-31,23
Montrose,2317,1,24,7,5,61,35,26,79
Peterhead,2317,2,24,4,8,80,38,42,76
Stirling,2317,3,17,6,13,63,51,12,57
Clyde,2317,4,15,9,12,53,48,5,54
Stenhousem'r,2317,5,15,8,13,55,49,6,53
Elgin,2317,6,14,6,16,54,62,-8,48
Annan Athlet,2317,7,12,11,13,49,42,7,47
Berwick,2317,8,8,10,18,29,60,-31,34
Edinburgh Ci,2317,9,7,9,20,36,63,-27,30
Cowdenbeath,2317,10,4,10,22,24,56,-32,22
Montrose,2318,1,24,7,5,61,34,27,79
Peterhead,2318,2,24,4,8,78,38,40,76
Stirling,2318,3,16,7,13,62,53,9,55
Stenhousem'r,2318,4,15,9,12,57,48,9,54
Clyde,2318,5,14,9,13,51,49,2,51
Elgin,2318,6,14,6,16,53,62,-9,48
Annan Athlet,2318,7,12,11,13,48,41,7,47
Berwick,2318,8,9,10,17,30,58,-28,37
Edinburgh Ci,2318,9,7,9,20,36,61,-25,30
Cowdenbeath,2318,10,4,10,22,23,55,-32,22
Peterhead,2319,1,24,4,8,82,39,43,76
Montrose,2319,2,23,7,6,59,35,24,76
Stenhousem'r,2319,3,16,8,12,57,47,10,56
Stirling,2319,4,16,6,14,61,53,8,54
Clyde,2319,5,15,9,12,53,48,5,54
Elgin,2319,6,15,6,15,54,60,-6,51
Annan Athlet,2319,7,11,12,13,48,42,6,45
Berwick,2319,8,8,10,18,29,60,-31,34
Edinburgh Ci,2319,9,7,9,20,37,65,-28,30
Cowdenbeath,2319,10,4,11,21,24,55,-31,23
Montrose,2320,1,23,8,5,60,35,25,77
Peterhead,2320,2,24,4,8,79,38,41,76
Stirling,2320,3,17,6,13,63,52,11,57
Stenhousem'r,2320,4,15,8,13,56,49,7,53
Clyde,2320,5,14,9,13,51,50,1,51
Elgin,2320,6,14,7,15,54,61,-7,49
Annan Athlet,2320,7,11,12,13,49,43,6,45
Berwick,2320,8,9,10,17,31,58,-27,37
Edinburgh Ci,2320,9,7,9,20,36,62,-26,30
Cowdenbeath,2320,10,4,11,21,25,56,-31,23
Montrose,2321,1,24,7,5,61,34,27,79
Peterhead,2321,2,23,5,8,78,39,39,74
Stenhousem'r,2321,3,16,8,12,60,46,14,56
Stirling,2321,4,16,6,14,60,56,4,54
Clyde,2321,5,15,9,12,53,49,4,54
Elgin,2321,6,14,6,16,53,62,-9,48
Annan Athlet,2321,7,11,11,14,48,43,5,44
Berwick,2321,8,8,10,18,30,60,-30,34
Edinburgh Ci,2321,9,7,10,19,37,61,-24,31
Cowdenbeath,2321,10,5,10,21,25,55,-30,25
Montrose,2322,1,24,7,5,62,35,27,79
Peterhead,2322,2,23,4,9,77,39,38,73
Stirling,2322,3,16,7,13,62,53,9,55
Stenhousem'r,2322,4,15,9,12,57,48,9,54
Clyde,2322,5,15,9,12,55,50,5,54
Elgin,2322,6,14,6,16,54,63,-9,48
Annan Athlet,2322,7,11,11,14,47,43,4,44
Berwick,2322,8,8,10,18,31,62,-31,34
Edinburgh Ci,2322,9,8,9,19,37,60,-23,33
Cowdenbeath,2322,10,5,10,21,25,54,-29,25
Montrose,2323,1,24,7,5,62,35,27,79
Peterhead,2323,2,24,4,8,81,38,43,76
Stirling,2323,3,16,7,13,61,52,9,55
Stenhousem'r,2323,4,15,9,12,56,47,9,54
Clyde,2323,5,15,9,12,56,48,8,54
Elgin,2323,6,14,6,16,54,63,-9,48
Annan Athlet,2323,7,12,11,13,49,41,8,47
Berwick,2323,8,8,10,18,29,63,-34,34
Edinburgh Ci,2323,9,7,9,20,36,64,-28,30
Cowdenbeath,2323,10,4,10,22,23,56,-33,22
Montrose,2324,1,23,7,6,59,36,23,76
Peterhead,2324,2,23,4,9,78,40,38,73
Stenhousem'r,2324,3,16,8,12,57,46,11,56
Stirling,2324,4,16,6,14,60,53,7,54
Clyde,2324,5,15,9,12,55,48,7,54
Elgin,2324,6,15,6,15,55,60,-5,51
Annan Athlet,2324,7,11,12,13,47,41,6,45
Berwick,2324,8,8,10,18,29,62,-33,34
Edinburgh Ci,2324,9,8,9,19,38,61,-23,33
Cowdenbeath,2324,10,4,11,21,23,54,-31,23
Montrose,2325,1,23,8,5,59,34,25,77
Peterhead,2325,2,24,4,8,78,38,40,76
Stirling,2325,3,17,6,13,62,51,11,57
Stenhousem'r,2325,4,15,8,13,55,48,7,53
Clyde,2325,5,14,10,12,52,49,3,52
Elgin,2325,6,14,7,15,53,60,-7,49
Annan Athlet,2325,7,12,11,13,49,41,8,47
Berwick,2325,8,8,11,17,30,59,-29,35
Edinburgh Ci,2325,9,7,9,20,36,61,-25,30
Cowdenbeath,2325,10,4,10,22,23,56,-33,22
Montrose,2326,1,23,7,6,59,35,24,76
Peterhead,2326,2,23,5,8,80,41,39,74
Stirling,2326,3,17,6,13,61,51,10,57
Clyde,2326,4,15,9,12,52,48,4,54
Stenhousem'r,2326,5,15,8,13,55,47,8,53
Elgin,2326,6,15,6,15,54,60,-6,51
Annan Athlet,2326,7,11,11,14,47,44,3,44
Berwick,2326,8,8,10,18,29,59,-30,34
Edinburgh Ci,2326,9,7,10,19,39,63,-24,31
Cowdenbeath,2326,10,5,10,21,26,54,-28,25
Montrose,2327,1,24,7,5,63,37,26,79
Peterhead,2327,2,24,4,8,79,38,41,76
Stirling,2327,3,17,6,13,61,51,10,57
Clyde,2327,4,15,9,12,53,48,5,54
Stenhousem'r,2327,5,15,8,13,55,47,8,53
Elgin,2327,6,14,6,16,56,64,-8,48
Annan Athlet,2327,7,12,11,13,50,43,7,47
Berwick,2327,8,8,10,18,29,60,-31,34
Edinburgh Ci,2327,9,7,9,20,36,62,-26,30
Cowdenbeath,2327,10,4,10,22,25,57,-32,22
Montrose,2328,1,24,7,5,64,36,28,79
Peterhead,2328,2,24,4,8,85,38,47,76
Stenhousem'r,2328,3,16,8,12,56,46,10,56
Stirling,2328,4,16,6,14,60,52,8,54
Clyde,2328,5,15,9,12,53,48,5,54
Elgin,2328,6,14,6,16,55,65,-10,48
Annan Athlet,2328,7,12,11,13,49,41,8,47
Berwick,2328,8,8,10,18,29,60,-31,34
Edinburgh Ci,2328,9,7,9,20,36,68,-32,30
Cowdenbeath,2328,10,4,10,22,23,56,-33,22
Montrose,2329,1,24,7,5,60,34,26,79
Peterhead,2329,2,24,4,8,81,39,42,76
Stirling,2329,3,17,6,13,62,51,11,57
Clyde,2329,4,15,9,12,54,49,5,54
Stenhousem'r,2329,5,15,8,13,55,48,7,53
Elgin,2329,6,14,6,16,53,61,-8,48
Annan Athlet,2329,7,11,11,14,47,42,5,44
Berwick,2329,8,8,10,18,30,61,-31,34
Edinburgh Ci,2329,9,7,9,20,37,64,-27,30
Cowdenbeath,2329,10,5,10,21,24,54,-30,25
Montrose,2330,1,23,7,6,60,36,24,76
Peterhead,2330,2,23,4,9,77,42,35,73
Stirling,2330,3,17,6,13,61,51,10,57
Stenhousem'r,2330,4,15,8,13,55,47,8,53
Clyde,2330,5,14,10,12,51,48,3,52
Elgin,2330,6,15,6,15,55,61,-6,51
Annan Athlet,2330,7,11,12,13,48,42,6,45
Berwick,2330,8,8,11,17,29,58,-29,35
Edinburgh Ci,2330,9,8,9,19,40,60,-20,33
Cowdenbeath,2330,10,4,11,21,24,55,-31,23
Montrose,2331,1,24,7,5,62,34,28,79
Peterhead,2331,2,23,5,8,78,39,39,74
Stirling,2331,3,17,6,13,62,51,11,57
Clyde,2331,4,15,9,12,53,49,4,54
Stenhousem'r,2331,5,15,8,13,55,48,7,53
Elgin,2331,6,14,6,16,53,63,-10,48
Annan Athlet,2331,7,12,11,13,49,42,7,47
Berwick,2331,8,8,10,18,30,60,-30,34
Edinburgh Ci,2331,9,7,10,19,37,61,-24,31
Cowdenbeath,2331,10,4,10,22,24,56,-32,22
Peterhead,2332,1,24,4,8,81,40,41,76
Montrose,2332,2,23,7,6,61,38,23,76
Stirling,2332,3,17,6,13,62,51,11,57
Stenhousem'r,2332,4,15,8,13,55,48,7,53
Clyde,2332,5,14,9,13,51,49,2,51
Elgin,2332,6,15,6,15,57,62,-5,51
Annan Athlet,2332,7,11,12,13,48,42,6,45
Berwick,2332,8,9,10,17,30,58,-28,37
Edinburgh Ci,2332,9,7,9,20,38,64,-26,30
Cowdenbeath,2332,10,4,11,21,24,55,-31,23
Montrose,2333,1,24,7,5,64,34,30,79
Peterhead,2333,2,23,4,9,78,40,38,73
Stirling,2333,3,17,6,13,63,53,10,57
Clyde,2333,4,15,9,12,52,48,4,54
Stenhousem'r,2333,5,15,8,13,57,49,8,53
Elgin,2333,6,14,6,16,53,65,-12,48
Annan Athlet,2333,7,12,11,13,49,41,8,47
Berwick,2333,8,8,10,18,29,59,-30,34
Edinburgh Ci,2333,9,8,9,19,38,61,-23,33
Cowdenbeath,2333,10,4,10,22,23,56,-33,22
Montrose,2334,1,24,7,5,64,36,28,79
Peterhead,2334,2,24,4,8,80,39,41,76
Stirling,2334,3,16,7,13,61,52,9,55
Stenhousem'r,2334,4,15,9,12,56,47,9,54
Clyde,2334,5,14,9,13,51,49,2,51
Elgin,2334,6,14,6,16,55,65,-10,48
Annan Athlet,2334,7,12,11,13,50,42,8,47
Berwick,2334,8,9,10,17,30,58,-28,37
Edinburgh Ci,2334,9,7,9,20,37,63,-26,30
Cowdenbeath,2334,10,4,10,22,24,57,-33,22
Montrose,2335,1,24,7,5,63,34,29,79
Peterhead,2335,2,23,4,9,79,43,36,73
Stirling,2335,3,17,6,13,63,51,12,57
Clyde,2335,4,15,9,12,56,48,8,54
Stenhousem'r,2335,5,15,8,13,55,49,6,53
Elgin,2335,6,14,6,16,53,64,-11,48
Annan Athlet,2335,7,11,12,13,48,42,6,45
Berwick,2335,8,8,10,18,29,63,-34,34
Edinburgh Ci,2335,9,8,9,19,41,62,-21,33
Cowdenbeath,2335,10,4,11,21,24,55,-31,23
Montrose,2336,1,24,7,5,61,34,27,79
Peterhead,2336,2,24,4,8,78,38,40,76
Stenhousem'r,2336,3,16,8,12,56,46,10,56
Stirling,2336,4,16,6,14,60,52,8,54
Clyde,2336,5,15,9,12,52,48,4,54
Elgin,2336,6,14,6,16,53,62,-9,48
Annan Athlet,2336,7,12,11,13,48,41,7,47
Berwick,2336,8,8,10,18,29,59,-30,34
Edinburgh Ci,2336,9,7,9,20,36,61,-25,30
Cowdenbeath,2336,10,4,10,22,23,55,-32,22
Montrose,2337,1,23,8,5,60,35,25,77
Peterhead,2337,2,24,4,8,81,39,42,76
Stenhousem'r,2337,3,16,8,12,59,49,10,56
Stirling,2337,4,16,6,14,63,55,8,54
Clyde,2337,5,15,9,12,53,48,5,54
Elgin,2337,6,14,7,15,54,61,-7,49
Annan Athlet,2337,7,12,11,13,50,41,9,47
Berwick,2337,8,8,10,18,29,60,-31,34
Edinburgh Ci,2337,9,7,9,20,37,64,-27,30
Cowdenbeath,2337,10,4,10,22,23,57,-34,22
Montrose,2338,1,24,7,5,61,34,27,79
Peterhead,2338,2,24,4,8,80,40,40,76
Stenhousem'r,2338,3,16,8,12,57,47,10,56
Stirling,2338,4,16,6,14,61,53,8,54
Clyde,2338,5,15,9,12,54,49,5,54
Elgin,2338,6,14,6,16,53,62,-9,48
Annan Athlet,2338,7,11,11,14,47,43,4,44
Berwick,2338,8,8,10,18,30,61,-31,34
Edinburgh Ci,2338,9,7,9,20,38,63,-25,30
Cowdenbeath,2338,10,5,10,21,25,54,-29,25
Montrose,2339,1,23,8,5,61,36,25,77
Peterhead,2339,2,24,4,8,80,39,41,76
Stenhousem'r,2339,3,16,8,12,57,47,10,56
Stirling,2339,4,16,6,14,61,53,8,54
Clyde,2339,5,15,9,12,53,48,5,54
Elgin,2339,6,14,7,15,55,62,-7,49
Annan Athlet,2339,7,11,11,14,48,44,4,44
Berwick,2339,8,8,10,18,29,60,-31,34
Edinburgh Ci,2339,9,7,9,20,37,63,-26,30
Cowdenbeath,2339,10,5,10,21,26,55,-29,25
Peterhead,2340,1,24,4,8,78,38,40,76
Montrose,2340,2,23,7,6,59,35,24,76
Stirling,2340,3,17,6,13,61,51,10,57
Stenhousem'r,2340,4,15,8,13,55,47,8,53
Clyde,2340,5,14,9,13,51,49,2,51
Elgin,2340,6,15,6,15,54,60,-6,51
Annan Athlet,2340,7,11,11,14,47,42,5,44
Berwick,2340,8,9,10,17,30,58,-28,37
Edinburgh Ci,2340,9,7,9,20,36,61,-25,30
Cowdenbeath,2340,10,5,10,21,24,54,-30,25
Montrose,2341,1,24,7,5,61,34,27,79
Peterhead,2341,2,23,5,8,79,40,39,74
Stirling,2341,3,16,7,13,62,53,9,55
Stenhousem'r,2341,4,15,9,12,57,48,9,54
Clyde,2341,5,14,9,13,51,50,1,51
Elgin,2341,6,14,6,16,53,62,-9,48
Annan Athlet,2341,7,12,11,13,50,43,7,47
Berwick,2341,8,9,10,17,31,58,-27,37
Edinburgh Ci,2341,9,7,10,19,38,62,-24,31
Cowdenbeath,2341,10,4,10,22,25,57,-32,22
Montrose,2342,1,24,7,5,62,35,27,79
Peterhead,2342,2,24,4,8,83,38,45,76
Stirling,2342,3,17,6,13,62,51,11,57
Stenhousem'r,2342,4,15,8,13,55,48,7,53
Clyde,2342,5,14,10,12,54,51,3,52
Elgin,2342,6,14,6,16,54,63,-9,48
Annan Athlet,2342,7,12,11,13,51,42,9,47
Berwick,2342,8,8,11,17,32,61,-29,35
Edinburgh Ci,2342,9,7,9,20,36,66,-30,30
Cowdenbeath,2342,10,4,10,22,24,58,-34,22
Montrose,2343,1,24,7,5,62,35,27,79
Peterhead,2343,2,24,4,8,81,38,43,76
Stirling,2343,3,17,6,13,61,51,10,57
Clyde,2343,4,15,9,12,54,50,4,54
Stenhousem'r,2343,5,15,8,13,55,47,8,53
Elgin,2343,6,14,6,16,54,63,-9,48
Annan Athlet,2343,7,12,11,13,49,42,7,47
Berwick,2343,8,8,10,18,31,61,-30,34
Edinburgh Ci,2343,9,7,9,20,36,64,-28,30
Cowdenbeath,2343,10,4,10,22,24,56,-32,22
Montrose,2344,1,24,7,5,60,34,26,79
Peterhead,2344,2,24,4,8,81,38,43,76
Stirling,2344,3,17,6,13,64,52,12,57
Clyde,2344,4,15,9,12,54,49,5,54
Stenhousem'r,2344,5,15,8,13,56,50,6,53
Elgin,2344,6,14,6,16,53,61,-8,48
Annan Athlet,2344,7,11,11,14,47,42,5,44
Berwick,2344,8,8,10,18,30,61,-31,34
Edinburgh Ci,2344,9,7,9,20,36,64,-28,30
Cowdenbeath,2344,10,5,10,21,24,54,-30,25
Montrose,2345,1,24,7,5,65,35,30,79
Peterhead,2345,2,24,4,8,80,39,41,76
Stirling,2345,3,16,7,13,60,51,9,55
Stenhousem'r,2345,4,15,9,12,55,46,9,54
Clyde,2345,5,14,10,12,52,49,3,52
Elgin,2345,6,14,6,16,54,66,-12,48
Annan Athlet,2345,7,12,11,13,49,41,8,47
Berwick,2345,8,8,11,17,30,59,-29,35
Edinburgh Ci,2345,9,7,9,20,37,63,-26,30
Cowdenbeath,2345,10,4,10,22,23,56,-33,22
Montrose,2346,1,23,8,5,59,34,25,77
Peterhead,2346,2,24,4,8,80,40,40,76
Stenhousem'r,2346,3,16,8,12,57,47,10,56
Stirling,2346,4,16,6,14,61,53,8,54
Clyde,2346,5,14,10,12,52,49,3,52
Elgin,2346,6,14,7,15,53,60,-7,49
Annan Athlet,2346,7,11,12,13,48,42,6,45
Berwick,2346,8,8,11,17,30,59,-29,35
Edinburgh Ci,2346,9,7,9,20,38,63,-25,30
Cowdenbeath,2346,10,4,11,21,24,55,-31,23
Montrose,2347,1,24,7,5,61,35,26,79
Peterhead,2347,2,24,4,8,80,39,41,76
Stenhousem'r,2347,3,16,8,12,57,46,11,56
Stirling,2347,4,16,6,14,60,53,7,54
Clyde,2347,5,15,9,12,53,49,4,54
Elgin,2347,6,14,6,16,54,62,-8,48
Annan Athlet,2347,7,11,11,14,47,42,5,44
Berwick,2347,8,8,10,18,30,60,-30,34
Edinburgh Ci,2347,9,7,9,20,37,63,-26,30
Cowdenbeath,2347,10,5,10,21,24,54,-30,25
Peterhead,2348,1,24,4,8,81,40,41,76
Montrose,2348,2,23,7,6,59,36,23,76
Stenhousem'r,2348,3,16,8,12,59,46,13,56
Stirling,2348,4,16,6,14,60,55,5,54
Clyde,2348,5,14,10,12,52,49,3,52
Elgin,2348,6,15,6,15,55,60,-5,51
Annan Athlet,2348,7,12,11,13,50,42,8,47
Berwick,2348,8,8,11,17,30,59,-29,35
Edinburgh Ci,2348,9,7,9,20,38,64,-26,30
Cowdenbeath,2348,10,4,10,22,24,57,-33,22
Montrose,2349,1,23,8,5,60,35,25,77
Peterhead,2349,2,24,4,8,83,39,44,76
Stenhousem'r,2349,3,16,8,12,60,50,10,56
Stirling,2349,4,16,6,14,64,56,8,54
Clyde,2349,5,14,9,13,51,49,2,51
Elgin,2349,6,14,7,15,54,61,-7,49
Annan Athlet,2349,7,11,11,14,47,42,5,44
Berwick,2349,8,9,10,17,30,58,-28,37
Edinburgh Ci,2349,9,7,9,20,37,66,-29,30
Cowdenbeath,2349,10,5,10,21,24,54,-30,25
Montrose,2350,1,23,8,5,59,34,25,77
Peterhead,2350,2,24,4,8,81,38,43,76
Stirling,2350,3,17,6,13,62,51,11,57
Stenhousem'r,2350,4,15,8,13,55,48,7,53
Clyde,2350,5,14,10,12,51,48,3,52
Elgin,2350,6,14,7,15,53,60,-7,49
Annan Athlet,2350,7,11,12,13,48,42,6,45
Berwick,2350,8,8,11,17,29,58,-29,35
Edinburgh Ci,2350,9,7,9,20,36,64,-28,30
Cowdenbeath,2350,10,4,11,21,24,55,-31,23
Montrose,2351,1,24,7,5,62,35,27,79
Peterhead,2351,2,24,4,8,82,39,43,76
Stirling,2351,3,16,7,13,61,52,9,55
Stenhousem'r,2351,4,15,9,12,56,47,9,54
Clyde,2351,5,15,9,12,54,48,6,54
Elgin,2351,6,14,6,16,54,63,-9,48
Annan Athlet,2351,7,12,11,13,50,42,8,47
Berwick,2351,8,8,10,18,29,61,-32,34
Edinburgh Ci,2351,9,7,9,20,37,65,-28,30
Cowdenbeath,2351,10,4,10,22,24,57,-33,22
Montrose,2352,1,24,7,5,60,34,26,79
Peterhead,2352,2,24,4,8,81,39,42,76
Stirling,2352,3,17,6,13,63,51,12,57
Clyde,2352,4,15,9,12,55,48,7,54
Stenhousem'r,2352,5,15,8,13,55,49,6,53
Elgin,2352,6,14,6,16,53,61,-8,48
Annan Athlet,2352,7,11,12,13,48,42,6,45
Berwick,2352,8,8,10,18,29,62,-33,34
Edinburgh Ci,2352,9,7,9,20,37,64,-27,30
Cowdenbeath,2352,10,4,11,21,24,55,-31,23
Montrose,2353,1,24,7,5,62,35,27,79
Peterhead,2353,2,24,4,8,82,38,44,76
Stirling,2353,3,17,6,13,63,53,10,57
Stenhousem'r,2353,4,15,8,13,57,49,8,53
Clyde,2353,5,14,10,12,53,50,3,52
Elgin,2353,6,14,6,16,54,63,-9,48
Annan Athlet,2353,7,12,11,13,49,41,8,47
Berwick,2353,8,8,11,17,31,60,-29,35
Edinburgh Ci,2353,9,7,9,20,36,65,-29,30
Cowdenbeath,2353,10,4,10,22,23,56,-33,22
Peterhead,2354,1,24,4,8,80,38,42,76
Montrose,2354,2,23,7,6,60,36,24,76
Stirling,2354,3,17,6,13,61,51,10,57
Stenhousem'r,2354,4,15,8,13,55,47,8,53
Clyde,2354,5,14,9,13,53,51,2,51
Elgin,2354,6,15,6,15,55,61,-6,51
Annan Athlet,2354,7,12,11,13,48,41,7,47
Berwick,2354,8,9,10,17,32,60,-28,37
Edinburgh Ci,2354,9,7,9,20,36,63,-27,30
Cowdenbeath,2354,10,4,10,22,23,55,-32,22
Montrose,2355,1,24,7,5,61,34,27,79
Peterhead,2355,2,24,4,8,80,38,42,76
Stenhousem'r,2355,3,16,8,12,57,47,10,56
Stirling,2355,4,16,6,14,61,53,8,54
Clyde,2355,5,15,9,12,53,49,4,54
Elgin,2355,6,14,6,16,53,62,-9,48
Annan Athlet,2355,7,12,11,13,49,42,7,47
Berwick,2355,8,8,10,18,30,60,-30,34
Edinburgh Ci,2355,9,7,9,20,36,63,-27,30
Cowdenbeath,2355,10,4,10,22,24,56,-32,22
Montrose,2356,1,23,8,5,61,36,25,77
Peterhead,2356,2,24,4,8,80,39,41,76
Stenhousem'r,2356,3,16,8,12,57,47,10,56
Stirling,2356,4,16,6,14,61,53,8,54
Clyde,2356,5,14,9,13,52,50,2,51
Elgin,2356,6,14,7,15,55,62,-7,49
Annan Athlet,2356,7,12,11,13,48,41,7,47
Berwick,2356,8,9,10,17,31,59,-28,37
Edinburgh Ci,2356,9,7,9,20,37,63,-26,30
Cowdenbeath,2356,10,4,10,22,23,55,-32,22
Peterhead,2357,1,24,4,8,80,38,42,76
Montrose,2357,2,23,7,6,60,36,24,76
Stirling,2357,3,17,6,13,64,54,10,57
Clyde,2357,4,15,9,12,53,48,5,54
Stenhousem'r,2357,5,15,8,13,58,50,8,53
Elgin,2357,6,15,6,15,55,61,-6,51
Annan Athlet,2357,7,12,11,13,49,42,7,47
Berwick,2357,8,8,10,18,29,60,-31,34
Edinburgh Ci,2357,9,7,9,20,36,63,-27,30
Cowdenbeath,2357,10,4,10,22,24,56,-32,22
Montrose,2358,1,24,7,5,62,34,28,79
Peterhead,2358,2,24,4,8,81,39,42,76
Stirling,2358,3,17,6,13,63,52,11,57
Stenhousem'r,2358,4,15,8,13,56,49,7,53
Clyde,2358,5,14,9,13,51,49,2,51
Elgin,2358,6,14,6,16,53,63,-10,48
Annan Athlet,2358,7,12,11,13,48,41,7,47
Berwick,2358,8,9,10,17,30,58,-28,37
Edinburgh Ci,2358,9,7,9,20,37,64,-27,30
Cowdenbeath,2358,10,4,10,22,23,55,-32,22
Montrose,2359,1,24,7,5,62,35,27,79
Peterhead,2359,2,24,4,8,80,38,42,76
Stirling,2359,3,16,7,13,61,52,9,55
Stenhousem'r,2359,4,15,9,12,56,47,9,54
Clyde,2359,5,15,9,12,53,48,5,54
Elgin,2359,6,14,6,16,54,63,-9,48
Annan Athlet,2359,7,12,11,13,51,41,10,47
Berwick,2359,8,8,10,18,29,60,-31,34
Edinburgh Ci,2359,9,7,9,20,36,63,-27,30
Cowdenbeath,2359,10,4,10,22,23,58,-35,22
Montrose,2360,1,23,8,5,61,36,25,77
Peterhead,2360,2,23,5,8,79,40,39,74
Stirling,2360,3,17,6,13,65,53,12,57
Stenhousem'r,2360,4,15,8,13,57,51,6,53
Clyde,2360,5,14,10,12,52,49,3,52
Elgin,2360,6,14,7,15,55,62,-7,49
Annan Athlet,2360,7,12,11,13,49,42,7,47
Berwick,2360,8,8,11,17,30,59,-29,35
Edinburgh Ci,2360,9,7,10,19,38,62,-24,31
Cowdenbeath,2360,10,4,10,22,24,56,-32,22
Montrose,2361,1,23,8,5,61,36,25,77
Peterhead,2361,2,23,4,9,78,40,38,73
Stenhousem'r,2361,3,16,8,12,56,46,10,56
Stirling,2361,4,16,6,14,60,52,8,54
Clyde,2361,5,14,10,12,52,49,3,52
Elgin,2361,6,14,7,15,55,62,-7,49
Annan Athlet,2361,7,11,12,13,48,42,6,45
Berwick,2361,8,8,11,17,30,59,-29,35
Edinburgh Ci,2361,9,8,9,19,38,61,-23,33
Cowdenbeath,2361,10,4,11,21,24,55,-31,23
Montrose,2362,1,24,7,5,64,35,29,79
Peterhead,2362,2,24,4,8,85,43,42,76
Stenhousem'r,2362,3,16,8,12,58,47,11,56
Stirling,2362,4,16,6,14,61,54,7,54
Clyde,2362,5,15,9,12,52,48,4,54
Elgin,2362,6,14,6,16,54,65,-11,48
Annan Athlet,2362,7,11,12,13,47,41,6,45
Berwick,2362,8,8,10,18,29,59,-30,34
Edinburgh Ci,2362,9,7,9,20,41,68,-27,30
Cowdenbeath,2362,10,4,11,21,23,54,-31,23
Montrose,2363,1,24,7,5,62,36,26,79
Peterhead,2363,2,24,4,8,79,39,40,76
Stirling,2363,3,16,7,13,63,54,9,55
Stenhousem'r,2363,4,15,9,12,58,49,9,54
Clyde,2363,5,15,9,12,53,49,4,54
Elgin,2363,6,14,6,16,55,63,-8,48
Annan Athlet,2363,7,12,11,13,50,42,8,47
Berwick,2363,8,8,10,18,30,60,-30,34
Edinburgh Ci,2363,9,7,9,20,37,62,-25,30
Cowdenbeath,2363,10,4,10,22,24,57,-33,22
Montrose,2364,1,24,7,5,61,34,27,79
Peterhead,2364,2,24,4,8,79,39,40,76
Stirling,2364,3,17,6,13,62,52,10,57
Stenhousem'r,2364,4,15,8,13,56,48,8,53
Clyde,2364,5,14,10,12,52,49,3,52
Elgin,2364,6,14,6,16,53,62,-9,48
Annan Athlet,2364,7,11,11,14,47,42,5,44
Berwick,2364,8,8,11,17,30,59,-29,35
Edinburgh Ci,2364,9,7,9,20,37,62,-25,30
Cowdenbeath,2364,10,5,10,21,24,54,-30,25
Peterhead,2365,1,24,4,8,79,39,40,76
Montrose,2365,2,23,7,6,60,36,24,76
Stenhousem'r,2365,3,16,8,12,57,47,10,56
Stirling,2365,4,16,6,14,61,53,8,54
Clyde,2365,5,14,10,12,52,49,3,52
Elgin,2365,6,15,6,15,55,61,-6,51
Annan Athlet,2365,7,12,11,13,49,42,7,47
Berwick,2365,8,8,11,17,30,59,-29,35
Edinburgh Ci,2365,9,7,9,20,37,62,-25,30
Cowdenbeath,2365,10,4,10,22,24,56,-32,22
Montrose,2366,1,24,7,5,61,35,26,79
Peterhead,2366,2,24,4,8,80,38,42,76
Stirling,2366,3,16,7,13,60,51,9,55
Stenhousem'r,2366,4,15,9,12,55,46,9,54
Clyde,2366,5,15,9,12,53,48,5,54
Elgin,2366,6,14,6,16,54,62,-8,48
Annan Athlet,2366,7,12,11,13,48,41,7,47
Berwick,2366,8,8,10,18,29,60,-31,34
Edinburgh Ci,2366,9,7,9,20,36,63,-27,30
Cowdenbeath,2366,10,4,10,22,23,55,-32,22
Montrose,2367,1,23,8,5,60,35,25,77
Peterhead,2367,2,24,4,8,80,38,42,76
Stirling,2367,3,16,7,13,61,52,9,55
Stenhousem'r,2367,4,15,9,12,56,47,9,54
Clyde,2367,5,15,9,12,54,48,6,54
Elgin,2367,6,14,7,15,54,61,-7,49
Annan Athlet,2367,7,12,11,13,49,41,8,47
Berwick,2367,8,8,10,18,29,61,-32,34
Edinburgh Ci,2367,9,7,9,20,36,63,-27,30
Cowdenbeath,2367,10,4,10,22,23,56,-33,22
Montrose,2368,1,24,7,5,61,35,26,79
Peterhead,2368,2,24,4,8,80,38,42,76
Stirling,2368,3,17,6,13,63,52,11,57
Stenhousem'r,2368,4,15,8,13,56,49,7,53
Clyde,2368,5,14,10,12,52,49,3,52
Elgin,2368,6,14,6,16,54,62,-8,48
Annan Athlet,2368,7,11,11,14,47,42,5,44
Berwick,2368,8,8,11,17,30,59,-29,35
Edinburgh Ci,2368,9,7,9,20,36,63,-27,30
Cowdenbeath,2368,10,5,10,21,24,54,-30,25
Montrose,2369,1,23,8,5,59,34,25,77
Peterhead,2369,2,24,4,8,81,39,42,76
Stenhousem'r,2369,3,16,8,12,56,46,10,56
Stirling,2369,4,16,6,14,60,52,8,54
Clyde,2369,5,15,9,12,54,49,5,54
Elgin,2369,6,14,7,15,53,60,-7,49
Annan Athlet,2369,7,12,11,13,50,41,9,47
Berwick,2369,8,8,10,18,30,61,-31,34
Edinburgh Ci,2369,9,7,9,20,37,64,-27,30
Cowdenbeath,2369,10,4,10,22,23,57,-34,22
Peterhead,2370,1,24,4,8,79,39,40,76
Montrose,2370,2,23,7,6,60,36,24,76
Stenhousem'r,2370,3,16,8,12,58,46,12,56
Stirling,2370,4,16,6,14,60,54,6,54
Clyde,2370,5,15,9,12,53,49,4,54
Elgin,2370,6,15,6,15,55,61,-6,51
Annan Athlet,2370,7,11,11,14,48,43,5,44
Berwick,2370,8,8,10,18,30,60,-30,34
Edinburgh Ci,2370,9,7,9,20,37,62,-25,30
Cowdenbeath,2370,10,5,10,21,25,55,-30,25
Montrose,2371,1,24,7,5,63,36,27,79
Peterhead,2371,2,24,4,8,79,38,41,76
Stirling,2371,3,17,6,13,62,52,10,57
Stenhousem'r,2371,4,15,8,13,56,48,8,53
Clyde,2371,5,14,10,12,51,48,3,52
Elgin,2371,6,14,6,16,55,64,-9,48
Annan Athlet,2371,7,11,11,14,47,42,5,44
Berwick,2371,8,8,11,17,29,58,-29,35
Edinburgh Ci,2371,9,7,9,20,36,62,-26,30
Cowdenbeath,2371,10,5,10,21,24,54,-30,25
Montrose,2372,1,24,7,5,62,34,28,79
Peterhead,2372,2,24,4,8,79,39,40,76
Stirling,2372,3,16,7,13,61,52,9,55
Stenhousem'r,2372,4,15,9,12,56,47,9,54
Clyde,2372,5,15,9,12,55,50,5,54
Elgin,2372,6,14,6,16,53,63,-10,48
Annan Athlet,2372,7,12,11,13,48,41,7,47
Berwick,2372,8,8,10,18,31,62,-31,34
Edinburgh Ci,2372,9,7,9,20,37,62,-25,30
Cowdenbeath,2372,10,4,10,22,23,55,-32,22
Montrose,2373,1,24,7,5,61,35,26,79
Peterhead,2373,2,23,5,8,78,39,39,74
Stirling,2373,3,17,6,13,63,51,12,57
Stenhousem'r,2373,4,15,8,13,55,49,6,53
Clyde,2373,5,14,9,13,52,50,2,51
Elgin,2373,6,14,6,16,54,62,-8,48
Annan Athlet,2373,7,11,11,14,47,42,5,44
Berwick,2373,8,9,10,17,31,59,-28,37
Edinburgh Ci,2373,9,7,10,19,37,61,-24,31
Cowdenbeath,2373,10,5,10,21,24,54,-30,25
Montrose,2374,1,24,7,5,63,34,29,79
Peterhead,2374,2,23,5,8,79,40,39,74
Stenhousem'r,2374,3,16,8,12,58,48,10,56
Stirling,2374,4,16,6,14,62,54,8,54
Clyde,2374,5,15,9,12,52,48,4,54
Elgin,2374,6,14,6,16,53,64,-11,48
Annan Athlet,2374,7,11,12,13,47,41,6,45
Berwick,2374,8,8,10,18,29,59,-30,34
Edinburgh Ci,2374,9,7,10,19,38,62,-24,31
Cowdenbeath,2374,10,4,11,21,23,54,-31,23
Montrose,2375,1,24,7,5,60,34,26,79
Peterhead,2375,2,24,4,8,78,38,40,76
Stirling,2375,3,17,6,13,62,52,10,57
Stenhousem'r,2375,4,15,8,13,56,48,8,53
Clyde,2375,5,14,10,12,52,49,3,52
Elgin,2375,6,14,6,16,53,61,-8,48
Annan Athlet,2375,7,11,12,13,48,42,6,45
Berwick,2375,8,8,11,17,30,59,-29,35
Edinburgh Ci,2375,9,7,9,20,36,61,-25,30
Cowdenbeath,2375,10,4,11,21,24,55,-31,23
Montrose,2376,1,24,7,5,60,34,26,79
Peterhead,2376,2,24,4,8,80,38,42,76
Stirling,2376,3,17,6,13,63,53,10,57
Stenhousem'r,2376,4,15,8,13,57,49,8,53
Clyde,2376,5,14,9,13,51,51,0,51
Elgin,2376,6,14,6,16,53,61,-8,48
Annan Athlet,2376,7,11,11,14,47,44,3,44
Berwick,2376,8,9,10,17,32,58,-26,37
Edinburgh Ci,2376,9,7,9,20,36,63,-27,30
Cowdenbeath,2376,10,5,10,21,26,54,-28,25
Peterhead,2377,1,24,4,8,82,38,44,76
Montrose,2377,2,23,7,6,59,37,22,76
Stirling,2377,3,17,6,13,61,51,10,57
Clyde,2377,4,15,9,12,53,48,5,54
Stenhousem'r,2377,5,15,8,13,55,47,8,53
Elgin,2377,6,15,6,15,56,60,-4,51
Annan Athlet,2377,7,11,12,13,48,42,6,45
Berwick,2377,8,8,10,18,29,60,-31,34
Edinburgh Ci,2377,9,7,9,20,36,65,-29,30
Cowdenbeath,2377,10,4,11,21,24,55,-31,23
Montrose,2378,1,24,7,5,61,34,27,79
Peterhead,2378,2,24,4,8,81,38,43,76
Stirling,2378,3,17,6,13,62,52,10,57
Clyde,2378,4,15,9,12,53,48,5,54
Stenhousem'r,2378,5,15,8,13,56,48,8,53
Elgin,2378,6,14,6,16,53,62,-9,48
Annan Athlet,2378,7,11,11,14,49,44,5,44
Berwick,2378,8,8,10,18,29,60,-31,34
Edinburgh Ci,2378,9,7,9,20,36,64,-28,30
Cowdenbeath,2378,10,5,10,21,26,56,-30,25
Montrose,2379,1,23,7,6,60,37,23,76
Peterhead,2379,2,23,5,8,78,39,39,74
Stenhousem'r,2379,3,16,8,12,60,47,13,56
Stirling,2379,4,16,6,14,61,56,5,54
Clyde,2379,5,15,9,12,54,49,5,54
Elgin,2379,6,15,6,15,56,61,-5,51
Annan Athlet,2379,7,12,11,13,50,41,9,47
Berwick,2379,8,8,10,18,30,61,-31,34
Edinburgh Ci,2379,9,7,10,19,37,61,-24,31
Cowdenbeath,2379,10,4,10,22,23,57,-34,22
Montrose,2380,1,24,7,5,61,35,26,79
Peterhead,2380,2,23,4,9,78,40,38,73
Stirling,2380,3,17,6,13,61,51,10,57
Clyde,2380,4,15,9,12,54,49,5,54
Stenhousem'r,2380,5,15,8,13,55,47,8,53
Elgin,2380,6,14,6,16,54,62,-8,48
Annan Athlet,2380,7,12,11,13,49,42,7,47
Berwick,2380,8,8,10,18,30,61,-31,34
Edinburgh Ci,2380,9,8,9,19,38,61,-23,33
Cowdenbeath,2380,10,4,10,22,24,56,-32,22
Montrose,2381,1,24,7,5,61,34,27,79
Peterhead,2381,2,23,4,9,77,40,37,73
Stenhousem'r,2381,3,16,8,12,60,48,12,56
Stirling,2381,4,16,6,14,62,56,6,54
Clyde,2381,5,14,9,13,53,51,2,51
Elgin,2381,6,14,6,16,53,62,-9,48
Annan Athlet,2381,7,11,12,13,48,42,6,45
Berwick,2381,8,9,10,17,32,60,-28,37
Edinburgh Ci,2381,9,8,9,19,38,60,-22,33
Cowdenbeath,2381,10,4,11,21,24,55,-31,23
Montrose,2382,1,24,7,5,62,34,28,79
Peterhead,2382,2,24,4,8,79,39,40,76
Stirling,2382,3,16,7,13,62,53,9,55
Stenhousem'r,2382,4,15,9,12,57,48,9,54
Clyde,2382,5,14,10,12,52,49,3,52
Elgin,2382,6,14,6,16,53,63,-10,48
Annan Athlet,2382,7,12,11,13,48,41,7,47
Berwick,2382,8,8,11,17,30,59,-29,35
Edinburgh Ci,2382,9,7,9,20,37,62,-25,30
Cowdenbeath,2382,10,4,10,22,23,55,-32,22
Montrose,2383,1,24,7,5,61,34,27,79
Peterhead,2383,2,24,4,8,80,39,41,76
Stirling,2383,3,16,7,13,61,52,9,55
Stenhousem'r,2383,4,15,9,12,56,47,9,54
Clyde,2383,5,14,10,12,52,49,3,52
Elgin,2383,6,14,6,16,53,62,-9,48
Annan Athlet,2383,7,11,12,13,47,41,6,45
Berwick,2383,8,8,11,17,30,59,-29,35
Edinburgh Ci,2383,9,7,9,20,37,63,-26,30
Cowdenbeath,2383,10,4,11,21,23,54,-31,23
Montrose,2384,1,24,7,5,62,34,28,79
Peterhead,2384,2,24,4,8,80,39,41,76
Stirling,2384,3,17,6,13,63,52,11,57
Stenhousem'r,2384,4,15,8,13,56,49,7,53
Clyde,2384,5,14,9,13,52,50,2,51
Elgin,2384,6,14,6,16,53,63,-10,48
Annan Athlet,2384,7,11,11,14,48,43,5,44
Berwick,2384,8,9,10,17,31,59,-28,37
Edinburgh Ci,2384,9,7,9,20,37,63,-26,30
Cowdenbeath,2384,10,5,10,21,25,55,-30,25
Montrose,2385,1,24,7,5,61,34,27,79
Peterhead,2385,2,24,4,8,81,40,41,76
Stenhousem'r,2385,3,16,8,12,58,47,11,56
Stirling,2385,4,16,6,14,61,54,7,54
Clyde,2385,5,15,9,12,53,48,5,54
Elgin,2385,6,14,6,16,53,62,-9,48
Annan Athlet,2385,7,12,11,13,48,41,7,47
Berwick,2385,8,8,10,18,29,60,-31,34
Edinburgh Ci,2385,9,7,9,20,38,64,-26,30
Cowdenbeath,2385,10,4,10,22,23,55,-32,22
Montrose,2386,1,24,7,5,62,34,28,79
Peterhead,2386,2,23,5,8,81,42,39,74
Stirling,2386,3,16,7,13,61,52,9,55
Stenhousem'r,2386,4,15,9,12,56,47,9,54
Clyde,2386,5,15,9,12,55,50,5,54
Elgin,2386,6,14,6,16,53,63,-10,48
Annan Athlet,2386,7,12,11,13,49,42,7,47
Berwick,2386,8,8,10,18,31,62,-31,34
Edinburgh Ci,2386,9,7,10,19,40,64,-24,31
Cowdenbeath,2386,10,4,10,22,24,56,-32,22
Montrose,2387,1,24,7,5,62,35,27,79
Peterhead,2387,2,24,4,8,80,39,41,76
Stirling,2387,3,16,7,13,61,52,9,55
Stenhousem'r,2387,4,15,9,12,56,47,9,54
Clyde,2387,5,15,9,12,54,50,4,54
Elgin,2387,6,14,6,16,54,63,-9,48
Annan Athlet,2387,7,12,11,13,49,42,7,47
Berwick,2387,8,8,10,18,31,61,-30,34
Edinburgh Ci,2387,9,7,9,20,37,63,-26,30
Cowdenbeath,2387,10,4,10,22,24,56,-32,22
Montrose,2388,1,23,8,5,60,35,25,77
Peterhead,2388,2,24,4,8,81,38,43,76
Stirling,2388,3,17,6,13,62,51,11,57
Stenhousem'r,2388,4,15,8,13,55,48,7,53
Clyde,2388,5,14,10,12,52,49,3,52
Elgin,2388,6,14,7,15,54,61,-7,49
Annan Athlet,2388,7,11,11,14,47,42,5,44
Berwick,2388,8,8,11,17,30,59,-29,35
Edinburgh Ci,2388,9,7,9,20,36,64,-28,30
Cowdenbeath,2388,10,5,10,21,24,54,-30,25
Montrose,2389,1,23,8,5,60,35,25,77
Peterhead,2389,2,23,5,8,77,38,39,74
Stirling,2389,3,17,6,13,62,52,10,57
Stenhousem'r,2389,4,15,8,13,56,48,8,53
Clyde,2389,5,14,9,13,53,51,2,51
Elgin,2389,6,14,7,15,54,61,-7,49
Annan Athlet,2389,7,12,11,13,48,41,7,47
Berwick,2389,8,9,10,17,32,60,-28,37
Edinburgh Ci,2389,9,7,10,19,36,60,-24,31
Cowdenbeath,2389,10,4,10,22,23,55,-32,22
Montrose,2390,1,24,7,5,62,35,27,79
Peterhead,2390,2,24,4,8,81,38,43,76
Stirling,2390,3,17,6,13,64,52,12,57
Clyde,2390,4,15,9,12,53,49,4,54
Stenhousem'r,2390,5,15,8,13,56,50,6,53
Elgin,2390,6,14,6,16,54,63,-9,48
Annan Athlet,2390,7,12,11,13,48,41,7,47
Berwick,2390,8,8,10,18,30,60,-30,34
Edinburgh Ci,2390,9,7,9,20,36,64,-28,30
Cowdenbeath,2390,10,4,10,22,23,55,-32,22
Montrose,2391,1,24,7,5,63,35,28,79
Peterhead,2391,2,24,4,8,81,38,43,76
Stirling,2391,3,16,7,13,61,52,9,55
Stenhousem'r,2391,4,15,9,12,56,47,9,54
Clyde,2391,5,15,9,12,53,49,4,54
Elgin,2391,6,14,6,16,54,64,-10,48
Annan Athlet,2391,7,11,12,13,47,41,6,45
Berwick,2391,8,8,10,18,30,60,-30,34
Edinburgh Ci,2391,9,7,9,20,36,64,-28,30
Cowdenbeath,2391,10,4,11,21,23,54,-31,23
Montrose,2392,1,24,7,5,61,34,27,79
Peterhead,2392,2,24,4,8,80,38,42,76
Stirling,2392,3,17,6,13,61,51,10,57
Stenhousem'r,2392,4,15,8,13,55,47,8,53
Clyde,2392,5,14,10,12,52,49,3,52
Elgin,2392,6,14,6,16,53,62,-9,48
Annan Athlet,2392,7,12,11,13,48,41,7,47
Berwick,2392,8,8,11,17,30,59,-29,35
Edinburgh Ci,2392,9,7,9,20,36,63,-27,30
Cowdenbeath,2392,10,4,10,22,23,55,-32,22
Montrose,2393,1,23,8,5,60,35,25,77
Peterhead,2393,2,24,4,8,79,38,41,76
Stirling,2393,3,17,6,13,63,52,11,57
Clyde,2393,4,15,9,12,53,48,5,54
Stenhousem'r,2393,5,15,8,13,56,49,7,53
Elgin,2393,6,14,7,15,54,61,-7,49
Annan Athlet,2393,7,11,11,14,48,43,5,44
Berwick,2393,8,8,10,18,29,60,-31,34
Edinburgh Ci,2393,9,7,9,20,36,62,-26,30
Cowdenbeath,2393,10,5,10,21,25,55,-30,25
Peterhead,2394,1,24,4,8,79,38,41,76
Montrose,2394,2,23,7,6,59,35,24,76
Stirling,2394,3,16,7,13,62,53,9,55
Stenhousem'r,2394,4,15,9,12,57,48,9,54
Clyde,2394,5,14,10,12,52,49,3,52
Elgin,2394,6,15,6,15,54,60,-6,51
Annan Athlet,2394,7,11,11,14,47,43,4,44
Berwick,2394,8,8,11,17,30,59,-29,35
Edinburgh Ci,2394,9,7,9,20,36,62,-26,30
Cowdenbeath,2394,10,5,10,21,25,54,-29,25
Montrose,2395,1,23,8,5,60,35,25,77
Peterhead,2395,2,24,4,8,80,38,42,76
Stirling,2395,3,17,6,13,62,52,10,57
Stenhousem'r,2395,4,15,8,13,56,48,8,53
Clyde,2395,5,14,10,12,51,48,3,52
Elgin,2395,6,14,7,15,54,61,-7,49
Annan Athlet,2395,7,11,11,14,49,44,5,44
Berwick,2395,8,8,11,17,29,58,-29,35
Edinburgh Ci,2395,9,7,9,20,36,63,-27,30
Cowdenbeath,2395,10,5,10,21,26,56,-30,25
Montrose,2396,1,24,7,5,61,35,26,79
Peterhead,2396,2,23,5,8,78,39,39,74
Stirling,2396,3,17,6,13,63,51,12,57
Stenhousem'r,2396,4,15,8,13,55,49,6,53
Clyde,2396,5,14,10,12,52,49,3,52
Elgin,2396,6,14,6,16,54,62,-8,48
Annan Athlet,2396,7,12,11,13,50,43,7,47
Berwick,2396,8,8,11,17,30,59,-29,35
Edinburgh Ci,2396,9,7,10,19,37,61,-24,31
Cowdenbeath,2396,10,4,10,22,25,57,-32,22
Peterhead,2397,1,24,4,8,80,38,42,76
Montrose,2397,2,23,7,6,59,36,23,76
Stirling,2397,3,17,6,13,64,52,12,57
Clyde,2397,4,15,9,12,52,48,4,54
Stenhousem'r,2397,5,15,8,13,56,50,6,53
Elgin,2397,6,15,6,15,55,60,-5,51
Annan Athlet,2397,7,11,11,14,47,42,5,44
Berwick,2397,8,8,10,18,29,59,-30,34
Edinburgh Ci,2397,9,7,9,20,36,63,-27,30
Cowdenbeath,2397,10,5,10,21,24,54,-30,25
Montrose,2398,1,23,7,6,59,37,22,76
Peterhead,2398,2,23,5,8,78,39,39,74
Stirling,2398,3,17,6,13,62,51,11,57
Stenhousem'r,2398,4,15,8,13,55,48,7,53
Clyde,2398,5,14,10,12,54,51,3,52
Elgin,2398,6,15,6,15,56,60,-4,51
Annan Athlet,2398,7,11,11,14,47,42,5,44
Berwick,2398,8,8,11,17,32,61,-29,35
Edinburgh Ci,2398,9,7,10,19,37,61,-24,31
Cowdenbeath,2398,10,5,10,21,24,54,-30,25
Montrose,2399,1,24,7,5,63,35,28,79
Peterhead,2399,2,23,4,9,79,41,38,73
Stenhousem'r,2399,3,16,8,12,57,47,10,56
Stirling,2399,4,16,6,14,61,53,8,54
Clyde,2399,5,15,9,12,55,51,4,54
Elgin,2399,6,14,6,16,54,64,-10,48
Annan Athlet,2399,7,12,11,13,48,41,7,47
Berwick,2399,8,8,10,18,32,62,-30,34
Edinburgh Ci,2399,9,8,9,19,39,62,-23,33
Cowdenbeath,2399,10,4,10,22,23,55,-32,22
Peterhead,2400,1,24,4,8,79,38,41,76
Montrose,2400,2,23,7,6,59,36,23,76
Stirling,2400,3,17,6,13,63,51,12,57
Stenhousem'r,2400,4,15,8,13,55,49,6,53
Clyde,2400,5,14,9,13,51,50,1,51
Elgin,2400,6,15,6,15,55,60,-5,51
Annan Athlet,2400,7,12,11,13,50,43,7,47
Berwick,2400,8,9,10,17,31,58,-27,37
Edinburgh Ci,2400,9,7,9,20,36,62,-26,30
Cowdenbeath,2400,10,4,10,22,25,57,-32,22
Montrose,2401,1,24,7,5,61,35,26,79
Peterhead,2401,2,24,4,8,80,38,42,76
Stirling,2401,3,17,6,13,62,51,11,57
Stenhousem'r,2401,4,15,8,13,55,48,7,53
Clyde,2401,5,14,10,12,51,48,3,52
Elgin,2401,6,14,6,16,54,62,-8,48
Annan Athlet,2401,7,12,11,13,50,42,8,47
Berwick,2401,8,8,11,17,29,58,-29,35
Edinburgh Ci,2401,9,7,9,20,36,63,-27,30
Cowdenbeath,2401,10,4,10,22,24,57,-33,22
Peterhead,2402,1,24,4,8,82,39,43,76
Montrose,2402,2,23,7,6,60,36,24,76
Stirling,2402,3,17,6,13,63,52,11,57
Stenhousem'r,2402,4,15,8,13,56,49,7,53
Clyde,2402,5,14,10,12,51,48,3,52
Elgin,2402,6,15,6,15,55,61,-6,51
Annan Athlet,2402,7,12,11,13,48,41,7,47
Berwick,2402,8,8,11,17,29,58,-29,35
Edinburgh Ci,2402,9,7,9,20,37,65,-28,30
Cowdenbeath,2402,10,4,10,22,23,55,-32,22
Montrose,2403,1,23,8,5,59,34,25,77
Peterhead,2403,2,24,4,8,78,38,40,76
Stirling,2403,3,17,6,13,61,51,10,57
Stenhousem'r,2403,4,15,8,13,55,47,8,53
Clyde,2403,5,14,9,13,51,49,2,51
Elgin,2403,6,14,7,15,53,60,-7,49
Annan Athlet,2403,7,12,11,13,50,41,9,47
Berwick,2403,8,9,10,17,30,58,-28,37
Edinburgh Ci,2403,9,7,9,20,36,61,-25,30
Cowdenbeath,2403,10,4,10,22,23,57,-34,22
Peterhead,2404,1,24,4,8,79,38,41,76
Montrose,2404,2,23,7,6,59,36,23,76
Stirling,2404,3,16,7,13,60,51,9,55
Stenhousem'r,2404,4,15,9,12,55,46,9,54
Clyde,2404,5,15,9,12,52,48,4,54
Elgin,2404,6,15,6,15,55,60,-5,51
Annan Athlet,2404,7,12,11,13,50,41,9,47
Berwick,2404,8,8,10,18,29,59,-30,34
Edinburgh Ci,2404,9,7,9,20,36,62,-26,30
Cowdenbeath,2404,10,4,10,22,23,57,-34,22
Montrose,2405,1,24,7,5,63,34,29,79
Peterhead,2405,2,23,5,8,77,38,39,74
Stirling,2405,3,16,7,13,60,51,9,55
Stenhousem'r,2405,4,15,9,12,55,46,9,54
Clyde,2405,5,15,9,12,55,49,6,54
Elgin,2405,6,14,6,16,53,64,-11,48
Annan Athlet,2405,7,12,11,13,50,41,9,47
Berwick,2405,8,8,10,18,30,62,-32,34
Edinburgh Ci,2405,9,7,10,19,36,60,-24,31
Cowdenbeath,2405,10,4,10,22,23,57,-34,22
Montrose,2406,1,24,7,5,60,34,26,79
Peterhead,2406,2,24,4,8,79,39,40,76
Stirling,2406,3,17,6,13,61,51,10,57
Clyde,2406,4,15,9,12,58,50,8,54
Stenhousem'r,2406,5,15,8,13,55,47,8,53
Elgin,2406,6,14,6,16,53,61,-8,48
Annan Athlet,2406,7,11,12,13,47,41,6,45
Berwick,2406,8,8,10,18,31,65,-34,34
Edinburgh Ci,2406,9,7,9,20,37,62,-25,30
Cowdenbeath,2406,10,4,11,21,23,54,-31,23
Montrose,2407,1,24,7,5,60,34,26,79
Peterhead,2407,2,23,5,8,77,38,39,74
Stirling,2407,3,16,7,13,60,51,9,55
Stenhousem'r,2407,4,15,9,12,55,46,9,54
Clyde,2407,5,15,9,12,52,48,4,54
Elgin,2407,6,14,6,16,53,61,-8,48
Annan Athlet,2407,7,12,11,13,51,41,10,47
Berwick,2407,8,8,10,18,29,59,-30,34
Edinburgh Ci,2407,9,7,10,19,36,60,-24,31
Cowdenbeath,2407,10,4,10,22,23,58,-35,22
Peterhead,2408,1,24,4,8,80,39,41,76
Montrose,2408,2,23,7,6,60,37,23,76
Stirling,2408,3,16,7,13,61,52,9,55
Stenhousem'r,2408,4,15,9,12,56,47,9,54
Clyde,2408,5,14,10,12,51,48,3,52
Elgin,2408,6,15,6,15,56,61,-5,51
Annan Athlet,2408,7,11,12,13,47,41,6,45
Berwick,2408,8,8,11,17,29,58,-29,35
Edinburgh Ci,2408,9,7,9,20,37,63,-26,30
Cowdenbeath,2408,10,4,11,21,23,54,-31,23
Montrose,2409,1,24,7,5,61,34,27,79
Peterhead,2409,2,24,4,8,78,38,40,76
Stirling,2409,3,17,6,13,62,52,10,57
Clyde,2409,4,15,9,12,53,49,4,54
Stenhousem'r,2409,5,15,8,13,56,48,8,53
Elgin,2409,6,14,6,16,53,62,-9,48
Annan Athlet,2409,7,12,11,13,48,41,7,47
Berwick,2409,8,8,10,18,30,60,-30,34
Edinburgh Ci,2409,9,7,9,20,36,61,-25,30
Cowdenbeath,2409,10,4,10,22,23,55,-32,22
Montrose,2410,1,24,7,5,62,34,28,79
Peterhead,2410,2,23,4,9,78,41,37,73
Stirling,2410,3,17,6,13,62,51,11,57
Clyde,2410,4,15,9,12,53,48,5,54
Stenhousem'r,2410,5,15,8,13,55,48,7,53
Elgin,2410,6,14,6,16,53,63,-10,48
Annan Athlet,2410,7,12,11,13,48,41,7,47
Berwick,2410,8,8,10,18,29,60,-31,34
Edinburgh Ci,2410,9,8,9,19,39,61,-22,33
Cowdenbeath,2410,10,4,10,22,23,55,-32,22
Montrose,2411,1,23,7,6,59,36,23,76
Peterhead,2411,2,23,5,8,77,38,39,74
Stirling,2411,3,16,7,13,62,53,9,55
Stenhousem'r,2411,4,15,9,12,57,48,9,54
Clyde,2411,5,15,9,12,54,49,5,54
Elgin,2411,6,15,6,15,55,60,-5,51
Annan Athlet,2411,7,11,11,14,47,42,5,44
Berwick,2411,8,8,10,18,30,61,-31,34
Edinburgh Ci,2411,9,7,10,19,36,60,-24,31
Cowdenbeath,2411,10,5,10,21,24,54,-30,25
Montrose,2412,1,24,7,5,65,34,31,79
Peterhead,2412,2,24,4,8,80,40,40,76
Stenhousem'r,2412,3,16,8,12,58,48,10,56
Stirling,2412,4,16,6,14,62,54,8,54
Clyde,2412,5,15,9,12,53,49,4,54
Elgin,2412,6,14,6,16,53,66,-13,48
Annan Athlet,2412,7,11,11,14,48,43,5,44
Berwick,2412,8,8,10,18,30,60,-30,34
Edinburgh Ci,2412,9,7,9,20,38,63,-25,30
Cowdenbeath,2412,10,5,10,21,25,55,-30,25
Montrose,2413,1,24,7,5,62,36,26,79
Peterhead,2413,2,24,4,8,78,38,40,76
Stirling,2413,3,17,6,13,63,51,12,57
Stenhousem'r,2413,4,15,8,13,55,49,6,53
Clyde,2413,5,14,9,13,52,50,2,51
Elgin,2413,6,14,6,16,55,63,-8,48
Annan Athlet,2413,7,12,11,13,48,41,7,47
Berwick,2413,8,9,10,17,31,59,-28,37
Edinburgh Ci,2413,9,7,9,20,36,61,-25,30
Cowdenbeath,2413,10,4,10,22,23,55,-32,22
Montrose,2414,1,24,7,5,64,35,29,79
Peterhead,2414,2,24,4,8,83,38,45,76
Stirling,2414,3,17,6,13,62,52,10,57
Clyde,2414,4,15,9,12,56,50,6,54
Stenhousem'r,2414,5,15,8,13,56,48,8,53
Elgin,2414,6,14,6,16,54,65,-11,48
Annan Athlet,2414,7,12,11,13,49,41,8,47
Berwick,2414,8,8,10,18,31,63,-32,34
Edinburgh Ci,2414,9,7,9,20,36,66,-30,30
Cowdenbeath,2414,10,4,10,22,23,56,-33,22
Peterhead,2415,1,24,4,8,80,38,42,76
Montrose,2415,2,23,7,6,60,36,24,76
Stenhousem'r,2415,3,16,8,12,59,48,11,56
Stirling,2415,4,16,6,14,62,55,7,54
Clyde,2415,5,15,9,12,56,50,6,54
Elgin,2415,6,15,6,15,55,61,-6,51
Annan Athlet,2415,7,11,12,13,47,41,6,45
Berwick,2415,8,8,10,18,31,63,-32,34
Edinburgh Ci,2415,9,7,9,20,36,63,-27,30
Cowdenbeath,2415,10,4,11,21,23,54,-31,23
Montrose,2416,1,24,7,5,62,35,27,79
Peterhead,2416,2,24,4,8,79,38,41,76
Stirling,2416,3,17,6,13,65,52,13,57
Stenhousem'r,2416,4,15,8,13,56,51,5,53
Clyde,2416,5,14,9,13,52,50,2,51
Elgin,2416,6,14,6,16,54,63,-9,48
Annan Athlet,2416,7,11,12,13,47,41,6,45
Berwick,2416,8,9,10,17,31,59,-28,37
Edinburgh Ci,2416,9,7,9,20,36,62,-26,30
Cowdenbeath,2416,10,4,11,21,23,54,-31,23
Montrose,2417,1,24,7,5,61,34,27,79
Peterhead,2417,2,24,4,8,80,38,42,76
Stirling,2417,3,17,6,13,62,52,10,57
Clyde,2417,4,15,9,12,53,48,5,54
Stenhousem'r,2417,5,15,8,13,56,48,8,53
Elgin,2417,6,14,6,16,53,62,-9,48
Annan Athlet,2417,7,11,11,14,47,43,4,44
Berwick,2417,8,8,10,18,29,60,-31,34
Edinburgh Ci,2417,9,7,9,20,36,63,-27,30
Cowdenbeath,2417,10,5,10,21,25,54,-29,25
Montrose,2418,1,23,8,5,61,36,25,77
Peterhead,2418,2,24,4,8,79,38,41,76
Stirling,2418,3,16,7,13,61,52,9,55
Stenhousem'r,2418,4,15,9,12,56,47,9,54
Clyde,2418,5,15,9,12,54,49,5,54
Elgin,2418,6,14,7,15,55,62,-7,49
Annan Athlet,2418,7,11,11,14,47,42,5,44
Berwick,2418,8,8,10,18,30,61,-31,34
Edinburgh Ci,2418,9,7,9,20,36,62,-26,30
Cowdenbeath,2418,10,5,10,21,24,54,-30,25
Montrose,2419,1,24,7,5,61,34,27,79
Peterhead,2419,2,24,4,8,80,38,42,76
Stenhousem'r,2419,3,16,8,12,57,47,10,56
Stirling,2419,4,16,6,14,61,53,8,54
Clyde,2419,5,15,9,12,53,49,4,54
Elgin,2419,6,14,6,16,53,62,-9,48
Annan Athlet,2419,7,11,12,13,47,41,6,45
Berwick,2419,8,8,10,18,30,60,-30,34
Edinburgh Ci,2419,9,7,9,20,36,63,-27,30
Cowdenbeath,2419,10,4,11,21,23,54,-31,23
Montrose,2420,1,23,8,5,61,36,25,77
Peterhead,2420,2,24,4,8,80,40,40,76
Stirling,2420,3,16,7,13,63,54,9,55
Stenhousem'r,2420,4,15,9,12,58,49,9,54
Clyde,2420,5,15,9,12,55,49,6,54
Elgin,2420,6,14,7,15,55,62,-7,49
Annan Athlet,2420,7,11,11,14,47,42,5,44
Berwick,2420,8,8,10,18,30,62,-32,34
Edinburgh Ci,2420,9,7,9,20,38,63,-25,30
Cowdenbeath,2420,10,5,10,21,24,54,-30,25
Peterhead,2421,1,24,4,8,79,39,40,76
Montrose,2421,2,23,7,6,59,35,24,76
Stenhousem'r,2421,3,16,8,12,56,46,10,56
Stirling,2421,4,16,6,14,60,52,8,54
Clyde,2421,5,15,9,12,54,49,5,54
Elgin,2421,6,15,6,15,54,60,-6,51
Annan Athlet,2421,7,11,11,14,48,43,5,44
Berwick,2421,8,8,10,18,30,61,-31,34
Edinburgh Ci,2421,9,7,9,20,37,62,-25,30
Cowdenbeath,2421,10,5,10,21,25,55,-30,25
Montrose,2422,1,24,7,5,61,35,26,79
Peterhead,2422,2,24,4,8,80,39,41,76
Stenhousem'r,2422,3,16,8,12,57,47,10,56
Stirling,2422,4,16,6,14,61,53,8,54
Clyde,2422,5,14,10,12,52,49,3,52
Elgin,2422,6,14,6,16,54,62,-8,48
Annan Athlet,2422,7,12,11,13,49,41,8,47
Berwick,2422,8,8,11,17,30,59,-29,35
Edinburgh Ci,2422,9,7,9,20,37,63,-26,30
Cowdenbeath,2422,10,4,10,22,23,56,-33,22
Montrose,2423,1,24,7,5,61,35,26,79
Peterhead,2423,2,24,4,8,80,39,41,76
Stirling,2423,3,16,7,13,60,51,9,55
Stenhousem'r,2423,4,15,9,12,55,46,9,54
Clyde,2423,5,14,10,12,51,48,3,52
Elgin,2423,6,14,6,16,54,62,-8,48
Annan Athlet,2423,7,12,11,13,48,41,7,47
Berwick,2423,8,8,11,17,29,58,-29,35
Edinburgh Ci,2423,9,7,9,20,37,63,-26,30
Cowdenbeath,2423,10,4,10,22,23,55,-32,22
Peterhead,2424,1,24,4,8,81,40,41,76
Montrose,2424,2,23,7,6,59,35,24,76
Stirling,2424,3,16,7,13,61,52,9,55
Stenhousem'r,2424,4,15,9,12,56,47,9,54
Clyde,2424,5,15,9,12,53,48,5,54
Elgin,2424,6,15,6,15,54,60,-6,51
Annan Athlet,2424,7,11,12,13,48,42,6,45
Berwick,2424,8,8,10,18,29,60,-31,34
Edinburgh Ci,2424,9,7,9,20,38,64,-26,30
Cowdenbeath,2424,10,4,11,21,24,55,-31,23
Montrose,2425,1,24,7,5,62,35,27,79
Peterhead,2425,2,24,4,8,80,38,42,76
Stirling,2425,3,16,7,13,61,52,9,55
Stenhousem'r,2425,4,15,9,12,56,47,9,54
Clyde,2425,5,14,10,12,51,48,3,52
Elgin,2425,6,14,6,16,54,63,-9,48
Annan Athlet,2425,7,11,11,14,47,42,5,44
Berwick,2425,8,8,11,17,29,58,-29,35
Edinburgh Ci,2425,9,7,9,20,36,63,-27,30
Cowdenbeath,2425,10,5,10,21,24,54,-30,25
Montrose,2426,1,24,7,5,60,34,26,79
Peterhead,2426,2,24,4,8,79,39,40,76
Stirling,2426,3,17,6,13,62,52,10,57
Stenhousem'r,2426,4,15,8,13,56,48,8,53
Clyde,2426,5,14,9,13,51,50,1,51
Elgin,2426,6,14,6,16,53,61,-8,48
Annan Athlet,2426,7,11,12,13,47,41,6,45
Berwick,2426,8,9,10,17,31,58,-27,37
Edinburgh Ci,2426,9,7,9,20,37,62,-25,30
Cowdenbeath,2426,10,4,11,21,23,54,-31,23
Montrose,2427,1,24,7,5,61,34,27,79
Peterhead,2427,2,24,4,8,83,38,45,76
Stirling,2427,3,17,6,13,62,51,11,57
Clyde,2427,4,15,9,12,54,49,5,54
Stenhousem'r,2427,5,15,8,13,55,48,7,53
Elgin,2427,6,14,6,16,53,62,-9,48
Annan Athlet,2427,7,11,11,14,47,44,3,44
Berwick,2427,8,8,10,18,30,61,-31,34
Edinburgh Ci,2427,9,7,9,20,36,66,-30,30
Cowdenbeath,2427,10,5,10,21,26,54,-28,25
Montrose,2428,1,23,8,5,61,36,25,77
Peterhead,2428,2,24,4,8,79,38,41,76
Stirling,2428,3,17,6,13,64,51,13,57
Clyde,2428,4,15,9,12,53,48,5,54
Stenhousem'r,2428,5,15,8,13,55,50,5,53
Elgin,2428,6,14,7,15,55,62,-7,49
Annan Athlet,2428,7,11,11,14,48,46,2,44
Berwick,2428,8,8,10,18,29,60,-31,34
Edinburgh Ci,2428,9,7,9,20,36,62,-26,30
Cowdenbeath,2428,10,5,10,21,28,55,-27,25
Montrose,2429,1,24,7,5,61,35,26,79
Peterhead,2429,2,24,4,8,81,38,43,76
Stenhousem'r,2429,3,16,8,12,57,46,11,56
Clyde,2429,4,15,9,12,56,48,8,54
Stirling,2429,5,16,6,14,60,53,7,54
Elgin,2429,6,14,6,16,54,62,-8,48
Annan Athlet,2429,7,11,12,13,47,41,6,45
Berwick,2429,8,8,10,18,29,63,-34,34
Edinburgh Ci,2429,9,7,9,20,36,64,-28,30
Cowdenbeath,2429,10,4,11,21,23,54,-31,23
Montrose,2430,1,24,7,5,60,34,26,79
Peterhead,2430,2,24,4,8,80,39,41,76
Stenhousem'r,2430,3,16,8,12,58,47,11,56
Stirling,2430,4,16,6,14,61,54,7,54
Clyde,2430,5,15,9,12,53,48,5,54
Elgin,2430,6,14,6,16,53,61,-8,48
Annan Athlet,2430,7,11,11,14,47,42,5,44
Berwick,2430,8,8,10,18,29,60,-31,34
Edinburgh Ci,2430,9,7,9,20,37,63,-26,30
Cowdenbeath,2430,10,5,10,21,24,54,-30,25
Montrose,2431,1,23,8,5,59,34,25,77
Peterhead,2431,2,24,4,8,78,38,40,76
Stirling,2431,3,17,6,13,63,53,10,57
Clyde,2431,4,15,9,12,54,48,6,54
Stenhousem'r,2431,5,15,8,13,57,49,8,53
Elgin,2431,6,14,7,15,53,60,-7,49
Annan Athlet,2431,7,12,11,13,52,42,10,47
Berwick,2431,8,8,10,18,29,61,-32,34
Edinburgh Ci,2431,9,7,9,20,36,61,-25,30
Cowdenbeath,2431,10,4,10,22,24,59,-35,22
Montrose,2432,1,24,7,5,63,34,29,79
Peterhead,2432,2,24,4,8,82,38,44,76
Stirling,2432,3,16,7,13,62,53,9,55
Stenhousem'r,2432,4,15,9,12,57,48,9,54
Clyde,2432,5,14,10,12,51,48,3,52
Elgin,2432,6,14,6,16,53,64,-11,48
Annan Athlet,2432,7,11,11,14,48,44,4,44
Berwick,2432,8,8,11,17,29,58,-29,35
Edinburgh Ci,2432,9,7,9,20,36,65,-29,30
Cowdenbeath,2432,10,5,10,21,26,55,-29,25
Peterhead,2433,1,24,4,8,80,39,41,76
Montrose,2433,2,23,7,6,59,37,22,76
Stirling,2433,3,17,6,13,62,52,10,57
Clyde,2433,4,15,9,12,56,48,8,54
Stenhousem'r,2433,5,15,8,13,56,48,8,53
Elgin,2433,6,15,6,15,56,60,-4,51
Annan Athlet,2433,7,12,11,13,48,41,7,47
Berwick,2433,8,8,10,18,29,63,-34,34
Edinburgh Ci,2433,9,7,9,20,37,63,-26,30
Cowdenbeath,2433,10,4,10,22,23,55,-32,22
Montrose,2434,1,23,8,5,60,35,25,77
Peterhead,2434,2,24,4,8,81,38,43,76
Stirling,2434,3,17,6,13,62,52,10,57
Stenhousem'r,2434,4,15,8,13,56,48,8,53
Clyde,2434,5,14,10,12,53,50,3,52
Elgin,2434,6,14,7,15,54,61,-7,49
Annan Athlet,2434,7,11,12,13,49,43,6,45
Berwick,2434,8,8,11,17,31,60,-29,35
Edinburgh Ci,2434,9,7,9,20,36,64,-28,30
Cowdenbeath,2434,10,4,11,21,25,56,-31,23
Montrose,2435,1,23,8,5,60,35,25,77
Peterhead,2435,2,24,4,8,79,39,40,76
Stirling,2435,3,17,6,13,63,51,12,57
Stenhousem'r,2435,4,15,8,13,55,49,6,53
Clyde,2435,5,14,10,12,51,48,3,52
Elgin,2435,6,14,7,15,54,61,-7,49
Annan Athlet,2435,7,12,11,13,49,41,8,47
Berwick,2435,8,8,11,17,29,58,-29,35
Edinburgh Ci,2435,9,7,9,20,37,62,-25,30
Cowdenbeath,2435,10,4,10,22,23,56,-33,22
Montrose,2436,1,23,7,6,59,35,24,76
Peterhead,2436,2,23,5,8,79,40,39,74
Stirling,2436,3,17,6,13,63,51,12,57
Clyde,2436,4,15,9,12,53,48,5,54
Stenhousem'r,2436,5,15,8,13,55,49,6,53
Elgin,2436,6,15,6,15,54,60,-6,51
Annan Athlet,2436,7,12,11,13,50,42,8,47
Berwick,2436,8,8,10,18,29,60,-31,34
Edinburgh Ci,2436,9,7,10,19,38,62,-24,31
Cowdenbeath,2436,10,4,10,22,24,57,-33,22
Peterhead,2437,1,24,4,8,80,39,41,76
Montrose,2437,2,23,7,6,59,35,24,76
Stirling,2437,3,16,7,13,61,52,9,55
Stenhousem'r,2437,4,15,9,12,56,47,9,54
Clyde,2437,5,14,9,13,51,51,0,51
Elgin,2437,6,15,6,15,54,60,-6,51
Annan Athlet,2437,7,11,12,13,49,43,6,45
Berwick,2437,8,9,10,17,32,58,-26,37
Edinburgh Ci,2437,9,7,9,20,37,63,-26,30
Cowdenbeath,2437,10,4,11,21,25,56,-31,23
Montrose,2438,1,24,7,5,61,35,26,79
Peterhead,2438,2,24,4,8,82,42,40,76
Stirling,2438,3,17,6,13,62,51,11,57
Clyde,2438,4,15,9,12,53,49,4,54
Stenhousem'r,2438,5,15,8,13,55,48,7,53
Elgin,2438,6,14,6,16,54,62,-8,48
Annan Athlet,2438,7,11,12,13,47,41,6,45
Berwick,2438,8,8,10,18,30,60,-30,34
Edinburgh Ci,2438,9,7,9,20,40,65,-25,30
Cowdenbeath,2438,10,4,11,21,23,54,-31,23
Peterhead,2439,1,24,4,8,80,39,41,76
Montrose,2439,2,23,7,6,60,36,24,76
Stirling,2439,3,17,6,13,63,53,10,57
Clyde,2439,4,15,9,12,54,48,6,54
Stenhousem'r,2439,5,15,8,13,57,49,8,53
Elgin,2439,6,15,6,15,55,61,-6,51
Annan Athlet,2439,7,11,12,13,48,42,6,45
Berwick,2439,8,8,10,18,29,61,-32,34
Edinburgh Ci,2439,9,7,9,20,37,63,-26,30
Cowdenbeath,2439,10,4,11,21,24,55,-31,23
Montrose,2440,1,23,8,5,61,36,25,77
Peterhead,2440,2,23,5,8,78,39,39,74
Stirling,2440,3,17,6,13,62,51,11,57
Clyde,2440,4,15,9,12,58,49,9,54
Stenhousem'r,2440,5,15,8,13,55,48,7,53
Elgin,2440,6,14,7,15,55,62,-7,49
Annan Athlet,2440,7,11,12,13,48,42,6,45
Berwick,2440,8,8,10,18,30,65,-35,34
Edinburgh Ci,2440,9,7,10,19,37,61,-24,31
Cowdenbeath,2440,10,4,11,21,24,55,-31,23
Montrose,2441,1,24,7,5,61,34,27,79
Peterhead,2441,2,24,4,8,81,38,43,76
Stirling,2441,3,16,7,13,60,51,9,55
Stenhousem'r,2441,4,15,9,12,55,46,9,54
Clyde,2441,5,15,9,12,53,49,4,54
Elgin,2441,6,14,6,16,53,62,-9,48
Annan Athlet,2441,7,11,12,13,48,42,6,45
Berwick,2441,8,8,10,18,30,60,-30,34
Edinburgh Ci,2441,9,7,9,20,36,64,-28,30
Cowdenbeath,2441,10,4,11,21,24,55,-31,23
Montrose,2442,1,24,7,5,64,34,30,79
Peterhead,2442,2,24,4,8,81,39,42,76
Stirling,2442,3,17,6,13,62,51,11,57
Clyde,2442,4,15,9,12,54,50,4,54
Stenhousem'r,2442,5,15,8,13,55,48,7,53
Elgin,2442,6,14,6,16,53,65,-12,48
Annan Athlet,2442,7,12,11,13,50,42,8,47
Berwick,2442,8,8,10,18,31,61,-30,34
Edinburgh Ci,2442,9,7,9,20,37,64,-27,30
Cowdenbeath,2442,10,4,10,22,24,57,-33,22
Peterhead,2443,1,24,4,8,81,40,41,76
Montrose,2443,2,23,7,6,60,37,23,76
Stirling,2443,3,17,6,13,62,52,10,57
Stenhousem'r,2443,4,15,8,13,56,48,8,53
Clyde,2443,5,14,10,12,51,48,3,52
Elgin,2443,6,15,6,15,56,61,-5,51
Annan Athlet,2443,7,11,11,14,47,44,3,44
Berwick,2443,8,8,11,17,29,58,-29,35
Edinburgh Ci,2443,9,7,9,20,38,64,-26,30
Cowdenbeath,2443,10,5,10,21,26,54,-28,25
Montrose,2444,1,24,7,5,62,35,27,79
Peterhead,2444,2,24,4,8,78,38,40,76
Stenhousem'r,2444,3,16,8,12,64,46,18,56
Clyde,2444,4,15,9,12,54,48,6,54
Stirling,2444,5,16,6,14,60,60,0,54
Elgin,2444,6,14,6,16,54,63,-9,48
Annan Athlet,2444,7,11,11,14,47,42,5,44
Berwick,2444,8,8,10,18,29,61,-32,34
Edinburgh Ci,2444,9,7,9,20,36,61,-25,30
Cowdenbeath,2444,10,5,10,21,24,54,-30,25
Montrose,2445,1,23,7,6,59,37,22,76
Peterhead,2445,2,23,5,8,78,39,39,74
Stenhousem'r,2445,3,16,8,12,56,46,10,56
Stirling,2445,4,16,6,14,60,52,8,54
Clyde,2445,5,14,10,12,52,49,3,52
Elgin,2445,6,15,6,15,56,60,-4,51
Annan Athlet,2445,7,11,11,14,47,42,5,44
Berwick,2445,8,8,11,17,30,59,-29,35
Edinburgh Ci,2445,9,7,10,19,37,61,-24,31
Cowdenbeath,2445,10,5,10,21,24,54,-30,25
Montrose,2446,1,24,7,5,61,35,26,79
Peterhead,2446,2,24,4,8,80,39,41,76
Stenhousem'r,2446,3,16,8,12,57,47,10,56
Stirling,2446,4,16,6,14,61,53,8,54
Clyde,2446,5,14,10,12,52,49,3,52
Elgin,2446,6,14,6,16,54,62,-8,48
Annan Athlet,2446,7,12,11,13,50,43,7,47
Berwick,2446,8,8,11,17,30,59,-29,35
Edinburgh Ci,2446,9,7,9,20,37,63,-26,30
Cowdenbeath,2446,10,4,10,22,25,57,-32,22
Montrose,2447,1,23,8,5,60,35,25,77
Peterhead,2447,2,24,4,8,81,38,43,76
Stirling,2447,3,17,6,13,62,51,11,57
Clyde,2447,4,15,9,12,54,49,5,54
Stenhousem'r,2447,5,15,8,13,55,48,7,53
Elgin,2447,6,14,7,15,54,61,-7,49
Annan Athlet,2447,7,11,11,14,48,43,5,44
Berwick,2447,8,8,10,18,30,61,-31,34
Edinburgh Ci,2447,9,7,9,20,36,64,-28,30
Cowdenbeath,2447,10,5,10,21,25,55,-30,25
Peterhead,2448,1,24,4,8,78,38,40,76
Montrose,2448,2,23,7,6,59,36,23,76
Stirling,2448,3,17,6,13,64,54,10,57
Stenhousem'r,2448,4,15,8,13,58,50,8,53
Clyde,2448,5,14,10,12,52,49,3,52
Elgin,2448,6,15,6,15,55,60,-5,51
Annan Athlet,2448,7,12,11,13,49,42,7,47
Berwick,2448,8,8,11,17,30,59,-29,35
Edinburgh Ci,2448,9,7,9,20,36,61,-25,30
Cowdenbeath,2448,10,4,10,22,24,56,-32,22
Montrose,2449,1,24,7,5,60,34,26,79
Peterhead,2449,2,24,4,8,80,38,42,76
Stenhousem'r,2449,3,16,8,12,58,47,11,56
Stirling,2449,4,16,6,14,61,54,7,54
Clyde,2449,5,15,9,12,54,48,6,54
Elgin,2449,6,14,6,16,53,61,-8,48
Annan Athlet,2449,7,12,11,13,49,41,8,47
Berwick,2449,8,8,10,18,29,61,-32,34
Edinburgh Ci,2449,9,7,9,20,36,63,-27,30
Cowdenbeath,2449,10,4,10,22,23,56,-33,22
Montrose,2450,1,24,7,5,61,34,27,79
Peterhead,2450,2,24,4,8,79,38,41,76
Stirling,2450,3,16,7,13,61,52,9,55
Stenhousem'r,2450,4,15,9,12,56,47,9,54
Clyde,2450,5,14,10,12,52,49,3,52
Elgin,2450,6,14,6,16,53,62,-9,48
Annan Athlet,2450,7,11,11,14,47,42,5,44
Berwick,2450,8,8,11,17,30,59,-29,35
Edinburgh Ci,2450,9,7,9,20,36,62,-26,30
Cowdenbeath,2450,10,5,10,21,24,54,-30,25
Peterhead,2451,1,24,4,8,81,38,43,76
Montrose,2451,2,23,7,6,60,36,24,76
Stenhousem'r,2451,3,16,8,12,57,47,10,56
Stirling,2451,4,16,6,14,61,53,8,54
Clyde,2451,5,15,9,12,56,49,7,54
Elgin,2451,6,15,6,15,55,61,-6,51
Annan Athlet,2451,7,12,11,13,49,42,7,47
Berwick,2451,8,8,10,18,30,63,-33,34
Edinburgh Ci,2451,9,7,9,20,36,64,-28,30
Cowdenbeath,2451,10,4,10,22,24,56,-32,22
Montrose,2452,1,24,7,5,60,34,26,79
Peterhead,2452,2,24,4,8,80,38,42,76
Stenhousem'r,2452,3,16,8,12,58,47,11,56
Stirling,2452,4,16,6,14,61,54,7,54
Clyde,2452,5,15,9,12,54,50,4,54
Elgin,2452,6,14,6,16,53,61,-8,48
Annan Athlet,2452,7,11,12,13,47,41,6,45
Berwick,2452,8,8,10,18,31,61,-30,34
Edinburgh Ci,2452,9,7,9,20,36,63,-27,30
Cowdenbeath,2452,10,4,11,21,23,54,-31,23
Montrose,2453,1,24,7,5,60,34,26,79
Peterhead,2453,2,24,4,8,78,38,40,76
Stenhousem'r,2453,3,16,8,12,58,48,10,56
Stirling,2453,4,16,6,14,62,54,8,54
Clyde,2453,5,15,9,12,54,50,4,54
Elgin,2453,6,14,6,16,53,61,-8,48
Annan Athlet,2453,7,12,11,13,51,41,10,47
Berwick,2453,8,8,10,18,31,61,-30,34
Edinburgh Ci,2453,9,7,9,20,36,61,-25,30
Cowdenbeath,2453,10,4,10,22,23,58,-35,22
Montrose,2454,1,23,7,6,59,37,22,76
Peterhead,2454,2,23,5,8,77,38,39,74
Stenhousem'r,2454,3,16,8,12,57,47,10,56
Stirling,2454,4,16,6,14,61,53,8,54
Clyde,2454,5,14,9,13,52,50,2,51
Elgin,2454,6,15,6,15,56,60,-4,51
Annan Athlet,2454,7,11,12,13,47,41,6,45
Berwick,2454,8,9,10,17,31,59,-28,37
Edinburgh Ci,2454,9,7,10,19,36,60,-24,31
Cowdenbeath,2454,10,4,11,21,23,54,-31,23
Montrose,2455,1,24,7,5,63,35,28,79
Peterhead,2455,2,23,5,8,78,39,39,74
Stirling,2455,3,16,7,13,62,53,9,55
Stenhousem'r,2455,4,15,9,12,57,48,9,54
Clyde,2455,5,15,9,12,52,48,4,54
Elgin,2455,6,14,6,16,54,64,-10,48
Annan Athlet,2455,7,11,11,14,48,43,5,44
Berwick,2455,8,8,10,18,29,59,-30,34
Edinburgh Ci,2455,9,7,10,19,37,61,-24,31
Cowdenbeath,2455,10,5,10,21,25,55,-30,25
Montrose,2456,1,23,8,5,59,34,25,77
Peterhead,2456,2,24,4,8,80,38,42,76
Stirling,2456,3,17,6,13,64,52,12,57
Stenhousem'r,2456,4,15,8,13,56,50,6,53
Clyde,2456,5,14,10,12,53,50,3,52
Elgin,2456,6,14,7,15,53,60,-7,49
Annan Athlet,2456,7,12,11,13,49,42,7,47
Berwick,2456,8,8,11,17,31,60,-29,35
Edinburgh Ci,2456,9,7,9,20,36,63,-27,30
Cowdenbeath,2456,10,4,10,22,24,56,-32,22
Montrose,2457,1,23,8,5,60,35,25,77
Peterhead,2457,2,24,4,8,78,38,40,76
Stirling,2457,3,17,6,13,62,51,11,57
Clyde,2457,4,15,9,12,53,48,5,54
Stenhousem'r,2457,5,15,8,13,55,48,7,53
Elgin,2457,6,14,7,15,54,61,-7,49
Annan Athlet,2457,7,11,12,13,48,42,6,45
Berwick,2457,8,8,10,18,29,60,-31,34
Edinburgh Ci,2457,9,7,9,20,36,61,-25,30
Cowdenbeath,2457,10,4,11,21,24,55,-31,23
Montrose,2458,1,24,7,5,63,36,27,79
Peterhead,2458,2,24,4,8,80,38,42,76
Stenhousem'r,2458,3,16,8,12,57,47,10,56
Stirling,2458,4,16,6,14,61,53,8,54
Clyde,2458,5,15,9,12,55,49,6,54
Elgin,2458,6,14,6,16,55,64,-9,48
Annan Athlet,2458,7,11,11,14,47,43,4,44
Berwick,2458,8,8,10,18,30,62,-32,34
Edinburgh Ci,2458,9,7,9,20,36,63,-27,30
Cowdenbeath,2458,10,5,10,21,25,54,-29,25
Montrose,2459,1,24,7,5,61,34,27,79
Peterhead,2459,2,24,4,8,80,38,42,76
Stirling,2459,3,17,6,13,61,51,10,57
Clyde,2459,4,15,9,12,53,48,5,54
Stenhousem'r,2459,5,15,8,13,55,47,8,53
Elgin,2459,6,14,6,16,53,62,-9,48
Annan Athlet,2459,7,12,11,13,50,41,9,47
Berwick,2459,8,8,10,18,29,60,-31,34
Edinburgh Ci,2459,9,7,9,20,36,63,-27,30
Cowdenbeath,2459,10,4,10,22,23,57,-34,22
Montrose,2460,1,24,7,5,62,36,26,79
Peterhead,2460,2,24,4,8,81,39,42,76
Stirling,2460,3,17,6,13,62,52,10,57
Clyde,2460,4,15,9,12,54,48,6,54
Stenhousem'r,2460,5,15,8,13,56,48,8,53
Elgin,2460,6,14,6,16,55,63,-8,48
Annan Athlet,2460,7,12,11,13,50,41,9,47
Berwick,2460,8,8,10,18,29,61,-32,34
Edinburgh Ci,2460,9,7,9,20,37,64,-27,30
Cowdenbeath,2460,10,4,10,22,23,57,-34,22
Montrose,2461,1,24,7,5,61,34,27,79
Peterhead,2461,2,24,4,8,82,38,44,76
Stenhousem'r,2461,3,16,8,12,58,48,10,56
Stirling,2461,4,16,6,14,62,54,8,54
Clyde,2461,5,15,9,12,52,48,4,54
Elgin,2461,6,14,6,16,53,62,-9,48
Annan Athlet,2461,7,11,11,14,47,43,4,44
Berwick,2461,8,8,10,18,29,59,-30,34
Edinburgh Ci,2461,9,7,9,20,36,65,-29,30
Cowdenbeath,2461,10,5,10,21,25,54,-29,25
Montrose,2462,1,24,7,5,63,36,27,79
Peterhead,2462,2,24,4,8,82,39,43,76
Stirling,2462,3,17,6,13,64,51,13,57
Clyde,2462,4,15,9,12,53,49,4,54
Stenhousem'r,2462,5,15,8,13,55,50,5,53
Elgin,2462,6,14,6,16,55,64,-9,48
Annan Athlet,2462,7,12,11,13,49,42,7,47
Berwick,2462,8,8,10,18,30,60,-30,34
Edinburgh Ci,2462,9,7,9,20,37,65,-28,30
Cowdenbeath,2462,10,4,10,22,24,56,-32,22
Montrose,2463,1,24,7,5,61,35,26,79
Peterhead,2463,2,24,4,8,81,40,41,76
Stenhousem'r,2463,3,16,8,12,58,48,10,56
Stirling,2463,4,16,6,14,62,54,8,54
Clyde,2463,5,15,9,12,54,48,6,54
Elgin,2463,6,14,6,16,54,62,-8,48
Annan Athlet,2463,7,12,11,13,48,41,7,47
Berwick,2463,8,8,10,18,29,61,-32,34
Edinburgh Ci,2463,9,7,9,20,38,64,-26,30
Cowdenbeath,2463,10,4,10,22,23,55,-32,22
Montrose,2464,1,24,7,5,61,35,26,79
Peterhead,2464,2,24,4,8,81,39,42,76
Stirling,2464,3,16,7,13,61,52,9,55
Stenhousem'r,2464,4,15,9,12,56,47,9,54
Clyde,2464,5,14,10,12,51,48,3,52
Elgin,2464,6,14,6,16,54,62,-8,48
Annan Athlet,2464,7,11,12,13,47,41,6,45
Berwick,2464,8,8,11,17,29,58,-29,35
Edinburgh Ci,2464,9,7,9,20,37,64,-27,30
Cowdenbeath,2464,10,4,11,21,23,54,-31,23
Montrose,2465,1,24,7,5,62,36,26,79
Peterhead,2465,2,23,4,9,77,41,36,73
Stirling,2465,3,17,6,13,62,51,11,57
Clyde,2465,4,15,9,12,52,48,4,54
Stenhousem'r,2465,5,15,8,13,55,48,7,53
Elgin,2465,6,14,6,16,55,63,-8,48
Annan Athlet,2465,7,11,12,13,49,43,6,45
Berwick,2465,8,8,10,18,29,59,-30,34
Edinburgh Ci,2465,9,8,9,19,39,60,-21,33
Cowdenbeath,2465,10,4,11,21,25,56,-31,23
Montrose,2466,1,24,7,5,60,34,26,79
Peterhead,2466,2,24,4,8,81,39,42,76
Stenhousem'r,2466,3,16,8,12,59,49,10,56
Stirling,2466,4,16,6,14,63,55,8,54
Clyde,2466,5,15,9,12,55,48,7,54
Elgin,2466,6,14,6,16,53,61,-8,48
Annan Athlet,2466,7,11,11,14,47,44,3,44
Berwick,2466,8,8,10,18,29,62,-33,34
Edinburgh Ci,2466,9,7,9,20,37,64,-27,30
Cowdenbeath,2466,10,5,10,21,26,54,-28,25
Montrose,2467,1,23,8,5,61,36,25,77
Peterhead,2467,2,24,4,8,82,38,44,76
Stirling,2467,3,17,6,13,61,51,10,57
Clyde,2467,4,15,9,12,56,50,6,54
Stenhousem'r,2467,5,15,8,13,55,47,8,53
Elgin,2467,6,14,7,15,55,62,-7,49
Annan Athlet,2467,7,11,11,14,48,43,5,44
Berwick,2467,8,8,10,18,31,63,-32,34
Edinburgh Ci,2467,9,7,9,20,36,65,-29,30
Cowdenbeath,2467,10,5,10,21,25,55,-30,25
Montrose,2468,1,23,8,5,61,36,25,77
Peterhead,2468,2,24,4,8,81,38,43,76
Stirling,2468,3,16,7,13,61,52,9,55
Stenhousem'r,2468,4,15,9,12,56,47,9,54
Clyde,2468,5,14,10,12,51,48,3,52
Elgin,2468,6,14,7,15,55,62,-7,49
Annan Athlet,2468,7,11,11,14,47,46,1,44
Berwick,2468,8,8,11,17,29,58,-29,35
Edinburgh Ci,2468,9,7,9,20,36,64,-28,30
Cowdenbeath,2468,10,5,10,21,28,54,-26,25
Montrose,2469,1,23,8,5,60,35,25,77
Peterhead,2469,2,24,4,8,79,38,41,76
Stirling,2469,3,16,7,13,62,53,9,55
Stenhousem'r,2469,4,15,9,12,57,48,9,54
Clyde,2469,5,15,9,12,55,50,5,54
Elgin,2469,6,14,7,15,54,61,-7,49
Annan Athlet,2469,7,11,11,14,47,43,4,44
Berwick,2469,8,8,10,18,31,62,-31,34
Edinburgh Ci,2469,9,7,9,20,36,62,-26,30
Cowdenbeath,2469,10,5,10,21,25,54,-29,25
Montrose,2470,1,24,7,5,62,35,27,79
Peterhead,2470,2,24,4,8,78,38,40,76
Stirling,2470,3,17,6,13,61,51,10,57
Clyde,2470,4,15,9,12,56,49,7,54
Stenhousem'r,2470,5,15,8,13,55,47,8,53
Elgin,2470,6,14,6,16,54,63,-9,48
Annan Athlet,2470,7,11,12,13,48,42,6,45
Berwick,2470,8,8,10,18,30,63,-33,34
Edinburgh Ci,2470,9,7,9,20,36,61,-25,30
Cowdenbeath,2470,10,4,11,21,24,55,-31,23
Montrose,2471,1,24,7,5,61,35,26,79
Peterhead,2471,2,24,4,8,79,38,41,76
Stirling,2471,3,16,7,13,62,53,9,55
Stenhousem'r,2471,4,15,9,12,57,48,9,54
Clyde,2471,5,14,9,13,52,50,2,51
Elgin,2471,6,14,6,16,54,62,-8,48
Annan Athlet,2471,7,12,11,13,49,42,7,47
Berwick,2471,8,9,10,17,31,59,-28,37
Edinburgh Ci,2471,9,7,9,20,36,62,-26,30
Cowdenbeath,2471,10,4,10,22,24,56,-32,22
Peterhead,2472,1,24,4,8,80,38,42,76
Montrose,2472,2,23,7,6,62,38,24,76
Stirling,2472,3,17,6,13,62,52,10,57
Stenhousem'r,2472,4,15,8,13,56,48,8,53
Clyde,2472,5,14,9,13,51,49,2,51
Elgin,2472,6,15,6,15,57,63,-6,51
Annan Athlet,2472,7,12,11,13,48,41,7,47
Berwick,2472,8,9,10,17,30,58,-28,37
Edinburgh Ci,2472,9,7,9,20,36,63,-27,30
Cowdenbeath,2472,10,4,10,22,23,55,-32,22
Montrose,2473,1,23,7,6,59,35,24,76
Peterhead,2473,2,23,4,9,79,41,38,73
Stirling,2473,3,17,6,13,62,52,10,57
Stenhousem'r,2473,4,15,8,13,56,48,8,53
Clyde,2473,5,14,9,13,51,49,2,51
Elgin,2473,6,15,6,15,54,60,-6,51
Annan Athlet,2473,7,11,12,13,47,41,6,45
Berwick,2473,8,9,10,17,30,58,-28,37
Edinburgh Ci,2473,9,8,9,19,39,62,-23,33
Cowdenbeath,2473,10,4,11,21,23,54,-31,23
Peterhead,2474,1,24,4,8,79,39,40,76
Montrose,2474,2,23,7,6,59,36,23,76
Stirling,2474,3,17,6,13,63,52,11,57
Clyde,2474,4,15,9,12,53,49,4,54
Stenhousem'r,2474,5,15,8,13,56,49,7,53
Elgin,2474,6,15,6,15,55,60,-5,51
Annan Athlet,2474,7,11,12,13,48,42,6,45
Berwick,2474,8,8,10,18,30,60,-30,34
Edinburgh Ci,2474,9,7,9,20,37,62,-25,30
Cowdenbeath,2474,10,4,11,21,24,55,-31,23
Montrose,2475,1,23,8,5,60,35,25,77
Peterhead,2475,2,23,4,9,79,41,38,73
Stirling,2475,3,17,6,13,63,51,12,57
Clyde,2475,4,15,9,12,54,49,5,54
Stenhousem'r,2475,5,15,8,13,55,49,6,53
Elgin,2475,6,14,7,15,54,61,-7,49
Annan Athlet,2475,7,11,11,14,47,42,5,44
Berwick,2475,8,8,10,18,30,61,-31,34
Edinburgh Ci,2475,9,8,9,19,39,62,-23,33
Cowdenbeath,2475,10,5,10,21,24,54,-30,25
Peterhead,2476,1,24,4,8,80,40,40,76
Montrose,2476,2,23,7,6,59,35,24,76
Stirling,2476,3,16,7,13,60,51,9,55
Stenhousem'r,2476,4,15,9,12,55,46,9,54
Clyde,2476,5,14,9,13,53,51,2,51
Elgin,2476,6,15,6,15,54,60,-6,51
Annan Athlet,2476,7,11,12,13,49,43,6,45
Berwick,2476,8,9,10,17,32,60,-28,37
Edinburgh Ci,2476,9,7,9,20,38,63,-25,30
Cowdenbeath,2476,10,4,11,21,25,56,-31,23
Montrose,2477,1,24,7,5,61,35,26,79
Peterhead,2477,2,24,4,8,78,38,40,76
Stirling,2477,3,16,7,13,61,52,9,55
Stenhousem'r,2477,4,15,9,12,56,47,9,54
Clyde,2477,5,15,9,12,53,49,4,54
Elgin,2477,6,14,6,16,54,62,-8,48
Annan Athlet,2477,7,11,12,13,48,42,6,45
Berwick,2477,8,8,10,18,30,60,-30,34
Edinburgh Ci,2477,9,7,9,20,36,61,-25,30
Cowdenbeath,2477,10,4,11,21,24,55,-31,23
Montrose,2478,1,24,7,5,63,34,29,79
Peterhead,2478,2,23,5,8,78,39,39,74
Stenhousem'r,2478,3,16,8,12,57,47,10,56
Stirling,2478,4,16,6,14,61,53,8,54
Clyde,2478,5,14,10,12,52,49,3,52
Elgin,2478,6,14,6,16,53,64,-11,48
Annan Athlet,2478,7,11,11,14,47,42,5,44
Berwick,2478,8,8,11,17,30,59,-29,35
Edinburgh Ci,2478,9,7,10,19,37,61,-24,31
Cowdenbeath,2478,10,5,10,21,24,54,-30,25
Peterhead,2479,1,24,4,8,81,38,43,76
Montrose,2479,2,23,7,6,59,35,24,76
Stirling,2479,3,16,7,13,61,52,9,55
Stenhousem'r,2479,4,15,9,12,56,47,9,54
Clyde,2479,5,15,9,12,55,50,5,54
Elgin,2479,6,15,6,15,54,60,-6,51
Annan Athlet,2479,7,11,12,13,48,42,6,45
Berwick,2479,8,8,10,18,31,62,-31,34
Edinburgh Ci,2479,9,7,9,20,36,64,-28,30
Cowdenbeath,2479,10,4,11,21,24,55,-31,23
Montrose,2480,1,24,7,5,61,35,26,79
Peterhead,2480,2,24,4,8,81,39,42,76
Stenhousem'r,2480,3,16,8,12,56,46,10,56
Stirling,2480,4,16,6,14,60,52,8,54
Clyde,2480,5,15,9,12,52,48,4,54
Elgin,2480,6,14,6,16,54,62,-8,48
Annan Athlet,2480,7,11,11,14,48,43,5,44
Berwick,2480,8,8,10,18,29,59,-30,34
Edinburgh Ci,2480,9,7,9,20,37,64,-27,30
Cowdenbeath,2480,10,5,10,21,25,55,-30,25
Montrose,2481,1,23,8,5,59,34,25,77
Peterhead,2481,2,24,4,8,79,39,40,76
Stenhousem'r,2481,3,16,8,12,56,46,10,56
Stirling,2481,4,16,6,14,60,52,8,54
Clyde,2481,5,14,9,13,52,51,1,51
Elgin,2481,6,14,7,15,53,60,-7,49
Annan Athlet,2481,7,11,12,13,47,41,6,45
Berwick,2481,8,9,10,17,32,59,-27,37
Edinburgh Ci,2481,9,7,9,20,37,62,-25,30
Cowdenbeath,2481,10,4,11,21,23,54,-31,23
Montrose,2482,1,23,8,5,61,36,25,77
Peterhead,2482,2,23,5,8,78,39,39,74
Stirling,2482,3,17,6,13,61,51,10,57
Stenhousem'r,2482,4,15,8,13,55,47,8,53
Clyde,2482,5,14,9,13,52,50,2,51
Elgin,2482,6,14,7,15,55,62,-7,49
Annan Athlet,2482,7,11,12,13,48,42,6,45
Berwick,2482,8,9,10,17,31,59,-28,37
Edinburgh Ci,2482,9,7,10,19,37,61,-24,31
Cowdenbeath,2482,10,4,11,21,24,55,-31,23
Montrose,2483,1,24,7,5,61,34,27,79
Peterhead,2483,2,24,4,8,83,39,44,76
Stirling,2483,3,17,6,13,63,52,11,57
Clyde,2483,4,15,9,12,55,49,6,54
Stenhousem'r,2483,5,15,8,13,56,49,7,53
Elgin,2483,6,14,6,16,53,62,-9,48
Annan Athlet,2483,7,12,11,13,48,41,7,47
Berwick,2483,8,8,10,18,30,62,-32,34
Edinburgh Ci,2483,9,7,9,20,37,66,-29,30
Cowdenbeath,2483,10,4,10,22,23,55,-32,22
Montrose,2484,1,24,7,5,63,36,27,79
Peterhead,2484,2,24,4,8,81,39,42,76
Stirling,2484,3,17,6,13,61,51,10,57
Stenhousem'r,2484,4,15,8,13,55,47,8,53
Clyde,2484,5,14,9,13,52,50,2,51
Elgin,2484,6,14,6,16,55,64,-9,48
Annan Athlet,2484,7,11,12,13,48,42,6,45
Berwick,2484,8,9,10,17,31,59,-28,37
Edinburgh Ci,2484,9,7,9,20,37,64,-27,30
Cowdenbeath,2484,10,4,11,21,24,55,-31,23
Montrose,2485,1,24,7,5,61,35,26,79
Peterhead,2485,2,24,4,8,79,39,40,76
Stenhousem'r,2485,3,16,8,12,57,46,11,56
Stirling,2485,4,16,6,14,60,53,7,54
Clyde,2485,5,14,9,13,53,51,2,51
Elgin,2485,6,14,6,16,54,62,-8,48
Annan Athlet,2485,7,12,11,13,48,41,7,47
Berwick,2485,8,9,10,17,32,60,-28,37
Edinburgh Ci,2485,9,7,9,20,37,62,-25,30
Cowdenbeath,2485,10,4,10,22,23,55,-32,22
Montrose,2486,1,23,8,5,61,36,25,77
Peterhead,2486,2,24,4,8,79,38,41,76
Stenhousem'r,2486,3,16,8,12,57,47,10,56
Stirling,2486,4,16,6,14,61,53,8,54
Clyde,2486,5,15,9,12,53,48,5,54
Elgin,2486,6,14,7,15,55,62,-7,49
Annan Athlet,2486,7,11,11,14,47,42,5,44
Berwick,2486,8,8,10,18,29,60,-31,34
Edinburgh Ci,2486,9,7,9,20,36,62,-26,30
Cowdenbeath,2486,10,5,10,21,24,54,-30,25
Montrose,2487,1,23,8,5,61,36,25,77
Peterhead,2487,2,23,5,8,78,39,39,74
Stirling,2487,3,16,7,13,61,52,9,55
Stenhousem'r,2487,4,15,9,12,56,47,9,54
Clyde,2487,5,14,9,13,51,50,1,51
Elgin,2487,6,14,7,15,55,62,-7,49
Annan Athlet,2487,7,11,12,13,48,42,6,45
Berwick,2487,8,9,10,17,31,58,-27,37
Edinburgh Ci,2487,9,7,10,19,37,61,-24,31
Cowdenbeath,2487,10,4,11,21,24,55,-31,23
Montrose,2488,1,24,7,5,62,34,28,79
Peterhead,2488,2,23,5,8,79,40,39,74
Stirling,2488,3,16,7,13,60,51,9,55
Stenhousem'r,2488,4,15,9,12,55,46,9,54
Clyde,2488,5,14,9,13,51,49,2,51
Elgin,2488,6,14,6,16,53,63,-10,48
Annan Athlet,2488,7,11,11,14,47,42,5,44
Berwick,2488,8,9,10,17,30,58,-28,37
Edinburgh Ci,2488,9,7,10,19,38,62,-24,31
Cowdenbeath,2488,10,5,10,21,24,54,-30,25
Montrose,2489,1,24,7,5,61,34,27,79
Peterhead,2489,2,24,4,8,80,38,42,76
Stenhousem'r,2489,3,16,8,12,59,47,12,56
Stirling,2489,4,16,6,14,61,55,6,54
Clyde,2489,5,15,9,12,53,49,4,54
Elgin,2489,6,14,6,16,53,62,-9,48
Annan Athlet,2489,7,12,11,13,51,42,9,47
Berwick,2489,8,8,10,18,30,60,-30,34
Edinburgh Ci,2489,9,7,9,20,36,63,-27,30
Cowdenbeath,2489,10,4,10,22,24,58,-34,22
Montrose,2490,1,24,7,5,62,35,27,79
Peterhead,2490,2,24,4,8,84,39,45,76
Stirling,2490,3,17,6,13,63,51,12,57
Clyde,2490,4,15,9,12,52,48,4,54
Stenhousem'r,2490,5,15,8,13,55,49,6,53
Elgin,2490,6,14,6,16,54,63,-9,48
Annan Athlet,2490,7,11,12,13,48,42,6,45
Berwick,2490,8,8,10,18,29,59,-30,34
Edinburgh Ci,2490,9,7,9,20,37,67,-30,30
Cowdenbeath,2490,10,4,11,21,24,55,-31,23
Peterhead,2491,1,24,4,8,80,38,42,76
Montrose,2491,2,23,7,6,61,37,24,76
Stenhousem'r,2491,3,16,8,12,57,46,11,56
Stirling,2491,4,16,6,14,60,53,7,54
Clyde,2491,5,14,10,12,52,49,3,52
Elgin,2491,6,15,6,15,56,62,-6,51
Annan Athlet,2491,7,12,11,13,49,42,7,47
Berwick,2491,8,8,11,17,30,59,-29,35
Edinburgh Ci,2491,9,7,9,20,36,63,-27,30
Cowdenbeath,2491,10,4,10,22,24,56,-32,22
Montrose,2492,1,23,8,5,59,34,25,77
Peterhead,2492,2,24,4,8,78,38,40,76
Stirling,2492,3,17,6,13,63,53,10,57
Clyde,2492,4,15,9,12,55,50,5,54
Stenhousem'r,2492,5,15,8,13,57,49,8,53
Elgin,2492,6,14,7,15,53,60,-7,49
Annan Athlet,2492,7,12,11,13,49,41,8,47
Berwick,2492,8,8,10,18,31,62,-31,34
Edinburgh Ci,2492,9,7,9,20,36,61,-25,30
Cowdenbeath,2492,10,4,10,22,23,56,-33,22
Montrose,2493,1,23,8,5,59,34,25,77
Peterhead,2493,2,24,4,8,83,39,44,76
Stirling,2493,3,17,6,13,64,52,12,57
Clyde,2493,4,15,9,12,53,49,4,54
Stenhousem'r,2493,5,15,8,13,56,50,6,53
Elgin,2493,6,14,7,15,53,60,-7,49
Annan Athlet,2493,7,12,11,13,49,42,7,47
Berwick,2493,8,8,10,18,30,60,-30,34
Edinburgh Ci,2493,9,7,9,20,37,66,-29,30
Cowdenbeath,2493,10,4,10,22,24,56,-32,22
Montrose,2494,1,24,7,5,61,34,27,79
Peterhead,2494,2,23,5,8,80,41,39,74
Stirling,2494,3,17,6,13,63,52,11,57
Stenhousem'r,2494,4,15,8,13,56,49,7,53
Clyde,2494,5,14,10,12,54,51,3,52
Elgin,2494,6,14,6,16,53,62,-9,48
Annan Athlet,2494,7,11,11,14,47,44,3,44
Berwick,2494,8,8,11,17,32,61,-29,35
Edinburgh Ci,2494,9,7,10,19,39,63,-24,31
Cowdenbeath,2494,10,5,10,21,26,54,-28,25
Montrose,2495,1,24,7,5,61,35,26,79
Peterhead,2495,2,24,4,8,82,38,44,76
Stenhousem'r,2495,3,16,8,12,56,46,10,56
Stirling,2495,4,16,6,14,60,52,8,54
Clyde,2495,5,15,9,12,54,48,6,54
Elgin,2495,6,14,6,16,54,62,-8,48
Annan Athlet,2495,7,11,11,14,48,43,5,44
Berwick,2495,8,8,10,18,29,61,-32,34
Edinburgh Ci,2495,9,7,9,20,36,65,-29,30
Cowdenbeath,2495,10,5,10,21,25,55,-30,25
Montrose,2496,1,24,7,5,63,35,28,79
Peterhead,2496,2,24,4,8,81,38,43,76
Stirling,2496,3,17,6,13,62,52,10,57
Clyde,2496,4,15,9,12,55,48,7,54
Stenhousem'r,2496,5,15,8,13,56,48,8,53
Elgin,2496,6,14,6,16,54,64,-10,48
Annan Athlet,2496,7,11,12,13,47,41,6,45
Berwick,2496,8,8,10,18,29,62,-33,34
Edinburgh Ci,2496,9,7,9,20,36,64,-28,30
Cowdenbeath,2496,10,4,11,21,23,54,-31,23
Montrose,2497,1,24,7,5,61,35,26,79
Peterhead,2497,2,23,5,8,77,38,39,74
Stenhousem'r,2497,3,16,8,12,57,46,11,56
Clyde,2497,4,15,9,12,56,48,8,54
Stirling,2497,5,16,6,14,60,53,7,54
Elgin,2497,6,14,6,16,54,62,-8,48
Annan Athlet,2497,7,11,11,14,47,42,5,44
Berwick,2497,8,8,10,18,29,63,-34,34
Edinburgh Ci,2497,9,7,10,19,36,60,-24,31
Cowdenbeath,2497,10,5,10,21,24,54,-30,25
Montrose,2498,1,24,7,5,62,36,26,79
Peterhead,2498,2,24,4,8,80,40,40,76
Stirling,2498,3,17,6,13,64,53,11,57
Clyde,2498,4,15,9,12,54,49,5,54
Stenhousem'r,2498,5,15,8,13,57,50,7,53
Elgin,2498,6,14,6,16,55,63,-8,48
Annan Athlet,2498,7,12,11,13,49,42,7,47
Berwick,2498,8,8,10,18,30,61,-31,34
Edinburgh Ci,2498,9,7,9,20,38,63,-25,30
Cowdenbeath,2498,10,4,10,22,24,56,-32,22
Peterhead,2499,1,24,4,8,81,38,43,76
Montrose,2499,2,23,7,6,59,38,21,76
Stirling,2499,3,17,6,13,63,51,12,57
Clyde,2499,4,15,9,12,54,49,5,54
Stenhousem'r,2499,5,15,8,13,55,49,6,53
Elgin,2499,6,15,6,15,57,60,-3,51
Annan Athlet,2499,7,11,12,13,48,42,6,45
Berwick,2499,8,8,10,18,30,61,-31,34
Edinburgh Ci,2499,9,7,9,20,36,64,-28,30
Cowdenbeath,2499,10,4,11,21,24,55,-31,23
Montrose,2500,1,24,7,5,66,35,31,79
Peterhead,2500,2,24,4,8,78,38,40,76
Stenhousem'r,2500,3,16,8,12,59,47,12,56
Stirling,2500,4,16,6,14,61,55,6,54
Clyde,2500,5,15,9,12,53,49,4,54
Elgin,2500,6,14,6,16,54,67,-13,48
Annan Athlet,2500,7,11,11,14,47,42,5,44
Berwick,2500,8,8,10,18,30,60,-30,34
Edinburgh Ci,2500,9,7,9,20,36,61,-25,30
Cowdenbeath,2500,10,5,10,21,24,54,-30,25
Montrose,2501,1,24,7,5,61,35,26,79
Peterhead,2501,2,24,4,8,78,38,40,76
Stenhousem'r,2501,3,16,8,12,56,46,10,56
Stirling,2501,4,16,6,14,60,52,8,54
Clyde,2501,5,15,9,12,54,49,5,54
Elgin,2501,6,14,6,16,54,62,-8,48
Annan Athlet,2501,7,11,12,13,48,42,6,45
Berwick,2501,8,8,10,18,30,61,-31,34
Edinburgh Ci,2501,9,7,9,20,36,61,-25,30
Cowdenbeath,2501,10,4,11,21,24,55,-31,23
Montrose,2502,1,24,7,5,62,34,28,79
Peterhead,2502,2,24,4,8,79,39,40,76
Stenhousem'r,2502,3,16,8,12,58,47,11,56
Stirling,2502,4,16,6,14,61,54,7,54
Clyde,2502,5,14,10,12,52,49,3,52
Elgin,2502,6,14,6,16,53,63,-10,48
Annan Athlet,2502,7,12,11,13,48,41,7,47
Berwick,2502,8,8,11,17,30,59,-29,35
Edinburgh Ci,2502,9,7,9,20,37,62,-25,30
Cowdenbeath,2502,10,4,10,22,23,55,-32,22
Montrose,2503,1,23,7,6,59,35,24,76
Peterhead,2503,2,23,4,9,79,41,38,73
Stirling,2503,3,16,7,13,61,52,9,55
Stenhousem'r,2503,4,15,9,12,56,47,9,54
Clyde,2503,5,15,9,12,53,49,4,54
Elgin,2503,6,15,6,15,54,60,-6,51
Annan Athlet,2503,7,11,12,13,47,41,6,45
Berwick,2503,8,8,10,18,30,60,-30,34
Edinburgh Ci,2503,9,8,9,19,39,62,-23,33
Cowdenbeath,2503,10,4,11,21,23,54,-31,23
Montrose,2504,1,23,8,5,60,35,25,77
Peterhead,2504,2,24,4,8,80,40,40,76
Stenhousem'r,2504,3,16,8,12,57,46,11,56
Stirling,2504,4,16,6,14,60,53,7,54
Clyde,2504,5,15,9,12,53,49,4,54
Elgin,2504,6,14,7,15,54,61,-7,49
Annan Athlet,2504,7,12,11,13,48,41,7,47
Berwick,2504,8,8,10,18,30,60,-30,34
Edinburgh Ci,2504,9,7,9,20,38,63,-25,30
Cowdenbeath,2504,10,4,10,22,23,55,-32,22
Montrose,2505,1,24,7,5,62,36,26,79
Peterhead,2505,2,23,4,9,78,40,38,73
Stirling,2505,3,17,6,13,63,52,11,57
Stenhousem'r,2505,4,15,8,13,56,49,7,53
Clyde,2505,5,14,10,12,53,50,3,52
Elgin,2505,6,14,6,16,55,63,-8,48
Annan Athlet,2505,7,12,11,13,48,41,7,47
Berwick,2505,8,8,11,17,31,60,-29,35
Edinburgh Ci,2505,9,8,9,19,38,61,-23,33
Cowdenbeath,2505,10,4,10,22,23,55,-32,22
Montrose,2506,1,24,7,5,62,34,28,79
Peterhead,2506,2,24,4,8,80,40,40,76
Stirling,2506,3,17,6,13,62,52,10,57
Stenhousem'r,2506,4,15,8,13,56,48,8,53
Clyde,2506,5,14,9,13,52,50,2,51
Elgin,2506,6,14,6,16,53,63,-10,48
Annan Athlet,2506,7,12,11,13,50,41,9,47
Berwick,2506,8,9,10,17,31,59,-28,37
Edinburgh Ci,2506,9,7,9,20,38,63,-25,30
Cowdenbeath,2506,10,4,10,22,23,57,-34,22
Montrose,2507,1,24,7,5,61,35,26,79
Peterhead,2507,2,24,4,8,78,38,40,76
Stirling,2507,3,17,6,13,66,52,14,57
Stenhousem'r,2507,4,15,8,13,56,52,4,53
Clyde,2507,5,14,10,12,52,49,3,52
Elgin,2507,6,14,6,16,54,62,-8,48
Annan Athlet,2507,7,12,11,13,48,41,7,47
Berwick,2507,8,8,11,17,30,59,-29,35
Edinburgh Ci,2507,9,7,9,20,36,61,-25,30
Cowdenbeath,2507,10,4,10,22,23,55,-32,22
Montrose,2508,1,23,8,5,59,34,25,77
Peterhead,2508,2,24,4,8,80,38,42,76
Stenhousem'r,2508,3,16,8,12,58,47,11,56
Stirling,2508,4,16,6,14,61,54,7,54
Clyde,2508,5,15,9,12,55,49,6,54
Elgin,2508,6,14,7,15,53,60,-7,49
Annan Athlet,2508,7,12,11,13,51,43,8,47
Berwick,2508,8,8,10,18,30,62,-32,34
Edinburgh Ci,2508,9,7,9,20,36,63,-27,30
Cowdenbeath,2508,10,4,10,22,25,58,-33,22
Montrose,2509,1,23,8,5,60,35,25,77
Peterhead,2509,2,24,4,8,79,39,40,76
Stirling,2509,3,17,6,13,63,51,12,57
Stenhousem'r,2509,4,15,8,13,55,49,6,53
Clyde,2509,5,14,10,12,52,49,3,52
Elgin,2509,6,14,7,15,54,61,-7,49
Annan Athlet,2509,7,11,11,14,48,43,5,44
Berwick,2509,8,8,11,17,30,59,-29,35
Edinburgh Ci,2509,9,7,9,20,37,62,-25,30
Cowdenbeath,2509,10,5,10,21,25,55,-30,25
Montrose,2510,1,23,8,5,60,35,25,77
Peterhead,2510,2,24,4,8,79,39,40,76
Stirling,2510,3,17,6,13,62,52,10,57
Stenhousem'r,2510,4,15,8,13,56,48,8,53
Clyde,2510,5,14,9,13,51,50,1,51
Elgin,2510,6,14,7,15,54,61,-7,49
Annan Athlet,2510,7,11,11,14,47,44,3,44
Berwick,2510,8,9,10,17,31,58,-27,37
Edinburgh Ci,2510,9,7,9,20,37,62,-25,30
Cowdenbeath,2510,10,5,10,21,26,54,-28,25
Montrose,2511,1,24,7,5,64,35,29,79
Peterhead,2511,2,24,4,8,82,39,43,76
Stirling,2511,3,17,6,13,61,51,10,57
Clyde,2511,4,15,9,12,54,49,5,54
Stenhousem'r,2511,5,15,8,13,55,47,8,53
Elgin,2511,6,14,6,16,54,65,-11,48
Annan Athlet,2511,7,11,11,14,47,43,4,44
Berwick,2511,8,8,10,18,30,61,-31,34
Edinburgh Ci,2511,9,7,9,20,37,65,-28,30
Cowdenbeath,2511,10,5,10,21,25,54,-29,25
Peterhead,2512,1,24,4,8,81,38,43,76
Montrose,2512,2,23,7,6,59,36,23,76
Stirling,2512,3,17,6,13,63,53,10,57
Stenhousem'r,2512,4,15,8,13,57,49,8,53
Clyde,2512,5,14,10,12,51,48,3,52
Elgin,2512,6,15,6,15,55,60,-5,51
Annan Athlet,2512,7,12,11,13,48,41,7,47
Berwick,2512,8,8,11,17,29,58,-29,35
Edinburgh Ci,2512,9,7,9,20,36,64,-28,30
Cowdenbeath,2512,10,4,10,22,23,55,-32,22
Montrose,2513,1,24,7,5,63,35,28,79
Peterhead,2513,2,23,4,9,78,40,38,73
Stirling,2513,3,17,6,13,63,51,12,57
Clyde,2513,4,15,9,12,54,50,4,54
Stenhousem'r,2513,5,15,8,13,55,49,6,53
Elgin,2513,6,14,6,16,54,64,-10,48
Annan Athlet,2513,7,11,12,13,48,42,6,45
Berwick,2513,8,8,10,18,31,61,-30,34
Edinburgh Ci,2513,9,8,9,19,38,61,-23,33
Cowdenbeath,2513,10,4,11,21,24,55,-31,23
Montrose,2514,1,24,7,5,62,36,26,79
Peterhead,2514,2,24,4,8,79,39,40,76
Stirling,2514,3,17,6,13,62,52,10,57
Stenhousem'r,2514,4,15,8,13,56,48,8,53
Clyde,2514,5,14,9,13,53,51,2,51
Elgin,2514,6,14,6,16,55,63,-8,48
Annan Athlet,2514,7,12,11,13,51,41,10,47
Berwick,2514,8,9,10,17,32,60,-28,37
Edinburgh Ci,2514,9,7,9,20,37,62,-25,30
Cowdenbeath,2514,10,4,10,22,23,58,-35,22
Montrose,2515,1,23,8,5,61,36,25,77
Peterhead,2515,2,24,4,8,79,38,41,76
Stirling,2515,3,17,6,13,64,51,13,57
Clyde,2515,4,15,9,12,56,48,8,54
Stenhousem'r,2515,5,15,8,13,55,50,5,53
Elgin,2515,6,14,7,15,55,62,-7,49
Annan Athlet,2515,7,11,12,13,48,42,6,45
Berwick,2515,8,8,10,18,29,63,-34,34
Edinburgh Ci,2515,9,7,9,20,36,62,-26,30
Cowdenbeath,2515,10,4,11,21,24,55,-31,23
Montrose,2516,1,23,8,5,60,35,25,77
Peterhead,2516,2,24,4,8,81,39,42,76
Stirling,2516,3,16,7,13,61,52,9,55
Stenhousem'r,2516,4,15,9,12,56,47,9,54
Clyde,2516,5,15,9,12,53,49,4,54
Elgin,2516,6,14,7,15,54,61,-7,49
Annan Athlet,2516,7,12,11,13,48,41,7,47
Berwick,2516,8,8,10,18,30,60,-30,34
Edinburgh Ci,2516,9,7,9,20,37,64,-27,30
Cowdenbeath,2516,10,4,10,22,23,55,-32,22
Montrose,2517,1,23,7,6,61,37,24,76
Peterhead,2517,2,23,5,8,79,40,39,74
Stirling,2517,3,17,6,13,63,51,12,57
Clyde,2517,4,15,9,12,53,48,5,54
Stenhousem'r,2517,5,15,8,13,55,49,6,53
Elgin,2517,6,15,6,15,56,62,-6,51
Annan Athlet,2517,7,11,12,13,48,42,6,45
Berwick,2517,8,8,10,18,29,60,-31,34
Edinburgh Ci,2517,9,7,10,19,38,62,-24,31
Cowdenbeath,2517,10,4,11,21,24,55,-31,23
Montrose,2518,1,24,7,5,61,35,26,79
Peterhead,2518,2,24,4,8,80,39,41,76
Stenhousem'r,2518,3,16,8,12,57,46,11,56
Stirling,2518,4,16,6,14,60,53,7,54
Clyde,2518,5,14,10,12,52,49,3,52
Elgin,2518,6,14,6,16,54,62,-8,48
Annan Athlet,2518,7,11,12,13,48,42,6,45
Berwick,2518,8,8,11,17,30,59,-29,35
Edinburgh Ci,2518,9,7,9,20,37,63,-26,30
Cowdenbeath,2518,10,4,11,21,24,55,-31,23
Montrose,2519,1,24,7,5,64,36,28,79
Peterhead,2519,2,24,4,8,84,40,44,76
Stirling,2519,3,16,7,13,60,51,9,55
Stenhousem'r,2519,4,15,9,12,55,46,9,54
Clyde,2519,5,14,10,12,51,48,3,52
Elgin,2519,6,14,6,16,55,65,-10,48
Annan Athlet,2519,7,11,11,14,48,43,5,44
Berwick,2519,8,8,11,17,29,58,-29,35
Edinburgh Ci,2519,9,7,9,20,38,67,-29,30
Cowdenbeath,2519,10,5,10,21,25,55,-30,25
Montrose,2520,1,23,8,5,60,35,25,77
Peterhead,2520,2,23,5,8,78,39,39,74
Stirling,2520,3,16,7,13,61,52,9,55
Stenhousem'r,2520,4,15,9,12,56,47,9,54
Clyde,2520,5,15,9,12,52,48,4,54
Elgin,2520,6,14,7,15,54,61,-7,49
Annan Athlet,2520,7,11,11,14,47,42,5,44
Berwick,2520,8,8,10,18,29,59,-30,34
Edinburgh Ci,2520,9,7,10,19,37,61,-24,31
Cowdenbeath,2520,10,5,10,21,24,54,-30,25
Peterhead,2521,1,24,4,8,81,39,42,76
Montrose,2521,2,23,7,6,60,36,24,76
Stirling,2521,3,16,7,13,61,52,9,55
Stenhousem'r,2521,4,15,9,12,56,47,9,54
Clyde,2521,5,15,9,12,56,49,7,54
Elgin,2521,6,15,6,15,55,61,-6,51
Annan Athlet,2521,7,11,12,13,47,41,6,45
Berwick,2521,8,8,10,18,30,63,-33,34
Edinburgh Ci,2521,9,7,9,20,37,64,-27,30
Cowdenbeath,2521,10,4,11,21,23,54,-31,23
Montrose,2522,1,24,7,5,61,34,27,79
Peterhead,2522,2,24,4,8,80,38,42,76
Stirling,2522,3,17,6,13,63,52,11,57
Clyde,2522,4,15,9,12,53,48,5,54
Stenhousem'r,2522,5,15,8,13,56,49,7,53
Elgin,2522,6,14,6,16,53,62,-9,48
Annan Athlet,2522,7,12,11,13,50,42,8,47
Berwick,2522,8,8,10,18,29,60,-31,34
Edinburgh Ci,2522,9,7,9,20,36,63,-27,30
Cowdenbeath,2522,10,4,10,22,24,57,-33,22
Montrose,2523,1,24,7,5,61,34,27,79
Peterhead,2523,2,24,4,8,80,38,42,76
Stenhousem'r,2523,3,16,8,12,58,48,10,56
Stirling,2523,4,16,6,14,62,54,8,54
Clyde,2523,5,15,9,12,54,50,4,54
Elgin,2523,6,14,6,16,53,62,-9,48
Annan Athlet,2523,7,11,12,13,48,42,6,45
Berwick,2523,8,8,10,18,31,61,-30,34
Edinburgh Ci,2523,9,7,9,20,36,63,-27,30
Cowdenbeath,2523,10,4,11,21,24,55,-31,23
Montrose,2524,1,24,7,5,61,35,26,79
Peterhead,2524,2,24,4,8,82,38,44,76
Stirling,2524,3,16,7,13,61,52,9,55
Stenhousem'r,2524,4,15,9,12,56,47,9,54
Clyde,2524,5,15,9,12,54,50,4,54
Elgin,2524,6,14,6,16,54,62,-8,48
Annan Athlet,2524,7,11,11,14,47,44,3,44
Berwick,2524,8,8,10,18,31,61,-30,34
Edinburgh Ci,2524,9,7,9,20,36,65,-29,30
Cowdenbeath,2524,10,5,10,21,26,54,-28,25
Montrose,2525,1,23,8,5,60,35,25,77
Peterhead,2525,2,24,4,8,80,38,42,76
Stirling,2525,3,16,7,13,62,53,9,55
Stenhousem'r,2525,4,15,9,12,57,48,9,54
Clyde,2525,5,15,9,12,54,48,6,54
Elgin,2525,6,14,7,15,54,61,-7,49
Annan Athlet,2525,7,12,11,13,49,42,7,47
Berwick,2525,8,8,10,18,29,61,-32,34
Edinburgh Ci,2525,9,7,9,20,36,63,-27,30
Cowdenbeath,2525,10,4,10,22,24,56,-32,22
Peterhead,2526,1,24,4,8,81,41,40,76
Montrose,2526,2,23,7,6,59,36,23,76
Stirling,2526,3,16,7,13,62,53,9,55
Stenhousem'r,2526,4,15,9,12,57,48,9,54
Clyde,2526,5,14,10,12,52,49,3,52
Elgin,2526,6,15,6,15,55,60,-5,51
Annan Athlet,2526,7,12,11,13,49,41,8,47
Berwick,2526,8,8,11,17,30,59,-29,35
Edinburgh Ci,2526,9,7,9,20,39,64,-25,30
Cowdenbeath,2526,10,4,10,22,23,56,-33,22
Peterhead,2527,1,24,4,8,82,38,44,76
Montrose,2527,2,23,7,6,59,36,23,76
Stirling,2527,3,17,6,13,62,52,10,57
Clyde,2527,4,15,9,12,55,49,6,54
Stenhousem'r,2527,5,15,8,13,56,48,8,53
Elgin,2527,6,15,6,15,55,60,-5,51
Annan Athlet,2527,7,11,12,13,48,42,6,45
Berwick,2527,8,8,10,18,30,62,-32,34
Edinburgh Ci,2527,9,7,9,20,36,65,-29,30
Cowdenbeath,2527,10,4,11,21,24,55,-31,23
Montrose,2528,1,24,7,5,61,35,26,79
Peterhead,2528,2,24,4,8,84,38,46,76
Stenhousem'r,2528,3,16,8,12,58,47,11,56
Stirling,2528,4,16,6,14,61,54,7,54
Clyde,2528,5,15,9,12,53,49,4,54
Elgin,2528,6,14,6,16,54,62,-8,48
Annan Athlet,2528,7,11,11,14,47,42,5,44
Berwick,2528,8,8,10,18,30,60,-30,34
Edinburgh Ci,2528,9,7,9,20,36,67,-31,30
Cowdenbeath,2528,10,5,10,21,24,54,-30,25
Montrose,2529,1,23,8,5,60,35,25,77
Peterhead,2529,2,24,4,8,79,38,41,76
Stirling,2529,3,17,6,13,63,52,11,57
Stenhousem'r,2529,4,15,8,13,56,49,7,53
Clyde,2529,5,14,10,12,53,50,3,52
Elgin,2529,6,14,7,15,54,61,-7,49
Annan Athlet,2529,7,11,12,13,48,42,6,45
Berwick,2529,8,8,11,17,31,60,-29,35
Edinburgh Ci,2529,9,7,9,20,36,62,-26,30
Cowdenbeath,2529,10,4,11,21,24,55,-31,23
Montrose,2530,1,23,8,5,61,36,25,77
Peterhead,2530,2,24,4,8,81,39,42,76
Stirling,2530,3,17,6,13,65,52,13,57
Stenhousem'r,2530,4,15,8,13,56,51,5,53
Clyde,2530,5,14,10,12,53,50,3,52
Elgin,2530,6,14,7,15,55,62,-7,49
Annan Athlet,2530,7,12,11,13,48,41,7,47
Berwick,2530,8,8,11,17,31,60,-29,35
Edinburgh Ci,2530,9,7,9,20,37,64,-27,30
Cowdenbeath,2530,10,4,10,22,23,55,-32,22
Montrose,2531,1,24,7,5,62,35,27,79
Peterhead,2531,2,24,4,8,78,38,40,76
Stenhousem'r,2531,3,16,8,12,60,47,13,56
Stirling,2531,4,16,6,14,61,56,5,54
Clyde,2531,5,14,10,12,52,49,3,52
Elgin,2531,6,14,6,16,54,63,-9,48
Annan Athlet,2531,7,11,12,13,48,42,6,45
Berwick,2531,8,8,11,17,30,59,-29,35
Edinburgh Ci,2531,9,7,9,20,36,61,-25,30
Cowdenbeath,2531,10,4,11,21,24,55,-31,23
Montrose,2532,1,23,8,5,60,35,25,77
Peterhead,2532,2,24,4,8,80,40,40,76
Stirling,2532,3,17,6,13,63,52,11,57
Stenhousem'r,2532,4,15,8,13,56,49,7,53
Clyde,2532,5,14,9,13,51,49,2,51
Elgin,2532,6,14,7,15,54,61,-7,49
Annan Athlet,2532,7,11,12,13,49,43,6,45
Berwick,2532,8,9,10,17,30,58,-28,37
Edinburgh Ci,2532,9,7,9,20,38,63,-25,30
Cowdenbeath,2532,10,4,11,21,25,56,-31,23
Montrose,2533,1,24,7,5,62,35,27,79
Peterhead,2533,2,23,4,9,77,40,37,73
Stirling,2533,3,17,6,13,62,52,10,57
Clyde,2533,4,15,9,12,53,49,4,54
Stenhousem'r,2533,5,15,8,13,56,48,8,53
Elgin,2533,6,14,6,16,54,63,-9,48
Annan Athlet,2533,7,11,12,13,47,41,6,45
Berwick,2533,8,8,10,18,30,60,-30,34
Edinburgh Ci,2533,9,8,9,19,38,60,-22,33
Cowdenbeath,2533,10,4,11,21,23,54,-31,23
Peterhead,2534,1,24,4,8,80,39,41,76
Montrose,2534,2,23,7,6,60,37,23,76
Stirling,2534,3,16,7,13,60,51,9,55
Stenhousem'r,2534,4,15,9,12,55,46,9,54
Clyde,2534,5,14,10,12,51,48,3,52
Elgin,2534,6,15,6,15,56,61,-5,51
Annan Athlet,2534,7,11,11,14,48,43,5,44
Berwick,2534,8,8,11,17,29,58,-29,35
Edinburgh Ci,2534,9,7,9,20,37,63,-26,30
Cowdenbeath,2534,10,5,10,21,25,55,-30,25
Montrose,2535,1,24,7,5,61,35,26,79
Peterhead,2535,2,24,4,8,80,38,42,76
Stirling,2535,3,16,7,13,61,52,9,55
Stenhousem'r,2535,4,15,9,12,56,47,9,54
Clyde,2535,5,14,9,13,51,51,0,51
Elgin,2535,6,14,6,16,54,62,-8,48
Annan Athlet,2535,7,11,11,14,47,44,3,44
Berwick,2535,8,9,10,17,32,58,-26,37
Edinburgh Ci,2535,9,7,9,20,36,63,-27,30
Cowdenbeath,2535,10,5,10,21,26,54,-28,25
Montrose,2536,1,23,8,5,61,36,25,77
Peterhead,2536,2,23,4,9,78,40,38,73
Stirling,2536,3,17,6,13,63,52,11,57
Clyde,2536,4,15,9,12,53,49,4,54
Stenhousem'r,2536,5,15,8,13,56,49,7,53
Elgin,2536,6,14,7,15,55,62,-7,49
Annan Athlet,2536,7,11,11,14,47,42,5,44
Berwick,2536,8,8,10,18,30,60,-30,34
Edinburgh Ci,2536,9,8,9,19,38,61,-23,33
Cowdenbeath,2536,10,5,10,21,24,54,-30,25
Montrose,2537,1,24,7,5,60,34,26,79
Peterhead,2537,2,23,4,9,77,39,38,73
Stirling,2537,3,17,6,13,63,52,11,57
Stenhousem'r,2537,4,15,8,13,56,49,7,53
Clyde,2537,5,14,10,12,52,49,3,52
Elgin,2537,6,14,6,16,53,61,-8,48
Annan Athlet,2537,7,11,11,14,48,43,5,44
Berwick,2537,8,8,11,17,30,59,-29,35
Edinburgh Ci,2537,9,8,9,19,37,60,-23,33
Cowdenbeath,2537,10,5,10,21,25,55,-30,25
Montrose,2538,1,24,7,5,64,35,29,79
Peterhead,2538,2,24,4,8,79,38,41,76
Stirling,2538,3,17,6,13,63,52,11,57
Clyde,2538,4,15,9,12,53,49,4,54
Stenhousem'r,2538,5,15,8,13,56,49,7,53
Elgin,2538,6,14,6,16,54,65,-11,48
Annan Athlet,2538,7,11,11,14,47,43,4,44
Berwick,2538,8,8,10,18,30,60,-30,34
Edinburgh Ci,2538,9,7,9,20,36,62,-26,30
Cowdenbeath,2538,10,5,10,21,25,54,-29,25
Montrose,2539,1,23,8,5,60,35,25,77
Peterhead,2539,2,23,4,9,78,41,37,73
Stenhousem'r,2539,3,16,8,12,56,46,10,56
Stirling,2539,4,16,6,14,60,52,8,54
Clyde,2539,5,14,10,12,52,49,3,52
Elgin,2539,6,14,7,15,54,61,-7,49
Annan Athlet,2539,7,11,11,14,48,43,5,44
Berwick,2539,8,8,11,17,30,59,-29,35
Edinburgh Ci,2539,9,8,9,19,39,61,-22,33
Cowdenbeath,2539,10,5,10,21,25,55,-30,25
Montrose,2540,1,23,8,5,59,34,25,77
Peterhead,2540,2,24,4,8,81,38,43,76
Stirling,2540,3,16,7,13,61,52,9,55
Stenhousem'r,2540,4,15,9,12,56,47,9,54
Clyde,2540,5,15,9,12,53,48,5,54
Elgin,2540,6,14,7,15,53,60,-7,49
Annan Athlet,2540,7,12,11,13,51,43,8,47
Berwick,2540,8,8,10,18,29,60,-31,34
Edinburgh Ci,2540,9,7,9,20,36,64,-28,30
Cowdenbeath,2540,10,4,10,22,25,58,-33,22
Montrose,2541,1,24,7,5,62,34,28,79
Peterhead,2541,2,24,4,8,81,39,42,76
Stirling,2541,3,17,6,13,62,52,10,57
Clyde,2541,4,15,9,12,54,49,5,54
Stenhousem'r,2541,5,15,8,13,56,48,8,53
Elgin,2541,6,14,6,16,53,63,-10,48
Annan Athlet,2541,7,11,12,13,48,42,6,45
Berwick,2541,8,8,10,18,30,61,-31,34
Edinburgh Ci,2541,9,7,9,20,37,64,-27,30
Cowdenbeath,2541,10,4,11,21,24,55,-31,23
Montrose,2542,1,24,7,5,62,36,26,79
Peterhead,2542,2,23,4,9,78,40,38,73
Stirling,2542,3,16,7,13,62,53,9,55
Stenhousem'r,2542,4,15,9,12,57,48,9,54
Clyde,2542,5,14,9,13,53,51,2,51
Elgin,2542,6,14,6,16,55,63,-8,48
Annan Athlet,2542,7,12,11,13,51,41,10,47
Berwick,2542,8,9,10,17,32,60,-28,37
Edinburgh Ci,2542,9,8,9,19,38,61,-23,33
Cowdenbeath,2542,10,4,10,22,23,58,-35,22
Peterhead,2543,1,24,4,8,79,39,40,76
Montrose,2543,2,23,7,6,59,35,24,76
Stirling,2543,3,17,6,13,62,52,10,57
Clyde,2543,4,15,9,12,53,49,4,54
Stenhousem'r,2543,5,15,8,13,56,48,8,53
Elgin,2543,6,15,6,15,54,60,-6,51
Annan Athlet,2543,7,12,11,13,49,41,8,47
Berwick,2543,8,8,10,18,30,60,-30,34
Edinburgh Ci,2543,9,7,9,20,37,62,-25,30
Cowdenbeath,2543,10,4,10,22,23,56,-33,22
Montrose,2544,1,24,7,5,64,35,29,79
Peterhead,2544,2,24,4,8,82,39,43,76
Stenhousem'r,2544,3,16,8,12,59,47,12,56
Stirling,2544,4,16,6,14,61,55,6,54
Clyde,2544,5,15,9,12,53,49,4,54
Elgin,2544,6,14,6,16,54,65,-11,48
Annan Athlet,2544,7,12,11,13,51,42,9,47
Berwick,2544,8,8,10,18,30,60,-30,34
Edinburgh Ci,2544,9,7,9,20,37,65,-28,30
Cowdenbeath,2544,10,4,10,22,24,58,-34,22
Peterhead,2545,1,24,4,8,82,41,41,76
Montrose,2545,2,23,7,6,59,35,24,76
Stirling,2545,3,16,7,13,62,53,9,55
Stenhousem'r,2545,4,15,9,12,57,48,9,54
Clyde,2545,5,14,9,13,51,50,1,51
Elgin,2545,6,15,6,15,54,60,-6,51
Annan Athlet,2545,7,11,12,13,49,43,6,45
Berwick,2545,8,9,10,17,31,58,-27,37
Edinburgh Ci,2545,9,7,9,20,39,65,-26,30
Cowdenbeath,2545,10,4,11,21,25,56,-31,23
Montrose,2546,1,24,7,5,62,34,28,79
Peterhead,2546,2,24,4,8,80,38,42,76
Stirling,2546,3,17,6,13,62,51,11,57
Stenhousem'r,2546,4,15,8,13,55,48,7,53
Clyde,2546,5,14,10,12,52,49,3,52
Elgin,2546,6,14,6,16,53,63,-10,48
Annan Athlet,2546,7,11,11,14,47,42,5,44
Berwick,2546,8,8,11,17,30,59,-29,35
Edinburgh Ci,2546,9,7,9,20,36,63,-27,30
Cowdenbeath,2546,10,5,10,21,24,54,-30,25
Peterhead,2547,1,24,4,8,78,38,40,76
Montrose,2547,2,23,7,6,61,37,24,76
Stenhousem'r,2547,3,16,8,12,56,46,10,56
Stirling,2547,4,16,6,14,60,52,8,54
Clyde,2547,5,14,9,13,51,50,1,51
Elgin,2547,6,15,6,15,56,62,-6,51
Annan Athlet,2547,7,12,11,13,49,42,7,47
Berwick,2547,8,9,10,17,31,58,-27,37
Edinburgh Ci,2547,9,7,9,20,36,61,-25,30
Cowdenbeath,2547,10,4,10,22,24,56,-32,22
Peterhead,2548,1,24,4,8,78,38,40,76
Montrose,2548,2,23,7,6,59,35,24,76
Stirling,2548,3,17,6,13,62,52,10,57
Clyde,2548,4,15,9,12,54,48,6,54
Stenhousem'r,2548,5,15,8,13,56,48,8,53
Elgin,2548,6,15,6,15,54,60,-6,51
Annan Athlet,2548,7,12,11,13,49,41,8,47
Berwick,2548,8,8,10,18,29,61,-32,34
Edinburgh Ci,2548,9,7,9,20,36,61,-25,30
Cowdenbeath,2548,10,4,10,22,23,56,-33,22
Montrose,2549,1,23,8,5,59,34,25,77
Peterhead,2549,2,24,4,8,80,40,40,76
Stirling,2549,3,17,6,13,62,52,10,57
Stenhousem'r,2549,4,15,8,13,56,48,8,53
Clyde,2549,5,14,9,13,52,51,1,51
Elgin,2549,6,14,7,15,53,60,-7,49
Annan Athlet,2549,7,11,11,14,47,42,5,44
Berwick,2549,8,9,10,17,32,59,-27,37
Edinburgh Ci,2549,9,7,9,20,38,63,-25,30
Cowdenbeath,2549,10,5,10,21,24,54,-30,25
Montrose,2550,1,24,7,5,60,34,26,79
Peterhead,2550,2,24,4,8,79,38,41,76
Stirling,2550,3,17,6,13,65,51,14,57
Clyde,2550,4,15,9,12,54,48,6,54
Stenhousem'r,2550,5,15,8,13,55,51,4,53
Elgin,2550,6,14,6,16,53,61,-8,48
Annan Athlet,2550,7,12,11,13,49,41,8,47
Berwick,2550,8,8,10,18,29,61,-32,34
Edinburgh Ci,2550,9,7,9,20,36,62,-26,30
Cowdenbeath,2550,10,4,10,22,23,56,-33,22
Montrose,2551,1,24,7,5,61,34,27,79
Peterhead,2551,2,24,4,8,78,38,40,76
Stirling,2551,3,16,7,13,63,54,9,55
Stenhousem'r,2551,4,15,9,12,58,49,9,54
Clyde,2551,5,14,9,13,52,50,2,51
Elgin,2551,6,14,6,16,53,62,-9,48
Annan Athlet,2551,7,12,11,13,50,42,8,47
Berwick,2551,8,9,10,17,31,59,-28,37
Edinburgh Ci,2551,9,7,9,20,36,61,-25,30
Cowdenbeath,2551,10,4,10,22,24,57,-33,22
Montrose,2552,1,24,7,5,63,34,29,79
Peterhead,2552,2,23,5,8,78,39,39,74
Stirling,2552,3,16,7,13,62,53,9,55
Stenhousem'r,2552,4,15,9,12,57,48,9,54
Clyde,2552,5,15,9,12,54,49,5,54
Elgin,2552,6,14,6,16,53,64,-11,48
Annan Athlet,2552,7,11,11,14,47,42,5,44
Berwick,2552,8,8,10,18,30,61,-31,34
Edinburgh Ci,2552,9,7,10,19,37,61,-24,31
Cowdenbeath,2552,10,5,10,21,24,54,-30,25
Montrose,2553,1,23,7,6,59,38,21,76
Peterhead,2553,2,23,5,8,77,38,39,74
Stirling,2553,3,17,6,13,63,51,12,57
Clyde,2553,4,15,9,12,52,48,4,54
Stenhousem'r,2553,5,15,8,13,55,49,6,53
Elgin,2553,6,15,6,15,57,60,-3,51
Annan Athlet,2553,7,12,11,13,49,41,8,47
Berwick,2553,8,8,10,18,29,59,-30,34
Edinburgh Ci,2553,9,7,10,19,36,60,-24,31
Cowdenbeath,2553,10,4,10,22,23,56,-33,22
Montrose,2554,1,23,8,5,61,36,25,77
Peterhead,2554,2,24,4,8,79,38,41,76
Stenhousem'r,2554,3,16,8,12,56,46,10,56
Stirling,2554,4,16,6,14,60,52,8,54
Clyde,2554,5,14,9,13,52,50,2,51
Elgin,2554,6,14,7,15,55,62,-7,49
Annan Athlet,2554,7,12,11,13,50,42,8,47
Berwick,2554,8,9,10,17,31,59,-28,37
Edinburgh Ci,2554,9,7,9,20,36,62,-26,30
Cowdenbeath,2554,10,4,10,22,24,57,-33,22
Peterhead,2555,1,24,4,8,80,38,42,76
Montrose,2555,2,23,7,6,59,37,22,76
Stirling,2555,3,17,6,13,62,52,10,57
Clyde,2555,4,15,9,12,53,48,5,54
Stenhousem'r,2555,5,15,8,13,56,48,8,53
Elgin,2555,6,15,6,15,56,60,-4,51
Annan Athlet,2555,7,11,12,13,49,43,6,45
Berwick,2555,8,8,10,18,29,60,-31,34
Edinburgh Ci,2555,9,7,9,20,36,63,-27,30
Cowdenbeath,2555,10,4,11,21,25,56,-31,23
Peterhead,2556,1,24,4,8,80,39,41,76
Montrose,2556,2,23,7,6,60,38,22,76
Stirling,2556,3,16,7,13,62,53,9,55
Stenhousem'r,2556,4,15,9,12,57,48,9,54
Clyde,2556,5,15,9,12,55,49,6,54
Elgin,2556,6,15,6,15,57,61,-4,51
Annan Athlet,2556,7,11,12,13,47,41,6,45
Berwick,2556,8,8,10,18,30,62,-32,34
Edinburgh Ci,2556,9,7,9,20,37,63,-26,30
Cowdenbeath,2556,10,4,11,21,23,54,-31,23
Peterhead,2557,1,24,4,8,79,38,41,76
Montrose,2557,2,23,7,6,60,36,24,76
Stirling,2557,3,17,6,13,61,51,10,57
Clyde,2557,4,15,9,12,53,48,5,54
Stenhousem'r,2557,5,15,8,13,55,47,8,53
Elgin,2557,6,15,6,15,55,61,-6,51
Annan Athlet,2557,7,11,12,13,48,42,6,45
Berwick,2557,8,8,10,18,29,60,-31,34
Edinburgh Ci,2557,9,7,9,20,36,62,-26,30
Cowdenbeath,2557,10,4,11,21,24,55,-31,23
Montrose,2558,1,23,8,5,61,36,25,77
Peterhead,2558,2,24,4,8,83,40,43,76
Stirling,2558,3,17,6,13,63,51,12,57
Clyde,2558,4,15,9,12,54,50,4,54
Stenhousem'r,2558,5,15,8,13,55,49,6,53
Elgin,2558,6,14,7,15,55,62,-7,49
Annan Athlet,2558,7,11,11,14,48,43,5,44
Berwick,2558,8,8,10,18,31,61,-30,34
Edinburgh Ci,2558,9,7,9,20,38,66,-28,30
Cowdenbeath,2558,10,5,10,21,25,55,-30,25
Montrose,2559,1,23,8,5,60,35,25,77
Peterhead,2559,2,24,4,8,79,38,41,76
Stirling,2559,3,16,7,13,63,54,9,55
Stenhousem'r,2559,4,15,9,12,58,49,9,54
Clyde,2559,5,14,9,13,52,50,2,51
Elgin,2559,6,14,7,15,54,61,-7,49
Annan Athlet,2559,7,11,11,14,47,42,5,44
Berwick,2559,8,9,10,17,31,59,-28,37
Edinburgh Ci,2559,9,7,9,20,36,62,-26,30
Cowdenbeath,2559,10,5,10,21,24,54,-30,25
Montrose,2560,1,23,8,5,62,37,25,77
Peterhead,2560,2,24,4,8,79,39,40,76
Stirling,2560,3,17,6,13,61,51,10,57
Stenhousem'r,2560,4,15,8,13,55,47,8,53
Clyde,2560,5,14,10,12,53,50,3,52
Elgin,2560,6,14,7,15,56,63,-7,49
Annan Athlet,2560,7,12,11,13,50,41,9,47
Berwick,2560,8,8,11,17,31,60,-29,35
Edinburgh Ci,2560,9,7,9,20,37,62,-25,30
Cowdenbeath,2560,10,4,10,22,23,57,-34,22
Montrose,2561,1,24,7,5,64,36,28,79
Peterhead,2561,2,24,4,8,79,38,41,76
Stenhousem'r,2561,3,16,8,12,57,46,11,56
Stirling,2561,4,16,6,14,60,53,7,54
Clyde,2561,5,15,9,12,52,48,4,54
Elgin,2561,6,14,6,16,55,65,-10,48
Annan Athlet,2561,7,11,12,13,48,42,6,45
Berwick,2561,8,8,10,18,29,59,-30,34
Edinburgh Ci,2561,9,7,9,20,36,62,-26,30
Cowdenbeath,2561,10,4,11,21,24,55,-31,23
Peterhead,2562,1,24,4,8,81,38,43,76
Montrose,2562,2,23,7,6,59,35,24,76
Stirling,2562,3,17,6,13,63,52,11,57
Stenhousem'r,2562,4,15,8,13,56,49,7,53
Clyde,2562,5,14,9,13,52,50,2,51
Elgin,2562,6,15,6,15,54,60,-6,51
Annan Athlet,2562,7,11,12,13,49,43,6,45
Berwick,2562,8,9,10,17,31,59,-28,37
Edinburgh Ci,2562,9,7,9,20,36,64,-28,30
Cowdenbeath,2562,10,4,11,21,25,56,-31,23
Montrose,2563,1,24,7,5,61,35,26,79
Peterhead,2563,2,23,4,9,78,40,38,73
Stenhousem'r,2563,3,16,8,12,56,46,10,56
Stirling,2563,4,16,6,14,60,52,8,54
Clyde,2563,5,14,10,12,51,48,3,52
Elgin,2563,6,14,6,16,54,62,-8,48
Annan Athlet,2563,7,11,11,14,47,44,3,44
Berwick,2563,8,8,11,17,29,58,-29,35
Edinburgh Ci,2563,9,8,9,19,38,61,-23,33
Cowdenbeath,2563,10,5,10,21,26,54,-28,25
Montrose,2564,1,24,7,5,61,35,26,79
Peterhead,2564,2,24,4,8,80,38,42,76
Stirling,2564,3,17,6,13,62,52,10,57
Clyde,2564,4,15,9,12,53,49,4,54
Stenhousem'r,2564,5,15,8,13,56,48,8,53
Elgin,2564,6,14,6,16,54,62,-8,48
Annan Athlet,2564,7,12,11,13,49,41,8,47
Berwick,2564,8,8,10,18,30,60,-30,34
Edinburgh Ci,2564,9,7,9,20,36,63,-27,30
Cowdenbeath,2564,10,4,10,22,23,56,-33,22
Montrose,2565,1,24,7,5,60,34,26,79
Peterhead,2565,2,24,4,8,79,39,40,76
Stirling,2565,3,17,6,13,62,51,11,57
Clyde,2565,4,15,9,12,55,48,7,54
Stenhousem'r,2565,5,15,8,13,55,48,7,53
Elgin,2565,6,14,6,16,53,61,-8,48
Annan Athlet,2565,7,11,11,14,48,43,5,44
Berwick,2565,8,8,10,18,29,62,-33,34
Edinburgh Ci,2565,9,7,9,20,37,62,-25,30
Cowdenbeath,2565,10,5,10,21,25,55,-30,25
Montrose,2566,1,23,8,5,59,34,25,77
Peterhead,2566,2,24,4,8,82,40,42,76
Stirling,2566,3,17,6,13,63,53,10,57
Stenhousem'r,2566,4,15,8,13,57,49,8,53
Clyde,2566,5,14,10,12,51,48,3,52
Elgin,2566,6,14,7,15,53,60,-7,49
Annan Athlet,2566,7,11,11,14,48,43,5,44
Berwick,2566,8,8,11,17,29,58,-29,35
Edinburgh Ci,2566,9,7,9,20,38,65,-27,30
Cowdenbeath,2566,10,5,10,21,25,55,-30,25
Montrose,2567,1,24,7,5,62,34,28,79
Peterhead,2567,2,24,4,8,83,39,44,76
Stirling,2567,3,17,6,13,64,52,12,57
Clyde,2567,4,15,9,12,54,48,6,54
Stenhousem'r,2567,5,15,8,13,56,50,6,53
Elgin,2567,6,14,6,16,53,63,-10,48
Annan Athlet,2567,7,12,11,13,50,42,8,47
Berwick,2567,8,8,10,18,29,61,-32,34
Edinburgh Ci,2567,9,7,9,20,37,66,-29,30
Cowdenbeath,2567,10,4,10,22,24,57,-33,22
Montrose,2568,1,23,8,5,60,35,25,77
Peterhead,2568,2,24,4,8,81,39,42,76
Stirling,2568,3,17,6,13,62,52,10,57
Clyde,2568,4,15,9,12,52,48,4,54
Stenhousem'r,2568,5,15,8,13,56,48,8,53
Elgin,2568,6,14,7,15,54,61,-7,49
Annan Athlet,2568,7,12,11,13,48,41,7,47
Berwick,2568,8,8,10,18,29,59,-30,34
Edinburgh Ci,2568,9,7,9,20,37,64,-27,30
Cowdenbeath,2568,10,4,10,22,23,55,-32,22
Montrose,2569,1,23,8,5,60,35,25,77
Peterhead,2569,2,24,4,8,80,38,42,76
Stirling,2569,3,17,6,13,64,52,12,57
Clyde,2569,4,15,9,12,54,49,5,54
Stenhousem'r,2569,5,15,8,13,56,50,6,53
Elgin,2569,6,14,7,15,54,61,-7,49
Annan Athlet,2569,7,12,11,13,50,42,8,47
Berwick,2569,8,8,10,18,30,61,-31,34
Edinburgh Ci,2569,9,7,9,20,36,63,-27,30
Cowdenbeath,2569,10,4,10,22,24,57,-33,22
Montrose,2570,1,24,7,5,64,36,28,79
Peterhead,2570,2,24,4,8,78,38,40,76
Stirling,2570,3,17,6,13,63,51,12,57
Stenhousem'r,2570,4,15,8,13,55,49,6,53
Clyde,2570,5,14,10,12,51,48,3,52
Elgin,2570,6,14,6,16,55,65,-10,48
Annan Athlet,2570,7,11,11,14,49,44,5,44
Berwick,2570,8,8,11,17,29,58,-29,35
Edinburgh Ci,2570,9,7,9,20,36,61,-25,30
Cowdenbeath,2570,10,5,10,21,26,56,-30,25
Montrose,2571,1,23,8,5,60,35,25,77
Peterhead,2571,2,24,4,8,82,39,43,76
Stirling,2571,3,17,6,13,64,51,13,57
Clyde,2571,4,15,9,12,53,48,5,54
Stenhousem'r,2571,5,15,8,13,55,50,5,53
Elgin,2571,6,14,7,15,54,61,-7,49
Annan Athlet,2571,7,11,11,14,47,42,5,44
Berwick,2571,8,8,10,18,29,60,-31,34
Edinburgh Ci,2571,9,7,9,20,37,65,-28,30
Cowdenbeath,2571,10,5,10,21,24,54,-30,25
Montrose,2572,1,24,7,5,63,35,28,79
Peterhead,2572,2,24,4,8,80,40,40,76
Stenhousem'r,2572,3,16,8,12,58,48,10,56
Stirling,2572,4,16,6,14,62,54,8,54
Clyde,2572,5,15,9,12,54,49,5,54
Elgin,2572,6,14,6,16,54,64,-10,48
Annan Athlet,2572,7,11,12,13,47,41,6,45
Berwick,2572,8,8,10,18,30,61,-31,34
Edinburgh Ci,2572,9,7,9,20,38,63,-25,30
Cowdenbeath,2572,10,4,11,21,23,54,-31,23
Montrose,2573,1,24,7,5,62,34,28,79
Peterhead,2573,2,24,4,8,78,38,40,76
Stirling,2573,3,17,6,13,63,53,10,57
Clyde,2573,4,15,9,12,53,49,4,54
Stenhousem'r,2573,5,15,8,13,57,49,8,53
Elgin,2573,6,14,6,16,53,63,-10,48
Annan Athlet,2573,7,11,12,13,47,41,6,45
Berwick,2573,8,8,10,18,30,60,-30,34
Edinburgh Ci,2573,9,7,9,20,36,61,-25,30
Cowdenbeath,2573,10,4,11,21,23,54,-31,23
Montrose,2574,1,24,7,5,61,35,26,79
Peterhead,2574,2,24,4,8,79,39,40,76
Stirling,2574,3,17,6,13,61,51,10,57
Stenhousem'r,2574,4,15,8,13,55,47,8,53
Clyde,2574,5,14,9,13,52,50,2,51
Elgin,2574,6,14,6,16,54,62,-8,48
Annan Athlet,2574,7,11,11,14,48,43,5,44
Berwick,2574,8,9,10,17,31,59,-28,37
Edinburgh Ci,2574,9,7,9,20,37,62,-25,30
Cowdenbeath,2574,10,5,10,21,25,55,-30,25
Montrose,2575,1,23,8,5,61,36,25,77
Peterhead,2575,2,24,4,8,78,38,40,76
Stenhousem'r,2575,3,16,8,12,56,46,10,56
Stirling,2575,4,16,6,14,60,52,8,54
Clyde,2575,5,15,9,12,52,48,4,54
Elgin,2575,6,14,7,15,55,62,-7,49
Annan Athlet,2575,7,11,11,14,49,44,5,44
Berwick,2575,8,8,10,18,29,59,-30,34
Edinburgh Ci,2575,9,7,9,20,36,61,-25,30
Cowdenbeath,2575,10,5,10,21,26,56,-30,25
Montrose,2576,1,23,8,5,60,35,25,77
Peterhead,2576,2,24,4,8,81,39,42,76
Stenhousem'r,2576,3,16,8,12,56,46,10,56
Stirling,2576,4,16,6,14,60,52,8,54
Clyde,2576,5,15,9,12,52,48,4,54
Elgin,2576,6,14,7,15,54,61,-7,49
Annan Athlet,2576,7,11,12,13,48,42,6,45
Berwick,2576,8,8,10,18,29,59,-30,34
Edinburgh Ci,2576,9,7,9,20,37,64,-27,30
Cowdenbeath,2576,10,4,11,21,24,55,-31,23
Montrose,2577,1,23,8,5,60,35,25,77
Peterhead,2577,2,24,4,8,80,39,41,76
Stenhousem'r,2577,3,16,8,12,56,46,10,56
Stirling,2577,4,16,6,14,60,52,8,54
Clyde,2577,5,14,9,13,51,49,2,51
Elgin,2577,6,14,7,15,54,61,-7,49
Annan Athlet,2577,7,12,11,13,49,42,7,47
Berwick,2577,8,9,10,17,30,58,-28,37
Edinburgh Ci,2577,9,7,9,20,37,63,-26,30
Cowdenbeath,2577,10,4,10,22,24,56,-32,22
Montrose,2578,1,24,7,5,61,35,26,79
Peterhead,2578,2,24,4,8,80,40,40,76
Stenhousem'r,2578,3,16,8,12,58,48,10,56
Stirling,2578,4,16,6,14,62,54,8,54
Clyde,2578,5,15,9,12,56,49,7,54
Elgin,2578,6,14,6,16,54,62,-8,48
Annan Athlet,2578,7,12,11,13,49,42,7,47
Berwick,2578,8,8,10,18,30,63,-33,34
Edinburgh Ci,2578,9,7,9,20,38,63,-25,30
Cowdenbeath,2578,10,4,10,22,24,56,-32,22
Montrose,2579,1,24,7,5,60,34,26,79
Peterhead,2579,2,24,4,8,78,38,40,76
Stirling,2579,3,17,6,13,64,53,11,57
Clyde,2579,4,15,9,12,54,50,4,54
Stenhousem'r,2579,5,15,8,13,57,50,7,53
Elgin,2579,6,14,6,16,53,61,-8,48
Annan Athlet,2579,7,11,12,13,48,42,6,45
Berwick,2579,8,8,10,18,31,61,-30,34
Edinburgh Ci,2579,9,7,9,20,36,61,-25,30
Cowdenbeath,2579,10,4,11,21,24,55,-31,23
Montrose,2580,1,24,7,5,63,34,29,79
Peterhead,2580,2,24,4,8,81,39,42,76
Stirling,2580,3,17,6,13,62,51,11,57
Stenhousem'r,2580,4,15,8,13,55,48,7,53
Clyde,2580,5,14,9,13,52,50,2,51
Elgin,2580,6,14,6,16,53,64,-11,48
Annan Athlet,2580,7,11,11,14,47,42,5,44
Berwick,2580,8,9,10,17,31,59,-28,37
Edinburgh Ci,2580,9,7,9,20,37,64,-27,30
Cowdenbeath,2580,10,5,10,21,24,54,-30,25
Montrose,2581,1,23,8,5,60,35,25,77
Peterhead,2581,2,23,4,9,77,39,38,73
Stirling,2581,3,17,6,13,62,51,11,57
Stenhousem'r,2581,4,15,8,13,55,48,7,53
Clyde,2581,5,14,9,13,52,50,2,51
Elgin,2581,6,14,7,15,54,61,-7,49
Annan Athlet,2581,7,12,11,13,50,42,8,47
Berwick,2581,8,9,10,17,31,59,-28,37
Edinburgh Ci,2581,9,8,9,19,37,60,-23,33
Cowdenbeath,2581,10,4,10,22,24,57,-33,22
Montrose,2582,1,24,7,5,61,34,27,79
Peterhead,2582,2,24,4,8,80,40,40,76
Stirling,2582,3,17,6,13,64,52,12,57
Stenhousem'r,2582,4,15,8,13,56,50,6,53
Clyde,2582,5,14,9,13,51,51,0,51
Elgin,2582,6,14,6,16,53,62,-9,48
Annan Athlet,2582,7,11,11,14,47,46,1,44
Berwick,2582,8,9,10,17,32,58,-26,37
Edinburgh Ci,2582,9,7,9,20,38,63,-25,30
Cowdenbeath,2582,10,5,10,21,28,54,-26,25
Montrose,2583,1,24,7,5,60,34,26,79
Peterhead,2583,2,24,4,8,79,39,40,76
Stenhousem'r,2583,3,16,8,12,58,47,11,56
Stirling,2583,4,16,6,14,61,54,7,54
Clyde,2583,5,15,9,12,53,49,4,54
Elgin,2583,6,14,6,16,53,61,-8,48
Annan Athlet,2583,7,11,12,13,47,41,6,45
Berwick,2583,8,8,10,18,30,60,-30,34
Edinburgh Ci,2583,9,7,9,20,37,62,-25,30
Cowdenbeath,2583,10,4,11,21,23,54,-31,23
Peterhead,2584,1,24,4,8,84,39,45,76
Montrose,2584,2,23,7,6,59,35,24,76
Stirling,2584,3,17,6,13,63,52,11,57
Clyde,2584,4,15,9,12,54,50,4,54
Stenhousem'r,2584,5,15,8,13,56,49,7,53
Elgin,2584,6,15,6,15,54,60,-6,51
Annan Athlet,2584,7,11,12,13,47,41,6,45
Berwick,2584,8,8,10,18,31,61,-30,34
Edinburgh Ci,2584,9,7,9,20,37,67,-30,30
Cowdenbeath,2584,10,4,11,21,23,54,-31,23
Montrose,2585,1,23,8,5,59,34,25,77
Peterhead,2585,2,23,4,9,77,40,37,73
Stenhousem'r,2585,3,16,8,12,58,46,12,56
Stirling,2585,4,16,6,14,60,54,6,54
Clyde,2585,5,15,9,12,54,50,4,54
Elgin,2585,6,14,7,15,53,60,-7,49
Annan Athlet,2585,7,11,11,14,47,43,4,44
Berwick,2585,8,8,10,18,31,61,-30,34
Edinburgh Ci,2585,9,8,9,19,38,60,-22,33
Cowdenbeath,2585,10,5,10,21,25,54,-29,25
Montrose,2586,1,24,7,5,61,34,27,79
Peterhead,2586,2,24,4,8,79,39,40,76
Stirling,2586,3,17,6,13,62,52,10,57
Stenhousem'r,2586,4,15,8,13,56,48,8,53
Clyde,2586,5,14,9,13,52,52,0,51
Elgin,2586,6,14,6,16,53,62,-9,48
Annan Athlet,2586,7,11,11,14,47,42,5,44
Berwick,2586,8,9,10,17,33,59,-26,37
Edinburgh Ci,2586,9,7,9,20,37,62,-25,30
Cowdenbeath,2586,10,5,10,21,24,54,-30,25
Montrose,2587,1,24,7,5,60,34,26,79
Peterhead,2587,2,24,4,8,78,38,40,76
Stirling,2587,3,16,7,13,60,51,9,55
Stenhousem'r,2587,4,15,9,12,55,46,9,54
Clyde,2587,5,15,9,12,54,49,5,54
Elgin,2587,6,14,6,16,53,61,-8,48
Annan Athlet,2587,7,11,12,13,49,43,6,45
Berwick,2587,8,8,10,18,30,61,-31,34
Edinburgh Ci,2587,9,7,9,20,36,61,-25,30
Cowdenbeath,2587,10,4,11,21,25,56,-31,23
Montrose,2588,1,23,8,5,60,35,25,77
Peterhead,2588,2,24,4,8,79,38,41,76
Stenhousem'r,2588,3,16,8,12,57,47,10,56
Stirling,2588,4,16,6,14,61,53,8,54
Clyde,2588,5,14,10,12,52,49,3,52
Elgin,2588,6,14,7,15,54,61,-7,49
Annan Athlet,2588,7,12,11,13,48,41,7,47
Berwick,2588,8,8,11,17,30,59,-29,35
Edinburgh Ci,2588,9,7,9,20,36,62,-26,30
Cowdenbeath,2588,10,4,10,22,23,55,-32,22
Peterhead,2589,1,24,4,8,83,39,44,76
Montrose,2589,2,23,7,6,59,35,24,76
Stenhousem'r,2589,3,16,8,12,56,46,10,56
Stirling,2589,4,16,6,14,60,52,8,54
Clyde,2589,5,15,9,12,54,48,6,54
Elgin,2589,6,15,6,15,54,60,-6,51
Annan Athlet,2589,7,11,12,13,49,43,6,45
Berwick,2589,8,8,10,18,29,61,-32,34
Edinburgh Ci,2589,9,7,9,20,37,66,-29,30
Cowdenbeath,2589,10,4,11,21,25,56,-31,23
Montrose,2590,1,23,8,5,61,36,25,77
Peterhead,2590,2,24,4,8,80,40,40,76
Stirling,2590,3,16,7,13,61,52,9,55
Stenhousem'r,2590,4,15,9,12,56,47,9,54
Clyde,2590,5,15,9,12,54,48,6,54
Elgin,2590,6,14,7,15,55,62,-7,49
Annan Athlet,2590,7,11,12,13,47,41,6,45
Berwick,2590,8,8,10,18,29,61,-32,34
Edinburgh Ci,2590,9,7,9,20,38,63,-25,30
Cowdenbeath,2590,10,4,11,21,23,54,-31,23
Montrose,2591,1,23,8,5,60,35,25,77
Peterhead,2591,2,24,4,8,83,39,44,76
Stenhousem'r,2591,3,16,8,12,56,46,10,56
Stirling,2591,4,16,6,14,60,52,8,54
Clyde,2591,5,15,9,12,53,49,4,54
Elgin,2591,6,14,7,15,54,61,-7,49
Annan Athlet,2591,7,12,11,13,48,41,7,47
Berwick,2591,8,8,10,18,30,60,-30,34
Edinburgh Ci,2591,9,7,9,20,37,66,-29,30
Cowdenbeath,2591,10,4,10,22,23,55,-32,22
Montrose,2592,1,24,7,5,60,34,26,79
Peterhead,2592,2,24,4,8,79,38,41,76
Stirling,2592,3,17,6,13,61,51,10,57
Stenhousem'r,2592,4,15,8,13,55,47,8,53
Clyde,2592,5,14,10,12,51,48,3,52
Elgin,2592,6,14,6,16,53,61,-8,48
Annan Athlet,2592,7,11,12,13,49,43,6,45
Berwick,2592,8,8,11,17,29,58,-29,35
Edinburgh Ci,2592,9,7,9,20,36,62,-26,30
Cowdenbeath,2592,10,4,11,21,25,56,-31,23
Montrose,2593,1,24,7,5,62,35,27,79
Peterhead,2593,2,24,4,8,82,38,44,76
Stirling,2593,3,16,7,13,62,53,9,55
Stenhousem'r,2593,4,15,9,12,57,48,9,54
Clyde,2593,5,15,9,12,52,48,4,54
Elgin,2593,6,14,6,16,54,63,-9,48
Annan Athlet,2593,7,12,11,13,48,41,7,47
Berwick,2593,8,8,10,18,29,59,-30,34
Edinburgh Ci,2593,9,7,9,20,36,65,-29,30
Cowdenbeath,2593,10,4,10,22,23,55,-32,22
Montrose,2594,1,23,8,5,60,35,25,77
Peterhead,2594,2,23,4,9,78,40,38,73
Stirling,2594,3,17,6,13,63,52,11,57
Clyde,2594,4,15,9,12,54,48,6,54
Stenhousem'r,2594,5,15,8,13,56,49,7,53
Elgin,2594,6,14,7,15,54,61,-7,49
Annan Athlet,2594,7,11,11,14,48,43,5,44
Berwick,2594,8,8,10,18,29,61,-32,34
Edinburgh Ci,2594,9,8,9,19,38,61,-23,33
Cowdenbeath,2594,10,5,10,21,25,55,-30,25
Montrose,2595,1,24,7,5,60,34,26,79
Peterhead,2595,2,24,4,8,79,38,41,76
Stirling,2595,3,17,6,13,62,51,11,57
Clyde,2595,4,15,9,12,55,49,6,54
Stenhousem'r,2595,5,15,8,13,55,48,7,53
Elgin,2595,6,14,6,16,53,61,-8,48
Annan Athlet,2595,7,12,11,13,48,41,7,47
Berwick,2595,8,8,10,18,30,62,-32,34
Edinburgh Ci,2595,9,7,9,20,36,62,-26,30
Cowdenbeath,2595,10,4,10,22,23,55,-32,22
Montrose,2596,1,24,7,5,62,36,26,79
Peterhead,2596,2,24,4,8,80,38,42,76
Stirling,2596,3,16,7,13,62,53,9,55
Stenhousem'r,2596,4,15,9,12,57,48,9,54
Clyde,2596,5,15,9,12,53,49,4,54
Elgin,2596,6,14,6,16,55,63,-8,48
Annan Athlet,2596,7,12,11,13,49,42,7,47
Berwick,2596,8,8,10,18,30,60,-30,34
Edinburgh Ci,2596,9,7,9,20,36,63,-27,30
Cowdenbeath,2596,10,4,10,22,24,56,-32,22
Peterhead,2597,1,24,4,8,79,38,41,76
Montrose,2597,2,23,7,6,60,36,24,76
Stenhousem'r,2597,3,16,8,12,59,48,11,56
Stirling,2597,4,16,6,14,62,55,7,54
Clyde,2597,5,14,9,13,51,49,2,51
Elgin,2597,6,15,6,15,55,61,-6,51
Annan Athlet,2597,7,11,12,13,48,42,6,45
Berwick,2597,8,9,10,17,30,58,-28,37
Edinburgh Ci,2597,9,7,9,20,36,62,-26,30
Cowdenbeath,2597,10,4,11,21,24,55,-31,23
Montrose,2598,1,24,7,5,62,34,28,79
Peterhead,2598,2,24,4,8,80,39,41,76
Stenhousem'r,2598,3,16,8,12,56,46,10,56
Stirling,2598,4,16,6,14,60,52,8,54
Clyde,2598,5,14,10,12,51,48,3,52
Elgin,2598,6,14,6,16,53,63,-10,48
Annan Athlet,2598,7,11,11,14,47,42,5,44
Berwick,2598,8,8,11,17,29,58,-29,35
Edinburgh Ci,2598,9,7,9,20,37,63,-26,30
Cowdenbeath,2598,10,5,10,21,24,54,-30,25
Montrose,2599,1,24,7,5,61,34,27,79
Peterhead,2599,2,24,4,8,83,39,44,76
Stirling,2599,3,16,7,13,61,52,9,55
Stenhousem'r,2599,4,15,9,12,56,47,9,54
Clyde,2599,5,14,9,13,52,51,1,51
Elgin,2599,6,14,6,16,53,62,-9,48
Annan Athlet,2599,7,12,11,13,48,41,7,47
Berwick,2599,8,9,10,17,32,59,-27,37
Edinburgh Ci,2599,9,7,9,20,37,66,-29,30
Cowdenbeath,2599,10,4,10,22,23,55,-32,22
Peterhead,2600,1,24,4,8,79,39,40,76
Montrose,2600,2,23,7,6,59,36,23,76
Stenhousem'r,2600,3,16,8,12,58,46,12,56
Stirling,2600,4,16,6,14,60,54,6,54
Clyde,2600,5,14,10,12,52,49,3,52
Elgin,2600,6,15,6,15,55,60,-5,51
Annan Athlet,2600,7,11,12,13,47,41,6,45
Berwick,2600,8,8,11,17,30,59,-29,35
Edinburgh Ci,2600,9,7,9,20,37,62,-25,30
Cowdenbeath,2600,10,4,11,21,23,54,-31,23
Peterhead,2601,1,24,4,8,82,38,44,76
Montrose,2601,2,23,7,6,59,36,23,76
Stirling,2601,3,16,7,13,62,53,9,55
Stenhousem'r,2601,4,15,9,12,57,48,9,54
Clyde,2601,5,15,9,12,55,48,7,54
Elgin,2601,6,15,6,15,55,60,-5,51
Annan Athlet,2601,7,11,12,13,48,42,6,45
Berwick,2601,8,8,10,18,29,62,-33,34
Edinburgh Ci,2601,9,7,9,20,36,65,-29,30
Cowdenbeath,2601,10,4,11,21,24,55,-31,23
Montrose,2602,1,24,7,5,60,34,26,79
Peterhead,2602,2,23,5,8,78,39,39,74
Stirling,2602,3,17,6,13,63,52,11,57
Stenhousem'r,2602,4,15,8,13,56,49,7,53
Clyde,2602,5,14,10,12,53,50,3,52
Elgin,2602,6,14,6,16,53,61,-8,48
Annan Athlet,2602,7,11,11,14,47,42,5,44
Berwick,2602,8,8,11,17,31,60,-29,35
Edinburgh Ci,2602,9,7,10,19,37,61,-24,31
Cowdenbeath,2602,10,5,10,21,24,54,-30,25
Montrose,2603,1,24,7,5,61,35,26,79
Peterhead,2603,2,24,4,8,81,38,43,76
Stirling,2603,3,17,6,13,63,53,10,57
Clyde,2603,4,15,9,12,52,48,4,54
Stenhousem'r,2603,5,15,8,13,57,49,8,53
Elgin,2603,6,14,6,16,54,62,-8,48
Annan Athlet,2603,7,11,11,14,48,43,5,44
Berwick,2603,8,8,10,18,29,59,-30,34
Edinburgh Ci,2603,9,7,9,20,36,64,-28,30
Cowdenbeath,2603,10,5,10,21,25,55,-30,25
Montrose,2604,1,24,7,5,61,35,26,79
Peterhead,2604,2,23,5,8,78,39,39,74
Stirling,2604,3,17,6,13,63,52,11,57
Stenhousem'r,2604,4,15,8,13,56,49,7,53
Clyde,2604,5,14,10,12,52,49,3,52
Elgin,2604,6,14,6,16,54,62,-8,48
Annan Athlet,2604,7,11,11,14,49,44,5,44
Berwick,2604,8,8,11,17,30,59,-29,35
Edinburgh Ci,2604,9,7,10,19,37,61,-24,31
Cowdenbeath,2604,10,5,10,21,26,56,-30,25
Montrose,2605,1,24,7,5,61,34,27,79
Peterhead,2605,2,24,4,8,79,38,41,76
Stirling,2605,3,17,6,13,61,51,10,57
Stenhousem'r,2605,4,15,8,13,55,47,8,53
Clyde,2605,5,14,10,12,51,48,3,52
Elgin,2605,6,14,6,16,53,62,-9,48
Annan Athlet,2605,7,12,11,13,49,41,8,47
Berwick,2605,8,8,11,17,29,58,-29,35
Edinburgh Ci,2605,9,7,9,20,36,62,-26,30
Cowdenbeath,2605,10,4,10,22,23,56,-33,22
Montrose,2606,1,24,7,5,61,35,26,79
Peterhead,2606,2,24,4,8,79,39,40,76
Stirling,2606,3,16,7,13,62,53,9,55
Stenhousem'r,2606,4,15,9,12,57,48,9,54
Clyde,2606,5,14,9,13,51,49,2,51
Elgin,2606,6,14,6,16,54,62,-8,48
Annan Athlet,2606,7,12,11,13,48,41,7,47
Berwick,2606,8,9,10,17,30,58,-28,37
Edinburgh Ci,2606,9,7,9,20,37,62,-25,30
Cowdenbeath,2606,10,4,10,22,23,55,-32,22
Montrose,2607,1,23,7,6,59,35,24,76
Peterhead,2607,2,23,4,9,78,40,38,73
Stirling,2607,3,17,6,13,63,52,11,57
Clyde,2607,4,15,9,12,55,49,6,54
Stenhousem'r,2607,5,15,8,13,56,49,7,53
Elgin,2607,6,15,6,15,54,60,-6,51
Annan Athlet,2607,7,11,11,14,47,43,4,44
Berwick,2607,8,8,10,18,30,62,-32,34
Edinburgh Ci,2607,9,8,9,19,38,61,-23,33
Cowdenbeath,2607,10,5,10,21,25,54,-29,25
Montrose,2608,1,23,8,5,60,35,25,77
Peterhead,2608,2,24,4,8,80,38,42,76
Stenhousem'r,2608,3,16,8,12,57,47,10,56
Stirling,2608,4,16,6,14,61,53,8,54
Clyde,2608,5,14,9,13,51,49,2,51
Elgin,2608,6,14,7,15,54,61,-7,49
Annan Athlet,2608,7,12,11,13,50,42,8,47
Berwick,2608,8,9,10,17,30,58,-28,37
Edinburgh Ci,2608,9,7,9,20,36,63,-27,30
Cowdenbeath,2608,10,4,10,22,24,57,-33,22
Montrose,2609,1,24,7,5,63,35,28,79
Peterhead,2609,2,24,4,8,78,38,40,76
Stirling,2609,3,17,6,13,63,53,10,57
Clyde,2609,4,15,9,12,54,49,5,54
Stenhousem'r,2609,5,15,8,13,57,49,8,53
Elgin,2609,6,14,6,16,54,64,-10,48
Annan Athlet,2609,7,11,12,13,48,42,6,45
Berwick,2609,8,8,10,18,30,61,-31,34
Edinburgh Ci,2609,9,7,9,20,36,61,-25,30
Cowdenbeath,2609,10,4,11,21,24,55,-31,23
Peterhead,2610,1,24,4,8,79,38,41,76
Montrose,2610,2,23,7,6,61,37,24,76
Stenhousem'r,2610,3,16,8,12,58,46,12,56
Stirling,2610,4,16,6,14,60,54,6,54
Clyde,2610,5,15,9,12,55,49,6,54
Elgin,2610,6,15,6,15,56,62,-6,51
Annan Athlet,2610,7,11,12,13,47,41,6,45
Berwick,2610,8,8,10,18,30,62,-32,34
Edinburgh Ci,2610,9,7,9,20,36,62,-26,30
Cowdenbeath,2610,10,4,11,21,23,54,-31,23
Montrose,2611,1,24,7,5,60,34,26,79
Peterhead,2611,2,23,5,8,77,38,39,74
Stenhousem'r,2611,3,16,8,12,58,48,10,56
Stirling,2611,4,16,6,14,62,54,8,54
Clyde,2611,5,15,9,12,53,49,4,54
Elgin,2611,6,14,6,16,53,61,-8,48
Annan Athlet,2611,7,12,11,13,51,44,7,47
Berwick,2611,8,8,10,18,30,60,-30,34
Edinburgh Ci,2611,9,7,10,19,36,60,-24,31
Cowdenbeath,2611,10,4,10,22,26,58,-32,22
Montrose,2612,1,23,8,5,60,35,25,77
Peterhead,2612,2,24,4,8,81,41,40,76
Stenhousem'r,2612,3,16,8,12,56,46,10,56
Stirling,2612,4,16,6,14,60,52,8,54
Clyde,2612,5,14,9,13,53,51,2,51
Elgin,2612,6,14,7,15,54,61,-7,49
Annan Athlet,2612,7,11,12,13,48,42,6,45
Berwick,2612,8,9,10,17,32,60,-28,37
Edinburgh Ci,2612,9,7,9,20,39,64,-25,30
Cowdenbeath,2612,10,4,11,21,24,55,-31,23
Montrose,2613,1,24,7,5,64,35,29,79
Peterhead,2613,2,24,4,8,79,39,40,76
Stirling,2613,3,16,7,13,61,52,9,55
Stenhousem'r,2613,4,15,9,12,56,47,9,54
Clyde,2613,5,15,9,12,55,50,5,54
Elgin,2613,6,14,6,16,54,65,-11,48
Annan Athlet,2613,7,11,11,14,48,43,5,44
Berwick,2613,8,8,10,18,31,62,-31,34
Edinburgh Ci,2613,9,7,9,20,37,62,-25,30
Cowdenbeath,2613,10,5,10,21,25,55,-30,25
Montrose,2614,1,24,7,5,63,35,28,79
Peterhead,2614,2,23,5,8,78,39,39,74
Stirling,2614,3,17,6,13,63,52,11,57
Stenhousem'r,2614,4,15,8,13,56,49,7,53
Clyde,2614,5,14,10,12,52,49,3,52
Elgin,2614,6,14,6,16,54,64,-10,48
Annan Athlet,2614,7,11,11,14,47,42,5,44
Berwick,2614,8,8,11,17,30,59,-29,35
Edinburgh Ci,2614,9,7,10,19,37,61,-24,31
Cowdenbeath,2614,10,5,10,21,24,54,-30,25
Montrose,2615,1,24,7,5,63,34,29,79
Peterhead,2615,2,24,4,8,79,38,41,76
Stenhousem'r,2615,3,16,8,12,57,47,10,56
Stirling,2615,4,16,6,14,61,53,8,54
Clyde,2615,5,15,9,12,54,48,6,54
Elgin,2615,6,14,6,16,53,64,-11,48
Annan Athlet,2615,7,12,11,13,48,41,7,47
Berwick,2615,8,8,10,18,29,61,-32,34
Edinburgh Ci,2615,9,7,9,20,36,62,-26,30
Cowdenbeath,2615,10,4,10,22,23,55,-32,22
Montrose,2616,1,23,8,5,60,35,25,77
Peterhead,2616,2,24,4,8,79,38,41,76
Stirling,2616,3,17,6,13,62,52,10,57
Clyde,2616,4,15,9,12,54,49,5,54
Stenhousem'r,2616,5,15,8,13,56,48,8,53
Elgin,2616,6,14,7,15,54,61,-7,49
Annan Athlet,2616,7,11,12,13,47,41,6,45
Berwick,2616,8,8,10,18,30,61,-31,34
Edinburgh Ci,2616,9,7,9,20,36,62,-26,30
Cowdenbeath,2616,10,4,11,21,23,54,-31,23
Montrose,2617,1,24,7,5,62,34,28,79
Peterhead,2617,2,24,4,8,83,40,43,76
Stirling,2617,3,17,6,13,61,51,10,57
Stenhousem'r,2617,4,15,8,13,55,47,8,53
Clyde,2617,5,14,9,13,51,49,2,51
Elgin,2617,6,14,6,16,53,63,-10,48
Annan Athlet,2617,7,11,11,14,47,42,5,44
Berwick,2617,8,9,10,17,30,58,-28,37
Edinburgh Ci,2617,9,7,9,20,38,66,-28,30
Cowdenbeath,2617,10,5,10,21,24,54,-30,25
Montrose,2618,1,24,7,5,64,34,30,79
Peterhead,2618,2,24,4,8,78,38,40,76
Stirling,2618,3,17,6,13,64,52,12,57
Stenhousem'r,2618,4,15,8,13,56,50,6,53
Clyde,2618,5,14,10,12,53,50,3,52
Elgin,2618,6,14,6,16,53,65,-12,48
Annan Athlet,2618,7,11,12,13,48,42,6,45
Berwick,2618,8,8,11,17,31,60,-29,35
Edinburgh Ci,2618,9,7,9,20,36,61,-25,30
Cowdenbeath,2618,10,4,11,21,24,55,-31,23
Montrose,2619,1,23,8,5,61,36,25,77
Peterhead,2619,2,24,4,8,78,38,40,76
Stirling,2619,3,16,7,13,61,52,9,55
Stenhousem'r,2619,4,15,9,12,56,47,9,54
Clyde,2619,5,15,9,12,53,48,5,54
Elgin,2619,6,14,7,15,55,62,-7,49
Annan Athlet,2619,7,12,11,13,49,42,7,47
Berwick,2619,8,8,10,18,29,60,-31,34
Edinburgh Ci,2619,9,7,9,20,36,61,-25,30
Cowdenbeath,2619,10,4,10,22,24,56,-32,22
Montrose,2620,1,24,7,5,60,34,26,79
Peterhead,2620,2,24,4,8,82,39,43,76
Stirling,2620,3,17,6,13,61,51,10,57
Clyde,2620,4,15,9,12,57,49,8,54
Stenhousem'r,2620,5,15,8,13,55,47,8,53
Elgin,2620,6,14,6,16,53,61,-8,48
Annan Athlet,2620,7,12,11,13,50,42,8,47
Berwick,2620,8,8,10,18,30,64,-34,34
Edinburgh Ci,2620,9,7,9,20,37,65,-28,30
Cowdenbeath,2620,10,4,10,22,24,57,-33,22
Montrose,2621,1,23,8,5,61,36,25,77
Peterhead,2621,2,24,4,8,82,38,44,76
Stirling,2621,3,17,6,13,61,51,10,57
Clyde,2621,4,15,9,12,53,48,5,54
Stenhousem'r,2621,5,15,8,13,55,47,8,53
Elgin,2621,6,14,7,15,55,62,-7,49
Annan Athlet,2621,7,12,11,13,49,42,7,47
Berwick,2621,8,8,10,18,29,60,-31,34
Edinburgh Ci,2621,9,7,9,20,36,65,-29,30
Cowdenbeath,2621,10,4,10,22,24,56,-32,22
Montrose,2622,1,24,7,5,60,34,26,79
Peterhead,2622,2,24,4,8,79,38,41,76
Stenhousem'r,2622,3,16,8,12,57,47,10,56
Stirling,2622,4,16,6,14,61,53,8,54
Clyde,2622,5,15,9,12,53,49,4,54
Elgin,2622,6,14,6,16,53,61,-8,48
Annan Athlet,2622,7,12,11,13,49,42,7,47
Berwick,2622,8,8,10,18,30,60,-30,34
Edinburgh Ci,2622,9,7,9,20,36,62,-26,30
Cowdenbeath,2622,10,4,10,22,24,56,-32,22
Montrose,2623,1,24,7,5,62,35,27,79
Peterhead,2623,2,24,4,8,79,38,41,76
Stirling,2623,3,17,6,13,62,51,11,57
Stenhousem'r,2623,4,15,8,13,55,48,7,53
Clyde,2623,5,14,10,12,52,49,3,52
Elgin,2623,6,14,6,16,54,63,-9,48
Annan Athlet,2623,7,12,11,13,50,42,8,47
Berwick,2623,8,8,11,17,30,59,-29,35
Edinburgh Ci,2623,9,7,9,20,36,62,-26,30
Cowdenbeath,2623,10,4,10,22,24,57,-33,22
Montrose,2624,1,24,7,5,61,35,26,79
Peterhead,2624,2,23,5,8,79,40,39,74
Stirling,2624,3,17,6,13,63,52,11,57
Stenhousem'r,2624,4,15,8,13,56,49,7,53
Clyde,2624,5,14,10,12,52,49,3,52
Elgin,2624,6,14,6,16,54,62,-8,48
Annan Athlet,2624,7,11,11,14,47,43,4,44
Berwick,2624,8,8,11,17,30,59,-29,35
Edinburgh Ci,2624,9,7,10,19,38,62,-24,31
Cowdenbeath,2624,10,5,10,21,25,54,-29,25
Montrose,2625,1,24,7,5,61,34,27,79
Peterhead,2625,2,24,4,8,79,38,41,76
Stirling,2625,3,17,6,13,62,52,10,57
Clyde,2625,4,15,9,12,55,50,5,54
Stenhousem'r,2625,5,15,8,13,56,48,8,53
Elgin,2625,6,14,6,16,53,62,-9,48
Annan Athlet,2625,7,11,12,13,48,42,6,45
Berwick,2625,8,8,10,18,31,62,-31,34
Edinburgh Ci,2625,9,7,9,20,36,62,-26,30
Cowdenbeath,2625,10,4,11,21,24,55,-31,23
Montrose,2626,1,24,7,5,62,36,26,79
Peterhead,2626,2,24,4,8,79,38,41,76
Stirling,2626,3,17,6,13,61,51,10,57
Stenhousem'r,2626,4,15,8,13,55,47,8,53
Clyde,2626,5,14,10,12,52,49,3,52
Elgin,2626,6,14,6,16,55,63,-8,48
Annan Athlet,2626,7,12,11,13,48,41,7,47
Berwick,2626,8,8,11,17,30,59,-29,35
Edinburgh Ci,2626,9,7,9,20,36,62,-26,30
Cowdenbeath,2626,10,4,10,22,23,55,-32,22
Montrose,2627,1,24,7,5,61,34,27,79
Peterhead,2627,2,23,5,8,79,40,39,74
Stenhousem'r,2627,3,16,8,12,57,46,11,56
Stirling,2627,4,16,6,14,60,53,7,54
Clyde,2627,5,14,10,12,52,49,3,52
Elgin,2627,6,14,6,16,53,62,-9,48
Annan Athlet,2627,7,11,12,13,48,42,6,45
Berwick,2627,8,8,11,17,30,59,-29,35
Edinburgh Ci,2627,9,7,10,19,38,62,-24,31
Cowdenbeath,2627,10,4,11,21,24,55,-31,23
Montrose,2628,1,24,7,5,61,34,27,79
Peterhead,2628,2,23,5,8,80,41,39,74
Stirling,2628,3,17,6,13,62,51,11,57
Stenhousem'r,2628,4,15,8,13,55,48,7,53
Clyde,2628,5,14,10,12,51,48,3,52
Elgin,2628,6,14,6,16,53,62,-9,48
Annan Athlet,2628,7,12,11,13,49,42,7,47
Berwick,2628,8,8,11,17,29,58,-29,35
Edinburgh Ci,2628,9,7,10,19,39,63,-24,31
Cowdenbeath,2628,10,4,10,22,24,56,-32,22
Montrose,2629,1,24,7,5,62,34,28,79
Peterhead,2629,2,24,4,8,83,39,44,76
Stirling,2629,3,17,6,13,63,51,12,57
Stenhousem'r,2629,4,15,8,13,55,49,6,53
Clyde,2629,5,14,10,12,53,50,3,52
Elgin,2629,6,14,6,16,53,63,-10,48
Annan Athlet,2629,7,12,11,13,48,41,7,47
Berwick,2629,8,8,11,17,31,60,-29,35
Edinburgh Ci,2629,9,7,9,20,37,66,-29,30
Cowdenbeath,2629,10,4,10,22,23,55,-32,22
Montrose,2630,1,23,8,5,61,36,25,77
Peterhead,2630,2,24,4,8,80,39,41,76
Stirling,2630,3,17,6,13,63,52,11,57
Clyde,2630,4,15,9,12,53,49,4,54
Stenhousem'r,2630,5,15,8,13,56,49,7,53
Elgin,2630,6,14,7,15,55,62,-7,49
Annan Athlet,2630,7,11,12,13,49,43,6,45
Berwick,2630,8,8,10,18,30,60,-30,34
Edinburgh Ci,2630,9,7,9,20,37,63,-26,30
Cowdenbeath,2630,10,4,11,21,25,56,-31,23
Montrose,2631,1,24,7,5,61,34,27,79
Peterhead,2631,2,24,4,8,79,39,40,76
Stirling,2631,3,17,6,13,61,51,10,57
Clyde,2631,4,15,9,12,53,48,5,54
Stenhousem'r,2631,5,15,8,13,55,47,8,53
Elgin,2631,6,14,6,16,53,62,-9,48
Annan Athlet,2631,7,12,11,13,49,42,7,47
Berwick,2631,8,8,10,18,29,60,-31,34
Edinburgh Ci,2631,9,7,9,20,37,62,-25,30
Cowdenbeath,2631,10,4,10,22,24,56,-32,22
Montrose,2632,1,23,7,6,60,36,24,76
Peterhead,2632,2,23,5,8,78,39,39,74
Stirling,2632,3,16,7,13,61,52,9,55
Stenhousem'r,2632,4,15,9,12,56,47,9,54
Clyde,2632,5,14,9,13,52,51,1,51
Elgin,2632,6,15,6,15,55,61,-6,51
Annan Athlet,2632,7,11,11,14,47,42,5,44
Berwick,2632,8,9,10,17,32,59,-27,37
Edinburgh Ci,2632,9,7,10,19,37,61,-24,31
Cowdenbeath,2632,10,5,10,21,24,54,-30,25
Montrose,2633,1,24,7,5,63,34,29,79
Peterhead,2633,2,23,5,8,79,40,39,74
Stirling,2633,3,16,7,13,61,52,9,55
Stenhousem'r,2633,4,15,9,12,56,47,9,54
Clyde,2633,5,15,9,12,52,48,4,54
Elgin,2633,6,14,6,16,53,64,-11,48
Annan Athlet,2633,7,12,11,13,49,41,8,47
Berwick,2633,8,8,10,18,29,59,-30,34
Edinburgh Ci,2633,9,7,10,19,38,62,-24,31
Cowdenbeath,2633,10,4,10,22,23,56,-33,22
Montrose,2634,1,24,7,5,65,34,31,79
Peterhead,2634,2,24,4,8,82,40,42,76
Stirling,2634,3,17,6,13,63,52,11,57
Clyde,2634,4,15,9,12,56,48,8,54
Stenhousem'r,2634,5,15,8,13,56,49,7,53
Elgin,2634,6,14,6,16,53,66,-13,48
Annan Athlet,2634,7,11,11,14,47,42,5,44
Berwick,2634,8,8,10,18,29,63,-34,34
Edinburgh Ci,2634,9,7,9,20,38,65,-27,30
Cowdenbeath,2634,10,5,10,21,24,54,-30,25
Montrose,2635,1,23,8,5,59,34,25,77
Peterhead,2635,2,24,4,8,79,38,41,76
Stirling,2635,3,16,7,13,60,51,9,55
Stenhousem'r,2635,4,15,9,12,55,46,9,54
Clyde,2635,5,14,9,13,51,49,2,51
Elgin,2635,6,14,7,15,53,60,-7,49
Annan Athlet,2635,7,12,11,13,48,41,7,47
Berwick,2635,8,9,10,17,30,58,-28,37
Edinburgh Ci,2635,9,7,9,20,36,62,-26,30
Cowdenbeath,2635,10,4,10,22,23,55,-32,22
Montrose,2636,1,23,7,6,59,35,24,76
Peterhead,2636,2,23,5,8,78,39,39,74
Stirling,2636,3,17,6,13,61,51,10,57
Clyde,2636,4,15,9,12,53,48,5,54
Stenhousem'r,2636,5,15,8,13,55,47,8,53
Elgin,2636,6,15,6,15,54,60,-6,51
Annan Athlet,2636,7,12,11,13,48,41,7,47
Berwick,2636,8,8,10,18,29,60,-31,34
Edinburgh Ci,2636,9,7,10,19,37,61,-24,31
Cowdenbeath,2636,10,4,10,22,23,55,-32,22
Montrose,2637,1,24,7,5,61,34,27,79
Peterhead,2637,2,24,4,8,80,38,42,76
Stenhousem'r,2637,3,16,8,12,56,46,10,56
Stirling,2637,4,16,6,14,60,52,8,54
Clyde,2637,5,14,9,13,52,51,1,51
Elgin,2637,6,14,6,16,53,62,-9,48
Annan Athlet,2637,7,12,11,13,50,41,9,47
Berwick,2637,8,9,10,17,32,59,-27,37
Edinburgh Ci,2637,9,7,9,20,36,63,-27,30
Cowdenbeath,2637,10,4,10,22,23,57,-34,22
Montrose,2638,1,24,7,5,61,34,27,79
Peterhead,2638,2,23,4,9,77,41,36,73
Stirling,2638,3,17,6,13,61,51,10,57
Stenhousem'r,2638,4,15,8,13,55,47,8,53
Clyde,2638,5,14,10,12,51,48,3,52
Elgin,2638,6,14,6,16,53,62,-9,48
Annan Athlet,2638,7,12,11,13,50,42,8,47
Berwick,2638,8,8,11,17,29,58,-29,35
Edinburgh Ci,2638,9,8,9,19,39,60,-21,33
Cowdenbeath,2638,10,4,10,22,24,57,-33,22
Montrose,2639,1,24,7,5,62,35,27,79
Peterhead,2639,2,24,4,8,80,39,41,76
Stirling,2639,3,17,6,13,61,51,10,57
Clyde,2639,4,15,9,12,55,48,7,54
Stenhousem'r,2639,5,15,8,13,55,47,8,53
Elgin,2639,6,14,6,16,54,63,-9,48
Annan Athlet,2639,7,12,11,13,51,42,9,47
Berwick,2639,8,8,10,18,29,62,-33,34
Edinburgh Ci,2639,9,7,9,20,37,63,-26,30
Cowdenbeath,2639,10,4,10,22,24,58,-34,22
Montrose,2640,1,24,7,5,62,35,27,79
Peterhead,2640,2,24,4,8,79,38,41,76
Stirling,2640,3,17,6,13,62,51,11,57
Stenhousem'r,2640,4,15,8,13,55,48,7,53
Clyde,2640,5,14,10,12,52,49,3,52
Elgin,2640,6,14,6,16,54,63,-9,48
Annan Athlet,2640,7,12,11,13,50,42,8,47
Berwick,2640,8,8,11,17,30,59,-29,35
Edinburgh Ci,2640,9,7,9,20,36,62,-26,30
Cowdenbeath,2640,10,4,10,22,24,57,-33,22
Montrose,2641,1,24,7,5,65,35,30,79
Peterhead,2641,2,24,4,8,82,38,44,76
Stirling,2641,3,17,6,13,62,52,10,57
Clyde,2641,4,15,9,12,54,50,4,54
Stenhousem'r,2641,5,15,8,13,56,48,8,53
Elgin,2641,6,14,6,16,54,66,-12,48
Annan Athlet,2641,7,12,11,13,50,43,7,47
Berwick,2641,8,8,10,18,31,61,-30,34
Edinburgh Ci,2641,9,7,9,20,36,65,-29,30
Cowdenbeath,2641,10,4,10,22,25,57,-32,22
Montrose,2642,1,23,8,5,60,35,25,77
Peterhead,2642,2,24,4,8,78,38,40,76
Stirling,2642,3,17,6,13,61,51,10,57
Stenhousem'r,2642,4,15,8,13,55,47,8,53
Clyde,2642,5,14,9,13,51,49,2,51
Elgin,2642,6,14,7,15,54,61,-7,49
Annan Athlet,2642,7,12,11,13,49,42,7,47
Berwick,2642,8,9,10,17,30,58,-28,37
Edinburgh Ci,2642,9,7,9,20,36,61,-25,30
Cowdenbeath,2642,10,4,10,22,24,56,-32,22
Montrose,2643,1,24,7,5,62,34,28,79
Peterhead,2643,2,23,5,8,79,40,39,74
Stenhousem'r,2643,3,16,8,12,57,47,10,56
Stirling,2643,4,16,6,14,61,53,8,54
Clyde,2643,5,15,9,12,53,48,5,54
Elgin,2643,6,14,6,16,53,63,-10,48
Annan Athlet,2643,7,11,12,13,47,41,6,45
Berwick,2643,8,8,10,18,29,60,-31,34
Edinburgh Ci,2643,9,7,10,19,38,62,-24,31
Cowdenbeath,2643,10,4,11,21,23,54,-31,23
Montrose,2644,1,24,7,5,61,34,27,79
Peterhead,2644,2,24,4,8,82,39,43,76
Stirling,2644,3,17,6,13,63,52,11,57
Clyde,2644,4,15,9,12,52,48,4,54
Stenhousem'r,2644,5,15,8,13,56,49,7,53
Elgin,2644,6,14,6,16,53,62,-9,48
Annan Athlet,2644,7,11,11,14,47,43,4,44
Berwick,2644,8,8,10,18,29,59,-30,34
Edinburgh Ci,2644,9,7,9,20,37,65,-28,30
Cowdenbeath,2644,10,5,10,21,25,54,-29,25
Montrose,2645,1,23,8,5,61,36,25,77
Peterhead,2645,2,24,4,8,78,38,40,76
Stirling,2645,3,17,6,13,63,53,10,57
Stenhousem'r,2645,4,15,8,13,57,49,8,53
Clyde,2645,5,14,9,13,51,49,2,51
Elgin,2645,6,14,7,15,55,62,-7,49
Annan Athlet,2645,7,11,11,14,48,44,4,44
Berwick,2645,8,9,10,17,30,58,-28,37
Edinburgh Ci,2645,9,7,9,20,36,61,-25,30
Cowdenbeath,2645,10,5,10,21,26,55,-29,25
Montrose,2646,1,24,7,5,60,34,26,79
Peterhead,2646,2,24,4,8,80,39,41,76
Stirling,2646,3,16,7,13,60,51,9,55
Stenhousem'r,2646,4,15,9,12,55,46,9,54
Clyde,2646,5,15,9,12,53,49,4,54
Elgin,2646,6,14,6,16,53,61,-8,48
Annan Athlet,2646,7,11,12,13,49,43,6,45
Berwick,2646,8,8,10,18,30,60,-30,34
Edinburgh Ci,2646,9,7,9,20,37,63,-26,30
Cowdenbeath,2646,10,4,11,21,25,56,-31,23
Montrose,2647,1,23,8,5,60,35,25,77
Peterhead,2647,2,24,4,8,80,40,40,76
Stirling,2647,3,16,7,13,60,51,9,55
Stenhousem'r,2647,4,15,9,12,55,46,9,54
Clyde,2647,5,14,10,12,51,48,3,52
Elgin,2647,6,14,7,15,54,61,-7,49
Annan Athlet,2647,7,11,11,14,47,43,4,44
Berwick,2647,8,8,11,17,29,58,-29,35
Edinburgh Ci,2647,9,7,9,20,38,63,-25,30
Cowdenbeath,2647,10,5,10,21,25,54,-29,25
Montrose,2648,1,24,7,5,60,34,26,79
Peterhead,2648,2,23,4,9,78,40,38,73
Stirling,2648,3,17,6,13,62,52,10,57
Clyde,2648,4,15,9,12,52,48,4,54
Stenhousem'r,2648,5,15,8,13,56,48,8,53
Elgin,2648,6,14,6,16,53,61,-8,48
Annan Athlet,2648,7,11,12,13,47,41,6,45
Berwick,2648,8,8,10,18,29,59,-30,34
Edinburgh Ci,2648,9,8,9,19,38,61,-23,33
Cowdenbeath,2648,10,4,11,21,23,54,-31,23
Montrose,2649,1,23,8,5,60,35,25,77
Peterhead,2649,2,23,5,8,78,39,39,74
Stirling,2649,3,17,6,13,65,52,13,57
Clyde,2649,4,15,9,12,52,48,4,54
Stenhousem'r,2649,5,15,8,13,56,51,5,53
Elgin,2649,6,14,7,15,54,61,-7,49
Annan Athlet,2649,7,11,11,14,47,42,5,44
Berwick,2649,8,8,10,18,29,59,-30,34
Edinburgh Ci,2649,9,7,10,19,37,61,-24,31
Cowdenbeath,2649,10,5,10,21,24,54,-30,25
Montrose,2650,1,24,7,5,62,35,27,79
Peterhead,2650,2,24,4,8,80,39,41,76
Stirling,2650,3,17,6,13,63,51,12,57
Clyde,2650,4,15,9,12,56,49,7,54
Stenhousem'r,2650,5,15,8,13,55,49,6,53
Elgin,2650,6,14,6,16,54,63,-9,48
Annan Athlet,2650,7,12,11,13,50,43,7,47
Berwick,2650,8,8,10,18,30,63,-33,34
Edinburgh Ci,2650,9,7,9,20,37,63,-26,30
Cowdenbeath,2650,10,4,10,22,25,57,-32,22
Montrose,2651,1,24,7,5,62,34,28,79
Peterhead,2651,2,24,4,8,81,38,43,76
Stirling,2651,3,17,6,13,63,51,12,57
Stenhousem'r,2651,4,15,8,13,55,49,6,53
Clyde,2651,5,14,9,13,52,51,1,51
Elgin,2651,6,14,6,16,53,63,-10,48
Annan Athlet,2651,7,11,12,13,48,42,6,45
Berwick,2651,8,9,10,17,32,59,-27,37
Edinburgh Ci,2651,9,7,9,20,36,64,-28,30
Cowdenbeath,2651,10,4,11,21,24,55,-31,23
Montrose,2652,1,24,7,5,62,35,27,79
Peterhead,2652,2,23,5,8,80,41,39,74
Stirling,2652,3,17,6,13,62,52,10,57
Stenhousem'r,2652,4,15,8,13,56,48,8,53
Clyde,2652,5,14,9,13,51,49,2,51
Elgin,2652,6,14,6,16,54,63,-9,48
Annan Athlet,2652,7,11,12,13,48,42,6,45
Berwick,2652,8,9,10,17,30,58,-28,37
Edinburgh Ci,2652,9,7,10,19,39,63,-24,31
Cowdenbeath,2652,10,4,11,21,24,55,-31,23
Montrose,2653,1,24,7,5,65,34,31,79
Peterhead,2653,2,24,4,8,86,38,48,76
Stenhousem'r,2653,3,16,8,12,56,46,10,56
Stirling,2653,4,16,6,14,60,52,8,54
Clyde,2653,5,14,10,12,51,48,3,52
Elgin,2653,6,14,6,16,53,66,-13,48
Annan Athlet,2653,7,11,12,13,48,42,6,45
Berwick,2653,8,8,11,17,29,58,-29,35
Edinburgh Ci,2653,9,7,9,20,36,69,-33,30
Cowdenbeath,2653,10,4,11,21,24,55,-31,23
Montrose,2654,1,23,7,6,59,36,23,76
Peterhead,2654,2,23,5,8,78,39,39,74
Stirling,2654,3,16,7,13,61,52,9,55
Stenhousem'r,2654,4,15,9,12,56,47,9,54
Clyde,2654,5,14,10,12,51,48,3,52
Elgin,2654,6,15,6,15,55,60,-5,51
Annan Athlet,2654,7,12,11,13,49,41,8,47
Berwick,2654,8,8,11,17,29,58,-29,35
Edinburgh Ci,2654,9,7,10,19,37,61,-24,31
Cowdenbeath,2654,10,4,10,22,23,56,-33,22
Peterhead,2655,1,24,4,8,80,39,41,76
Montrose,2655,2,23,7,6,61,37,24,76
Stirling,2655,3,17,6,13,64,52,12,57
Clyde,2655,4,15,9,12,53,49,4,54
Stenhousem'r,2655,5,15,8,13,56,50,6,53
Elgin,2655,6,15,6,15,56,62,-6,51
Annan Athlet,2655,7,11,12,13,48,42,6,45
Berwick,2655,8,8,10,18,30,60,-30,34
Edinburgh Ci,2655,9,7,9,20,37,63,-26,30
Cowdenbeath,2655,10,4,11,21,24,55,-31,23
Montrose,2656,1,23,8,5,60,35,25,77
Peterhead,2656,2,24,4,8,81,38,43,76
Stirling,2656,3,17,6,13,63,51,12,57
Stenhousem'r,2656,4,15,8,13,55,49,6,53
Clyde,2656,5,14,9,13,52,50,2,51
Elgin,2656,6,14,7,15,54,61,-7,49
Annan Athlet,2656,7,12,11,13,48,41,7,47
Berwick,2656,8,9,10,17,31,59,-28,37
Edinburgh Ci,2656,9,7,9,20,36,64,-28,30
Cowdenbeath,2656,10,4,10,22,23,55,-32,22
Montrose,2657,1,23,7,6,59,37,22,76
Peterhead,2657,2,23,5,8,79,40,39,74
Stirling,2657,3,17,6,13,65,52,13,57
Stenhousem'r,2657,4,15,8,13,56,51,5,53
Clyde,2657,5,14,10,12,52,49,3,52
Elgin,2657,6,15,6,15,56,60,-4,51
Annan Athlet,2657,7,12,11,13,49,42,7,47
Berwick,2657,8,8,11,17,30,59,-29,35
Edinburgh Ci,2657,9,7,10,19,38,62,-24,31
Cowdenbeath,2657,10,4,10,22,24,56,-32,22
Montrose,2658,1,24,7,5,61,34,27,79
Peterhead,2658,2,24,4,8,82,38,44,76
Stirling,2658,3,17,6,13,65,52,13,57
Stenhousem'r,2658,4,15,8,13,56,51,5,53
Clyde,2658,5,14,9,13,51,49,2,51
Elgin,2658,6,14,6,16,53,62,-9,48
Annan Athlet,2658,7,11,12,13,48,42,6,45
Berwick,2658,8,9,10,17,30,58,-28,37
Edinburgh Ci,2658,9,7,9,20,36,65,-29,30
Cowdenbeath,2658,10,4,11,21,24,55,-31,23
Montrose,2659,1,24,7,5,62,34,28,79
Peterhead,2659,2,24,4,8,79,39,40,76
Stirling,2659,3,17,6,13,66,52,14,57
Clyde,2659,4,15,9,12,56,49,7,54
Stenhousem'r,2659,5,15,8,13,56,52,4,53
Elgin,2659,6,14,6,16,53,63,-10,48
Annan Athlet,2659,7,12,11,13,51,42,9,47
Berwick,2659,8,8,10,18,30,63,-33,34
Edinburgh Ci,2659,9,7,9,20,37,62,-25,30
Cowdenbeath,2659,10,4,10,22,24,58,-34,22
Montrose,2660,1,23,8,5,61,36,25,77
Peterhead,2660,2,24,4,8,79,39,40,76
Stirling,2660,3,16,7,13,60,51,9,55
Stenhousem'r,2660,4,15,9,12,55,46,9,54
Clyde,2660,5,14,10,12,52,49,3,52
Elgin,2660,6,14,7,15,55,62,-7,49
Annan Athlet,2660,7,12,11,13,48,41,7,47
Berwick,2660,8,8,11,17,30,59,-29,35
Edinburgh Ci,2660,9,7,9,20,37,62,-25,30
Cowdenbeath,2660,10,4,10,22,23,55,-32,22
Montrose,2661,1,24,7,5,61,35,26,79
Peterhead,2661,2,23,5,8,78,39,39,74
Stenhousem'r,2661,3,16,8,12,57,46,11,56
Stirling,2661,4,16,6,14,60,53,7,54
Clyde,2661,5,15,9,12,54,50,4,54
Elgin,2661,6,14,6,16,54,62,-8,48
Annan Athlet,2661,7,12,11,13,50,41,9,47
Berwick,2661,8,8,10,18,31,61,-30,34
Edinburgh Ci,2661,9,7,10,19,37,61,-24,31
Cowdenbeath,2661,10,4,10,22,23,57,-34,22
Montrose,2662,1,24,7,5,62,36,26,79
Peterhead,2662,2,24,4,8,80,38,42,76
Stirling,2662,3,17,6,13,61,51,10,57
Clyde,2662,4,15,9,12,52,48,4,54
Stenhousem'r,2662,5,15,8,13,55,47,8,53
Elgin,2662,6,14,6,16,55,63,-8,48
Annan Athlet,2662,7,11,12,13,48,42,6,45
Berwick,2662,8,8,10,18,29,59,-30,34
Edinburgh Ci,2662,9,7,9,20,36,63,-27,30
Cowdenbeath,2662,10,4,11,21,24,55,-31,23
Montrose,2663,1,24,7,5,60,34,26,79
Peterhead,2663,2,24,4,8,81,38,43,76
Stirling,2663,3,17,6,13,64,53,11,57
Clyde,2663,4,15,9,12,53,48,5,54
Stenhousem'r,2663,5,15,8,13,57,50,7,53
Elgin,2663,6,14,6,16,53,61,-8,48
Annan Athlet,2663,7,12,11,13,49,42,7,47
Berwick,2663,8,8,10,18,29,60,-31,34
Edinburgh Ci,2663,9,7,9,20,36,64,-28,30
Cowdenbeath,2663,10,4,10,22,24,56,-32,22
Peterhead,2664,1,24,4,8,78,38,40,76
Montrose,2664,2,23,7,6,59,36,23,76
Stirling,2664,3,17,6,13,64,53,11,57
Clyde,2664,4,15,9,12,54,49,5,54
Stenhousem'r,2664,5,15,8,13,57,50,7,53
Elgin,2664,6,15,6,15,55,60,-5,51
Annan Athlet,2664,7,11,12,13,49,43,6,45
Berwick,2664,8,8,10,18,30,61,-31,34
Edinburgh Ci,2664,9,7,9,20,36,61,-25,30
Cowdenbeath,2664,10,4,11,21,25,56,-31,23
Montrose,2665,1,24,7,5,62,34,28,79
Peterhead,2665,2,24,4,8,82,40,42,76
Stenhousem'r,2665,3,16,8,12,60,50,10,56
Stirling,2665,4,16,6,14,64,56,8,54
Clyde,2665,5,15,9,12,52,48,4,54
Elgin,2665,6,14,6,16,53,63,-10,48
Annan Athlet,2665,7,12,11,13,51,43,8,47
Berwick,2665,8,8,10,18,29,59,-30,34
Edinburgh Ci,2665,9,7,9,20,38,65,-27,30
Cowdenbeath,2665,10,4,10,22,25,58,-33,22
Peterhead,2666,1,24,4,8,80,39,41,76
Montrose,2666,2,23,7,6,61,37,24,76
Stirling,2666,3,16,7,13,62,53,9,55
Stenhousem'r,2666,4,15,9,12,57,48,9,54
Clyde,2666,5,14,10,12,53,50,3,52
Elgin,2666,6,15,6,15,56,62,-6,51
Annan Athlet,2666,7,11,12,13,48,42,6,45
Berwick,2666,8,8,11,17,31,60,-29,35
Edinburgh Ci,2666,9,7,9,20,37,63,-26,30
Cowdenbeath,2666,10,4,11,21,24,55,-31,23
Peterhead,2667,1,24,4,8,80,38,42,76
Montrose,2667,2,23,7,6,59,36,23,76
Stirling,2667,3,17,6,13,63,53,10,57
Clyde,2667,4,15,9,12,53,48,5,54
Stenhousem'r,2667,5,15,8,13,57,49,8,53
Elgin,2667,6,15,6,15,55,60,-5,51
Annan Athlet,2667,7,11,11,14,47,42,5,44
Berwick,2667,8,8,10,18,29,60,-31,34
Edinburgh Ci,2667,9,7,9,20,36,63,-27,30
Cowdenbeath,2667,10,5,10,21,24,54,-30,25
Montrose,2668,1,24,7,5,61,34,27,79
Peterhead,2668,2,24,4,8,81,41,40,76
Stirling,2668,3,17,6,13,62,52,10,57
Clyde,2668,4,15,9,12,53,48,5,54
Stenhousem'r,2668,5,15,8,13,56,48,8,53
Elgin,2668,6,14,6,16,53,62,-9,48
Annan Athlet,2668,7,11,11,14,47,42,5,44
Berwick,2668,8,8,10,18,29,60,-31,34
Edinburgh Ci,2668,9,7,9,20,39,64,-25,30
Cowdenbeath,2668,10,5,10,21,24,54,-30,25
Montrose,2669,1,23,8,5,62,37,25,77
Peterhead,2669,2,24,4,8,83,40,43,76
Stirling,2669,3,16,7,13,61,52,9,55
Stenhousem'r,2669,4,15,9,12,56,47,9,54
Clyde,2669,5,15,9,12,53,48,5,54
Elgin,2669,6,14,7,15,56,63,-7,49
Annan Athlet,2669,7,12,11,13,49,42,7,47
Berwick,2669,8,8,10,18,29,60,-31,34
Edinburgh Ci,2669,9,7,9,20,38,66,-28,30
Cowdenbeath,2669,10,4,10,22,24,56,-32,22
Montrose,2670,1,24,7,5,61,34,27,79
Peterhead,2670,2,23,4,9,78,40,38,73
Stenhousem'r,2670,3,16,8,12,59,48,11,56
Stirling,2670,4,16,6,14,62,55,7,54
Clyde,2670,5,14,9,13,51,49,2,51
Elgin,2670,6,14,6,16,53,62,-9,48
Annan Athlet,2670,7,12,11,13,50,42,8,47
Berwick,2670,8,9,10,17,30,58,-28,37
Edinburgh Ci,2670,9,8,9,19,38,61,-23,33
Cowdenbeath,2670,10,4,10,22,24,57,-33,22
Peterhead,2671,1,24,4,8,79,38,41,76
Montrose,2671,2,23,7,6,59,36,23,76
Stirling,2671,3,16,7,13,60,51,9,55
Stenhousem'r,2671,4,15,9,12,55,46,9,54
Clyde,2671,5,15,9,12,52,48,4,54
Elgin,2671,6,15,6,15,55,60,-5,51
Annan Athlet,2671,7,11,11,14,49,44,5,44
Berwick,2671,8,8,10,18,29,59,-30,34
Edinburgh Ci,2671,9,7,9,20,36,62,-26,30
Cowdenbeath,2671,10,5,10,21,26,56,-30,25
Peterhead,2672,1,24,4,8,85,40,45,76
Montrose,2672,2,23,7,6,60,36,24,76
Stirling,2672,3,16,7,13,61,52,9,55
Stenhousem'r,2672,4,15,9,12,56,47,9,54
Clyde,2672,5,15,9,12,53,49,4,54
Elgin,2672,6,15,6,15,55,61,-6,51
Annan Athlet,2672,7,12,11,13,51,41,10,47
Berwick,2672,8,8,10,18,30,60,-30,34
Edinburgh Ci,2672,9,7,9,20,38,68,-30,30
Cowdenbeath,2672,10,4,10,22,23,58,-35,22
Montrose,2673,1,24,7,5,61,34,27,79
Peterhead,2673,2,24,4,8,84,40,44,76
Stirling,2673,3,17,6,13,62,52,10,57
Clyde,2673,4,15,9,12,52,48,4,54
Stenhousem'r,2673,5,15,8,13,56,48,8,53
Elgin,2673,6,14,6,16,53,62,-9,48
Annan Athlet,2673,7,12,11,13,50,41,9,47
Berwick,2673,8,8,10,18,29,59,-30,34
Edinburgh Ci,2673,9,7,9,20,38,67,-29,30
Cowdenbeath,2673,10,4,10,22,23,57,-34,22
Montrose,2674,1,24,7,5,62,35,27,79
Peterhead,2674,2,24,4,8,78,38,40,76
Stenhousem'r,2674,3,16,8,12,59,46,13,56
Clyde,2674,4,15,9,12,54,48,6,54
Stirling,2674,5,16,6,14,60,55,5,54
Elgin,2674,6,14,6,16,54,63,-9,48
Annan Athlet,2674,7,11,12,13,47,41,6,45
Berwick,2674,8,8,10,18,29,61,-32,34
Edinburgh Ci,2674,9,7,9,20,36,61,-25,30
Cowdenbeath,2674,10,4,11,21,23,54,-31,23
Montrose,2675,1,23,8,5,62,37,25,77
Peterhead,2675,2,24,4,8,79,39,40,76
Stenhousem'r,2675,3,16,8,12,56,46,10,56
Stirling,2675,4,16,6,14,60,52,8,54
Clyde,2675,5,15,9,12,52,48,4,54
Elgin,2675,6,14,7,15,56,63,-7,49
Annan Athlet,2675,7,11,12,13,49,43,6,45
Berwick,2675,8,8,10,18,29,59,-30,34
Edinburgh Ci,2675,9,7,9,20,37,62,-25,30
Cowdenbeath,2675,10,4,11,21,25,56,-31,23
Montrose,2676,1,23,8,5,61,36,25,77
Peterhead,2676,2,24,4,8,80,39,41,76
Stenhousem'r,2676,3,16,8,12,56,46,10,56
Stirling,2676,4,16,6,14,60,52,8,54
Clyde,2676,5,14,10,12,52,49,3,52
Elgin,2676,6,14,7,15,55,62,-7,49
Annan Athlet,2676,7,11,11,14,48,44,4,44
Berwick,2676,8,8,11,17,30,59,-29,35
Edinburgh Ci,2676,9,7,9,20,37,63,-26,30
Cowdenbeath,2676,10,5,10,21,26,55,-29,25
Montrose,2677,1,24,7,5,61,35,26,79
Peterhead,2677,2,24,4,8,80,40,40,76
Stenhousem'r,2677,3,16,8,12,56,46,10,56
Stirling,2677,4,16,6,14,60,52,8,54
Clyde,2677,5,14,9,13,52,51,1,51
Elgin,2677,6,14,6,16,54,62,-8,48
Annan Athlet,2677,7,11,11,14,47,43,4,44
Berwick,2677,8,9,10,17,32,59,-27,37
Edinburgh Ci,2677,9,7,9,20,38,63,-25,30
Cowdenbeath,2677,10,5,10,21,25,54,-29,25
Montrose,2678,1,24,7,5,64,34,30,79
Peterhead,2678,2,24,4,8,81,40,41,76
Stirling,2678,3,17,6,13,62,51,11,57
Clyde,2678,4,15,9,12,54,50,4,54
Stenhousem'r,2678,5,15,8,13,55,48,7,53
Elgin,2678,6,14,6,16,53,65,-12,48
Annan Athlet,2678,7,11,12,13,48,42,6,45
Berwick,2678,8,8,10,18,31,61,-30,34
Edinburgh Ci,2678,9,7,9,20,38,64,-26,30
Cowdenbeath,2678,10,4,11,21,24,55,-31,23
Montrose,2679,1,24,7,5,62,35,27,79
Peterhead,2679,2,24,4,8,80,39,41,76
Stirling,2679,3,17,6,13,62,52,10,57
Stenhousem'r,2679,4,15,8,13,56,48,8,53
Clyde,2679,5,14,10,12,52,49,3,52
Elgin,2679,6,14,6,16,54,63,-9,48
Annan Athlet,2679,7,11,12,13,48,42,6,45
Berwick,2679,8,8,11,17,30,59,-29,35
Edinburgh Ci,2679,9,7,9,20,37,63,-26,30
Cowdenbeath,2679,10,4,11,21,24,55,-31,23
Peterhead,2680,1,24,4,8,78,38,40,76
Montrose,2680,2,23,7,6,60,36,24,76
Stenhousem'r,2680,3,16,8,12,57,46,11,56
Stirling,2680,4,16,6,14,60,53,7,54
Clyde,2680,5,14,10,12,52,49,3,52
Elgin,2680,6,15,6,15,55,61,-6,51
Annan Athlet,2680,7,12,11,13,51,41,10,47
Berwick,2680,8,8,11,17,30,59,-29,35
Edinburgh Ci,2680,9,7,9,20,36,61,-25,30
Cowdenbeath,2680,10,4,10,22,23,58,-35,22
Peterhead,2681,1,24,4,8,79,38,41,76
Montrose,2681,2,23,7,6,61,37,24,76
Stirling,2681,3,17,6,13,64,51,13,57
Stenhousem'r,2681,4,15,8,13,55,50,5,53
Clyde,2681,5,14,10,12,52,49,3,52
Elgin,2681,6,15,6,15,56,62,-6,51
Annan Athlet,2681,7,11,11,14,48,43,5,44
Berwick,2681,8,8,11,17,30,59,-29,35
Edinburgh Ci,2681,9,7,9,20,36,62,-26,30
Cowdenbeath,2681,10,5,10,21,25,55,-30,25
Montrose,2682,1,24,7,5,62,36,26,79
Peterhead,2682,2,24,4,8,80,39,41,76
Stirling,2682,3,16,7,13,63,54,9,55
Stenhousem'r,2682,4,15,9,12,58,49,9,54
Clyde,2682,5,14,9,13,51,49,2,51
Elgin,2682,6,14,6,16,55,63,-8,48
Annan Athlet,2682,7,12,11,13,48,41,7,47
Berwick,2682,8,9,10,17,30,58,-28,37
Edinburgh Ci,2682,9,7,9,20,37,63,-26,30
Cowdenbeath,2682,10,4,10,22,23,55,-32,22
Montrose,2683,1,24,7,5,60,34,26,79
Peterhead,2683,2,24,4,8,80,38,42,76
Stirling,2683,3,17,6,13,67,51,16,57
Clyde,2683,4,15,9,12,54,50,4,54
Stenhousem'r,2683,5,15,8,13,55,53,2,53
Elgin,2683,6,14,6,16,53,61,-8,48
Annan Athlet,2683,7,11,11,14,47,42,5,44
Berwick,2683,8,8,10,18,31,61,-30,34
Edinburgh Ci,2683,9,7,9,20,36,63,-27,30
Cowdenbeath,2683,10,5,10,21,24,54,-30,25
Montrose,2684,1,23,8,5,59,34,25,77
Peterhead,2684,2,24,4,8,79,39,40,76
Stirling,2684,3,17,6,13,64,51,13,57
Stenhousem'r,2684,4,15,8,13,55,50,5,53
Clyde,2684,5,14,10,12,52,49,3,52
Elgin,2684,6,14,7,15,53,60,-7,49
Annan Athlet,2684,7,12,11,13,50,41,9,47
Berwick,2684,8,8,11,17,30,59,-29,35
Edinburgh Ci,2684,9,7,9,20,37,62,-25,30
Cowdenbeath,2684,10,4,10,22,23,57,-34,22
Montrose,2685,1,24,7,5,61,35,26,79
Peterhead,2685,2,23,5,8,77,38,39,74
Stenhousem'r,2685,3,16,8,12,58,47,11,56
Stirling,2685,4,16,6,14,61,54,7,54
Clyde,2685,5,14,9,13,51,50,1,51
Elgin,2685,6,14,6,16,54,62,-8,48
Annan Athlet,2685,7,11,12,13,49,43,6,45
Berwick,2685,8,9,10,17,31,58,-27,37
Edinburgh Ci,2685,9,7,10,19,36,60,-24,31
Cowdenbeath,2685,10,4,11,21,25,56,-31,23
Montrose,2686,1,24,7,5,61,35,26,79
Peterhead,2686,2,24,4,8,79,38,41,76
Stirling,2686,3,17,6,13,62,52,10,57
Clyde,2686,4,15,9,12,52,48,4,54
Stenhousem'r,2686,5,15,8,13,56,48,8,53
Elgin,2686,6,14,6,16,54,62,-8,48
Annan Athlet,2686,7,11,12,13,48,42,6,45
Berwick,2686,8,8,10,18,29,59,-30,34
Edinburgh Ci,2686,9,7,9,20,36,62,-26,30
Cowdenbeath,2686,10,4,11,21,24,55,-31,23
Montrose,2687,1,23,8,5,61,36,25,77
Peterhead,2687,2,23,4,9,77,39,38,73
Stirling,2687,3,17,6,13,63,52,11,57
Stenhousem'r,2687,4,15,8,13,56,49,7,53
Clyde,2687,5,14,9,13,51,49,2,51
Elgin,2687,6,14,7,15,55,62,-7,49
Annan Athlet,2687,7,11,12,13,48,42,6,45
Berwick,2687,8,9,10,17,30,58,-28,37
Edinburgh Ci,2687,9,8,9,19,37,60,-23,33
Cowdenbeath,2687,10,4,11,21,24,55,-31,23
Montrose,2688,1,24,7,5,62,36,26,79
Peterhead,2688,2,23,4,9,78,40,38,73
Stenhousem'r,2688,3,16,8,12,57,46,11,56
Stirling,2688,4,16,6,14,60,53,7,54
Clyde,2688,5,14,9,13,52,50,2,51
Elgin,2688,6,14,6,16,55,63,-8,48
Annan Athlet,2688,7,12,11,13,49,42,7,47
Berwick,2688,8,9,10,17,31,59,-28,37
Edinburgh Ci,2688,9,8,9,19,38,61,-23,33
Cowdenbeath,2688,10,4,10,22,24,56,-32,22
Montrose,2689,1,23,7,6,59,35,24,76
Peterhead,2689,2,23,5,8,78,39,39,74
Stirling,2689,3,16,7,13,61,52,9,55
Stenhousem'r,2689,4,15,9,12,56,47,9,54
Clyde,2689,5,14,9,13,53,51,2,51
Elgin,2689,6,15,6,15,54,60,-6,51
Annan Athlet,2689,7,11,12,13,47,41,6,45
Berwick,2689,8,9,10,17,32,60,-28,37
Edinburgh Ci,2689,9,7,10,19,37,61,-24,31
Cowdenbeath,2689,10,4,11,21,23,54,-31,23
Montrose,2690,1,23,7,6,60,36,24,76
Peterhead,2690,2,23,4,9,78,40,38,73
Stirling,2690,3,17,6,13,62,52,10,57
Clyde,2690,4,15,9,12,53,49,4,54
Stenhousem'r,2690,5,15,8,13,56,48,8,53
Elgin,2690,6,15,6,15,55,61,-6,51
Annan Athlet,2690,7,11,12,13,47,41,6,45
Berwick,2690,8,8,10,18,30,60,-30,34
Edinburgh Ci,2690,9,8,9,19,38,61,-23,33
Cowdenbeath,2690,10,4,11,21,23,54,-31,23
Montrose,2691,1,23,8,5,61,36,25,77
Peterhead,2691,2,24,4,8,80,39,41,76
Stenhousem'r,2691,3,16,8,12,58,48,10,56
Stirling,2691,4,16,6,14,62,54,8,54
Clyde,2691,5,15,9,12,53,48,5,54
Elgin,2691,6,14,7,15,55,62,-7,49
Annan Athlet,2691,7,11,11,14,47,42,5,44
Berwick,2691,8,8,10,18,29,60,-31,34
Edinburgh Ci,2691,9,7,9,20,37,63,-26,30
Cowdenbeath,2691,10,5,10,21,24,54,-30,25
Montrose,2692,1,24,7,5,64,34,30,79
Peterhead,2692,2,23,5,8,79,40,39,74
Stirling,2692,3,17,6,13,65,52,13,57
Clyde,2692,4,15,9,12,53,48,5,54
Stenhousem'r,2692,5,15,8,13,56,51,5,53
Elgin,2692,6,14,6,16,53,65,-12,48
Annan Athlet,2692,7,11,12,13,48,42,6,45
Berwick,2692,8,8,10,18,29,60,-31,34
Edinburgh Ci,2692,9,7,10,19,38,62,-24,31
Cowdenbeath,2692,10,4,11,21,24,55,-31,23
Montrose,2693,1,24,7,5,61,34,27,79
Peterhead,2693,2,24,4,8,83,39,44,76
Stirling,2693,3,16,7,13,61,52,9,55
Stenhousem'r,2693,4,15,9,12,56,47,9,54
Clyde,2693,5,15,9,12,52,48,4,54
Elgin,2693,6,14,6,16,53,62,-9,48
Annan Athlet,2693,7,12,11,13,48,41,7,47
Berwick,2693,8,8,10,18,29,59,-30,34
Edinburgh Ci,2693,9,7,9,20,37,66,-29,30
Cowdenbeath,2693,10,4,10,22,23,55,-32,22
Peterhead,2694,1,24,4,8,78,38,40,76
Montrose,2694,2,23,7,6,60,37,23,76
Stirling,2694,3,16,7,13,62,53,9,55
Stenhousem'r,2694,4,15,9,12,57,48,9,54
Clyde,2694,5,14,9,13,53,51,2,51
Elgin,2694,6,15,6,15,56,61,-5,51
Annan Athlet,2694,7,11,12,13,48,42,6,45
Berwick,2694,8,9,10,17,32,60,-28,37
Edinburgh Ci,2694,9,7,9,20,36,61,-25,30
Cowdenbeath,2694,10,4,11,21,24,55,-31,23
Montrose,2695,1,24,7,5,61,34,27,79
Peterhead,2695,2,24,4,8,83,38,45,76
Stirling,2695,3,17,6,13,62,52,10,57
Clyde,2695,4,15,9,12,54,49,5,54
Stenhousem'r,2695,5,15,8,13,56,48,8,53
Elgin,2695,6,14,6,16,53,62,-9,48
Annan Athlet,2695,7,11,11,14,48,45,3,44
Berwick,2695,8,8,10,18,30,61,-31,34
Edinburgh Ci,2695,9,7,9,20,36,66,-30,30
Cowdenbeath,2695,10,5,10,21,27,55,-28,25
Peterhead,2696,1,24,4,8,79,39,40,76
Montrose,2696,2,23,7,6,61,37,24,76
Stenhousem'r,2696,3,16,8,12,57,46,11,56
Stirling,2696,4,16,6,14,60,53,7,54
Clyde,2696,5,15,9,12,54,48,6,54
Elgin,2696,6,15,6,15,56,62,-6,51
Annan Athlet,2696,7,11,11,14,48,44,4,44
Berwick,2696,8,8,10,18,29,61,-32,34
Edinburgh Ci,2696,9,7,9,20,37,62,-25,30
Cowdenbeath,2696,10,5,10,21,26,55,-29,25
Montrose,2697,1,24,7,5,62,35,27,79
Peterhead,2697,2,24,4,8,79,39,40,76
Stirling,2697,3,17,6,13,62,51,11,57
Clyde,2697,4,15,9,12,53,49,4,54
Stenhousem'r,2697,5,15,8,13,55,48,7,53
Elgin,2697,6,14,6,16,54,63,-9,48
Annan Athlet,2697,7,12,11,13,50,41,9,47
Berwick,2697,8,8,10,18,30,60,-30,34
Edinburgh Ci,2697,9,7,9,20,37,62,-25,30
Cowdenbeath,2697,10,4,10,22,23,57,-34,22
Montrose,2698,1,24,7,5,62,35,27,79
Peterhead,2698,2,23,4,9,78,40,38,73
Stirling,2698,3,17,6,13,65,51,14,57
Clyde,2698,4,15,9,12,55,48,7,54
Stenhousem'r,2698,5,15,8,13,55,51,4,53
Elgin,2698,6,14,6,16,54,63,-9,48
Annan Athlet,2698,7,11,11,14,47,44,3,44
Berwick,2698,8,8,10,18,29,62,-33,34
Edinburgh Ci,2698,9,8,9,19,38,61,-23,33
Cowdenbeath,2698,10,5,10,21,26,54,-28,25
Montrose,2699,1,23,8,5,60,35,25,77
Peterhead,2699,2,24,4,8,79,39,40,76
Stirling,2699,3,17,6,13,64,52,12,57
Stenhousem'r,2699,4,15,8,13,56,50,6,53
Clyde,2699,5,14,9,13,51,50,1,51
Elgin,2699,6,14,7,15,54,61,-7,49
Annan Athlet,2699,7,12,11,13,48,41,7,47
Berwick,2699,8,9,10,17,31,58,-27,37
Edinburgh Ci,2699,9,7,9,20,37,62,-25,30
Cowdenbeath,2699,10,4,10,22,23,55,-32,22
Montrose,2700,1,23,7,6,60,36,24,76
Peterhead,2700,2,23,4,9,78,40,38,73
Stirling,2700,3,16,7,13,62,53,9,55
Stenhousem'r,2700,4,15,9,12,57,48,9,54
Clyde,2700,5,14,10,12,51,48,3,52
Elgin,2700,6,15,6,15,55,61,-6,51
Annan Athlet,2700,7,11,11,14,49,44,5,44
Berwick,2700,8,8,11,17,29,58,-29,35
Edinburgh Ci,2700,9,8,9,19,38,61,-23,33
Cowdenbeath,2700,10,5,10,21,26,56,-30,25
Montrose,2701,1,24,7,5,63,35,28,79
Peterhead,2701,2,24,4,8,79,38,41,76
Stirling,2701,3,17,6,13,61,51,10,57
Stenhousem'r,2701,4,15,8,13,55,47,8,53
Clyde,2701,5,14,9,13,52,51,1,51
Elgin,2701,6,14,6,16,54,64,-10,48
Annan Athlet,2701,7,11,11,14,47,43,4,44
Berwick,2701,8,9,10,17,32,59,-27,37
Edinburgh Ci,2701,9,7,9,20,36,62,-26,30
Cowdenbeath,2701,10,5,10,21,25,54,-29,25
Montrose,2702,1,23,8,5,59,34,25,77
Peterhead,2702,2,23,5,8,78,39,39,74
Stirling,2702,3,17,6,13,64,51,13,57
Stenhousem'r,2702,4,15,8,13,55,50,5,53
Clyde,2702,5,14,10,12,51,48,3,52
Elgin,2702,6,14,7,15,53,60,-7,49
Annan Athlet,2702,7,12,11,13,49,42,7,47
Berwick,2702,8,8,11,17,29,58,-29,35
Edinburgh Ci,2702,9,7,10,19,37,61,-24,31
Cowdenbeath,2702,10,4,10,22,24,56,-32,22
Montrose,2703,1,24,7,5,63,34,29,79
Peterhead,2703,2,24,4,8,82,38,44,76
Stirling,2703,3,16,7,13,62,53,9,55
Stenhousem'r,2703,4,15,9,12,57,48,9,54
Clyde,2703,5,15,9,12,53,48,5,54
Elgin,2703,6,14,6,16,53,64,-11,48
Annan Athlet,2703,7,11,12,13,48,42,6,45
Berwick,2703,8,8,10,18,29,60,-31,34
Edinburgh Ci,2703,9,7,9,20,36,65,-29,30
Cowdenbeath,2703,10,4,11,21,24,55,-31,23
Montrose,2704,1,24,7,5,61,35,26,79
Peterhead,2704,2,24,4,8,84,40,44,76
Stirling,2704,3,17,6,13,62,51,11,57
Stenhousem'r,2704,4,15,8,13,55,48,7,53
Clyde,2704,5,14,9,13,51,49,2,51
Elgin,2704,6,14,6,16,54,62,-8,48
Annan Athlet,2704,7,12,11,13,49,42,7,47
Berwick,2704,8,9,10,17,30,58,-28,37
Edinburgh Ci,2704,9,7,9,20,38,67,-29,30
Cowdenbeath,2704,10,4,10,22,24,56,-32,22
Peterhead,2705,1,24,4,8,81,38,43,76
Montrose,2705,2,23,7,6,59,35,24,76
Stirling,2705,3,16,7,13,62,53,9,55
Stenhousem'r,2705,4,15,9,12,57,48,9,54
Clyde,2705,5,14,9,13,52,53,-1,51
Elgin,2705,6,15,6,15,54,60,-6,51
Annan Athlet,2705,7,11,12,13,47,41,6,45
Berwick,2705,8,9,10,17,34,59,-25,37
Edinburgh Ci,2705,9,7,9,20,36,64,-28,30
Cowdenbeath,2705,10,4,11,21,23,54,-31,23
Montrose,2706,1,24,7,5,62,35,27,79
Peterhead,2706,2,24,4,8,79,38,41,76
Stirling,2706,3,17,6,13,61,51,10,57
Clyde,2706,4,15,9,12,54,49,5,54
Stenhousem'r,2706,5,15,8,13,55,47,8,53
Elgin,2706,6,14,6,16,54,63,-9,48
Annan Athlet,2706,7,12,11,13,48,41,7,47
Berwick,2706,8,8,10,18,30,61,-31,34
Edinburgh Ci,2706,9,7,9,20,36,62,-26,30
Cowdenbeath,2706,10,4,10,22,23,55,-32,22
Peterhead,2707,1,24,4,8,81,39,42,76
Montrose,2707,2,23,7,6,61,38,23,76
Stenhousem'r,2707,3,16,8,12,57,47,10,56
Stirling,2707,4,16,6,14,61,53,8,54
Clyde,2707,5,14,10,12,52,49,3,52
Elgin,2707,6,15,6,15,57,62,-5,51
Annan Athlet,2707,7,12,11,13,48,41,7,47
Berwick,2707,8,8,11,17,30,59,-29,35
Edinburgh Ci,2707,9,7,9,20,37,64,-27,30
Cowdenbeath,2707,10,4,10,22,23,55,-32,22
Montrose,2708,1,24,7,5,61,34,27,79
Peterhead,2708,2,24,4,8,83,39,44,76
Stirling,2708,3,17,6,13,62,52,10,57
Stenhousem'r,2708,4,15,8,13,56,48,8,53
Clyde,2708,5,14,9,13,51,50,1,51
Elgin,2708,6,14,6,16,53,62,-9,48
Annan Athlet,2708,7,12,11,13,48,41,7,47
Berwick,2708,8,9,10,17,31,58,-27,37
Edinburgh Ci,2708,9,7,9,20,37,66,-29,30
Cowdenbeath,2708,10,4,10,22,23,55,-32,22
Peterhead,2709,1,24,4,8,81,39,42,76
Montrose,2709,2,23,7,6,61,37,24,76
Stirling,2709,3,17,6,13,61,51,10,57
Clyde,2709,4,15,9,12,53,48,5,54
Stenhousem'r,2709,5,15,8,13,55,47,8,53
Elgin,2709,6,15,6,15,56,62,-6,51
Annan Athlet,2709,7,11,11,14,47,43,4,44
Berwick,2709,8,8,10,18,29,60,-31,34
Edinburgh Ci,2709,9,7,9,20,37,64,-27,30
Cowdenbeath,2709,10,5,10,21,25,54,-29,25
Montrose,2710,1,24,7,5,62,34,28,79
Peterhead,2710,2,24,4,8,80,39,41,76
Stirling,2710,3,17,6,13,61,51,10,57
Clyde,2710,4,15,9,12,56,48,8,54
Stenhousem'r,2710,5,15,8,13,55,47,8,53
Elgin,2710,6,14,6,16,53,63,-10,48
Annan Athlet,2710,7,12,11,13,48,41,7,47
Berwick,2710,8,8,10,18,29,63,-34,34
Edinburgh Ci,2710,9,7,9,20,37,63,-26,30
Cowdenbeath,2710,10,4,10,22,23,55,-32,22
Montrose,2711,1,23,8,5,60,35,25,77
Peterhead,2711,2,23,5,8,78,39,39,74
Stirling,2711,3,17,6,13,62,51,11,57
Clyde,2711,4,15,9,12,56,49,7,54
Stenhousem'r,2711,5,15,8,13,55,48,7,53
Elgin,2711,6,14,7,15,54,61,-7,49
Annan Athlet,2711,7,11,12,13,48,42,6,45
Berwick,2711,8,8,10,18,30,63,-33,34
Edinburgh Ci,2711,9,7,10,19,37,61,-24,31
Cowdenbeath,2711,10,4,11,21,24,55,-31,23
Montrose,2712,1,24,7,5,62,35,27,79
Peterhead,2712,2,24,4,8,80,39,41,76
Stenhousem'r,2712,3,16,8,12,57,46,11,56
Stirling,2712,4,16,6,14,60,53,7,54
Clyde,2712,5,15,9,12,53,48,5,54
Elgin,2712,6,14,6,16,54,63,-9,48
Annan Athlet,2712,7,11,12,13,49,43,6,45
Berwick,2712,8,8,10,18,29,60,-31,34
Edinburgh Ci,2712,9,7,9,20,37,63,-26,30
Cowdenbeath,2712,10,4,11,21,25,56,-31,23
Montrose,2713,1,23,8,5,60,35,25,77
Peterhead,2713,2,23,5,8,78,39,39,74
Stenhousem'r,2713,3,16,8,12,56,46,10,56
Stirling,2713,4,16,6,14,60,52,8,54
Clyde,2713,5,14,10,12,52,49,3,52
Elgin,2713,6,14,7,15,54,61,-7,49
Annan Athlet,2713,7,11,11,14,47,42,5,44
Berwick,2713,8,8,11,17,30,59,-29,35
Edinburgh Ci,2713,9,7,10,19,37,61,-24,31
Cowdenbeath,2713,10,5,10,21,24,54,-30,25
Montrose,2714,1,24,7,5,62,36,26,79
Peterhead,2714,2,23,5,8,78,39,39,74
Stirling,2714,3,17,6,13,63,53,10,57
Stenhousem'r,2714,4,15,8,13,57,49,8,53
Clyde,2714,5,14,9,13,51,49,2,51
Elgin,2714,6,14,6,16,55,63,-8,48
Annan Athlet,2714,7,11,12,13,48,42,6,45
Berwick,2714,8,9,10,17,30,58,-28,37
Edinburgh Ci,2714,9,7,10,19,37,61,-24,31
Cowdenbeath,2714,10,4,11,21,24,55,-31,23
Montrose,2715,1,24,7,5,61,34,27,79
Peterhead,2715,2,24,4,8,80,39,41,76
Stenhousem'r,2715,3,16,8,12,57,47,10,56
Stirling,2715,4,16,6,14,61,53,8,54
Clyde,2715,5,15,9,12,56,50,6,54
Elgin,2715,6,14,6,16,53,62,-9,48
Annan Athlet,2715,7,11,11,14,48,44,4,44
Berwick,2715,8,8,10,18,31,63,-32,34
Edinburgh Ci,2715,9,7,9,20,37,63,-26,30
Cowdenbeath,2715,10,5,10,21,26,55,-29,25
Peterhead,2716,1,24,4,8,80,40,40,76
Montrose,2716,2,23,7,6,59,35,24,76
Stirling,2716,3,17,6,13,63,52,11,57
Stenhousem'r,2716,4,15,8,13,56,49,7,53
Clyde,2716,5,14,9,13,51,49,2,51
Elgin,2716,6,15,6,15,54,60,-6,51
Annan Athlet,2716,7,11,11,14,47,43,4,44
Berwick,2716,8,9,10,17,30,58,-28,37
Edinburgh Ci,2716,9,7,9,20,38,63,-25,30
Cowdenbeath,2716,10,5,10,21,25,54,-29,25
Montrose,2717,1,24,7,5,62,34,28,79
Peterhead,2717,2,24,4,8,82,39,43,76
Stenhousem'r,2717,3,16,8,12,58,48,10,56
Stirling,2717,4,16,6,14,62,54,8,54
Clyde,2717,5,14,9,13,51,49,2,51
Elgin,2717,6,14,6,16,53,63,-10,48
Annan Athlet,2717,7,12,11,13,48,41,7,47
Berwick,2717,8,9,10,17,30,58,-28,37
Edinburgh Ci,2717,9,7,9,20,37,65,-28,30
Cowdenbeath,2717,10,4,10,22,23,55,-32,22
Montrose,2718,1,24,7,5,62,35,27,79
Peterhead,2718,2,24,4,8,80,39,41,76
Stirling,2718,3,17,6,13,63,51,12,57
Stenhousem'r,2718,4,15,8,13,55,49,6,53
Clyde,2718,5,14,9,13,53,51,2,51
Elgin,2718,6,14,6,16,54,63,-9,48
Annan Athlet,2718,7,11,12,13,49,43,6,45
Berwick,2718,8,9,10,17,32,60,-28,37
Edinburgh Ci,2718,9,7,9,20,37,63,-26,30
Cowdenbeath,2718,10,4,11,21,25,56,-31,23
Montrose,2719,1,23,8,5,61,36,25,77
Peterhead,2719,2,23,5,8,79,40,39,74
Stirling,2719,3,17,6,13,63,51,12,57
Stenhousem'r,2719,4,15,8,13,55,49,6,53
Clyde,2719,5,14,9,13,52,51,1,51
Elgin,2719,6,14,7,15,55,62,-7,49
Annan Athlet,2719,7,12,11,13,50,43,7,47
Berwick,2719,8,9,10,17,32,59,-27,37
Edinburgh Ci,2719,9,7,10,19,38,62,-24,31
Cowdenbeath,2719,10,4,10,22,25,57,-32,22
Peterhead,2720,1,24,4,8,82,39,43,76
Montrose,2720,2,23,7,6,59,35,24,76
Stirling,2720,3,16,7,13,62,53,9,55
Stenhousem'r,2720,4,15,9,12,57,48,9,54
Clyde,2720,5,14,9,13,52,50,2,51
Elgin,2720,6,15,6,15,54,60,-6,51
Annan Athlet,2720,7,11,11,14,48,45,3,44
Berwick,2720,8,9,10,17,31,59,-28,37
Edinburgh Ci,2720,9,7,9,20,37,65,-28,30
Cowdenbeath,2720,10,5,10,21,27,55,-28,25
Montrose,2721,1,24,7,5,63,34,29,79
Peterhead,2721,2,24,4,8,80,38,42,76
Stirling,2721,3,16,7,13,62,53,9,55
Stenhousem'r,2721,4,15,9,12,57,48,9,54
Clyde,2721,5,15,9,12,55,50,5,54
Elgin,2721,6,14,6,16,53,64,-11,48
Annan Athlet,2721,7,11,12,13,49,43,6,45
Berwick,2721,8,8,10,18,31,62,-31,34
Edinburgh Ci,2721,9,7,9,20,36,63,-27,30
Cowdenbeath,2721,10,4,11,21,25,56,-31,23
Montrose,2722,1,24,7,5,61,35,26,79
Peterhead,2722,2,23,5,8,78,39,39,74
Stenhousem'r,2722,3,16,8,12,57,47,10,56
Stirling,2722,4,16,6,14,61,53,8,54
Clyde,2722,5,15,9,12,54,48,6,54
Elgin,2722,6,14,6,16,54,62,-8,48
Annan Athlet,2722,7,11,11,14,48,43,5,44
Berwick,2722,8,8,10,18,29,61,-32,34
Edinburgh Ci,2722,9,7,10,19,37,61,-24,31
Cowdenbeath,2722,10,5,10,21,25,55,-30,25
Montrose,2723,1,23,8,5,60,35,25,77
Peterhead,2723,2,24,4,8,79,39,40,76
Stirling,2723,3,16,7,13,62,53,9,55
Stenhousem'r,2723,4,15,9,12,57,48,9,54
Clyde,2723,5,14,9,13,53,51,2,51
Elgin,2723,6,14,7,15,54,61,-7,49
Annan Athlet,2723,7,12,11,13,50,42,8,47
Berwick,2723,8,9,10,17,32,60,-28,37
Edinburgh Ci,2723,9,7,9,20,37,62,-25,30
Cowdenbeath,2723,10,4,10,22,24,57,-33,22
Montrose,2724,1,23,8,5,59,34,25,77
Peterhead,2724,2,24,4,8,81,39,42,76
Stirling,2724,3,17,6,13,63,51,12,57
Stenhousem'r,2724,4,15,8,13,55,49,6,53
Clyde,2724,5,14,10,12,52,49,3,52
Elgin,2724,6,14,7,15,53,60,-7,49
Annan Athlet,2724,7,11,12,13,47,41,6,45
Berwick,2724,8,8,11,17,30,59,-29,35
Edinburgh Ci,2724,9,7,9,20,37,64,-27,30
Cowdenbeath,2724,10,4,11,21,23,54,-31,23
Montrose,2725,1,24,7,5,62,34,28,79
Peterhead,2725,2,24,4,8,79,38,41,76
Stirling,2725,3,17,6,13,63,52,11,57
Clyde,2725,4,15,9,12,54,49,5,54
Stenhousem'r,2725,5,15,8,13,56,49,7,53
Elgin,2725,6,14,6,16,53,63,-10,48
Annan Athlet,2725,7,12,11,13,51,43,8,47
Berwick,2725,8,8,10,18,30,61,-31,34
Edinburgh Ci,2725,9,7,9,20,36,62,-26,30
Cowdenbeath,2725,10,4,10,22,25,58,-33,22
Montrose,2726,1,23,8,5,59,34,25,77
Peterhead,2726,2,24,4,8,82,42,40,76
Stirling,2726,3,16,7,13,62,53,9,55
Stenhousem'r,2726,4,15,9,12,57,48,9,54
Clyde,2726,5,15,9,12,52,48,4,54
Elgin,2726,6,14,7,15,53,60,-7,49
Annan Athlet,2726,7,12,11,13,51,41,10,47
Berwick,2726,8,8,10,18,29,59,-30,34
Edinburgh Ci,2726,9,7,9,20,40,65,-25,30
Cowdenbeath,2726,10,4,10,22,23,58,-35,22
Peterhead,2727,1,24,4,8,81,40,41,76
Montrose,2727,2,23,7,6,60,37,23,76
Stirling,2727,3,16,7,13,61,52,9,55
Stenhousem'r,2727,4,15,9,12,56,47,9,54
Clyde,2727,5,14,9,13,52,51,1,51
Elgin,2727,6,15,6,15,56,61,-5,51
Annan Athlet,2727,7,12,11,13,50,41,9,47
Berwick,2727,8,9,10,17,32,59,-27,37
Edinburgh Ci,2727,9,7,9,20,38,64,-26,30
Cowdenbeath,2727,10,4,10,22,23,57,-34,22
Montrose,2728,1,23,8,5,59,34,25,77
Peterhead,2728,2,23,5,8,78,39,39,74
Stirling,2728,3,16,7,13,61,52,9,55
Stenhousem'r,2728,4,15,9,12,56,47,9,54
Clyde,2728,5,14,9,13,52,50,2,51
Elgin,2728,6,14,7,15,53,60,-7,49
Annan Athlet,2728,7,12,11,13,49,41,8,47
Berwick,2728,8,9,10,17,31,59,-28,37
Edinburgh Ci,2728,9,7,10,19,37,61,-24,31
Cowdenbeath,2728,10,4,10,22,23,56,-33,22
Peterhead,2729,1,24,4,8,78,38,40,76
Montrose,2729,2,23,7,6,59,35,24,76
Stirling,2729,3,17,6,13,64,54,10,57
Clyde,2729,4,15,9,12,53,48,5,54
Stenhousem'r,2729,5,15,8,13,58,50,8,53
Elgin,2729,6,15,6,15,54,60,-6,51
Annan Athlet,2729,7,12,11,13,48,41,7,47
Berwick,2729,8,8,10,18,29,60,-31,34
Edinburgh Ci,2729,9,7,9,20,36,61,-25,30
Cowdenbeath,2729,10,4,10,22,23,55,-32,22
Montrose,2730,1,24,7,5,62,34,28,79
Peterhead,2730,2,24,4,8,80,38,42,76
Stirling,2730,3,17,6,13,61,51,10,57
Stenhousem'r,2730,4,15,8,13,55,47,8,53
Clyde,2730,5,14,10,12,53,50,3,52
Elgin,2730,6,14,6,16,53,63,-10,48
Annan Athlet,2730,7,11,12,13,47,41,6,45
Berwick,2730,8,8,11,17,31,60,-29,35
Edinburgh Ci,2730,9,7,9,20,36,63,-27,30
Cowdenbeath,2730,10,4,11,21,23,54,-31,23
Montrose,2731,1,24,7,5,62,34,28,79
Peterhead,2731,2,23,4,9,77,40,37,73
Stirling,2731,3,16,7,13,61,52,9,55
Stenhousem'r,2731,4,15,9,12,56,47,9,54
Clyde,2731,5,14,10,12,54,51,3,52
Elgin,2731,6,14,6,16,53,63,-10,48
Annan Athlet,2731,7,12,11,13,51,41,10,47
Berwick,2731,8,8,11,17,32,61,-29,35
Edinburgh Ci,2731,9,8,9,19,38,60,-22,33
Cowdenbeath,2731,10,4,10,22,23,58,-35,22
Montrose,2732,1,24,7,5,64,36,28,79
Peterhead,2732,2,23,4,9,77,39,38,73
Stirling,2732,3,17,6,13,62,52,10,57
Stenhousem'r,2732,4,15,8,13,56,48,8,53
Clyde,2732,5,14,10,12,51,48,3,52
Elgin,2732,6,14,6,16,55,65,-10,48
Annan Athlet,2732,7,12,11,13,51,42,9,47
Berwick,2732,8,8,11,17,29,58,-29,35
Edinburgh Ci,2732,9,8,9,19,37,60,-23,33
Cowdenbeath,2732,10,4,10,22,24,58,-34,22
Montrose,2733,1,24,7,5,60,34,26,79
Peterhead,2733,2,24,4,8,80,40,40,76
Stirling,2733,3,17,6,13,64,51,13,57
Stenhousem'r,2733,4,15,8,13,55,50,5,53
Clyde,2733,5,14,10,12,52,49,3,52
Elgin,2733,6,14,6,16,53,61,-8,48
Annan Athlet,2733,7,11,12,13,48,42,6,45
Berwick,2733,8,8,11,17,30,59,-29,35
Edinburgh Ci,2733,9,7,9,20,38,63,-25,30
Cowdenbeath,2733,10,4,11,21,24,55,-31,23
Peterhead,2734,1,24,4,8,78,38,40,76
Montrose,2734,2,23,7,6,60,37,23,76
Stirling,2734,3,16,7,13,61,52,9,55
Stenhousem'r,2734,4,15,9,12,56,47,9,54
Clyde,2734,5,14,10,12,51,48,3,52
Elgin,2734,6,15,6,15,56,61,-5,51
Annan Athlet,2734,7,11,11,14,47,46,1,44
Berwick,2734,8,8,11,17,29,58,-29,35
Edinburgh Ci,2734,9,7,9,20,36,61,-25,30
Cowdenbeath,2734,10,5,10,21,28,54,-26,25
Montrose,2735,1,23,8,5,61,36,25,77
Peterhead,2735,2,24,4,8,79,38,41,76
Stirling,2735,3,17,6,13,65,51,14,57
Clyde,2735,4,15,9,12,53,49,4,54
Stenhousem'r,2735,5,15,8,13,55,51,4,53
Elgin,2735,6,14,7,15,55,62,-7,49
Annan Athlet,2735,7,12,11,13,49,41,8,47
Berwick,2735,8,8,10,18,30,60,-30,34
Edinburgh Ci,2735,9,7,9,20,36,62,-26,30
Cowdenbeath,2735,10,4,10,22,23,56,-33,22
Montrose,2736,1,23,8,5,60,35,25,77
Peterhead,2736,2,24,4,8,80,39,41,76
Stirling,2736,3,17,6,13,64,51,13,57
Stenhousem'r,2736,4,15,8,13,55,50,5,53
Clyde,2736,5,14,9,13,51,49,2,51
Elgin,2736,6,14,7,15,54,61,-7,49
Annan Athlet,2736,7,11,11,14,47,43,4,44
Berwick,2736,8,9,10,17,30,58,-28,37
Edinburgh Ci,2736,9,7,9,20,37,63,-26,30
Cowdenbeath,2736,10,5,10,21,25,54,-29,25
Montrose,2737,1,24,7,5,64,35,29,79
Peterhead,2737,2,24,4,8,78,38,40,76
Stirling,2737,3,17,6,13,65,52,13,57
Stenhousem'r,2737,4,15,8,13,56,51,5,53
Clyde,2737,5,14,9,13,52,50,2,51
Elgin,2737,6,14,6,16,54,65,-11,48
Annan Athlet,2737,7,12,11,13,51,42,9,47
Berwick,2737,8,9,10,17,31,59,-28,37
Edinburgh Ci,2737,9,7,9,20,36,61,-25,30
Cowdenbeath,2737,10,4,10,22,24,58,-34,22
Montrose,2738,1,24,7,5,63,36,27,79
Peterhead,2738,2,24,4,8,79,38,41,76
Stirling,2738,3,17,6,13,63,52,11,57
Stenhousem'r,2738,4,15,8,13,56,49,7,53
Clyde,2738,5,14,10,12,51,48,3,52
Elgin,2738,6,14,6,16,55,64,-9,48
Annan Athlet,2738,7,11,11,14,47,45,2,44
Berwick,2738,8,8,11,17,29,58,-29,35
Edinburgh Ci,2738,9,7,9,20,36,62,-26,30
Cowdenbeath,2738,10,5,10,21,27,54,-27,25
Montrose,2739,1,23,8,5,61,36,25,77
Peterhead,2739,2,24,4,8,80,38,42,76
Stenhousem'r,2739,3,16,8,12,57,47,10,56
Stirling,2739,4,16,6,14,61,53,8,54
Clyde,2739,5,14,10,12,51,48,3,52
Elgin,2739,6,14,7,15,55,62,-7,49
Annan Athlet,2739,7,11,11,14,48,43,5,44
Berwick,2739,8,8,11,17,29,58,-29,35
Edinburgh Ci,2739,9,7,9,20,36,63,-27,30
Cowdenbeath,2739,10,5,10,21,25,55,-30,25
Peterhead,2740,1,24,4,8,83,38,45,76
Montrose,2740,2,23,7,6,60,36,24,76
Stirling,2740,3,17,6,13,62,51,11,57
Clyde,2740,4,15,9,12,53,49,4,54
Stenhousem'r,2740,5,15,8,13,55,48,7,53
Elgin,2740,6,15,6,15,55,61,-6,51
Annan Athlet,2740,7,12,11,13,48,41,7,47
Berwick,2740,8,8,10,18,30,60,-30,34
Edinburgh Ci,2740,9,7,9,20,36,66,-30,30
Cowdenbeath,2740,10,4,10,22,23,55,-32,22
Montrose,2741,1,23,8,5,60,35,25,77
Peterhead,2741,2,24,4,8,78,38,40,76
Stirling,2741,3,17,6,13,61,51,10,57
Stenhousem'r,2741,4,15,8,13,55,47,8,53
Clyde,2741,5,14,10,12,51,48,3,52
Elgin,2741,6,14,7,15,54,61,-7,49
Annan Athlet,2741,7,11,12,13,48,42,6,45
Berwick,2741,8,8,11,17,29,58,-29,35
Edinburgh Ci,2741,9,7,9,20,36,61,-25,30
Cowdenbeath,2741,10,4,11,21,24,55,-31,23
Montrose,2742,1,23,8,5,60,35,25,77
Peterhead,2742,2,24,4,8,82,39,43,76
Stenhousem'r,2742,3,16,8,12,57,47,10,56
Stirling,2742,4,16,6,14,61,53,8,54
Clyde,2742,5,15,9,12,53,49,4,54
Elgin,2742,6,14,7,15,54,61,-7,49
Annan Athlet,2742,7,11,11,14,48,43,5,44
Berwick,2742,8,8,10,18,30,60,-30,34
Edinburgh Ci,2742,9,7,9,20,37,65,-28,30
Cowdenbeath,2742,10,5,10,21,25,55,-30,25
Peterhead,2743,1,24,4,8,78,38,40,76
Montrose,2743,2,23,7,6,59,36,23,76
Stirling,2743,3,17,6,13,62,51,11,57
Stenhousem'r,2743,4,15,8,13,55,48,7,53
Clyde,2743,5,14,9,13,51,49,2,51
Elgin,2743,6,15,6,15,55,60,-5,51
Annan Athlet,2743,7,11,12,13,49,43,6,45
Berwick,2743,8,9,10,17,30,58,-28,37
Edinburgh Ci,2743,9,7,9,20,36,61,-25,30
Cowdenbeath,2743,10,4,11,21,25,56,-31,23
Montrose,2744,1,24,7,5,61,34,27,79
Peterhead,2744,2,24,4,8,83,39,44,76
Stirling,2744,3,17,6,13,63,53,10,57
Clyde,2744,4,15,9,12,52,48,4,54
Stenhousem'r,2744,5,15,8,13,57,49,8,53
Elgin,2744,6,14,6,16,53,62,-9,48
Annan Athlet,2744,7,12,11,13,50,43,7,47
Berwick,2744,8,8,10,18,29,59,-30,34
Edinburgh Ci,2744,9,7,9,20,37,66,-29,30
Cowdenbeath,2744,10,4,10,22,25,57,-32,22
Montrose,2745,1,24,7,5,64,34,30,79
Peterhead,2745,2,24,4,8,79,38,41,76
Stenhousem'r,2745,3,16,8,12,56,46,10,56
Stirling,2745,4,16,6,14,60,52,8,54
Clyde,2745,5,15,9,12,56,49,7,54
Elgin,2745,6,14,6,16,53,65,-12,48
Annan Athlet,2745,7,12,11,13,49,42,7,47
Berwick,2745,8,8,10,18,30,63,-33,34
Edinburgh Ci,2745,9,7,9,20,36,62,-26,30
Cowdenbeath,2745,10,4,10,22,24,56,-32,22
Peterhead,2746,1,24,4,8,79,39,40,76
Montrose,2746,2,23,7,6,59,35,24,76
Stirling,2746,3,16,7,13,61,52,9,55
Stenhousem'r,2746,4,15,9,12,56,47,9,54
Clyde,2746,5,15,9,12,52,48,4,54
Elgin,2746,6,15,6,15,54,60,-6,51
Annan Athlet,2746,7,11,11,14,48,44,4,44
Berwick,2746,8,8,10,18,29,59,-30,34
Edinburgh Ci,2746,9,7,9,20,37,62,-25,30
Cowdenbeath,2746,10,5,10,21,26,55,-29,25
Montrose,2747,1,23,8,5,62,37,25,77
Peterhead,2747,2,24,4,8,81,38,43,76
Stenhousem'r,2747,3,16,8,12,57,46,11,56
Stirling,2747,4,16,6,14,60,53,7,54
Clyde,2747,5,15,9,12,53,48,5,54
Elgin,2747,6,14,7,15,56,63,-7,49
Annan Athlet,2747,7,12,11,13,48,41,7,47
Berwick,2747,8,8,10,18,29,60,-31,34
Edinburgh Ci,2747,9,7,9,20,36,64,-28,30
Cowdenbeath,2747,10,4,10,22,23,55,-32,22
Montrose,2748,1,23,8,5,60,35,25,77
Peterhead,2748,2,24,4,8,79,38,41,76
Stenhousem'r,2748,3,16,8,12,57,46,11,56
Stirling,2748,4,16,6,14,60,53,7,54
Clyde,2748,5,15,9,12,53,48,5,54
Elgin,2748,6,14,7,15,54,61,-7,49
Annan Athlet,2748,7,11,11,14,47,42,5,44
Berwick,2748,8,8,10,18,29,60,-31,34
Edinburgh Ci,2748,9,7,9,20,36,62,-26,30
Cowdenbeath,2748,10,5,10,21,24,54,-30,25
Montrose,2749,1,24,7,5,63,35,28,79
Peterhead,2749,2,24,4,8,79,39,40,76
Stenhousem'r,2749,3,16,8,12,58,47,11,56
Stirling,2749,4,16,6,14,61,54,7,54
Clyde,2749,5,15,9,12,53,49,4,54
Elgin,2749,6,14,6,16,54,64,-10,48
Annan Athlet,2749,7,12,11,13,49,42,7,47
Berwick,2749,8,8,10,18,30,60,-30,34
Edinburgh Ci,2749,9,7,9,20,37,62,-25,30
Cowdenbeath,2749,10,4,10,22,24,56,-32,22
Montrose,2750,1,24,7,5,62,35,27,79
Peterhead,2750,2,24,4,8,81,39,42,76
Stirling,2750,3,16,7,13,61,52,9,55
Stenhousem'r,2750,4,15,9,12,56,47,9,54
Clyde,2750,5,15,9,12,52,48,4,54
Elgin,2750,6,14,6,16,54,63,-9,48
Annan Athlet,2750,7,11,11,14,47,43,4,44
Berwick,2750,8,8,10,18,29,59,-30,34
Edinburgh Ci,2750,9,7,9,20,37,64,-27,30
Cowdenbeath,2750,10,5,10,21,25,54,-29,25
Montrose,2751,1,23,8,5,62,37,25,77
Peterhead,2751,2,23,5,8,77,38,39,74
Stirling,2751,3,17,6,13,61,51,10,57
Clyde,2751,4,15,9,12,52,48,4,54
Stenhousem'r,2751,5,15,8,13,55,47,8,53
Elgin,2751,6,14,7,15,56,63,-7,49
Annan Athlet,2751,7,12,11,13,48,41,7,47
Berwick,2751,8,8,10,18,29,59,-30,34
Edinburgh Ci,2751,9,7,10,19,36,60,-24,31
Cowdenbeath,2751,10,4,10,22,23,55,-32,22
Montrose,2752,1,24,7,5,61,35,26,79
Peterhead,2752,2,24,4,8,79,39,40,76
Stirling,2752,3,17,6,13,63,52,11,57
Stenhousem'r,2752,4,15,8,13,56,49,7,53
Clyde,2752,5,14,10,12,52,49,3,52
Elgin,2752,6,14,6,16,54,62,-8,48
Annan Athlet,2752,7,12,11,13,49,41,8,47
Berwick,2752,8,8,11,17,30,59,-29,35
Edinburgh Ci,2752,9,7,9,20,37,62,-25,30
Cowdenbeath,2752,10,4,10,22,23,56,-33,22
Montrose,2753,1,24,7,5,62,34,28,79
Peterhead,2753,2,24,4,8,81,39,42,76
Stenhousem'r,2753,3,16,8,12,56,46,10,56
Stirling,2753,4,16,6,14,60,52,8,54
Clyde,2753,5,14,10,12,51,48,3,52
Elgin,2753,6,14,6,16,53,63,-10,48
Annan Athlet,2753,7,12,11,13,48,41,7,47
Berwick,2753,8,8,11,17,29,58,-29,35
Edinburgh Ci,2753,9,7,9,20,37,64,-27,30
Cowdenbeath,2753,10,4,10,22,23,55,-32,22
Montrose,2754,1,23,7,6,59,35,24,76
Peterhead,2754,2,23,4,9,79,41,38,73
Stirling,2754,3,17,6,13,61,51,10,57
Stenhousem'r,2754,4,15,8,13,55,47,8,53
Clyde,2754,5,14,10,12,51,48,3,52
Elgin,2754,6,15,6,15,54,60,-6,51
Annan Athlet,2754,7,11,12,13,48,42,6,45
Berwick,2754,8,8,11,17,29,58,-29,35
Edinburgh Ci,2754,9,8,9,19,39,62,-23,33
Cowdenbeath,2754,10,4,11,21,24,55,-31,23
Montrose,2755,1,24,7,5,62,35,27,79
Peterhead,2755,2,24,4,8,79,38,41,76
Stirling,2755,3,16,7,13,61,52,9,55
Stenhousem'r,2755,4,15,9,12,56,47,9,54
Clyde,2755,5,15,9,12,54,50,4,54
Elgin,2755,6,14,6,16,54,63,-9,48
Annan Athlet,2755,7,12,11,13,49,42,7,47
Berwick,2755,8,8,10,18,31,61,-30,34
Edinburgh Ci,2755,9,7,9,20,36,62,-26,30
Cowdenbeath,2755,10,4,10,22,24,56,-32,22
Montrose,2756,1,24,7,5,61,34,27,79
Peterhead,2756,2,23,4,9,78,41,37,73
Stirling,2756,3,17,6,13,63,51,12,57
Clyde,2756,4,15,9,12,55,51,4,54
Stenhousem'r,2756,5,15,8,13,55,49,6,53
Elgin,2756,6,14,6,16,53,62,-9,48
Annan Athlet,2756,7,11,11,14,48,44,4,44
Berwick,2756,8,8,10,18,32,62,-30,34
Edinburgh Ci,2756,9,8,9,19,39,61,-22,33
Cowdenbeath,2756,10,5,10,21,26,55,-29,25
Montrose,2757,1,23,8,5,61,36,25,77
Peterhead,2757,2,24,4,8,83,38,45,76
Stirling,2757,3,16,7,13,60,51,9,55
Stenhousem'r,2757,4,15,9,12,55,46,9,54
Clyde,2757,5,14,10,12,54,51,3,52
Elgin,2757,6,14,7,15,55,62,-7,49
Annan Athlet,2757,7,12,11,13,50,42,8,47
Berwick,2757,8,8,11,17,32,61,-29,35
Edinburgh Ci,2757,9,7,9,20,36,66,-30,30
Cowdenbeath,2757,10,4,10,22,24,57,-33,22
Montrose,2758,1,23,7,6,61,37,24,76
Peterhead,2758,2,23,5,8,79,40,39,74
Stirling,2758,3,17,6,13,61,51,10,57
Stenhousem'r,2758,4,15,8,13,55,47,8,53
Clyde,2758,5,14,9,13,53,51,2,51
Elgin,2758,6,15,6,15,56,62,-6,51
Annan Athlet,2758,7,11,11,14,47,42,5,44
Berwick,2758,8,9,10,17,32,60,-28,37
Edinburgh Ci,2758,9,7,10,19,38,62,-24,31
Cowdenbeath,2758,10,5,10,21,24,54,-30,25
Montrose,2759,1,24,7,5,60,34,26,79
Peterhead,2759,2,24,4,8,80,38,42,76
Stenhousem'r,2759,3,16,8,12,57,47,10,56
Stirling,2759,4,16,6,14,61,53,8,54
Clyde,2759,5,14,9,13,51,49,2,51
Elgin,2759,6,14,6,16,53,61,-8,48
Annan Athlet,2759,7,11,12,13,48,42,6,45
Berwick,2759,8,9,10,17,30,58,-28,37
Edinburgh Ci,2759,9,7,9,20,36,63,-27,30
Cowdenbeath,2759,10,4,11,21,24,55,-31,23
Montrose,2760,1,24,7,5,61,34,27,79
Peterhead,2760,2,23,5,8,78,39,39,74
Stirling,2760,3,17,6,13,62,52,10,57
Clyde,2760,4,15,9,12,53,49,4,54
Stenhousem'r,2760,5,15,8,13,56,48,8,53
Elgin,2760,6,14,6,16,53,62,-9,48
Annan Athlet,2760,7,11,12,13,48,42,6,45
Berwick,2760,8,8,10,18,30,60,-30,34
Edinburgh Ci,2760,9,7,10,19,37,61,-24,31
Cowdenbeath,2760,10,4,11,21,24,55,-31,23
Montrose,2761,1,23,8,5,60,35,25,77
Peterhead,2761,2,24,4,8,80,38,42,76
Stirling,2761,3,17,6,13,63,53,10,57
Clyde,2761,4,15,9,12,54,48,6,54
Stenhousem'r,2761,5,15,8,13,57,49,8,53
Elgin,2761,6,14,7,15,54,61,-7,49
Annan Athlet,2761,7,12,11,13,48,41,7,47
Berwick,2761,8,8,10,18,29,61,-32,34
Edinburgh Ci,2761,9,7,9,20,36,63,-27,30
Cowdenbeath,2761,10,4,10,22,23,55,-32,22
Montrose,2762,1,23,8,5,61,36,25,77
Peterhead,2762,2,23,4,9,77,41,36,73
Stenhousem'r,2762,3,16,8,12,57,47,10,56
Stirling,2762,4,16,6,14,61,53,8,54
Clyde,2762,5,14,10,12,53,50,3,52
Elgin,2762,6,14,7,15,55,62,-7,49
Annan Athlet,2762,7,11,12,13,48,42,6,45
Berwick,2762,8,8,11,17,31,60,-29,35
Edinburgh Ci,2762,9,8,9,19,39,60,-21,33
Cowdenbeath,2762,10,4,11,21,24,55,-31,23
Montrose,2763,1,23,8,5,60,35,25,77
Peterhead,2763,2,23,5,8,78,39,39,74
Stirling,2763,3,17,6,13,64,53,11,57
Stenhousem'r,2763,4,15,8,13,57,50,7,53
Clyde,2763,5,14,9,13,51,50,1,51
Elgin,2763,6,14,7,15,54,61,-7,49
Annan Athlet,2763,7,11,12,13,47,41,6,45
Berwick,2763,8,9,10,17,31,58,-27,37
Edinburgh Ci,2763,9,7,10,19,37,61,-24,31
Cowdenbeath,2763,10,4,11,21,23,54,-31,23
Montrose,2764,1,24,7,5,60,34,26,79
Peterhead,2764,2,24,4,8,80,39,41,76
Stirling,2764,3,17,6,13,64,53,11,57
Stenhousem'r,2764,4,15,8,13,57,50,7,53
Clyde,2764,5,14,10,12,51,48,3,52
Elgin,2764,6,14,6,16,53,61,-8,48
Annan Athlet,2764,7,12,11,13,48,41,7,47
Berwick,2764,8,8,11,17,29,58,-29,35
Edinburgh Ci,2764,9,7,9,20,37,63,-26,30
Cowdenbeath,2764,10,4,10,22,23,55,-32,22
Montrose,2765,1,24,7,5,63,35,28,79
Peterhead,2765,2,24,4,8,81,39,42,76
Stirling,2765,3,17,6,13,61,51,10,57
Clyde,2765,4,15,9,12,52,48,4,54
Stenhousem'r,2765,5,15,8,13,55,47,8,53
Elgin,2765,6,14,6,16,54,64,-10,48
Annan Athlet,2765,7,12,11,13,48,41,7,47
Berwick,2765,8,8,10,18,29,59,-30,34
Edinburgh Ci,2765,9,7,9,20,37,64,-27,30
Cowdenbeath,2765,10,4,10,22,23,55,-32,22
Montrose,2766,1,23,8,5,60,35,25,77
Peterhead,2766,2,24,4,8,78,38,40,76
Stenhousem'r,2766,3,16,8,12,56,46,10,56
Stirling,2766,4,16,6,14,60,52,8,54
Clyde,2766,5,15,9,12,53,49,4,54
Elgin,2766,6,14,7,15,54,61,-7,49
Annan Athlet,2766,7,11,11,14,47,42,5,44
Berwick,2766,8,8,10,18,30,60,-30,34
Edinburgh Ci,2766,9,7,9,20,36,61,-25,30
Cowdenbeath,2766,10,5,10,21,24,54,-30,25
Montrose,2767,1,24,7,5,61,34,27,79
Peterhead,2767,2,24,4,8,78,38,40,76
Stenhousem'r,2767,3,16,8,12,57,46,11,56
Stirling,2767,4,16,6,14,60,53,7,54
Clyde,2767,5,15,9,12,52,48,4,54
Elgin,2767,6,14,6,16,53,62,-9,48
Annan Athlet,2767,7,12,11,13,48,41,7,47
Berwick,2767,8,8,10,18,29,59,-30,34
Edinburgh Ci,2767,9,7,9,20,36,61,-25,30
Cowdenbeath,2767,10,4,10,22,23,55,-32,22
Montrose,2768,1,24,7,5,62,34,28,79
Peterhead,2768,2,23,4,9,78,40,38,73
Stirling,2768,3,17,6,13,62,51,11,57
Clyde,2768,4,15,9,12,53,49,4,54
Stenhousem'r,2768,5,15,8,13,55,48,7,53
Elgin,2768,6,14,6,16,53,63,-10,48
Annan Athlet,2768,7,11,12,13,48,42,6,45
Berwick,2768,8,8,10,18,30,60,-30,34
Edinburgh Ci,2768,9,8,9,19,38,61,-23,33
Cowdenbeath,2768,10,4,11,21,24,55,-31,23
Montrose,2769,1,23,8,5,59,34,25,77
Peterhead,2769,2,24,4,8,80,39,41,76
Stirling,2769,3,17,6,13,65,52,13,57
Stenhousem'r,2769,4,15,8,13,56,51,5,53
Clyde,2769,5,14,10,12,52,49,3,52
Elgin,2769,6,14,7,15,53,60,-7,49
Annan Athlet,2769,7,12,11,13,49,42,7,47
Berwick,2769,8,8,11,17,30,59,-29,35
Edinburgh Ci,2769,9,7,9,20,37,63,-26,30
Cowdenbeath,2769,10,4,10,22,24,56,-32,22
Peterhead,2770,1,24,4,8,81,38,43,76
Montrose,2770,2,23,7,6,60,37,23,76
Stenhousem'r,2770,3,16,8,12,60,48,12,56
Stirling,2770,4,16,6,14,62,56,6,54
Clyde,2770,5,14,10,12,52,49,3,52
Elgin,2770,6,15,6,15,56,61,-5,51
Annan Athlet,2770,7,11,11,14,48,43,5,44
Berwick,2770,8,8,11,17,30,59,-29,35
Edinburgh Ci,2770,9,7,9,20,36,64,-28,30
Cowdenbeath,2770,10,5,10,21,25,55,-30,25
Montrose,2771,1,23,8,5,60,35,25,77
Peterhead,2771,2,23,4,9,77,40,37,73
Stenhousem'r,2771,3,16,8,12,58,48,10,56
Stirling,2771,4,16,6,14,62,54,8,54
Clyde,2771,5,14,10,12,52,49,3,52
Elgin,2771,6,14,7,15,54,61,-7,49
Annan Athlet,2771,7,11,11,14,47,43,4,44
Berwick,2771,8,8,11,17,30,59,-29,35
Edinburgh Ci,2771,9,8,9,19,38,60,-22,33
Cowdenbeath,2771,10,5,10,21,25,54,-29,25
Montrose,2772,1,24,7,5,61,34,27,79
Peterhead,2772,2,24,4,8,81,38,43,76
Stirling,2772,3,17,6,13,62,52,10,57
Clyde,2772,4,15,9,12,53,48,5,54
Stenhousem'r,2772,5,15,8,13,56,48,8,53
Elgin,2772,6,14,6,16,53,62,-9,48
Annan Athlet,2772,7,12,11,13,50,42,8,47
Berwick,2772,8,8,10,18,29,60,-31,34
Edinburgh Ci,2772,9,7,9,20,36,64,-28,30
Cowdenbeath,2772,10,4,10,22,24,57,-33,22
Montrose,2773,1,24,7,5,62,35,27,79
Peterhead,2773,2,23,4,9,78,40,38,73
Stirling,2773,3,17,6,13,63,53,10,57
Clyde,2773,4,15,9,12,55,50,5,54
Stenhousem'r,2773,5,15,8,13,57,49,8,53
Elgin,2773,6,14,6,16,54,63,-9,48
Annan Athlet,2773,7,11,11,14,48,43,5,44
Berwick,2773,8,8,10,18,31,62,-31,34
Edinburgh Ci,2773,9,8,9,19,38,61,-23,33
Cowdenbeath,2773,10,5,10,21,25,55,-30,25
Montrose,2774,1,23,8,5,59,34,25,77
Peterhead,2774,2,23,5,8,78,39,39,74
Stirling,2774,3,17,6,13,62,51,11,57
Clyde,2774,4,15,9,12,54,49,5,54
Stenhousem'r,2774,5,15,8,13,55,48,7,53
Elgin,2774,6,14,7,15,53,60,-7,49
Annan Athlet,2774,7,12,11,13,50,43,7,47
Berwick,2774,8,8,10,18,30,61,-31,34
Edinburgh Ci,2774,9,7,10,19,37,61,-24,31
Cowdenbeath,2774,10,4,10,22,25,57,-32,22
Montrose,2775,1,24,7,5,60,34,26,79
Peterhead,2775,2,24,4,8,79,39,40,76
Stirling,2775,3,16,7,13,61,52,9,55
Stenhousem'r,2775,4,15,9,12,56,47,9,54
Clyde,2775,5,15,9,12,53,49,4,54
Elgin,2775,6,14,6,16,53,61,-8,48
Annan Athlet,2775,7,12,11,13,49,41,8,47
Berwick,2775,8,8,10,18,30,60,-30,34
Edinburgh Ci,2775,9,7,9,20,37,62,-25,30
Cowdenbeath,2775,10,4,10,22,23,56,-33,22
Montrose,2776,1,24,7,5,62,35,27,79
Peterhead,2776,2,23,5,8,77,38,39,74
Stenhousem'r,2776,3,16,8,12,56,46,10,56
Stirling,2776,4,16,6,14,60,52,8,54
Clyde,2776,5,14,9,13,51,49,2,51
Elgin,2776,6,14,6,16,54,63,-9,48
Annan Athlet,2776,7,11,11,14,47,42,5,44
Berwick,2776,8,9,10,17,30,58,-28,37
Edinburgh Ci,2776,9,7,10,19,36,60,-24,31
Cowdenbeath,2776,10,5,10,21,24,54,-30,25
Montrose,2777,1,24,7,5,61,35,26,79
Peterhead,2777,2,23,5,8,78,39,39,74
Stenhousem'r,2777,3,16,8,12,58,47,11,56
Stirling,2777,4,16,6,14,61,54,7,54
Clyde,2777,5,14,9,13,52,50,2,51
Elgin,2777,6,14,6,16,54,62,-8,48
Annan Athlet,2777,7,11,11,14,47,43,4,44
Berwick,2777,8,9,10,17,31,59,-28,37
Edinburgh Ci,2777,9,7,10,19,37,61,-24,31
Cowdenbeath,2777,10,5,10,21,25,54,-29,25
Montrose,2778,1,24,7,5,60,34,26,79
Peterhead,2778,2,24,4,8,79,38,41,76
Stenhousem'r,2778,3,16,8,12,58,47,11,56
Stirling,2778,4,16,6,14,61,54,7,54
Clyde,2778,5,15,9,12,53,49,4,54
Elgin,2778,6,14,6,16,53,61,-8,48
Annan Athlet,2778,7,11,11,14,47,45,2,44
Berwick,2778,8,8,10,18,30,60,-30,34
Edinburgh Ci,2778,9,7,9,20,36,62,-26,30
Cowdenbeath,2778,10,5,10,21,27,54,-27,25
Montrose,2779,1,24,7,5,62,34,28,79
Peterhead,2779,2,23,4,9,78,40,38,73
Stenhousem'r,2779,3,16,8,12,57,47,10,56
Stirling,2779,4,16,6,14,61,53,8,54
Clyde,2779,5,15,9,12,53,49,4,54
Elgin,2779,6,14,6,16,53,63,-10,48
Annan Athlet,2779,7,11,11,14,47,42,5,44
Berwick,2779,8,8,10,18,30,60,-30,34
Edinburgh Ci,2779,9,8,9,19,38,61,-23,33
Cowdenbeath,2779,10,5,10,21,24,54,-30,25
Montrose,2780,1,24,7,5,60,34,26,79
Peterhead,2780,2,24,4,8,79,38,41,76
Stirling,2780,3,17,6,13,63,51,12,57
Stenhousem'r,2780,4,15,8,13,55,49,6,53
Clyde,2780,5,14,10,12,51,48,3,52
Elgin,2780,6,14,6,16,53,61,-8,48
Annan Athlet,2780,7,12,11,13,50,41,9,47
Berwick,2780,8,8,11,17,29,58,-29,35
Edinburgh Ci,2780,9,7,9,20,36,62,-26,30
Cowdenbeath,2780,10,4,10,22,23,57,-34,22
Montrose,2781,1,24,7,5,61,35,26,79
Peterhead,2781,2,24,4,8,81,38,43,76
Stirling,2781,3,17,6,13,62,51,11,57
Clyde,2781,4,15,9,12,52,48,4,54
Stenhousem'r,2781,5,15,8,13,55,48,7,53
Elgin,2781,6,14,6,16,54,62,-8,48
Annan Athlet,2781,7,11,12,13,49,43,6,45
Berwick,2781,8,8,10,18,29,59,-30,34
Edinburgh Ci,2781,9,7,9,20,36,64,-28,30
Cowdenbeath,2781,10,4,11,21,25,56,-31,23
Montrose,2782,1,24,7,5,61,34,27,79
Peterhead,2782,2,23,4,9,80,43,37,73
Stenhousem'r,2782,3,16,8,12,58,47,11,56
Stirling,2782,4,16,6,14,61,54,7,54
Clyde,2782,5,14,9,13,51,49,2,51
Elgin,2782,6,14,6,16,53,62,-9,48
Annan Athlet,2782,7,11,12,13,48,42,6,45
Berwick,2782,8,9,10,17,30,58,-28,37
Edinburgh Ci,2782,9,8,9,19,41,63,-22,33
Cowdenbeath,2782,10,4,11,21,24,55,-31,23
Montrose,2783,1,24,7,5,64,35,29,79
Peterhead,2783,2,24,4,8,82,38,44,76
Stirling,2783,3,16,7,13,61,52,9,55
Stenhousem'r,2783,4,15,9,12,56,47,9,54
Clyde,2783,5,15,9,12,55,50,5,54
Elgin,2783,6,14,6,16,54,65,-11,48
Annan Athlet,2783,7,11,12,13,48,42,6,45
Berwick,2783,8,8,10,18,31,62,-31,34
Edinburgh Ci,2783,9,7,9,20,36,65,-29,30
Cowdenbeath,2783,10,4,11,21,24,55,-31,23
Montrose,2784,1,24,7,5,60,34,26,79
Peterhead,2784,2,24,4,8,82,39,43,76
Stirling,2784,3,17,6,13,62,52,10,57
Stenhousem'r,2784,4,15,8,13,56,48,8,53
Clyde,2784,5,14,10,12,52,49,3,52
Elgin,2784,6,14,6,16,53,61,-8,48
Annan Athlet,2784,7,11,11,14,48,43,5,44
Berwick,2784,8,8,11,17,30,59,-29,35
Edinburgh Ci,2784,9,7,9,20,37,65,-28,30
Cowdenbeath,2784,10,5,10,21,25,55,-30,25
Montrose,2785,1,23,8,5,61,36,25,77
Peterhead,2785,2,23,5,8,80,41,39,74
Stirling,2785,3,17,6,13,64,53,11,57
Clyde,2785,4,15,9,12,55,48,7,54
Stenhousem'r,2785,5,15,8,13,57,50,7,53
Elgin,2785,6,14,7,15,55,62,-7,49
Annan Athlet,2785,7,11,12,13,47,41,6,45
Berwick,2785,8,8,10,18,29,62,-33,34
Edinburgh Ci,2785,9,7,10,19,39,63,-24,31
Cowdenbeath,2785,10,4,11,21,23,54,-31,23
Peterhead,2786,1,24,4,8,81,39,42,76
Montrose,2786,2,23,7,6,59,36,23,76
Stenhousem'r,2786,3,16,8,12,56,46,10,56
Stirling,2786,4,16,6,14,60,52,8,54
Clyde,2786,5,14,9,13,51,50,1,51
Elgin,2786,6,15,6,15,55,60,-5,51
Annan Athlet,2786,7,11,12,13,47,41,6,45
Berwick,2786,8,9,10,17,31,58,-27,37
Edinburgh Ci,2786,9,7,9,20,37,64,-27,30
Cowdenbeath,2786,10,4,11,21,23,54,-31,23
Montrose,2787,1,24,7,5,63,37,26,79
Peterhead,2787,2,24,4,8,79,39,40,76
Stirling,2787,3,17,6,13,62,52,10,57
Stenhousem'r,2787,4,15,8,13,56,48,8,53
Clyde,2787,5,14,9,13,52,50,2,51
Elgin,2787,6,14,6,16,56,64,-8,48
Annan Athlet,2787,7,12,11,13,49,42,7,47
Berwick,2787,8,9,10,17,31,59,-28,37
Edinburgh Ci,2787,9,7,9,20,37,62,-25,30
Cowdenbeath,2787,10,4,10,22,24,56,-32,22
Montrose,2788,1,24,7,5,61,34,27,79
Peterhead,2788,2,24,4,8,79,39,40,76
Stirling,2788,3,17,6,13,61,51,10,57
Clyde,2788,4,15,9,12,53,49,4,54
Stenhousem'r,2788,5,15,8,13,55,47,8,53
Elgin,2788,6,14,6,16,53,62,-9,48
Annan Athlet,2788,7,12,11,13,49,41,8,47
Berwick,2788,8,8,10,18,30,60,-30,34
Edinburgh Ci,2788,9,7,9,20,37,62,-25,30
Cowdenbeath,2788,10,4,10,22,23,56,-33,22
Montrose,2789,1,24,7,5,65,35,30,79
Peterhead,2789,2,24,4,8,80,38,42,76
Stirling,2789,3,17,6,13,63,51,12,57
Stenhousem'r,2789,4,15,8,13,55,49,6,53
Clyde,2789,5,14,9,13,51,51,0,51
Elgin,2789,6,14,6,16,54,66,-12,48
Annan Athlet,2789,7,11,11,14,47,42,5,44
Berwick,2789,8,9,10,17,32,58,-26,37
Edinburgh Ci,2789,9,7,9,20,36,63,-27,30
Cowdenbeath,2789,10,5,10,21,24,54,-30,25
Montrose,2790,1,24,7,5,61,35,26,79
Peterhead,2790,2,24,4,8,82,40,42,76
Stirling,2790,3,17,6,13,62,51,11,57
Clyde,2790,4,15,9,12,54,49,5,54
Stenhousem'r,2790,5,15,8,13,55,48,7,53
Elgin,2790,6,14,6,16,54,62,-8,48
Annan Athlet,2790,7,11,12,13,49,43,6,45
Berwick,2790,8,8,10,18,30,61,-31,34
Edinburgh Ci,2790,9,7,9,20,38,65,-27,30
Cowdenbeath,2790,10,4,11,21,25,56,-31,23
Montrose,2791,1,23,8,5,61,36,25,77
Peterhead,2791,2,24,4,8,78,38,40,76
Stirling,2791,3,17,6,13,64,53,11,57
Clyde,2791,4,15,9,12,52,48,4,54
Stenhousem'r,2791,5,15,8,13,57,50,7,53
Elgin,2791,6,14,7,15,55,62,-7,49
Annan Athlet,2791,7,11,12,13,48,42,6,45
Berwick,2791,8,8,10,18,29,59,-30,34
Edinburgh Ci,2791,9,7,9,20,36,61,-25,30
Cowdenbeath,2791,10,4,11,21,24,55,-31,23
Montrose,2792,1,24,7,5,60,34,26,79
Peterhead,2792,2,23,4,9,78,40,38,73
Stirling,2792,3,17,6,13,61,51,10,57
Stenhousem'r,2792,4,15,8,13,55,47,8,53
Clyde,2792,5,14,9,13,51,50,1,51
Elgin,2792,6,14,6,16,53,61,-8,48
Annan Athlet,2792,7,11,11,14,47,42,5,44
Berwick,2792,8,9,10,17,31,58,-27,37
Edinburgh Ci,2792,9,8,9,19,38,61,-23,33
Cowdenbeath,2792,10,5,10,21,24,54,-30,25
Montrose,2793,1,24,7,5,62,34,28,79
Peterhead,2793,2,23,5,8,79,40,39,74
Stirling,2793,3,16,7,13,61,52,9,55
Stenhousem'r,2793,4,15,9,12,56,47,9,54
Clyde,2793,5,15,9,12,53,49,4,54
Elgin,2793,6,14,6,16,53,63,-10,48
Annan Athlet,2793,7,11,11,14,47,42,5,44
Berwick,2793,8,8,10,18,30,60,-30,34
Edinburgh Ci,2793,9,7,10,19,38,62,-24,31
Cowdenbeath,2793,10,5,10,21,24,54,-30,25
Montrose,2794,1,23,8,5,60,35,25,77
Peterhead,2794,2,24,4,8,80,38,42,76
Stenhousem'r,2794,3,16,8,12,57,47,10,56
Stirling,2794,4,16,6,14,61,53,8,54
Clyde,2794,5,14,9,13,51,49,2,51
Elgin,2794,6,14,7,15,54,61,-7,49
Annan Athlet,2794,7,11,12,13,47,41,6,45
Berwick,2794,8,9,10,17,30,58,-28,37
Edinburgh Ci,2794,9,7,9,20,36,63,-27,30
Cowdenbeath,2794,10,4,11,21,23,54,-31,23
Montrose,2795,1,24,7,5,62,34,28,79
Peterhead,2795,2,24,4,8,79,38,41,76
Stirling,2795,3,17,6,13,62,51,11,57
Clyde,2795,4,15,9,12,53,49,4,54
Stenhousem'r,2795,5,15,8,13,55,48,7,53
Elgin,2795,6,14,6,16,53,63,-10,48
Annan Athlet,2795,7,12,11,13,49,42,7,47
Berwick,2795,8,8,10,18,30,60,-30,34
Edinburgh Ci,2795,9,7,9,20,36,62,-26,30
Cowdenbeath,2795,10,4,10,22,24,56,-32,22
Montrose,2796,1,23,8,5,61,36,25,77
Peterhead,2796,2,24,4,8,82,41,41,76
Stenhousem'r,2796,3,16,8,12,56,46,10,56
Stirling,2796,4,16,6,14,60,52,8,54
Clyde,2796,5,15,9,12,53,48,5,54
Elgin,2796,6,14,7,15,55,62,-7,49
Annan Athlet,2796,7,11,11,14,48,44,4,44
Berwick,2796,8,8,10,18,29,60,-31,34
Edinburgh Ci,2796,9,7,9,20,39,65,-26,30
Cowdenbeath,2796,10,5,10,21,26,55,-29,25
Peterhead,2797,1,24,4,8,78,38,40,76
Montrose,2797,2,23,7,6,60,37,23,76
Stirling,2797,3,16,7,13,61,52,9,55
Stenhousem'r,2797,4,15,9,12,56,47,9,54
Clyde,2797,5,14,10,12,51,48,3,52
Elgin,2797,6,15,6,15,56,61,-5,51
Annan Athlet,2797,7,11,12,13,49,43,6,45
Berwick,2797,8,8,11,17,29,58,-29,35
Edinburgh Ci,2797,9,7,9,20,36,61,-25,30
Cowdenbeath,2797,10,4,11,21,25,56,-31,23
Montrose,2798,1,24,7,5,61,35,26,79
Peterhead,2798,2,24,4,8,81,38,43,76
Stenhousem'r,2798,3,16,8,12,56,46,10,56
Stirling,2798,4,16,6,14,60,52,8,54
Clyde,2798,5,14,10,12,52,49,3,52
Elgin,2798,6,14,6,16,54,62,-8,48
Annan Athlet,2798,7,12,11,13,48,41,7,47
Berwick,2798,8,8,11,17,30,59,-29,35
Edinburgh Ci,2798,9,7,9,20,36,64,-28,30
Cowdenbeath,2798,10,4,10,22,23,55,-32,22
Montrose,2799,1,23,8,5,61,36,25,77
Peterhead,2799,2,24,4,8,78,38,40,76
Stirling,2799,3,17,6,13,63,53,10,57
Stenhousem'r,2799,4,15,8,13,57,49,8,53
Clyde,2799,5,14,9,13,52,50,2,51
Elgin,2799,6,14,7,15,55,62,-7,49
Annan Athlet,2799,7,11,12,13,47,41,6,45
Berwick,2799,8,9,10,17,31,59,-28,37
Edinburgh Ci,2799,9,7,9,20,36,61,-25,30
Cowdenbeath,2799,10,4,11,21,23,54,-31,23
Montrose,2800,1,23,7,6,62,38,24,76
Peterhead,2800,2,23,5,8,77,38,39,74
Stenhousem'r,2800,3,16,8,12,56,46,10,56
Stirling,2800,4,16,6,14,60,52,8,54
Clyde,2800,5,15,9,12,53,49,4,54
Elgin,2800,6,15,6,15,57,63,-6,51
Annan Athlet,2800,7,11,11,14,47,42,5,44
Berwick,2800,8,8,10,18,30,60,-30,34
Edinburgh Ci,2800,9,7,10,19,36,60,-24,31
Cowdenbeath,2800,10,5,10,21,24,54,-30,25
Montrose,2801,1,23,8,5,60,35,25,77
Peterhead,2801,2,24,4,8,78,38,40,76
Stirling,2801,3,17,6,13,66,51,15,57
Stenhousem'r,2801,4,15,8,13,55,52,3,53
Clyde,2801,5,14,10,12,52,49,3,52
Elgin,2801,6,14,7,15,54,61,-7,49
Annan Athlet,2801,7,11,11,14,48,43,5,44
Berwick,2801,8,8,11,17,30,59,-29,35
Edinburgh Ci,2801,9,7,9,20,36,61,-25,30
Cowdenbeath,2801,10,5,10,21,25,55,-30,25
Montrose,2802,1,23,8,5,59,34,25,77
Peterhead,2802,2,24,4,8,78,38,40,76
Stirling,2802,3,17,6,13,63,53,10,57
Stenhousem'r,2802,4,15,8,13,57,49,8,53
Clyde,2802,5,14,9,13,51,49,2,51
Elgin,2802,6,14,7,15,53,60,-7,49
Annan Athlet,2802,7,11,12,13,47,41,6,45
Berwick,2802,8,9,10,17,30,58,-28,37
Edinburgh Ci,2802,9,7,9,20,36,61,-25,30
Cowdenbeath,2802,10,4,11,21,23,54,-31,23
Montrose,2803,1,24,7,5,61,35,26,79
Peterhead,2803,2,24,4,8,79,38,41,76
Stenhousem'r,2803,3,16,8,12,57,47,10,56
Stirling,2803,4,16,6,14,61,53,8,54
Clyde,2803,5,15,9,12,52,48,4,54
Elgin,2803,6,14,6,16,54,62,-8,48
Annan Athlet,2803,7,11,12,13,47,41,6,45
Berwick,2803,8,8,10,18,29,59,-30,34
Edinburgh Ci,2803,9,7,9,20,36,62,-26,30
Cowdenbeath,2803,10,4,11,21,23,54,-31,23
Montrose,2804,1,24,7,5,63,37,26,79
Peterhead,2804,2,24,4,8,79,39,40,76
Stirling,2804,3,17,6,13,63,52,11,57
Clyde,2804,4,15,9,12,53,49,4,54
Stenhousem'r,2804,5,15,8,13,56,49,7,53
Elgin,2804,6,14,6,16,56,64,-8,48
Annan Athlet,2804,7,12,11,13,49,41,8,47
Berwick,2804,8,8,10,18,30,60,-30,34
Edinburgh Ci,2804,9,7,9,20,37,62,-25,30
Cowdenbeath,2804,10,4,10,22,23,56,-33,22
Montrose,2805,1,24,7,5,60,34,26,79
Peterhead,2805,2,24,4,8,79,39,40,76
Stirling,2805,3,17,6,13,62,51,11,57
Clyde,2805,4,15,9,12,55,49,6,54
Stenhousem'r,2805,5,15,8,13,55,48,7,53
Elgin,2805,6,14,6,16,53,61,-8,48
Annan Athlet,2805,7,11,12,13,48,42,6,45
Berwick,2805,8,8,10,18,30,62,-32,34
Edinburgh Ci,2805,9,7,9,20,37,62,-25,30
Cowdenbeath,2805,10,4,11,21,24,55,-31,23
Montrose,2806,1,24,7,5,60,34,26,79
Peterhead,2806,2,24,4,8,78,38,40,76
Stirling,2806,3,17,6,13,63,52,11,57
Clyde,2806,4,15,9,12,52,48,4,54
Stenhousem'r,2806,5,15,8,13,56,49,7,53
Elgin,2806,6,14,6,16,53,61,-8,48
Annan Athlet,2806,7,12,11,13,49,42,7,47
Berwick,2806,8,8,10,18,29,59,-30,34
Edinburgh Ci,2806,9,7,9,20,36,61,-25,30
Cowdenbeath,2806,10,4,10,22,24,56,-32,22
Montrose,2807,1,24,7,5,61,35,26,79
Peterhead,2807,2,24,4,8,80,40,40,76
Stirling,2807,3,16,7,13,61,52,9,55
Stenhousem'r,2807,4,15,9,12,56,47,9,54
Clyde,2807,5,15,9,12,53,48,5,54
Elgin,2807,6,14,6,16,54,62,-8,48
Annan Athlet,2807,7,12,11,13,49,41,8,47
Berwick,2807,8,8,10,18,29,60,-31,34
Edinburgh Ci,2807,9,7,9,20,38,63,-25,30
Cowdenbeath,2807,10,4,10,22,23,56,-33,22
Montrose,2808,1,24,7,5,62,34,28,79
Peterhead,2808,2,23,4,9,77,39,38,73
Stirling,2808,3,17,6,13,61,51,10,57
Stenhousem'r,2808,4,15,8,13,55,47,8,53
Clyde,2808,5,14,9,13,51,50,1,51
Elgin,2808,6,14,6,16,53,63,-10,48
Annan Athlet,2808,7,11,11,14,48,44,4,44
Berwick,2808,8,9,10,17,31,58,-27,37
Edinburgh Ci,2808,9,8,9,19,37,60,-23,33
Cowdenbeath,2808,10,5,10,21,26,55,-29,25
Montrose,2809,1,24,7,5,61,34,27,79
Peterhead,2809,2,24,4,8,79,39,40,76
Stirling,2809,3,16,7,13,60,51,9,55
Stenhousem'r,2809,4,15,9,12,55,46,9,54
Clyde,2809,5,14,9,13,51,49,2,51
Elgin,2809,6,14,6,16,53,62,-9,48
Annan Athlet,2809,7,11,11,14,47,43,4,44
Berwick,2809,8,9,10,17,30,58,-28,37
Edinburgh Ci,2809,9,7,9,20,37,62,-25,30
Cowdenbeath,2809,10,5,10,21,25,54,-29,25
Montrose,2810,1,23,7,6,60,37,23,76
Peterhead,2810,2,23,4,9,78,40,38,73
Stirling,2810,3,17,6,13,63,53,10,57
Stenhousem'r,2810,4,15,8,13,57,49,8,53
Clyde,2810,5,14,10,12,52,49,3,52
Elgin,2810,6,15,6,15,56,61,-5,51
Annan Athlet,2810,7,11,11,14,47,43,4,44
Berwick,2810,8,8,11,17,30,59,-29,35
Edinburgh Ci,2810,9,8,9,19,38,61,-23,33
Cowdenbeath,2810,10,5,10,21,25,54,-29,25
Montrose,2811,1,24,7,5,61,34,27,79
Peterhead,2811,2,23,4,9,79,41,38,73
Stenhousem'r,2811,3,16,8,12,60,49,11,56
Stirling,2811,4,16,6,14,63,56,7,54
Clyde,2811,5,15,9,12,53,48,5,54
Elgin,2811,6,14,6,16,53,62,-9,48
Annan Athlet,2811,7,11,11,14,49,44,5,44
Berwick,2811,8,8,10,18,29,60,-31,34
Edinburgh Ci,2811,9,8,9,19,39,62,-23,33
Cowdenbeath,2811,10,5,10,21,26,56,-30,25
Montrose,2812,1,24,7,5,64,34,30,79
Peterhead,2812,2,24,4,8,81,39,42,76
Stirling,2812,3,16,7,13,61,52,9,55
Stenhousem'r,2812,4,15,9,12,56,47,9,54
Clyde,2812,5,14,10,12,53,50,3,52
Elgin,2812,6,14,6,16,53,65,-12,48
Annan Athlet,2812,7,11,12,13,48,42,6,45
Berwick,2812,8,8,11,17,31,60,-29,35
Edinburgh Ci,2812,9,7,9,20,37,64,-27,30
Cowdenbeath,2812,10,4,11,21,24,55,-31,23
Peterhead,2813,1,24,4,8,83,39,44,76
Montrose,2813,2,23,7,6,59,36,23,76
Stenhousem'r,2813,3,16,8,12,57,47,10,56
Stirling,2813,4,16,6,14,61,53,8,54
Clyde,2813,5,15,9,12,53,49,4,54
Elgin,2813,6,15,6,15,55,60,-5,51
Annan Athlet,2813,7,11,12,13,48,42,6,45
Berwick,2813,8,8,10,18,30,60,-30,34
Edinburgh Ci,2813,9,7,9,20,37,66,-29,30
Cowdenbeath,2813,10,4,11,21,24,55,-31,23
Montrose,2814,1,24,7,5,61,35,26,79
Peterhead,2814,2,24,4,8,79,38,41,76
Stirling,2814,3,17,6,13,62,51,11,57
Clyde,2814,4,15,9,12,52,48,4,54
Stenhousem'r,2814,5,15,8,13,55,48,7,53
Elgin,2814,6,14,6,16,54,62,-8,48
Annan Athlet,2814,7,12,11,13,48,41,7,47
Berwick,2814,8,8,10,18,29,59,-30,34
Edinburgh Ci,2814,9,7,9,20,36,62,-26,30
Cowdenbeath,2814,10,4,10,22,23,55,-32,22
Montrose,2815,1,24,7,5,61,35,26,79
Peterhead,2815,2,24,4,8,84,41,43,76
Stenhousem'r,2815,3,16,8,12,57,47,10,56
Stirling,2815,4,16,6,14,61,53,8,54
Clyde,2815,5,14,9,13,52,50,2,51
Elgin,2815,6,14,6,16,54,62,-8,48
Annan Athlet,2815,7,11,12,13,48,42,6,45
Berwick,2815,8,9,10,17,31,59,-28,37
Edinburgh Ci,2815,9,7,9,20,39,67,-28,30
Cowdenbeath,2815,10,4,11,21,24,55,-31,23
Montrose,2816,1,24,7,5,63,35,28,79
Peterhead,2816,2,24,4,8,82,38,44,76
Stirling,2816,3,17,6,13,63,53,10,57
Clyde,2816,4,15,9,12,54,50,4,54
Stenhousem'r,2816,5,15,8,13,57,49,8,53
Elgin,2816,6,14,6,16,54,64,-10,48
Annan Athlet,2816,7,12,11,13,51,42,9,47
Berwick,2816,8,8,10,18,31,61,-30,34
Edinburgh Ci,2816,9,7,9,20,36,65,-29,30
Cowdenbeath,2816,10,4,10,22,24,58,-34,22
Montrose,2817,1,24,7,5,62,34,28,79
Peterhead,2817,2,24,4,8,84,38,46,76
Stirling,2817,3,16,7,13,60,51,9,55
Stenhousem'r,2817,4,15,9,12,55,46,9,54
Clyde,2817,5,15,9,12,54,50,4,54
Elgin,2817,6,14,6,16,53,63,-10,48
Annan Athlet,2817,7,12,11,13,48,41,7,47
Berwick,2817,8,8,10,18,31,61,-30,34
Edinburgh Ci,2817,9,7,9,20,36,67,-31,30
Cowdenbeath,2817,10,4,10,22,23,55,-32,22
Montrose,2818,1,23,7,6,62,39,23,76
Peterhead,2818,2,23,5,8,80,41,39,74
Stirling,2818,3,16,7,13,61,52,9,55
Stenhousem'r,2818,4,15,9,12,56,47,9,54
Clyde,2818,5,14,10,12,51,48,3,52
Elgin,2818,6,15,6,15,58,63,-5,51
Annan Athlet,2818,7,12,11,13,49,41,8,47
Berwick,2818,8,8,11,17,29,58,-29,35
Edinburgh Ci,2818,9,7,10,19,39,63,-24,31
Cowdenbeath,2818,10,4,10,22,23,56,-33,22
Montrose,2819,1,24,7,5,61,34,27,79
Peterhead,2819,2,23,5,8,78,39,39,74
Stirling,2819,3,17,6,13,63,52,11,57
Clyde,2819,4,15,9,12,54,50,4,54
Stenhousem'r,2819,5,15,8,13,56,49,7,53
Elgin,2819,6,14,6,16,53,62,-9,48
Annan Athlet,2819,7,11,11,14,47,43,4,44
Berwick,2819,8,8,10,18,31,61,-30,34
Edinburgh Ci,2819,9,7,10,19,37,61,-24,31
Cowdenbeath,2819,10,5,10,21,25,54,-29,25
Montrose,2820,1,24,7,5,62,36,26,79
Peterhead,2820,2,24,4,8,79,39,40,76
Stenhousem'r,2820,3,16,8,12,59,48,11,56
Stirling,2820,4,16,6,14,62,55,7,54
Clyde,2820,5,15,9,12,54,49,5,54
Elgin,2820,6,14,6,16,55,63,-8,48
Annan Athlet,2820,7,12,11,13,48,41,7,47
Berwick,2820,8,8,10,18,30,61,-31,34
Edinburgh Ci,2820,9,7,9,20,37,62,-25,30
Cowdenbeath,2820,10,4,10,22,23,55,-32,22
Montrose,2821,1,24,7,5,65,35,30,79
Peterhead,2821,2,23,5,8,80,41,39,74
Stirling,2821,3,17,6,13,63,52,11,57
Stenhousem'r,2821,4,15,8,13,56,49,7,53
Clyde,2821,5,14,9,13,53,51,2,51
Elgin,2821,6,14,6,16,54,66,-12,48
Annan Athlet,2821,7,11,11,14,47,43,4,44
Berwick,2821,8,9,10,17,32,60,-28,37
Edinburgh Ci,2821,9,7,10,19,39,63,-24,31
Cowdenbeath,2821,10,5,10,21,25,54,-29,25
Montrose,2822,1,23,8,5,60,35,25,77
Peterhead,2822,2,23,4,9,77,39,38,73
Stenhousem'r,2822,3,16,8,12,60,46,14,56
Stirling,2822,4,16,6,14,60,56,4,54
Clyde,2822,5,15,9,12,52,48,4,54
Elgin,2822,6,14,7,15,54,61,-7,49
Annan Athlet,2822,7,11,11,14,47,43,4,44
Berwick,2822,8,8,10,18,29,59,-30,34
Edinburgh Ci,2822,9,8,9,19,37,60,-23,33
Cowdenbeath,2822,10,5,10,21,25,54,-29,25
Montrose,2823,1,24,7,5,60,34,26,79
Peterhead,2823,2,23,5,8,78,39,39,74
Stenhousem'r,2823,3,16,8,12,57,46,11,56
Stirling,2823,4,16,6,14,60,53,7,54
Clyde,2823,5,14,9,13,51,49,2,51
Elgin,2823,6,14,6,16,53,61,-8,48
Annan Athlet,2823,7,11,12,13,48,42,6,45
Berwick,2823,8,9,10,17,30,58,-28,37
Edinburgh Ci,2823,9,7,10,19,37,61,-24,31
Cowdenbeath,2823,10,4,11,21,24,55,-31,23
Montrose,2824,1,23,8,5,62,37,25,77
Peterhead,2824,2,23,4,9,77,39,38,73
Stirling,2824,3,16,7,13,62,53,9,55
Stenhousem'r,2824,4,15,9,12,57,48,9,54
Clyde,2824,5,14,10,12,53,50,3,52
Elgin,2824,6,14,7,15,56,63,-7,49
Annan Athlet,2824,7,11,11,14,47,42,5,44
Berwick,2824,8,8,11,17,31,60,-29,35
Edinburgh Ci,2824,9,8,9,19,37,60,-23,33
Cowdenbeath,2824,10,5,10,21,24,54,-30,25
Montrose,2825,1,24,7,5,60,34,26,79
Peterhead,2825,2,24,4,8,80,39,41,76
Stirling,2825,3,17,6,13,61,51,10,57
Stenhousem'r,2825,4,15,8,13,55,47,8,53
Clyde,2825,5,14,10,12,51,48,3,52
Elgin,2825,6,14,6,16,53,61,-8,48
Annan Athlet,2825,7,11,12,13,48,42,6,45
Berwick,2825,8,8,11,17,29,58,-29,35
Edinburgh Ci,2825,9,7,9,20,37,63,-26,30
Cowdenbeath,2825,10,4,11,21,24,55,-31,23
Peterhead,2826,1,24,4,8,78,38,40,76
Montrose,2826,2,23,7,6,60,36,24,76
Stirling,2826,3,17,6,13,62,51,11,57
Clyde,2826,4,15,9,12,54,50,4,54
Stenhousem'r,2826,5,15,8,13,55,48,7,53
Elgin,2826,6,15,6,15,55,61,-6,51
Annan Athlet,2826,7,12,11,13,49,42,7,47
Berwick,2826,8,8,10,18,31,61,-30,34
Edinburgh Ci,2826,9,7,9,20,36,61,-25,30
Cowdenbeath,2826,10,4,10,22,24,56,-32,22
Montrose,2827,1,23,7,6,59,35,24,76
Peterhead,2827,2,23,4,9,78,41,37,73
Stirling,2827,3,17,6,13,65,53,12,57
Stenhousem'r,2827,4,15,8,13,57,51,6,53
Clyde,2827,5,14,9,13,52,51,1,51
Elgin,2827,6,15,6,15,54,60,-6,51
Annan Athlet,2827,7,11,11,14,47,42,5,44
Berwick,2827,8,9,10,17,32,59,-27,37
Edinburgh Ci,2827,9,8,9,19,39,61,-22,33
Cowdenbeath,2827,10,5,10,21,24,54,-30,25
Montrose,2828,1,23,8,5,61,36,25,77
Peterhead,2828,2,24,4,8,79,38,41,76
Stirling,2828,3,17,6,13,64,51,13,57
Stenhousem'r,2828,4,15,8,13,55,50,5,53
Clyde,2828,5,14,10,12,51,48,3,52
Elgin,2828,6,14,7,15,55,62,-7,49
Annan Athlet,2828,7,11,12,13,47,41,6,45
Berwick,2828,8,8,11,17,29,58,-29,35
Edinburgh Ci,2828,9,7,9,20,36,62,-26,30
Cowdenbeath,2828,10,4,11,21,23,54,-31,23
Montrose,2829,1,24,7,5,62,35,27,79
Peterhead,2829,2,23,5,8,77,38,39,74
Stirling,2829,3,16,7,13,60,51,9,55
Stenhousem'r,2829,4,15,9,12,55,46,9,54
Clyde,2829,5,15,9,12,53,48,5,54
Elgin,2829,6,14,6,16,54,63,-9,48
Annan Athlet,2829,7,12,11,13,50,41,9,47
Berwick,2829,8,8,10,18,29,60,-31,34
Edinburgh Ci,2829,9,7,10,19,36,60,-24,31
Cowdenbeath,2829,10,4,10,22,23,57,-34,22
Montrose,2830,1,24,7,5,62,34,28,79
Peterhead,2830,2,24,4,8,80,38,42,76
Stirling,2830,3,17,6,13,63,53,10,57
Clyde,2830,4,15,9,12,52,48,4,54
Stenhousem'r,2830,5,15,8,13,57,49,8,53
Elgin,2830,6,14,6,16,53,63,-10,48
Annan Athlet,2830,7,11,11,14,47,45,2,44
Berwick,2830,8,8,10,18,29,59,-30,34
Edinburgh Ci,2830,9,7,9,20,36,63,-27,30
Cowdenbeath,2830,10,5,10,21,27,54,-27,25
Montrose,2831,1,23,8,5,60,35,25,77
Peterhead,2831,2,24,4,8,82,39,43,76
Stenhousem'r,2831,3,16,8,12,58,47,11,56
Clyde,2831,4,15,9,12,56,48,8,54
Stirling,2831,5,16,6,14,61,54,7,54
Elgin,2831,6,14,7,15,54,61,-7,49
Annan Athlet,2831,7,11,12,13,48,42,6,45
Berwick,2831,8,8,10,18,29,63,-34,34
Edinburgh Ci,2831,9,7,9,20,37,65,-28,30
Cowdenbeath,2831,10,4,11,21,24,55,-31,23
Montrose,2832,1,24,7,5,62,36,26,79
Peterhead,2832,2,24,4,8,79,38,41,76
Stirling,2832,3,16,7,13,62,53,9,55
Stenhousem'r,2832,4,15,9,12,57,48,9,54
Clyde,2832,5,14,10,12,53,50,3,52
Elgin,2832,6,14,6,16,55,63,-8,48
Annan Athlet,2832,7,12,11,13,50,41,9,47
Berwick,2832,8,8,11,17,31,60,-29,35
Edinburgh Ci,2832,9,7,9,20,36,62,-26,30
Cowdenbeath,2832,10,4,10,22,23,57,-34,22
Montrose,2833,1,24,7,5,60,34,26,79
Peterhead,2833,2,24,4,8,81,40,41,76
Stirling,2833,3,17,6,13,64,52,12,57
Clyde,2833,4,15,9,12,53,48,5,54
Stenhousem'r,2833,5,15,8,13,56,50,6,53
Elgin,2833,6,14,6,16,53,61,-8,48
Annan Athlet,2833,7,12,11,13,49,41,8,47
Berwick,2833,8,8,10,18,29,60,-31,34
Edinburgh Ci,2833,9,7,9,20,38,64,-26,30
Cowdenbeath,2833,10,4,10,22,23,56,-33,22
Montrose,2834,1,23,7,6,60,37,23,76
Peterhead,2834,2,23,5,8,77,38,39,74
Stirling,2834,3,17,6,13,64,52,12,57
Stenhousem'r,2834,4,15,8,13,56,50,6,53
Clyde,2834,5,14,10,12,52,49,3,52
Elgin,2834,6,15,6,15,56,61,-5,51
Annan Athlet,2834,7,12,11,13,48,41,7,47
Berwick,2834,8,8,11,17,30,59,-29,35
Edinburgh Ci,2834,9,7,10,19,36,60,-24,31
Cowdenbeath,2834,10,4,10,22,23,55,-32,22
Montrose,2835,1,24,7,5,61,35,26,79
Peterhead,2835,2,24,4,8,78,38,40,76
Stirling,2835,3,17,6,13,61,51,10,57
Stenhousem'r,2835,4,15,8,13,55,47,8,53
Clyde,2835,5,14,9,13,51,50,1,51
Elgin,2835,6,14,6,16,54,62,-8,48
Annan Athlet,2835,7,11,11,14,48,43,5,44
Berwick,2835,8,9,10,17,31,58,-27,37
Edinburgh Ci,2835,9,7,9,20,36,61,-25,30
Cowdenbeath,2835,10,5,10,21,25,55,-30,25
Montrose,2836,1,24,7,5,63,34,29,79
Peterhead,2836,2,24,4,8,78,38,40,76
Stirling,2836,3,17,6,13,63,52,11,57
Clyde,2836,4,15,9,12,54,48,6,54
Stenhousem'r,2836,5,15,8,13,56,49,7,53
Elgin,2836,6,14,6,16,53,64,-11,48
Annan Athlet,2836,7,11,11,14,47,44,3,44
Berwick,2836,8,8,10,18,29,61,-32,34
Edinburgh Ci,2836,9,7,9,20,36,61,-25,30
Cowdenbeath,2836,10,5,10,21,26,54,-28,25
Montrose,2837,1,23,7,6,59,35,24,76
Peterhead,2837,2,23,4,9,78,41,37,73
Stenhousem'r,2837,3,16,8,12,57,47,10,56
Stirling,2837,4,16,6,14,61,53,8,54
Clyde,2837,5,14,10,12,53,50,3,52
Elgin,2837,6,15,6,15,54,60,-6,51
Annan Athlet,2837,7,11,11,14,47,42,5,44
Berwick,2837,8,8,11,17,31,60,-29,35
Edinburgh Ci,2837,9,8,9,19,39,61,-22,33
Cowdenbeath,2837,10,5,10,21,24,54,-30,25
Montrose,2838,1,24,7,5,61,35,26,79
Peterhead,2838,2,24,4,8,79,38,41,76
Stirling,2838,3,17,6,13,63,51,12,57
Stenhousem'r,2838,4,15,8,13,55,49,6,53
Clyde,2838,5,14,10,12,51,48,3,52
Elgin,2838,6,14,6,16,54,62,-8,48
Annan Athlet,2838,7,12,11,13,48,41,7,47
Berwick,2838,8,8,11,17,29,58,-29,35
Edinburgh Ci,2838,9,7,9,20,36,62,-26,30
Cowdenbeath,2838,10,4,10,22,23,55,-32,22
Peterhead,2839,1,24,4,8,79,39,40,76
Montrose,2839,2,23,7,6,61,37,24,76
Stirling,2839,3,17,6,13,64,51,13,57
Clyde,2839,4,15,9,12,53,48,5,54
Stenhousem'r,2839,5,15,8,13,55,50,5,53
Elgin,2839,6,15,6,15,56,62,-6,51
Annan Athlet,2839,7,12,11,13,49,41,8,47
Berwick,2839,8,8,10,18,29,60,-31,34
Edinburgh Ci,2839,9,7,9,20,37,62,-25,30
Cowdenbeath,2839,10,4,10,22,23,56,-33,22
Montrose,2840,1,23,8,5,60,35,25,77
Peterhead,2840,2,24,4,8,81,38,43,76
Stirling,2840,3,17,6,13,62,51,11,57
Clyde,2840,4,15,9,12,53,49,4,54
Stenhousem'r,2840,5,15,8,13,55,48,7,53
Elgin,2840,6,14,7,15,54,61,-7,49
Annan Athlet,2840,7,12,11,13,49,42,7,47
Berwick,2840,8,8,10,18,30,60,-30,34
Edinburgh Ci,2840,9,7,9,20,36,64,-28,30
Cowdenbeath,2840,10,4,10,22,24,56,-32,22
Montrose,2841,1,23,8,5,60,35,25,77
Peterhead,2841,2,24,4,8,80,38,42,76
Stirling,2841,3,16,7,13,61,52,9,55
Stenhousem'r,2841,4,15,9,12,56,47,9,54
Clyde,2841,5,14,10,12,51,48,3,52
Elgin,2841,6,14,7,15,54,61,-7,49
Annan Athlet,2841,7,11,11,14,48,45,3,44
Berwick,2841,8,8,11,17,29,58,-29,35
Edinburgh Ci,2841,9,7,9,20,36,63,-27,30
Cowdenbeath,2841,10,5,10,21,27,55,-28,25
Montrose,2842,1,24,7,5,62,34,28,79
Peterhead,2842,2,24,4,8,80,38,42,76
Stirling,2842,3,16,7,13,61,52,9,55
Stenhousem'r,2842,4,15,9,12,56,47,9,54
Clyde,2842,5,15,9,12,54,48,6,54
Elgin,2842,6,14,6,16,53,63,-10,48
Annan Athlet,2842,7,11,12,13,49,43,6,45
Berwick,2842,8,8,10,18,29,61,-32,34
Edinburgh Ci,2842,9,7,9,20,36,63,-27,30
Cowdenbeath,2842,10,4,11,21,25,56,-31,23
Montrose,2843,1,24,7,5,61,35,26,79
Peterhead,2843,2,24,4,8,81,38,43,76
Stirling,2843,3,17,6,13,62,52,10,57
Stenhousem'r,2843,4,15,8,13,56,48,8,53
Clyde,2843,5,14,9,13,51,49,2,51
Elgin,2843,6,14,6,16,54,62,-8,48
Annan Athlet,2843,7,11,11,14,48,43,5,44
Berwick,2843,8,9,10,17,30,58,-28,37
Edinburgh Ci,2843,9,7,9,20,36,64,-28,30
Cowdenbeath,2843,10,5,10,21,25,55,-30,25
Montrose,2844,1,24,7,5,62,34,28,79
Peterhead,2844,2,24,4,8,81,39,42,76
Stirling,2844,3,16,7,13,60,51,9,55
Stenhousem'r,2844,4,15,9,12,55,46,9,54
Clyde,2844,5,15,9,12,53,48,5,54
Elgin,2844,6,14,6,16,53,63,-10,48
Annan Athlet,2844,7,11,11,14,47,42,5,44
Berwick,2844,8,8,10,18,29,60,-31,34
Edinburgh Ci,2844,9,7,9,20,37,64,-27,30
Cowdenbeath,2844,10,5,10,21,24,54,-30,25
Montrose,2845,1,23,8,5,60,35,25,77
Peterhead,2845,2,23,5,8,79,40,39,74
Stenhousem'r,2845,3,16,8,12,57,47,10,56
Stirling,2845,4,16,6,14,61,53,8,54
Clyde,2845,5,14,9,13,51,49,2,51
Elgin,2845,6,14,7,15,54,61,-7,49
Annan Athlet,2845,7,11,12,13,47,41,6,45
Berwick,2845,8,9,10,17,30,58,-28,37
Edinburgh Ci,2845,9,7,10,19,38,62,-24,31
Cowdenbeath,2845,10,4,11,21,23,54,-31,23
Montrose,2846,1,23,8,5,59,34,25,77
Peterhead,2846,2,24,4,8,80,40,40,76
Stirling,2846,3,17,6,13,66,52,14,57
Clyde,2846,4,15,9,12,52,48,4,54
Stenhousem'r,2846,5,15,8,13,56,52,4,53
Elgin,2846,6,14,7,15,53,60,-7,49
Annan Athlet,2846,7,12,11,13,53,42,11,47
Berwick,2846,8,8,10,18,29,59,-30,34
Edinburgh Ci,2846,9,7,9,20,38,63,-25,30
Cowdenbeath,2846,10,4,10,22,24,60,-36,22
Montrose,2847,1,24,7,5,62,36,26,79
Peterhead,2847,2,24,4,8,78,38,40,76
Stirling,2847,3,17,6,13,64,52,12,57
Clyde,2847,4,15,9,12,53,49,4,54
Stenhousem'r,2847,5,15,8,13,56,50,6,53
Elgin,2847,6,14,6,16,55,63,-8,48
Annan Athlet,2847,7,12,11,13,49,41,8,47
Berwick,2847,8,8,10,18,30,60,-30,34
Edinburgh Ci,2847,9,7,9,20,36,61,-25,30
Cowdenbeath,2847,10,4,10,22,23,56,-33,22
Montrose,2848,1,24,7,5,60,34,26,79
Peterhead,2848,2,24,4,8,80,40,40,76
Stirling,2848,3,17,6,13,61,51,10,57
Stenhousem'r,2848,4,15,8,13,55,47,8,53
Clyde,2848,5,14,10,12,53,50,3,52
Elgin,2848,6,14,6,16,53,61,-8,48
Annan Athlet,2848,7,11,12,13,47,41,6,45
Berwick,2848,8,8,11,17,31,60,-29,35
Edinburgh Ci,2848,9,7,9,20,38,63,-25,30
Cowdenbeath,2848,10,4,11,21,23,54,-31,23
Montrose,2849,1,24,7,5,61,35,26,79
Peterhead,2849,2,24,4,8,80,39,41,76
Stenhousem'r,2849,3,16,8,12,58,46,12,56
Stirling,2849,4,16,6,14,60,54,6,54
Clyde,2849,5,14,9,13,51,50,1,51
Elgin,2849,6,14,6,16,54,62,-8,48
Annan Athlet,2849,7,11,12,13,47,41,6,45
Berwick,2849,8,9,10,17,31,58,-27,37
Edinburgh Ci,2849,9,7,9,20,37,63,-26,30
Cowdenbeath,2849,10,4,11,21,23,54,-31,23
Montrose,2850,1,23,8,5,60,35,25,77
Peterhead,2850,2,24,4,8,82,38,44,76
Stirling,2850,3,17,6,13,65,52,13,57
Clyde,2850,4,15,9,12,53,48,5,54
Stenhousem'r,2850,5,15,8,13,56,51,5,53
Elgin,2850,6,14,7,15,54,61,-7,49
Annan Athlet,2850,7,11,12,13,48,42,6,45
Berwick,2850,8,8,10,18,29,60,-31,34
Edinburgh Ci,2850,9,7,9,20,36,65,-29,30
Cowdenbeath,2850,10,4,11,21,24,55,-31,23
Montrose,2851,1,24,7,5,62,35,27,79
Peterhead,2851,2,24,4,8,80,39,41,76
Stirling,2851,3,17,6,13,63,52,11,57
Stenhousem'r,2851,4,15,8,13,56,49,7,53
Clyde,2851,5,14,10,12,52,49,3,52
Elgin,2851,6,14,6,16,54,63,-9,48
Annan Athlet,2851,7,11,11,14,47,42,5,44
Berwick,2851,8,8,11,17,30,59,-29,35
Edinburgh Ci,2851,9,7,9,20,37,63,-26,30
Cowdenbeath,2851,10,5,10,21,24,54,-30,25
Montrose,2852,1,24,7,5,62,34,28,79
Peterhead,2852,2,24,4,8,78,38,40,76
Stirling,2852,3,17,6,13,61,51,10,57
Stenhousem'r,2852,4,15,8,13,55,47,8,53
Clyde,2852,5,14,10,12,52,49,3,52
Elgin,2852,6,14,6,16,53,63,-10,48
Annan Athlet,2852,7,12,11,13,48,41,7,47
Berwick,2852,8,8,11,17,30,59,-29,35
Edinburgh Ci,2852,9,7,9,20,36,61,-25,30
Cowdenbeath,2852,10,4,10,22,23,55,-32,22
Montrose,2853,1,24,7,5,61,35,26,79
Peterhead,2853,2,23,5,8,80,41,39,74
Stirling,2853,3,17,6,13,63,52,11,57
Clyde,2853,4,15,9,12,53,48,5,54
Stenhousem'r,2853,5,15,8,13,56,49,7,53
Elgin,2853,6,14,6,16,54,62,-8,48
Annan Athlet,2853,7,12,11,13,49,42,7,47
Berwick,2853,8,8,10,18,29,60,-31,34
Edinburgh Ci,2853,9,7,10,19,39,63,-24,31
Cowdenbeath,2853,10,4,10,22,24,56,-32,22
Montrose,2854,1,24,7,5,62,36,26,79
Peterhead,2854,2,24,4,8,81,38,43,76
Stirling,2854,3,16,7,13,61,52,9,55
Stenhousem'r,2854,4,15,9,12,56,47,9,54
Clyde,2854,5,15,9,12,52,48,4,54
Elgin,2854,6,14,6,16,55,63,-8,48
Annan Athlet,2854,7,11,11,14,47,42,5,44
Berwick,2854,8,8,10,18,29,59,-30,34
Edinburgh Ci,2854,9,7,9,20,36,64,-28,30
Cowdenbeath,2854,10,5,10,21,24,54,-30,25
Montrose,2855,1,23,8,5,60,35,25,77
Peterhead,2855,2,23,4,9,77,40,37,73
Stirling,2855,3,17,6,13,62,51,11,57
Clyde,2855,4,15,9,12,53,48,5,54
Stenhousem'r,2855,5,15,8,13,55,48,7,53
Elgin,2855,6,14,7,15,54,61,-7,49
Annan Athlet,2855,7,11,12,13,49,43,6,45
Berwick,2855,8,8,10,18,29,60,-31,34
Edinburgh Ci,2855,9,8,9,19,38,60,-22,33
Cowdenbeath,2855,10,4,11,21,25,56,-31,23
Peterhead,2856,1,24,4,8,79,39,40,76
Montrose,2856,2,23,7,6,59,35,24,76
Stirling,2856,3,17,6,13,62,51,11,57
Clyde,2856,4,15,9,12,54,49,5,54
Stenhousem'r,2856,5,15,8,13,55,48,7,53
Elgin,2856,6,15,6,15,54,60,-6,51
Annan Athlet,2856,7,11,11,14,48,43,5,44
Berwick,2856,8,8,10,18,30,61,-31,34
Edinburgh Ci,2856,9,7,9,20,37,62,-25,30
Cowdenbeath,2856,10,5,10,21,25,55,-30,25
Montrose,2857,1,24,7,5,64,36,28,79
Peterhead,2857,2,23,5,8,78,39,39,74
Stirling,2857,3,17,6,13,64,52,12,57
Clyde,2857,4,15,9,12,54,48,6,54
Stenhousem'r,2857,5,15,8,13,56,50,6,53
Elgin,2857,6,14,6,16,55,65,-10,48
Annan Athlet,2857,7,12,11,13,52,42,10,47
Berwick,2857,8,8,10,18,29,61,-32,34
Edinburgh Ci,2857,9,7,10,19,37,61,-24,31
Cowdenbeath,2857,10,4,10,22,24,59,-35,22
Montrose,2858,1,24,7,5,62,35,27,79
Peterhead,2858,2,24,4,8,83,38,45,76
Stirling,2858,3,17,6,13,61,51,10,57
Stenhousem'r,2858,4,15,8,13,55,47,8,53
Clyde,2858,5,14,10,12,52,49,3,52
Elgin,2858,6,14,6,16,54,63,-9,48
Annan Athlet,2858,7,11,12,13,48,42,6,45
Berwick,2858,8,8,11,17,30,59,-29,35
Edinburgh Ci,2858,9,7,9,20,36,66,-30,30
Cowdenbeath,2858,10,4,11,21,24,55,-31,23
Montrose,2859,1,23,7,6,61,38,23,76
Peterhead,2859,2,23,5,8,78,39,39,74
Stirling,2859,3,17,6,13,64,53,11,57
Clyde,2859,4,15,9,12,54,48,6,54
Stenhousem'r,2859,5,15,8,13,57,50,7,53
Elgin,2859,6,15,6,15,57,62,-5,51
Annan Athlet,2859,7,11,12,13,47,41,6,45
Berwick,2859,8,8,10,18,29,61,-32,34
Edinburgh Ci,2859,9,7,10,19,37,61,-24,31
Cowdenbeath,2859,10,4,11,21,23,54,-31,23
Peterhead,2860,1,24,4,8,82,38,44,76
Montrose,2860,2,23,7,6,59,35,24,76
Stirling,2860,3,17,6,13,64,52,12,57
Stenhousem'r,2860,4,15,8,13,56,50,6,53
Clyde,2860,5,14,9,13,52,51,1,51
Elgin,2860,6,15,6,15,54,60,-6,51
Annan Athlet,2860,7,11,11,14,48,43,5,44
Berwick,2860,8,9,10,17,32,59,-27,37
Edinburgh Ci,2860,9,7,9,20,36,65,-29,30
Cowdenbeath,2860,10,5,10,21,25,55,-30,25
Montrose,2861,1,23,8,5,59,34,25,77
Peterhead,2861,2,23,5,8,77,38,39,74
Stirling,2861,3,17,6,13,62,51,11,57
Stenhousem'r,2861,4,15,8,13,55,48,7,53
Clyde,2861,5,14,10,12,52,49,3,52
Elgin,2861,6,14,7,15,53,60,-7,49
Annan Athlet,2861,7,11,12,13,47,41,6,45
Berwick,2861,8,8,11,17,30,59,-29,35
Edinburgh Ci,2861,9,7,10,19,36,60,-24,31
Cowdenbeath,2861,10,4,11,21,23,54,-31,23
Montrose,2862,1,24,7,5,62,35,27,79
Peterhead,2862,2,23,4,9,78,40,38,73
Stirling,2862,3,17,6,13,64,52,12,57
Stenhousem'r,2862,4,15,8,13,56,50,6,53
Clyde,2862,5,14,10,12,51,48,3,52
Elgin,2862,6,14,6,16,54,63,-9,48
Annan Athlet,2862,7,12,11,13,49,41,8,47
Berwick,2862,8,8,11,17,29,58,-29,35
Edinburgh Ci,2862,9,8,9,19,38,61,-23,33
Cowdenbeath,2862,10,4,10,22,23,56,-33,22
Montrose,2863,1,23,7,6,59,36,23,76
Peterhead,2863,2,23,4,9,78,41,37,73
Stenhousem'r,2863,3,16,8,12,58,48,10,56
Stirling,2863,4,16,6,14,62,54,8,54
Clyde,2863,5,15,9,12,54,48,6,54
Elgin,2863,6,15,6,15,55,60,-5,51
Annan Athlet,2863,7,12,11,13,49,41,8,47
Berwick,2863,8,8,10,18,29,61,-32,34
Edinburgh Ci,2863,9,8,9,19,39,61,-22,33
Cowdenbeath,2863,10,4,10,22,23,56,-33,22
Peterhead,2864,1,24,4,8,78,38,40,76
Montrose,2864,2,23,7,6,60,36,24,76
Stenhousem'r,2864,3,16,8,12,56,46,10,56
Stirling,2864,4,16,6,14,60,52,8,54
Clyde,2864,5,14,9,13,51,49,2,51
Elgin,2864,6,15,6,15,55,61,-6,51
Annan Athlet,2864,7,11,12,13,48,42,6,45
Berwick,2864,8,9,10,17,30,58,-28,37
Edinburgh Ci,2864,9,7,9,20,36,61,-25,30
Cowdenbeath,2864,10,4,11,21,24,55,-31,23
Montrose,2865,1,23,8,5,60,35,25,77
Peterhead,2865,2,23,4,9,78,41,37,73
Stirling,2865,3,16,7,13,62,53,9,55
Stenhousem'r,2865,4,15,9,12,57,48,9,54
Clyde,2865,5,15,9,12,57,51,6,54
Elgin,2865,6,14,7,15,54,61,-7,49
Annan Athlet,2865,7,12,11,13,48,41,7,47
Berwick,2865,8,8,10,18,32,64,-32,34
Edinburgh Ci,2865,9,8,9,19,39,61,-22,33
Cowdenbeath,2865,10,4,10,22,23,55,-32,22
Montrose,2866,1,23,8,5,61,36,25,77
Peterhead,2866,2,24,4,8,80,38,42,76
Stirling,2866,3,17,6,13,65,51,14,57
Clyde,2866,4,15,9,12,53,48,5,54
Stenhousem'r,2866,5,15,8,13,55,51,4,53
Elgin,2866,6,14,7,15,55,62,-7,49
Annan Athlet,2866,7,12,11,13,50,42,8,47
Berwick,2866,8,8,10,18,29,60,-31,34
Edinburgh Ci,2866,9,7,9,20,36,63,-27,30
Cowdenbeath,2866,10,4,10,22,24,57,-33,22
Montrose,2867,1,23,8,5,60,35,25,77
Peterhead,2867,2,24,4,8,80,38,42,76
Stirling,2867,3,17,6,13,62,52,10,57
Clyde,2867,4,15,9,12,54,49,5,54
Stenhousem'r,2867,5,15,8,13,56,48,8,53
Elgin,2867,6,14,7,15,54,61,-7,49
Annan Athlet,2867,7,11,11,14,47,44,3,44
Berwick,2867,8,8,10,18,30,61,-31,34
Edinburgh Ci,2867,9,7,9,20,36,63,-27,30
Cowdenbeath,2867,10,5,10,21,26,54,-28,25
Montrose,2868,1,24,7,5,63,34,29,79
Peterhead,2868,2,24,4,8,80,40,40,76
Stirling,2868,3,16,7,13,61,52,9,55
Stenhousem'r,2868,4,15,9,12,56,47,9,54
Clyde,2868,5,14,9,13,51,50,1,51
Elgin,2868,6,14,6,16,53,64,-11,48
Annan Athlet,2868,7,11,11,14,48,44,4,44
Berwick,2868,8,9,10,17,31,58,-27,37
Edinburgh Ci,2868,9,7,9,20,38,63,-25,30
Cowdenbeath,2868,10,5,10,21,26,55,-29,25
Montrose,2869,1,24,7,5,62,35,27,79
Peterhead,2869,2,24,4,8,81,38,43,76
Stenhousem'r,2869,3,16,8,12,57,46,11,56
Stirling,2869,4,16,6,14,60,53,7,54
Clyde,2869,5,15,9,12,55,50,5,54
Elgin,2869,6,14,6,16,54,63,-9,48
Annan Athlet,2869,7,12,11,13,49,41,8,47
Berwick,2869,8,8,10,18,31,62,-31,34
Edinburgh Ci,2869,9,7,9,20,36,64,-28,30
Cowdenbeath,2869,10,4,10,22,23,56,-33,22
Montrose,2870,1,23,7,6,59,35,24,76
Peterhead,2870,2,23,5,8,79,40,39,74
Stirling,2870,3,17,6,13,63,52,11,57
Clyde,2870,4,15,9,12,53,48,5,54
Stenhousem'r,2870,5,15,8,13,56,49,7,53
Elgin,2870,6,15,6,15,54,60,-6,51
Annan Athlet,2870,7,12,11,13,48,41,7,47
Berwick,2870,8,8,10,18,29,60,-31,34
Edinburgh Ci,2870,9,7,10,19,38,62,-24,31
Cowdenbeath,2870,10,4,10,22,23,55,-32,22
Montrose,2871,1,24,7,5,64,37,27,79
Peterhead,2871,2,23,5,8,78,39,39,74
Stirling,2871,3,16,7,13,61,52,9,55
Stenhousem'r,2871,4,15,9,12,56,47,9,54
Clyde,2871,5,15,9,12,56,49,7,54
Elgin,2871,6,14,6,16,56,65,-9,48
Annan Athlet,2871,7,12,11,13,51,41,10,47
Berwick,2871,8,8,10,18,30,63,-33,34
Edinburgh Ci,2871,9,7,10,19,37,61,-24,31
Cowdenbeath,2871,10,4,10,22,23,58,-35,22
Montrose,2872,1,24,7,5,61,34,27,79
Peterhead,2872,2,24,4,8,81,38,43,76
Stirling,2872,3,17,6,13,63,52,11,57
Clyde,2872,4,15,9,12,55,49,6,54
Stenhousem'r,2872,5,15,8,13,56,49,7,53
Elgin,2872,6,14,6,16,53,62,-9,48
Annan Athlet,2872,7,11,12,13,47,41,6,45
Berwick,2872,8,8,10,18,30,62,-32,34
Edinburgh Ci,2872,9,7,9,20,36,64,-28,30
Cowdenbeath,2872,10,4,11,21,23,54,-31,23
Montrose,2873,1,23,8,5,60,35,25,77
Peterhead,2873,2,24,4,8,79,39,40,76
Stirling,2873,3,17,6,13,62,52,10,57
Clyde,2873,4,15,9,12,53,49,4,54
Stenhousem'r,2873,5,15,8,13,56,48,8,53
Elgin,2873,6,14,7,15,54,61,-7,49
Annan Athlet,2873,7,11,12,13,48,42,6,45
Berwick,2873,8,8,10,18,30,60,-30,34
Edinburgh Ci,2873,9,7,9,20,37,62,-25,30
Cowdenbeath,2873,10,4,11,21,24,55,-31,23
Peterhead,2874,1,24,4,8,80,39,41,76
Montrose,2874,2,23,7,6,60,36,24,76
Stirling,2874,3,17,6,13,63,53,10,57
Clyde,2874,4,15,9,12,54,48,6,54
Stenhousem'r,2874,5,15,8,13,57,49,8,53
Elgin,2874,6,15,6,15,55,61,-6,51
Annan Athlet,2874,7,12,11,13,48,41,7,47
Berwick,2874,8,8,10,18,29,61,-32,34
Edinburgh Ci,2874,9,7,9,20,37,63,-26,30
Cowdenbeath,2874,10,4,10,22,23,55,-32,22
Montrose,2875,1,23,8,5,60,35,25,77
Peterhead,2875,2,23,5,8,77,38,39,74
Stirling,2875,3,17,6,13,62,51,11,57
Clyde,2875,4,15,9,12,54,48,6,54
Stenhousem'r,2875,5,15,8,13,55,48,7,53
Elgin,2875,6,14,7,15,54,61,-7,49
Annan Athlet,2875,7,11,12,13,48,42,6,45
Berwick,2875,8,8,10,18,29,61,-32,34
Edinburgh Ci,2875,9,7,10,19,36,60,-24,31
Cowdenbeath,2875,10,4,11,21,24,55,-31,23
Peterhead,2876,1,24,4,8,80,38,42,76
Montrose,2876,2,23,7,6,60,36,24,76
Stirling,2876,3,16,7,13,61,52,9,55
Stenhousem'r,2876,4,15,9,12,56,47,9,54
Clyde,2876,5,15,9,12,54,48,6,54
Elgin,2876,6,15,6,15,55,61,-6,51
Annan Athlet,2876,7,11,11,14,47,42,5,44
Berwick,2876,8,8,10,18,29,61,-32,34
Edinburgh Ci,2876,9,7,9,20,36,63,-27,30
Cowdenbeath,2876,10,5,10,21,24,54,-30,25
Montrose,2877,1,24,7,5,61,35,26,79
Peterhead,2877,2,23,5,8,78,39,39,74
Stirling,2877,3,16,7,13,61,52,9,55
Stenhousem'r,2877,4,15,9,12,56,47,9,54
Clyde,2877,5,15,9,12,53,49,4,54
Elgin,2877,6,14,6,16,54,62,-8,48
Annan Athlet,2877,7,11,11,14,47,44,3,44
Berwick,2877,8,8,10,18,30,60,-30,34
Edinburgh Ci,2877,9,7,10,19,37,61,-24,31
Cowdenbeath,2877,10,5,10,21,26,54,-28,25
Montrose,2878,1,23,7,6,60,36,24,76
Peterhead,2878,2,23,5,8,77,38,39,74
Stirling,2878,3,16,7,13,60,51,9,55
Stenhousem'r,2878,4,15,9,12,55,46,9,54
Clyde,2878,5,15,9,12,54,49,5,54
Elgin,2878,6,15,6,15,55,61,-6,51
Annan Athlet,2878,7,12,11,13,48,41,7,47
Berwick,2878,8,8,10,18,30,61,-31,34
Edinburgh Ci,2878,9,7,10,19,36,60,-24,31
Cowdenbeath,2878,10,4,10,22,23,55,-32,22
Montrose,2879,1,24,7,5,61,35,26,79
Peterhead,2879,2,24,4,8,82,38,44,76
Stenhousem'r,2879,3,16,8,12,57,47,10,56
Stirling,2879,4,16,6,14,61,53,8,54
Clyde,2879,5,15,9,12,54,48,6,54
Elgin,2879,6,14,6,16,54,62,-8,48
Annan Athlet,2879,7,12,11,13,48,41,7,47
Berwick,2879,8,8,10,18,29,61,-32,34
Edinburgh Ci,2879,9,7,9,20,36,65,-29,30
Cowdenbeath,2879,10,4,10,22,23,55,-32,22
Montrose,2880,1,23,8,5,59,34,25,77
Peterhead,2880,2,24,4,8,78,38,40,76
Stenhousem'r,2880,3,16,8,12,58,46,12,56
Clyde,2880,4,15,9,12,55,48,7,54
Stirling,2880,5,16,6,14,60,54,6,54
Elgin,2880,6,14,7,15,53,60,-7,49
Annan Athlet,2880,7,12,11,13,51,41,10,47
Berwick,2880,8,8,10,18,29,62,-33,34
Edinburgh Ci,2880,9,7,9,20,36,61,-25,30
Cowdenbeath,2880,10,4,10,22,23,58,-35,22
Montrose,2881,1,23,8,5,61,36,25,77
Peterhead,2881,2,24,4,8,81,38,43,76
Stenhousem'r,2881,3,16,8,12,58,48,10,56
Stirling,2881,4,16,6,14,62,54,8,54
Clyde,2881,5,15,9,12,53,48,5,54
Elgin,2881,6,14,7,15,55,62,-7,49
Annan Athlet,2881,7,12,11,13,49,41,8,47
Berwick,2881,8,8,10,18,29,60,-31,34
Edinburgh Ci,2881,9,7,9,20,36,64,-28,30
Cowdenbeath,2881,10,4,10,22,23,56,-33,22
Peterhead,2882,1,24,4,8,79,38,41,76
Montrose,2882,2,23,7,6,59,36,23,76
Stenhousem'r,2882,3,16,8,12,57,47,10,56
Stirling,2882,4,16,6,14,61,53,8,54
Clyde,2882,5,14,10,12,51,48,3,52
Elgin,2882,6,15,6,15,55,60,-5,51
Annan Athlet,2882,7,11,12,13,47,41,6,45
Berwick,2882,8,8,11,17,29,58,-29,35
Edinburgh Ci,2882,9,7,9,20,36,62,-26,30
Cowdenbeath,2882,10,4,11,21,23,54,-31,23
Montrose,2883,1,24,7,5,62,36,26,79
Peterhead,2883,2,24,4,8,79,38,41,76
Stirling,2883,3,17,6,13,61,51,10,57
Stenhousem'r,2883,4,15,8,13,55,47,8,53
Clyde,2883,5,14,9,13,51,50,1,51
Elgin,2883,6,14,6,16,55,63,-8,48
Annan Athlet,2883,7,11,11,14,47,42,5,44
Berwick,2883,8,9,10,17,31,58,-27,37
Edinburgh Ci,2883,9,7,9,20,36,62,-26,30
Cowdenbeath,2883,10,5,10,21,24,54,-30,25
Montrose,2884,1,24,7,5,62,35,27,79
Peterhead,2884,2,24,4,8,83,39,44,76
Stirling,2884,3,17,6,13,66,51,15,57
Stenhousem'r,2884,4,15,8,13,55,52,3,53
Clyde,2884,5,14,9,13,51,49,2,51
Elgin,2884,6,14,6,16,54,63,-9,48
Annan Athlet,2884,7,12,11,13,48,41,7,47
Berwick,2884,8,9,10,17,30,58,-28,37
Edinburgh Ci,2884,9,7,9,20,37,66,-29,30
Cowdenbeath,2884,10,4,10,22,23,55,-32,22
Peterhead,2885,1,24,4,8,79,39,40,76
Montrose,2885,2,23,7,6,59,35,24,76
Stenhousem'r,2885,3,16,8,12,57,46,11,56
Stirling,2885,4,16,6,14,60,53,7,54
Clyde,2885,5,15,9,12,54,48,6,54
Elgin,2885,6,15,6,15,54,60,-6,51
Annan Athlet,2885,7,12,11,13,49,41,8,47
Berwick,2885,8,8,10,18,29,61,-32,34
Edinburgh Ci,2885,9,7,9,20,37,62,-25,30
Cowdenbeath,2885,10,4,10,22,23,56,-33,22
Montrose,2886,1,24,7,5,60,34,26,79
Peterhead,2886,2,23,5,8,78,39,39,74
Stirling,2886,3,17,6,13,62,51,11,57
Clyde,2886,4,15,9,12,53,48,5,54
Stenhousem'r,2886,5,15,8,13,55,48,7,53
Elgin,2886,6,14,6,16,53,61,-8,48
Annan Athlet,2886,7,12,11,13,48,41,7,47
Berwick,2886,8,8,10,18,29,60,-31,34
Edinburgh Ci,2886,9,7,10,19,37,61,-24,31
Cowdenbeath,2886,10,4,10,22,23,55,-32,22
Montrose,2887,1,24,7,5,62,36,26,79
Peterhead,2887,2,23,5,8,78,39,39,74
Stirling,2887,3,17,6,13,61,51,10,57
Clyde,2887,4,15,9,12,54,50,4,54
Stenhousem'r,2887,5,15,8,13,55,47,8,53
Elgin,2887,6,14,6,16,55,63,-8,48
Annan Athlet,2887,7,11,11,14,47,43,4,44
Berwick,2887,8,8,10,18,31,61,-30,34
Edinburgh Ci,2887,9,7,10,19,37,61,-24,31
Cowdenbeath,2887,10,5,10,21,25,54,-29,25
Peterhead,2888,1,24,4,8,78,38,40,76
Montrose,2888,2,23,7,6,60,36,24,76
Stirling,2888,3,17,6,13,62,51,11,57
Clyde,2888,4,15,9,12,55,48,7,54
Stenhousem'r,2888,5,15,8,13,55,48,7,53
Elgin,2888,6,15,6,15,55,61,-6,51
Annan Athlet,2888,7,11,12,13,47,41,6,45
Berwick,2888,8,8,10,18,29,62,-33,34
Edinburgh Ci,2888,9,7,9,20,36,61,-25,30
Cowdenbeath,2888,10,4,11,21,23,54,-31,23
Montrose,2889,1,23,8,5,59,34,25,77
Peterhead,2889,2,24,4,8,79,38,41,76
Stenhousem'r,2889,3,16,8,12,56,46,10,56
Stirling,2889,4,16,6,14,60,52,8,54
Clyde,2889,5,14,10,12,52,49,3,52
Elgin,2889,6,14,7,15,53,60,-7,49
Annan Athlet,2889,7,11,12,13,48,42,6,45
Berwick,2889,8,8,11,17,30,59,-29,35
Edinburgh Ci,2889,9,7,9,20,36,62,-26,30
Cowdenbeath,2889,10,4,11,21,24,55,-31,23
Montrose,2890,1,24,7,5,62,36,26,79
Peterhead,2890,2,23,5,8,79,40,39,74
Stirling,2890,3,16,7,13,61,52,9,55
Stenhousem'r,2890,4,15,9,12,56,47,9,54
Clyde,2890,5,15,9,12,55,48,7,54
Elgin,2890,6,14,6,16,55,63,-8,48
Annan Athlet,2890,7,11,12,13,48,42,6,45
Berwick,2890,8,8,10,18,29,62,-33,34
Edinburgh Ci,2890,9,7,10,19,38,62,-24,31
Cowdenbeath,2890,10,4,11,21,24,55,-31,23
Montrose,2891,1,24,7,5,63,35,28,79
Peterhead,2891,2,24,4,8,79,38,41,76
Stirling,2891,3,16,7,13,61,52,9,55
Stenhousem'r,2891,4,15,9,12,56,47,9,54
Clyde,2891,5,14,10,12,51,48,3,52
Elgin,2891,6,14,6,16,54,64,-10,48
Annan Athlet,2891,7,11,12,13,47,41,6,45
Berwick,2891,8,8,11,17,29,58,-29,35
Edinburgh Ci,2891,9,7,9,20,36,62,-26,30
Cowdenbeath,2891,10,4,11,21,23,54,-31,23
Montrose,2892,1,24,7,5,62,35,27,79
Peterhead,2892,2,24,4,8,79,38,41,76
Stirling,2892,3,16,7,13,62,53,9,55
Stenhousem'r,2892,4,15,9,12,57,48,9,54
Clyde,2892,5,15,9,12,54,48,6,54
Elgin,2892,6,14,6,16,54,63,-9,48
Annan Athlet,2892,7,11,12,13,47,41,6,45
Berwick,2892,8,8,10,18,29,61,-32,34
Edinburgh Ci,2892,9,7,9,20,36,62,-26,30
Cowdenbeath,2892,10,4,11,21,23,54,-31,23
Montrose,2893,1,24,7,5,60,34,26,79
Peterhead,2893,2,24,4,8,78,38,40,76
Stenhousem'r,2893,3,16,8,12,56,46,10,56
Stirling,2893,4,16,6,14,60,52,8,54
Clyde,2893,5,14,10,12,52,49,3,52
Elgin,2893,6,14,6,16,53,61,-8,48
Annan Athlet,2893,7,12,11,13,48,41,7,47
Berwick,2893,8,8,11,17,30,59,-29,35
Edinburgh Ci,2893,9,7,9,20,36,61,-25,30
Cowdenbeath,2893,10,4,10,22,23,55,-32,22
Montrose,2894,1,24,7,5,61,35,26,79
Peterhead,2894,2,24,4,8,80,39,41,76
Stirling,2894,3,16,7,13,60,51,9,55
Stenhousem'r,2894,4,15,9,12,55,46,9,54
Clyde,2894,5,14,10,12,53,50,3,52
Elgin,2894,6,14,6,16,54,62,-8,48
Annan Athlet,2894,7,11,11,14,48,43,5,44
Berwick,2894,8,8,11,17,31,60,-29,35
Edinburgh Ci,2894,9,7,9,20,37,63,-26,30
Cowdenbeath,2894,10,5,10,21,25,55,-30,25
Peterhead,2895,1,24,4,8,81,39,42,76
Montrose,2895,2,23,7,6,60,36,24,76
Stirling,2895,3,16,7,13,61,52,9,55
Stenhousem'r,2895,4,15,9,12,56,47,9,54
Clyde,2895,5,15,9,12,53,49,4,54
Elgin,2895,6,15,6,15,55,61,-6,51
Annan Athlet,2895,7,11,12,13,47,41,6,45
Berwick,2895,8,8,10,18,30,60,-30,34
Edinburgh Ci,2895,9,7,9,20,37,64,-27,30
Cowdenbeath,2895,10,4,11,21,23,54,-31,23
Montrose,2896,1,23,8,5,60,35,25,77
Peterhead,2896,2,23,5,8,77,38,39,74
Stirling,2896,3,17,6,13,63,51,12,57
Clyde,2896,4,15,9,12,54,49,5,54
Stenhousem'r,2896,5,15,8,13,55,49,6,53
Elgin,2896,6,14,7,15,54,61,-7,49
Annan Athlet,2896,7,12,11,13,49,42,7,47
Berwick,2896,8,8,10,18,30,61,-31,34
Edinburgh Ci,2896,9,7,10,19,36,60,-24,31
Cowdenbeath,2896,10,4,10,22,24,56,-32,22
Montrose,2897,1,23,7,6,60,36,24,76
Peterhead,2897,2,23,5,8,79,40,39,74
Stenhousem'r,2897,3,16,8,12,57,47,10,56
Stirling,2897,4,16,6,14,61,53,8,54
Clyde,2897,5,14,10,12,52,49,3,52
Elgin,2897,6,15,6,15,55,61,-6,51
Annan Athlet,2897,7,12,11,13,50,41,9,47
Berwick,2897,8,8,11,17,30,59,-29,35
Edinburgh Ci,2897,9,7,10,19,38,62,-24,31
Cowdenbeath,2897,10,4,10,22,23,57,-34,22
Montrose,2898,1,24,7,5,61,35,26,79
Peterhead,2898,2,24,4,8,82,38,44,76
Stirling,2898,3,17,6,13,61,51,10,57
Stenhousem'r,2898,4,15,8,13,55,47,8,53
Clyde,2898,5,14,9,13,52,50,2,51
Elgin,2898,6,14,6,16,54,62,-8,48
Annan Athlet,2898,7,11,12,13,48,42,6,45
Berwick,2898,8,9,10,17,31,59,-28,37
Edinburgh Ci,2898,9,7,9,20,36,65,-29,30
Cowdenbeath,2898,10,4,11,21,24,55,-31,23
Montrose,2899,1,24,7,5,60,34,26,79
Peterhead,2899,2,24,4,8,78,38,40,76
Stirling,2899,3,16,7,13,60,51,9,55
Stenhousem'r,2899,4,15,9,12,55,46,9,54
Clyde,2899,5,15,9,12,52,48,4,54
Elgin,2899,6,14,6,16,53,61,-8,48
Annan Athlet,2899,7,12,11,13,48,41,7,47
Berwick,2899,8,8,10,18,29,59,-30,34
Edinburgh Ci,2899,9,7,9,20,36,61,-25,30
Cowdenbeath,2899,10,4,10,22,23,55,-32,22
Montrose,2900,1,23,7,6,60,36,24,76
Peterhead,2900,2,23,5,8,78,39,39,74
Stirling,2900,3,16,7,13,61,52,9,55
Stenhousem'r,2900,4,15,9,12,56,47,9,54
Clyde,2900,5,14,10,12,52,49,3,52
Elgin,2900,6,15,6,15,55,61,-6,51
Annan Athlet,2900,7,12,11,13,51,41,10,47
Berwick,2900,8,8,11,17,30,59,-29,35
Edinburgh Ci,2900,9,7,10,19,37,61,-24,31
Cowdenbeath,2900,10,4,10,22,23,58,-35,22
Montrose,2901,1,24,7,5,61,34,27,79
Peterhead,2901,2,24,4,8,80,39,41,76
Stenhousem'r,2901,3,16,8,12,57,47,10,56
Stirling,2901,4,16,6,14,61,53,8,54
Clyde,2901,5,15,9,12,53,48,5,54
Elgin,2901,6,14,6,16,53,62,-9,48
Annan Athlet,2901,7,12,11,13,50,41,9,47
Berwick,2901,8,8,10,18,29,60,-31,34
Edinburgh Ci,2901,9,7,9,20,37,63,-26,30
Cowdenbeath,2901,10,4,10,22,23,57,-34,22
Montrose,2902,1,24,7,5,63,36,27,79
Peterhead,2902,2,24,4,8,80,40,40,76
Stirling,2902,3,17,6,13,62,52,10,57
Stenhousem'r,2902,4,15,8,13,56,48,8,53
Clyde,2902,5,14,9,13,51,49,2,51
Elgin,2902,6,14,6,16,55,64,-9,48
Annan Athlet,2902,7,12,11,13,50,42,8,47
Berwick,2902,8,9,10,17,30,58,-28,37
Edinburgh Ci,2902,9,7,9,20,38,63,-25,30
Cowdenbeath,2902,10,4,10,22,24,57,-33,22
Montrose,2903,1,24,7,5,62,36,26,79
Peterhead,2903,2,23,5,8,78,39,39,74
Stirling,2903,3,17,6,13,62,52,10,57
Clyde,2903,4,15,9,12,53,48,5,54
Stenhousem'r,2903,5,15,8,13,56,48,8,53
Elgin,2903,6,14,6,16,55,63,-8,48
Annan Athlet,2903,7,12,11,13,49,42,7,47
Berwick,2903,8,8,10,18,29,60,-31,34
Edinburgh Ci,2903,9,7,10,19,37,61,-24,31
Cowdenbeath,2903,10,4,10,22,24,56,-32,22
Montrose,2904,1,24,7,5,61,34,27,79
Peterhead,2904,2,24,4,8,78,38,40,76
Stirling,2904,3,17,6,13,62,51,11,57
Stenhousem'r,2904,4,15,8,13,55,48,7,53
Clyde,2904,5,14,9,13,53,51,2,51
Elgin,2904,6,14,6,16,53,62,-9,48
Annan Athlet,2904,7,12,11,13,48,41,7,47
Berwick,2904,8,9,10,17,32,60,-28,37
Edinburgh Ci,2904,9,7,9,20,36,61,-25,30
Cowdenbeath,2904,10,4,10,22,23,55,-32,22
Montrose,2905,1,24,7,5,62,34,28,79
Peterhead,2905,2,24,4,8,80,38,42,76
Stirling,2905,3,17,6,13,65,53,12,57
Stenhousem'r,2905,4,15,8,13,57,51,6,53
Clyde,2905,5,14,9,13,52,50,2,51
Elgin,2905,6,14,6,16,53,63,-10,48
Annan Athlet,2905,7,11,12,13,48,42,6,45
Berwick,2905,8,9,10,17,31,59,-28,37
Edinburgh Ci,2905,9,7,9,20,36,63,-27,30
Cowdenbeath,2905,10,4,11,21,24,55,-31,23
Montrose,2906,1,24,7,5,63,34,29,79
Peterhead,2906,2,24,4,8,78,38,40,76
Stirling,2906,3,17,6,13,64,53,11,57
Clyde,2906,4,15,9,12,53,49,4,54
Stenhousem'r,2906,5,15,8,13,57,50,7,53
Elgin,2906,6,14,6,16,53,64,-11,48
Annan Athlet,2906,7,12,11,13,49,41,8,47
Berwick,2906,8,8,10,18,30,60,-30,34
Edinburgh Ci,2906,9,7,9,20,36,61,-25,30
Cowdenbeath,2906,10,4,10,22,23,56,-33,22
Montrose,2907,1,23,8,5,59,34,25,77
Peterhead,2907,2,24,4,8,80,38,42,76
Stenhousem'r,2907,3,16,8,12,58,48,10,56
Stirling,2907,4,16,6,14,62,54,8,54
Clyde,2907,5,14,9,13,52,50,2,51
Elgin,2907,6,14,7,15,53,60,-7,49
Annan Athlet,2907,7,11,11,14,47,43,4,44
Berwick,2907,8,9,10,17,31,59,-28,37
Edinburgh Ci,2907,9,7,9,20,36,63,-27,30
Cowdenbeath,2907,10,5,10,21,25,54,-29,25
Montrose,2908,1,24,7,5,60,34,26,79
Peterhead,2908,2,24,4,8,81,40,41,76
Stirling,2908,3,17,6,13,64,51,13,57
Stenhousem'r,2908,4,15,8,13,55,50,5,53
Clyde,2908,5,14,9,13,52,50,2,51
Elgin,2908,6,14,6,16,53,61,-8,48
Annan Athlet,2908,7,12,11,13,50,41,9,47
Berwick,2908,8,9,10,17,31,59,-28,37
Edinburgh Ci,2908,9,7,9,20,38,64,-26,30
Cowdenbeath,2908,10,4,10,22,23,57,-34,22
Montrose,2909,1,24,7,5,62,34,28,79
Peterhead,2909,2,24,4,8,80,39,41,76
Stirling,2909,3,17,6,13,62,51,11,57
Clyde,2909,4,15,9,12,53,48,5,54
Stenhousem'r,2909,5,15,8,13,55,48,7,53
Elgin,2909,6,14,6,16,53,63,-10,48
Annan Athlet,2909,7,11,11,14,47,43,4,44
Berwick,2909,8,8,10,18,29,60,-31,34
Edinburgh Ci,2909,9,7,9,20,37,63,-26,30
Cowdenbeath,2909,10,5,10,21,25,54,-29,25
Peterhead,2910,1,24,4,8,80,39,41,76
Montrose,2910,2,23,7,6,59,35,24,76
Stirling,2910,3,17,6,13,61,51,10,57
Stenhousem'r,2910,4,15,8,13,55,47,8,53
Clyde,2910,5,14,9,13,52,50,2,51
Elgin,2910,6,15,6,15,54,60,-6,51
Annan Athlet,2910,7,12,11,13,50,42,8,47
Berwick,2910,8,9,10,17,31,59,-28,37
Edinburgh Ci,2910,9,7,9,20,37,63,-26,30
Cowdenbeath,2910,10,4,10,22,24,57,-33,22
Montrose,2911,1,24,7,5,61,35,26,79
Peterhead,2911,2,23,5,8,79,40,39,74
Stirling,2911,3,16,7,13,62,53,9,55
Stenhousem'r,2911,4,15,9,12,57,48,9,54
Clyde,2911,5,15,9,12,53,48,5,54
Elgin,2911,6,14,6,16,54,62,-8,48
Annan Athlet,2911,7,11,11,14,48,44,4,44
Berwick,2911,8,8,10,18,29,60,-31,34
Edinburgh Ci,2911,9,7,10,19,38,62,-24,31
Cowdenbeath,2911,10,5,10,21,26,55,-29,25
Peterhead,2912,1,24,4,8,81,39,42,76
Montrose,2912,2,23,7,6,60,36,24,76
Stirling,2912,3,17,6,13,63,51,12,57
Stenhousem'r,2912,4,15,8,13,55,49,6,53
Clyde,2912,5,14,10,12,52,49,3,52
Elgin,2912,6,15,6,15,55,61,-6,51
Annan Athlet,2912,7,12,11,13,51,43,8,47
Berwick,2912,8,8,11,17,30,59,-29,35
Edinburgh Ci,2912,9,7,9,20,37,64,-27,30
Cowdenbeath,2912,10,4,10,22,25,58,-33,22
Montrose,2913,1,24,7,5,65,35,30,79
Peterhead,2913,2,24,4,8,82,39,43,76
Stirling,2913,3,16,7,13,62,53,9,55
Stenhousem'r,2913,4,15,9,12,57,48,9,54
Clyde,2913,5,15,9,12,52,48,4,54
Elgin,2913,6,14,6,16,54,66,-12,48
Annan Athlet,2913,7,11,12,13,47,41,6,45
Berwick,2913,8,8,10,18,29,59,-30,34
Edinburgh Ci,2913,9,7,9,20,37,65,-28,30
Cowdenbeath,2913,10,4,11,21,23,54,-31,23
Montrose,2914,1,24,7,5,61,34,27,79
Peterhead,2914,2,24,4,8,80,40,40,76
Stirling,2914,3,17,6,13,61,51,10,57
Clyde,2914,4,15,9,12,54,49,5,54
Stenhousem'r,2914,5,15,8,13,55,47,8,53
Elgin,2914,6,14,6,16,53,62,-9,48
Annan Athlet,2914,7,12,11,13,49,42,7,47
Berwick,2914,8,8,10,18,30,61,-31,34
Edinburgh Ci,2914,9,7,9,20,38,63,-25,30
Cowdenbeath,2914,10,4,10,22,24,56,-32,22
Peterhead,2915,1,24,4,8,79,39,40,76
Montrose,2915,2,23,7,6,59,36,23,76
Stirling,2915,3,17,6,13,64,52,12,57
Clyde,2915,4,15,9,12,52,48,4,54
Stenhousem'r,2915,5,15,8,13,56,50,6,53
Elgin,2915,6,15,6,15,55,60,-5,51
Annan Athlet,2915,7,12,11,13,48,41,7,47
Berwick,2915,8,8,10,18,29,59,-30,34
Edinburgh Ci,2915,9,7,9,20,37,62,-25,30
Cowdenbeath,2915,10,4,10,22,23,55,-32,22
Montrose,2916,1,24,7,5,61,35,26,79
Peterhead,2916,2,24,4,8,80,39,41,76
Stirling,2916,3,16,7,13,61,52,9,55
Stenhousem'r,2916,4,15,9,12,56,47,9,54
Clyde,2916,5,14,9,13,51,49,2,51
Elgin,2916,6,14,6,16,54,62,-8,48
Annan Athlet,2916,7,11,11,14,47,43,4,44
Berwick,2916,8,9,10,17,30,58,-28,37
Edinburgh Ci,2916,9,7,9,20,37,63,-26,30
Cowdenbeath,2916,10,5,10,21,25,54,-29,25
Montrose,2917,1,23,8,5,60,35,25,77
Peterhead,2917,2,24,4,8,81,38,43,76
Stirling,2917,3,17,6,13,64,54,10,57
Stenhousem'r,2917,4,15,8,13,58,50,8,53
Clyde,2917,5,14,9,13,52,50,2,51
Elgin,2917,6,14,7,15,54,61,-7,49
Annan Athlet,2917,7,12,11,13,50,42,8,47
Berwick,2917,8,9,10,17,31,59,-28,37
Edinburgh Ci,2917,9,7,9,20,36,64,-28,30
Cowdenbeath,2917,10,4,10,22,24,57,-33,22
Montrose,2918,1,24,7,5,62,34,28,79
Peterhead,2918,2,24,4,8,79,39,40,76
Stirling,2918,3,17,6,13,61,51,10,57
Stenhousem'r,2918,4,15,8,13,55,47,8,53
Clyde,2918,5,14,10,12,52,49,3,52
Elgin,2918,6,14,6,16,53,63,-10,48
Annan Athlet,2918,7,11,11,14,47,43,4,44
Berwick,2918,8,8,11,17,30,59,-29,35
Edinburgh Ci,2918,9,7,9,20,37,62,-25,30
Cowdenbeath,2918,10,5,10,21,25,54,-29,25
Montrose,2919,1,24,7,5,62,35,27,79
Peterhead,2919,2,24,4,8,83,38,45,76
Stirling,2919,3,16,7,13,61,52,9,55
Stenhousem'r,2919,4,15,9,12,56,47,9,54
Clyde,2919,5,14,9,13,51,49,2,51
Elgin,2919,6,14,6,16,54,63,-9,48
Annan Athlet,2919,7,11,11,14,47,42,5,44
Berwick,2919,8,9,10,17,30,58,-28,37
Edinburgh Ci,2919,9,7,9,20,36,66,-30,30
Cowdenbeath,2919,10,5,10,21,24,54,-30,25
Montrose,2920,1,24,7,5,61,35,26,79
Peterhead,2920,2,24,4,8,79,38,41,76
Stirling,2920,3,17,6,13,63,52,11,57
Clyde,2920,4,15,9,12,54,50,4,54
Stenhousem'r,2920,5,15,8,13,56,49,7,53
Elgin,2920,6,14,6,16,54,62,-8,48
Annan Athlet,2920,7,11,11,14,48,43,5,44
Berwick,2920,8,8,10,18,31,61,-30,34
Edinburgh Ci,2920,9,7,9,20,36,62,-26,30
Cowdenbeath,2920,10,5,10,21,25,55,-30,25
Montrose,2921,1,24,7,5,64,36,28,79
Peterhead,2921,2,24,4,8,79,38,41,76
Stirling,2921,3,17,6,13,62,52,10,57
Stenhousem'r,2921,4,15,8,13,56,48,8,53
Clyde,2921,5,14,9,13,51,49,2,51
Elgin,2921,6,14,6,16,55,65,-10,48
Annan Athlet,2921,7,12,11,13,48,41,7,47
Berwick,2921,8,9,10,17,30,58,-28,37
Edinburgh Ci,2921,9,7,9,20,36,62,-26,30
Cowdenbeath,2921,10,4,10,22,23,55,-32,22
Montrose,2922,1,24,7,5,60,34,26,79
Peterhead,2922,2,24,4,8,82,39,43,76
Stenhousem'r,2922,3,16,8,12,57,47,10,56
Stirling,2922,4,16,6,14,61,53,8,54
Clyde,2922,5,14,9,13,51,50,1,51
Elgin,2922,6,14,6,16,53,61,-8,48
Annan Athlet,2922,7,11,12,13,47,41,6,45
Berwick,2922,8,9,10,17,31,58,-27,37
Edinburgh Ci,2922,9,7,9,20,37,65,-28,30
Cowdenbeath,2922,10,4,11,21,23,54,-31,23
Montrose,2923,1,24,7,5,60,34,26,79
Peterhead,2923,2,24,4,8,78,38,40,76
Stirling,2923,3,17,6,13,62,51,11,57
Stenhousem'r,2923,4,15,8,13,55,48,7,53
Clyde,2923,5,14,9,13,51,49,2,51
Elgin,2923,6,14,6,16,53,61,-8,48
Annan Athlet,2923,7,11,11,14,47,44,3,44
Berwick,2923,8,9,10,17,30,58,-28,37
Edinburgh Ci,2923,9,7,9,20,36,61,-25,30
Cowdenbeath,2923,10,5,10,21,26,54,-28,25
Peterhead,2924,1,24,4,8,80,39,41,76
Montrose,2924,2,23,7,6,61,37,24,76
Stirling,2924,3,16,7,13,63,54,9,55
Stenhousem'r,2924,4,15,9,12,58,49,9,54
Clyde,2924,5,14,9,13,51,49,2,51
Elgin,2924,6,15,6,15,56,62,-6,51
Annan Athlet,2924,7,12,11,13,49,41,8,47
Berwick,2924,8,9,10,17,30,58,-28,37
Edinburgh Ci,2924,9,7,9,20,37,63,-26,30
Cowdenbeath,2924,10,4,10,22,23,56,-33,22
Montrose,2925,1,24,7,5,60,34,26,79
Peterhead,2925,2,23,5,8,79,40,39,74
Stenhousem'r,2925,3,16,8,12,58,48,10,56
Stirling,2925,4,16,6,14,62,54,8,54
Clyde,2925,5,15,9,12,54,49,5,54
Elgin,2925,6,14,6,16,53,61,-8,48
Annan Athlet,2925,7,11,12,13,48,42,6,45
Berwick,2925,8,8,10,18,30,61,-31,34
Edinburgh Ci,2925,9,7,10,19,38,62,-24,31
Cowdenbeath,2925,10,4,11,21,24,55,-31,23
Montrose,2926,1,24,7,5,61,35,26,79
Peterhead,2926,2,23,4,9,77,42,35,73
Stirling,2926,3,17,6,13,63,52,11,57
Stenhousem'r,2926,4,15,8,13,56,49,7,53
Clyde,2926,5,14,9,13,53,51,2,51
Elgin,2926,6,14,6,16,54,62,-8,48
Annan Athlet,2926,7,11,11,14,47,42,5,44
Berwick,2926,8,9,10,17,32,60,-28,37
Edinburgh Ci,2926,9,8,9,19,40,60,-20,33
Cowdenbeath,2926,10,5,10,21,24,54,-30,25
Montrose,2927,1,24,7,5,63,36,27,79
Peterhead,2927,2,23,4,9,78,40,38,73
Stirling,2927,3,17,6,13,63,52,11,57
Stenhousem'r,2927,4,15,8,13,56,49,7,53
Clyde,2927,5,14,10,12,51,48,3,52
Elgin,2927,6,14,6,16,55,64,-9,48
Annan Athlet,2927,7,11,12,13,48,42,6,45
Berwick,2927,8,8,11,17,29,58,-29,35
Edinburgh Ci,2927,9,8,9,19,38,61,-23,33
Cowdenbeath,2927,10,4,11,21,24,55,-31,23
Montrose,2928,1,24,7,5,61,34,27,79
Peterhead,2928,2,24,4,8,80,40,40,76
Stirling,2928,3,17,6,13,61,51,10,57
Clyde,2928,4,15,9,12,54,49,5,54
Stenhousem'r,2928,5,15,8,13,55,47,8,53
Elgin,2928,6,14,6,16,53,62,-9,48
Annan Athlet,2928,7,12,11,13,50,42,8,47
Berwick,2928,8,8,10,18,30,61,-31,34
Edinburgh Ci,2928,9,7,9,20,38,63,-25,30
Cowdenbeath,2928,10,4,10,22,24,57,-33,22
Montrose,2929,1,24,7,5,62,34,28,79
Peterhead,2929,2,24,4,8,78,38,40,76
Stirling,2929,3,17,6,13,63,51,12,57
Clyde,2929,4,15,9,12,52,48,4,54
Stenhousem'r,2929,5,15,8,13,55,49,6,53
Elgin,2929,6,14,6,16,53,63,-10,48
Annan Athlet,2929,7,12,11,13,49,41,8,47
Berwick,2929,8,8,10,18,29,59,-30,34
Edinburgh Ci,2929,9,7,9,20,36,61,-25,30
Cowdenbeath,2929,10,4,10,22,23,56,-33,22
Montrose,2930,1,24,7,5,62,34,28,79
Peterhead,2930,2,23,4,9,78,40,38,73
Stirling,2930,3,16,7,13,60,51,9,55
Stenhousem'r,2930,4,15,9,12,55,46,9,54
Clyde,2930,5,14,10,12,53,50,3,52
Elgin,2930,6,14,6,16,53,63,-10,48
Annan Athlet,2930,7,12,11,13,51,42,9,47
Berwick,2930,8,8,11,17,31,60,-29,35
Edinburgh Ci,2930,9,8,9,19,38,61,-23,33
Cowdenbeath,2930,10,4,10,22,24,58,-34,22
Peterhead,2931,1,24,4,8,79,38,41,76
Montrose,2931,2,23,7,6,60,37,23,76
Stirling,2931,3,17,6,13,62,52,10,57
Stenhousem'r,2931,4,15,8,13,56,48,8,53
Clyde,2931,5,14,10,12,51,48,3,52
Elgin,2931,6,15,6,15,56,61,-5,51
Annan Athlet,2931,7,12,11,13,49,41,8,47
Berwick,2931,8,8,11,17,29,58,-29,35
Edinburgh Ci,2931,9,7,9,20,36,62,-26,30
Cowdenbeath,2931,10,4,10,22,23,56,-33,22
Montrose,2932,1,23,7,6,59,35,24,76
Peterhead,2932,2,23,5,8,77,38,39,74
Stirling,2932,3,16,7,13,60,51,9,55
Stenhousem'r,2932,4,15,9,12,55,46,9,54
Clyde,2932,5,14,10,12,51,48,3,52
Elgin,2932,6,15,6,15,54,60,-6,51
Annan Athlet,2932,7,12,11,13,48,41,7,47
Berwick,2932,8,8,11,17,29,58,-29,35
Edinburgh Ci,2932,9,7,10,19,36,60,-24,31
Cowdenbeath,2932,10,4,10,22,23,55,-32,22
Montrose,2933,1,24,7,5,62,36,26,79
Peterhead,2933,2,24,4,8,80,39,41,76
Stenhousem'r,2933,3,16,8,12,58,47,11,56
Stirling,2933,4,16,6,14,61,54,7,54
Clyde,2933,5,14,10,12,52,49,3,52
Elgin,2933,6,14,6,16,55,63,-8,48
Annan Athlet,2933,7,12,11,13,48,41,7,47
Berwick,2933,8,8,11,17,30,59,-29,35
Edinburgh Ci,2933,9,7,9,20,37,63,-26,30
Cowdenbeath,2933,10,4,10,22,23,55,-32,22
Montrose,2934,1,23,8,5,62,37,25,77
Peterhead,2934,2,23,5,8,78,39,39,74
Stenhousem'r,2934,3,16,8,12,57,46,11,56
Stirling,2934,4,16,6,14,60,53,7,54
Clyde,2934,5,14,9,13,51,49,2,51
Elgin,2934,6,14,7,15,56,63,-7,49
Annan Athlet,2934,7,11,12,13,47,41,6,45
Berwick,2934,8,9,10,17,30,58,-28,37
Edinburgh Ci,2934,9,7,10,19,37,61,-24,31
Cowdenbeath,2934,10,4,11,21,23,54,-31,23
Montrose,2935,1,23,7,6,60,41,19,76
Peterhead,2935,2,23,4,9,77,39,38,73
Stirling,2935,3,17,6,13,63,53,10,57
Clyde,2935,4,15,9,12,53,48,5,54
Stenhousem'r,2935,5,15,8,13,57,49,8,53
Elgin,2935,6,15,6,15,60,61,-1,51
Annan Athlet,2935,7,11,12,13,48,42,6,45
Berwick,2935,8,8,10,18,29,60,-31,34
Edinburgh Ci,2935,9,8,9,19,37,60,-23,33
Cowdenbeath,2935,10,4,11,21,24,55,-31,23
Montrose,2936,1,24,7,5,62,36,26,79
Peterhead,2936,2,24,4,8,80,39,41,76
Stirling,2936,3,16,7,13,60,51,9,55
Stenhousem'r,2936,4,15,9,12,55,46,9,54
Clyde,2936,5,15,9,12,53,48,5,54
Elgin,2936,6,14,6,16,55,63,-8,48
Annan Athlet,2936,7,12,11,13,49,41,8,47
Berwick,2936,8,8,10,18,29,60,-31,34
Edinburgh Ci,2936,9,7,9,20,37,63,-26,30
Cowdenbeath,2936,10,4,10,22,23,56,-33,22
Montrose,2937,1,23,8,5,61,36,25,77
Peterhead,2937,2,24,4,8,81,38,43,76
Stenhousem'r,2937,3,16,8,12,57,46,11,56
Stirling,2937,4,16,6,14,60,53,7,54
Clyde,2937,5,15,9,12,53,49,4,54
Elgin,2937,6,14,7,15,55,62,-7,49
Annan Athlet,2937,7,11,12,13,48,42,6,45
Berwick,2937,8,8,10,18,30,60,-30,34
Edinburgh Ci,2937,9,7,9,20,36,64,-28,30
Cowdenbeath,2937,10,4,11,21,24,55,-31,23
Montrose,2938,1,24,7,5,61,35,26,79
Peterhead,2938,2,24,4,8,80,38,42,76
Stenhousem'r,2938,3,16,8,12,57,47,10,56
Stirling,2938,4,16,6,14,61,53,8,54
Clyde,2938,5,15,9,12,53,49,4,54
Elgin,2938,6,14,6,16,54,62,-8,48
Annan Athlet,2938,7,12,11,13,50,43,7,47
Berwick,2938,8,8,10,18,30,60,-30,34
Edinburgh Ci,2938,9,7,9,20,36,63,-27,30
Cowdenbeath,2938,10,4,10,22,25,57,-32,22
Montrose,2939,1,24,7,5,63,36,27,79
Peterhead,2939,2,23,5,8,79,40,39,74
Stenhousem'r,2939,3,16,8,12,57,46,11,56
Stirling,2939,4,16,6,14,60,53,7,54
Clyde,2939,5,14,10,12,52,49,3,52
Elgin,2939,6,14,6,16,55,64,-9,48
Annan Athlet,2939,7,11,11,14,48,43,5,44
Berwick,2939,8,8,11,17,30,59,-29,35
Edinburgh Ci,2939,9,7,10,19,38,62,-24,31
Cowdenbeath,2939,10,5,10,21,25,55,-30,25
Montrose,2940,1,24,7,5,61,34,27,79
Peterhead,2940,2,24,4,8,81,38,43,76
Stenhousem'r,2940,3,16,8,12,58,47,11,56
Stirling,2940,4,16,6,14,61,54,7,54
Clyde,2940,5,15,9,12,57,50,7,54
Elgin,2940,6,14,6,16,53,62,-9,48
Annan Athlet,2940,7,11,12,13,47,41,6,45
Berwick,2940,8,8,10,18,31,64,-33,34
Edinburgh Ci,2940,9,7,9,20,36,64,-28,30
Cowdenbeath,2940,10,4,11,21,23,54,-31,23
Peterhead,2941,1,24,4,8,81,40,41,76
Montrose,2941,2,23,7,6,59,35,24,76
Stenhousem'r,2941,3,16,8,12,57,47,10,56
Stirling,2941,4,16,6,14,61,53,8,54
Clyde,2941,5,15,9,12,54,49,5,54
Elgin,2941,6,15,6,15,54,60,-6,51
Annan Athlet,2941,7,11,12,13,48,42,6,45
Berwick,2941,8,8,10,18,30,61,-31,34
Edinburgh Ci,2941,9,7,9,20,38,64,-26,30
Cowdenbeath,2941,10,4,11,21,24,55,-31,23
Peterhead,2942,1,24,4,8,79,39,40,76
Montrose,2942,2,23,7,6,60,36,24,76
Stenhousem'r,2942,3,16,8,12,56,46,10,56
Stirling,2942,4,16,6,14,60,52,8,54
Clyde,2942,5,15,9,12,52,48,4,54
Elgin,2942,6,15,6,15,55,61,-6,51
Annan Athlet,2942,7,11,12,13,47,41,6,45
Berwick,2942,8,8,10,18,29,59,-30,34
Edinburgh Ci,2942,9,7,9,20,37,62,-25,30
Cowdenbeath,2942,10,4,11,21,23,54,-31,23
Montrose,2943,1,24,7,5,62,36,26,79
Peterhead,2943,2,24,4,8,81,39,42,76
Stirling,2943,3,17,6,13,65,54,11,57
Stenhousem'r,2943,4,15,8,13,58,51,7,53
Clyde,2943,5,14,10,12,52,49,3,52
Elgin,2943,6,14,6,16,55,63,-8,48
Annan Athlet,2943,7,11,11,14,47,42,5,44
Berwick,2943,8,8,11,17,30,59,-29,35
Edinburgh Ci,2943,9,7,9,20,37,64,-27,30
Cowdenbeath,2943,10,5,10,21,24,54,-30,25
Montrose,2944,1,23,7,6,61,37,24,76
Peterhead,2944,2,23,5,8,81,42,39,74
Stirling,2944,3,17,6,13,64,51,13,57
Clyde,2944,4,15,9,12,53,49,4,54
Stenhousem'r,2944,5,15,8,13,55,50,5,53
Elgin,2944,6,15,6,15,56,62,-6,51
Annan Athlet,2944,7,11,12,13,47,41,6,45
Berwick,2944,8,8,10,18,30,60,-30,34
Edinburgh Ci,2944,9,7,10,19,40,64,-24,31
Cowdenbeath,2944,10,4,11,21,23,54,-31,23
Montrose,2945,1,23,8,5,60,35,25,77
Peterhead,2945,2,23,5,8,80,41,39,74
Stenhousem'r,2945,3,16,8,12,56,46,10,56
Stirling,2945,4,16,6,14,60,52,8,54
Clyde,2945,5,15,9,12,52,48,4,54
Elgin,2945,6,14,7,15,54,61,-7,49
Annan Athlet,2945,7,11,12,13,48,42,6,45
Berwick,2945,8,8,10,18,29,59,-30,34
Edinburgh Ci,2945,9,7,10,19,39,63,-24,31
Cowdenbeath,2945,10,4,11,21,24,55,-31,23
Montrose,2946,1,23,8,5,60,35,25,77
Peterhead,2946,2,24,4,8,79,39,40,76
Stirling,2946,3,17,6,13,61,51,10,57
Clyde,2946,4,15,9,12,52,48,4,54
Stenhousem'r,2946,5,15,8,13,55,47,8,53
Elgin,2946,6,14,7,15,54,61,-7,49
Annan Athlet,2946,7,11,12,13,47,41,6,45
Berwick,2946,8,8,10,18,29,59,-30,34
Edinburgh Ci,2946,9,7,9,20,37,62,-25,30
Cowdenbeath,2946,10,4,11,21,23,54,-31,23
Montrose,2947,1,24,7,5,60,34,26,79
Peterhead,2947,2,24,4,8,79,38,41,76
Stirling,2947,3,16,7,13,61,52,9,55
Stenhousem'r,2947,4,15,9,12,56,47,9,54
Clyde,2947,5,15,9,12,52,48,4,54
Elgin,2947,6,14,6,16,53,61,-8,48
Annan Athlet,2947,7,11,12,13,47,41,6,45
Berwick,2947,8,8,10,18,29,59,-30,34
Edinburgh Ci,2947,9,7,9,20,36,62,-26,30
Cowdenbeath,2947,10,4,11,21,23,54,-31,23
Peterhead,2948,1,24,4,8,79,38,41,76
Montrose,2948,2,23,7,6,59,36,23,76
Stirling,2948,3,16,7,13,61,52,9,55
Stenhousem'r,2948,4,15,9,12,56,47,9,54
Clyde,2948,5,15,9,12,52,48,4,54
Elgin,2948,6,15,6,15,55,60,-5,51
Annan Athlet,2948,7,12,11,13,51,42,9,47
Berwick,2948,8,8,10,18,29,59,-30,34
Edinburgh Ci,2948,9,7,9,20,36,62,-26,30
Cowdenbeath,2948,10,4,10,22,24,58,-34,22
Peterhead,2949,1,24,4,8,80,38,42,76
Montrose,2949,2,23,7,6,61,37,24,76
Stirling,2949,3,17,6,13,62,52,10,57
Clyde,2949,4,15,9,12,54,49,5,54
Stenhousem'r,2949,5,15,8,13,56,48,8,53
Elgin,2949,6,15,6,15,56,62,-6,51
Annan Athlet,2949,7,11,11,14,47,42,5,44
Berwick,2949,8,8,10,18,30,61,-31,34
Edinburgh Ci,2949,9,7,9,20,36,63,-27,30
Cowdenbeath,2949,10,5,10,21,24,54,-30,25
Montrose,2950,1,24,7,5,60,34,26,79
Peterhead,2950,2,24,4,8,80,40,40,76
Stirling,2950,3,16,7,13,61,52,9,55
Stenhousem'r,2950,4,15,9,12,56,47,9,54
Clyde,2950,5,14,10,12,51,48,3,52
Elgin,2950,6,14,6,16,53,61,-8,48
Annan Athlet,2950,7,11,11,14,47,42,5,44
Berwick,2950,8,8,11,17,29,58,-29,35
Edinburgh Ci,2950,9,7,9,20,38,63,-25,30
Cowdenbeath,2950,10,5,10,21,24,54,-30,25
Montrose,2951,1,23,8,5,61,36,25,77
Peterhead,2951,2,24,4,8,83,41,42,76
Stirling,2951,3,16,7,13,62,53,9,55
Stenhousem'r,2951,4,15,9,12,57,48,9,54
Clyde,2951,5,15,9,12,53,49,4,54
Elgin,2951,6,14,7,15,55,62,-7,49
Annan Athlet,2951,7,12,11,13,49,41,8,47
Berwick,2951,8,8,10,18,30,60,-30,34
Edinburgh Ci,2951,9,7,9,20,39,66,-27,30
Cowdenbeath,2951,10,4,10,22,23,56,-33,22
Montrose,2952,1,24,7,5,60,34,26,79
Peterhead,2952,2,24,4,8,79,39,40,76
Stenhousem'r,2952,3,16,8,12,56,46,10,56
Stirling,2952,4,16,6,14,60,52,8,54
Clyde,2952,5,15,9,12,54,48,6,54
Elgin,2952,6,14,6,16,53,61,-8,48
Annan Athlet,2952,7,12,11,13,48,41,7,47
Berwick,2952,8,8,10,18,29,61,-32,34
Edinburgh Ci,2952,9,7,9,20,37,62,-25,30
Cowdenbeath,2952,10,4,10,22,23,55,-32,22
Montrose,2953,1,24,7,5,62,35,27,79
Peterhead,2953,2,24,4,8,81,38,43,76
Stenhousem'r,2953,3,16,8,12,57,46,11,56
Stirling,2953,4,16,6,14,60,53,7,54
Clyde,2953,5,15,9,12,53,48,5,54
Elgin,2953,6,14,6,16,54,63,-9,48
Annan Athlet,2953,7,12,11,13,48,41,7,47
Berwick,2953,8,8,10,18,29,60,-31,34
Edinburgh Ci,2953,9,7,9,20,36,64,-28,30
Cowdenbeath,2953,10,4,10,22,23,55,-32,22
Montrose,2954,1,23,8,5,61,36,25,77
Peterhead,2954,2,23,5,8,77,38,39,74
Stirling,2954,3,17,6,13,63,51,12,57
Clyde,2954,4,15,9,12,54,50,4,54
Stenhousem'r,2954,5,15,8,13,55,49,6,53
Elgin,2954,6,14,7,15,55,62,-7,49
Annan Athlet,2954,7,12,11,13,50,42,8,47
Berwick,2954,8,8,10,18,31,61,-30,34
Edinburgh Ci,2954,9,7,10,19,36,60,-24,31
Cowdenbeath,2954,10,4,10,22,24,57,-33,22
Montrose,2955,1,24,7,5,60,34,26,79
Peterhead,2955,2,24,4,8,79,38,41,76
Stirling,2955,3,16,7,13,62,53,9,55
Stenhousem'r,2955,4,15,9,12,57,48,9,54
Clyde,2955,5,15,9,12,55,48,7,54
Elgin,2955,6,14,6,16,53,61,-8,48
Annan Athlet,2955,7,12,11,13,49,41,8,47
Berwick,2955,8,8,10,18,29,62,-33,34
Edinburgh Ci,2955,9,7,9,20,36,62,-26,30
Cowdenbeath,2955,10,4,10,22,23,56,-33,22
Montrose,2956,1,24,7,5,61,35,26,79
Peterhead,2956,2,24,4,8,82,39,43,76
Stirling,2956,3,17,6,13,63,52,11,57
Clyde,2956,4,15,9,12,53,48,5,54
Stenhousem'r,2956,5,15,8,13,56,49,7,53
Elgin,2956,6,14,6,16,54,62,-8,48
Annan Athlet,2956,7,11,12,13,48,42,6,45
Berwick,2956,8,8,10,18,29,60,-31,34
Edinburgh Ci,2956,9,7,9,20,37,65,-28,30
Cowdenbeath,2956,10,4,11,21,24,55,-31,23
Montrose,2957,1,23,7,6,59,35,24,76
Peterhead,2957,2,23,5,8,80,41,39,74
Stirling,2957,3,16,7,13,63,54,9,55
Stenhousem'r,2957,4,15,9,12,58,49,9,54
Clyde,2957,5,15,9,12,53,48,5,54
Elgin,2957,6,15,6,15,54,60,-6,51
Annan Athlet,2957,7,11,11,14,47,42,5,44
Berwick,2957,8,8,10,18,29,60,-31,34
Edinburgh Ci,2957,9,7,10,19,39,63,-24,31
Cowdenbeath,2957,10,5,10,21,24,54,-30,25
Montrose,2958,1,24,7,5,63,35,28,79
Peterhead,2958,2,23,4,9,78,41,37,73
Stirling,2958,3,16,7,13,62,53,9,55
Stenhousem'r,2958,4,15,9,12,57,48,9,54
Clyde,2958,5,14,10,12,52,49,3,52
Elgin,2958,6,14,6,16,54,64,-10,48
Annan Athlet,2958,7,12,11,13,48,41,7,47
Berwick,2958,8,8,11,17,30,59,-29,35
Edinburgh Ci,2958,9,8,9,19,39,61,-22,33
Cowdenbeath,2958,10,4,10,22,23,55,-32,22
Montrose,2959,1,24,7,5,63,36,27,79
Peterhead,2959,2,24,4,8,80,39,41,76
Stirling,2959,3,17,6,13,62,52,10,57
Clyde,2959,4,15,9,12,55,51,4,54
Stenhousem'r,2959,5,15,8,13,56,48,8,53
Elgin,2959,6,14,6,16,55,64,-9,48
Annan Athlet,2959,7,11,11,14,48,44,4,44
Berwick,2959,8,8,10,18,32,62,-30,34
Edinburgh Ci,2959,9,7,9,20,37,63,-26,30
Cowdenbeath,2959,10,5,10,21,26,55,-29,25
Montrose,2960,1,24,7,5,61,35,26,79
Peterhead,2960,2,24,4,8,79,38,41,76
Stirling,2960,3,16,7,13,62,53,9,55
Stenhousem'r,2960,4,15,9,12,57,48,9,54
Clyde,2960,5,14,10,12,52,49,3,52
Elgin,2960,6,14,6,16,54,62,-8,48
Annan Athlet,2960,7,11,11,14,47,43,4,44
Berwick,2960,8,8,11,17,30,59,-29,35
Edinburgh Ci,2960,9,7,9,20,36,62,-26,30
Cowdenbeath,2960,10,5,10,21,25,54,-29,25
Montrose,2961,1,24,7,5,60,34,26,79
Peterhead,2961,2,24,4,8,79,38,41,76
Stirling,2961,3,17,6,13,68,52,16,57
Clyde,2961,4,15,9,12,54,49,5,54
Stenhousem'r,2961,5,15,8,13,56,54,2,53
Elgin,2961,6,14,6,16,53,61,-8,48
Annan Athlet,2961,7,12,11,13,48,41,7,47
Berwick,2961,8,8,10,18,30,61,-31,34
Edinburgh Ci,2961,9,7,9,20,36,62,-26,30
Cowdenbeath,2961,10,4,10,22,23,55,-32,22
Montrose,2962,1,24,7,5,64,35,29,79
Peterhead,2962,2,24,4,8,80,39,41,76
Stirling,2962,3,17,6,13,64,52,12,57
Clyde,2962,4,15,9,12,54,48,6,54
Stenhousem'r,2962,5,15,8,13,56,50,6,53
Elgin,2962,6,14,6,16,54,65,-11,48
Annan Athlet,2962,7,12,11,13,50,42,8,47
Berwick,2962,8,8,10,18,29,61,-32,34
Edinburgh Ci,2962,9,7,9,20,37,63,-26,30
Cowdenbeath,2962,10,4,10,22,24,57,-33,22
Montrose,2963,1,24,7,5,61,34,27,79
Peterhead,2963,2,24,4,8,79,38,41,76
Stirling,2963,3,16,7,13,61,52,9,55
Stenhousem'r,2963,4,15,9,12,56,47,9,54
Clyde,2963,5,15,9,12,52,48,4,54
Elgin,2963,6,14,6,16,53,62,-9,48
Annan Athlet,2963,7,12,11,13,51,43,8,47
Berwick,2963,8,8,10,18,29,59,-30,34
Edinburgh Ci,2963,9,7,9,20,36,62,-26,30
Cowdenbeath,2963,10,4,10,22,25,58,-33,22
Montrose,2964,1,23,8,5,60,35,25,77
Peterhead,2964,2,24,4,8,81,38,43,76
Stirling,2964,3,16,7,13,61,52,9,55
Stenhousem'r,2964,4,15,9,12,56,47,9,54
Clyde,2964,5,14,9,13,51,49,2,51
Elgin,2964,6,14,7,15,54,61,-7,49
Annan Athlet,2964,7,11,11,14,47,43,4,44
Berwick,2964,8,9,10,17,30,58,-28,37
Edinburgh Ci,2964,9,7,9,20,36,64,-28,30
Cowdenbeath,2964,10,5,10,21,25,54,-29,25
Montrose,2965,1,24,7,5,61,35,26,79
Peterhead,2965,2,24,4,8,79,38,41,76
Stirling,2965,3,17,6,13,63,52,11,57
Stenhousem'r,2965,4,15,8,13,56,49,7,53
Clyde,2965,5,14,9,13,51,53,-2,51
Elgin,2965,6,14,6,16,54,62,-8,48
Annan Athlet,2965,7,11,12,13,48,42,6,45
Berwick,2965,8,9,10,17,34,58,-24,37
Edinburgh Ci,2965,9,7,9,20,36,62,-26,30
Cowdenbeath,2965,10,4,11,21,24,55,-31,23
Montrose,2966,1,24,7,5,61,35,26,79
Peterhead,2966,2,24,4,8,81,40,41,76
Stenhousem'r,2966,3,16,8,12,56,46,10,56
Stirling,2966,4,16,6,14,60,52,8,54
Clyde,2966,5,14,9,13,52,51,1,51
Elgin,2966,6,14,6,16,54,62,-8,48
Annan Athlet,2966,7,12,11,13,48,41,7,47
Berwick,2966,8,9,10,17,32,59,-27,37
Edinburgh Ci,2966,9,7,9,20,38,64,-26,30
Cowdenbeath,2966,10,4,10,22,23,55,-32,22
Montrose,2967,1,23,8,5,60,35,25,77
Peterhead,2967,2,24,4,8,78,38,40,76
Stenhousem'r,2967,3,16,8,12,57,47,10,56
Stirling,2967,4,16,6,14,61,53,8,54
Clyde,2967,5,14,10,12,52,49,3,52
Elgin,2967,6,14,7,15,54,61,-7,49
Annan Athlet,2967,7,11,11,14,47,42,5,44
Berwick,2967,8,8,11,17,30,59,-29,35
Edinburgh Ci,2967,9,7,9,20,36,61,-25,30
Cowdenbeath,2967,10,5,10,21,24,54,-30,25
Montrose,2968,1,24,7,5,60,34,26,79
Peterhead,2968,2,24,4,8,79,39,40,76
Stirling,2968,3,16,7,13,62,53,9,55
Stenhousem'r,2968,4,15,9,12,57,48,9,54
Clyde,2968,5,14,9,13,53,51,2,51
Elgin,2968,6,14,6,16,53,61,-8,48
Annan Athlet,2968,7,11,11,14,47,43,4,44
Berwick,2968,8,9,10,17,32,60,-28,37
Edinburgh Ci,2968,9,7,9,20,37,62,-25,30
Cowdenbeath,2968,10,5,10,21,25,54,-29,25
Montrose,2969,1,23,8,5,60,35,25,77
Peterhead,2969,2,24,4,8,81,40,41,76
Stenhousem'r,2969,3,16,8,12,57,47,10,56
Stirling,2969,4,16,6,14,61,53,8,54
Clyde,2969,5,15,9,12,53,49,4,54
Elgin,2969,6,14,7,15,54,61,-7,49
Annan Athlet,2969,7,11,11,14,47,43,4,44
Berwick,2969,8,8,10,18,30,60,-30,34
Edinburgh Ci,2969,9,7,9,20,38,64,-26,30
Cowdenbeath,2969,10,5,10,21,25,54,-29,25
Montrose,2970,1,24,7,5,62,36,26,79
Peterhead,2970,2,24,4,8,81,39,42,76
Stirling,2970,3,17,6,13,63,51,12,57
Clyde,2970,4,15,9,12,56,48,8,54
Stenhousem'r,2970,5,15,8,13,55,49,6,53
Elgin,2970,6,14,6,16,55,63,-8,48
Annan Athlet,2970,7,11,12,13,48,42,6,45
Berwick,2970,8,8,10,18,29,63,-34,34
Edinburgh Ci,2970,9,7,9,20,37,64,-27,30
Cowdenbeath,2970,10,4,11,21,24,55,-31,23
Montrose,2971,1,24,7,5,63,35,28,79
Peterhead,2971,2,23,4,9,78,40,38,73
Stirling,2971,3,16,7,13,61,52,9,55
Stenhousem'r,2971,4,15,9,12,56,47,9,54
Clyde,2971,5,15,9,12,54,48,6,54
Elgin,2971,6,14,6,16,54,64,-10,48
Annan Athlet,2971,7,12,11,13,48,41,7,47
Berwick,2971,8,8,10,18,29,61,-32,34
Edinburgh Ci,2971,9,8,9,19,38,61,-23,33
Cowdenbeath,2971,10,4,10,22,23,55,-32,22
Montrose,2972,1,24,7,5,62,36,26,79
Peterhead,2972,2,24,4,8,80,38,42,76
Stirling,2972,3,17,6,13,62,52,10,57
Clyde,2972,4,15,9,12,53,49,4,54
Stenhousem'r,2972,5,15,8,13,56,48,8,53
Elgin,2972,6,14,6,16,55,63,-8,48
Annan Athlet,2972,7,12,11,13,49,42,7,47
Berwick,2972,8,8,10,18,30,60,-30,34
Edinburgh Ci,2972,9,7,9,20,36,63,-27,30
Cowdenbeath,2972,10,4,10,22,24,56,-32,22
Montrose,2973,1,24,7,5,62,35,27,79
Peterhead,2973,2,24,4,8,81,39,42,76
Stirling,2973,3,17,6,13,62,51,11,57
Clyde,2973,4,15,9,12,54,48,6,54
Stenhousem'r,2973,5,15,8,13,55,48,7,53
Elgin,2973,6,14,6,16,54,63,-9,48
Annan Athlet,2973,7,11,12,13,47,41,6,45
Berwick,2973,8,8,10,18,29,61,-32,34
Edinburgh Ci,2973,9,7,9,20,37,64,-27,30
Cowdenbeath,2973,10,4,11,21,23,54,-31,23
Montrose,2974,1,24,7,5,62,36,26,79
Peterhead,2974,2,24,4,8,80,40,40,76
Stirling,2974,3,17,6,13,62,51,11,57
Clyde,2974,4,15,9,12,52,48,4,54
Stenhousem'r,2974,5,15,8,13,55,48,7,53
Elgin,2974,6,14,6,16,55,63,-8,48
Annan Athlet,2974,7,12,11,13,50,42,8,47
Berwick,2974,8,8,10,18,29,59,-30,34
Edinburgh Ci,2974,9,7,9,20,38,63,-25,30
Cowdenbeath,2974,10,4,10,22,24,57,-33,22
Montrose,2975,1,24,7,5,61,35,26,79
Peterhead,2975,2,24,4,8,80,39,41,76
Stenhousem'r,2975,3,16,8,12,58,46,12,56
Stirling,2975,4,16,6,14,60,54,6,54
Clyde,2975,5,15,9,12,52,48,4,54
Elgin,2975,6,14,6,16,54,62,-8,48
Annan Athlet,2975,7,11,12,13,48,42,6,45
Berwick,2975,8,8,10,18,29,59,-30,34
Edinburgh Ci,2975,9,7,9,20,37,63,-26,30
Cowdenbeath,2975,10,4,11,21,24,55,-31,23
Montrose,2976,1,23,8,5,61,36,25,77
Peterhead,2976,2,24,4,8,80,38,42,76
Stirling,2976,3,17,6,13,62,52,10,57
Clyde,2976,4,15,9,12,52,48,4,54
Stenhousem'r,2976,5,15,8,13,56,48,8,53
Elgin,2976,6,14,7,15,55,62,-7,49
Annan Athlet,2976,7,12,11,13,51,41,10,47
Berwick,2976,8,8,10,18,29,59,-30,34
Edinburgh Ci,2976,9,7,9,20,36,63,-27,30
Cowdenbeath,2976,10,4,10,22,23,58,-35,22
Montrose,2977,1,23,8,5,62,37,25,77
Peterhead,2977,2,24,4,8,80,38,42,76
Stirling,2977,3,16,7,13,62,53,9,55
Stenhousem'r,2977,4,15,9,12,57,48,9,54
Clyde,2977,5,15,9,12,53,49,4,54
Elgin,2977,6,14,7,15,56,63,-7,49
Annan Athlet,2977,7,12,11,13,49,42,7,47
Berwick,2977,8,8,10,18,30,60,-30,34
Edinburgh Ci,2977,9,7,9,20,36,63,-27,30
Cowdenbeath,2977,10,4,10,22,24,56,-32,22
Montrose,2978,1,24,7,5,63,36,27,79
Peterhead,2978,2,23,5,8,78,39,39,74
Stenhousem'r,2978,3,16,8,12,59,49,10,56
Stirling,2978,4,16,6,14,63,55,8,54
Clyde,2978,5,15,9,12,52,48,4,54
Elgin,2978,6,14,6,16,55,64,-9,48
Annan Athlet,2978,7,11,11,14,47,42,5,44
Berwick,2978,8,8,10,18,29,59,-30,34
Edinburgh Ci,2978,9,7,10,19,37,61,-24,31
Cowdenbeath,2978,10,5,10,21,24,54,-30,25
Montrose,2979,1,23,8,5,59,34,25,77
Peterhead,2979,2,24,4,8,79,39,40,76
Stirling,2979,3,16,7,13,61,52,9,55
Stenhousem'r,2979,4,15,9,12,56,47,9,54
Clyde,2979,5,14,10,12,52,49,3,52
Elgin,2979,6,14,7,15,53,60,-7,49
Annan Athlet,2979,7,11,12,13,47,41,6,45
Berwick,2979,8,8,11,17,30,59,-29,35
Edinburgh Ci,2979,9,7,9,20,37,62,-25,30
Cowdenbeath,2979,10,4,11,21,23,54,-31,23
Montrose,2980,1,24,7,5,62,36,26,79
Peterhead,2980,2,24,4,8,81,38,43,76
Stirling,2980,3,17,6,13,61,51,10,57
Clyde,2980,4,15,9,12,54,48,6,54
Stenhousem'r,2980,5,15,8,13,55,47,8,53
Elgin,2980,6,14,6,16,55,63,-8,48
Annan Athlet,2980,7,11,11,14,47,42,5,44
Berwick,2980,8,8,10,18,29,61,-32,34
Edinburgh Ci,2980,9,7,9,20,36,64,-28,30
Cowdenbeath,2980,10,5,10,21,24,54,-30,25
Montrose,2981,1,23,8,5,60,35,25,77
Peterhead,2981,2,23,5,8,79,40,39,74
Stirling,2981,3,17,6,13,64,52,12,57
Stenhousem'r,2981,4,15,8,13,56,50,6,53
Clyde,2981,5,14,9,13,52,50,2,51
Elgin,2981,6,14,7,15,54,61,-7,49
Annan Athlet,2981,7,12,11,13,50,42,8,47
Berwick,2981,8,9,10,17,31,59,-28,37
Edinburgh Ci,2981,9,7,10,19,38,62,-24,31
Cowdenbeath,2981,10,4,10,22,24,57,-33,22
Montrose,2982,1,24,7,5,61,35,26,79
Peterhead,2982,2,24,4,8,81,38,43,76
Stirling,2982,3,17,6,13,65,51,14,57
Stenhousem'r,2982,4,15,8,13,55,51,4,53
Clyde,2982,5,14,9,13,51,49,2,51
Elgin,2982,6,14,6,16,54,62,-8,48
Annan Athlet,2982,7,11,12,13,47,41,6,45
Berwick,2982,8,9,10,17,30,58,-28,37
Edinburgh Ci,2982,9,7,9,20,36,64,-28,30
Cowdenbeath,2982,10,4,11,21,23,54,-31,23
Montrose,2983,1,24,7,5,63,36,27,79
Peterhead,2983,2,24,4,8,79,38,41,76
Stenhousem'r,2983,3,16,8,12,56,46,10,56
Stirling,2983,4,16,6,14,60,52,8,54
Clyde,2983,5,15,9,12,54,48,6,54
Elgin,2983,6,14,6,16,55,64,-9,48
Annan Athlet,2983,7,12,11,13,50,42,8,47
Berwick,2983,8,8,10,18,29,61,-32,34
Edinburgh Ci,2983,9,7,9,20,36,62,-26,30
Cowdenbeath,2983,10,4,10,22,24,57,-33,22
Montrose,2984,1,24,7,5,60,34,26,79
Peterhead,2984,2,23,5,8,79,40,39,74
Stirling,2984,3,17,6,13,62,52,10,57
Stenhousem'r,2984,4,15,8,13,56,48,8,53
Clyde,2984,5,14,10,12,51,48,3,52
Elgin,2984,6,14,6,16,53,61,-8,48
Annan Athlet,2984,7,11,12,13,48,42,6,45
Berwick,2984,8,8,11,17,29,58,-29,35
Edinburgh Ci,2984,9,7,10,19,38,62,-24,31
Cowdenbeath,2984,10,4,11,21,24,55,-31,23
Montrose,2985,1,23,8,5,61,36,25,77
Peterhead,2985,2,24,4,8,82,38,44,76
Stirling,2985,3,17,6,13,63,51,12,57
Clyde,2985,4,15,9,12,53,48,5,54
Stenhousem'r,2985,5,15,8,13,55,49,6,53
Elgin,2985,6,14,7,15,55,62,-7,49
Annan Athlet,2985,7,12,11,13,49,41,8,47
Berwick,2985,8,8,10,18,29,60,-31,34
Edinburgh Ci,2985,9,7,9,20,36,65,-29,30
Cowdenbeath,2985,10,4,10,22,23,56,-33,22
Montrose,2986,1,24,7,5,60,34,26,79
Peterhead,2986,2,24,4,8,80,39,41,76
Stirling,2986,3,17,6,13,65,53,12,57
Stenhousem'r,2986,4,15,8,13,57,51,6,53
Clyde,2986,5,14,10,12,51,48,3,52
Elgin,2986,6,14,6,16,53,61,-8,48
Annan Athlet,2986,7,11,11,14,48,43,5,44
Berwick,2986,8,8,11,17,29,58,-29,35
Edinburgh Ci,2986,9,7,9,20,37,63,-26,30
Cowdenbeath,2986,10,5,10,21,25,55,-30,25
Montrose,2987,1,24,7,5,60,34,26,79
Peterhead,2987,2,23,5,8,79,40,39,74
Stirling,2987,3,16,7,13,62,53,9,55
Stenhousem'r,2987,4,15,9,12,57,48,9,54
Clyde,2987,5,14,10,12,52,49,3,52
Elgin,2987,6,14,6,16,53,61,-8,48
Annan Athlet,2987,7,11,12,13,48,42,6,45
Berwick,2987,8,8,11,17,30,59,-29,35
Edinburgh Ci,2987,9,7,10,19,38,62,-24,31
Cowdenbeath,2987,10,4,11,21,24,55,-31,23
Montrose,2988,1,23,8,5,61,36,25,77
Peterhead,2988,2,24,4,8,84,39,45,76
Stirling,2988,3,17,6,13,63,51,12,57
Stenhousem'r,2988,4,15,8,13,55,49,6,53
Clyde,2988,5,14,9,13,51,49,2,51
Elgin,2988,6,14,7,15,55,62,-7,49
Annan Athlet,2988,7,11,11,14,47,43,4,44
Berwick,2988,8,9,10,17,30,58,-28,37
Edinburgh Ci,2988,9,7,9,20,37,67,-30,30
Cowdenbeath,2988,10,5,10,21,25,54,-29,25
Montrose,2989,1,24,7,5,61,34,27,79
Peterhead,2989,2,24,4,8,80,38,42,76
Stenhousem'r,2989,3,16,8,12,57,46,11,56
Stirling,2989,4,16,6,14,60,53,7,54
Clyde,2989,5,15,9,12,54,49,5,54
Elgin,2989,6,14,6,16,53,62,-9,48
Annan Athlet,2989,7,12,11,13,49,42,7,47
Berwick,2989,8,8,10,18,30,61,-31,34
Edinburgh Ci,2989,9,7,9,20,36,63,-27,30
Cowdenbeath,2989,10,4,10,22,24,56,-32,22
Montrose,2990,1,23,7,6,59,35,24,76
Peterhead,2990,2,23,5,8,78,39,39,74
Stirling,2990,3,17,6,13,61,51,10,57
Stenhousem'r,2990,4,15,8,13,55,47,8,53
Clyde,2990,5,14,9,13,52,50,2,51
Elgin,2990,6,15,6,15,54,60,-6,51
Annan Athlet,2990,7,11,11,14,47,42,5,44
Berwick,2990,8,9,10,17,31,59,-28,37
Edinburgh Ci,2990,9,7,10,19,37,61,-24,31
Cowdenbeath,2990,10,5,10,21,24,54,-30,25
Montrose,2991,1,23,7,6,61,38,23,76
Peterhead,2991,2,23,5,8,78,39,39,74
Stenhousem'r,2991,3,16,8,12,58,47,11,56
Stirling,2991,4,16,6,14,61,54,7,54
Clyde,2991,5,14,10,12,51,48,3,52
Elgin,2991,6,15,6,15,57,62,-5,51
Annan Athlet,2991,7,11,12,13,47,41,6,45
Berwick,2991,8,8,11,17,29,58,-29,35
Edinburgh Ci,2991,9,7,10,19,37,61,-24,31
Cowdenbeath,2991,10,4,11,21,23,54,-31,23
Montrose,2992,1,24,7,5,61,35,26,79
Peterhead,2992,2,24,4,8,81,38,43,76
Stirling,2992,3,17,6,13,62,52,10,57
Clyde,2992,4,15,9,12,53,48,5,54
Stenhousem'r,2992,5,15,8,13,56,48,8,53
Elgin,2992,6,14,6,16,54,62,-8,48
Annan Athlet,2992,7,12,11,13,49,42,7,47
Berwick,2992,8,8,10,18,29,60,-31,34
Edinburgh Ci,2992,9,7,9,20,36,64,-28,30
Cowdenbeath,2992,10,4,10,22,24,56,-32,22
Montrose,2993,1,24,7,5,60,34,26,79
Peterhead,2993,2,24,4,8,79,39,40,76
Stirling,2993,3,17,6,13,64,53,11,57
Clyde,2993,4,15,9,12,54,50,4,54
Stenhousem'r,2993,5,15,8,13,57,50,7,53
Elgin,2993,6,14,6,16,53,61,-8,48
Annan Athlet,2993,7,11,11,14,48,43,5,44
Berwick,2993,8,8,10,18,31,61,-30,34
Edinburgh Ci,2993,9,7,9,20,37,62,-25,30
Cowdenbeath,2993,10,5,10,21,25,55,-30,25
Montrose,2994,1,24,7,5,63,37,26,79
Peterhead,2994,2,23,5,8,78,39,39,74
Stirling,2994,3,16,7,13,64,55,9,55
Stenhousem'r,2994,4,15,9,12,59,50,9,54
Clyde,2994,5,15,9,12,56,48,8,54
Elgin,2994,6,14,6,16,56,64,-8,48
Annan Athlet,2994,7,11,11,14,48,46,2,44
Berwick,2994,8,8,10,18,29,63,-34,34
Edinburgh Ci,2994,9,7,10,19,37,61,-24,31
Cowdenbeath,2994,10,5,10,21,28,55,-27,25
Peterhead,2995,1,24,4,8,82,40,42,76
Montrose,2995,2,23,7,6,60,37,23,76
Stirling,2995,3,17,6,13,62,52,10,57
Clyde,2995,4,15,9,12,55,49,6,54
Stenhousem'r,2995,5,15,8,13,56,48,8,53
Elgin,2995,6,15,6,15,56,61,-5,51
Annan Athlet,2995,7,11,12,13,48,42,6,45
Berwick,2995,8,8,10,18,30,62,-32,34
Edinburgh Ci,2995,9,7,9,20,38,65,-27,30
Cowdenbeath,2995,10,4,11,21,24,55,-31,23
Montrose,2996,1,24,7,5,64,35,29,79
Peterhead,2996,2,24,4,8,80,39,41,76
Stenhousem'r,2996,3,16,8,12,58,48,10,56
Stirling,2996,4,16,6,14,62,54,8,54
Clyde,2996,5,14,9,13,52,50,2,51
Elgin,2996,6,14,6,16,54,65,-11,48
Annan Athlet,2996,7,11,11,14,47,44,3,44
Berwick,2996,8,9,10,17,31,59,-28,37
Edinburgh Ci,2996,9,7,9,20,37,63,-26,30
Cowdenbeath,2996,10,5,10,21,26,54,-28,25
Montrose,2997,1,24,7,5,64,35,29,79
Peterhead,2997,2,24,4,8,80,39,41,76
Stirling,2997,3,17,6,13,62,51,11,57
Clyde,2997,4,15,9,12,55,49,6,54
Stenhousem'r,2997,5,15,8,13,55,48,7,53
Elgin,2997,6,14,6,16,54,65,-11,48
Annan Athlet,2997,7,11,11,14,47,42,5,44
Berwick,2997,8,8,10,18,30,62,-32,34
Edinburgh Ci,2997,9,7,9,20,37,63,-26,30
Cowdenbeath,2997,10,5,10,21,24,54,-30,25
Montrose,2998,1,24,7,5,62,35,27,79
Peterhead,2998,2,24,4,8,82,38,44,76
Stirling,2998,3,16,7,13,63,54,9,55
Stenhousem'r,2998,4,15,9,12,58,49,9,54
Clyde,2998,5,15,9,12,54,48,6,54
Elgin,2998,6,14,6,16,54,63,-9,48
Annan Athlet,2998,7,11,12,13,48,42,6,45
Berwick,2998,8,8,10,18,29,61,-32,34
Edinburgh Ci,2998,9,7,9,20,36,65,-29,30
Cowdenbeath,2998,10,4,11,21,24,55,-31,23
Montrose,2999,1,24,7,5,63,34,29,79
Peterhead,2999,2,23,5,8,78,39,39,74
Stenhousem'r,2999,3,16,8,12,56,46,10,56
Stirling,2999,4,16,6,14,60,52,8,54
Clyde,2999,5,14,10,12,51,48,3,52
Elgin,2999,6,14,6,16,53,64,-11,48
Annan Athlet,2999,7,11,11,14,48,43,5,44
Berwick,2999,8,8,11,17,29,58,-29,35
Edinburgh Ci,2999,9,7,10,19,37,61,-24,31
Cowdenbeath,2999,10,5,10,21,25,55,-30,25
Montrose,3000,1,24,7,5,61,34,27,79
Peterhead,3000,2,24,4,8,81,39,42,76
Stirling,3000,3,17,6,13,62,51,11,57
Stenhousem'r,3000,4,15,8,13,55,48,7,53
Clyde,3000,5,14,9,13,51,50,1,51
Elgin,3000,6,14,6,16,53,62,-9,48
Annan Athlet,3000,7,11,12,13,47,41,6,45
Berwick,3000,8,9,10,17,31,58,-27,37
Edinburgh Ci,3000,9,7,9,20,37,64,-27,30
Cowdenbeath,3000,10,4,11,21,23,54,-31,23
Montrose,3001,1,24,7,5,60,34,26,79
Peterhead,3001,2,24,4,8,79,38,41,76
Stirling,3001,3,17,6,13,63,53,10,57
Clyde,3001,4,15,9,12,54,50,4,54
Stenhousem'r,3001,5,15,8,13,57,49,8,53
Elgin,3001,6,14,6,16,53,61,-8,48
Annan Athlet,3001,7,12,11,13,51,42,9,47
Berwick,3001,8,8,10,18,31,61,-30,34
Edinburgh Ci,3001,9,7,9,20,36,62,-26,30
Cowdenbeath,3001,10,4,10,22,24,58,-34,22
Montrose,3002,1,24,7,5,61,34,27,79
Peterhead,3002,2,24,4,8,81,39,42,76
Stirling,3002,3,17,6,13,63,52,11,57
Clyde,3002,4,15,9,12,53,48,5,54
Stenhousem'r,3002,5,15,8,13,56,49,7,53
Elgin,3002,6,14,6,16,53,62,-9,48
Annan Athlet,3002,7,11,12,13,47,41,6,45
Berwick,3002,8,8,10,18,29,60,-31,34
Edinburgh Ci,3002,9,7,9,20,37,64,-27,30
Cowdenbeath,3002,10,4,11,21,23,54,-31,23
Peterhead,3003,1,24,4,8,79,39,40,76
Montrose,3003,2,23,7,6,60,37,23,76
Stirling,3003,3,17,6,13,62,52,10,57
Clyde,3003,4,15,9,12,53,48,5,54
Stenhousem'r,3003,5,15,8,13,56,48,8,53
Elgin,3003,6,15,6,15,56,61,-5,51
Annan Athlet,3003,7,11,11,14,48,43,5,44
Berwick,3003,8,8,10,18,29,60,-31,34
Edinburgh Ci,3003,9,7,9,20,37,62,-25,30
Cowdenbeath,3003,10,5,10,21,25,55,-30,25
Montrose,3004,1,24,7,5,61,34,27,79
Peterhead,3004,2,24,4,8,81,41,40,76
Stenhousem'r,3004,3,16,8,12,58,46,12,56
Stirling,3004,4,16,6,14,60,54,6,54
Clyde,3004,5,15,9,12,52,48,4,54
Elgin,3004,6,14,6,16,53,62,-9,48
Annan Athlet,3004,7,11,12,13,48,42,6,45
Berwick,3004,8,8,10,18,29,59,-30,34
Edinburgh Ci,3004,9,7,9,20,39,64,-25,30
Cowdenbeath,3004,10,4,11,21,24,55,-31,23
Peterhead,3005,1,24,4,8,79,39,40,76
Montrose,3005,2,23,7,6,59,36,23,76
Stirling,3005,3,16,7,13,62,53,9,55
Stenhousem'r,3005,4,15,9,12,57,48,9,54
Clyde,3005,5,15,9,12,53,48,5,54
Elgin,3005,6,15,6,15,55,60,-5,51
Annan Athlet,3005,7,11,11,14,47,42,5,44
Berwick,3005,8,8,10,18,29,60,-31,34
Edinburgh Ci,3005,9,7,9,20,37,62,-25,30
Cowdenbeath,3005,10,5,10,21,24,54,-30,25
Montrose,3006,1,24,7,5,62,34,28,79
Peterhead,3006,2,24,4,8,82,39,43,76
Stirling,3006,3,17,6,13,61,51,10,57
Clyde,3006,4,15,9,12,54,48,6,54
Stenhousem'r,3006,5,15,8,13,55,47,8,53
Elgin,3006,6,14,6,16,53,63,-10,48
Annan Athlet,3006,7,11,11,14,47,42,5,44
Berwick,3006,8,8,10,18,29,61,-32,34
Edinburgh Ci,3006,9,7,9,20,37,65,-28,30
Cowdenbeath,3006,10,5,10,21,24,54,-30,25
Peterhead,3007,1,24,4,8,78,38,40,76
Montrose,3007,2,23,7,6,59,36,23,76
Stirling,3007,3,17,6,13,65,53,12,57
Stenhousem'r,3007,4,15,8,13,57,51,6,53
Clyde,3007,5,14,9,13,51,49,2,51
Elgin,3007,6,15,6,15,55,60,-5,51
Annan Athlet,3007,7,11,12,13,49,43,6,45
Berwick,3007,8,9,10,17,30,58,-28,37
Edinburgh Ci,3007,9,7,9,20,36,61,-25,30
Cowdenbeath,3007,10,4,11,21,25,56,-31,23
Montrose,3008,1,23,8,5,59,34,25,77
Peterhead,3008,2,23,4,9,78,40,38,73
Stenhousem'r,3008,3,16,8,12,58,48,10,56
Stirling,3008,4,16,6,14,62,54,8,54
Clyde,3008,5,15,9,12,52,48,4,54
Elgin,3008,6,14,7,15,53,60,-7,49
Annan Athlet,3008,7,11,12,13,48,42,6,45
Berwick,3008,8,8,10,18,29,59,-30,34
Edinburgh Ci,3008,9,8,9,19,38,61,-23,33
Cowdenbeath,3008,10,4,11,21,24,55,-31,23
Montrose,3009,1,23,8,5,59,34,25,77
Peterhead,3009,2,24,4,8,80,38,42,76
Stirling,3009,3,17,6,13,62,52,10,57
Clyde,3009,4,15,9,12,52,48,4,54
Stenhousem'r,3009,5,15,8,13,56,48,8,53
Elgin,3009,6,14,7,15,53,60,-7,49
Annan Athlet,3009,7,11,12,13,48,42,6,45
Berwick,3009,8,8,10,18,29,59,-30,34
Edinburgh Ci,3009,9,7,9,20,36,63,-27,30
Cowdenbeath,3009,10,4,11,21,24,55,-31,23
Montrose,3010,1,24,7,5,60,34,26,79
Peterhead,3010,2,24,4,8,83,39,44,76
Stirling,3010,3,16,7,13,61,52,9,55
Stenhousem'r,3010,4,15,9,12,56,47,9,54
Clyde,3010,5,15,9,12,54,48,6,54
Elgin,3010,6,14,6,16,53,61,-8,48
Annan Athlet,3010,7,11,12,13,48,42,6,45
Berwick,3010,8,8,10,18,29,61,-32,34
Edinburgh Ci,3010,9,7,9,20,37,66,-29,30
Cowdenbeath,3010,10,4,11,21,24,55,-31,23
Montrose,3011,1,24,7,5,62,36,26,79
Peterhead,3011,2,24,4,8,80,38,42,76
Stirling,3011,3,17,6,13,61,51,10,57
Stenhousem'r,3011,4,15,8,13,55,47,8,53
Clyde,3011,5,14,10,12,53,50,3,52
Elgin,3011,6,14,6,16,55,63,-8,48
Annan Athlet,3011,7,11,11,14,47,44,3,44
Berwick,3011,8,8,11,17,31,60,-29,35
Edinburgh Ci,3011,9,7,9,20,36,63,-27,30
Cowdenbeath,3011,10,5,10,21,26,54,-28,25
Montrose,3012,1,23,8,5,62,37,25,77
Peterhead,3012,2,24,4,8,82,38,44,76
Stirling,3012,3,17,6,13,62,51,11,57
Clyde,3012,4,15,9,12,53,49,4,54
Stenhousem'r,3012,5,15,8,13,55,48,7,53
Elgin,3012,6,14,7,15,56,63,-7,49
Annan Athlet,3012,7,12,11,13,48,41,7,47
Berwick,3012,8,8,10,18,30,60,-30,34
Edinburgh Ci,3012,9,7,9,20,36,65,-29,30
Cowdenbeath,3012,10,4,10,22,23,55,-32,22
Montrose,3013,1,24,7,5,61,35,26,79
Peterhead,3013,2,24,4,8,79,38,41,76
Stirling,3013,3,16,7,13,61,52,9,55
Stenhousem'r,3013,4,15,9,12,56,47,9,54
Clyde,3013,5,14,10,12,52,49,3,52
Elgin,3013,6,14,6,16,54,62,-8,48
Annan Athlet,3013,7,11,11,14,47,42,5,44
Berwick,3013,8,8,11,17,30,59,-29,35
Edinburgh Ci,3013,9,7,9,20,36,62,-26,30
Cowdenbeath,3013,10,5,10,21,24,54,-30,25
Montrose,3014,1,24,7,5,61,35,26,79
Peterhead,3014,2,23,5,8,79,40,39,74
Stenhousem'r,3014,3,16,8,12,57,47,10,56
Stirling,3014,4,16,6,14,61,53,8,54
Clyde,3014,5,14,9,13,52,50,2,51
Elgin,3014,6,14,6,16,54,62,-8,48
Annan Athlet,3014,7,11,12,13,48,42,6,45
Berwick,3014,8,9,10,17,31,59,-28,37
Edinburgh Ci,3014,9,7,10,19,38,62,-24,31
Cowdenbeath,3014,10,4,11,21,24,55,-31,23
Peterhead,3015,1,24,4,8,82,39,43,76
Montrose,3015,2,23,7,6,60,37,23,76
Stirling,3015,3,17,6,13,63,51,12,57
Clyde,3015,4,15,9,12,54,48,6,54
Stenhousem'r,3015,5,15,8,13,55,49,6,53
Elgin,3015,6,15,6,15,56,61,-5,51
Annan Athlet,3015,7,11,11,14,47,42,5,44
Berwick,3015,8,8,10,18,29,61,-32,34
Edinburgh Ci,3015,9,7,9,20,37,65,-28,30
Cowdenbeath,3015,10,5,10,21,24,54,-30,25
Montrose,3016,1,24,7,5,62,36,26,79
Peterhead,3016,2,24,4,8,81,39,42,76
Stirling,3016,3,16,7,13,61,52,9,55
Stenhousem'r,3016,4,15,9,12,56,47,9,54
Clyde,3016,5,14,9,13,52,50,2,51
Elgin,3016,6,14,6,16,55,63,-8,48
Annan Athlet,3016,7,12,11,13,49,42,7,47
Berwick,3016,8,9,10,17,31,59,-28,37
Edinburgh Ci,3016,9,7,9,20,37,64,-27,30
Cowdenbeath,3016,10,4,10,22,24,56,-32,22
Montrose,3017,1,24,7,5,61,34,27,79
Peterhead,3017,2,24,4,8,80,38,42,76
Stirling,3017,3,16,7,13,62,53,9,55
Stenhousem'r,3017,4,15,9,12,57,48,9,54
Clyde,3017,5,15,9,12,52,48,4,54
Elgin,3017,6,14,6,16,53,62,-9,48
Annan Athlet,3017,7,11,12,13,48,42,6,45
Berwick,3017,8,8,10,18,29,59,-30,34
Edinburgh Ci,3017,9,7,9,20,36,63,-27,30
Cowdenbeath,3017,10,4,11,21,24,55,-31,23
Montrose,3018,1,24,7,5,61,35,26,79
Peterhead,3018,2,24,4,8,80,38,42,76
Stirling,3018,3,17,6,13,62,52,10,57
Clyde,3018,4,15,9,12,53,48,5,54
Stenhousem'r,3018,5,15,8,13,56,48,8,53
Elgin,3018,6,14,6,16,54,62,-8,48
Annan Athlet,3018,7,12,11,13,49,42,7,47
Berwick,3018,8,8,10,18,29,60,-31,34
Edinburgh Ci,3018,9,7,9,20,36,63,-27,30
Cowdenbeath,3018,10,4,10,22,24,56,-32,22
Montrose,3019,1,24,7,5,61,34,27,79
Peterhead,3019,2,24,4,8,81,39,42,76
Stirling,3019,3,16,7,13,61,52,9,55
Stenhousem'r,3019,4,15,9,12,56,47,9,54
Clyde,3019,5,15,9,12,52,48,4,54
Elgin,3019,6,14,6,16,53,62,-9,48
Annan Athlet,3019,7,11,12,13,47,41,6,45
Berwick,3019,8,8,10,18,29,59,-30,34
Edinburgh Ci,3019,9,7,9,20,37,64,-27,30
Cowdenbeath,3019,10,4,11,21,23,54,-31,23
Montrose,3020,1,23,8,5,61,36,25,77
Peterhead,3020,2,24,4,8,80,38,42,76
Stenhousem'r,3020,3,16,8,12,56,46,10,56
Stirling,3020,4,16,6,14,60,52,8,54
Clyde,3020,5,14,10,12,51,48,3,52
Elgin,3020,6,14,7,15,55,62,-7,49
Annan Athlet,3020,7,11,12,13,48,42,6,45
Berwick,3020,8,8,11,17,29,58,-29,35
Edinburgh Ci,3020,9,7,9,20,36,63,-27,30
Cowdenbeath,3020,10,4,11,21,24,55,-31,23
Montrose,3021,1,24,7,5,63,36,27,79
Peterhead,3021,2,24,4,8,79,38,41,76
Stenhousem'r,3021,3,16,8,12,58,46,12,56
Stirling,3021,4,16,6,14,60,54,6,54
Clyde,3021,5,14,10,12,52,49,3,52
Elgin,3021,6,14,6,16,55,64,-9,48
Annan Athlet,3021,7,12,11,13,50,41,9,47
Berwick,3021,8,8,11,17,30,59,-29,35
Edinburgh Ci,3021,9,7,9,20,36,62,-26,30
Cowdenbeath,3021,10,4,10,22,23,57,-34,22
Montrose,3022,1,24,7,5,61,34,27,79
Peterhead,3022,2,23,5,8,79,40,39,74
Stirling,3022,3,17,6,13,62,52,10,57
Clyde,3022,4,15,9,12,53,49,4,54
Stenhousem'r,3022,5,15,8,13,56,48,8,53
Elgin,3022,6,14,6,16,53,62,-9,48
Annan Athlet,3022,7,12,11,13,48,41,7,47
Berwick,3022,8,8,10,18,30,60,-30,34
Edinburgh Ci,3022,9,7,10,19,38,62,-24,31
Cowdenbeath,3022,10,4,10,22,23,55,-32,22
Montrose,3023,1,24,7,5,64,35,29,79
Peterhead,3023,2,24,4,8,81,38,43,76
Stirling,3023,3,16,7,13,60,51,9,55
Stenhousem'r,3023,4,15,9,12,55,46,9,54
Clyde,3023,5,15,9,12,52,48,4,54
Elgin,3023,6,14,6,16,54,65,-11,48
Annan Athlet,3023,7,12,11,13,48,41,7,47
Berwick,3023,8,8,10,18,29,59,-30,34
Edinburgh Ci,3023,9,7,9,20,36,64,-28,30
Cowdenbeath,3023,10,4,10,22,23,55,-32,22
Peterhead,3024,1,24,4,8,80,38,42,76
Montrose,3024,2,23,7,6,60,36,24,76
Stirling,3024,3,16,7,13,62,53,9,55
Stenhousem'r,3024,4,15,9,12,57,48,9,54
Clyde,3024,5,14,10,12,51,48,3,52
Elgin,3024,6,15,6,15,55,61,-6,51
Annan Athlet,3024,7,11,11,14,47,42,5,44
Berwick,3024,8,8,11,17,29,58,-29,35
Edinburgh Ci,3024,9,7,9,20,36,63,-27,30
Cowdenbeath,3024,10,5,10,21,24,54,-30,25
Montrose,3025,1,24,7,5,62,35,27,79
Peterhead,3025,2,24,4,8,81,38,43,76
Stirling,3025,3,17,6,13,63,52,11,57
Clyde,3025,4,15,9,12,53,48,5,54
Stenhousem'r,3025,5,15,8,13,56,49,7,53
Elgin,3025,6,14,6,16,54,63,-9,48
Annan Athlet,3025,7,12,11,13,50,42,8,47
Berwick,3025,8,8,10,18,29,60,-31,34
Edinburgh Ci,3025,9,7,9,20,36,64,-28,30
Cowdenbeath,3025,10,4,10,22,24,57,-33,22
Montrose,3026,1,24,7,5,63,35,28,79
Peterhead,3026,2,23,4,9,77,39,38,73
Stirling,3026,3,17,6,13,62,52,10,57
Clyde,3026,4,15,9,12,54,48,6,54
Stenhousem'r,3026,5,15,8,13,56,48,8,53
Elgin,3026,6,14,6,16,54,64,-10,48
Annan Athlet,3026,7,12,11,13,49,41,8,47
Berwick,3026,8,8,10,18,29,61,-32,34
Edinburgh Ci,3026,9,8,9,19,37,60,-23,33
Cowdenbeath,3026,10,4,10,22,23,56,-33,22
Montrose,3027,1,24,7,5,60,34,26,79
Peterhead,3027,2,24,4,8,80,40,40,76
Stirling,3027,3,17,6,13,62,51,11,57
Clyde,3027,4,15,9,12,53,49,4,54
Stenhousem'r,3027,5,15,8,13,55,48,7,53
Elgin,3027,6,14,6,16,53,61,-8,48
Annan Athlet,3027,7,11,11,14,47,43,4,44
Berwick,3027,8,8,10,18,30,60,-30,34
Edinburgh Ci,3027,9,7,9,20,38,63,-25,30
Cowdenbeath,3027,10,5,10,21,25,54,-29,25
Montrose,3028,1,23,8,5,60,35,25,77
Peterhead,3028,2,23,5,8,77,38,39,74
Stirling,3028,3,17,6,13,62,52,10,57
Clyde,3028,4,15,9,12,52,48,4,54
Stenhousem'r,3028,5,15,8,13,56,48,8,53
Elgin,3028,6,14,7,15,54,61,-7,49
Annan Athlet,3028,7,11,12,13,48,42,6,45
Berwick,3028,8,8,10,18,29,59,-30,34
Edinburgh Ci,3028,9,7,10,19,36,60,-24,31
Cowdenbeath,3028,10,4,11,21,24,55,-31,23
Montrose,3029,1,23,7,6,59,35,24,76
Peterhead,3029,2,23,4,9,78,41,37,73
Stenhousem'r,3029,3,16,8,12,57,46,11,56
Stirling,3029,4,16,6,14,60,53,7,54
Clyde,3029,5,15,9,12,55,50,5,54
Elgin,3029,6,15,6,15,54,60,-6,51
Annan Athlet,3029,7,11,11,14,47,43,4,44
Berwick,3029,8,8,10,18,31,62,-31,34
Edinburgh Ci,3029,9,8,9,19,39,61,-22,33
Cowdenbeath,3029,10,5,10,21,25,54,-29,25
Peterhead,3030,1,24,4,8,80,39,41,76
Montrose,3030,2,23,7,6,60,36,24,76
Stirling,3030,3,16,7,13,62,53,9,55
Stenhousem'r,3030,4,15,9,12,57,48,9,54
Clyde,3030,5,14,9,13,54,52,2,51
Elgin,3030,6,15,6,15,55,61,-6,51
Annan Athlet,3030,7,12,11,13,50,42,8,47
Berwick,3030,8,9,10,17,33,61,-28,37
Edinburgh Ci,3030,9,7,9,20,37,63,-26,30
Cowdenbeath,3030,10,4,10,22,24,57,-33,22
Montrose,3031,1,24,7,5,60,34,26,79
Peterhead,3031,2,24,4,8,78,38,40,76
Stirling,3031,3,16,7,13,61,52,9,55
Stenhousem'r,3031,4,15,9,12,56,47,9,54
Clyde,3031,5,15,9,12,52,48,4,54
Elgin,3031,6,14,6,16,53,61,-8,48
Annan Athlet,3031,7,11,11,14,47,43,4,44
Berwick,3031,8,8,10,18,29,59,-30,34
Edinburgh Ci,3031,9,7,9,20,36,61,-25,30
Cowdenbeath,3031,10,5,10,21,25,54,-29,25
Montrose,3032,1,23,8,5,61,36,25,77
Peterhead,3032,2,24,4,8,85,38,47,76
Stirling,3032,3,17,6,13,62,51,11,57
Stenhousem'r,3032,4,15,8,13,55,48,7,53
Clyde,3032,5,14,10,12,51,48,3,52
Elgin,3032,6,14,7,15,55,62,-7,49
Annan Athlet,3032,7,11,11,14,48,43,5,44
Berwick,3032,8,8,11,17,29,58,-29,35
Edinburgh Ci,3032,9,7,9,20,36,68,-32,30
Cowdenbeath,3032,10,5,10,21,25,55,-30,25
Montrose,3033,1,23,8,5,60,35,25,77
Peterhead,3033,2,24,4,8,81,39,42,76
Stirling,3033,3,17,6,13,62,51,11,57
Stenhousem'r,3033,4,15,8,13,55,48,7,53
Clyde,3033,5,14,10,12,52,49,3,52
Elgin,3033,6,14,7,15,54,61,-7,49
Annan Athlet,3033,7,11,11,14,49,44,5,44
Berwick,3033,8,8,11,17,30,59,-29,35
Edinburgh Ci,3033,9,7,9,20,37,64,-27,30
Cowdenbeath,3033,10,5,10,21,26,56,-30,25
Montrose,3034,1,24,7,5,62,36,26,79
Peterhead,3034,2,24,4,8,79,38,41,76
Stirling,3034,3,17,6,13,62,51,11,57
Stenhousem'r,3034,4,15,8,13,55,48,7,53
Clyde,3034,5,14,10,12,52,49,3,52
Elgin,3034,6,14,6,16,55,63,-8,48
Annan Athlet,3034,7,11,11,14,47,42,5,44
Berwick,3034,8,8,11,17,30,59,-29,35
Edinburgh Ci,3034,9,7,9,20,36,62,-26,30
Cowdenbeath,3034,10,5,10,21,24,54,-30,25
Montrose,3035,1,24,7,5,60,34,26,79
Peterhead,3035,2,24,4,8,80,38,42,76
Stirling,3035,3,17,6,13,62,52,10,57
Clyde,3035,4,15,9,12,53,48,5,54
Stenhousem'r,3035,5,15,8,13,56,48,8,53
Elgin,3035,6,14,6,16,53,61,-8,48
Annan Athlet,3035,7,12,11,13,48,41,7,47
Berwick,3035,8,8,10,18,29,60,-31,34
Edinburgh Ci,3035,9,7,9,20,36,63,-27,30
Cowdenbeath,3035,10,4,10,22,23,55,-32,22
Montrose,3036,1,23,8,5,61,36,25,77
Peterhead,3036,2,24,4,8,82,39,43,76
Stenhousem'r,3036,3,16,8,12,56,46,10,56
Stirling,3036,4,16,6,14,60,52,8,54
Clyde,3036,5,15,9,12,52,48,4,54
Elgin,3036,6,14,7,15,55,62,-7,49
Annan Athlet,3036,7,11,12,13,47,41,6,45
Berwick,3036,8,8,10,18,29,59,-30,34
Edinburgh Ci,3036,9,7,9,20,37,65,-28,30
Cowdenbeath,3036,10,4,11,21,23,54,-31,23
Peterhead,3037,1,24,4,8,81,39,42,76
Montrose,3037,2,23,7,6,59,35,24,76
Stirling,3037,3,17,6,13,64,51,13,57
Stenhousem'r,3037,4,15,8,13,55,50,5,53
Clyde,3037,5,14,9,13,53,51,2,51
Elgin,3037,6,15,6,15,54,60,-6,51
Annan Athlet,3037,7,11,11,14,48,43,5,44
Berwick,3037,8,9,10,17,32,60,-28,37
Edinburgh Ci,3037,9,7,9,20,37,64,-27,30
Cowdenbeath,3037,10,5,10,21,25,55,-30,25
Montrose,3038,1,24,7,5,62,34,28,79
Peterhead,3038,2,24,4,8,80,40,40,76
Stirling,3038,3,17,6,13,61,51,10,57
Clyde,3038,4,15,9,12,53,48,5,54
Stenhousem'r,3038,5,15,8,13,55,47,8,53
Elgin,3038,6,14,6,16,53,63,-10,48
Annan Athlet,3038,7,12,11,13,49,41,8,47
Berwick,3038,8,8,10,18,29,60,-31,34
Edinburgh Ci,3038,9,7,9,20,38,63,-25,30
Cowdenbeath,3038,10,4,10,22,23,56,-33,22
Montrose,3039,1,23,8,5,59,34,25,77
Peterhead,3039,2,23,4,9,79,41,38,73
Stirling,3039,3,16,7,13,62,53,9,55
Stenhousem'r,3039,4,15,9,12,57,48,9,54
Clyde,3039,5,15,9,12,52,48,4,54
Elgin,3039,6,14,7,15,53,60,-7,49
Annan Athlet,3039,7,12,11,13,48,41,7,47
Berwick,3039,8,8,10,18,29,59,-30,34
Edinburgh Ci,3039,9,8,9,19,39,62,-23,33
Cowdenbeath,3039,10,4,10,22,23,55,-32,22
Peterhead,3040,1,24,4,8,80,38,42,76
Montrose,3040,2,23,7,6,59,36,23,76
Stirling,3040,3,17,6,13,62,51,11,57
Stenhousem'r,3040,4,15,8,13,55,48,7,53
Clyde,3040,5,14,9,13,53,51,2,51
Elgin,3040,6,15,6,15,55,60,-5,51
Annan Athlet,3040,7,11,11,14,47,43,4,44
Berwick,3040,8,9,10,17,32,60,-28,37
Edinburgh Ci,3040,9,7,9,20,36,63,-27,30
Cowdenbeath,3040,10,5,10,21,25,54,-29,25
Montrose,3041,1,24,7,5,64,34,30,79
Peterhead,3041,2,23,5,8,78,39,39,74
Stirling,3041,3,16,7,13,61,52,9,55
Stenhousem'r,3041,4,15,9,12,56,47,9,54
Clyde,3041,5,14,9,13,51,50,1,51
Elgin,3041,6,14,6,16,53,65,-12,48
Annan Athlet,3041,7,12,11,13,50,43,7,47
Berwick,3041,8,9,10,17,31,58,-27,37
Edinburgh Ci,3041,9,7,10,19,37,61,-24,31
Cowdenbeath,3041,10,4,10,22,25,57,-32,22
Peterhead,3042,1,24,4,8,80,38,42,76
Montrose,3042,2,23,7,6,59,35,24,76
Stenhousem'r,3042,3,16,8,12,56,46,10,56
Stirling,3042,4,16,6,14,60,52,8,54
Clyde,3042,5,15,9,12,52,48,4,54
Elgin,3042,6,15,6,15,54,60,-6,51
Annan Athlet,3042,7,12,11,13,48,41,7,47
Berwick,3042,8,8,10,18,29,59,-30,34
Edinburgh Ci,3042,9,7,9,20,36,63,-27,30
Cowdenbeath,3042,10,4,10,22,23,55,-32,22
Montrose,3043,1,24,7,5,61,35,26,79
Peterhead,3043,2,24,4,8,81,40,41,76
Stenhousem'r,3043,3,16,8,12,57,47,10,56
Stirling,3043,4,16,6,14,61,53,8,54
Clyde,3043,5,14,9,13,52,50,2,51
Elgin,3043,6,14,6,16,54,62,-8,48
Annan Athlet,3043,7,12,11,13,48,41,7,47
Berwick,3043,8,9,10,17,31,59,-28,37
Edinburgh Ci,3043,9,7,9,20,38,64,-26,30
Cowdenbeath,3043,10,4,10,22,23,55,-32,22
Montrose,3044,1,24,7,5,61,34,27,79
Peterhead,3044,2,24,4,8,81,39,42,76
Stirling,3044,3,17,6,13,62,51,11,57
Stenhousem'r,3044,4,15,8,13,55,48,7,53
Clyde,3044,5,14,10,12,51,48,3,52
Elgin,3044,6,14,6,16,53,62,-9,48
Annan Athlet,3044,7,11,12,13,48,42,6,45
Berwick,3044,8,8,11,17,29,58,-29,35
Edinburgh Ci,3044,9,7,9,20,37,64,-27,30
Cowdenbeath,3044,10,4,11,21,24,55,-31,23
Montrose,3045,1,24,7,5,61,35,26,79
Peterhead,3045,2,23,5,8,78,39,39,74
Stenhousem'r,3045,3,16,8,12,57,46,11,56
Stirling,3045,4,16,6,14,60,53,7,54
Clyde,3045,5,15,9,12,52,48,4,54
Elgin,3045,6,14,6,16,54,62,-8,48
Annan Athlet,3045,7,12,11,13,50,43,7,47
Berwick,3045,8,8,10,18,29,59,-30,34
Edinburgh Ci,3045,9,7,10,19,37,61,-24,31
Cowdenbeath,3045,10,4,10,22,25,57,-32,22
Montrose,3046,1,23,8,5,59,34,25,77
Peterhead,3046,2,24,4,8,78,38,40,76
Stirling,3046,3,16,7,13,62,53,9,55
Stenhousem'r,3046,4,15,9,12,57,48,9,54
Clyde,3046,5,15,9,12,52,48,4,54
Elgin,3046,6,14,7,15,53,60,-7,49
Annan Athlet,3046,7,11,11,14,48,43,5,44
Berwick,3046,8,8,10,18,29,59,-30,34
Edinburgh Ci,3046,9,7,9,20,36,61,-25,30
Cowdenbeath,3046,10,5,10,21,25,55,-30,25
Peterhead,3047,1,24,4,8,79,39,40,76
Montrose,3047,2,23,7,6,61,37,24,76
Stirling,3047,3,17,6,13,63,53,10,57
Clyde,3047,4,15,9,12,55,51,4,54
Stenhousem'r,3047,5,15,8,13,57,49,8,53
Elgin,3047,6,15,6,15,56,62,-6,51
Annan Athlet,3047,7,12,11,13,50,42,8,47
Berwick,3047,8,8,10,18,32,62,-30,34
Edinburgh Ci,3047,9,7,9,20,37,62,-25,30
Cowdenbeath,3047,10,4,10,22,24,57,-33,22
Peterhead,3048,1,24,4,8,81,39,42,76
Montrose,3048,2,23,7,6,60,37,23,76
Stirling,3048,3,16,7,13,64,55,9,55
Stenhousem'r,3048,4,15,9,12,59,50,9,54
Clyde,3048,5,14,10,12,51,48,3,52
Elgin,3048,6,15,6,15,56,61,-5,51
Annan Athlet,3048,7,11,11,14,48,43,5,44
Berwick,3048,8,8,11,17,29,58,-29,35
Edinburgh Ci,3048,9,7,9,20,37,64,-27,30
Cowdenbeath,3048,10,5,10,21,25,55,-30,25
Montrose,3049,1,24,7,5,60,34,26,79
Peterhead,3049,2,24,4,8,79,38,41,76
Stirling,3049,3,16,7,13,60,51,9,55
Stenhousem'r,3049,4,15,9,12,55,46,9,54
Clyde,3049,5,15,9,12,54,48,6,54
Elgin,3049,6,14,6,16,53,61,-8,48
Annan Athlet,3049,7,11,11,14,47,43,4,44
Berwick,3049,8,8,10,18,29,61,-32,34
Edinburgh Ci,3049,9,7,9,20,36,62,-26,30
Cowdenbeath,3049,10,5,10,21,25,54,-29,25
Montrose,3050,1,23,7,6,60,36,24,76
Peterhead,3050,2,23,4,9,77,42,35,73
Stenhousem'r,3050,3,16,8,12,56,46,10,56
Stirling,3050,4,16,6,14,60,52,8,54
Clyde,3050,5,14,10,12,52,49,3,52
Elgin,3050,6,15,6,15,55,61,-6,51
Annan Athlet,3050,7,12,11,13,50,41,9,47
Berwick,3050,8,8,11,17,30,59,-29,35
Edinburgh Ci,3050,9,8,9,19,40,60,-20,33
Cowdenbeath,3050,10,4,10,22,23,57,-34,22
Peterhead,3051,1,24,4,8,84,40,44,76
Montrose,3051,2,23,7,6,60,36,24,76
Stirling,3051,3,17,6,13,62,52,10,57
Stenhousem'r,3051,4,15,8,13,56,48,8,53
Clyde,3051,5,14,9,13,51,50,1,51
Elgin,3051,6,15,6,15,55,61,-6,51
Annan Athlet,3051,7,11,12,13,49,43,6,45
Berwick,3051,8,9,10,17,31,58,-27,37
Edinburgh Ci,3051,9,7,9,20,38,67,-29,30
Cowdenbeath,3051,10,4,11,21,25,56,-31,23
Montrose,3052,1,23,8,5,60,35,25,77
Peterhead,3052,2,23,5,8,77,38,39,74
Stenhousem'r,3052,3,16,8,12,57,46,11,56
Stirling,3052,4,16,6,14,60,53,7,54
Clyde,3052,5,15,9,12,55,48,7,54
Elgin,3052,6,14,7,15,54,61,-7,49
Annan Athlet,3052,7,11,11,14,47,43,4,44
Berwick,3052,8,8,10,18,29,62,-33,34
Edinburgh Ci,3052,9,7,10,19,36,60,-24,31
Cowdenbeath,3052,10,5,10,21,25,54,-29,25
Montrose,3053,1,24,7,5,62,35,27,79
Peterhead,3053,2,24,4,8,78,38,40,76
Stirling,3053,3,17,6,13,61,51,10,57
Stenhousem'r,3053,4,15,8,13,55,47,8,53
Clyde,3053,5,14,10,12,54,51,3,52
Elgin,3053,6,14,6,16,54,63,-9,48
Annan Athlet,3053,7,12,11,13,49,41,8,47
Berwick,3053,8,8,11,17,32,61,-29,35
Edinburgh Ci,3053,9,7,9,20,36,61,-25,30
Cowdenbeath,3053,10,4,10,22,23,56,-33,22
Montrose,3054,1,24,7,5,62,35,27,79
Peterhead,3054,2,23,4,9,77,39,38,73
Stirling,3054,3,17,6,13,65,52,13,57
Stenhousem'r,3054,4,15,8,13,56,51,5,53
Clyde,3054,5,14,9,13,52,50,2,51
Elgin,3054,6,14,6,16,54,63,-9,48
Annan Athlet,3054,7,11,12,13,49,43,6,45
Berwick,3054,8,9,10,17,31,59,-28,37
Edinburgh Ci,3054,9,8,9,19,37,60,-23,33
Cowdenbeath,3054,10,4,11,21,25,56,-31,23
Montrose,3055,1,24,7,5,63,34,29,79
Peterhead,3055,2,24,4,8,81,39,42,76
Stirling,3055,3,16,7,13,61,52,9,55
Stenhousem'r,3055,4,15,9,12,56,47,9,54
Clyde,3055,5,15,9,12,54,49,5,54
Elgin,3055,6,14,6,16,53,64,-11,48
Annan Athlet,3055,7,11,12,13,47,41,6,45
Berwick,3055,8,8,10,18,30,61,-31,34
Edinburgh Ci,3055,9,7,9,20,37,64,-27,30
Cowdenbeath,3055,10,4,11,21,23,54,-31,23
Montrose,3056,1,24,7,5,63,36,27,79
Peterhead,3056,2,24,4,8,84,39,45,76
Stirling,3056,3,17,6,13,61,51,10,57
Stenhousem'r,3056,4,15,8,13,55,47,8,53
Clyde,3056,5,14,10,12,52,49,3,52
Elgin,3056,6,14,6,16,55,64,-9,48
Annan Athlet,3056,7,11,11,14,48,43,5,44
Berwick,3056,8,8,11,17,30,59,-29,35
Edinburgh Ci,3056,9,7,9,20,37,67,-30,30
Cowdenbeath,3056,10,5,10,21,25,55,-30,25
Montrose,3057,1,23,8,5,60,35,25,77
Peterhead,3057,2,24,4,8,80,40,40,76
Stirling,3057,3,17,6,13,62,51,11,57
Stenhousem'r,3057,4,15,8,13,55,48,7,53
Clyde,3057,5,14,10,12,52,49,3,52
Elgin,3057,6,14,7,15,54,61,-7,49
Annan Athlet,3057,7,11,11,14,47,43,4,44
Berwick,3057,8,8,11,17,30,59,-29,35
Edinburgh Ci,3057,9,7,9,20,38,63,-25,30
Cowdenbeath,3057,10,5,10,21,25,54,-29,25
Montrose,3058,1,23,8,5,60,35,25,77
Peterhead,3058,2,23,4,9,78,46,32,73
Stirling,3058,3,16,7,13,61,52,9,55
Stenhousem'r,3058,4,15,9,12,56,47,9,54
Clyde,3058,5,14,9,13,53,51,2,51
Elgin,3058,6,14,7,15,54,61,-7,49
Annan Athlet,3058,7,11,11,14,47,44,3,44
Berwick,3058,8,9,10,17,32,60,-28,37
Edinburgh Ci,3058,9,8,9,19,44,61,-17,33
Cowdenbeath,3058,10,5,10,21,26,54,-28,25
Montrose,3059,1,24,7,5,63,36,27,79
Peterhead,3059,2,24,4,8,80,39,41,76
Stirling,3059,3,16,7,13,60,51,9,55
Stenhousem'r,3059,4,15,9,12,55,46,9,54
Clyde,3059,5,15,9,12,54,48,6,54
Elgin,3059,6,14,6,16,55,64,-9,48
Annan Athlet,3059,7,12,11,13,50,43,7,47
Berwick,3059,8,8,10,18,29,61,-32,34
Edinburgh Ci,3059,9,7,9,20,37,63,-26,30
Cowdenbeath,3059,10,4,10,22,25,57,-32,22
Montrose,3060,1,24,7,5,61,35,26,79
Peterhead,3060,2,23,4,9,78,40,38,73
Stirling,3060,3,16,7,13,60,51,9,55
Stenhousem'r,3060,4,15,9,12,55,46,9,54
Clyde,3060,5,15,9,12,52,48,4,54
Elgin,3060,6,14,6,16,54,62,-8,48
Annan Athlet,3060,7,11,11,14,47,42,5,44
Berwick,3060,8,8,10,18,29,59,-30,34
Edinburgh Ci,3060,9,8,9,19,38,61,-23,33
Cowdenbeath,3060,10,5,10,21,24,54,-30,25
Montrose,3061,1,24,7,5,60,34,26,79
Peterhead,3061,2,24,4,8,80,39,41,76
Stirling,3061,3,17,6,13,63,52,11,57
Clyde,3061,4,15,9,12,52,48,4,54
Stenhousem'r,3061,5,15,8,13,56,49,7,53
Elgin,3061,6,14,6,16,53,61,-8,48
Annan Athlet,3061,7,11,12,13,47,41,6,45
Berwick,3061,8,8,10,18,29,59,-30,34
Edinburgh Ci,3061,9,7,9,20,37,63,-26,30
Cowdenbeath,3061,10,4,11,21,23,54,-31,23
Peterhead,3062,1,24,4,8,78,38,40,76
Montrose,3062,2,23,7,6,60,36,24,76
Stirling,3062,3,16,7,13,62,53,9,55
Stenhousem'r,3062,4,15,9,12,57,48,9,54
Clyde,3062,5,15,9,12,55,50,5,54
Elgin,3062,6,15,6,15,55,61,-6,51
Annan Athlet,3062,7,12,11,13,49,42,7,47
Berwick,3062,8,8,10,18,31,62,-31,34
Edinburgh Ci,3062,9,7,9,20,36,61,-25,30
Cowdenbeath,3062,10,4,10,22,24,56,-32,22
Montrose,3063,1,23,8,5,61,36,25,77
Peterhead,3063,2,23,5,8,78,39,39,74
Stirling,3063,3,17,6,13,63,51,12,57
Clyde,3063,4,15,9,12,55,48,7,54
Stenhousem'r,3063,5,15,8,13,55,49,6,53
Elgin,3063,6,14,7,15,55,62,-7,49
Annan Athlet,3063,7,11,12,13,48,42,6,45
Berwick,3063,8,8,10,18,29,62,-33,34
Edinburgh Ci,3063,9,7,10,19,37,61,-24,31
Cowdenbeath,3063,10,4,11,21,24,55,-31,23
Montrose,3064,1,24,7,5,63,35,28,79
Peterhead,3064,2,23,5,8,78,39,39,74
Stirling,3064,3,16,7,13,62,53,9,55
Stenhousem'r,3064,4,15,9,12,57,48,9,54
Clyde,3064,5,15,9,12,53,48,5,54
Elgin,3064,6,14,6,16,54,64,-10,48
Annan Athlet,3064,7,11,11,14,48,43,5,44
Berwick,3064,8,8,10,18,29,60,-31,34
Edinburgh Ci,3064,9,7,10,19,37,61,-24,31
Cowdenbeath,3064,10,5,10,21,25,55,-30,25
Peterhead,3065,1,24,4,8,78,38,40,76
Montrose,3065,2,23,7,6,62,39,23,76
Stirling,3065,3,17,6,13,63,51,12,57
Stenhousem'r,3065,4,15,8,13,55,49,6,53
Clyde,3065,5,14,10,12,52,49,3,52
Elgin,3065,6,15,6,15,58,63,-5,51
Annan Athlet,3065,7,11,12,13,48,42,6,45
Berwick,3065,8,8,11,17,30,59,-29,35
Edinburgh Ci,3065,9,7,9,20,36,61,-25,30
Cowdenbeath,3065,10,4,11,21,24,55,-31,23
Montrose,3066,1,23,7,6,60,38,22,76
Peterhead,3066,2,23,4,9,78,40,38,73
Stirling,3066,3,16,7,13,61,52,9,55
Stenhousem'r,3066,4,15,9,12,56,47,9,54
Clyde,3066,5,15,9,12,52,48,4,54
Elgin,3066,6,15,6,15,57,61,-4,51
Annan Athlet,3066,7,11,11,14,47,42,5,44
Berwick,3066,8,8,10,18,29,59,-30,34
Edinburgh Ci,3066,9,8,9,19,38,61,-23,33
Cowdenbeath,3066,10,5,10,21,24,54,-30,25
Montrose,3067,1,24,7,5,60,34,26,79
Peterhead,3067,2,24,4,8,81,38,43,76
Stirling,3067,3,17,6,13,63,51,12,57
Clyde,3067,4,15,9,12,53,49,4,54
Stenhousem'r,3067,5,15,8,13,55,49,6,53
Elgin,3067,6,14,6,16,53,61,-8,48
Annan Athlet,3067,7,11,11,14,47,42,5,44
Berwick,3067,8,8,10,18,30,60,-30,34
Edinburgh Ci,3067,9,7,9,20,36,64,-28,30
Cowdenbeath,3067,10,5,10,21,24,54,-30,25
Montrose,3068,1,24,7,5,61,35,26,79
Peterhead,3068,2,24,4,8,80,39,41,76
Stirling,3068,3,17,6,13,65,54,11,57
Clyde,3068,4,15,9,12,52,48,4,54
Stenhousem'r,3068,5,15,8,13,58,51,7,53
Elgin,3068,6,14,6,16,54,62,-8,48
Annan Athlet,3068,7,11,11,14,47,43,4,44
Berwick,3068,8,8,10,18,29,59,-30,34
Edinburgh Ci,3068,9,7,9,20,37,63,-26,30
Cowdenbeath,3068,10,5,10,21,25,54,-29,25
Montrose,3069,1,23,8,5,59,34,25,77
Peterhead,3069,2,24,4,8,80,38,42,76
Stenhousem'r,3069,3,16,8,12,60,49,11,56
Stirling,3069,4,16,6,14,63,56,7,54
Clyde,3069,5,15,9,12,56,49,7,54
Elgin,3069,6,14,7,15,53,60,-7,49
Annan Athlet,3069,7,12,11,13,48,41,7,47
Berwick,3069,8,8,10,18,30,63,-33,34
Edinburgh Ci,3069,9,7,9,20,36,63,-27,30
Cowdenbeath,3069,10,4,10,22,23,55,-32,22
Peterhead,3070,1,24,4,8,79,38,41,76
Montrose,3070,2,23,7,6,59,35,24,76
Stirling,3070,3,17,6,13,67,54,13,57
Clyde,3070,4,15,9,12,53,48,5,54
Stenhousem'r,3070,5,15,8,13,58,53,5,53
Elgin,3070,6,15,6,15,54,60,-6,51
Annan Athlet,3070,7,11,11,14,49,44,5,44
Berwick,3070,8,8,10,18,29,60,-31,34
Edinburgh Ci,3070,9,7,9,20,36,62,-26,30
Cowdenbeath,3070,10,5,10,21,26,56,-30,25
Montrose,3071,1,24,7,5,62,34,28,79
Peterhead,3071,2,24,4,8,81,38,43,76
Stirling,3071,3,16,7,13,63,54,9,55
Stenhousem'r,3071,4,15,9,12,58,49,9,54
Clyde,3071,5,14,10,12,52,49,3,52
Elgin,3071,6,14,6,16,53,63,-10,48
Annan Athlet,3071,7,12,11,13,50,42,8,47
Berwick,3071,8,8,11,17,30,59,-29,35
Edinburgh Ci,3071,9,7,9,20,36,64,-28,30
Cowdenbeath,3071,10,4,10,22,24,57,-33,22
Montrose,3072,1,24,7,5,60,34,26,79
Peterhead,3072,2,24,4,8,81,38,43,76
Stirling,3072,3,16,7,13,62,53,9,55
Stenhousem'r,3072,4,15,9,12,57,48,9,54
Clyde,3072,5,15,9,12,54,49,5,54
Elgin,3072,6,14,6,16,53,61,-8,48
Annan Athlet,3072,7,11,11,14,48,44,4,44
Berwick,3072,8,8,10,18,30,61,-31,34
Edinburgh Ci,3072,9,7,9,20,36,64,-28,30
Cowdenbeath,3072,10,5,10,21,26,55,-29,25
Montrose,3073,1,24,7,5,60,34,26,79
Peterhead,3073,2,24,4,8,78,38,40,76
Stirling,3073,3,17,6,13,62,51,11,57
Clyde,3073,4,15,9,12,54,50,4,54
Stenhousem'r,3073,5,15,8,13,55,48,7,53
Elgin,3073,6,14,6,16,53,61,-8,48
Annan Athlet,3073,7,11,11,14,48,44,4,44
Berwick,3073,8,8,10,18,31,61,-30,34
Edinburgh Ci,3073,9,7,9,20,36,61,-25,30
Cowdenbeath,3073,10,5,10,21,26,55,-29,25
Montrose,3074,1,24,7,5,61,34,27,79
Peterhead,3074,2,24,4,8,80,40,40,76
Stirling,3074,3,17,6,13,63,53,10,57
Stenhousem'r,3074,4,15,8,13,57,49,8,53
Clyde,3074,5,14,10,12,51,48,3,52
Elgin,3074,6,14,6,16,53,62,-9,48
Annan Athlet,3074,7,11,11,14,47,42,5,44
Berwick,3074,8,8,11,17,29,58,-29,35
Edinburgh Ci,3074,9,7,9,20,38,63,-25,30
Cowdenbeath,3074,10,5,10,21,24,54,-30,25
Montrose,3075,1,24,7,5,60,34,26,79
Peterhead,3075,2,24,4,8,80,39,41,76
Stirling,3075,3,17,6,13,62,51,11,57
Clyde,3075,4,15,9,12,53,49,4,54
Stenhousem'r,3075,5,15,8,13,55,48,7,53
Elgin,3075,6,14,6,16,53,61,-8,48
Annan Athlet,3075,7,11,12,13,48,42,6,45
Berwick,3075,8,8,10,18,30,60,-30,34
Edinburgh Ci,3075,9,7,9,20,37,63,-26,30
Cowdenbeath,3075,10,4,11,21,24,55,-31,23
Peterhead,3076,1,24,4,8,79,39,40,76
Montrose,3076,2,23,7,6,59,37,22,76
Stenhousem'r,3076,3,16,8,12,56,46,10,56
Stirling,3076,4,16,6,14,60,52,8,54
Clyde,3076,5,14,9,13,51,51,0,51
Elgin,3076,6,15,6,15,56,60,-4,51
Annan Athlet,3076,7,11,11,14,48,43,5,44
Berwick,3076,8,9,10,17,32,58,-26,37
Edinburgh Ci,3076,9,7,9,20,37,62,-25,30
Cowdenbeath,3076,10,5,10,21,25,55,-30,25
Montrose,3077,1,24,7,5,60,34,26,79
Peterhead,3077,2,23,4,9,78,40,38,73
Stenhousem'r,3077,3,16,8,12,56,46,10,56
Stirling,3077,4,16,6,14,60,52,8,54
Clyde,3077,5,15,9,12,53,49,4,54
Elgin,3077,6,14,6,16,53,61,-8,48
Annan Athlet,3077,7,12,11,13,49,42,7,47
Berwick,3077,8,8,10,18,30,60,-30,34
Edinburgh Ci,3077,9,8,9,19,38,61,-23,33
Cowdenbeath,3077,10,4,10,22,24,56,-32,22
Montrose,3078,1,24,7,5,63,35,28,79
Peterhead,3078,2,24,4,8,80,39,41,76
Stenhousem'r,3078,3,16,8,12,58,46,12,56
Stirling,3078,4,16,6,14,60,54,6,54
Clyde,3078,5,14,10,12,51,48,3,52
Elgin,3078,6,14,6,16,54,64,-10,48
Annan Athlet,3078,7,12,11,13,49,41,8,47
Berwick,3078,8,8,11,17,29,58,-29,35
Edinburgh Ci,3078,9,7,9,20,37,63,-26,30
Cowdenbeath,3078,10,4,10,22,23,56,-33,22
Montrose,3079,1,24,7,5,63,35,28,79
Peterhead,3079,2,23,4,9,78,40,38,73
Stenhousem'r,3079,3,16,8,12,57,46,11,56
Stirling,3079,4,16,6,14,60,53,7,54
Clyde,3079,5,15,9,12,53,48,5,54
Elgin,3079,6,14,6,16,54,64,-10,48
Annan Athlet,3079,7,11,12,13,48,42,6,45
Berwick,3079,8,8,10,18,29,60,-31,34
Edinburgh Ci,3079,9,8,9,19,38,61,-23,33
Cowdenbeath,3079,10,4,11,21,24,55,-31,23
Montrose,3080,1,24,7,5,60,34,26,79
Peterhead,3080,2,23,5,8,78,39,39,74
Stenhousem'r,3080,3,16,8,12,58,47,11,56
Stirling,3080,4,16,6,14,61,54,7,54
Clyde,3080,5,14,9,13,53,51,2,51
Elgin,3080,6,14,6,16,53,61,-8,48
Annan Athlet,3080,7,12,11,13,50,42,8,47
Berwick,3080,8,9,10,17,32,60,-28,37
Edinburgh Ci,3080,9,7,10,19,37,61,-24,31
Cowdenbeath,3080,10,4,10,22,24,57,-33,22
Montrose,3081,1,23,8,5,59,34,25,77
Peterhead,3081,2,24,4,8,78,38,40,76
Stenhousem'r,3081,3,16,8,12,59,49,10,56
Stirling,3081,4,16,6,14,63,55,8,54
Clyde,3081,5,14,9,13,51,50,1,51
Elgin,3081,6,14,7,15,53,60,-7,49
Annan Athlet,3081,7,12,11,13,48,41,7,47
Berwick,3081,8,9,10,17,31,58,-27,37
Edinburgh Ci,3081,9,7,9,20,36,61,-25,30
Cowdenbeath,3081,10,4,10,22,23,55,-32,22
Montrose,3082,1,24,7,5,61,34,27,79
Peterhead,3082,2,24,4,8,79,39,40,76
Stirling,3082,3,17,6,13,62,51,11,57
Clyde,3082,4,15,9,12,54,49,5,54
Stenhousem'r,3082,5,15,8,13,55,48,7,53
Elgin,3082,6,14,6,16,53,62,-9,48
Annan Athlet,3082,7,11,11,14,47,42,5,44
Berwick,3082,8,8,10,18,30,61,-31,34
Edinburgh Ci,3082,9,7,9,20,37,62,-25,30
Cowdenbeath,3082,10,5,10,21,24,54,-30,25
Montrose,3083,1,24,7,5,62,34,28,79
Peterhead,3083,2,24,4,8,79,38,41,76
Stenhousem'r,3083,3,16,8,12,58,48,10,56
Stirling,3083,4,16,6,14,62,54,8,54
Clyde,3083,5,14,10,12,52,49,3,52
Elgin,3083,6,14,6,16,53,63,-10,48
Annan Athlet,3083,7,11,11,14,47,42,5,44
Berwick,3083,8,8,11,17,30,59,-29,35
Edinburgh Ci,3083,9,7,9,20,36,62,-26,30
Cowdenbeath,3083,10,5,10,21,24,54,-30,25
Montrose,3084,1,24,7,5,63,36,27,79
Peterhead,3084,2,24,4,8,80,38,42,76
Stenhousem'r,3084,3,16,8,12,59,47,12,56
Stirling,3084,4,16,6,14,61,55,6,54
Clyde,3084,5,15,9,12,53,48,5,54
Elgin,3084,6,14,6,16,55,64,-9,48
Annan Athlet,3084,7,12,11,13,48,41,7,47
Berwick,3084,8,8,10,18,29,60,-31,34
Edinburgh Ci,3084,9,7,9,20,36,63,-27,30
Cowdenbeath,3084,10,4,10,22,23,55,-32,22
Montrose,3085,1,24,7,5,61,34,27,79
Peterhead,3085,2,24,4,8,80,40,40,76
Stirling,3085,3,16,7,13,62,53,9,55
Stenhousem'r,3085,4,15,9,12,57,48,9,54
Clyde,3085,5,15,9,12,55,48,7,54
Elgin,3085,6,14,6,16,53,62,-9,48
Annan Athlet,3085,7,11,12,13,47,41,6,45
Berwick,3085,8,8,10,18,29,62,-33,34
Edinburgh Ci,3085,9,7,9,20,38,63,-25,30
Cowdenbeath,3085,10,4,11,21,23,54,-31,23
Montrose,3086,1,24,7,5,63,36,27,79
Peterhead,3086,2,23,5,8,79,40,39,74
Stirling,3086,3,17,6,13,63,53,10,57
Clyde,3086,4,15,9,12,54,48,6,54
Stenhousem'r,3086,5,15,8,13,57,49,8,53
Elgin,3086,6,14,6,16,55,64,-9,48
Annan Athlet,3086,7,11,12,13,48,42,6,45
Berwick,3086,8,8,10,18,29,61,-32,34
Edinburgh Ci,3086,9,7,10,19,38,62,-24,31
Cowdenbeath,3086,10,4,11,21,24,55,-31,23
Montrose,3087,1,23,7,6,60,37,23,76
Peterhead,3087,2,23,5,8,77,38,39,74
Stirling,3087,3,17,6,13,61,51,10,57
Clyde,3087,4,15,9,12,53,48,5,54
Stenhousem'r,3087,5,15,8,13,55,47,8,53
Elgin,3087,6,15,6,15,56,61,-5,51
Annan Athlet,3087,7,12,11,13,48,41,7,47
Berwick,3087,8,8,10,18,29,60,-31,34
Edinburgh Ci,3087,9,7,10,19,36,60,-24,31
Cowdenbeath,3087,10,4,10,22,23,55,-32,22
Montrose,3088,1,24,7,5,61,34,27,79
Peterhead,3088,2,24,4,8,79,38,41,76
Stirling,3088,3,16,7,13,62,53,9,55
Stenhousem'r,3088,4,15,9,12,57,48,9,54
Clyde,3088,5,15,9,12,55,48,7,54
Elgin,3088,6,14,6,16,53,62,-9,48
Annan Athlet,3088,7,12,11,13,50,42,8,47
Berwick,3088,8,8,10,18,29,62,-33,34
Edinburgh Ci,3088,9,7,9,20,36,62,-26,30
Cowdenbeath,3088,10,4,10,22,24,57,-33,22
Montrose,3089,1,24,7,5,65,37,28,79
Peterhead,3089,2,24,4,8,83,39,44,76
Stirling,3089,3,17,6,13,63,52,11,57
Clyde,3089,4,15,9,12,54,49,5,54
Stenhousem'r,3089,5,15,8,13,56,49,7,53
Elgin,3089,6,14,6,16,56,66,-10,48
Annan Athlet,3089,7,11,12,13,47,41,6,45
Berwick,3089,8,8,10,18,30,61,-31,34
Edinburgh Ci,3089,9,7,9,20,37,66,-29,30
Cowdenbeath,3089,10,4,11,21,23,54,-31,23
Montrose,3090,1,24,7,5,61,35,26,79
Peterhead,3090,2,24,4,8,82,38,44,76
Stirling,3090,3,17,6,13,61,51,10,57
Clyde,3090,4,15,9,12,53,49,4,54
Stenhousem'r,3090,5,15,8,13,55,47,8,53
Elgin,3090,6,14,6,16,54,62,-8,48
Annan Athlet,3090,7,11,12,13,47,41,6,45
Berwick,3090,8,8,10,18,30,60,-30,34
Edinburgh Ci,3090,9,7,9,20,36,65,-29,30
Cowdenbeath,3090,10,4,11,21,23,54,-31,23
Peterhead,3091,1,24,4,8,79,38,41,76
Montrose,3091,2,23,7,6,59,36,23,76
Stirling,3091,3,17,6,13,61,51,10,57
Clyde,3091,4,15,9,12,55,50,5,54
Stenhousem'r,3091,5,15,8,13,55,47,8,53
Elgin,3091,6,15,6,15,55,60,-5,51
Annan Athlet,3091,7,12,11,13,51,41,10,47
Berwick,3091,8,8,10,18,31,62,-31,34
Edinburgh Ci,3091,9,7,9,20,36,62,-26,30
Cowdenbeath,3091,10,4,10,22,23,58,-35,22
Montrose,3092,1,23,8,5,60,35,25,77
Peterhead,3092,2,24,4,8,80,39,41,76
Stenhousem'r,3092,3,16,8,12,58,48,10,56
Stirling,3092,4,16,6,14,62,54,8,54
Clyde,3092,5,15,9,12,53,49,4,54
Elgin,3092,6,14,7,15,54,61,-7,49
Annan Athlet,3092,7,11,12,13,48,42,6,45
Berwick,3092,8,8,10,18,30,60,-30,34
Edinburgh Ci,3092,9,7,9,20,37,63,-26,30
Cowdenbeath,3092,10,4,11,21,24,55,-31,23
Montrose,3093,1,23,8,5,60,35,25,77
Peterhead,3093,2,24,4,8,79,39,40,76
Stirling,3093,3,17,6,13,62,52,10,57
Clyde,3093,4,15,9,12,54,48,6,54
Stenhousem'r,3093,5,15,8,13,56,48,8,53
Elgin,3093,6,14,7,15,54,61,-7,49
Annan Athlet,3093,7,11,12,13,47,41,6,45
Berwick,3093,8,8,10,18,29,61,-32,34
Edinburgh Ci,3093,9,7,9,20,37,62,-25,30
Cowdenbeath,3093,10,4,11,21,23,54,-31,23
Peterhead,3094,1,24,4,8,79,39,40,76
Montrose,3094,2,23,7,6,60,36,24,76
Stirling,3094,3,17,6,13,62,52,10,57
Clyde,3094,4,15,9,12,53,48,5,54
Stenhousem'r,3094,5,15,8,13,56,48,8,53
Elgin,3094,6,15,6,15,55,61,-6,51
Annan Athlet,3094,7,11,12,13,48,42,6,45
Berwick,3094,8,8,10,18,29,60,-31,34
Edinburgh Ci,3094,9,7,9,20,37,62,-25,30
Cowdenbeath,3094,10,4,11,21,24,55,-31,23
Montrose,3095,1,24,7,5,62,34,28,79
Peterhead,3095,2,24,4,8,79,39,40,76
Stirling,3095,3,16,7,13,61,52,9,55
Stenhousem'r,3095,4,15,9,12,56,47,9,54
Clyde,3095,5,14,10,12,53,50,3,52
Elgin,3095,6,14,6,16,53,63,-10,48
Annan Athlet,3095,7,11,12,13,49,43,6,45
Berwick,3095,8,8,11,17,31,60,-29,35
Edinburgh Ci,3095,9,7,9,20,37,62,-25,30
Cowdenbeath,3095,10,4,11,21,25,56,-31,23
Montrose,3096,1,24,7,5,61,35,26,79
Peterhead,3096,2,24,4,8,79,39,40,76
Stenhousem'r,3096,3,16,8,12,58,48,10,56
Stirling,3096,4,16,6,14,62,54,8,54
Clyde,3096,5,15,9,12,55,49,6,54
Elgin,3096,6,14,6,16,54,62,-8,48
Annan Athlet,3096,7,12,11,13,50,42,8,47
Berwick,3096,8,8,10,18,30,62,-32,34
Edinburgh Ci,3096,9,7,9,20,37,62,-25,30
Cowdenbeath,3096,10,4,10,22,24,57,-33,22
Montrose,3097,1,24,7,5,62,34,28,79
Peterhead,3097,2,23,4,9,78,41,37,73
Stenhousem'r,3097,3,16,8,12,56,46,10,56
Stirling,3097,4,16,6,14,60,52,8,54
Clyde,3097,5,14,10,12,54,51,3,52
Elgin,3097,6,14,6,16,53,63,-10,48
Annan Athlet,3097,7,12,11,13,48,41,7,47
Berwick,3097,8,8,11,17,32,61,-29,35
Edinburgh Ci,3097,9,8,9,19,39,61,-22,33
Cowdenbeath,3097,10,4,10,22,23,55,-32,22
Montrose,3098,1,24,7,5,61,35,26,79
Peterhead,3098,2,24,4,8,79,38,41,76
Stirling,3098,3,17,6,13,64,52,12,57
Stenhousem'r,3098,4,15,8,13,56,50,6,53
Clyde,3098,5,14,10,12,53,50,3,52
Elgin,3098,6,14,6,16,54,62,-8,48
Annan Athlet,3098,7,11,12,13,48,42,6,45
Berwick,3098,8,8,11,17,31,60,-29,35
Edinburgh Ci,3098,9,7,9,20,36,62,-26,30
Cowdenbeath,3098,10,4,11,21,24,55,-31,23
Montrose,3099,1,24,7,5,64,34,30,79
Peterhead,3099,2,24,4,8,78,38,40,76
Stirling,3099,3,16,7,13,61,52,9,55
Stenhousem'r,3099,4,15,9,12,56,47,9,54
Clyde,3099,5,15,9,12,54,48,6,54
Elgin,3099,6,14,6,16,53,65,-12,48
Annan Athlet,3099,7,11,11,14,47,44,3,44
Berwick,3099,8,8,10,18,29,61,-32,34
Edinburgh Ci,3099,9,7,9,20,36,61,-25,30
Cowdenbeath,3099,10,5,10,21,26,54,-28,25
Montrose,3100,1,24,7,5,60,34,26,79
Peterhead,3100,2,24,4,8,79,38,41,76
Stirling,3100,3,17,6,13,61,51,10,57
Clyde,3100,4,15,9,12,55,48,7,54
Stenhousem'r,3100,5,15,8,13,55,47,8,53
Elgin,3100,6,14,6,16,53,61,-8,48
Annan Athlet,3100,7,11,12,13,48,42,6,45
Berwick,3100,8,8,10,18,29,62,-33,34
Edinburgh Ci,3100,9,7,9,20,36,62,-26,30
Cowdenbeath,3100,10,4,11,21,24,55,-31,23
Montrose,3101,1,24,7,5,64,35,29,79
Peterhead,3101,2,24,4,8,78,38,40,76
Stirling,3101,3,17,6,13,62,52,10,57
Stenhousem'r,3101,4,15,8,13,56,48,8,53
Clyde,3101,5,14,9,13,52,50,2,51
Elgin,3101,6,14,6,16,54,65,-11,48
Annan Athlet,3101,7,12,11,13,48,41,7,47
Berwick,3101,8,9,10,17,31,59,-28,37
Edinburgh Ci,3101,9,7,9,20,36,61,-25,30
Cowdenbeath,3101,10,4,10,22,23,55,-32,22
Montrose,3102,1,24,7,5,62,34,28,79
Peterhead,3102,2,24,4,8,78,38,40,76
Stirling,3102,3,17,6,13,63,52,11,57
Clyde,3102,4,15,9,12,52,48,4,54
Stenhousem'r,3102,5,15,8,13,56,49,7,53
Elgin,3102,6,14,6,16,53,63,-10,48
Annan Athlet,3102,7,11,11,14,48,43,5,44
Berwick,3102,8,8,10,18,29,59,-30,34
Edinburgh Ci,3102,9,7,9,20,36,61,-25,30
Cowdenbeath,3102,10,5,10,21,25,55,-30,25
Montrose,3103,1,24,7,5,63,35,28,79
Peterhead,3103,2,23,4,9,78,40,38,73
Stirling,3103,3,17,6,13,63,51,12,57
Stenhousem'r,3103,4,15,8,13,55,49,6,53
Clyde,3103,5,14,10,12,52,49,3,52
Elgin,3103,6,14,6,16,54,64,-10,48
Annan Athlet,3103,7,12,11,13,49,42,7,47
Berwick,3103,8,8,11,17,30,59,-29,35
Edinburgh Ci,3103,9,8,9,19,38,61,-23,33
Cowdenbeath,3103,10,4,10,22,24,56,-32,22
Montrose,3104,1,23,8,5,60,35,25,77
Peterhead,3104,2,23,5,8,78,39,39,74
Stirling,3104,3,17,6,13,62,51,11,57
Clyde,3104,4,15,9,12,54,50,4,54
Stenhousem'r,3104,5,15,8,13,55,48,7,53
Elgin,3104,6,14,7,15,54,61,-7,49
Annan Athlet,3104,7,11,11,14,48,43,5,44
Berwick,3104,8,8,10,18,31,61,-30,34
Edinburgh Ci,3104,9,7,10,19,37,61,-24,31
Cowdenbeath,3104,10,5,10,21,25,55,-30,25
Montrose,3105,1,23,8,5,60,35,25,77
Peterhead,3105,2,24,4,8,80,40,40,76
Stirling,3105,3,17,6,13,65,52,13,57
Clyde,3105,4,15,9,12,52,48,4,54
Stenhousem'r,3105,5,15,8,13,56,51,5,53
Elgin,3105,6,14,7,15,54,61,-7,49
Annan Athlet,3105,7,12,11,13,49,42,7,47
Berwick,3105,8,8,10,18,29,59,-30,34
Edinburgh Ci,3105,9,7,9,20,38,63,-25,30
Cowdenbeath,3105,10,4,10,22,24,56,-32,22
Montrose,3106,1,24,7,5,64,34,30,79
Peterhead,3106,2,24,4,8,79,39,40,76
Stirling,3106,3,17,6,13,62,52,10,57
Clyde,3106,4,15,9,12,54,48,6,54
Stenhousem'r,3106,5,15,8,13,56,48,8,53
Elgin,3106,6,14,6,16,53,65,-12,48
Annan Athlet,3106,7,12,11,13,52,42,10,47
Berwick,3106,8,8,10,18,29,61,-32,34
Edinburgh Ci,3106,9,7,9,20,37,62,-25,30
Cowdenbeath,3106,10,4,10,22,24,59,-35,22
Montrose,3107,1,24,7,5,63,37,26,79
Peterhead,3107,2,24,4,8,80,39,41,76
Stirling,3107,3,16,7,13,61,52,9,55
Stenhousem'r,3107,4,15,9,12,56,47,9,54
Clyde,3107,5,14,10,12,53,50,3,52
Elgin,3107,6,14,6,16,56,64,-8,48
Annan Athlet,3107,7,11,11,14,47,43,4,44
Berwick,3107,8,8,11,17,31,60,-29,35
Edinburgh Ci,3107,9,7,9,20,37,63,-26,30
Cowdenbeath,3107,10,5,10,21,25,54,-29,25
Peterhead,3108,1,24,4,8,80,38,42,76
Montrose,3108,2,23,7,6,61,37,24,76
Stirling,3108,3,16,7,13,62,53,9,55
Stenhousem'r,3108,4,15,9,12,57,48,9,54
Clyde,3108,5,15,9,12,54,48,6,54
Elgin,3108,6,15,6,15,56,62,-6,51
Annan Athlet,3108,7,11,12,13,47,41,6,45
Berwick,3108,8,8,10,18,29,61,-32,34
Edinburgh Ci,3108,9,7,9,20,36,63,-27,30
Cowdenbeath,3108,10,4,11,21,23,54,-31,23
Montrose,3109,1,24,7,5,61,35,26,79
Peterhead,3109,2,24,4,8,78,38,40,76
Stirling,3109,3,17,6,13,66,54,12,57
Stenhousem'r,3109,4,15,8,13,58,52,6,53
Clyde,3109,5,14,10,12,52,49,3,52
Elgin,3109,6,14,6,16,54,62,-8,48
Annan Athlet,3109,7,11,12,13,48,42,6,45
Berwick,3109,8,8,11,17,30,59,-29,35
Edinburgh Ci,3109,9,7,9,20,36,61,-25,30
Cowdenbeath,3109,10,4,11,21,24,55,-31,23
Montrose,3110,1,24,7,5,61,35,26,79
Peterhead,3110,2,24,4,8,80,38,42,76
Stenhousem'r,3110,3,16,8,12,57,47,10,56
Stirling,3110,4,16,6,14,61,53,8,54
Clyde,3110,5,14,10,12,52,49,3,52
Elgin,3110,6,14,6,16,54,62,-8,48
Annan Athlet,3110,7,11,11,14,47,42,5,44
Berwick,3110,8,8,11,17,30,59,-29,35
Edinburgh Ci,3110,9,7,9,20,36,63,-27,30
Cowdenbeath,3110,10,5,10,21,24,54,-30,25
Montrose,3111,1,23,8,5,59,34,25,77
Peterhead,3111,2,24,4,8,79,38,41,76
Stirling,3111,3,16,7,13,61,52,9,55
Stenhousem'r,3111,4,15,9,12,56,47,9,54
Clyde,3111,5,15,9,12,56,49,7,54
Elgin,3111,6,14,7,15,53,60,-7,49
Annan Athlet,3111,7,11,12,13,49,43,6,45
Berwick,3111,8,8,10,18,30,63,-33,34
Edinburgh Ci,3111,9,7,9,20,36,62,-26,30
Cowdenbeath,3111,10,4,11,21,25,56,-31,23
Montrose,3112,1,24,7,5,60,34,26,79
Peterhead,3112,2,24,4,8,81,38,43,76
Stirling,3112,3,17,6,13,63,52,11,57
Clyde,3112,4,15,9,12,53,49,4,54
Stenhousem'r,3112,5,15,8,13,56,49,7,53
Elgin,3112,6,14,6,16,53,61,-8,48
Annan Athlet,3112,7,12,11,13,49,41,8,47
Berwick,3112,8,8,10,18,30,60,-30,34
Edinburgh Ci,3112,9,7,9,20,36,64,-28,30
Cowdenbeath,3112,10,4,10,22,23,56,-33,22
Montrose,3113,1,24,7,5,61,34,27,79
Peterhead,3113,2,24,4,8,80,38,42,76
Stirling,3113,3,17,6,13,62,51,11,57
Clyde,3113,4,15,9,12,52,48,4,54
Stenhousem'r,3113,5,15,8,13,55,48,7,53
Elgin,3113,6,14,6,16,53,62,-9,48
Annan Athlet,3113,7,11,11,14,47,42,5,44
Berwick,3113,8,8,10,18,29,59,-30,34
Edinburgh Ci,3113,9,7,9,20,36,63,-27,30
Cowdenbeath,3113,10,5,10,21,24,54,-30,25
Montrose,3114,1,24,7,5,63,35,28,79
Peterhead,3114,2,23,5,8,78,39,39,74
Stenhousem'r,3114,3,16,8,12,56,46,10,56
Stirling,3114,4,16,6,14,60,52,8,54
Clyde,3114,5,14,9,13,51,49,2,51
Elgin,3114,6,14,6,16,54,64,-10,48
Annan Athlet,3114,7,12,11,13,51,42,9,47
Berwick,3114,8,9,10,17,30,58,-28,37
Edinburgh Ci,3114,9,7,10,19,37,61,-24,31
Cowdenbeath,3114,10,4,10,22,24,58,-34,22
Montrose,3115,1,24,7,5,62,36,26,79
Peterhead,3115,2,24,4,8,78,38,40,76
Stirling,3115,3,17,6,13,63,51,12,57
Clyde,3115,4,15,9,12,53,48,5,54
Stenhousem'r,3115,5,15,8,13,55,49,6,53
Elgin,3115,6,14,6,16,55,63,-8,48
Annan Athlet,3115,7,11,12,13,48,42,6,45
Berwick,3115,8,8,10,18,29,60,-31,34
Edinburgh Ci,3115,9,7,9,20,36,61,-25,30
Cowdenbeath,3115,10,4,11,21,24,55,-31,23
Peterhead,3116,1,24,4,8,80,39,41,76
Montrose,3116,2,23,7,6,59,35,24,76
Stirling,3116,3,16,7,13,60,51,9,55
Stenhousem'r,3116,4,15,9,12,55,46,9,54
Clyde,3116,5,15,9,12,57,49,8,54
Elgin,3116,6,15,6,15,54,60,-6,51
Annan Athlet,3116,7,11,12,13,49,43,6,45
Berwick,3116,8,8,10,18,30,64,-34,34
Edinburgh Ci,3116,9,7,9,20,37,63,-26,30
Cowdenbeath,3116,10,4,11,21,25,56,-31,23
Montrose,3117,1,23,8,5,60,35,25,77
Peterhead,3117,2,24,4,8,78,38,40,76
Stirling,3117,3,17,6,13,61,51,10,57
Stenhousem'r,3117,4,15,8,13,55,47,8,53
Clyde,3117,5,14,9,13,51,52,-1,51
Elgin,3117,6,14,7,15,54,61,-7,49
Annan Athlet,3117,7,11,11,14,47,42,5,44
Berwick,3117,8,9,10,17,33,58,-25,37
Edinburgh Ci,3117,9,7,9,20,36,61,-25,30
Cowdenbeath,3117,10,5,10,21,24,54,-30,25
Montrose,3118,1,23,8,5,59,34,25,77
Peterhead,3118,2,24,4,8,80,39,41,76
Stirling,3118,3,16,7,13,61,52,9,55
Stenhousem'r,3118,4,15,9,12,56,47,9,54
Clyde,3118,5,15,9,12,53,49,4,54
Elgin,3118,6,14,7,15,53,60,-7,49
Annan Athlet,3118,7,11,12,13,49,43,6,45
Berwick,3118,8,8,10,18,30,60,-30,34
Edinburgh Ci,3118,9,7,9,20,37,63,-26,30
Cowdenbeath,3118,10,4,11,21,25,56,-31,23
Peterhead,3119,1,24,4,8,81,39,42,76
Montrose,3119,2,23,7,6,60,36,24,76
Stirling,3119,3,17,6,13,63,53,10,57
Stenhousem'r,3119,4,15,8,13,57,49,8,53
Clyde,3119,5,14,9,13,52,50,2,51
Elgin,3119,6,15,6,15,55,61,-6,51
Annan Athlet,3119,7,12,11,13,48,41,7,47
Berwick,3119,8,9,10,17,31,59,-28,37
Edinburgh Ci,3119,9,7,9,20,37,64,-27,30
Cowdenbeath,3119,10,4,10,22,23,55,-32,22
Montrose,3120,1,23,8,5,60,35,25,77
Peterhead,3120,2,23,5,8,79,40,39,74
Stirling,3120,3,17,6,13,63,53,10,57
Clyde,3120,4,15,9,12,53,49,4,54
Stenhousem'r,3120,5,15,8,13,57,49,8,53
Elgin,3120,6,14,7,15,54,61,-7,49
Annan Athlet,3120,7,12,11,13,49,42,7,47
Berwick,3120,8,8,10,18,30,60,-30,34
Edinburgh Ci,3120,9,7,10,19,38,62,-24,31
Cowdenbeath,3120,10,4,10,22,24,56,-32,22
Montrose,3121,1,24,7,5,61,35,26,79
Peterhead,3121,2,24,4,8,78,38,40,76
Stirling,3121,3,16,7,13,62,53,9,55
Stenhousem'r,3121,4,15,9,12,57,48,9,54
Clyde,3121,5,14,9,13,52,52,0,51
Elgin,3121,6,14,6,16,54,62,-8,48
Annan Athlet,3121,7,11,11,14,47,42,5,44
Berwick,3121,8,9,10,17,33,59,-26,37
Edinburgh Ci,3121,9,7,9,20,36,61,-25,30
Cowdenbeath,3121,10,5,10,21,24,54,-30,25
Montrose,3122,1,24,7,5,61,35,26,79
Peterhead,3122,2,24,4,8,78,38,40,76
Stenhousem'r,3122,3,16,8,12,57,46,11,56
Stirling,3122,4,16,6,14,60,53,7,54
Clyde,3122,5,14,10,12,52,49,3,52
Elgin,3122,6,14,6,16,54,62,-8,48
Annan Athlet,3122,7,11,12,13,47,41,6,45
Berwick,3122,8,8,11,17,30,59,-29,35
Edinburgh Ci,3122,9,7,9,20,36,61,-25,30
Cowdenbeath,3122,10,4,11,21,23,54,-31,23
Montrose,3123,1,24,7,5,61,35,26,79
Peterhead,3123,2,24,4,8,80,39,41,76
Stirling,3123,3,16,7,13,61,52,9,55
Stenhousem'r,3123,4,15,9,12,56,47,9,54
Clyde,3123,5,15,9,12,54,50,4,54
Elgin,3123,6,14,6,16,54,62,-8,48
Annan Athlet,3123,7,11,12,13,48,42,6,45
Berwick,3123,8,8,10,18,31,61,-30,34
Edinburgh Ci,3123,9,7,9,20,37,63,-26,30
Cowdenbeath,3123,10,4,11,21,24,55,-31,23
Montrose,3124,1,24,7,5,62,35,27,79
Peterhead,3124,2,24,4,8,79,38,41,76
Stirling,3124,3,16,7,13,61,52,9,55
Stenhousem'r,3124,4,15,9,12,56,47,9,54
Clyde,3124,5,14,9,13,51,49,2,51
Elgin,3124,6,14,6,16,54,63,-9,48
Annan Athlet,3124,7,11,11,14,47,46,1,44
Berwick,3124,8,9,10,17,30,58,-28,37
Edinburgh Ci,3124,9,7,9,20,36,62,-26,30
Cowdenbeath,3124,10,5,10,21,28,54,-26,25
Montrose,3125,1,24,7,5,60,34,26,79
Peterhead,3125,2,24,4,8,80,39,41,76
Stirling,3125,3,17,6,13,63,51,12,57
Stenhousem'r,3125,4,15,8,13,55,49,6,53
Clyde,3125,5,14,9,13,52,50,2,51
Elgin,3125,6,14,6,16,53,61,-8,48
Annan Athlet,3125,7,12,11,13,48,41,7,47
Berwick,3125,8,9,10,17,31,59,-28,37
Edinburgh Ci,3125,9,7,9,20,37,63,-26,30
Cowdenbeath,3125,10,4,10,22,23,55,-32,22
Montrose,3126,1,23,8,5,60,35,25,77
Peterhead,3126,2,23,4,9,77,39,38,73
Stirling,3126,3,16,7,13,63,54,9,55
Stenhousem'r,3126,4,15,9,12,58,49,9,54
Clyde,3126,5,14,9,13,52,50,2,51
Elgin,3126,6,14,7,15,54,61,-7,49
Annan Athlet,3126,7,12,11,13,49,42,7,47
Berwick,3126,8,9,10,17,31,59,-28,37
Edinburgh Ci,3126,9,8,9,19,37,60,-23,33
Cowdenbeath,3126,10,4,10,22,24,56,-32,22
Peterhead,3127,1,24,4,8,80,38,42,76
Montrose,3127,2,23,7,6,59,36,23,76
Stirling,3127,3,17,6,13,62,51,11,57
Stenhousem'r,3127,4,15,8,13,55,48,7,53
Clyde,3127,5,14,10,12,52,49,3,52
Elgin,3127,6,15,6,15,55,60,-5,51
Annan Athlet,3127,7,12,11,13,49,41,8,47
Berwick,3127,8,8,11,17,30,59,-29,35
Edinburgh Ci,3127,9,7,9,20,36,63,-27,30
Cowdenbeath,3127,10,4,10,22,23,56,-33,22
Peterhead,3128,1,24,4,8,80,38,42,76
Montrose,3128,2,23,7,6,59,37,22,76
Stirling,3128,3,17,6,13,63,52,11,57
Clyde,3128,4,15,9,12,53,49,4,54
Stenhousem'r,3128,5,15,8,13,56,49,7,53
Elgin,3128,6,15,6,15,56,60,-4,51
Annan Athlet,3128,7,12,11,13,50,41,9,47
Berwick,3128,8,8,10,18,30,60,-30,34
Edinburgh Ci,3128,9,7,9,20,36,63,-27,30
Cowdenbeath,3128,10,4,10,22,23,57,-34,22
Montrose,3129,1,24,7,5,62,35,27,79
Peterhead,3129,2,24,4,8,80,39,41,76
Stirling,3129,3,16,7,13,62,53,9,55
Stenhousem'r,3129,4,15,9,12,57,48,9,54
Clyde,3129,5,15,9,12,56,51,5,54
Elgin,3129,6,14,6,16,54,63,-9,48
Annan Athlet,3129,7,12,11,13,50,43,7,47
Berwick,3129,8,8,10,18,32,63,-31,34
Edinburgh Ci,3129,9,7,9,20,37,63,-26,30
Cowdenbeath,3129,10,4,10,22,25,57,-32,22
Montrose,3130,1,23,8,5,61,36,25,77
Peterhead,3130,2,23,5,8,78,39,39,74
Stirling,3130,3,16,7,13,61,52,9,55
Stenhousem'r,3130,4,15,9,12,56,47,9,54
Clyde,3130,5,14,9,13,51,49,2,51
Elgin,3130,6,14,7,15,55,62,-7,49
Annan Athlet,3130,7,12,11,13,51,41,10,47
Berwick,3130,8,9,10,17,30,58,-28,37
Edinburgh Ci,3130,9,7,10,19,37,61,-24,31
Cowdenbeath,3130,10,4,10,22,23,58,-35,22
Montrose,3131,1,24,7,5,61,35,26,79
Peterhead,3131,2,24,4,8,82,38,44,76
Stenhousem'r,3131,3,16,8,12,57,47,10,56
Stirling,3131,4,16,6,14,61,53,8,54
Clyde,3131,5,15,9,12,55,48,7,54
Elgin,3131,6,14,6,16,54,62,-8,48
Annan Athlet,3131,7,11,12,13,49,43,6,45
Berwick,3131,8,8,10,18,29,62,-33,34
Edinburgh Ci,3131,9,7,9,20,36,65,-29,30
Cowdenbeath,3131,10,4,11,21,25,56,-31,23
Montrose,3132,1,23,8,5,61,36,25,77
Peterhead,3132,2,23,5,8,77,38,39,74
Stirling,3132,3,17,6,13,64,51,13,57
Clyde,3132,4,15,9,12,52,48,4,54
Stenhousem'r,3132,5,15,8,13,55,50,5,53
Elgin,3132,6,14,7,15,55,62,-7,49
Annan Athlet,3132,7,11,11,14,48,43,5,44
Berwick,3132,8,8,10,18,29,59,-30,34
Edinburgh Ci,3132,9,7,10,19,36,60,-24,31
Cowdenbeath,3132,10,5,10,21,25,55,-30,25
Montrose,3133,1,24,7,5,63,35,28,79
Peterhead,3133,2,24,4,8,79,39,40,76
Stenhousem'r,3133,3,16,8,12,58,47,11,56
Stirling,3133,4,16,6,14,61,54,7,54
Clyde,3133,5,14,9,13,51,50,1,51
Elgin,3133,6,14,6,16,54,64,-10,48
Annan Athlet,3133,7,11,11,14,47,42,5,44
Berwick,3133,8,9,10,17,31,58,-27,37
Edinburgh Ci,3133,9,7,9,20,37,62,-25,30
Cowdenbeath,3133,10,5,10,21,24,54,-30,25
Montrose,3134,1,23,8,5,60,35,25,77
Peterhead,3134,2,23,4,9,79,41,38,73
Stirling,3134,3,17,6,13,63,51,12,57
Clyde,3134,4,15,9,12,54,50,4,54
Stenhousem'r,3134,5,15,8,13,55,49,6,53
Elgin,3134,6,14,7,15,54,61,-7,49
Annan Athlet,3134,7,11,11,14,47,43,4,44
Berwick,3134,8,8,10,18,31,61,-30,34
Edinburgh Ci,3134,9,8,9,19,39,62,-23,33
Cowdenbeath,3134,10,5,10,21,25,54,-29,25
Montrose,3135,1,24,7,5,61,34,27,79
Peterhead,3135,2,24,4,8,82,40,42,76
Stirling,3135,3,17,6,13,62,51,11,57
Clyde,3135,4,15,9,12,52,48,4,54
Stenhousem'r,3135,5,15,8,13,55,48,7,53
Elgin,3135,6,14,6,16,53,62,-9,48
Annan Athlet,3135,7,12,11,13,48,41,7,47
Berwick,3135,8,8,10,18,29,59,-30,34
Edinburgh Ci,3135,9,7,9,20,38,65,-27,30
Cowdenbeath,3135,10,4,10,22,23,55,-32,22
Montrose,3136,1,24,7,5,61,35,26,79
Peterhead,3136,2,24,4,8,78,38,40,76
Stirling,3136,3,17,6,13,61,51,10,57
Clyde,3136,4,15,9,12,54,49,5,54
Stenhousem'r,3136,5,15,8,13,55,47,8,53
Elgin,3136,6,14,6,16,54,62,-8,48
Annan Athlet,3136,7,11,11,14,48,44,4,44
Berwick,3136,8,8,10,18,30,61,-31,34
Edinburgh Ci,3136,9,7,9,20,36,61,-25,30
Cowdenbeath,3136,10,5,10,21,26,55,-29,25
Montrose,3137,1,24,7,5,60,34,26,79
Peterhead,3137,2,24,4,8,80,40,40,76
Stenhousem'r,3137,3,16,8,12,56,46,10,56
Stirling,3137,4,16,6,14,60,52,8,54
Clyde,3137,5,14,10,12,51,48,3,52
Elgin,3137,6,14,6,16,53,61,-8,48
Annan Athlet,3137,7,11,11,14,47,42,5,44
Berwick,3137,8,8,11,17,29,58,-29,35
Edinburgh Ci,3137,9,7,9,20,38,63,-25,30
Cowdenbeath,3137,10,5,10,21,24,54,-30,25
Montrose,3138,1,24,7,5,68,35,33,79
Peterhead,3138,2,24,4,8,78,38,40,76
Stenhousem'r,3138,3,16,8,12,59,47,12,56
Stirling,3138,4,16,6,14,61,55,6,54
Clyde,3138,5,14,10,12,52,49,3,52
Elgin,3138,6,14,6,16,54,69,-15,48
Annan Athlet,3138,7,11,11,14,47,43,4,44
Berwick,3138,8,8,11,17,30,59,-29,35
Edinburgh Ci,3138,9,7,9,20,36,61,-25,30
Cowdenbeath,3138,10,5,10,21,25,54,-29,25
Peterhead,3139,1,24,4,8,78,38,40,76
Montrose,3139,2,23,7,6,59,35,24,76
Stirling,3139,3,17,6,13,63,51,12,57
Clyde,3139,4,15,9,12,54,49,5,54
Stenhousem'r,3139,5,15,8,13,55,49,6,53
Elgin,3139,6,15,6,15,54,60,-6,51
Annan Athlet,3139,7,12,11,13,48,41,7,47
Berwick,3139,8,8,10,18,30,61,-31,34
Edinburgh Ci,3139,9,7,9,20,36,61,-25,30
Cowdenbeath,3139,10,4,10,22,23,55,-32,22
Montrose,3140,1,24,7,5,64,34,30,79
Peterhead,3140,2,24,4,8,79,39,40,76
Stirling,3140,3,17,6,13,62,51,11,57
Clyde,3140,4,15,9,12,54,50,4,54
Stenhousem'r,3140,5,15,8,13,55,48,7,53
Elgin,3140,6,14,6,16,53,65,-12,48
Annan Athlet,3140,7,11,11,14,48,43,5,44
Berwick,3140,8,8,10,18,31,61,-30,34
Edinburgh Ci,3140,9,7,9,20,37,62,-25,30
Cowdenbeath,3140,10,5,10,21,25,55,-30,25
Peterhead,3141,1,24,4,8,82,38,44,76
Montrose,3141,2,23,7,6,60,36,24,76
Stirling,3141,3,17,6,13,63,52,11,57
Clyde,3141,4,15,9,12,52,48,4,54
Stenhousem'r,3141,5,15,8,13,56,49,7,53
Elgin,3141,6,15,6,15,55,61,-6,51
Annan Athlet,3141,7,11,12,13,47,41,6,45
Berwick,3141,8,8,10,18,29,59,-30,34
Edinburgh Ci,3141,9,7,9,20,36,65,-29,30
Cowdenbeath,3141,10,4,11,21,23,54,-31,23
Montrose,3142,1,24,7,5,64,34,30,79
Peterhead,3142,2,24,4,8,81,39,42,76
Stirling,3142,3,17,6,13,62,51,11,57
Clyde,3142,4,15,9,12,54,49,5,54
Stenhousem'r,3142,5,15,8,13,55,48,7,53
Elgin,3142,6,14,6,16,53,65,-12,48
Annan Athlet,3142,7,11,11,14,47,44,3,44
Berwick,3142,8,8,10,18,30,61,-31,34
Edinburgh Ci,3142,9,7,9,20,37,64,-27,30
Cowdenbeath,3142,10,5,10,21,26,54,-28,25
Montrose,3143,1,23,8,5,59,34,25,77
Peterhead,3143,2,23,4,9,78,40,38,73
Stenhousem'r,3143,3,16,8,12,58,48,10,56
Stirling,3143,4,16,6,14,62,54,8,54
Clyde,3143,5,14,9,13,52,51,1,51
Elgin,3143,6,14,7,15,53,60,-7,49
Annan Athlet,3143,7,11,12,13,48,42,6,45
Berwick,3143,8,9,10,17,32,59,-27,37
Edinburgh Ci,3143,9,8,9,19,38,61,-23,33
Cowdenbeath,3143,10,4,11,21,24,55,-31,23
Montrose,3144,1,24,7,5,63,35,28,79
Peterhead,3144,2,24,4,8,81,38,43,76
Stirling,3144,3,17,6,13,63,51,12,57
Stenhousem'r,3144,4,15,8,13,55,49,6,53
Clyde,3144,5,14,9,13,51,49,2,51
Elgin,3144,6,14,6,16,54,64,-10,48
Annan Athlet,3144,7,12,11,13,49,42,7,47
Berwick,3144,8,9,10,17,30,58,-28,37
Edinburgh Ci,3144,9,7,9,20,36,64,-28,30
Cowdenbeath,3144,10,4,10,22,24,56,-32,22
Montrose,3145,1,24,7,5,62,34,28,79
Peterhead,3145,2,24,4,8,81,38,43,76
Stirling,3145,3,17,6,13,62,52,10,57
Clyde,3145,4,15,9,12,53,48,5,54
Stenhousem'r,3145,5,15,8,13,56,48,8,53
Elgin,3145,6,14,6,16,53,63,-10,48
Annan Athlet,3145,7,11,11,14,47,42,5,44
Berwick,3145,8,8,10,18,29,60,-31,34
Edinburgh Ci,3145,9,7,9,20,36,64,-28,30
Cowdenbeath,3145,10,5,10,21,24,54,-30,25
Montrose,3146,1,24,7,5,61,35,26,79
Peterhead,3146,2,23,4,9,78,41,37,73
Stenhousem'r,3146,3,16,8,12,56,46,10,56
Stirling,3146,4,16,6,14,60,52,8,54
Clyde,3146,5,15,9,12,53,49,4,54
Elgin,3146,6,14,6,16,54,62,-8,48
Annan Athlet,3146,7,11,11,14,47,43,4,44
Berwick,3146,8,8,10,18,30,60,-30,34
Edinburgh Ci,3146,9,8,9,19,39,61,-22,33
Cowdenbeath,3146,10,5,10,21,25,54,-29,25
Montrose,3147,1,24,7,5,62,35,27,79
Peterhead,3147,2,24,4,8,83,38,45,76
Stirling,3147,3,17,6,13,63,53,10,57
Clyde,3147,4,15,9,12,54,49,5,54
Stenhousem'r,3147,5,15,8,13,57,49,8,53
Elgin,3147,6,14,6,16,54,63,-9,48
Annan Athlet,3147,7,11,12,13,47,41,6,45
Berwick,3147,8,8,10,18,30,61,-31,34
Edinburgh Ci,3147,9,7,9,20,36,66,-30,30
Cowdenbeath,3147,10,4,11,21,23,54,-31,23
Montrose,3148,1,23,8,5,59,34,25,77
Peterhead,3148,2,24,4,8,80,39,41,76
Stirling,3148,3,16,7,13,62,53,9,55
Stenhousem'r,3148,4,15,9,12,57,48,9,54
Clyde,3148,5,14,10,12,52,49,3,52
Elgin,3148,6,14,7,15,53,60,-7,49
Annan Athlet,3148,7,11,11,14,48,44,4,44
Berwick,3148,8,8,11,17,30,59,-29,35
Edinburgh Ci,3148,9,7,9,20,37,63,-26,30
Cowdenbeath,3148,10,5,10,21,26,55,-29,25
Montrose,3149,1,24,7,5,62,35,27,79
Peterhead,3149,2,23,4,9,78,41,37,73
Stenhousem'r,3149,3,16,8,12,57,47,10,56
Stirling,3149,4,16,6,14,61,53,8,54
Clyde,3149,5,15,9,12,56,49,7,54
Elgin,3149,6,14,6,16,54,63,-9,48
Annan Athlet,3149,7,11,12,13,48,42,6,45
Berwick,3149,8,8,10,18,30,63,-33,34
Edinburgh Ci,3149,9,8,9,19,39,61,-22,33
Cowdenbeath,3149,10,4,11,21,24,55,-31,23
Montrose,3150,1,24,7,5,62,35,27,79
Peterhead,3150,2,24,4,8,81,38,43,76
Stenhousem'r,3150,3,16,8,12,57,46,11,56
Stirling,3150,4,16,6,14,60,53,7,54
Clyde,3150,5,14,9,13,53,51,2,51
Elgin,3150,6,14,6,16,54,63,-9,48
Annan Athlet,3150,7,12,11,13,50,42,8,47
Berwick,3150,8,9,10,17,32,60,-28,37
Edinburgh Ci,3150,9,7,9,20,36,64,-28,30
Cowdenbeath,3150,10,4,10,22,24,57,-33,22
Peterhead,3151,1,24,4,8,84,39,45,76
Montrose,3151,2,23,7,6,59,36,23,76
Stirling,3151,3,16,7,13,60,51,9,55
Stenhousem'r,3151,4,15,9,12,55,46,9,54
Clyde,3151,5,15,9,12,54,48,6,54
Elgin,3151,6,15,6,15,55,60,-5,51
Annan Athlet,3151,7,11,12,13,49,43,6,45
Berwick,3151,8,8,10,18,29,61,-32,34
Edinburgh Ci,3151,9,7,9,20,37,67,-30,30
Cowdenbeath,3151,10,4,11,21,25,56,-31,23
Peterhead,3152,1,24,4,8,83,39,44,76
Montrose,3152,2,23,7,6,59,36,23,76
Stenhousem'r,3152,3,16,8,12,56,46,10,56
Stirling,3152,4,16,6,14,60,52,8,54
Clyde,3152,5,14,10,12,53,50,3,52
Elgin,3152,6,15,6,15,55,60,-5,51
Annan Athlet,3152,7,11,12,13,49,43,6,45
Berwick,3152,8,8,11,17,31,60,-29,35
Edinburgh Ci,3152,9,7,9,20,37,66,-29,30
Cowdenbeath,3152,10,4,11,21,25,56,-31,23
Peterhead,3153,1,24,4,8,80,40,40,76
Montrose,3153,2,23,7,6,59,36,23,76
Stirling,3153,3,16,7,13,60,51,9,55
Stenhousem'r,3153,4,15,9,12,55,46,9,54
Clyde,3153,5,15,9,12,55,49,6,54
Elgin,3153,6,15,6,15,55,60,-5,51
Annan Athlet,3153,7,11,11,14,47,42,5,44
Berwick,3153,8,8,10,18,30,62,-32,34
Edinburgh Ci,3153,9,7,9,20,38,63,-25,30
Cowdenbeath,3153,10,5,10,21,24,54,-30,25
Montrose,3154,1,23,8,5,61,36,25,77
Peterhead,3154,2,24,4,8,82,39,43,76
Stirling,3154,3,17,6,13,62,52,10,57
Clyde,3154,4,15,9,12,53,48,5,54
Stenhousem'r,3154,5,15,8,13,56,48,8,53
Elgin,3154,6,14,7,15,55,62,-7,49
Annan Athlet,3154,7,11,12,13,47,41,6,45
Berwick,3154,8,8,10,18,29,60,-31,34
Edinburgh Ci,3154,9,7,9,20,37,65,-28,30
Cowdenbeath,3154,10,4,11,21,23,54,-31,23
Montrose,3155,1,24,7,5,62,34,28,79
Peterhead,3155,2,24,4,8,79,39,40,76
Stirling,3155,3,17,6,13,63,53,10,57
Clyde,3155,4,15,9,12,54,48,6,54
Stenhousem'r,3155,5,15,8,13,57,49,8,53
Elgin,3155,6,14,6,16,53,63,-10,48
Annan Athlet,3155,7,11,11,14,47,43,4,44
Berwick,3155,8,8,10,18,29,61,-32,34
Edinburgh Ci,3155,9,7,9,20,37,62,-25,30
Cowdenbeath,3155,10,5,10,21,25,54,-29,25
Montrose,3156,1,24,7,5,62,35,27,79
Peterhead,3156,2,24,4,8,83,40,43,76
Stirling,3156,3,17,6,13,64,53,11,57
Clyde,3156,4,15,9,12,52,48,4,54
Stenhousem'r,3156,5,15,8,13,57,50,7,53
Elgin,3156,6,14,6,16,54,63,-9,48
Annan Athlet,3156,7,12,11,13,48,41,7,47
Berwick,3156,8,8,10,18,29,59,-30,34
Edinburgh Ci,3156,9,7,9,20,38,66,-28,30
Cowdenbeath,3156,10,4,10,22,23,55,-32,22
Montrose,3157,1,24,7,5,63,37,26,79
Peterhead,3157,2,24,4,8,80,39,41,76
Stirling,3157,3,17,6,13,61,51,10,57
Clyde,3157,4,15,9,12,53,48,5,54
Stenhousem'r,3157,5,15,8,13,55,47,8,53
Elgin,3157,6,14,6,16,56,64,-8,48
Annan Athlet,3157,7,11,11,14,47,43,4,44
Berwick,3157,8,8,10,18,29,60,-31,34
Edinburgh Ci,3157,9,7,9,20,37,63,-26,30
Cowdenbeath,3157,10,5,10,21,25,54,-29,25
Montrose,3158,1,24,7,5,60,34,26,79
Peterhead,3158,2,24,4,8,80,40,40,76
Stirling,3158,3,17,6,13,67,52,15,57
Stenhousem'r,3158,4,15,8,13,56,53,3,53
Clyde,3158,5,14,10,12,52,49,3,52
Elgin,3158,6,14,6,16,53,61,-8,48
Annan Athlet,3158,7,12,11,13,48,41,7,47
Berwick,3158,8,8,11,17,30,59,-29,35
Edinburgh Ci,3158,9,7,9,20,38,63,-25,30
Cowdenbeath,3158,10,4,10,22,23,55,-32,22
Montrose,3159,1,24,7,5,60,34,26,79
Peterhead,3159,2,24,4,8,80,39,41,76
Stirling,3159,3,17,6,13,63,51,12,57
Stenhousem'r,3159,4,15,8,13,55,49,6,53
Clyde,3159,5,14,9,13,51,49,2,51
Elgin,3159,6,14,6,16,53,61,-8,48
Annan Athlet,3159,7,12,11,13,49,42,7,47
Berwick,3159,8,9,10,17,30,58,-28,37
Edinburgh Ci,3159,9,7,9,20,37,63,-26,30
Cowdenbeath,3159,10,4,10,22,24,56,-32,22
Montrose,3160,1,23,7,6,60,36,24,76
Peterhead,3160,2,23,5,8,79,40,39,74
Stenhousem'r,3160,3,16,8,12,58,47,11,56
Stirling,3160,4,16,6,14,61,54,7,54
Clyde,3160,5,15,9,12,52,48,4,54
Elgin,3160,6,15,6,15,55,61,-6,51
Annan Athlet,3160,7,11,12,13,47,41,6,45
Berwick,3160,8,8,10,18,29,59,-30,34
Edinburgh Ci,3160,9,7,10,19,38,62,-24,31
Cowdenbeath,3160,10,4,11,21,23,54,-31,23
Montrose,3161,1,24,7,5,62,34,28,79
Peterhead,3161,2,24,4,8,78,38,40,76
Stenhousem'r,3161,3,16,8,12,58,48,10,56
Stirling,3161,4,16,6,14,62,54,8,54
Clyde,3161,5,15,9,12,54,49,5,54
Elgin,3161,6,14,6,16,53,63,-10,48
Annan Athlet,3161,7,11,12,13,47,41,6,45
Berwick,3161,8,8,10,18,30,61,-31,34
Edinburgh Ci,3161,9,7,9,20,36,61,-25,30
Cowdenbeath,3161,10,4,11,21,23,54,-31,23
Montrose,3162,1,23,8,5,61,36,25,77
Peterhead,3162,2,23,4,9,78,40,38,73
Stenhousem'r,3162,3,16,8,12,59,47,12,56
Stirling,3162,4,16,6,14,61,55,6,54
Clyde,3162,5,14,10,12,53,50,3,52
Elgin,3162,6,14,7,15,55,62,-7,49
Annan Athlet,3162,7,11,11,14,48,43,5,44
Berwick,3162,8,8,11,17,31,60,-29,35
Edinburgh Ci,3162,9,8,9,19,38,61,-23,33
Cowdenbeath,3162,10,5,10,21,25,55,-30,25
Montrose,3163,1,23,8,5,60,35,25,77
Peterhead,3163,2,24,4,8,81,39,42,76
Stenhousem'r,3163,3,16,8,12,58,48,10,56
Stirling,3163,4,16,6,14,62,54,8,54
Clyde,3163,5,14,10,12,52,49,3,52
Elgin,3163,6,14,7,15,54,61,-7,49
Annan Athlet,3163,7,12,11,13,50,41,9,47
Berwick,3163,8,8,11,17,30,59,-29,35
Edinburgh Ci,3163,9,7,9,20,37,64,-27,30
Cowdenbeath,3163,10,4,10,22,23,57,-34,22
Montrose,3164,1,24,7,5,63,35,28,79
Peterhead,3164,2,24,4,8,80,38,42,76
Stirling,3164,3,17,6,13,63,51,12,57
Stenhousem'r,3164,4,15,8,13,55,49,6,53
Clyde,3164,5,14,10,12,52,49,3,52
Elgin,3164,6,14,6,16,54,64,-10,48
Annan Athlet,3164,7,11,12,13,48,42,6,45
Berwick,3164,8,8,11,17,30,59,-29,35
Edinburgh Ci,3164,9,7,9,20,36,63,-27,30
Cowdenbeath,3164,10,4,11,21,24,55,-31,23
Montrose,3165,1,24,7,5,61,35,26,79
Peterhead,3165,2,24,4,8,79,39,40,76
Stirling,3165,3,17,6,13,63,52,11,57
Clyde,3165,4,15,9,12,59,50,9,54
Stenhousem'r,3165,5,15,8,13,56,49,7,53
Elgin,3165,6,14,6,16,54,62,-8,48
Annan Athlet,3165,7,11,11,14,48,43,5,44
Berwick,3165,8,8,10,18,31,66,-35,34
Edinburgh Ci,3165,9,7,9,20,37,62,-25,30
Cowdenbeath,3165,10,5,10,21,25,55,-30,25
Montrose,3166,1,23,8,5,59,34,25,77
Peterhead,3166,2,24,4,8,78,38,40,76
Stirling,3166,3,17,6,13,62,52,10,57
Clyde,3166,4,15,9,12,53,48,5,54
Stenhousem'r,3166,5,15,8,13,56,48,8,53
Elgin,3166,6,14,7,15,53,60,-7,49
Annan Athlet,3166,7,12,11,13,49,41,8,47
Berwick,3166,8,8,10,18,29,60,-31,34
Edinburgh Ci,3166,9,7,9,20,36,61,-25,30
Cowdenbeath,3166,10,4,10,22,23,56,-33,22
Peterhead,3167,1,24,4,8,79,38,41,76
Montrose,3167,2,23,7,6,59,35,24,76
Stirling,3167,3,16,7,13,62,53,9,55
Stenhousem'r,3167,4,15,9,12,57,48,9,54
Clyde,3167,5,15,9,12,54,48,6,54
Elgin,3167,6,15,6,15,54,60,-6,51
Annan Athlet,3167,7,12,11,13,50,41,9,47
Berwick,3167,8,8,10,18,29,61,-32,34
Edinburgh Ci,3167,9,7,9,20,36,62,-26,30
Cowdenbeath,3167,10,4,10,22,23,57,-34,22
Montrose,3168,1,24,7,5,62,36,26,79
Peterhead,3168,2,24,4,8,80,38,42,76
Stirling,3168,3,17,6,13,61,51,10,57
Stenhousem'r,3168,4,15,8,13,55,47,8,53
Clyde,3168,5,14,10,12,51,48,3,52
Elgin,3168,6,14,6,16,55,63,-8,48
Annan Athlet,3168,7,11,11,14,48,44,4,44
Berwick,3168,8,8,11,17,29,58,-29,35
Edinburgh Ci,3168,9,7,9,20,36,63,-27,30
Cowdenbeath,3168,10,5,10,21,26,55,-29,25
Montrose,3169,1,24,7,5,62,35,27,79
Peterhead,3169,2,24,4,8,79,39,40,76
Stirling,3169,3,17,6,13,62,52,10,57
Stenhousem'r,3169,4,15,8,13,56,48,8,53
Clyde,3169,5,14,10,12,51,48,3,52
Elgin,3169,6,14,6,16,54,63,-9,48
Annan Athlet,3169,7,11,12,13,47,41,6,45
Berwick,3169,8,8,11,17,29,58,-29,35
Edinburgh Ci,3169,9,7,9,20,37,62,-25,30
Cowdenbeath,3169,10,4,11,21,23,54,-31,23
Montrose,3170,1,24,7,5,61,34,27,79
Peterhead,3170,2,24,4,8,81,38,43,76
Stirling,3170,3,16,7,13,61,52,9,55
Stenhousem'r,3170,4,15,9,12,56,47,9,54
Clyde,3170,5,15,9,12,53,49,4,54
Elgin,3170,6,14,6,16,53,62,-9,48
Annan Athlet,3170,7,12,11,13,49,41,8,47
Berwick,3170,8,8,10,18,30,60,-30,34
Edinburgh Ci,3170,9,7,9,20,36,64,-28,30
Cowdenbeath,3170,10,4,10,22,23,56,-33,22
Montrose,3171,1,24,7,5,61,34,27,79
Peterhead,3171,2,24,4,8,80,38,42,76
Stirling,3171,3,17,6,13,61,51,10,57
Stenhousem'r,3171,4,15,8,13,55,47,8,53
Clyde,3171,5,14,10,12,53,50,3,52
Elgin,3171,6,14,6,16,53,62,-9,48
Annan Athlet,3171,7,11,11,14,47,42,5,44
Berwick,3171,8,8,11,17,31,60,-29,35
Edinburgh Ci,3171,9,7,9,20,36,63,-27,30
Cowdenbeath,3171,10,5,10,21,24,54,-30,25
Montrose,3172,1,24,7,5,62,35,27,79
Peterhead,3172,2,24,4,8,79,38,41,76
Stirling,3172,3,17,6,13,64,52,12,57
Stenhousem'r,3172,4,15,8,13,56,50,6,53
Clyde,3172,5,14,10,12,52,49,3,52
Elgin,3172,6,14,6,16,54,63,-9,48
Annan Athlet,3172,7,11,11,14,47,44,3,44
Berwick,3172,8,8,11,17,30,59,-29,35
Edinburgh Ci,3172,9,7,9,20,36,62,-26,30
Cowdenbeath,3172,10,5,10,21,26,54,-28,25
Montrose,3173,1,24,7,5,61,34,27,79
Peterhead,3173,2,24,4,8,83,40,43,76
Stenhousem'r,3173,3,16,8,12,57,46,11,56
Stirling,3173,4,16,6,14,60,53,7,54
Clyde,3173,5,15,9,12,52,48,4,54
Elgin,3173,6,14,6,16,53,62,-9,48
Annan Athlet,3173,7,11,11,14,47,42,5,44
Berwick,3173,8,8,10,18,29,59,-30,34
Edinburgh Ci,3173,9,7,9,20,38,66,-28,30
Cowdenbeath,3173,10,5,10,21,24,54,-30,25
Montrose,3174,1,23,8,5,60,35,25,77
Peterhead,3174,2,24,4,8,84,40,44,76
Stirling,3174,3,16,7,13,61,52,9,55
Stenhousem'r,3174,4,15,9,12,56,47,9,54
Clyde,3174,5,14,9,13,52,51,1,51
Elgin,3174,6,14,7,15,54,61,-7,49
Annan Athlet,3174,7,12,11,13,50,41,9,47
Berwick,3174,8,9,10,17,32,59,-27,37
Edinburgh Ci,3174,9,7,9,20,38,67,-29,30
Cowdenbeath,3174,10,4,10,22,23,57,-34,22
Peterhead,3175,1,24,4,8,81,38,43,76
Montrose,3175,2,23,7,6,61,37,24,76
Stirling,3175,3,16,7,13,61,52,9,55
Stenhousem'r,3175,4,15,9,12,56,47,9,54
Clyde,3175,5,14,9,13,51,49,2,51
Elgin,3175,6,15,6,15,56,62,-6,51
Annan Athlet,3175,7,11,11,14,47,42,5,44
Berwick,3175,8,9,10,17,30,58,-28,37
Edinburgh Ci,3175,9,7,9,20,36,64,-28,30
Cowdenbeath,3175,10,5,10,21,24,54,-30,25
Montrose,3176,1,24,7,5,63,35,28,79
Peterhead,3176,2,23,5,8,78,39,39,74
Stenhousem'r,3176,3,16,8,12,56,46,10,56
Stirling,3176,4,16,6,14,60,52,8,54
Clyde,3176,5,15,9,12,52,48,4,54
Elgin,3176,6,14,6,16,54,64,-10,48
Annan Athlet,3176,7,11,12,13,47,41,6,45
Berwick,3176,8,8,10,18,29,59,-30,34
Edinburgh Ci,3176,9,7,10,19,37,61,-24,31
Cowdenbeath,3176,10,4,11,21,23,54,-31,23
Montrose,3177,1,23,8,5,59,34,25,77
Peterhead,3177,2,24,4,8,79,39,40,76
Stirling,3177,3,17,6,13,63,51,12,57
Clyde,3177,4,15,9,12,55,48,7,54
Stenhousem'r,3177,5,15,8,13,55,49,6,53
Elgin,3177,6,14,7,15,53,60,-7,49
Annan Athlet,3177,7,12,11,13,49,42,7,47
Berwick,3177,8,8,10,18,29,62,-33,34
Edinburgh Ci,3177,9,7,9,20,37,62,-25,30
Cowdenbeath,3177,10,4,10,22,24,56,-32,22
Peterhead,3178,1,24,4,8,79,38,41,76
Montrose,3178,2,23,7,6,60,36,24,76
Stirling,3178,3,17,6,13,61,51,10,57
Stenhousem'r,3178,4,15,8,13,55,47,8,53
Clyde,3178,5,14,10,12,53,50,3,52
Elgin,3178,6,15,6,15,55,61,-6,51
Annan Athlet,3178,7,11,12,13,47,41,6,45
Berwick,3178,8,8,11,17,31,60,-29,35
Edinburgh Ci,3178,9,7,9,20,36,62,-26,30
Cowdenbeath,3178,10,4,11,21,23,54,-31,23
Montrose,3179,1,24,7,5,62,35,27,79
Peterhead,3179,2,24,4,8,80,38,42,76
Stirling,3179,3,17,6,13,63,53,10,57
Clyde,3179,4,15,9,12,54,49,5,54
Stenhousem'r,3179,5,15,8,13,57,49,8,53
Elgin,3179,6,14,6,16,54,63,-9,48
Annan Athlet,3179,7,12,11,13,48,41,7,47
Berwick,3179,8,8,10,18,30,61,-31,34
Edinburgh Ci,3179,9,7,9,20,36,63,-27,30
Cowdenbeath,3179,10,4,10,22,23,55,-32,22
Montrose,3180,1,24,7,5,60,34,26,79
Peterhead,3180,2,24,4,8,78,38,40,76
Stirling,3180,3,17,6,13,63,52,11,57
Clyde,3180,4,15,9,12,54,48,6,54
Stenhousem'r,3180,5,15,8,13,56,49,7,53
Elgin,3180,6,14,6,16,53,61,-8,48
Annan Athlet,3180,7,12,11,13,48,41,7,47
Berwick,3180,8,8,10,18,29,61,-32,34
Edinburgh Ci,3180,9,7,9,20,36,61,-25,30
Cowdenbeath,3180,10,4,10,22,23,55,-32,22
Montrose,3181,1,23,8,5,60,35,25,77
Peterhead,3181,2,24,4,8,83,40,43,76
Stirling,3181,3,17,6,13,62,51,11,57
Clyde,3181,4,15,9,12,53,48,5,54
Stenhousem'r,3181,5,15,8,13,55,48,7,53
Elgin,3181,6,14,7,15,54,61,-7,49
Annan Athlet,3181,7,11,12,13,49,43,6,45
Berwick,3181,8,8,10,18,29,60,-31,34
Edinburgh Ci,3181,9,7,9,20,38,66,-28,30
Cowdenbeath,3181,10,4,11,21,25,56,-31,23
Montrose,3182,1,23,8,5,59,34,25,77
Peterhead,3182,2,24,4,8,79,38,41,76
Stirling,3182,3,16,7,13,62,53,9,55
Stenhousem'r,3182,4,15,9,12,57,48,9,54
Clyde,3182,5,15,9,12,56,49,7,54
Elgin,3182,6,14,7,15,53,60,-7,49
Annan Athlet,3182,7,12,11,13,49,41,8,47
Berwick,3182,8,8,10,18,30,63,-33,34
Edinburgh Ci,3182,9,7,9,20,36,62,-26,30
Cowdenbeath,3182,10,4,10,22,23,56,-33,22
Montrose,3183,1,24,7,5,61,35,26,79
Peterhead,3183,2,24,4,8,80,39,41,76
Stenhousem'r,3183,3,16,8,12,56,46,10,56
Stirling,3183,4,16,6,14,60,52,8,54
Clyde,3183,5,14,10,12,52,49,3,52
Elgin,3183,6,14,6,16,54,62,-8,48
Annan Athlet,3183,7,11,11,14,48,47,1,44
Berwick,3183,8,8,11,17,30,59,-29,35
Edinburgh Ci,3183,9,7,9,20,37,63,-26,30
Cowdenbeath,3183,10,5,10,21,29,55,-26,25
Montrose,3184,1,24,7,5,60,34,26,79
Peterhead,3184,2,24,4,8,78,38,40,76
Stirling,3184,3,17,6,13,62,51,11,57
Stenhousem'r,3184,4,15,8,13,55,48,7,53
Clyde,3184,5,14,10,12,52,49,3,52
Elgin,3184,6,14,6,16,53,61,-8,48
Annan Athlet,3184,7,11,12,13,50,44,6,45
Berwick,3184,8,8,11,17,30,59,-29,35
Edinburgh Ci,3184,9,7,9,20,36,61,-25,30
Cowdenbeath,3184,10,4,11,21,26,57,-31,23
Montrose,3185,1,23,8,5,60,35,25,77
Peterhead,3185,2,23,5,8,79,40,39,74
Stirling,3185,3,17,6,13,62,51,11,57
Clyde,3185,4,15,9,12,53,49,4,54
Stenhousem'r,3185,5,15,8,13,55,48,7,53
Elgin,3185,6,14,7,15,54,61,-7,49
Annan Athlet,3185,7,12,11,13,49,41,8,47
Berwick,3185,8,8,10,18,30,60,-30,34
Edinburgh Ci,3185,9,7,10,19,38,62,-24,31
Cowdenbeath,3185,10,4,10,22,23,56,-33,22
Montrose,3186,1,24,7,5,64,37,27,79
Peterhead,3186,2,24,4,8,79,38,41,76
Stenhousem'r,3186,3,16,8,12,59,47,12,56
Stirling,3186,4,16,6,14,61,55,6,54
Clyde,3186,5,14,9,13,54,52,2,51
Elgin,3186,6,14,6,16,56,65,-9,48
Annan Athlet,3186,7,11,11,14,47,43,4,44
Berwick,3186,8,9,10,17,33,61,-28,37
Edinburgh Ci,3186,9,7,9,20,36,62,-26,30
Cowdenbeath,3186,10,5,10,21,25,54,-29,25
Montrose,3187,1,23,8,5,60,35,25,77
Peterhead,3187,2,24,4,8,78,38,40,76
Stirling,3187,3,16,7,13,61,52,9,55
Stenhousem'r,3187,4,15,9,12,56,47,9,54
Clyde,3187,5,15,9,12,53,48,5,54
Elgin,3187,6,14,7,15,54,61,-7,49
Annan Athlet,3187,7,11,12,13,48,42,6,45
Berwick,3187,8,8,10,18,29,60,-31,34
Edinburgh Ci,3187,9,7,9,20,36,61,-25,30
Cowdenbeath,3187,10,4,11,21,24,55,-31,23
Montrose,3188,1,23,8,5,61,36,25,77
Peterhead,3188,2,24,4,8,78,38,40,76
Stirling,3188,3,16,7,13,61,52,9,55
Stenhousem'r,3188,4,15,9,12,56,47,9,54
Clyde,3188,5,14,10,12,53,50,3,52
Elgin,3188,6,14,7,15,55,62,-7,49
Annan Athlet,3188,7,11,12,13,47,41,6,45
Berwick,3188,8,8,11,17,31,60,-29,35
Edinburgh Ci,3188,9,7,9,20,36,61,-25,30
Cowdenbeath,3188,10,4,11,21,23,54,-31,23
Montrose,3189,1,24,7,5,62,35,27,79
Peterhead,3189,2,24,4,8,79,38,41,76
Stenhousem'r,3189,3,16,8,12,56,46,10,56
Stirling,3189,4,16,6,14,60,52,8,54
Clyde,3189,5,14,9,13,51,49,2,51
Elgin,3189,6,14,6,16,54,63,-9,48
Annan Athlet,3189,7,12,11,13,50,43,7,47
Berwick,3189,8,9,10,17,30,58,-28,37
Edinburgh Ci,3189,9,7,9,20,36,62,-26,30
Cowdenbeath,3189,10,4,10,22,25,57,-32,22
Peterhead,3190,1,24,4,8,80,39,41,76
Montrose,3190,2,23,7,6,60,37,23,76
Stenhousem'r,3190,3,16,8,12,57,47,10,56
Stirling,3190,4,16,6,14,61,53,8,54
Clyde,3190,5,15,9,12,53,48,5,54
Elgin,3190,6,15,6,15,56,61,-5,51
Annan Athlet,3190,7,12,11,13,50,42,8,47
Berwick,3190,8,8,10,18,29,60,-31,34
Edinburgh Ci,3190,9,7,9,20,37,63,-26,30
Cowdenbeath,3190,10,4,10,22,24,57,-33,22
Montrose,3191,1,23,8,5,60,35,25,77
Peterhead,3191,2,23,4,9,77,39,38,73
Stirling,3191,3,17,6,13,64,53,11,57
Stenhousem'r,3191,4,15,8,13,57,50,7,53
Clyde,3191,5,14,10,12,51,48,3,52
Elgin,3191,6,14,7,15,54,61,-7,49
Annan Athlet,3191,7,12,11,13,48,41,7,47
Berwick,3191,8,8,11,17,29,58,-29,35
Edinburgh Ci,3191,9,8,9,19,37,60,-23,33
Cowdenbeath,3191,10,4,10,22,23,55,-32,22
Montrose,3192,1,23,8,5,59,34,25,77
Peterhead,3192,2,23,5,8,79,40,39,74
Stirling,3192,3,16,7,13,63,54,9,55
Stenhousem'r,3192,4,15,9,12,58,49,9,54
Clyde,3192,5,15,9,12,52,48,4,54
Elgin,3192,6,14,7,15,53,60,-7,49
Annan Athlet,3192,7,11,11,14,47,43,4,44
Berwick,3192,8,8,10,18,29,59,-30,34
Edinburgh Ci,3192,9,7,10,19,38,62,-24,31
Cowdenbeath,3192,10,5,10,21,25,54,-29,25
Montrose,3193,1,24,7,5,62,36,26,79
Peterhead,3193,2,24,4,8,80,39,41,76
Stenhousem'r,3193,3,16,8,12,59,46,13,56
Stirling,3193,4,16,6,14,60,55,5,54
Clyde,3193,5,15,9,12,52,48,4,54
Elgin,3193,6,14,6,16,55,63,-8,48
Annan Athlet,3193,7,12,11,13,48,41,7,47
Berwick,3193,8,8,10,18,29,59,-30,34
Edinburgh Ci,3193,9,7,9,20,37,63,-26,30
Cowdenbeath,3193,10,4,10,22,23,55,-32,22
Montrose,3194,1,24,7,5,61,35,26,79
Peterhead,3194,2,24,4,8,80,39,41,76
Stirling,3194,3,17,6,13,62,52,10,57
Clyde,3194,4,15,9,12,53,48,5,54
Stenhousem'r,3194,5,15,8,13,56,48,8,53
Elgin,3194,6,14,6,16,54,62,-8,48
Annan Athlet,3194,7,12,11,13,48,41,7,47
Berwick,3194,8,8,10,18,29,60,-31,34
Edinburgh Ci,3194,9,7,9,20,37,63,-26,30
Cowdenbeath,3194,10,4,10,22,23,55,-32,22
Montrose,3195,1,23,7,6,60,36,24,76
Peterhead,3195,2,23,4,9,77,41,36,73
Stenhousem'r,3195,3,16,8,12,57,47,10,56
Stirling,3195,4,16,6,14,61,53,8,54
Clyde,3195,5,15,9,12,53,48,5,54
Elgin,3195,6,15,6,15,55,61,-6,51
Annan Athlet,3195,7,12,11,13,49,41,8,47
Berwick,3195,8,8,10,18,29,60,-31,34
Edinburgh Ci,3195,9,8,9,19,39,60,-21,33
Cowdenbeath,3195,10,4,10,22,23,56,-33,22
Montrose,3196,1,23,8,5,61,36,25,77
Peterhead,3196,2,24,4,8,79,38,41,76
Stenhousem'r,3196,3,16,8,12,58,47,11,56
Stirling,3196,4,16,6,14,61,54,7,54
Clyde,3196,5,15,9,12,55,49,6,54
Elgin,3196,6,14,7,15,55,62,-7,49
Annan Athlet,3196,7,11,12,13,48,42,6,45
Berwick,3196,8,8,10,18,30,62,-32,34
Edinburgh Ci,3196,9,7,9,20,36,62,-26,30
Cowdenbeath,3196,10,4,11,21,24,55,-31,23
Montrose,3197,1,24,7,5,63,37,26,79
Peterhead,3197,2,24,4,8,83,38,45,76
Stirling,3197,3,17,6,13,61,51,10,57
Clyde,3197,4,15,9,12,54,48,6,54
Stenhousem'r,3197,5,15,8,13,55,47,8,53
Elgin,3197,6,14,6,16,56,64,-8,48
Annan Athlet,3197,7,11,11,14,47,44,3,44
Berwick,3197,8,8,10,18,29,61,-32,34
Edinburgh Ci,3197,9,7,9,20,36,66,-30,30
Cowdenbeath,3197,10,5,10,21,26,54,-28,25
Montrose,3198,1,23,8,5,59,34,25,77
Peterhead,3198,2,24,4,8,78,38,40,76
Stirling,3198,3,17,6,13,65,52,13,57
Clyde,3198,4,15,9,12,53,49,4,54
Stenhousem'r,3198,5,15,8,13,56,51,5,53
Elgin,3198,6,14,7,15,53,60,-7,49
Annan Athlet,3198,7,11,12,13,48,42,6,45
Berwick,3198,8,8,10,18,30,60,-30,34
Edinburgh Ci,3198,9,7,9,20,36,61,-25,30
Cowdenbeath,3198,10,4,11,21,24,55,-31,23
Montrose,3199,1,23,8,5,60,35,25,77
Peterhead,3199,2,24,4,8,78,38,40,76
Stirling,3199,3,16,7,13,61,52,9,55
Stenhousem'r,3199,4,15,9,12,56,47,9,54
Clyde,3199,5,15,9,12,53,48,5,54
Elgin,3199,6,14,7,15,54,61,-7,49
Annan Athlet,3199,7,11,12,13,47,41,6,45
Berwick,3199,8,8,10,18,29,60,-31,34
Edinburgh Ci,3199,9,7,9,20,36,61,-25,30
Cowdenbeath,3199,10,4,11,21,23,54,-31,23
Montrose,3200,1,24,7,5,61,35,26,79
Peterhead,3200,2,23,4,9,77,39,38,73
Stirling,3200,3,17,6,13,61,51,10,57
Clyde,3200,4,15,9,12,54,48,6,54
Stenhousem'r,3200,5,15,8,13,55,47,8,53
Elgin,3200,6,14,6,16,54,62,-8,48
Annan Athlet,3200,7,11,11,14,47,43,4,44
Berwick,3200,8,8,10,18,29,61,-32,34
Edinburgh Ci,3200,9,8,9,19,37,60,-23,33
Cowdenbeath,3200,10,5,10,21,25,54,-29,25
Montrose,3201,1,23,7,6,60,36,24,76
Peterhead,3201,2,23,5,8,77,38,39,74
Stirling,3201,3,17,6,13,61,51,10,57
Stenhousem'r,3201,4,15,8,13,55,47,8,53
Clyde,3201,5,14,9,13,55,53,2,51
Elgin,3201,6,15,6,15,55,61,-6,51
Annan Athlet,3201,7,11,12,13,47,41,6,45
Berwick,3201,8,9,10,17,34,62,-28,37
Edinburgh Ci,3201,9,7,10,19,36,60,-24,31
Cowdenbeath,3201,10,4,11,21,23,54,-31,23
Montrose,3202,1,24,7,5,61,34,27,79
Peterhead,3202,2,24,4,8,80,38,42,76
Stirling,3202,3,17,6,13,61,51,10,57
Stenhousem'r,3202,4,15,8,13,55,47,8,53
Clyde,3202,5,14,10,12,52,49,3,52
Elgin,3202,6,14,6,16,53,62,-9,48
Annan Athlet,3202,7,11,12,13,48,42,6,45
Berwick,3202,8,8,11,17,30,59,-29,35
Edinburgh Ci,3202,9,7,9,20,36,63,-27,30
Cowdenbeath,3202,10,4,11,21,24,55,-31,23
Montrose,3203,1,23,8,5,62,37,25,77
Peterhead,3203,2,24,4,8,79,38,41,76
Stirling,3203,3,17,6,13,65,51,14,57
Stenhousem'r,3203,4,15,8,13,55,51,4,53
Clyde,3203,5,14,9,13,51,49,2,51
Elgin,3203,6,14,7,15,56,63,-7,49
Annan Athlet,3203,7,11,12,13,48,42,6,45
Berwick,3203,8,9,10,17,30,58,-28,37
Edinburgh Ci,3203,9,7,9,20,36,62,-26,30
Cowdenbeath,3203,10,4,11,21,24,55,-31,23
Montrose,3204,1,23,8,5,60,35,25,77
Peterhead,3204,2,24,4,8,83,40,43,76
Stirling,3204,3,16,7,13,60,51,9,55
Stenhousem'r,3204,4,15,9,12,55,46,9,54
Clyde,3204,5,14,9,13,51,49,2,51
Elgin,3204,6,14,7,15,54,61,-7,49
Annan Athlet,3204,7,11,12,13,48,42,6,45
Berwick,3204,8,9,10,17,30,58,-28,37
Edinburgh Ci,3204,9,7,9,20,38,66,-28,30
Cowdenbeath,3204,10,4,11,21,24,55,-31,23
Montrose,3205,1,24,7,5,64,34,30,79
Peterhead,3205,2,24,4,8,81,41,40,76
Stirling,3205,3,17,6,13,64,53,11,57
Stenhousem'r,3205,4,15,8,13,57,50,7,53
Clyde,3205,5,14,9,13,51,49,2,51
Elgin,3205,6,14,6,16,53,65,-12,48
Annan Athlet,3205,7,12,11,13,49,41,8,47
Berwick,3205,8,9,10,17,30,58,-28,37
Edinburgh Ci,3205,9,7,9,20,39,64,-25,30
Cowdenbeath,3205,10,4,10,22,23,56,-33,22
Montrose,3206,1,24,7,5,63,34,29,79
Peterhead,3206,2,24,4,8,80,40,40,76
Stirling,3206,3,17,6,13,62,51,11,57
Stenhousem'r,3206,4,15,8,13,55,48,7,53
Clyde,3206,5,14,9,13,52,51,1,51
Elgin,3206,6,14,6,16,53,64,-11,48
Annan Athlet,3206,7,11,12,13,49,43,6,45
Berwick,3206,8,9,10,17,32,59,-27,37
Edinburgh Ci,3206,9,7,9,20,38,63,-25,30
Cowdenbeath,3206,10,4,11,21,25,56,-31,23
Montrose,3207,1,23,8,5,59,34,25,77
Peterhead,3207,2,23,5,8,78,39,39,74
Stirling,3207,3,17,6,13,64,52,12,57
Clyde,3207,4,15,9,12,54,49,5,54
Stenhousem'r,3207,5,15,8,13,56,50,6,53
Elgin,3207,6,14,7,15,53,60,-7,49
Annan Athlet,3207,7,12,11,13,49,41,8,47
Berwick,3207,8,8,10,18,30,61,-31,34
Edinburgh Ci,3207,9,7,10,19,37,61,-24,31
Cowdenbeath,3207,10,4,10,22,23,56,-33,22
Montrose,3208,1,23,8,5,59,34,25,77
Peterhead,3208,2,23,4,9,78,41,37,73
Stenhousem'r,3208,3,16,8,12,58,48,10,56
Stirling,3208,4,16,6,14,62,54,8,54
Clyde,3208,5,14,10,12,52,49,3,52
Elgin,3208,6,14,7,15,53,60,-7,49
Annan Athlet,3208,7,12,11,13,50,41,9,47
Berwick,3208,8,8,11,17,30,59,-29,35
Edinburgh Ci,3208,9,8,9,19,39,61,-22,33
Cowdenbeath,3208,10,4,10,22,23,57,-34,22
Montrose,3209,1,24,7,5,60,34,26,79
Peterhead,3209,2,24,4,8,79,38,41,76
Stirling,3209,3,17,6,13,65,52,13,57
Clyde,3209,4,15,9,12,53,49,4,54
Stenhousem'r,3209,5,15,8,13,56,51,5,53
Elgin,3209,6,14,6,16,53,61,-8,48
Annan Athlet,3209,7,12,11,13,49,41,8,47
Berwick,3209,8,8,10,18,30,60,-30,34
Edinburgh Ci,3209,9,7,9,20,36,62,-26,30
Cowdenbeath,3209,10,4,10,22,23,56,-33,22
Montrose,3210,1,23,8,5,61,36,25,77
Peterhead,3210,2,24,4,8,80,38,42,76
Stenhousem'r,3210,3,16,8,12,57,46,11,56
Stirling,3210,4,16,6,14,60,53,7,54
Clyde,3210,5,15,9,12,53,48,5,54
Elgin,3210,6,14,7,15,55,62,-7,49
Annan Athlet,3210,7,11,11,14,48,45,3,44
Berwick,3210,8,8,10,18,29,60,-31,34
Edinburgh Ci,3210,9,7,9,20,36,63,-27,30
Cowdenbeath,3210,10,5,10,21,27,55,-28,25
Montrose,3211,1,23,8,5,59,34,25,77
Peterhead,3211,2,23,4,9,78,40,38,73
Stenhousem'r,3211,3,16,8,12,60,47,13,56
Clyde,3211,4,15,9,12,54,48,6,54
Stirling,3211,5,16,6,14,61,56,5,54
Elgin,3211,6,14,7,15,53,60,-7,49
Annan Athlet,3211,7,12,11,13,50,43,7,47
Berwick,3211,8,8,10,18,29,61,-32,34
Edinburgh Ci,3211,9,8,9,19,38,61,-23,33
Cowdenbeath,3211,10,4,10,22,25,57,-32,22
Montrose,3212,1,24,7,5,62,36,26,79
Peterhead,3212,2,24,4,8,80,38,42,76
Stenhousem'r,3212,3,16,8,12,57,46,11,56
Stirling,3212,4,16,6,14,60,53,7,54
Clyde,3212,5,15,9,12,55,50,5,54
Elgin,3212,6,14,6,16,55,63,-8,48
Annan Athlet,3212,7,12,11,13,48,41,7,47
Berwick,3212,8,8,10,18,31,62,-31,34
Edinburgh Ci,3212,9,7,9,20,36,63,-27,30
Cowdenbeath,3212,10,4,10,22,23,55,-32,22
Montrose,3213,1,24,7,5,62,34,28,79
Peterhead,3213,2,23,5,8,78,39,39,74
Stirling,3213,3,17,6,13,61,51,10,57
Stenhousem'r,3213,4,15,8,13,55,47,8,53
Clyde,3213,5,14,9,13,51,50,1,51
Elgin,3213,6,14,6,16,53,63,-10,48
Annan Athlet,3213,7,11,11,14,49,44,5,44
Berwick,3213,8,9,10,17,31,58,-27,37
Edinburgh Ci,3213,9,7,10,19,37,61,-24,31
Cowdenbeath,3213,10,5,10,21,26,56,-30,25
Montrose,3214,1,24,7,5,61,34,27,79
Peterhead,3214,2,24,4,8,78,38,40,76
Stirling,3214,3,17,6,13,65,51,14,57
Clyde,3214,4,15,9,12,52,48,4,54
Stenhousem'r,3214,5,15,8,13,55,51,4,53
Elgin,3214,6,14,6,16,53,62,-9,48
Annan Athlet,3214,7,12,11,13,49,41,8,47
Berwick,3214,8,8,10,18,29,59,-30,34
Edinburgh Ci,3214,9,7,9,20,36,61,-25,30
Cowdenbeath,3214,10,4,10,22,23,56,-33,22
Peterhead,3215,1,24,4,8,79,39,40,76
Montrose,3215,2,23,7,6,59,35,24,76
Stirling,3215,3,17,6,13,61,51,10,57
Stenhousem'r,3215,4,15,8,13,55,47,8,53
Clyde,3215,5,14,10,12,51,48,3,52
Elgin,3215,6,15,6,15,54,60,-6,51
Annan Athlet,3215,7,11,11,14,48,43,5,44
Berwick,3215,8,8,11,17,29,58,-29,35
Edinburgh Ci,3215,9,7,9,20,37,62,-25,30
Cowdenbeath,3215,10,5,10,21,25,55,-30,25
Montrose,3216,1,23,7,6,59,35,24,76
Peterhead,3216,2,23,5,8,77,38,39,74
Stirling,3216,3,17,6,13,62,52,10,57
Clyde,3216,4,15,9,12,56,48,8,54
Stenhousem'r,3216,5,15,8,13,56,48,8,53
Elgin,3216,6,15,6,15,54,60,-6,51
Annan Athlet,3216,7,11,12,13,47,41,6,45
Berwick,3216,8,8,10,18,29,63,-34,34
Edinburgh Ci,3216,9,7,10,19,36,60,-24,31
Cowdenbeath,3216,10,4,11,21,23,54,-31,23
Montrose,3217,1,23,8,5,60,35,25,77
Peterhead,3217,2,23,4,9,78,40,38,73
Stirling,3217,3,17,6,13,64,52,12,57
Clyde,3217,4,15,9,12,52,48,4,54
Stenhousem'r,3217,5,15,8,13,56,50,6,53
Elgin,3217,6,14,7,15,54,61,-7,49
Annan Athlet,3217,7,11,12,13,47,41,6,45
Berwick,3217,8,8,10,18,29,59,-30,34
Edinburgh Ci,3217,9,8,9,19,38,61,-23,33
Cowdenbeath,3217,10,4,11,21,23,54,-31,23
Montrose,3218,1,23,8,5,60,35,25,77
Peterhead,3218,2,24,4,8,79,39,40,76
Stenhousem'r,3218,3,16,8,12,58,46,12,56
Stirling,3218,4,16,6,14,60,54,6,54
Clyde,3218,5,14,9,13,51,49,2,51
Elgin,3218,6,14,7,15,54,61,-7,49
Annan Athlet,3218,7,11,12,13,48,42,6,45
Berwick,3218,8,9,10,17,30,58,-28,37
Edinburgh Ci,3218,9,7,9,20,37,62,-25,30
Cowdenbeath,3218,10,4,11,21,24,55,-31,23
Montrose,3219,1,24,7,5,60,34,26,79
Peterhead,3219,2,23,5,8,79,40,39,74
Stirling,3219,3,17,6,13,64,51,13,57
Clyde,3219,4,15,9,12,54,48,6,54
Stenhousem'r,3219,5,15,8,13,55,50,5,53
Elgin,3219,6,14,6,16,53,61,-8,48
Annan Athlet,3219,7,11,12,13,48,42,6,45
Berwick,3219,8,8,10,18,29,61,-32,34
Edinburgh Ci,3219,9,7,10,19,38,62,-24,31
Cowdenbeath,3219,10,4,11,21,24,55,-31,23
Montrose,3220,1,24,7,5,60,34,26,79
Peterhead,3220,2,24,4,8,81,39,42,76
Stirling,3220,3,17,6,13,65,53,12,57
Clyde,3220,4,15,9,12,53,49,4,54
Stenhousem'r,3220,5,15,8,13,57,51,6,53
Elgin,3220,6,14,6,16,53,61,-8,48
Annan Athlet,3220,7,11,11,14,47,42,5,44
Berwick,3220,8,8,10,18,30,60,-30,34
Edinburgh Ci,3220,9,7,9,20,37,64,-27,30
Cowdenbeath,3220,10,5,10,21,24,54,-30,25
Montrose,3221,1,23,8,5,60,35,25,77
Peterhead,3221,2,23,5,8,79,40,39,74
Stirling,3221,3,17,6,13,64,52,12,57
Clyde,3221,4,15,9,12,52,48,4,54
Stenhousem'r,3221,5,15,8,13,56,50,6,53
Elgin,3221,6,14,7,15,54,61,-7,49
Annan Athlet,3221,7,12,11,13,49,41,8,47
Berwick,3221,8,8,10,18,29,59,-30,34
Edinburgh Ci,3221,9,7,10,19,38,62,-24,31
Cowdenbeath,3221,10,4,10,22,23,56,-33,22
Montrose,3222,1,24,7,5,63,35,28,79
Peterhead,3222,2,24,4,8,81,39,42,76
Stenhousem'r,3222,3,16,8,12,57,47,10,56
Stirling,3222,4,16,6,14,61,53,8,54
Clyde,3222,5,15,9,12,53,48,5,54
Elgin,3222,6,14,6,16,54,64,-10,48
Annan Athlet,3222,7,11,12,13,48,42,6,45
Berwick,3222,8,8,10,18,29,60,-31,34
Edinburgh Ci,3222,9,7,9,20,37,64,-27,30
Cowdenbeath,3222,10,4,11,21,24,55,-31,23
Montrose,3223,1,24,7,5,64,35,29,79
Peterhead,3223,2,24,4,8,79,38,41,76
Stirling,3223,3,16,7,13,60,51,9,55
Stenhousem'r,3223,4,15,9,12,55,46,9,54
Clyde,3223,5,14,10,12,52,49,3,52
Elgin,3223,6,14,6,16,54,65,-11,48
Annan Athlet,3223,7,11,11,14,47,44,3,44
Berwick,3223,8,8,11,17,30,59,-29,35
Edinburgh Ci,3223,9,7,9,20,36,62,-26,30
Cowdenbeath,3223,10,5,10,21,26,54,-28,25
Peterhead,3224,1,24,4,8,80,40,40,76
Montrose,3224,2,23,7,6,60,36,24,76
Stirling,3224,3,17,6,13,63,51,12,57
Clyde,3224,4,15,9,12,53,48,5,54
Stenhousem'r,3224,5,15,8,13,55,49,6,53
Elgin,3224,6,15,6,15,55,61,-6,51
Annan Athlet,3224,7,11,12,13,47,41,6,45
Berwick,3224,8,8,10,18,29,60,-31,34
Edinburgh Ci,3224,9,7,9,20,38,63,-25,30
Cowdenbeath,3224,10,4,11,21,23,54,-31,23
Montrose,3225,1,24,7,5,61,34,27,79
Peterhead,3225,2,23,5,8,78,39,39,74
Stirling,3225,3,17,6,13,61,51,10,57
Clyde,3225,4,15,9,12,53,49,4,54
Stenhousem'r,3225,5,15,8,13,55,47,8,53
Elgin,3225,6,14,6,16,53,62,-9,48
Annan Athlet,3225,7,11,12,13,49,43,6,45
Berwick,3225,8,8,10,18,30,60,-30,34
Edinburgh Ci,3225,9,7,10,19,37,61,-24,31
Cowdenbeath,3225,10,4,11,21,25,56,-31,23
Montrose,3226,1,24,7,5,60,34,26,79
Peterhead,3226,2,24,4,8,81,38,43,76
Stenhousem'r,3226,3,16,8,12,58,46,12,56
Stirling,3226,4,16,6,14,60,54,6,54
Clyde,3226,5,14,10,12,51,48,3,52
Elgin,3226,6,14,6,16,53,61,-8,48
Annan Athlet,3226,7,12,11,13,51,42,9,47
Berwick,3226,8,8,11,17,29,58,-29,35
Edinburgh Ci,3226,9,7,9,20,36,64,-28,30
Cowdenbeath,3226,10,4,10,22,24,58,-34,22
Montrose,3227,1,24,7,5,61,34,27,79
Peterhead,3227,2,24,4,8,81,39,42,76
Stirling,3227,3,17,6,13,62,52,10,57
Clyde,3227,4,15,9,12,52,48,4,54
Stenhousem'r,3227,5,15,8,13,56,48,8,53
Elgin,3227,6,14,6,16,53,62,-9,48
Annan Athlet,3227,7,11,12,13,47,41,6,45
Berwick,3227,8,8,10,18,29,59,-30,34
Edinburgh Ci,3227,9,7,9,20,37,64,-27,30
Cowdenbeath,3227,10,4,11,21,23,54,-31,23
Montrose,3228,1,24,7,5,62,35,27,79
Peterhead,3228,2,24,4,8,80,39,41,76
Stenhousem'r,3228,3,16,8,12,57,47,10,56
Stirling,3228,4,16,6,14,61,53,8,54
Clyde,3228,5,14,9,13,52,51,1,51
Elgin,3228,6,14,6,16,54,63,-9,48
Annan Athlet,3228,7,11,12,13,48,42,6,45
Berwick,3228,8,9,10,17,32,59,-27,37
Edinburgh Ci,3228,9,7,9,20,37,63,-26,30
Cowdenbeath,3228,10,4,11,21,24,55,-31,23
Montrose,3229,1,24,7,5,63,35,28,79
Peterhead,3229,2,24,4,8,81,40,41,76
Stirling,3229,3,16,7,13,61,52,9,55
Clyde,3229,4,15,9,12,59,48,11,54
Stenhousem'r,3229,5,15,9,12,56,47,9,54
Elgin,3229,6,14,6,16,54,64,-10,48
Annan Athlet,3229,7,11,11,14,48,43,5,44
Berwick,3229,8,8,10,18,29,66,-37,34
Edinburgh Ci,3229,9,7,9,20,38,64,-26,30
Cowdenbeath,3229,10,5,10,21,25,55,-30,25
Peterhead,3230,1,24,4,8,81,40,41,76
Montrose,3230,2,23,7,6,59,37,22,76
Stenhousem'r,3230,3,16,8,12,57,46,11,56
Stirling,3230,4,16,6,14,60,53,7,54
Clyde,3230,5,14,10,12,52,49,3,52
Elgin,3230,6,15,6,15,56,60,-4,51
Annan Athlet,3230,7,11,12,13,49,43,6,45
Berwick,3230,8,8,11,17,30,59,-29,35
Edinburgh Ci,3230,9,7,9,20,38,64,-26,30
Cowdenbeath,3230,10,4,11,21,25,56,-31,23
Montrose,3231,1,23,8,5,61,36,25,77
Peterhead,3231,2,23,5,8,78,39,39,74
Stenhousem'r,3231,3,16,8,12,57,47,10,56
Stirling,3231,4,16,6,14,61,53,8,54
Clyde,3231,5,14,10,12,53,50,3,52
Elgin,3231,6,14,7,15,55,62,-7,49
Annan Athlet,3231,7,11,12,13,49,43,6,45
Berwick,3231,8,8,11,17,31,60,-29,35
Edinburgh Ci,3231,9,7,10,19,37,61,-24,31
Cowdenbeath,3231,10,4,11,21,25,56,-31,23
Montrose,3232,1,23,8,5,61,36,25,77
Peterhead,3232,2,24,4,8,79,39,40,76
Stirling,3232,3,17,6,13,63,52,11,57
Clyde,3232,4,15,9,12,55,48,7,54
Stenhousem'r,3232,5,15,8,13,56,49,7,53
Elgin,3232,6,14,7,15,55,62,-7,49
Annan Athlet,3232,7,11,12,13,48,42,6,45
Berwick,3232,8,8,10,18,29,62,-33,34
Edinburgh Ci,3232,9,7,9,20,37,62,-25,30
Cowdenbeath,3232,10,4,11,21,24,55,-31,23
Montrose,3233,1,23,8,5,60,35,25,77
Peterhead,3233,2,24,4,8,81,40,41,76
Stirling,3233,3,17,6,13,63,53,10,57
Clyde,3233,4,15,9,12,57,48,9,54
Stenhousem'r,3233,5,15,8,13,57,49,8,53
Elgin,3233,6,14,7,15,54,61,-7,49
Annan Athlet,3233,7,11,11,14,47,43,4,44
Berwick,3233,8,8,10,18,29,64,-35,34
Edinburgh Ci,3233,9,7,9,20,38,64,-26,30
Cowdenbeath,3233,10,5,10,21,25,54,-29,25
Montrose,3234,1,24,7,5,63,35,28,79
Peterhead,3234,2,24,4,8,81,38,43,76
Stenhousem'r,3234,3,16,8,12,56,46,10,56
Stirling,3234,4,16,6,14,60,52,8,54
Clyde,3234,5,15,9,12,54,49,5,54
Elgin,3234,6,14,6,16,54,64,-10,48
Annan Athlet,3234,7,11,11,14,47,44,3,44
Berwick,3234,8,8,10,18,30,61,-31,34
Edinburgh Ci,3234,9,7,9,20,36,64,-28,30
Cowdenbeath,3234,10,5,10,21,26,54,-28,25
Montrose,3235,1,24,7,5,61,34,27,79
Peterhead,3235,2,24,4,8,81,39,42,76
Stirling,3235,3,17,6,13,63,51,12,57
Stenhousem'r,3235,4,15,8,13,55,49,6,53
Clyde,3235,5,14,9,13,52,50,2,51
Elgin,3235,6,14,6,16,53,62,-9,48
Annan Athlet,3235,7,11,12,13,49,43,6,45
Berwick,3235,8,9,10,17,31,59,-28,37
Edinburgh Ci,3235,9,7,9,20,37,64,-27,30
Cowdenbeath,3235,10,4,11,21,25,56,-31,23
Montrose,3236,1,24,7,5,61,35,26,79
Peterhead,3236,2,24,4,8,78,38,40,76
Stirling,3236,3,17,6,13,63,53,10,57
Clyde,3236,4,15,9,12,53,49,4,54
Stenhousem'r,3236,5,15,8,13,57,49,8,53
Elgin,3236,6,14,6,16,54,62,-8,48
Annan Athlet,3236,7,11,11,14,48,43,5,44
Berwick,3236,8,8,10,18,30,60,-30,34
Edinburgh Ci,3236,9,7,9,20,36,61,-25,30
Cowdenbeath,3236,10,5,10,21,25,55,-30,25
Montrose,3237,1,23,8,5,61,36,25,77
Peterhead,3237,2,23,5,8,78,39,39,74
Stirling,3237,3,17,6,13,61,51,10,57
Clyde,3237,4,15,9,12,54,49,5,54
Stenhousem'r,3237,5,15,8,13,55,47,8,53
Elgin,3237,6,14,7,15,55,62,-7,49
Annan Athlet,3237,7,11,11,14,47,43,4,44
Berwick,3237,8,8,10,18,30,61,-31,34
Edinburgh Ci,3237,9,7,10,19,37,61,-24,31
Cowdenbeath,3237,10,5,10,21,25,54,-29,25
Montrose,3238,1,24,7,5,61,35,26,79
Peterhead,3238,2,24,4,8,80,40,40,76
Stirling,3238,3,17,6,13,62,51,11,57
Clyde,3238,4,15,9,12,52,48,4,54
Stenhousem'r,3238,5,15,8,13,55,48,7,53
Elgin,3238,6,14,6,16,54,62,-8,48
Annan Athlet,3238,7,11,11,14,47,43,4,44
Berwick,3238,8,8,10,18,29,59,-30,34
Edinburgh Ci,3238,9,7,9,20,38,63,-25,30
Cowdenbeath,3238,10,5,10,21,25,54,-29,25
Montrose,3239,1,24,7,5,62,34,28,79
Peterhead,3239,2,24,4,8,80,38,42,76
Stirling,3239,3,16,7,13,61,52,9,55
Stenhousem'r,3239,4,15,9,12,56,47,9,54
Clyde,3239,5,15,9,12,55,51,4,54
Elgin,3239,6,14,6,16,53,63,-10,48
Annan Athlet,3239,7,11,11,14,48,44,4,44
Berwick,3239,8,8,10,18,32,62,-30,34
Edinburgh Ci,3239,9,7,9,20,36,63,-27,30
Cowdenbeath,3239,10,5,10,21,26,55,-29,25
Montrose,3240,1,24,7,5,60,34,26,79
Peterhead,3240,2,23,5,8,79,40,39,74
Stirling,3240,3,17,6,13,63,51,12,57
Clyde,3240,4,15,9,12,53,49,4,54
Stenhousem'r,3240,5,15,8,13,55,49,6,53
Elgin,3240,6,14,6,16,53,61,-8,48
Annan Athlet,3240,7,12,11,13,50,41,9,47
Berwick,3240,8,8,10,18,30,60,-30,34
Edinburgh Ci,3240,9,7,10,19,38,62,-24,31
Cowdenbeath,3240,10,4,10,22,23,57,-34,22
Montrose,3241,1,24,7,5,63,35,28,79
Peterhead,3241,2,24,4,8,81,38,43,76
Stirling,3241,3,16,7,13,62,53,9,55
Stenhousem'r,3241,4,15,9,12,57,48,9,54
Clyde,3241,5,15,9,12,54,48,6,54
Elgin,3241,6,14,6,16,54,64,-10,48
Annan Athlet,3241,7,11,11,14,48,44,4,44
Berwick,3241,8,8,10,18,29,61,-32,34
Edinburgh Ci,3241,9,7,9,20,36,64,-28,30
Cowdenbeath,3241,10,5,10,21,26,55,-29,25
Montrose,3242,1,24,7,5,61,34,27,79
Peterhead,3242,2,24,4,8,80,39,41,76
Stirling,3242,3,17,6,13,63,53,10,57
Clyde,3242,4,15,9,12,52,48,4,54
Stenhousem'r,3242,5,15,8,13,57,49,8,53
Elgin,3242,6,14,6,16,53,62,-9,48
Annan Athlet,3242,7,11,11,14,47,42,5,44
Berwick,3242,8,8,10,18,29,59,-30,34
Edinburgh Ci,3242,9,7,9,20,37,63,-26,30
Cowdenbeath,3242,10,5,10,21,24,54,-30,25
Peterhead,3243,1,24,4,8,83,38,45,76
Montrose,3243,2,23,7,6,59,35,24,76
Stirling,3243,3,17,6,13,63,51,12,57
Clyde,3243,4,15,9,12,54,48,6,54
Stenhousem'r,3243,5,15,8,13,55,49,6,53
Elgin,3243,6,15,6,15,54,60,-6,51
Annan Athlet,3243,7,12,11,13,50,43,7,47
Berwick,3243,8,8,10,18,29,61,-32,34
Edinburgh Ci,3243,9,7,9,20,36,66,-30,30
Cowdenbeath,3243,10,4,10,22,25,57,-32,22
Montrose,3244,1,24,7,5,62,34,28,79
Peterhead,3244,2,24,4,8,78,38,40,76
Stenhousem'r,3244,3,16,8,12,56,46,10,56
Stirling,3244,4,16,6,14,60,52,8,54
Clyde,3244,5,15,9,12,54,50,4,54
Elgin,3244,6,14,6,16,53,63,-10,48
Annan Athlet,3244,7,11,12,13,47,41,6,45
Berwick,3244,8,8,10,18,31,61,-30,34
Edinburgh Ci,3244,9,7,9,20,36,61,-25,30
Cowdenbeath,3244,10,4,11,21,23,54,-31,23
Montrose,3245,1,24,7,5,61,35,26,79
Peterhead,3245,2,24,4,8,79,39,40,76
Stirling,3245,3,17,6,13,64,51,13,57
Clyde,3245,4,15,9,12,54,50,4,54
Stenhousem'r,3245,5,15,8,13,55,50,5,53
Elgin,3245,6,14,6,16,54,62,-8,48
Annan Athlet,3245,7,11,11,14,47,42,5,44
Berwick,3245,8,8,10,18,31,61,-30,34
Edinburgh Ci,3245,9,7,9,20,37,62,-25,30
Cowdenbeath,3245,10,5,10,21,24,54,-30,25
Montrose,3246,1,24,7,5,62,34,28,79
Peterhead,3246,2,24,4,8,81,39,42,76
Stirling,3246,3,17,6,13,61,51,10,57
Clyde,3246,4,15,9,12,53,49,4,54
Stenhousem'r,3246,5,15,8,13,55,47,8,53
Elgin,3246,6,14,6,16,53,63,-10,48
Annan Athlet,3246,7,11,12,13,49,43,6,45
Berwick,3246,8,8,10,18,30,60,-30,34
Edinburgh Ci,3246,9,7,9,20,37,64,-27,30
Cowdenbeath,3246,10,4,11,21,25,56,-31,23
Peterhead,3247,1,24,4,8,81,40,41,76
Montrose,3247,2,23,7,6,61,39,22,76
Stirling,3247,3,17,6,13,63,52,11,57
Clyde,3247,4,15,9,12,53,49,4,54
Stenhousem'r,3247,5,15,8,13,56,49,7,53
Elgin,3247,6,15,6,15,58,62,-4,51
Annan Athlet,3247,7,11,12,13,47,41,6,45
Berwick,3247,8,8,10,18,30,60,-30,34
Edinburgh Ci,3247,9,7,9,20,38,64,-26,30
Cowdenbeath,3247,10,4,11,21,23,54,-31,23
Montrose,3248,1,23,8,5,62,37,25,77
Peterhead,3248,2,23,4,9,78,41,37,73
Stirling,3248,3,17,6,13,64,52,12,57
Clyde,3248,4,15,9,12,53,49,4,54
Stenhousem'r,3248,5,15,8,13,56,50,6,53
Elgin,3248,6,14,7,15,56,63,-7,49
Annan Athlet,3248,7,12,11,13,49,41,8,47
Berwick,3248,8,8,10,18,30,60,-30,34
Edinburgh Ci,3248,9,8,9,19,39,61,-22,33
Cowdenbeath,3248,10,4,10,22,23,56,-33,22
Montrose,3249,1,23,7,6,60,37,23,76
Peterhead,3249,2,23,5,8,80,41,39,74
Stirling,3249,3,17,6,13,61,51,10,57
Stenhousem'r,3249,4,15,8,13,55,47,8,53
Clyde,3249,5,14,10,12,51,48,3,52
Elgin,3249,6,15,6,15,56,61,-5,51
Annan Athlet,3249,7,11,12,13,49,43,6,45
Berwick,3249,8,8,11,17,29,58,-29,35
Edinburgh Ci,3249,9,7,10,19,39,63,-24,31
Cowdenbeath,3249,10,4,11,21,25,56,-31,23
Montrose,3250,1,24,7,5,64,34,30,79
Peterhead,3250,2,24,4,8,78,38,40,76
Stirling,3250,3,16,7,13,61,52,9,55
Stenhousem'r,3250,4,15,9,12,56,47,9,54
Clyde,3250,5,14,10,12,52,49,3,52
Elgin,3250,6,14,6,16,53,65,-12,48
Annan Athlet,3250,7,11,11,14,48,44,4,44
Berwick,3250,8,8,11,17,30,59,-29,35
Edinburgh Ci,3250,9,7,9,20,36,61,-25,30
Cowdenbeath,3250,10,5,10,21,26,55,-29,25
Peterhead,3251,1,24,4,8,82,38,44,76
Montrose,3251,2,23,7,6,60,37,23,76
Stirling,3251,3,17,6,13,63,51,12,57
Clyde,3251,4,15,9,12,54,49,5,54
Stenhousem'r,3251,5,15,8,13,55,49,6,53
Elgin,3251,6,15,6,15,56,61,-5,51
Annan Athlet,3251,7,12,11,13,48,41,7,47
Berwick,3251,8,8,10,18,30,61,-31,34
Edinburgh Ci,3251,9,7,9,20,36,65,-29,30
Cowdenbeath,3251,10,4,10,22,23,55,-32,22
Peterhead,3252,1,24,4,8,81,38,43,76
Montrose,3252,2,23,7,6,60,37,23,76
Stenhousem'r,3252,3,16,8,12,58,48,10,56
Stirling,3252,4,16,6,14,62,54,8,54
Clyde,3252,5,15,9,12,53,49,4,54
Elgin,3252,6,15,6,15,56,61,-5,51
Annan Athlet,3252,7,11,12,13,48,42,6,45
Berwick,3252,8,8,10,18,30,60,-30,34
Edinburgh Ci,3252,9,7,9,20,36,64,-28,30
Cowdenbeath,3252,10,4,11,21,24,55,-31,23
Peterhead,3253,1,24,4,8,78,38,40,76
Montrose,3253,2,23,7,6,59,35,24,76
Stenhousem'r,3253,3,16,8,12,56,46,10,56
Stirling,3253,4,16,6,14,60,52,8,54
Clyde,3253,5,14,10,12,52,49,3,52
Elgin,3253,6,15,6,15,54,60,-6,51
Annan Athlet,3253,7,11,12,13,48,42,6,45
Berwick,3253,8,8,11,17,30,59,-29,35
Edinburgh Ci,3253,9,7,9,20,36,61,-25,30
Cowdenbeath,3253,10,4,11,21,24,55,-31,23
Peterhead,3254,1,24,4,8,80,39,41,76
Montrose,3254,2,23,7,6,60,36,24,76
Stenhousem'r,3254,3,16,8,12,59,46,13,56
Stirling,3254,4,16,6,14,60,55,5,54
Clyde,3254,5,15,9,12,54,50,4,54
Elgin,3254,6,15,6,15,55,61,-6,51
Annan Athlet,3254,7,11,12,13,50,44,6,45
Berwick,3254,8,8,10,18,31,61,-30,34
Edinburgh Ci,3254,9,7,9,20,37,63,-26,30
Cowdenbeath,3254,10,4,11,21,26,57,-31,23
Montrose,3255,1,23,8,5,60,35,25,77
Peterhead,3255,2,24,4,8,79,38,41,76
Stirling,3255,3,17,6,13,62,52,10,57
Clyde,3255,4,15,9,12,53,49,4,54
Stenhousem'r,3255,5,15,8,13,56,48,8,53
Elgin,3255,6,14,7,15,54,61,-7,49
Annan Athlet,3255,7,11,11,14,48,44,4,44
Berwick,3255,8,8,10,18,30,60,-30,34
Edinburgh Ci,3255,9,7,9,20,36,62,-26,30
Cowdenbeath,3255,10,5,10,21,26,55,-29,25
Montrose,3256,1,24,7,5,61,34,27,79
Peterhead,3256,2,23,4,9,78,40,38,73
Stirling,3256,3,16,7,13,61,52,9,55
Stenhousem'r,3256,4,15,9,12,56,47,9,54
Clyde,3256,5,15,9,12,52,48,4,54
Elgin,3256,6,14,6,16,53,62,-9,48
Annan Athlet,3256,7,11,12,13,47,41,6,45
Berwick,3256,8,8,10,18,29,59,-30,34
Edinburgh Ci,3256,9,8,9,19,38,61,-23,33
Cowdenbeath,3256,10,4,11,21,23,54,-31,23
Montrose,3257,1,23,8,5,61,36,25,77
Peterhead,3257,2,23,5,8,77,38,39,74
Stirling,3257,3,17,6,13,63,53,10,57
Clyde,3257,4,15,9,12,54,50,4,54
Stenhousem'r,3257,5,15,8,13,57,49,8,53
Elgin,3257,6,14,7,15,55,62,-7,49
Annan Athlet,3257,7,12,11,13,51,42,9,47
Berwick,3257,8,8,10,18,31,61,-30,34
Edinburgh Ci,3257,9,7,10,19,36,60,-24,31
Cowdenbeath,3257,10,4,10,22,24,58,-34,22
Montrose,3258,1,24,7,5,61,34,27,79
Peterhead,3258,2,23,4,9,78,41,37,73
Stirling,3258,3,17,6,13,63,52,11,57
Stenhousem'r,3258,4,15,8,13,56,49,7,53
Clyde,3258,5,14,9,13,51,49,2,51
Elgin,3258,6,14,6,16,53,62,-9,48
Annan Athlet,3258,7,11,11,14,47,42,5,44
Berwick,3258,8,9,10,17,30,58,-28,37
Edinburgh Ci,3258,9,8,9,19,39,61,-22,33
Cowdenbeath,3258,10,5,10,21,24,54,-30,25
Montrose,3259,1,24,7,5,63,34,29,79
Peterhead,3259,2,24,4,8,83,39,44,76
Stirling,3259,3,17,6,13,61,51,10,57
Clyde,3259,4,15,9,12,54,48,6,54
Stenhousem'r,3259,5,15,8,13,55,47,8,53
Elgin,3259,6,14,6,16,53,64,-11,48
Annan Athlet,3259,7,11,11,14,47,43,4,44
Berwick,3259,8,8,10,18,29,61,-32,34
Edinburgh Ci,3259,9,7,9,20,37,66,-29,30
Cowdenbeath,3259,10,5,10,21,25,54,-29,25
Montrose,3260,1,24,7,5,63,35,28,79
Peterhead,3260,2,24,4,8,80,38,42,76
Stirling,3260,3,17,6,13,61,51,10,57
Clyde,3260,4,15,9,12,53,48,5,54
Stenhousem'r,3260,5,15,8,13,55,47,8,53
Elgin,3260,6,14,6,16,54,64,-10,48
Annan Athlet,3260,7,11,11,14,48,44,4,44
Berwick,3260,8,8,10,18,29,60,-31,34
Edinburgh Ci,3260,9,7,9,20,36,63,-27,30
Cowdenbeath,3260,10,5,10,21,26,55,-29,25
Montrose,3261,1,23,8,5,60,35,25,77
Peterhead,3261,2,24,4,8,83,39,44,76
Stirling,3261,3,16,7,13,60,51,9,55
Stenhousem'r,3261,4,15,9,12,55,46,9,54
Clyde,3261,5,15,9,12,53,49,4,54
Elgin,3261,6,14,7,15,54,61,-7,49
Annan Athlet,3261,7,12,11,13,48,41,7,47
Berwick,3261,8,8,10,18,30,60,-30,34
Edinburgh Ci,3261,9,7,9,20,37,66,-29,30
Cowdenbeath,3261,10,4,10,22,23,55,-32,22
Montrose,3262,1,24,7,5,63,35,28,79
Peterhead,3262,2,23,5,8,79,40,39,74
Stirling,3262,3,17,6,13,62,52,10,57
Clyde,3262,4,15,9,12,54,49,5,54
Stenhousem'r,3262,5,15,8,13,56,48,8,53
Elgin,3262,6,14,6,16,54,64,-10,48
Annan Athlet,3262,7,11,11,14,49,44,5,44
Berwick,3262,8,8,10,18,30,61,-31,34
Edinburgh Ci,3262,9,7,10,19,38,62,-24,31
Cowdenbeath,3262,10,5,10,21,26,56,-30,25
Montrose,3263,1,24,7,5,62,34,28,79
Peterhead,3263,2,24,4,8,81,40,41,76
Stirling,3263,3,17,6,13,64,52,12,57
Clyde,3263,4,15,9,12,53,48,5,54
Stenhousem'r,3263,5,15,8,13,56,50,6,53
Elgin,3263,6,14,6,16,53,63,-10,48
Annan Athlet,3263,7,11,11,14,48,43,5,44
Berwick,3263,8,8,10,18,29,60,-31,34
Edinburgh Ci,3263,9,7,9,20,38,64,-26,30
Cowdenbeath,3263,10,5,10,21,25,55,-30,25
Montrose,3264,1,23,8,5,60,35,25,77
Peterhead,3264,2,24,4,8,80,39,41,76
Stirling,3264,3,17,6,13,64,54,10,57
Clyde,3264,4,15,9,12,54,50,4,54
Stenhousem'r,3264,5,15,8,13,58,50,8,53
Elgin,3264,6,14,7,15,54,61,-7,49
Annan Athlet,3264,7,11,12,13,47,41,6,45
Berwick,3264,8,8,10,18,31,61,-30,34
Edinburgh Ci,3264,9,7,9,20,37,63,-26,30
Cowdenbeath,3264,10,4,11,21,23,54,-31,23
Montrose,3265,1,24,7,5,61,35,26,79
Peterhead,3265,2,24,4,8,79,38,41,76
Stirling,3265,3,17,6,13,64,52,12,57
Stenhousem'r,3265,4,15,8,13,56,50,6,53
Clyde,3265,5,14,10,12,52,49,3,52
Elgin,3265,6,14,6,16,54,62,-8,48
Annan Athlet,3265,7,12,11,13,49,42,7,47
Berwick,3265,8,8,11,17,30,59,-29,35
Edinburgh Ci,3265,9,7,9,20,36,62,-26,30
Cowdenbeath,3265,10,4,10,22,24,56,-32,22
Montrose,3266,1,24,7,5,60,34,26,79
Peterhead,3266,2,23,4,9,77,39,38,73
Stirling,3266,3,17,6,13,62,51,11,57
Clyde,3266,4,15,9,12,53,49,4,54
Stenhousem'r,3266,5,15,8,13,55,48,7,53
Elgin,3266,6,14,6,16,53,61,-8,48
Annan Athlet,3266,7,12,11,13,50,42,8,47
Berwick,3266,8,8,10,18,30,60,-30,34
Edinburgh Ci,3266,9,8,9,19,37,60,-23,33
Cowdenbeath,3266,10,4,10,22,24,57,-33,22
Montrose,3267,1,24,7,5,61,34,27,79
Peterhead,3267,2,24,4,8,84,40,44,76
Stirling,3267,3,17,6,13,62,52,10,57
Clyde,3267,4,15,9,12,54,48,6,54
Stenhousem'r,3267,5,15,8,13,56,48,8,53
Elgin,3267,6,14,6,16,53,62,-9,48
Annan Athlet,3267,7,12,11,13,50,41,9,47
Berwick,3267,8,8,10,18,29,61,-32,34
Edinburgh Ci,3267,9,7,9,20,38,67,-29,30
Cowdenbeath,3267,10,4,10,22,23,57,-34,22
Montrose,3268,1,24,7,5,60,34,26,79
Peterhead,3268,2,24,4,8,80,38,42,76
Stirling,3268,3,17,6,13,66,53,13,57
Clyde,3268,4,15,9,12,54,50,4,54
Stenhousem'r,3268,5,15,8,13,57,52,5,53
Elgin,3268,6,14,6,16,53,61,-8,48
Annan Athlet,3268,7,12,11,13,48,41,7,47
Berwick,3268,8,8,10,18,31,61,-30,34
Edinburgh Ci,3268,9,7,9,20,36,63,-27,30
Cowdenbeath,3268,10,4,10,22,23,55,-32,22
Peterhead,3269,1,24,4,8,79,39,40,76
Montrose,3269,2,23,7,6,61,37,24,76
Stirling,3269,3,17,6,13,62,52,10,57
Stenhousem'r,3269,4,15,8,13,56,48,8,53
Clyde,3269,5,14,10,12,51,48,3,52
Elgin,3269,6,15,6,15,56,62,-6,51
Annan Athlet,3269,7,11,11,14,47,43,4,44
Berwick,3269,8,8,11,17,29,58,-29,35
Edinburgh Ci,3269,9,7,9,20,37,62,-25,30
Cowdenbeath,3269,10,5,10,21,25,54,-29,25
Peterhead,3270,1,24,4,8,79,39,40,76
Montrose,3270,2,23,7,6,59,35,24,76
Stirling,3270,3,17,6,13,63,52,11,57
Stenhousem'r,3270,4,15,8,13,56,49,7,53
Clyde,3270,5,14,9,13,51,49,2,51
Elgin,3270,6,15,6,15,54,60,-6,51
Annan Athlet,3270,7,12,11,13,49,42,7,47
Berwick,3270,8,9,10,17,30,58,-28,37
Edinburgh Ci,3270,9,7,9,20,37,62,-25,30
Cowdenbeath,3270,10,4,10,22,24,56,-32,22
Montrose,3271,1,24,7,5,62,35,27,79
Peterhead,3271,2,24,4,8,79,39,40,76
Stenhousem'r,3271,3,16,8,12,58,48,10,56
Stirling,3271,4,16,6,14,62,54,8,54
Clyde,3271,5,15,9,12,55,50,5,54
Elgin,3271,6,14,6,16,54,63,-9,48
Annan Athlet,3271,7,12,11,13,49,42,7,47
Berwick,3271,8,8,10,18,31,62,-31,34
Edinburgh Ci,3271,9,7,9,20,37,62,-25,30
Cowdenbeath,3271,10,4,10,22,24,56,-32,22
Montrose,3272,1,24,7,5,63,34,29,79
Peterhead,3272,2,24,4,8,80,39,41,76
Stenhousem'r,3272,3,16,8,12,57,47,10,56
Stirling,3272,4,16,6,14,61,53,8,54
Clyde,3272,5,14,10,12,53,50,3,52
Elgin,3272,6,14,6,16,53,64,-11,48
Annan Athlet,3272,7,11,12,13,48,42,6,45
Berwick,3272,8,8,11,17,31,60,-29,35
Edinburgh Ci,3272,9,7,9,20,37,63,-26,30
Cowdenbeath,3272,10,4,11,21,24,55,-31,23
Peterhead,3273,1,24,4,8,79,39,40,76
Montrose,3273,2,23,7,6,59,36,23,76
Stirling,3273,3,16,7,13,61,52,9,55
Stenhousem'r,3273,4,15,9,12,56,47,9,54
Clyde,3273,5,15,9,12,53,48,5,54
Elgin,3273,6,15,6,15,55,60,-5,51
Annan Athlet,3273,7,11,12,13,48,42,6,45
Berwick,3273,8,8,10,18,29,60,-31,34
Edinburgh Ci,3273,9,7,9,20,37,62,-25,30
Cowdenbeath,3273,10,4,11,21,24,55,-31,23
Montrose,3274,1,24,7,5,63,35,28,79
Peterhead,3274,2,24,4,8,79,39,40,76
Stirling,3274,3,17,6,13,63,52,11,57
Clyde,3274,4,15,9,12,56,49,7,54
Stenhousem'r,3274,5,15,8,13,56,49,7,53
Elgin,3274,6,14,6,16,54,64,-10,48
Annan Athlet,3274,7,12,11,13,51,42,9,47
Berwick,3274,8,8,10,18,30,63,-33,34
Edinburgh Ci,3274,9,7,9,20,37,62,-25,30
Cowdenbeath,3274,10,4,10,22,24,58,-34,22
Montrose,3275,1,24,7,5,61,34,27,79
Peterhead,3275,2,23,4,9,79,42,37,73
Stirling,3275,3,17,6,13,61,51,10,57
Stenhousem'r,3275,4,15,8,13,55,47,8,53
Clyde,3275,5,14,9,13,51,49,2,51
Elgin,3275,6,14,6,16,53,62,-9,48
Annan Athlet,3275,7,12,11,13,48,41,7,47
Berwick,3275,8,9,10,17,30,58,-28,37
Edinburgh Ci,3275,9,8,9,19,40,62,-22,33
Cowdenbeath,3275,10,4,10,22,23,55,-32,22
Montrose,3276,1,24,7,5,60,34,26,79
Peterhead,3276,2,24,4,8,80,38,42,76
Stirling,3276,3,17,6,13,62,51,11,57
Stenhousem'r,3276,4,15,8,13,55,48,7,53
Clyde,3276,5,14,9,13,53,51,2,51
Elgin,3276,6,14,6,16,53,61,-8,48
Annan Athlet,3276,7,12,11,13,49,41,8,47
Berwick,3276,8,9,10,17,32,60,-28,37
Edinburgh Ci,3276,9,7,9,20,36,63,-27,30
Cowdenbeath,3276,10,4,10,22,23,56,-33,22
Montrose,3277,1,24,7,5,63,35,28,79
Peterhead,3277,2,23,5,8,79,40,39,74
Stenhousem'r,3277,3,16,8,12,57,47,10,56
Stirling,3277,4,16,6,14,61,53,8,54
Clyde,3277,5,15,9,12,53,48,5,54
Elgin,3277,6,14,6,16,54,64,-10,48
Annan Athlet,3277,7,12,11,13,49,42,7,47
Berwick,3277,8,8,10,18,29,60,-31,34
Edinburgh Ci,3277,9,7,10,19,38,62,-24,31
Cowdenbeath,3277,10,4,10,22,24,56,-32,22
Montrose,3278,1,23,8,5,60,35,25,77
Peterhead,3278,2,24,4,8,80,38,42,76
Stirling,3278,3,17,6,13,62,51,11,57
Stenhousem'r,3278,4,15,8,13,55,48,7,53
Clyde,3278,5,14,10,12,53,50,3,52
Elgin,3278,6,14,7,15,54,61,-7,49
Annan Athlet,3278,7,11,12,13,48,42,6,45
Berwick,3278,8,8,11,17,31,60,-29,35
Edinburgh Ci,3278,9,7,9,20,36,63,-27,30
Cowdenbeath,3278,10,4,11,21,24,55,-31,23
Montrose,3279,1,24,7,5,61,35,26,79
Peterhead,3279,2,24,4,8,84,38,46,76
Stirling,3279,3,17,6,13,64,52,12,57
Clyde,3279,4,15,9,12,54,50,4,54
Stenhousem'r,3279,5,15,8,13,56,50,6,53
Elgin,3279,6,14,6,16,54,62,-8,48
Annan Athlet,3279,7,11,11,14,47,43,4,44
Berwick,3279,8,8,10,18,31,61,-30,34
Edinburgh Ci,3279,9,7,9,20,36,67,-31,30
Cowdenbeath,3279,10,5,10,21,25,54,-29,25
Montrose,3280,1,23,8,5,60,35,25,77
Peterhead,3280,2,23,5,8,79,40,39,74
Stenhousem'r,3280,3,16,8,12,58,47,11,56
Stirling,3280,4,16,6,14,61,54,7,54
Clyde,3280,5,14,10,12,51,48,3,52
Elgin,3280,6,14,7,15,54,61,-7,49
Annan Athlet,3280,7,11,11,14,47,42,5,44
Berwick,3280,8,8,11,17,29,58,-29,35
Edinburgh Ci,3280,9,7,10,19,38,62,-24,31
Cowdenbeath,3280,10,5,10,21,24,54,-30,25
Montrose,3281,1,24,7,5,61,34,27,79
Peterhead,3281,2,24,4,8,83,39,44,76
Stirling,3281,3,17,6,13,63,53,10,57
Stenhousem'r,3281,4,15,8,13,57,49,8,53
Clyde,3281,5,14,10,12,53,50,3,52
Elgin,3281,6,14,6,16,53,62,-9,48
Annan Athlet,3281,7,12,11,13,49,41,8,47
Berwick,3281,8,8,11,17,31,60,-29,35
Edinburgh Ci,3281,9,7,9,20,37,66,-29,30
Cowdenbeath,3281,10,4,10,22,23,56,-33,22
Montrose,3282,1,23,8,5,61,36,25,77
Peterhead,3282,2,24,4,8,78,38,40,76
Stirling,3282,3,17,6,13,61,51,10,57
Stenhousem'r,3282,4,15,8,13,55,47,8,53
Clyde,3282,5,14,9,13,52,50,2,51
Elgin,3282,6,14,7,15,55,62,-7,49
Annan Athlet,3282,7,12,11,13,50,41,9,47
Berwick,3282,8,9,10,17,31,59,-28,37
Edinburgh Ci,3282,9,7,9,20,36,61,-25,30
Cowdenbeath,3282,10,4,10,22,23,57,-34,22
Montrose,3283,1,23,7,6,60,36,24,76
Peterhead,3283,2,23,5,8,77,38,39,74
Stirling,3283,3,17,6,13,62,51,11,57
Clyde,3283,4,15,9,12,53,48,5,54
Stenhousem'r,3283,5,15,8,13,55,48,7,53
Elgin,3283,6,15,6,15,55,61,-6,51
Annan Athlet,3283,7,12,11,13,50,42,8,47
Berwick,3283,8,8,10,18,29,60,-31,34
Edinburgh Ci,3283,9,7,10,19,36,60,-24,31
Cowdenbeath,3283,10,4,10,22,24,57,-33,22
Montrose,3284,1,23,8,5,60,35,25,77
Peterhead,3284,2,23,4,9,77,40,37,73
Stirling,3284,3,17,6,13,62,52,10,57
Clyde,3284,4,15,9,12,53,48,5,54
Stenhousem'r,3284,5,15,8,13,56,48,8,53
Elgin,3284,6,14,7,15,54,61,-7,49
Annan Athlet,3284,7,11,11,14,47,44,3,44
Berwick,3284,8,8,10,18,29,60,-31,34
Edinburgh Ci,3284,9,8,9,19,38,60,-22,33
Cowdenbeath,3284,10,5,10,21,26,54,-28,25
Peterhead,3285,1,24,4,8,79,39,40,76
Montrose,3285,2,23,7,6,59,35,24,76
Stirling,3285,3,16,7,13,61,52,9,55
Stenhousem'r,3285,4,15,9,12,56,47,9,54
Clyde,3285,5,15,9,12,52,48,4,54
Elgin,3285,6,15,6,15,54,60,-6,51
Annan Athlet,3285,7,12,11,13,49,41,8,47
Berwick,3285,8,8,10,18,29,59,-30,34
Edinburgh Ci,3285,9,7,9,20,37,62,-25,30
Cowdenbeath,3285,10,4,10,22,23,56,-33,22
Montrose,3286,1,24,7,5,60,34,26,79
Peterhead,3286,2,23,5,8,79,40,39,74
Stirling,3286,3,17,6,13,62,51,11,57
Stenhousem'r,3286,4,15,8,13,55,48,7,53
Clyde,3286,5,14,10,12,52,49,3,52
Elgin,3286,6,14,6,16,53,61,-8,48
Annan Athlet,3286,7,11,11,14,47,43,4,44
Berwick,3286,8,8,11,17,30,59,-29,35
Edinburgh Ci,3286,9,7,10,19,38,62,-24,31
Cowdenbeath,3286,10,5,10,21,25,54,-29,25
Montrose,3287,1,24,7,5,62,35,27,79
Peterhead,3287,2,23,5,8,78,39,39,74
Stirling,3287,3,16,7,13,61,52,9,55
Stenhousem'r,3287,4,15,9,12,56,47,9,54
Clyde,3287,5,14,10,12,51,48,3,52
Elgin,3287,6,14,6,16,54,63,-9,48
Annan Athlet,3287,7,11,12,13,47,41,6,45
Berwick,3287,8,8,11,17,29,58,-29,35
Edinburgh Ci,3287,9,7,10,19,37,61,-24,31
Cowdenbeath,3287,10,4,11,21,23,54,-31,23
Montrose,3288,1,24,7,5,61,34,27,79
Peterhead,3288,2,24,4,8,79,39,40,76
Stirling,3288,3,17,6,13,65,52,13,57
Clyde,3288,4,15,9,12,55,50,5,54
Stenhousem'r,3288,5,15,8,13,56,51,5,53
Elgin,3288,6,14,6,16,53,62,-9,48
Annan Athlet,3288,7,12,11,13,49,42,7,47
Berwick,3288,8,8,10,18,31,62,-31,34
Edinburgh Ci,3288,9,7,9,20,37,62,-25,30
Cowdenbeath,3288,10,4,10,22,24,56,-32,22
Montrose,3289,1,24,7,5,62,35,27,79
Peterhead,3289,2,23,5,8,78,39,39,74
Stirling,3289,3,17,6,13,62,52,10,57
Stenhousem'r,3289,4,15,8,13,56,48,8,53
Clyde,3289,5,14,10,12,51,48,3,52
Elgin,3289,6,14,6,16,54,63,-9,48
Annan Athlet,3289,7,11,12,13,49,43,6,45
Berwick,3289,8,8,11,17,29,58,-29,35
Edinburgh Ci,3289,9,7,10,19,37,61,-24,31
Cowdenbeath,3289,10,4,11,21,25,56,-31,23
Montrose,3290,1,24,7,5,61,34,27,79
Peterhead,3290,2,23,4,9,77,39,38,73
Stirling,3290,3,16,7,13,60,51,9,55
Stenhousem'r,3290,4,15,9,12,55,46,9,54
Clyde,3290,5,14,10,12,53,50,3,52
Elgin,3290,6,14,6,16,53,62,-9,48
Annan Athlet,3290,7,12,11,13,49,42,7,47
Berwick,3290,8,8,11,17,31,60,-29,35
Edinburgh Ci,3290,9,8,9,19,37,60,-23,33
Cowdenbeath,3290,10,4,10,22,24,56,-32,22
Montrose,3291,1,24,7,5,62,34,28,79
Peterhead,3291,2,24,4,8,81,39,42,76
Stenhousem'r,3291,3,16,8,12,56,46,10,56
Stirling,3291,4,16,6,14,60,52,8,54
Clyde,3291,5,14,9,13,51,49,2,51
Elgin,3291,6,14,6,16,53,63,-10,48
Annan Athlet,3291,7,11,12,13,48,42,6,45
Berwick,3291,8,9,10,17,30,58,-28,37
Edinburgh Ci,3291,9,7,9,20,37,64,-27,30
Cowdenbeath,3291,10,4,11,21,24,55,-31,23
Peterhead,3292,1,24,4,8,79,39,40,76
Montrose,3292,2,23,7,6,59,36,23,76
Stenhousem'r,3292,3,16,8,12,57,47,10,56
Stirling,3292,4,16,6,14,61,53,8,54
Clyde,3292,5,14,9,13,51,50,1,51
Elgin,3292,6,15,6,15,55,60,-5,51
Annan Athlet,3292,7,11,11,14,47,43,4,44
Berwick,3292,8,9,10,17,31,58,-27,37
Edinburgh Ci,3292,9,7,9,20,37,62,-25,30
Cowdenbeath,3292,10,5,10,21,25,54,-29,25
Montrose,3293,1,24,7,5,61,35,26,79
Peterhead,3293,2,24,4,8,78,38,40,76
Stenhousem'r,3293,3,16,8,12,57,46,11,56
Stirling,3293,4,16,6,14,60,53,7,54
Clyde,3293,5,14,9,13,51,49,2,51
Elgin,3293,6,14,6,16,54,62,-8,48
Annan Athlet,3293,7,12,11,13,49,42,7,47
Berwick,3293,8,9,10,17,30,58,-28,37
Edinburgh Ci,3293,9,7,9,20,36,61,-25,30
Cowdenbeath,3293,10,4,10,22,24,56,-32,22
Montrose,3294,1,24,7,5,62,34,28,79
Peterhead,3294,2,24,4,8,79,39,40,76
Stenhousem'r,3294,3,16,8,12,57,47,10,56
Stirling,3294,4,16,6,14,61,53,8,54
Clyde,3294,5,15,9,12,54,49,5,54
Elgin,3294,6,14,6,16,53,63,-10,48
Annan Athlet,3294,7,11,12,13,48,42,6,45
Berwick,3294,8,8,10,18,30,61,-31,34
Edinburgh Ci,3294,9,7,9,20,37,62,-25,30
Cowdenbeath,3294,10,4,11,21,24,55,-31,23
Peterhead,3295,1,24,4,8,80,38,42,76
Montrose,3295,2,23,7,6,60,36,24,76
Stirling,3295,3,17,6,13,63,53,10,57
Clyde,3295,4,15,9,12,53,49,4,54
Stenhousem'r,3295,5,15,8,13,57,49,8,53
Elgin,3295,6,15,6,15,55,61,-6,51
Annan Athlet,3295,7,11,12,13,48,42,6,45
Berwick,3295,8,8,10,18,30,60,-30,34
Edinburgh Ci,3295,9,7,9,20,36,63,-27,30
Cowdenbeath,3295,10,4,11,21,24,55,-31,23
Montrose,3296,1,24,7,5,64,36,28,79
Peterhead,3296,2,23,5,8,79,40,39,74
Stenhousem'r,3296,3,16,8,12,57,47,10,56
Stirling,3296,4,16,6,14,61,53,8,54
Clyde,3296,5,15,9,12,54,49,5,54
Elgin,3296,6,14,6,16,55,65,-10,48
Annan Athlet,3296,7,11,11,14,47,42,5,44
Berwick,3296,8,8,10,18,30,61,-31,34
Edinburgh Ci,3296,9,7,10,19,38,62,-24,31
Cowdenbeath,3296,10,5,10,21,24,54,-30,25
Peterhead,3297,1,24,4,8,78,38,40,76
Montrose,3297,2,23,7,6,60,36,24,76
Stirling,3297,3,17,6,13,62,52,10,57
Stenhousem'r,3297,4,15,8,13,56,48,8,53
Clyde,3297,5,14,9,13,51,52,-1,51
Elgin,3297,6,15,6,15,55,61,-6,51
Annan Athlet,3297,7,11,11,14,47,42,5,44
Berwick,3297,8,9,10,17,33,58,-25,37
Edinburgh Ci,3297,9,7,9,20,36,61,-25,30
Cowdenbeath,3297,10,5,10,21,24,54,-30,25
Montrose,3298,1,24,7,5,62,34,28,79
Peterhead,3298,2,24,4,8,78,38,40,76
Stirling,3298,3,16,7,13,60,51,9,55
Stenhousem'r,3298,4,15,9,12,55,46,9,54
Clyde,3298,5,14,10,12,52,49,3,52
Elgin,3298,6,14,6,16,53,63,-10,48
Annan Athlet,3298,7,11,12,13,48,42,6,45
Berwick,3298,8,8,11,17,30,59,-29,35
Edinburgh Ci,3298,9,7,9,20,36,61,-25,30
Cowdenbeath,3298,10,4,11,21,24,55,-31,23
Montrose,3299,1,24,7,5,61,34,27,79
Peterhead,3299,2,24,4,8,80,39,41,76
Stenhousem'r,3299,3,16,8,12,59,48,11,56
Stirling,3299,4,16,6,14,62,55,7,54
Clyde,3299,5,15,9,12,53,48,5,54
Elgin,3299,6,14,6,16,53,62,-9,48
Annan Athlet,3299,7,11,12,13,48,42,6,45
Berwick,3299,8,8,10,18,29,60,-31,34
Edinburgh Ci,3299,9,7,9,20,37,63,-26,30
Cowdenbeath,3299,10,4,11,21,24,55,-31,23
Montrose,3300,1,23,7,6,60,36,24,76
Peterhead,3300,2,23,5,8,78,39,39,74
Stirling,3300,3,17,6,13,62,52,10,57
Clyde,3300,4,15,9,12,53,48,5,54
Stenhousem'r,3300,5,15,8,13,56,48,8,53
Elgin,3300,6,15,6,15,55,61,-6,51
Annan Athlet,3300,7,11,11,14,47,42,5,44
Berwick,3300,8,8,10,18,29,60,-31,34
Edinburgh Ci,3300,9,7,10,19,37,61,-24,31
Cowdenbeath,3300,10,5,10,21,24,54,-30,25
Montrose,3301,1,24,7,5,60,34,26,79
Peterhead,3301,2,24,4,8,79,38,41,76
Stenhousem'r,3301,3,16,8,12,56,46,10,56
Stirling,3301,4,16,6,14,60,52,8,54
Clyde,3301,5,15,9,12,53,48,5,54
Elgin,3301,6,14,6,16,53,61,-8,48
Annan Athlet,3301,7,11,11,14,48,45,3,44
Berwick,3301,8,8,10,18,29,60,-31,34
Edinburgh Ci,3301,9,7,9,20,36,62,-26,30
Cowdenbeath,3301,10,5,10,21,27,55,-28,25
Montrose,3302,1,23,8,5,60,35,25,77
Peterhead,3302,2,24,4,8,79,38,41,76
Stirling,3302,3,17,6,13,62,52,10,57
Clyde,3302,4,15,9,12,54,48,6,54
Stenhousem'r,3302,5,15,8,13,56,48,8,53
Elgin,3302,6,14,7,15,54,61,-7,49
Annan Athlet,3302,7,12,11,13,51,41,10,47
Berwick,3302,8,8,10,18,29,61,-32,34
Edinburgh Ci,3302,9,7,9,20,36,62,-26,30
Cowdenbeath,3302,10,4,10,22,23,58,-35,22
Montrose,3303,1,24,7,5,61,35,26,79
Peterhead,3303,2,24,4,8,82,38,44,76
Stirling,3303,3,16,7,13,61,52,9,55
Stenhousem'r,3303,4,15,9,12,56,47,9,54
Clyde,3303,5,14,10,12,53,50,3,52
Elgin,3303,6,14,6,16,54,62,-8,48
Annan Athlet,3303,7,12,11,13,49,41,8,47
Berwick,3303,8,8,11,17,31,60,-29,35
Edinburgh Ci,3303,9,7,9,20,36,65,-29,30
Cowdenbeath,3303,10,4,10,22,23,56,-33,22
Montrose,3304,1,24,7,5,61,35,26,79
Peterhead,3304,2,23,4,9,78,42,36,73
Stirling,3304,3,17,6,13,62,52,10,57
Stenhousem'r,3304,4,15,8,13,56,48,8,53
Clyde,3304,5,14,9,13,51,52,-1,51
Elgin,3304,6,14,6,16,54,62,-8,48
Annan Athlet,3304,7,11,12,13,48,42,6,45
Berwick,3304,8,9,10,17,33,58,-25,37
Edinburgh Ci,3304,9,8,9,19,40,61,-21,33
Cowdenbeath,3304,10,4,11,21,24,55,-31,23
Montrose,3305,1,23,8,5,61,36,25,77
Peterhead,3305,2,24,4,8,80,38,42,76
Stenhousem'r,3305,3,16,8,12,56,46,10,56
Stirling,3305,4,16,6,14,60,52,8,54
Clyde,3305,5,15,9,12,54,49,5,54
Elgin,3305,6,14,7,15,55,62,-7,49
Annan Athlet,3305,7,11,12,13,47,41,6,45
Berwick,3305,8,8,10,18,30,61,-31,34
Edinburgh Ci,3305,9,7,9,20,36,63,-27,30
Cowdenbeath,3305,10,4,11,21,23,54,-31,23
Montrose,3306,1,23,8,5,61,36,25,77
Peterhead,3306,2,24,4,8,79,39,40,76
Stirling,3306,3,16,7,13,62,53,9,55
Stenhousem'r,3306,4,15,9,12,57,48,9,54
Clyde,3306,5,15,9,12,53,48,5,54
Elgin,3306,6,14,7,15,55,62,-7,49
Annan Athlet,3306,7,11,12,13,48,42,6,45
Berwick,3306,8,8,10,18,29,60,-31,34
Edinburgh Ci,3306,9,7,9,20,37,62,-25,30
Cowdenbeath,3306,10,4,11,21,24,55,-31,23
Peterhead,3307,1,24,4,8,82,39,43,76
Montrose,3307,2,23,7,6,60,36,24,76
Stenhousem'r,3307,3,16,8,12,57,46,11,56
Stirling,3307,4,16,6,14,60,53,7,54
Clyde,3307,5,15,9,12,52,48,4,54
Elgin,3307,6,15,6,15,55,61,-6,51
Annan Athlet,3307,7,11,12,13,47,41,6,45
Berwick,3307,8,8,10,18,29,59,-30,34
Edinburgh Ci,3307,9,7,9,20,37,65,-28,30
Cowdenbeath,3307,10,4,11,21,23,54,-31,23
Montrose,3308,1,24,7,5,60,34,26,79
Peterhead,3308,2,23,4,9,77,40,37,73
Stenhousem'r,3308,3,16,8,12,57,46,11,56
Stirling,3308,4,16,6,14,60,53,7,54
Clyde,3308,5,14,10,12,52,49,3,52
Elgin,3308,6,14,6,16,53,61,-8,48
Annan Athlet,3308,7,11,12,13,48,42,6,45
Berwick,3308,8,8,11,17,30,59,-29,35
Edinburgh Ci,3308,9,8,9,19,38,60,-22,33
Cowdenbeath,3308,10,4,11,21,24,55,-31,23
Montrose,3309,1,24,7,5,63,34,29,79
Peterhead,3309,2,24,4,8,79,39,40,76
Stenhousem'r,3309,3,16,8,12,57,47,10,56
Stirling,3309,4,16,6,14,61,53,8,54
Clyde,3309,5,14,9,13,52,50,2,51
Elgin,3309,6,14,6,16,53,64,-11,48
Annan Athlet,3309,7,11,11,14,47,42,5,44
Berwick,3309,8,9,10,17,31,59,-28,37
Edinburgh Ci,3309,9,7,9,20,37,62,-25,30
Cowdenbeath,3309,10,5,10,21,24,54,-30,25
Montrose,3310,1,23,7,6,60,38,22,76
Peterhead,3310,2,23,5,8,78,39,39,74
Stenhousem'r,3310,3,16,8,12,59,48,11,56
Stirling,3310,4,16,6,14,62,55,7,54
Clyde,3310,5,14,10,12,52,49,3,52
Elgin,3310,6,15,6,15,57,61,-4,51
Annan Athlet,3310,7,11,11,14,47,43,4,44
Berwick,3310,8,8,11,17,30,59,-29,35
Edinburgh Ci,3310,9,7,10,19,37,61,-24,31
Cowdenbeath,3310,10,5,10,21,25,54,-29,25
Montrose,3311,1,24,7,5,61,35,26,79
Peterhead,3311,2,24,4,8,82,39,43,76
Stirling,3311,3,17,6,13,62,52,10,57
Clyde,3311,4,15,9,12,54,49,5,54
Stenhousem'r,3311,5,15,8,13,56,48,8,53
Elgin,3311,6,14,6,16,54,62,-8,48
Annan Athlet,3311,7,12,11,13,48,41,7,47
Berwick,3311,8,8,10,18,30,61,-31,34
Edinburgh Ci,3311,9,7,9,20,37,65,-28,30
Cowdenbeath,3311,10,4,10,22,23,55,-32,22
Peterhead,3312,1,24,4,8,79,39,40,76
Montrose,3312,2,23,7,6,59,36,23,76
Stenhousem'r,3312,3,16,8,12,57,47,10,56
Stirling,3312,4,16,6,14,61,53,8,54
Clyde,3312,5,15,9,12,52,48,4,54
Elgin,3312,6,15,6,15,55,60,-5,51
Annan Athlet,3312,7,11,11,14,48,45,3,44
Berwick,3312,8,8,10,18,29,59,-30,34
Edinburgh Ci,3312,9,7,9,20,37,62,-25,30
Cowdenbeath,3312,10,5,10,21,27,55,-28,25
Peterhead,3313,1,24,4,8,79,38,41,76
Montrose,3313,2,23,7,6,59,36,23,76
Stenhousem'r,3313,3,16,8,12,57,47,10,56
Stirling,3313,4,16,6,14,61,53,8,54
Clyde,3313,5,14,10,12,52,49,3,52
Elgin,3313,6,15,6,15,55,60,-5,51
Annan Athlet,3313,7,11,12,13,48,42,6,45
Berwick,3313,8,8,11,17,30,59,-29,35
Edinburgh Ci,3313,9,7,9,20,36,62,-26,30
Cowdenbeath,3313,10,4,11,21,24,55,-31,23
Montrose,3314,1,23,8,5,61,36,25,77
Peterhead,3314,2,24,4,8,80,39,41,76
Stirling,3314,3,16,7,13,62,53,9,55
Stenhousem'r,3314,4,15,9,12,57,48,9,54
Clyde,3314,5,15,9,12,53,49,4,54
Elgin,3314,6,14,7,15,55,62,-7,49
Annan Athlet,3314,7,12,11,13,49,42,7,47
Berwick,3314,8,8,10,18,30,60,-30,34
Edinburgh Ci,3314,9,7,9,20,37,63,-26,30
Cowdenbeath,3314,10,4,10,22,24,56,-32,22
Montrose,3315,1,24,7,5,60,34,26,79
Peterhead,3315,2,24,4,8,79,38,41,76
Stirling,3315,3,17,6,13,61,51,10,57
Stenhousem'r,3315,4,15,8,13,55,47,8,53
Clyde,3315,5,14,10,12,52,49,3,52
Elgin,3315,6,14,6,16,53,61,-8,48
Annan Athlet,3315,7,12,11,13,48,41,7,47
Berwick,3315,8,8,11,17,30,59,-29,35
Edinburgh Ci,3315,9,7,9,20,36,62,-26,30
Cowdenbeath,3315,10,4,10,22,23,55,-32,22
Montrose,3316,1,24,7,5,61,34,27,79
Peterhead,3316,2,24,4,8,79,38,41,76
Stirling,3316,3,17,6,13,63,51,12,57
Clyde,3316,4,15,9,12,54,49,5,54
Stenhousem'r,3316,5,15,8,13,55,49,6,53
Elgin,3316,6,14,6,16,53,62,-9,48
Annan Athlet,3316,7,12,11,13,48,41,7,47
Berwick,3316,8,8,10,18,30,61,-31,34
Edinburgh Ci,3316,9,7,9,20,36,62,-26,30
Cowdenbeath,3316,10,4,10,22,23,55,-32,22
Montrose,3317,1,24,7,5,60,34,26,79
Peterhead,3317,2,24,4,8,80,39,41,76
Stirling,3317,3,16,7,13,61,52,9,55
Stenhousem'r,3317,4,15,9,12,56,47,9,54
Clyde,3317,5,15,9,12,52,48,4,54
Elgin,3317,6,14,6,16,53,61,-8,48
Annan Athlet,3317,7,12,11,13,52,43,9,47
Berwick,3317,8,8,10,18,29,59,-30,34
Edinburgh Ci,3317,9,7,9,20,37,63,-26,30
Cowdenbeath,3317,10,4,10,22,25,59,-34,22
Montrose,3318,1,24,7,5,62,34,28,79
Peterhead,3318,2,24,4,8,81,38,43,76
Stirling,3318,3,17,6,13,61,51,10,57
Clyde,3318,4,15,9,12,54,49,5,54
Stenhousem'r,3318,5,15,8,13,55,47,8,53
Elgin,3318,6,14,6,16,53,63,-10,48
Annan Athlet,3318,7,11,11,14,47,43,4,44
Berwick,3318,8,8,10,18,30,61,-31,34
Edinburgh Ci,3318,9,7,9,20,36,64,-28,30
Cowdenbeath,3318,10,5,10,21,25,54,-29,25
Montrose,3319,1,24,7,5,60,34,26,79
Peterhead,3319,2,24,4,8,83,39,44,76
Stirling,3319,3,17,6,13,62,51,11,57
Clyde,3319,4,15,9,12,53,48,5,54
Stenhousem'r,3319,5,15,8,13,55,48,7,53
Elgin,3319,6,14,6,16,53,61,-8,48
Annan Athlet,3319,7,12,11,13,48,41,7,47
Berwick,3319,8,8,10,18,29,60,-31,34
Edinburgh Ci,3319,9,7,9,20,37,66,-29,30
Cowdenbeath,3319,10,4,10,22,23,55,-32,22
Montrose,3320,1,23,8,5,62,37,25,77
Peterhead,3320,2,24,4,8,80,38,42,76
Stenhousem'r,3320,3,16,8,12,57,47,10,56
Stirling,3320,4,16,6,14,61,53,8,54
Clyde,3320,5,14,10,12,52,49,3,52
Elgin,3320,6,14,7,15,56,63,-7,49
Annan Athlet,3320,7,11,12,13,48,42,6,45
Berwick,3320,8,8,11,17,30,59,-29,35
Edinburgh Ci,3320,9,7,9,20,36,63,-27,30
Cowdenbeath,3320,10,4,11,21,24,55,-31,23
Montrose,3321,1,24,7,5,62,35,27,79
Peterhead,3321,2,24,4,8,82,38,44,76
Stirling,3321,3,17,6,13,64,53,11,57
Stenhousem'r,3321,4,15,8,13,57,50,7,53
Clyde,3321,5,14,9,13,51,50,1,51
Elgin,3321,6,14,6,16,54,63,-9,48
Annan Athlet,3321,7,11,11,14,48,43,5,44
Berwick,3321,8,9,10,17,31,58,-27,37
Edinburgh Ci,3321,9,7,9,20,36,65,-29,30
Cowdenbeath,3321,10,5,10,21,25,55,-30,25
Montrose,3322,1,24,7,5,60,34,26,79
Peterhead,3322,2,24,4,8,79,38,41,76
Stirling,3322,3,16,7,13,62,53,9,55
Stenhousem'r,3322,4,15,9,12,57,48,9,54
Clyde,3322,5,15,9,12,53,49,4,54
Elgin,3322,6,14,6,16,53,61,-8,48
Annan Athlet,3322,7,12,11,13,48,41,7,47
Berwick,3322,8,8,10,18,30,60,-30,34
Edinburgh Ci,3322,9,7,9,20,36,62,-26,30
Cowdenbeath,3322,10,4,10,22,23,55,-32,22
Montrose,3323,1,24,7,5,64,34,30,79
Peterhead,3323,2,23,5,8,77,38,39,74
Stenhousem'r,3323,3,16,8,12,57,47,10,56
Stirling,3323,4,16,6,14,61,53,8,54
Clyde,3323,5,15,9,12,53,49,4,54
Elgin,3323,6,14,6,16,53,65,-12,48
Annan Athlet,3323,7,12,11,13,48,41,7,47
Berwick,3323,8,8,10,18,30,60,-30,34
Edinburgh Ci,3323,9,7,10,19,36,60,-24,31
Cowdenbeath,3323,10,4,10,22,23,55,-32,22
Montrose,3324,1,23,8,5,61,36,25,77
Peterhead,3324,2,24,4,8,80,38,42,76
Stirling,3324,3,17,6,13,61,51,10,57
Clyde,3324,4,15,9,12,52,48,4,54
Stenhousem'r,3324,5,15,8,13,55,47,8,53
Elgin,3324,6,14,7,15,55,62,-7,49
Annan Athlet,3324,7,11,11,14,47,43,4,44
Berwick,3324,8,8,10,18,29,59,-30,34
Edinburgh Ci,3324,9,7,9,20,36,63,-27,30
Cowdenbeath,3324,10,5,10,21,25,54,-29,25
Montrose,3325,1,23,8,5,60,35,25,77
Peterhead,3325,2,24,4,8,79,39,40,76
Stirling,3325,3,16,7,13,61,52,9,55
Stenhousem'r,3325,4,15,9,12,56,47,9,54
Clyde,3325,5,15,9,12,54,48,6,54
Elgin,3325,6,14,7,15,54,61,-7,49
Annan Athlet,3325,7,11,12,13,48,42,6,45
Berwick,3325,8,8,10,18,29,61,-32,34
Edinburgh Ci,3325,9,7,9,20,37,62,-25,30
Cowdenbeath,3325,10,4,11,21,24,55,-31,23
Montrose,3326,1,23,8,5,59,34,25,77
Peterhead,3326,2,24,4,8,82,38,44,76
Stirling,3326,3,17,6,13,61,51,10,57
Clyde,3326,4,15,9,12,56,51,5,54
Stenhousem'r,3326,5,15,8,13,55,47,8,53
Elgin,3326,6,14,7,15,53,60,-7,49
Annan Athlet,3326,7,11,12,13,49,43,6,45
Berwick,3326,8,8,10,18,32,63,-31,34
Edinburgh Ci,3326,9,7,9,20,36,65,-29,30
Cowdenbeath,3326,10,4,11,21,25,56,-31,23
Montrose,3327,1,23,8,5,60,35,25,77
Peterhead,3327,2,23,5,8,79,40,39,74
Stirling,3327,3,16,7,13,60,51,9,55
Stenhousem'r,3327,4,15,9,12,55,46,9,54
Clyde,3327,5,15,9,12,54,49,5,54
Elgin,3327,6,14,7,15,54,61,-7,49
Annan Athlet,3327,7,11,12,13,48,42,6,45
Berwick,3327,8,8,10,18,30,61,-31,34
Edinburgh Ci,3327,9,7,10,19,38,62,-24,31
Cowdenbeath,3327,10,4,11,21,24,55,-31,23
Montrose,3328,1,24,7,5,62,34,28,79
Peterhead,3328,2,24,4,8,81,40,41,76
Stirling,3328,3,16,7,13,60,51,9,55
Stenhousem'r,3328,4,15,9,12,55,46,9,54
Clyde,3328,5,15,9,12,53,49,4,54
Elgin,3328,6,14,6,16,53,63,-10,48
Annan Athlet,3328,7,12,11,13,48,41,7,47
Berwick,3328,8,8,10,18,30,60,-30,34
Edinburgh Ci,3328,9,7,9,20,38,64,-26,30
Cowdenbeath,3328,10,4,10,22,23,55,-32,22
Montrose,3329,1,24,7,5,62,34,28,79
Peterhead,3329,2,24,4,8,78,38,40,76
Stenhousem'r,3329,3,16,8,12,57,47,10,56
Stirling,3329,4,16,6,14,61,53,8,54
Clyde,3329,5,14,9,13,52,50,2,51
Elgin,3329,6,14,6,16,53,63,-10,48
Annan Athlet,3329,7,11,11,14,47,43,4,44
Berwick,3329,8,9,10,17,31,59,-28,37
Edinburgh Ci,3329,9,7,9,20,36,61,-25,30
Cowdenbeath,3329,10,5,10,21,25,54,-29,25
Montrose,3330,1,24,7,5,61,34,27,79
Peterhead,3330,2,24,4,8,79,38,41,76
Stenhousem'r,3330,3,16,8,12,57,46,11,56
Stirling,3330,4,16,6,14,60,53,7,54
Clyde,3330,5,14,9,13,52,50,2,51
Elgin,3330,6,14,6,16,53,62,-9,48
Annan Athlet,3330,7,11,11,14,48,45,3,44
Berwick,3330,8,9,10,17,31,59,-28,37
Edinburgh Ci,3330,9,7,9,20,36,62,-26,30
Cowdenbeath,3330,10,5,10,21,27,55,-28,25
Montrose,3331,1,24,7,5,61,35,26,79
Peterhead,3331,2,23,5,8,78,39,39,74
Stenhousem'r,3331,3,16,8,12,58,48,10,56
Stirling,3331,4,16,6,14,62,54,8,54
Clyde,3331,5,15,9,12,53,49,4,54
Elgin,3331,6,14,6,16,54,62,-8,48
Annan Athlet,3331,7,12,11,13,48,41,7,47
Berwick,3331,8,8,10,18,30,60,-30,34
Edinburgh Ci,3331,9,7,10,19,37,61,-24,31
Cowdenbeath,3331,10,4,10,22,23,55,-32,22
Montrose,3332,1,24,7,5,62,35,27,79
Peterhead,3332,2,24,4,8,78,38,40,76
Stirling,3332,3,17,6,13,63,51,12,57
Clyde,3332,4,15,9,12,52,48,4,54
Stenhousem'r,3332,5,15,8,13,55,49,6,53
Elgin,3332,6,14,6,16,54,63,-9,48
Annan Athlet,3332,7,11,12,13,49,43,6,45
Berwick,3332,8,8,10,18,29,59,-30,34
Edinburgh Ci,3332,9,7,9,20,36,61,-25,30
Cowdenbeath,3332,10,4,11,21,25,56,-31,23
Montrose,3333,1,24,7,5,63,37,26,79
Peterhead,3333,2,24,4,8,80,38,42,76
Stirling,3333,3,17,6,13,63,53,10,57
Stenhousem'r,3333,4,15,8,13,57,49,8,53
Clyde,3333,5,14,9,13,51,49,2,51
Elgin,3333,6,14,6,16,56,64,-8,48
Annan Athlet,3333,7,11,12,13,49,43,6,45
Berwick,3333,8,9,10,17,30,58,-28,37
Edinburgh Ci,3333,9,7,9,20,36,63,-27,30
Cowdenbeath,3333,10,4,11,21,25,56,-31,23
Montrose,3334,1,23,8,5,59,34,25,77
Peterhead,3334,2,24,4,8,79,38,41,76
Stenhousem'r,3334,3,16,8,12,57,46,11,56
Stirling,3334,4,16,6,14,60,53,7,54
Clyde,3334,5,15,9,12,52,48,4,54
Elgin,3334,6,14,7,15,53,60,-7,49
Annan Athlet,3334,7,12,11,13,49,41,8,47
Berwick,3334,8,8,10,18,29,59,-30,34
Edinburgh Ci,3334,9,7,9,20,36,62,-26,30
Cowdenbeath,3334,10,4,10,22,23,56,-33,22
Montrose,3335,1,24,7,5,60,34,26,79
Peterhead,3335,2,24,4,8,84,40,44,76
Stenhousem'r,3335,3,16,8,12,56,46,10,56
Stirling,3335,4,16,6,14,60,52,8,54
Clyde,3335,5,15,9,12,53,49,4,54
Elgin,3335,6,14,6,16,53,61,-8,48
Annan Athlet,3335,7,12,11,13,48,41,7,47
Berwick,3335,8,8,10,18,30,60,-30,34
Edinburgh Ci,3335,9,7,9,20,38,67,-29,30
Cowdenbeath,3335,10,4,10,22,23,55,-32,22
Montrose,3336,1,24,7,5,63,34,29,79
Peterhead,3336,2,23,5,8,79,40,39,74
Stirling,3336,3,17,6,13,64,54,10,57
Clyde,3336,4,15,9,12,52,48,4,54
Stenhousem'r,3336,5,15,8,13,58,50,8,53
Elgin,3336,6,14,6,16,53,64,-11,48
Annan Athlet,3336,7,12,11,13,48,41,7,47
Berwick,3336,8,8,10,18,29,59,-30,34
Edinburgh Ci,3336,9,7,10,19,38,62,-24,31
Cowdenbeath,3336,10,4,10,22,23,55,-32,22
Montrose,3337,1,23,8,5,59,34,25,77
Peterhead,3337,2,24,4,8,79,39,40,76
Stirling,3337,3,17,6,13,61,51,10,57
Clyde,3337,4,15,9,12,53,49,4,54
Stenhousem'r,3337,5,15,8,13,55,47,8,53
Elgin,3337,6,14,7,15,53,60,-7,49
Annan Athlet,3337,7,12,11,13,48,41,7,47
Berwick,3337,8,8,10,18,30,60,-30,34
Edinburgh Ci,3337,9,7,9,20,37,62,-25,30
Cowdenbeath,3337,10,4,10,22,23,55,-32,22
Montrose,3338,1,24,7,5,65,37,28,79
Peterhead,3338,2,23,4,9,77,39,38,73
Stirling,3338,3,17,6,13,63,52,11,57
Clyde,3338,4,15,9,12,52,48,4,54
Stenhousem'r,3338,5,15,8,13,56,49,7,53
Elgin,3338,6,14,6,16,56,66,-10,48
Annan Athlet,3338,7,12,11,13,51,41,10,47
Berwick,3338,8,8,10,18,29,59,-30,34
Edinburgh Ci,3338,9,8,9,19,37,60,-23,33
Cowdenbeath,3338,10,4,10,22,23,58,-35,22
Montrose,3339,1,23,8,5,60,35,25,77
Peterhead,3339,2,24,4,8,79,38,41,76
Stirling,3339,3,17,6,13,62,51,11,57
Stenhousem'r,3339,4,15,8,13,55,48,7,53
Clyde,3339,5,14,10,12,52,49,3,52
Elgin,3339,6,14,7,15,54,61,-7,49
Annan Athlet,3339,7,11,11,14,50,45,5,44
Berwick,3339,8,8,11,17,30,59,-29,35
Edinburgh Ci,3339,9,7,9,20,36,62,-26,30
Cowdenbeath,3339,10,5,10,21,27,57,-30,25
Montrose,3340,1,23,8,5,60,35,25,77
Peterhead,3340,2,24,4,8,79,38,41,76
Stirling,3340,3,16,7,13,60,51,9,55
Stenhousem'r,3340,4,15,9,12,55,46,9,54
Clyde,3340,5,15,9,12,54,50,4,54
Elgin,3340,6,14,7,15,54,61,-7,49
Annan Athlet,3340,7,12,11,13,50,42,8,47
Berwick,3340,8,8,10,18,31,61,-30,34
Edinburgh Ci,3340,9,7,9,20,36,62,-26,30
Cowdenbeath,3340,10,4,10,22,24,57,-33,22
Montrose,3341,1,24,7,5,61,34,27,79
Peterhead,3341,2,23,5,8,78,39,39,74
Stenhousem'r,3341,3,16,8,12,58,47,11,56
Stirling,3341,4,16,6,14,61,54,7,54
Clyde,3341,5,15,9,12,52,48,4,54
Elgin,3341,6,14,6,16,53,62,-9,48
Annan Athlet,3341,7,11,11,14,47,43,4,44
Berwick,3341,8,8,10,18,29,59,-30,34
Edinburgh Ci,3341,9,7,10,19,37,61,-24,31
Cowdenbeath,3341,10,5,10,21,25,54,-29,25
Montrose,3342,1,24,7,5,62,35,27,79
Peterhead,3342,2,24,4,8,81,38,43,76
Stirling,3342,3,16,7,13,61,52,9,55
Stenhousem'r,3342,4,15,9,12,56,47,9,54
Clyde,3342,5,14,9,13,53,52,1,51
Elgin,3342,6,14,6,16,54,63,-9,48
Annan Athlet,3342,7,11,12,13,47,41,6,45
Berwick,3342,8,9,10,17,33,60,-27,37
Edinburgh Ci,3342,9,7,9,20,36,64,-28,30
Cowdenbeath,3342,10,4,11,21,23,54,-31,23
Montrose,3343,1,24,7,5,60,34,26,79
Peterhead,3343,2,24,4,8,80,38,42,76
Stirling,3343,3,17,6,13,62,51,11,57
Stenhousem'r,3343,4,15,8,13,55,48,7,53
Clyde,3343,5,14,10,12,52,49,3,52
Elgin,3343,6,14,6,16,53,61,-8,48
Annan Athlet,3343,7,12,11,13,49,42,7,47
Berwick,3343,8,8,11,17,30,59,-29,35
Edinburgh Ci,3343,9,7,9,20,36,63,-27,30
Cowdenbeath,3343,10,4,10,22,24,56,-32,22
Montrose,3344,1,24,7,5,60,34,26,79
Peterhead,3344,2,23,4,9,77,41,36,73
Stirling,3344,3,17,6,13,61,51,10,57
Clyde,3344,4,15,9,12,53,48,5,54
Stenhousem'r,3344,5,15,8,13,55,47,8,53
Elgin,3344,6,14,6,16,53,61,-8,48
Annan Athlet,3344,7,12,11,13,48,41,7,47
Berwick,3344,8,8,10,18,29,60,-31,34
Edinburgh Ci,3344,9,8,9,19,39,60,-21,33
Cowdenbeath,3344,10,4,10,22,23,55,-32,22
Montrose,3345,1,23,8,5,61,36,25,77
Peterhead,3345,2,24,4,8,80,38,42,76
Stirling,3345,3,17,6,13,61,51,10,57
Stenhousem'r,3345,4,15,8,13,55,47,8,53
Clyde,3345,5,14,9,13,51,49,2,51
Elgin,3345,6,14,7,15,55,62,-7,49
Annan Athlet,3345,7,12,11,13,50,41,9,47
Berwick,3345,8,9,10,17,30,58,-28,37
Edinburgh Ci,3345,9,7,9,20,36,63,-27,30
Cowdenbeath,3345,10,4,10,22,23,57,-34,22
Montrose,3346,1,23,8,5,60,35,25,77
Peterhead,3346,2,24,4,8,82,38,44,76
Stirling,3346,3,17,6,13,62,52,10,57
Clyde,3346,4,15,9,12,53,49,4,54
Stenhousem'r,3346,5,15,8,13,56,48,8,53
Elgin,3346,6,14,7,15,54,61,-7,49
Annan Athlet,3346,7,11,12,13,47,41,6,45
Berwick,3346,8,8,10,18,30,60,-30,34
Edinburgh Ci,3346,9,7,9,20,36,65,-29,30
Cowdenbeath,3346,10,4,11,21,23,54,-31,23
Montrose,3347,1,24,7,5,61,35,26,79
Peterhead,3347,2,24,4,8,81,38,43,76
Stirling,3347,3,17,6,13,62,52,10,57
Clyde,3347,4,15,9,12,52,48,4,54
Stenhousem'r,3347,5,15,8,13,56,48,8,53
Elgin,3347,6,14,6,16,54,62,-8,48
Annan Athlet,3347,7,12,11,13,48,41,7,47
Berwick,3347,8,8,10,18,29,59,-30,34
Edinburgh Ci,3347,9,7,9,20,36,64,-28,30
Cowdenbeath,3347,10,4,10,22,23,55,-32,22
Montrose,3348,1,24,7,5,63,36,27,79
Peterhead,3348,2,24,4,8,82,40,42,76
Stirling,3348,3,17,6,13,62,52,10,57
Stenhousem'r,3348,4,15,8,13,56,48,8,53
Clyde,3348,5,14,10,12,52,49,3,52
Elgin,3348,6,14,6,16,55,64,-9,48
Annan Athlet,3348,7,11,11,14,47,43,4,44
Berwick,3348,8,8,11,17,30,59,-29,35
Edinburgh Ci,3348,9,7,9,20,38,65,-27,30
Cowdenbeath,3348,10,5,10,21,25,54,-29,25
Montrose,3349,1,23,7,6,61,37,24,76
Peterhead,3349,2,23,5,8,77,38,39,74
Stirling,3349,3,16,7,13,60,51,9,55
Stenhousem'r,3349,4,15,9,12,55,46,9,54
Clyde,3349,5,14,9,13,52,50,2,51
Elgin,3349,6,15,6,15,56,62,-6,51
Annan Athlet,3349,7,11,12,13,48,42,6,45
Berwick,3349,8,9,10,17,31,59,-28,37
Edinburgh Ci,3349,9,7,10,19,36,60,-24,31
Cowdenbeath,3349,10,4,11,21,24,55,-31,23
Peterhead,3350,1,24,4,8,80,38,42,76
Montrose,3350,2,23,7,6,61,39,22,76
Stirling,3350,3,16,7,13,60,51,9,55
Stenhousem'r,3350,4,15,9,12,55,46,9,54
Clyde,3350,5,15,9,12,54,50,4,54
Elgin,3350,6,15,6,15,58,62,-4,51
Annan Athlet,3350,7,11,12,13,47,41,6,45
Berwick,3350,8,8,10,18,31,61,-30,34
Edinburgh Ci,3350,9,7,9,20,36,63,-27,30
Cowdenbeath,3350,10,4,11,21,23,54,-31,23
Montrose,3351,1,24,7,5,61,35,26,79
Peterhead,3351,2,24,4,8,79,39,40,76
Stirling,3351,3,17,6,13,63,52,11,57
Clyde,3351,4,15,9,12,52,48,4,54
Stenhousem'r,3351,5,15,8,13,56,49,7,53
Elgin,3351,6,14,6,16,54,62,-8,48
Annan Athlet,3351,7,12,11,13,52,41,11,47
Berwick,3351,8,8,10,18,29,59,-30,34
Edinburgh Ci,3351,9,7,9,20,37,62,-25,30
Cowdenbeath,3351,10,4,10,22,23,59,-36,22
Montrose,3352,1,23,7,6,60,37,23,76
Peterhead,3352,2,23,4,9,77,40,37,73
Stenhousem'r,3352,3,16,8,12,57,47,10,56
Stirling,3352,4,16,6,14,61,53,8,54
Clyde,3352,5,15,9,12,53,48,5,54
Elgin,3352,6,15,6,15,56,61,-5,51
Annan Athlet,3352,7,11,12,13,49,43,6,45
Berwick,3352,8,8,10,18,29,60,-31,34
Edinburgh Ci,3352,9,8,9,19,38,60,-22,33
Cowdenbeath,3352,10,4,11,21,25,56,-31,23
Montrose,3353,1,24,7,5,60,34,26,79
Peterhead,3353,2,24,4,8,80,38,42,76
Stirling,3353,3,17,6,13,63,53,10,57
Stenhousem'r,3353,4,15,8,13,57,49,8,53
Clyde,3353,5,14,9,13,53,51,2,51
Elgin,3353,6,14,6,16,53,61,-8,48
Annan Athlet,3353,7,11,11,14,48,43,5,44
Berwick,3353,8,9,10,17,32,60,-28,37
Edinburgh Ci,3353,9,7,9,20,36,63,-27,30
Cowdenbeath,3353,10,5,10,21,25,55,-30,25
Montrose,3354,1,24,7,5,61,34,27,79
Peterhead,3354,2,24,4,8,81,39,42,76
Stenhousem'r,3354,3,16,8,12,57,47,10,56
Stirling,3354,4,16,6,14,61,53,8,54
Clyde,3354,5,14,10,12,52,49,3,52
Elgin,3354,6,14,6,16,53,62,-9,48
Annan Athlet,3354,7,11,12,13,48,42,6,45
Berwick,3354,8,8,11,17,30,59,-29,35
Edinburgh Ci,3354,9,7,9,20,37,64,-27,30
Cowdenbeath,3354,10,4,11,21,24,55,-31,23
Montrose,3355,1,24,7,5,61,35,26,79
Peterhead,3355,2,23,5,8,79,40,39,74
Stenhousem'r,3355,3,16,8,12,56,46,10,56
Stirling,3355,4,16,6,14,60,52,8,54
Clyde,3355,5,15,9,12,54,48,6,54
Elgin,3355,6,14,6,16,54,62,-8,48
Annan Athlet,3355,7,11,11,14,47,43,4,44
Berwick,3355,8,8,10,18,29,61,-32,34
Edinburgh Ci,3355,9,7,10,19,38,62,-24,31
Cowdenbeath,3355,10,5,10,21,25,54,-29,25
Montrose,3356,1,24,7,5,62,35,27,79
Peterhead,3356,2,24,4,8,78,38,40,76
Stenhousem'r,3356,3,16,8,12,57,46,11,56
Stirling,3356,4,16,6,14,60,53,7,54
Clyde,3356,5,14,10,12,54,51,3,52
Elgin,3356,6,14,6,16,54,63,-9,48
Annan Athlet,3356,7,11,11,14,47,42,5,44
Berwick,3356,8,8,11,17,32,61,-29,35
Edinburgh Ci,3356,9,7,9,20,36,61,-25,30
Cowdenbeath,3356,10,5,10,21,24,54,-30,25
Montrose,3357,1,24,7,5,61,35,26,79
Peterhead,3357,2,24,4,8,79,39,40,76
Stirling,3357,3,17,6,13,62,52,10,57
Clyde,3357,4,15,9,12,52,48,4,54
Stenhousem'r,3357,5,15,8,13,56,48,8,53
Elgin,3357,6,14,6,16,54,62,-8,48
Annan Athlet,3357,7,12,11,13,48,41,7,47
Berwick,3357,8,8,10,18,29,59,-30,34
Edinburgh Ci,3357,9,7,9,20,37,62,-25,30
Cowdenbeath,3357,10,4,10,22,23,55,-32,22
Montrose,3358,1,24,7,5,63,36,27,79
Peterhead,3358,2,23,5,8,78,39,39,74
Stirling,3358,3,17,6,13,62,52,10,57
Clyde,3358,4,15,9,12,55,48,7,54
Stenhousem'r,3358,5,15,8,13,56,48,8,53
Elgin,3358,6,14,6,16,55,64,-9,48
Annan Athlet,3358,7,11,12,13,48,42,6,45
Berwick,3358,8,8,10,18,29,62,-33,34
Edinburgh Ci,3358,9,7,10,19,37,61,-24,31
Cowdenbeath,3358,10,4,11,21,24,55,-31,23
Montrose,3359,1,23,8,5,59,34,25,77
Peterhead,3359,2,23,4,9,77,40,37,73
Stirling,3359,3,16,7,13,61,52,9,55
Stenhousem'r,3359,4,15,9,12,56,47,9,54
Clyde,3359,5,15,9,12,53,48,5,54
Elgin,3359,6,14,7,15,53,60,-7,49
Annan Athlet,3359,7,11,11,14,47,43,4,44
Berwick,3359,8,8,10,18,29,60,-31,34
Edinburgh Ci,3359,9,8,9,19,38,60,-22,33
Cowdenbeath,3359,10,5,10,21,25,54,-29,25
Montrose,3360,1,23,8,5,62,37,25,77
Peterhead,3360,2,24,4,8,80,39,41,76
Stirling,3360,3,17,6,13,62,52,10,57
Clyde,3360,4,15,9,12,53,48,5,54
Stenhousem'r,3360,5,15,8,13,56,48,8,53
Elgin,3360,6,14,7,15,56,63,-7,49
Annan Athlet,3360,7,11,12,13,47,41,6,45
Berwick,3360,8,8,10,18,29,60,-31,34
Edinburgh Ci,3360,9,7,9,20,37,63,-26,30
Cowdenbeath,3360,10,4,11,21,23,54,-31,23
Montrose,3361,1,24,7,5,61,35,26,79
Peterhead,3361,2,24,4,8,80,38,42,76
Stirling,3361,3,17,6,13,64,54,10,57
Clyde,3361,4,15,9,12,52,48,4,54
Stenhousem'r,3361,5,15,8,13,58,50,8,53
Elgin,3361,6,14,6,16,54,62,-8,48
Annan Athlet,3361,7,11,12,13,47,41,6,45
Berwick,3361,8,8,10,18,29,59,-30,34
Edinburgh Ci,3361,9,7,9,20,36,63,-27,30
Cowdenbeath,3361,10,4,11,21,23,54,-31,23
Montrose,3362,1,23,8,5,60,35,25,77
Peterhead,3362,2,24,4,8,80,38,42,76
Stirling,3362,3,17,6,13,62,51,11,57
Clyde,3362,4,15,9,12,53,49,4,54
Stenhousem'r,3362,5,15,8,13,55,48,7,53
Elgin,3362,6,14,7,15,54,61,-7,49
Annan Athlet,3362,7,11,11,14,47,42,5,44
Berwick,3362,8,8,10,18,30,60,-30,34
Edinburgh Ci,3362,9,7,9,20,36,63,-27,30
Cowdenbeath,3362,10,5,10,21,24,54,-30,25
Montrose,3363,1,24,7,5,64,36,28,79
Peterhead,3363,2,24,4,8,80,38,42,76
Stirling,3363,3,17,6,13,62,51,11,57
Stenhousem'r,3363,4,15,8,13,55,48,7,53
Clyde,3363,5,14,10,12,52,49,3,52
Elgin,3363,6,14,6,16,55,65,-10,48
Annan Athlet,3363,7,11,12,13,48,42,6,45
Berwick,3363,8,8,11,17,30,59,-29,35
Edinburgh Ci,3363,9,7,9,20,36,63,-27,30
Cowdenbeath,3363,10,4,11,21,24,55,-31,23
Montrose,3364,1,24,7,5,60,34,26,79
Peterhead,3364,2,24,4,8,79,38,41,76
Stenhousem'r,3364,3,16,8,12,57,47,10,56
Stirling,3364,4,16,6,14,61,53,8,54
Clyde,3364,5,15,9,12,53,48,5,54
Elgin,3364,6,14,6,16,53,61,-8,48
Annan Athlet,3364,7,12,11,13,49,41,8,47
Berwick,3364,8,8,10,18,29,60,-31,34
Edinburgh Ci,3364,9,7,9,20,36,62,-26,30
Cowdenbeath,3364,10,4,10,22,23,56,-33,22
Peterhead,3365,1,24,4,8,82,38,44,76
Montrose,3365,2,23,7,6,60,36,24,76
Stirling,3365,3,17,6,13,62,51,11,57
Stenhousem'r,3365,4,15,8,13,55,48,7,53
Clyde,3365,5,14,9,13,52,50,2,51
Elgin,3365,6,15,6,15,55,61,-6,51
Annan Athlet,3365,7,12,11,13,49,41,8,47
Berwick,3365,8,9,10,17,31,59,-28,37
Edinburgh Ci,3365,9,7,9,20,36,65,-29,30
Cowdenbeath,3365,10,4,10,22,23,56,-33,22
Montrose,3366,1,23,8,5,60,35,25,77
Peterhead,3366,2,24,4,8,81,40,41,76
Stenhousem'r,3366,3,16,8,12,57,46,11,56
Stirling,3366,4,16,6,14,60,53,7,54
Clyde,3366,5,15,9,12,54,49,5,54
Elgin,3366,6,14,7,15,54,61,-7,49
Annan Athlet,3366,7,12,11,13,49,42,7,47
Berwick,3366,8,8,10,18,30,61,-31,34
Edinburgh Ci,3366,9,7,9,20,38,64,-26,30
Cowdenbeath,3366,10,4,10,22,24,56,-32,22
Montrose,3367,1,24,7,5,61,35,26,79
Peterhead,3367,2,24,4,8,82,38,44,76
Stirling,3367,3,16,7,13,61,52,9,55
Stenhousem'r,3367,4,15,9,12,56,47,9,54
Clyde,3367,5,14,9,13,52,52,0,51
Elgin,3367,6,14,6,16,54,62,-8,48
Annan Athlet,3367,7,12,11,13,48,41,7,47
Berwick,3367,8,9,10,17,33,59,-26,37
Edinburgh Ci,3367,9,7,9,20,36,65,-29,30
Cowdenbeath,3367,10,4,10,22,23,55,-32,22
Peterhead,3368,1,24,4,8,81,38,43,76
Montrose,3368,2,23,7,6,59,35,24,76
Stirling,3368,3,17,6,13,62,52,10,57
Clyde,3368,4,15,9,12,53,48,5,54
Stenhousem'r,3368,5,15,8,13,56,48,8,53
Elgin,3368,6,15,6,15,54,60,-6,51
Annan Athlet,3368,7,11,12,13,47,41,6,45
Berwick,3368,8,8,10,18,29,60,-31,34
Edinburgh Ci,3368,9,7,9,20,36,64,-28,30
Cowdenbeath,3368,10,4,11,21,23,54,-31,23
Montrose,3369,1,24,7,5,61,34,27,79
Peterhead,3369,2,23,5,8,78,39,39,74
Stirling,3369,3,16,7,13,61,52,9,55
Stenhousem'r,3369,4,15,9,12,56,47,9,54
Clyde,3369,5,15,9,12,55,48,7,54
Elgin,3369,6,14,6,16,53,62,-9,48
Annan Athlet,3369,7,11,12,13,49,43,6,45
Berwick,3369,8,8,10,18,29,62,-33,34
Edinburgh Ci,3369,9,7,10,19,37,61,-24,31
Cowdenbeath,3369,10,4,11,21,25,56,-31,23
Montrose,3370,1,24,7,5,62,34,28,79
Peterhead,3370,2,23,5,8,78,39,39,74
Stirling,3370,3,17,6,13,62,52,10,57
Stenhousem'r,3370,4,15,8,13,56,48,8,53
Clyde,3370,5,14,10,12,52,49,3,52
Elgin,3370,6,14,6,16,53,63,-10,48
Annan Athlet,3370,7,12,11,13,52,43,9,47
Berwick,3370,8,8,11,17,30,59,-29,35
Edinburgh Ci,3370,9,7,10,19,37,61,-24,31
Cowdenbeath,3370,10,4,10,22,25,59,-34,22
Montrose,3371,1,24,7,5,61,34,27,79
Peterhead,3371,2,24,4,8,79,38,41,76
Stirling,3371,3,16,7,13,61,52,9,55
Stenhousem'r,3371,4,15,9,12,56,47,9,54
Clyde,3371,5,15,9,12,53,48,5,54
Elgin,3371,6,14,6,16,53,62,-9,48
Annan Athlet,3371,7,12,11,13,48,41,7,47
Berwick,3371,8,8,10,18,29,60,-31,34
Edinburgh Ci,3371,9,7,9,20,36,62,-26,30
Cowdenbeath,3371,10,4,10,22,23,55,-32,22
Peterhead,3372,1,24,4,8,80,38,42,76
Montrose,3372,2,23,7,6,59,37,22,76
Stirling,3372,3,17,6,13,63,53,10,57
Clyde,3372,4,15,9,12,55,48,7,54
Stenhousem'r,3372,5,15,8,13,57,49,8,53
Elgin,3372,6,15,6,15,56,60,-4,51
Annan Athlet,3372,7,12,11,13,48,41,7,47
Berwick,3372,8,8,10,18,29,62,-33,34
Edinburgh Ci,3372,9,7,9,20,36,63,-27,30
Cowdenbeath,3372,10,4,10,22,23,55,-32,22
Montrose,3373,1,23,8,5,60,35,25,77
Peterhead,3373,2,24,4,8,80,38,42,76
Stirling,3373,3,17,6,13,63,53,10,57
Clyde,3373,4,15,9,12,53,48,5,54
Stenhousem'r,3373,5,15,8,13,57,49,8,53
Elgin,3373,6,14,7,15,54,61,-7,49
Annan Athlet,3373,7,11,12,13,47,41,6,45
Berwick,3373,8,8,10,18,29,60,-31,34
Edinburgh Ci,3373,9,7,9,20,36,63,-27,30
Cowdenbeath,3373,10,4,11,21,23,54,-31,23
Montrose,3374,1,24,7,5,64,35,29,79
Peterhead,3374,2,23,5,8,78,39,39,74
Stirling,3374,3,16,7,13,63,54,9,55
Stenhousem'r,3374,4,15,9,12,58,49,9,54
Clyde,3374,5,14,9,13,52,50,2,51
Elgin,3374,6,14,6,16,54,65,-11,48
Annan Athlet,3374,7,11,12,13,47,41,6,45
Berwick,3374,8,9,10,17,31,59,-28,37
Edinburgh Ci,3374,9,7,10,19,37,61,-24,31
Cowdenbeath,3374,10,4,11,21,23,54,-31,23
Montrose,3375,1,24,7,5,63,34,29,79
Peterhead,3375,2,24,4,8,80,38,42,76
Stenhousem'r,3375,3,16,8,12,56,46,10,56
Stirling,3375,4,16,6,14,60,52,8,54
Clyde,3375,5,14,9,13,52,50,2,51
Elgin,3375,6,14,6,16,53,64,-11,48
Annan Athlet,3375,7,11,12,13,48,42,6,45
Berwick,3375,8,9,10,17,31,59,-28,37
Edinburgh Ci,3375,9,7,9,20,36,63,-27,30
Cowdenbeath,3375,10,4,11,21,24,55,-31,23
Montrose,3376,1,23,8,5,59,34,25,77
Peterhead,3376,2,23,5,8,78,39,39,74
Stenhousem'r,3376,3,16,8,12,58,47,11,56
Stirling,3376,4,16,6,14,61,54,7,54
Clyde,3376,5,15,9,12,53,48,5,54
Elgin,3376,6,14,7,15,53,60,-7,49
Annan Athlet,3376,7,11,11,14,48,44,4,44
Berwick,3376,8,8,10,18,29,60,-31,34
Edinburgh Ci,3376,9,7,10,19,37,61,-24,31
Cowdenbeath,3376,10,5,10,21,26,55,-29,25
Montrose,3377,1,23,8,5,62,37,25,77
Peterhead,3377,2,23,4,9,77,39,38,73
Stirling,3377,3,17,6,13,62,52,10,57
Clyde,3377,4,15,9,12,53,49,4,54
Stenhousem'r,3377,5,15,8,13,56,48,8,53
Elgin,3377,6,14,7,15,56,63,-7,49
Annan Athlet,3377,7,12,11,13,49,41,8,47
Berwick,3377,8,8,10,18,30,60,-30,34
Edinburgh Ci,3377,9,8,9,19,37,60,-23,33
Cowdenbeath,3377,10,4,10,22,23,56,-33,22
Montrose,3378,1,23,8,5,61,36,25,77
Peterhead,3378,2,24,4,8,79,38,41,76
Stirling,3378,3,17,6,13,62,52,10,57
Stenhousem'r,3378,4,15,8,13,56,48,8,53
Clyde,3378,5,14,10,12,52,49,3,52
Elgin,3378,6,14,7,15,55,62,-7,49
Annan Athlet,3378,7,11,11,14,47,43,4,44
Berwick,3378,8,8,11,17,30,59,-29,35
Edinburgh Ci,3378,9,7,9,20,36,62,-26,30
Cowdenbeath,3378,10,5,10,21,25,54,-29,25
Montrose,3379,1,24,7,5,61,35,26,79
Peterhead,3379,2,24,4,8,80,38,42,76
Stenhousem'r,3379,3,16,8,12,57,46,11,56
Clyde,3379,4,15,9,12,56,48,8,54
Stirling,3379,5,16,6,14,60,53,7,54
Elgin,3379,6,14,6,16,54,62,-8,48
Annan Athlet,3379,7,12,11,13,48,41,7,47
Berwick,3379,8,8,10,18,29,63,-34,34
Edinburgh Ci,3379,9,7,9,20,36,63,-27,30
Cowdenbeath,3379,10,4,10,22,23,55,-32,22
Montrose,3380,1,23,8,5,60,35,25,77
Peterhead,3380,2,23,4,9,78,40,38,73
Stenhousem'r,3380,3,16,8,12,58,48,10,56
Stirling,3380,4,16,6,14,62,54,8,54
Clyde,3380,5,15,9,12,56,49,7,54
Elgin,3380,6,14,7,15,54,61,-7,49
Annan Athlet,3380,7,11,12,13,47,41,6,45
Berwick,3380,8,8,10,18,30,63,-33,34
Edinburgh Ci,3380,9,8,9,19,38,61,-23,33
Cowdenbeath,3380,10,4,11,21,23,54,-31,23
Peterhead,3381,1,24,4,8,81,40,41,76
Montrose,3381,2,23,7,6,59,36,23,76
Stirling,3381,3,17,6,13,63,53,10,57
Clyde,3381,4,15,9,12,52,48,4,54
Stenhousem'r,3381,5,15,8,13,57,49,8,53
Elgin,3381,6,15,6,15,55,60,-5,51
Annan Athlet,3381,7,12,11,13,50,42,8,47
Berwick,3381,8,8,10,18,29,59,-30,34
Edinburgh Ci,3381,9,7,9,20,38,64,-26,30
Cowdenbeath,3381,10,4,10,22,24,57,-33,22
Montrose,3382,1,23,7,6,59,35,24,76
Peterhead,3382,2,23,4,9,77,39,38,73
Stenhousem'r,3382,3,16,8,12,58,47,11,56
Stirling,3382,4,16,6,14,61,54,7,54
Clyde,3382,5,15,9,12,53,48,5,54
Elgin,3382,6,15,6,15,54,60,-6,51
Annan Athlet,3382,7,12,11,13,49,41,8,47
Berwick,3382,8,8,10,18,29,60,-31,34
Edinburgh Ci,3382,9,8,9,19,37,60,-23,33
Cowdenbeath,3382,10,4,10,22,23,56,-33,22
Montrose,3383,1,24,7,5,62,34,28,79
Peterhead,3383,2,24,4,8,81,38,43,76
Stirling,3383,3,16,7,13,60,51,9,55
Stenhousem'r,3383,4,15,9,12,55,46,9,54
Clyde,3383,5,15,9,12,55,50,5,54
Elgin,3383,6,14,6,16,53,63,-10,48
Annan Athlet,3383,7,12,11,13,50,42,8,47
Berwick,3383,8,8,10,18,31,62,-31,34
Edinburgh Ci,3383,9,7,9,20,36,64,-28,30
Cowdenbeath,3383,10,4,10,22,24,57,-33,22
Montrose,3384,1,24,7,5,61,35,26,79
Peterhead,3384,2,24,4,8,81,38,43,76
Stenhousem'r,3384,3,16,8,12,57,47,10,56
Stirling,3384,4,16,6,14,61,53,8,54
Clyde,3384,5,15,9,12,54,48,6,54
Elgin,3384,6,14,6,16,54,62,-8,48
Annan Athlet,3384,7,12,11,13,48,41,7,47
Berwick,3384,8,8,10,18,29,61,-32,34
Edinburgh Ci,3384,9,7,9,20,36,64,-28,30
Cowdenbeath,3384,10,4,10,22,23,55,-32,22
Peterhead,3385,1,24,4,8,80,40,40,76
Montrose,3385,2,23,7,6,59,36,23,76
Stirling,3385,3,17,6,13,61,51,10,57
Clyde,3385,4,15,9,12,53,48,5,54
Stenhousem'r,3385,5,15,8,13,55,47,8,53
Elgin,3385,6,15,6,15,55,60,-5,51
Annan Athlet,3385,7,11,12,13,47,41,6,45
Berwick,3385,8,8,10,18,29,60,-31,34
Edinburgh Ci,3385,9,7,9,20,38,63,-25,30
Cowdenbeath,3385,10,4,11,21,23,54,-31,23
Montrose,3386,1,23,8,5,61,36,25,77
Peterhead,3386,2,23,4,9,78,40,38,73
Stirling,3386,3,16,7,13,62,53,9,55
Stenhousem'r,3386,4,15,9,12,57,48,9,54
Clyde,3386,5,15,9,12,52,48,4,54
Elgin,3386,6,14,7,15,55,62,-7,49
Annan Athlet,3386,7,11,11,14,47,42,5,44
Berwick,3386,8,8,10,18,29,59,-30,34
Edinburgh Ci,3386,9,8,9,19,38,61,-23,33
Cowdenbeath,3386,10,5,10,21,24,54,-30,25
Montrose,3387,1,23,8,5,60,35,25,77
Peterhead,3387,2,24,4,8,80,39,41,76
Stenhousem'r,3387,3,16,8,12,58,48,10,56
Stirling,3387,4,16,6,14,62,54,8,54
Clyde,3387,5,14,9,13,51,49,2,51
Elgin,3387,6,14,7,15,54,61,-7,49
Annan Athlet,3387,7,11,12,13,48,42,6,45
Berwick,3387,8,9,10,17,30,58,-28,37
Edinburgh Ci,3387,9,7,9,20,37,63,-26,30
Cowdenbeath,3387,10,4,11,21,24,55,-31,23
Montrose,3388,1,23,7,6,60,36,24,76
Peterhead,3388,2,23,5,8,78,39,39,74
Stirling,3388,3,16,7,13,61,52,9,55
Stenhousem'r,3388,4,15,9,12,56,47,9,54
Clyde,3388,5,15,9,12,52,48,4,54
Elgin,3388,6,15,6,15,55,61,-6,51
Annan Athlet,3388,7,11,11,14,48,44,4,44
Berwick,3388,8,8,10,18,29,59,-30,34
Edinburgh Ci,3388,9,7,10,19,37,61,-24,31
Cowdenbeath,3388,10,5,10,21,26,55,-29,25
Montrose,3389,1,24,7,5,63,35,28,79
Peterhead,3389,2,23,4,9,77,40,37,73
Stenhousem'r,3389,3,16,8,12,57,47,10,56
Stirling,3389,4,16,6,14,61,53,8,54
Clyde,3389,5,15,9,12,53,49,4,54
Elgin,3389,6,14,6,16,54,64,-10,48
Annan Athlet,3389,7,11,11,14,48,43,5,44
Berwick,3389,8,8,10,18,30,60,-30,34
Edinburgh Ci,3389,9,8,9,19,38,60,-22,33
Cowdenbeath,3389,10,5,10,21,25,55,-30,25
Montrose,3390,1,24,7,5,61,35,26,79
Peterhead,3390,2,24,4,8,81,38,43,76
Stirling,3390,3,16,7,13,61,52,9,55
Stenhousem'r,3390,4,15,9,12,56,47,9,54
Clyde,3390,5,15,9,12,53,49,4,54
Elgin,3390,6,14,6,16,54,62,-8,48
Annan Athlet,3390,7,12,11,13,48,41,7,47
Berwick,3390,8,8,10,18,30,60,-30,34
Edinburgh Ci,3390,9,7,9,20,36,64,-28,30
Cowdenbeath,3390,10,4,10,22,23,55,-32,22
Peterhead,3391,1,24,4,8,79,38,41,76
Montrose,3391,2,23,7,6,60,36,24,76
Stirling,3391,3,16,7,13,62,53,9,55
Stenhousem'r,3391,4,15,9,12,57,48,9,54
Clyde,3391,5,14,9,13,52,50,2,51
Elgin,3391,6,15,6,15,55,61,-6,51
Annan Athlet,3391,7,11,12,13,47,41,6,45
Berwick,3391,8,9,10,17,31,59,-28,37
Edinburgh Ci,3391,9,7,9,20,36,62,-26,30
Cowdenbeath,3391,10,4,11,21,23,54,-31,23
Montrose,3392,1,23,8,5,60,35,25,77
Peterhead,3392,2,24,4,8,80,38,42,76
Stirling,3392,3,17,6,13,61,51,10,57
Clyde,3392,4,15,9,12,56,49,7,54
Stenhousem'r,3392,5,15,8,13,55,47,8,53
Elgin,3392,6,14,7,15,54,61,-7,49
Annan Athlet,3392,7,11,12,13,49,43,6,45
Berwick,3392,8,8,10,18,30,63,-33,34
Edinburgh Ci,3392,9,7,9,20,36,63,-27,30
Cowdenbeath,3392,10,4,11,21,25,56,-31,23
Montrose,3393,1,24,7,5,61,34,27,79
Peterhead,3393,2,24,4,8,79,38,41,76
Stenhousem'r,3393,3,16,8,12,59,46,13,56
Stirling,3393,4,16,6,14,60,55,5,54
Clyde,3393,5,14,10,12,52,49,3,52
Elgin,3393,6,14,6,16,53,62,-9,48
Annan Athlet,3393,7,12,11,13,49,41,8,47
Berwick,3393,8,8,11,17,30,59,-29,35
Edinburgh Ci,3393,9,7,9,20,36,62,-26,30
Cowdenbeath,3393,10,4,10,22,23,56,-33,22
Montrose,3394,1,23,8,5,60,35,25,77
Peterhead,3394,2,24,4,8,80,39,41,76
Stirling,3394,3,16,7,13,62,53,9,55
Stenhousem'r,3394,4,15,9,12,57,48,9,54
Clyde,3394,5,14,10,12,52,49,3,52
Elgin,3394,6,14,7,15,54,61,-7,49
Annan Athlet,3394,7,12,11,13,51,41,10,47
Berwick,3394,8,8,11,17,30,59,-29,35
Edinburgh Ci,3394,9,7,9,20,37,63,-26,30
Cowdenbeath,3394,10,4,10,22,23,58,-35,22
Montrose,3395,1,24,7,5,62,36,26,79
Peterhead,3395,2,24,4,8,81,39,42,76
Stirling,3395,3,17,6,13,62,52,10,57
Stenhousem'r,3395,4,15,8,13,56,48,8,53
Clyde,3395,5,14,10,12,52,49,3,52
Elgin,3395,6,14,6,16,55,63,-8,48
Annan Athlet,3395,7,11,11,14,48,44,4,44
Berwick,3395,8,8,11,17,30,59,-29,35
Edinburgh Ci,3395,9,7,9,20,37,64,-27,30
Cowdenbeath,3395,10,5,10,21,26,55,-29,25
Montrose,3396,1,24,7,5,62,34,28,79
Peterhead,3396,2,24,4,8,83,38,45,76
Stirling,3396,3,17,6,13,63,52,11,57
Clyde,3396,4,15,9,12,54,49,5,54
Stenhousem'r,3396,5,15,8,13,56,49,7,53
Elgin,3396,6,14,6,16,53,63,-10,48
Annan Athlet,3396,7,11,12,13,48,42,6,45
Berwick,3396,8,8,10,18,30,61,-31,34
Edinburgh Ci,3396,9,7,9,20,36,66,-30,30
Cowdenbeath,3396,10,4,11,21,24,55,-31,23
Montrose,3397,1,24,7,5,63,36,27,79
Peterhead,3397,2,24,4,8,80,39,41,76
Stenhousem'r,3397,3,16,8,12,56,46,10,56
Stirling,3397,4,16,6,14,60,52,8,54
Clyde,3397,5,15,9,12,52,48,4,54
Elgin,3397,6,14,6,16,55,64,-9,48
Annan Athlet,3397,7,11,11,14,49,44,5,44
Berwick,3397,8,8,10,18,29,59,-30,34
Edinburgh Ci,3397,9,7,9,20,37,63,-26,30
Cowdenbeath,3397,10,5,10,21,26,56,-30,25
Montrose,3398,1,23,8,5,59,34,25,77
Peterhead,3398,2,24,4,8,79,38,41,76
Stenhousem'r,3398,3,16,8,12,57,46,11,56
Stirling,3398,4,16,6,14,60,53,7,54
Clyde,3398,5,14,10,12,51,48,3,52
Elgin,3398,6,14,7,15,53,60,-7,49
Annan Athlet,3398,7,11,12,13,48,42,6,45
Berwick,3398,8,8,11,17,29,58,-29,35
Edinburgh Ci,3398,9,7,9,20,36,62,-26,30
Cowdenbeath,3398,10,4,11,21,24,55,-31,23
Peterhead,3399,1,24,4,8,80,39,41,76
Montrose,3399,2,23,7,6,59,37,22,76
Stirling,3399,3,17,6,13,62,51,11,57
Clyde,3399,4,15,9,12,55,51,4,54
Stenhousem'r,3399,5,15,8,13,55,48,7,53
Elgin,3399,6,15,6,15,56,60,-4,51
Annan Athlet,3399,7,11,11,14,48,44,4,44
Berwick,3399,8,8,10,18,32,62,-30,34
Edinburgh Ci,3399,9,7,9,20,37,63,-26,30
Cowdenbeath,3399,10,5,10,21,26,55,-29,25
Montrose,3400,1,23,7,6,59,35,24,76
Peterhead,3400,2,23,5,8,79,40,39,74
Stenhousem'r,3400,3,16,8,12,58,47,11,56
Clyde,3400,4,15,9,12,58,49,9,54
Stirling,3400,5,16,6,14,61,54,7,54
Elgin,3400,6,15,6,15,54,60,-6,51
Annan Athlet,3400,7,12,11,13,49,41,8,47
Berwick,3400,8,8,10,18,30,65,-35,34
Edinburgh Ci,3400,9,7,10,19,38,62,-24,31
Cowdenbeath,3400,10,4,10,22,23,56,-33,22
Montrose,3401,1,24,7,5,63,36,27,79
Peterhead,3401,2,24,4,8,78,38,40,76
Stenhousem'r,3401,3,16,8,12,58,47,11,56
Stirling,3401,4,16,6,14,61,54,7,54
Clyde,3401,5,14,10,12,52,49,3,52
Elgin,3401,6,14,6,16,55,64,-9,48
Annan Athlet,3401,7,12,11,13,49,42,7,47
Berwick,3401,8,8,11,17,30,59,-29,35
Edinburgh Ci,3401,9,7,9,20,36,61,-25,30
Cowdenbeath,3401,10,4,10,22,24,56,-32,22
Montrose,3402,1,24,7,5,63,35,28,79
Peterhead,3402,2,24,4,8,80,39,41,76
Stirling,3402,3,17,6,13,61,51,10,57
Clyde,3402,4,15,9,12,53,49,4,54
Stenhousem'r,3402,5,15,8,13,55,47,8,53
Elgin,3402,6,14,6,16,54,64,-10,48
Annan Athlet,3402,7,11,12,13,48,42,6,45
Berwick,3402,8,8,10,18,30,60,-30,34
Edinburgh Ci,3402,9,7,9,20,37,63,-26,30
Cowdenbeath,3402,10,4,11,21,24,55,-31,23
Montrose,3403,1,23,8,5,60,35,25,77
Peterhead,3403,2,24,4,8,80,39,41,76
Stirling,3403,3,17,6,13,65,52,13,57
Clyde,3403,4,15,9,12,54,50,4,54
Stenhousem'r,3403,5,15,8,13,56,51,5,53
Elgin,3403,6,14,7,15,54,61,-7,49
Annan Athlet,3403,7,11,12,13,49,43,6,45
Berwick,3403,8,8,10,18,31,61,-30,34
Edinburgh Ci,3403,9,7,9,20,37,63,-26,30
Cowdenbeath,3403,10,4,11,21,25,56,-31,23
Montrose,3404,1,24,7,5,61,35,26,79
Peterhead,3404,2,24,4,8,81,38,43,76
Stenhousem'r,3404,3,16,8,12,57,46,11,56
Stirling,3404,4,16,6,14,60,53,7,54
Clyde,3404,5,15,9,12,54,50,4,54
Elgin,3404,6,14,6,16,54,62,-8,48
Annan Athlet,3404,7,12,11,13,49,42,7,47
Berwick,3404,8,8,10,18,31,61,-30,34
Edinburgh Ci,3404,9,7,9,20,36,64,-28,30
Cowdenbeath,3404,10,4,10,22,24,56,-32,22
Montrose,3405,1,24,7,5,62,36,26,79
Peterhead,3405,2,24,4,8,80,39,41,76
Stirling,3405,3,16,7,13,60,51,9,55
Stenhousem'r,3405,4,15,9,12,55,46,9,54
Clyde,3405,5,15,9,12,53,49,4,54
Elgin,3405,6,14,6,16,55,63,-8,48
Annan Athlet,3405,7,11,12,13,47,41,6,45
Berwick,3405,8,8,10,18,30,60,-30,34
Edinburgh Ci,3405,9,7,9,20,37,63,-26,30
Cowdenbeath,3405,10,4,11,21,23,54,-31,23
Montrose,3406,1,24,7,5,62,35,27,79
Peterhead,3406,2,24,4,8,79,38,41,76
Stenhousem'r,3406,3,16,8,12,57,46,11,56
Stirling,3406,4,16,6,14,60,53,7,54
Clyde,3406,5,15,9,12,53,49,4,54
Elgin,3406,6,14,6,16,54,63,-9,48
Annan Athlet,3406,7,11,11,14,48,43,5,44
Berwick,3406,8,8,10,18,30,60,-30,34
Edinburgh Ci,3406,9,7,9,20,36,62,-26,30
Cowdenbeath,3406,10,5,10,21,25,55,-30,25
Montrose,3407,1,24,7,5,62,34,28,79
Peterhead,3407,2,24,4,8,82,38,44,76
Stirling,3407,3,17,6,13,64,53,11,57
Clyde,3407,4,15,9,12,55,49,6,54
Stenhousem'r,3407,5,15,8,13,57,50,7,53
Elgin,3407,6,14,6,16,53,63,-10,48
Annan Athlet,3407,7,12,11,13,48,41,7,47
Berwick,3407,8,8,10,18,30,62,-32,34
Edinburgh Ci,3407,9,7,9,20,36,65,-29,30
Cowdenbeath,3407,10,4,10,22,23,55,-32,22
Montrose,3408,1,23,8,5,60,35,25,77
Peterhead,3408,2,24,4,8,78,38,40,76
Stenhousem'r,3408,3,16,8,12,58,48,10,56
Stirling,3408,4,16,6,14,62,54,8,54
Clyde,3408,5,15,9,12,53,48,5,54
Elgin,3408,6,14,7,15,54,61,-7,49
Annan Athlet,3408,7,12,11,13,49,42,7,47
Berwick,3408,8,8,10,18,29,60,-31,34
Edinburgh Ci,3408,9,7,9,20,36,61,-25,30
Cowdenbeath,3408,10,4,10,22,24,56,-32,22
Montrose,3409,1,24,7,5,63,34,29,79
Peterhead,3409,2,24,4,8,79,39,40,76
Stirling,3409,3,17,6,13,62,51,11,57
Stenhousem'r,3409,4,15,8,13,55,48,7,53
Clyde,3409,5,14,10,12,53,50,3,52
Elgin,3409,6,14,6,16,53,64,-11,48
Annan Athlet,3409,7,11,12,13,47,41,6,45
Berwick,3409,8,8,11,17,31,60,-29,35
Edinburgh Ci,3409,9,7,9,20,37,62,-25,30
Cowdenbeath,3409,10,4,11,21,23,54,-31,23
Peterhead,3410,1,24,4,8,78,38,40,76
Montrose,3410,2,23,7,6,62,38,24,76
Stenhousem'r,3410,3,16,8,12,59,48,11,56
Stirling,3410,4,16,6,14,62,55,7,54
Clyde,3410,5,15,9,12,53,48,5,54
Elgin,3410,6,15,6,15,57,63,-6,51
Annan Athlet,3410,7,12,11,13,49,41,8,47
Berwick,3410,8,8,10,18,29,60,-31,34
Edinburgh Ci,3410,9,7,9,20,36,61,-25,30
Cowdenbeath,3410,10,4,10,22,23,56,-33,22
Montrose,3411,1,24,7,5,63,36,27,79
Peterhead,3411,2,24,4,8,81,40,41,76
Stenhousem'r,3411,3,16,8,12,57,47,10,56
Stirling,3411,4,16,6,14,61,53,8,54
Clyde,3411,5,15,9,12,54,50,4,54
Elgin,3411,6,14,6,16,55,64,-9,48
Annan Athlet,3411,7,11,11,14,47,42,5,44
Berwick,3411,8,8,10,18,31,61,-30,34
Edinburgh Ci,3411,9,7,9,20,38,64,-26,30
Cowdenbeath,3411,10,5,10,21,24,54,-30,25
Montrose,3412,1,23,8,5,60,35,25,77
Peterhead,3412,2,24,4,8,79,38,41,76
Stirling,3412,3,16,7,13,61,52,9,55
Stenhousem'r,3412,4,15,9,12,56,47,9,54
Clyde,3412,5,14,10,12,52,49,3,52
Elgin,3412,6,14,7,15,54,61,-7,49
Annan Athlet,3412,7,12,11,13,50,41,9,47
Berwick,3412,8,8,11,17,30,59,-29,35
Edinburgh Ci,3412,9,7,9,20,36,62,-26,30
Cowdenbeath,3412,10,4,10,22,23,57,-34,22
Montrose,3413,1,24,7,5,62,35,27,79
Peterhead,3413,2,24,4,8,82,38,44,76
Stirling,3413,3,17,6,13,63,52,11,57
Stenhousem'r,3413,4,15,8,13,56,49,7,53
Clyde,3413,5,14,10,12,52,49,3,52
Elgin,3413,6,14,6,16,54,63,-9,48
Annan Athlet,3413,7,11,11,14,48,43,5,44
Berwick,3413,8,8,11,17,30,59,-29,35
Edinburgh Ci,3413,9,7,9,20,36,65,-29,30
Cowdenbeath,3413,10,5,10,21,25,55,-30,25
Montrose,3414,1,23,7,6,60,36,24,76
Peterhead,3414,2,23,5,8,78,39,39,74
Stirling,3414,3,17,6,13,64,53,11,57
Stenhousem'r,3414,4,15,8,13,57,50,7,53
Clyde,3414,5,14,9,13,52,50,2,51
Elgin,3414,6,15,6,15,55,61,-6,51
Annan Athlet,3414,7,11,12,13,47,41,6,45
Berwick,3414,8,9,10,17,31,59,-28,37
Edinburgh Ci,3414,9,7,10,19,37,61,-24,31
Cowdenbeath,3414,10,4,11,21,23,54,-31,23
Montrose,3415,1,24,7,5,60,34,26,79
Peterhead,3415,2,24,4,8,79,39,40,76
Stenhousem'r,3415,3,16,8,12,56,46,10,56
Stirling,3415,4,16,6,14,60,52,8,54
Clyde,3415,5,15,9,12,53,49,4,54
Elgin,3415,6,14,6,16,53,61,-8,48
Annan Athlet,3415,7,12,11,13,48,41,7,47
Berwick,3415,8,8,10,18,30,60,-30,34
Edinburgh Ci,3415,9,7,9,20,37,62,-25,30
Cowdenbeath,3415,10,4,10,22,23,55,-32,22
Montrose,3416,1,24,7,5,61,34,27,79
Peterhead,3416,2,24,4,8,79,38,41,76
Stenhousem'r,3416,3,16,8,12,56,46,10,56
Stirling,3416,4,16,6,14,60,52,8,54
Clyde,3416,5,14,9,13,53,52,1,51
Elgin,3416,6,14,6,16,53,62,-9,48
Annan Athlet,3416,7,12,11,13,48,41,7,47
Berwick,3416,8,9,10,17,33,60,-27,37
Edinburgh Ci,3416,9,7,9,20,36,62,-26,30
Cowdenbeath,3416,10,4,10,22,23,55,-32,22
Peterhead,3417,1,24,4,8,83,38,45,76
Montrose,3417,2,23,7,6,60,38,22,76
Stenhousem'r,3417,3,16,8,12,58,46,12,56
Stirling,3417,4,16,6,14,60,54,6,54
Clyde,3417,5,14,9,13,51,49,2,51
Elgin,3417,6,15,6,15,57,61,-4,51
Annan Athlet,3417,7,11,12,13,48,42,6,45
Berwick,3417,8,9,10,17,30,58,-28,37
Edinburgh Ci,3417,9,7,9,20,36,66,-30,30
Cowdenbeath,3417,10,4,11,21,24,55,-31,23
Montrose,3418,1,24,7,5,62,34,28,79
Peterhead,3418,2,23,5,8,79,40,39,74
Stirling,3418,3,17,6,13,62,52,10,57
Clyde,3418,4,15,9,12,56,49,7,54
Stenhousem'r,3418,5,15,8,13,56,48,8,53
Elgin,3418,6,14,6,16,53,63,-10,48
Annan Athlet,3418,7,11,11,14,47,42,5,44
Berwick,3418,8,8,10,18,30,63,-33,34
Edinburgh Ci,3418,9,7,10,19,38,62,-24,31
Cowdenbeath,3418,10,5,10,21,24,54,-30,25
Montrose,3419,1,24,7,5,62,34,28,79
Peterhead,3419,2,23,5,8,78,39,39,74
Stirling,3419,3,17,6,13,61,51,10,57
Clyde,3419,4,15,9,12,53,49,4,54
Stenhousem'r,3419,5,15,8,13,55,47,8,53
Elgin,3419,6,14,6,16,53,63,-10,48
Annan Athlet,3419,7,12,11,13,50,42,8,47
Berwick,3419,8,8,10,18,30,60,-30,34
Edinburgh Ci,3419,9,7,10,19,37,61,-24,31
Cowdenbeath,3419,10,4,10,22,24,57,-33,22
Montrose,3420,1,24,7,5,61,35,26,79
Peterhead,3420,2,24,4,8,78,38,40,76
Stirling,3420,3,16,7,13,61,52,9,55
Stenhousem'r,3420,4,15,9,12,56,47,9,54
Clyde,3420,5,14,10,12,53,50,3,52
Elgin,3420,6,14,6,16,54,62,-8,48
Annan Athlet,3420,7,11,11,14,47,42,5,44
Berwick,3420,8,8,11,17,31,60,-29,35
Edinburgh Ci,3420,9,7,9,20,36,61,-25,30
Cowdenbeath,3420,10,5,10,21,24,54,-30,25
Montrose,3421,1,24,7,5,61,35,26,79
Peterhead,3421,2,24,4,8,79,39,40,76
Stirling,3421,3,17,6,13,62,52,10,57
Clyde,3421,4,15,9,12,52,48,4,54
Stenhousem'r,3421,5,15,8,13,56,48,8,53
Elgin,3421,6,14,6,16,54,62,-8,48
Annan Athlet,3421,7,11,12,13,48,42,6,45
Berwick,3421,8,8,10,18,29,59,-30,34
Edinburgh Ci,3421,9,7,9,20,37,62,-25,30
Cowdenbeath,3421,10,4,11,21,24,55,-31,23
Montrose,3422,1,23,8,5,60,35,25,77
Peterhead,3422,2,23,4,9,77,39,38,73
Stirling,3422,3,17,6,13,63,51,12,57
Clyde,3422,4,15,9,12,52,48,4,54
Stenhousem'r,3422,5,15,8,13,55,49,6,53
Elgin,3422,6,14,7,15,54,61,-7,49
Annan Athlet,3422,7,11,12,13,48,42,6,45
Berwick,3422,8,8,10,18,29,59,-30,34
Edinburgh Ci,3422,9,8,9,19,37,60,-23,33
Cowdenbeath,3422,10,4,11,21,24,55,-31,23
Montrose,3423,1,24,7,5,62,34,28,79
Peterhead,3423,2,24,4,8,80,38,42,76
Stirling,3423,3,17,6,13,62,51,11,57
Clyde,3423,4,15,9,12,52,48,4,54
Stenhousem'r,3423,5,15,8,13,55,48,7,53
Elgin,3423,6,14,6,16,53,63,-10,48
Annan Athlet,3423,7,11,11,14,47,42,5,44
Berwick,3423,8,8,10,18,29,59,-30,34
Edinburgh Ci,3423,9,7,9,20,36,63,-27,30
Cowdenbeath,3423,10,5,10,21,24,54,-30,25
Montrose,3424,1,24,7,5,61,34,27,79
Peterhead,3424,2,23,4,9,77,39,38,73
Stirling,3424,3,17,6,13,63,52,11,57
Stenhousem'r,3424,4,15,8,13,56,49,7,53
Clyde,3424,5,14,9,13,51,49,2,51
Elgin,3424,6,14,6,16,53,62,-9,48
Annan Athlet,3424,7,11,12,13,49,43,6,45
Berwick,3424,8,9,10,17,30,58,-28,37
Edinburgh Ci,3424,9,8,9,19,37,60,-23,33
Cowdenbeath,3424,10,4,11,21,25,56,-31,23
Montrose,3425,1,24,7,5,61,35,26,79
Peterhead,3425,2,24,4,8,83,39,44,76
Stirling,3425,3,17,6,13,64,52,12,57
Clyde,3425,4,15,9,12,53,49,4,54
Stenhousem'r,3425,5,15,8,13,56,50,6,53
Elgin,3425,6,14,6,16,54,62,-8,48
Annan Athlet,3425,7,12,11,13,50,42,8,47
Berwick,3425,8,8,10,18,30,60,-30,34
Edinburgh Ci,3425,9,7,9,20,37,66,-29,30
Cowdenbeath,3425,10,4,10,22,24,57,-33,22
Montrose,3426,1,24,7,5,60,34,26,79
Peterhead,3426,2,24,4,8,81,38,43,76
Stenhousem'r,3426,3,16,8,12,58,48,10,56
Stirling,3426,4,16,6,14,62,54,8,54
Clyde,3426,5,15,9,12,55,48,7,54
Elgin,3426,6,14,6,16,53,61,-8,48
Annan Athlet,3426,7,12,11,13,48,41,7,47
Berwick,3426,8,8,10,18,29,62,-33,34
Edinburgh Ci,3426,9,7,9,20,36,64,-28,30
Cowdenbeath,3426,10,4,10,22,23,55,-32,22
Peterhead,3427,1,24,4,8,81,39,42,76
Montrose,3427,2,23,7,6,59,35,24,76
Stirling,3427,3,17,6,13,62,52,10,57
Stenhousem'r,3427,4,15,8,13,56,48,8,53
Clyde,3427,5,14,10,12,51,48,3,52
Elgin,3427,6,15,6,15,54,60,-6,51
Annan Athlet,3427,7,12,11,13,50,41,9,47
Berwick,3427,8,8,11,17,29,58,-29,35
Edinburgh Ci,3427,9,7,9,20,37,64,-27,30
Cowdenbeath,3427,10,4,10,22,23,57,-34,22
Montrose,3428,1,24,7,5,62,34,28,79
Peterhead,3428,2,24,4,8,83,39,44,76
Stirling,3428,3,17,6,13,63,52,11,57
Stenhousem'r,3428,4,15,8,13,56,49,7,53
Clyde,3428,5,14,9,13,51,50,1,51
Elgin,3428,6,14,6,16,53,63,-10,48
Annan Athlet,3428,7,11,11,14,47,42,5,44
Berwick,3428,8,9,10,17,31,58,-27,37
Edinburgh Ci,3428,9,7,9,20,37,66,-29,30
Cowdenbeath,3428,10,5,10,21,24,54,-30,25
Peterhead,3429,1,24,4,8,80,38,42,76
Montrose,3429,2,23,7,6,59,35,24,76
Stirling,3429,3,17,6,13,65,51,14,57
Clyde,3429,4,15,9,12,57,49,8,54
Stenhousem'r,3429,5,15,8,13,55,51,4,53
Elgin,3429,6,15,6,15,54,60,-6,51
Annan Athlet,3429,7,12,11,13,49,42,7,47
Berwick,3429,8,8,10,18,30,64,-34,34
Edinburgh Ci,3429,9,7,9,20,36,63,-27,30
Cowdenbeath,3429,10,4,10,22,24,56,-32,22
Montrose,3430,1,24,7,5,63,35,28,79
Peterhead,3430,2,24,4,8,83,39,44,76
Stirling,3430,3,17,6,13,63,52,11,57
Clyde,3430,4,15,9,12,52,48,4,54
Stenhousem'r,3430,5,15,8,13,56,49,7,53
Elgin,3430,6,14,6,16,54,64,-10,48
Annan Athlet,3430,7,11,11,14,47,43,4,44
Berwick,3430,8,8,10,18,29,59,-30,34
Edinburgh Ci,3430,9,7,9,20,37,66,-29,30
Cowdenbeath,3430,10,5,10,21,25,54,-29,25
Montrose,3431,1,24,7,5,62,35,27,79
Peterhead,3431,2,24,4,8,78,38,40,76
Stirling,3431,3,16,7,13,62,53,9,55
Stenhousem'r,3431,4,15,9,12,57,48,9,54
Clyde,3431,5,15,9,12,53,49,4,54
Elgin,3431,6,14,6,16,54,63,-9,48
Annan Athlet,3431,7,11,12,13,49,43,6,45
Berwick,3431,8,8,10,18,30,60,-30,34
Edinburgh Ci,3431,9,7,9,20,36,61,-25,30
Cowdenbeath,3431,10,4,11,21,25,56,-31,23
Montrose,3432,1,24,7,5,60,34,26,79
Peterhead,3432,2,24,4,8,80,40,40,76
Stenhousem'r,3432,3,16,8,12,56,46,10,56
Stirling,3432,4,16,6,14,60,52,8,54
Clyde,3432,5,14,10,12,53,50,3,52
Elgin,3432,6,14,6,16,53,61,-8,48
Annan Athlet,3432,7,11,11,14,47,43,4,44
Berwick,3432,8,8,11,17,31,60,-29,35
Edinburgh Ci,3432,9,7,9,20,38,63,-25,30
Cowdenbeath,3432,10,5,10,21,25,54,-29,25
Peterhead,3433,1,24,4,8,79,38,41,76
Montrose,3433,2,23,7,6,60,36,24,76
Stirling,3433,3,17,6,13,63,52,11,57
Clyde,3433,4,15,9,12,52,48,4,54
Stenhousem'r,3433,5,15,8,13,56,49,7,53
Elgin,3433,6,15,6,15,55,61,-6,51
Annan Athlet,3433,7,11,12,13,48,42,6,45
Berwick,3433,8,8,10,18,29,59,-30,34
Edinburgh Ci,3433,9,7,9,20,36,62,-26,30
Cowdenbeath,3433,10,4,11,21,24,55,-31,23
Montrose,3434,1,24,7,5,62,36,26,79
Peterhead,3434,2,24,4,8,79,39,40,76
Stirling,3434,3,16,7,13,62,53,9,55
Clyde,3434,4,15,9,12,58,49,9,54
Stenhousem'r,3434,5,15,9,12,57,48,9,54
Elgin,3434,6,14,6,16,55,63,-8,48
Annan Athlet,3434,7,11,11,14,47,43,4,44
Berwick,3434,8,8,10,18,30,65,-35,34
Edinburgh Ci,3434,9,7,9,20,37,62,-25,30
Cowdenbeath,3434,10,5,10,21,25,54,-29,25
Montrose,3435,1,23,8,5,60,35,25,77
Peterhead,3435,2,24,4,8,79,38,41,76
Stirling,3435,3,16,7,13,62,53,9,55
Stenhousem'r,3435,4,15,9,12,57,48,9,54
Clyde,3435,5,15,9,12,54,49,5,54
Elgin,3435,6,14,7,15,54,61,-7,49
Annan Athlet,3435,7,11,11,14,47,42,5,44
Berwick,3435,8,8,10,18,30,61,-31,34
Edinburgh Ci,3435,9,7,9,20,36,62,-26,30
Cowdenbeath,3435,10,5,10,21,24,54,-30,25
Montrose,3436,1,24,7,5,60,34,26,79
Peterhead,3436,2,24,4,8,82,40,42,76
Stirling,3436,3,17,6,13,64,53,11,57
Stenhousem'r,3436,4,15,8,13,57,50,7,53
Clyde,3436,5,14,9,13,53,51,2,51
Elgin,3436,6,14,6,16,53,61,-8,48
Annan Athlet,3436,7,11,11,14,47,42,5,44
Berwick,3436,8,9,10,17,32,60,-28,37
Edinburgh Ci,3436,9,7,9,20,38,65,-27,30
Cowdenbeath,3436,10,5,10,21,24,54,-30,25
Peterhead,3437,1,24,4,8,81,38,43,76
Montrose,3437,2,23,7,6,59,35,24,76
Stirling,3437,3,17,6,13,62,52,10,57
Stenhousem'r,3437,4,15,8,13,56,48,8,53
Clyde,3437,5,14,9,13,51,49,2,51
Elgin,3437,6,15,6,15,54,60,-6,51
Annan Athlet,3437,7,11,12,13,48,42,6,45
Berwick,3437,8,9,10,17,30,58,-28,37
Edinburgh Ci,3437,9,7,9,20,36,64,-28,30
Cowdenbeath,3437,10,4,11,21,24,55,-31,23
Montrose,3438,1,24,7,5,61,34,27,79
Peterhead,3438,2,24,4,8,83,39,44,76
Stirling,3438,3,17,6,13,64,51,13,57
Clyde,3438,4,15,9,12,53,49,4,54
Stenhousem'r,3438,5,15,8,13,55,50,5,53
Elgin,3438,6,14,6,16,53,62,-9,48
Annan Athlet,3438,7,11,11,14,47,42,5,44
Berwick,3438,8,8,10,18,30,60,-30,34
Edinburgh Ci,3438,9,7,9,20,37,66,-29,30
Cowdenbeath,3438,10,5,10,21,24,54,-30,25
Montrose,3439,1,24,7,5,61,35,26,79
Peterhead,3439,2,23,5,8,78,39,39,74
Stirling,3439,3,16,7,13,61,52,9,55
Stenhousem'r,3439,4,15,9,12,56,47,9,54
Clyde,3439,5,14,9,13,51,50,1,51
Elgin,3439,6,14,6,16,54,62,-8,48
Annan Athlet,3439,7,11,11,14,47,43,4,44
Berwick,3439,8,9,10,17,31,58,-27,37
Edinburgh Ci,3439,9,7,10,19,37,61,-24,31
Cowdenbeath,3439,10,5,10,21,25,54,-29,25
Montrose,3440,1,24,7,5,61,35,26,79
Peterhead,3440,2,24,4,8,80,40,40,76
Stirling,3440,3,17,6,13,65,52,13,57
Stenhousem'r,3440,4,15,8,13,56,51,5,53
Clyde,3440,5,14,10,12,53,50,3,52
Elgin,3440,6,14,6,16,54,62,-8,48
Annan Athlet,3440,7,11,11,14,47,42,5,44
Berwick,3440,8,8,11,17,31,60,-29,35
Edinburgh Ci,3440,9,7,9,20,38,63,-25,30
Cowdenbeath,3440,10,5,10,21,24,54,-30,25
Montrose,3441,1,23,8,5,61,36,25,77
Peterhead,3441,2,24,4,8,79,39,40,76
Stirling,3441,3,16,7,13,60,51,9,55
Stenhousem'r,3441,4,15,9,12,55,46,9,54
Clyde,3441,5,15,9,12,55,50,5,54
Elgin,3441,6,14,7,15,55,62,-7,49
Annan Athlet,3441,7,11,11,14,47,43,4,44
Berwick,3441,8,8,10,18,31,62,-31,34
Edinburgh Ci,3441,9,7,9,20,37,62,-25,30
Cowdenbeath,3441,10,5,10,21,25,54,-29,25
Montrose,3442,1,24,7,5,61,35,26,79
Peterhead,3442,2,24,4,8,80,38,42,76
Stirling,3442,3,17,6,13,62,51,11,57
Clyde,3442,4,15,9,12,53,49,4,54
Stenhousem'r,3442,5,15,8,13,55,48,7,53
Elgin,3442,6,14,6,16,54,62,-8,48
Annan Athlet,3442,7,12,11,13,49,42,7,47
Berwick,3442,8,8,10,18,30,60,-30,34
Edinburgh Ci,3442,9,7,9,20,36,63,-27,30
Cowdenbeath,3442,10,4,10,22,24,56,-32,22
Montrose,3443,1,23,8,5,60,35,25,77
Peterhead,3443,2,24,4,8,81,38,43,76
Stirling,3443,3,17,6,13,64,53,11,57
Clyde,3443,4,15,9,12,52,48,4,54
Stenhousem'r,3443,5,15,8,13,57,50,7,53
Elgin,3443,6,14,7,15,54,61,-7,49
Annan Athlet,3443,7,11,12,13,49,43,6,45
Berwick,3443,8,8,10,18,29,59,-30,34
Edinburgh Ci,3443,9,7,9,20,36,64,-28,30
Cowdenbeath,3443,10,4,11,21,25,56,-31,23
Montrose,3444,1,23,8,5,61,36,25,77
Peterhead,3444,2,24,4,8,78,38,40,76
Stirling,3444,3,17,6,13,62,52,10,57
Clyde,3444,4,15,9,12,53,49,4,54
Stenhousem'r,3444,5,15,8,13,56,48,8,53
Elgin,3444,6,14,7,15,55,62,-7,49
Annan Athlet,3444,7,12,11,13,49,42,7,47
Berwick,3444,8,8,10,18,30,60,-30,34
Edinburgh Ci,3444,9,7,9,20,36,61,-25,30
Cowdenbeath,3444,10,4,10,22,24,56,-32,22
Montrose,3445,1,24,7,5,61,34,27,79
Peterhead,3445,2,24,4,8,78,38,40,76
Stirling,3445,3,17,6,13,63,51,12,57
Stenhousem'r,3445,4,15,8,13,55,49,6,53
Clyde,3445,5,14,10,12,52,49,3,52
Elgin,3445,6,14,6,16,53,62,-9,48
Annan Athlet,3445,7,11,12,13,48,42,6,45
Berwick,3445,8,8,11,17,30,59,-29,35
Edinburgh Ci,3445,9,7,9,20,36,61,-25,30
Cowdenbeath,3445,10,4,11,21,24,55,-31,23
Montrose,3446,1,24,7,5,62,35,27,79
Peterhead,3446,2,24,4,8,79,38,41,76
Stirling,3446,3,17,6,13,64,53,11,57
Clyde,3446,4,15,9,12,53,49,4,54
Stenhousem'r,3446,5,15,8,13,57,50,7,53
Elgin,3446,6,14,6,16,54,63,-9,48
Annan Athlet,3446,7,11,11,14,47,42,5,44
Berwick,3446,8,8,10,18,30,60,-30,34
Edinburgh Ci,3446,9,7,9,20,36,62,-26,30
Cowdenbeath,3446,10,5,10,21,24,54,-30,25
Montrose,3447,1,23,7,6,59,35,24,76
Peterhead,3447,2,23,5,8,80,41,39,74
Stenhousem'r,3447,3,16,8,12,56,46,10,56
Stirling,3447,4,16,6,14,60,52,8,54
Clyde,3447,5,14,10,12,52,49,3,52
Elgin,3447,6,15,6,15,54,60,-6,51
Annan Athlet,3447,7,11,12,13,49,43,6,45
Berwick,3447,8,8,11,17,30,59,-29,35
Edinburgh Ci,3447,9,7,10,19,39,63,-24,31
Cowdenbeath,3447,10,4,11,21,25,56,-31,23
Montrose,3448,1,24,7,5,61,34,27,79
Peterhead,3448,2,24,4,8,81,39,42,76
Stirling,3448,3,17,6,13,66,52,14,57
Stenhousem'r,3448,4,15,8,13,56,52,4,53
Clyde,3448,5,14,10,12,52,49,3,52
Elgin,3448,6,14,6,16,53,62,-9,48
Annan Athlet,3448,7,12,11,13,48,41,7,47
Berwick,3448,8,8,11,17,30,59,-29,35
Edinburgh Ci,3448,9,7,9,20,37,64,-27,30
Cowdenbeath,3448,10,4,10,22,23,55,-32,22
Montrose,3449,1,24,7,5,63,36,27,79
Peterhead,3449,2,24,4,8,79,39,40,76
Stirling,3449,3,16,7,13,62,53,9,55
Stenhousem'r,3449,4,15,9,12,57,48,9,54
Clyde,3449,5,14,9,13,52,50,2,51
Elgin,3449,6,14,6,16,55,64,-9,48
Annan Athlet,3449,7,11,12,13,49,43,6,45
Berwick,3449,8,9,10,17,31,59,-28,37
Edinburgh Ci,3449,9,7,9,20,37,62,-25,30
Cowdenbeath,3449,10,4,11,21,25,56,-31,23
Montrose,3450,1,24,7,5,60,34,26,79
Peterhead,3450,2,24,4,8,79,38,41,76
Stirling,3450,3,16,7,13,60,51,9,55
Stenhousem'r,3450,4,15,9,12,55,46,9,54
Clyde,3450,5,14,10,12,52,49,3,52
Elgin,3450,6,14,6,16,53,61,-8,48
Annan Athlet,3450,7,11,11,14,47,43,4,44
Berwick,3450,8,8,11,17,30,59,-29,35
Edinburgh Ci,3450,9,7,9,20,36,62,-26,30
Cowdenbeath,3450,10,5,10,21,25,54,-29,25
Montrose,3451,1,24,7,5,62,35,27,79
Peterhead,3451,2,24,4,8,81,41,40,76
Stenhousem'r,3451,3,16,8,12,59,46,13,56
Stirling,3451,4,16,6,14,60,55,5,54
Clyde,3451,5,15,9,12,53,48,5,54
Elgin,3451,6,14,6,16,54,63,-9,48
Annan Athlet,3451,7,11,11,14,48,43,5,44
Berwick,3451,8,8,10,18,29,60,-31,34
Edinburgh Ci,3451,9,7,9,20,39,64,-25,30
Cowdenbeath,3451,10,5,10,21,25,55,-30,25
Montrose,3452,1,24,7,5,62,36,26,79
Peterhead,3452,2,24,4,8,78,38,40,76
Stenhousem'r,3452,3,16,8,12,57,47,10,56
Stirling,3452,4,16,6,14,61,53,8,54
Clyde,3452,5,14,10,12,52,49,3,52
Elgin,3452,6,14,6,16,55,63,-8,48
Annan Athlet,3452,7,12,11,13,48,41,7,47
Berwick,3452,8,8,11,17,30,59,-29,35
Edinburgh Ci,3452,9,7,9,20,36,61,-25,30
Cowdenbeath,3452,10,4,10,22,23,55,-32,22
Montrose,3453,1,24,7,5,61,35,26,79
Peterhead,3453,2,24,4,8,83,38,45,76
Stenhousem'r,3453,3,16,8,12,58,48,10,56
Stirling,3453,4,16,6,14,62,54,8,54
Clyde,3453,5,15,9,12,54,49,5,54
Elgin,3453,6,14,6,16,54,62,-8,48
Annan Athlet,3453,7,11,11,14,47,42,5,44
Berwick,3453,8,8,10,18,30,61,-31,34
Edinburgh Ci,3453,9,7,9,20,36,66,-30,30
Cowdenbeath,3453,10,5,10,21,24,54,-30,25
Montrose,3454,1,23,8,5,61,36,25,77
Peterhead,3454,2,23,5,8,77,38,39,74
Stirling,3454,3,17,6,13,63,52,11,57
Stenhousem'r,3454,4,15,8,13,56,49,7,53
Clyde,3454,5,14,10,12,53,50,3,52
Elgin,3454,6,14,7,15,55,62,-7,49
Annan Athlet,3454,7,11,11,14,47,44,3,44
Berwick,3454,8,8,11,17,31,60,-29,35
Edinburgh Ci,3454,9,7,10,19,36,60,-24,31
Cowdenbeath,3454,10,5,10,21,26,54,-28,25
Montrose,3455,1,23,8,5,59,34,25,77
Peterhead,3455,2,24,4,8,79,38,41,76
Stirling,3455,3,17,6,13,62,51,11,57
Stenhousem'r,3455,4,15,8,13,55,48,7,53
Clyde,3455,5,14,9,13,51,49,2,51
Elgin,3455,6,14,7,15,53,60,-7,49
Annan Athlet,3455,7,12,11,13,50,42,8,47
Berwick,3455,8,9,10,17,30,58,-28,37
Edinburgh Ci,3455,9,7,9,20,36,62,-26,30
Cowdenbeath,3455,10,4,10,22,24,57,-33,22
Peterhead,3456,1,24,4,8,80,39,41,76
Montrose,3456,2,23,7,6,59,35,24,76
Stirling,3456,3,17,6,13,63,53,10,57
Stenhousem'r,3456,4,15,8,13,57,49,8,53
Clyde,3456,5,14,10,12,52,49,3,52
Elgin,3456,6,15,6,15,54,60,-6,51
Annan Athlet,3456,7,11,12,13,49,43,6,45
Berwick,3456,8,8,11,17,30,59,-29,35
Edinburgh Ci,3456,9,7,9,20,37,63,-26,30
Cowdenbeath,3456,10,4,11,21,25,56,-31,23
Montrose,3457,1,24,7,5,61,34,27,79
Peterhead,3457,2,24,4,8,81,38,43,76
Stirling,3457,3,17,6,13,63,52,11,57
Clyde,3457,4,15,9,12,53,49,4,54
Stenhousem'r,3457,5,15,8,13,56,49,7,53
Elgin,3457,6,14,6,16,53,62,-9,48
Annan Athlet,3457,7,11,11,14,47,42,5,44
Berwick,3457,8,8,10,18,30,60,-30,34
Edinburgh Ci,3457,9,7,9,20,36,64,-28,30
Cowdenbeath,3457,10,5,10,21,24,54,-30,25
Montrose,3458,1,24,7,5,64,34,30,79
Peterhead,3458,2,24,4,8,79,39,40,76
Stirling,3458,3,16,7,13,61,52,9,55
Stenhousem'r,3458,4,15,9,12,56,47,9,54
Clyde,3458,5,15,9,12,52,48,4,54
Elgin,3458,6,14,6,16,53,65,-12,48
Annan Athlet,3458,7,12,11,13,50,42,8,47
Berwick,3458,8,8,10,18,29,59,-30,34
Edinburgh Ci,3458,9,7,9,20,37,62,-25,30
Cowdenbeath,3458,10,4,10,22,24,57,-33,22
Montrose,3459,1,23,8,5,61,36,25,77
Peterhead,3459,2,24,4,8,81,39,42,76
Stenhousem'r,3459,3,16,8,12,58,48,10,56
Stirling,3459,4,16,6,14,62,54,8,54
Clyde,3459,5,15,9,12,56,50,6,54
Elgin,3459,6,14,7,15,55,62,-7,49
Annan Athlet,3459,7,11,12,13,48,42,6,45
Berwick,3459,8,8,10,18,31,63,-32,34
Edinburgh Ci,3459,9,7,9,20,37,64,-27,30
Cowdenbeath,3459,10,4,11,21,24,55,-31,23
Peterhead,3460,1,24,4,8,79,38,41,76
Montrose,3460,2,23,7,6,59,35,24,76
Stenhousem'r,3460,3,16,8,12,57,46,11,56
Stirling,3460,4,16,6,14,60,53,7,54
Clyde,3460,5,15,9,12,53,49,4,54
Elgin,3460,6,15,6,15,54,60,-6,51
Annan Athlet,3460,7,11,12,13,47,41,6,45
Berwick,3460,8,8,10,18,30,60,-30,34
Edinburgh Ci,3460,9,7,9,20,36,62,-26,30
Cowdenbeath,3460,10,4,11,21,23,54,-31,23
Peterhead,3461,1,24,4,8,78,38,40,76
Montrose,3461,2,23,7,6,60,36,24,76
Stirling,3461,3,16,7,13,61,52,9,55
Stenhousem'r,3461,4,15,9,12,56,47,9,54
Clyde,3461,5,15,9,12,53,48,5,54
Elgin,3461,6,15,6,15,55,61,-6,51
Annan Athlet,3461,7,11,11,14,47,44,3,44
Berwick,3461,8,8,10,18,29,60,-31,34
Edinburgh Ci,3461,9,7,9,20,36,61,-25,30
Cowdenbeath,3461,10,5,10,21,26,54,-28,25
Montrose,3462,1,24,7,5,61,35,26,79
Peterhead,3462,2,23,5,8,78,39,39,74
Stirling,3462,3,16,7,13,61,52,9,55
Stenhousem'r,3462,4,15,9,12,56,47,9,54
Clyde,3462,5,14,9,13,52,50,2,51
Elgin,3462,6,14,6,16,54,62,-8,48
Annan Athlet,3462,7,11,11,14,47,42,5,44
Berwick,3462,8,9,10,17,31,59,-28,37
Edinburgh Ci,3462,9,7,10,19,37,61,-24,31
Cowdenbeath,3462,10,5,10,21,24,54,-30,25
Montrose,3463,1,24,7,5,62,35,27,79
Peterhead,3463,2,23,5,8,79,40,39,74
Stenhousem'r,3463,3,16,8,12,56,46,10,56
Stirling,3463,4,16,6,14,60,52,8,54
Clyde,3463,5,15,9,12,54,48,6,54
Elgin,3463,6,14,6,16,54,63,-9,48
Annan Athlet,3463,7,11,12,13,48,42,6,45
Berwick,3463,8,8,10,18,29,61,-32,34
Edinburgh Ci,3463,9,7,10,19,38,62,-24,31
Cowdenbeath,3463,10,4,11,21,24,55,-31,23
Montrose,3464,1,24,7,5,62,36,26,79
Peterhead,3464,2,24,4,8,79,39,40,76
Stirling,3464,3,16,7,13,61,52,9,55
Stenhousem'r,3464,4,15,9,12,56,47,9,54
Clyde,3464,5,15,9,12,53,48,5,54
Elgin,3464,6,14,6,16,55,63,-8,48
Annan Athlet,3464,7,12,11,13,48,41,7,47
Berwick,3464,8,8,10,18,29,60,-31,34
Edinburgh Ci,3464,9,7,9,20,37,62,-25,30
Cowdenbeath,3464,10,4,10,22,23,55,-32,22
Montrose,3465,1,24,7,5,61,35,26,79
Peterhead,3465,2,24,4,8,78,38,40,76
Stenhousem'r,3465,3,16,8,12,58,47,11,56
Stirling,3465,4,16,6,14,61,54,7,54
Clyde,3465,5,14,9,13,51,49,2,51
Elgin,3465,6,14,6,16,54,62,-8,48
Annan Athlet,3465,7,11,12,13,47,41,6,45
Berwick,3465,8,9,10,17,30,58,-28,37
Edinburgh Ci,3465,9,7,9,20,36,61,-25,30
Cowdenbeath,3465,10,4,11,21,23,54,-31,23
Montrose,3466,1,24,7,5,63,35,28,79
Peterhead,3466,2,24,4,8,80,40,40,76
Stirling,3466,3,17,6,13,64,53,11,57
Stenhousem'r,3466,4,15,8,13,57,50,7,53
Clyde,3466,5,14,9,13,51,50,1,51
Elgin,3466,6,14,6,16,54,64,-10,48
Annan Athlet,3466,7,11,12,13,48,42,6,45
Berwick,3466,8,9,10,17,31,58,-27,37
Edinburgh Ci,3466,9,7,9,20,38,63,-25,30
Cowdenbeath,3466,10,4,11,21,24,55,-31,23
Montrose,3467,1,24,7,5,62,36,26,79
Peterhead,3467,2,24,4,8,83,39,44,76
Stenhousem'r,3467,3,16,8,12,60,46,14,56
Stirling,3467,4,16,6,14,60,56,4,54
Clyde,3467,5,15,9,12,53,49,4,54
Elgin,3467,6,14,6,16,55,63,-8,48
Annan Athlet,3467,7,12,11,13,49,41,8,47
Berwick,3467,8,8,10,18,30,60,-30,34
Edinburgh Ci,3467,9,7,9,20,37,66,-29,30
Cowdenbeath,3467,10,4,10,22,23,56,-33,22
Montrose,3468,1,24,7,5,62,35,27,79
Peterhead,3468,2,24,4,8,80,38,42,76
Stirling,3468,3,16,7,13,60,51,9,55
Stenhousem'r,3468,4,15,9,12,55,46,9,54
Clyde,3468,5,14,10,12,52,49,3,52
Elgin,3468,6,14,6,16,54,63,-9,48
Annan Athlet,3468,7,11,12,13,47,41,6,45
Berwick,3468,8,8,11,17,30,59,-29,35
Edinburgh Ci,3468,9,7,9,20,36,63,-27,30
Cowdenbeath,3468,10,4,11,21,23,54,-31,23
Montrose,3469,1,24,7,5,60,34,26,79
Peterhead,3469,2,24,4,8,80,38,42,76
Stirling,3469,3,16,7,13,60,51,9,55
Stenhousem'r,3469,4,15,9,12,55,46,9,54
Clyde,3469,5,14,10,12,51,48,3,52
Elgin,3469,6,14,6,16,53,61,-8,48
Annan Athlet,3469,7,11,12,13,49,43,6,45
Berwick,3469,8,8,11,17,29,58,-29,35
Edinburgh Ci,3469,9,7,9,20,36,63,-27,30
Cowdenbeath,3469,10,4,11,21,25,56,-31,23
Montrose,3470,1,24,7,5,62,34,28,79
Peterhead,3470,2,24,4,8,80,39,41,76
Stirling,3470,3,16,7,13,61,52,9,55
Stenhousem'r,3470,4,15,9,12,56,47,9,54
Clyde,3470,5,15,9,12,54,49,5,54
Elgin,3470,6,14,6,16,53,63,-10,48
Annan Athlet,3470,7,11,12,13,47,41,6,45
Berwick,3470,8,8,10,18,30,61,-31,34
Edinburgh Ci,3470,9,7,9,20,37,63,-26,30
Cowdenbeath,3470,10,4,11,21,23,54,-31,23
Montrose,3471,1,23,8,5,60,35,25,77
Peterhead,3471,2,23,4,9,77,39,38,73
Stenhousem'r,3471,3,16,8,12,58,46,12,56
Stirling,3471,4,16,6,14,60,54,6,54
Clyde,3471,5,14,10,12,52,49,3,52
Elgin,3471,6,14,7,15,54,61,-7,49
Annan Athlet,3471,7,11,12,13,48,42,6,45
Berwick,3471,8,8,11,17,30,59,-29,35
Edinburgh Ci,3471,9,8,9,19,37,60,-23,33
Cowdenbeath,3471,10,4,11,21,24,55,-31,23
Peterhead,3472,1,24,4,8,80,38,42,76
Montrose,3472,2,23,7,6,59,35,24,76
Stirling,3472,3,16,7,13,62,53,9,55
Stenhousem'r,3472,4,15,9,12,57,48,9,54
Clyde,3472,5,14,10,12,51,48,3,52
Elgin,3472,6,15,6,15,54,60,-6,51
Annan Athlet,3472,7,11,11,14,47,42,5,44
Berwick,3472,8,8,11,17,29,58,-29,35
Edinburgh Ci,3472,9,7,9,20,36,63,-27,30
Cowdenbeath,3472,10,5,10,21,24,54,-30,25
Montrose,3473,1,24,7,5,61,35,26,79
Peterhead,3473,2,24,4,8,80,38,42,76
Stenhousem'r,3473,3,16,8,12,58,47,11,56
Stirling,3473,4,16,6,14,61,54,7,54
Clyde,3473,5,15,9,12,53,48,5,54
Elgin,3473,6,14,6,16,54,62,-8,48
Annan Athlet,3473,7,11,11,14,48,44,4,44
Berwick,3473,8,8,10,18,29,60,-31,34
Edinburgh Ci,3473,9,7,9,20,36,63,-27,30
Cowdenbeath,3473,10,5,10,21,26,55,-29,25
Montrose,3474,1,24,7,5,62,34,28,79
Peterhead,3474,2,23,5,8,78,39,39,74
Stirling,3474,3,16,7,13,61,52,9,55
Stenhousem'r,3474,4,15,9,12,56,47,9,54
Clyde,3474,5,15,9,12,54,50,4,54
Elgin,3474,6,14,6,16,53,63,-10,48
Annan Athlet,3474,7,11,11,14,47,43,4,44
Berwick,3474,8,8,10,18,31,61,-30,34
Edinburgh Ci,3474,9,7,10,19,37,61,-24,31
Cowdenbeath,3474,10,5,10,21,25,54,-29,25
Montrose,3475,1,23,8,5,61,36,25,77
Peterhead,3475,2,24,4,8,80,39,41,76
Stirling,3475,3,17,6,13,62,52,10,57
Clyde,3475,4,15,9,12,54,48,6,54
Stenhousem'r,3475,5,15,8,13,56,48,8,53
Elgin,3475,6,14,7,15,55,62,-7,49
Annan Athlet,3475,7,12,11,13,48,41,7,47
Berwick,3475,8,8,10,18,29,61,-32,34
Edinburgh Ci,3475,9,7,9,20,37,63,-26,30
Cowdenbeath,3475,10,4,10,22,23,55,-32,22
Montrose,3476,1,23,8,5,60,35,25,77
Peterhead,3476,2,24,4,8,79,38,41,76
Stirling,3476,3,17,6,13,63,52,11,57
Stenhousem'r,3476,4,15,8,13,56,49,7,53
Clyde,3476,5,14,10,12,54,51,3,52
Elgin,3476,6,14,7,15,54,61,-7,49
Annan Athlet,3476,7,12,11,13,49,42,7,47
Berwick,3476,8,8,11,17,32,61,-29,35
Edinburgh Ci,3476,9,7,9,20,36,62,-26,30
Cowdenbeath,3476,10,4,10,22,24,56,-32,22
Peterhead,3477,1,24,4,8,79,38,41,76
Montrose,3477,2,23,7,6,59,35,24,76
Stirling,3477,3,17,6,13,63,53,10,57
Stenhousem'r,3477,4,15,8,13,57,49,8,53
Clyde,3477,5,14,9,13,51,49,2,51
Elgin,3477,6,15,6,15,54,60,-6,51
Annan Athlet,3477,7,11,11,14,47,43,4,44
Berwick,3477,8,9,10,17,30,58,-28,37
Edinburgh Ci,3477,9,7,9,20,36,62,-26,30
Cowdenbeath,3477,10,5,10,21,25,54,-29,25
Montrose,3478,1,23,8,5,60,35,25,77
Peterhead,3478,2,24,4,8,80,39,41,76
Stirling,3478,3,17,6,13,64,53,11,57
Stenhousem'r,3478,4,15,8,13,57,50,7,53
Clyde,3478,5,14,9,13,51,49,2,51
Elgin,3478,6,14,7,15,54,61,-7,49
Annan Athlet,3478,7,12,11,13,49,41,8,47
Berwick,3478,8,9,10,17,30,58,-28,37
Edinburgh Ci,3478,9,7,9,20,37,63,-26,30
Cowdenbeath,3478,10,4,10,22,23,56,-33,22
Peterhead,3479,1,24,4,8,81,38,43,76
Montrose,3479,2,23,7,6,59,36,23,76
Stirling,3479,3,17,6,13,65,52,13,57
Clyde,3479,4,15,9,12,55,49,6,54
Stenhousem'r,3479,5,15,8,13,56,51,5,53
Elgin,3479,6,15,6,15,55,60,-5,51
Annan Athlet,3479,7,11,11,14,48,44,4,44
Berwick,3479,8,8,10,18,30,62,-32,34
Edinburgh Ci,3479,9,7,9,20,36,64,-28,30
Cowdenbeath,3479,10,5,10,21,26,55,-29,25
Montrose,3480,1,24,7,5,62,34,28,79
Peterhead,3480,2,24,4,8,82,40,42,76
Stenhousem'r,3480,3,16,8,12,56,46,10,56
Stirling,3480,4,16,6,14,60,52,8,54
Clyde,3480,5,14,10,12,52,49,3,52
Elgin,3480,6,14,6,16,53,63,-10,48
Annan Athlet,3480,7,11,11,14,47,43,4,44
Berwick,3480,8,8,11,17,30,59,-29,35
Edinburgh Ci,3480,9,7,9,20,38,65,-27,30
Cowdenbeath,3480,10,5,10,21,25,54,-29,25
Montrose,3481,1,24,7,5,62,35,27,79
Peterhead,3481,2,24,4,8,79,39,40,76
Stirling,3481,3,17,6,13,63,53,10,57
Stenhousem'r,3481,4,15,8,13,57,49,8,53
Clyde,3481,5,14,9,13,53,51,2,51
Elgin,3481,6,14,6,16,54,63,-9,48
Annan Athlet,3481,7,12,11,13,48,41,7,47
Berwick,3481,8,9,10,17,32,60,-28,37
Edinburgh Ci,3481,9,7,9,20,37,62,-25,30
Cowdenbeath,3481,10,4,10,22,23,55,-32,22
Montrose,3482,1,24,7,5,62,36,26,79
Peterhead,3482,2,24,4,8,78,38,40,76
Stenhousem'r,3482,3,16,8,12,59,47,12,56
Stirling,3482,4,16,6,14,61,55,6,54
Clyde,3482,5,14,10,12,52,49,3,52
Elgin,3482,6,14,6,16,55,63,-8,48
Annan Athlet,3482,7,11,11,14,47,42,5,44
Berwick,3482,8,8,11,17,30,59,-29,35
Edinburgh Ci,3482,9,7,9,20,36,61,-25,30
Cowdenbeath,3482,10,5,10,21,24,54,-30,25
Montrose,3483,1,24,7,5,61,35,26,79
Peterhead,3483,2,23,5,8,79,40,39,74
Stirling,3483,3,17,6,13,62,52,10,57
Stenhousem'r,3483,4,15,8,13,56,48,8,53
Clyde,3483,5,14,9,13,52,50,2,51
Elgin,3483,6,14,6,16,54,62,-8,48
Annan Athlet,3483,7,12,11,13,48,41,7,47
Berwick,3483,8,9,10,17,31,59,-28,37
Edinburgh Ci,3483,9,7,10,19,38,62,-24,31
Cowdenbeath,3483,10,4,10,22,23,55,-32,22
Montrose,3484,1,24,7,5,66,34,32,79
Peterhead,3484,2,24,4,8,81,39,42,76
Stirling,3484,3,17,6,13,64,51,13,57
Clyde,3484,4,15,9,12,53,48,5,54
Stenhousem'r,3484,5,15,8,13,55,50,5,53
Elgin,3484,6,14,6,16,53,67,-14,48
Annan Athlet,3484,7,12,11,13,48,41,7,47
Berwick,3484,8,8,10,18,29,60,-31,34
Edinburgh Ci,3484,9,7,9,20,37,64,-27,30
Cowdenbeath,3484,10,4,10,22,23,55,-32,22
Montrose,3485,1,23,8,5,61,36,25,77
Peterhead,3485,2,24,4,8,80,39,41,76
Stirling,3485,3,17,6,13,62,52,10,57
Clyde,3485,4,15,9,12,53,49,4,54
Stenhousem'r,3485,5,15,8,13,56,48,8,53
Elgin,3485,6,14,7,15,55,62,-7,49
Annan Athlet,3485,7,12,11,13,51,42,9,47
Berwick,3485,8,8,10,18,30,60,-30,34
Edinburgh Ci,3485,9,7,9,20,37,63,-26,30
Cowdenbeath,3485,10,4,10,22,24,58,-34,22
Montrose,3486,1,24,7,5,61,35,26,79
Peterhead,3486,2,24,4,8,81,38,43,76
Stenhousem'r,3486,3,16,8,12,59,46,13,56
Stirling,3486,4,16,6,14,60,55,5,54
Clyde,3486,5,15,9,12,54,50,4,54
Elgin,3486,6,14,6,16,54,62,-8,48
Annan Athlet,3486,7,12,11,13,49,41,8,47
Berwick,3486,8,8,10,18,31,61,-30,34
Edinburgh Ci,3486,9,7,9,20,36,64,-28,30
Cowdenbeath,3486,10,4,10,22,23,56,-33,22
Montrose,3487,1,24,7,5,62,36,26,79
Peterhead,3487,2,24,4,8,79,38,41,76
Stirling,3487,3,17,6,13,63,51,12,57
Clyde,3487,4,15,9,12,56,48,8,54
Stenhousem'r,3487,5,15,8,13,55,49,6,53
Elgin,3487,6,14,6,16,55,63,-8,48
Annan Athlet,3487,7,11,11,14,48,43,5,44
Berwick,3487,8,8,10,18,29,63,-34,34
Edinburgh Ci,3487,9,7,9,20,36,62,-26,30
Cowdenbeath,3487,10,5,10,21,25,55,-30,25
Montrose,3488,1,24,7,5,61,34,27,79
Peterhead,3488,2,23,5,8,78,39,39,74
Stirling,3488,3,17,6,13,62,52,10,57
Clyde,3488,4,15,9,12,54,49,5,54
Stenhousem'r,3488,5,15,8,13,56,48,8,53
Elgin,3488,6,14,6,16,53,62,-9,48
Annan Athlet,3488,7,11,12,13,48,42,6,45
Berwick,3488,8,8,10,18,30,61,-31,34
Edinburgh Ci,3488,9,7,10,19,37,61,-24,31
Cowdenbeath,3488,10,4,11,21,24,55,-31,23
Montrose,3489,1,23,8,5,61,36,25,77
Peterhead,3489,2,24,4,8,80,39,41,76
Stenhousem'r,3489,3,16,8,12,58,46,12,56
Stirling,3489,4,16,6,14,60,54,6,54
Clyde,3489,5,15,9,12,54,49,5,54
Elgin,3489,6,14,7,15,55,62,-7,49
Annan Athlet,3489,7,11,11,14,48,43,5,44
Berwick,3489,8,8,10,18,30,61,-31,34
Edinburgh Ci,3489,9,7,9,20,37,63,-26,30
Cowdenbeath,3489,10,5,10,21,25,55,-30,25
Montrose,3490,1,24,7,5,61,34,27,79
Peterhead,3490,2,24,4,8,82,38,44,76
Stirling,3490,3,16,7,13,61,52,9,55
Stenhousem'r,3490,4,15,9,12,56,47,9,54
Clyde,3490,5,15,9,12,54,48,6,54
Elgin,3490,6,14,6,16,53,62,-9,48
Annan Athlet,3490,7,12,11,13,50,43,7,47
Berwick,3490,8,8,10,18,29,61,-32,34
Edinburgh Ci,3490,9,7,9,20,36,65,-29,30
Cowdenbeath,3490,10,4,10,22,25,57,-32,22
Montrose,3491,1,24,7,5,62,36,26,79
Peterhead,3491,2,23,5,8,79,40,39,74
Stirling,3491,3,17,6,13,62,52,10,57
Clyde,3491,4,15,9,12,53,48,5,54
Stenhousem'r,3491,5,15,8,13,56,48,8,53
Elgin,3491,6,14,6,16,55,63,-8,48
Annan Athlet,3491,7,11,11,14,47,43,4,44
Berwick,3491,8,8,10,18,29,60,-31,34
Edinburgh Ci,3491,9,7,10,19,38,62,-24,31
Cowdenbeath,3491,10,5,10,21,25,54,-29,25
Montrose,3492,1,24,7,5,62,35,27,79
Peterhead,3492,2,24,4,8,80,39,41,76
Stirling,3492,3,17,6,13,62,51,11,57
Clyde,3492,4,15,9,12,53,48,5,54
Stenhousem'r,3492,5,15,8,13,55,48,7,53
Elgin,3492,6,14,6,16,54,63,-9,48
Annan Athlet,3492,7,12,11,13,48,41,7,47
Berwick,3492,8,8,10,18,29,60,-31,34
Edinburgh Ci,3492,9,7,9,20,37,63,-26,30
Cowdenbeath,3492,10,4,10,22,23,55,-32,22
Montrose,3493,1,23,8,5,60,35,25,77
Peterhead,3493,2,24,4,8,79,39,40,76
Stirling,3493,3,17,6,13,63,51,12,57
Clyde,3493,4,15,9,12,54,49,5,54
Stenhousem'r,3493,5,15,8,13,55,49,6,53
Elgin,3493,6,14,7,15,54,61,-7,49
Annan Athlet,3493,7,11,12,13,48,42,6,45
Berwick,3493,8,8,10,18,30,61,-31,34
Edinburgh Ci,3493,9,7,9,20,37,62,-25,30
Cowdenbeath,3493,10,4,11,21,24,55,-31,23
Montrose,3494,1,24,7,5,66,36,30,79
Peterhead,3494,2,24,4,8,80,39,41,76
Stirling,3494,3,16,7,13,61,52,9,55
Stenhousem'r,3494,4,15,9,12,56,47,9,54
Clyde,3494,5,15,9,12,54,50,4,54
Elgin,3494,6,14,6,16,55,67,-12,48
Annan Athlet,3494,7,12,11,13,50,41,9,47
Berwick,3494,8,8,10,18,31,61,-30,34
Edinburgh Ci,3494,9,7,9,20,37,63,-26,30
Cowdenbeath,3494,10,4,10,22,23,57,-34,22
Montrose,3495,1,23,8,5,59,34,25,77
Peterhead,3495,2,24,4,8,82,38,44,76
Stenhousem'r,3495,3,16,8,12,58,48,10,56
Stirling,3495,4,16,6,14,62,54,8,54
Clyde,3495,5,15,9,12,52,48,4,54
Elgin,3495,6,14,7,15,53,60,-7,49
Annan Athlet,3495,7,11,11,14,48,43,5,44
Berwick,3495,8,8,10,18,29,59,-30,34
Edinburgh Ci,3495,9,7,9,20,36,65,-29,30
Cowdenbeath,3495,10,5,10,21,25,55,-30,25
Montrose,3496,1,24,7,5,61,34,27,79
Peterhead,3496,2,24,4,8,79,38,41,76
Stirling,3496,3,16,7,13,62,53,9,55
Stenhousem'r,3496,4,15,9,12,57,48,9,54
Clyde,3496,5,15,9,12,53,48,5,54
Elgin,3496,6,14,6,16,53,62,-9,48
Annan Athlet,3496,7,11,12,13,47,41,6,45
Berwick,3496,8,8,10,18,29,60,-31,34
Edinburgh Ci,3496,9,7,9,20,36,62,-26,30
Cowdenbeath,3496,10,4,11,21,23,54,-31,23
Montrose,3497,1,24,7,5,63,35,28,79
Peterhead,3497,2,24,4,8,79,38,41,76
Stenhousem'r,3497,3,16,8,12,57,46,11,56
Stirling,3497,4,16,6,14,60,53,7,54
Clyde,3497,5,15,9,12,55,49,6,54
Elgin,3497,6,14,6,16,54,64,-10,48
Annan Athlet,3497,7,11,12,13,48,42,6,45
Berwick,3497,8,8,10,18,30,62,-32,34
Edinburgh Ci,3497,9,7,9,20,36,62,-26,30
Cowdenbeath,3497,10,4,11,21,24,55,-31,23
Montrose,3498,1,24,7,5,61,34,27,79
Peterhead,3498,2,24,4,8,79,39,40,76
Stenhousem'r,3498,3,16,8,12,56,46,10,56
Stirling,3498,4,16,6,14,60,52,8,54
Clyde,3498,5,15,9,12,56,50,6,54
Elgin,3498,6,14,6,16,53,62,-9,48
Annan Athlet,3498,7,12,11,13,49,41,8,47
Berwick,3498,8,8,10,18,31,63,-32,34
Edinburgh Ci,3498,9,7,9,20,37,62,-25,30
Cowdenbeath,3498,10,4,10,22,23,56,-33,22
Montrose,3499,1,23,8,5,59,34,25,77
Peterhead,3499,2,23,5,8,78,39,39,74
Stirling,3499,3,17,6,13,61,51,10,57
Clyde,3499,4,15,9,12,54,48,6,54
Stenhousem'r,3499,5,15,8,13,55,47,8,53
Elgin,3499,6,14,7,15,53,60,-7,49
Annan Athlet,3499,7,11,11,14,47,42,5,44
Berwick,3499,8,8,10,18,29,61,-32,34
Edinburgh Ci,3499,9,7,10,19,37,61,-24,31
Cowdenbeath,3499,10,5,10,21,24,54,-30,25
Montrose,3500,1,24,7,5,62,34,28,79
Peterhead,3500,2,24,4,8,79,39,40,76
Stirling,3500,3,17,6,13,63,53,10,57
Stenhousem'r,3500,4,15,8,13,57,49,8,53
Clyde,3500,5,14,10,12,52,49,3,52
Elgin,3500,6,14,6,16,53,63,-10,48
Annan Athlet,3500,7,12,11,13,50,42,8,47
Berwick,3500,8,8,11,17,30,59,-29,35
Edinburgh Ci,3500,9,7,9,20,37,62,-25,30
Cowdenbeath,3500,10,4,10,22,24,57,-33,22
Peterhead,3501,1,24,4,8,79,38,41,76
Montrose,3501,2,23,7,6,59,35,24,76
Stirling,3501,3,16,7,13,60,51,9,55
Stenhousem'r,3501,4,15,9,12,55,46,9,54
Clyde,3501,5,15,9,12,54,48,6,54
Elgin,3501,6,15,6,15,54,60,-6,51
Annan Athlet,3501,7,11,12,13,47,41,6,45
Berwick,3501,8,8,10,18,29,61,-32,34
Edinburgh Ci,3501,9,7,9,20,36,62,-26,30
Cowdenbeath,3501,10,4,11,21,23,54,-31,23
Montrose,3502,1,24,7,5,61,35,26,79
Peterhead,3502,2,23,4,9,77,39,38,73
Stirling,3502,3,16,7,13,60,51,9,55
Stenhousem'r,3502,4,15,9,12,55,46,9,54
Clyde,3502,5,15,9,12,55,48,7,54
Elgin,3502,6,14,6,16,54,62,-8,48
Annan Athlet,3502,7,11,12,13,47,41,6,45
Berwick,3502,8,8,10,18,29,62,-33,34
Edinburgh Ci,3502,9,8,9,19,37,60,-23,33
Cowdenbeath,3502,10,4,11,21,23,54,-31,23
Montrose,3503,1,24,7,5,61,34,27,79
Peterhead,3503,2,24,4,8,80,40,40,76
Stirling,3503,3,17,6,13,61,51,10,57
Clyde,3503,4,15,9,12,55,48,7,54
Stenhousem'r,3503,5,15,8,13,55,47,8,53
Elgin,3503,6,14,6,16,53,62,-9,48
Annan Athlet,3503,7,11,12,13,48,42,6,45
Berwick,3503,8,8,10,18,29,62,-33,34
Edinburgh Ci,3503,9,7,9,20,38,63,-25,30
Cowdenbeath,3503,10,4,11,21,24,55,-31,23
Montrose,3504,1,24,7,5,61,35,26,79
Peterhead,3504,2,23,4,9,78,41,37,73
Stenhousem'r,3504,3,16,8,12,57,47,10,56
Stirling,3504,4,16,6,14,61,53,8,54
Clyde,3504,5,14,10,12,52,49,3,52
Elgin,3504,6,14,6,16,54,62,-8,48
Annan Athlet,3504,7,12,11,13,50,42,8,47
Berwick,3504,8,8,11,17,30,59,-29,35
Edinburgh Ci,3504,9,8,9,19,39,61,-22,33
Cowdenbeath,3504,10,4,10,22,24,57,-33,22
Montrose,3505,1,23,8,5,59,34,25,77
Peterhead,3505,2,24,4,8,78,38,40,76
Stirling,3505,3,16,7,13,60,51,9,55
Stenhousem'r,3505,4,15,9,12,55,46,9,54
Clyde,3505,5,14,10,12,52,49,3,52
Elgin,3505,6,14,7,15,53,60,-7,49
Annan Athlet,3505,7,11,11,14,47,42,5,44
Berwick,3505,8,8,11,17,30,59,-29,35
Edinburgh Ci,3505,9,7,9,20,36,61,-25,30
Cowdenbeath,3505,10,5,10,21,24,54,-30,25
Montrose,3506,1,24,7,5,62,36,26,79
Peterhead,3506,2,24,4,8,79,38,41,76
Stenhousem'r,3506,3,16,8,12,57,47,10,56
Stirling,3506,4,16,6,14,61,53,8,54
Clyde,3506,5,15,9,12,53,49,4,54
Elgin,3506,6,14,6,16,55,63,-8,48
Annan Athlet,3506,7,11,12,13,47,41,6,45
Berwick,3506,8,8,10,18,30,60,-30,34
Edinburgh Ci,3506,9,7,9,20,36,62,-26,30
Cowdenbeath,3506,10,4,11,21,23,54,-31,23
Montrose,3507,1,23,7,6,59,35,24,76
Peterhead,3507,2,23,4,9,79,41,38,73
Stirling,3507,3,17,6,13,62,52,10,57
Clyde,3507,4,15,9,12,53,49,4,54
Stenhousem'r,3507,5,15,8,13,56,48,8,53
Elgin,3507,6,15,6,15,54,60,-6,51
Annan Athlet,3507,7,11,11,14,48,43,5,44
Berwick,3507,8,8,10,18,30,60,-30,34
Edinburgh Ci,3507,9,8,9,19,39,62,-23,33
Cowdenbeath,3507,10,5,10,21,25,55,-30,25
Montrose,3508,1,24,7,5,60,34,26,79
Peterhead,3508,2,24,4,8,82,42,40,76
Stenhousem'r,3508,3,16,8,12,60,47,13,56
Stirling,3508,4,16,6,14,61,56,5,54
Clyde,3508,5,14,10,12,52,49,3,52
Elgin,3508,6,14,6,16,53,61,-8,48
Annan Athlet,3508,7,11,12,13,47,41,6,45
Berwick,3508,8,8,11,17,30,59,-29,35
Edinburgh Ci,3508,9,7,9,20,40,65,-25,30
Cowdenbeath,3508,10,4,11,21,23,54,-31,23
Montrose,3509,1,24,7,5,61,35,26,79
Peterhead,3509,2,24,4,8,78,38,40,76
Stirling,3509,3,17,6,13,63,53,10,57
Clyde,3509,4,15,9,12,56,48,8,54
Stenhousem'r,3509,5,15,8,13,57,49,8,53
Elgin,3509,6,14,6,16,54,62,-8,48
Annan Athlet,3509,7,12,11,13,48,41,7,47
Berwick,3509,8,8,10,18,29,63,-34,34
Edinburgh Ci,3509,9,7,9,20,36,61,-25,30
Cowdenbeath,3509,10,4,10,22,23,55,-32,22
Peterhead,3510,1,24,4,8,80,38,42,76
Montrose,3510,2,23,7,6,60,37,23,76
Stirling,3510,3,17,6,13,64,51,13,57
Stenhousem'r,3510,4,15,8,13,55,50,5,53
Clyde,3510,5,14,10,12,52,49,3,52
Elgin,3510,6,15,6,15,56,61,-5,51
Annan Athlet,3510,7,12,11,13,51,43,8,47
Berwick,3510,8,8,11,17,30,59,-29,35
Edinburgh Ci,3510,9,7,9,20,36,63,-27,30
Cowdenbeath,3510,10,4,10,22,25,58,-33,22
Montrose,3511,1,24,7,5,62,35,27,79
Peterhead,3511,2,24,4,8,80,38,42,76
Stirling,3511,3,16,7,13,61,52,9,55
Stenhousem'r,3511,4,15,9,12,56,47,9,54
Clyde,3511,5,15,9,12,52,48,4,54
Elgin,3511,6,14,6,16,54,63,-9,48
Annan Athlet,3511,7,12,11,13,48,41,7,47
Berwick,3511,8,8,10,18,29,59,-30,34
Edinburgh Ci,3511,9,7,9,20,36,63,-27,30
Cowdenbeath,3511,10,4,10,22,23,55,-32,22
Montrose,3512,1,23,8,5,61,36,25,77
Peterhead,3512,2,24,4,8,80,40,40,76
Stirling,3512,3,16,7,13,61,52,9,55
Stenhousem'r,3512,4,15,9,12,56,47,9,54
Clyde,3512,5,15,9,12,55,50,5,54
Elgin,3512,6,14,7,15,55,62,-7,49
Annan Athlet,3512,7,12,11,13,48,41,7,47
Berwick,3512,8,8,10,18,31,62,-31,34
Edinburgh Ci,3512,9,7,9,20,38,63,-25,30
Cowdenbeath,3512,10,4,10,22,23,55,-32,22
Montrose,3513,1,24,7,5,63,35,28,79
Peterhead,3513,2,24,4,8,80,38,42,76
Stirling,3513,3,16,7,13,61,52,9,55
Stenhousem'r,3513,4,15,9,12,56,47,9,54
Clyde,3513,5,15,9,12,52,48,4,54
Elgin,3513,6,14,6,16,54,64,-10,48
Annan Athlet,3513,7,12,11,13,48,41,7,47
Berwick,3513,8,8,10,18,29,59,-30,34
Edinburgh Ci,3513,9,7,9,20,36,63,-27,30
Cowdenbeath,3513,10,4,10,22,23,55,-32,22
Montrose,3514,1,23,8,5,59,34,25,77
Peterhead,3514,2,24,4,8,79,38,41,76
Stirling,3514,3,17,6,13,64,51,13,57
Clyde,3514,4,15,9,12,52,48,4,54
Stenhousem'r,3514,5,15,8,13,55,50,5,53
Elgin,3514,6,14,7,15,53,60,-7,49
Annan Athlet,3514,7,12,11,13,49,41,8,47
Berwick,3514,8,8,10,18,29,59,-30,34
Edinburgh Ci,3514,9,7,9,20,36,62,-26,30
Cowdenbeath,3514,10,4,10,22,23,56,-33,22
Montrose,3515,1,24,7,5,61,35,26,79
Peterhead,3515,2,23,5,8,79,40,39,74
Stenhousem'r,3515,3,16,8,12,58,47,11,56
Stirling,3515,4,16,6,14,61,54,7,54
Clyde,3515,5,14,9,13,52,51,1,51
Elgin,3515,6,14,6,16,54,62,-8,48
Annan Athlet,3515,7,12,11,13,49,41,8,47
Berwick,3515,8,9,10,17,32,59,-27,37
Edinburgh Ci,3515,9,7,10,19,38,62,-24,31
Cowdenbeath,3515,10,4,10,22,23,56,-33,22
Peterhead,3516,1,24,4,8,80,39,41,76
Montrose,3516,2,23,7,6,59,35,24,76
Stirling,3516,3,17,6,13,61,51,10,57
Clyde,3516,4,15,9,12,53,49,4,54
Stenhousem'r,3516,5,15,8,13,55,47,8,53
Elgin,3516,6,15,6,15,54,60,-6,51
Annan Athlet,3516,7,12,11,13,49,42,7,47
Berwick,3516,8,8,10,18,30,60,-30,34
Edinburgh Ci,3516,9,7,9,20,37,63,-26,30
Cowdenbeath,3516,10,4,10,22,24,56,-32,22
Montrose,3517,1,23,8,5,60,35,25,77
Peterhead,3517,2,24,4,8,81,39,42,76
Stirling,3517,3,16,7,13,61,52,9,55
Stenhousem'r,3517,4,15,9,12,56,47,9,54
Clyde,3517,5,14,10,12,51,48,3,52
Elgin,3517,6,14,7,15,54,61,-7,49
Annan Athlet,3517,7,11,11,14,47,42,5,44
Berwick,3517,8,8,11,17,29,58,-29,35
Edinburgh Ci,3517,9,7,9,20,37,64,-27,30
Cowdenbeath,3517,10,5,10,21,24,54,-30,25
Peterhead,3518,1,24,4,8,79,39,40,76
Montrose,3518,2,23,7,6,59,38,21,76
Stirling,3518,3,17,6,13,62,52,10,57
Stenhousem'r,3518,4,15,8,13,56,48,8,53
Clyde,3518,5,14,9,13,52,50,2,51
Elgin,3518,6,15,6,15,57,60,-3,51
Annan Athlet,3518,7,11,12,13,47,41,6,45
Berwick,3518,8,9,10,17,31,59,-28,37
Edinburgh Ci,3518,9,7,9,20,37,62,-25,30
Cowdenbeath,3518,10,4,11,21,23,54,-31,23
Peterhead,3519,1,24,4,8,82,38,44,76
Montrose,3519,2,23,7,6,60,36,24,76
Stirling,3519,3,17,6,13,62,51,11,57
Stenhousem'r,3519,4,15,8,13,55,48,7,53
Clyde,3519,5,14,10,12,51,48,3,52
Elgin,3519,6,15,6,15,55,61,-6,51
Annan Athlet,3519,7,12,11,13,50,41,9,47
Berwick,3519,8,8,11,17,29,58,-29,35
Edinburgh Ci,3519,9,7,9,20,36,65,-29,30
Cowdenbeath,3519,10,4,10,22,23,57,-34,22
Montrose,3520,1,24,7,5,62,34,28,79
Peterhead,3520,2,24,4,8,81,38,43,76
Stenhousem'r,3520,3,16,8,12,56,46,10,56
Stirling,3520,4,16,6,14,60,52,8,54
Clyde,3520,5,14,10,12,52,49,3,52
Elgin,3520,6,14,6,16,53,63,-10,48
Annan Athlet,3520,7,12,11,13,49,41,8,47
Berwick,3520,8,8,11,17,30,59,-29,35
Edinburgh Ci,3520,9,7,9,20,36,64,-28,30
Cowdenbeath,3520,10,4,10,22,23,56,-33,22
Montrose,3521,1,23,8,5,61,36,25,77
Peterhead,3521,2,24,4,8,81,39,42,76
Stirling,3521,3,17,6,13,62,52,10,57
Clyde,3521,4,15,9,12,53,49,4,54
Stenhousem'r,3521,5,15,8,13,56,48,8,53
Elgin,3521,6,14,7,15,55,62,-7,49
Annan Athlet,3521,7,11,11,14,47,42,5,44
Berwick,3521,8,8,10,18,30,60,-30,34
Edinburgh Ci,3521,9,7,9,20,37,64,-27,30
Cowdenbeath,3521,10,5,10,21,24,54,-30,25
Montrose,3522,1,23,8,5,59,34,25,77
Peterhead,3522,2,24,4,8,82,39,43,76
Stenhousem'r,3522,3,16,8,12,57,46,11,56
Stirling,3522,4,16,6,14,60,53,7,54
Clyde,3522,5,14,9,13,52,51,1,51
Elgin,3522,6,14,7,15,53,60,-7,49
Annan Athlet,3522,7,12,11,13,49,41,8,47
Berwick,3522,8,9,10,17,32,59,-27,37
Edinburgh Ci,3522,9,7,9,20,37,65,-28,30
Cowdenbeath,3522,10,4,10,22,23,56,-33,22
Montrose,3523,1,24,7,5,61,34,27,79
Peterhead,3523,2,24,4,8,80,39,41,76
Stirling,3523,3,17,6,13,64,52,12,57
Clyde,3523,4,15,9,12,53,49,4,54
Stenhousem'r,3523,5,15,8,13,56,50,6,53
Elgin,3523,6,14,6,16,53,62,-9,48
Annan Athlet,3523,7,12,11,13,49,41,8,47
Berwick,3523,8,8,10,18,30,60,-30,34
Edinburgh Ci,3523,9,7,9,20,37,63,-26,30
Cowdenbeath,3523,10,4,10,22,23,56,-33,22
Montrose,3524,1,24,7,5,60,34,26,79
Peterhead,3524,2,24,4,8,80,40,40,76
Stirling,3524,3,16,7,13,62,53,9,55
Stenhousem'r,3524,4,15,9,12,57,48,9,54
Clyde,3524,5,15,9,12,52,48,4,54
Elgin,3524,6,14,6,16,53,61,-8,48
Annan Athlet,3524,7,11,11,14,47,42,5,44
Berwick,3524,8,8,10,18,29,59,-30,34
Edinburgh Ci,3524,9,7,9,20,38,63,-25,30
Cowdenbeath,3524,10,5,10,21,24,54,-30,25
Montrose,3525,1,24,7,5,60,34,26,79
Peterhead,3525,2,24,4,8,81,39,42,76
Stenhousem'r,3525,3,16,8,12,57,46,11,56
Stirling,3525,4,16,6,14,60,53,7,54
Clyde,3525,5,14,10,12,52,49,3,52
Elgin,3525,6,14,6,16,53,61,-8,48
Annan Athlet,3525,7,12,11,13,49,42,7,47
Berwick,3525,8,8,11,17,30,59,-29,35
Edinburgh Ci,3525,9,7,9,20,37,64,-27,30
Cowdenbeath,3525,10,4,10,22,24,56,-32,22
Montrose,3526,1,24,7,5,60,34,26,79
Peterhead,3526,2,24,4,8,80,39,41,76
Stirling,3526,3,17,6,13,63,53,10,57
Clyde,3526,4,15,9,12,55,50,5,54
Stenhousem'r,3526,5,15,8,13,57,49,8,53
Elgin,3526,6,14,6,16,53,61,-8,48
Annan Athlet,3526,7,12,11,13,49,42,7,47
Berwick,3526,8,8,10,18,31,62,-31,34
Edinburgh Ci,3526,9,7,9,20,37,63,-26,30
Cowdenbeath,3526,10,4,10,22,24,56,-32,22
Montrose,3527,1,24,7,5,63,34,29,79
Peterhead,3527,2,24,4,8,81,39,42,76
Stirling,3527,3,16,7,13,61,52,9,55
Stenhousem'r,3527,4,15,9,12,56,47,9,54
Clyde,3527,5,14,10,12,53,50,3,52
Elgin,3527,6,14,6,16,53,64,-11,48
Annan Athlet,3527,7,11,11,14,48,43,5,44
Berwick,3527,8,8,11,17,31,60,-29,35
Edinburgh Ci,3527,9,7,9,20,37,64,-27,30
Cowdenbeath,3527,10,5,10,21,25,55,-30,25
Montrose,3528,1,24,7,5,61,34,27,79
Peterhead,3528,2,24,4,8,78,38,40,76
Stirling,3528,3,17,6,13,64,52,12,57
Clyde,3528,4,15,9,12,54,50,4,54
Stenhousem'r,3528,5,15,8,13,56,50,6,53
Elgin,3528,6,14,6,16,53,62,-9,48
Annan Athlet,3528,7,11,12,13,48,42,6,45
Berwick,3528,8,8,10,18,31,61,-30,34
Edinburgh Ci,3528,9,7,9,20,36,61,-25,30
Cowdenbeath,3528,10,4,11,21,24,55,-31,23
Montrose,3529,1,24,7,5,63,34,29,79
Peterhead,3529,2,23,5,8,79,40,39,74
Stenhousem'r,3529,3,16,8,12,59,48,11,56
Stirling,3529,4,16,6,14,62,55,7,54
Clyde,3529,5,14,9,13,51,49,2,51
Elgin,3529,6,14,6,16,53,64,-11,48
Annan Athlet,3529,7,11,12,13,48,42,6,45
Berwick,3529,8,9,10,17,30,58,-28,37
Edinburgh Ci,3529,9,7,10,19,38,62,-24,31
Cowdenbeath,3529,10,4,11,21,24,55,-31,23
Montrose,3530,1,24,7,5,64,35,29,79
Peterhead,3530,2,24,4,8,81,38,43,76
Stenhousem'r,3530,3,16,8,12,58,48,10,56
Stirling,3530,4,16,6,14,62,54,8,54
Clyde,3530,5,14,9,13,51,50,1,51
Elgin,3530,6,14,6,16,54,65,-11,48
Annan Athlet,3530,7,11,12,13,48,42,6,45
Berwick,3530,8,9,10,17,31,58,-27,37
Edinburgh Ci,3530,9,7,9,20,36,64,-28,30
Cowdenbeath,3530,10,4,11,21,24,55,-31,23
Montrose,3531,1,23,8,5,60,35,25,77
Peterhead,3531,2,24,4,8,79,38,41,76
Stenhousem'r,3531,3,16,8,12,58,47,11,56
Stirling,3531,4,16,6,14,61,54,7,54
Clyde,3531,5,14,10,12,53,50,3,52
Elgin,3531,6,14,7,15,54,61,-7,49
Annan Athlet,3531,7,11,11,14,48,43,5,44
Berwick,3531,8,8,11,17,31,60,-29,35
Edinburgh Ci,3531,9,7,9,20,36,62,-26,30
Cowdenbeath,3531,10,5,10,21,25,55,-30,25
Montrose,3532,1,24,7,5,62,34,28,79
Peterhead,3532,2,23,5,8,77,38,39,74
Stirling,3532,3,17,6,13,64,51,13,57
Stenhousem'r,3532,4,15,8,13,55,50,5,53
Clyde,3532,5,14,10,12,52,49,3,52
Elgin,3532,6,14,6,16,53,63,-10,48
Annan Athlet,3532,7,11,12,13,47,41,6,45
Berwick,3532,8,8,11,17,30,59,-29,35
Edinburgh Ci,3532,9,7,10,19,36,60,-24,31
Cowdenbeath,3532,10,4,11,21,23,54,-31,23
Montrose,3533,1,24,7,5,66,37,29,79
Peterhead,3533,2,24,4,8,79,38,41,76
Stirling,3533,3,16,7,13,62,53,9,55
Stenhousem'r,3533,4,15,9,12,57,48,9,54
Clyde,3533,5,14,10,12,54,51,3,52
Elgin,3533,6,14,6,16,56,67,-11,48
Annan Athlet,3533,7,12,11,13,48,41,7,47
Berwick,3533,8,8,11,17,32,61,-29,35
Edinburgh Ci,3533,9,7,9,20,36,62,-26,30
Cowdenbeath,3533,10,4,10,22,23,55,-32,22
Peterhead,3534,1,24,4,8,79,39,40,76
Montrose,3534,2,23,7,6,61,38,23,76
Stenhousem'r,3534,3,16,8,12,57,47,10,56
Stirling,3534,4,16,6,14,61,53,8,54
Clyde,3534,5,14,10,12,51,48,3,52
Elgin,3534,6,15,6,15,57,62,-5,51
Annan Athlet,3534,7,12,11,13,48,41,7,47
Berwick,3534,8,8,11,17,29,58,-29,35
Edinburgh Ci,3534,9,7,9,20,37,62,-25,30
Cowdenbeath,3534,10,4,10,22,23,55,-32,22
Peterhead,3535,1,24,4,8,79,39,40,76
Montrose,3535,2,23,7,6,59,35,24,76
Stenhousem'r,3535,3,16,8,12,60,46,14,56
Clyde,3535,4,15,9,12,53,48,5,54
Stirling,3535,5,16,6,14,60,56,4,54
Elgin,3535,6,15,6,15,54,60,-6,51
Annan Athlet,3535,7,11,11,14,48,45,3,44
Berwick,3535,8,8,10,18,29,60,-31,34
Edinburgh Ci,3535,9,7,9,20,37,62,-25,30
Cowdenbeath,3535,10,5,10,21,27,55,-28,25
Montrose,3536,1,24,7,5,66,37,29,79
Peterhead,3536,2,24,4,8,78,38,40,76
Stenhousem'r,3536,3,16,8,12,58,48,10,56
Stirling,3536,4,16,6,14,62,54,8,54
Clyde,3536,5,15,9,12,53,48,5,54
Elgin,3536,6,14,6,16,56,67,-11,48
Annan Athlet,3536,7,11,11,14,47,42,5,44
Berwick,3536,8,8,10,18,29,60,-31,34
Edinburgh Ci,3536,9,7,9,20,36,61,-25,30
Cowdenbeath,3536,10,5,10,21,24,54,-30,25
Montrose,3537,1,24,7,5,60,34,26,79
Peterhead,3537,2,24,4,8,81,39,42,76
Stirling,3537,3,16,7,13,60,51,9,55
Stenhousem'r,3537,4,15,9,12,55,46,9,54
Clyde,3537,5,15,9,12,54,50,4,54
Elgin,3537,6,14,6,16,53,61,-8,48
Annan Athlet,3537,7,11,11,14,48,44,4,44
Berwick,3537,8,8,10,18,31,61,-30,34
Edinburgh Ci,3537,9,7,9,20,37,64,-27,30
Cowdenbeath,3537,10,5,10,21,26,55,-29,25
Montrose,3538,1,24,7,5,62,35,27,79
Peterhead,3538,2,24,4,8,81,38,43,76
Stirling,3538,3,17,6,13,62,52,10,57
Clyde,3538,4,15,9,12,54,49,5,54
Stenhousem'r,3538,5,15,8,13,56,48,8,53
Elgin,3538,6,14,6,16,54,63,-9,48
Annan Athlet,3538,7,11,11,14,47,42,5,44
Berwick,3538,8,8,10,18,30,61,-31,34
Edinburgh Ci,3538,9,7,9,20,36,64,-28,30
Cowdenbeath,3538,10,5,10,21,24,54,-30,25
Montrose,3539,1,24,7,5,63,35,28,79
Peterhead,3539,2,24,4,8,82,41,41,76
Stenhousem'r,3539,3,16,8,12,57,47,10,56
Stirling,3539,4,16,6,14,61,53,8,54
Clyde,3539,5,15,9,12,54,48,6,54
Elgin,3539,6,14,6,16,54,64,-10,48
Annan Athlet,3539,7,11,11,14,47,44,3,44
Berwick,3539,8,8,10,18,29,61,-32,34
Edinburgh Ci,3539,9,7,9,20,39,65,-26,30
Cowdenbeath,3539,10,5,10,21,26,54,-28,25
Montrose,3540,1,24,7,5,64,35,29,79
Peterhead,3540,2,23,5,8,79,40,39,74
Stirling,3540,3,17,6,13,64,52,12,57
Clyde,3540,4,15,9,12,53,49,4,54
Stenhousem'r,3540,5,15,8,13,56,50,6,53
Elgin,3540,6,14,6,16,54,65,-11,48
Annan Athlet,3540,7,12,11,13,50,42,8,47
Berwick,3540,8,8,10,18,30,60,-30,34
Edinburgh Ci,3540,9,7,10,19,38,62,-24,31
Cowdenbeath,3540,10,4,10,22,24,57,-33,22
Montrose,3541,1,24,7,5,64,34,30,79
Peterhead,3541,2,24,4,8,78,38,40,76
Stirling,3541,3,17,6,13,63,52,11,57
Clyde,3541,4,15,9,12,54,50,4,54
Stenhousem'r,3541,5,15,8,13,56,49,7,53
Elgin,3541,6,14,6,16,53,65,-12,48
Annan Athlet,3541,7,11,12,13,48,42,6,45
Berwick,3541,8,8,10,18,31,61,-30,34
Edinburgh Ci,3541,9,7,9,20,36,61,-25,30
Cowdenbeath,3541,10,4,11,21,24,55,-31,23
Montrose,3542,1,24,7,5,61,35,26,79
Peterhead,3542,2,24,4,8,78,38,40,76
Stirling,3542,3,17,6,13,63,52,11,57
Stenhousem'r,3542,4,15,8,13,56,49,7,53
Clyde,3542,5,14,9,13,51,49,2,51
Elgin,3542,6,14,6,16,54,62,-8,48
Annan Athlet,3542,7,12,11,13,49,42,7,47
Berwick,3542,8,9,10,17,30,58,-28,37
Edinburgh Ci,3542,9,7,9,20,36,61,-25,30
Cowdenbeath,3542,10,4,10,22,24,56,-32,22
Montrose,3543,1,24,7,5,60,34,26,79
Peterhead,3543,2,24,4,8,78,38,40,76
Stirling,3543,3,16,7,13,61,52,9,55
Stenhousem'r,3543,4,15,9,12,56,47,9,54
Clyde,3543,5,15,9,12,52,48,4,54
Elgin,3543,6,14,6,16,53,61,-8,48
Annan Athlet,3543,7,12,11,13,49,41,8,47
Berwick,3543,8,8,10,18,29,59,-30,34
Edinburgh Ci,3543,9,7,9,20,36,61,-25,30
Cowdenbeath,3543,10,4,10,22,23,56,-33,22
Montrose,3544,1,23,8,5,60,35,25,77
Peterhead,3544,2,23,5,8,78,39,39,74
Stirling,3544,3,16,7,13,61,52,9,55
Stenhousem'r,3544,4,15,9,12,56,47,9,54
Clyde,3544,5,14,9,13,53,52,1,51
Elgin,3544,6,14,7,15,54,61,-7,49
Annan Athlet,3544,7,12,11,13,48,41,7,47
Berwick,3544,8,9,10,17,33,60,-27,37
Edinburgh Ci,3544,9,7,10,19,37,61,-24,31
Cowdenbeath,3544,10,4,10,22,23,55,-32,22
Montrose,3545,1,23,8,5,60,35,25,77
Peterhead,3545,2,24,4,8,79,39,40,76
Stenhousem'r,3545,3,16,8,12,57,47,10,56
Stirling,3545,4,16,6,14,61,53,8,54
Clyde,3545,5,15,9,12,54,48,6,54
Elgin,3545,6,14,7,15,54,61,-7,49
Annan Athlet,3545,7,12,11,13,49,42,7,47
Berwick,3545,8,8,10,18,29,61,-32,34
Edinburgh Ci,3545,9,7,9,20,37,62,-25,30
Cowdenbeath,3545,10,4,10,22,24,56,-32,22
Montrose,3546,1,24,7,5,62,35,27,79
Peterhead,3546,2,24,4,8,82,41,41,76
Stirling,3546,3,17,6,13,65,53,12,57
Stenhousem'r,3546,4,15,8,13,57,51,6,53
Clyde,3546,5,14,9,13,51,49,2,51
Elgin,3546,6,14,6,16,54,63,-9,48
Annan Athlet,3546,7,11,12,13,49,43,6,45
Berwick,3546,8,9,10,17,30,58,-28,37
Edinburgh Ci,3546,9,7,9,20,39,65,-26,30
Cowdenbeath,3546,10,4,11,21,25,56,-31,23
Montrose,3547,1,24,7,5,62,35,27,79
Peterhead,3547,2,23,4,9,78,41,37,73
Stenhousem'r,3547,3,16,8,12,58,46,12,56
Stirling,3547,4,16,6,14,60,54,6,54
Clyde,3547,5,14,10,12,51,48,3,52
Elgin,3547,6,14,6,16,54,63,-9,48
Annan Athlet,3547,7,12,11,13,52,42,10,47
Berwick,3547,8,8,11,17,29,58,-29,35
Edinburgh Ci,3547,9,8,9,19,39,61,-22,33
Cowdenbeath,3547,10,4,10,22,24,59,-35,22
Montrose,3548,1,23,8,5,59,34,25,77
Peterhead,3548,2,24,4,8,83,38,45,76
Stirling,3548,3,17,6,13,63,52,11,57
Clyde,3548,4,15,9,12,56,50,6,54
Stenhousem'r,3548,5,15,8,13,56,49,7,53
Elgin,3548,6,14,7,15,53,60,-7,49
Annan Athlet,3548,7,11,11,14,47,43,4,44
Berwick,3548,8,8,10,18,31,63,-32,34
Edinburgh Ci,3548,9,7,9,20,36,66,-30,30
Cowdenbeath,3548,10,5,10,21,25,54,-29,25
Montrose,3549,1,24,7,5,61,35,26,79
Peterhead,3549,2,24,4,8,78,38,40,76
Stirling,3549,3,17,6,13,62,52,10,57
Stenhousem'r,3549,4,15,8,13,56,48,8,53
Clyde,3549,5,14,9,13,51,50,1,51
Elgin,3549,6,14,6,16,54,62,-8,48
Annan Athlet,3549,7,12,11,13,48,41,7,47
Berwick,3549,8,9,10,17,31,58,-27,37
Edinburgh Ci,3549,9,7,9,20,36,61,-25,30
Cowdenbeath,3549,10,4,10,22,23,55,-32,22
Montrose,3550,1,23,7,6,60,36,24,76
Peterhead,3550,2,23,5,8,78,39,39,74
Stenhousem'r,3550,3,16,8,12,60,48,12,56
Stirling,3550,4,16,6,14,62,56,6,54
Clyde,3550,5,15,9,12,55,49,6,54
Elgin,3550,6,15,6,15,55,61,-6,51
Annan Athlet,3550,7,12,11,13,49,42,7,47
Berwick,3550,8,8,10,18,30,62,-32,34
Edinburgh Ci,3550,9,7,10,19,37,61,-24,31
Cowdenbeath,3550,10,4,10,22,24,56,-32,22
Montrose,3551,1,23,8,5,61,36,25,77
Peterhead,3551,2,23,4,9,77,39,38,73
Stirling,3551,3,17,6,13,62,52,10,57
Clyde,3551,4,15,9,12,53,49,4,54
Stenhousem'r,3551,5,15,8,13,56,48,8,53
Elgin,3551,6,14,7,15,55,62,-7,49
Annan Athlet,3551,7,11,12,13,48,42,6,45
Berwick,3551,8,8,10,18,30,60,-30,34
Edinburgh Ci,3551,9,8,9,19,37,60,-23,33
Cowdenbeath,3551,10,4,11,21,24,55,-31,23
Montrose,3552,1,24,7,5,62,35,27,79
Peterhead,3552,2,24,4,8,78,38,40,76
Stirling,3552,3,17,6,13,61,51,10,57
Clyde,3552,4,15,9,12,53,48,5,54
Stenhousem'r,3552,5,15,8,13,55,47,8,53
Elgin,3552,6,14,6,16,54,63,-9,48
Annan Athlet,3552,7,11,12,13,49,43,6,45
Berwick,3552,8,8,10,18,29,60,-31,34
Edinburgh Ci,3552,9,7,9,20,36,61,-25,30
Cowdenbeath,3552,10,4,11,21,25,56,-31,23
Peterhead,3553,1,24,4,8,79,38,41,76
Montrose,3553,2,23,7,6,60,36,24,76
Stenhousem'r,3553,3,16,8,12,57,47,10,56
Clyde,3553,4,15,9,12,57,48,9,54
Stirling,3553,5,16,6,14,61,53,8,54
Elgin,3553,6,15,6,15,55,61,-6,51
Annan Athlet,3553,7,12,11,13,50,41,9,47
Berwick,3553,8,8,10,18,29,64,-35,34
Edinburgh Ci,3553,9,7,9,20,36,62,-26,30
Cowdenbeath,3553,10,4,10,22,23,57,-34,22
Montrose,3554,1,24,7,5,61,35,26,79
Peterhead,3554,2,24,4,8,80,40,40,76
Stirling,3554,3,17,6,13,64,52,12,57
Clyde,3554,4,15,9,12,54,48,6,54
Stenhousem'r,3554,5,15,8,13,56,50,6,53
Elgin,3554,6,14,6,16,54,62,-8,48
Annan Athlet,3554,7,11,12,13,48,42,6,45
Berwick,3554,8,8,10,18,29,61,-32,34
Edinburgh Ci,3554,9,7,9,20,38,63,-25,30
Cowdenbeath,3554,10,4,11,21,24,55,-31,23
Montrose,3555,1,23,8,5,60,35,25,77
Peterhead,3555,2,24,4,8,78,38,40,76
Stirling,3555,3,16,7,13,62,53,9,55
Stenhousem'r,3555,4,15,9,12,57,48,9,54
Clyde,3555,5,14,10,12,51,48,3,52
Elgin,3555,6,14,7,15,54,61,-7,49
Annan Athlet,3555,7,12,11,13,49,41,8,47
Berwick,3555,8,8,11,17,29,58,-29,35
Edinburgh Ci,3555,9,7,9,20,36,61,-25,30
Cowdenbeath,3555,10,4,10,22,23,56,-33,22
Montrose,3556,1,24,7,5,60,34,26,79
Peterhead,3556,2,24,4,8,79,38,41,76
Stirling,3556,3,17,6,13,63,53,10,57
Clyde,3556,4,15,9,12,53,49,4,54
Stenhousem'r,3556,5,15,8,13,57,49,8,53
Elgin,3556,6,14,6,16,53,61,-8,48
Annan Athlet,3556,7,12,11,13,51,41,10,47
Berwick,3556,8,8,10,18,30,60,-30,34
Edinburgh Ci,3556,9,7,9,20,36,62,-26,30
Cowdenbeath,3556,10,4,10,22,23,58,-35,22
Montrose,3557,1,23,8,5,62,37,25,77
Peterhead,3557,2,23,5,8,78,39,39,74
Stenhousem'r,3557,3,16,8,12,57,47,10,56
Stirling,3557,4,16,6,14,61,53,8,54
Clyde,3557,5,14,10,12,52,49,3,52
Elgin,3557,6,14,7,15,56,63,-7,49
Annan Athlet,3557,7,11,12,13,47,41,6,45
Berwick,3557,8,8,11,17,30,59,-29,35
Edinburgh Ci,3557,9,7,10,19,37,61,-24,31
Cowdenbeath,3557,10,4,11,21,23,54,-31,23
Peterhead,3558,1,24,4,8,81,38,43,76
Montrose,3558,2,23,7,6,59,35,24,76
Stenhousem'r,3558,3,16,8,12,58,46,12,56
Stirling,3558,4,16,6,14,60,54,6,54
Clyde,3558,5,14,9,13,53,51,2,51
Elgin,3558,6,15,6,15,54,60,-6,51
Annan Athlet,3558,7,11,12,13,47,41,6,45
Berwick,3558,8,9,10,17,32,60,-28,37
Edinburgh Ci,3558,9,7,9,20,36,64,-28,30
Cowdenbeath,3558,10,4,11,21,23,54,-31,23
Peterhead,3559,1,24,4,8,80,38,42,76
Montrose,3559,2,23,7,6,59,35,24,76
Stirling,3559,3,17,6,13,62,52,10,57
Stenhousem'r,3559,4,15,8,13,56,48,8,53
Clyde,3559,5,14,9,13,51,51,0,51
Elgin,3559,6,15,6,15,54,60,-6,51
Annan Athlet,3559,7,11,12,13,48,42,6,45
Berwick,3559,8,9,10,17,32,58,-26,37
Edinburgh Ci,3559,9,7,9,20,36,63,-27,30
Cowdenbeath,3559,10,4,11,21,24,55,-31,23
Montrose,3560,1,23,8,5,60,35,25,77
Peterhead,3560,2,24,4,8,81,38,43,76
Stenhousem'r,3560,3,16,8,12,57,47,10,56
Stirling,3560,4,16,6,14,61,53,8,54
Clyde,3560,5,15,9,12,53,49,4,54
Elgin,3560,6,14,7,15,54,61,-7,49
Annan Athlet,3560,7,12,11,13,48,41,7,47
Berwick,3560,8,8,10,18,30,60,-30,34
Edinburgh Ci,3560,9,7,9,20,36,64,-28,30
Cowdenbeath,3560,10,4,10,22,23,55,-32,22
Montrose,3561,1,24,7,5,63,34,29,79
Peterhead,3561,2,24,4,8,82,38,44,76
Stirling,3561,3,16,7,13,61,52,9,55
Stenhousem'r,3561,4,15,9,12,56,47,9,54
Clyde,3561,5,15,9,12,52,48,4,54
Elgin,3561,6,14,6,16,53,64,-11,48
Annan Athlet,3561,7,12,11,13,48,41,7,47
Berwick,3561,8,8,10,18,29,59,-30,34
Edinburgh Ci,3561,9,7,9,20,36,65,-29,30
Cowdenbeath,3561,10,4,10,22,23,55,-32,22
Montrose,3562,1,24,7,5,62,35,27,79
Peterhead,3562,2,24,4,8,78,38,40,76
Stenhousem'r,3562,3,16,8,12,56,46,10,56
Stirling,3562,4,16,6,14,60,52,8,54
Clyde,3562,5,14,10,12,52,49,3,52
Elgin,3562,6,14,6,16,54,63,-9,48
Annan Athlet,3562,7,11,11,14,47,42,5,44
Berwick,3562,8,8,11,17,30,59,-29,35
Edinburgh Ci,3562,9,7,9,20,36,61,-25,30
Cowdenbeath,3562,10,5,10,21,24,54,-30,25
Montrose,3563,1,23,8,5,59,34,25,77
Peterhead,3563,2,23,5,8,80,41,39,74
Stirling,3563,3,17,6,13,62,52,10,57
Stenhousem'r,3563,4,15,8,13,56,48,8,53
Clyde,3563,5,14,9,13,51,49,2,51
Elgin,3563,6,14,7,15,53,60,-7,49
Annan Athlet,3563,7,11,11,14,48,45,3,44
Berwick,3563,8,9,10,17,30,58,-28,37
Edinburgh Ci,3563,9,7,10,19,39,63,-24,31
Cowdenbeath,3563,10,5,10,21,27,55,-28,25
Montrose,3564,1,24,7,5,61,35,26,79
Peterhead,3564,2,24,4,8,80,39,41,76
Stirling,3564,3,17,6,13,62,51,11,57
Stenhousem'r,3564,4,15,8,13,55,48,7,53
Clyde,3564,5,14,10,12,51,48,3,52
Elgin,3564,6,14,6,16,54,62,-8,48
Annan Athlet,3564,7,11,12,13,48,42,6,45
Berwick,3564,8,8,11,17,29,58,-29,35
Edinburgh Ci,3564,9,7,9,20,37,63,-26,30
Cowdenbeath,3564,10,4,11,21,24,55,-31,23
Montrose,3565,1,24,7,5,61,34,27,79
Peterhead,3565,2,23,5,8,79,40,39,74
Stirling,3565,3,17,6,13,63,52,11,57
Stenhousem'r,3565,4,15,8,13,56,49,7,53
Clyde,3565,5,14,10,12,51,48,3,52
Elgin,3565,6,14,6,16,53,62,-9,48
Annan Athlet,3565,7,11,12,13,48,42,6,45
Berwick,3565,8,8,11,17,29,58,-29,35
Edinburgh Ci,3565,9,7,10,19,38,62,-24,31
Cowdenbeath,3565,10,4,11,21,24,55,-31,23
Montrose,3566,1,23,8,5,61,36,25,77
Peterhead,3566,2,24,4,8,82,39,43,76
Stenhousem'r,3566,3,16,8,12,58,47,11,56
Stirling,3566,4,16,6,14,61,54,7,54
Clyde,3566,5,14,10,12,52,49,3,52
Elgin,3566,6,14,7,15,55,62,-7,49
Annan Athlet,3566,7,11,11,14,47,43,4,44
Berwick,3566,8,8,11,17,30,59,-29,35
Edinburgh Ci,3566,9,7,9,20,37,65,-28,30
Cowdenbeath,3566,10,5,10,21,25,54,-29,25
Montrose,3567,1,24,7,5,63,37,26,79
Peterhead,3567,2,24,4,8,79,38,41,76
Stirling,3567,3,17,6,13,61,51,10,57
Clyde,3567,4,15,9,12,54,49,5,54
Stenhousem'r,3567,5,15,8,13,55,47,8,53
Elgin,3567,6,14,6,16,56,64,-8,48
Annan Athlet,3567,7,11,12,13,48,42,6,45
Berwick,3567,8,8,10,18,30,61,-31,34
Edinburgh Ci,3567,9,7,9,20,36,62,-26,30
Cowdenbeath,3567,10,4,11,21,24,55,-31,23
Montrose,3568,1,23,8,5,60,35,25,77
Peterhead,3568,2,24,4,8,81,40,41,76
Stirling,3568,3,17,6,13,63,52,11,57
Clyde,3568,4,15,9,12,53,48,5,54
Stenhousem'r,3568,5,15,8,13,56,49,7,53
Elgin,3568,6,14,7,15,54,61,-7,49
Annan Athlet,3568,7,11,11,14,48,43,5,44
Berwick,3568,8,8,10,18,29,60,-31,34
Edinburgh Ci,3568,9,7,9,20,38,64,-26,30
Cowdenbeath,3568,10,5,10,21,25,55,-30,25
Montrose,3569,1,24,7,5,62,35,27,79
Peterhead,3569,2,24,4,8,78,38,40,76
Stirling,3569,3,16,7,13,62,53,9,55
Stenhousem'r,3569,4,15,9,12,57,48,9,54
Clyde,3569,5,15,9,12,53,48,5,54
Elgin,3569,6,14,6,16,54,63,-9,48
Annan Athlet,3569,7,12,11,13,50,41,9,47
Berwick,3569,8,8,10,18,29,60,-31,34
Edinburgh Ci,3569,9,7,9,20,36,61,-25,30
Cowdenbeath,3569,10,4,10,22,23,57,-34,22
Peterhead,3570,1,24,4,8,80,39,41,76
Montrose,3570,2,23,7,6,61,37,24,76
Stirling,3570,3,17,6,13,62,52,10,57
Clyde,3570,4,15,9,12,57,48,9,54
Stenhousem'r,3570,5,15,8,13,56,48,8,53
Elgin,3570,6,15,6,15,56,62,-6,51
Annan Athlet,3570,7,11,11,14,47,42,5,44
Berwick,3570,8,8,10,18,29,64,-35,34
Edinburgh Ci,3570,9,7,9,20,37,63,-26,30
Cowdenbeath,3570,10,5,10,21,24,54,-30,25
Montrose,3571,1,24,7,5,64,34,30,79
Peterhead,3571,2,24,4,8,81,38,43,76
Stirling,3571,3,17,6,13,63,51,12,57
Clyde,3571,4,15,9,12,52,48,4,54
Stenhousem'r,3571,5,15,8,13,55,49,6,53
Elgin,3571,6,14,6,16,53,65,-12,48
Annan Athlet,3571,7,12,11,13,49,41,8,47
Berwick,3571,8,8,10,18,29,59,-30,34
Edinburgh Ci,3571,9,7,9,20,36,64,-28,30
Cowdenbeath,3571,10,4,10,22,23,56,-33,22
Montrose,3572,1,23,7,6,60,37,23,76
Peterhead,3572,2,23,5,8,78,39,39,74
Stirling,3572,3,16,7,13,60,51,9,55
Stenhousem'r,3572,4,15,9,12,55,46,9,54
Clyde,3572,5,15,9,12,55,48,7,54
Elgin,3572,6,15,6,15,56,61,-5,51
Annan Athlet,3572,7,12,11,13,49,42,7,47
Berwick,3572,8,8,10,18,29,62,-33,34
Edinburgh Ci,3572,9,7,10,19,37,61,-24,31
Cowdenbeath,3572,10,4,10,22,24,56,-32,22
Montrose,3573,1,24,7,5,62,35,27,79
Peterhead,3573,2,23,5,8,79,40,39,74
Stirling,3573,3,17,6,13,62,51,11,57
Clyde,3573,4,15,9,12,53,48,5,54
Stenhousem'r,3573,5,15,8,13,55,48,7,53
Elgin,3573,6,14,6,16,54,63,-9,48
Annan Athlet,3573,7,12,11,13,49,41,8,47
Berwick,3573,8,8,10,18,29,60,-31,34
Edinburgh Ci,3573,9,7,10,19,38,62,-24,31
Cowdenbeath,3573,10,4,10,22,23,56,-33,22
Montrose,3574,1,24,7,5,61,35,26,79
Peterhead,3574,2,24,4,8,80,38,42,76
Stirling,3574,3,17,6,13,61,51,10,57
Stenhousem'r,3574,4,15,8,13,55,47,8,53
Clyde,3574,5,14,9,13,53,51,2,51
Elgin,3574,6,14,6,16,54,62,-8,48
Annan Athlet,3574,7,12,11,13,50,43,7,47
Berwick,3574,8,9,10,17,32,60,-28,37
Edinburgh Ci,3574,9,7,9,20,36,63,-27,30
Cowdenbeath,3574,10,4,10,22,25,57,-32,22
Montrose,3575,1,24,7,5,61,35,26,79
Peterhead,3575,2,24,4,8,81,39,42,76
Stenhousem'r,3575,3,16,8,12,59,47,12,56
Stirling,3575,4,16,6,14,61,55,6,54
Clyde,3575,5,15,9,12,54,50,4,54
Elgin,3575,6,14,6,16,54,62,-8,48
Annan Athlet,3575,7,11,12,13,49,43,6,45
Berwick,3575,8,8,10,18,31,61,-30,34
Edinburgh Ci,3575,9,7,9,20,37,64,-27,30
Cowdenbeath,3575,10,4,11,21,25,56,-31,23
Peterhead,3576,1,24,4,8,79,38,41,76
Montrose,3576,2,23,7,6,60,36,24,76
Stirling,3576,3,17,6,13,62,52,10,57
Clyde,3576,4,15,9,12,52,48,4,54
Stenhousem'r,3576,5,15,8,13,56,48,8,53
Elgin,3576,6,15,6,15,55,61,-6,51
Annan Athlet,3576,7,11,12,13,48,42,6,45
Berwick,3576,8,8,10,18,29,59,-30,34
Edinburgh Ci,3576,9,7,9,20,36,62,-26,30
Cowdenbeath,3576,10,4,11,21,24,55,-31,23
Montrose,3577,1,23,7,6,59,35,24,76
Peterhead,3577,2,23,4,9,77,39,38,73
Stirling,3577,3,17,6,13,62,52,10,57
Clyde,3577,4,15,9,12,52,48,4,54
Stenhousem'r,3577,5,15,8,13,56,48,8,53
Elgin,3577,6,15,6,15,54,60,-6,51
Annan Athlet,3577,7,12,11,13,49,41,8,47
Berwick,3577,8,8,10,18,29,59,-30,34
Edinburgh Ci,3577,9,8,9,19,37,60,-23,33
Cowdenbeath,3577,10,4,10,22,23,56,-33,22
Montrose,3578,1,23,8,5,60,35,25,77
Peterhead,3578,2,23,5,8,78,39,39,74
Stenhousem'r,3578,3,16,8,12,56,46,10,56
Stirling,3578,4,16,6,14,60,52,8,54
Clyde,3578,5,15,9,12,55,48,7,54
Elgin,3578,6,14,7,15,54,61,-7,49
Annan Athlet,3578,7,11,12,13,47,41,6,45
Berwick,3578,8,8,10,18,29,62,-33,34
Edinburgh Ci,3578,9,7,10,19,37,61,-24,31
Cowdenbeath,3578,10,4,11,21,23,54,-31,23
Montrose,3579,1,23,8,5,61,36,25,77
Peterhead,3579,2,24,4,8,80,40,40,76
Stirling,3579,3,16,7,13,61,52,9,55
Stenhousem'r,3579,4,15,9,12,56,47,9,54
Clyde,3579,5,15,9,12,53,49,4,54
Elgin,3579,6,14,7,15,55,62,-7,49
Annan Athlet,3579,7,12,11,13,49,42,7,47
Berwick,3579,8,8,10,18,30,60,-30,34
Edinburgh Ci,3579,9,7,9,20,38,63,-25,30
Cowdenbeath,3579,10,4,10,22,24,56,-32,22
Montrose,3580,1,23,8,5,59,34,25,77
Peterhead,3580,2,24,4,8,80,39,41,76
Stirling,3580,3,17,6,13,62,51,11,57
Stenhousem'r,3580,4,15,8,13,55,48,7,53
Clyde,3580,5,14,9,13,51,50,1,51
Elgin,3580,6,14,7,15,53,60,-7,49
Annan Athlet,3580,7,12,11,13,48,41,7,47
Berwick,3580,8,9,10,17,31,58,-27,37
Edinburgh Ci,3580,9,7,9,20,37,63,-26,30
Cowdenbeath,3580,10,4,10,22,23,55,-32,22
Montrose,3581,1,24,7,5,63,35,28,79
Peterhead,3581,2,24,4,8,82,39,43,76
Stirling,3581,3,17,6,13,62,51,11,57
Clyde,3581,4,15,9,12,54,50,4,54
Stenhousem'r,3581,5,15,8,13,55,48,7,53
Elgin,3581,6,14,6,16,54,64,-10,48
Annan Athlet,3581,7,11,12,13,47,41,6,45
Berwick,3581,8,8,10,18,31,61,-30,34
Edinburgh Ci,3581,9,7,9,20,37,65,-28,30
Cowdenbeath,3581,10,4,11,21,23,54,-31,23
Peterhead,3582,1,24,4,8,81,39,42,76
Montrose,3582,2,23,7,6,61,37,24,76
Stirling,3582,3,16,7,13,60,51,9,55
Stenhousem'r,3582,4,15,9,12,55,46,9,54
Clyde,3582,5,14,10,12,52,49,3,52
Elgin,3582,6,15,6,15,56,62,-6,51
Annan Athlet,3582,7,11,12,13,48,42,6,45
Berwick,3582,8,8,11,17,30,59,-29,35
Edinburgh Ci,3582,9,7,9,20,37,64,-27,30
Cowdenbeath,3582,10,4,11,21,24,55,-31,23
Montrose,3583,1,24,7,5,64,34,30,79
Peterhead,3583,2,23,4,9,78,40,38,73
Stenhousem'r,3583,3,16,8,12,58,47,11,56
Stirling,3583,4,16,6,14,61,54,7,54
Clyde,3583,5,14,10,12,53,50,3,52
Elgin,3583,6,14,6,16,53,65,-12,48
Annan Athlet,3583,7,12,11,13,48,41,7,47
Berwick,3583,8,8,11,17,31,60,-29,35
Edinburgh Ci,3583,9,8,9,19,38,61,-23,33
Cowdenbeath,3583,10,4,10,22,23,55,-32,22
Montrose,3584,1,23,7,6,60,36,24,76
Peterhead,3584,2,23,4,9,78,40,38,73
Stirling,3584,3,17,6,13,61,51,10,57
Clyde,3584,4,15,9,12,55,48,7,54
Stenhousem'r,3584,5,15,8,13,55,47,8,53
Elgin,3584,6,15,6,15,55,61,-6,51
Annan Athlet,3584,7,11,11,14,48,43,5,44
Berwick,3584,8,8,10,18,29,62,-33,34
Edinburgh Ci,3584,9,8,9,19,38,61,-23,33
Cowdenbeath,3584,10,5,10,21,25,55,-30,25
Peterhead,3585,1,24,4,8,78,38,40,76
Montrose,3585,2,23,7,6,59,36,23,76
Stirling,3585,3,17,6,13,64,53,11,57
Clyde,3585,4,15,9,12,54,49,5,54
Stenhousem'r,3585,5,15,8,13,57,50,7,53
Elgin,3585,6,15,6,15,55,60,-5,51
Annan Athlet,3585,7,11,12,13,48,42,6,45
Berwick,3585,8,8,10,18,30,61,-31,34
Edinburgh Ci,3585,9,7,9,20,36,61,-25,30
Cowdenbeath,3585,10,4,11,21,24,55,-31,23
Montrose,3586,1,24,7,5,61,35,26,79
Peterhead,3586,2,23,5,8,78,39,39,74
Stirling,3586,3,16,7,13,62,53,9,55
Stenhousem'r,3586,4,15,9,12,57,48,9,54
Clyde,3586,5,14,10,12,52,49,3,52
Elgin,3586,6,14,6,16,54,62,-8,48
Annan Athlet,3586,7,12,11,13,48,41,7,47
Berwick,3586,8,8,11,17,30,59,-29,35
Edinburgh Ci,3586,9,7,10,19,37,61,-24,31
Cowdenbeath,3586,10,4,10,22,23,55,-32,22
Montrose,3587,1,24,7,5,65,37,28,79
Peterhead,3587,2,24,4,8,83,38,45,76
Stirling,3587,3,17,6,13,61,51,10,57
Stenhousem'r,3587,4,15,8,13,55,47,8,53
Clyde,3587,5,14,10,12,53,50,3,52
Elgin,3587,6,14,6,16,56,66,-10,48
Annan Athlet,3587,7,12,11,13,49,42,7,47
Berwick,3587,8,8,11,17,31,60,-29,35
Edinburgh Ci,3587,9,7,9,20,36,66,-30,30
Cowdenbeath,3587,10,4,10,22,24,56,-32,22
Montrose,3588,1,24,7,5,63,35,28,79
Peterhead,3588,2,24,4,8,81,39,42,76
Stirling,3588,3,17,6,13,63,52,11,57
Stenhousem'r,3588,4,15,8,13,56,49,7,53
Clyde,3588,5,14,10,12,52,49,3,52
Elgin,3588,6,14,6,16,54,64,-10,48
Annan Athlet,3588,7,11,11,14,48,43,5,44
Berwick,3588,8,8,11,17,30,59,-29,35
Edinburgh Ci,3588,9,7,9,20,37,64,-27,30
Cowdenbeath,3588,10,5,10,21,25,55,-30,25
Peterhead,3589,1,24,4,8,81,38,43,76
Montrose,3589,2,23,7,6,60,36,24,76
Stenhousem'r,3589,3,16,8,12,56,46,10,56
Stirling,3589,4,16,6,14,60,52,8,54
Clyde,3589,5,14,10,12,53,50,3,52
Elgin,3589,6,15,6,15,55,61,-6,51
Annan Athlet,3589,7,11,11,14,48,43,5,44
Berwick,3589,8,8,11,17,31,60,-29,35
Edinburgh Ci,3589,9,7,9,20,36,64,-28,30
Cowdenbeath,3589,10,5,10,21,25,55,-30,25
Montrose,3590,1,24,7,5,61,34,27,79
Peterhead,3590,2,24,4,8,80,39,41,76
Stirling,3590,3,17,6,13,62,52,10,57
Clyde,3590,4,15,9,12,55,50,5,54
Stenhousem'r,3590,5,15,8,13,56,48,8,53
Elgin,3590,6,14,6,16,53,62,-9,48
Annan Athlet,3590,7,11,12,13,49,43,6,45
Berwick,3590,8,8,10,18,31,62,-31,34
Edinburgh Ci,3590,9,7,9,20,37,63,-26,30
Cowdenbeath,3590,10,4,11,21,25,56,-31,23
Montrose,3591,1,24,7,5,63,35,28,79
Peterhead,3591,2,24,4,8,79,38,41,76
Stirling,3591,3,17,6,13,62,52,10,57
Clyde,3591,4,15,9,12,60,51,9,54
Stenhousem'r,3591,5,15,8,13,56,48,8,53
Elgin,3591,6,14,6,16,54,64,-10,48
Annan Athlet,3591,7,11,12,13,48,42,6,45
Berwick,3591,8,8,10,18,32,67,-35,34
Edinburgh Ci,3591,9,7,9,20,36,62,-26,30
Cowdenbeath,3591,10,4,11,21,24,55,-31,23
Peterhead,3592,1,24,4,8,81,39,42,76
Montrose,3592,2,23,7,6,59,35,24,76
Stirling,3592,3,17,6,13,65,51,14,57
Clyde,3592,4,15,9,12,52,48,4,54
Stenhousem'r,3592,5,15,8,13,55,51,4,53
Elgin,3592,6,15,6,15,54,60,-6,51
Annan Athlet,3592,7,12,11,13,51,42,9,47
Berwick,3592,8,8,10,18,29,59,-30,34
Edinburgh Ci,3592,9,7,9,20,37,64,-27,30
Cowdenbeath,3592,10,4,10,22,24,58,-34,22
Montrose,3593,1,24,7,5,61,35,26,79
Peterhead,3593,2,24,4,8,80,38,42,76
Stenhousem'r,3593,3,16,8,12,56,46,10,56
Clyde,3593,4,15,9,12,57,48,9,54
Stirling,3593,5,16,6,14,60,52,8,54
Elgin,3593,6,14,6,16,54,62,-8,48
Annan Athlet,3593,7,12,11,13,48,41,7,47
Berwick,3593,8,8,10,18,29,64,-35,34
Edinburgh Ci,3593,9,7,9,20,36,63,-27,30
Cowdenbeath,3593,10,4,10,22,23,55,-32,22
Montrose,3594,1,24,7,5,62,36,26,79
Peterhead,3594,2,24,4,8,81,38,43,76
Stirling,3594,3,17,6,13,62,51,11,57
Clyde,3594,4,15,9,12,53,48,5,54
Stenhousem'r,3594,5,15,8,13,55,48,7,53
Elgin,3594,6,14,6,16,55,63,-8,48
Annan Athlet,3594,7,11,11,14,47,42,5,44
Berwick,3594,8,8,10,18,29,60,-31,34
Edinburgh Ci,3594,9,7,9,20,36,64,-28,30
Cowdenbeath,3594,10,5,10,21,24,54,-30,25
Montrose,3595,1,24,7,5,61,35,26,79
Peterhead,3595,2,23,4,9,79,41,38,73
Stirling,3595,3,17,6,13,63,51,12,57
Clyde,3595,4,15,9,12,53,48,5,54
Stenhousem'r,3595,5,15,8,13,55,49,6,53
Elgin,3595,6,14,6,16,54,62,-8,48
Annan Athlet,3595,7,12,11,13,48,41,7,47
Berwick,3595,8,8,10,18,29,60,-31,34
Edinburgh Ci,3595,9,8,9,19,39,62,-23,33
Cowdenbeath,3595,10,4,10,22,23,55,-32,22
Montrose,3596,1,24,7,5,60,34,26,79
Peterhead,3596,2,24,4,8,79,39,40,76
Stirling,3596,3,16,7,13,60,51,9,55
Stenhousem'r,3596,4,15,9,12,55,46,9,54
Clyde,3596,5,15,9,12,53,49,4,54
Elgin,3596,6,14,6,16,53,61,-8,48
Annan Athlet,3596,7,11,12,13,47,41,6,45
Berwick,3596,8,8,10,18,30,60,-30,34
Edinburgh Ci,3596,9,7,9,20,37,62,-25,30
Cowdenbeath,3596,10,4,11,21,23,54,-31,23
Montrose,3597,1,23,8,5,59,34,25,77
Peterhead,3597,2,23,5,8,78,39,39,74
Stirling,3597,3,17,6,13,63,52,11,57
Clyde,3597,4,15,9,12,53,49,4,54
Stenhousem'r,3597,5,15,8,13,56,49,7,53
Elgin,3597,6,14,7,15,53,60,-7,49
Annan Athlet,3597,7,11,12,13,47,41,6,45
Berwick,3597,8,8,10,18,30,60,-30,34
Edinburgh Ci,3597,9,7,10,19,37,61,-24,31
Cowdenbeath,3597,10,4,11,21,23,54,-31,23
Montrose,3598,1,24,7,5,62,34,28,79
Peterhead,3598,2,23,5,8,79,40,39,74
Stenhousem'r,3598,3,16,8,12,58,47,11,56
Stirling,3598,4,16,6,14,61,54,7,54
Clyde,3598,5,15,9,12,53,49,4,54
Elgin,3598,6,14,6,16,53,63,-10,48
Annan Athlet,3598,7,11,11,14,49,44,5,44
Berwick,3598,8,8,10,18,30,60,-30,34
Edinburgh Ci,3598,9,7,10,19,38,62,-24,31
Cowdenbeath,3598,10,5,10,21,26,56,-30,25
Montrose,3599,1,24,7,5,62,34,28,79
Peterhead,3599,2,23,5,8,79,40,39,74
Stenhousem'r,3599,3,16,8,12,59,47,12,56
Stirling,3599,4,16,6,14,61,55,6,54
Clyde,3599,5,14,10,12,51,48,3,52
Elgin,3599,6,14,6,16,53,63,-10,48
Annan Athlet,3599,7,12,11,13,50,42,8,47
Berwick,3599,8,8,11,17,29,58,-29,35
Edinburgh Ci,3599,9,7,10,19,38,62,-24,31
Cowdenbeath,3599,10,4,10,22,24,57,-33,22
Montrose,3600,1,24,7,5,60,34,26,79
Peterhead,3600,2,23,4,9,78,40,38,73
Stenhousem'r,3600,3,16,8,12,57,47,10,56
Stirling,3600,4,16,6,14,61,53,8,54
Clyde,3600,5,15,9,12,53,48,5,54
Elgin,3600,6,14,6,16,53,61,-8,48
Annan Athlet,3600,7,12,11,13,52,41,11,47
Berwick,3600,8,8,10,18,29,60,-31,34
Edinburgh Ci,3600,9,8,9,19,38,61,-23,33
Cowdenbeath,3600,10,4,10,22,23,59,-36,22
Montrose,3601,1,24,7,5,62,35,27,79
Peterhead,3601,2,24,4,8,82,40,42,76
Stirling,3601,3,17,6,13,63,52,11,57
Clyde,3601,4,15,9,12,52,48,4,54
Stenhousem'r,3601,5,15,8,13,56,49,7,53
Elgin,3601,6,14,6,16,54,63,-9,48
Annan Athlet,3601,7,11,12,13,47,41,6,45
Berwick,3601,8,8,10,18,29,59,-30,34
Edinburgh Ci,3601,9,7,9,20,38,65,-27,30
Cowdenbeath,3601,10,4,11,21,23,54,-31,23
Montrose,3602,1,24,7,5,62,36,26,79
Peterhead,3602,2,23,4,9,77,41,36,73
Stirling,3602,3,17,6,13,61,51,10,57
Clyde,3602,4,15,9,12,54,48,6,54
Stenhousem'r,3602,5,15,8,13,55,47,8,53
Elgin,3602,6,14,6,16,55,63,-8,48
Annan Athlet,3602,7,11,11,14,48,43,5,44
Berwick,3602,8,8,10,18,29,61,-32,34
Edinburgh Ci,3602,9,8,9,19,39,60,-21,33
Cowdenbeath,3602,10,5,10,21,25,55,-30,25
Montrose,3603,1,24,7,5,63,36,27,79
Peterhead,3603,2,23,4,9,78,40,38,73
Stirling,3603,3,17,6,13,65,52,13,57
Stenhousem'r,3603,4,15,8,13,56,51,5,53
Clyde,3603,5,14,9,13,51,49,2,51
Elgin,3603,6,14,6,16,55,64,-9,48
Annan Athlet,3603,7,12,11,13,48,41,7,47
Berwick,3603,8,9,10,17,30,58,-28,37
Edinburgh Ci,3603,9,8,9,19,38,61,-23,33
Cowdenbeath,3603,10,4,10,22,23,55,-32,22
Montrose,3604,1,23,8,5,59,34,25,77
Peterhead,3604,2,24,4,8,80,39,41,76
Stenhousem'r,3604,3,16,8,12,56,46,10,56
Stirling,3604,4,16,6,14,60,52,8,54
Clyde,3604,5,15,9,12,52,48,4,54
Elgin,3604,6,14,7,15,53,60,-7,49
Annan Athlet,3604,7,11,11,14,47,42,5,44
Berwick,3604,8,8,10,18,29,59,-30,34
Edinburgh Ci,3604,9,7,9,20,37,63,-26,30
Cowdenbeath,3604,10,5,10,21,24,54,-30,25
Montrose,3605,1,24,7,5,62,36,26,79
Peterhead,3605,2,24,4,8,81,40,41,76
Stenhousem'r,3605,3,16,8,12,57,46,11,56
Stirling,3605,4,16,6,14,60,53,7,54
Clyde,3605,5,14,9,13,51,49,2,51
Elgin,3605,6,14,6,16,55,63,-8,48
Annan Athlet,3605,7,12,11,13,51,43,8,47
Berwick,3605,8,9,10,17,30,58,-28,37
Edinburgh Ci,3605,9,7,9,20,38,64,-26,30
Cowdenbeath,3605,10,4,10,22,25,58,-33,22
Montrose,3606,1,24,7,5,61,35,26,79
Peterhead,3606,2,24,4,8,81,41,40,76
Stirling,3606,3,17,6,13,62,51,11,57
Stenhousem'r,3606,4,15,8,13,55,48,7,53
Clyde,3606,5,14,9,13,52,50,2,51
Elgin,3606,6,14,6,16,54,62,-8,48
Annan Athlet,3606,7,11,12,13,47,41,6,45
Berwick,3606,8,9,10,17,31,59,-28,37
Edinburgh Ci,3606,9,7,9,20,39,64,-25,30
Cowdenbeath,3606,10,4,11,21,23,54,-31,23
Montrose,3607,1,23,8,5,60,35,25,77
Peterhead,3607,2,24,4,8,83,39,44,76
Stirling,3607,3,17,6,13,62,52,10,57
Clyde,3607,4,15,9,12,53,49,4,54
Stenhousem'r,3607,5,15,8,13,56,48,8,53
Elgin,3607,6,14,7,15,54,61,-7,49
Annan Athlet,3607,7,11,11,14,47,42,5,44
Berwick,3607,8,8,10,18,30,60,-30,34
Edinburgh Ci,3607,9,7,9,20,37,66,-29,30
Cowdenbeath,3607,10,5,10,21,24,54,-30,25
Montrose,3608,1,24,7,5,60,34,26,79
Peterhead,3608,2,24,4,8,81,39,42,76
Stirling,3608,3,16,7,13,61,52,9,55
Stenhousem'r,3608,4,15,9,12,56,47,9,54
Clyde,3608,5,15,9,12,53,49,4,54
Elgin,3608,6,14,6,16,53,61,-8,48
Annan Athlet,3608,7,12,11,13,51,43,8,47
Berwick,3608,8,8,10,18,30,60,-30,34
Edinburgh Ci,3608,9,7,9,20,37,64,-27,30
Cowdenbeath,3608,10,4,10,22,25,58,-33,22
Montrose,3609,1,24,7,5,63,35,28,79
Peterhead,3609,2,24,4,8,80,40,40,76
Stenhousem'r,3609,3,16,8,12,58,46,12,56
Stirling,3609,4,16,6,14,60,54,6,54
Clyde,3609,5,15,9,12,52,48,4,54
Elgin,3609,6,14,6,16,54,64,-10,48
Annan Athlet,3609,7,11,11,14,48,44,4,44
Berwick,3609,8,8,10,18,29,59,-30,34
Edinburgh Ci,3609,9,7,9,20,38,63,-25,30
Cowdenbeath,3609,10,5,10,21,26,55,-29,25
Montrose,3610,1,23,8,5,61,36,25,77
Peterhead,3610,2,24,4,8,81,38,43,76
Stirling,3610,3,17,6,13,61,51,10,57
Clyde,3610,4,15,9,12,55,50,5,54
Stenhousem'r,3610,5,15,8,13,55,47,8,53
Elgin,3610,6,14,7,15,55,62,-7,49
Annan Athlet,3610,7,12,11,13,50,42,8,47
Berwick,3610,8,8,10,18,31,62,-31,34
Edinburgh Ci,3610,9,7,9,20,36,64,-28,30
Cowdenbeath,3610,10,4,10,22,24,57,-33,22
Montrose,3611,1,24,7,5,64,34,30,79
Peterhead,3611,2,24,4,8,78,38,40,76
Stirling,3611,3,17,6,13,61,51,10,57
Clyde,3611,4,15,9,12,55,48,7,54
Stenhousem'r,3611,5,15,8,13,55,47,8,53
Elgin,3611,6,14,6,16,53,65,-12,48
Annan Athlet,3611,7,12,11,13,49,42,7,47
Berwick,3611,8,8,10,18,29,62,-33,34
Edinburgh Ci,3611,9,7,9,20,36,61,-25,30
Cowdenbeath,3611,10,4,10,22,24,56,-32,22
Montrose,3612,1,24,7,5,62,35,27,79
Peterhead,3612,2,23,4,9,78,40,38,73
Stenhousem'r,3612,3,16,8,12,57,46,11,56
Stirling,3612,4,16,6,14,60,53,7,54
Clyde,3612,5,14,9,13,51,49,2,51
Elgin,3612,6,14,6,16,54,63,-9,48
Annan Athlet,3612,7,12,11,13,48,41,7,47
Berwick,3612,8,9,10,17,30,58,-28,37
Edinburgh Ci,3612,9,8,9,19,38,61,-23,33
Cowdenbeath,3612,10,4,10,22,23,55,-32,22
Montrose,3613,1,24,7,5,62,34,28,79
Peterhead,3613,2,24,4,8,79,39,40,76
Stenhousem'r,3613,3,16,8,12,57,47,10,56
Stirling,3613,4,16,6,14,61,53,8,54
Clyde,3613,5,14,9,13,51,49,2,51
Elgin,3613,6,14,6,16,53,63,-10,48
Annan Athlet,3613,7,12,11,13,49,42,7,47
Berwick,3613,8,9,10,17,30,58,-28,37
Edinburgh Ci,3613,9,7,9,20,37,62,-25,30
Cowdenbeath,3613,10,4,10,22,24,56,-32,22
Montrose,3614,1,24,7,5,61,34,27,79
Peterhead,3614,2,23,5,8,79,40,39,74
Stenhousem'r,3614,3,16,8,12,58,47,11,56
Stirling,3614,4,16,6,14,61,54,7,54
Clyde,3614,5,14,9,13,51,49,2,51
Elgin,3614,6,14,6,16,53,62,-9,48
Annan Athlet,3614,7,11,11,14,49,44,5,44
Berwick,3614,8,9,10,17,30,58,-28,37
Edinburgh Ci,3614,9,7,10,19,38,62,-24,31
Cowdenbeath,3614,10,5,10,21,26,56,-30,25
Peterhead,3615,1,24,4,8,78,38,40,76
Montrose,3615,2,23,7,6,59,35,24,76
Stirling,3615,3,17,6,13,64,51,13,57
Clyde,3615,4,15,9,12,53,48,5,54
Stenhousem'r,3615,5,15,8,13,55,50,5,53
Elgin,3615,6,15,6,15,54,60,-6,51
Annan Athlet,3615,7,12,11,13,49,42,7,47
Berwick,3615,8,8,10,18,29,60,-31,34
Edinburgh Ci,3615,9,7,9,20,36,61,-25,30
Cowdenbeath,3615,10,4,10,22,24,56,-32,22
Peterhead,3616,1,24,4,8,80,38,42,76
Montrose,3616,2,23,7,6,59,35,24,76
Stirling,3616,3,17,6,13,62,52,10,57
Clyde,3616,4,15,9,12,52,48,4,54
Stenhousem'r,3616,5,15,8,13,56,48,8,53
Elgin,3616,6,15,6,15,54,60,-6,51
Annan Athlet,3616,7,12,11,13,50,42,8,47
Berwick,3616,8,8,10,18,29,59,-30,34
Edinburgh Ci,3616,9,7,9,20,36,63,-27,30
Cowdenbeath,3616,10,4,10,22,24,57,-33,22
Montrose,3617,1,24,7,5,63,34,29,79
Peterhead,3617,2,24,4,8,79,39,40,76
Stirling,3617,3,17,6,13,63,52,11,57
Clyde,3617,4,15,9,12,52,48,4,54
Stenhousem'r,3617,5,15,8,13,56,49,7,53
Elgin,3617,6,14,6,16,53,64,-11,48
Annan Athlet,3617,7,12,11,13,51,43,8,47
Berwick,3617,8,8,10,18,29,59,-30,34
Edinburgh Ci,3617,9,7,9,20,37,62,-25,30
Cowdenbeath,3617,10,4,10,22,25,58,-33,22
Montrose,3618,1,24,7,5,61,35,26,79
Peterhead,3618,2,24,4,8,78,38,40,76
Stirling,3618,3,16,7,13,60,51,9,55
Stenhousem'r,3618,4,15,9,12,55,46,9,54
Clyde,3618,5,14,9,13,52,51,1,51
Elgin,3618,6,14,6,16,54,62,-8,48
Annan Athlet,3618,7,11,12,13,48,42,6,45
Berwick,3618,8,9,10,17,32,59,-27,37
Edinburgh Ci,3618,9,7,9,20,36,61,-25,30
Cowdenbeath,3618,10,4,11,21,24,55,-31,23
Montrose,3619,1,24,7,5,61,35,26,79
Peterhead,3619,2,24,4,8,82,42,40,76
Stirling,3619,3,17,6,13,62,52,10,57
Stenhousem'r,3619,4,15,8,13,56,48,8,53
Clyde,3619,5,14,10,12,52,49,3,52
Elgin,3619,6,14,6,16,54,62,-8,48
Annan Athlet,3619,7,12,11,13,49,42,7,47
Berwick,3619,8,8,11,17,30,59,-29,35
Edinburgh Ci,3619,9,7,9,20,40,65,-25,30
Cowdenbeath,3619,10,4,10,22,24,56,-32,22
Montrose,3620,1,24,7,5,62,35,27,79
Peterhead,3620,2,24,4,8,81,40,41,76
Stirling,3620,3,17,6,13,61,51,10,57
Stenhousem'r,3620,4,15,8,13,55,47,8,53
Clyde,3620,5,14,10,12,51,48,3,52
Elgin,3620,6,14,6,16,54,63,-9,48
Annan Athlet,3620,7,12,11,13,48,41,7,47
Berwick,3620,8,8,11,17,29,58,-29,35
Edinburgh Ci,3620,9,7,9,20,38,64,-26,30
Cowdenbeath,3620,10,4,10,22,23,55,-32,22
Montrose,3621,1,23,7,6,60,36,24,76
Peterhead,3621,2,23,4,9,79,41,38,73
Stirling,3621,3,17,6,13,61,51,10,57
Stenhousem'r,3621,4,15,8,13,55,47,8,53
Clyde,3621,5,14,9,13,51,49,2,51
Elgin,3621,6,15,6,15,55,61,-6,51
Annan Athlet,3621,7,11,11,14,48,43,5,44
Berwick,3621,8,9,10,17,30,58,-28,37
Edinburgh Ci,3621,9,8,9,19,39,62,-23,33
Cowdenbeath,3621,10,5,10,21,25,55,-30,25
Montrose,3622,1,24,7,5,62,35,27,79
Peterhead,3622,2,24,4,8,78,38,40,76
Stenhousem'r,3622,3,16,8,12,57,46,11,56
Stirling,3622,4,16,6,14,60,53,7,54
Clyde,3622,5,14,9,13,52,50,2,51
Elgin,3622,6,14,6,16,54,63,-9,48
Annan Athlet,3622,7,12,11,13,48,41,7,47
Berwick,3622,8,9,10,17,31,59,-28,37
Edinburgh Ci,3622,9,7,9,20,36,61,-25,30
Cowdenbeath,3622,10,4,10,22,23,55,-32,22
Montrose,3623,1,24,7,5,64,35,29,79
Peterhead,3623,2,24,4,8,79,38,41,76
Stirling,3623,3,17,6,13,61,51,10,57
Stenhousem'r,3623,4,15,8,13,55,47,8,53
Clyde,3623,5,14,10,12,52,49,3,52
Elgin,3623,6,14,6,16,54,65,-11,48
Annan Athlet,3623,7,12,11,13,48,41,7,47
Berwick,3623,8,8,11,17,30,59,-29,35
Edinburgh Ci,3623,9,7,9,20,36,62,-26,30
Cowdenbeath,3623,10,4,10,22,23,55,-32,22
Peterhead,3624,1,24,4,8,79,39,40,76
Montrose,3624,2,23,7,6,59,37,22,76
Stirling,3624,3,16,7,13,61,52,9,55
Stenhousem'r,3624,4,15,9,12,56,47,9,54
Clyde,3624,5,15,9,12,54,48,6,54
Elgin,3624,6,15,6,15,56,60,-4,51
Annan Athlet,3624,7,11,12,13,47,41,6,45
Berwick,3624,8,8,10,18,29,61,-32,34
Edinburgh Ci,3624,9,7,9,20,37,62,-25,30
Cowdenbeath,3624,10,4,11,21,23,54,-31,23
Peterhead,3625,1,24,4,8,83,39,44,76
Montrose,3625,2,23,7,6,61,38,23,76
Stenhousem'r,3625,3,16,8,12,57,47,10,56
Stirling,3625,4,16,6,14,61,53,8,54
Clyde,3625,5,15,9,12,54,49,5,54
Elgin,3625,6,15,6,15,57,62,-5,51
Annan Athlet,3625,7,12,11,13,48,41,7,47
Berwick,3625,8,8,10,18,30,61,-31,34
Edinburgh Ci,3625,9,7,9,20,37,66,-29,30
Cowdenbeath,3625,10,4,10,22,23,55,-32,22
Montrose,3626,1,24,7,5,62,36,26,79
Peterhead,3626,2,23,5,8,78,39,39,74
Stirling,3626,3,16,7,13,61,52,9,55
Stenhousem'r,3626,4,15,9,12,56,47,9,54
Clyde,3626,5,15,9,12,54,49,5,54
Elgin,3626,6,14,6,16,55,63,-8,48
Annan Athlet,3626,7,11,11,14,47,42,5,44
Berwick,3626,8,8,10,18,30,61,-31,34
Edinburgh Ci,3626,9,7,10,19,37,61,-24,31
Cowdenbeath,3626,10,5,10,21,24,54,-30,25
Montrose,3627,1,24,7,5,61,35,26,79
Peterhead,3627,2,24,4,8,81,38,43,76
Stirling,3627,3,16,7,13,60,51,9,55
Stenhousem'r,3627,4,15,9,12,55,46,9,54
Clyde,3627,5,15,9,12,53,49,4,54
Elgin,3627,6,14,6,16,54,62,-8,48
Annan Athlet,3627,7,11,11,14,47,42,5,44
Berwick,3627,8,8,10,18,30,60,-30,34
Edinburgh Ci,3627,9,7,9,20,36,64,-28,30
Cowdenbeath,3627,10,5,10,21,24,54,-30,25
Montrose,3628,1,23,7,6,60,36,24,76
Peterhead,3628,2,23,5,8,79,40,39,74
Stenhousem'r,3628,3,16,8,12,56,46,10,56
Stirling,3628,4,16,6,14,60,52,8,54
Clyde,3628,5,14,10,12,52,49,3,52
Elgin,3628,6,15,6,15,55,61,-6,51
Annan Athlet,3628,7,12,11,13,50,42,8,47
Berwick,3628,8,8,11,17,30,59,-29,35
Edinburgh Ci,3628,9,7,10,19,38,62,-24,31
Cowdenbeath,3628,10,4,10,22,24,57,-33,22
Montrose,3629,1,23,8,5,59,34,25,77
Peterhead,3629,2,24,4,8,78,38,40,76
Stirling,3629,3,17,6,13,62,52,10,57
Stenhousem'r,3629,4,15,8,13,56,48,8,53
Clyde,3629,5,14,9,13,52,50,2,51
Elgin,3629,6,14,7,15,53,60,-7,49
Annan Athlet,3629,7,12,11,13,48,41,7,47
Berwick,3629,8,9,10,17,31,59,-28,37
Edinburgh Ci,3629,9,7,9,20,36,61,-25,30
Cowdenbeath,3629,10,4,10,22,23,55,-32,22
Montrose,3630,1,23,8,5,60,35,25,77
Peterhead,3630,2,24,4,8,80,40,40,76
Stirling,3630,3,17,6,13,62,52,10,57
Clyde,3630,4,15,9,12,55,48,7,54
Stenhousem'r,3630,5,15,8,13,56,48,8,53
Elgin,3630,6,14,7,15,54,61,-7,49
Annan Athlet,3630,7,12,11,13,50,42,8,47
Berwick,3630,8,8,10,18,29,62,-33,34
Edinburgh Ci,3630,9,7,9,20,38,63,-25,30
Cowdenbeath,3630,10,4,10,22,24,57,-33,22
Montrose,3631,1,24,7,5,62,36,26,79
Peterhead,3631,2,24,4,8,79,38,41,76
Stirling,3631,3,16,7,13,62,53,9,55
Stenhousem'r,3631,4,15,9,12,57,48,9,54
Clyde,3631,5,15,9,12,54,48,6,54
Elgin,3631,6,14,6,16,55,63,-8,48
Annan Athlet,3631,7,12,11,13,48,41,7,47
Berwick,3631,8,8,10,18,29,61,-32,34
Edinburgh Ci,3631,9,7,9,20,36,62,-26,30
Cowdenbeath,3631,10,4,10,22,23,55,-32,22
Peterhead,3632,1,24,4,8,80,40,40,76
Montrose,3632,2,23,7,6,60,36,24,76
Stirling,3632,3,16,7,13,61,52,9,55
Stenhousem'r,3632,4,15,9,12,56,47,9,54
Clyde,3632,5,14,9,13,54,53,1,51
Elgin,3632,6,15,6,15,55,61,-6,51
Annan Athlet,3632,7,11,12,13,48,42,6,45
Berwick,3632,8,9,10,17,34,61,-27,37
Edinburgh Ci,3632,9,7,9,20,38,63,-25,30
Cowdenbeath,3632,10,4,11,21,24,55,-31,23
Peterhead,3633,1,24,4,8,79,38,41,76
Montrose,3633,2,23,7,6,59,35,24,76
Stirling,3633,3,17,6,13,62,51,11,57
Clyde,3633,4,15,9,12,53,48,5,54
Stenhousem'r,3633,5,15,8,13,55,48,7,53
Elgin,3633,6,15,6,15,54,60,-6,51
Annan Athlet,3633,7,11,12,13,47,41,6,45
Berwick,3633,8,8,10,18,29,60,-31,34
Edinburgh Ci,3633,9,7,9,20,36,62,-26,30
Cowdenbeath,3633,10,4,11,21,23,54,-31,23
Montrose,3634,1,24,7,5,63,34,29,79
Peterhead,3634,2,24,4,8,79,38,41,76
Stenhousem'r,3634,3,16,8,12,57,47,10,56
Stirling,3634,4,16,6,14,61,53,8,54
Clyde,3634,5,14,9,13,52,50,2,51
Elgin,3634,6,14,6,16,53,64,-11,48
Annan Athlet,3634,7,11,12,13,49,43,6,45
Berwick,3634,8,9,10,17,31,59,-28,37
Edinburgh Ci,3634,9,7,9,20,36,62,-26,30
Cowdenbeath,3634,10,4,11,21,25,56,-31,23
Montrose,3635,1,24,7,5,63,37,26,79
Peterhead,3635,2,24,4,8,79,38,41,76
Stirling,3635,3,17,6,13,61,51,10,57
Clyde,3635,4,15,9,12,53,49,4,54
Stenhousem'r,3635,5,15,8,13,55,47,8,53
Elgin,3635,6,14,6,16,56,64,-8,48
Annan Athlet,3635,7,11,11,14,47,42,5,44
Berwick,3635,8,8,10,18,30,60,-30,34
Edinburgh Ci,3635,9,7,9,20,36,62,-26,30
Cowdenbeath,3635,10,5,10,21,24,54,-30,25
Montrose,3636,1,23,8,5,59,34,25,77
Peterhead,3636,2,23,4,9,77,39,38,73
Stirling,3636,3,17,6,13,63,51,12,57
Clyde,3636,4,15,9,12,54,50,4,54
Stenhousem'r,3636,5,15,8,13,55,49,6,53
Elgin,3636,6,14,7,15,53,60,-7,49
Annan Athlet,3636,7,11,11,14,47,43,4,44
Berwick,3636,8,8,10,18,31,61,-30,34
Edinburgh Ci,3636,9,8,9,19,37,60,-23,33
Cowdenbeath,3636,10,5,10,21,25,54,-29,25
Montrose,3637,1,24,7,5,60,34,26,79
Peterhead,3637,2,24,4,8,78,38,40,76
Stirling,3637,3,17,6,13,62,51,11,57
Clyde,3637,4,15,9,12,53,48,5,54
Stenhousem'r,3637,5,15,8,13,55,48,7,53
Elgin,3637,6,14,6,16,53,61,-8,48
Annan Athlet,3637,7,11,11,14,47,44,3,44
Berwick,3637,8,8,10,18,29,60,-31,34
Edinburgh Ci,3637,9,7,9,20,36,61,-25,30
Cowdenbeath,3637,10,5,10,21,26,54,-28,25
Montrose,3638,1,24,7,5,61,35,26,79
Peterhead,3638,2,24,4,8,79,39,40,76
Stenhousem'r,3638,3,16,8,12,58,47,11,56
Stirling,3638,4,16,6,14,61,54,7,54
Clyde,3638,5,15,9,12,53,49,4,54
Elgin,3638,6,14,6,16,54,62,-8,48
Annan Athlet,3638,7,11,11,14,47,44,3,44
Berwick,3638,8,8,10,18,30,60,-30,34
Edinburgh Ci,3638,9,7,9,20,37,62,-25,30
Cowdenbeath,3638,10,5,10,21,26,54,-28,25
Montrose,3639,1,24,7,5,60,34,26,79
Peterhead,3639,2,24,4,8,82,39,43,76
Stenhousem'r,3639,3,16,8,12,60,47,13,56
Clyde,3639,4,15,9,12,54,48,6,54
Stirling,3639,5,16,6,14,61,56,5,54
Elgin,3639,6,14,6,16,53,61,-8,48
Annan Athlet,3639,7,11,11,14,47,42,5,44
Berwick,3639,8,8,10,18,29,61,-32,34
Edinburgh Ci,3639,9,7,9,20,37,65,-28,30
Cowdenbeath,3639,10,5,10,21,24,54,-30,25
Peterhead,3640,1,24,4,8,80,39,41,76
Montrose,3640,2,23,7,6,59,36,23,76
Stenhousem'r,3640,3,16,8,12,58,46,12,56
Stirling,3640,4,16,6,14,60,54,6,54
Clyde,3640,5,15,9,12,52,48,4,54
Elgin,3640,6,15,6,15,55,60,-5,51
Annan Athlet,3640,7,11,12,13,48,42,6,45
Berwick,3640,8,8,10,18,29,59,-30,34
Edinburgh Ci,3640,9,7,9,20,37,63,-26,30
Cowdenbeath,3640,10,4,11,21,24,55,-31,23
Montrose,3641,1,24,7,5,61,35,26,79
Peterhead,3641,2,24,4,8,79,38,41,76
Stirling,3641,3,16,7,13,60,51,9,55
Stenhousem'r,3641,4,15,9,12,55,46,9,54
Clyde,3641,5,15,9,12,53,48,5,54
Elgin,3641,6,14,6,16,54,62,-8,48
Annan Athlet,3641,7,11,12,13,48,42,6,45
Berwick,3641,8,8,10,18,29,60,-31,34
Edinburgh Ci,3641,9,7,9,20,36,62,-26,30
Cowdenbeath,3641,10,4,11,21,24,55,-31,23
Montrose,3642,1,24,7,5,63,34,29,79
Peterhead,3642,2,23,5,8,79,40,39,74
Stirling,3642,3,16,7,13,60,51,9,55
Stenhousem'r,3642,4,15,9,12,55,46,9,54
Clyde,3642,5,15,9,12,52,48,4,54
Elgin,3642,6,14,6,16,53,64,-11,48
Annan Athlet,3642,7,12,11,13,49,42,7,47
Berwick,3642,8,8,10,18,29,59,-30,34
Edinburgh Ci,3642,9,7,10,19,38,62,-24,31
Cowdenbeath,3642,10,4,10,22,24,56,-32,22
Montrose,3643,1,24,7,5,60,34,26,79
Peterhead,3643,2,24,4,8,79,39,40,76
Stirling,3643,3,17,6,13,63,52,11,57
Clyde,3643,4,15,9,12,53,48,5,54
Stenhousem'r,3643,5,15,8,13,56,49,7,53
Elgin,3643,6,14,6,16,53,61,-8,48
Annan Athlet,3643,7,11,12,13,47,41,6,45
Berwick,3643,8,8,10,18,29,60,-31,34
Edinburgh Ci,3643,9,7,9,20,37,62,-25,30
Cowdenbeath,3643,10,4,11,21,23,54,-31,23
Montrose,3644,1,24,7,5,63,34,29,79
Peterhead,3644,2,24,4,8,81,38,43,76
Stirling,3644,3,17,6,13,61,51,10,57
Stenhousem'r,3644,4,15,8,13,55,47,8,53
Clyde,3644,5,14,10,12,53,50,3,52
Elgin,3644,6,14,6,16,53,64,-11,48
Annan Athlet,3644,7,11,12,13,47,41,6,45
Berwick,3644,8,8,11,17,31,60,-29,35
Edinburgh Ci,3644,9,7,9,20,36,64,-28,30
Cowdenbeath,3644,10,4,11,21,23,54,-31,23
Peterhead,3645,1,24,4,8,81,41,40,76
Montrose,3645,2,23,7,6,60,36,24,76
Stirling,3645,3,17,6,13,62,52,10,57
Stenhousem'r,3645,4,15,8,13,56,48,8,53
Clyde,3645,5,14,9,13,51,50,1,51
Elgin,3645,6,15,6,15,55,61,-6,51
Annan Athlet,3645,7,11,12,13,50,44,6,45
Berwick,3645,8,9,10,17,31,58,-27,37
Edinburgh Ci,3645,9,7,9,20,39,64,-25,30
Cowdenbeath,3645,10,4,11,21,26,57,-31,23
Montrose,3646,1,24,7,5,63,35,28,79
Peterhead,3646,2,24,4,8,81,39,42,76
Stirling,3646,3,17,6,13,64,54,10,57
Clyde,3646,4,15,9,12,52,48,4,54
Stenhousem'r,3646,5,15,8,13,58,50,8,53
Elgin,3646,6,14,6,16,54,64,-10,48
Annan Athlet,3646,7,12,11,13,49,41,8,47
Berwick,3646,8,8,10,18,29,59,-30,34
Edinburgh Ci,3646,9,7,9,20,37,64,-27,30
Cowdenbeath,3646,10,4,10,22,23,56,-33,22
Montrose,3647,1,24,7,5,62,34,28,79
Peterhead,3647,2,24,4,8,82,39,43,76
Stirling,3647,3,16,7,13,61,52,9,55
Stenhousem'r,3647,4,15,9,12,56,47,9,54
Clyde,3647,5,15,9,12,53,48,5,54
Elgin,3647,6,14,6,16,53,63,-10,48
Annan Athlet,3647,7,11,11,14,47,43,4,44
Berwick,3647,8,8,10,18,29,60,-31,34
Edinburgh Ci,3647,9,7,9,20,37,65,-28,30
Cowdenbeath,3647,10,5,10,21,25,54,-29,25
Montrose,3648,1,24,7,5,60,34,26,79
Peterhead,3648,2,24,4,8,80,38,42,76
Stirling,3648,3,17,6,13,63,51,12,57
Stenhousem'r,3648,4,15,8,13,55,49,6,53
Clyde,3648,5,14,9,13,52,50,2,51
Elgin,3648,6,14,6,16,53,61,-8,48
Annan Athlet,3648,7,11,12,13,49,43,6,45
Berwick,3648,8,9,10,17,31,59,-28,37
Edinburgh Ci,3648,9,7,9,20,36,63,-27,30
Cowdenbeath,3648,10,4,11,21,25,56,-31,23
Montrose,3649,1,24,7,5,63,34,29,79
Peterhead,3649,2,23,5,8,78,39,39,74
Stenhousem'r,3649,3,16,8,12,56,46,10,56
Stirling,3649,4,16,6,14,60,52,8,54
Clyde,3649,5,15,9,12,56,49,7,54
Elgin,3649,6,14,6,16,53,64,-11,48
Annan Athlet,3649,7,12,11,13,48,41,7,47
Berwick,3649,8,8,10,18,30,63,-33,34
Edinburgh Ci,3649,9,7,10,19,37,61,-24,31
Cowdenbeath,3649,10,4,10,22,23,55,-32,22
Montrose,3650,1,24,7,5,64,35,29,79
Peterhead,3650,2,24,4,8,82,38,44,76
Stirling,3650,3,17,6,13,61,51,10,57
Clyde,3650,4,15,9,12,54,48,6,54
Stenhousem'r,3650,5,15,8,13,55,47,8,53
Elgin,3650,6,14,6,16,54,65,-11,48
Annan Athlet,3650,7,11,11,14,47,43,4,44
Berwick,3650,8,8,10,18,29,61,-32,34
Edinburgh Ci,3650,9,7,9,20,36,65,-29,30
Cowdenbeath,3650,10,5,10,21,25,54,-29,25
Montrose,3651,1,24,7,5,61,34,27,79
Peterhead,3651,2,24,4,8,78,38,40,76
Stirling,3651,3,16,7,13,60,51,9,55
Stenhousem'r,3651,4,15,9,12,55,46,9,54
Clyde,3651,5,15,9,12,54,48,6,54
Elgin,3651,6,14,6,16,53,62,-9,48
Annan Athlet,3651,7,11,12,13,47,41,6,45
Berwick,3651,8,8,10,18,29,61,-32,34
Edinburgh Ci,3651,9,7,9,20,36,61,-25,30
Cowdenbeath,3651,10,4,11,21,23,54,-31,23
Montrose,3652,1,23,8,5,60,35,25,77
Peterhead,3652,2,24,4,8,82,38,44,76
Stenhousem'r,3652,3,16,8,12,58,46,12,56
Stirling,3652,4,16,6,14,60,54,6,54
Clyde,3652,5,15,9,12,54,48,6,54
Elgin,3652,6,14,7,15,54,61,-7,49
Annan Athlet,3652,7,12,11,13,48,41,7,47
Berwick,3652,8,8,10,18,29,61,-32,34
Edinburgh Ci,3652,9,7,9,20,36,65,-29,30
Cowdenbeath,3652,10,4,10,22,23,55,-32,22
Peterhead,3653,1,24,4,8,79,38,41,76
Montrose,3653,2,23,7,6,59,35,24,76
Stenhousem'r,3653,3,16,8,12,56,46,10,56
Stirling,3653,4,16,6,14,60,52,8,54
Clyde,3653,5,15,9,12,52,48,4,54
Elgin,3653,6,15,6,15,54,60,-6,51
Annan Athlet,3653,7,12,11,13,49,41,8,47
Berwick,3653,8,8,10,18,29,59,-30,34
Edinburgh Ci,3653,9,7,9,20,36,62,-26,30
Cowdenbeath,3653,10,4,10,22,23,56,-33,22
Montrose,3654,1,24,7,5,62,36,26,79
Peterhead,3654,2,23,4,9,77,39,38,73
Stenhousem'r,3654,3,16,8,12,58,47,11,56
Stirling,3654,4,16,6,14,61,54,7,54
Clyde,3654,5,14,10,12,52,49,3,52
Elgin,3654,6,14,6,16,55,63,-8,48
Annan Athlet,3654,7,11,11,14,47,43,4,44
Berwick,3654,8,8,11,17,30,59,-29,35
Edinburgh Ci,3654,9,8,9,19,37,60,-23,33
Cowdenbeath,3654,10,5,10,21,25,54,-29,25
Montrose,3655,1,24,7,5,61,35,26,79
Peterhead,3655,2,24,4,8,79,38,41,76
Stirling,3655,3,17,6,13,63,53,10,57
Stenhousem'r,3655,4,15,8,13,57,49,8,53
Clyde,3655,5,14,10,12,53,50,3,52
Elgin,3655,6,14,6,16,54,62,-8,48
Annan Athlet,3655,7,11,12,13,47,41,6,45
Berwick,3655,8,8,11,17,31,60,-29,35
Edinburgh Ci,3655,9,7,9,20,36,62,-26,30
Cowdenbeath,3655,10,4,11,21,23,54,-31,23
Montrose,3656,1,23,8,5,60,35,25,77
Peterhead,3656,2,23,5,8,78,39,39,74
Stenhousem'r,3656,3,16,8,12,56,46,10,56
Stirling,3656,4,16,6,14,60,52,8,54
Clyde,3656,5,14,9,13,54,53,1,51
Elgin,3656,6,14,7,15,54,61,-7,49
Annan Athlet,3656,7,12,11,13,48,41,7,47
Berwick,3656,8,9,10,17,34,61,-27,37
Edinburgh Ci,3656,9,7,10,19,37,61,-24,31
Cowdenbeath,3656,10,4,10,22,23,55,-32,22
Peterhead,3657,1,24,4,8,81,40,41,76
Montrose,3657,2,23,7,6,59,36,23,76
Stirling,3657,3,17,6,13,61,51,10,57
Stenhousem'r,3657,4,15,8,13,55,47,8,53
Clyde,3657,5,14,9,13,54,52,2,51
Elgin,3657,6,15,6,15,55,60,-5,51
Annan Athlet,3657,7,12,11,13,48,41,7,47
Berwick,3657,8,9,10,17,33,61,-28,37
Edinburgh Ci,3657,9,7,9,20,38,64,-26,30
Cowdenbeath,3657,10,4,10,22,23,55,-32,22
Peterhead,3658,1,24,4,8,80,39,41,76
Montrose,3658,2,23,7,6,59,36,23,76
Stirling,3658,3,17,6,13,66,51,15,57
Clyde,3658,4,15,9,12,55,49,6,54
Stenhousem'r,3658,5,15,8,13,55,52,3,53
Elgin,3658,6,15,6,15,55,60,-5,51
Annan Athlet,3658,7,11,12,13,47,41,6,45
Berwick,3658,8,8,10,18,30,62,-32,34
Edinburgh Ci,3658,9,7,9,20,37,63,-26,30
Cowdenbeath,3658,10,4,11,21,23,54,-31,23
Montrose,3659,1,24,7,5,63,35,28,79
Peterhead,3659,2,24,4,8,81,39,42,76
Stenhousem'r,3659,3,16,8,12,57,46,11,56
Stirling,3659,4,16,6,14,60,53,7,54
Clyde,3659,5,15,9,12,55,51,4,54
Elgin,3659,6,14,6,16,54,64,-10,48
Annan Athlet,3659,7,12,11,13,49,41,8,47
Berwick,3659,8,8,10,18,32,62,-30,34
Edinburgh Ci,3659,9,7,9,20,37,64,-27,30
Cowdenbeath,3659,10,4,10,22,23,56,-33,22
Montrose,3660,1,24,7,5,62,34,28,79
Peterhead,3660,2,24,4,8,81,40,41,76
Stenhousem'r,3660,3,16,8,12,58,47,11,56
Stirling,3660,4,16,6,14,61,54,7,54
Clyde,3660,5,14,9,13,52,50,2,51
Elgin,3660,6,14,6,16,53,63,-10,48
Annan Athlet,3660,7,11,11,14,48,43,5,44
Berwick,3660,8,9,10,17,31,59,-28,37
Edinburgh Ci,3660,9,7,9,20,38,64,-26,30
Cowdenbeath,3660,10,5,10,21,25,55,-30,25
Montrose,3661,1,24,7,5,61,35,26,79
Peterhead,3661,2,24,4,8,80,38,42,76
Stirling,3661,3,17,6,13,65,52,13,57
Clyde,3661,4,15,9,12,56,50,6,54
Stenhousem'r,3661,5,15,8,13,56,51,5,53
Elgin,3661,6,14,6,16,54,62,-8,48
Annan Athlet,3661,7,11,11,14,47,42,5,44
Berwick,3661,8,8,10,18,31,63,-32,34
Edinburgh Ci,3661,9,7,9,20,36,63,-27,30
Cowdenbeath,3661,10,5,10,21,24,54,-30,25
Montrose,3662,1,24,7,5,61,34,27,79
Peterhead,3662,2,24,4,8,78,38,40,76
Stirling,3662,3,17,6,13,63,53,10,57
Stenhousem'r,3662,4,15,8,13,57,49,8,53
Clyde,3662,5,14,10,12,51,48,3,52
Elgin,3662,6,14,6,16,53,62,-9,48
Annan Athlet,3662,7,12,11,13,49,41,8,47
Berwick,3662,8,8,11,17,29,58,-29,35
Edinburgh Ci,3662,9,7,9,20,36,61,-25,30
Cowdenbeath,3662,10,4,10,22,23,56,-33,22
Montrose,3663,1,23,8,5,60,35,25,77
Peterhead,3663,2,23,5,8,79,40,39,74
Stenhousem'r,3663,3,16,8,12,57,46,11,56
Stirling,3663,4,16,6,14,60,53,7,54
Clyde,3663,5,14,10,12,51,48,3,52
Elgin,3663,6,14,7,15,54,61,-7,49
Annan Athlet,3663,7,12,11,13,50,42,8,47
Berwick,3663,8,8,11,17,29,58,-29,35
Edinburgh Ci,3663,9,7,10,19,38,62,-24,31
Cowdenbeath,3663,10,4,10,22,24,57,-33,22
Peterhead,3664,1,24,4,8,79,39,40,76
Montrose,3664,2,23,7,6,61,37,24,76
Stirling,3664,3,16,7,13,62,53,9,55
Stenhousem'r,3664,4,15,9,12,57,48,9,54
Clyde,3664,5,14,10,12,53,50,3,52
Elgin,3664,6,15,6,15,56,62,-6,51
Annan Athlet,3664,7,11,11,14,47,42,5,44
Berwick,3664,8,8,11,17,31,60,-29,35
Edinburgh Ci,3664,9,7,9,20,37,62,-25,30
Cowdenbeath,3664,10,5,10,21,24,54,-30,25
Montrose,3665,1,24,7,5,61,35,26,79
Peterhead,3665,2,24,4,8,80,39,41,76
Stenhousem'r,3665,3,16,8,12,56,46,10,56
Stirling,3665,4,16,6,14,60,52,8,54
Clyde,3665,5,14,10,12,51,48,3,52
Elgin,3665,6,14,6,16,54,62,-8,48
Annan Athlet,3665,7,12,11,13,48,41,7,47
Berwick,3665,8,8,11,17,29,58,-29,35
Edinburgh Ci,3665,9,7,9,20,37,63,-26,30
Cowdenbeath,3665,10,4,10,22,23,55,-32,22
Montrose,3666,1,24,7,5,61,34,27,79
Peterhead,3666,2,24,4,8,80,39,41,76
Stirling,3666,3,16,7,13,62,53,9,55
Stenhousem'r,3666,4,15,9,12,57,48,9,54
Clyde,3666,5,15,9,12,54,49,5,54
Elgin,3666,6,14,6,16,53,62,-9,48
Annan Athlet,3666,7,12,11,13,48,41,7,47
Berwick,3666,8,8,10,18,30,61,-31,34
Edinburgh Ci,3666,9,7,9,20,37,63,-26,30
Cowdenbeath,3666,10,4,10,22,23,55,-32,22
Montrose,3667,1,24,7,5,63,36,27,79
Peterhead,3667,2,24,4,8,78,38,40,76
Stirling,3667,3,17,6,13,62,51,11,57
Stenhousem'r,3667,4,15,8,13,55,48,7,53
Clyde,3667,5,14,10,12,52,49,3,52
Elgin,3667,6,14,6,16,55,64,-9,48
Annan Athlet,3667,7,11,11,14,48,43,5,44
Berwick,3667,8,8,11,17,30,59,-29,35
Edinburgh Ci,3667,9,7,9,20,36,61,-25,30
Cowdenbeath,3667,10,5,10,21,25,55,-30,25
Montrose,3668,1,24,7,5,61,35,26,79
Peterhead,3668,2,24,4,8,82,39,43,76
Stenhousem'r,3668,3,16,8,12,58,46,12,56
Stirling,3668,4,16,6,14,60,54,6,54
Clyde,3668,5,14,10,12,51,48,3,52
Elgin,3668,6,14,6,16,54,62,-8,48
Annan Athlet,3668,7,11,11,14,48,43,5,44
Berwick,3668,8,8,11,17,29,58,-29,35
Edinburgh Ci,3668,9,7,9,20,37,65,-28,30
Cowdenbeath,3668,10,5,10,21,25,55,-30,25
Peterhead,3669,1,24,4,8,80,40,40,76
Montrose,3669,2,23,7,6,60,36,24,76
Stirling,3669,3,17,6,13,64,52,12,57
Clyde,3669,4,15,9,12,53,48,5,54
Stenhousem'r,3669,5,15,8,13,56,50,6,53
Elgin,3669,6,15,6,15,55,61,-6,51
Annan Athlet,3669,7,11,12,13,47,41,6,45
Berwick,3669,8,8,10,18,29,60,-31,34
Edinburgh Ci,3669,9,7,9,20,38,63,-25,30
Cowdenbeath,3669,10,4,11,21,23,54,-31,23
Montrose,3670,1,24,7,5,60,34,26,79
Peterhead,3670,2,24,4,8,79,39,40,76
Stirling,3670,3,16,7,13,62,53,9,55
Stenhousem'r,3670,4,15,9,12,57,48,9,54
Clyde,3670,5,14,10,12,52,49,3,52
Elgin,3670,6,14,6,16,53,61,-8,48
Annan Athlet,3670,7,11,12,13,48,42,6,45
Berwick,3670,8,8,11,17,30,59,-29,35
Edinburgh Ci,3670,9,7,9,20,37,62,-25,30
Cowdenbeath,3670,10,4,11,21,24,55,-31,23
Montrose,3671,1,24,7,5,61,35,26,79
Peterhead,3671,2,24,4,8,81,39,42,76
Stirling,3671,3,17,6,13,64,52,12,57
Stenhousem'r,3671,4,15,8,13,56,50,6,53
Clyde,3671,5,14,10,12,52,49,3,52
Elgin,3671,6,14,6,16,54,62,-8,48
Annan Athlet,3671,7,11,12,13,48,42,6,45
Berwick,3671,8,8,11,17,30,59,-29,35
Edinburgh Ci,3671,9,7,9,20,37,64,-27,30
Cowdenbeath,3671,10,4,11,21,24,55,-31,23
Montrose,3672,1,23,8,5,61,36,25,77
Peterhead,3672,2,23,5,8,77,38,39,74
Stenhousem'r,3672,3,16,8,12,57,47,10,56
Stirling,3672,4,16,6,14,61,53,8,54
Clyde,3672,5,14,10,12,51,48,3,52
Elgin,3672,6,14,7,15,55,62,-7,49
Annan Athlet,3672,7,12,11,13,48,41,7,47
Berwick,3672,8,8,11,17,29,58,-29,35
Edinburgh Ci,3672,9,7,10,19,36,60,-24,31
Cowdenbeath,3672,10,4,10,22,23,55,-32,22
Montrose,3673,1,24,7,5,63,37,26,79
Peterhead,3673,2,24,4,8,78,38,40,76
Stirling,3673,3,17,6,13,61,51,10,57
Stenhousem'r,3673,4,15,8,13,55,47,8,53
Clyde,3673,5,14,10,12,54,51,3,52
Elgin,3673,6,14,6,16,56,64,-8,48
Annan Athlet,3673,7,11,11,14,48,43,5,44
Berwick,3673,8,8,11,17,32,61,-29,35
Edinburgh Ci,3673,9,7,9,20,36,61,-25,30
Cowdenbeath,3673,10,5,10,21,25,55,-30,25
Montrose,3674,1,24,7,5,62,35,27,79
Peterhead,3674,2,24,4,8,79,38,41,76
Stirling,3674,3,17,6,13,61,51,10,57
Clyde,3674,4,15,9,12,55,49,6,54
Stenhousem'r,3674,5,15,8,13,55,47,8,53
Elgin,3674,6,14,6,16,54,63,-9,48
Annan Athlet,3674,7,12,11,13,48,41,7,47
Berwick,3674,8,8,10,18,30,62,-32,34
Edinburgh Ci,3674,9,7,9,20,36,62,-26,30
Cowdenbeath,3674,10,4,10,22,23,55,-32,22
Montrose,3675,1,23,8,5,61,36,25,77
Peterhead,3675,2,23,5,8,79,40,39,74
Stirling,3675,3,17,6,13,63,52,11,57
Clyde,3675,4,15,9,12,53,48,5,54
Stenhousem'r,3675,5,15,8,13,56,49,7,53
Elgin,3675,6,14,7,15,55,62,-7,49
Annan Athlet,3675,7,11,12,13,47,41,6,45
Berwick,3675,8,8,10,18,29,60,-31,34
Edinburgh Ci,3675,9,7,10,19,38,62,-24,31
Cowdenbeath,3675,10,4,11,21,23,54,-31,23
Montrose,3676,1,23,8,5,61,36,25,77
Peterhead,3676,2,24,4,8,81,38,43,76
Stirling,3676,3,16,7,13,61,52,9,55
Stenhousem'r,3676,4,15,9,12,56,47,9,54
Clyde,3676,5,15,9,12,52,48,4,54
Elgin,3676,6,14,7,15,55,62,-7,49
Annan Athlet,3676,7,11,11,14,48,43,5,44
Berwick,3676,8,8,10,18,29,59,-30,34
Edinburgh Ci,3676,9,7,9,20,36,64,-28,30
Cowdenbeath,3676,10,5,10,21,25,55,-30,25
Montrose,3677,1,24,7,5,62,35,27,79
Peterhead,3677,2,24,4,8,79,38,41,76
Stirling,3677,3,17,6,13,63,52,11,57
Stenhousem'r,3677,4,15,8,13,56,49,7,53
Clyde,3677,5,14,9,13,51,49,2,51
Elgin,3677,6,14,6,16,54,63,-9,48
Annan Athlet,3677,7,12,11,13,49,41,8,47
Berwick,3677,8,9,10,17,30,58,-28,37
Edinburgh Ci,3677,9,7,9,20,36,62,-26,30
Cowdenbeath,3677,10,4,10,22,23,56,-33,22
Montrose,3678,1,24,7,5,61,35,26,79
Peterhead,3678,2,23,5,8,77,38,39,74
Stirling,3678,3,16,7,13,62,53,9,55
Stenhousem'r,3678,4,15,9,12,57,48,9,54
Clyde,3678,5,15,9,12,52,48,4,54
Elgin,3678,6,14,6,16,54,62,-8,48
Annan Athlet,3678,7,11,12,13,48,42,6,45
Berwick,3678,8,8,10,18,29,59,-30,34
Edinburgh Ci,3678,9,7,10,19,36,60,-24,31
Cowdenbeath,3678,10,4,11,21,24,55,-31,23
Montrose,3679,1,23,8,5,59,34,25,77
Peterhead,3679,2,24,4,8,84,39,45,76
Stirling,3679,3,17,6,13,61,51,10,57
Stenhousem'r,3679,4,15,8,13,55,47,8,53
Clyde,3679,5,14,10,12,52,49,3,52
Elgin,3679,6,14,7,15,53,60,-7,49
Annan Athlet,3679,7,11,12,13,48,42,6,45
Berwick,3679,8,8,11,17,30,59,-29,35
Edinburgh Ci,3679,9,7,9,20,37,67,-30,30
Cowdenbeath,3679,10,4,11,21,24,55,-31,23
Montrose,3680,1,23,8,5,60,35,25,77
Peterhead,3680,2,24,4,8,79,39,40,76
Stirling,3680,3,17,6,13,63,52,11,57
Stenhousem'r,3680,4,15,8,13,56,49,7,53
Clyde,3680,5,14,9,13,51,50,1,51
Elgin,3680,6,14,7,15,54,61,-7,49
Annan Athlet,3680,7,12,11,13,48,41,7,47
Berwick,3680,8,9,10,17,31,58,-27,37
Edinburgh Ci,3680,9,7,9,20,37,62,-25,30
Cowdenbeath,3680,10,4,10,22,23,55,-32,22
Montrose,3681,1,23,7,6,59,35,24,76
Peterhead,3681,2,23,4,9,77,39,38,73
Stirling,3681,3,16,7,13,61,52,9,55
Stenhousem'r,3681,4,15,9,12,56,47,9,54
Clyde,3681,5,15,9,12,53,48,5,54
Elgin,3681,6,15,6,15,54,60,-6,51
Annan Athlet,3681,7,11,12,13,48,42,6,45
Berwick,3681,8,8,10,18,29,60,-31,34
Edinburgh Ci,3681,9,8,9,19,37,60,-23,33
Cowdenbeath,3681,10,4,11,21,24,55,-31,23
Montrose,3682,1,23,8,5,59,34,25,77
Peterhead,3682,2,23,5,8,77,38,39,74
Stirling,3682,3,17,6,13,63,51,12,57
Stenhousem'r,3682,4,15,8,13,55,49,6,53
Clyde,3682,5,14,9,13,53,51,2,51
Elgin,3682,6,14,7,15,53,60,-7,49
Annan Athlet,3682,7,12,11,13,49,42,7,47
Berwick,3682,8,9,10,17,32,60,-28,37
Edinburgh Ci,3682,9,7,10,19,36,60,-24,31
Cowdenbeath,3682,10,4,10,22,24,56,-32,22
Montrose,3683,1,24,7,5,62,36,26,79
Peterhead,3683,2,24,4,8,78,38,40,76
Stenhousem'r,3683,3,16,8,12,56,46,10,56
Stirling,3683,4,16,6,14,60,52,8,54
Clyde,3683,5,14,9,13,52,50,2,51
Elgin,3683,6,14,6,16,55,63,-8,48
Annan Athlet,3683,7,12,11,13,50,43,7,47
Berwick,3683,8,9,10,17,31,59,-28,37
Edinburgh Ci,3683,9,7,9,20,36,61,-25,30
Cowdenbeath,3683,10,4,10,22,25,57,-32,22
Montrose,3684,1,24,7,5,60,34,26,79
Peterhead,3684,2,23,5,8,78,39,39,74
Stirling,3684,3,16,7,13,63,54,9,55
Stenhousem'r,3684,4,15,9,12,58,49,9,54
Clyde,3684,5,15,9,12,54,48,6,54
Elgin,3684,6,14,6,16,53,61,-8,48
Annan Athlet,3684,7,12,11,13,49,41,8,47
Berwick,3684,8,8,10,18,29,61,-32,34
Edinburgh Ci,3684,9,7,10,19,37,61,-24,31
Cowdenbeath,3684,10,4,10,22,23,56,-33,22
Montrose,3685,1,24,7,5,62,34,28,79
Peterhead,3685,2,23,4,9,78,40,38,73
Stenhousem'r,3685,3,16,8,12,57,47,10,56
Stirling,3685,4,16,6,14,61,53,8,54
Clyde,3685,5,14,10,12,52,49,3,52
Elgin,3685,6,14,6,16,53,63,-10,48
Annan Athlet,3685,7,12,11,13,48,41,7,47
Berwick,3685,8,8,11,17,30,59,-29,35
Edinburgh Ci,3685,9,8,9,19,38,61,-23,33
Cowdenbeath,3685,10,4,10,22,23,55,-32,22
Montrose,3686,1,24,7,5,64,35,29,79
Peterhead,3686,2,23,4,9,77,39,38,73
Stenhousem'r,3686,3,16,8,12,57,46,11,56
Stirling,3686,4,16,6,14,60,53,7,54
Clyde,3686,5,15,9,12,53,48,5,54
Elgin,3686,6,14,6,16,54,65,-11,48
Annan Athlet,3686,7,11,11,14,47,42,5,44
Berwick,3686,8,8,10,18,29,60,-31,34
Edinburgh Ci,3686,9,8,9,19,37,60,-23,33
Cowdenbeath,3686,10,5,10,21,24,54,-30,25
Montrose,3687,1,24,7,5,61,35,26,79
Peterhead,3687,2,24,4,8,78,38,40,76
Stenhousem'r,3687,3,16,8,12,56,46,10,56
Stirling,3687,4,16,6,14,60,52,8,54
Clyde,3687,5,15,9,12,54,50,4,54
Elgin,3687,6,14,6,16,54,62,-8,48
Annan Athlet,3687,7,12,11,13,49,42,7,47
Berwick,3687,8,8,10,18,31,61,-30,34
Edinburgh Ci,3687,9,7,9,20,36,61,-25,30
Cowdenbeath,3687,10,4,10,22,24,56,-32,22
Montrose,3688,1,24,7,5,62,35,27,79
Peterhead,3688,2,24,4,8,78,38,40,76
Stirling,3688,3,17,6,13,64,52,12,57
Clyde,3688,4,15,9,12,52,48,4,54
Stenhousem'r,3688,5,15,8,13,56,50,6,53
Elgin,3688,6,14,6,16,54,63,-9,48
Annan Athlet,3688,7,11,12,13,48,42,6,45
Berwick,3688,8,8,10,18,29,59,-30,34
Edinburgh Ci,3688,9,7,9,20,36,61,-25,30
Cowdenbeath,3688,10,4,11,21,24,55,-31,23
Montrose,3689,1,23,8,5,60,35,25,77
Peterhead,3689,2,24,4,8,79,39,40,76
Stirling,3689,3,17,6,13,63,53,10,57
Clyde,3689,4,15,9,12,54,49,5,54
Stenhousem'r,3689,5,15,8,13,57,49,8,53
Elgin,3689,6,14,7,15,54,61,-7,49
Annan Athlet,3689,7,11,11,14,48,43,5,44
Berwick,3689,8,8,10,18,30,61,-31,34
Edinburgh Ci,3689,9,7,9,20,37,62,-25,30
Cowdenbeath,3689,10,5,10,21,25,55,-30,25
Montrose,3690,1,23,7,6,60,37,23,76
Peterhead,3690,2,23,5,8,78,39,39,74
Stirling,3690,3,17,6,13,61,51,10,57
Clyde,3690,4,15,9,12,53,48,5,54
Stenhousem'r,3690,5,15,8,13,55,47,8,53
Elgin,3690,6,15,6,15,56,61,-5,51
Annan Athlet,3690,7,11,12,13,47,41,6,45
Berwick,3690,8,8,10,18,29,60,-31,34
Edinburgh Ci,3690,9,7,10,19,37,61,-24,31
Cowdenbeath,3690,10,4,11,21,23,54,-31,23
Peterhead,3691,1,24,4,8,81,38,43,76
Montrose,3691,2,23,7,6,59,37,22,76
Stenhousem'r,3691,3,16,8,12,57,46,11,56
Stirling,3691,4,16,6,14,60,53,7,54
Clyde,3691,5,15,9,12,53,49,4,54
Elgin,3691,6,15,6,15,56,60,-4,51
Annan Athlet,3691,7,11,12,13,49,43,6,45
Berwick,3691,8,8,10,18,30,60,-30,34
Edinburgh Ci,3691,9,7,9,20,36,64,-28,30
Cowdenbeath,3691,10,4,11,21,25,56,-31,23
Montrose,3692,1,24,7,5,63,34,29,79
Peterhead,3692,2,24,4,8,80,40,40,76
Stirling,3692,3,17,6,13,62,51,11,57
Stenhousem'r,3692,4,15,8,13,55,48,7,53
Clyde,3692,5,14,9,13,51,49,2,51
Elgin,3692,6,14,6,16,53,64,-11,48
Annan Athlet,3692,7,11,11,14,47,42,5,44
Berwick,3692,8,9,10,17,30,58,-28,37
Edinburgh Ci,3692,9,7,9,20,38,63,-25,30
Cowdenbeath,3692,10,5,10,21,24,54,-30,25
Montrose,3693,1,24,7,5,62,36,26,79
Peterhead,3693,2,24,4,8,81,38,43,76
Stirling,3693,3,17,6,13,62,51,11,57
Clyde,3693,4,15,9,12,53,48,5,54
Stenhousem'r,3693,5,15,8,13,55,48,7,53
Elgin,3693,6,14,6,16,55,63,-8,48
Annan Athlet,3693,7,11,12,13,48,42,6,45
Berwick,3693,8,8,10,18,29,60,-31,34
Edinburgh Ci,3693,9,7,9,20,36,64,-28,30
Cowdenbeath,3693,10,4,11,21,24,55,-31,23
Montrose,3694,1,23,7,6,61,37,24,76
Peterhead,3694,2,23,5,8,80,41,39,74
Stenhousem'r,3694,3,16,8,12,59,46,13,56
Clyde,3694,4,15,9,12,55,49,6,54
Stirling,3694,5,16,6,14,60,55,5,54
Elgin,3694,6,15,6,15,56,62,-6,51
Annan Athlet,3694,7,11,12,13,47,41,6,45
Berwick,3694,8,8,10,18,30,62,-32,34
Edinburgh Ci,3694,9,7,10,19,39,63,-24,31
Cowdenbeath,3694,10,4,11,21,23,54,-31,23
Peterhead,3695,1,24,4,8,82,38,44,76
Montrose,3695,2,23,7,6,60,36,24,76
Stenhousem'r,3695,3,16,8,12,57,47,10,56
Stirling,3695,4,16,6,14,61,53,8,54
Clyde,3695,5,14,9,13,53,51,2,51
Elgin,3695,6,15,6,15,55,61,-6,51
Annan Athlet,3695,7,11,12,13,48,42,6,45
Berwick,3695,8,9,10,17,32,60,-28,37
Edinburgh Ci,3695,9,7,9,20,36,65,-29,30
Cowdenbeath,3695,10,4,11,21,24,55,-31,23
Montrose,3696,1,23,8,5,59,34,25,77
Peterhead,3696,2,24,4,8,81,39,42,76
Stenhousem'r,3696,3,16,8,12,58,47,11,56
Stirling,3696,4,16,6,14,61,54,7,54
Clyde,3696,5,15,9,12,55,48,7,54
Elgin,3696,6,14,7,15,53,60,-7,49
Annan Athlet,3696,7,11,12,13,49,43,6,45
Berwick,3696,8,8,10,18,29,62,-33,34
Edinburgh Ci,3696,9,7,9,20,37,64,-27,30
Cowdenbeath,3696,10,4,11,21,25,56,-31,23
Montrose,3697,1,23,8,5,60,35,25,77
Peterhead,3697,2,24,4,8,84,39,45,76
Stenhousem'r,3697,3,16,8,12,56,46,10,56
Stirling,3697,4,16,6,14,60,52,8,54
Clyde,3697,5,14,10,12,52,49,3,52
Elgin,3697,6,14,7,15,54,61,-7,49
Annan Athlet,3697,7,12,11,13,51,42,9,47
Berwick,3697,8,8,11,17,30,59,-29,35
Edinburgh Ci,3697,9,7,9,20,37,67,-30,30
Cowdenbeath,3697,10,4,10,22,24,58,-34,22
Montrose,3698,1,24,7,5,64,36,28,79
Peterhead,3698,2,24,4,8,82,39,43,76
Stirling,3698,3,17,6,13,63,51,12,57
Clyde,3698,4,15,9,12,53,48,5,54
Stenhousem'r,3698,5,15,8,13,55,49,6,53
Elgin,3698,6,14,6,16,55,65,-10,48
Annan Athlet,3698,7,11,11,14,49,44,5,44
Berwick,3698,8,8,10,18,29,60,-31,34
Edinburgh Ci,3698,9,7,9,20,37,65,-28,30
Cowdenbeath,3698,10,5,10,21,26,56,-30,25
Montrose,3699,1,24,7,5,62,35,27,79
Peterhead,3699,2,24,4,8,80,39,41,76
Stirling,3699,3,16,7,13,60,51,9,55
Stenhousem'r,3699,4,15,9,12,55,46,9,54
Clyde,3699,5,15,9,12,55,50,5,54
Elgin,3699,6,14,6,16,54,63,-9,48
Annan Athlet,3699,7,11,12,13,47,41,6,45
Berwick,3699,8,8,10,18,31,62,-31,34
Edinburgh Ci,3699,9,7,9,20,37,63,-26,30
Cowdenbeath,3699,10,4,11,21,23,54,-31,23
Montrose,3700,1,24,7,5,61,35,26,79
Peterhead,3700,2,24,4,8,81,40,41,76
Stenhousem'r,3700,3,16,8,12,59,48,11,56
Stirling,3700,4,16,6,14,62,55,7,54
Clyde,3700,5,15,9,12,55,48,7,54
Elgin,3700,6,14,6,16,54,62,-8,48
Annan Athlet,3700,7,11,11,14,47,42,5,44
Berwick,3700,8,8,10,18,29,62,-33,34
Edinburgh Ci,3700,9,7,9,20,38,64,-26,30
Cowdenbeath,3700,10,5,10,21,24,54,-30,25
Montrose,3701,1,23,7,6,59,35,24,76
Peterhead,3701,2,23,4,9,78,40,38,73
Stirling,3701,3,16,7,13,62,53,9,55
Stenhousem'r,3701,4,15,9,12,57,48,9,54
Clyde,3701,5,14,10,12,53,50,3,52
Elgin,3701,6,15,6,15,54,60,-6,51
Annan Athlet,3701,7,11,11,14,47,42,5,44
Berwick,3701,8,8,11,17,31,60,-29,35
Edinburgh Ci,3701,9,8,9,19,38,61,-23,33
Cowdenbeath,3701,10,5,10,21,24,54,-30,25
Montrose,3702,1,24,7,5,61,34,27,79
Peterhead,3702,2,24,4,8,79,38,41,76
Stirling,3702,3,16,7,13,62,53,9,55
Stenhousem'r,3702,4,15,9,12,57,48,9,54
Clyde,3702,5,14,10,12,52,49,3,52
Elgin,3702,6,14,6,16,53,62,-9,48
Annan Athlet,3702,7,11,12,13,48,42,6,45
Berwick,3702,8,8,11,17,30,59,-29,35
Edinburgh Ci,3702,9,7,9,20,36,62,-26,30
Cowdenbeath,3702,10,4,11,21,24,55,-31,23
Montrose,3703,1,24,7,5,65,37,28,79
Peterhead,3703,2,24,4,8,81,38,43,76
Stirling,3703,3,17,6,13,62,51,11,57
Clyde,3703,4,15,9,12,53,48,5,54
Stenhousem'r,3703,5,15,8,13,55,48,7,53
Elgin,3703,6,14,6,16,56,66,-10,48
Annan Athlet,3703,7,11,11,14,48,43,5,44
Berwick,3703,8,8,10,18,29,60,-31,34
Edinburgh Ci,3703,9,7,9,20,36,64,-28,30
Cowdenbeath,3703,10,5,10,21,25,55,-30,25
Montrose,3704,1,23,8,5,60,35,25,77
Peterhead,3704,2,24,4,8,78,38,40,76
Stirling,3704,3,16,7,13,61,52,9,55
Stenhousem'r,3704,4,15,9,12,56,47,9,54
Clyde,3704,5,15,9,12,52,48,4,54
Elgin,3704,6,14,7,15,54,61,-7,49
Annan Athlet,3704,7,11,12,13,47,41,6,45
Berwick,3704,8,8,10,18,29,59,-30,34
Edinburgh Ci,3704,9,7,9,20,36,61,-25,30
Cowdenbeath,3704,10,4,11,21,23,54,-31,23
Montrose,3705,1,24,7,5,60,34,26,79
Peterhead,3705,2,23,4,9,78,40,38,73
Stenhousem'r,3705,3,16,8,12,57,47,10,56
Stirling,3705,4,16,6,14,61,53,8,54
Clyde,3705,5,14,10,12,51,48,3,52
Elgin,3705,6,14,6,16,53,61,-8,48
Annan Athlet,3705,7,12,11,13,48,41,7,47
Berwick,3705,8,8,11,17,29,58,-29,35
Edinburgh Ci,3705,9,8,9,19,38,61,-23,33
Cowdenbeath,3705,10,4,10,22,23,55,-32,22
Montrose,3706,1,24,7,5,62,36,26,79
Peterhead,3706,2,24,4,8,81,40,41,76
Stirling,3706,3,17,6,13,61,51,10,57
Stenhousem'r,3706,4,15,8,13,55,47,8,53
Clyde,3706,5,14,10,12,52,49,3,52
Elgin,3706,6,14,6,16,55,63,-8,48
Annan Athlet,3706,7,11,11,14,48,43,5,44
Berwick,3706,8,8,11,17,30,59,-29,35
Edinburgh Ci,3706,9,7,9,20,38,64,-26,30
Cowdenbeath,3706,10,5,10,21,25,55,-30,25
Montrose,3707,1,24,7,5,62,34,28,79
Peterhead,3707,2,24,4,8,81,38,43,76
Stirling,3707,3,17,6,13,61,51,10,57
Clyde,3707,4,15,9,12,54,49,5,54
Stenhousem'r,3707,5,15,8,13,55,47,8,53
Elgin,3707,6,14,6,16,53,63,-10,48
Annan Athlet,3707,7,11,12,13,48,42,6,45
Berwick,3707,8,8,10,18,30,61,-31,34
Edinburgh Ci,3707,9,7,9,20,36,64,-28,30
Cowdenbeath,3707,10,4,11,21,24,55,-31,23
Montrose,3708,1,24,7,5,62,35,27,79
Peterhead,3708,2,23,5,8,78,39,39,74
Stirling,3708,3,16,7,13,62,53,9,55
Stenhousem'r,3708,4,15,9,12,57,48,9,54
Clyde,3708,5,15,9,12,53,48,5,54
Elgin,3708,6,14,6,16,54,63,-9,48
Annan Athlet,3708,7,12,11,13,48,41,7,47
Berwick,3708,8,8,10,18,29,60,-31,34
Edinburgh Ci,3708,9,7,10,19,37,61,-24,31
Cowdenbeath,3708,10,4,10,22,23,55,-32,22
Montrose,3709,1,24,7,5,63,35,28,79
Peterhead,3709,2,24,4,8,82,38,44,76
Stirling,3709,3,17,6,13,62,51,11,57
Clyde,3709,4,15,9,12,53,49,4,54
Stenhousem'r,3709,5,15,8,13,55,48,7,53
Elgin,3709,6,14,6,16,54,64,-10,48
Annan Athlet,3709,7,12,11,13,50,42,8,47
Berwick,3709,8,8,10,18,30,60,-30,34
Edinburgh Ci,3709,9,7,9,20,36,65,-29,30
Cowdenbeath,3709,10,4,10,22,24,57,-33,22
Montrose,3710,1,24,7,5,63,36,27,79
Peterhead,3710,2,24,4,8,79,39,40,76
Stenhousem'r,3710,3,16,8,12,57,46,11,56
Stirling,3710,4,16,6,14,60,53,7,54
Clyde,3710,5,15,9,12,54,50,4,54
Elgin,3710,6,14,6,16,55,64,-9,48
Annan Athlet,3710,7,11,12,13,49,43,6,45
Berwick,3710,8,8,10,18,31,61,-30,34
Edinburgh Ci,3710,9,7,9,20,37,62,-25,30
Cowdenbeath,3710,10,4,11,21,25,56,-31,23
Montrose,3711,1,24,7,5,62,34,28,79
Peterhead,3711,2,24,4,8,81,38,43,76
Stenhousem'r,3711,3,16,8,12,58,47,11,56
Stirling,3711,4,16,6,14,61,54,7,54
Clyde,3711,5,15,9,12,53,49,4,54
Elgin,3711,6,14,6,16,53,63,-10,48
Annan Athlet,3711,7,12,11,13,49,41,8,47
Berwick,3711,8,8,10,18,30,60,-30,34
Edinburgh Ci,3711,9,7,9,20,36,64,-28,30
Cowdenbeath,3711,10,4,10,22,23,56,-33,22
Montrose,3712,1,24,7,5,61,35,26,79
Peterhead,3712,2,24,4,8,79,39,40,76
Stirling,3712,3,17,6,13,62,51,11,57
Stenhousem'r,3712,4,15,8,13,55,48,7,53
Clyde,3712,5,14,10,12,52,49,3,52
Elgin,3712,6,14,6,16,54,62,-8,48
Annan Athlet,3712,7,11,12,13,47,41,6,45
Berwick,3712,8,8,11,17,30,59,-29,35
Edinburgh Ci,3712,9,7,9,20,37,62,-25,30
Cowdenbeath,3712,10,4,11,21,23,54,-31,23
Montrose,3713,1,23,8,5,61,36,25,77
Peterhead,3713,2,24,4,8,80,40,40,76
Stirling,3713,3,17,6,13,62,52,10,57
Stenhousem'r,3713,4,15,8,13,56,48,8,53
Clyde,3713,5,14,9,13,51,51,0,51
Elgin,3713,6,14,7,15,55,62,-7,49
Annan Athlet,3713,7,12,11,13,48,41,7,47
Berwick,3713,8,9,10,17,32,58,-26,37
Edinburgh Ci,3713,9,7,9,20,38,63,-25,30
Cowdenbeath,3713,10,4,10,22,23,55,-32,22
Peterhead,3714,1,24,4,8,80,39,41,76
Montrose,3714,2,23,7,6,60,37,23,76
Stenhousem'r,3714,3,16,8,12,57,46,11,56
Stirling,3714,4,16,6,14,60,53,7,54
Clyde,3714,5,15,9,12,53,49,4,54
Elgin,3714,6,15,6,15,56,61,-5,51
Annan Athlet,3714,7,11,11,14,47,42,5,44
Berwick,3714,8,8,10,18,30,60,-30,34
Edinburgh Ci,3714,9,7,9,20,37,63,-26,30
Cowdenbeath,3714,10,5,10,21,24,54,-30,25
Montrose,3715,1,24,7,5,61,35,26,79
Peterhead,3715,2,23,5,8,78,39,39,74
Stirling,3715,3,16,7,13,61,52,9,55
Stenhousem'r,3715,4,15,9,12,56,47,9,54
Clyde,3715,5,14,10,12,52,49,3,52
Elgin,3715,6,14,6,16,54,62,-8,48
Annan Athlet,3715,7,12,11,13,51,42,9,47
Berwick,3715,8,8,11,17,30,59,-29,35
Edinburgh Ci,3715,9,7,10,19,37,61,-24,31
Cowdenbeath,3715,10,4,10,22,24,58,-34,22
Montrose,3716,1,24,7,5,62,36,26,79
Peterhead,3716,2,23,4,9,78,40,38,73
Stirling,3716,3,17,6,13,62,52,10,57
Clyde,3716,4,15,9,12,54,49,5,54
Stenhousem'r,3716,5,15,8,13,56,48,8,53
Elgin,3716,6,14,6,16,55,63,-8,48
Annan Athlet,3716,7,11,12,13,47,41,6,45
Berwick,3716,8,8,10,18,30,61,-31,34
Edinburgh Ci,3716,9,8,9,19,38,61,-23,33
Cowdenbeath,3716,10,4,11,21,23,54,-31,23
Peterhead,3717,1,24,4,8,82,39,43,76
Montrose,3717,2,23,7,6,59,36,23,76
Stirling,3717,3,16,7,13,61,52,9,55
Stenhousem'r,3717,4,15,9,12,56,47,9,54
Clyde,3717,5,15,9,12,53,48,5,54
Elgin,3717,6,15,6,15,55,60,-5,51
Annan Athlet,3717,7,12,11,13,49,42,7,47
Berwick,3717,8,8,10,18,29,60,-31,34
Edinburgh Ci,3717,9,7,9,20,37,65,-28,30
Cowdenbeath,3717,10,4,10,22,24,56,-32,22
Peterhead,3718,1,24,4,8,78,38,40,76
Montrose,3718,2,23,7,6,59,35,24,76
Stenhousem'r,3718,3,16,8,12,57,47,10,56
Stirling,3718,4,16,6,14,61,53,8,54
Clyde,3718,5,14,9,13,52,50,2,51
Elgin,3718,6,15,6,15,54,60,-6,51
Annan Athlet,3718,7,12,11,13,49,42,7,47
Berwick,3718,8,9,10,17,31,59,-28,37
Edinburgh Ci,3718,9,7,9,20,36,61,-25,30
Cowdenbeath,3718,10,4,10,22,24,56,-32,22
Peterhead,3719,1,24,4,8,81,38,43,76
Montrose,3719,2,23,7,6,60,36,24,76
Stirling,3719,3,17,6,13,63,52,11,57
Stenhousem'r,3719,4,15,8,13,56,49,7,53
Clyde,3719,5,14,9,13,51,49,2,51
Elgin,3719,6,15,6,15,55,61,-6,51
Annan Athlet,3719,7,12,11,13,49,41,8,47
Berwick,3719,8,9,10,17,30,58,-28,37
Edinburgh Ci,3719,9,7,9,20,36,64,-28,30
Cowdenbeath,3719,10,4,10,22,23,56,-33,22
Montrose,3720,1,24,7,5,61,34,27,79
Peterhead,3720,2,24,4,8,80,40,40,76
Stirling,3720,3,17,6,13,63,53,10,57
Stenhousem'r,3720,4,15,8,13,57,49,8,53
Clyde,3720,5,14,10,12,52,49,3,52
Elgin,3720,6,14,6,16,53,62,-9,48
Annan Athlet,3720,7,12,11,13,49,41,8,47
Berwick,3720,8,8,11,17,30,59,-29,35
Edinburgh Ci,3720,9,7,9,20,38,63,-25,30
Cowdenbeath,3720,10,4,10,22,23,56,-33,22
Montrose,3721,1,23,8,5,59,34,25,77
Peterhead,3721,2,23,5,8,79,40,39,74
Stenhousem'r,3721,3,16,8,12,57,46,11,56
Stirling,3721,4,16,6,14,60,53,7,54
Clyde,3721,5,15,9,12,54,49,5,54
Elgin,3721,6,14,7,15,53,60,-7,49
Annan Athlet,3721,7,11,12,13,48,42,6,45
Berwick,3721,8,8,10,18,30,61,-31,34
Edinburgh Ci,3721,9,7,10,19,38,62,-24,31
Cowdenbeath,3721,10,4,11,21,24,55,-31,23
Montrose,3722,1,24,7,5,62,35,27,79
Peterhead,3722,2,23,5,8,78,39,39,74
Stirling,3722,3,16,7,13,61,52,9,55
Stenhousem'r,3722,4,15,9,12,56,47,9,54
Clyde,3722,5,14,10,12,52,49,3,52
Elgin,3722,6,14,6,16,54,63,-9,48
Annan Athlet,3722,7,11,11,14,47,45,2,44
Berwick,3722,8,8,11,17,30,59,-29,35
Edinburgh Ci,3722,9,7,10,19,37,61,-24,31
Cowdenbeath,3722,10,5,10,21,27,54,-27,25
Montrose,3723,1,24,7,5,63,36,27,79
Peterhead,3723,2,24,4,8,81,39,42,76
Stenhousem'r,3723,3,16,8,12,57,47,10,56
Stirling,3723,4,16,6,14,61,53,8,54
Clyde,3723,5,14,10,12,52,49,3,52
Elgin,3723,6,14,6,16,55,64,-9,48
Annan Athlet,3723,7,12,11,13,49,41,8,47
Berwick,3723,8,8,11,17,30,59,-29,35
Edinburgh Ci,3723,9,7,9,20,37,64,-27,30
Cowdenbeath,3723,10,4,10,22,23,56,-33,22
Peterhead,3724,1,24,4,8,83,42,41,76
Montrose,3724,2,23,7,6,59,36,23,76
Stirling,3724,3,17,6,13,65,52,13,57
Clyde,3724,4,15,9,12,53,49,4,54
Stenhousem'r,3724,5,15,8,13,56,51,5,53
Elgin,3724,6,15,6,15,55,60,-5,51
Annan Athlet,3724,7,11,11,14,48,44,4,44
Berwick,3724,8,8,10,18,30,60,-30,34
Edinburgh Ci,3724,9,7,9,20,40,66,-26,30
Cowdenbeath,3724,10,5,10,21,26,55,-29,25
Peterhead,3725,1,24,4,8,80,39,41,76
Montrose,3725,2,23,7,6,60,36,24,76
Stirling,3725,3,16,7,13,61,52,9,55
Stenhousem'r,3725,4,15,9,12,56,47,9,54
Clyde,3725,5,14,10,12,51,48,3,52
Elgin,3725,6,15,6,15,55,61,-6,51
Annan Athlet,3725,7,11,11,14,47,43,4,44
Berwick,3725,8,8,11,17,29,58,-29,35
Edinburgh Ci,3725,9,7,9,20,37,63,-26,30
Cowdenbeath,3725,10,5,10,21,25,54,-29,25
Montrose,3726,1,24,7,5,64,34,30,79
Peterhead,3726,2,24,4,8,81,41,40,76
Stirling,3726,3,16,7,13,62,53,9,55
Stenhousem'r,3726,4,15,9,12,57,48,9,54
Clyde,3726,5,14,10,12,52,49,3,52
Elgin,3726,6,14,6,16,53,65,-12,48
Annan Athlet,3726,7,11,11,14,47,44,3,44
Berwick,3726,8,8,11,17,30,59,-29,35
Edinburgh Ci,3726,9,7,9,20,39,64,-25,30
Cowdenbeath,3726,10,5,10,21,26,54,-28,25
Montrose,3727,1,24,7,5,65,35,30,79
Peterhead,3727,2,24,4,8,81,40,41,76
Stenhousem'r,3727,3,16,8,12,56,46,10,56
Stirling,3727,4,16,6,14,60,52,8,54
Clyde,3727,5,15,9,12,54,48,6,54
Elgin,3727,6,14,6,16,54,66,-12,48
Annan Athlet,3727,7,11,11,14,49,44,5,44
Berwick,3727,8,8,10,18,29,61,-32,34
Edinburgh Ci,3727,9,7,9,20,38,64,-26,30
Cowdenbeath,3727,10,5,10,21,26,56,-30,25
Montrose,3728,1,24,7,5,62,34,28,79
Peterhead,3728,2,24,4,8,79,38,41,76
Stirling,3728,3,17,6,13,63,51,12,57
Clyde,3728,4,15,9,12,53,49,4,54
Stenhousem'r,3728,5,15,8,13,55,49,6,53
Elgin,3728,6,14,6,16,53,63,-10,48
Annan Athlet,3728,7,12,11,13,48,41,7,47
Berwick,3728,8,8,10,18,30,60,-30,34
Edinburgh Ci,3728,9,7,9,20,36,62,-26,30
Cowdenbeath,3728,10,4,10,22,23,55,-32,22
Montrose,3729,1,23,8,5,59,34,25,77
Peterhead,3729,2,24,4,8,81,41,40,76
Stirling,3729,3,17,6,13,62,51,11,57
Clyde,3729,4,15,9,12,52,48,4,54
Stenhousem'r,3729,5,15,8,13,55,48,7,53
Elgin,3729,6,14,7,15,53,60,-7,49
Annan Athlet,3729,7,11,11,14,48,43,5,44
Berwick,3729,8,8,10,18,29,59,-30,34
Edinburgh Ci,3729,9,7,9,20,39,64,-25,30
Cowdenbeath,3729,10,5,10,21,25,55,-30,25
Montrose,3730,1,24,7,5,61,34,27,79
Peterhead,3730,2,24,4,8,80,38,42,76
Stenhousem'r,3730,3,16,8,12,57,47,10,56
Stirling,3730,4,16,6,14,61,53,8,54
Clyde,3730,5,15,9,12,55,49,6,54
Elgin,3730,6,14,6,16,53,62,-9,48
Annan Athlet,3730,7,12,11,13,49,41,8,47
Berwick,3730,8,8,10,18,30,62,-32,34
Edinburgh Ci,3730,9,7,9,20,36,63,-27,30
Cowdenbeath,3730,10,4,10,22,23,56,-33,22
Montrose,3731,1,24,7,5,64,35,29,79
Peterhead,3731,2,23,5,8,78,39,39,74
Stirling,3731,3,17,6,13,61,51,10,57
Clyde,3731,4,15,9,12,52,48,4,54
Stenhousem'r,3731,5,15,8,13,55,47,8,53
Elgin,3731,6,14,6,16,54,65,-11,48
Annan Athlet,3731,7,11,12,13,48,42,6,45
Berwick,3731,8,8,10,18,29,59,-30,34
Edinburgh Ci,3731,9,7,10,19,37,61,-24,31
Cowdenbeath,3731,10,4,11,21,24,55,-31,23
Montrose,3732,1,23,8,5,60,35,25,77
Peterhead,3732,2,24,4,8,80,39,41,76
Stenhousem'r,3732,3,16,8,12,58,48,10,56
Stirling,3732,4,16,6,14,62,54,8,54
Clyde,3732,5,15,9,12,54,49,5,54
Elgin,3732,6,14,7,15,54,61,-7,49
Annan Athlet,3732,7,12,11,13,48,41,7,47
Berwick,3732,8,8,10,18,30,61,-31,34
Edinburgh Ci,3732,9,7,9,20,37,63,-26,30
Cowdenbeath,3732,10,4,10,22,23,55,-32,22
Montrose,3733,1,23,8,5,61,36,25,77
Peterhead,3733,2,24,4,8,80,40,40,76
Stirling,3733,3,17,6,13,63,51,12,57
Stenhousem'r,3733,4,15,8,13,55,49,6,53
Clyde,3733,5,14,9,13,51,50,1,51
Elgin,3733,6,14,7,15,55,62,-7,49
Annan Athlet,3733,7,12,11,13,50,42,8,47
Berwick,3733,8,9,10,17,31,58,-27,37
Edinburgh Ci,3733,9,7,9,20,38,63,-25,30
Cowdenbeath,3733,10,4,10,22,24,57,-33,22
Montrose,3734,1,24,7,5,63,34,29,79
Peterhead,3734,2,24,4,8,81,38,43,76
Stenhousem'r,3734,3,16,8,12,58,46,12,56
Stirling,3734,4,16,6,14,60,54,6,54
Clyde,3734,5,15,9,12,53,48,5,54
Elgin,3734,6,14,6,16,53,64,-11,48
Annan Athlet,3734,7,11,11,14,47,42,5,44
Berwick,3734,8,8,10,18,29,60,-31,34
Edinburgh Ci,3734,9,7,9,20,36,64,-28,30
Cowdenbeath,3734,10,5,10,21,24,54,-30,25
Montrose,3735,1,24,7,5,61,35,26,79
Peterhead,3735,2,24,4,8,80,38,42,76
Stirling,3735,3,17,6,13,63,51,12,57
Stenhousem'r,3735,4,15,8,13,55,49,6,53
Clyde,3735,5,14,10,12,53,50,3,52
Elgin,3735,6,14,6,16,54,62,-8,48
Annan Athlet,3735,7,11,11,14,47,43,4,44
Berwick,3735,8,8,11,17,31,60,-29,35
Edinburgh Ci,3735,9,7,9,20,36,63,-27,30
Cowdenbeath,3735,10,5,10,21,25,54,-29,25
Montrose,3736,1,24,7,5,61,35,26,79
Peterhead,3736,2,23,5,8,78,39,39,74
Stirling,3736,3,17,6,13,63,53,10,57
Clyde,3736,4,15,9,12,53,48,5,54
Stenhousem'r,3736,5,15,8,13,57,49,8,53
Elgin,3736,6,14,6,16,54,62,-8,48
Annan Athlet,3736,7,11,11,14,47,42,5,44
Berwick,3736,8,8,10,18,29,60,-31,34
Edinburgh Ci,3736,9,7,10,19,37,61,-24,31
Cowdenbeath,3736,10,5,10,21,24,54,-30,25
Montrose,3737,1,24,7,5,62,36,26,79
Peterhead,3737,2,23,4,9,77,39,38,73
Stirling,3737,3,17,6,13,62,52,10,57
Clyde,3737,4,15,9,12,54,48,6,54
Stenhousem'r,3737,5,15,8,13,56,48,8,53
Elgin,3737,6,14,6,16,55,63,-8,48
Annan Athlet,3737,7,12,11,13,50,41,9,47
Berwick,3737,8,8,10,18,29,61,-32,34
Edinburgh Ci,3737,9,8,9,19,37,60,-23,33
Cowdenbeath,3737,10,4,10,22,23,57,-34,22
Montrose,3738,1,24,7,5,60,34,26,79
Peterhead,3738,2,23,5,8,78,39,39,74
Stenhousem'r,3738,3,16,8,12,57,47,10,56
Stirling,3738,4,16,6,14,61,53,8,54
Clyde,3738,5,15,9,12,52,48,4,54
Elgin,3738,6,14,6,16,53,61,-8,48
Annan Athlet,3738,7,12,11,13,50,42,8,47
Berwick,3738,8,8,10,18,29,59,-30,34
Edinburgh Ci,3738,9,7,10,19,37,61,-24,31
Cowdenbeath,3738,10,4,10,22,24,57,-33,22
Montrose,3739,1,23,8,5,60,35,25,77
Peterhead,3739,2,24,4,8,79,39,40,76
Stenhousem'r,3739,3,16,8,12,58,46,12,56
Stirling,3739,4,16,6,14,60,54,6,54
Clyde,3739,5,14,9,13,51,49,2,51
Elgin,3739,6,14,7,15,54,61,-7,49
Annan Athlet,3739,7,11,12,13,48,42,6,45
Berwick,3739,8,9,10,17,30,58,-28,37
Edinburgh Ci,3739,9,7,9,20,37,62,-25,30
Cowdenbeath,3739,10,4,11,21,24,55,-31,23
Montrose,3740,1,24,7,5,62,35,27,79
Peterhead,3740,2,24,4,8,80,39,41,76
Stenhousem'r,3740,3,16,8,12,57,47,10,56
Stirling,3740,4,16,6,14,61,53,8,54
Clyde,3740,5,14,10,12,51,48,3,52
Elgin,3740,6,14,6,16,54,63,-9,48
Annan Athlet,3740,7,12,11,13,50,42,8,47
Berwick,3740,8,8,11,17,29,58,-29,35
Edinburgh Ci,3740,9,7,9,20,37,63,-26,30
Cowdenbeath,3740,10,4,10,22,24,57,-33,22
Peterhead,3741,1,24,4,8,78,38,40,76
Montrose,3741,2,23,7,6,60,36,24,76
Stirling,3741,3,17,6,13,63,51,12,57
Clyde,3741,4,15,9,12,55,49,6,54
Stenhousem'r,3741,5,15,8,13,55,49,6,53
Elgin,3741,6,15,6,15,55,61,-6,51
Annan Athlet,3741,7,11,12,13,48,42,6,45
Berwick,3741,8,8,10,18,30,62,-32,34
Edinburgh Ci,3741,9,7,9,20,36,61,-25,30
Cowdenbeath,3741,10,4,11,21,24,55,-31,23
Montrose,3742,1,24,7,5,62,36,26,79
Peterhead,3742,2,24,4,8,79,38,41,76
Stirling,3742,3,17,6,13,62,51,11,57
Clyde,3742,4,15,9,12,53,48,5,54
Stenhousem'r,3742,5,15,8,13,55,48,7,53
Elgin,3742,6,14,6,16,55,63,-8,48
Annan Athlet,3742,7,11,12,13,49,43,6,45
Berwick,3742,8,8,10,18,29,60,-31,34
Edinburgh Ci,3742,9,7,9,20,36,62,-26,30
Cowdenbeath,3742,10,4,11,21,25,56,-31,23
Montrose,3743,1,23,8,5,62,37,25,77
Peterhead,3743,2,24,4,8,80,38,42,76
Stirling,3743,3,16,7,13,61,52,9,55
Stenhousem'r,3743,4,15,9,12,56,47,9,54
Clyde,3743,5,14,10,12,53,50,3,52
Elgin,3743,6,14,7,15,56,63,-7,49
Annan Athlet,3743,7,11,12,13,48,42,6,45
Berwick,3743,8,8,11,17,31,60,-29,35
Edinburgh Ci,3743,9,7,9,20,36,63,-27,30
Cowdenbeath,3743,10,4,11,21,24,55,-31,23
Montrose,3744,1,24,7,5,62,35,27,79
Peterhead,3744,2,24,4,8,79,38,41,76
Stirling,3744,3,17,6,13,63,52,11,57
Clyde,3744,4,15,9,12,53,49,4,54
Stenhousem'r,3744,5,15,8,13,56,49,7,53
Elgin,3744,6,14,6,16,54,63,-9,48
Annan Athlet,3744,7,12,11,13,50,42,8,47
Berwick,3744,8,8,10,18,30,60,-30,34
Edinburgh Ci,3744,9,7,9,20,36,62,-26,30
Cowdenbeath,3744,10,4,10,22,24,57,-33,22
Montrose,3745,1,23,8,5,59,34,25,77
Peterhead,3745,2,23,5,8,78,39,39,74
Stirling,3745,3,17,6,13,64,51,13,57
Clyde,3745,4,15,9,12,54,48,6,54
Stenhousem'r,3745,5,15,8,13,55,50,5,53
Elgin,3745,6,14,7,15,53,60,-7,49
Annan Athlet,3745,7,11,12,13,47,41,6,45
Berwick,3745,8,8,10,18,29,61,-32,34
Edinburgh Ci,3745,9,7,10,19,37,61,-24,31
Cowdenbeath,3745,10,4,11,21,23,54,-31,23
Montrose,3746,1,23,8,5,60,35,25,77
Peterhead,3746,2,24,4,8,80,40,40,76
Stenhousem'r,3746,3,16,8,12,56,46,10,56
Stirling,3746,4,16,6,14,60,52,8,54
Clyde,3746,5,15,9,12,55,49,6,54
Elgin,3746,6,14,7,15,54,61,-7,49
Annan Athlet,3746,7,12,11,13,49,41,8,47
Berwick,3746,8,8,10,18,30,62,-32,34
Edinburgh Ci,3746,9,7,9,20,38,63,-25,30
Cowdenbeath,3746,10,4,10,22,23,56,-33,22
Montrose,3747,1,23,8,5,62,37,25,77
Peterhead,3747,2,24,4,8,79,39,40,76
Stenhousem'r,3747,3,16,8,12,57,46,11,56
Stirling,3747,4,16,6,14,60,53,7,54
Clyde,3747,5,14,9,13,51,49,2,51
Elgin,3747,6,14,7,15,56,63,-7,49
Annan Athlet,3747,7,11,12,13,49,43,6,45
Berwick,3747,8,9,10,17,30,58,-28,37
Edinburgh Ci,3747,9,7,9,20,37,62,-25,30
Cowdenbeath,3747,10,4,11,21,25,56,-31,23
Montrose,3748,1,23,8,5,61,36,25,77
Peterhead,3748,2,24,4,8,85,40,45,76
Stirling,3748,3,16,7,13,60,51,9,55
Stenhousem'r,3748,4,15,9,12,55,46,9,54
Clyde,3748,5,15,9,12,55,50,5,54
Elgin,3748,6,14,7,15,55,62,-7,49
Annan Athlet,3748,7,12,11,13,49,41,8,47
Berwick,3748,8,8,10,18,31,62,-31,34
Edinburgh Ci,3748,9,7,9,20,38,68,-30,30
Cowdenbeath,3748,10,4,10,22,23,56,-33,22
Montrose,3749,1,24,7,5,64,34,30,79
Peterhead,3749,2,23,5,8,79,40,39,74
Stirling,3749,3,16,7,13,63,54,9,55
Stenhousem'r,3749,4,15,9,12,58,49,9,54
Clyde,3749,5,15,9,12,52,48,4,54
Elgin,3749,6,14,6,16,53,65,-12,48
Annan Athlet,3749,7,11,11,14,48,43,5,44
Berwick,3749,8,8,10,18,29,59,-30,34
Edinburgh Ci,3749,9,7,10,19,38,62,-24,31
Cowdenbeath,3749,10,5,10,21,25,55,-30,25
Peterhead,3750,1,24,4,8,81,39,42,76
Montrose,3750,2,23,7,6,60,36,24,76
Stirling,3750,3,17,6,13,62,52,10,57
Clyde,3750,4,15,9,12,53,49,4,54
Stenhousem'r,3750,5,15,8,13,56,48,8,53
Elgin,3750,6,15,6,15,55,61,-6,51
Annan Athlet,3750,7,11,12,13,49,43,6,45
Berwick,3750,8,8,10,18,30,60,-30,34
Edinburgh Ci,3750,9,7,9,20,37,64,-27,30
Cowdenbeath,3750,10,4,11,21,25,56,-31,23
Montrose,3751,1,24,7,5,61,34,27,79
Peterhead,3751,2,24,4,8,80,39,41,76
Stirling,3751,3,17,6,13,63,52,11,57
Clyde,3751,4,15,9,12,52,48,4,54
Stenhousem'r,3751,5,15,8,13,56,49,7,53
Elgin,3751,6,14,6,16,53,62,-9,48
Annan Athlet,3751,7,12,11,13,50,41,9,47
Berwick,3751,8,8,10,18,29,59,-30,34
Edinburgh Ci,3751,9,7,9,20,37,63,-26,30
Cowdenbeath,3751,10,4,10,22,23,57,-34,22
Montrose,3752,1,24,7,5,61,34,27,79
Peterhead,3752,2,24,4,8,80,39,41,76
Stenhousem'r,3752,3,16,8,12,59,47,12,56
Stirling,3752,4,16,6,14,61,55,6,54
Clyde,3752,5,15,9,12,53,49,4,54
Elgin,3752,6,14,6,16,53,62,-9,48
Annan Athlet,3752,7,11,12,13,48,42,6,45
Berwick,3752,8,8,10,18,30,60,-30,34
Edinburgh Ci,3752,9,7,9,20,37,63,-26,30
Cowdenbeath,3752,10,4,11,21,24,55,-31,23
Montrose,3753,1,23,8,5,61,36,25,77
Peterhead,3753,2,24,4,8,82,39,43,76
Stenhousem'r,3753,3,16,8,12,57,47,10,56
Stirling,3753,4,16,6,14,61,53,8,54
Clyde,3753,5,15,9,12,53,49,4,54
Elgin,3753,6,14,7,15,55,62,-7,49
Annan Athlet,3753,7,11,11,14,47,43,4,44
Berwick,3753,8,8,10,18,30,60,-30,34
Edinburgh Ci,3753,9,7,9,20,37,65,-28,30
Cowdenbeath,3753,10,5,10,21,25,54,-29,25
Montrose,3754,1,24,7,5,62,34,28,79
Peterhead,3754,2,24,4,8,80,38,42,76
Stirling,3754,3,16,7,13,60,51,9,55
Stenhousem'r,3754,4,15,9,12,55,46,9,54
Clyde,3754,5,15,9,12,53,48,5,54
Elgin,3754,6,14,6,16,53,63,-10,48
Annan Athlet,3754,7,11,12,13,48,42,6,45
Berwick,3754,8,8,10,18,29,60,-31,34
Edinburgh Ci,3754,9,7,9,20,36,63,-27,30
Cowdenbeath,3754,10,4,11,21,24,55,-31,23
Montrose,3755,1,24,7,5,61,35,26,79
Peterhead,3755,2,24,4,8,78,38,40,76
Stirling,3755,3,16,7,13,61,52,9,55
Stenhousem'r,3755,4,15,9,12,56,47,9,54
Clyde,3755,5,15,9,12,54,49,5,54
Elgin,3755,6,14,6,16,54,62,-8,48
Annan Athlet,3755,7,11,11,14,47,44,3,44
Berwick,3755,8,8,10,18,30,61,-31,34
Edinburgh Ci,3755,9,7,9,20,36,61,-25,30
Cowdenbeath,3755,10,5,10,21,26,54,-28,25
Montrose,3756,1,24,7,5,61,34,27,79
Peterhead,3756,2,24,4,8,80,39,41,76
Stenhousem'r,3756,3,16,8,12,56,46,10,56
Stirling,3756,4,16,6,14,60,52,8,54
Clyde,3756,5,15,9,12,53,48,5,54
Elgin,3756,6,14,6,16,53,62,-9,48
Annan Athlet,3756,7,11,11,14,47,42,5,44
Berwick,3756,8,8,10,18,29,60,-31,34
Edinburgh Ci,3756,9,7,9,20,37,63,-26,30
Cowdenbeath,3756,10,5,10,21,24,54,-30,25
Peterhead,3757,1,24,4,8,79,39,40,76
Montrose,3757,2,23,7,6,59,35,24,76
Stirling,3757,3,16,7,13,62,53,9,55
Stenhousem'r,3757,4,15,9,12,57,48,9,54
Clyde,3757,5,14,9,13,52,51,1,51
Elgin,3757,6,15,6,15,54,60,-6,51
Annan Athlet,3757,7,11,12,13,47,41,6,45
Berwick,3757,8,9,10,17,32,59,-27,37
Edinburgh Ci,3757,9,7,9,20,37,62,-25,30
Cowdenbeath,3757,10,4,11,21,23,54,-31,23
Montrose,3758,1,24,7,5,61,35,26,79
Peterhead,3758,2,23,4,9,78,40,38,73
Stirling,3758,3,17,6,13,61,51,10,57
Clyde,3758,4,15,9,12,56,48,8,54
Stenhousem'r,3758,5,15,8,13,55,47,8,53
Elgin,3758,6,14,6,16,54,62,-8,48
Annan Athlet,3758,7,11,11,14,47,45,2,44
Berwick,3758,8,8,10,18,29,63,-34,34
Edinburgh Ci,3758,9,8,9,19,38,61,-23,33
Cowdenbeath,3758,10,5,10,21,27,54,-27,25
Peterhead,3759,1,24,4,8,79,39,40,76
Montrose,3759,2,23,7,6,60,36,24,76
Stirling,3759,3,16,7,13,62,53,9,55
Stenhousem'r,3759,4,15,9,12,57,48,9,54
Clyde,3759,5,15,9,12,52,48,4,54
Elgin,3759,6,15,6,15,55,61,-6,51
Annan Athlet,3759,7,11,11,14,47,43,4,44
Berwick,3759,8,8,10,18,29,59,-30,34
Edinburgh Ci,3759,9,7,9,20,37,62,-25,30
Cowdenbeath,3759,10,5,10,21,25,54,-29,25
Montrose,3760,1,23,8,5,60,35,25,77
Peterhead,3760,2,24,4,8,81,38,43,76
Stirling,3760,3,17,6,13,61,51,10,57
Clyde,3760,4,15,9,12,54,50,4,54
Stenhousem'r,3760,5,15,8,13,55,47,8,53
Elgin,3760,6,14,7,15,54,61,-7,49
Annan Athlet,3760,7,11,11,14,47,43,4,44
Berwick,3760,8,8,10,18,31,61,-30,34
Edinburgh Ci,3760,9,7,9,20,36,64,-28,30
Cowdenbeath,3760,10,5,10,21,25,54,-29,25
Montrose,3761,1,24,7,5,64,34,30,79
Peterhead,3761,2,24,4,8,80,40,40,76
Stirling,3761,3,16,7,13,61,52,9,55
Stenhousem'r,3761,4,15,9,12,56,47,9,54
Clyde,3761,5,15,9,12,54,48,6,54
Elgin,3761,6,14,6,16,53,65,-12,48
Annan Athlet,3761,7,11,12,13,48,42,6,45
Berwick,3761,8,8,10,18,29,61,-32,34
Edinburgh Ci,3761,9,7,9,20,38,63,-25,30
Cowdenbeath,3761,10,4,11,21,24,55,-31,23
Montrose,3762,1,24,7,5,61,35,26,79
Peterhead,3762,2,23,5,8,78,39,39,74
Stirling,3762,3,16,7,13,62,53,9,55
Stenhousem'r,3762,4,15,9,12,57,48,9,54
Clyde,3762,5,15,9,12,53,48,5,54
Elgin,3762,6,14,6,16,54,62,-8,48
Annan Athlet,3762,7,11,11,14,47,43,4,44
Berwick,3762,8,8,10,18,29,60,-31,34
Edinburgh Ci,3762,9,7,10,19,37,61,-24,31
Cowdenbeath,3762,10,5,10,21,25,54,-29,25
Montrose,3763,1,24,7,5,63,34,29,79
Peterhead,3763,2,24,4,8,81,38,43,76
Stirling,3763,3,17,6,13,63,53,10,57
Clyde,3763,4,15,9,12,54,50,4,54
Stenhousem'r,3763,5,15,8,13,57,49,8,53
Elgin,3763,6,14,6,16,53,64,-11,48
Annan Athlet,3763,7,11,12,13,49,43,6,45
Berwick,3763,8,8,10,18,31,61,-30,34
Edinburgh Ci,3763,9,7,9,20,36,64,-28,30
Cowdenbeath,3763,10,4,11,21,25,56,-31,23
Montrose,3764,1,24,7,5,60,34,26,79
Peterhead,3764,2,24,4,8,80,38,42,76
Stenhousem'r,3764,3,16,8,12,56,46,10,56
Stirling,3764,4,16,6,14,60,52,8,54
Clyde,3764,5,15,9,12,54,49,5,54
Elgin,3764,6,14,6,16,53,61,-8,48
Annan Athlet,3764,7,11,12,13,49,43,6,45
Berwick,3764,8,8,10,18,30,61,-31,34
Edinburgh Ci,3764,9,7,9,20,36,63,-27,30
Cowdenbeath,3764,10,4,11,21,25,56,-31,23
Montrose,3765,1,24,7,5,62,35,27,79
Peterhead,3765,2,24,4,8,81,40,41,76
Stirling,3765,3,17,6,13,64,53,11,57
Clyde,3765,4,15,9,12,52,48,4,54
Stenhousem'r,3765,5,15,8,13,57,50,7,53
Elgin,3765,6,14,6,16,54,63,-9,48
Annan Athlet,3765,7,11,11,14,47,42,5,44
Berwick,3765,8,8,10,18,29,59,-30,34
Edinburgh Ci,3765,9,7,9,20,38,64,-26,30
Cowdenbeath,3765,10,5,10,21,24,54,-30,25
Montrose,3766,1,24,7,5,62,35,27,79
Peterhead,3766,2,24,4,8,79,38,41,76
Stirling,3766,3,17,6,13,62,51,11,57
Clyde,3766,4,15,9,12,56,48,8,54
Stenhousem'r,3766,5,15,8,13,55,48,7,53
Elgin,3766,6,14,6,16,54,63,-9,48
Annan Athlet,3766,7,11,12,13,47,41,6,45
Berwick,3766,8,8,10,18,29,63,-34,34
Edinburgh Ci,3766,9,7,9,20,36,62,-26,30
Cowdenbeath,3766,10,4,11,21,23,54,-31,23
Montrose,3767,1,24,7,5,60,34,26,79
Peterhead,3767,2,24,4,8,84,41,43,76
Stirling,3767,3,17,6,13,61,51,10,57
Stenhousem'r,3767,4,15,8,13,55,47,8,53
Clyde,3767,5,14,10,12,52,49,3,52
Elgin,3767,6,14,6,16,53,61,-8,48
Annan Athlet,3767,7,11,12,13,48,42,6,45
Berwick,3767,8,8,11,17,30,59,-29,35
Edinburgh Ci,3767,9,7,9,20,39,67,-28,30
Cowdenbeath,3767,10,4,11,21,24,55,-31,23
Montrose,3768,1,23,7,6,60,36,24,76
Peterhead,3768,2,23,4,9,78,40,38,73
Stirling,3768,3,17,6,13,63,53,10,57
Stenhousem'r,3768,4,15,8,13,57,49,8,53
Clyde,3768,5,14,10,12,51,48,3,52
Elgin,3768,6,15,6,15,55,61,-6,51
Annan Athlet,3768,7,11,11,14,48,45,3,44
Berwick,3768,8,8,11,17,29,58,-29,35
Edinburgh Ci,3768,9,8,9,19,38,61,-23,33
Cowdenbeath,3768,10,5,10,21,27,55,-28,25
Montrose,3769,1,24,7,5,61,34,27,79
Peterhead,3769,2,23,4,9,77,40,37,73
Stirling,3769,3,16,7,13,60,51,9,55
Stenhousem'r,3769,4,15,9,12,55,46,9,54
Clyde,3769,5,15,9,12,53,49,4,54
Elgin,3769,6,14,6,16,53,62,-9,48
Annan Athlet,3769,7,11,12,13,47,41,6,45
Berwick,3769,8,8,10,18,30,60,-30,34
Edinburgh Ci,3769,9,8,9,19,38,60,-22,33
Cowdenbeath,3769,10,4,11,21,23,54,-31,23
Montrose,3770,1,24,7,5,62,35,27,79
Peterhead,3770,2,23,4,9,78,40,38,73
Stirling,3770,3,17,6,13,61,51,10,57
Clyde,3770,4,15,9,12,55,49,6,54
Stenhousem'r,3770,5,15,8,13,55,47,8,53
Elgin,3770,6,14,6,16,54,63,-9,48
Annan Athlet,3770,7,11,11,14,47,42,5,44
Berwick,3770,8,8,10,18,30,62,-32,34
Edinburgh Ci,3770,9,8,9,19,38,61,-23,33
Cowdenbeath,3770,10,5,10,21,24,54,-30,25
Montrose,3771,1,24,7,5,62,34,28,79
Peterhead,3771,2,24,4,8,78,38,40,76
Stenhousem'r,3771,3,16,8,12,59,48,11,56
Stirling,3771,4,16,6,14,62,55,7,54
Clyde,3771,5,15,9,12,55,49,6,54
Elgin,3771,6,14,6,16,53,63,-10,48
Annan Athlet,3771,7,12,11,13,48,41,7,47
Berwick,3771,8,8,10,18,30,62,-32,34
Edinburgh Ci,3771,9,7,9,20,36,61,-25,30
Cowdenbeath,3771,10,4,10,22,23,55,-32,22
Montrose,3772,1,24,7,5,62,36,26,79
Peterhead,3772,2,24,4,8,81,39,42,76
Stenhousem'r,3772,3,16,8,12,57,46,11,56
Stirling,3772,4,16,6,14,60,53,7,54
Clyde,3772,5,15,9,12,53,49,4,54
Elgin,3772,6,14,6,16,55,63,-8,48
Annan Athlet,3772,7,12,11,13,50,43,7,47
Berwick,3772,8,8,10,18,30,60,-30,34
Edinburgh Ci,3772,9,7,9,20,37,64,-27,30
Cowdenbeath,3772,10,4,10,22,25,57,-32,22
Montrose,3773,1,23,7,6,60,37,23,76
Peterhead,3773,2,23,5,8,77,38,39,74
Stirling,3773,3,17,6,13,64,53,11,57
Stenhousem'r,3773,4,15,8,13,57,50,7,53
Clyde,3773,5,14,9,13,51,49,2,51
Elgin,3773,6,15,6,15,56,61,-5,51
Annan Athlet,3773,7,12,11,13,48,41,7,47
Berwick,3773,8,9,10,17,30,58,-28,37
Edinburgh Ci,3773,9,7,10,19,36,60,-24,31
Cowdenbeath,3773,10,4,10,22,23,55,-32,22
Montrose,3774,1,23,8,5,61,36,25,77
Peterhead,3774,2,24,4,8,79,38,41,76
Stirling,3774,3,17,6,13,63,52,11,57
Stenhousem'r,3774,4,15,8,13,56,49,7,53
Clyde,3774,5,14,10,12,51,48,3,52
Elgin,3774,6,14,7,15,55,62,-7,49
Annan Athlet,3774,7,11,11,14,47,43,4,44
Berwick,3774,8,8,11,17,29,58,-29,35
Edinburgh Ci,3774,9,7,9,20,36,62,-26,30
Cowdenbeath,3774,10,5,10,21,25,54,-29,25
Montrose,3775,1,24,7,5,61,35,26,79
Peterhead,3775,2,24,4,8,80,39,41,76
Stirling,3775,3,16,7,13,61,52,9,55
Stenhousem'r,3775,4,15,9,12,56,47,9,54
Clyde,3775,5,14,10,12,51,48,3,52
Elgin,3775,6,14,6,16,54,62,-8,48
Annan Athlet,3775,7,11,12,13,48,42,6,45
Berwick,3775,8,8,11,17,29,58,-29,35
Edinburgh Ci,3775,9,7,9,20,37,63,-26,30
Cowdenbeath,3775,10,4,11,21,24,55,-31,23
Montrose,3776,1,23,8,5,60,35,25,77
Peterhead,3776,2,24,4,8,79,38,41,76
Stirling,3776,3,16,7,13,61,52,9,55
Stenhousem'r,3776,4,15,9,12,56,47,9,54
Clyde,3776,5,14,10,12,54,51,3,52
Elgin,3776,6,14,7,15,54,61,-7,49
Annan Athlet,3776,7,11,12,13,49,43,6,45
Berwick,3776,8,8,11,17,32,61,-29,35
Edinburgh Ci,3776,9,7,9,20,36,62,-26,30
Cowdenbeath,3776,10,4,11,21,25,56,-31,23
Montrose,3777,1,24,7,5,61,34,27,79
Peterhead,3777,2,24,4,8,79,39,40,76
Stirling,3777,3,17,6,13,64,52,12,57
Clyde,3777,4,15,9,12,56,48,8,54
Stenhousem'r,3777,5,15,8,13,56,50,6,53
Elgin,3777,6,14,6,16,53,62,-9,48
Annan Athlet,3777,7,11,11,14,47,43,4,44
Berwick,3777,8,8,10,18,29,63,-34,34
Edinburgh Ci,3777,9,7,9,20,37,62,-25,30
Cowdenbeath,3777,10,5,10,21,25,54,-29,25
Peterhead,3778,1,24,4,8,80,38,42,76
Montrose,3778,2,23,7,6,61,37,24,76
Stenhousem'r,3778,3,16,8,12,56,46,10,56
Stirling,3778,4,16,6,14,60,52,8,54
Clyde,3778,5,15,9,12,54,49,5,54
Elgin,3778,6,15,6,15,56,62,-6,51
Annan Athlet,3778,7,12,11,13,49,41,8,47
Berwick,3778,8,8,10,18,30,61,-31,34
Edinburgh Ci,3778,9,7,9,20,36,63,-27,30
Cowdenbeath,3778,10,4,10,22,23,56,-33,22
Peterhead,3779,1,24,4,8,80,40,40,76
Montrose,3779,2,23,7,6,61,37,24,76
Stirling,3779,3,17,6,13,61,51,10,57
Stenhousem'r,3779,4,15,8,13,55,47,8,53
Clyde,3779,5,14,10,12,52,49,3,52
Elgin,3779,6,15,6,15,56,62,-6,51
Annan Athlet,3779,7,11,12,13,47,41,6,45
Berwick,3779,8,8,11,17,30,59,-29,35
Edinburgh Ci,3779,9,7,9,20,38,63,-25,30
Cowdenbeath,3779,10,4,11,21,23,54,-31,23
Montrose,3780,1,23,8,5,60,35,25,77
Peterhead,3780,2,24,4,8,79,39,40,76
Stirling,3780,3,16,7,13,61,52,9,55
Stenhousem'r,3780,4,15,9,12,56,47,9,54
Clyde,3780,5,15,9,12,53,48,5,54
Elgin,3780,6,14,7,15,54,61,-7,49
Annan Athlet,3780,7,11,12,13,47,41,6,45
Berwick,3780,8,8,10,18,29,60,-31,34
Edinburgh Ci,3780,9,7,9,20,37,62,-25,30
Cowdenbeath,3780,10,4,11,21,23,54,-31,23
Montrose,3781,1,24,7,5,61,35,26,79
Peterhead,3781,2,24,4,8,79,38,41,76
Stenhousem'r,3781,3,16,8,12,58,47,11,56
Stirling,3781,4,16,6,14,61,54,7,54
Clyde,3781,5,14,10,12,51,48,3,52
Elgin,3781,6,14,6,16,54,62,-8,48
Annan Athlet,3781,7,11,11,14,47,43,4,44
Berwick,3781,8,8,11,17,29,58,-29,35
Edinburgh Ci,3781,9,7,9,20,36,62,-26,30
Cowdenbeath,3781,10,5,10,21,25,54,-29,25
Montrose,3782,1,24,7,5,62,34,28,79
Peterhead,3782,2,24,4,8,81,39,42,76
Stenhousem'r,3782,3,16,8,12,57,46,11,56
Stirling,3782,4,16,6,14,60,53,7,54
Clyde,3782,5,15,9,12,53,48,5,54
Elgin,3782,6,14,6,16,53,63,-10,48
Annan Athlet,3782,7,11,12,13,48,42,6,45
Berwick,3782,8,8,10,18,29,60,-31,34
Edinburgh Ci,3782,9,7,9,20,37,64,-27,30
Cowdenbeath,3782,10,4,11,21,24,55,-31,23
Montrose,3783,1,24,7,5,60,34,26,79
Peterhead,3783,2,23,4,9,77,40,37,73
Stirling,3783,3,17,6,13,62,51,11,57
Clyde,3783,4,15,9,12,55,49,6,54
Stenhousem'r,3783,5,15,8,13,55,48,7,53
Elgin,3783,6,14,6,16,53,61,-8,48
Annan Athlet,3783,7,11,12,13,49,43,6,45
Berwick,3783,8,8,10,18,30,62,-32,34
Edinburgh Ci,3783,9,8,9,19,38,60,-22,33
Cowdenbeath,3783,10,4,11,21,25,56,-31,23
Montrose,3784,1,24,7,5,62,35,27,79
Peterhead,3784,2,24,4,8,80,38,42,76
Stenhousem'r,3784,3,16,8,12,57,46,11,56
Stirling,3784,4,16,6,14,60,53,7,54
Clyde,3784,5,15,9,12,53,49,4,54
Elgin,3784,6,14,6,16,54,63,-9,48
Annan Athlet,3784,7,12,11,13,48,41,7,47
Berwick,3784,8,8,10,18,30,60,-30,34
Edinburgh Ci,3784,9,7,9,20,36,63,-27,30
Cowdenbeath,3784,10,4,10,22,23,55,-32,22
Montrose,3785,1,24,7,5,63,35,28,79
Peterhead,3785,2,24,4,8,78,38,40,76
Stirling,3785,3,17,6,13,63,51,12,57
Stenhousem'r,3785,4,15,8,13,55,49,6,53
Clyde,3785,5,14,9,13,52,50,2,51
Elgin,3785,6,14,6,16,54,64,-10,48
Annan Athlet,3785,7,11,11,14,47,42,5,44
Berwick,3785,8,9,10,17,31,59,-28,37
Edinburgh Ci,3785,9,7,9,20,36,61,-25,30
Cowdenbeath,3785,10,5,10,21,24,54,-30,25
Montrose,3786,1,24,7,5,62,34,28,79
Peterhead,3786,2,24,4,8,78,38,40,76
Stirling,3786,3,17,6,13,62,52,10,57
Stenhousem'r,3786,4,15,8,13,56,48,8,53
Clyde,3786,5,14,10,12,51,48,3,52
Elgin,3786,6,14,6,16,53,63,-10,48
Annan Athlet,3786,7,11,11,14,47,42,5,44
Berwick,3786,8,8,11,17,29,58,-29,35
Edinburgh Ci,3786,9,7,9,20,36,61,-25,30
Cowdenbeath,3786,10,5,10,21,24,54,-30,25
Montrose,3787,1,23,7,6,59,36,23,76
Peterhead,3787,2,23,5,8,78,39,39,74
Stirling,3787,3,16,7,13,61,52,9,55
Stenhousem'r,3787,4,15,9,12,56,47,9,54
Clyde,3787,5,14,9,13,53,51,2,51
Elgin,3787,6,15,6,15,55,60,-5,51
Annan Athlet,3787,7,12,11,13,49,42,7,47
Berwick,3787,8,9,10,17,32,60,-28,37
Edinburgh Ci,3787,9,7,10,19,37,61,-24,31
Cowdenbeath,3787,10,4,10,22,24,56,-32,22
Montrose,3788,1,23,8,5,64,39,25,77
Peterhead,3788,2,24,4,8,82,38,44,76
Stirling,3788,3,17,6,13,63,51,12,57
Stenhousem'r,3788,4,15,8,13,55,49,6,53
Clyde,3788,5,14,10,12,54,51,3,52
Elgin,3788,6,14,7,15,58,65,-7,49
Annan Athlet,3788,7,11,11,14,47,43,4,44
Berwick,3788,8,8,11,17,32,61,-29,35
Edinburgh Ci,3788,9,7,9,20,36,65,-29,30
Cowdenbeath,3788,10,5,10,21,25,54,-29,25
Montrose,3789,1,23,8,5,60,35,25,77
Peterhead,3789,2,24,4,8,80,38,42,76
Stirling,3789,3,17,6,13,63,51,12,57
Stenhousem'r,3789,4,15,8,13,55,49,6,53
Clyde,3789,5,14,10,12,52,49,3,52
Elgin,3789,6,14,7,15,54,61,-7,49
Annan Athlet,3789,7,11,12,13,48,42,6,45
Berwick,3789,8,8,11,17,30,59,-29,35
Edinburgh Ci,3789,9,7,9,20,36,63,-27,30
Cowdenbeath,3789,10,4,11,21,24,55,-31,23
Peterhead,3790,1,24,4,8,82,39,43,76
Montrose,3790,2,23,7,6,60,36,24,76
Stirling,3790,3,17,6,13,62,51,11,57
Stenhousem'r,3790,4,15,8,13,55,48,7,53
Clyde,3790,5,14,10,12,51,48,3,52
Elgin,3790,6,15,6,15,55,61,-6,51
Annan Athlet,3790,7,11,11,14,47,43,4,44
Berwick,3790,8,8,11,17,29,58,-29,35
Edinburgh Ci,3790,9,7,9,20,37,65,-28,30
Cowdenbeath,3790,10,5,10,21,25,54,-29,25
Montrose,3791,1,24,7,5,61,35,26,79
Peterhead,3791,2,24,4,8,82,39,43,76
Stirling,3791,3,17,6,13,65,51,14,57
Stenhousem'r,3791,4,15,8,13,55,51,4,53
Clyde,3791,5,14,10,12,52,49,3,52
Elgin,3791,6,14,6,16,54,62,-8,48
Annan Athlet,3791,7,11,12,13,50,44,6,45
Berwick,3791,8,8,11,17,30,59,-29,35
Edinburgh Ci,3791,9,7,9,20,37,65,-28,30
Cowdenbeath,3791,10,4,11,21,26,57,-31,23
Montrose,3792,1,24,7,5,63,34,29,79
Peterhead,3792,2,24,4,8,79,38,41,76
Stirling,3792,3,17,6,13,63,53,10,57
Stenhousem'r,3792,4,15,8,13,57,49,8,53
Clyde,3792,5,14,10,12,52,49,3,52
Elgin,3792,6,14,6,16,53,64,-11,48
Annan Athlet,3792,7,11,12,13,48,42,6,45
Berwick,3792,8,8,11,17,30,59,-29,35
Edinburgh Ci,3792,9,7,9,20,36,62,-26,30
Cowdenbeath,3792,10,4,11,21,24,55,-31,23
Montrose,3793,1,23,8,5,62,37,25,77
Peterhead,3793,2,24,4,8,80,39,41,76
Stirling,3793,3,16,7,13,60,51,9,55
Stenhousem'r,3793,4,15,9,12,55,46,9,54
Clyde,3793,5,14,10,12,52,49,3,52
Elgin,3793,6,14,7,15,56,63,-7,49
Annan Athlet,3793,7,11,12,13,49,43,6,45
Berwick,3793,8,8,11,17,30,59,-29,35
Edinburgh Ci,3793,9,7,9,20,37,63,-26,30
Cowdenbeath,3793,10,4,11,21,25,56,-31,23
Montrose,3794,1,23,8,5,61,36,25,77
Peterhead,3794,2,24,4,8,79,39,40,76
Stenhousem'r,3794,3,16,8,12,58,48,10,56
Stirling,3794,4,16,6,14,62,54,8,54
Clyde,3794,5,14,9,13,52,50,2,51
Elgin,3794,6,14,7,15,55,62,-7,49
Annan Athlet,3794,7,11,11,14,47,43,4,44
Berwick,3794,8,9,10,17,31,59,-28,37
Edinburgh Ci,3794,9,7,9,20,37,62,-25,30
Cowdenbeath,3794,10,5,10,21,25,54,-29,25
Montrose,3795,1,24,7,5,62,35,27,79
Peterhead,3795,2,24,4,8,80,38,42,76
Stirling,3795,3,17,6,13,64,52,12,57
Stenhousem'r,3795,4,15,8,13,56,50,6,53
Clyde,3795,5,14,9,13,52,50,2,51
Elgin,3795,6,14,6,16,54,63,-9,48
Annan Athlet,3795,7,11,11,14,47,42,5,44
Berwick,3795,8,9,10,17,31,59,-28,37
Edinburgh Ci,3795,9,7,9,20,36,63,-27,30
Cowdenbeath,3795,10,5,10,21,24,54,-30,25
Montrose,3796,1,24,7,5,61,35,26,79
Peterhead,3796,2,24,4,8,81,38,43,76
Stirling,3796,3,17,6,13,63,52,11,57
Stenhousem'r,3796,4,15,8,13,56,49,7,53
Clyde,3796,5,14,9,13,51,50,1,51
Elgin,3796,6,14,6,16,54,62,-8,48
Annan Athlet,3796,7,12,11,13,48,41,7,47
Berwick,3796,8,9,10,17,31,58,-27,37
Edinburgh Ci,3796,9,7,9,20,36,64,-28,30
Cowdenbeath,3796,10,4,10,22,23,55,-32,22
Montrose,3797,1,24,7,5,63,35,28,79
Peterhead,3797,2,24,4,8,79,38,41,76
Stirling,3797,3,16,7,13,60,51,9,55
Stenhousem'r,3797,4,15,9,12,55,46,9,54
Clyde,3797,5,14,10,12,53,50,3,52
Elgin,3797,6,14,6,16,54,64,-10,48
Annan Athlet,3797,7,12,11,13,50,42,8,47
Berwick,3797,8,8,11,17,31,60,-29,35
Edinburgh Ci,3797,9,7,9,20,36,62,-26,30
Cowdenbeath,3797,10,4,10,22,24,57,-33,22
Montrose,3798,1,24,7,5,62,34,28,79
Peterhead,3798,2,24,4,8,82,39,43,76
Stirling,3798,3,17,6,13,63,52,11,57
Clyde,3798,4,15,9,12,54,50,4,54
Stenhousem'r,3798,5,15,8,13,56,49,7,53
Elgin,3798,6,14,6,16,53,63,-10,48
Annan Athlet,3798,7,11,12,13,48,42,6,45
Berwick,3798,8,8,10,18,31,61,-30,34
Edinburgh Ci,3798,9,7,9,20,37,65,-28,30
Cowdenbeath,3798,10,4,11,21,24,55,-31,23
Montrose,3799,1,24,7,5,63,35,28,79
Peterhead,3799,2,24,4,8,80,38,42,76
Stirling,3799,3,16,7,13,61,52,9,55
Stenhousem'r,3799,4,15,9,12,56,47,9,54
Clyde,3799,5,15,9,12,53,48,5,54
Elgin,3799,6,14,6,16,54,64,-10,48
Annan Athlet,3799,7,12,11,13,48,41,7,47
Berwick,3799,8,8,10,18,29,60,-31,34
Edinburgh Ci,3799,9,7,9,20,36,63,-27,30
Cowdenbeath,3799,10,4,10,22,23,55,-32,22
Montrose,3800,1,23,7,6,59,38,21,76
Peterhead,3800,2,23,4,9,78,41,37,73
Stirling,3800,3,16,7,13,60,51,9,55
Stenhousem'r,3800,4,15,9,12,55,46,9,54
Clyde,3800,5,15,9,12,54,48,6,54
Elgin,3800,6,15,6,15,57,60,-3,51
Annan Athlet,3800,7,11,12,13,48,42,6,45
Berwick,3800,8,8,10,18,29,61,-32,34
Edinburgh Ci,3800,9,8,9,19,39,61,-22,33
Cowdenbeath,3800,10,4,11,21,24,55,-31,23
Montrose,3801,1,23,8,5,61,36,25,77
Peterhead,3801,2,24,4,8,80,38,42,76
Stirling,3801,3,17,6,13,64,52,12,57
Stenhousem'r,3801,4,15,8,13,56,50,6,53
Clyde,3801,5,14,9,13,52,50,2,51
Elgin,3801,6,14,7,15,55,62,-7,49
Annan Athlet,3801,7,11,12,13,49,43,6,45
Berwick,3801,8,9,10,17,31,59,-28,37
Edinburgh Ci,3801,9,7,9,20,36,63,-27,30
Cowdenbeath,3801,10,4,11,21,25,56,-31,23
Montrose,3802,1,23,8,5,59,34,25,77
Peterhead,3802,2,24,4,8,82,39,43,76
Stirling,3802,3,17,6,13,62,52,10,57
Clyde,3802,4,15,9,12,54,49,5,54
Stenhousem'r,3802,5,15,8,13,56,48,8,53
Elgin,3802,6,14,7,15,53,60,-7,49
Annan Athlet,3802,7,11,12,13,48,42,6,45
Berwick,3802,8,8,10,18,30,61,-31,34
Edinburgh Ci,3802,9,7,9,20,37,65,-28,30
Cowdenbeath,3802,10,4,11,21,24,55,-31,23
Montrose,3803,1,24,7,5,63,36,27,79
Peterhead,3803,2,24,4,8,80,39,41,76
Stenhousem'r,3803,3,16,8,12,58,48,10,56
Stirling,3803,4,16,6,14,62,54,8,54
Clyde,3803,5,15,9,12,52,48,4,54
Elgin,3803,6,14,6,16,55,64,-9,48
Annan Athlet,3803,7,11,11,14,47,42,5,44
Berwick,3803,8,8,10,18,29,59,-30,34
Edinburgh Ci,3803,9,7,9,20,37,63,-26,30
Cowdenbeath,3803,10,5,10,21,24,54,-30,25
Montrose,3804,1,24,7,5,60,34,26,79
Peterhead,3804,2,24,4,8,80,38,42,76
Stenhousem'r,3804,3,16,8,12,58,47,11,56
Stirling,3804,4,16,6,14,61,54,7,54
Clyde,3804,5,15,9,12,53,48,5,54
Elgin,3804,6,14,6,16,53,61,-8,48
Annan Athlet,3804,7,12,11,13,48,41,7,47
Berwick,3804,8,8,10,18,29,60,-31,34
Edinburgh Ci,3804,9,7,9,20,36,63,-27,30
Cowdenbeath,3804,10,4,10,22,23,55,-32,22
Montrose,3805,1,23,7,6,60,36,24,76
Peterhead,3805,2,23,5,8,77,38,39,74
Stirling,3805,3,17,6,13,62,52,10,57
Clyde,3805,4,15,9,12,54,48,6,54
Stenhousem'r,3805,5,15,8,13,56,48,8,53
Elgin,3805,6,15,6,15,55,61,-6,51
Annan Athlet,3805,7,11,12,13,47,41,6,45
Berwick,3805,8,8,10,18,29,61,-32,34
Edinburgh Ci,3805,9,7,10,19,36,60,-24,31
Cowdenbeath,3805,10,4,11,21,23,54,-31,23
Montrose,3806,1,23,8,5,60,35,25,77
Peterhead,3806,2,24,4,8,80,38,42,76
Stirling,3806,3,17,6,13,61,51,10,57
Clyde,3806,4,15,9,12,54,49,5,54
Stenhousem'r,3806,5,15,8,13,55,47,8,53
Elgin,3806,6,14,7,15,54,61,-7,49
Annan Athlet,3806,7,12,11,13,49,41,8,47
Berwick,3806,8,8,10,18,30,61,-31,34
Edinburgh Ci,3806,9,7,9,20,36,63,-27,30
Cowdenbeath,3806,10,4,10,22,23,56,-33,22
Montrose,3807,1,23,8,5,60,35,25,77
Peterhead,3807,2,23,4,9,79,43,36,73
Stirling,3807,3,17,6,13,62,51,11,57
Stenhousem'r,3807,4,15,8,13,55,48,7,53
Clyde,3807,5,14,9,13,52,51,1,51
Elgin,3807,6,14,7,15,54,61,-7,49
Annan Athlet,3807,7,12,11,13,49,41,8,47
Berwick,3807,8,9,10,17,32,59,-27,37
Edinburgh Ci,3807,9,8,9,19,41,62,-21,33
Cowdenbeath,3807,10,4,10,22,23,56,-33,22
Peterhead,3808,1,24,4,8,79,38,41,76
Montrose,3808,2,23,7,6,59,35,24,76
Stirling,3808,3,17,6,13,63,51,12,57
Clyde,3808,4,15,9,12,54,49,5,54
Stenhousem'r,3808,5,15,8,13,55,49,6,53
Elgin,3808,6,15,6,15,54,60,-6,51
Annan Athlet,3808,7,12,11,13,49,41,8,47
Berwick,3808,8,8,10,18,30,61,-31,34
Edinburgh Ci,3808,9,7,9,20,36,62,-26,30
Cowdenbeath,3808,10,4,10,22,23,56,-33,22
Montrose,3809,1,23,8,5,63,38,25,77
Peterhead,3809,2,23,5,8,78,39,39,74
Stirling,3809,3,17,6,13,62,51,11,57
Clyde,3809,4,15,9,12,56,51,5,54
Stenhousem'r,3809,5,15,8,13,55,48,7,53
Elgin,3809,6,14,7,15,57,64,-7,49
Annan Athlet,3809,7,11,12,13,48,42,6,45
Berwick,3809,8,8,10,18,32,63,-31,34
Edinburgh Ci,3809,9,7,10,19,37,61,-24,31
Cowdenbeath,3809,10,4,11,21,24,55,-31,23
Montrose,3810,1,24,7,5,61,35,26,79
Peterhead,3810,2,24,4,8,78,38,40,76
Stirling,3810,3,17,6,13,61,51,10,57
Stenhousem'r,3810,4,15,8,13,55,47,8,53
Clyde,3810,5,14,9,13,51,49,2,51
Elgin,3810,6,14,6,16,54,62,-8,48
Annan Athlet,3810,7,11,12,13,47,41,6,45
Berwick,3810,8,9,10,17,30,58,-28,37
Edinburgh Ci,3810,9,7,9,20,36,61,-25,30
Cowdenbeath,3810,10,4,11,21,23,54,-31,23
Montrose,3811,1,23,8,5,60,35,25,77
Peterhead,3811,2,24,4,8,83,40,43,76
Stirling,3811,3,17,6,13,63,53,10,57
Clyde,3811,4,15,9,12,53,49,4,54
Stenhousem'r,3811,5,15,8,13,57,49,8,53
Elgin,3811,6,14,7,15,54,61,-7,49
Annan Athlet,3811,7,12,11,13,51,42,9,47
Berwick,3811,8,8,10,18,30,60,-30,34
Edinburgh Ci,3811,9,7,9,20,38,66,-28,30
Cowdenbeath,3811,10,4,10,22,24,58,-34,22
Montrose,3812,1,24,7,5,63,36,27,79
Peterhead,3812,2,24,4,8,79,39,40,76
Stirling,3812,3,17,6,13,62,52,10,57
Clyde,3812,4,15,9,12,55,48,7,54
Stenhousem'r,3812,5,15,8,13,56,48,8,53
Elgin,3812,6,14,6,16,55,64,-9,48
Annan Athlet,3812,7,11,12,13,47,41,6,45
Berwick,3812,8,8,10,18,29,62,-33,34
Edinburgh Ci,3812,9,7,9,20,37,62,-25,30
Cowdenbeath,3812,10,4,11,21,23,54,-31,23
Peterhead,3813,1,24,4,8,78,38,40,76
Montrose,3813,2,23,7,6,60,36,24,76
Stenhousem'r,3813,3,16,8,12,57,47,10,56
Stirling,3813,4,16,6,14,61,53,8,54
Clyde,3813,5,15,9,12,56,49,7,54
Elgin,3813,6,15,6,15,55,61,-6,51
Annan Athlet,3813,7,11,11,14,47,42,5,44
Berwick,3813,8,8,10,18,30,63,-33,34
Edinburgh Ci,3813,9,7,9,20,36,61,-25,30
Cowdenbeath,3813,10,5,10,21,24,54,-30,25
Montrose,3814,1,23,8,5,59,34,25,77
Peterhead,3814,2,24,4,8,80,38,42,76
Stirling,3814,3,16,7,13,60,51,9,55
Stenhousem'r,3814,4,15,9,12,55,46,9,54
Clyde,3814,5,15,9,12,54,49,5,54
Elgin,3814,6,14,7,15,53,60,-7,49
Annan Athlet,3814,7,12,11,13,49,41,8,47
Berwick,3814,8,8,10,18,30,61,-31,34
Edinburgh Ci,3814,9,7,9,20,36,63,-27,30
Cowdenbeath,3814,10,4,10,22,23,56,-33,22
Montrose,3815,1,24,7,5,61,35,26,79
Peterhead,3815,2,24,4,8,78,38,40,76
Stirling,3815,3,17,6,13,63,52,11,57
Clyde,3815,4,15,9,12,53,48,5,54
Stenhousem'r,3815,5,15,8,13,56,49,7,53
Elgin,3815,6,14,6,16,54,62,-8,48
Annan Athlet,3815,7,11,12,13,48,42,6,45
Berwick,3815,8,8,10,18,29,60,-31,34
Edinburgh Ci,3815,9,7,9,20,36,61,-25,30
Cowdenbeath,3815,10,4,11,21,24,55,-31,23
Montrose,3816,1,23,8,5,61,36,25,77
Peterhead,3816,2,24,4,8,79,38,41,76
Stirling,3816,3,17,6,13,62,52,10,57
Stenhousem'r,3816,4,15,8,13,56,48,8,53
Clyde,3816,5,14,9,13,51,49,2,51
Elgin,3816,6,14,7,15,55,62,-7,49
Annan Athlet,3816,7,11,11,14,47,42,5,44
Berwick,3816,8,9,10,17,30,58,-28,37
Edinburgh Ci,3816,9,7,9,20,36,62,-26,30
Cowdenbeath,3816,10,5,10,21,24,54,-30,25
Montrose,3817,1,23,8,5,60,35,25,77
Peterhead,3817,2,23,4,9,78,40,38,73
Stirling,3817,3,17,6,13,63,52,11,57
Clyde,3817,4,15,9,12,52,48,4,54
Stenhousem'r,3817,5,15,8,13,56,49,7,53
Elgin,3817,6,14,7,15,54,61,-7,49
Annan Athlet,3817,7,11,11,14,50,45,5,44
Berwick,3817,8,8,10,18,29,59,-30,34
Edinburgh Ci,3817,9,8,9,19,38,61,-23,33
Cowdenbeath,3817,10,5,10,21,27,57,-30,25
Montrose,3818,1,24,7,5,62,34,28,79
Peterhead,3818,2,24,4,8,80,39,41,76
Stirling,3818,3,16,7,13,62,53,9,55
Stenhousem'r,3818,4,15,9,12,57,48,9,54
Clyde,3818,5,15,9,12,56,48,8,54
Elgin,3818,6,14,6,16,53,63,-10,48
Annan Athlet,3818,7,11,11,14,48,44,4,44
Berwick,3818,8,8,10,18,29,63,-34,34
Edinburgh Ci,3818,9,7,9,20,37,63,-26,30
Cowdenbeath,3818,10,5,10,21,26,55,-29,25
Montrose,3819,1,23,8,5,60,35,25,77
Peterhead,3819,2,24,4,8,81,40,41,76
Stirling,3819,3,17,6,13,64,54,10,57
Clyde,3819,4,15,9,12,53,49,4,54
Stenhousem'r,3819,5,15,8,13,58,50,8,53
Elgin,3819,6,14,7,15,54,61,-7,49
Annan Athlet,3819,7,12,11,13,49,41,8,47
Berwick,3819,8,8,10,18,30,60,-30,34
Edinburgh Ci,3819,9,7,9,20,38,64,-26,30
Cowdenbeath,3819,10,4,10,22,23,56,-33,22
Montrose,3820,1,24,7,5,60,34,26,79
Peterhead,3820,2,24,4,8,81,38,43,76
Stirling,3820,3,16,7,13,61,52,9,55
Stenhousem'r,3820,4,15,9,12,56,47,9,54
Clyde,3820,5,15,9,12,53,49,4,54
Elgin,3820,6,14,6,16,53,61,-8,48
Annan Athlet,3820,7,11,11,14,47,44,3,44
Berwick,3820,8,8,10,18,30,60,-30,34
Edinburgh Ci,3820,9,7,9,20,36,64,-28,30
Cowdenbeath,3820,10,5,10,21,26,54,-28,25
Montrose,3821,1,24,7,5,61,34,27,79
Peterhead,3821,2,24,4,8,82,39,43,76
Stirling,3821,3,16,7,13,61,52,9,55
Stenhousem'r,3821,4,15,9,12,56,47,9,54
Clyde,3821,5,15,9,12,54,49,5,54
Elgin,3821,6,14,6,16,53,62,-9,48
Annan Athlet,3821,7,11,11,14,47,42,5,44
Berwick,3821,8,8,10,18,30,61,-31,34
Edinburgh Ci,3821,9,7,9,20,37,65,-28,30
Cowdenbeath,3821,10,5,10,21,24,54,-30,25
Montrose,3822,1,24,7,5,62,34,28,79
Peterhead,3822,2,23,5,8,78,39,39,74
Stenhousem'r,3822,3,16,8,12,57,46,11,56
Stirling,3822,4,16,6,14,60,53,7,54
Clyde,3822,5,15,9,12,53,49,4,54
Elgin,3822,6,14,6,16,53,63,-10,48
Annan Athlet,3822,7,11,11,14,49,44,5,44
Berwick,3822,8,8,10,18,30,60,-30,34
Edinburgh Ci,3822,9,7,10,19,37,61,-24,31
Cowdenbeath,3822,10,5,10,21,26,56,-30,25
Montrose,3823,1,24,7,5,61,35,26,79
Peterhead,3823,2,23,4,9,78,40,38,73
Stirling,3823,3,16,7,13,60,51,9,55
Stenhousem'r,3823,4,15,9,12,55,46,9,54
Clyde,3823,5,15,9,12,52,48,4,54
Elgin,3823,6,14,6,16,54,62,-8,48
Annan Athlet,3823,7,12,11,13,51,41,10,47
Berwick,3823,8,8,10,18,29,59,-30,34
Edinburgh Ci,3823,9,8,9,19,38,61,-23,33
Cowdenbeath,3823,10,4,10,22,23,58,-35,22
Montrose,3824,1,24,7,5,61,34,27,79
Peterhead,3824,2,24,4,8,82,39,43,76
Stirling,3824,3,17,6,13,62,52,10,57
Stenhousem'r,3824,4,15,8,13,56,48,8,53
Clyde,3824,5,14,10,12,52,49,3,52
Elgin,3824,6,14,6,16,53,62,-9,48
Annan Athlet,3824,7,11,11,14,48,43,5,44
Berwick,3824,8,8,11,17,30,59,-29,35
Edinburgh Ci,3824,9,7,9,20,37,65,-28,30
Cowdenbeath,3824,10,5,10,21,25,55,-30,25
Montrose,3825,1,23,8,5,60,35,25,77
Peterhead,3825,2,24,4,8,82,39,43,76
Stirling,3825,3,17,6,13,63,51,12,57
Stenhousem'r,3825,4,15,8,13,55,49,6,53
Clyde,3825,5,14,9,13,52,50,2,51
Elgin,3825,6,14,7,15,54,61,-7,49
Annan Athlet,3825,7,11,11,14,47,42,5,44
Berwick,3825,8,9,10,17,31,59,-28,37
Edinburgh Ci,3825,9,7,9,20,37,65,-28,30
Cowdenbeath,3825,10,5,10,21,24,54,-30,25
Montrose,3826,1,24,7,5,61,34,27,79
Peterhead,3826,2,23,5,8,79,40,39,74
Stirling,3826,3,17,6,13,63,52,11,57
Clyde,3826,4,15,9,12,56,49,7,54
Stenhousem'r,3826,5,15,8,13,56,49,7,53
Elgin,3826,6,14,6,16,53,62,-9,48
Annan Athlet,3826,7,12,11,13,52,41,11,47
Berwick,3826,8,8,10,18,30,63,-33,34
Edinburgh Ci,3826,9,7,10,19,38,62,-24,31
Cowdenbeath,3826,10,4,10,22,23,59,-36,22
Montrose,3827,1,24,7,5,65,37,28,79
Peterhead,3827,2,24,4,8,80,38,42,76
Stirling,3827,3,17,6,13,63,53,10,57
Stenhousem'r,3827,4,15,8,13,57,49,8,53
Clyde,3827,5,14,10,12,52,49,3,52
Elgin,3827,6,14,6,16,56,66,-10,48
Annan Athlet,3827,7,11,11,14,49,44,5,44
Berwick,3827,8,8,11,17,30,59,-29,35
Edinburgh Ci,3827,9,7,9,20,36,63,-27,30
Cowdenbeath,3827,10,5,10,21,26,56,-30,25
Montrose,3828,1,24,7,5,62,34,28,79
Peterhead,3828,2,23,4,9,77,39,38,73
Stirling,3828,3,17,6,13,63,51,12,57
Clyde,3828,4,15,9,12,55,49,6,54
Stenhousem'r,3828,5,15,8,13,55,49,6,53
Elgin,3828,6,14,6,16,53,63,-10,48
Annan Athlet,3828,7,11,11,14,48,43,5,44
Berwick,3828,8,8,10,18,30,62,-32,34
Edinburgh Ci,3828,9,8,9,19,37,60,-23,33
Cowdenbeath,3828,10,5,10,21,25,55,-30,25
Montrose,3829,1,24,7,5,62,34,28,79
Peterhead,3829,2,23,5,8,78,39,39,74
Stirling,3829,3,17,6,13,63,52,11,57
Stenhousem'r,3829,4,15,8,13,56,49,7,53
Clyde,3829,5,14,9,13,53,51,2,51
Elgin,3829,6,14,6,16,53,63,-10,48
Annan Athlet,3829,7,11,11,14,47,43,4,44
Berwick,3829,8,9,10,17,32,60,-28,37
Edinburgh Ci,3829,9,7,10,19,37,61,-24,31
Cowdenbeath,3829,10,5,10,21,25,54,-29,25
Montrose,3830,1,24,7,5,62,34,28,79
Peterhead,3830,2,24,4,8,80,40,40,76
Stirling,3830,3,17,6,13,61,51,10,57
Clyde,3830,4,15,9,12,52,48,4,54
Stenhousem'r,3830,5,15,8,13,55,47,8,53
Elgin,3830,6,14,6,16,53,63,-10,48
Annan Athlet,3830,7,11,11,14,48,44,4,44
Berwick,3830,8,8,10,18,29,59,-30,34
Edinburgh Ci,3830,9,7,9,20,38,63,-25,30
Cowdenbeath,3830,10,5,10,21,26,55,-29,25
Montrose,3831,1,23,8,5,59,34,25,77
Peterhead,3831,2,24,4,8,79,39,40,76
Stirling,3831,3,17,6,13,61,51,10,57
Stenhousem'r,3831,4,15,8,13,55,47,8,53
Clyde,3831,5,14,9,13,53,51,2,51
Elgin,3831,6,14,7,15,53,60,-7,49
Annan Athlet,3831,7,12,11,13,49,41,8,47
Berwick,3831,8,9,10,17,32,60,-28,37
Edinburgh Ci,3831,9,7,9,20,37,62,-25,30
Cowdenbeath,3831,10,4,10,22,23,56,-33,22
Montrose,3832,1,24,7,5,62,35,27,79
Peterhead,3832,2,24,4,8,81,40,41,76
Stenhousem'r,3832,3,16,8,12,58,47,11,56
Stirling,3832,4,16,6,14,61,54,7,54
Clyde,3832,5,14,10,12,51,48,3,52
Elgin,3832,6,14,6,16,54,63,-9,48
Annan Athlet,3832,7,11,11,14,48,43,5,44
Berwick,3832,8,8,11,17,29,58,-29,35
Edinburgh Ci,3832,9,7,9,20,38,64,-26,30
Cowdenbeath,3832,10,5,10,21,25,55,-30,25
Montrose,3833,1,24,7,5,62,36,26,79
Peterhead,3833,2,24,4,8,80,38,42,76
Stirling,3833,3,17,6,13,64,51,13,57
Stenhousem'r,3833,4,15,8,13,55,50,5,53
Clyde,3833,5,14,9,13,53,51,2,51
Elgin,3833,6,14,6,16,55,63,-8,48
Annan Athlet,3833,7,11,11,14,47,42,5,44
Berwick,3833,8,9,10,17,32,60,-28,37
Edinburgh Ci,3833,9,7,9,20,36,63,-27,30
Cowdenbeath,3833,10,5,10,21,24,54,-30,25
Montrose,3834,1,24,7,5,61,35,26,79
Peterhead,3834,2,24,4,8,79,38,41,76
Stirling,3834,3,17,6,13,62,51,11,57
Clyde,3834,4,15,9,12,53,49,4,54
Stenhousem'r,3834,5,15,8,13,55,48,7,53
Elgin,3834,6,14,6,16,54,62,-8,48
Annan Athlet,3834,7,11,12,13,48,42,6,45
Berwick,3834,8,8,10,18,30,60,-30,34
Edinburgh Ci,3834,9,7,9,20,36,62,-26,30
Cowdenbeath,3834,10,4,11,21,24,55,-31,23
Montrose,3835,1,23,8,5,59,34,25,77
Peterhead,3835,2,24,4,8,83,39,44,76
Stenhousem'r,3835,3,16,8,12,57,46,11,56
Stirling,3835,4,16,6,14,60,53,7,54
Clyde,3835,5,15,9,12,52,48,4,54
Elgin,3835,6,14,7,15,53,60,-7,49
Annan Athlet,3835,7,12,11,13,48,41,7,47
Berwick,3835,8,8,10,18,29,59,-30,34
Edinburgh Ci,3835,9,7,9,20,37,66,-29,30
Cowdenbeath,3835,10,4,10,22,23,55,-32,22
Montrose,3836,1,24,7,5,61,35,26,79
Peterhead,3836,2,24,4,8,81,38,43,76
Stirling,3836,3,16,7,13,60,51,9,55
Stenhousem'r,3836,4,15,9,12,55,46,9,54
Clyde,3836,5,15,9,12,53,48,5,54
Elgin,3836,6,14,6,16,54,62,-8,48
Annan Athlet,3836,7,11,12,13,48,42,6,45
Berwick,3836,8,8,10,18,29,60,-31,34
Edinburgh Ci,3836,9,7,9,20,36,64,-28,30
Cowdenbeath,3836,10,4,11,21,24,55,-31,23
Montrose,3837,1,23,8,5,60,35,25,77
Peterhead,3837,2,23,4,9,79,41,38,73
Stirling,3837,3,16,7,13,60,51,9,55
Stenhousem'r,3837,4,15,9,12,55,46,9,54
Clyde,3837,5,15,9,12,56,48,8,54
Elgin,3837,6,14,7,15,54,61,-7,49
Annan Athlet,3837,7,11,12,13,48,42,6,45
Berwick,3837,8,8,10,18,29,63,-34,34
Edinburgh Ci,3837,9,8,9,19,39,62,-23,33
Cowdenbeath,3837,10,4,11,21,24,55,-31,23
Montrose,3838,1,23,7,6,59,37,22,76
Peterhead,3838,2,23,5,8,79,40,39,74
Stirling,3838,3,17,6,13,62,52,10,57
Stenhousem'r,3838,4,15,8,13,56,48,8,53
Clyde,3838,5,14,10,12,52,49,3,52
Elgin,3838,6,15,6,15,56,60,-4,51
Annan Athlet,3838,7,12,11,13,50,42,8,47
Berwick,3838,8,8,11,17,30,59,-29,35
Edinburgh Ci,3838,9,7,10,19,38,62,-24,31
Cowdenbeath,3838,10,4,10,22,24,57,-33,22
Montrose,3839,1,23,8,5,61,36,25,77
Peterhead,3839,2,24,4,8,80,38,42,76
Stirling,3839,3,17,6,13,66,53,13,57
Stenhousem'r,3839,4,15,8,13,57,52,5,53
Clyde,3839,5,14,10,12,51,48,3,52
Elgin,3839,6,14,7,15,55,62,-7,49
Annan Athlet,3839,7,11,12,13,47,41,6,45
Berwick,3839,8,8,11,17,29,58,-29,35
Edinburgh Ci,3839,9,7,9,20,36,63,-27,30
Cowdenbeath,3839,10,4,11,21,23,54,-31,23
Montrose,3840,1,23,8,5,60,35,25,77
Peterhead,3840,2,23,4,9,78,40,38,73
Stirling,3840,3,17,6,13,64,52,12,57
Clyde,3840,4,15,9,12,52,48,4,54
Stenhousem'r,3840,5,15,8,13,56,50,6,53
Elgin,3840,6,14,7,15,54,61,-7,49
Annan Athlet,3840,7,11,12,13,49,43,6,45
Berwick,3840,8,8,10,18,29,59,-30,34
Edinburgh Ci,3840,9,8,9,19,38,61,-23,33
Cowdenbeath,3840,10,4,11,21,25,56,-31,23
Montrose,3841,1,24,7,5,62,34,28,79
Peterhead,3841,2,24,4,8,81,40,41,76
Stirling,3841,3,17,6,13,61,51,10,57
Stenhousem'r,3841,4,15,8,13,55,47,8,53
Clyde,3841,5,14,9,13,52,51,1,51
Elgin,3841,6,14,6,16,53,63,-10,48
Annan Athlet,3841,7,12,11,13,49,42,7,47
Berwick,3841,8,9,10,17,32,59,-27,37
Edinburgh Ci,3841,9,7,9,20,38,64,-26,30
Cowdenbeath,3841,10,4,10,22,24,56,-32,22
Montrose,3842,1,24,7,5,60,34,26,79
Peterhead,3842,2,24,4,8,79,38,41,76
Stirling,3842,3,17,6,13,66,52,14,57
Clyde,3842,4,15,9,12,52,48,4,54
Stenhousem'r,3842,5,15,8,13,56,52,4,53
Elgin,3842,6,14,6,16,53,61,-8,48
Annan Athlet,3842,7,11,12,13,48,42,6,45
Berwick,3842,8,8,10,18,29,59,-30,34
Edinburgh Ci,3842,9,7,9,20,36,62,-26,30
Cowdenbeath,3842,10,4,11,21,24,55,-31,23
Montrose,3843,1,24,7,5,61,34,27,79
Peterhead,3843,2,24,4,8,79,39,40,76
Stenhousem'r,3843,3,16,8,12,56,46,10,56
Stirling,3843,4,16,6,14,60,52,8,54
Clyde,3843,5,15,9,12,55,49,6,54
Elgin,3843,6,14,6,16,53,62,-9,48
Annan Athlet,3843,7,11,12,13,48,42,6,45
Berwick,3843,8,8,10,18,30,62,-32,34
Edinburgh Ci,3843,9,7,9,20,37,62,-25,30
Cowdenbeath,3843,10,4,11,21,24,55,-31,23
Montrose,3844,1,23,8,5,62,37,25,77
Peterhead,3844,2,24,4,8,80,40,40,76
Stirling,3844,3,17,6,13,62,51,11,57
Stenhousem'r,3844,4,15,8,13,55,48,7,53
Clyde,3844,5,14,9,13,52,51,1,51
Elgin,3844,6,14,7,15,56,63,-7,49
Annan Athlet,3844,7,11,12,13,47,41,6,45
Berwick,3844,8,9,10,17,32,59,-27,37
Edinburgh Ci,3844,9,7,9,20,38,63,-25,30
Cowdenbeath,3844,10,4,11,21,23,54,-31,23
Montrose,3845,1,24,7,5,61,34,27,79
Peterhead,3845,2,24,4,8,81,38,43,76
Stenhousem'r,3845,3,16,8,12,57,47,10,56
Stirling,3845,4,16,6,14,61,53,8,54
Clyde,3845,5,14,10,12,52,49,3,52
Elgin,3845,6,14,6,16,53,62,-9,48
Annan Athlet,3845,7,12,11,13,49,42,7,47
Berwick,3845,8,8,11,17,30,59,-29,35
Edinburgh Ci,3845,9,7,9,20,36,64,-28,30
Cowdenbeath,3845,10,4,10,22,24,56,-32,22
Montrose,3846,1,23,7,6,59,36,23,76
Peterhead,3846,2,23,4,9,77,40,37,73
Stenhousem'r,3846,3,16,8,12,57,46,11,56
Stirling,3846,4,16,6,14,60,53,7,54
Clyde,3846,5,14,10,12,52,49,3,52
Elgin,3846,6,15,6,15,55,60,-5,51
Annan Athlet,3846,7,12,11,13,48,41,7,47
Berwick,3846,8,8,11,17,30,59,-29,35
Edinburgh Ci,3846,9,8,9,19,38,60,-22,33
Cowdenbeath,3846,10,4,10,22,23,55,-32,22
Montrose,3847,1,24,7,5,62,35,27,79
Peterhead,3847,2,24,4,8,80,39,41,76
Stenhousem'r,3847,3,16,8,12,57,46,11,56
Stirling,3847,4,16,6,14,60,53,7,54
Clyde,3847,5,15,9,12,53,49,4,54
Elgin,3847,6,14,6,16,54,63,-9,48
Annan Athlet,3847,7,11,12,13,47,41,6,45
Berwick,3847,8,8,10,18,30,60,-30,34
Edinburgh Ci,3847,9,7,9,20,37,63,-26,30
Cowdenbeath,3847,10,4,11,21,23,54,-31,23
Montrose,3848,1,24,7,5,62,36,26,79
Peterhead,3848,2,24,4,8,79,38,41,76
Stenhousem'r,3848,3,16,8,12,59,49,10,56
Clyde,3848,4,15,9,12,57,48,9,54
Stirling,3848,5,16,6,14,63,55,8,54
Elgin,3848,6,14,6,16,55,63,-8,48
Annan Athlet,3848,7,11,11,14,47,42,5,44
Berwick,3848,8,8,10,18,29,64,-35,34
Edinburgh Ci,3848,9,7,9,20,36,62,-26,30
Cowdenbeath,3848,10,5,10,21,24,54,-30,25
Montrose,3849,1,24,7,5,62,34,28,79
Peterhead,3849,2,24,4,8,80,38,42,76
Stenhousem'r,3849,3,16,8,12,58,46,12,56
Stirling,3849,4,16,6,14,60,54,6,54
Clyde,3849,5,14,9,13,51,49,2,51
Elgin,3849,6,14,6,16,53,63,-10,48
Annan Athlet,3849,7,11,11,14,47,42,5,44
Berwick,3849,8,9,10,17,30,58,-28,37
Edinburgh Ci,3849,9,7,9,20,36,63,-27,30
Cowdenbeath,3849,10,5,10,21,24,54,-30,25
Montrose,3850,1,24,7,5,62,34,28,79
Peterhead,3850,2,24,4,8,78,38,40,76
Stirling,3850,3,17,6,13,64,52,12,57
Clyde,3850,4,15,9,12,52,48,4,54
Stenhousem'r,3850,5,15,8,13,56,50,6,53
Elgin,3850,6,14,6,16,53,63,-10,48
Annan Athlet,3850,7,12,11,13,49,41,8,47
Berwick,3850,8,8,10,18,29,59,-30,34
Edinburgh Ci,3850,9,7,9,20,36,61,-25,30
Cowdenbeath,3850,10,4,10,22,23,56,-33,22
Montrose,3851,1,23,8,5,61,36,25,77
Peterhead,3851,2,23,5,8,78,39,39,74
Stirling,3851,3,17,6,13,61,51,10,57
Stenhousem'r,3851,4,15,8,13,55,47,8,53
Clyde,3851,5,14,10,12,51,48,3,52
Elgin,3851,6,14,7,15,55,62,-7,49
Annan Athlet,3851,7,11,12,13,48,42,6,45
Berwick,3851,8,8,11,17,29,58,-29,35
Edinburgh Ci,3851,9,7,10,19,37,61,-24,31
Cowdenbeath,3851,10,4,11,21,24,55,-31,23
Montrose,3852,1,24,7,5,61,34,27,79
Peterhead,3852,2,23,4,9,78,40,38,73
Stirling,3852,3,17,6,13,62,51,11,57
Stenhousem'r,3852,4,15,8,13,55,48,7,53
Clyde,3852,5,14,9,13,52,50,2,51
Elgin,3852,6,14,6,16,53,62,-9,48
Annan Athlet,3852,7,11,11,14,47,42,5,44
Berwick,3852,8,9,10,17,31,59,-28,37
Edinburgh Ci,3852,9,8,9,19,38,61,-23,33
Cowdenbeath,3852,10,5,10,21,24,54,-30,25
Peterhead,3853,1,24,4,8,78,38,40,76
Montrose,3853,2,23,7,6,60,38,22,76
Stirling,3853,3,16,7,13,63,54,9,55
Stenhousem'r,3853,4,15,9,12,58,49,9,54
Clyde,3853,5,14,9,13,51,49,2,51
Elgin,3853,6,15,6,15,57,61,-4,51
Annan Athlet,3853,7,12,11,13,49,42,7,47
Berwick,3853,8,9,10,17,30,58,-28,37
Edinburgh Ci,3853,9,7,9,20,36,61,-25,30
Cowdenbeath,3853,10,4,10,22,24,56,-32,22
Montrose,3854,1,24,7,5,61,34,27,79
Peterhead,3854,2,24,4,8,80,39,41,76
Stirling,3854,3,16,7,13,63,54,9,55
Stenhousem'r,3854,4,15,9,12,58,49,9,54
Clyde,3854,5,14,9,13,51,49,2,51
Elgin,3854,6,14,6,16,53,62,-9,48
Annan Athlet,3854,7,12,11,13,49,41,8,47
Berwick,3854,8,9,10,17,30,58,-28,37
Edinburgh Ci,3854,9,7,9,20,37,63,-26,30
Cowdenbeath,3854,10,4,10,22,23,56,-33,22
Montrose,3855,1,24,7,5,61,34,27,79
Peterhead,3855,2,24,4,8,82,39,43,76
Stirling,3855,3,17,6,13,62,51,11,57
Stenhousem'r,3855,4,15,8,13,55,48,7,53
Clyde,3855,5,14,10,12,51,48,3,52
Elgin,3855,6,14,6,16,53,62,-9,48
Annan Athlet,3855,7,11,12,13,48,42,6,45
Berwick,3855,8,8,11,17,29,58,-29,35
Edinburgh Ci,3855,9,7,9,20,37,65,-28,30
Cowdenbeath,3855,10,4,11,21,24,55,-31,23
Peterhead,3856,1,24,4,8,79,39,40,76
Montrose,3856,2,23,7,6,60,36,24,76
Stirling,3856,3,17,6,13,64,53,11,57
Stenhousem'r,3856,4,15,8,13,57,50,7,53
Clyde,3856,5,14,10,12,52,49,3,52
Elgin,3856,6,15,6,15,55,61,-6,51
Annan Athlet,3856,7,12,11,13,48,41,7,47
Berwick,3856,8,8,11,17,30,59,-29,35
Edinburgh Ci,3856,9,7,9,20,37,62,-25,30
Cowdenbeath,3856,10,4,10,22,23,55,-32,22
Montrose,3857,1,23,8,5,59,34,25,77
Peterhead,3857,2,23,5,8,79,40,39,74
Stenhousem'r,3857,3,16,8,12,57,47,10,56
Stirling,3857,4,16,6,14,61,53,8,54
Clyde,3857,5,14,10,12,52,49,3,52
Elgin,3857,6,14,7,15,53,60,-7,49
Annan Athlet,3857,7,11,11,14,48,44,4,44
Berwick,3857,8,8,11,17,30,59,-29,35
Edinburgh Ci,3857,9,7,10,19,38,62,-24,31
Cowdenbeath,3857,10,5,10,21,26,55,-29,25
Peterhead,3858,1,24,4,8,79,39,40,76
Montrose,3858,2,23,7,6,59,35,24,76
Stirling,3858,3,17,6,13,64,54,10,57
Stenhousem'r,3858,4,15,8,13,58,50,8,53
Clyde,3858,5,14,9,13,52,54,-2,51
Elgin,3858,6,15,6,15,54,60,-6,51
Annan Athlet,3858,7,12,11,13,48,41,7,47
Berwick,3858,8,9,10,17,35,59,-24,37
Edinburgh Ci,3858,9,7,9,20,37,62,-25,30
Cowdenbeath,3858,10,4,10,22,23,55,-32,22
Montrose,3859,1,24,7,5,60,34,26,79
Peterhead,3859,2,23,5,8,79,40,39,74
Stirling,3859,3,17,6,13,66,52,14,57
Clyde,3859,4,15,9,12,55,51,4,54
Stenhousem'r,3859,5,15,8,13,56,52,4,53
Elgin,3859,6,14,6,16,53,61,-8,48
Annan Athlet,3859,7,12,11,13,51,41,10,47
Berwick,3859,8,8,10,18,32,62,-30,34
Edinburgh Ci,3859,9,7,10,19,38,62,-24,31
Cowdenbeath,3859,10,4,10,22,23,58,-35,22
Montrose,3860,1,24,7,5,61,34,27,79
Peterhead,3860,2,23,5,8,79,40,39,74
Stenhousem'r,3860,3,16,8,12,59,48,11,56
Stirling,3860,4,16,6,14,62,55,7,54
Clyde,3860,5,14,9,13,51,49,2,51
Elgin,3860,6,14,6,16,53,62,-9,48
Annan Athlet,3860,7,11,11,14,48,43,5,44
Berwick,3860,8,9,10,17,30,58,-28,37
Edinburgh Ci,3860,9,7,10,19,38,62,-24,31
Cowdenbeath,3860,10,5,10,21,25,55,-30,25
Montrose,3861,1,24,7,5,61,35,26,79
Peterhead,3861,2,24,4,8,83,38,45,76
Stirling,3861,3,17,6,13,64,51,13,57
Stenhousem'r,3861,4,15,8,13,55,50,5,53
Clyde,3861,5,14,9,13,52,50,2,51
Elgin,3861,6,14,6,16,54,62,-8,48
Annan Athlet,3861,7,11,11,14,47,42,5,44
Berwick,3861,8,9,10,17,31,59,-28,37
Edinburgh Ci,3861,9,7,9,20,36,66,-30,30
Cowdenbeath,3861,10,5,10,21,24,54,-30,25
Peterhead,3862,1,24,4,8,80,40,40,76
Montrose,3862,2,23,7,6,60,37,23,76
Stirling,3862,3,16,7,13,61,52,9,55
Stenhousem'r,3862,4,15,9,12,56,47,9,54
Clyde,3862,5,14,9,13,52,50,2,51
Elgin,3862,6,15,6,15,56,61,-5,51
Annan Athlet,3862,7,11,11,14,49,44,5,44
Berwick,3862,8,9,10,17,31,59,-28,37
Edinburgh Ci,3862,9,7,9,20,38,63,-25,30
Cowdenbeath,3862,10,5,10,21,26,56,-30,25
Montrose,3863,1,24,7,5,60,34,26,79
Peterhead,3863,2,24,4,8,80,38,42,76
Stirling,3863,3,16,7,13,60,51,9,55
Stenhousem'r,3863,4,15,9,12,55,46,9,54
Clyde,3863,5,14,9,13,52,50,2,51
Elgin,3863,6,14,6,16,53,61,-8,48
Annan Athlet,3863,7,11,11,14,48,43,5,44
Berwick,3863,8,9,10,17,31,59,-28,37
Edinburgh Ci,3863,9,7,9,20,36,63,-27,30
Cowdenbeath,3863,10,5,10,21,25,55,-30,25
Montrose,3864,1,23,7,6,59,36,23,76
Peterhead,3864,2,23,5,8,78,39,39,74
Stenhousem'r,3864,3,16,8,12,57,46,11,56
Stirling,3864,4,16,6,14,60,53,7,54
Clyde,3864,5,15,9,12,55,48,7,54
Elgin,3864,6,15,6,15,55,60,-5,51
Annan Athlet,3864,7,12,11,13,51,44,7,47
Berwick,3864,8,8,10,18,29,62,-33,34
Edinburgh Ci,3864,9,7,10,19,37,61,-24,31
Cowdenbeath,3864,10,4,10,22,26,58,-32,22
Montrose,3865,1,24,7,5,62,35,27,79
Peterhead,3865,2,23,5,8,78,39,39,74
Stirling,3865,3,17,6,13,61,51,10,57
Stenhousem'r,3865,4,15,8,13,55,47,8,53
Clyde,3865,5,14,9,13,52,51,1,51
Elgin,3865,6,14,6,16,54,63,-9,48
Annan Athlet,3865,7,11,12,13,47,41,6,45
Berwick,3865,8,9,10,17,32,59,-27,37
Edinburgh Ci,3865,9,7,10,19,37,61,-24,31
Cowdenbeath,3865,10,4,11,21,23,54,-31,23
Peterhead,3866,1,24,4,8,79,38,41,76
Montrose,3866,2,23,7,6,59,35,24,76
Stenhousem'r,3866,3,16,8,12,59,47,12,56
Stirling,3866,4,16,6,14,61,55,6,54
Clyde,3866,5,14,10,12,51,48,3,52
Elgin,3866,6,15,6,15,54,60,-6,51
Annan Athlet,3866,7,12,11,13,52,41,11,47
Berwick,3866,8,8,11,17,29,58,-29,35
Edinburgh Ci,3866,9,7,9,20,36,62,-26,30
Cowdenbeath,3866,10,4,10,22,23,59,-36,22
Montrose,3867,1,24,7,5,61,35,26,79
Peterhead,3867,2,24,4,8,78,38,40,76
Stenhousem'r,3867,3,16,8,12,56,46,10,56
Stirling,3867,4,16,6,14,60,52,8,54
Clyde,3867,5,15,9,12,54,49,5,54
Elgin,3867,6,14,6,16,54,62,-8,48
Annan Athlet,3867,7,11,12,13,47,41,6,45
Berwick,3867,8,8,10,18,30,61,-31,34
Edinburgh Ci,3867,9,7,9,20,36,61,-25,30
Cowdenbeath,3867,10,4,11,21,23,54,-31,23
Montrose,3868,1,23,8,5,61,36,25,77
Peterhead,3868,2,24,4,8,79,38,41,76
Stirling,3868,3,17,6,13,62,52,10,57
Clyde,3868,4,15,9,12,52,48,4,54
Stenhousem'r,3868,5,15,8,13,56,48,8,53
Elgin,3868,6,14,7,15,55,62,-7,49
Annan Athlet,3868,7,11,11,14,47,43,4,44
Berwick,3868,8,8,10,18,29,59,-30,34
Edinburgh Ci,3868,9,7,9,20,36,62,-26,30
Cowdenbeath,3868,10,5,10,21,25,54,-29,25
Montrose,3869,1,24,7,5,63,34,29,79
Peterhead,3869,2,23,5,8,79,40,39,74
Stirling,3869,3,17,6,13,64,51,13,57
Stenhousem'r,3869,4,15,8,13,55,50,5,53
Clyde,3869,5,14,9,13,52,51,1,51
Elgin,3869,6,14,6,16,53,64,-11,48
Annan Athlet,3869,7,11,12,13,48,42,6,45
Berwick,3869,8,9,10,17,32,59,-27,37
Edinburgh Ci,3869,9,7,10,19,38,62,-24,31
Cowdenbeath,3869,10,4,11,21,24,55,-31,23
Montrose,3870,1,23,7,6,60,36,24,76
Peterhead,3870,2,23,4,9,77,39,38,73
Stirling,3870,3,16,7,13,62,53,9,55
Stenhousem'r,3870,4,15,9,12,57,48,9,54
Clyde,3870,5,14,9,13,51,49,2,51
Elgin,3870,6,15,6,15,55,61,-6,51
Annan Athlet,3870,7,11,12,13,47,41,6,45
Berwick,3870,8,9,10,17,30,58,-28,37
Edinburgh Ci,3870,9,8,9,19,37,60,-23,33
Cowdenbeath,3870,10,4,11,21,23,54,-31,23
Montrose,3871,1,23,8,5,61,36,25,77
Peterhead,3871,2,24,4,8,79,39,40,76
Stenhousem'r,3871,3,16,8,12,59,47,12,56
Stirling,3871,4,16,6,14,61,55,6,54
Clyde,3871,5,14,9,13,52,50,2,51
Elgin,3871,6,14,7,15,55,62,-7,49
Annan Athlet,3871,7,12,11,13,49,41,8,47
Berwick,3871,8,9,10,17,31,59,-28,37
Edinburgh Ci,3871,9,7,9,20,37,62,-25,30
Cowdenbeath,3871,10,4,10,22,23,56,-33,22
Montrose,3872,1,23,8,5,61,36,25,77
Peterhead,3872,2,24,4,8,80,40,40,76
Stirling,3872,3,17,6,13,65,54,11,57
Clyde,3872,4,15,9,12,55,49,6,54
Stenhousem'r,3872,5,15,8,13,58,51,7,53
Elgin,3872,6,14,7,15,55,62,-7,49
Annan Athlet,3872,7,12,11,13,48,41,7,47
Berwick,3872,8,8,10,18,30,62,-32,34
Edinburgh Ci,3872,9,7,9,20,38,63,-25,30
Cowdenbeath,3872,10,4,10,22,23,55,-32,22
Montrose,3873,1,24,7,5,62,36,26,79
Peterhead,3873,2,23,5,8,79,40,39,74
Stenhousem'r,3873,3,16,8,12,58,46,12,56
Stirling,3873,4,16,6,14,60,54,6,54
Clyde,3873,5,15,9,12,52,48,4,54
Elgin,3873,6,14,6,16,55,63,-8,48
Annan Athlet,3873,7,11,12,13,47,41,6,45
Berwick,3873,8,8,10,18,29,59,-30,34
Edinburgh Ci,3873,9,7,10,19,38,62,-24,31
Cowdenbeath,3873,10,4,11,21,23,54,-31,23
Montrose,3874,1,24,7,5,60,34,26,79
Peterhead,3874,2,24,4,8,80,38,42,76
Stirling,3874,3,17,6,13,63,52,11,57
Clyde,3874,4,15,9,12,53,48,5,54
Stenhousem'r,3874,5,15,8,13,56,49,7,53
Elgin,3874,6,14,6,16,53,61,-8,48
Annan Athlet,3874,7,11,11,14,47,43,4,44
Berwick,3874,8,8,10,18,29,60,-31,34
Edinburgh Ci,3874,9,7,9,20,36,63,-27,30
Cowdenbeath,3874,10,5,10,21,25,54,-29,25
Montrose,3875,1,24,7,5,63,35,28,79
Peterhead,3875,2,24,4,8,80,38,42,76
Stenhousem'r,3875,3,16,8,12,59,47,12,56
Stirling,3875,4,16,6,14,61,55,6,54
Clyde,3875,5,14,9,13,51,49,2,51
Elgin,3875,6,14,6,16,54,64,-10,48
Annan Athlet,3875,7,12,11,13,49,41,8,47
Berwick,3875,8,9,10,17,30,58,-28,37
Edinburgh Ci,3875,9,7,9,20,36,63,-27,30
Cowdenbeath,3875,10,4,10,22,23,56,-33,22
Montrose,3876,1,24,7,5,61,34,27,79
Peterhead,3876,2,24,4,8,79,38,41,76
Stenhousem'r,3876,3,16,8,12,58,47,11,56
Stirling,3876,4,16,6,14,61,54,7,54
Clyde,3876,5,14,9,13,53,51,2,51
Elgin,3876,6,14,6,16,53,62,-9,48
Annan Athlet,3876,7,11,11,14,47,42,5,44
Berwick,3876,8,9,10,17,32,60,-28,37
Edinburgh Ci,3876,9,7,9,20,36,62,-26,30
Cowdenbeath,3876,10,5,10,21,24,54,-30,25
Peterhead,3877,1,24,4,8,79,39,40,76
Montrose,3877,2,23,7,6,59,36,23,76
Stirling,3877,3,17,6,13,63,53,10,57
Clyde,3877,4,15,9,12,54,49,5,54
Stenhousem'r,3877,5,15,8,13,57,49,8,53
Elgin,3877,6,15,6,15,55,60,-5,51
Annan Athlet,3877,7,12,11,13,48,41,7,47
Berwick,3877,8,8,10,18,30,61,-31,34
Edinburgh Ci,3877,9,7,9,20,37,62,-25,30
Cowdenbeath,3877,10,4,10,22,23,55,-32,22
Peterhead,3878,1,24,4,8,78,38,40,76
Montrose,3878,2,23,7,6,60,37,23,76
Stirling,3878,3,16,7,13,60,51,9,55
Stenhousem'r,3878,4,15,9,12,55,46,9,54
Clyde,3878,5,14,9,13,52,51,1,51
Elgin,3878,6,15,6,15,56,61,-5,51
Annan Athlet,3878,7,11,11,14,49,44,5,44
Berwick,3878,8,9,10,17,32,59,-27,37
Edinburgh Ci,3878,9,7,9,20,36,61,-25,30
Cowdenbeath,3878,10,5,10,21,26,56,-30,25
Montrose,3879,1,24,7,5,61,34,27,79
Peterhead,3879,2,23,4,9,78,40,38,73
Stirling,3879,3,17,6,13,62,51,11,57
Clyde,3879,4,15,9,12,52,48,4,54
Stenhousem'r,3879,5,15,8,13,55,48,7,53
Elgin,3879,6,14,6,16,53,62,-9,48
Annan Athlet,3879,7,11,11,14,48,43,5,44
Berwick,3879,8,8,10,18,29,59,-30,34
Edinburgh Ci,3879,9,8,9,19,38,61,-23,33
Cowdenbeath,3879,10,5,10,21,25,55,-30,25
Montrose,3880,1,24,7,5,62,35,27,79
Peterhead,3880,2,24,4,8,79,38,41,76
Stenhousem'r,3880,3,16,8,12,59,48,11,56
Stirling,3880,4,16,6,14,62,55,7,54
Clyde,3880,5,15,9,12,52,48,4,54
Elgin,3880,6,14,6,16,54,63,-9,48
Annan Athlet,3880,7,11,12,13,47,41,6,45
Berwick,3880,8,8,10,18,29,59,-30,34
Edinburgh Ci,3880,9,7,9,20,36,62,-26,30
Cowdenbeath,3880,10,4,11,21,23,54,-31,23
Montrose,3881,1,24,7,5,60,34,26,79
Peterhead,3881,2,24,4,8,78,38,40,76
Stirling,3881,3,16,7,13,64,55,9,55
Stenhousem'r,3881,4,15,9,12,59,50,9,54
Clyde,3881,5,14,9,13,51,49,2,51
Elgin,3881,6,14,6,16,53,61,-8,48
Annan Athlet,3881,7,11,11,14,48,43,5,44
Berwick,3881,8,9,10,17,30,58,-28,37
Edinburgh Ci,3881,9,7,9,20,36,61,-25,30
Cowdenbeath,3881,10,5,10,21,25,55,-30,25
Peterhead,3882,1,24,4,8,79,38,41,76
Montrose,3882,2,23,7,6,60,38,22,76
Stirling,3882,3,16,7,13,62,53,9,55
Stenhousem'r,3882,4,15,9,12,57,48,9,54
Clyde,3882,5,15,9,12,55,48,7,54
Elgin,3882,6,15,6,15,57,61,-4,51
Annan Athlet,3882,7,11,11,14,47,43,4,44
Berwick,3882,8,8,10,18,29,62,-33,34
Edinburgh Ci,3882,9,7,9,20,36,62,-26,30
Cowdenbeath,3882,10,5,10,21,25,54,-29,25
Montrose,3883,1,23,8,5,61,36,25,77
Peterhead,3883,2,24,4,8,79,38,41,76
Stirling,3883,3,16,7,13,62,53,9,55
Stenhousem'r,3883,4,15,9,12,57,48,9,54
Clyde,3883,5,14,10,12,51,48,3,52
Elgin,3883,6,14,7,15,55,62,-7,49
Annan Athlet,3883,7,11,11,14,47,44,3,44
Berwick,3883,8,8,11,17,29,58,-29,35
Edinburgh Ci,3883,9,7,9,20,36,62,-26,30
Cowdenbeath,3883,10,5,10,21,26,54,-28,25
Montrose,3884,1,23,7,6,61,37,24,76
Peterhead,3884,2,23,4,9,77,39,38,73
Stenhousem'r,3884,3,16,8,12,56,46,10,56
Stirling,3884,4,16,6,14,60,52,8,54
Clyde,3884,5,15,9,12,53,49,4,54
Elgin,3884,6,15,6,15,56,62,-6,51
Annan Athlet,3884,7,11,11,14,47,42,5,44
Berwick,3884,8,8,10,18,30,60,-30,34
Edinburgh Ci,3884,9,8,9,19,37,60,-23,33
Cowdenbeath,3884,10,5,10,21,24,54,-30,25
Montrose,3885,1,24,7,5,62,34,28,79
Peterhead,3885,2,24,4,8,82,38,44,76
Stenhousem'r,3885,3,16,8,12,57,47,10,56
Stirling,3885,4,16,6,14,61,53,8,54
Clyde,3885,5,15,9,12,54,49,5,54
Elgin,3885,6,14,6,16,53,63,-10,48
Annan Athlet,3885,7,11,11,14,48,45,3,44
Berwick,3885,8,8,10,18,30,61,-31,34
Edinburgh Ci,3885,9,7,9,20,36,65,-29,30
Cowdenbeath,3885,10,5,10,21,27,55,-28,25
Montrose,3886,1,23,8,5,60,35,25,77
Peterhead,3886,2,23,5,8,79,40,39,74
Stirling,3886,3,17,6,13,63,52,11,57
Clyde,3886,4,15,9,12,54,49,5,54
Stenhousem'r,3886,5,15,8,13,56,49,7,53
Elgin,3886,6,14,7,15,54,61,-7,49
Annan Athlet,3886,7,11,12,13,49,43,6,45
Berwick,3886,8,8,10,18,30,61,-31,34
Edinburgh Ci,3886,9,7,10,19,38,62,-24,31
Cowdenbeath,3886,10,4,11,21,25,56,-31,23
Montrose,3887,1,24,7,5,60,34,26,79
Peterhead,3887,2,23,4,9,78,40,38,73
Stenhousem'r,3887,3,16,8,12,57,47,10,56
Stirling,3887,4,16,6,14,61,53,8,54
Clyde,3887,5,15,9,12,56,50,6,54
Elgin,3887,6,14,6,16,53,61,-8,48
Annan Athlet,3887,7,12,11,13,48,41,7,47
Berwick,3887,8,8,10,18,31,63,-32,34
Edinburgh Ci,3887,9,8,9,19,38,61,-23,33
Cowdenbeath,3887,10,4,10,22,23,55,-32,22
Peterhead,3888,1,24,4,8,79,38,41,76
Montrose,3888,2,23,7,6,60,37,23,76
Stirling,3888,3,17,6,13,62,52,10,57
Clyde,3888,4,15,9,12,53,49,4,54
Stenhousem'r,3888,5,15,8,13,56,48,8,53
Elgin,3888,6,15,6,15,56,61,-5,51
Annan Athlet,3888,7,11,12,13,48,42,6,45
Berwick,3888,8,8,10,18,30,60,-30,34
Edinburgh Ci,3888,9,7,9,20,36,62,-26,30
Cowdenbeath,3888,10,4,11,21,24,55,-31,23
Montrose,3889,1,24,7,5,61,34,27,79
Peterhead,3889,2,24,4,8,79,38,41,76
Stirling,3889,3,17,6,13,62,52,10,57
Stenhousem'r,3889,4,15,8,13,56,48,8,53
Clyde,3889,5,14,10,12,53,50,3,52
Elgin,3889,6,14,6,16,53,62,-9,48
Annan Athlet,3889,7,11,11,14,47,45,2,44
Berwick,3889,8,8,11,17,31,60,-29,35
Edinburgh Ci,3889,9,7,9,20,36,62,-26,30
Cowdenbeath,3889,10,5,10,21,27,54,-27,25
Montrose,3890,1,24,7,5,62,35,27,79
Peterhead,3890,2,24,4,8,83,39,44,76
Stirling,3890,3,17,6,13,62,52,10,57
Stenhousem'r,3890,4,15,8,13,56,48,8,53
Clyde,3890,5,14,10,12,51,48,3,52
Elgin,3890,6,14,6,16,54,63,-9,48
Annan Athlet,3890,7,12,11,13,48,41,7,47
Berwick,3890,8,8,11,17,29,58,-29,35
Edinburgh Ci,3890,9,7,9,20,37,66,-29,30
Cowdenbeath,3890,10,4,10,22,23,55,-32,22
Peterhead,3891,1,24,4,8,81,38,43,76
Montrose,3891,2,23,7,6,59,38,21,76
Stenhousem'r,3891,3,16,8,12,59,46,13,56
Stirling,3891,4,16,6,14,60,55,5,54
Clyde,3891,5,14,10,12,52,49,3,52
Elgin,3891,6,15,6,15,57,60,-3,51
Annan Athlet,3891,7,11,12,13,48,42,6,45
Berwick,3891,8,8,11,17,30,59,-29,35
Edinburgh Ci,3891,9,7,9,20,36,64,-28,30
Cowdenbeath,3891,10,4,11,21,24,55,-31,23
Montrose,3892,1,24,7,5,60,34,26,79
Peterhead,3892,2,24,4,8,80,38,42,76
Stirling,3892,3,17,6,13,61,51,10,57
Stenhousem'r,3892,4,15,8,13,55,47,8,53
Clyde,3892,5,14,10,12,53,50,3,52
Elgin,3892,6,14,6,16,53,61,-8,48
Annan Athlet,3892,7,11,12,13,47,41,6,45
Berwick,3892,8,8,11,17,31,60,-29,35
Edinburgh Ci,3892,9,7,9,20,36,63,-27,30
Cowdenbeath,3892,10,4,11,21,23,54,-31,23
Montrose,3893,1,24,7,5,65,34,31,79
Peterhead,3893,2,23,4,9,77,39,38,73
Stirling,3893,3,16,7,13,61,52,9,55
Stenhousem'r,3893,4,15,9,12,56,47,9,54
Clyde,3893,5,14,9,13,52,51,1,51
Elgin,3893,6,14,6,16,53,66,-13,48
Annan Athlet,3893,7,11,11,14,47,44,3,44
Berwick,3893,8,9,10,17,32,59,-27,37
Edinburgh Ci,3893,9,8,9,19,37,60,-23,33
Cowdenbeath,3893,10,5,10,21,26,54,-28,25
Montrose,3894,1,24,7,5,63,34,29,79
Peterhead,3894,2,23,5,8,79,40,39,74
Stenhousem'r,3894,3,16,8,12,57,47,10,56
Stirling,3894,4,16,6,14,61,53,8,54
Clyde,3894,5,15,9,12,52,48,4,54
Elgin,3894,6,14,6,16,53,64,-11,48
Annan Athlet,3894,7,12,11,13,48,41,7,47
Berwick,3894,8,8,10,18,29,59,-30,34
Edinburgh Ci,3894,9,7,10,19,38,62,-24,31
Cowdenbeath,3894,10,4,10,22,23,55,-32,22
Peterhead,3895,1,24,4,8,80,39,41,76
Montrose,3895,2,23,7,6,59,36,23,76
Stirling,3895,3,16,7,13,62,53,9,55
Stenhousem'r,3895,4,15,9,12,57,48,9,54
Clyde,3895,5,15,9,12,53,48,5,54
Elgin,3895,6,15,6,15,55,60,-5,51
Annan Athlet,3895,7,12,11,13,48,41,7,47
Berwick,3895,8,8,10,18,29,60,-31,34
Edinburgh Ci,3895,9,7,9,20,37,63,-26,30
Cowdenbeath,3895,10,4,10,22,23,55,-32,22
Montrose,3896,1,24,7,5,63,35,28,79
Peterhead,3896,2,23,4,9,77,39,38,73
Stirling,3896,3,17,6,13,65,52,13,57
Clyde,3896,4,15,9,12,56,48,8,54
Stenhousem'r,3896,5,15,8,13,56,51,5,53
Elgin,3896,6,14,6,16,54,64,-10,48
Annan Athlet,3896,7,11,12,13,47,41,6,45
Berwick,3896,8,8,10,18,29,63,-34,34
Edinburgh Ci,3896,9,8,9,19,37,60,-23,33
Cowdenbeath,3896,10,4,11,21,23,54,-31,23
Montrose,3897,1,24,7,5,62,35,27,79
Peterhead,3897,2,24,4,8,82,39,43,76
Stirling,3897,3,16,7,13,62,53,9,55
Stenhousem'r,3897,4,15,9,12,57,48,9,54
Clyde,3897,5,15,9,12,56,50,6,54
Elgin,3897,6,14,6,16,54,63,-9,48
Annan Athlet,3897,7,12,11,13,49,42,7,47
Berwick,3897,8,8,10,18,31,63,-32,34
Edinburgh Ci,3897,9,7,9,20,37,65,-28,30
Cowdenbeath,3897,10,4,10,22,24,56,-32,22
Peterhead,3898,1,24,4,8,78,38,40,76
Montrose,3898,2,23,7,6,60,36,24,76
Stirling,3898,3,17,6,13,61,51,10,57
Clyde,3898,4,15,9,12,53,48,5,54
Stenhousem'r,3898,5,15,8,13,55,47,8,53
Elgin,3898,6,15,6,15,55,61,-6,51
Annan Athlet,3898,7,11,12,13,49,43,6,45
Berwick,3898,8,8,10,18,29,60,-31,34
Edinburgh Ci,3898,9,7,9,20,36,61,-25,30
Cowdenbeath,3898,10,4,11,21,25,56,-31,23
Montrose,3899,1,24,7,5,60,34,26,79
Peterhead,3899,2,23,4,9,78,40,38,73
Stirling,3899,3,17,6,13,64,51,13,57
Clyde,3899,4,15,9,12,55,49,6,54
Stenhousem'r,3899,5,15,8,13,55,50,5,53
Elgin,3899,6,14,6,16,53,61,-8,48
Annan Athlet,3899,7,11,11,14,49,44,5,44
Berwick,3899,8,8,10,18,30,62,-32,34
Edinburgh Ci,3899,9,8,9,19,38,61,-23,33
Cowdenbeath,3899,10,5,10,21,26,56,-30,25
Montrose,3900,1,24,7,5,61,35,26,79
Peterhead,3900,2,24,4,8,84,39,45,76
Stenhousem'r,3900,3,16,8,12,57,47,10,56
Stirling,3900,4,16,6,14,61,53,8,54
Clyde,3900,5,15,9,12,53,48,5,54
Elgin,3900,6,14,6,16,54,62,-8,48
Annan Athlet,3900,7,12,11,13,50,42,8,47
Berwick,3900,8,8,10,18,29,60,-31,34
Edinburgh Ci,3900,9,7,9,20,37,67,-30,30
Cowdenbeath,3900,10,4,10,22,24,57,-33,22
Montrose,3901,1,24,7,5,63,34,29,79
Peterhead,3901,2,24,4,8,81,39,42,76
Stenhousem'r,3901,3,16,8,12,59,48,11,56
Stirling,3901,4,16,6,14,62,55,7,54
Clyde,3901,5,15,9,12,54,48,6,54
Elgin,3901,6,14,6,16,53,64,-11,48
Annan Athlet,3901,7,11,11,14,47,43,4,44
Berwick,3901,8,8,10,18,29,61,-32,34
Edinburgh Ci,3901,9,7,9,20,37,64,-27,30
Cowdenbeath,3901,10,5,10,21,25,54,-29,25
Montrose,3902,1,24,7,5,62,34,28,79
Peterhead,3902,2,24,4,8,82,38,44,76
Stirling,3902,3,16,7,13,61,52,9,55
Stenhousem'r,3902,4,15,9,12,56,47,9,54
Clyde,3902,5,14,10,12,52,49,3,52
Elgin,3902,6,14,6,16,53,63,-10,48
Annan Athlet,3902,7,11,12,13,48,42,6,45
Berwick,3902,8,8,11,17,30,59,-29,35
Edinburgh Ci,3902,9,7,9,20,36,65,-29,30
Cowdenbeath,3902,10,4,11,21,24,55,-31,23
Montrose,3903,1,24,7,5,61,34,27,79
Peterhead,3903,2,24,4,8,78,38,40,76
Stirling,3903,3,17,6,13,62,52,10,57
Clyde,3903,4,15,9,12,53,48,5,54
Stenhousem'r,3903,5,15,8,13,56,48,8,53
Elgin,3903,6,14,6,16,53,62,-9,48
Annan Athlet,3903,7,11,12,13,49,43,6,45
Berwick,3903,8,8,10,18,29,60,-31,34
Edinburgh Ci,3903,9,7,9,20,36,61,-25,30
Cowdenbeath,3903,10,4,11,21,25,56,-31,23
Montrose,3904,1,23,7,6,60,36,24,76
Peterhead,3904,2,23,5,8,79,40,39,74
Stenhousem'r,3904,3,16,8,12,58,47,11,56
Stirling,3904,4,16,6,14,61,54,7,54
Clyde,3904,5,15,9,12,54,49,5,54
Elgin,3904,6,15,6,15,55,61,-6,51
Annan Athlet,3904,7,12,11,13,48,41,7,47
Berwick,3904,8,8,10,18,30,61,-31,34
Edinburgh Ci,3904,9,7,10,19,38,62,-24,31
Cowdenbeath,3904,10,4,10,22,23,55,-32,22
Montrose,3905,1,24,7,5,64,34,30,79
Peterhead,3905,2,24,4,8,80,38,42,76
Stirling,3905,3,17,6,13,64,52,12,57
Stenhousem'r,3905,4,15,8,13,56,50,6,53
Clyde,3905,5,14,10,12,52,49,3,52
Elgin,3905,6,14,6,16,53,65,-12,48
Annan Athlet,3905,7,11,11,14,47,42,5,44
Berwick,3905,8,8,11,17,30,59,-29,35
Edinburgh Ci,3905,9,7,9,20,36,63,-27,30
Cowdenbeath,3905,10,5,10,21,24,54,-30,25
Montrose,3906,1,24,7,5,61,35,26,79
Peterhead,3906,2,23,5,8,78,39,39,74
Stenhousem'r,3906,3,16,8,12,62,46,16,56
Stirling,3906,4,16,6,14,60,58,2,54
Clyde,3906,5,14,10,12,52,49,3,52
Elgin,3906,6,14,6,16,54,62,-8,48
Annan Athlet,3906,7,11,11,14,47,43,4,44
Berwick,3906,8,8,11,17,30,59,-29,35
Edinburgh Ci,3906,9,7,10,19,37,61,-24,31
Cowdenbeath,3906,10,5,10,21,25,54,-29,25
Montrose,3907,1,24,7,5,62,34,28,79
Peterhead,3907,2,23,4,9,78,40,38,73
Stirling,3907,3,17,6,13,61,51,10,57
Stenhousem'r,3907,4,15,8,13,55,47,8,53
Clyde,3907,5,14,10,12,52,49,3,52
Elgin,3907,6,14,6,16,53,63,-10,48
Annan Athlet,3907,7,11,12,13,47,41,6,45
Berwick,3907,8,8,11,17,30,59,-29,35
Edinburgh Ci,3907,9,8,9,19,38,61,-23,33
Cowdenbeath,3907,10,4,11,21,23,54,-31,23
Peterhead,3908,1,24,4,8,81,40,41,76
Montrose,3908,2,23,7,6,59,36,23,76
Stirling,3908,3,16,7,13,62,53,9,55
Stenhousem'r,3908,4,15,9,12,57,48,9,54
Clyde,3908,5,15,9,12,53,48,5,54
Elgin,3908,6,15,6,15,55,60,-5,51
Annan Athlet,3908,7,12,11,13,49,41,8,47
Berwick,3908,8,8,10,18,29,60,-31,34
Edinburgh Ci,3908,9,7,9,20,38,64,-26,30
Cowdenbeath,3908,10,4,10,22,23,56,-33,22
Montrose,3909,1,24,7,5,60,34,26,79
Peterhead,3909,2,24,4,8,79,39,40,76
Stenhousem'r,3909,3,16,8,12,60,50,10,56
Stirling,3909,4,16,6,14,64,56,8,54
Clyde,3909,5,15,9,12,58,51,7,54
Elgin,3909,6,14,6,16,53,61,-8,48
Annan Athlet,3909,7,11,12,13,49,43,6,45
Berwick,3909,8,8,10,18,32,65,-33,34
Edinburgh Ci,3909,9,7,9,20,37,62,-25,30
Cowdenbeath,3909,10,4,11,21,25,56,-31,23
Montrose,3910,1,24,7,5,62,34,28,79
Peterhead,3910,2,23,5,8,77,38,39,74
Stirling,3910,3,16,7,13,61,52,9,55
Stenhousem'r,3910,4,15,9,12,56,47,9,54
Clyde,3910,5,15,9,12,52,48,4,54
Elgin,3910,6,14,6,16,53,63,-10,48
Annan Athlet,3910,7,11,12,13,48,42,6,45
Berwick,3910,8,8,10,18,29,59,-30,34
Edinburgh Ci,3910,9,7,10,19,36,60,-24,31
Cowdenbeath,3910,10,4,11,21,24,55,-31,23
Peterhead,3911,1,24,4,8,79,39,40,76
Montrose,3911,2,23,7,6,60,36,24,76
Stirling,3911,3,16,7,13,60,51,9,55
Stenhousem'r,3911,4,15,9,12,55,46,9,54
Clyde,3911,5,15,9,12,53,49,4,54
Elgin,3911,6,15,6,15,55,61,-6,51
Annan Athlet,3911,7,11,11,14,47,42,5,44
Berwick,3911,8,8,10,18,30,60,-30,34
Edinburgh Ci,3911,9,7,9,20,37,62,-25,30
Cowdenbeath,3911,10,5,10,21,24,54,-30,25
Montrose,3912,1,24,7,5,61,34,27,79
Peterhead,3912,2,24,4,8,79,38,41,76
Stirling,3912,3,17,6,13,63,51,12,57
Stenhousem'r,3912,4,15,8,13,55,49,6,53
Clyde,3912,5,14,9,13,51,49,2,51
Elgin,3912,6,14,6,16,53,62,-9,48
Annan Athlet,3912,7,11,12,13,48,42,6,45
Berwick,3912,8,9,10,17,30,58,-28,37
Edinburgh Ci,3912,9,7,9,20,36,62,-26,30
Cowdenbeath,3912,10,4,11,21,24,55,-31,23
Montrose,3913,1,24,7,5,61,34,27,79
Peterhead,3913,2,24,4,8,80,39,41,76
Stirling,3913,3,17,6,13,65,53,12,57
Clyde,3913,4,15,9,12,52,48,4,54
Stenhousem'r,3913,5,15,8,13,57,51,6,53
Elgin,3913,6,14,6,16,53,62,-9,48
Annan Athlet,3913,7,12,11,13,51,42,9,47
Berwick,3913,8,8,10,18,29,59,-30,34
Edinburgh Ci,3913,9,7,9,20,37,63,-26,30
Cowdenbeath,3913,10,4,10,22,24,58,-34,22
Montrose,3914,1,24,7,5,60,34,26,79
Peterhead,3914,2,24,4,8,81,40,41,76
Stirling,3914,3,16,7,13,62,53,9,55
Stenhousem'r,3914,4,15,9,12,57,48,9,54
Clyde,3914,5,15,9,12,52,48,4,54
Elgin,3914,6,14,6,16,53,61,-8,48
Annan Athlet,3914,7,11,12,13,47,41,6,45
Berwick,3914,8,8,10,18,29,59,-30,34
Edinburgh Ci,3914,9,7,9,20,38,64,-26,30
Cowdenbeath,3914,10,4,11,21,23,54,-31,23
Montrose,3915,1,24,7,5,63,34,29,79
Peterhead,3915,2,24,4,8,81,38,43,76
Stirling,3915,3,17,6,13,61,51,10,57
Stenhousem'r,3915,4,15,8,13,55,47,8,53
Clyde,3915,5,14,10,12,52,49,3,52
Elgin,3915,6,14,6,16,53,64,-11,48
Annan Athlet,3915,7,11,12,13,47,41,6,45
Berwick,3915,8,8,11,17,30,59,-29,35
Edinburgh Ci,3915,9,7,9,20,36,64,-28,30
Cowdenbeath,3915,10,4,11,21,23,54,-31,23
Montrose,3916,1,24,7,5,62,35,27,79
Peterhead,3916,2,24,4,8,80,39,41,76
Stirling,3916,3,17,6,13,63,53,10,57
Stenhousem'r,3916,4,15,8,13,57,49,8,53
Clyde,3916,5,14,9,13,53,51,2,51
Elgin,3916,6,14,6,16,54,63,-9,48
Annan Athlet,3916,7,11,12,13,47,41,6,45
Berwick,3916,8,9,10,17,32,60,-28,37
Edinburgh Ci,3916,9,7,9,20,37,63,-26,30
Cowdenbeath,3916,10,4,11,21,23,54,-31,23
Montrose,3917,1,24,7,5,62,36,26,79
Peterhead,3917,2,23,5,8,78,39,39,74
Stenhousem'r,3917,3,16,8,12,57,47,10,56
Stirling,3917,4,16,6,14,61,53,8,54
Clyde,3917,5,14,9,13,52,50,2,51
Elgin,3917,6,14,6,16,55,63,-8,48
Annan Athlet,3917,7,11,11,14,47,42,5,44
Berwick,3917,8,9,10,17,31,59,-28,37
Edinburgh Ci,3917,9,7,10,19,37,61,-24,31
Cowdenbeath,3917,10,5,10,21,24,54,-30,25
Montrose,3918,1,24,7,5,61,34,27,79
Peterhead,3918,2,24,4,8,79,39,40,76
Stirling,3918,3,16,7,13,62,53,9,55
Stenhousem'r,3918,4,15,9,12,57,48,9,54
Clyde,3918,5,14,10,12,52,49,3,52
Elgin,3918,6,14,6,16,53,62,-9,48
Annan Athlet,3918,7,12,11,13,48,41,7,47
Berwick,3918,8,8,11,17,30,59,-29,35
Edinburgh Ci,3918,9,7,9,20,37,62,-25,30
Cowdenbeath,3918,10,4,10,22,23,55,-32,22
Montrose,3919,1,23,8,5,59,34,25,77
Peterhead,3919,2,24,4,8,79,39,40,76
Stirling,3919,3,17,6,13,63,53,10,57
Clyde,3919,4,15,9,12,53,48,5,54
Stenhousem'r,3919,5,15,8,13,57,49,8,53
Elgin,3919,6,14,7,15,53,60,-7,49
Annan Athlet,3919,7,11,11,14,47,43,4,44
Berwick,3919,8,8,10,18,29,60,-31,34
Edinburgh Ci,3919,9,7,9,20,37,62,-25,30
Cowdenbeath,3919,10,5,10,21,25,54,-29,25
Montrose,3920,1,24,7,5,62,34,28,79
Peterhead,3920,2,24,4,8,79,38,41,76
Stirling,3920,3,17,6,13,63,52,11,57
Clyde,3920,4,15,9,12,54,49,5,54
Stenhousem'r,3920,5,15,8,13,56,49,7,53
Elgin,3920,6,14,6,16,53,63,-10,48
Annan Athlet,3920,7,12,11,13,52,42,10,47
Berwick,3920,8,8,10,18,30,61,-31,34
Edinburgh Ci,3920,9,7,9,20,36,62,-26,30
Cowdenbeath,3920,10,4,10,22,24,59,-35,22
Montrose,3921,1,23,8,5,60,35,25,77
Peterhead,3921,2,24,4,8,82,39,43,76
Stenhousem'r,3921,3,16,8,12,58,48,10,56
Stirling,3921,4,16,6,14,62,54,8,54
Clyde,3921,5,14,10,12,52,49,3,52
Elgin,3921,6,14,7,15,54,61,-7,49
Annan Athlet,3921,7,11,12,13,48,42,6,45
Berwick,3921,8,8,11,17,30,59,-29,35
Edinburgh Ci,3921,9,7,9,20,37,65,-28,30
Cowdenbeath,3921,10,4,11,21,24,55,-31,23
Montrose,3922,1,24,7,5,61,35,26,79
Peterhead,3922,2,24,4,8,81,39,42,76
Stirling,3922,3,17,6,13,64,51,13,57
Clyde,3922,4,15,9,12,52,48,4,54
Stenhousem'r,3922,5,15,8,13,55,50,5,53
Elgin,3922,6,14,6,16,54,62,-8,48
Annan Athlet,3922,7,11,12,13,47,41,6,45
Berwick,3922,8,8,10,18,29,59,-30,34
Edinburgh Ci,3922,9,7,9,20,37,64,-27,30
Cowdenbeath,3922,10,4,11,21,23,54,-31,23
Montrose,3923,1,24,7,5,60,34,26,79
Peterhead,3923,2,24,4,8,82,39,43,76
Stenhousem'r,3923,3,16,8,12,56,46,10,56
Stirling,3923,4,16,6,14,60,52,8,54
Clyde,3923,5,14,9,13,51,50,1,51
Elgin,3923,6,14,6,16,53,61,-8,48
Annan Athlet,3923,7,11,11,14,47,43,4,44
Berwick,3923,8,9,10,17,31,58,-27,37
Edinburgh Ci,3923,9,7,9,20,37,65,-28,30
Cowdenbeath,3923,10,5,10,21,25,54,-29,25
Peterhead,3924,1,24,4,8,79,38,41,76
Montrose,3924,2,23,7,6,59,35,24,76
Stirling,3924,3,17,6,13,61,51,10,57
Clyde,3924,4,15,9,12,53,49,4,54
Stenhousem'r,3924,5,15,8,13,55,47,8,53
Elgin,3924,6,15,6,15,54,60,-6,51
Annan Athlet,3924,7,11,12,13,47,41,6,45
Berwick,3924,8,8,10,18,30,60,-30,34
Edinburgh Ci,3924,9,7,9,20,36,62,-26,30
Cowdenbeath,3924,10,4,11,21,23,54,-31,23
Montrose,3925,1,23,8,5,59,34,25,77
Peterhead,3925,2,24,4,8,79,39,40,76
Stenhousem'r,3925,3,16,8,12,56,46,10,56
Stirling,3925,4,16,6,14,60,52,8,54
Clyde,3925,5,14,9,13,52,51,1,51
Elgin,3925,6,14,7,15,53,60,-7,49
Annan Athlet,3925,7,11,12,13,49,43,6,45
Berwick,3925,8,9,10,17,32,59,-27,37
Edinburgh Ci,3925,9,7,9,20,37,62,-25,30
Cowdenbeath,3925,10,4,11,21,25,56,-31,23
Montrose,3926,1,24,7,5,62,35,27,79
Peterhead,3926,2,24,4,8,82,39,43,76
Stirling,3926,3,17,6,13,62,52,10,57
Stenhousem'r,3926,4,15,8,13,56,48,8,53
Clyde,3926,5,14,9,13,52,50,2,51
Elgin,3926,6,14,6,16,54,63,-9,48
Annan Athlet,3926,7,11,11,14,48,43,5,44
Berwick,3926,8,9,10,17,31,59,-28,37
Edinburgh Ci,3926,9,7,9,20,37,65,-28,30
Cowdenbeath,3926,10,5,10,21,25,55,-30,25
Montrose,3927,1,23,8,5,61,36,25,77
Peterhead,3927,2,24,4,8,79,38,41,76
Stirling,3927,3,16,7,13,61,52,9,55
Stenhousem'r,3927,4,15,9,12,56,47,9,54
Clyde,3927,5,15,9,12,53,49,4,54
Elgin,3927,6,14,7,15,55,62,-7,49
Annan Athlet,3927,7,12,11,13,48,41,7,47
Berwick,3927,8,8,10,18,30,60,-30,34
Edinburgh Ci,3927,9,7,9,20,36,62,-26,30
Cowdenbeath,3927,10,4,10,22,23,55,-32,22
Montrose,3928,1,24,7,5,63,36,27,79
Peterhead,3928,2,23,5,8,80,41,39,74
Stirling,3928,3,17,6,13,61,51,10,57
Clyde,3928,4,15,9,12,53,49,4,54
Stenhousem'r,3928,5,15,8,13,55,47,8,53
Elgin,3928,6,14,6,16,55,64,-9,48
Annan Athlet,3928,7,12,11,13,48,41,7,47
Berwick,3928,8,8,10,18,30,60,-30,34
Edinburgh Ci,3928,9,7,10,19,39,63,-24,31
Cowdenbeath,3928,10,4,10,22,23,55,-32,22
Montrose,3929,1,23,8,5,60,35,25,77
Peterhead,3929,2,24,4,8,80,38,42,76
Stenhousem'r,3929,3,16,8,12,56,46,10,56
Stirling,3929,4,16,6,14,60,52,8,54
Clyde,3929,5,14,10,12,51,48,3,52
Elgin,3929,6,14,7,15,54,61,-7,49
Annan Athlet,3929,7,11,12,13,47,41,6,45
Berwick,3929,8,8,11,17,29,58,-29,35
Edinburgh Ci,3929,9,7,9,20,36,63,-27,30
Cowdenbeath,3929,10,4,11,21,23,54,-31,23
Montrose,3930,1,24,7,5,61,34,27,79
Peterhead,3930,2,24,4,8,78,38,40,76
Stenhousem'r,3930,3,16,8,12,58,47,11,56
Stirling,3930,4,16,6,14,61,54,7,54
Clyde,3930,5,15,9,12,53,48,5,54
Elgin,3930,6,14,6,16,53,62,-9,48
Annan Athlet,3930,7,12,11,13,49,41,8,47
Berwick,3930,8,8,10,18,29,60,-31,34
Edinburgh Ci,3930,9,7,9,20,36,61,-25,30
Cowdenbeath,3930,10,4,10,22,23,56,-33,22
Montrose,3931,1,24,7,5,60,34,26,79
Peterhead,3931,2,24,4,8,79,38,41,76
Stirling,3931,3,16,7,13,62,53,9,55
Stenhousem'r,3931,4,15,9,12,57,48,9,54
Clyde,3931,5,15,9,12,54,50,4,54
Elgin,3931,6,14,6,16,53,61,-8,48
Annan Athlet,3931,7,11,12,13,47,41,6,45
Berwick,3931,8,8,10,18,31,61,-30,34
Edinburgh Ci,3931,9,7,9,20,36,62,-26,30
Cowdenbeath,3931,10,4,11,21,23,54,-31,23
Montrose,3932,1,24,7,5,64,35,29,79
Peterhead,3932,2,24,4,8,82,39,43,76
Stirling,3932,3,17,6,13,64,53,11,57
Stenhousem'r,3932,4,15,8,13,57,50,7,53
Clyde,3932,5,14,9,13,52,50,2,51
Elgin,3932,6,14,6,16,54,65,-11,48
Annan Athlet,3932,7,11,11,14,48,44,4,44
Berwick,3932,8,9,10,17,31,59,-28,37
Edinburgh Ci,3932,9,7,9,20,37,65,-28,30
Cowdenbeath,3932,10,5,10,21,26,55,-29,25
Montrose,3933,1,24,7,5,60,34,26,79
Peterhead,3933,2,24,4,8,78,38,40,76
Stirling,3933,3,17,6,13,62,52,10,57
Stenhousem'r,3933,4,15,8,13,56,48,8,53
Clyde,3933,5,14,10,12,52,49,3,52
Elgin,3933,6,14,6,16,53,61,-8,48
Annan Athlet,3933,7,11,11,14,48,43,5,44
Berwick,3933,8,8,11,17,30,59,-29,35
Edinburgh Ci,3933,9,7,9,20,36,61,-25,30
Cowdenbeath,3933,10,5,10,21,25,55,-30,25
Peterhead,3934,1,24,4,8,81,38,43,76
Montrose,3934,2,23,7,6,60,36,24,76
Stenhousem'r,3934,3,16,8,12,58,48,10,56
Stirling,3934,4,16,6,14,62,54,8,54
Clyde,3934,5,14,9,13,52,52,0,51
Elgin,3934,6,15,6,15,55,61,-6,51
Annan Athlet,3934,7,11,11,14,47,42,5,44
Berwick,3934,8,9,10,17,33,59,-26,37
Edinburgh Ci,3934,9,7,9,20,36,64,-28,30
Cowdenbeath,3934,10,5,10,21,24,54,-30,25
Montrose,3935,1,24,7,5,61,34,27,79
Peterhead,3935,2,24,4,8,81,39,42,76
Stirling,3935,3,17,6,13,63,51,12,57
Stenhousem'r,3935,4,15,8,13,55,49,6,53
Clyde,3935,5,14,9,13,52,50,2,51
Elgin,3935,6,14,6,16,53,62,-9,48
Annan Athlet,3935,7,12,11,13,49,42,7,47
Berwick,3935,8,9,10,17,31,59,-28,37
Edinburgh Ci,3935,9,7,9,20,37,64,-27,30
Cowdenbeath,3935,10,4,10,22,24,56,-32,22
Montrose,3936,1,23,8,5,60,35,25,77
Peterhead,3936,2,24,4,8,79,39,40,76
Stenhousem'r,3936,3,16,8,12,56,46,10,56
Stirling,3936,4,16,6,14,60,52,8,54
Clyde,3936,5,14,9,13,52,50,2,51
Elgin,3936,6,14,7,15,54,61,-7,49
Annan Athlet,3936,7,12,11,13,48,41,7,47
Berwick,3936,8,9,10,17,31,59,-28,37
Edinburgh Ci,3936,9,7,9,20,37,62,-25,30
Cowdenbeath,3936,10,4,10,22,23,55,-32,22
Montrose,3937,1,24,7,5,61,34,27,79
Peterhead,3937,2,24,4,8,82,38,44,76
Stirling,3937,3,17,6,13,62,51,11,57
Clyde,3937,4,15,9,12,52,48,4,54
Stenhousem'r,3937,5,15,8,13,55,48,7,53
Elgin,3937,6,14,6,16,53,62,-9,48
Annan Athlet,3937,7,11,11,14,47,45,2,44
Berwick,3937,8,8,10,18,29,59,-30,34
Edinburgh Ci,3937,9,7,9,20,36,65,-29,30
Cowdenbeath,3937,10,5,10,21,27,54,-27,25
Montrose,3938,1,24,7,5,61,35,26,79
Peterhead,3938,2,24,4,8,78,38,40,76
Stirling,3938,3,17,6,13,64,52,12,57
Clyde,3938,4,15,9,12,55,48,7,54
Stenhousem'r,3938,5,15,8,13,56,50,6,53
Elgin,3938,6,14,6,16,54,62,-8,48
Annan Athlet,3938,7,11,11,14,47,42,5,44
Berwick,3938,8,8,10,18,29,62,-33,34
Edinburgh Ci,3938,9,7,9,20,36,61,-25,30
Cowdenbeath,3938,10,5,10,21,24,54,-30,25
Montrose,3939,1,23,8,5,59,34,25,77
Peterhead,3939,2,23,4,9,77,40,37,73
Stirling,3939,3,17,6,13,63,51,12,57
Stenhousem'r,3939,4,15,8,13,55,49,6,53
Clyde,3939,5,14,9,13,51,49,2,51
Elgin,3939,6,14,7,15,53,60,-7,49
Annan Athlet,3939,7,12,11,13,48,41,7,47
Berwick,3939,8,9,10,17,30,58,-28,37
Edinburgh Ci,3939,9,8,9,19,38,60,-22,33
Cowdenbeath,3939,10,4,10,22,23,55,-32,22
Montrose,3940,1,24,7,5,61,34,27,79
Peterhead,3940,2,24,4,8,80,40,40,76
Stenhousem'r,3940,3,16,8,12,58,46,12,56
Stirling,3940,4,16,6,14,60,54,6,54
Clyde,3940,5,14,10,12,51,48,3,52
Elgin,3940,6,14,6,16,53,62,-9,48
Annan Athlet,3940,7,12,11,13,49,42,7,47
Berwick,3940,8,8,11,17,29,58,-29,35
Edinburgh Ci,3940,9,7,9,20,38,63,-25,30
Cowdenbeath,3940,10,4,10,22,24,56,-32,22
Montrose,3941,1,23,8,5,60,35,25,77
Peterhead,3941,2,24,4,8,78,38,40,76
Stirling,3941,3,17,6,13,61,51,10,57
Clyde,3941,4,15,9,12,52,48,4,54
Stenhousem'r,3941,5,15,8,13,55,47,8,53
Elgin,3941,6,14,7,15,54,61,-7,49
Annan Athlet,3941,7,11,11,14,47,42,5,44
Berwick,3941,8,8,10,18,29,59,-30,34
Edinburgh Ci,3941,9,7,9,20,36,61,-25,30
Cowdenbeath,3941,10,5,10,21,24,54,-30,25
Montrose,3942,1,24,7,5,61,34,27,79
Peterhead,3942,2,24,4,8,79,39,40,76
Stirling,3942,3,16,7,13,60,51,9,55
Stenhousem'r,3942,4,15,9,12,55,46,9,54
Clyde,3942,5,15,9,12,53,48,5,54
Elgin,3942,6,14,6,16,53,62,-9,48
Annan Athlet,3942,7,11,12,13,47,41,6,45
Berwick,3942,8,8,10,18,29,60,-31,34
Edinburgh Ci,3942,9,7,9,20,37,62,-25,30
Cowdenbeath,3942,10,4,11,21,23,54,-31,23
Montrose,3943,1,24,7,5,62,34,28,79
Peterhead,3943,2,24,4,8,79,39,40,76
Stirling,3943,3,16,7,13,63,54,9,55
Stenhousem'r,3943,4,15,9,12,58,49,9,54
Clyde,3943,5,15,9,12,53,48,5,54
Elgin,3943,6,14,6,16,53,63,-10,48
Annan Athlet,3943,7,11,11,14,48,43,5,44
Berwick,3943,8,8,10,18,29,60,-31,34
Edinburgh Ci,3943,9,7,9,20,37,62,-25,30
Cowdenbeath,3943,10,5,10,21,25,55,-30,25
Montrose,3944,1,24,7,5,60,34,26,79
Peterhead,3944,2,23,4,9,78,40,38,73
Stenhousem'r,3944,3,16,8,12,56,46,10,56
Stirling,3944,4,16,6,14,60,52,8,54
Clyde,3944,5,15,9,12,54,48,6,54
Elgin,3944,6,14,6,16,53,61,-8,48
Annan Athlet,3944,7,11,11,14,47,42,5,44
Berwick,3944,8,8,10,18,29,61,-32,34
Edinburgh Ci,3944,9,8,9,19,38,61,-23,33
Cowdenbeath,3944,10,5,10,21,24,54,-30,25
Montrose,3945,1,24,7,5,62,34,28,79
Peterhead,3945,2,24,4,8,80,38,42,76
Stirling,3945,3,17,6,13,63,51,12,57
Stenhousem'r,3945,4,15,8,13,55,49,6,53
Clyde,3945,5,14,10,12,52,49,3,52
Elgin,3945,6,14,6,16,53,63,-10,48
Annan Athlet,3945,7,11,12,13,47,41,6,45
Berwick,3945,8,8,11,17,30,59,-29,35
Edinburgh Ci,3945,9,7,9,20,36,63,-27,30
Cowdenbeath,3945,10,4,11,21,23,54,-31,23
Montrose,3946,1,24,7,5,64,37,27,79
Peterhead,3946,2,23,5,8,79,40,39,74
Stenhousem'r,3946,3,16,8,12,58,47,11,56
Stirling,3946,4,16,6,14,61,54,7,54
Clyde,3946,5,14,10,12,53,50,3,52
Elgin,3946,6,14,6,16,56,65,-9,48
Annan Athlet,3946,7,11,11,14,47,43,4,44
Berwick,3946,8,8,11,17,31,60,-29,35
Edinburgh Ci,3946,9,7,10,19,38,62,-24,31
Cowdenbeath,3946,10,5,10,21,25,54,-29,25
Peterhead,3947,1,24,4,8,80,38,42,76
Montrose,3947,2,23,7,6,59,36,23,76
Stenhousem'r,3947,3,16,8,12,60,48,12,56
Stirling,3947,4,16,6,14,62,56,6,54
Clyde,3947,5,14,10,12,52,49,3,52
Elgin,3947,6,15,6,15,55,60,-5,51
Annan Athlet,3947,7,11,11,14,47,42,5,44
Berwick,3947,8,8,11,17,30,59,-29,35
Edinburgh Ci,3947,9,7,9,20,36,63,-27,30
Cowdenbeath,3947,10,5,10,21,24,54,-30,25
Montrose,3948,1,24,7,5,62,35,27,79
Peterhead,3948,2,24,4,8,80,38,42,76
Stirling,3948,3,16,7,13,61,52,9,55
Stenhousem'r,3948,4,15,9,12,56,47,9,54
Clyde,3948,5,15,9,12,55,49,6,54
Elgin,3948,6,14,6,16,54,63,-9,48
Annan Athlet,3948,7,12,11,13,49,41,8,47
Berwick,3948,8,8,10,18,30,62,-32,34
Edinburgh Ci,3948,9,7,9,20,36,63,-27,30
Cowdenbeath,3948,10,4,10,22,23,56,-33,22
Montrose,3949,1,24,7,5,62,34,28,79
Peterhead,3949,2,24,4,8,80,38,42,76
Stenhousem'r,3949,3,16,8,12,57,47,10,56
Stirling,3949,4,16,6,14,61,53,8,54
Clyde,3949,5,15,9,12,53,48,5,54
Elgin,3949,6,14,6,16,53,63,-10,48
Annan Athlet,3949,7,11,11,14,48,44,4,44
Berwick,3949,8,8,10,18,29,60,-31,34
Edinburgh Ci,3949,9,7,9,20,36,63,-27,30
Cowdenbeath,3949,10,5,10,21,26,55,-29,25
Montrose,3950,1,24,7,5,61,35,26,79
Peterhead,3950,2,23,5,8,78,39,39,74
Stirling,3950,3,17,6,13,62,52,10,57
Stenhousem'r,3950,4,15,8,13,56,48,8,53
Clyde,3950,5,14,10,12,52,49,3,52
Elgin,3950,6,14,6,16,54,62,-8,48
Annan Athlet,3950,7,11,11,14,47,44,3,44
Berwick,3950,8,8,11,17,30,59,-29,35
Edinburgh Ci,3950,9,7,10,19,37,61,-24,31
Cowdenbeath,3950,10,5,10,21,26,54,-28,25
Montrose,3951,1,24,7,5,61,35,26,79
Peterhead,3951,2,23,5,8,78,39,39,74
Stirling,3951,3,17,6,13,62,51,11,57
Clyde,3951,4,15,9,12,52,48,4,54
Stenhousem'r,3951,5,15,8,13,55,48,7,53
Elgin,3951,6,14,6,16,54,62,-8,48
Annan Athlet,3951,7,11,11,14,47,43,4,44
Berwick,3951,8,8,10,18,29,59,-30,34
Edinburgh Ci,3951,9,7,10,19,37,61,-24,31
Cowdenbeath,3951,10,5,10,21,25,54,-29,25
Montrose,3952,1,24,7,5,63,34,29,79
Peterhead,3952,2,23,5,8,78,39,39,74
Stirling,3952,3,17,6,13,62,51,11,57
Stenhousem'r,3952,4,15,8,13,55,48,7,53
Clyde,3952,5,14,9,13,52,51,1,51
Elgin,3952,6,14,6,16,53,64,-11,48
Annan Athlet,3952,7,12,11,13,50,42,8,47
Berwick,3952,8,9,10,17,32,59,-27,37
Edinburgh Ci,3952,9,7,10,19,37,61,-24,31
Cowdenbeath,3952,10,4,10,22,24,57,-33,22
Montrose,3953,1,24,7,5,61,35,26,79
Peterhead,3953,2,24,4,8,82,38,44,76
Stirling,3953,3,17,6,13,63,52,11,57
Clyde,3953,4,15,9,12,54,50,4,54
Stenhousem'r,3953,5,15,8,13,56,49,7,53
Elgin,3953,6,14,6,16,54,62,-8,48
Annan Athlet,3953,7,11,11,14,48,43,5,44
Berwick,3953,8,8,10,18,31,61,-30,34
Edinburgh Ci,3953,9,7,9,20,36,65,-29,30
Cowdenbeath,3953,10,5,10,21,25,55,-30,25
Montrose,3954,1,24,7,5,62,34,28,79
Peterhead,3954,2,24,4,8,79,38,41,76
Stirling,3954,3,17,6,13,62,52,10,57
Stenhousem'r,3954,4,15,8,13,56,48,8,53
Clyde,3954,5,14,10,12,51,48,3,52
Elgin,3954,6,14,6,16,53,63,-10,48
Annan Athlet,3954,7,12,11,13,49,42,7,47
Berwick,3954,8,8,11,17,29,58,-29,35
Edinburgh Ci,3954,9,7,9,20,36,62,-26,30
Cowdenbeath,3954,10,4,10,22,24,56,-32,22
Montrose,3955,1,24,7,5,61,34,27,79
Peterhead,3955,2,23,4,9,79,41,38,73
Stirling,3955,3,16,7,13,61,52,9,55
Stenhousem'r,3955,4,15,9,12,56,47,9,54
Clyde,3955,5,14,9,13,51,49,2,51
Elgin,3955,6,14,6,16,53,62,-9,48
Annan Athlet,3955,7,12,11,13,49,42,7,47
Berwick,3955,8,9,10,17,30,58,-28,37
Edinburgh Ci,3955,9,8,9,19,39,62,-23,33
Cowdenbeath,3955,10,4,10,22,24,56,-32,22
Montrose,3956,1,24,7,5,61,34,27,79
Peterhead,3956,2,24,4,8,80,38,42,76
Stirling,3956,3,17,6,13,63,52,11,57
Stenhousem'r,3956,4,15,8,13,56,49,7,53
Clyde,3956,5,14,10,12,51,48,3,52
Elgin,3956,6,14,6,16,53,62,-9,48
Annan Athlet,3956,7,11,11,14,47,42,5,44
Berwick,3956,8,8,11,17,29,58,-29,35
Edinburgh Ci,3956,9,7,9,20,36,63,-27,30
Cowdenbeath,3956,10,5,10,21,24,54,-30,25
Montrose,3957,1,23,8,5,61,36,25,77
Peterhead,3957,2,24,4,8,79,38,41,76
Stirling,3957,3,17,6,13,62,52,10,57
Clyde,3957,4,15,9,12,52,48,4,54
Stenhousem'r,3957,5,15,8,13,56,48,8,53
Elgin,3957,6,14,7,15,55,62,-7,49
Annan Athlet,3957,7,11,11,14,47,43,4,44
Berwick,3957,8,8,10,18,29,59,-30,34
Edinburgh Ci,3957,9,7,9,20,36,62,-26,30
Cowdenbeath,3957,10,5,10,21,25,54,-29,25
Montrose,3958,1,24,7,5,60,34,26,79
Peterhead,3958,2,24,4,8,79,38,41,76
Stirling,3958,3,17,6,13,63,53,10,57
Clyde,3958,4,15,9,12,55,48,7,54
Stenhousem'r,3958,5,15,8,13,57,49,8,53
Elgin,3958,6,14,6,16,53,61,-8,48
Annan Athlet,3958,7,11,12,13,48,42,6,45
Berwick,3958,8,8,10,18,29,62,-33,34
Edinburgh Ci,3958,9,7,9,20,36,62,-26,30
Cowdenbeath,3958,10,4,11,21,24,55,-31,23
Montrose,3959,1,24,7,5,61,35,26,79
Peterhead,3959,2,24,4,8,80,38,42,76
Stirling,3959,3,17,6,13,62,52,10,57
Clyde,3959,4,15,9,12,54,49,5,54
Stenhousem'r,3959,5,15,8,13,56,48,8,53
Elgin,3959,6,14,6,16,54,62,-8,48
Annan Athlet,3959,7,11,12,13,48,42,6,45
Berwick,3959,8,8,10,18,30,61,-31,34
Edinburgh Ci,3959,9,7,9,20,36,63,-27,30
Cowdenbeath,3959,10,4,11,21,24,55,-31,23
Montrose,3960,1,24,7,5,61,35,26,79
Peterhead,3960,2,24,4,8,79,39,40,76
Stirling,3960,3,17,6,13,62,52,10,57
Clyde,3960,4,15,9,12,55,49,6,54
Stenhousem'r,3960,5,15,8,13,56,48,8,53
Elgin,3960,6,14,6,16,54,62,-8,48
Annan Athlet,3960,7,11,12,13,47,41,6,45
Berwick,3960,8,8,10,18,30,62,-32,34
Edinburgh Ci,3960,9,7,9,20,37,62,-25,30
Cowdenbeath,3960,10,4,11,21,23,54,-31,23
Montrose,3961,1,24,7,5,62,35,27,79
Peterhead,3961,2,24,4,8,79,38,41,76
Stirling,3961,3,17,6,13,62,51,11,57
Clyde,3961,4,15,9,12,53,48,5,54
Stenhousem'r,3961,5,15,8,13,55,48,7,53
Elgin,3961,6,14,6,16,54,63,-9,48
Annan Athlet,3961,7,11,11,14,48,43,5,44
Berwick,3961,8,8,10,18,29,60,-31,34
Edinburgh Ci,3961,9,7,9,20,36,62,-26,30
Cowdenbeath,3961,10,5,10,21,25,55,-30,25
Peterhead,3962,1,24,4,8,79,38,41,76
Montrose,3962,2,23,7,6,59,35,24,76
Stirling,3962,3,17,6,13,66,52,14,57
Clyde,3962,4,15,9,12,53,48,5,54
Stenhousem'r,3962,5,15,8,13,56,52,4,53
Elgin,3962,6,15,6,15,54,60,-6,51
Annan Athlet,3962,7,11,12,13,47,41,6,45
Berwick,3962,8,8,10,18,29,60,-31,34
Edinburgh Ci,3962,9,7,9,20,36,62,-26,30
Cowdenbeath,3962,10,4,11,21,23,54,-31,23
Montrose,3963,1,24,7,5,62,34,28,79
Peterhead,3963,2,24,4,8,79,39,40,76
Stenhousem'r,3963,3,16,8,12,57,46,11,56
Stirling,3963,4,16,6,14,60,53,7,54
Clyde,3963,5,15,9,12,53,48,5,54
Elgin,3963,6,14,6,16,53,63,-10,48
Annan Athlet,3963,7,12,11,13,48,41,7,47
Berwick,3963,8,8,10,18,29,60,-31,34
Edinburgh Ci,3963,9,7,9,20,37,62,-25,30
Cowdenbeath,3963,10,4,10,22,23,55,-32,22
Montrose,3964,1,24,7,5,62,35,27,79
Peterhead,3964,2,24,4,8,80,39,41,76
Stirling,3964,3,17,6,13,62,52,10,57
Clyde,3964,4,15,9,12,54,48,6,54
Stenhousem'r,3964,5,15,8,13,56,48,8,53
Elgin,3964,6,14,6,16,54,63,-9,48
Annan Athlet,3964,7,11,12,13,48,42,6,45
Berwick,3964,8,8,10,18,29,61,-32,34
Edinburgh Ci,3964,9,7,9,20,37,63,-26,30
Cowdenbeath,3964,10,4,11,21,24,55,-31,23
Montrose,3965,1,24,7,5,65,34,31,79
Peterhead,3965,2,24,4,8,80,38,42,76
Stirling,3965,3,16,7,13,62,53,9,55
Stenhousem'r,3965,4,15,9,12,57,48,9,54
Clyde,3965,5,15,9,12,52,48,4,54
Elgin,3965,6,14,6,16,53,66,-13,48
Annan Athlet,3965,7,12,11,13,49,41,8,47
Berwick,3965,8,8,10,18,29,59,-30,34
Edinburgh Ci,3965,9,7,9,20,36,63,-27,30
Cowdenbeath,3965,10,4,10,22,23,56,-33,22
Montrose,3966,1,23,8,5,60,35,25,77
Peterhead,3966,2,23,5,8,80,41,39,74
Stenhousem'r,3966,3,16,8,12,56,46,10,56
Stirling,3966,4,16,6,14,60,52,8,54
Clyde,3966,5,14,10,12,52,49,3,52
Elgin,3966,6,14,7,15,54,61,-7,49
Annan Athlet,3966,7,12,11,13,49,42,7,47
Berwick,3966,8,8,11,17,30,59,-29,35
Edinburgh Ci,3966,9,7,10,19,39,63,-24,31
Cowdenbeath,3966,10,4,10,22,24,56,-32,22
Montrose,3967,1,24,7,5,61,34,27,79
Peterhead,3967,2,24,4,8,81,38,43,76
Stenhousem'r,3967,3,16,8,12,58,48,10,56
Stirling,3967,4,16,6,14,62,54,8,54
Clyde,3967,5,15,9,12,52,48,4,54
Elgin,3967,6,14,6,16,53,62,-9,48
Annan Athlet,3967,7,12,11,13,49,42,7,47
Berwick,3967,8,8,10,18,29,59,-30,34
Edinburgh Ci,3967,9,7,9,20,36,64,-28,30
Cowdenbeath,3967,10,4,10,22,24,56,-32,22
Montrose,3968,1,24,7,5,61,34,27,79
Peterhead,3968,2,24,4,8,80,38,42,76
Stenhousem'r,3968,3,16,8,12,57,46,11,56
Stirling,3968,4,16,6,14,60,53,7,54
Clyde,3968,5,15,9,12,55,49,6,54
Elgin,3968,6,14,6,16,53,62,-9,48
Annan Athlet,3968,7,12,11,13,49,42,7,47
Berwick,3968,8,8,10,18,30,62,-32,34
Edinburgh Ci,3968,9,7,9,20,36,63,-27,30
Cowdenbeath,3968,10,4,10,22,24,56,-32,22
Montrose,3969,1,23,8,5,59,34,25,77
Peterhead,3969,2,24,4,8,81,39,42,76
Stirling,3969,3,16,7,13,61,52,9,55
Stenhousem'r,3969,4,15,9,12,56,47,9,54
Clyde,3969,5,15,9,12,55,49,6,54
Elgin,3969,6,14,7,15,53,60,-7,49
Annan Athlet,3969,7,11,12,13,48,42,6,45
Berwick,3969,8,8,10,18,30,62,-32,34
Edinburgh Ci,3969,9,7,9,20,37,64,-27,30
Cowdenbeath,3969,10,4,11,21,24,55,-31,23
Montrose,3970,1,24,7,5,63,35,28,79
Peterhead,3970,2,24,4,8,81,38,43,76
Stirling,3970,3,17,6,13,62,52,10,57
Clyde,3970,4,15,9,12,54,48,6,54
Stenhousem'r,3970,5,15,8,13,56,48,8,53
Elgin,3970,6,14,6,16,54,64,-10,48
Annan Athlet,3970,7,11,12,13,47,41,6,45
Berwick,3970,8,8,10,18,29,61,-32,34
Edinburgh Ci,3970,9,7,9,20,36,64,-28,30
Cowdenbeath,3970,10,4,11,21,23,54,-31,23
Montrose,3971,1,24,7,5,62,35,27,79
Peterhead,3971,2,24,4,8,78,38,40,76
Stirling,3971,3,17,6,13,62,51,11,57
Stenhousem'r,3971,4,15,8,13,55,48,7,53
Clyde,3971,5,14,9,13,51,49,2,51
Elgin,3971,6,14,6,16,54,63,-9,48
Annan Athlet,3971,7,11,12,13,47,41,6,45
Berwick,3971,8,9,10,17,30,58,-28,37
Edinburgh Ci,3971,9,7,9,20,36,61,-25,30
Cowdenbeath,3971,10,4,11,21,23,54,-31,23
Montrose,3972,1,23,8,5,60,35,25,77
Peterhead,3972,2,24,4,8,79,38,41,76
Stenhousem'r,3972,3,16,8,12,58,47,11,56
Stirling,3972,4,16,6,14,61,54,7,54
Clyde,3972,5,14,9,13,53,51,2,51
Elgin,3972,6,14,7,15,54,61,-7,49
Annan Athlet,3972,7,11,11,14,47,42,5,44
Berwick,3972,8,9,10,17,32,60,-28,37
Edinburgh Ci,3972,9,7,9,20,36,62,-26,30
Cowdenbeath,3972,10,5,10,21,24,54,-30,25
Montrose,3973,1,24,7,5,61,35,26,79
Peterhead,3973,2,24,4,8,82,40,42,76
Stirling,3973,3,17,6,13,63,51,12,57
Clyde,3973,4,15,9,12,57,49,8,54
Stenhousem'r,3973,5,15,8,13,55,49,6,53
Elgin,3973,6,14,6,16,54,62,-8,48
Annan Athlet,3973,7,11,11,14,47,43,4,44
Berwick,3973,8,8,10,18,30,64,-34,34
Edinburgh Ci,3973,9,7,9,20,38,65,-27,30
Cowdenbeath,3973,10,5,10,21,25,54,-29,25
Montrose,3974,1,24,7,5,62,35,27,79
Peterhead,3974,2,23,4,9,77,39,38,73
Stirling,3974,3,16,7,13,61,52,9,55
Stenhousem'r,3974,4,15,9,12,56,47,9,54
Clyde,3974,5,15,9,12,53,48,5,54
Elgin,3974,6,14,6,16,54,63,-9,48
Annan Athlet,3974,7,11,12,13,47,41,6,45
Berwick,3974,8,8,10,18,29,60,-31,34
Edinburgh Ci,3974,9,8,9,19,37,60,-23,33
Cowdenbeath,3974,10,4,11,21,23,54,-31,23
Montrose,3975,1,24,7,5,63,34,29,79
Peterhead,3975,2,24,4,8,80,38,42,76
Stirling,3975,3,16,7,13,62,53,9,55
Stenhousem'r,3975,4,15,9,12,57,48,9,54
Clyde,3975,5,15,9,12,53,49,4,54
Elgin,3975,6,14,6,16,53,64,-11,48
Annan Athlet,3975,7,11,12,13,48,42,6,45
Berwick,3975,8,8,10,18,30,60,-30,34
Edinburgh Ci,3975,9,7,9,20,36,63,-27,30
Cowdenbeath,3975,10,4,11,21,24,55,-31,23
Montrose,3976,1,24,7,5,61,34,27,79
Peterhead,3976,2,24,4,8,80,39,41,76
Stirling,3976,3,16,7,13,61,52,9,55
Stenhousem'r,3976,4,15,9,12,56,47,9,54
Clyde,3976,5,15,9,12,52,48,4,54
Elgin,3976,6,14,6,16,53,62,-9,48
Annan Athlet,3976,7,11,11,14,47,42,5,44
Berwick,3976,8,8,10,18,29,59,-30,34
Edinburgh Ci,3976,9,7,9,20,37,63,-26,30
Cowdenbeath,3976,10,5,10,21,24,54,-30,25
Montrose,3977,1,23,8,5,59,34,25,77
Peterhead,3977,2,23,4,9,79,41,38,73
Stirling,3977,3,16,7,13,63,54,9,55
Stenhousem'r,3977,4,15,9,12,58,49,9,54
Clyde,3977,5,14,10,12,52,49,3,52
Elgin,3977,6,14,7,15,53,60,-7,49
Annan Athlet,3977,7,11,11,14,47,42,5,44
Berwick,3977,8,8,11,17,30,59,-29,35
Edinburgh Ci,3977,9,8,9,19,39,62,-23,33
Cowdenbeath,3977,10,5,10,21,24,54,-30,25
Peterhead,3978,1,24,4,8,80,39,41,76
Montrose,3978,2,23,7,6,61,37,24,76
Stenhousem'r,3978,3,16,8,12,58,48,10,56
Stirling,3978,4,16,6,14,62,54,8,54
Clyde,3978,5,14,9,13,52,50,2,51
Elgin,3978,6,15,6,15,56,62,-6,51
Annan Athlet,3978,7,12,11,13,50,43,7,47
Berwick,3978,8,9,10,17,31,59,-28,37
Edinburgh Ci,3978,9,7,9,20,37,63,-26,30
Cowdenbeath,3978,10,4,10,22,25,57,-32,22
Montrose,3979,1,23,8,5,61,36,25,77
Peterhead,3979,2,24,4,8,80,40,40,76
Stirling,3979,3,16,7,13,60,51,9,55
Stenhousem'r,3979,4,15,9,12,55,46,9,54
Clyde,3979,5,15,9,12,52,48,4,54
Elgin,3979,6,14,7,15,55,62,-7,49
Annan Athlet,3979,7,12,11,13,48,41,7,47
Berwick,3979,8,8,10,18,29,59,-30,34
Edinburgh Ci,3979,9,7,9,20,38,63,-25,30
Cowdenbeath,3979,10,4,10,22,23,55,-32,22
Montrose,3980,1,23,8,5,60,35,25,77
Peterhead,3980,2,24,4,8,78,38,40,76
Stenhousem'r,3980,3,16,8,12,57,47,10,56
Stirling,3980,4,16,6,14,61,53,8,54
Clyde,3980,5,14,10,12,53,50,3,52
Elgin,3980,6,14,7,15,54,61,-7,49
Annan Athlet,3980,7,12,11,13,48,41,7,47
Berwick,3980,8,8,11,17,31,60,-29,35
Edinburgh Ci,3980,9,7,9,20,36,61,-25,30
Cowdenbeath,3980,10,4,10,22,23,55,-32,22
Montrose,3981,1,24,7,5,63,36,27,79
Peterhead,3981,2,24,4,8,79,38,41,76
Stirling,3981,3,17,6,13,61,51,10,57
Clyde,3981,4,15,9,12,52,48,4,54
Stenhousem'r,3981,5,15,8,13,55,47,8,53
Elgin,3981,6,14,6,16,55,64,-9,48
Annan Athlet,3981,7,11,12,13,49,43,6,45
Berwick,3981,8,8,10,18,29,59,-30,34
Edinburgh Ci,3981,9,7,9,20,36,62,-26,30
Cowdenbeath,3981,10,4,11,21,25,56,-31,23
Montrose,3982,1,24,7,5,61,35,26,79
Peterhead,3982,2,24,4,8,80,38,42,76
Stenhousem'r,3982,3,16,8,12,56,46,10,56
Stirling,3982,4,16,6,14,60,52,8,54
Clyde,3982,5,15,9,12,53,49,4,54
Elgin,3982,6,14,6,16,54,62,-8,48
Annan Athlet,3982,7,12,11,13,48,41,7,47
Berwick,3982,8,8,10,18,30,60,-30,34
Edinburgh Ci,3982,9,7,9,20,36,63,-27,30
Cowdenbeath,3982,10,4,10,22,23,55,-32,22
Montrose,3983,1,24,7,5,61,35,26,79
Peterhead,3983,2,24,4,8,80,39,41,76
Stirling,3983,3,16,7,13,61,52,9,55
Stenhousem'r,3983,4,15,9,12,56,47,9,54
Clyde,3983,5,14,9,13,52,50,2,51
Elgin,3983,6,14,6,16,54,62,-8,48
Annan Athlet,3983,7,11,11,14,47,42,5,44
Berwick,3983,8,9,10,17,31,59,-28,37
Edinburgh Ci,3983,9,7,9,20,37,63,-26,30
Cowdenbeath,3983,10,5,10,21,24,54,-30,25
Montrose,3984,1,24,7,5,63,37,26,79
Peterhead,3984,2,24,4,8,81,39,42,76
Stirling,3984,3,17,6,13,64,51,13,57
Clyde,3984,4,15,9,12,53,48,5,54
Stenhousem'r,3984,5,15,8,13,55,50,5,53
Elgin,3984,6,14,6,16,56,64,-8,48
Annan Athlet,3984,7,11,12,13,49,43,6,45
Berwick,3984,8,8,10,18,29,60,-31,34
Edinburgh Ci,3984,9,7,9,20,37,64,-27,30
Cowdenbeath,3984,10,4,11,21,25,56,-31,23
Montrose,3985,1,24,7,5,62,35,27,79
Peterhead,3985,2,23,5,8,79,40,39,74
Stirling,3985,3,17,6,13,61,51,10,57
Stenhousem'r,3985,4,15,8,13,55,47,8,53
Clyde,3985,5,14,9,13,52,50,2,51
Elgin,3985,6,14,6,16,54,63,-9,48
Annan Athlet,3985,7,11,11,14,47,43,4,44
Berwick,3985,8,9,10,17,31,59,-28,37
Edinburgh Ci,3985,9,7,10,19,38,62,-24,31
Cowdenbeath,3985,10,5,10,21,25,54,-29,25
Montrose,3986,1,23,8,5,61,36,25,77
Peterhead,3986,2,24,4,8,78,38,40,76
Stirling,3986,3,17,6,13,62,52,10,57
Stenhousem'r,3986,4,15,8,13,56,48,8,53
Clyde,3986,5,14,9,13,52,52,0,51
Elgin,3986,6,14,7,15,55,62,-7,49
Annan Athlet,3986,7,11,11,14,47,43,4,44
Berwick,3986,8,9,10,17,33,59,-26,37
Edinburgh Ci,3986,9,7,9,20,36,61,-25,30
Cowdenbeath,3986,10,5,10,21,25,54,-29,25
Montrose,3987,1,24,7,5,63,35,28,79
Peterhead,3987,2,24,4,8,82,38,44,76
Stirling,3987,3,16,7,13,63,54,9,55
Stenhousem'r,3987,4,15,9,12,58,49,9,54
Clyde,3987,5,15,9,12,55,49,6,54
Elgin,3987,6,14,6,16,54,64,-10,48
Annan Athlet,3987,7,12,11,13,50,41,9,47
Berwick,3987,8,8,10,18,30,62,-32,34
Edinburgh Ci,3987,9,7,9,20,36,65,-29,30
Cowdenbeath,3987,10,4,10,22,23,57,-34,22
Montrose,3988,1,23,7,6,59,35,24,76
Peterhead,3988,2,23,4,9,77,39,38,73
Stenhousem'r,3988,3,16,8,12,58,46,12,56
Stirling,3988,4,16,6,14,60,54,6,54
Clyde,3988,5,15,9,12,54,48,6,54
Elgin,3988,6,15,6,15,54,60,-6,51
Annan Athlet,3988,7,11,12,13,49,43,6,45
Berwick,3988,8,8,10,18,29,61,-32,34
Edinburgh Ci,3988,9,8,9,19,37,60,-23,33
Cowdenbeath,3988,10,4,11,21,25,56,-31,23
Montrose,3989,1,24,7,5,61,35,26,79
Peterhead,3989,2,23,4,9,78,40,38,73
Stirling,3989,3,16,7,13,62,53,9,55
Stenhousem'r,3989,4,15,9,12,57,48,9,54
Clyde,3989,5,14,9,13,52,50,2,51
Elgin,3989,6,14,6,16,54,62,-8,48
Annan Athlet,3989,7,11,12,13,47,41,6,45
Berwick,3989,8,9,10,17,31,59,-28,37
Edinburgh Ci,3989,9,8,9,19,38,61,-23,33
Cowdenbeath,3989,10,4,11,21,23,54,-31,23
Montrose,3990,1,24,7,5,63,34,29,79
Peterhead,3990,2,24,4,8,82,39,43,76
Stirling,3990,3,17,6,13,62,52,10,57
Clyde,3990,4,15,9,12,54,49,5,54
Stenhousem'r,3990,5,15,8,13,56,48,8,53
Elgin,3990,6,14,6,16,53,64,-11,48
Annan Athlet,3990,7,11,12,13,47,41,6,45
Berwick,3990,8,8,10,18,30,61,-31,34
Edinburgh Ci,3990,9,7,9,20,37,65,-28,30
Cowdenbeath,3990,10,4,11,21,23,54,-31,23
Montrose,3991,1,24,7,5,64,34,30,79
Peterhead,3991,2,24,4,8,79,39,40,76
Stirling,3991,3,16,7,13,61,52,9,55
Stenhousem'r,3991,4,15,9,12,56,47,9,54
Clyde,3991,5,14,10,12,52,49,3,52
Elgin,3991,6,14,6,16,53,65,-12,48
Annan Athlet,3991,7,11,11,14,47,42,5,44
Berwick,3991,8,8,11,17,30,59,-29,35
Edinburgh Ci,3991,9,7,9,20,37,62,-25,30
Cowdenbeath,3991,10,5,10,21,24,54,-30,25
Montrose,3992,1,24,7,5,61,34,27,79
Peterhead,3992,2,24,4,8,78,38,40,76
Stirling,3992,3,17,6,13,62,52,10,57
Clyde,3992,4,15,9,12,53,48,5,54
Stenhousem'r,3992,5,15,8,13,56,48,8,53
Elgin,3992,6,14,6,16,53,62,-9,48
Annan Athlet,3992,7,11,11,14,48,43,5,44
Berwick,3992,8,8,10,18,29,60,-31,34
Edinburgh Ci,3992,9,7,9,20,36,61,-25,30
Cowdenbeath,3992,10,5,10,21,25,55,-30,25
Montrose,3993,1,23,7,6,59,35,24,76
Peterhead,3993,2,23,5,8,78,39,39,74
Stirling,3993,3,17,6,13,65,54,11,57
Clyde,3993,4,15,9,12,54,48,6,54
Stenhousem'r,3993,5,15,8,13,58,51,7,53
Elgin,3993,6,15,6,15,54,60,-6,51
Annan Athlet,3993,7,11,12,13,48,42,6,45
Berwick,3993,8,8,10,18,29,61,-32,34
Edinburgh Ci,3993,9,7,10,19,37,61,-24,31
Cowdenbeath,3993,10,4,11,21,24,55,-31,23
Montrose,3994,1,24,7,5,61,35,26,79
Peterhead,3994,2,24,4,8,80,39,41,76
Stirling,3994,3,17,6,13,64,52,12,57
Clyde,3994,4,15,9,12,53,49,4,54
Stenhousem'r,3994,5,15,8,13,56,50,6,53
Elgin,3994,6,14,6,16,54,62,-8,48
Annan Athlet,3994,7,11,11,14,47,43,4,44
Berwick,3994,8,8,10,18,30,60,-30,34
Edinburgh Ci,3994,9,7,9,20,37,63,-26,30
Cowdenbeath,3994,10,5,10,21,25,54,-29,25
Montrose,3995,1,24,7,5,60,34,26,79
Peterhead,3995,2,24,4,8,84,39,45,76
Stenhousem'r,3995,3,16,8,12,58,46,12,56
Stirling,3995,4,16,6,14,60,54,6,54
Clyde,3995,5,14,10,12,52,49,3,52
Elgin,3995,6,14,6,16,53,61,-8,48
Annan Athlet,3995,7,12,11,13,49,42,7,47
Berwick,3995,8,8,11,17,30,59,-29,35
Edinburgh Ci,3995,9,7,9,20,37,67,-30,30
Cowdenbeath,3995,10,4,10,22,24,56,-32,22
Montrose,3996,1,24,7,5,62,35,27,79
Peterhead,3996,2,24,4,8,79,39,40,76
Stirling,3996,3,17,6,13,63,52,11,57
Clyde,3996,4,15,9,12,53,48,5,54
Stenhousem'r,3996,5,15,8,13,56,49,7,53
Elgin,3996,6,14,6,16,54,63,-9,48
Annan Athlet,3996,7,11,12,13,47,41,6,45
Berwick,3996,8,8,10,18,29,60,-31,34
Edinburgh Ci,3996,9,7,9,20,37,62,-25,30
Cowdenbeath,3996,10,4,11,21,23,54,-31,23
Montrose,3997,1,24,7,5,62,34,28,79
Peterhead,3997,2,24,4,8,80,40,40,76
Stirling,3997,3,16,7,13,61,52,9,55
Stenhousem'r,3997,4,15,9,12,56,47,9,54
Clyde,3997,5,14,9,13,51,49,2,51
Elgin,3997,6,14,6,16,53,63,-10,48
Annan Athlet,3997,7,12,11,13,50,41,9,47
Berwick,3997,8,9,10,17,30,58,-28,37
Edinburgh Ci,3997,9,7,9,20,38,63,-25,30
Cowdenbeath,3997,10,4,10,22,23,57,-34,22
Montrose,3998,1,24,7,5,64,35,29,79
Peterhead,3998,2,24,4,8,81,39,42,76
Stirling,3998,3,17,6,13,62,51,11,57
Clyde,3998,4,15,9,12,55,49,6,54
Stenhousem'r,3998,5,15,8,13,55,48,7,53
Elgin,3998,6,14,6,16,54,65,-11,48
Annan Athlet,3998,7,12,11,13,48,41,7,47
Berwick,3998,8,8,10,18,30,62,-32,34
Edinburgh Ci,3998,9,7,9,20,37,64,-27,30
Cowdenbeath,3998,10,4,10,22,23,55,-32,22
Montrose,3999,1,23,8,5,60,35,25,77
Peterhead,3999,2,24,4,8,82,39,43,76
Stirling,3999,3,17,6,13,63,51,12,57
Stenhousem'r,3999,4,15,8,13,55,49,6,53
Clyde,3999,5,14,10,12,52,49,3,52
Elgin,3999,6,14,7,15,54,61,-7,49
Annan Athlet,3999,7,11,11,14,47,42,5,44
Berwick,3999,8,8,11,17,30,59,-29,35
Edinburgh Ci,3999,9,7,9,20,37,65,-28,30
Cowdenbeath,3999,10,5,10,21,24,54,-30,25
Montrose,4000,1,24,7,5,60,34,26,79
Peterhead,4000,2,23,5,8,77,38,39,74
Stirling,4000,3,16,7,13,62,53,9,55
Stenhousem'r,4000,4,15,9,12,57,48,9,54
Clyde,4000,5,15,9,12,54,49,5,54
Elgin,4000,6,14,6,16,53,61,-8,48
Annan Athlet,4000,7,11,12,13,48,42,6,45
Berwick,4000,8,8,10,18,30,61,-31,34
Edinburgh Ci,4000,9,7,10,19,36,60,-24,31
Cowdenbeath,4000,10,4,11,21,24,55,-31,23
Montrose,4001,1,24,7,5,60,34,26,79
Peterhead,4001,2,24,4,8,79,39,40,76
Stirling,4001,3,16,7,13,61,52,9,55
Stenhousem'r,4001,4,15,9,12,56,47,9,54
Clyde,4001,5,15,9,12,54,48,6,54
Elgin,4001,6,14,6,16,53,61,-8,48
Annan Athlet,4001,7,11,12,13,49,43,6,45
Berwick,4001,8,8,10,18,29,61,-32,34
Edinburgh Ci,4001,9,7,9,20,37,62,-25,30
Cowdenbeath,4001,10,4,11,21,25,56,-31,23
Montrose,4002,1,24,7,5,61,35,26,79
Peterhead,4002,2,23,4,9,78,42,36,73
Stirling,4002,3,16,7,13,62,53,9,55
Stenhousem'r,4002,4,15,9,12,57,48,9,54
Clyde,4002,5,15,9,12,54,48,6,54
Elgin,4002,6,14,6,16,54,62,-8,48
Annan Athlet,4002,7,11,11,14,48,44,4,44
Berwick,4002,8,8,10,18,29,61,-32,34
Edinburgh Ci,4002,9,8,9,19,40,61,-21,33
Cowdenbeath,4002,10,5,10,21,26,55,-29,25
Montrose,4003,1,24,7,5,62,35,27,79
Peterhead,4003,2,24,4,8,82,39,43,76
Stenhousem'r,4003,3,16,8,12,58,47,11,56
Stirling,4003,4,16,6,14,61,54,7,54
Clyde,4003,5,15,9,12,53,48,5,54
Elgin,4003,6,14,6,16,54,63,-9,48
Annan Athlet,4003,7,11,11,14,48,44,4,44
Berwick,4003,8,8,10,18,29,60,-31,34
Edinburgh Ci,4003,9,7,9,20,37,65,-28,30
Cowdenbeath,4003,10,5,10,21,26,55,-29,25
Montrose,4004,1,24,7,5,61,35,26,79
Peterhead,4004,2,23,4,9,79,41,38,73
Stirling,4004,3,17,6,13,63,51,12,57
Clyde,4004,4,15,9,12,53,48,5,54
Stenhousem'r,4004,5,15,8,13,55,49,6,53
Elgin,4004,6,14,6,16,54,62,-8,48
Annan Athlet,4004,7,11,12,13,48,42,6,45
Berwick,4004,8,8,10,18,29,60,-31,34
Edinburgh Ci,4004,9,8,9,19,39,62,-23,33
Cowdenbeath,4004,10,4,11,21,24,55,-31,23
Montrose,4005,1,23,8,5,59,34,25,77
Peterhead,4005,2,23,5,8,79,40,39,74
Stirling,4005,3,16,7,13,62,53,9,55
Stenhousem'r,4005,4,15,9,12,57,48,9,54
Clyde,4005,5,15,9,12,54,48,6,54
Elgin,4005,6,14,7,15,53,60,-7,49
Annan Athlet,4005,7,11,12,13,47,41,6,45
Berwick,4005,8,8,10,18,29,61,-32,34
Edinburgh Ci,4005,9,7,10,19,38,62,-24,31
Cowdenbeath,4005,10,4,11,21,23,54,-31,23
Montrose,4006,1,23,8,5,61,36,25,77
Peterhead,4006,2,24,4,8,81,38,43,76
Stirling,4006,3,17,6,13,63,52,11,57
Stenhousem'r,4006,4,15,8,13,56,49,7,53
Clyde,4006,5,14,10,12,54,51,3,52
Elgin,4006,6,14,7,15,55,62,-7,49
Annan Athlet,4006,7,11,11,14,49,44,5,44
Berwick,4006,8,8,11,17,32,61,-29,35
Edinburgh Ci,4006,9,7,9,20,36,64,-28,30
Cowdenbeath,4006,10,5,10,21,26,56,-30,25
Montrose,4007,1,24,7,5,62,34,28,79
Peterhead,4007,2,23,5,8,78,39,39,74
Stirling,4007,3,17,6,13,62,52,10,57
Clyde,4007,4,15,9,12,53,48,5,54
Stenhousem'r,4007,5,15,8,13,56,48,8,53
Elgin,4007,6,14,6,16,53,63,-10,48
Annan Athlet,4007,7,12,11,13,49,42,7,47
Berwick,4007,8,8,10,18,29,60,-31,34
Edinburgh Ci,4007,9,7,10,19,37,61,-24,31
Cowdenbeath,4007,10,4,10,22,24,56,-32,22
Montrose,4008,1,24,7,5,62,36,26,79
Peterhead,4008,2,24,4,8,81,41,40,76
Stirling,4008,3,17,6,13,62,52,10,57
Stenhousem'r,4008,4,15,8,13,56,48,8,53
Clyde,4008,5,14,9,13,51,49,2,51
Elgin,4008,6,14,6,16,55,63,-8,48
Annan Athlet,4008,7,11,12,13,47,41,6,45
Berwick,4008,8,9,10,17,30,58,-28,37
Edinburgh Ci,4008,9,7,9,20,39,64,-25,30
Cowdenbeath,4008,10,4,11,21,23,54,-31,23
Peterhead,4009,1,24,4,8,81,38,43,76
Montrose,4009,2,23,7,6,61,37,24,76
Stenhousem'r,4009,3,16,8,12,56,46,10,56
Stirling,4009,4,16,6,14,60,52,8,54
Clyde,4009,5,14,9,13,52,50,2,51
Elgin,4009,6,15,6,15,56,62,-6,51
Annan Athlet,4009,7,12,11,13,48,41,7,47
Berwick,4009,8,9,10,17,31,59,-28,37
Edinburgh Ci,4009,9,7,9,20,36,64,-28,30
Cowdenbeath,4009,10,4,10,22,23,55,-32,22
Montrose,4010,1,23,8,5,59,34,25,77
Peterhead,4010,2,24,4,8,79,39,40,76
Stirling,4010,3,17,6,13,63,53,10,57
Clyde,4010,4,15,9,12,55,49,6,54
Stenhousem'r,4010,5,15,8,13,57,49,8,53
Elgin,4010,6,14,7,15,53,60,-7,49
Annan Athlet,4010,7,11,11,14,47,44,3,44
Berwick,4010,8,8,10,18,30,62,-32,34
Edinburgh Ci,4010,9,7,9,20,37,62,-25,30
Cowdenbeath,4010,10,5,10,21,26,54,-28,25
Montrose,4011,1,24,7,5,61,35,26,79
Peterhead,4011,2,24,4,8,81,39,42,76
Stirling,4011,3,17,6,13,64,53,11,57
Stenhousem'r,4011,4,15,8,13,57,50,7,53
Clyde,4011,5,14,9,13,53,51,2,51
Elgin,4011,6,14,6,16,54,62,-8,48
Annan Athlet,4011,7,11,12,13,48,42,6,45
Berwick,4011,8,9,10,17,32,60,-28,37
Edinburgh Ci,4011,9,7,9,20,37,64,-27,30
Cowdenbeath,4011,10,4,11,21,24,55,-31,23
Montrose,4012,1,24,7,5,63,36,27,79
Peterhead,4012,2,24,4,8,81,38,43,76
Stirling,4012,3,17,6,13,63,52,11,57
Stenhousem'r,4012,4,15,8,13,56,49,7,53
Clyde,4012,5,14,9,13,52,50,2,51
Elgin,4012,6,14,6,16,55,64,-9,48
Annan Athlet,4012,7,11,11,14,48,43,5,44
Berwick,4012,8,9,10,17,31,59,-28,37
Edinburgh Ci,4012,9,7,9,20,36,64,-28,30
Cowdenbeath,4012,10,5,10,21,25,55,-30,25
Montrose,4013,1,24,7,5,60,34,26,79
Peterhead,4013,2,23,5,8,78,39,39,74
Stirling,4013,3,16,7,13,61,52,9,55
Stenhousem'r,4013,4,15,9,12,56,47,9,54
Clyde,4013,5,15,9,12,53,48,5,54
Elgin,4013,6,14,6,16,53,61,-8,48
Annan Athlet,4013,7,12,11,13,49,41,8,47
Berwick,4013,8,8,10,18,29,60,-31,34
Edinburgh Ci,4013,9,7,10,19,37,61,-24,31
Cowdenbeath,4013,10,4,10,22,23,56,-33,22
Montrose,4014,1,23,8,5,59,34,25,77
Peterhead,4014,2,24,4,8,79,39,40,76
Stenhousem'r,4014,3,16,8,12,58,47,11,56
Stirling,4014,4,16,6,14,61,54,7,54
Clyde,4014,5,15,9,12,53,48,5,54
Elgin,4014,6,14,7,15,53,60,-7,49
Annan Athlet,4014,7,11,11,14,48,43,5,44
Berwick,4014,8,8,10,18,29,60,-31,34
Edinburgh Ci,4014,9,7,9,20,37,62,-25,30
Cowdenbeath,4014,10,5,10,21,25,55,-30,25
Montrose,4015,1,24,7,5,63,34,29,79
Peterhead,4015,2,24,4,8,80,39,41,76
Stirling,4015,3,17,6,13,66,51,15,57
Stenhousem'r,4015,4,15,8,13,55,52,3,53
Clyde,4015,5,14,10,12,51,48,3,52
Elgin,4015,6,14,6,16,53,64,-11,48
Annan Athlet,4015,7,11,12,13,47,41,6,45
Berwick,4015,8,8,11,17,29,58,-29,35
Edinburgh Ci,4015,9,7,9,20,37,63,-26,30
Cowdenbeath,4015,10,4,11,21,23,54,-31,23
Montrose,4016,1,23,8,5,61,36,25,77
Peterhead,4016,2,24,4,8,79,39,40,76
Stirling,4016,3,17,6,13,63,53,10,57
Stenhousem'r,4016,4,15,8,13,57,49,8,53
Clyde,4016,5,14,9,13,52,51,1,51
Elgin,4016,6,14,7,15,55,62,-7,49
Annan Athlet,4016,7,12,11,13,50,41,9,47
Berwick,4016,8,9,10,17,32,59,-27,37
Edinburgh Ci,4016,9,7,9,20,37,62,-25,30
Cowdenbeath,4016,10,4,10,22,23,57,-34,22
Montrose,4017,1,23,8,5,61,36,25,77
Peterhead,4017,2,23,5,8,78,39,39,74
Stirling,4017,3,17,6,13,65,51,14,57
Stenhousem'r,4017,4,15,8,13,55,51,4,53
Clyde,4017,5,14,9,13,52,51,1,51
Elgin,4017,6,14,7,15,55,62,-7,49
Annan Athlet,4017,7,12,11,13,51,41,10,47
Berwick,4017,8,9,10,17,32,59,-27,37
Edinburgh Ci,4017,9,7,10,19,37,61,-24,31
Cowdenbeath,4017,10,4,10,22,23,58,-35,22
Montrose,4018,1,24,7,5,62,35,27,79
Peterhead,4018,2,24,4,8,80,39,41,76
Stirling,4018,3,17,6,13,63,52,11,57
Stenhousem'r,4018,4,15,8,13,56,49,7,53
Clyde,4018,5,14,9,13,51,49,2,51
Elgin,4018,6,14,6,16,54,63,-9,48
Annan Athlet,4018,7,11,12,13,48,42,6,45
Berwick,4018,8,9,10,17,30,58,-28,37
Edinburgh Ci,4018,9,7,9,20,37,63,-26,30
Cowdenbeath,4018,10,4,11,21,24,55,-31,23
Montrose,4019,1,24,7,5,63,37,26,79
Peterhead,4019,2,24,4,8,80,39,41,76
Stirling,4019,3,17,6,13,64,51,13,57
Clyde,4019,4,15,9,12,56,49,7,54
Stenhousem'r,4019,5,15,8,13,55,50,5,53
Elgin,4019,6,14,6,16,56,64,-8,48
Annan Athlet,4019,7,12,11,13,49,42,7,47
Berwick,4019,8,8,10,18,30,63,-33,34
Edinburgh Ci,4019,9,7,9,20,37,63,-26,30
Cowdenbeath,4019,10,4,10,22,24,56,-32,22
Montrose,4020,1,24,7,5,61,35,26,79
Peterhead,4020,2,24,4,8,81,41,40,76
Stenhousem'r,4020,3,16,8,12,57,47,10,56
Stirling,4020,4,16,6,14,61,53,8,54
Clyde,4020,5,15,9,12,53,49,4,54
Elgin,4020,6,14,6,16,54,62,-8,48
Annan Athlet,4020,7,11,12,13,48,42,6,45
Berwick,4020,8,8,10,18,30,60,-30,34
Edinburgh Ci,4020,9,7,9,20,39,64,-25,30
Cowdenbeath,4020,10,4,11,21,24,55,-31,23
Montrose,4021,1,24,7,5,60,34,26,79
Peterhead,4021,2,24,4,8,82,39,43,76
Stenhousem'r,4021,3,16,8,12,58,47,11,56
Stirling,4021,4,16,6,14,61,54,7,54
Clyde,4021,5,15,9,12,54,50,4,54
Elgin,4021,6,14,6,16,53,61,-8,48
Annan Athlet,4021,7,12,11,13,49,42,7,47
Berwick,4021,8,8,10,18,31,61,-30,34
Edinburgh Ci,4021,9,7,9,20,37,65,-28,30
Cowdenbeath,4021,10,4,10,22,24,56,-32,22
Peterhead,4022,1,24,4,8,79,38,41,76
Montrose,4022,2,23,7,6,60,37,23,76
Stenhousem'r,4022,3,16,8,12,57,47,10,56
Stirling,4022,4,16,6,14,61,53,8,54
Clyde,4022,5,14,9,13,52,50,2,51
Elgin,4022,6,15,6,15,56,61,-5,51
Annan Athlet,4022,7,11,12,13,47,41,6,45
Berwick,4022,8,9,10,17,31,59,-28,37
Edinburgh Ci,4022,9,7,9,20,36,62,-26,30
Cowdenbeath,4022,10,4,11,21,23,54,-31,23
Montrose,4023,1,24,7,5,69,35,34,79
Peterhead,4023,2,24,4,8,81,39,42,76
Stenhousem'r,4023,3,16,8,12,58,47,11,56
Stirling,4023,4,16,6,14,61,54,7,54
Clyde,4023,5,15,9,12,52,48,4,54
Elgin,4023,6,14,6,16,54,70,-16,48
Annan Athlet,4023,7,11,12,13,47,41,6,45
Berwick,4023,8,8,10,18,29,59,-30,34
Edinburgh Ci,4023,9,7,9,20,37,64,-27,30
Cowdenbeath,4023,10,4,11,21,23,54,-31,23
Montrose,4024,1,24,7,5,61,34,27,79
Peterhead,4024,2,24,4,8,85,38,47,76
Stirling,4024,3,17,6,13,64,53,11,57
Clyde,4024,4,15,9,12,52,48,4,54
Stenhousem'r,4024,5,15,8,13,57,50,7,53
Elgin,4024,6,14,6,16,53,62,-9,48
Annan Athlet,4024,7,11,12,13,48,42,6,45
Berwick,4024,8,8,10,18,29,59,-30,34
Edinburgh Ci,4024,9,7,9,20,36,68,-32,30
Cowdenbeath,4024,10,4,11,21,24,55,-31,23
Montrose,4025,1,23,7,6,59,36,23,76
Peterhead,4025,2,23,5,8,80,41,39,74
Stirling,4025,3,17,6,13,64,53,11,57
Stenhousem'r,4025,4,15,8,13,57,50,7,53
Clyde,4025,5,14,10,12,54,51,3,52
Elgin,4025,6,15,6,15,55,60,-5,51
Annan Athlet,4025,7,12,11,13,50,41,9,47
Berwick,4025,8,8,11,17,32,61,-29,35
Edinburgh Ci,4025,9,7,10,19,39,63,-24,31
Cowdenbeath,4025,10,4,10,22,23,57,-34,22
Peterhead,4026,1,24,4,8,80,39,41,76
Montrose,4026,2,23,7,6,60,36,24,76
Stirling,4026,3,16,7,13,60,51,9,55
Stenhousem'r,4026,4,15,9,12,55,46,9,54
Clyde,4026,5,15,9,12,55,49,6,54
Elgin,4026,6,15,6,15,55,61,-6,51
Annan Athlet,4026,7,12,11,13,49,42,7,47
Berwick,4026,8,8,10,18,30,62,-32,34
Edinburgh Ci,4026,9,7,9,20,37,63,-26,30
Cowdenbeath,4026,10,4,10,22,24,56,-32,22
Montrose,4027,1,24,7,5,65,34,31,79
Peterhead,4027,2,24,4,8,82,39,43,76
Stirling,4027,3,17,6,13,63,52,11,57
Stenhousem'r,4027,4,15,8,13,56,49,7,53
Clyde,4027,5,14,10,12,52,49,3,52
Elgin,4027,6,14,6,16,53,66,-13,48
Annan Athlet,4027,7,12,11,13,49,42,7,47
Berwick,4027,8,8,11,17,30,59,-29,35
Edinburgh Ci,4027,9,7,9,20,37,65,-28,30
Cowdenbeath,4027,10,4,10,22,24,56,-32,22
Montrose,4028,1,23,8,5,61,36,25,77
Peterhead,4028,2,24,4,8,82,39,43,76
Stirling,4028,3,17,6,13,62,51,11,57
Clyde,4028,4,15,9,12,55,48,7,54
Stenhousem'r,4028,5,15,8,13,55,48,7,53
Elgin,4028,6,14,7,15,55,62,-7,49
Annan Athlet,4028,7,12,11,13,48,41,7,47
Berwick,4028,8,8,10,18,29,62,-33,34
Edinburgh Ci,4028,9,7,9,20,37,65,-28,30
Cowdenbeath,4028,10,4,10,22,23,55,-32,22
Peterhead,4029,1,24,4,8,81,40,41,76
Montrose,4029,2,23,7,6,60,36,24,76
Stirling,4029,3,17,6,13,61,51,10,57
Clyde,4029,4,15,9,12,52,48,4,54
Stenhousem'r,4029,5,15,8,13,55,47,8,53
Elgin,4029,6,15,6,15,55,61,-6,51
Annan Athlet,4029,7,11,12,13,47,41,6,45
Berwick,4029,8,8,10,18,29,59,-30,34
Edinburgh Ci,4029,9,7,9,20,38,64,-26,30
Cowdenbeath,4029,10,4,11,21,23,54,-31,23
Montrose,4030,1,24,7,5,61,35,26,79
Peterhead,4030,2,23,4,9,77,39,38,73
Stirling,4030,3,17,6,13,64,54,10,57
Clyde,4030,4,15,9,12,54,48,6,54
Stenhousem'r,4030,5,15,8,13,58,50,8,53
Elgin,4030,6,14,6,16,54,62,-8,48
Annan Athlet,4030,7,12,11,13,49,41,8,47
Berwick,4030,8,8,10,18,29,61,-32,34
Edinburgh Ci,4030,9,8,9,19,37,60,-23,33
Cowdenbeath,4030,10,4,10,22,23,56,-33,22
Montrose,4031,1,23,8,5,60,35,25,77
Peterhead,4031,2,24,4,8,80,39,41,76
Stirling,4031,3,17,6,13,62,52,10,57
Clyde,4031,4,15,9,12,54,50,4,54
Stenhousem'r,4031,5,15,8,13,56,48,8,53
Elgin,4031,6,14,7,15,54,61,-7,49
Annan Athlet,4031,7,11,11,14,48,43,5,44
Berwick,4031,8,8,10,18,31,61,-30,34
Edinburgh Ci,4031,9,7,9,20,37,63,-26,30
Cowdenbeath,4031,10,5,10,21,25,55,-30,25
Montrose,4032,1,24,7,5,61,35,26,79
Peterhead,4032,2,24,4,8,80,38,42,76
Stirling,4032,3,16,7,13,62,53,9,55
Stenhousem'r,4032,4,15,9,12,57,48,9,54
Clyde,4032,5,14,10,12,52,49,3,52
Elgin,4032,6,14,6,16,54,62,-8,48
Annan Athlet,4032,7,12,11,13,51,42,9,47
Berwick,4032,8,8,11,17,30,59,-29,35
Edinburgh Ci,4032,9,7,9,20,36,63,-27,30
Cowdenbeath,4032,10,4,10,22,24,58,-34,22
Montrose,4033,1,24,7,5,61,35,26,79
Peterhead,4033,2,23,5,8,79,40,39,74
Stenhousem'r,4033,3,16,8,12,58,48,10,56
Stirling,4033,4,16,6,14,62,54,8,54
Clyde,4033,5,15,9,12,55,48,7,54
Elgin,4033,6,14,6,16,54,62,-8,48
Annan Athlet,4033,7,11,12,13,47,41,6,45
Berwick,4033,8,8,10,18,29,62,-33,34
Edinburgh Ci,4033,9,7,10,19,38,62,-24,31
Cowdenbeath,4033,10,4,11,21,23,54,-31,23
Montrose,4034,1,24,7,5,61,34,27,79
Peterhead,4034,2,24,4,8,81,39,42,76
Stenhousem'r,4034,3,16,8,12,58,48,10,56
Stirling,4034,4,16,6,14,62,54,8,54
Clyde,4034,5,14,9,13,51,49,2,51
Elgin,4034,6,14,6,16,53,62,-9,48
Annan Athlet,4034,7,11,11,14,47,42,5,44
Berwick,4034,8,9,10,17,30,58,-28,37
Edinburgh Ci,4034,9,7,9,20,37,64,-27,30
Cowdenbeath,4034,10,5,10,21,24,54,-30,25
Montrose,4035,1,24,7,5,61,34,27,79
Peterhead,4035,2,24,4,8,80,39,41,76
Stenhousem'r,4035,3,16,8,12,56,46,10,56
Stirling,4035,4,16,6,14,60,52,8,54
Clyde,4035,5,15,9,12,54,49,5,54
Elgin,4035,6,14,6,16,53,62,-9,48
Annan Athlet,4035,7,12,11,13,50,41,9,47
Berwick,4035,8,8,10,18,30,61,-31,34
Edinburgh Ci,4035,9,7,9,20,37,63,-26,30
Cowdenbeath,4035,10,4,10,22,23,57,-34,22
Montrose,4036,1,24,7,5,60,34,26,79
Peterhead,4036,2,24,4,8,78,38,40,76
Stirling,4036,3,17,6,13,61,51,10,57
Clyde,4036,4,15,9,12,52,48,4,54
Stenhousem'r,4036,5,15,8,13,55,47,8,53
Elgin,4036,6,14,6,16,53,61,-8,48
Annan Athlet,4036,7,11,12,13,48,42,6,45
Berwick,4036,8,8,10,18,29,59,-30,34
Edinburgh Ci,4036,9,7,9,20,36,61,-25,30
Cowdenbeath,4036,10,4,11,21,24,55,-31,23
Montrose,4037,1,23,8,5,62,37,25,77
Peterhead,4037,2,24,4,8,79,39,40,76
Stirling,4037,3,17,6,13,62,51,11,57
Clyde,4037,4,15,9,12,53,48,5,54
Stenhousem'r,4037,5,15,8,13,55,48,7,53
Elgin,4037,6,14,7,15,56,63,-7,49
Annan Athlet,4037,7,11,11,14,47,44,3,44
Berwick,4037,8,8,10,18,29,60,-31,34
Edinburgh Ci,4037,9,7,9,20,37,62,-25,30
Cowdenbeath,4037,10,5,10,21,26,54,-28,25
Montrose,4038,1,24,7,5,63,37,26,79
Peterhead,4038,2,24,4,8,79,38,41,76
Stirling,4038,3,17,6,13,63,53,10,57
Clyde,4038,4,15,9,12,53,48,5,54
Stenhousem'r,4038,5,15,8,13,57,49,8,53
Elgin,4038,6,14,6,16,56,64,-8,48
Annan Athlet,4038,7,11,11,14,48,43,5,44
Berwick,4038,8,8,10,18,29,60,-31,34
Edinburgh Ci,4038,9,7,9,20,36,62,-26,30
Cowdenbeath,4038,10,5,10,21,25,55,-30,25
Peterhead,4039,1,24,4,8,80,39,41,76
Montrose,4039,2,23,7,6,59,35,24,76
Stirling,4039,3,16,7,13,61,52,9,55
Stenhousem'r,4039,4,15,9,12,56,47,9,54
Clyde,4039,5,15,9,12,54,49,5,54
Elgin,4039,6,15,6,15,54,60,-6,51
Annan Athlet,4039,7,11,12,13,48,42,6,45
Berwick,4039,8,8,10,18,30,61,-31,34
Edinburgh Ci,4039,9,7,9,20,37,63,-26,30
Cowdenbeath,4039,10,4,11,21,24,55,-31,23
Montrose,4040,1,24,7,5,62,34,28,79
Peterhead,4040,2,24,4,8,80,39,41,76
Stirling,4040,3,16,7,13,62,53,9,55
Stenhousem'r,4040,4,15,9,12,57,48,9,54
Clyde,4040,5,14,10,12,52,49,3,52
Elgin,4040,6,14,6,16,53,63,-10,48
Annan Athlet,4040,7,12,11,13,48,41,7,47
Berwick,4040,8,8,11,17,30,59,-29,35
Edinburgh Ci,4040,9,7,9,20,37,63,-26,30
Cowdenbeath,4040,10,4,10,22,23,55,-32,22
Montrose,4041,1,23,8,5,60,35,25,77
Peterhead,4041,2,24,4,8,83,38,45,76
Stirling,4041,3,16,7,13,61,52,9,55
Stenhousem'r,4041,4,15,9,12,56,47,9,54
Clyde,4041,5,15,9,12,54,48,6,54
Elgin,4041,6,14,7,15,54,61,-7,49
Annan Athlet,4041,7,12,11,13,49,41,8,47
Berwick,4041,8,8,10,18,29,61,-32,34
Edinburgh Ci,4041,9,7,9,20,36,66,-30,30
Cowdenbeath,4041,10,4,10,22,23,56,-33,22
Montrose,4042,1,24,7,5,62,35,27,79
Peterhead,4042,2,24,4,8,80,38,42,76
Stirling,4042,3,17,6,13,62,51,11,57
Stenhousem'r,4042,4,15,8,13,55,48,7,53
Clyde,4042,5,14,10,12,52,49,3,52
Elgin,4042,6,14,6,16,54,63,-9,48
Annan Athlet,4042,7,11,12,13,49,43,6,45
Berwick,4042,8,8,11,17,30,59,-29,35
Edinburgh Ci,4042,9,7,9,20,36,63,-27,30
Cowdenbeath,4042,10,4,11,21,25,56,-31,23
Montrose,4043,1,24,7,5,60,34,26,79
Peterhead,4043,2,24,4,8,79,39,40,76
Stirling,4043,3,17,6,13,66,52,14,57
Stenhousem'r,4043,4,15,8,13,56,52,4,53
Clyde,4043,5,14,9,13,51,50,1,51
Elgin,4043,6,14,6,16,53,61,-8,48
Annan Athlet,4043,7,11,12,13,49,43,6,45
Berwick,4043,8,9,10,17,31,58,-27,37
Edinburgh Ci,4043,9,7,9,20,37,62,-25,30
Cowdenbeath,4043,10,4,11,21,25,56,-31,23
Montrose,4044,1,24,7,5,61,34,27,79
Peterhead,4044,2,23,5,8,77,38,39,74
Stirling,4044,3,17,6,13,63,51,12,57
Clyde,4044,4,15,9,12,54,49,5,54
Stenhousem'r,4044,5,15,8,13,55,49,6,53
Elgin,4044,6,14,6,16,53,62,-9,48
Annan Athlet,4044,7,11,12,13,47,41,6,45
Berwick,4044,8,8,10,18,30,61,-31,34
Edinburgh Ci,4044,9,7,10,19,36,60,-24,31
Cowdenbeath,4044,10,4,11,21,23,54,-31,23
Montrose,4045,1,23,8,5,60,35,25,77
Peterhead,4045,2,24,4,8,82,39,43,76
Stirling,4045,3,17,6,13,64,53,11,57
Stenhousem'r,4045,4,15,8,13,57,50,7,53
Clyde,4045,5,14,10,12,51,48,3,52
Elgin,4045,6,14,7,15,54,61,-7,49
Annan Athlet,4045,7,12,11,13,49,41,8,47
Berwick,4045,8,8,11,17,29,58,-29,35
Edinburgh Ci,4045,9,7,9,20,37,65,-28,30
Cowdenbeath,4045,10,4,10,22,23,56,-33,22
Montrose,4046,1,23,8,5,59,34,25,77
Peterhead,4046,2,23,4,9,77,39,38,73
Stirling,4046,3,16,7,13,61,52,9,55
Stenhousem'r,4046,4,15,9,12,56,47,9,54
Clyde,4046,5,15,9,12,54,48,6,54
Elgin,4046,6,14,7,15,53,60,-7,49
Annan Athlet,4046,7,12,11,13,48,41,7,47
Berwick,4046,8,8,10,18,29,61,-32,34
Edinburgh Ci,4046,9,8,9,19,37,60,-23,33
Cowdenbeath,4046,10,4,10,22,23,55,-32,22
Montrose,4047,1,23,8,5,62,37,25,77
Peterhead,4047,2,23,4,9,78,40,38,73
Stirling,4047,3,16,7,13,61,52,9,55
Stenhousem'r,4047,4,15,9,12,56,47,9,54
Clyde,4047,5,15,9,12,53,48,5,54
Elgin,4047,6,14,7,15,56,63,-7,49
Annan Athlet,4047,7,11,12,13,47,41,6,45
Berwick,4047,8,8,10,18,29,60,-31,34
Edinburgh Ci,4047,9,8,9,19,38,61,-23,33
Cowdenbeath,4047,10,4,11,21,23,54,-31,23
Peterhead,4048,1,24,4,8,80,38,42,76
Montrose,4048,2,23,7,6,61,38,23,76
Stenhousem'r,4048,3,16,8,12,56,46,10,56
Stirling,4048,4,16,6,14,60,52,8,54
Clyde,4048,5,14,9,13,53,51,2,51
Elgin,4048,6,15,6,15,57,62,-5,51
Annan Athlet,4048,7,12,11,13,49,41,8,47
Berwick,4048,8,9,10,17,32,60,-28,37
Edinburgh Ci,4048,9,7,9,20,36,63,-27,30
Cowdenbeath,4048,10,4,10,22,23,56,-33,22
Montrose,4049,1,23,8,5,59,34,25,77
Peterhead,4049,2,24,4,8,79,39,40,76
Stirling,4049,3,17,6,13,62,52,10,57
Stenhousem'r,4049,4,15,8,13,56,48,8,53
Clyde,4049,5,14,10,12,51,48,3,52
Elgin,4049,6,14,7,15,53,60,-7,49
Annan Athlet,4049,7,11,11,14,47,43,4,44
Berwick,4049,8,8,11,17,29,58,-29,35
Edinburgh Ci,4049,9,7,9,20,37,62,-25,30
Cowdenbeath,4049,10,5,10,21,25,54,-29,25
Montrose,4050,1,24,7,5,61,35,26,79
Peterhead,4050,2,24,4,8,80,38,42,76
Stirling,4050,3,17,6,13,61,51,10,57
Stenhousem'r,4050,4,15,8,13,55,47,8,53
Clyde,4050,5,14,9,13,51,50,1,51
Elgin,4050,6,14,6,16,54,62,-8,48
Annan Athlet,4050,7,11,12,13,48,42,6,45
Berwick,4050,8,9,10,17,31,58,-27,37
Edinburgh Ci,4050,9,7,9,20,36,63,-27,30
Cowdenbeath,4050,10,4,11,21,24,55,-31,23
Montrose,4051,1,23,8,5,60,35,25,77
Peterhead,4051,2,24,4,8,79,39,40,76
Stirling,4051,3,16,7,13,61,52,9,55
Stenhousem'r,4051,4,15,9,12,56,47,9,54
Clyde,4051,5,14,10,12,53,50,3,52
Elgin,4051,6,14,7,15,54,61,-7,49
Annan Athlet,4051,7,11,11,14,47,42,5,44
Berwick,4051,8,8,11,17,31,60,-29,35
Edinburgh Ci,4051,9,7,9,20,37,62,-25,30
Cowdenbeath,4051,10,5,10,21,24,54,-30,25
Montrose,4052,1,24,7,5,63,34,29,79
Peterhead,4052,2,24,4,8,80,38,42,76
Stenhousem'r,4052,3,16,8,12,56,46,10,56
Stirling,4052,4,16,6,14,60,52,8,54
Clyde,4052,5,15,9,12,54,50,4,54
Elgin,4052,6,14,6,16,53,64,-11,48
Annan Athlet,4052,7,11,11,14,48,43,5,44
Berwick,4052,8,8,10,18,31,61,-30,34
Edinburgh Ci,4052,9,7,9,20,36,63,-27,30
Cowdenbeath,4052,10,5,10,21,25,55,-30,25
Montrose,4053,1,24,7,5,63,35,28,79
Peterhead,4053,2,24,4,8,84,39,45,76
Stenhousem'r,4053,3,16,8,12,57,47,10,56
Stirling,4053,4,16,6,14,61,53,8,54
Clyde,4053,5,15,9,12,54,49,5,54
Elgin,4053,6,14,6,16,54,64,-10,48
Annan Athlet,4053,7,11,11,14,47,45,2,44
Berwick,4053,8,8,10,18,30,61,-31,34
Edinburgh Ci,4053,9,7,9,20,37,67,-30,30
Cowdenbeath,4053,10,5,10,21,27,54,-27,25
Montrose,4054,1,23,8,5,60,35,25,77
Peterhead,4054,2,23,4,9,79,41,38,73
Stirling,4054,3,16,7,13,61,52,9,55
Stenhousem'r,4054,4,15,9,12,56,47,9,54
Clyde,4054,5,15,9,12,55,50,5,54
Elgin,4054,6,14,7,15,54,61,-7,49
Annan Athlet,4054,7,11,12,13,47,41,6,45
Berwick,4054,8,8,10,18,31,62,-31,34
Edinburgh Ci,4054,9,8,9,19,39,62,-23,33
Cowdenbeath,4054,10,4,11,21,23,54,-31,23
Peterhead,4055,1,24,4,8,83,41,42,76
Montrose,4055,2,23,7,6,59,35,24,76
Stirling,4055,3,17,6,13,62,52,10,57
Clyde,4055,4,15,9,12,55,48,7,54
Stenhousem'r,4055,5,15,8,13,56,48,8,53
Elgin,4055,6,15,6,15,54,60,-6,51
Annan Athlet,4055,7,12,11,13,50,41,9,47
Berwick,4055,8,8,10,18,29,62,-33,34
Edinburgh Ci,4055,9,7,9,20,39,66,-27,30
Cowdenbeath,4055,10,4,10,22,23,57,-34,22
Montrose,4056,1,24,7,5,61,34,27,79
Peterhead,4056,2,24,4,8,80,38,42,76
Stirling,4056,3,16,7,13,62,53,9,55
Stenhousem'r,4056,4,15,9,12,57,48,9,54
Clyde,4056,5,15,9,12,52,48,4,54
Elgin,4056,6,14,6,16,53,62,-9,48
Annan Athlet,4056,7,11,12,13,47,41,6,45
Berwick,4056,8,8,10,18,29,59,-30,34
Edinburgh Ci,4056,9,7,9,20,36,63,-27,30
Cowdenbeath,4056,10,4,11,21,23,54,-31,23
Montrose,4057,1,24,7,5,60,34,26,79
Peterhead,4057,2,24,4,8,80,39,41,76
Stirling,4057,3,17,6,13,61,51,10,57
Stenhousem'r,4057,4,15,8,13,55,47,8,53
Clyde,4057,5,14,10,12,51,48,3,52
Elgin,4057,6,14,6,16,53,61,-8,48
Annan Athlet,4057,7,11,11,14,48,43,5,44
Berwick,4057,8,8,11,17,29,58,-29,35
Edinburgh Ci,4057,9,7,9,20,37,63,-26,30
Cowdenbeath,4057,10,5,10,21,25,55,-30,25
Montrose,4058,1,24,7,5,64,35,29,79
Peterhead,4058,2,24,4,8,79,39,40,76
Stenhousem'r,4058,3,16,8,12,57,47,10,56
Stirling,4058,4,16,6,14,61,53,8,54
Clyde,4058,5,15,9,12,54,48,6,54
Elgin,4058,6,14,6,16,54,65,-11,48
Annan Athlet,4058,7,11,12,13,48,42,6,45
Berwick,4058,8,8,10,18,29,61,-32,34
Edinburgh Ci,4058,9,7,9,20,37,62,-25,30
Cowdenbeath,4058,10,4,11,21,24,55,-31,23
Montrose,4059,1,23,8,5,59,34,25,77
Peterhead,4059,2,24,4,8,82,38,44,76
Stenhousem'r,4059,3,16,8,12,56,46,10,56
Stirling,4059,4,16,6,14,60,52,8,54
Clyde,4059,5,15,9,12,53,48,5,54
Elgin,4059,6,14,7,15,53,60,-7,49
Annan Athlet,4059,7,11,12,13,47,41,6,45
Berwick,4059,8,8,10,18,29,60,-31,34
Edinburgh Ci,4059,9,7,9,20,36,65,-29,30
Cowdenbeath,4059,10,4,11,21,23,54,-31,23
Montrose,4060,1,24,7,5,63,37,26,79
Peterhead,4060,2,24,4,8,79,38,41,76
Stirling,4060,3,16,7,13,60,51,9,55
Stenhousem'r,4060,4,15,9,12,55,46,9,54
Clyde,4060,5,14,9,13,52,50,2,51
Elgin,4060,6,14,6,16,56,64,-8,48
Annan Athlet,4060,7,12,11,13,48,41,7,47
Berwick,4060,8,9,10,17,31,59,-28,37
Edinburgh Ci,4060,9,7,9,20,36,62,-26,30
Cowdenbeath,4060,10,4,10,22,23,55,-32,22
Montrose,4061,1,24,7,5,62,36,26,79
Peterhead,4061,2,24,4,8,78,38,40,76
Stirling,4061,3,16,7,13,62,53,9,55
Stenhousem'r,4061,4,15,9,12,57,48,9,54
Clyde,4061,5,15,9,12,53,49,4,54
Elgin,4061,6,14,6,16,55,63,-8,48
Annan Athlet,4061,7,11,11,14,48,43,5,44
Berwick,4061,8,8,10,18,30,60,-30,34
Edinburgh Ci,4061,9,7,9,20,36,61,-25,30
Cowdenbeath,4061,10,5,10,21,25,55,-30,25
Montrose,4062,1,23,8,5,60,35,25,77
Peterhead,4062,2,23,4,9,77,39,38,73
Stirling,4062,3,17,6,13,66,51,15,57
Clyde,4062,4,15,9,12,54,48,6,54
Stenhousem'r,4062,5,15,8,13,55,52,3,53
Elgin,4062,6,14,7,15,54,61,-7,49
Annan Athlet,4062,7,12,11,13,48,41,7,47
Berwick,4062,8,8,10,18,29,61,-32,34
Edinburgh Ci,4062,9,8,9,19,37,60,-23,33
Cowdenbeath,4062,10,4,10,22,23,55,-32,22
Montrose,4063,1,24,7,5,61,34,27,79
Peterhead,4063,2,24,4,8,79,38,41,76
Stirling,4063,3,16,7,13,62,53,9,55
Stenhousem'r,4063,4,15,9,12,57,48,9,54
Clyde,4063,5,15,9,12,52,48,4,54
Elgin,4063,6,14,6,16,53,62,-9,48
Annan Athlet,4063,7,11,11,14,47,42,5,44
Berwick,4063,8,8,10,18,29,59,-30,34
Edinburgh Ci,4063,9,7,9,20,36,62,-26,30
Cowdenbeath,4063,10,5,10,21,24,54,-30,25
Montrose,4064,1,24,7,5,60,34,26,79
Peterhead,4064,2,23,4,9,77,39,38,73
Stirling,4064,3,17,6,13,63,52,11,57
Stenhousem'r,4064,4,15,8,13,56,49,7,53
Clyde,4064,5,14,10,12,53,50,3,52
Elgin,4064,6,14,6,16,53,61,-8,48
Annan Athlet,4064,7,11,12,13,47,41,6,45
Berwick,4064,8,8,11,17,31,60,-29,35
Edinburgh Ci,4064,9,8,9,19,37,60,-23,33
Cowdenbeath,4064,10,4,11,21,23,54,-31,23
Montrose,4065,1,24,7,5,62,34,28,79
Peterhead,4065,2,24,4,8,81,39,42,76
Stirling,4065,3,16,7,13,62,53,9,55
Stenhousem'r,4065,4,15,9,12,57,48,9,54
Clyde,4065,5,15,9,12,55,49,6,54
Elgin,4065,6,14,6,16,53,63,-10,48
Annan Athlet,4065,7,11,11,14,48,43,5,44
Berwick,4065,8,8,10,18,30,62,-32,34
Edinburgh Ci,4065,9,7,9,20,37,64,-27,30
Cowdenbeath,4065,10,5,10,21,25,55,-30,25
Montrose,4066,1,24,7,5,60,34,26,79
Peterhead,4066,2,24,4,8,80,39,41,76
Stenhousem'r,4066,3,16,8,12,59,48,11,56
Stirling,4066,4,16,6,14,62,55,7,54
Clyde,4066,5,14,10,12,51,48,3,52
Elgin,4066,6,14,6,16,53,61,-8,48
Annan Athlet,4066,7,12,11,13,48,41,7,47
Berwick,4066,8,8,11,17,29,58,-29,35
Edinburgh Ci,4066,9,7,9,20,37,63,-26,30
Cowdenbeath,4066,10,4,10,22,23,55,-32,22
Montrose,4067,1,23,7,6,60,36,24,76
Peterhead,4067,2,23,5,8,77,38,39,74
Stirling,4067,3,16,7,13,62,53,9,55
Stenhousem'r,4067,4,15,9,12,57,48,9,54
Clyde,4067,5,14,9,13,51,50,1,51
Elgin,4067,6,15,6,15,55,61,-6,51
Annan Athlet,4067,7,11,12,13,49,43,6,45
Berwick,4067,8,9,10,17,31,58,-27,37
Edinburgh Ci,4067,9,7,10,19,36,60,-24,31
Cowdenbeath,4067,10,4,11,21,25,56,-31,23
Montrose,4068,1,24,7,5,61,35,26,79
Peterhead,4068,2,24,4,8,83,38,45,76
Stirling,4068,3,17,6,13,62,51,11,57
Clyde,4068,4,15,9,12,52,48,4,54
Stenhousem'r,4068,5,15,8,13,55,48,7,53
Elgin,4068,6,14,6,16,54,62,-8,48
Annan Athlet,4068,7,11,11,14,47,42,5,44
Berwick,4068,8,8,10,18,29,59,-30,34
Edinburgh Ci,4068,9,7,9,20,36,66,-30,30
Cowdenbeath,4068,10,5,10,21,24,54,-30,25
Peterhead,4069,1,24,4,8,79,38,41,76
Montrose,4069,2,23,7,6,61,37,24,76
Stirling,4069,3,16,7,13,62,53,9,55
Stenhousem'r,4069,4,15,9,12,57,48,9,54
Clyde,4069,5,14,9,13,51,50,1,51
Elgin,4069,6,15,6,15,56,62,-6,51
Annan Athlet,4069,7,11,11,14,47,43,4,44
Berwick,4069,8,9,10,17,31,58,-27,37
Edinburgh Ci,4069,9,7,9,20,36,62,-26,30
Cowdenbeath,4069,10,5,10,21,25,54,-29,25
Montrose,4070,1,24,7,5,61,34,27,79
Peterhead,4070,2,23,5,8,80,41,39,74
Stirling,4070,3,17,6,13,62,51,11,57
Stenhousem'r,4070,4,15,8,13,55,48,7,53
Clyde,4070,5,14,10,12,51,48,3,52
Elgin,4070,6,14,6,16,53,62,-9,48
Annan Athlet,4070,7,11,12,13,47,41,6,45
Berwick,4070,8,8,11,17,29,58,-29,35
Edinburgh Ci,4070,9,7,10,19,39,63,-24,31
Cowdenbeath,4070,10,4,11,21,23,54,-31,23
Montrose,4071,1,24,7,5,62,35,27,79
Peterhead,4071,2,24,4,8,78,38,40,76
Stenhousem'r,4071,3,16,8,12,57,47,10,56
Stirling,4071,4,16,6,14,61,53,8,54
Clyde,4071,5,14,9,13,51,50,1,51
Elgin,4071,6,14,6,16,54,63,-9,48
Annan Athlet,4071,7,12,11,13,49,42,7,47
Berwick,4071,8,9,10,17,31,58,-27,37
Edinburgh Ci,4071,9,7,9,20,36,61,-25,30
Cowdenbeath,4071,10,4,10,22,24,56,-32,22
Montrose,4072,1,23,8,5,59,34,25,77
Peterhead,4072,2,23,5,8,77,38,39,74
Stirling,4072,3,17,6,13,63,53,10,57
Stenhousem'r,4072,4,15,8,13,57,49,8,53
Clyde,4072,5,14,9,13,51,50,1,51
Elgin,4072,6,14,7,15,53,60,-7,49
Annan Athlet,4072,7,12,11,13,49,42,7,47
Berwick,4072,8,9,10,17,31,58,-27,37
Edinburgh Ci,4072,9,7,10,19,36,60,-24,31
Cowdenbeath,4072,10,4,10,22,24,56,-32,22
Montrose,4073,1,23,8,5,60,35,25,77
Peterhead,4073,2,24,4,8,80,40,40,76
Stenhousem'r,4073,3,16,8,12,58,48,10,56
Stirling,4073,4,16,6,14,62,54,8,54
Clyde,4073,5,15,9,12,55,50,5,54
Elgin,4073,6,14,7,15,54,61,-7,49
Annan Athlet,4073,7,12,11,13,48,41,7,47
Berwick,4073,8,8,10,18,31,62,-31,34
Edinburgh Ci,4073,9,7,9,20,38,63,-25,30
Cowdenbeath,4073,10,4,10,22,23,55,-32,22
Montrose,4074,1,24,7,5,61,35,26,79
Peterhead,4074,2,24,4,8,79,39,40,76
Stenhousem'r,4074,3,16,8,12,59,48,11,56
Stirling,4074,4,16,6,14,62,55,7,54
Clyde,4074,5,14,9,13,51,49,2,51
Elgin,4074,6,14,6,16,54,62,-8,48
Annan Athlet,4074,7,11,11,14,47,43,4,44
Berwick,4074,8,9,10,17,30,58,-28,37
Edinburgh Ci,4074,9,7,9,20,37,62,-25,30
Cowdenbeath,4074,10,5,10,21,25,54,-29,25
Montrose,4075,1,23,8,5,60,35,25,77
Peterhead,4075,2,24,4,8,82,39,43,76
Stirling,4075,3,17,6,13,61,51,10,57
Stenhousem'r,4075,4,15,8,13,55,47,8,53
Clyde,4075,5,14,9,13,51,49,2,51
Elgin,4075,6,14,7,15,54,61,-7,49
Annan Athlet,4075,7,12,11,13,48,41,7,47
Berwick,4075,8,9,10,17,30,58,-28,37
Edinburgh Ci,4075,9,7,9,20,37,65,-28,30
Cowdenbeath,4075,10,4,10,22,23,55,-32,22
Montrose,4076,1,24,7,5,63,35,28,79
Peterhead,4076,2,24,4,8,81,41,40,76
Stirling,4076,3,17,6,13,63,53,10,57
Stenhousem'r,4076,4,15,8,13,57,49,8,53
Clyde,4076,5,14,9,13,52,50,2,51
Elgin,4076,6,14,6,16,54,64,-10,48
Annan Athlet,4076,7,11,12,13,47,41,6,45
Berwick,4076,8,9,10,17,31,59,-28,37
Edinburgh Ci,4076,9,7,9,20,39,64,-25,30
Cowdenbeath,4076,10,4,11,21,23,54,-31,23
Montrose,4077,1,23,8,5,60,35,25,77
Peterhead,4077,2,24,4,8,79,39,40,76
Stirling,4077,3,17,6,13,63,51,12,57
Clyde,4077,4,15,9,12,56,49,7,54
Stenhousem'r,4077,5,15,8,13,55,49,6,53
Elgin,4077,6,14,7,15,54,61,-7,49
Annan Athlet,4077,7,11,11,14,47,42,5,44
Berwick,4077,8,8,10,18,30,63,-33,34
Edinburgh Ci,4077,9,7,9,20,37,62,-25,30
Cowdenbeath,4077,10,5,10,21,24,54,-30,25
Montrose,4078,1,24,7,5,61,35,26,79
Peterhead,4078,2,24,4,8,78,38,40,76
Stirling,4078,3,17,6,13,62,52,10,57
Clyde,4078,4,15,9,12,52,48,4,54
Stenhousem'r,4078,5,15,8,13,56,48,8,53
Elgin,4078,6,14,6,16,54,62,-8,48
Annan Athlet,4078,7,11,12,13,48,42,6,45
Berwick,4078,8,8,10,18,29,59,-30,34
Edinburgh Ci,4078,9,7,9,20,36,61,-25,30
Cowdenbeath,4078,10,4,11,21,24,55,-31,23
Montrose,4079,1,24,7,5,62,34,28,79
Peterhead,4079,2,23,5,8,78,39,39,74
Stirling,4079,3,17,6,13,62,52,10,57
Clyde,4079,4,15,9,12,52,48,4,54
Stenhousem'r,4079,5,15,8,13,56,48,8,53
Elgin,4079,6,14,6,16,53,63,-10,48
Annan Athlet,4079,7,11,12,13,47,41,6,45
Berwick,4079,8,8,10,18,29,59,-30,34
Edinburgh Ci,4079,9,7,10,19,37,61,-24,31
Cowdenbeath,4079,10,4,11,21,23,54,-31,23
Montrose,4080,1,23,8,5,60,35,25,77
Peterhead,4080,2,24,4,8,79,39,40,76
Stirling,4080,3,17,6,13,64,51,13,57
Clyde,4080,4,15,9,12,53,48,5,54
Stenhousem'r,4080,5,15,8,13,55,50,5,53
Elgin,4080,6,14,7,15,54,61,-7,49
Annan Athlet,4080,7,11,12,13,48,42,6,45
Berwick,4080,8,8,10,18,29,60,-31,34
Edinburgh Ci,4080,9,7,9,20,37,62,-25,30
Cowdenbeath,4080,10,4,11,21,24,55,-31,23
Montrose,4081,1,24,7,5,61,35,26,79
Peterhead,4081,2,23,4,9,77,39,38,73
Stirling,4081,3,17,6,13,62,52,10,57
Clyde,4081,4,15,9,12,54,48,6,54
Stenhousem'r,4081,5,15,8,13,56,48,8,53
Elgin,4081,6,14,6,16,54,62,-8,48
Annan Athlet,4081,7,11,12,13,49,43,6,45
Berwick,4081,8,8,10,18,29,61,-32,34
Edinburgh Ci,4081,9,8,9,19,37,60,-23,33
Cowdenbeath,4081,10,4,11,21,25,56,-31,23
Montrose,4082,1,24,7,5,61,34,27,79
Peterhead,4082,2,24,4,8,79,39,40,76
Stirling,4082,3,17,6,13,65,53,12,57
Clyde,4082,4,15,9,12,52,48,4,54
Stenhousem'r,4082,5,15,8,13,57,51,6,53
Elgin,4082,6,14,6,16,53,62,-9,48
Annan Athlet,4082,7,12,11,13,49,42,7,47
Berwick,4082,8,8,10,18,29,59,-30,34
Edinburgh Ci,4082,9,7,9,20,37,62,-25,30
Cowdenbeath,4082,10,4,10,22,24,56,-32,22
Montrose,4083,1,24,7,5,61,34,27,79
Peterhead,4083,2,24,4,8,83,38,45,76
Stirling,4083,3,16,7,13,63,54,9,55
Stenhousem'r,4083,4,15,9,12,58,49,9,54
Clyde,4083,5,14,10,12,52,49,3,52
Elgin,4083,6,14,6,16,53,62,-9,48
Annan Athlet,4083,7,11,11,14,49,45,4,44
Berwick,4083,8,8,11,17,30,59,-29,35
Edinburgh Ci,4083,9,7,9,20,36,66,-30,30
Cowdenbeath,4083,10,5,10,21,27,56,-29,25
Montrose,4084,1,24,7,5,63,35,28,79
Peterhead,4084,2,24,4,8,81,39,42,76
Stirling,4084,3,16,7,13,61,52,9,55
Stenhousem'r,4084,4,15,9,12,56,47,9,54
Clyde,4084,5,14,9,13,53,51,2,51
Elgin,4084,6,14,6,16,54,64,-10,48
Annan Athlet,4084,7,11,11,14,47,44,3,44
Berwick,4084,8,9,10,17,32,60,-28,37
Edinburgh Ci,4084,9,7,9,20,37,64,-27,30
Cowdenbeath,4084,10,5,10,21,26,54,-28,25
Montrose,4085,1,24,7,5,62,36,26,79
Peterhead,4085,2,24,4,8,80,38,42,76
Stenhousem'r,4085,3,16,8,12,59,48,11,56
Stirling,4085,4,16,6,14,62,55,7,54
Clyde,4085,5,15,9,12,53,49,4,54
Elgin,4085,6,14,6,16,55,63,-8,48
Annan Athlet,4085,7,12,11,13,49,42,7,47
Berwick,4085,8,8,10,18,30,60,-30,34
Edinburgh Ci,4085,9,7,9,20,36,63,-27,30
Cowdenbeath,4085,10,4,10,22,24,56,-32,22
Montrose,4086,1,23,8,5,59,34,25,77
Peterhead,4086,2,23,5,8,78,39,39,74
Stenhousem'r,4086,3,16,8,12,57,47,10,56
Stirling,4086,4,16,6,14,61,53,8,54
Clyde,4086,5,15,9,12,55,48,7,54
Elgin,4086,6,14,7,15,53,60,-7,49
Annan Athlet,4086,7,12,11,13,49,42,7,47
Berwick,4086,8,8,10,18,29,62,-33,34
Edinburgh Ci,4086,9,7,10,19,37,61,-24,31
Cowdenbeath,4086,10,4,10,22,24,56,-32,22
Montrose,4087,1,24,7,5,60,34,26,79
Peterhead,4087,2,24,4,8,81,39,42,76
Stenhousem'r,4087,3,16,8,12,58,47,11,56
Stirling,4087,4,16,6,14,61,54,7,54
Clyde,4087,5,14,10,12,51,48,3,52
Elgin,4087,6,14,6,16,53,61,-8,48
Annan Athlet,4087,7,11,11,14,47,43,4,44
Berwick,4087,8,8,11,17,29,58,-29,35
Edinburgh Ci,4087,9,7,9,20,37,64,-27,30
Cowdenbeath,4087,10,5,10,21,25,54,-29,25
Montrose,4088,1,24,7,5,61,34,27,79
Peterhead,4088,2,24,4,8,80,39,41,76
Stenhousem'r,4088,3,16,8,12,58,48,10,56
Stirling,4088,4,16,6,14,62,54,8,54
Clyde,4088,5,14,9,13,51,49,2,51
Elgin,4088,6,14,6,16,53,62,-9,48
Annan Athlet,4088,7,11,12,13,48,42,6,45
Berwick,4088,8,9,10,17,30,58,-28,37
Edinburgh Ci,4088,9,7,9,20,37,63,-26,30
Cowdenbeath,4088,10,4,11,21,24,55,-31,23
Montrose,4089,1,24,7,5,65,35,30,79
Peterhead,4089,2,24,4,8,79,38,41,76
Stenhousem'r,4089,3,16,8,12,58,47,11,56
Stirling,4089,4,16,6,14,61,54,7,54
Clyde,4089,5,15,9,12,54,49,5,54
Elgin,4089,6,14,6,16,54,66,-12,48
Annan Athlet,4089,7,12,11,13,50,42,8,47
Berwick,4089,8,8,10,18,30,61,-31,34
Edinburgh Ci,4089,9,7,9,20,36,62,-26,30
Cowdenbeath,4089,10,4,10,22,24,57,-33,22
Montrose,4090,1,23,8,5,59,34,25,77
Peterhead,4090,2,23,5,8,78,39,39,74
Stenhousem'r,4090,3,16,8,12,59,47,12,56
Stirling,4090,4,16,6,14,61,55,6,54
Clyde,4090,5,15,9,12,52,48,4,54
Elgin,4090,6,14,7,15,53,60,-7,49
Annan Athlet,4090,7,11,12,13,48,42,6,45
Berwick,4090,8,8,10,18,29,59,-30,34
Edinburgh Ci,4090,9,7,10,19,37,61,-24,31
Cowdenbeath,4090,10,4,11,21,24,55,-31,23
Peterhead,4091,1,24,4,8,81,38,43,76
Montrose,4091,2,23,7,6,60,37,23,76
Stenhousem'r,4091,3,16,8,12,56,46,10,56
Stirling,4091,4,16,6,14,60,52,8,54
Clyde,4091,5,14,10,12,52,49,3,52
Elgin,4091,6,15,6,15,56,61,-5,51
Annan Athlet,4091,7,11,12,13,47,41,6,45
Berwick,4091,8,8,11,17,30,59,-29,35
Edinburgh Ci,4091,9,7,9,20,36,64,-28,30
Cowdenbeath,4091,10,4,11,21,23,54,-31,23
Montrose,4092,1,24,7,5,60,34,26,79
Peterhead,4092,2,23,5,8,77,38,39,74
Stirling,4092,3,17,6,13,61,51,10,57
Stenhousem'r,4092,4,15,8,13,55,47,8,53
Clyde,4092,5,14,10,12,55,52,3,52
Elgin,4092,6,14,6,16,53,61,-8,48
Annan Athlet,4092,7,11,12,13,49,43,6,45
Berwick,4092,8,8,11,17,33,62,-29,35
Edinburgh Ci,4092,9,7,10,19,36,60,-24,31
Cowdenbeath,4092,10,4,11,21,25,56,-31,23
Montrose,4093,1,24,7,5,61,35,26,79
Peterhead,4093,2,23,4,9,78,40,38,73
Stenhousem'r,4093,3,16,8,12,58,48,10,56
Stirling,4093,4,16,6,14,62,54,8,54
Clyde,4093,5,14,10,12,52,49,3,52
Elgin,4093,6,14,6,16,54,62,-8,48
Annan Athlet,4093,7,11,11,14,48,43,5,44
Berwick,4093,8,8,11,17,30,59,-29,35
Edinburgh Ci,4093,9,8,9,19,38,61,-23,33
Cowdenbeath,4093,10,5,10,21,25,55,-30,25
Montrose,4094,1,23,8,5,60,35,25,77
Peterhead,4094,2,23,4,9,77,39,38,73
Stirling,4094,3,17,6,13,61,51,10,57
Stenhousem'r,4094,4,15,8,13,55,47,8,53
Clyde,4094,5,14,9,13,54,52,2,51
Elgin,4094,6,14,7,15,54,61,-7,49
Annan Athlet,4094,7,11,11,14,47,42,5,44
Berwick,4094,8,9,10,17,33,61,-28,37
Edinburgh Ci,4094,9,8,9,19,37,60,-23,33
Cowdenbeath,4094,10,5,10,21,24,54,-30,25
Montrose,4095,1,23,8,5,59,34,25,77
Peterhead,4095,2,23,4,9,79,41,38,73
Stenhousem'r,4095,3,16,8,12,58,48,10,56
Stirling,4095,4,16,6,14,62,54,8,54
Clyde,4095,5,14,9,13,53,51,2,51
Elgin,4095,6,14,7,15,53,60,-7,49
Annan Athlet,4095,7,11,11,14,47,42,5,44
Berwick,4095,8,9,10,17,32,60,-28,37
Edinburgh Ci,4095,9,8,9,19,39,62,-23,33
Cowdenbeath,4095,10,5,10,21,24,54,-30,25
Peterhead,4096,1,24,4,8,80,38,42,76
Montrose,4096,2,23,7,6,59,35,24,76
Stirling,4096,3,17,6,13,62,51,11,57
Stenhousem'r,4096,4,15,8,13,55,48,7,53
Clyde,4096,5,14,9,13,52,50,2,51
Elgin,4096,6,15,6,15,54,60,-6,51
Annan Athlet,4096,7,12,11,13,49,42,7,47
Berwick,4096,8,9,10,17,31,59,-28,37
Edinburgh Ci,4096,9,7,9,20,36,63,-27,30
Cowdenbeath,4096,10,4,10,22,24,56,-32,22
Montrose,4097,1,23,8,5,60,35,25,77
Peterhead,4097,2,24,4,8,81,38,43,76
Stirling,4097,3,17,6,13,66,51,15,57
Clyde,4097,4,15,9,12,53,48,5,54
Stenhousem'r,4097,5,15,8,13,55,52,3,53
Elgin,4097,6,14,7,15,54,61,-7,49
Annan Athlet,4097,7,11,11,14,47,42,5,44
Berwick,4097,8,8,10,18,29,60,-31,34
Edinburgh Ci,4097,9,7,9,20,36,64,-28,30
Cowdenbeath,4097,10,5,10,21,24,54,-30,25
Montrose,4098,1,23,8,5,61,36,25,77
Peterhead,4098,2,24,4,8,79,38,41,76
Stirling,4098,3,17,6,13,62,52,10,57
Stenhousem'r,4098,4,15,8,13,56,48,8,53
Clyde,4098,5,14,9,13,52,51,1,51
Elgin,4098,6,14,7,15,55,62,-7,49
Annan Athlet,4098,7,12,11,13,48,41,7,47
Berwick,4098,8,9,10,17,32,59,-27,37
Edinburgh Ci,4098,9,7,9,20,36,62,-26,30
Cowdenbeath,4098,10,4,10,22,23,55,-32,22
Montrose,4099,1,24,7,5,62,35,27,79
Peterhead,4099,2,23,4,9,77,39,38,73
Stirling,4099,3,17,6,13,64,52,12,57
Clyde,4099,4,15,9,12,54,48,6,54
Stenhousem'r,4099,5,15,8,13,56,50,6,53
Elgin,4099,6,14,6,16,54,63,-9,48
Annan Athlet,4099,7,11,12,13,48,42,6,45
Berwick,4099,8,8,10,18,29,61,-32,34
Edinburgh Ci,4099,9,8,9,19,37,60,-23,33
Cowdenbeath,4099,10,4,11,21,24,55,-31,23
Montrose,4100,1,23,8,5,59,34,25,77
Peterhead,4100,2,23,5,8,78,39,39,74
Stirling,4100,3,17,6,13,61,51,10,57
Clyde,4100,4,15,9,12,53,49,4,54
Stenhousem'r,4100,5,15,8,13,55,47,8,53
Elgin,4100,6,14,7,15,53,60,-7,49
Annan Athlet,4100,7,11,11,14,47,42,5,44
Berwick,4100,8,8,10,18,30,60,-30,34
Edinburgh Ci,4100,9,7,10,19,37,61,-24,31
Cowdenbeath,4100,10,5,10,21,24,54,-30,25
Montrose,4101,1,23,8,5,60,35,25,77
Peterhead,4101,2,24,4,8,81,38,43,76
Stirling,4101,3,17,6,13,63,51,12,57
Stenhousem'r,4101,4,15,8,13,55,49,6,53
Clyde,4101,5,14,10,12,52,49,3,52
Elgin,4101,6,14,7,15,54,61,-7,49
Annan Athlet,4101,7,12,11,13,48,41,7,47
Berwick,4101,8,8,11,17,30,59,-29,35
Edinburgh Ci,4101,9,7,9,20,36,64,-28,30
Cowdenbeath,4101,10,4,10,22,23,55,-32,22
Montrose,4102,1,24,7,5,64,34,30,79
Peterhead,4102,2,24,4,8,81,38,43,76
Stirling,4102,3,17,6,13,61,51,10,57
Clyde,4102,4,15,9,12,53,48,5,54
Stenhousem'r,4102,5,15,8,13,55,47,8,53
Elgin,4102,6,14,6,16,53,65,-12,48
Annan Athlet,4102,7,12,11,13,48,41,7,47
Berwick,4102,8,8,10,18,29,60,-31,34
Edinburgh Ci,4102,9,7,9,20,36,64,-28,30
Cowdenbeath,4102,10,4,10,22,23,55,-32,22
Montrose,4103,1,24,7,5,64,35,29,79
Peterhead,4103,2,24,4,8,80,40,40,76
Stirling,4103,3,17,6,13,62,52,10,57
Clyde,4103,4,15,9,12,55,48,7,54
Stenhousem'r,4103,5,15,8,13,56,48,8,53
Elgin,4103,6,14,6,16,54,65,-11,48
Annan Athlet,4103,7,12,11,13,50,43,7,47
Berwick,4103,8,8,10,18,29,62,-33,34
Edinburgh Ci,4103,9,7,9,20,38,63,-25,30
Cowdenbeath,4103,10,4,10,22,25,57,-32,22
Montrose,4104,1,24,7,5,62,34,28,79
Peterhead,4104,2,24,4,8,80,40,40,76
Stirling,4104,3,16,7,13,63,54,9,55
Stenhousem'r,4104,4,15,9,12,58,49,9,54
Clyde,4104,5,15,9,12,52,48,4,54
Elgin,4104,6,14,6,16,53,63,-10,48
Annan Athlet,4104,7,11,11,14,47,43,4,44
Berwick,4104,8,8,10,18,29,59,-30,34
Edinburgh Ci,4104,9,7,9,20,38,63,-25,30
Cowdenbeath,4104,10,5,10,21,25,54,-29,25
Montrose,4105,1,23,7,6,62,38,24,76
Peterhead,4105,2,23,4,9,78,41,37,73
Stirling,4105,3,16,7,13,61,52,9,55
Stenhousem'r,4105,4,15,9,12,56,47,9,54
Clyde,4105,5,14,9,13,52,51,1,51
Elgin,4105,6,15,6,15,57,63,-6,51
Annan Athlet,4105,7,11,12,13,48,42,6,45
Berwick,4105,8,9,10,17,32,59,-27,37
Edinburgh Ci,4105,9,8,9,19,39,61,-22,33
Cowdenbeath,4105,10,4,11,21,24,55,-31,23
Montrose,4106,1,24,7,5,62,34,28,79
Peterhead,4106,2,24,4,8,80,39,41,76
Stirling,4106,3,16,7,13,64,55,9,55
Stenhousem'r,4106,4,15,9,12,59,50,9,54
Clyde,4106,5,14,9,13,51,50,1,51
Elgin,4106,6,14,6,16,53,63,-10,48
Annan Athlet,4106,7,12,11,13,49,41,8,47
Berwick,4106,8,9,10,17,31,58,-27,37
Edinburgh Ci,4106,9,7,9,20,37,63,-26,30
Cowdenbeath,4106,10,4,10,22,23,56,-33,22
Montrose,4107,1,24,7,5,61,35,26,79
Peterhead,4107,2,24,4,8,80,38,42,76
Stirling,4107,3,16,7,13,60,51,9,55
Stenhousem'r,4107,4,15,9,12,55,46,9,54
Clyde,4107,5,14,10,12,52,49,3,52
Elgin,4107,6,14,6,16,54,62,-8,48
Annan Athlet,4107,7,11,12,13,47,41,6,45
Berwick,4107,8,8,11,17,30,59,-29,35
Edinburgh Ci,4107,9,7,9,20,36,63,-27,30
Cowdenbeath,4107,10,4,11,21,23,54,-31,23
Montrose,4108,1,24,7,5,62,36,26,79
Peterhead,4108,2,24,4,8,80,40,40,76
Stenhousem'r,4108,3,16,8,12,59,48,11,56
Stirling,4108,4,16,6,14,62,55,7,54
Clyde,4108,5,14,10,12,52,49,3,52
Elgin,4108,6,14,6,16,55,63,-8,48
Annan Athlet,4108,7,12,11,13,48,41,7,47
Berwick,4108,8,8,11,17,30,59,-29,35
Edinburgh Ci,4108,9,7,9,20,38,63,-25,30
Cowdenbeath,4108,10,4,10,22,23,55,-32,22
Montrose,4109,1,24,7,5,60,34,26,79
Peterhead,4109,2,24,4,8,82,38,44,76
Stirling,4109,3,16,7,13,62,53,9,55
Stenhousem'r,4109,4,15,9,12,57,48,9,54
Clyde,4109,5,15,9,12,55,49,6,54
Elgin,4109,6,14,6,16,53,61,-8,48
Annan Athlet,4109,7,11,11,14,47,42,5,44
Berwick,4109,8,8,10,18,30,62,-32,34
Edinburgh Ci,4109,9,7,9,20,36,65,-29,30
Cowdenbeath,4109,10,5,10,21,24,54,-30,25
Montrose,4110,1,24,7,5,62,35,27,79
Peterhead,4110,2,24,4,8,83,39,44,76
Stirling,4110,3,17,6,13,65,52,13,57
Clyde,4110,4,15,9,12,55,48,7,54
Stenhousem'r,4110,5,15,8,13,56,51,5,53
Elgin,4110,6,14,6,16,54,63,-9,48
Annan Athlet,4110,7,12,11,13,49,42,7,47
Berwick,4110,8,8,10,18,29,62,-33,34
Edinburgh Ci,4110,9,7,9,20,37,66,-29,30
Cowdenbeath,4110,10,4,10,22,24,56,-32,22
Montrose,4111,1,23,8,5,61,36,25,77
Peterhead,4111,2,23,5,8,78,39,39,74
Stirling,4111,3,17,6,13,61,51,10,57
Clyde,4111,4,15,9,12,54,50,4,54
Stenhousem'r,4111,5,15,8,13,55,47,8,53
Elgin,4111,6,14,7,15,55,62,-7,49
Annan Athlet,4111,7,12,11,13,49,41,8,47
Berwick,4111,8,8,10,18,31,61,-30,34
Edinburgh Ci,4111,9,7,10,19,37,61,-24,31
Cowdenbeath,4111,10,4,10,22,23,56,-33,22
Montrose,4112,1,24,7,5,60,34,26,79
Peterhead,4112,2,24,4,8,80,38,42,76
Stirling,4112,3,17,6,13,62,52,10,57
Clyde,4112,4,15,9,12,53,49,4,54
Stenhousem'r,4112,5,15,8,13,56,48,8,53
Elgin,4112,6,14,6,16,53,61,-8,48
Annan Athlet,4112,7,12,11,13,49,41,8,47
Berwick,4112,8,8,10,18,30,60,-30,34
Edinburgh Ci,4112,9,7,9,20,36,63,-27,30
Cowdenbeath,4112,10,4,10,22,23,56,-33,22
Montrose,4113,1,24,7,5,62,34,28,79
Peterhead,4113,2,24,4,8,79,39,40,76
Stirling,4113,3,17,6,13,62,52,10,57
Stenhousem'r,4113,4,15,8,13,56,48,8,53
Clyde,4113,5,14,10,12,51,48,3,52
Elgin,4113,6,14,6,16,53,63,-10,48
Annan Athlet,4113,7,11,11,14,48,44,4,44
Berwick,4113,8,8,11,17,29,58,-29,35
Edinburgh Ci,4113,9,7,9,20,37,62,-25,30
Cowdenbeath,4113,10,5,10,21,26,55,-29,25
Montrose,4114,1,23,8,5,60,35,25,77
Peterhead,4114,2,24,4,8,79,39,40,76
Stenhousem'r,4114,3,16,8,12,57,47,10,56
Stirling,4114,4,16,6,14,61,53,8,54
Clyde,4114,5,14,10,12,51,48,3,52
Elgin,4114,6,14,7,15,54,61,-7,49
Annan Athlet,4114,7,11,11,14,47,42,5,44
Berwick,4114,8,8,11,17,29,58,-29,35
Edinburgh Ci,4114,9,7,9,20,37,62,-25,30
Cowdenbeath,4114,10,5,10,21,24,54,-30,25
Peterhead,4115,1,24,4,8,79,38,41,76
Montrose,4115,2,23,7,6,60,37,23,76
Stirling,4115,3,16,7,13,61,52,9,55
Stenhousem'r,4115,4,15,9,12,56,47,9,54
Clyde,4115,5,15,9,12,53,49,4,54
Elgin,4115,6,15,6,15,56,61,-5,51
Annan Athlet,4115,7,11,12,13,47,41,6,45
Berwick,4115,8,8,10,18,30,60,-30,34
Edinburgh Ci,4115,9,7,9,20,36,62,-26,30
Cowdenbeath,4115,10,4,11,21,23,54,-31,23
Montrose,4116,1,24,7,5,62,35,27,79
Peterhead,4116,2,24,4,8,81,39,42,76
Stirling,4116,3,17,6,13,63,51,12,57
Stenhousem'r,4116,4,15,8,13,55,49,6,53
Clyde,4116,5,14,9,13,52,50,2,51
Elgin,4116,6,14,6,16,54,63,-9,48
Annan Athlet,4116,7,11,12,13,48,42,6,45
Berwick,4116,8,9,10,17,31,59,-28,37
Edinburgh Ci,4116,9,7,9,20,37,64,-27,30
Cowdenbeath,4116,10,4,11,21,24,55,-31,23
Montrose,4117,1,24,7,5,61,35,26,79
Peterhead,4117,2,24,4,8,81,39,42,76
Stenhousem'r,4117,3,16,8,12,59,48,11,56
Stirling,4117,4,16,6,14,62,55,7,54
Clyde,4117,5,14,9,13,52,50,2,51
Elgin,4117,6,14,6,16,54,62,-8,48
Annan Athlet,4117,7,11,11,14,47,42,5,44
Berwick,4117,8,9,10,17,31,59,-28,37
Edinburgh Ci,4117,9,7,9,20,37,64,-27,30
Cowdenbeath,4117,10,5,10,21,24,54,-30,25
Montrose,4118,1,24,7,5,61,34,27,79
Peterhead,4118,2,23,5,8,78,39,39,74
Stirling,4118,3,17,6,13,63,51,12,57
Stenhousem'r,4118,4,15,8,13,55,49,6,53
Clyde,4118,5,14,9,13,52,51,1,51
Elgin,4118,6,14,6,16,53,62,-9,48
Annan Athlet,4118,7,11,11,14,48,44,4,44
Berwick,4118,8,9,10,17,32,59,-27,37
Edinburgh Ci,4118,9,7,10,19,37,61,-24,31
Cowdenbeath,4118,10,5,10,21,26,55,-29,25
Montrose,4119,1,23,8,5,59,34,25,77
Peterhead,4119,2,24,4,8,79,39,40,76
Stirling,4119,3,17,6,13,62,51,11,57
Stenhousem'r,4119,4,15,8,13,55,48,7,53
Clyde,4119,5,14,10,12,52,49,3,52
Elgin,4119,6,14,7,15,53,60,-7,49
Annan Athlet,4119,7,11,12,13,49,43,6,45
Berwick,4119,8,8,11,17,30,59,-29,35
Edinburgh Ci,4119,9,7,9,20,37,62,-25,30
Cowdenbeath,4119,10,4,11,21,25,56,-31,23
Montrose,4120,1,24,7,5,63,37,26,79
Peterhead,4120,2,24,4,8,79,38,41,76
Stirling,4120,3,17,6,13,63,52,11,57
Stenhousem'r,4120,4,15,8,13,56,49,7,53
Clyde,4120,5,14,10,12,54,51,3,52
Elgin,4120,6,14,6,16,56,64,-8,48
Annan Athlet,4120,7,11,11,14,47,46,1,44
Berwick,4120,8,8,11,17,32,61,-29,35
Edinburgh Ci,4120,9,7,9,20,36,62,-26,30
Cowdenbeath,4120,10,5,10,21,28,54,-26,25
Montrose,4121,1,24,7,5,62,36,26,79
Peterhead,4121,2,24,4,8,83,40,43,76
Stirling,4121,3,16,7,13,63,54,9,55
Stenhousem'r,4121,4,15,9,12,58,49,9,54
Clyde,4121,5,15,9,12,55,49,6,54
Elgin,4121,6,14,6,16,55,63,-8,48
Annan Athlet,4121,7,11,12,13,48,42,6,45
Berwick,4121,8,8,10,18,30,62,-32,34
Edinburgh Ci,4121,9,7,9,20,38,66,-28,30
Cowdenbeath,4121,10,4,11,21,24,55,-31,23
Montrose,4122,1,24,7,5,60,34,26,79
Peterhead,4122,2,24,4,8,79,39,40,76
Stenhousem'r,4122,3,16,8,12,59,46,13,56
Clyde,4122,4,15,9,12,54,48,6,54
Stirling,4122,5,16,6,14,60,55,5,54
Elgin,4122,6,14,6,16,53,61,-8,48
Annan Athlet,4122,7,11,12,13,47,41,6,45
Berwick,4122,8,8,10,18,29,61,-32,34
Edinburgh Ci,4122,9,7,9,20,37,62,-25,30
Cowdenbeath,4122,10,4,11,21,23,54,-31,23
Peterhead,4123,1,24,4,8,80,38,42,76
Montrose,4123,2,23,7,6,59,36,23,76
Stirling,4123,3,17,6,13,61,51,10,57
Stenhousem'r,4123,4,15,8,13,55,47,8,53
Clyde,4123,5,14,10,12,51,48,3,52
Elgin,4123,6,15,6,15,55,60,-5,51
Annan Athlet,4123,7,12,11,13,48,41,7,47
Berwick,4123,8,8,11,17,29,58,-29,35
Edinburgh Ci,4123,9,7,9,20,36,63,-27,30
Cowdenbeath,4123,10,4,10,22,23,55,-32,22
Montrose,4124,1,24,7,5,60,34,26,79
Peterhead,4124,2,23,5,8,78,39,39,74
Stirling,4124,3,17,6,13,62,52,10,57
Clyde,4124,4,15,9,12,53,48,5,54
Stenhousem'r,4124,5,15,8,13,56,48,8,53
Elgin,4124,6,14,6,16,53,61,-8,48
Annan Athlet,4124,7,11,12,13,49,43,6,45
Berwick,4124,8,8,10,18,29,60,-31,34
Edinburgh Ci,4124,9,7,10,19,37,61,-24,31
Cowdenbeath,4124,10,4,11,21,25,56,-31,23
Peterhead,4125,1,24,4,8,83,38,45,76
Montrose,4125,2,23,7,6,60,36,24,76
Stirling,4125,3,16,7,13,63,54,9,55
Stenhousem'r,4125,4,15,9,12,58,49,9,54
Clyde,4125,5,15,9,12,54,48,6,54
Elgin,4125,6,15,6,15,55,61,-6,51
Annan Athlet,4125,7,11,12,13,47,41,6,45
Berwick,4125,8,8,10,18,29,61,-32,34
Edinburgh Ci,4125,9,7,9,20,36,66,-30,30
Cowdenbeath,4125,10,4,11,21,23,54,-31,23
Montrose,4126,1,24,7,5,60,34,26,79
Peterhead,4126,2,24,4,8,78,38,40,76
Stirling,4126,3,17,6,13,64,52,12,57
Clyde,4126,4,15,9,12,52,48,4,54
Stenhousem'r,4126,5,15,8,13,56,50,6,53
Elgin,4126,6,14,6,16,53,61,-8,48
Annan Athlet,4126,7,11,11,14,48,43,5,44
Berwick,4126,8,8,10,18,29,59,-30,34
Edinburgh Ci,4126,9,7,9,20,36,61,-25,30
Cowdenbeath,4126,10,5,10,21,25,55,-30,25
Montrose,4127,1,23,8,5,60,35,25,77
Peterhead,4127,2,24,4,8,81,39,42,76
Stirling,4127,3,17,6,13,62,51,11,57
Stenhousem'r,4127,4,15,8,13,55,48,7,53
Clyde,4127,5,14,9,13,51,49,2,51
Elgin,4127,6,14,7,15,54,61,-7,49
Annan Athlet,4127,7,11,12,13,48,42,6,45
Berwick,4127,8,9,10,17,30,58,-28,37
Edinburgh Ci,4127,9,7,9,20,37,64,-27,30
Cowdenbeath,4127,10,4,11,21,24,55,-31,23
Peterhead,4128,1,24,4,8,80,40,40,76
Montrose,4128,2,23,7,6,60,37,23,76
Stirling,4128,3,17,6,13,62,51,11,57
Stenhousem'r,4128,4,15,8,13,55,48,7,53
Clyde,4128,5,14,10,12,51,48,3,52
Elgin,4128,6,15,6,15,56,61,-5,51
Annan Athlet,4128,7,11,12,13,48,42,6,45
Berwick,4128,8,8,11,17,29,58,-29,35
Edinburgh Ci,4128,9,7,9,20,38,63,-25,30
Cowdenbeath,4128,10,4,11,21,24,55,-31,23
Montrose,4129,1,24,7,5,65,34,31,79
Peterhead,4129,2,24,4,8,78,38,40,76
Stirling,4129,3,17,6,13,62,51,11,57
Clyde,4129,4,15,9,12,52,48,4,54
Stenhousem'r,4129,5,15,8,13,55,48,7,53
Elgin,4129,6,14,6,16,53,66,-13,48
Annan Athlet,4129,7,11,12,13,47,41,6,45
Berwick,4129,8,8,10,18,29,59,-30,34
Edinburgh Ci,4129,9,7,9,20,36,61,-25,30
Cowdenbeath,4129,10,4,11,21,23,54,-31,23
Peterhead,4130,1,24,4,8,83,39,44,76
Montrose,4130,2,23,7,6,61,38,23,76
Stirling,4130,3,16,7,13,61,52,9,55
Stenhousem'r,4130,4,15,9,12,56,47,9,54
Clyde,4130,5,14,9,13,51,50,1,51
Elgin,4130,6,15,6,15,57,62,-5,51
Annan Athlet,4130,7,11,12,13,48,42,6,45
Berwick,4130,8,9,10,17,31,58,-27,37
Edinburgh Ci,4130,9,7,9,20,37,66,-29,30
Cowdenbeath,4130,10,4,11,21,24,55,-31,23
Montrose,4131,1,24,7,5,62,35,27,79
Peterhead,4131,2,24,4,8,84,38,46,76
Stirling,4131,3,17,6,13,62,52,10,57
Stenhousem'r,4131,4,15,8,13,56,48,8,53
Clyde,4131,5,14,9,13,51,49,2,51
Elgin,4131,6,14,6,16,54,63,-9,48
Annan Athlet,4131,7,11,11,14,47,43,4,44
Berwick,4131,8,9,10,17,30,58,-28,37
Edinburgh Ci,4131,9,7,9,20,36,67,-31,30
Cowdenbeath,4131,10,5,10,21,25,54,-29,25
Montrose,4132,1,24,7,5,65,35,30,79
Peterhead,4132,2,24,4,8,80,38,42,76
Stirling,4132,3,17,6,13,63,52,11,57
Stenhousem'r,4132,4,15,8,13,56,49,7,53
Clyde,4132,5,14,10,12,51,48,3,52
Elgin,4132,6,14,6,16,54,66,-12,48
Annan Athlet,4132,7,11,12,13,50,44,6,45
Berwick,4132,8,8,11,17,29,58,-29,35
Edinburgh Ci,4132,9,7,9,20,36,63,-27,30
Cowdenbeath,4132,10,4,11,21,26,57,-31,23
Peterhead,4133,1,24,4,8,79,38,41,76
Montrose,4133,2,23,7,6,60,37,23,76
Stirling,4133,3,16,7,13,61,52,9,55
Stenhousem'r,4133,4,15,9,12,56,47,9,54
Clyde,4133,5,15,9,12,54,49,5,54
Elgin,4133,6,15,6,15,56,61,-5,51
Annan Athlet,4133,7,11,11,14,47,43,4,44
Berwick,4133,8,8,10,18,30,61,-31,34
Edinburgh Ci,4133,9,7,9,20,36,62,-26,30
Cowdenbeath,4133,10,5,10,21,25,54,-29,25
Montrose,4134,1,24,7,5,63,34,29,79
Peterhead,4134,2,23,4,9,77,40,37,73
Stirling,4134,3,17,6,13,61,51,10,57
Clyde,4134,4,15,9,12,53,49,4,54
Stenhousem'r,4134,5,15,8,13,55,47,8,53
Elgin,4134,6,14,6,16,53,64,-11,48
Annan Athlet,4134,7,11,11,14,47,42,5,44
Berwick,4134,8,8,10,18,30,60,-30,34
Edinburgh Ci,4134,9,8,9,19,38,60,-22,33
Cowdenbeath,4134,10,5,10,21,24,54,-30,25
Montrose,4135,1,24,7,5,63,35,28,79
Peterhead,4135,2,24,4,8,78,38,40,76
Stenhousem'r,4135,3,16,8,12,57,46,11,56
Stirling,4135,4,16,6,14,60,53,7,54
Clyde,4135,5,15,9,12,52,48,4,54
Elgin,4135,6,14,6,16,54,64,-10,48
Annan Athlet,4135,7,11,12,13,47,41,6,45
Berwick,4135,8,8,10,18,29,59,-30,34
Edinburgh Ci,4135,9,7,9,20,36,61,-25,30
Cowdenbeath,4135,10,4,11,21,23,54,-31,23
Montrose,4136,1,24,7,5,61,35,26,79
Peterhead,4136,2,23,5,8,79,40,39,74
Stirling,4136,3,17,6,13,62,51,11,57
Stenhousem'r,4136,4,15,8,13,55,48,7,53
Clyde,4136,5,14,10,12,53,50,3,52
Elgin,4136,6,14,6,16,54,62,-8,48
Annan Athlet,4136,7,11,11,14,47,43,4,44
Berwick,4136,8,8,11,17,31,60,-29,35
Edinburgh Ci,4136,9,7,10,19,38,62,-24,31
Cowdenbeath,4136,10,5,10,21,25,54,-29,25
Montrose,4137,1,24,7,5,61,35,26,79
Peterhead,4137,2,24,4,8,80,39,41,76
Stirling,4137,3,17,6,13,62,51,11,57
Clyde,4137,4,15,9,12,53,48,5,54
Stenhousem'r,4137,5,15,8,13,55,48,7,53
Elgin,4137,6,14,6,16,54,62,-8,48
Annan Athlet,4137,7,12,11,13,53,42,11,47
Berwick,4137,8,8,10,18,29,60,-31,34
Edinburgh Ci,4137,9,7,9,20,37,63,-26,30
Cowdenbeath,4137,10,4,10,22,24,60,-36,22
Montrose,4138,1,24,7,5,62,35,27,79
Peterhead,4138,2,24,4,8,80,39,41,76
Stirling,4138,3,17,6,13,62,52,10,57
Stenhousem'r,4138,4,15,8,13,56,48,8,53
Clyde,4138,5,14,10,12,53,50,3,52
Elgin,4138,6,14,6,16,54,63,-9,48
Annan Athlet,4138,7,12,11,13,48,41,7,47
Berwick,4138,8,8,11,17,31,60,-29,35
Edinburgh Ci,4138,9,7,9,20,37,63,-26,30
Cowdenbeath,4138,10,4,10,22,23,55,-32,22
Peterhead,4139,1,24,4,8,80,39,41,76
Montrose,4139,2,23,7,6,59,35,24,76
Stirling,4139,3,17,6,13,65,51,14,57
Clyde,4139,4,15,9,12,53,49,4,54
Stenhousem'r,4139,5,15,8,13,55,51,4,53
Elgin,4139,6,15,6,15,54,60,-6,51
Annan Athlet,4139,7,11,11,14,49,44,5,44
Berwick,4139,8,8,10,18,30,60,-30,34
Edinburgh Ci,4139,9,7,9,20,37,63,-26,30
Cowdenbeath,4139,10,5,10,21,26,56,-30,25
Montrose,4140,1,24,7,5,63,34,29,79
Peterhead,4140,2,23,5,8,78,39,39,74
Stirling,4140,3,16,7,13,63,54,9,55
Stenhousem'r,4140,4,15,9,12,58,49,9,54
Clyde,4140,5,14,10,12,51,48,3,52
Elgin,4140,6,14,6,16,53,64,-11,48
Annan Athlet,4140,7,12,11,13,49,41,8,47
Berwick,4140,8,8,11,17,29,58,-29,35
Edinburgh Ci,4140,9,7,10,19,37,61,-24,31
Cowdenbeath,4140,10,4,10,22,23,56,-33,22
Montrose,4141,1,24,7,5,62,34,28,79
Peterhead,4141,2,24,4,8,78,38,40,76
Stirling,4141,3,17,6,13,61,51,10,57
Stenhousem'r,4141,4,15,8,13,55,47,8,53
Clyde,4141,5,14,9,13,51,50,1,51
Elgin,4141,6,14,6,16,53,63,-10,48
Annan Athlet,4141,7,12,11,13,50,41,9,47
Berwick,4141,8,9,10,17,31,58,-27,37
Edinburgh Ci,4141,9,7,9,20,36,61,-25,30
Cowdenbeath,4141,10,4,10,22,23,57,-34,22
Peterhead,4142,1,24,4,8,79,39,40,76
Montrose,4142,2,23,7,6,59,36,23,76
Stirling,4142,3,16,7,13,62,53,9,55
Stenhousem'r,4142,4,15,9,12,57,48,9,54
Clyde,4142,5,15,9,12,53,48,5,54
Elgin,4142,6,15,6,15,55,60,-5,51
Annan Athlet,4142,7,11,12,13,48,42,6,45
Berwick,4142,8,8,10,18,29,60,-31,34
Edinburgh Ci,4142,9,7,9,20,37,62,-25,30
Cowdenbeath,4142,10,4,11,21,24,55,-31,23
Montrose,4143,1,23,7,6,60,36,24,76
Peterhead,4143,2,23,5,8,80,41,39,74
Stirling,4143,3,17,6,13,62,52,10,57
Clyde,4143,4,15,9,12,53,48,5,54
Stenhousem'r,4143,5,15,8,13,56,48,8,53
Elgin,4143,6,15,6,15,55,61,-6,51
Annan Athlet,4143,7,11,11,14,47,42,5,44
Berwick,4143,8,8,10,18,29,60,-31,34
Edinburgh Ci,4143,9,7,10,19,39,63,-24,31
Cowdenbeath,4143,10,5,10,21,24,54,-30,25
Montrose,4144,1,23,8,5,59,34,25,77
Peterhead,4144,2,24,4,8,82,39,43,76
Stirling,4144,3,16,7,13,60,51,9,55
Stenhousem'r,4144,4,15,9,12,55,46,9,54
Clyde,4144,5,15,9,12,54,48,6,54
Elgin,4144,6,14,7,15,53,60,-7,49
Annan Athlet,4144,7,11,11,14,47,42,5,44
Berwick,4144,8,8,10,18,29,61,-32,34
Edinburgh Ci,4144,9,7,9,20,37,65,-28,30
Cowdenbeath,4144,10,5,10,21,24,54,-30,25
Montrose,4145,1,24,7,5,61,34,27,79
Peterhead,4145,2,23,4,9,77,40,37,73
Stirling,4145,3,17,6,13,61,51,10,57
Stenhousem'r,4145,4,15,8,13,55,47,8,53
Clyde,4145,5,14,10,12,52,49,3,52
Elgin,4145,6,14,6,16,53,62,-9,48
Annan Athlet,4145,7,11,12,13,47,41,6,45
Berwick,4145,8,8,11,17,30,59,-29,35
Edinburgh Ci,4145,9,8,9,19,38,60,-22,33
Cowdenbeath,4145,10,4,11,21,23,54,-31,23
Montrose,4146,1,24,7,5,62,35,27,79
Peterhead,4146,2,23,4,9,78,40,38,73
Stirling,4146,3,17,6,13,64,51,13,57
Clyde,4146,4,15,9,12,53,49,4,54
Stenhousem'r,4146,5,15,8,13,55,50,5,53
Elgin,4146,6,14,6,16,54,63,-9,48
Annan Athlet,4146,7,11,12,13,47,41,6,45
Berwick,4146,8,8,10,18,30,60,-30,34
Edinburgh Ci,4146,9,8,9,19,38,61,-23,33
Cowdenbeath,4146,10,4,11,21,23,54,-31,23
Montrose,4147,1,23,8,5,59,34,25,77
Peterhead,4147,2,24,4,8,81,39,42,76
Stenhousem'r,4147,3,16,8,12,56,46,10,56
Stirling,4147,4,16,6,14,60,52,8,54
Clyde,4147,5,14,10,12,52,49,3,52
Elgin,4147,6,14,7,15,53,60,-7,49
Annan Athlet,4147,7,12,11,13,50,41,9,47
Berwick,4147,8,8,11,17,30,59,-29,35
Edinburgh Ci,4147,9,7,9,20,37,64,-27,30
Cowdenbeath,4147,10,4,10,22,23,57,-34,22
Montrose,4148,1,23,8,5,60,35,25,77
Peterhead,4148,2,23,4,9,77,40,37,73
Stenhousem'r,4148,3,16,8,12,58,48,10,56
Stirling,4148,4,16,6,14,62,54,8,54
Clyde,4148,5,15,9,12,52,48,4,54
Elgin,4148,6,14,7,15,54,61,-7,49
Annan Athlet,4148,7,11,11,14,47,44,3,44
Berwick,4148,8,8,10,18,29,59,-30,34
Edinburgh Ci,4148,9,8,9,19,38,60,-22,33
Cowdenbeath,4148,10,5,10,21,26,54,-28,25
Montrose,4149,1,23,8,5,62,37,25,77
Peterhead,4149,2,24,4,8,82,38,44,76
Stirling,4149,3,17,6,13,65,55,10,57
Clyde,4149,4,15,9,12,54,49,5,54
Stenhousem'r,4149,5,15,8,13,59,51,8,53
Elgin,4149,6,14,7,15,56,63,-7,49
Annan Athlet,4149,7,11,12,13,47,41,6,45
Berwick,4149,8,8,10,18,30,61,-31,34
Edinburgh Ci,4149,9,7,9,20,36,65,-29,30
Cowdenbeath,4149,10,4,11,21,23,54,-31,23
Montrose,4150,1,23,8,5,61,36,25,77
Peterhead,4150,2,23,5,8,79,40,39,74
Stenhousem'r,4150,3,16,8,12,57,46,11,56
Stirling,4150,4,16,6,14,60,53,7,54
Clyde,4150,5,14,10,12,52,49,3,52
Elgin,4150,6,14,7,15,55,62,-7,49
Annan Athlet,4150,7,11,12,13,48,42,6,45
Berwick,4150,8,8,11,17,30,59,-29,35
Edinburgh Ci,4150,9,7,10,19,38,62,-24,31
Cowdenbeath,4150,10,4,11,21,24,55,-31,23
Montrose,4151,1,24,7,5,61,35,26,79
Peterhead,4151,2,24,4,8,82,39,43,76
Stirling,4151,3,17,6,13,62,52,10,57
Clyde,4151,4,15,9,12,54,48,6,54
Stenhousem'r,4151,5,15,8,13,56,48,8,53
Elgin,4151,6,14,6,16,54,62,-8,48
Annan Athlet,4151,7,11,12,13,47,41,6,45
Berwick,4151,8,8,10,18,29,61,-32,34
Edinburgh Ci,4151,9,7,9,20,37,65,-28,30
Cowdenbeath,4151,10,4,11,21,23,54,-31,23
Montrose,4152,1,24,7,5,62,36,26,79
Peterhead,4152,2,24,4,8,79,38,41,76
Stenhousem'r,4152,3,16,8,12,57,46,11,56
Clyde,4152,4,15,9,12,56,48,8,54
Stirling,4152,5,16,6,14,60,53,7,54
Elgin,4152,6,14,6,16,55,63,-8,48
Annan Athlet,4152,7,12,11,13,49,41,8,47
Berwick,4152,8,8,10,18,29,63,-34,34
Edinburgh Ci,4152,9,7,9,20,36,62,-26,30
Cowdenbeath,4152,10,4,10,22,23,56,-33,22
Peterhead,4153,1,24,4,8,82,39,43,76
Montrose,4153,2,23,7,6,60,36,24,76
Stirling,4153,3,16,7,13,60,51,9,55
Stenhousem'r,4153,4,15,9,12,55,46,9,54
Clyde,4153,5,15,9,12,54,49,5,54
Elgin,4153,6,15,6,15,55,61,-6,51
Annan Athlet,4153,7,11,12,13,48,42,6,45
Berwick,4153,8,8,10,18,30,61,-31,34
Edinburgh Ci,4153,9,7,9,20,37,65,-28,30
Cowdenbeath,4153,10,4,11,21,24,55,-31,23
Peterhead,4154,1,24,4,8,79,38,41,76
Montrose,4154,2,23,7,6,60,37,23,76
Stenhousem'r,4154,3,16,8,12,57,47,10,56
Stirling,4154,4,16,6,14,61,53,8,54
Clyde,4154,5,15,9,12,53,49,4,54
Elgin,4154,6,15,6,15,56,61,-5,51
Annan Athlet,4154,7,12,11,13,48,41,7,47
Berwick,4154,8,8,10,18,30,60,-30,34
Edinburgh Ci,4154,9,7,9,20,36,62,-26,30
Cowdenbeath,4154,10,4,10,22,23,55,-32,22
Montrose,4155,1,23,8,5,59,34,25,77
Peterhead,4155,2,23,5,8,79,40,39,74
Stirling,4155,3,16,7,13,60,51,9,55
Stenhousem'r,4155,4,15,9,12,55,46,9,54
Clyde,4155,5,15,9,12,53,48,5,54
Elgin,4155,6,14,7,15,53,60,-7,49
Annan Athlet,4155,7,11,12,13,47,41,6,45
Berwick,4155,8,8,10,18,29,60,-31,34
Edinburgh Ci,4155,9,7,10,19,38,62,-24,31
Cowdenbeath,4155,10,4,11,21,23,54,-31,23
Montrose,4156,1,24,7,5,62,35,27,79
Peterhead,4156,2,24,4,8,83,38,45,76
Stirling,4156,3,17,6,13,64,52,12,57
Stenhousem'r,4156,4,15,8,13,56,50,6,53
Clyde,4156,5,14,9,13,51,49,2,51
Elgin,4156,6,14,6,16,54,63,-9,48
Annan Athlet,4156,7,11,11,14,47,43,4,44
Berwick,4156,8,9,10,17,30,58,-28,37
Edinburgh Ci,4156,9,7,9,20,36,66,-30,30
Cowdenbeath,4156,10,5,10,21,25,54,-29,25
Montrose,4157,1,24,7,5,61,35,26,79
Peterhead,4157,2,24,4,8,82,38,44,76
Stirling,4157,3,16,7,13,61,52,9,55
Stenhousem'r,4157,4,15,9,12,56,47,9,54
Clyde,4157,5,15,9,12,52,48,4,54
Elgin,4157,6,14,6,16,54,62,-8,48
Annan Athlet,4157,7,11,11,14,48,43,5,44
Berwick,4157,8,8,10,18,29,59,-30,34
Edinburgh Ci,4157,9,7,9,20,36,65,-29,30
Cowdenbeath,4157,10,5,10,21,25,55,-30,25
Montrose,4158,1,24,7,5,60,34,26,79
Peterhead,4158,2,24,4,8,79,39,40,76
Stirling,4158,3,17,6,13,63,51,12,57
Clyde,4158,4,15,9,12,53,48,5,54
Stenhousem'r,4158,5,15,8,13,55,49,6,53
Elgin,4158,6,14,6,16,53,61,-8,48
Annan Athlet,4158,7,11,11,14,47,42,5,44
Berwick,4158,8,8,10,18,29,60,-31,34
Edinburgh Ci,4158,9,7,9,20,37,62,-25,30
Cowdenbeath,4158,10,5,10,21,24,54,-30,25
Montrose,4159,1,24,7,5,60,34,26,79
Peterhead,4159,2,24,4,8,80,40,40,76
Stirling,4159,3,16,7,13,61,52,9,55
Stenhousem'r,4159,4,15,9,12,56,47,9,54
Clyde,4159,5,15,9,12,54,48,6,54
Elgin,4159,6,14,6,16,53,61,-8,48
Annan Athlet,4159,7,11,11,14,48,43,5,44
Berwick,4159,8,8,10,18,29,61,-32,34
Edinburgh Ci,4159,9,7,9,20,38,63,-25,30
Cowdenbeath,4159,10,5,10,21,25,55,-30,25
Montrose,4160,1,24,7,5,60,34,26,79
Peterhead,4160,2,24,4,8,78,38,40,76
Stirling,4160,3,17,6,13,62,51,11,57
Clyde,4160,4,15,9,12,55,48,7,54
Stenhousem'r,4160,5,15,8,13,55,48,7,53
Elgin,4160,6,14,6,16,53,61,-8,48
Annan Athlet,4160,7,11,11,14,47,42,5,44
Berwick,4160,8,8,10,18,29,62,-33,34
Edinburgh Ci,4160,9,7,9,20,36,61,-25,30
Cowdenbeath,4160,10,5,10,21,24,54,-30,25
Montrose,4161,1,24,7,5,63,35,28,79
Peterhead,4161,2,24,4,8,80,39,41,76
Stirling,4161,3,17,6,13,61,51,10,57
Stenhousem'r,4161,4,15,8,13,55,47,8,53
Clyde,4161,5,14,9,13,53,51,2,51
Elgin,4161,6,14,6,16,54,64,-10,48
Annan Athlet,4161,7,12,11,13,48,41,7,47
Berwick,4161,8,9,10,17,32,60,-28,37
Edinburgh Ci,4161,9,7,9,20,37,63,-26,30
Cowdenbeath,4161,10,4,10,22,23,55,-32,22
Montrose,4162,1,23,8,5,61,36,25,77
Peterhead,4162,2,24,4,8,82,42,40,76
Stirling,4162,3,16,7,13,62,53,9,55
Stenhousem'r,4162,4,15,9,12,57,48,9,54
Clyde,4162,5,15,9,12,55,49,6,54
Elgin,4162,6,14,7,15,55,62,-7,49
Annan Athlet,4162,7,12,11,13,50,41,9,47
Berwick,4162,8,8,10,18,30,62,-32,34
Edinburgh Ci,4162,9,7,9,20,40,65,-25,30
Cowdenbeath,4162,10,4,10,22,23,57,-34,22
Peterhead,4163,1,24,4,8,83,40,43,76
Montrose,4163,2,23,7,6,60,36,24,76
Stirling,4163,3,17,6,13,63,52,11,57
Stenhousem'r,4163,4,15,8,13,56,49,7,53
Clyde,4163,5,14,9,13,51,50,1,51
Elgin,4163,6,15,6,15,55,61,-6,51
Annan Athlet,4163,7,11,12,13,47,41,6,45
Berwick,4163,8,9,10,17,31,58,-27,37
Edinburgh Ci,4163,9,7,9,20,38,66,-28,30
Cowdenbeath,4163,10,4,11,21,23,54,-31,23
Montrose,4164,1,24,7,5,60,34,26,79
Peterhead,4164,2,24,4,8,81,40,41,76
Stirling,4164,3,16,7,13,60,51,9,55
Stenhousem'r,4164,4,15,9,12,55,46,9,54
Clyde,4164,5,15,9,12,56,49,7,54
Elgin,4164,6,14,6,16,53,61,-8,48
Annan Athlet,4164,7,11,11,14,47,42,5,44
Berwick,4164,8,8,10,18,30,63,-33,34
Edinburgh Ci,4164,9,7,9,20,38,64,-26,30
Cowdenbeath,4164,10,5,10,21,24,54,-30,25
Peterhead,4165,1,24,4,8,83,41,42,76
Montrose,4165,2,23,7,6,60,36,24,76
Stirling,4165,3,16,7,13,62,53,9,55
Stenhousem'r,4165,4,15,9,12,57,48,9,54
Clyde,4165,5,15,9,12,54,50,4,54
Elgin,4165,6,15,6,15,55,61,-6,51
Annan Athlet,4165,7,12,11,13,51,42,9,47
Berwick,4165,8,8,10,18,31,61,-30,34
Edinburgh Ci,4165,9,7,9,20,39,66,-27,30
Cowdenbeath,4165,10,4,10,22,24,58,-34,22
Montrose,4166,1,23,8,5,60,35,25,77
Peterhead,4166,2,24,4,8,81,38,43,76
Stenhousem'r,4166,3,16,8,12,59,48,11,56
Stirling,4166,4,16,6,14,62,55,7,54
Clyde,4166,5,15,9,12,54,49,5,54
Elgin,4166,6,14,7,15,54,61,-7,49
Annan Athlet,4166,7,11,12,13,48,42,6,45
Berwick,4166,8,8,10,18,30,61,-31,34
Edinburgh Ci,4166,9,7,9,20,36,64,-28,30
Cowdenbeath,4166,10,4,11,21,24,55,-31,23
Montrose,4167,1,24,7,5,61,35,26,79
Peterhead,4167,2,24,4,8,83,39,44,76
Stenhousem'r,4167,3,16,8,12,58,48,10,56
Stirling,4167,4,16,6,14,62,54,8,54
Clyde,4167,5,14,9,13,51,51,0,51
Elgin,4167,6,14,6,16,54,62,-8,48
Annan Athlet,4167,7,11,12,13,48,42,6,45
Berwick,4167,8,9,10,17,32,58,-26,37
Edinburgh Ci,4167,9,7,9,20,37,66,-29,30
Cowdenbeath,4167,10,4,11,21,24,55,-31,23
Montrose,4168,1,23,8,5,60,35,25,77
Peterhead,4168,2,24,4,8,80,39,41,76
Stirling,4168,3,16,7,13,61,52,9,55
Stenhousem'r,4168,4,15,9,12,56,47,9,54
Clyde,4168,5,14,10,12,52,49,3,52
Elgin,4168,6,14,7,15,54,61,-7,49
Annan Athlet,4168,7,12,11,13,48,41,7,47
Berwick,4168,8,8,11,17,30,59,-29,35
Edinburgh Ci,4168,9,7,9,20,37,63,-26,30
Cowdenbeath,4168,10,4,10,22,23,55,-32,22
Montrose,4169,1,23,8,5,60,35,25,77
Peterhead,4169,2,24,4,8,79,39,40,76
Stirling,4169,3,16,7,13,61,52,9,55
Stenhousem'r,4169,4,15,9,12,56,47,9,54
Clyde,4169,5,15,9,12,56,48,8,54
Elgin,4169,6,14,7,15,54,61,-7,49
Annan Athlet,4169,7,12,11,13,50,43,7,47
Berwick,4169,8,8,10,18,29,63,-34,34
Edinburgh Ci,4169,9,7,9,20,37,62,-25,30
Cowdenbeath,4169,10,4,10,22,25,57,-32,22
Montrose,4170,1,24,7,5,61,35,26,79
Peterhead,4170,2,24,4,8,80,38,42,76
Stenhousem'r,4170,3,16,8,12,57,47,10,56
Stirling,4170,4,16,6,14,61,53,8,54
Clyde,4170,5,15,9,12,53,48,5,54
Elgin,4170,6,14,6,16,54,62,-8,48
Annan Athlet,4170,7,12,11,13,49,42,7,47
Berwick,4170,8,8,10,18,29,60,-31,34
Edinburgh Ci,4170,9,7,9,20,36,63,-27,30
Cowdenbeath,4170,10,4,10,22,24,56,-32,22
Montrose,4171,1,23,8,5,61,36,25,77
Peterhead,4171,2,24,4,8,79,39,40,76
Stirling,4171,3,17,6,13,62,52,10,57
Clyde,4171,4,15,9,12,53,48,5,54
Stenhousem'r,4171,5,15,8,13,56,48,8,53
Elgin,4171,6,14,7,15,55,62,-7,49
Annan Athlet,4171,7,11,11,14,47,43,4,44
Berwick,4171,8,8,10,18,29,60,-31,34
Edinburgh Ci,4171,9,7,9,20,37,62,-25,30
Cowdenbeath,4171,10,5,10,21,25,54,-29,25
Montrose,4172,1,24,7,5,61,34,27,79
Peterhead,4172,2,24,4,8,82,39,43,76
Stirling,4172,3,17,6,13,64,51,13,57
Clyde,4172,4,15,9,12,53,48,5,54
Stenhousem'r,4172,5,15,8,13,55,50,5,53
Elgin,4172,6,14,6,16,53,62,-9,48
Annan Athlet,4172,7,11,11,14,49,44,5,44
Berwick,4172,8,8,10,18,29,60,-31,34
Edinburgh Ci,4172,9,7,9,20,37,65,-28,30
Cowdenbeath,4172,10,5,10,21,26,56,-30,25
Montrose,4173,1,23,8,5,60,35,25,77
Peterhead,4173,2,24,4,8,82,39,43,76
Stirling,4173,3,16,7,13,62,53,9,55
Stenhousem'r,4173,4,15,9,12,57,48,9,54
Clyde,4173,5,15,9,12,56,48,8,54
Elgin,4173,6,14,7,15,54,61,-7,49
Annan Athlet,4173,7,11,11,14,48,44,4,44
Berwick,4173,8,8,10,18,29,63,-34,34
Edinburgh Ci,4173,9,7,9,20,37,65,-28,30
Cowdenbeath,4173,10,5,10,21,26,55,-29,25
Montrose,4174,1,24,7,5,61,34,27,79
Peterhead,4174,2,24,4,8,79,39,40,76
Stirling,4174,3,17,6,13,63,53,10,57
Stenhousem'r,4174,4,15,8,13,57,49,8,53
Clyde,4174,5,14,9,13,52,50,2,51
Elgin,4174,6,14,6,16,53,62,-9,48
Annan Athlet,4174,7,11,12,13,49,43,6,45
Berwick,4174,8,9,10,17,31,59,-28,37
Edinburgh Ci,4174,9,7,9,20,37,62,-25,30
Cowdenbeath,4174,10,4,11,21,25,56,-31,23
Montrose,4175,1,24,7,5,61,35,26,79
Peterhead,4175,2,24,4,8,80,38,42,76
Stenhousem'r,4175,3,16,8,12,56,46,10,56
Stirling,4175,4,16,6,14,60,52,8,54
Clyde,4175,5,15,9,12,54,50,4,54
Elgin,4175,6,14,6,16,54,62,-8,48
Annan Athlet,4175,7,11,11,14,47,44,3,44
Berwick,4175,8,8,10,18,31,61,-30,34
Edinburgh Ci,4175,9,7,9,20,36,63,-27,30
Cowdenbeath,4175,10,5,10,21,26,54,-28,25
Montrose,4176,1,23,7,6,60,38,22,76
Peterhead,4176,2,23,4,9,78,40,38,73
Stenhousem'r,4176,3,16,8,12,57,46,11,56
Stirling,4176,4,16,6,14,60,53,7,54
Clyde,4176,5,14,10,12,52,49,3,52
Elgin,4176,6,15,6,15,57,61,-4,51
Annan Athlet,4176,7,12,11,13,49,41,8,47
Berwick,4176,8,8,11,17,30,59,-29,35
Edinburgh Ci,4176,9,8,9,19,38,61,-23,33
Cowdenbeath,4176,10,4,10,22,23,56,-33,22
Montrose,4177,1,23,8,5,59,34,25,77
Peterhead,4177,2,23,5,8,78,39,39,74
Stenhousem'r,4177,3,16,8,12,58,47,11,56
Stirling,4177,4,16,6,14,61,54,7,54
Clyde,4177,5,14,9,13,51,51,0,51
Elgin,4177,6,14,7,15,53,60,-7,49
Annan Athlet,4177,7,12,11,13,50,41,9,47
Berwick,4177,8,9,10,17,32,58,-26,37
Edinburgh Ci,4177,9,7,10,19,37,61,-24,31
Cowdenbeath,4177,10,4,10,22,23,57,-34,22
Montrose,4178,1,24,7,5,61,34,27,79
Peterhead,4178,2,23,5,8,78,39,39,74
Stirling,4178,3,16,7,13,61,52,9,55
Stenhousem'r,4178,4,15,9,12,56,47,9,54
Clyde,4178,5,14,10,12,52,49,3,52
Elgin,4178,6,14,6,16,53,62,-9,48
Annan Athlet,4178,7,11,12,13,47,41,6,45
Berwick,4178,8,8,11,17,30,59,-29,35
Edinburgh Ci,4178,9,7,10,19,37,61,-24,31
Cowdenbeath,4178,10,4,11,21,23,54,-31,23
Montrose,4179,1,24,7,5,63,34,29,79
Peterhead,4179,2,24,4,8,80,40,40,76
Stirling,4179,3,16,7,13,61,52,9,55
Stenhousem'r,4179,4,15,9,12,56,47,9,54
Clyde,4179,5,14,10,12,52,49,3,52
Elgin,4179,6,14,6,16,53,64,-11,48
Annan Athlet,4179,7,11,11,14,47,44,3,44
Berwick,4179,8,8,11,17,30,59,-29,35
Edinburgh Ci,4179,9,7,9,20,38,63,-25,30
Cowdenbeath,4179,10,5,10,21,26,54,-28,25
Montrose,4180,1,24,7,5,60,34,26,79
Peterhead,4180,2,24,4,8,80,40,40,76
Stenhousem'r,4180,3,16,8,12,57,46,11,56
Stirling,4180,4,16,6,14,60,53,7,54
Clyde,4180,5,15,9,12,53,49,4,54
Elgin,4180,6,14,6,16,53,61,-8,48
Annan Athlet,4180,7,11,11,14,47,42,5,44
Berwick,4180,8,8,10,18,30,60,-30,34
Edinburgh Ci,4180,9,7,9,20,38,63,-25,30
Cowdenbeath,4180,10,5,10,21,24,54,-30,25
Montrose,4181,1,23,8,5,59,34,25,77
Peterhead,4181,2,24,4,8,79,38,41,76
Stirling,4181,3,16,7,13,63,54,9,55
Stenhousem'r,4181,4,15,9,12,58,49,9,54
Clyde,4181,5,15,9,12,53,49,4,54
Elgin,4181,6,14,7,15,53,60,-7,49
Annan Athlet,4181,7,11,11,14,47,42,5,44
Berwick,4181,8,8,10,18,30,60,-30,34
Edinburgh Ci,4181,9,7,9,20,36,62,-26,30
Cowdenbeath,4181,10,5,10,21,24,54,-30,25
Peterhead,4182,1,24,4,8,80,39,41,76
Montrose,4182,2,23,7,6,59,36,23,76
Stirling,4182,3,17,6,13,62,51,11,57
Clyde,4182,4,15,9,12,52,48,4,54
Stenhousem'r,4182,5,15,8,13,55,48,7,53
Elgin,4182,6,15,6,15,55,60,-5,51
Annan Athlet,4182,7,11,12,13,47,41,6,45
Berwick,4182,8,8,10,18,29,59,-30,34
Edinburgh Ci,4182,9,7,9,20,37,63,-26,30
Cowdenbeath,4182,10,4,11,21,23,54,-31,23
Montrose,4183,1,24,7,5,63,34,29,79
Peterhead,4183,2,24,4,8,82,38,44,76
Stirling,4183,3,16,7,13,60,51,9,55
Stenhousem'r,4183,4,15,9,12,55,46,9,54
Clyde,4183,5,14,10,12,52,49,3,52
Elgin,4183,6,14,6,16,53,64,-11,48
Annan Athlet,4183,7,11,11,14,47,42,5,44
Berwick,4183,8,8,11,17,30,59,-29,35
Edinburgh Ci,4183,9,7,9,20,36,65,-29,30
Cowdenbeath,4183,10,5,10,21,24,54,-30,25
Montrose,4184,1,24,7,5,61,34,27,79
Peterhead,4184,2,24,4,8,80,39,41,76
Stirling,4184,3,17,6,13,64,52,12,57
Clyde,4184,4,15,9,12,52,48,4,54
Stenhousem'r,4184,5,15,8,13,56,50,6,53
Elgin,4184,6,14,6,16,53,62,-9,48
Annan Athlet,4184,7,11,12,13,48,42,6,45
Berwick,4184,8,8,10,18,29,59,-30,34
Edinburgh Ci,4184,9,7,9,20,37,63,-26,30
Cowdenbeath,4184,10,4,11,21,24,55,-31,23
Montrose,4185,1,24,7,5,61,35,26,79
Peterhead,4185,2,24,4,8,80,38,42,76
Stirling,4185,3,17,6,13,62,51,11,57
Stenhousem'r,4185,4,15,8,13,55,48,7,53
Clyde,4185,5,14,10,12,52,49,3,52
Elgin,4185,6,14,6,16,54,62,-8,48
Annan Athlet,4185,7,11,12,13,47,41,6,45
Berwick,4185,8,8,11,17,30,59,-29,35
Edinburgh Ci,4185,9,7,9,20,36,63,-27,30
Cowdenbeath,4185,10,4,11,21,23,54,-31,23
Montrose,4186,1,23,7,6,60,36,24,76
Peterhead,4186,2,23,5,8,80,41,39,74
Stirling,4186,3,16,7,13,62,53,9,55
Stenhousem'r,4186,4,15,9,12,57,48,9,54
Clyde,4186,5,14,10,12,52,49,3,52
Elgin,4186,6,15,6,15,55,61,-6,51
Annan Athlet,4186,7,12,11,13,51,41,10,47
Berwick,4186,8,8,11,17,30,59,-29,35
Edinburgh Ci,4186,9,7,10,19,39,63,-24,31
Cowdenbeath,4186,10,4,10,22,23,58,-35,22
Montrose,4187,1,24,7,5,62,34,28,79
Peterhead,4187,2,24,4,8,80,39,41,76
Stenhousem'r,4187,3,16,8,12,59,48,11,56
Stirling,4187,4,16,6,14,62,55,7,54
Clyde,4187,5,14,9,13,51,49,2,51
Elgin,4187,6,14,6,16,53,63,-10,48
Annan Athlet,4187,7,11,11,14,50,45,5,44
Berwick,4187,8,9,10,17,30,58,-28,37
Edinburgh Ci,4187,9,7,9,20,37,63,-26,30
Cowdenbeath,4187,10,5,10,21,27,57,-30,25
Montrose,4188,1,24,7,5,61,35,26,79
Peterhead,4188,2,24,4,8,79,38,41,76
Stirling,4188,3,17,6,13,64,52,12,57
Clyde,4188,4,15,9,12,53,49,4,54
Stenhousem'r,4188,5,15,8,13,56,50,6,53
Elgin,4188,6,14,6,16,54,62,-8,48
Annan Athlet,4188,7,12,11,13,49,41,8,47
Berwick,4188,8,8,10,18,30,60,-30,34
Edinburgh Ci,4188,9,7,9,20,36,62,-26,30
Cowdenbeath,4188,10,4,10,22,23,56,-33,22
Montrose,4189,1,23,8,5,60,35,25,77
Peterhead,4189,2,23,5,8,78,39,39,74
Stirling,4189,3,17,6,13,63,51,12,57
Stenhousem'r,4189,4,15,8,13,55,49,6,53
Clyde,4189,5,14,9,13,51,49,2,51
Elgin,4189,6,14,7,15,54,61,-7,49
Annan Athlet,4189,7,11,12,13,48,42,6,45
Berwick,4189,8,9,10,17,30,58,-28,37
Edinburgh Ci,4189,9,7,10,19,37,61,-24,31
Cowdenbeath,4189,10,4,11,21,24,55,-31,23
Montrose,4190,1,24,7,5,62,34,28,79
Peterhead,4190,2,23,5,8,78,39,39,74
Stirling,4190,3,16,7,13,62,53,9,55
Stenhousem'r,4190,4,15,9,12,57,48,9,54
Clyde,4190,5,14,9,13,51,50,1,51
Elgin,4190,6,14,6,16,53,63,-10,48
Annan Athlet,4190,7,12,11,13,50,42,8,47
Berwick,4190,8,9,10,17,31,58,-27,37
Edinburgh Ci,4190,9,7,10,19,37,61,-24,31
Cowdenbeath,4190,10,4,10,22,24,57,-33,22
Peterhead,4191,1,24,4,8,79,39,40,76
Montrose,4191,2,23,7,6,60,36,24,76
Stirling,4191,3,17,6,13,62,51,11,57
Clyde,4191,4,15,9,12,53,48,5,54
Stenhousem'r,4191,5,15,8,13,55,48,7,53
Elgin,4191,6,15,6,15,55,61,-6,51
Annan Athlet,4191,7,11,11,14,47,42,5,44
Berwick,4191,8,8,10,18,29,60,-31,34
Edinburgh Ci,4191,9,7,9,20,37,62,-25,30
Cowdenbeath,4191,10,5,10,21,24,54,-30,25
Montrose,4192,1,23,7,6,59,35,24,76
Peterhead,4192,2,23,5,8,78,39,39,74
Stirling,4192,3,17,6,13,62,52,10,57
Clyde,4192,4,15,9,12,54,50,4,54
Stenhousem'r,4192,5,15,8,13,56,48,8,53
Elgin,4192,6,15,6,15,54,60,-6,51
Annan Athlet,4192,7,11,12,13,47,41,6,45
Berwick,4192,8,8,10,18,31,61,-30,34
Edinburgh Ci,4192,9,7,10,19,37,61,-24,31
Cowdenbeath,4192,10,4,11,21,23,54,-31,23
Peterhead,4193,1,24,4,8,79,39,40,76
Montrose,4193,2,23,7,6,59,36,23,76
Stirling,4193,3,17,6,13,62,52,10,57
Clyde,4193,4,15,9,12,54,48,6,54
Stenhousem'r,4193,5,15,8,13,56,48,8,53
Elgin,4193,6,15,6,15,55,60,-5,51
Annan Athlet,4193,7,12,11,13,49,42,7,47
Berwick,4193,8,8,10,18,29,61,-32,34
Edinburgh Ci,4193,9,7,9,20,37,62,-25,30
Cowdenbeath,4193,10,4,10,22,24,56,-32,22
Montrose,4194,1,24,7,5,61,34,27,79
Peterhead,4194,2,23,5,8,77,38,39,74
Stirling,4194,3,17,6,13,63,52,11,57
Stenhousem'r,4194,4,15,8,13,56,49,7,53
Clyde,4194,5,14,10,12,51,48,3,52
Elgin,4194,6,14,6,16,53,62,-9,48
Annan Athlet,4194,7,12,11,13,51,41,10,47
Berwick,4194,8,8,11,17,29,58,-29,35
Edinburgh Ci,4194,9,7,10,19,36,60,-24,31
Cowdenbeath,4194,10,4,10,22,23,58,-35,22
Montrose,4195,1,24,7,5,61,35,26,79
Peterhead,4195,2,24,4,8,78,38,40,76
Stirling,4195,3,17,6,13,62,52,10,57
Clyde,4195,4,15,9,12,53,49,4,54
Stenhousem'r,4195,5,15,8,13,56,48,8,53
Elgin,4195,6,14,6,16,54,62,-8,48
Annan Athlet,4195,7,11,11,14,47,42,5,44
Berwick,4195,8,8,10,18,30,60,-30,34
Edinburgh Ci,4195,9,7,9,20,36,61,-25,30
Cowdenbeath,4195,10,5,10,21,24,54,-30,25
Montrose,4196,1,24,7,5,63,35,28,79
Peterhead,4196,2,24,4,8,81,38,43,76
Stirling,4196,3,17,6,13,63,52,11,57
Clyde,4196,4,15,9,12,54,50,4,54
Stenhousem'r,4196,5,15,8,13,56,49,7,53
Elgin,4196,6,14,6,16,54,64,-10,48
Annan Athlet,4196,7,11,11,14,47,42,5,44
Berwick,4196,8,8,10,18,31,61,-30,34
Edinburgh Ci,4196,9,7,9,20,36,64,-28,30
Cowdenbeath,4196,10,5,10,21,24,54,-30,25
Montrose,4197,1,24,7,5,60,34,26,79
Peterhead,4197,2,24,4,8,79,39,40,76
Stenhousem'r,4197,3,16,8,12,56,46,10,56
Stirling,4197,4,16,6,14,60,52,8,54
Clyde,4197,5,15,9,12,52,48,4,54
Elgin,4197,6,14,6,16,53,61,-8,48
Annan Athlet,4197,7,11,12,13,47,41,6,45
Berwick,4197,8,8,10,18,29,59,-30,34
Edinburgh Ci,4197,9,7,9,20,37,62,-25,30
Cowdenbeath,4197,10,4,11,21,23,54,-31,23
Montrose,4198,1,24,7,5,62,35,27,79
Peterhead,4198,2,23,5,8,78,39,39,74
Stirling,4198,3,17,6,13,61,51,10,57
Clyde,4198,4,15,9,12,53,48,5,54
Stenhousem'r,4198,5,15,8,13,55,47,8,53
Elgin,4198,6,14,6,16,54,63,-9,48
Annan Athlet,4198,7,11,11,14,48,43,5,44
Berwick,4198,8,8,10,18,29,60,-31,34
Edinburgh Ci,4198,9,7,10,19,37,61,-24,31
Cowdenbeath,4198,10,5,10,21,25,55,-30,25
Montrose,4199,1,24,7,5,62,34,28,79
Peterhead,4199,2,24,4,8,78,38,40,76
Stirling,4199,3,16,7,13,60,51,9,55
Stenhousem'r,4199,4,15,9,12,55,46,9,54
Clyde,4199,5,15,9,12,53,49,4,54
Elgin,4199,6,14,6,16,53,63,-10,48
Annan Athlet,4199,7,11,12,13,49,43,6,45
Berwick,4199,8,8,10,18,30,60,-30,34
Edinburgh Ci,4199,9,7,9,20,36,61,-25,30
Cowdenbeath,4199,10,4,11,21,25,56,-31,23
Peterhead,4200,1,24,4,8,78,38,40,76
Montrose,4200,2,23,7,6,59,37,22,76
Stirling,4200,3,16,7,13,61,52,9,55
Stenhousem'r,4200,4,15,9,12,56,47,9,54
Clyde,4200,5,15,9,12,52,48,4,54
Elgin,4200,6,15,6,15,56,60,-4,51
Annan Athlet,4200,7,12,11,13,49,42,7,47
Berwick,4200,8,8,10,18,29,59,-30,34
Edinburgh Ci,4200,9,7,9,20,36,61,-25,30
Cowdenbeath,4200,10,4,10,22,24,56,-32,22
Montrose,4201,1,23,8,5,59,34,25,77
Peterhead,4201,2,24,4,8,79,38,41,76
Stirling,4201,3,17,6,13,64,51,13,57
Clyde,4201,4,15,9,12,54,48,6,54
Stenhousem'r,4201,5,15,8,13,55,50,5,53
Elgin,4201,6,14,7,15,53,60,-7,49
Annan Athlet,4201,7,11,12,13,48,42,6,45
Berwick,4201,8,8,10,18,29,61,-32,34
Edinburgh Ci,4201,9,7,9,20,36,62,-26,30
Cowdenbeath,4201,10,4,11,21,24,55,-31,23
Montrose,4202,1,23,8,5,59,34,25,77
Peterhead,4202,2,23,4,9,78,40,38,73
Stirling,4202,3,16,7,13,62,53,9,55
Stenhousem'r,4202,4,15,9,12,57,48,9,54
Clyde,4202,5,15,9,12,53,48,5,54
Elgin,4202,6,14,7,15,53,60,-7,49
Annan Athlet,4202,7,12,11,13,48,41,7,47
Berwick,4202,8,8,10,18,29,60,-31,34
Edinburgh Ci,4202,9,8,9,19,38,61,-23,33
Cowdenbeath,4202,10,4,10,22,23,55,-32,22
Montrose,4203,1,23,8,5,60,35,25,77
Peterhead,4203,2,24,4,8,80,38,42,76
Stirling,4203,3,16,7,13,62,53,9,55
Stenhousem'r,4203,4,15,9,12,57,48,9,54
Clyde,4203,5,14,9,13,52,50,2,51
Elgin,4203,6,14,7,15,54,61,-7,49
Annan Athlet,4203,7,12,11,13,49,42,7,47
Berwick,4203,8,9,10,17,31,59,-28,37
Edinburgh Ci,4203,9,7,9,20,36,63,-27,30
Cowdenbeath,4203,10,4,10,22,24,56,-32,22
Montrose,4204,1,24,7,5,60,34,26,79
Peterhead,4204,2,23,5,8,78,39,39,74
Stenhousem'r,4204,3,16,8,12,58,48,10,56
Stirling,4204,4,16,6,14,62,54,8,54
Clyde,4204,5,15,9,12,54,48,6,54
Elgin,4204,6,14,6,16,53,61,-8,48
Annan Athlet,4204,7,11,11,14,47,42,5,44
Berwick,4204,8,8,10,18,29,61,-32,34
Edinburgh Ci,4204,9,7,10,19,37,61,-24,31
Cowdenbeath,4204,10,5,10,21,24,54,-30,25
Montrose,4205,1,24,7,5,62,34,28,79
Peterhead,4205,2,24,4,8,80,38,42,76
Stirling,4205,3,16,7,13,61,52,9,55
Stenhousem'r,4205,4,15,9,12,56,47,9,54
Clyde,4205,5,15,9,12,53,48,5,54
Elgin,4205,6,14,6,16,53,63,-10,48
Annan Athlet,4205,7,11,11,14,47,42,5,44
Berwick,4205,8,8,10,18,29,60,-31,34
Edinburgh Ci,4205,9,7,9,20,36,63,-27,30
Cowdenbeath,4205,10,5,10,21,24,54,-30,25
Montrose,4206,1,24,7,5,62,34,28,79
Peterhead,4206,2,24,4,8,84,39,45,76
Stirling,4206,3,17,6,13,61,51,10,57
Stenhousem'r,4206,4,15,8,13,55,47,8,53
Clyde,4206,5,14,9,13,51,51,0,51
Elgin,4206,6,14,6,16,53,63,-10,48
Annan Athlet,4206,7,12,11,13,48,41,7,47
Berwick,4206,8,9,10,17,32,58,-26,37
Edinburgh Ci,4206,9,7,9,20,37,67,-30,30
Cowdenbeath,4206,10,4,10,22,23,55,-32,22
Montrose,4207,1,24,7,5,60,34,26,79
Peterhead,4207,2,24,4,8,83,38,45,76
Stirling,4207,3,17,6,13,64,52,12,57
Clyde,4207,4,15,9,12,52,48,4,54
Stenhousem'r,4207,5,15,8,13,56,50,6,53
Elgin,4207,6,14,6,16,53,61,-8,48
Annan Athlet,4207,7,11,11,14,48,43,5,44
Berwick,4207,8,8,10,18,29,59,-30,34
Edinburgh Ci,4207,9,7,9,20,36,66,-30,30
Cowdenbeath,4207,10,5,10,21,25,55,-30,25
Montrose,4208,1,24,7,5,62,34,28,79
Peterhead,4208,2,24,4,8,79,38,41,76
Stenhousem'r,4208,3,16,8,12,57,47,10,56
Stirling,4208,4,16,6,14,61,53,8,54
Clyde,4208,5,15,9,12,55,49,6,54
Elgin,4208,6,14,6,16,53,63,-10,48
Annan Athlet,4208,7,11,12,13,48,42,6,45
Berwick,4208,8,8,10,18,30,62,-32,34
Edinburgh Ci,4208,9,7,9,20,36,62,-26,30
Cowdenbeath,4208,10,4,11,21,24,55,-31,23
Montrose,4209,1,24,7,5,61,35,26,79
Peterhead,4209,2,24,4,8,81,40,41,76
Stenhousem'r,4209,3,16,8,12,58,47,11,56
Stirling,4209,4,16,6,14,61,54,7,54
Clyde,4209,5,15,9,12,53,48,5,54
Elgin,4209,6,14,6,16,54,62,-8,48
Annan Athlet,4209,7,11,12,13,47,41,6,45
Berwick,4209,8,8,10,18,29,60,-31,34
Edinburgh Ci,4209,9,7,9,20,38,64,-26,30
Cowdenbeath,4209,10,4,11,21,23,54,-31,23
Montrose,4210,1,24,7,5,65,34,31,79
Peterhead,4210,2,23,5,8,77,38,39,74
Stirling,4210,3,17,6,13,61,51,10,57
Stenhousem'r,4210,4,15,8,13,55,47,8,53
Clyde,4210,5,14,10,12,51,48,3,52
Elgin,4210,6,14,6,16,53,66,-13,48
Annan Athlet,4210,7,11,11,14,48,46,2,44
Berwick,4210,8,8,11,17,29,58,-29,35
Edinburgh Ci,4210,9,7,10,19,36,60,-24,31
Cowdenbeath,4210,10,5,10,21,28,55,-27,25
Montrose,4211,1,24,7,5,62,35,27,79
Peterhead,4211,2,24,4,8,83,38,45,76
Stenhousem'r,4211,3,16,8,12,61,48,13,56
Stirling,4211,4,16,6,14,62,57,5,54
Clyde,4211,5,15,9,12,54,49,5,54
Elgin,4211,6,14,6,16,54,63,-9,48
Annan Athlet,4211,7,11,12,13,48,42,6,45
Berwick,4211,8,8,10,18,30,61,-31,34
Edinburgh Ci,4211,9,7,9,20,36,66,-30,30
Cowdenbeath,4211,10,4,11,21,24,55,-31,23
Montrose,4212,1,23,8,5,61,36,25,77
Peterhead,4212,2,23,5,8,80,41,39,74
Stirling,4212,3,17,6,13,62,52,10,57
Stenhousem'r,4212,4,15,8,13,56,48,8,53
Clyde,4212,5,14,10,12,52,49,3,52
Elgin,4212,6,14,7,15,55,62,-7,49
Annan Athlet,4212,7,11,12,13,49,43,6,45
Berwick,4212,8,8,11,17,30,59,-29,35
Edinburgh Ci,4212,9,7,10,19,39,63,-24,31
Cowdenbeath,4212,10,4,11,21,25,56,-31,23
Montrose,4213,1,24,7,5,60,34,26,79
Peterhead,4213,2,23,5,8,78,39,39,74
Stenhousem'r,4213,3,16,8,12,57,47,10,56
Stirling,4213,4,16,6,14,61,53,8,54
Clyde,4213,5,15,9,12,53,49,4,54
Elgin,4213,6,14,6,16,53,61,-8,48
Annan Athlet,4213,7,12,11,13,48,41,7,47
Berwick,4213,8,8,10,18,30,60,-30,34
Edinburgh Ci,4213,9,7,10,19,37,61,-24,31
Cowdenbeath,4213,10,4,10,22,23,55,-32,22
Peterhead,4214,1,24,4,8,82,39,43,76
Montrose,4214,2,23,7,6,59,35,24,76
Stenhousem'r,4214,3,16,8,12,59,46,13,56
Clyde,4214,4,15,9,12,54,48,6,54
Stirling,4214,5,16,6,14,60,55,5,54
Elgin,4214,6,15,6,15,54,60,-6,51
Annan Athlet,4214,7,11,11,14,49,44,5,44
Berwick,4214,8,8,10,18,29,61,-32,34
Edinburgh Ci,4214,9,7,9,20,37,65,-28,30
Cowdenbeath,4214,10,5,10,21,26,56,-30,25
Montrose,4215,1,23,8,5,59,34,25,77
Peterhead,4215,2,24,4,8,78,38,40,76
Stirling,4215,3,17,6,13,61,51,10,57
Stenhousem'r,4215,4,15,8,13,55,47,8,53
Clyde,4215,5,14,10,12,52,49,3,52
Elgin,4215,6,14,7,15,53,60,-7,49
Annan Athlet,4215,7,11,12,13,48,42,6,45
Berwick,4215,8,8,11,17,30,59,-29,35
Edinburgh Ci,4215,9,7,9,20,36,61,-25,30
Cowdenbeath,4215,10,4,11,21,24,55,-31,23
Montrose,4216,1,23,8,5,59,34,25,77
Peterhead,4216,2,24,4,8,81,40,41,76
Stirling,4216,3,17,6,13,65,52,13,57
Clyde,4216,4,15,9,12,53,48,5,54
Stenhousem'r,4216,5,15,8,13,56,51,5,53
Elgin,4216,6,14,7,15,53,60,-7,49
Annan Athlet,4216,7,11,12,13,47,41,6,45
Berwick,4216,8,8,10,18,29,60,-31,34
Edinburgh Ci,4216,9,7,9,20,38,64,-26,30
Cowdenbeath,4216,10,4,11,21,23,54,-31,23
Montrose,4217,1,24,7,5,62,35,27,79
Peterhead,4217,2,24,4,8,79,38,41,76
Stenhousem'r,4217,3,16,8,12,56,46,10,56
Stirling,4217,4,16,6,14,60,52,8,54
Clyde,4217,5,14,10,12,51,48,3,52
Elgin,4217,6,14,6,16,54,63,-9,48
Annan Athlet,4217,7,11,12,13,47,41,6,45
Berwick,4217,8,8,11,17,29,58,-29,35
Edinburgh Ci,4217,9,7,9,20,36,62,-26,30
Cowdenbeath,4217,10,4,11,21,23,54,-31,23
Montrose,4218,1,24,7,5,61,35,26,79
Peterhead,4218,2,24,4,8,81,38,43,76
Stirling,4218,3,16,7,13,63,54,9,55
Stenhousem'r,4218,4,15,9,12,58,49,9,54
Clyde,4218,5,15,9,12,54,48,6,54
Elgin,4218,6,14,6,16,54,62,-8,48
Annan Athlet,4218,7,11,12,13,47,41,6,45
Berwick,4218,8,8,10,18,29,61,-32,34
Edinburgh Ci,4218,9,7,9,20,36,64,-28,30
Cowdenbeath,4218,10,4,11,21,23,54,-31,23
Peterhead,4219,1,24,4,8,79,38,41,76
Montrose,4219,2,23,7,6,61,37,24,76
Stenhousem'r,4219,3,16,8,12,56,46,10,56
Stirling,4219,4,16,6,14,60,52,8,54
Clyde,4219,5,14,9,13,51,49,2,51
Elgin,4219,6,15,6,15,56,62,-6,51
Annan Athlet,4219,7,11,11,14,49,44,5,44
Berwick,4219,8,9,10,17,30,58,-28,37
Edinburgh Ci,4219,9,7,9,20,36,62,-26,30
Cowdenbeath,4219,10,5,10,21,26,56,-30,25
Peterhead,4220,1,24,4,8,81,38,43,76
Montrose,4220,2,23,7,6,59,35,24,76
Stirling,4220,3,17,6,13,63,51,12,57
Clyde,4220,4,15,9,12,52,48,4,54
Stenhousem'r,4220,5,15,8,13,55,49,6,53
Elgin,4220,6,15,6,15,54,60,-6,51
Annan Athlet,4220,7,11,11,14,47,45,2,44
Berwick,4220,8,8,10,18,29,59,-30,34
Edinburgh Ci,4220,9,7,9,20,36,64,-28,30
Cowdenbeath,4220,10,5,10,21,27,54,-27,25
Montrose,4221,1,24,7,5,61,34,27,79
Peterhead,4221,2,24,4,8,80,40,40,76
Stenhousem'r,4221,3,16,8,12,58,47,11,56
Stirling,4221,4,16,6,14,61,54,7,54
Clyde,4221,5,14,10,12,53,50,3,52
Elgin,4221,6,14,6,16,53,62,-9,48
Annan Athlet,4221,7,11,11,14,47,42,5,44
Berwick,4221,8,8,11,17,31,60,-29,35
Edinburgh Ci,4221,9,7,9,20,38,63,-25,30
Cowdenbeath,4221,10,5,10,21,24,54,-30,25
Montrose,4222,1,23,8,5,60,35,25,77
Peterhead,4222,2,24,4,8,79,39,40,76
Stenhousem'r,4222,3,16,8,12,57,47,10,56
Stirling,4222,4,16,6,14,61,53,8,54
Clyde,4222,5,15,9,12,55,50,5,54
Elgin,4222,6,14,7,15,54,61,-7,49
Annan Athlet,4222,7,12,11,13,49,42,7,47
Berwick,4222,8,8,10,18,31,62,-31,34
Edinburgh Ci,4222,9,7,9,20,37,62,-25,30
Cowdenbeath,4222,10,4,10,22,24,56,-32,22
Montrose,4223,1,24,7,5,63,37,26,79
Peterhead,4223,2,24,4,8,80,38,42,76
Stirling,4223,3,16,7,13,61,52,9,55
Stenhousem'r,4223,4,15,9,12,56,47,9,54
Clyde,4223,5,15,9,12,53,49,4,54
Elgin,4223,6,14,6,16,56,64,-8,48
Annan Athlet,4223,7,11,11,14,47,42,5,44
Berwick,4223,8,8,10,18,30,60,-30,34
Edinburgh Ci,4223,9,7,9,20,36,63,-27,30
Cowdenbeath,4223,10,5,10,21,24,54,-30,25
Montrose,4224,1,23,7,6,59,35,24,76
Peterhead,4224,2,23,5,8,80,41,39,74
Stirling,4224,3,17,6,13,64,52,12,57
Clyde,4224,4,15,9,12,53,48,5,54
Stenhousem'r,4224,5,15,8,13,56,50,6,53
Elgin,4224,6,15,6,15,54,60,-6,51
Annan Athlet,4224,7,11,11,14,47,42,5,44
Berwick,4224,8,8,10,18,29,60,-31,34
Edinburgh Ci,4224,9,7,10,19,39,63,-24,31
Cowdenbeath,4224,10,5,10,21,24,54,-30,25
Montrose,4225,1,24,7,5,61,35,26,79
Peterhead,4225,2,23,5,8,78,39,39,74
Stirling,4225,3,17,6,13,64,52,12,57
Clyde,4225,4,15,9,12,55,48,7,54
Stenhousem'r,4225,5,15,8,13,56,50,6,53
Elgin,4225,6,14,6,16,54,62,-8,48
Annan Athlet,4225,7,11,12,13,48,42,6,45
Berwick,4225,8,8,10,18,29,62,-33,34
Edinburgh Ci,4225,9,7,10,19,37,61,-24,31
Cowdenbeath,4225,10,4,11,21,24,55,-31,23
Montrose,4226,1,24,7,5,60,34,26,79
Peterhead,4226,2,23,5,8,78,39,39,74
Stirling,4226,3,17,6,13,62,52,10,57
Clyde,4226,4,15,9,12,55,49,6,54
Stenhousem'r,4226,5,15,8,13,56,48,8,53
Elgin,4226,6,14,6,16,53,61,-8,48
Annan Athlet,4226,7,12,11,13,49,41,8,47
Berwick,4226,8,8,10,18,30,62,-32,34
Edinburgh Ci,4226,9,7,10,19,37,61,-24,31
Cowdenbeath,4226,10,4,10,22,23,56,-33,22
Montrose,4227,1,24,7,5,61,35,26,79
Peterhead,4227,2,24,4,8,81,38,43,76
Stenhousem'r,4227,3,16,8,12,58,46,12,56
Stirling,4227,4,16,6,14,60,54,6,54
Clyde,4227,5,15,9,12,53,49,4,54
Elgin,4227,6,14,6,16,54,62,-8,48
Annan Athlet,4227,7,12,11,13,49,41,8,47
Berwick,4227,8,8,10,18,30,60,-30,34
Edinburgh Ci,4227,9,7,9,20,36,64,-28,30
Cowdenbeath,4227,10,4,10,22,23,56,-33,22
Montrose,4228,1,24,7,5,62,35,27,79
Peterhead,4228,2,23,4,9,78,40,38,73
Stirling,4228,3,16,7,13,63,54,9,55
Stenhousem'r,4228,4,15,9,12,58,49,9,54
Clyde,4228,5,14,9,13,51,49,2,51
Elgin,4228,6,14,6,16,54,63,-9,48
Annan Athlet,4228,7,12,11,13,50,43,7,47
Berwick,4228,8,9,10,17,30,58,-28,37
Edinburgh Ci,4228,9,8,9,19,38,61,-23,33
Cowdenbeath,4228,10,4,10,22,25,57,-32,22
Montrose,4229,1,24,7,5,62,34,28,79
Peterhead,4229,2,24,4,8,80,38,42,76
Stenhousem'r,4229,3,16,8,12,57,46,11,56
Stirling,4229,4,16,6,14,60,53,7,54
Clyde,4229,5,15,9,12,54,50,4,54
Elgin,4229,6,14,6,16,53,63,-10,48
Annan Athlet,4229,7,11,12,13,47,41,6,45
Berwick,4229,8,8,10,18,31,61,-30,34
Edinburgh Ci,4229,9,7,9,20,36,63,-27,30
Cowdenbeath,4229,10,4,11,21,23,54,-31,23
Montrose,4230,1,23,7,6,60,38,22,76
Peterhead,4230,2,23,4,9,77,39,38,73
Stenhousem'r,4230,3,16,8,12,56,46,10,56
Stirling,4230,4,16,6,14,60,52,8,54
Clyde,4230,5,14,10,12,52,49,3,52
Elgin,4230,6,15,6,15,57,61,-4,51
Annan Athlet,4230,7,11,11,14,48,43,5,44
Berwick,4230,8,8,11,17,30,59,-29,35
Edinburgh Ci,4230,9,8,9,19,37,60,-23,33
Cowdenbeath,4230,10,5,10,21,25,55,-30,25
Montrose,4231,1,23,8,5,62,37,25,77
Peterhead,4231,2,24,4,8,80,38,42,76
Stenhousem'r,4231,3,16,8,12,56,46,10,56
Stirling,4231,4,16,6,14,60,52,8,54
Clyde,4231,5,15,9,12,57,51,6,54
Elgin,4231,6,14,7,15,56,63,-7,49
Annan Athlet,4231,7,12,11,13,49,42,7,47
Berwick,4231,8,8,10,18,32,64,-32,34
Edinburgh Ci,4231,9,7,9,20,36,63,-27,30
Cowdenbeath,4231,10,4,10,22,24,56,-32,22
Montrose,4232,1,24,7,5,61,35,26,79
Peterhead,4232,2,24,4,8,82,39,43,76
Stirling,4232,3,17,6,13,62,51,11,57
Stenhousem'r,4232,4,15,8,13,55,48,7,53
Clyde,4232,5,14,9,13,53,51,2,51
Elgin,4232,6,14,6,16,54,62,-8,48
Annan Athlet,4232,7,11,11,14,49,45,4,44
Berwick,4232,8,9,10,17,32,60,-28,37
Edinburgh Ci,4232,9,7,9,20,37,65,-28,30
Cowdenbeath,4232,10,5,10,21,27,56,-29,25
Montrose,4233,1,24,7,5,61,34,27,79
Peterhead,4233,2,24,4,8,78,38,40,76
Stirling,4233,3,17,6,13,64,52,12,57
Stenhousem'r,4233,4,15,8,13,56,50,6,53
Clyde,4233,5,14,9,13,51,50,1,51
Elgin,4233,6,14,6,16,53,62,-9,48
Annan Athlet,4233,7,11,11,14,47,43,4,44
Berwick,4233,8,9,10,17,31,58,-27,37
Edinburgh Ci,4233,9,7,9,20,36,61,-25,30
Cowdenbeath,4233,10,5,10,21,25,54,-29,25
Montrose,4234,1,24,7,5,61,35,26,79
Peterhead,4234,2,24,4,8,83,38,45,76
Stirling,4234,3,17,6,13,61,51,10,57
Stenhousem'r,4234,4,15,8,13,55,47,8,53
Clyde,4234,5,14,10,12,52,49,3,52
Elgin,4234,6,14,6,16,54,62,-8,48
Annan Athlet,4234,7,12,11,13,52,43,9,47
Berwick,4234,8,8,11,17,30,59,-29,35
Edinburgh Ci,4234,9,7,9,20,36,66,-30,30
Cowdenbeath,4234,10,4,10,22,25,59,-34,22
Montrose,4235,1,24,7,5,62,34,28,79
Peterhead,4235,2,24,4,8,80,40,40,76
Stirling,4235,3,17,6,13,66,51,15,57
Clyde,4235,4,15,9,12,53,48,5,54
Stenhousem'r,4235,5,15,8,13,55,52,3,53
Elgin,4235,6,14,6,16,53,63,-10,48
Annan Athlet,4235,7,11,12,13,48,42,6,45
Berwick,4235,8,8,10,18,29,60,-31,34
Edinburgh Ci,4235,9,7,9,20,38,63,-25,30
Cowdenbeath,4235,10,4,11,21,24,55,-31,23
Montrose,4236,1,23,8,5,60,35,25,77
Peterhead,4236,2,23,5,8,77,38,39,74
Stirling,4236,3,16,7,13,62,53,9,55
Stenhousem'r,4236,4,15,9,12,57,48,9,54
Clyde,4236,5,15,9,12,54,48,6,54
Elgin,4236,6,14,7,15,54,61,-7,49
Annan Athlet,4236,7,11,11,14,47,43,4,44
Berwick,4236,8,8,10,18,29,61,-32,34
Edinburgh Ci,4236,9,7,10,19,36,60,-24,31
Cowdenbeath,4236,10,5,10,21,25,54,-29,25
Montrose,4237,1,23,8,5,61,36,25,77
Peterhead,4237,2,24,4,8,79,38,41,76
Stirling,4237,3,17,6,13,63,53,10,57
Clyde,4237,4,15,9,12,53,48,5,54
Stenhousem'r,4237,5,15,8,13,57,49,8,53
Elgin,4237,6,14,7,15,55,62,-7,49
Annan Athlet,4237,7,11,11,14,48,44,4,44
Berwick,4237,8,8,10,18,29,60,-31,34
Edinburgh Ci,4237,9,7,9,20,36,62,-26,30
Cowdenbeath,4237,10,5,10,21,26,55,-29,25
Montrose,4238,1,24,7,5,62,36,26,79
Peterhead,4238,2,24,4,8,83,38,45,76
Stirling,4238,3,16,7,13,62,53,9,55
Stenhousem'r,4238,4,15,9,12,57,48,9,54
Clyde,4238,5,14,10,12,53,50,3,52
Elgin,4238,6,14,6,16,55,63,-8,48
Annan Athlet,4238,7,11,11,14,48,45,3,44
Berwick,4238,8,8,11,17,31,60,-29,35
Edinburgh Ci,4238,9,7,9,20,36,66,-30,30
Cowdenbeath,4238,10,5,10,21,27,55,-28,25
Montrose,4239,1,23,8,5,60,35,25,77
Peterhead,4239,2,23,5,8,78,39,39,74
Stirling,4239,3,16,7,13,61,52,9,55
Stenhousem'r,4239,4,15,9,12,56,47,9,54
Clyde,4239,5,14,10,12,51,48,3,52
Elgin,4239,6,14,7,15,54,61,-7,49
Annan Athlet,4239,7,11,12,13,49,43,6,45
Berwick,4239,8,8,11,17,29,58,-29,35
Edinburgh Ci,4239,9,7,10,19,37,61,-24,31
Cowdenbeath,4239,10,4,11,21,25,56,-31,23
Montrose,4240,1,24,7,5,62,34,28,79
Peterhead,4240,2,23,5,8,78,39,39,74
Stirling,4240,3,17,6,13,64,54,10,57
Clyde,4240,4,15,9,12,53,48,5,54
Stenhousem'r,4240,5,15,8,13,58,50,8,53
Elgin,4240,6,14,6,16,53,63,-10,48
Annan Athlet,4240,7,11,12,13,47,41,6,45
Berwick,4240,8,8,10,18,29,60,-31,34
Edinburgh Ci,4240,9,7,10,19,37,61,-24,31
Cowdenbeath,4240,10,4,11,21,23,54,-31,23
Montrose,4241,1,24,7,5,62,34,28,79
Peterhead,4241,2,24,4,8,81,38,43,76
Stirling,4241,3,16,7,13,61,52,9,55
Stenhousem'r,4241,4,15,9,12,56,47,9,54
Clyde,4241,5,15,9,12,55,49,6,54
Elgin,4241,6,14,6,16,53,63,-10,48
Annan Athlet,4241,7,12,11,13,49,42,7,47
Berwick,4241,8,8,10,18,30,62,-32,34
Edinburgh Ci,4241,9,7,9,20,36,64,-28,30
Cowdenbeath,4241,10,4,10,22,24,56,-32,22
Montrose,4242,1,23,8,5,61,36,25,77
Peterhead,4242,2,23,5,8,78,39,39,74
Stirling,4242,3,17,6,13,62,52,10,57
Stenhousem'r,4242,4,15,8,13,56,48,8,53
Clyde,4242,5,14,9,13,52,51,1,51
Elgin,4242,6,14,7,15,55,62,-7,49
Annan Athlet,4242,7,11,11,14,48,43,5,44
Berwick,4242,8,9,10,17,32,59,-27,37
Edinburgh Ci,4242,9,7,10,19,37,61,-24,31
Cowdenbeath,4242,10,5,10,21,25,55,-30,25
Montrose,4243,1,24,7,5,62,35,27,79
Peterhead,4243,2,23,4,9,77,39,38,73
Stirling,4243,3,17,6,13,62,52,10,57
Stenhousem'r,4243,4,15,8,13,56,48,8,53
Clyde,4243,5,14,10,12,51,48,3,52
Elgin,4243,6,14,6,16,54,63,-9,48
Annan Athlet,4243,7,11,11,14,47,42,5,44
Berwick,4243,8,8,11,17,29,58,-29,35
Edinburgh Ci,4243,9,8,9,19,37,60,-23,33
Cowdenbeath,4243,10,5,10,21,24,54,-30,25
Montrose,4244,1,24,7,5,63,35,28,79
Peterhead,4244,2,24,4,8,80,40,40,76
Stirling,4244,3,16,7,13,61,52,9,55
Stenhousem'r,4244,4,15,9,12,56,47,9,54
Clyde,4244,5,14,10,12,51,48,3,52
Elgin,4244,6,14,6,16,54,64,-10,48
Annan Athlet,4244,7,11,12,13,47,41,6,45
Berwick,4244,8,8,11,17,29,58,-29,35
Edinburgh Ci,4244,9,7,9,20,38,63,-25,30
Cowdenbeath,4244,10,4,11,21,23,54,-31,23
Peterhead,4245,1,24,4,8,81,38,43,76
Montrose,4245,2,23,7,6,59,35,24,76
Stirling,4245,3,17,6,13,62,51,11,57
Stenhousem'r,4245,4,15,8,13,55,48,7,53
Clyde,4245,5,14,10,12,51,48,3,52
Elgin,4245,6,15,6,15,54,60,-6,51
Annan Athlet,4245,7,12,11,13,49,42,7,47
Berwick,4245,8,8,11,17,29,58,-29,35
Edinburgh Ci,4245,9,7,9,20,36,64,-28,30
Cowdenbeath,4245,10,4,10,22,24,56,-32,22
Montrose,4246,1,23,8,5,62,37,25,77
Peterhead,4246,2,23,4,9,77,39,38,73
Stenhousem'r,4246,3,16,8,12,57,47,10,56
Stirling,4246,4,16,6,14,61,53,8,54
Clyde,4246,5,15,9,12,53,48,5,54
Elgin,4246,6,14,7,15,56,63,-7,49
Annan Athlet,4246,7,11,11,14,47,43,4,44
Berwick,4246,8,8,10,18,29,60,-31,34
Edinburgh Ci,4246,9,8,9,19,37,60,-23,33
Cowdenbeath,4246,10,5,10,21,25,54,-29,25
Montrose,4247,1,24,7,5,60,34,26,79
Peterhead,4247,2,24,4,8,82,39,43,76
Stirling,4247,3,17,6,13,62,52,10,57
Stenhousem'r,4247,4,15,8,13,56,48,8,53
Clyde,4247,5,14,10,12,51,48,3,52
Elgin,4247,6,14,6,16,53,61,-8,48
Annan Athlet,4247,7,11,11,14,48,43,5,44
Berwick,4247,8,8,11,17,29,58,-29,35
Edinburgh Ci,4247,9,7,9,20,37,65,-28,30
Cowdenbeath,4247,10,5,10,21,25,55,-30,25
Montrose,4248,1,24,7,5,64,35,29,79
Peterhead,4248,2,24,4,8,79,38,41,76
Stenhousem'r,4248,3,16,8,12,58,47,11,56
Stirling,4248,4,16,6,14,61,54,7,54
Clyde,4248,5,14,9,13,52,50,2,51
Elgin,4248,6,14,6,16,54,65,-11,48
Annan Athlet,4248,7,11,11,14,47,42,5,44
Berwick,4248,8,9,10,17,31,59,-28,37
Edinburgh Ci,4248,9,7,9,20,36,62,-26,30
Cowdenbeath,4248,10,5,10,21,24,54,-30,25
Montrose,4249,1,24,7,5,61,35,26,79
Peterhead,4249,2,24,4,8,80,39,41,76
Stirling,4249,3,16,7,13,60,51,9,55
Stenhousem'r,4249,4,15,9,12,55,46,9,54
Clyde,4249,5,15,9,12,53,48,5,54
Elgin,4249,6,14,6,16,54,62,-8,48
Annan Athlet,4249,7,11,11,14,48,43,5,44
Berwick,4249,8,8,10,18,29,60,-31,34
Edinburgh Ci,4249,9,7,9,20,37,63,-26,30
Cowdenbeath,4249,10,5,10,21,25,55,-30,25
Montrose,4250,1,23,8,5,60,35,25,77
Peterhead,4250,2,23,5,8,79,40,39,74
Stirling,4250,3,17,6,13,63,51,12,57
Clyde,4250,4,15,9,12,52,48,4,54
Stenhousem'r,4250,5,15,8,13,55,49,6,53
Elgin,4250,6,14,7,15,54,61,-7,49
Annan Athlet,4250,7,11,12,13,47,41,6,45
Berwick,4250,8,8,10,18,29,59,-30,34
Edinburgh Ci,4250,9,7,10,19,38,62,-24,31
Cowdenbeath,4250,10,4,11,21,23,54,-31,23
Montrose,4251,1,24,7,5,60,34,26,79
Peterhead,4251,2,24,4,8,81,38,43,76
Stirling,4251,3,16,7,13,62,53,9,55
Stenhousem'r,4251,4,15,9,12,57,48,9,54
Clyde,4251,5,14,10,12,51,48,3,52
Elgin,4251,6,14,6,16,53,61,-8,48
Annan Athlet,4251,7,11,12,13,49,43,6,45
Berwick,4251,8,8,11,17,29,58,-29,35
Edinburgh Ci,4251,9,7,9,20,36,64,-28,30
Cowdenbeath,4251,10,4,11,21,25,56,-31,23
Montrose,4252,1,24,7,5,61,35,26,79
Peterhead,4252,2,24,4,8,78,38,40,76
Stirling,4252,3,16,7,13,60,51,9,55
Stenhousem'r,4252,4,15,9,12,55,46,9,54
Clyde,4252,5,14,9,13,53,51,2,51
Elgin,4252,6,14,6,16,54,62,-8,48
Annan Athlet,4252,7,12,11,13,49,42,7,47
Berwick,4252,8,9,10,17,32,60,-28,37
Edinburgh Ci,4252,9,7,9,20,36,61,-25,30
Cowdenbeath,4252,10,4,10,22,24,56,-32,22
Montrose,4253,1,23,7,6,60,36,24,76
Peterhead,4253,2,23,5,8,77,38,39,74
Stenhousem'r,4253,3,16,8,12,61,47,14,56
Stirling,4253,4,16,6,14,61,57,4,54
Clyde,4253,5,14,9,13,52,51,1,51
Elgin,4253,6,15,6,15,55,61,-6,51
Annan Athlet,4253,7,11,11,14,47,46,1,44
Berwick,4253,8,9,10,17,32,59,-27,37
Edinburgh Ci,4253,9,7,10,19,36,60,-24,31
Cowdenbeath,4253,10,5,10,21,28,54,-26,25
Montrose,4254,1,23,8,5,61,36,25,77
Peterhead,4254,2,24,4,8,79,38,41,76
Stirling,4254,3,17,6,13,61,51,10,57
Clyde,4254,4,15,9,12,53,48,5,54
Stenhousem'r,4254,5,15,8,13,55,47,8,53
Elgin,4254,6,14,7,15,55,62,-7,49
Annan Athlet,4254,7,11,12,13,48,42,6,45
Berwick,4254,8,8,10,18,29,60,-31,34
Edinburgh Ci,4254,9,7,9,20,36,62,-26,30
Cowdenbeath,4254,10,4,11,21,24,55,-31,23
Montrose,4255,1,23,8,5,61,36,25,77
Peterhead,4255,2,24,4,8,78,38,40,76
Stirling,4255,3,16,7,13,62,53,9,55
Stenhousem'r,4255,4,15,9,12,57,48,9,54
Clyde,4255,5,14,10,12,51,48,3,52
Elgin,4255,6,14,7,15,55,62,-7,49
Annan Athlet,4255,7,11,11,14,47,43,4,44
Berwick,4255,8,8,11,17,29,58,-29,35
Edinburgh Ci,4255,9,7,9,20,36,61,-25,30
Cowdenbeath,4255,10,5,10,21,25,54,-29,25
Montrose,4256,1,24,7,5,61,34,27,79
Peterhead,4256,2,24,4,8,83,38,45,76
Stenhousem'r,4256,3,16,8,12,57,46,11,56
Stirling,4256,4,16,6,14,60,53,7,54
Clyde,4256,5,15,9,12,53,48,5,54
Elgin,4256,6,14,6,16,53,62,-9,48
Annan Athlet,4256,7,11,12,13,48,42,6,45
Berwick,4256,8,8,10,18,29,60,-31,34
Edinburgh Ci,4256,9,7,9,20,36,66,-30,30
Cowdenbeath,4256,10,4,11,21,24,55,-31,23
Peterhead,4257,1,24,4,8,82,39,43,76
Montrose,4257,2,23,7,6,60,36,24,76
Stenhousem'r,4257,3,16,8,12,56,46,10,56
Stirling,4257,4,16,6,14,60,52,8,54
Clyde,4257,5,14,9,13,53,51,2,51
Elgin,4257,6,15,6,15,55,61,-6,51
Annan Athlet,4257,7,11,12,13,47,41,6,45
Berwick,4257,8,9,10,17,32,60,-28,37
Edinburgh Ci,4257,9,7,9,20,37,65,-28,30
Cowdenbeath,4257,10,4,11,21,23,54,-31,23
Montrose,4258,1,24,7,5,61,34,27,79
Peterhead,4258,2,24,4,8,80,39,41,76
Stirling,4258,3,17,6,13,64,53,11,57
Stenhousem'r,4258,4,15,8,13,57,50,7,53
Clyde,4258,5,14,9,13,52,50,2,51
Elgin,4258,6,14,6,16,53,62,-9,48
Annan Athlet,4258,7,12,11,13,49,42,7,47
Berwick,4258,8,9,10,17,31,59,-28,37
Edinburgh Ci,4258,9,7,9,20,37,63,-26,30
Cowdenbeath,4258,10,4,10,22,24,56,-32,22
Montrose,4259,1,24,7,5,63,36,27,79
Peterhead,4259,2,24,4,8,80,39,41,76
Stirling,4259,3,17,6,13,64,53,11,57
Stenhousem'r,4259,4,15,8,13,57,50,7,53
Clyde,4259,5,14,10,12,51,48,3,52
Elgin,4259,6,14,6,16,55,64,-9,48
Annan Athlet,4259,7,12,11,13,48,41,7,47
Berwick,4259,8,8,11,17,29,58,-29,35
Edinburgh Ci,4259,9,7,9,20,37,63,-26,30
Cowdenbeath,4259,10,4,10,22,23,55,-32,22
Montrose,4260,1,24,7,5,64,36,28,79
Peterhead,4260,2,23,4,9,79,42,37,73
Stirling,4260,3,16,7,13,61,52,9,55
Stenhousem'r,4260,4,15,9,12,56,47,9,54
Clyde,4260,5,15,9,12,55,51,4,54
Elgin,4260,6,14,6,16,55,65,-10,48
Annan Athlet,4260,7,11,12,13,48,42,6,45
Berwick,4260,8,8,10,18,32,62,-30,34
Edinburgh Ci,4260,9,8,9,19,40,62,-22,33
Cowdenbeath,4260,10,4,11,21,24,55,-31,23
Montrose,4261,1,24,7,5,64,36,28,79
Peterhead,4261,2,24,4,8,81,38,43,76
Stenhousem'r,4261,3,16,8,12,58,46,12,56
Stirling,4261,4,16,6,14,60,54,6,54
Clyde,4261,5,15,9,12,54,49,5,54
Elgin,4261,6,14,6,16,55,65,-10,48
Annan Athlet,4261,7,11,11,14,48,43,5,44
Berwick,4261,8,8,10,18,30,61,-31,34
Edinburgh Ci,4261,9,7,9,20,36,64,-28,30
Cowdenbeath,4261,10,5,10,21,25,55,-30,25
Peterhead,4262,1,24,4,8,80,39,41,76
Montrose,4262,2,23,7,6,60,36,24,76
Stirling,4262,3,16,7,13,61,52,9,55
Stenhousem'r,4262,4,15,9,12,56,47,9,54
Clyde,4262,5,14,9,13,51,49,2,51
Elgin,4262,6,15,6,15,55,61,-6,51
Annan Athlet,4262,7,11,11,14,48,43,5,44
Berwick,4262,8,9,10,17,30,58,-28,37
Edinburgh Ci,4262,9,7,9,20,37,63,-26,30
Cowdenbeath,4262,10,5,10,21,25,55,-30,25
Montrose,4263,1,24,7,5,61,34,27,79
Peterhead,4263,2,23,4,9,78,40,38,73
Stirling,4263,3,17,6,13,62,51,11,57
Stenhousem'r,4263,4,15,8,13,55,48,7,53
Clyde,4263,5,14,9,13,51,51,0,51
Elgin,4263,6,14,6,16,53,62,-9,48
Annan Athlet,4263,7,12,11,13,51,41,10,47
Berwick,4263,8,9,10,17,32,58,-26,37
Edinburgh Ci,4263,9,8,9,19,38,61,-23,33
Cowdenbeath,4263,10,4,10,22,23,58,-35,22
Peterhead,4264,1,24,4,8,80,38,42,76
Montrose,4264,2,23,7,6,59,36,23,76
Stirling,4264,3,17,6,13,61,51,10,57
Stenhousem'r,4264,4,15,8,13,55,47,8,53
Clyde,4264,5,14,9,13,52,50,2,51
Elgin,4264,6,15,6,15,55,60,-5,51
Annan Athlet,4264,7,11,11,14,48,43,5,44
Berwick,4264,8,9,10,17,31,59,-28,37
Edinburgh Ci,4264,9,7,9,20,36,63,-27,30
Cowdenbeath,4264,10,5,10,21,25,55,-30,25
Peterhead,4265,1,24,4,8,80,39,41,76
Montrose,4265,2,23,7,6,61,37,24,76
Stenhousem'r,4265,3,16,8,12,58,48,10,56
Stirling,4265,4,16,6,14,62,54,8,54
Clyde,4265,5,14,10,12,52,49,3,52
Elgin,4265,6,15,6,15,56,62,-6,51
Annan Athlet,4265,7,12,11,13,48,41,7,47
Berwick,4265,8,8,11,17,30,59,-29,35
Edinburgh Ci,4265,9,7,9,20,37,63,-26,30
Cowdenbeath,4265,10,4,10,22,23,55,-32,22
Montrose,4266,1,24,7,5,63,36,27,79
Peterhead,4266,2,24,4,8,80,40,40,76
Stirling,4266,3,17,6,13,63,51,12,57
Stenhousem'r,4266,4,15,8,13,55,49,6,53
Clyde,4266,5,14,10,12,52,49,3,52
Elgin,4266,6,14,6,16,55,64,-9,48
Annan Athlet,4266,7,12,11,13,50,41,9,47
Berwick,4266,8,8,11,17,30,59,-29,35
Edinburgh Ci,4266,9,7,9,20,38,63,-25,30
Cowdenbeath,4266,10,4,10,22,23,57,-34,22
Montrose,4267,1,24,7,5,61,35,26,79
Peterhead,4267,2,24,4,8,81,38,43,76
Stirling,4267,3,16,7,13,61,52,9,55
Stenhousem'r,4267,4,15,9,12,56,47,9,54
Clyde,4267,5,14,10,12,51,48,3,52
Elgin,4267,6,14,6,16,54,62,-8,48
Annan Athlet,4267,7,12,11,13,49,41,8,47
Berwick,4267,8,8,11,17,29,58,-29,35
Edinburgh Ci,4267,9,7,9,20,36,64,-28,30
Cowdenbeath,4267,10,4,10,22,23,56,-33,22
Montrose,4268,1,23,8,5,60,35,25,77
Peterhead,4268,2,24,4,8,83,38,45,76
Stirling,4268,3,17,6,13,61,51,10,57
Clyde,4268,4,15,9,12,55,49,6,54
Stenhousem'r,4268,5,15,8,13,55,47,8,53
Elgin,4268,6,14,7,15,54,61,-7,49
Annan Athlet,4268,7,11,12,13,47,41,6,45
Berwick,4268,8,8,10,18,30,62,-32,34
Edinburgh Ci,4268,9,7,9,20,36,66,-30,30
Cowdenbeath,4268,10,4,11,21,23,54,-31,23
Montrose,4269,1,24,7,5,62,35,27,79
Peterhead,4269,2,24,4,8,81,39,42,76
Stirling,4269,3,17,6,13,62,52,10,57
Clyde,4269,4,15,9,12,57,49,8,54
Stenhousem'r,4269,5,15,8,13,56,48,8,53
Elgin,4269,6,14,6,16,54,63,-9,48
Annan Athlet,4269,7,11,11,14,47,44,3,44
Berwick,4269,8,8,10,18,30,64,-34,34
Edinburgh Ci,4269,9,7,9,20,37,64,-27,30
Cowdenbeath,4269,10,5,10,21,26,54,-28,25
Montrose,4270,1,24,7,5,60,34,26,79
Peterhead,4270,2,23,4,9,78,40,38,73
Stirling,4270,3,17,6,13,62,51,11,57
Clyde,4270,4,15,9,12,52,48,4,54
Stenhousem'r,4270,5,15,8,13,55,48,7,53
Elgin,4270,6,14,6,16,53,61,-8,48
Annan Athlet,4270,7,11,11,14,47,43,4,44
Berwick,4270,8,8,10,18,29,59,-30,34
Edinburgh Ci,4270,9,8,9,19,38,61,-23,33
Cowdenbeath,4270,10,5,10,21,25,54,-29,25
Montrose,4271,1,24,7,5,63,35,28,79
Peterhead,4271,2,24,4,8,79,38,41,76
Stenhousem'r,4271,3,16,8,12,59,47,12,56
Stirling,4271,4,16,6,14,61,55,6,54
Clyde,4271,5,15,9,12,52,48,4,54
Elgin,4271,6,14,6,16,54,64,-10,48
Annan Athlet,4271,7,12,11,13,50,42,8,47
Berwick,4271,8,8,10,18,29,59,-30,34
Edinburgh Ci,4271,9,7,9,20,36,62,-26,30
Cowdenbeath,4271,10,4,10,22,24,57,-33,22
Montrose,4272,1,24,7,5,60,34,26,79
Peterhead,4272,2,23,4,9,77,41,36,73
Stirling,4272,3,16,7,13,62,53,9,55
Stenhousem'r,4272,4,15,9,12,57,48,9,54
Clyde,4272,5,15,9,12,54,49,5,54
Elgin,4272,6,14,6,16,53,61,-8,48
Annan Athlet,4272,7,12,11,13,48,41,7,47
Berwick,4272,8,8,10,18,30,61,-31,34
Edinburgh Ci,4272,9,8,9,19,39,60,-21,33
Cowdenbeath,4272,10,4,10,22,23,55,-32,22
Montrose,4273,1,24,7,5,60,34,26,79
Peterhead,4273,2,24,4,8,79,39,40,76
Stirling,4273,3,16,7,13,62,53,9,55
Stenhousem'r,4273,4,15,9,12,57,48,9,54
Clyde,4273,5,14,10,12,53,50,3,52
Elgin,4273,6,14,6,16,53,61,-8,48
Annan Athlet,4273,7,12,11,13,50,42,8,47
Berwick,4273,8,8,11,17,31,60,-29,35
Edinburgh Ci,4273,9,7,9,20,37,62,-25,30
Cowdenbeath,4273,10,4,10,22,24,57,-33,22
Montrose,4274,1,24,7,5,62,34,28,79
Peterhead,4274,2,24,4,8,80,39,41,76
Stirling,4274,3,17,6,13,63,52,11,57
Stenhousem'r,4274,4,15,8,13,56,49,7,53
Clyde,4274,5,14,10,12,51,48,3,52
Elgin,4274,6,14,6,16,53,63,-10,48
Annan Athlet,4274,7,11,12,13,47,41,6,45
Berwick,4274,8,8,11,17,29,58,-29,35
Edinburgh Ci,4274,9,7,9,20,37,63,-26,30
Cowdenbeath,4274,10,4,11,21,23,54,-31,23
Montrose,4275,1,23,8,5,60,35,25,77
Peterhead,4275,2,24,4,8,83,39,44,76
Stirling,4275,3,17,6,13,62,51,11,57
Clyde,4275,4,15,9,12,54,49,5,54
Stenhousem'r,4275,5,15,8,13,55,48,7,53
Elgin,4275,6,14,7,15,54,61,-7,49
Annan Athlet,4275,7,12,11,13,49,41,8,47
Berwick,4275,8,8,10,18,30,61,-31,34
Edinburgh Ci,4275,9,7,9,20,37,66,-29,30
Cowdenbeath,4275,10,4,10,22,23,56,-33,22
Montrose,4276,1,24,7,5,62,35,27,79
Peterhead,4276,2,24,4,8,82,39,43,76
Stenhousem'r,4276,3,16,8,12,57,47,10,56
Stirling,4276,4,16,6,14,61,53,8,54
Clyde,4276,5,15,9,12,52,48,4,54
Elgin,4276,6,14,6,16,54,63,-9,48
Annan Athlet,4276,7,12,11,13,48,41,7,47
Berwick,4276,8,8,10,18,29,59,-30,34
Edinburgh Ci,4276,9,7,9,20,37,65,-28,30
Cowdenbeath,4276,10,4,10,22,23,55,-32,22
Montrose,4277,1,24,7,5,63,37,26,79
Peterhead,4277,2,23,5,8,78,39,39,74
Stirling,4277,3,16,7,13,61,52,9,55
Stenhousem'r,4277,4,15,9,12,56,47,9,54
Clyde,4277,5,14,9,13,51,49,2,51
Elgin,4277,6,14,6,16,56,64,-8,48
Annan Athlet,4277,7,11,12,13,48,42,6,45
Berwick,4277,8,9,10,17,30,58,-28,37
Edinburgh Ci,4277,9,7,10,19,37,61,-24,31
Cowdenbeath,4277,10,4,11,21,24,55,-31,23
Peterhead,4278,1,24,4,8,80,38,42,76
Montrose,4278,2,23,7,6,59,36,23,76
Stirling,4278,3,16,7,13,62,53,9,55
Stenhousem'r,4278,4,15,9,12,57,48,9,54
Clyde,4278,5,14,10,12,53,50,3,52
Elgin,4278,6,15,6,15,55,60,-5,51
Annan Athlet,4278,7,12,11,13,48,41,7,47
Berwick,4278,8,8,11,17,31,60,-29,35
Edinburgh Ci,4278,9,7,9,20,36,63,-27,30
Cowdenbeath,4278,10,4,10,22,23,55,-32,22
Montrose,4279,1,23,8,5,59,34,25,77
Peterhead,4279,2,24,4,8,81,38,43,76
Stirling,4279,3,17,6,13,62,52,10,57
Clyde,4279,4,15,9,12,54,50,4,54
Stenhousem'r,4279,5,15,8,13,56,48,8,53
Elgin,4279,6,14,7,15,53,60,-7,49
Annan Athlet,4279,7,11,12,13,48,42,6,45
Berwick,4279,8,8,10,18,31,61,-30,34
Edinburgh Ci,4279,9,7,9,20,36,64,-28,30
Cowdenbeath,4279,10,4,11,21,24,55,-31,23
Montrose,4280,1,24,7,5,60,34,26,79
Peterhead,4280,2,23,5,8,78,39,39,74
Stirling,4280,3,16,7,13,61,52,9,55
Stenhousem'r,4280,4,15,9,12,56,47,9,54
Clyde,4280,5,15,9,12,54,49,5,54
Elgin,4280,6,14,6,16,53,61,-8,48
Annan Athlet,4280,7,11,11,14,48,43,5,44
Berwick,4280,8,8,10,18,30,61,-31,34
Edinburgh Ci,4280,9,7,10,19,37,61,-24,31
Cowdenbeath,4280,10,5,10,21,25,55,-30,25
Montrose,4281,1,24,7,5,62,35,27,79
Peterhead,4281,2,24,4,8,79,39,40,76
Stirling,4281,3,17,6,13,63,51,12,57
Clyde,4281,4,15,9,12,56,48,8,54
Stenhousem'r,4281,5,15,8,13,55,49,6,53
Elgin,4281,6,14,6,16,54,63,-9,48
Annan Athlet,4281,7,11,12,13,48,42,6,45
Berwick,4281,8,8,10,18,29,63,-34,34
Edinburgh Ci,4281,9,7,9,20,37,62,-25,30
Cowdenbeath,4281,10,4,11,21,24,55,-31,23
Montrose,4282,1,24,7,5,62,35,27,79
Peterhead,4282,2,24,4,8,81,38,43,76
Stirling,4282,3,17,6,13,63,53,10,57
Clyde,4282,4,15,9,12,53,49,4,54
Stenhousem'r,4282,5,15,8,13,57,49,8,53
Elgin,4282,6,14,6,16,54,63,-9,48
Annan Athlet,4282,7,11,12,13,48,42,6,45
Berwick,4282,8,8,10,18,30,60,-30,34
Edinburgh Ci,4282,9,7,9,20,36,64,-28,30
Cowdenbeath,4282,10,4,11,21,24,55,-31,23
Montrose,4283,1,24,7,5,63,35,28,79
Peterhead,4283,2,24,4,8,79,38,41,76
Stirling,4283,3,17,6,13,63,52,11,57
Clyde,4283,4,15,9,12,54,48,6,54
Stenhousem'r,4283,5,15,8,13,56,49,7,53
Elgin,4283,6,14,6,16,54,64,-10,48
Annan Athlet,4283,7,11,12,13,48,42,6,45
Berwick,4283,8,8,10,18,29,61,-32,34
Edinburgh Ci,4283,9,7,9,20,36,62,-26,30
Cowdenbeath,4283,10,4,11,21,24,55,-31,23
Montrose,4284,1,24,7,5,61,34,27,79
Peterhead,4284,2,23,4,9,78,40,38,73
Stirling,4284,3,17,6,13,64,53,11,57
Stenhousem'r,4284,4,15,8,13,57,50,7,53
Clyde,4284,5,14,10,12,52,49,3,52
Elgin,4284,6,14,6,16,53,62,-9,48
Annan Athlet,4284,7,11,12,13,48,42,6,45
Berwick,4284,8,8,11,17,30,59,-29,35
Edinburgh Ci,4284,9,8,9,19,38,61,-23,33
Cowdenbeath,4284,10,4,11,21,24,55,-31,23
Montrose,4285,1,24,7,5,61,35,26,79
Peterhead,4285,2,23,5,8,79,40,39,74
Stirling,4285,3,17,6,13,62,51,11,57
Stenhousem'r,4285,4,15,8,13,55,48,7,53
Clyde,4285,5,14,9,13,52,50,2,51
Elgin,4285,6,14,6,16,54,62,-8,48
Annan Athlet,4285,7,11,12,13,48,42,6,45
Berwick,4285,8,9,10,17,31,59,-28,37
Edinburgh Ci,4285,9,7,10,19,38,62,-24,31
Cowdenbeath,4285,10,4,11,21,24,55,-31,23
Montrose,4286,1,23,8,5,61,36,25,77
Peterhead,4286,2,24,4,8,85,38,47,76
Stirling,4286,3,17,6,13,62,52,10,57
Clyde,4286,4,15,9,12,55,48,7,54
Stenhousem'r,4286,5,15,8,13,56,48,8,53
Elgin,4286,6,14,7,15,55,62,-7,49
Annan Athlet,4286,7,11,12,13,47,41,6,45
Berwick,4286,8,8,10,18,29,62,-33,34
Edinburgh Ci,4286,9,7,9,20,36,68,-32,30
Cowdenbeath,4286,10,4,11,21,23,54,-31,23
Montrose,4287,1,24,7,5,61,34,27,79
Peterhead,4287,2,24,4,8,84,39,45,76
Stirling,4287,3,16,7,13,61,52,9,55
Stenhousem'r,4287,4,15,9,12,56,47,9,54
Clyde,4287,5,15,9,12,53,49,4,54
Elgin,4287,6,14,6,16,53,62,-9,48
Annan Athlet,4287,7,11,12,13,48,42,6,45
Berwick,4287,8,8,10,18,30,60,-30,34
Edinburgh Ci,4287,9,7,9,20,37,67,-30,30
Cowdenbeath,4287,10,4,11,21,24,55,-31,23
Montrose,4288,1,24,7,5,61,35,26,79
Peterhead,4288,2,24,4,8,83,39,44,76
Stirling,4288,3,16,7,13,61,52,9,55
Stenhousem'r,4288,4,15,9,12,56,47,9,54
Clyde,4288,5,15,9,12,52,48,4,54
Elgin,4288,6,14,6,16,54,62,-8,48
Annan Athlet,4288,7,12,11,13,50,43,7,47
Berwick,4288,8,8,10,18,29,59,-30,34
Edinburgh Ci,4288,9,7,9,20,37,66,-29,30
Cowdenbeath,4288,10,4,10,22,25,57,-32,22
Montrose,4289,1,24,7,5,62,34,28,79
Peterhead,4289,2,24,4,8,79,39,40,76
Stenhousem'r,4289,3,16,8,12,56,46,10,56
Stirling,4289,4,16,6,14,60,52,8,54
Clyde,4289,5,15,9,12,53,49,4,54
Elgin,4289,6,14,6,16,53,63,-10,48
Annan Athlet,4289,7,12,11,13,49,42,7,47
Berwick,4289,8,8,10,18,30,60,-30,34
Edinburgh Ci,4289,9,7,9,20,37,62,-25,30
Cowdenbeath,4289,10,4,10,22,24,56,-32,22
Montrose,4290,1,24,7,5,64,36,28,79
Peterhead,4290,2,24,4,8,82,38,44,76
Stirling,4290,3,17,6,13,65,52,13,57
Stenhousem'r,4290,4,15,8,13,56,51,5,53
Clyde,4290,5,14,10,12,52,49,3,52
Elgin,4290,6,14,6,16,55,65,-10,48
Annan Athlet,4290,7,11,12,13,48,42,6,45
Berwick,4290,8,8,11,17,30,59,-29,35
Edinburgh Ci,4290,9,7,9,20,36,65,-29,30
Cowdenbeath,4290,10,4,11,21,24,55,-31,23
Montrose,4291,1,24,7,5,62,34,28,79
Peterhead,4291,2,23,4,9,77,39,38,73
Stenhousem'r,4291,3,16,8,12,57,47,10,56
Stirling,4291,4,16,6,14,61,53,8,54
Clyde,4291,5,15,9,12,54,49,5,54
Elgin,4291,6,14,6,16,53,63,-10,48
Annan Athlet,4291,7,11,12,13,48,42,6,45
Berwick,4291,8,8,10,18,30,61,-31,34
Edinburgh Ci,4291,9,8,9,19,37,60,-23,33
Cowdenbeath,4291,10,4,11,21,24,55,-31,23
Montrose,4292,1,24,7,5,64,35,29,79
Peterhead,4292,2,24,4,8,79,38,41,76
Stirling,4292,3,17,6,13,65,52,13,57
Stenhousem'r,4292,4,15,8,13,56,51,5,53
Clyde,4292,5,14,9,13,51,49,2,51
Elgin,4292,6,14,6,16,54,65,-11,48
Annan Athlet,4292,7,12,11,13,50,42,8,47
Berwick,4292,8,9,10,17,30,58,-28,37
Edinburgh Ci,4292,9,7,9,20,36,62,-26,30
Cowdenbeath,4292,10,4,10,22,24,57,-33,22
Montrose,4293,1,24,7,5,61,35,26,79
Peterhead,4293,2,24,4,8,82,39,43,76
Stirling,4293,3,16,7,13,61,52,9,55
Stenhousem'r,4293,4,15,9,12,56,47,9,54
Clyde,4293,5,15,9,12,52,48,4,54
Elgin,4293,6,14,6,16,54,62,-8,48
Annan Athlet,4293,7,12,11,13,50,42,8,47
Berwick,4293,8,8,10,18,29,59,-30,34
Edinburgh Ci,4293,9,7,9,20,37,65,-28,30
Cowdenbeath,4293,10,4,10,22,24,57,-33,22
Montrose,4294,1,24,7,5,63,36,27,79
Peterhead,4294,2,24,4,8,79,39,40,76
Stenhousem'r,4294,3,16,8,12,58,47,11,56
Stirling,4294,4,16,6,14,61,54,7,54
Clyde,4294,5,15,9,12,53,48,5,54
Elgin,4294,6,14,6,16,55,64,-9,48
Annan Athlet,4294,7,11,12,13,48,42,6,45
Berwick,4294,8,8,10,18,29,60,-31,34
Edinburgh Ci,4294,9,7,9,20,37,62,-25,30
Cowdenbeath,4294,10,4,11,21,24,55,-31,23
Montrose,4295,1,23,8,5,59,34,25,77
Peterhead,4295,2,24,4,8,81,39,42,76
Stenhousem'r,4295,3,16,8,12,58,47,11,56
Stirling,4295,4,16,6,14,61,54,7,54
Clyde,4295,5,15,9,12,55,48,7,54
Elgin,4295,6,14,7,15,53,60,-7,49
Annan Athlet,4295,7,11,11,14,47,42,5,44
Berwick,4295,8,8,10,18,29,62,-33,34
Edinburgh Ci,4295,9,7,9,20,37,64,-27,30
Cowdenbeath,4295,10,5,10,21,24,54,-30,25
Montrose,4296,1,23,8,5,59,34,25,77
Peterhead,4296,2,24,4,8,79,39,40,76
Stirling,4296,3,16,7,13,61,52,9,55
Stenhousem'r,4296,4,15,9,12,56,47,9,54
Clyde,4296,5,14,10,12,52,49,3,52
Elgin,4296,6,14,7,15,53,60,-7,49
Annan Athlet,4296,7,12,11,13,49,41,8,47
Berwick,4296,8,8,11,17,30,59,-29,35
Edinburgh Ci,4296,9,7,9,20,37,62,-25,30
Cowdenbeath,4296,10,4,10,22,23,56,-33,22
Montrose,4297,1,24,7,5,62,35,27,79
Peterhead,4297,2,24,4,8,79,38,41,76
Stirling,4297,3,17,6,13,62,51,11,57
Clyde,4297,4,15,9,12,55,49,6,54
Stenhousem'r,4297,5,15,8,13,55,48,7,53
Elgin,4297,6,14,6,16,54,63,-9,48
Annan Athlet,4297,7,12,11,13,51,43,8,47
Berwick,4297,8,8,10,18,30,62,-32,34
Edinburgh Ci,4297,9,7,9,20,36,62,-26,30
Cowdenbeath,4297,10,4,10,22,25,58,-33,22
Montrose,4298,1,24,7,5,62,34,28,79
Peterhead,4298,2,24,4,8,81,39,42,76
Stirling,4298,3,17,6,13,64,51,13,57
Clyde,4298,4,15,9,12,52,48,4,54
Stenhousem'r,4298,5,15,8,13,55,50,5,53
Elgin,4298,6,14,6,16,53,63,-10,48
Annan Athlet,4298,7,11,12,13,48,42,6,45
Berwick,4298,8,8,10,18,29,59,-30,34
Edinburgh Ci,4298,9,7,9,20,37,64,-27,30
Cowdenbeath,4298,10,4,11,21,24,55,-31,23
Montrose,4299,1,24,7,5,63,34,29,79
Peterhead,4299,2,24,4,8,83,40,43,76
Stirling,4299,3,17,6,13,63,52,11,57
Clyde,4299,4,15,9,12,52,48,4,54
Stenhousem'r,4299,5,15,8,13,56,49,7,53
Elgin,4299,6,14,6,16,53,64,-11,48
Annan Athlet,4299,7,11,12,13,48,42,6,45
Berwick,4299,8,8,10,18,29,59,-30,34
Edinburgh Ci,4299,9,7,9,20,38,66,-28,30
Cowdenbeath,4299,10,4,11,21,24,55,-31,23
Montrose,4300,1,23,8,5,62,37,25,77
Peterhead,4300,2,24,4,8,80,39,41,76
Stirling,4300,3,17,6,13,63,52,11,57
Stenhousem'r,4300,4,15,8,13,56,49,7,53
Clyde,4300,5,14,9,13,52,50,2,51
Elgin,4300,6,14,7,15,56,63,-7,49
Annan Athlet,4300,7,11,12,13,48,42,6,45
Berwick,4300,8,9,10,17,31,59,-28,37
Edinburgh Ci,4300,9,7,9,20,37,63,-26,30
Cowdenbeath,4300,10,4,11,21,24,55,-31,23
Montrose,4301,1,24,7,5,63,35,28,79
Peterhead,4301,2,24,4,8,79,38,41,76
Stirling,4301,3,17,6,13,61,51,10,57
Clyde,4301,4,15,9,12,53,49,4,54
Stenhousem'r,4301,5,15,8,13,55,47,8,53
Elgin,4301,6,14,6,16,54,64,-10,48
Annan Athlet,4301,7,11,12,13,48,42,6,45
Berwick,4301,8,8,10,18,30,60,-30,34
Edinburgh Ci,4301,9,7,9,20,36,62,-26,30
Cowdenbeath,4301,10,4,11,21,24,55,-31,23
Montrose,4302,1,24,7,5,61,34,27,79
Peterhead,4302,2,23,5,8,77,38,39,74
Stirling,4302,3,16,7,13,60,51,9,55
Stenhousem'r,4302,4,15,9,12,55,46,9,54
Clyde,4302,5,14,10,12,51,48,3,52
Elgin,4302,6,14,6,16,53,62,-9,48
Annan Athlet,4302,7,11,12,13,48,42,6,45
Berwick,4302,8,8,11,17,29,58,-29,35
Edinburgh Ci,4302,9,7,10,19,36,60,-24,31
Cowdenbeath,4302,10,4,11,21,24,55,-31,23
Montrose,4303,1,23,7,6,59,35,24,76
Peterhead,4303,2,23,4,9,77,39,38,73
Stirling,4303,3,16,7,13,61,52,9,55
Stenhousem'r,4303,4,15,9,12,56,47,9,54
Clyde,4303,5,15,9,12,52,48,4,54
Elgin,4303,6,15,6,15,54,60,-6,51
Annan Athlet,4303,7,11,11,14,47,42,5,44
Berwick,4303,8,8,10,18,29,59,-30,34
Edinburgh Ci,4303,9,8,9,19,37,60,-23,33
Cowdenbeath,4303,10,5,10,21,24,54,-30,25
Montrose,4304,1,23,8,5,59,34,25,77
Peterhead,4304,2,24,4,8,79,38,41,76
Stirling,4304,3,17,6,13,64,51,13,57
Clyde,4304,4,15,9,12,53,48,5,54
Stenhousem'r,4304,5,15,8,13,55,50,5,53
Elgin,4304,6,14,7,15,53,60,-7,49
Annan Athlet,4304,7,12,11,13,49,42,7,47
Berwick,4304,8,8,10,18,29,60,-31,34
Edinburgh Ci,4304,9,7,9,20,36,62,-26,30
Cowdenbeath,4304,10,4,10,22,24,56,-32,22
Montrose,4305,1,24,7,5,61,35,26,79
Peterhead,4305,2,23,4,9,79,41,38,73
Stirling,4305,3,16,7,13,61,52,9,55
Stenhousem'r,4305,4,15,9,12,56,47,9,54
Clyde,4305,5,15,9,12,56,49,7,54
Elgin,4305,6,14,6,16,54,62,-8,48
Annan Athlet,4305,7,11,12,13,49,43,6,45
Berwick,4305,8,8,10,18,30,63,-33,34
Edinburgh Ci,4305,9,8,9,19,39,62,-23,33
Cowdenbeath,4305,10,4,11,21,25,56,-31,23
Montrose,4306,1,23,7,6,60,38,22,76
Peterhead,4306,2,23,5,8,78,39,39,74
Stirling,4306,3,17,6,13,62,51,11,57
Stenhousem'r,4306,4,15,8,13,55,48,7,53
Clyde,4306,5,14,9,13,51,50,1,51
Elgin,4306,6,15,6,15,57,61,-4,51
Annan Athlet,4306,7,11,12,13,48,42,6,45
Berwick,4306,8,9,10,17,31,58,-27,37
Edinburgh Ci,4306,9,7,10,19,37,61,-24,31
Cowdenbeath,4306,10,4,11,21,24,55,-31,23
Montrose,4307,1,23,8,5,62,37,25,77
Peterhead,4307,2,24,4,8,79,38,41,76
Stirling,4307,3,17,6,13,64,52,12,57
Stenhousem'r,4307,4,15,8,13,56,50,6,53
Clyde,4307,5,14,9,13,52,50,2,51
Elgin,4307,6,14,7,15,56,63,-7,49
Annan Athlet,4307,7,12,11,13,49,41,8,47
Berwick,4307,8,9,10,17,31,59,-28,37
Edinburgh Ci,4307,9,7,9,20,36,62,-26,30
Cowdenbeath,4307,10,4,10,22,23,56,-33,22
Montrose,4308,1,23,8,5,60,35,25,77
Peterhead,4308,2,24,4,8,79,39,40,76
Stirling,4308,3,17,6,13,63,53,10,57
Clyde,4308,4,15,9,12,53,48,5,54
Stenhousem'r,4308,5,15,8,13,57,49,8,53
Elgin,4308,6,14,7,15,54,61,-7,49
Annan Athlet,4308,7,11,12,13,48,42,6,45
Berwick,4308,8,8,10,18,29,60,-31,34
Edinburgh Ci,4308,9,7,9,20,37,62,-25,30
Cowdenbeath,4308,10,4,11,21,24,55,-31,23
Peterhead,4309,1,24,4,8,81,39,42,76
Montrose,4309,2,23,7,6,63,39,24,76
Stirling,4309,3,17,6,13,64,51,13,57
Clyde,4309,4,15,9,12,54,49,5,54
Stenhousem'r,4309,5,15,8,13,55,50,5,53
Elgin,4309,6,15,6,15,58,64,-6,51
Annan Athlet,4309,7,11,11,14,47,42,5,44
Berwick,4309,8,8,10,18,30,61,-31,34
Edinburgh Ci,4309,9,7,9,20,37,64,-27,30
Cowdenbeath,4309,10,5,10,21,24,54,-30,25
Montrose,4310,1,24,7,5,61,34,27,79
Peterhead,4310,2,24,4,8,82,38,44,76
Stirling,4310,3,17,6,13,63,51,12,57
Clyde,4310,4,15,9,12,53,48,5,54
Stenhousem'r,4310,5,15,8,13,55,49,6,53
Elgin,4310,6,14,6,16,53,62,-9,48
Annan Athlet,4310,7,12,11,13,48,41,7,47
Berwick,4310,8,8,10,18,29,60,-31,34
Edinburgh Ci,4310,9,7,9,20,36,65,-29,30
Cowdenbeath,4310,10,4,10,22,23,55,-32,22
Montrose,4311,1,24,7,5,64,34,30,79
Peterhead,4311,2,24,4,8,82,39,43,76
Stenhousem'r,4311,3,16,8,12,58,47,11,56
Stirling,4311,4,16,6,14,61,54,7,54
Clyde,4311,5,15,9,12,53,48,5,54
Elgin,4311,6,14,6,16,53,65,-12,48
Annan Athlet,4311,7,11,11,14,47,42,5,44
Berwick,4311,8,8,10,18,29,60,-31,34
Edinburgh Ci,4311,9,7,9,20,37,65,-28,30
Cowdenbeath,4311,10,5,10,21,24,54,-30,25
Montrose,4312,1,24,7,5,61,35,26,79
Peterhead,4312,2,24,4,8,80,38,42,76
Stirling,4312,3,17,6,13,61,51,10,57
Clyde,4312,4,15,9,12,53,49,4,54
Stenhousem'r,4312,5,15,8,13,55,47,8,53
Elgin,4312,6,14,6,16,54,62,-8,48
Annan Athlet,4312,7,11,11,14,49,44,5,44
Berwick,4312,8,8,10,18,30,60,-30,34
Edinburgh Ci,4312,9,7,9,20,36,63,-27,30
Cowdenbeath,4312,10,5,10,21,26,56,-30,25
Peterhead,4313,1,24,4,8,78,38,40,76
Montrose,4313,2,23,7,6,59,36,23,76
Stenhousem'r,4313,3,16,8,12,57,47,10,56
Stirling,4313,4,16,6,14,61,53,8,54
Clyde,4313,5,14,9,13,52,50,2,51
Elgin,4313,6,15,6,15,55,60,-5,51
Annan Athlet,4313,7,11,12,13,47,41,6,45
Berwick,4313,8,9,10,17,31,59,-28,37
Edinburgh Ci,4313,9,7,9,20,36,61,-25,30
Cowdenbeath,4313,10,4,11,21,23,54,-31,23
Peterhead,4314,1,24,4,8,82,40,42,76
Montrose,4314,2,23,7,6,59,36,23,76
Stirling,4314,3,17,6,13,62,51,11,57
Stenhousem'r,4314,4,15,8,13,55,48,7,53
Clyde,4314,5,14,10,12,52,49,3,52
Elgin,4314,6,15,6,15,55,60,-5,51
Annan Athlet,4314,7,11,11,14,47,42,5,44
Berwick,4314,8,8,11,17,30,59,-29,35
Edinburgh Ci,4314,9,7,9,20,38,65,-27,30
Cowdenbeath,4314,10,5,10,21,24,54,-30,25
Montrose,4315,1,24,7,5,61,35,26,79
Peterhead,4315,2,23,4,9,78,40,38,73
Stirling,4315,3,16,7,13,62,53,9,55
Stenhousem'r,4315,4,15,9,12,57,48,9,54
Clyde,4315,5,15,9,12,54,48,6,54
Elgin,4315,6,14,6,16,54,62,-8,48
Annan Athlet,4315,7,12,11,13,48,41,7,47
Berwick,4315,8,8,10,18,29,61,-32,34
Edinburgh Ci,4315,9,8,9,19,38,61,-23,33
Cowdenbeath,4315,10,4,10,22,23,55,-32,22
Montrose,4316,1,24,7,5,62,36,26,79
Peterhead,4316,2,24,4,8,81,39,42,76
Stirling,4316,3,17,6,13,64,52,12,57
Stenhousem'r,4316,4,15,8,13,56,50,6,53
Clyde,4316,5,14,9,13,51,49,2,51
Elgin,4316,6,14,6,16,55,63,-8,48
Annan Athlet,4316,7,12,11,13,49,42,7,47
Berwick,4316,8,9,10,17,30,58,-28,37
Edinburgh Ci,4316,9,7,9,20,37,64,-27,30
Cowdenbeath,4316,10,4,10,22,24,56,-32,22
Montrose,4317,1,23,8,5,60,35,25,77
Peterhead,4317,2,24,4,8,79,39,40,76
Stirling,4317,3,16,7,13,62,53,9,55
Stenhousem'r,4317,4,15,9,12,57,48,9,54
Clyde,4317,5,15,9,12,56,48,8,54
Elgin,4317,6,14,7,15,54,61,-7,49
Annan Athlet,4317,7,11,12,13,50,44,6,45
Berwick,4317,8,8,10,18,29,63,-34,34
Edinburgh Ci,4317,9,7,9,20,37,62,-25,30
Cowdenbeath,4317,10,4,11,21,26,57,-31,23
Montrose,4318,1,23,8,5,63,38,25,77
Peterhead,4318,2,24,4,8,78,38,40,76
Stirling,4318,3,16,7,13,62,53,9,55
Stenhousem'r,4318,4,15,9,12,57,48,9,54
Clyde,4318,5,15,9,12,55,48,7,54
Elgin,4318,6,14,7,15,57,64,-7,49
Annan Athlet,4318,7,11,11,14,48,43,5,44
Berwick,4318,8,8,10,18,29,62,-33,34
Edinburgh Ci,4318,9,7,9,20,36,61,-25,30
Cowdenbeath,4318,10,5,10,21,25,55,-30,25
Peterhead,4319,1,24,4,8,78,38,40,76
Montrose,4319,2,23,7,6,60,36,24,76
Stirling,4319,3,16,7,13,61,52,9,55
Stenhousem'r,4319,4,15,9,12,56,47,9,54
Clyde,4319,5,15,9,12,54,50,4,54
Elgin,4319,6,15,6,15,55,61,-6,51
Annan Athlet,4319,7,11,12,13,47,41,6,45
Berwick,4319,8,8,10,18,31,61,-30,34
Edinburgh Ci,4319,9,7,9,20,36,61,-25,30
Cowdenbeath,4319,10,4,11,21,23,54,-31,23
Peterhead,4320,1,24,4,8,80,39,41,76
Montrose,4320,2,23,7,6,59,36,23,76
Stenhousem'r,4320,3,16,8,12,57,46,11,56
Stirling,4320,4,16,6,14,60,53,7,54
Clyde,4320,5,15,9,12,53,48,5,54
Elgin,4320,6,15,6,15,55,60,-5,51
Annan Athlet,4320,7,11,12,13,48,42,6,45
Berwick,4320,8,8,10,18,29,60,-31,34
Edinburgh Ci,4320,9,7,9,20,37,63,-26,30
Cowdenbeath,4320,10,4,11,21,24,55,-31,23
Montrose,4321,1,24,7,5,61,34,27,79
Peterhead,4321,2,23,4,9,77,39,38,73
Stirling,4321,3,17,6,13,63,53,10,57
Clyde,4321,4,15,9,12,53,48,5,54
Stenhousem'r,4321,5,15,8,13,57,49,8,53
Elgin,4321,6,14,6,16,53,62,-9,48
Annan Athlet,4321,7,11,11,14,49,44,5,44
Berwick,4321,8,8,10,18,29,60,-31,34
Edinburgh Ci,4321,9,8,9,19,37,60,-23,33
Cowdenbeath,4321,10,5,10,21,26,56,-30,25
Montrose,4322,1,24,7,5,62,34,28,79
Peterhead,4322,2,23,4,9,78,40,38,73
Stirling,4322,3,17,6,13,63,52,11,57
Stenhousem'r,4322,4,15,8,13,56,49,7,53
Clyde,4322,5,14,10,12,53,50,3,52
Elgin,4322,6,14,6,16,53,63,-10,48
Annan Athlet,4322,7,12,11,13,50,43,7,47
Berwick,4322,8,8,11,17,31,60,-29,35
Edinburgh Ci,4322,9,8,9,19,38,61,-23,33
Cowdenbeath,4322,10,4,10,22,25,57,-32,22
Montrose,4323,1,23,7,6,62,38,24,76
Peterhead,4323,2,23,5,8,78,39,39,74
Stirling,4323,3,17,6,13,62,52,10,57
Clyde,4323,4,15,9,12,54,50,4,54
Stenhousem'r,4323,5,15,8,13,56,48,8,53
Elgin,4323,6,15,6,15,57,63,-6,51
Annan Athlet,4323,7,11,12,13,48,42,6,45
Berwick,4323,8,8,10,18,31,61,-30,34
Edinburgh Ci,4323,9,7,10,19,37,61,-24,31
Cowdenbeath,4323,10,4,11,21,24,55,-31,23
Montrose,4324,1,23,8,5,61,36,25,77
Peterhead,4324,2,24,4,8,80,39,41,76
Stirling,4324,3,17,6,13,61,51,10,57
Stenhousem'r,4324,4,15,8,13,55,47,8,53
Clyde,4324,5,14,10,12,52,49,3,52
Elgin,4324,6,14,7,15,55,62,-7,49
Annan Athlet,4324,7,11,11,14,47,42,5,44
Berwick,4324,8,8,11,17,30,59,-29,35
Edinburgh Ci,4324,9,7,9,20,37,63,-26,30
Cowdenbeath,4324,10,5,10,21,24,54,-30,25
Montrose,4325,1,23,8,5,59,34,25,77
Peterhead,4325,2,24,4,8,82,39,43,76
Stirling,4325,3,17,6,13,64,51,13,57
Clyde,4325,4,15,9,12,52,48,4,54
Stenhousem'r,4325,5,15,8,13,55,50,5,53
Elgin,4325,6,14,7,15,53,60,-7,49
Annan Athlet,4325,7,12,11,13,49,41,8,47
Berwick,4325,8,8,10,18,29,59,-30,34
Edinburgh Ci,4325,9,7,9,20,37,65,-28,30
Cowdenbeath,4325,10,4,10,22,23,56,-33,22
Montrose,4326,1,24,7,5,61,34,27,79
Peterhead,4326,2,24,4,8,79,38,41,76
Stirling,4326,3,17,6,13,63,51,12,57
Clyde,4326,4,15,9,12,53,49,4,54
Stenhousem'r,4326,5,15,8,13,55,49,6,53
Elgin,4326,6,14,6,16,53,62,-9,48
Annan Athlet,4326,7,11,11,14,47,42,5,44
Berwick,4326,8,8,10,18,30,60,-30,34
Edinburgh Ci,4326,9,7,9,20,36,62,-26,30
Cowdenbeath,4326,10,5,10,21,24,54,-30,25
Montrose,4327,1,23,8,5,59,34,25,77
Peterhead,4327,2,23,5,8,81,42,39,74
Stenhousem'r,4327,3,16,8,12,57,47,10,56
Stirling,4327,4,16,6,14,61,53,8,54
Clyde,4327,5,15,9,12,55,50,5,54
Elgin,4327,6,14,7,15,53,60,-7,49
Annan Athlet,4327,7,11,11,14,47,42,5,44
Berwick,4327,8,8,10,18,31,62,-31,34
Edinburgh Ci,4327,9,7,10,19,40,64,-24,31
Cowdenbeath,4327,10,5,10,21,24,54,-30,25
Montrose,4328,1,24,7,5,60,34,26,79
Peterhead,4328,2,24,4,8,78,38,40,76
Stirling,4328,3,16,7,13,60,51,9,55
Stenhousem'r,4328,4,15,9,12,55,46,9,54
Clyde,4328,5,15,9,12,56,48,8,54
Elgin,4328,6,14,6,16,53,61,-8,48
Annan Athlet,4328,7,11,12,13,47,41,6,45
Berwick,4328,8,8,10,18,29,63,-34,34
Edinburgh Ci,4328,9,7,9,20,36,61,-25,30
Cowdenbeath,4328,10,4,11,21,23,54,-31,23
Montrose,4329,1,23,8,5,60,35,25,77
Peterhead,4329,2,24,4,8,79,39,40,76
Stirling,4329,3,16,7,13,62,53,9,55
Stenhousem'r,4329,4,15,9,12,57,48,9,54
Clyde,4329,5,14,10,12,53,50,3,52
Elgin,4329,6,14,7,15,54,61,-7,49
Annan Athlet,4329,7,11,12,13,49,43,6,45
Berwick,4329,8,8,11,17,31,60,-29,35
Edinburgh Ci,4329,9,7,9,20,37,62,-25,30
Cowdenbeath,4329,10,4,11,21,25,56,-31,23
Montrose,4330,1,23,8,5,59,34,25,77
Peterhead,4330,2,24,4,8,79,38,41,76
Stenhousem'r,4330,3,16,8,12,57,47,10,56
Stirling,4330,4,16,6,14,61,53,8,54
Clyde,4330,5,15,9,12,55,49,6,54
Elgin,4330,6,14,7,15,53,60,-7,49
Annan Athlet,4330,7,12,11,13,49,42,7,47
Berwick,4330,8,8,10,18,30,62,-32,34
Edinburgh Ci,4330,9,7,9,20,36,62,-26,30
Cowdenbeath,4330,10,4,10,22,24,56,-32,22
Montrose,4331,1,24,7,5,61,34,27,79
Peterhead,4331,2,24,4,8,84,38,46,76
Stenhousem'r,4331,3,16,8,12,57,47,10,56
Stirling,4331,4,16,6,14,61,53,8,54
Clyde,4331,5,15,9,12,55,48,7,54
Elgin,4331,6,14,6,16,53,62,-9,48
Annan Athlet,4331,7,11,12,13,48,42,6,45
Berwick,4331,8,8,10,18,29,62,-33,34
Edinburgh Ci,4331,9,7,9,20,36,67,-31,30
Cowdenbeath,4331,10,4,11,21,24,55,-31,23
Montrose,4332,1,23,8,5,60,35,25,77
Peterhead,4332,2,24,4,8,82,41,41,76
Stirling,4332,3,17,6,13,63,53,10,57
Stenhousem'r,4332,4,15,8,13,57,49,8,53
Clyde,4332,5,14,10,12,53,50,3,52
Elgin,4332,6,14,7,15,54,61,-7,49
Annan Athlet,4332,7,11,11,14,47,42,5,44
Berwick,4332,8,8,11,17,31,60,-29,35
Edinburgh Ci,4332,9,7,9,20,39,65,-26,30
Cowdenbeath,4332,10,5,10,21,24,54,-30,25
Montrose,4333,1,23,8,5,59,34,25,77
Peterhead,4333,2,24,4,8,78,38,40,76
Stenhousem'r,4333,3,16,8,12,58,46,12,56
Stirling,4333,4,16,6,14,60,54,6,54
Clyde,4333,5,15,9,12,54,48,6,54
Elgin,4333,6,14,7,15,53,60,-7,49
Annan Athlet,4333,7,12,11,13,49,42,7,47
Berwick,4333,8,8,10,18,29,61,-32,34
Edinburgh Ci,4333,9,7,9,20,36,61,-25,30
Cowdenbeath,4333,10,4,10,22,24,56,-32,22
Montrose,4334,1,23,8,5,60,35,25,77
Peterhead,4334,2,24,4,8,80,38,42,76
Stirling,4334,3,17,6,13,62,51,11,57
Clyde,4334,4,15,9,12,56,49,7,54
Stenhousem'r,4334,5,15,8,13,55,48,7,53
Elgin,4334,6,14,7,15,54,61,-7,49
Annan Athlet,4334,7,12,11,13,49,42,7,47
Berwick,4334,8,8,10,18,30,63,-33,34
Edinburgh Ci,4334,9,7,9,20,36,63,-27,30
Cowdenbeath,4334,10,4,10,22,24,56,-32,22
Montrose,4335,1,24,7,5,62,35,27,79
Peterhead,4335,2,23,4,9,79,41,38,73
Stirling,4335,3,17,6,13,63,52,11,57
Stenhousem'r,4335,4,15,8,13,56,49,7,53
Clyde,4335,5,14,9,13,52,50,2,51
Elgin,4335,6,14,6,16,54,63,-9,48
Annan Athlet,4335,7,11,12,13,47,41,6,45
Berwick,4335,8,9,10,17,31,59,-28,37
Edinburgh Ci,4335,9,8,9,19,39,62,-23,33
Cowdenbeath,4335,10,4,11,21,23,54,-31,23
Montrose,4336,1,23,8,5,59,34,25,77
Peterhead,4336,2,24,4,8,79,39,40,76
Stirling,4336,3,17,6,13,64,53,11,57
Stenhousem'r,4336,4,15,8,13,57,50,7,53
Clyde,4336,5,14,10,12,53,50,3,52
Elgin,4336,6,14,7,15,53,60,-7,49
Annan Athlet,4336,7,11,12,13,48,42,6,45
Berwick,4336,8,8,11,17,31,60,-29,35
Edinburgh Ci,4336,9,7,9,20,37,62,-25,30
Cowdenbeath,4336,10,4,11,21,24,55,-31,23
Peterhead,4337,1,24,4,8,80,38,42,76
Montrose,4337,2,23,7,6,59,35,24,76
Stirling,4337,3,16,7,13,62,53,9,55
Stenhousem'r,4337,4,15,9,12,57,48,9,54
Clyde,4337,5,15,9,12,55,48,7,54
Elgin,4337,6,15,6,15,54,60,-6,51
Annan Athlet,4337,7,11,12,13,47,41,6,45
Berwick,4337,8,8,10,18,29,62,-33,34
Edinburgh Ci,4337,9,7,9,20,36,63,-27,30
Cowdenbeath,4337,10,4,11,21,23,54,-31,23
Montrose,4338,1,23,8,5,60,35,25,77
Peterhead,4338,2,24,4,8,81,41,40,76
Stirling,4338,3,16,7,13,62,53,9,55
Stenhousem'r,4338,4,15,9,12,57,48,9,54
Clyde,4338,5,15,9,12,54,48,6,54
Elgin,4338,6,14,7,15,54,61,-7,49
Annan Athlet,4338,7,11,12,13,48,42,6,45
Berwick,4338,8,8,10,18,29,61,-32,34
Edinburgh Ci,4338,9,7,9,20,39,64,-25,30
Cowdenbeath,4338,10,4,11,21,24,55,-31,23
Montrose,4339,1,24,7,5,61,34,27,79
Peterhead,4339,2,24,4,8,83,41,42,76
Stirling,4339,3,17,6,13,61,51,10,57
Stenhousem'r,4339,4,15,8,13,55,47,8,53
Clyde,4339,5,14,9,13,51,50,1,51
Elgin,4339,6,14,6,16,53,62,-9,48
Annan Athlet,4339,7,12,11,13,48,41,7,47
Berwick,4339,8,9,10,17,31,58,-27,37
Edinburgh Ci,4339,9,7,9,20,39,66,-27,30
Cowdenbeath,4339,10,4,10,22,23,55,-32,22
Montrose,4340,1,24,7,5,61,34,27,79
Peterhead,4340,2,24,4,8,80,40,40,76
Stirling,4340,3,16,7,13,61,52,9,55
Stenhousem'r,4340,4,15,9,12,56,47,9,54
Clyde,4340,5,14,10,12,52,49,3,52
Elgin,4340,6,14,6,16,53,62,-9,48
Annan Athlet,4340,7,11,12,13,48,42,6,45
Berwick,4340,8,8,11,17,30,59,-29,35
Edinburgh Ci,4340,9,7,9,20,38,63,-25,30
Cowdenbeath,4340,10,4,11,21,24,55,-31,23
Montrose,4341,1,24,7,5,62,35,27,79
Peterhead,4341,2,24,4,8,80,39,41,76
Stenhousem'r,4341,3,16,8,12,56,46,10,56
Stirling,4341,4,16,6,14,60,52,8,54
Clyde,4341,5,15,9,12,53,48,5,54
Elgin,4341,6,14,6,16,54,63,-9,48
Annan Athlet,4341,7,11,12,13,47,41,6,45
Berwick,4341,8,8,10,18,29,60,-31,34
Edinburgh Ci,4341,9,7,9,20,37,63,-26,30
Cowdenbeath,4341,10,4,11,21,23,54,-31,23
Peterhead,4342,1,24,4,8,81,39,42,76
Montrose,4342,2,23,7,6,60,36,24,76
Stenhousem'r,4342,3,16,8,12,57,46,11,56
Stirling,4342,4,16,6,14,60,53,7,54
Clyde,4342,5,14,9,13,51,49,2,51
Elgin,4342,6,15,6,15,55,61,-6,51
Annan Athlet,4342,7,11,11,14,47,43,4,44
Berwick,4342,8,9,10,17,30,58,-28,37
Edinburgh Ci,4342,9,7,9,20,37,64,-27,30
Cowdenbeath,4342,10,5,10,21,25,54,-29,25
Montrose,4343,1,24,7,5,62,36,26,79
Peterhead,4343,2,24,4,8,79,38,41,76
Stenhousem'r,4343,3,16,8,12,58,46,12,56
Clyde,4343,4,15,9,12,55,48,7,54
Stirling,4343,5,16,6,14,60,54,6,54
Elgin,4343,6,14,6,16,55,63,-8,48
Annan Athlet,4343,7,11,11,14,47,42,5,44
Berwick,4343,8,8,10,18,29,62,-33,34
Edinburgh Ci,4343,9,7,9,20,36,62,-26,30
Cowdenbeath,4343,10,5,10,21,24,54,-30,25
Montrose,4344,1,24,7,5,60,34,26,79
Peterhead,4344,2,23,4,9,78,40,38,73
Stirling,4344,3,17,6,13,62,52,10,57
Clyde,4344,4,15,9,12,54,49,5,54
Stenhousem'r,4344,5,15,8,13,56,48,8,53
Elgin,4344,6,14,6,16,53,61,-8,48
Annan Athlet,4344,7,12,11,13,48,41,7,47
Berwick,4344,8,8,10,18,30,61,-31,34
Edinburgh Ci,4344,9,8,9,19,38,61,-23,33
Cowdenbeath,4344,10,4,10,22,23,55,-32,22
Montrose,4345,1,23,8,5,60,35,25,77
Peterhead,4345,2,24,4,8,79,38,41,76
Stenhousem'r,4345,3,16,8,12,58,48,10,56
Stirling,4345,4,16,6,14,62,54,8,54
Clyde,4345,5,15,9,12,52,48,4,54
Elgin,4345,6,14,7,15,54,61,-7,49
Annan Athlet,4345,7,12,11,13,49,41,8,47
Berwick,4345,8,8,10,18,29,59,-30,34
Edinburgh Ci,4345,9,7,9,20,36,62,-26,30
Cowdenbeath,4345,10,4,10,22,23,56,-33,22
Peterhead,4346,1,24,4,8,82,41,41,76
Montrose,4346,2,23,7,6,59,35,24,76
Stirling,4346,3,17,6,13,61,51,10,57
Stenhousem'r,4346,4,15,8,13,55,47,8,53
Clyde,4346,5,14,9,13,51,49,2,51
Elgin,4346,6,15,6,15,54,60,-6,51
Annan Athlet,4346,7,11,11,14,47,43,4,44
Berwick,4346,8,9,10,17,30,58,-28,37
Edinburgh Ci,4346,9,7,9,20,39,65,-26,30
Cowdenbeath,4346,10,5,10,21,25,54,-29,25
Montrose,4347,1,23,8,5,60,35,25,77
Peterhead,4347,2,23,5,8,78,39,39,74
Stirling,4347,3,17,6,13,63,52,11,57
Clyde,4347,4,15,9,12,54,48,6,54
Stenhousem'r,4347,5,15,8,13,56,49,7,53
Elgin,4347,6,14,7,15,54,61,-7,49
Annan Athlet,4347,7,11,11,14,47,42,5,44
Berwick,4347,8,8,10,18,29,61,-32,34
Edinburgh Ci,4347,9,7,10,19,37,61,-24,31
Cowdenbeath,4347,10,5,10,21,24,54,-30,25
Montrose,4348,1,24,7,5,61,35,26,79
Peterhead,4348,2,24,4,8,79,38,41,76
Stirling,4348,3,17,6,13,63,53,10,57
Clyde,4348,4,15,9,12,52,48,4,54
Stenhousem'r,4348,5,15,8,13,57,49,8,53
Elgin,4348,6,14,6,16,54,62,-8,48
Annan Athlet,4348,7,11,11,14,48,43,5,44
Berwick,4348,8,8,10,18,29,59,-30,34
Edinburgh Ci,4348,9,7,9,20,36,62,-26,30
Cowdenbeath,4348,10,5,10,21,25,55,-30,25
Montrose,4349,1,24,7,5,61,34,27,79
Peterhead,4349,2,24,4,8,81,40,41,76
Stirling,4349,3,16,7,13,62,53,9,55
Stenhousem'r,4349,4,15,9,12,57,48,9,54
Clyde,4349,5,14,10,12,52,49,3,52
Elgin,4349,6,14,6,16,53,62,-9,48
Annan Athlet,4349,7,12,11,13,48,41,7,47
Berwick,4349,8,8,11,17,30,59,-29,35
Edinburgh Ci,4349,9,7,9,20,38,64,-26,30
Cowdenbeath,4349,10,4,10,22,23,55,-32,22
Montrose,4350,1,23,8,5,60,35,25,77
Peterhead,4350,2,24,4,8,78,38,40,76
Stirling,4350,3,17,6,13,63,52,11,57
Stenhousem'r,4350,4,15,8,13,56,49,7,53
Clyde,4350,5,14,9,13,54,52,2,51
Elgin,4350,6,14,7,15,54,61,-7,49
Annan Athlet,4350,7,12,11,13,49,41,8,47
Berwick,4350,8,9,10,17,33,61,-28,37
Edinburgh Ci,4350,9,7,9,20,36,61,-25,30
Cowdenbeath,4350,10,4,10,22,23,56,-33,22
Montrose,4351,1,23,8,5,59,34,25,77
Peterhead,4351,2,24,4,8,84,39,45,76
Stirling,4351,3,17,6,13,63,52,11,57
Stenhousem'r,4351,4,15,8,13,56,49,7,53
Clyde,4351,5,14,10,12,53,50,3,52
Elgin,4351,6,14,7,15,53,60,-7,49
Annan Athlet,4351,7,11,11,14,47,42,5,44
Berwick,4351,8,8,11,17,31,60,-29,35
Edinburgh Ci,4351,9,7,9,20,37,67,-30,30
Cowdenbeath,4351,10,5,10,21,24,54,-30,25
Peterhead,4352,1,24,4,8,80,38,42,76
Montrose,4352,2,23,7,6,60,36,24,76
Stenhousem'r,4352,3,16,8,12,57,47,10,56
Stirling,4352,4,16,6,14,61,53,8,54
Clyde,4352,5,15,9,12,54,50,4,54
Elgin,4352,6,15,6,15,55,61,-6,51
Annan Athlet,4352,7,11,11,14,47,44,3,44
Berwick,4352,8,8,10,18,31,61,-30,34
Edinburgh Ci,4352,9,7,9,20,36,63,-27,30
Cowdenbeath,4352,10,5,10,21,26,54,-28,25
Peterhead,4353,1,24,4,8,80,39,41,76
Montrose,4353,2,23,7,6,61,38,23,76
Stirling,4353,3,17,6,13,64,52,12,57
Clyde,4353,4,15,9,12,53,49,4,54
Stenhousem'r,4353,5,15,8,13,56,50,6,53
Elgin,4353,6,15,6,15,57,62,-5,51
Annan Athlet,4353,7,11,12,13,47,41,6,45
Berwick,4353,8,8,10,18,30,60,-30,34
Edinburgh Ci,4353,9,7,9,20,37,63,-26,30
Cowdenbeath,4353,10,4,11,21,23,54,-31,23
Montrose,4354,1,24,7,5,63,36,27,79
Peterhead,4354,2,23,4,9,77,39,38,73
Stenhousem'r,4354,3,16,8,12,57,47,10,56
Stirling,4354,4,16,6,14,61,53,8,54
Clyde,4354,5,15,9,12,52,48,4,54
Elgin,4354,6,14,6,16,55,64,-9,48
Annan Athlet,4354,7,11,11,14,47,42,5,44
Berwick,4354,8,8,10,18,29,59,-30,34
Edinburgh Ci,4354,9,8,9,19,37,60,-23,33
Cowdenbeath,4354,10,5,10,21,24,54,-30,25
Peterhead,4355,1,24,4,8,84,39,45,76
Montrose,4355,2,23,7,6,60,36,24,76
Stirling,4355,3,16,7,13,60,51,9,55
Stenhousem'r,4355,4,15,9,12,55,46,9,54
Clyde,4355,5,15,9,12,53,49,4,54
Elgin,4355,6,15,6,15,55,61,-6,51
Annan Athlet,4355,7,12,11,13,49,41,8,47
Berwick,4355,8,8,10,18,30,60,-30,34
Edinburgh Ci,4355,9,7,9,20,37,67,-30,30
Cowdenbeath,4355,10,4,10,22,23,56,-33,22
Montrose,4356,1,24,7,5,61,34,27,79
Peterhead,4356,2,23,5,8,80,41,39,74
Stenhousem'r,4356,3,16,8,12,59,48,11,56
Stirling,4356,4,16,6,14,62,55,7,54
Clyde,4356,5,15,9,12,54,49,5,54
Elgin,4356,6,14,6,16,53,62,-9,48
Annan Athlet,4356,7,11,12,13,49,43,6,45
Berwick,4356,8,8,10,18,30,61,-31,34
Edinburgh Ci,4356,9,7,10,19,39,63,-24,31
Cowdenbeath,4356,10,4,11,21,25,56,-31,23
Peterhead,4357,1,24,4,8,79,38,41,76
Montrose,4357,2,23,7,6,60,36,24,76
Stirling,4357,3,17,6,13,63,53,10,57
Clyde,4357,4,15,9,12,53,48,5,54
Stenhousem'r,4357,5,15,8,13,57,49,8,53
Elgin,4357,6,15,6,15,55,61,-6,51
Annan Athlet,4357,7,11,12,13,48,42,6,45
Berwick,4357,8,8,10,18,29,60,-31,34
Edinburgh Ci,4357,9,7,9,20,36,62,-26,30
Cowdenbeath,4357,10,4,11,21,24,55,-31,23
Montrose,4358,1,24,7,5,64,35,29,79
Peterhead,4358,2,23,4,9,77,40,37,73
Stirling,4358,3,16,7,13,61,52,9,55
Stenhousem'r,4358,4,15,9,12,56,47,9,54
Clyde,4358,5,14,9,13,52,50,2,51
Elgin,4358,6,14,6,16,54,65,-11,48
Annan Athlet,4358,7,11,11,14,48,44,4,44
Berwick,4358,8,9,10,17,31,59,-28,37
Edinburgh Ci,4358,9,8,9,19,38,60,-22,33
Cowdenbeath,4358,10,5,10,21,26,55,-29,25
Montrose,4359,1,24,7,5,61,34,27,79
Peterhead,4359,2,24,4,8,84,39,45,76
Stenhousem'r,4359,3,16,8,12,56,46,10,56
Stirling,4359,4,16,6,14,60,52,8,54
Clyde,4359,5,14,10,12,53,50,3,52
Elgin,4359,6,14,6,16,53,62,-9,48
Annan Athlet,4359,7,11,12,13,47,41,6,45
Berwick,4359,8,8,11,17,31,60,-29,35
Edinburgh Ci,4359,9,7,9,20,37,67,-30,30
Cowdenbeath,4359,10,4,11,21,23,54,-31,23
Montrose,4360,1,23,8,5,60,35,25,77
Peterhead,4360,2,24,4,8,79,39,40,76
Stirling,4360,3,17,6,13,61,51,10,57
Stenhousem'r,4360,4,15,8,13,55,47,8,53
Clyde,4360,5,14,10,12,53,50,3,52
Elgin,4360,6,14,7,15,54,61,-7,49
Annan Athlet,4360,7,12,11,13,48,41,7,47
Berwick,4360,8,8,11,17,31,60,-29,35
Edinburgh Ci,4360,9,7,9,20,37,62,-25,30
Cowdenbeath,4360,10,4,10,22,23,55,-32,22
Peterhead,4361,1,24,4,8,79,39,40,76
Montrose,4361,2,23,7,6,60,37,23,76
Stirling,4361,3,16,7,13,61,52,9,55
Stenhousem'r,4361,4,15,9,12,56,47,9,54
Clyde,4361,5,15,9,12,53,48,5,54
Elgin,4361,6,15,6,15,56,61,-5,51
Annan Athlet,4361,7,11,12,13,50,44,6,45
Berwick,4361,8,8,10,18,29,60,-31,34
Edinburgh Ci,4361,9,7,9,20,37,62,-25,30
Cowdenbeath,4361,10,4,11,21,26,57,-31,23
Peterhead,4362,1,24,4,8,79,39,40,76
Montrose,4362,2,23,7,6,60,36,24,76
Stirling,4362,3,17,6,13,63,52,11,57
Clyde,4362,4,15,9,12,56,48,8,54
Stenhousem'r,4362,5,15,8,13,56,49,7,53
Elgin,4362,6,15,6,15,55,61,-6,51
Annan Athlet,4362,7,12,11,13,48,41,7,47
Berwick,4362,8,8,10,18,29,63,-34,34
Edinburgh Ci,4362,9,7,9,20,37,62,-25,30
Cowdenbeath,4362,10,4,10,22,23,55,-32,22
Peterhead,4363,1,24,4,8,79,38,41,76
Montrose,4363,2,23,7,6,59,35,24,76
Stirling,4363,3,17,6,13,63,51,12,57
Clyde,4363,4,15,9,12,54,48,6,54
Stenhousem'r,4363,5,15,8,13,55,49,6,53
Elgin,4363,6,15,6,15,54,60,-6,51
Annan Athlet,4363,7,11,11,14,47,42,5,44
Berwick,4363,8,8,10,18,29,61,-32,34
Edinburgh Ci,4363,9,7,9,20,36,62,-26,30
Cowdenbeath,4363,10,5,10,21,24,54,-30,25
Peterhead,4364,1,24,4,8,81,41,40,76
Montrose,4364,2,23,7,6,59,36,23,76
Stenhousem'r,4364,3,16,8,12,57,47,10,56
Stirling,4364,4,16,6,14,61,53,8,54
Clyde,4364,5,14,10,12,52,49,3,52
Elgin,4364,6,15,6,15,55,60,-5,51
Annan Athlet,4364,7,11,12,13,47,41,6,45
Berwick,4364,8,8,11,17,30,59,-29,35
Edinburgh Ci,4364,9,7,9,20,39,64,-25,30
Cowdenbeath,4364,10,4,11,21,23,54,-31,23
Montrose,4365,1,24,7,5,63,36,27,79
Peterhead,4365,2,23,5,8,79,40,39,74
Stirling,4365,3,17,6,13,63,51,12,57
Stenhousem'r,4365,4,15,8,13,55,49,6,53
Clyde,4365,5,14,10,12,54,51,3,52
Elgin,4365,6,14,6,16,55,64,-9,48
Annan Athlet,4365,7,11,11,14,47,44,3,44
Berwick,4365,8,8,11,17,32,61,-29,35
Edinburgh Ci,4365,9,7,10,19,38,62,-24,31
Cowdenbeath,4365,10,5,10,21,26,54,-28,25
Montrose,4366,1,23,8,5,60,35,25,77
Peterhead,4366,2,23,5,8,78,39,39,74
Stirling,4366,3,17,6,13,63,51,12,57
Clyde,4366,4,15,9,12,55,49,6,54
Stenhousem'r,4366,5,15,8,13,55,49,6,53
Elgin,4366,6,14,7,15,54,61,-7,49
Annan Athlet,4366,7,12,11,13,49,41,8,47
Berwick,4366,8,8,10,18,30,62,-32,34
Edinburgh Ci,4366,9,7,10,19,37,61,-24,31
Cowdenbeath,4366,10,4,10,22,23,56,-33,22
Peterhead,4367,1,24,4,8,79,38,41,76
Montrose,4367,2,23,7,6,60,37,23,76
Stirling,4367,3,17,6,13,61,51,10,57
Clyde,4367,4,15,9,12,54,49,5,54
Stenhousem'r,4367,5,15,8,13,55,47,8,53
Elgin,4367,6,15,6,15,56,61,-5,51
Annan Athlet,4367,7,11,12,13,48,42,6,45
Berwick,4367,8,8,10,18,30,61,-31,34
Edinburgh Ci,4367,9,7,9,20,36,62,-26,30
Cowdenbeath,4367,10,4,11,21,24,55,-31,23
Montrose,4368,1,24,7,5,61,34,27,79
Peterhead,4368,2,24,4,8,79,38,41,76
Stirling,4368,3,17,6,13,64,52,12,57
Stenhousem'r,4368,4,15,8,13,56,50,6,53
Clyde,4368,5,14,10,12,51,48,3,52
Elgin,4368,6,14,6,16,53,62,-9,48
Annan Athlet,4368,7,11,11,14,47,42,5,44
Berwick,4368,8,8,11,17,29,58,-29,35
Edinburgh Ci,4368,9,7,9,20,36,62,-26,30
Cowdenbeath,4368,10,5,10,21,24,54,-30,25
Montrose,4369,1,23,8,5,59,34,25,77
Peterhead,4369,2,24,4,8,80,39,41,76
Stirling,4369,3,16,7,13,61,52,9,55
Stenhousem'r,4369,4,15,9,12,56,47,9,54
Clyde,4369,5,15,9,12,53,49,4,54
Elgin,4369,6,14,7,15,53,60,-7,49
Annan Athlet,4369,7,12,11,13,48,41,7,47
Berwick,4369,8,8,10,18,30,60,-30,34
Edinburgh Ci,4369,9,7,9,20,37,63,-26,30
Cowdenbeath,4369,10,4,10,22,23,55,-32,22
Montrose,4370,1,23,8,5,60,35,25,77
Peterhead,4370,2,24,4,8,80,38,42,76
Stenhousem'r,4370,3,16,8,12,58,47,11,56
Stirling,4370,4,16,6,14,61,54,7,54
Clyde,4370,5,15,9,12,53,48,5,54
Elgin,4370,6,14,7,15,54,61,-7,49
Annan Athlet,4370,7,12,11,13,48,41,7,47
Berwick,4370,8,8,10,18,29,60,-31,34
Edinburgh Ci,4370,9,7,9,20,36,63,-27,30
Cowdenbeath,4370,10,4,10,22,23,55,-32,22
Montrose,4371,1,24,7,5,62,35,27,79
Peterhead,4371,2,24,4,8,79,38,41,76
Stirling,4371,3,16,7,13,61,52,9,55
Stenhousem'r,4371,4,15,9,12,56,47,9,54
Clyde,4371,5,14,10,12,52,49,3,52
Elgin,4371,6,14,6,16,54,63,-9,48
Annan Athlet,4371,7,11,12,13,48,42,6,45
Berwick,4371,8,8,11,17,30,59,-29,35
Edinburgh Ci,4371,9,7,9,20,36,62,-26,30
Cowdenbeath,4371,10,4,11,21,24,55,-31,23
Montrose,4372,1,24,7,5,62,36,26,79
Peterhead,4372,2,24,4,8,80,39,41,76
Stirling,4372,3,16,7,13,61,52,9,55
Stenhousem'r,4372,4,15,9,12,56,47,9,54
Clyde,4372,5,15,9,12,53,48,5,54
Elgin,4372,6,14,6,16,55,63,-8,48
Annan Athlet,4372,7,12,11,13,53,42,11,47
Berwick,4372,8,8,10,18,29,60,-31,34
Edinburgh Ci,4372,9,7,9,20,37,63,-26,30
Cowdenbeath,4372,10,4,10,22,24,60,-36,22
Montrose,4373,1,23,8,5,61,36,25,77
Peterhead,4373,2,24,4,8,81,38,43,76
Stenhousem'r,4373,3,16,8,12,57,47,10,56
Stirling,4373,4,16,6,14,61,53,8,54
Clyde,4373,5,15,9,12,54,50,4,54
Elgin,4373,6,14,7,15,55,62,-7,49
Annan Athlet,4373,7,12,11,13,48,41,7,47
Berwick,4373,8,8,10,18,31,61,-30,34
Edinburgh Ci,4373,9,7,9,20,36,64,-28,30
Cowdenbeath,4373,10,4,10,22,23,55,-32,22
Montrose,4374,1,24,7,5,60,34,26,79
Peterhead,4374,2,23,5,8,77,38,39,74
Stenhousem'r,4374,3,16,8,12,57,47,10,56
Stirling,4374,4,16,6,14,61,53,8,54
Clyde,4374,5,15,9,12,55,49,6,54
Elgin,4374,6,14,6,16,53,61,-8,48
Annan Athlet,4374,7,11,12,13,48,42,6,45
Berwick,4374,8,8,10,18,30,62,-32,34
Edinburgh Ci,4374,9,7,10,19,36,60,-24,31
Cowdenbeath,4374,10,4,11,21,24,55,-31,23
Peterhead,4375,1,24,4,8,83,38,45,76
Montrose,4375,2,23,7,6,59,35,24,76
Stenhousem'r,4375,3,16,8,12,57,46,11,56
Stirling,4375,4,16,6,14,60,53,7,54
Clyde,4375,5,15,9,12,52,48,4,54
Elgin,4375,6,15,6,15,54,60,-6,51
Annan Athlet,4375,7,12,11,13,49,41,8,47
Berwick,4375,8,8,10,18,29,59,-30,34
Edinburgh Ci,4375,9,7,9,20,36,66,-30,30
Cowdenbeath,4375,10,4,10,22,23,56,-33,22
Peterhead,4376,1,24,4,8,78,38,40,76
Montrose,4376,2,23,7,6,60,36,24,76
Stirling,4376,3,16,7,13,62,53,9,55
Stenhousem'r,4376,4,15,9,12,57,48,9,54
Clyde,4376,5,14,10,12,53,50,3,52
Elgin,4376,6,15,6,15,55,61,-6,51
Annan Athlet,4376,7,11,12,13,48,42,6,45
Berwick,4376,8,8,11,17,31,60,-29,35
Edinburgh Ci,4376,9,7,9,20,36,61,-25,30
Cowdenbeath,4376,10,4,11,21,24,55,-31,23
Montrose,4377,1,23,8,5,60,35,25,77
Peterhead,4377,2,24,4,8,80,38,42,76
Stenhousem'r,4377,3,16,8,12,57,47,10,56
Stirling,4377,4,16,6,14,61,53,8,54
Clyde,4377,5,14,9,13,51,49,2,51
Elgin,4377,6,14,7,15,54,61,-7,49
Annan Athlet,4377,7,12,11,13,49,41,8,47
Berwick,4377,8,9,10,17,30,58,-28,37
Edinburgh Ci,4377,9,7,9,20,36,63,-27,30
Cowdenbeath,4377,10,4,10,22,23,56,-33,22
Montrose,4378,1,23,8,5,60,35,25,77
Peterhead,4378,2,24,4,8,79,38,41,76
Stenhousem'r,4378,3,16,8,12,58,47,11,56
Stirling,4378,4,16,6,14,61,54,7,54
Clyde,4378,5,14,9,13,52,50,2,51
Elgin,4378,6,14,7,15,54,61,-7,49
Annan Athlet,4378,7,11,12,13,49,43,6,45
Berwick,4378,8,9,10,17,31,59,-28,37
Edinburgh Ci,4378,9,7,9,20,36,62,-26,30
Cowdenbeath,4378,10,4,11,21,25,56,-31,23
Montrose,4379,1,24,7,5,61,34,27,79
Peterhead,4379,2,24,4,8,79,38,41,76
Stirling,4379,3,16,7,13,60,51,9,55
Stenhousem'r,4379,4,15,9,12,55,46,9,54
Clyde,4379,5,15,9,12,53,48,5,54
Elgin,4379,6,14,6,16,53,62,-9,48
Annan Athlet,4379,7,12,11,13,49,42,7,47
Berwick,4379,8,8,10,18,29,60,-31,34
Edinburgh Ci,4379,9,7,9,20,36,62,-26,30
Cowdenbeath,4379,10,4,10,22,24,56,-32,22
Peterhead,4380,1,24,4,8,83,39,44,76
Montrose,4380,2,23,7,6,60,36,24,76
Stirling,4380,3,17,6,13,63,53,10,57
Stenhousem'r,4380,4,15,8,13,57,49,8,53
Clyde,4380,5,14,10,12,51,48,3,52
Elgin,4380,6,15,6,15,55,61,-6,51
Annan Athlet,4380,7,11,12,13,47,41,6,45
Berwick,4380,8,8,11,17,29,58,-29,35
Edinburgh Ci,4380,9,7,9,20,37,66,-29,30
Cowdenbeath,4380,10,4,11,21,23,54,-31,23
Montrose,4381,1,24,7,5,61,35,26,79
Peterhead,4381,2,24,4,8,78,38,40,76
Stirling,4381,3,16,7,13,60,51,9,55
Stenhousem'r,4381,4,15,9,12,55,46,9,54
Clyde,4381,5,15,9,12,54,48,6,54
Elgin,4381,6,14,6,16,54,62,-8,48
Annan Athlet,4381,7,11,11,14,48,43,5,44
Berwick,4381,8,8,10,18,29,61,-32,34
Edinburgh Ci,4381,9,7,9,20,36,61,-25,30
Cowdenbeath,4381,10,5,10,21,25,55,-30,25
Montrose,4382,1,24,7,5,60,34,26,79
Peterhead,4382,2,24,4,8,80,39,41,76
Stirling,4382,3,17,6,13,62,52,10,57
Clyde,4382,4,15,9,12,52,48,4,54
Stenhousem'r,4382,5,15,8,13,56,48,8,53
Elgin,4382,6,14,6,16,53,61,-8,48
Annan Athlet,4382,7,11,11,14,47,42,5,44
Berwick,4382,8,8,10,18,29,59,-30,34
Edinburgh Ci,4382,9,7,9,20,37,63,-26,30
Cowdenbeath,4382,10,5,10,21,24,54,-30,25
Montrose,4383,1,24,7,5,61,35,26,79
Peterhead,4383,2,23,4,9,77,40,37,73
Stenhousem'r,4383,3,16,8,12,58,46,12,56
Stirling,4383,4,16,6,14,60,54,6,54
Clyde,4383,5,15,9,12,54,49,5,54
Elgin,4383,6,14,6,16,54,62,-8,48
Annan Athlet,4383,7,12,11,13,48,41,7,47
Berwick,4383,8,8,10,18,30,61,-31,34
Edinburgh Ci,4383,9,8,9,19,38,60,-22,33
Cowdenbeath,4383,10,4,10,22,23,55,-32,22
Montrose,4384,1,24,7,5,62,34,28,79
Peterhead,4384,2,24,4,8,81,39,42,76
Stirling,4384,3,17,6,13,61,51,10,57
Clyde,4384,4,15,9,12,53,49,4,54
Stenhousem'r,4384,5,15,8,13,55,47,8,53
Elgin,4384,6,14,6,16,53,63,-10,48
Annan Athlet,4384,7,11,11,14,47,45,2,44
Berwick,4384,8,8,10,18,30,60,-30,34
Edinburgh Ci,4384,9,7,9,20,37,64,-27,30
Cowdenbeath,4384,10,5,10,21,27,54,-27,25
Montrose,4385,1,24,7,5,61,34,27,79
Peterhead,4385,2,24,4,8,81,38,43,76
Stirling,4385,3,17,6,13,63,52,11,57
Clyde,4385,4,15,9,12,53,49,4,54
Stenhousem'r,4385,5,15,8,13,56,49,7,53
Elgin,4385,6,14,6,16,53,62,-9,48
Annan Athlet,4385,7,12,11,13,49,41,8,47
Berwick,4385,8,8,10,18,30,60,-30,34
Edinburgh Ci,4385,9,7,9,20,36,64,-28,30
Cowdenbeath,4385,10,4,10,22,23,56,-33,22
Montrose,4386,1,24,7,5,64,34,30,79
Peterhead,4386,2,24,4,8,80,38,42,76
Stirling,4386,3,17,6,13,64,51,13,57
Clyde,4386,4,15,9,12,55,50,5,54
Stenhousem'r,4386,5,15,8,13,55,50,5,53
Elgin,4386,6,14,6,16,53,65,-12,48
Annan Athlet,4386,7,12,11,13,49,42,7,47
Berwick,4386,8,8,10,18,31,62,-31,34
Edinburgh Ci,4386,9,7,9,20,36,63,-27,30
Cowdenbeath,4386,10,4,10,22,24,56,-32,22
Montrose,4387,1,23,8,5,60,35,25,77
Peterhead,4387,2,24,4,8,78,38,40,76
Stenhousem'r,4387,3,16,8,12,57,47,10,56
Stirling,4387,4,16,6,14,61,53,8,54
Clyde,4387,5,15,9,12,54,49,5,54
Elgin,4387,6,14,7,15,54,61,-7,49
Annan Athlet,4387,7,12,11,13,50,41,9,47
Berwick,4387,8,8,10,18,30,61,-31,34
Edinburgh Ci,4387,9,7,9,20,36,61,-25,30
Cowdenbeath,4387,10,4,10,22,23,57,-34,22
Montrose,4388,1,23,8,5,60,35,25,77
Peterhead,4388,2,23,5,8,78,39,39,74
Stirling,4388,3,16,7,13,61,52,9,55
Stenhousem'r,4388,4,15,9,12,56,47,9,54
Clyde,4388,5,15,9,12,55,48,7,54
Elgin,4388,6,14,7,15,54,61,-7,49
Annan Athlet,4388,7,11,11,14,47,42,5,44
Berwick,4388,8,8,10,18,29,62,-33,34
Edinburgh Ci,4388,9,7,10,19,37,61,-24,31
Cowdenbeath,4388,10,5,10,21,24,54,-30,25
Montrose,4389,1,24,7,5,60,34,26,79
Peterhead,4389,2,23,5,8,79,40,39,74
Stenhousem'r,4389,3,16,8,12,58,46,12,56
Stirling,4389,4,16,6,14,60,54,6,54
Clyde,4389,5,15,9,12,52,48,4,54
Elgin,4389,6,14,6,16,53,61,-8,48
Annan Athlet,4389,7,11,11,14,47,42,5,44
Berwick,4389,8,8,10,18,29,59,-30,34
Edinburgh Ci,4389,9,7,10,19,38,62,-24,31
Cowdenbeath,4389,10,5,10,21,24,54,-30,25
Montrose,4390,1,23,8,5,60,35,25,77
Peterhead,4390,2,24,4,8,79,38,41,76
Stirling,4390,3,17,6,13,63,53,10,57
Clyde,4390,4,15,9,12,53,48,5,54
Stenhousem'r,4390,5,15,8,13,57,49,8,53
Elgin,4390,6,14,7,15,54,61,-7,49
Annan Athlet,4390,7,11,12,13,48,42,6,45
Berwick,4390,8,8,10,18,29,60,-31,34
Edinburgh Ci,4390,9,7,9,20,36,62,-26,30
Cowdenbeath,4390,10,4,11,21,24,55,-31,23
Montrose,4391,1,24,7,5,63,34,29,79
Peterhead,4391,2,24,4,8,80,39,41,76
Stirling,4391,3,17,6,13,64,53,11,57
Clyde,4391,4,15,9,12,53,49,4,54
Stenhousem'r,4391,5,15,8,13,57,50,7,53
Elgin,4391,6,14,6,16,53,64,-11,48
Annan Athlet,4391,7,11,11,14,48,43,5,44
Berwick,4391,8,8,10,18,30,60,-30,34
Edinburgh Ci,4391,9,7,9,20,37,63,-26,30
Cowdenbeath,4391,10,5,10,21,25,55,-30,25
Montrose,4392,1,24,7,5,62,35,27,79
Peterhead,4392,2,23,5,8,78,39,39,74
Stirling,4392,3,17,6,13,63,53,10,57
Stenhousem'r,4392,4,15,8,13,57,49,8,53
Clyde,4392,5,14,9,13,51,49,2,51
Elgin,4392,6,14,6,16,54,63,-9,48
Annan Athlet,4392,7,11,11,14,47,42,5,44
Berwick,4392,8,9,10,17,30,58,-28,37
Edinburgh Ci,4392,9,7,10,19,37,61,-24,31
Cowdenbeath,4392,10,5,10,21,24,54,-30,25
Montrose,4393,1,24,7,5,63,37,26,79
Peterhead,4393,2,24,4,8,79,38,41,76
Stirling,4393,3,16,7,13,60,51,9,55
Stenhousem'r,4393,4,15,9,12,55,46,9,54
Clyde,4393,5,14,9,13,53,51,2,51
Elgin,4393,6,14,6,16,56,64,-8,48
Annan Athlet,4393,7,12,11,13,49,41,8,47
Berwick,4393,8,9,10,17,32,60,-28,37
Edinburgh Ci,4393,9,7,9,20,36,62,-26,30
Cowdenbeath,4393,10,4,10,22,23,56,-33,22
Montrose,4394,1,23,8,5,61,36,25,77
Peterhead,4394,2,24,4,8,79,38,41,76
Stirling,4394,3,16,7,13,61,52,9,55
Stenhousem'r,4394,4,15,9,12,56,47,9,54
Clyde,4394,5,15,9,12,54,48,6,54
Elgin,4394,6,14,7,15,55,62,-7,49
Annan Athlet,4394,7,11,11,14,48,44,4,44
Berwick,4394,8,8,10,18,29,61,-32,34
Edinburgh Ci,4394,9,7,9,20,36,62,-26,30
Cowdenbeath,4394,10,5,10,21,26,55,-29,25
Montrose,4395,1,24,7,5,60,34,26,79
Peterhead,4395,2,24,4,8,80,39,41,76
Stirling,4395,3,17,6,13,63,53,10,57
Clyde,4395,4,15,9,12,55,49,6,54
Stenhousem'r,4395,5,15,8,13,57,49,8,53
Elgin,4395,6,14,6,16,53,61,-8,48
Annan Athlet,4395,7,12,11,13,48,41,7,47
Berwick,4395,8,8,10,18,30,62,-32,34
Edinburgh Ci,4395,9,7,9,20,37,63,-26,30
Cowdenbeath,4395,10,4,10,22,23,55,-32,22
Montrose,4396,1,23,8,5,60,35,25,77
Peterhead,4396,2,23,5,8,80,41,39,74
Stirling,4396,3,16,7,13,61,52,9,55
Stenhousem'r,4396,4,15,9,12,56,47,9,54
Clyde,4396,5,15,9,12,52,48,4,54
Elgin,4396,6,14,7,15,54,61,-7,49
Annan Athlet,4396,7,12,11,13,49,42,7,47
Berwick,4396,8,8,10,18,29,59,-30,34
Edinburgh Ci,4396,9,7,10,19,39,63,-24,31
Cowdenbeath,4396,10,4,10,22,24,56,-32,22
Montrose,4397,1,23,8,5,60,35,25,77
Peterhead,4397,2,24,4,8,82,38,44,76
Stenhousem'r,4397,3,16,8,12,57,46,11,56
Stirling,4397,4,16,6,14,60,53,7,54
Clyde,4397,5,15,9,12,55,49,6,54
Elgin,4397,6,14,7,15,54,61,-7,49
Annan Athlet,4397,7,12,11,13,50,42,8,47
Berwick,4397,8,8,10,18,30,62,-32,34
Edinburgh Ci,4397,9,7,9,20,36,65,-29,30
Cowdenbeath,4397,10,4,10,22,24,57,-33,22
Montrose,4398,1,24,7,5,61,35,26,79
Peterhead,4398,2,23,4,9,77,39,38,73
Stenhousem'r,4398,3,16,8,12,58,46,12,56
Stirling,4398,4,16,6,14,60,54,6,54
Clyde,4398,5,15,9,12,53,48,5,54
Elgin,4398,6,14,6,16,54,62,-8,48
Annan Athlet,4398,7,11,11,14,47,42,5,44
Berwick,4398,8,8,10,18,29,60,-31,34
Edinburgh Ci,4398,9,8,9,19,37,60,-23,33
Cowdenbeath,4398,10,5,10,21,24,54,-30,25
Montrose,4399,1,23,8,5,60,35,25,77
Peterhead,4399,2,24,4,8,84,38,46,76
Stenhousem'r,4399,3,16,8,12,58,48,10,56
Stirling,4399,4,16,6,14,62,54,8,54
Clyde,4399,5,15,9,12,54,49,5,54
Elgin,4399,6,14,7,15,54,61,-7,49
Annan Athlet,4399,7,11,11,14,47,42,5,44
Berwick,4399,8,8,10,18,30,61,-31,34
Edinburgh Ci,4399,9,7,9,20,36,67,-31,30
Cowdenbeath,4399,10,5,10,21,24,54,-30,25
Montrose,4400,1,23,8,5,59,34,25,77
Peterhead,4400,2,24,4,8,78,38,40,76
Stirling,4400,3,17,6,13,63,53,10,57
Stenhousem'r,4400,4,15,8,13,57,49,8,53
Clyde,4400,5,14,10,12,52,49,3,52
Elgin,4400,6,14,7,15,53,60,-7,49
Annan Athlet,4400,7,12,11,13,51,41,10,47
Berwick,4400,8,8,11,17,30,59,-29,35
Edinburgh Ci,4400,9,7,9,20,36,61,-25,30
Cowdenbeath,4400,10,4,10,22,23,58,-35,22
Montrose,4401,1,24,7,5,63,35,28,79
Peterhead,4401,2,24,4,8,78,38,40,76
Stirling,4401,3,16,7,13,61,52,9,55
Stenhousem'r,4401,4,15,9,12,56,47,9,54
Clyde,4401,5,14,10,12,51,48,3,52
Elgin,4401,6,14,6,16,54,64,-10,48
Annan Athlet,4401,7,11,11,14,48,44,4,44
Berwick,4401,8,8,11,17,29,58,-29,35
Edinburgh Ci,4401,9,7,9,20,36,61,-25,30
Cowdenbeath,4401,10,5,10,21,26,55,-29,25
Peterhead,4402,1,24,4,8,80,38,42,76
Montrose,4402,2,23,7,6,60,36,24,76
Stenhousem'r,4402,3,16,8,12,56,46,10,56
Stirling,4402,4,16,6,14,60,52,8,54
Clyde,4402,5,14,10,12,52,49,3,52
Elgin,4402,6,15,6,15,55,61,-6,51
Annan Athlet,4402,7,11,11,14,47,42,5,44
Berwick,4402,8,8,11,17,30,59,-29,35
Edinburgh Ci,4402,9,7,9,20,36,63,-27,30
Cowdenbeath,4402,10,5,10,21,24,54,-30,25
Peterhead,4403,1,24,4,8,78,38,40,76
Montrose,4403,2,23,7,6,60,36,24,76
Stirling,4403,3,17,6,13,63,51,12,57
Clyde,4403,4,15,9,12,52,48,4,54
Stenhousem'r,4403,5,15,8,13,55,49,6,53
Elgin,4403,6,15,6,15,55,61,-6,51
Annan Athlet,4403,7,12,11,13,51,44,7,47
Berwick,4403,8,8,10,18,29,59,-30,34
Edinburgh Ci,4403,9,7,9,20,36,61,-25,30
Cowdenbeath,4403,10,4,10,22,26,58,-32,22
Montrose,4404,1,24,7,5,63,36,27,79
Peterhead,4404,2,24,4,8,78,38,40,76
Stenhousem'r,4404,3,16,8,12,58,47,11,56
Stirling,4404,4,16,6,14,61,54,7,54
Clyde,4404,5,15,9,12,55,48,7,54
Elgin,4404,6,14,6,16,55,64,-9,48
Annan Athlet,4404,7,11,12,13,49,43,6,45
Berwick,4404,8,8,10,18,29,62,-33,34
Edinburgh Ci,4404,9,7,9,20,36,61,-25,30
Cowdenbeath,4404,10,4,11,21,25,56,-31,23
Peterhead,4405,1,24,4,8,80,38,42,76
Montrose,4405,2,23,7,6,59,35,24,76
Stirling,4405,3,17,6,13,62,52,10,57
Stenhousem'r,4405,4,15,8,13,56,48,8,53
Clyde,4405,5,14,9,13,51,49,2,51
Elgin,4405,6,15,6,15,54,60,-6,51
Annan Athlet,4405,7,11,12,13,50,44,6,45
Berwick,4405,8,9,10,17,30,58,-28,37
Edinburgh Ci,4405,9,7,9,20,36,63,-27,30
Cowdenbeath,4405,10,4,11,21,26,57,-31,23
Montrose,4406,1,23,8,5,60,35,25,77
Peterhead,4406,2,23,5,8,79,40,39,74
Stenhousem'r,4406,3,16,8,12,57,47,10,56
Stirling,4406,4,16,6,14,61,53,8,54
Clyde,4406,5,15,9,12,53,49,4,54
Elgin,4406,6,14,7,15,54,61,-7,49
Annan Athlet,4406,7,12,11,13,49,41,8,47
Berwick,4406,8,8,10,18,30,60,-30,34
Edinburgh Ci,4406,9,7,10,19,38,62,-24,31
Cowdenbeath,4406,10,4,10,22,23,56,-33,22
Montrose,4407,1,24,7,5,63,36,27,79
Peterhead,4407,2,24,4,8,82,42,40,76
Stirling,4407,3,17,6,13,63,53,10,57
Stenhousem'r,4407,4,15,8,13,57,49,8,53
Clyde,4407,5,14,9,13,51,50,1,51
Elgin,4407,6,14,6,16,55,64,-9,48
Annan Athlet,4407,7,12,11,13,49,42,7,47
Berwick,4407,8,9,10,17,31,58,-27,37
Edinburgh Ci,4407,9,7,9,20,40,65,-25,30
Cowdenbeath,4407,10,4,10,22,24,56,-32,22
Montrose,4408,1,23,8,5,60,35,25,77
Peterhead,4408,2,24,4,8,79,39,40,76
Stirling,4408,3,16,7,13,61,52,9,55
Stenhousem'r,4408,4,15,9,12,56,47,9,54
Clyde,4408,5,14,10,12,51,48,3,52
Elgin,4408,6,14,7,15,54,61,-7,49
Annan Athlet,4408,7,11,11,14,48,44,4,44
Berwick,4408,8,8,11,17,29,58,-29,35
Edinburgh Ci,4408,9,7,9,20,37,62,-25,30
Cowdenbeath,4408,10,5,10,21,26,55,-29,25
Montrose,4409,1,24,7,5,62,35,27,79
Peterhead,4409,2,24,4,8,80,38,42,76
Stirling,4409,3,17,6,13,63,51,12,57
Clyde,4409,4,15,9,12,57,48,9,54
Stenhousem'r,4409,5,15,8,13,55,49,6,53
Elgin,4409,6,14,6,16,54,63,-9,48
Annan Athlet,4409,7,12,11,13,48,41,7,47
Berwick,4409,8,8,10,18,29,64,-35,34
Edinburgh Ci,4409,9,7,9,20,36,63,-27,30
Cowdenbeath,4409,10,4,10,22,23,55,-32,22
Montrose,4410,1,24,7,5,61,35,26,79
Peterhead,4410,2,24,4,8,80,39,41,76
Stirling,4410,3,17,6,13,62,51,11,57
Clyde,4410,4,15,9,12,52,48,4,54
Stenhousem'r,4410,5,15,8,13,55,48,7,53
Elgin,4410,6,14,6,16,54,62,-8,48
Annan Athlet,4410,7,12,11,13,48,41,7,47
Berwick,4410,8,8,10,18,29,59,-30,34
Edinburgh Ci,4410,9,7,9,20,37,63,-26,30
Cowdenbeath,4410,10,4,10,22,23,55,-32,22
Montrose,4411,1,24,7,5,62,36,26,79
Peterhead,4411,2,24,4,8,80,39,41,76
Stirling,4411,3,16,7,13,61,52,9,55
Stenhousem'r,4411,4,15,9,12,56,47,9,54
Clyde,4411,5,14,9,13,51,49,2,51
Elgin,4411,6,14,6,16,55,63,-8,48
Annan Athlet,4411,7,12,11,13,51,43,8,47
Berwick,4411,8,9,10,17,30,58,-28,37
Edinburgh Ci,4411,9,7,9,20,37,63,-26,30
Cowdenbeath,4411,10,4,10,22,25,58,-33,22
Montrose,4412,1,24,7,5,62,35,27,79
Peterhead,4412,2,24,4,8,81,38,43,76
Stirling,4412,3,17,6,13,65,55,10,57
Stenhousem'r,4412,4,15,8,13,59,51,8,53
Clyde,4412,5,14,10,12,52,49,3,52
Elgin,4412,6,14,6,16,54,63,-9,48
Annan Athlet,4412,7,12,11,13,48,41,7,47
Berwick,4412,8,8,11,17,30,59,-29,35
Edinburgh Ci,4412,9,7,9,20,36,64,-28,30
Cowdenbeath,4412,10,4,10,22,23,55,-32,22
Montrose,4413,1,23,8,5,60,35,25,77
Peterhead,4413,2,24,4,8,80,38,42,76
Stenhousem'r,4413,3,16,8,12,57,46,11,56
Stirling,4413,4,16,6,14,60,53,7,54
Clyde,4413,5,14,10,12,51,48,3,52
Elgin,4413,6,14,7,15,54,61,-7,49
Annan Athlet,4413,7,11,12,13,47,41,6,45
Berwick,4413,8,8,11,17,29,58,-29,35
Edinburgh Ci,4413,9,7,9,20,36,63,-27,30
Cowdenbeath,4413,10,4,11,21,23,54,-31,23
Montrose,4414,1,23,7,6,59,38,21,76
Peterhead,4414,2,23,5,8,77,38,39,74
Stenhousem'r,4414,3,16,8,12,57,46,11,56
Stirling,4414,4,16,6,14,60,53,7,54
Clyde,4414,5,15,9,12,52,48,4,54
Elgin,4414,6,15,6,15,57,60,-3,51
Annan Athlet,4414,7,12,11,13,49,42,7,47
Berwick,4414,8,8,10,18,29,59,-30,34
Edinburgh Ci,4414,9,7,10,19,36,60,-24,31
Cowdenbeath,4414,10,4,10,22,24,56,-32,22
Montrose,4415,1,24,7,5,61,34,27,79
Peterhead,4415,2,24,4,8,81,39,42,76
Stenhousem'r,4415,3,16,8,12,58,47,11,56
Stirling,4415,4,16,6,14,61,54,7,54
Clyde,4415,5,15,9,12,53,49,4,54
Elgin,4415,6,14,6,16,53,62,-9,48
Annan Athlet,4415,7,11,12,13,47,41,6,45
Berwick,4415,8,8,10,18,30,60,-30,34
Edinburgh Ci,4415,9,7,9,20,37,64,-27,30
Cowdenbeath,4415,10,4,11,21,23,54,-31,23
Montrose,4416,1,24,7,5,61,34,27,79
Peterhead,4416,2,24,4,8,80,38,42,76
Stirling,4416,3,17,6,13,62,52,10,57
Clyde,4416,4,15,9,12,52,48,4,54
Stenhousem'r,4416,5,15,8,13,56,48,8,53
Elgin,4416,6,14,6,16,53,62,-9,48
Annan Athlet,4416,7,11,11,14,47,42,5,44
Berwick,4416,8,8,10,18,29,59,-30,34
Edinburgh Ci,4416,9,7,9,20,36,63,-27,30
Cowdenbeath,4416,10,5,10,21,24,54,-30,25
Montrose,4417,1,24,7,5,60,34,26,79
Peterhead,4417,2,23,5,8,77,38,39,74
Stirling,4417,3,17,6,13,61,51,10,57
Stenhousem'r,4417,4,15,8,13,55,47,8,53
Clyde,4417,5,14,10,12,52,49,3,52
Elgin,4417,6,14,6,16,53,61,-8,48
Annan Athlet,4417,7,12,11,13,49,41,8,47
Berwick,4417,8,8,11,17,30,59,-29,35
Edinburgh Ci,4417,9,7,10,19,36,60,-24,31
Cowdenbeath,4417,10,4,10,22,23,56,-33,22
Montrose,4418,1,24,7,5,65,34,31,79
Peterhead,4418,2,23,5,8,78,39,39,74
Stirling,4418,3,17,6,13,65,52,13,57
Clyde,4418,4,15,9,12,55,49,6,54
Stenhousem'r,4418,5,15,8,13,56,51,5,53
Elgin,4418,6,14,6,16,53,66,-13,48
Annan Athlet,4418,7,11,12,13,48,42,6,45
Berwick,4418,8,8,10,18,30,62,-32,34
Edinburgh Ci,4418,9,7,10,19,37,61,-24,31
Cowdenbeath,4418,10,4,11,21,24,55,-31,23
Peterhead,4419,1,24,4,8,79,38,41,76
Montrose,4419,2,23,7,6,59,35,24,76
Stirling,4419,3,17,6,13,61,51,10,57
Clyde,4419,4,15,9,12,53,48,5,54
Stenhousem'r,4419,5,15,8,13,55,47,8,53
Elgin,4419,6,15,6,15,54,60,-6,51
Annan Athlet,4419,7,11,12,13,48,42,6,45
Berwick,4419,8,8,10,18,29,60,-31,34
Edinburgh Ci,4419,9,7,9,20,36,62,-26,30
Cowdenbeath,4419,10,4,11,21,24,55,-31,23
Montrose,4420,1,24,7,5,61,35,26,79
Peterhead,4420,2,23,4,9,77,41,36,73
Stirling,4420,3,17,6,13,62,51,11,57
Stenhousem'r,4420,4,15,8,13,55,48,7,53
Clyde,4420,5,14,10,12,51,48,3,52
Elgin,4420,6,14,6,16,54,62,-8,48
Annan Athlet,4420,7,11,11,14,48,45,3,44
Berwick,4420,8,8,11,17,29,58,-29,35
Edinburgh Ci,4420,9,8,9,19,39,60,-21,33
Cowdenbeath,4420,10,5,10,21,27,55,-28,25
Peterhead,4421,1,24,4,8,79,38,41,76
Montrose,4421,2,23,7,6,60,37,23,76
Stirling,4421,3,17,6,13,62,51,11,57
Stenhousem'r,4421,4,15,8,13,55,48,7,53
Clyde,4421,5,14,9,13,52,50,2,51
Elgin,4421,6,15,6,15,56,61,-5,51
Annan Athlet,4421,7,11,11,14,48,43,5,44
Berwick,4421,8,9,10,17,31,59,-28,37
Edinburgh Ci,4421,9,7,9,20,36,62,-26,30
Cowdenbeath,4421,10,5,10,21,25,55,-30,25
Montrose,4422,1,24,7,5,62,36,26,79
Peterhead,4422,2,23,4,9,78,40,38,73
Stenhousem'r,4422,3,16,8,12,59,46,13,56
Stirling,4422,4,16,6,14,60,55,5,54
Clyde,4422,5,15,9,12,53,48,5,54
Elgin,4422,6,14,6,16,55,63,-8,48
Annan Athlet,4422,7,12,11,13,49,41,8,47
Berwick,4422,8,8,10,18,29,60,-31,34
Edinburgh Ci,4422,9,8,9,19,38,61,-23,33
Cowdenbeath,4422,10,4,10,22,23,56,-33,22
Montrose,4423,1,23,8,5,61,36,25,77
Peterhead,4423,2,23,5,8,77,38,39,74
Stirling,4423,3,16,7,13,61,52,9,55
Stenhousem'r,4423,4,15,9,12,56,47,9,54
Clyde,4423,5,14,9,13,52,51,1,51
Elgin,4423,6,14,7,15,55,62,-7,49
Annan Athlet,4423,7,12,11,13,50,41,9,47
Berwick,4423,8,9,10,17,32,59,-27,37
Edinburgh Ci,4423,9,7,10,19,36,60,-24,31
Cowdenbeath,4423,10,4,10,22,23,57,-34,22
Montrose,4424,1,24,7,5,61,34,27,79
Peterhead,4424,2,24,4,8,79,39,40,76
Stirling,4424,3,17,6,13,65,51,14,57
Stenhousem'r,4424,4,15,8,13,55,51,4,53
Clyde,4424,5,14,10,12,52,49,3,52
Elgin,4424,6,14,6,16,53,62,-9,48
Annan Athlet,4424,7,11,11,14,47,43,4,44
Berwick,4424,8,8,11,17,30,59,-29,35
Edinburgh Ci,4424,9,7,9,20,37,62,-25,30
Cowdenbeath,4424,10,5,10,21,25,54,-29,25
Montrose,4425,1,24,7,5,60,34,26,79
Peterhead,4425,2,23,5,8,78,39,39,74
Stirling,4425,3,16,7,13,63,54,9,55
Stenhousem'r,4425,4,15,9,12,58,49,9,54
Clyde,4425,5,14,9,13,51,49,2,51
Elgin,4425,6,14,6,16,53,61,-8,48
Annan Athlet,4425,7,11,12,13,47,41,6,45
Berwick,4425,8,9,10,17,30,58,-28,37
Edinburgh Ci,4425,9,7,10,19,37,61,-24,31
Cowdenbeath,4425,10,4,11,21,23,54,-31,23
Montrose,4426,1,24,7,5,60,34,26,79
Peterhead,4426,2,24,4,8,79,38,41,76
Stirling,4426,3,16,7,13,61,52,9,55
Stenhousem'r,4426,4,15,9,12,56,47,9,54
Clyde,4426,5,15,9,12,53,49,4,54
Elgin,4426,6,14,6,16,53,61,-8,48
Annan Athlet,4426,7,12,11,13,49,41,8,47
Berwick,4426,8,8,10,18,30,60,-30,34
Edinburgh Ci,4426,9,7,9,20,36,62,-26,30
Cowdenbeath,4426,10,4,10,22,23,56,-33,22
Montrose,4427,1,24,7,5,61,35,26,79
Peterhead,4427,2,24,4,8,79,39,40,76
Stenhousem'r,4427,3,16,8,12,57,47,10,56
Stirling,4427,4,16,6,14,61,53,8,54
Clyde,4427,5,15,9,12,56,49,7,54
Elgin,4427,6,14,6,16,54,62,-8,48
Annan Athlet,4427,7,11,11,14,47,43,4,44
Berwick,4427,8,8,10,18,30,63,-33,34
Edinburgh Ci,4427,9,7,9,20,37,62,-25,30
Cowdenbeath,4427,10,5,10,21,25,54,-29,25
Montrose,4428,1,23,7,6,60,38,22,76
Peterhead,4428,2,23,4,9,79,41,38,73
Stirling,4428,3,17,6,13,62,52,10,57
Clyde,4428,4,15,9,12,54,50,4,54
Stenhousem'r,4428,5,15,8,13,56,48,8,53
Elgin,4428,6,15,6,15,57,61,-4,51
Annan Athlet,4428,7,12,11,13,49,42,7,47
Berwick,4428,8,8,10,18,31,61,-30,34
Edinburgh Ci,4428,9,8,9,19,39,62,-23,33
Cowdenbeath,4428,10,4,10,22,24,56,-32,22
Montrose,4429,1,24,7,5,62,34,28,79
Peterhead,4429,2,23,4,9,77,39,38,73
Stenhousem'r,4429,3,16,8,12,57,47,10,56
Stirling,4429,4,16,6,14,61,53,8,54
Clyde,4429,5,14,9,13,51,49,2,51
Elgin,4429,6,14,6,16,53,63,-10,48
Annan Athlet,4429,7,11,11,14,47,42,5,44
Berwick,4429,8,9,10,17,30,58,-28,37
Edinburgh Ci,4429,9,8,9,19,37,60,-23,33
Cowdenbeath,4429,10,5,10,21,24,54,-30,25
Montrose,4430,1,24,7,5,64,36,28,79
Peterhead,4430,2,24,4,8,80,39,41,76
Stenhousem'r,4430,3,16,8,12,59,48,11,56
Stirling,4430,4,16,6,14,62,55,7,54
Clyde,4430,5,14,10,12,52,49,3,52
Elgin,4430,6,14,6,16,55,65,-10,48
Annan Athlet,4430,7,12,11,13,48,41,7,47
Berwick,4430,8,8,11,17,30,59,-29,35
Edinburgh Ci,4430,9,7,9,20,37,63,-26,30
Cowdenbeath,4430,10,4,10,22,23,55,-32,22
Peterhead,4431,1,24,4,8,81,38,43,76
Montrose,4431,2,23,7,6,60,36,24,76
Stirling,4431,3,17,6,13,61,51,10,57
Stenhousem'r,4431,4,15,8,13,55,47,8,53
Clyde,4431,5,14,10,12,51,48,3,52
Elgin,4431,6,15,6,15,55,61,-6,51
Annan Athlet,4431,7,11,11,14,47,42,5,44
Berwick,4431,8,8,11,17,29,58,-29,35
Edinburgh Ci,4431,9,7,9,20,36,64,-28,30
Cowdenbeath,4431,10,5,10,21,24,54,-30,25
Montrose,4432,1,24,7,5,63,35,28,79
Peterhead,4432,2,24,4,8,81,38,43,76
Stenhousem'r,4432,3,16,8,12,56,46,10,56
Stirling,4432,4,16,6,14,60,52,8,54
Clyde,4432,5,15,9,12,54,49,5,54
Elgin,4432,6,14,6,16,54,64,-10,48
Annan Athlet,4432,7,11,12,13,48,42,6,45
Berwick,4432,8,8,10,18,30,61,-31,34
Edinburgh Ci,4432,9,7,9,20,36,64,-28,30
Cowdenbeath,4432,10,4,11,21,24,55,-31,23
Peterhead,4433,1,24,4,8,79,39,40,76
Montrose,4433,2,23,7,6,59,35,24,76
Stenhousem'r,4433,3,16,8,12,57,47,10,56
Stirling,4433,4,16,6,14,61,53,8,54
Clyde,4433,5,15,9,12,55,49,6,54
Elgin,4433,6,15,6,15,54,60,-6,51
Annan Athlet,4433,7,12,11,13,50,42,8,47
Berwick,4433,8,8,10,18,30,62,-32,34
Edinburgh Ci,4433,9,7,9,20,37,62,-25,30
Cowdenbeath,4433,10,4,10,22,24,57,-33,22
Montrose,4434,1,24,7,5,60,34,26,79
Peterhead,4434,2,24,4,8,81,38,43,76
Stirling,4434,3,17,6,13,61,51,10,57
Stenhousem'r,4434,4,15,8,13,55,47,8,53
Clyde,4434,5,14,9,13,51,49,2,51
Elgin,4434,6,14,6,16,53,61,-8,48
Annan Athlet,4434,7,11,11,14,47,42,5,44
Berwick,4434,8,9,10,17,30,58,-28,37
Edinburgh Ci,4434,9,7,9,20,36,64,-28,30
Cowdenbeath,4434,10,5,10,21,24,54,-30,25
Montrose,4435,1,24,7,5,61,34,27,79
Peterhead,4435,2,23,4,9,77,40,37,73
Stirling,4435,3,17,6,13,63,52,11,57
Clyde,4435,4,15,9,12,55,48,7,54
Stenhousem'r,4435,5,15,8,13,56,49,7,53
Elgin,4435,6,14,6,16,53,62,-9,48
Annan Athlet,4435,7,11,11,14,47,42,5,44
Berwick,4435,8,8,10,18,29,62,-33,34
Edinburgh Ci,4435,9,8,9,19,38,60,-22,33
Cowdenbeath,4435,10,5,10,21,24,54,-30,25
Montrose,4436,1,23,8,5,65,40,25,77
Peterhead,4436,2,24,4,8,82,39,43,76
Stirling,4436,3,17,6,13,62,51,11,57
Clyde,4436,4,15,9,12,54,50,4,54
Stenhousem'r,4436,5,15,8,13,55,48,7,53
Elgin,4436,6,14,7,15,59,66,-7,49
Annan Athlet,4436,7,12,11,13,50,41,9,47
Berwick,4436,8,8,10,18,31,61,-30,34
Edinburgh Ci,4436,9,7,9,20,37,65,-28,30
Cowdenbeath,4436,10,4,10,22,23,57,-34,22
Peterhead,4437,1,24,4,8,80,39,41,76
Montrose,4437,2,23,7,6,61,38,23,76
Stirling,4437,3,16,7,13,61,52,9,55
Stenhousem'r,4437,4,15,9,12,56,47,9,54
Clyde,4437,5,14,10,12,52,49,3,52
Elgin,4437,6,15,6,15,57,62,-5,51
Annan Athlet,4437,7,11,11,14,47,42,5,44
Berwick,4437,8,8,11,17,30,59,-29,35
Edinburgh Ci,4437,9,7,9,20,37,63,-26,30
Cowdenbeath,4437,10,5,10,21,24,54,-30,25
Montrose,4438,1,24,7,5,67,35,32,79
Peterhead,4438,2,23,5,8,77,38,39,74
Stenhousem'r,4438,3,16,8,12,58,48,10,56
Stirling,4438,4,16,6,14,62,54,8,54
Clyde,4438,5,15,9,12,52,48,4,54
Elgin,4438,6,14,6,16,54,68,-14,48
Annan Athlet,4438,7,12,11,13,49,42,7,47
Berwick,4438,8,8,10,18,29,59,-30,34
Edinburgh Ci,4438,9,7,10,19,36,60,-24,31
Cowdenbeath,4438,10,4,10,22,24,56,-32,22
Montrose,4439,1,24,7,5,60,34,26,79
Peterhead,4439,2,23,5,8,78,39,39,74
Stirling,4439,3,17,6,13,64,51,13,57
Clyde,4439,4,15,9,12,54,48,6,54
Stenhousem'r,4439,5,15,8,13,55,50,5,53
Elgin,4439,6,14,6,16,53,61,-8,48
Annan Athlet,4439,7,12,11,13,50,43,7,47
Berwick,4439,8,8,10,18,29,61,-32,34
Edinburgh Ci,4439,9,7,10,19,37,61,-24,31
Cowdenbeath,4439,10,4,10,22,25,57,-32,22
Montrose,4440,1,24,7,5,63,34,29,79
Peterhead,4440,2,24,4,8,81,39,42,76
Stirling,4440,3,16,7,13,60,51,9,55
Stenhousem'r,4440,4,15,9,12,55,46,9,54
Clyde,4440,5,15,9,12,53,49,4,54
Elgin,4440,6,14,6,16,53,64,-11,48
Annan Athlet,4440,7,12,11,13,49,42,7,47
Berwick,4440,8,8,10,18,30,60,-30,34
Edinburgh Ci,4440,9,7,9,20,37,64,-27,30
Cowdenbeath,4440,10,4,10,22,24,56,-32,22
Montrose,4441,1,23,8,5,60,35,25,77
Peterhead,4441,2,23,5,8,78,39,39,74
Stirling,4441,3,16,7,13,61,52,9,55
Stenhousem'r,4441,4,15,9,12,56,47,9,54
Clyde,4441,5,14,10,12,51,48,3,52
Elgin,4441,6,14,7,15,54,61,-7,49
Annan Athlet,4441,7,11,11,14,48,43,5,44
Berwick,4441,8,8,11,17,29,58,-29,35
Edinburgh Ci,4441,9,7,10,19,37,61,-24,31
Cowdenbeath,4441,10,5,10,21,25,55,-30,25
Montrose,4442,1,24,7,5,61,35,26,79
Peterhead,4442,2,24,4,8,79,38,41,76
Stirling,4442,3,17,6,13,63,53,10,57
Stenhousem'r,4442,4,15,8,13,57,49,8,53
Clyde,4442,5,14,10,12,53,50,3,52
Elgin,4442,6,14,6,16,54,62,-8,48
Annan Athlet,4442,7,11,11,14,48,44,4,44
Berwick,4442,8,8,11,17,31,60,-29,35
Edinburgh Ci,4442,9,7,9,20,36,62,-26,30
Cowdenbeath,4442,10,5,10,21,26,55,-29,25
Montrose,4443,1,23,8,5,60,35,25,77
Peterhead,4443,2,23,5,8,78,39,39,74
Stirling,4443,3,17,6,13,63,52,11,57
Stenhousem'r,4443,4,15,8,13,56,49,7,53
Clyde,4443,5,14,9,13,52,50,2,51
Elgin,4443,6,14,7,15,54,61,-7,49
Annan Athlet,4443,7,12,11,13,50,42,8,47
Berwick,4443,8,9,10,17,31,59,-28,37
Edinburgh Ci,4443,9,7,10,19,37,61,-24,31
Cowdenbeath,4443,10,4,10,22,24,57,-33,22
Montrose,4444,1,24,7,5,61,34,27,79
Peterhead,4444,2,23,5,8,78,39,39,74
Stirling,4444,3,17,6,13,63,53,10,57
Clyde,4444,4,15,9,12,53,48,5,54
Stenhousem'r,4444,5,15,8,13,57,49,8,53
Elgin,4444,6,14,6,16,53,62,-9,48
Annan Athlet,4444,7,12,11,13,49,42,7,47
Berwick,4444,8,8,10,18,29,60,-31,34
Edinburgh Ci,4444,9,7,10,19,37,61,-24,31
Cowdenbeath,4444,10,4,10,22,24,56,-32,22
Montrose,4445,1,23,8,5,62,37,25,77
Peterhead,4445,2,24,4,8,80,40,40,76
Stenhousem'r,4445,3,16,8,12,57,47,10,56
Stirling,4445,4,16,6,14,61,53,8,54
Clyde,4445,5,15,9,12,54,49,5,54
Elgin,4445,6,14,7,15,56,63,-7,49
Annan Athlet,4445,7,11,11,14,47,42,5,44
Berwick,4445,8,8,10,18,30,61,-31,34
Edinburgh Ci,4445,9,7,9,20,38,63,-25,30
Cowdenbeath,4445,10,5,10,21,24,54,-30,25
Montrose,4446,1,24,7,5,62,34,28,79
Peterhead,4446,2,24,4,8,80,38,42,76
Stirling,4446,3,17,6,13,63,53,10,57
Stenhousem'r,4446,4,15,8,13,57,49,8,53
Clyde,4446,5,14,9,13,51,51,0,51
Elgin,4446,6,14,6,16,53,63,-10,48
Annan Athlet,4446,7,11,12,13,48,42,6,45
Berwick,4446,8,9,10,17,32,58,-26,37
Edinburgh Ci,4446,9,7,9,20,36,63,-27,30
Cowdenbeath,4446,10,4,11,21,24,55,-31,23
Peterhead,4447,1,24,4,8,82,39,43,76
Montrose,4447,2,23,7,6,60,36,24,76
Stirling,4447,3,17,6,13,62,52,10,57
Clyde,4447,4,15,9,12,53,48,5,54
Stenhousem'r,4447,5,15,8,13,56,48,8,53
Elgin,4447,6,15,6,15,55,61,-6,51
Annan Athlet,4447,7,12,11,13,49,41,8,47
Berwick,4447,8,8,10,18,29,60,-31,34
Edinburgh Ci,4447,9,7,9,20,37,65,-28,30
Cowdenbeath,4447,10,4,10,22,23,56,-33,22
Montrose,4448,1,24,7,5,62,34,28,79
Peterhead,4448,2,23,4,9,79,41,38,73
Stirling,4448,3,17,6,13,62,51,11,57
Stenhousem'r,4448,4,15,8,13,55,48,7,53
Clyde,4448,5,14,10,12,52,49,3,52
Elgin,4448,6,14,6,16,53,63,-10,48
Annan Athlet,4448,7,12,11,13,49,41,8,47
Berwick,4448,8,8,11,17,30,59,-29,35
Edinburgh Ci,4448,9,8,9,19,39,62,-23,33
Cowdenbeath,4448,10,4,10,22,23,56,-33,22
Peterhead,4449,1,24,4,8,81,39,42,76
Montrose,4449,2,23,7,6,60,37,23,76
Stirling,4449,3,16,7,13,62,53,9,55
Stenhousem'r,4449,4,15,9,12,57,48,9,54
Clyde,4449,5,15,9,12,53,48,5,54
Elgin,4449,6,15,6,15,56,61,-5,51
Annan Athlet,4449,7,11,11,14,47,43,4,44
Berwick,4449,8,8,10,18,29,60,-31,34
Edinburgh Ci,4449,9,7,9,20,37,64,-27,30
Cowdenbeath,4449,10,5,10,21,25,54,-29,25
Montrose,4450,1,24,7,5,61,34,27,79
Peterhead,4450,2,24,4,8,78,38,40,76
Stenhousem'r,4450,3,16,8,12,56,46,10,56
Stirling,4450,4,16,6,14,60,52,8,54
Clyde,4450,5,15,9,12,54,48,6,54
Elgin,4450,6,14,6,16,53,62,-9,48
Annan Athlet,4450,7,11,12,13,48,42,6,45
Berwick,4450,8,8,10,18,29,61,-32,34
Edinburgh Ci,4450,9,7,9,20,36,61,-25,30
Cowdenbeath,4450,10,4,11,21,24,55,-31,23
Montrose,4451,1,23,8,5,60,35,25,77
Peterhead,4451,2,23,4,9,77,39,38,73
Stenhousem'r,4451,3,16,8,12,60,49,11,56
Stirling,4451,4,16,6,14,63,56,7,54
Clyde,4451,5,15,9,12,55,48,7,54
Elgin,4451,6,14,7,15,54,61,-7,49
Annan Athlet,4451,7,11,12,13,50,44,6,45
Berwick,4451,8,8,10,18,29,62,-33,34
Edinburgh Ci,4451,9,8,9,19,37,60,-23,33
Cowdenbeath,4451,10,4,11,21,26,57,-31,23
Montrose,4452,1,24,7,5,61,34,27,79
Peterhead,4452,2,24,4,8,80,40,40,76
Stenhousem'r,4452,3,16,8,12,59,47,12,56
Stirling,4452,4,16,6,14,61,55,6,54
Clyde,4452,5,15,9,12,52,48,4,54
Elgin,4452,6,14,6,16,53,62,-9,48
Annan Athlet,4452,7,11,11,14,47,43,4,44
Berwick,4452,8,8,10,18,29,59,-30,34
Edinburgh Ci,4452,9,7,9,20,38,63,-25,30
Cowdenbeath,4452,10,5,10,21,25,54,-29,25
Montrose,4453,1,24,7,5,62,35,27,79
Peterhead,4453,2,24,4,8,85,39,46,76
Stenhousem'r,4453,3,16,8,12,57,47,10,56
Stirling,4453,4,16,6,14,61,53,8,54
Clyde,4453,5,15,9,12,55,51,4,54
Elgin,4453,6,14,6,16,54,63,-9,48
Annan Athlet,4453,7,11,11,14,47,42,5,44
Berwick,4453,8,8,10,18,32,62,-30,34
Edinburgh Ci,4453,9,7,9,20,37,68,-31,30
Cowdenbeath,4453,10,5,10,21,24,54,-30,25
Montrose,4454,1,24,7,5,64,34,30,79
Peterhead,4454,2,23,4,9,77,39,38,73
Stirling,4454,3,16,7,13,60,51,9,55
Stenhousem'r,4454,4,15,9,12,55,46,9,54
Clyde,4454,5,15,9,12,54,48,6,54
Elgin,4454,6,14,6,16,53,65,-12,48
Annan Athlet,4454,7,12,11,13,52,42,10,47
Berwick,4454,8,8,10,18,29,61,-32,34
Edinburgh Ci,4454,9,8,9,19,37,60,-23,33
Cowdenbeath,4454,10,4,10,22,24,59,-35,22
Montrose,4455,1,23,8,5,60,35,25,77
Peterhead,4455,2,24,4,8,82,40,42,76
Stirling,4455,3,17,6,13,62,52,10,57
Clyde,4455,4,15,9,12,55,48,7,54
Stenhousem'r,4455,5,15,8,13,56,48,8,53
Elgin,4455,6,14,7,15,54,61,-7,49
Annan Athlet,4455,7,11,12,13,48,42,6,45
Berwick,4455,8,8,10,18,29,62,-33,34
Edinburgh Ci,4455,9,7,9,20,38,65,-27,30
Cowdenbeath,4455,10,4,11,21,24,55,-31,23
Montrose,4456,1,24,7,5,60,34,26,79
Peterhead,4456,2,24,4,8,79,39,40,76
Stirling,4456,3,17,6,13,61,51,10,57
Clyde,4456,4,15,9,12,53,49,4,54
Stenhousem'r,4456,5,15,8,13,55,47,8,53
Elgin,4456,6,14,6,16,53,61,-8,48
Annan Athlet,4456,7,11,12,13,47,41,6,45
Berwick,4456,8,8,10,18,30,60,-30,34
Edinburgh Ci,4456,9,7,9,20,37,62,-25,30
Cowdenbeath,4456,10,4,11,21,23,54,-31,23
Montrose,4457,1,24,7,5,60,34,26,79
Peterhead,4457,2,24,4,8,80,39,41,76
Stenhousem'r,4457,3,16,8,12,56,46,10,56
Stirling,4457,4,16,6,14,60,52,8,54
Clyde,4457,5,15,9,12,52,48,4,54
Elgin,4457,6,14,6,16,53,61,-8,48
Annan Athlet,4457,7,11,11,14,48,43,5,44
Berwick,4457,8,8,10,18,29,59,-30,34
Edinburgh Ci,4457,9,7,9,20,37,63,-26,30
Cowdenbeath,4457,10,5,10,21,25,55,-30,25
Montrose,4458,1,24,7,5,62,36,26,79
Peterhead,4458,2,24,4,8,81,39,42,76
Stirling,4458,3,17,6,13,63,53,10,57
Clyde,4458,4,15,9,12,54,48,6,54
Stenhousem'r,4458,5,15,8,13,57,49,8,53
Elgin,4458,6,14,6,16,55,63,-8,48
Annan Athlet,4458,7,12,11,13,48,41,7,47
Berwick,4458,8,8,10,18,29,61,-32,34
Edinburgh Ci,4458,9,7,9,20,37,64,-27,30
Cowdenbeath,4458,10,4,10,22,23,55,-32,22
Peterhead,4459,1,24,4,8,78,38,40,76
Montrose,4459,2,23,7,6,61,37,24,76
Stirling,4459,3,16,7,13,61,52,9,55
Stenhousem'r,4459,4,15,9,12,56,47,9,54
Clyde,4459,5,15,9,12,55,49,6,54
Elgin,4459,6,15,6,15,56,62,-6,51
Annan Athlet,4459,7,12,11,13,48,41,7,47
Berwick,4459,8,8,10,18,30,62,-32,34
Edinburgh Ci,4459,9,7,9,20,36,61,-25,30
Cowdenbeath,4459,10,4,10,22,23,55,-32,22
Montrose,4460,1,24,7,5,63,35,28,79
Peterhead,4460,2,24,4,8,80,39,41,76
Stenhousem'r,4460,3,16,8,12,58,48,10,56
Stirling,4460,4,16,6,14,62,54,8,54
Clyde,4460,5,14,9,13,52,50,2,51
Elgin,4460,6,14,6,16,54,64,-10,48
Annan Athlet,4460,7,11,11,14,47,43,4,44
Berwick,4460,8,9,10,17,31,59,-28,37
Edinburgh Ci,4460,9,7,9,20,37,63,-26,30
Cowdenbeath,4460,10,5,10,21,25,54,-29,25
Montrose,4461,1,24,7,5,62,34,28,79
Peterhead,4461,2,23,5,8,79,40,39,74
Stirling,4461,3,17,6,13,62,51,11,57
Clyde,4461,4,15,9,12,55,49,6,54
Stenhousem'r,4461,5,15,8,13,55,48,7,53
Elgin,4461,6,14,6,16,53,63,-10,48
Annan Athlet,4461,7,11,11,14,47,43,4,44
Berwick,4461,8,8,10,18,30,62,-32,34
Edinburgh Ci,4461,9,7,10,19,38,62,-24,31
Cowdenbeath,4461,10,5,10,21,25,54,-29,25
Montrose,4462,1,24,7,5,61,34,27,79
Peterhead,4462,2,23,5,8,79,40,39,74
Stirling,4462,3,16,7,13,60,51,9,55
Stenhousem'r,4462,4,15,9,12,55,46,9,54
Clyde,4462,5,15,9,12,53,49,4,54
Elgin,4462,6,14,6,16,53,62,-9,48
Annan Athlet,4462,7,12,11,13,49,41,8,47
Berwick,4462,8,8,10,18,30,60,-30,34
Edinburgh Ci,4462,9,7,10,19,38,62,-24,31
Cowdenbeath,4462,10,4,10,22,23,56,-33,22
Montrose,4463,1,24,7,5,60,34,26,79
Peterhead,4463,2,23,4,9,80,43,37,73
Stirling,4463,3,16,7,13,62,53,9,55
Stenhousem'r,4463,4,15,9,12,57,48,9,54
Clyde,4463,5,15,9,12,54,49,5,54
Elgin,4463,6,14,6,16,53,61,-8,48
Annan Athlet,4463,7,11,11,14,47,42,5,44
Berwick,4463,8,8,10,18,30,61,-31,34
Edinburgh Ci,4463,9,8,9,19,41,63,-22,33
Cowdenbeath,4463,10,5,10,21,24,54,-30,25
Montrose,4464,1,24,7,5,60,34,26,79
Peterhead,4464,2,23,5,8,79,40,39,74
Stirling,4464,3,17,6,13,64,51,13,57
Clyde,4464,4,15,9,12,54,50,4,54
Stenhousem'r,4464,5,15,8,13,55,50,5,53
Elgin,4464,6,14,6,16,53,61,-8,48
Annan Athlet,4464,7,11,11,14,47,43,4,44
Berwick,4464,8,8,10,18,31,61,-30,34
Edinburgh Ci,4464,9,7,10,19,38,62,-24,31
Cowdenbeath,4464,10,5,10,21,25,54,-29,25
Montrose,4465,1,24,7,5,62,34,28,79
Peterhead,4465,2,23,5,8,78,39,39,74
Stirling,4465,3,17,6,13,63,53,10,57
Stenhousem'r,4465,4,15,8,13,57,49,8,53
Clyde,4465,5,14,10,12,52,49,3,52
Elgin,4465,6,14,6,16,53,63,-10,48
Annan Athlet,4465,7,11,12,13,48,42,6,45
Berwick,4465,8,8,11,17,30,59,-29,35
Edinburgh Ci,4465,9,7,10,19,37,61,-24,31
Cowdenbeath,4465,10,4,11,21,24,55,-31,23
Montrose,4466,1,24,7,5,62,35,27,79
Peterhead,4466,2,24,4,8,81,38,43,76
Stirling,4466,3,17,6,13,61,51,10,57
Stenhousem'r,4466,4,15,8,13,55,47,8,53
Clyde,4466,5,14,10,12,51,48,3,52
Elgin,4466,6,14,6,16,54,63,-9,48
Annan Athlet,4466,7,12,11,13,48,41,7,47
Berwick,4466,8,8,11,17,29,58,-29,35
Edinburgh Ci,4466,9,7,9,20,36,64,-28,30
Cowdenbeath,4466,10,4,10,22,23,55,-32,22
Montrose,4467,1,24,7,5,62,35,27,79
Peterhead,4467,2,24,4,8,81,38,43,76
Stenhousem'r,4467,3,16,8,12,56,46,10,56
Stirling,4467,4,16,6,14,60,52,8,54
Clyde,4467,5,14,10,12,51,48,3,52
Elgin,4467,6,14,6,16,54,63,-9,48
Annan Athlet,4467,7,11,12,13,48,42,6,45
Berwick,4467,8,8,11,17,29,58,-29,35
Edinburgh Ci,4467,9,7,9,20,36,64,-28,30
Cowdenbeath,4467,10,4,11,21,24,55,-31,23
Montrose,4468,1,24,7,5,62,34,28,79
Peterhead,4468,2,23,4,9,77,39,38,73
Stirling,4468,3,17,6,13,65,52,13,57
Clyde,4468,4,15,9,12,55,48,7,54
Stenhousem'r,4468,5,15,8,13,56,51,5,53
Elgin,4468,6,14,6,16,53,63,-10,48
Annan Athlet,4468,7,11,12,13,48,42,6,45
Berwick,4468,8,8,10,18,29,62,-33,34
Edinburgh Ci,4468,9,8,9,19,37,60,-23,33
Cowdenbeath,4468,10,4,11,21,24,55,-31,23
Montrose,4469,1,24,7,5,60,34,26,79
Peterhead,4469,2,24,4,8,79,39,40,76
Stirling,4469,3,17,6,13,61,51,10,57
Stenhousem'r,4469,4,15,8,13,55,47,8,53
Clyde,4469,5,14,10,12,51,48,3,52
Elgin,4469,6,14,6,16,53,61,-8,48
Annan Athlet,4469,7,11,12,13,48,42,6,45
Berwick,4469,8,8,11,17,29,58,-29,35
Edinburgh Ci,4469,9,7,9,20,37,62,-25,30
Cowdenbeath,4469,10,4,11,21,24,55,-31,23
Montrose,4470,1,24,7,5,63,34,29,79
Peterhead,4470,2,23,5,8,79,40,39,74
Stirling,4470,3,16,7,13,61,52,9,55
Stenhousem'r,4470,4,15,9,12,56,47,9,54
Clyde,4470,5,15,9,12,55,49,6,54
Elgin,4470,6,14,6,16,53,64,-11,48
Annan Athlet,4470,7,11,11,14,47,42,5,44
Berwick,4470,8,8,10,18,30,62,-32,34
Edinburgh Ci,4470,9,7,10,19,38,62,-24,31
Cowdenbeath,4470,10,5,10,21,24,54,-30,25
Peterhead,4471,1,24,4,8,78,38,40,76
Montrose,4471,2,23,7,6,61,38,23,76
Stenhousem'r,4471,3,16,8,12,59,46,13,56
Stirling,4471,4,16,6,14,60,55,5,54
Clyde,4471,5,15,9,12,52,48,4,54
Elgin,4471,6,15,6,15,57,62,-5,51
Annan Athlet,4471,7,11,12,13,49,43,6,45
Berwick,4471,8,8,10,18,29,59,-30,34
Edinburgh Ci,4471,9,7,9,20,36,61,-25,30
Cowdenbeath,4471,10,4,11,21,25,56,-31,23
Montrose,4472,1,24,7,5,61,34,27,79
Peterhead,4472,2,23,5,8,78,39,39,74
Stirling,4472,3,17,6,13,63,52,11,57
Stenhousem'r,4472,4,15,8,13,56,49,7,53
Clyde,4472,5,14,10,12,52,49,3,52
Elgin,4472,6,14,6,16,53,62,-9,48
Annan Athlet,4472,7,12,11,13,48,41,7,47
Berwick,4472,8,8,11,17,30,59,-29,35
Edinburgh Ci,4472,9,7,10,19,37,61,-24,31
Cowdenbeath,4472,10,4,10,22,23,55,-32,22
Montrose,4473,1,24,7,5,60,34,26,79
Peterhead,4473,2,24,4,8,79,38,41,76
Stirling,4473,3,17,6,13,61,51,10,57
Clyde,4473,4,15,9,12,52,48,4,54
Stenhousem'r,4473,5,15,8,13,55,47,8,53
Elgin,4473,6,14,6,16,53,61,-8,48
Annan Athlet,4473,7,12,11,13,48,41,7,47
Berwick,4473,8,8,10,18,29,59,-30,34
Edinburgh Ci,4473,9,7,9,20,36,62,-26,30
Cowdenbeath,4473,10,4,10,22,23,55,-32,22
Montrose,4474,1,24,7,5,66,35,31,79
Peterhead,4474,2,24,4,8,79,38,41,76
Stenhousem'r,4474,3,16,8,12,57,46,11,56
Stirling,4474,4,16,6,14,60,53,7,54
Clyde,4474,5,15,9,12,55,48,7,54
Elgin,4474,6,14,6,16,54,67,-13,48
Annan Athlet,4474,7,12,11,13,48,41,7,47
Berwick,4474,8,8,10,18,29,62,-33,34
Edinburgh Ci,4474,9,7,9,20,36,62,-26,30
Cowdenbeath,4474,10,4,10,22,23,55,-32,22
Montrose,4475,1,24,7,5,63,34,29,79
Peterhead,4475,2,24,4,8,81,38,43,76
Stirling,4475,3,17,6,13,62,51,11,57
Stenhousem'r,4475,4,15,8,13,55,48,7,53
Clyde,4475,5,14,9,13,51,49,2,51
Elgin,4475,6,14,6,16,53,64,-11,48
Annan Athlet,4475,7,12,11,13,50,43,7,47
Berwick,4475,8,9,10,17,30,58,-28,37
Edinburgh Ci,4475,9,7,9,20,36,64,-28,30
Cowdenbeath,4475,10,4,10,22,25,57,-32,22
Montrose,4476,1,23,8,5,61,36,25,77
Peterhead,4476,2,24,4,8,80,39,41,76
Stirling,4476,3,17,6,13,62,52,10,57
Clyde,4476,4,15,9,12,53,49,4,54
Stenhousem'r,4476,5,15,8,13,56,48,8,53
Elgin,4476,6,14,7,15,55,62,-7,49
Annan Athlet,4476,7,12,11,13,48,41,7,47
Berwick,4476,8,8,10,18,30,60,-30,34
Edinburgh Ci,4476,9,7,9,20,37,63,-26,30
Cowdenbeath,4476,10,4,10,22,23,55,-32,22
Montrose,4477,1,24,7,5,64,35,29,79
Peterhead,4477,2,24,4,8,83,38,45,76
Stirling,4477,3,17,6,13,62,52,10,57
Clyde,4477,4,15,9,12,55,50,5,54
Stenhousem'r,4477,5,15,8,13,56,48,8,53
Elgin,4477,6,14,6,16,54,65,-11,48
Annan Athlet,4477,7,11,11,14,47,43,4,44
Berwick,4477,8,8,10,18,31,62,-31,34
Edinburgh Ci,4477,9,7,9,20,36,66,-30,30
Cowdenbeath,4477,10,5,10,21,25,54,-29,25
Montrose,4478,1,24,7,5,61,35,26,79
Peterhead,4478,2,23,5,8,78,39,39,74
Stirling,4478,3,17,6,13,61,51,10,57
Stenhousem'r,4478,4,15,8,13,55,47,8,53
Clyde,4478,5,14,10,12,53,50,3,52
Elgin,4478,6,14,6,16,54,62,-8,48
Annan Athlet,4478,7,12,11,13,48,41,7,47
Berwick,4478,8,8,11,17,31,60,-29,35
Edinburgh Ci,4478,9,7,10,19,37,61,-24,31
Cowdenbeath,4478,10,4,10,22,23,55,-32,22
Montrose,4479,1,24,7,5,64,34,30,79
Peterhead,4479,2,24,4,8,81,39,42,76
Stenhousem'r,4479,3,16,8,12,57,47,10,56
Stirling,4479,4,16,6,14,61,53,8,54
Clyde,4479,5,14,10,12,51,48,3,52
Elgin,4479,6,14,6,16,53,65,-12,48
Annan Athlet,4479,7,11,12,13,48,42,6,45
Berwick,4479,8,8,11,17,29,58,-29,35
Edinburgh Ci,4479,9,7,9,20,37,64,-27,30
Cowdenbeath,4479,10,4,11,21,24,55,-31,23
Montrose,4480,1,23,8,5,60,35,25,77
Peterhead,4480,2,24,4,8,80,38,42,76
Stenhousem'r,4480,3,16,8,12,57,47,10,56
Stirling,4480,4,16,6,14,61,53,8,54
Clyde,4480,5,15,9,12,55,51,4,54
Elgin,4480,6,14,7,15,54,61,-7,49
Annan Athlet,4480,7,11,11,14,48,43,5,44
Berwick,4480,8,8,10,18,32,62,-30,34
Edinburgh Ci,4480,9,7,9,20,36,63,-27,30
Cowdenbeath,4480,10,5,10,21,25,55,-30,25
Peterhead,4481,1,24,4,8,81,39,42,76
Montrose,4481,2,23,7,6,59,35,24,76
Stirling,4481,3,16,7,13,61,52,9,55
Stenhousem'r,4481,4,15,9,12,56,47,9,54
Clyde,4481,5,14,9,13,52,50,2,51
Elgin,4481,6,15,6,15,54,60,-6,51
Annan Athlet,4481,7,11,12,13,47,41,6,45
Berwick,4481,8,9,10,17,31,59,-28,37
Edinburgh Ci,4481,9,7,9,20,37,64,-27,30
Cowdenbeath,4481,10,4,11,21,23,54,-31,23
Montrose,4482,1,23,8,5,59,34,25,77
Peterhead,4482,2,23,4,9,77,39,38,73
Stirling,4482,3,16,7,13,61,52,9,55
Stenhousem'r,4482,4,15,9,12,56,47,9,54
Clyde,4482,5,14,10,12,55,52,3,52
Elgin,4482,6,14,7,15,53,60,-7,49
Annan Athlet,4482,7,11,11,14,47,43,4,44
Berwick,4482,8,8,11,17,33,62,-29,35
Edinburgh Ci,4482,9,8,9,19,37,60,-23,33
Cowdenbeath,4482,10,5,10,21,25,54,-29,25
Montrose,4483,1,24,7,5,60,34,26,79
Peterhead,4483,2,23,5,8,78,39,39,74
Stirling,4483,3,17,6,13,61,51,10,57
Clyde,4483,4,15,9,12,54,48,6,54
Stenhousem'r,4483,5,15,8,13,55,47,8,53
Elgin,4483,6,14,6,16,53,61,-8,48
Annan Athlet,4483,7,11,12,13,48,42,6,45
Berwick,4483,8,8,10,18,29,61,-32,34
Edinburgh Ci,4483,9,7,10,19,37,61,-24,31
Cowdenbeath,4483,10,4,11,21,24,55,-31,23
Montrose,4484,1,24,7,5,61,34,27,79
Peterhead,4484,2,24,4,8,82,39,43,76
Stirling,4484,3,16,7,13,61,52,9,55
Stenhousem'r,4484,4,15,9,12,56,47,9,54
Clyde,4484,5,15,9,12,54,48,6,54
Elgin,4484,6,14,6,16,53,62,-9,48
Annan Athlet,4484,7,11,12,13,48,42,6,45
Berwick,4484,8,8,10,18,29,61,-32,34
Edinburgh Ci,4484,9,7,9,20,37,65,-28,30
Cowdenbeath,4484,10,4,11,21,24,55,-31,23
Montrose,4485,1,24,7,5,60,34,26,79
Peterhead,4485,2,24,4,8,81,38,43,76
Stirling,4485,3,17,6,13,63,51,12,57
Clyde,4485,4,15,9,12,53,49,4,54
Stenhousem'r,4485,5,15,8,13,55,49,6,53
Elgin,4485,6,14,6,16,53,61,-8,48
Annan Athlet,4485,7,11,11,14,47,42,5,44
Berwick,4485,8,8,10,18,30,60,-30,34
Edinburgh Ci,4485,9,7,9,20,36,64,-28,30
Cowdenbeath,4485,10,5,10,21,24,54,-30,25
Montrose,4486,1,23,8,5,60,35,25,77
Peterhead,4486,2,24,4,8,79,38,41,76
Stirling,4486,3,16,7,13,60,51,9,55
Stenhousem'r,4486,4,15,9,12,55,46,9,54
Clyde,4486,5,15,9,12,52,48,4,54
Elgin,4486,6,14,7,15,54,61,-7,49
Annan Athlet,4486,7,11,12,13,47,41,6,45
Berwick,4486,8,8,10,18,29,59,-30,34
Edinburgh Ci,4486,9,7,9,20,36,62,-26,30
Cowdenbeath,4486,10,4,11,21,23,54,-31,23
Montrose,4487,1,23,8,5,60,35,25,77
Peterhead,4487,2,23,4,9,77,39,38,73
Stenhousem'r,4487,3,16,8,12,57,47,10,56
Stirling,4487,4,16,6,14,61,53,8,54
Clyde,4487,5,15,9,12,54,49,5,54
Elgin,4487,6,14,7,15,54,61,-7,49
Annan Athlet,4487,7,12,11,13,51,43,8,47
Berwick,4487,8,8,10,18,30,61,-31,34
Edinburgh Ci,4487,9,8,9,19,37,60,-23,33
Cowdenbeath,4487,10,4,10,22,25,58,-33,22
Montrose,4488,1,24,7,5,62,34,28,79
Peterhead,4488,2,24,4,8,79,38,41,76
Stirling,4488,3,17,6,13,64,53,11,57
Clyde,4488,4,15,9,12,52,48,4,54
Stenhousem'r,4488,5,15,8,13,57,50,7,53
Elgin,4488,6,14,6,16,53,63,-10,48
Annan Athlet,4488,7,12,11,13,50,43,7,47
Berwick,4488,8,8,10,18,29,59,-30,34
Edinburgh Ci,4488,9,7,9,20,36,62,-26,30
Cowdenbeath,4488,10,4,10,22,25,57,-32,22
Montrose,4489,1,23,8,5,60,35,25,77
Peterhead,4489,2,24,4,8,83,40,43,76
Stirling,4489,3,17,6,13,63,53,10,57
Clyde,4489,4,15,9,12,55,49,6,54
Stenhousem'r,4489,5,15,8,13,57,49,8,53
Elgin,4489,6,14,7,15,54,61,-7,49
Annan Athlet,4489,7,11,11,14,47,42,5,44
Berwick,4489,8,8,10,18,30,62,-32,34
Edinburgh Ci,4489,9,7,9,20,38,66,-28,30
Cowdenbeath,4489,10,5,10,21,24,54,-30,25
Montrose,4490,1,24,7,5,63,34,29,79
Peterhead,4490,2,24,4,8,79,38,41,76
Stenhousem'r,4490,3,16,8,12,56,46,10,56
Stirling,4490,4,16,6,14,60,52,8,54
Clyde,4490,5,14,9,13,52,50,2,51
Elgin,4490,6,14,6,16,53,64,-11,48
Annan Athlet,4490,7,12,11,13,49,41,8,47
Berwick,4490,8,9,10,17,31,59,-28,37
Edinburgh Ci,4490,9,7,9,20,36,62,-26,30
Cowdenbeath,4490,10,4,10,22,23,56,-33,22
Montrose,4491,1,24,7,5,62,35,27,79
Peterhead,4491,2,24,4,8,80,38,42,76
Stirling,4491,3,17,6,13,63,53,10,57
Stenhousem'r,4491,4,15,8,13,57,49,8,53
Clyde,4491,5,14,9,13,51,49,2,51
Elgin,4491,6,14,6,16,54,63,-9,48
Annan Athlet,4491,7,11,11,14,47,43,4,44
Berwick,4491,8,9,10,17,30,58,-28,37
Edinburgh Ci,4491,9,7,9,20,36,63,-27,30
Cowdenbeath,4491,10,5,10,21,25,54,-29,25
Montrose,4492,1,24,7,5,61,35,26,79
Peterhead,4492,2,23,5,8,80,41,39,74
Stirling,4492,3,17,6,13,62,51,11,57
Stenhousem'r,4492,4,15,8,13,55,48,7,53
Clyde,4492,5,14,9,13,51,49,2,51
Elgin,4492,6,14,6,16,54,62,-8,48
Annan Athlet,4492,7,12,11,13,50,43,7,47
Berwick,4492,8,9,10,17,30,58,-28,37
Edinburgh Ci,4492,9,7,10,19,39,63,-24,31
Cowdenbeath,4492,10,4,10,22,25,57,-32,22
Montrose,4493,1,24,7,5,61,35,26,79
Peterhead,4493,2,24,4,8,80,39,41,76
Stirling,4493,3,17,6,13,65,51,14,57
Stenhousem'r,4493,4,15,8,13,55,51,4,53
Clyde,4493,5,14,10,12,52,49,3,52
Elgin,4493,6,14,6,16,54,62,-8,48
Annan Athlet,4493,7,11,12,13,47,41,6,45
Berwick,4493,8,8,11,17,30,59,-29,35
Edinburgh Ci,4493,9,7,9,20,37,63,-26,30
Cowdenbeath,4493,10,4,11,21,23,54,-31,23
Montrose,4494,1,24,7,5,63,36,27,79
Peterhead,4494,2,24,4,8,82,38,44,76
Stenhousem'r,4494,3,16,8,12,57,47,10,56
Stirling,4494,4,16,6,14,61,53,8,54
Clyde,4494,5,15,9,12,55,49,6,54
Elgin,4494,6,14,6,16,55,64,-9,48
Annan Athlet,4494,7,12,11,13,49,42,7,47
Berwick,4494,8,8,10,18,30,62,-32,34
Edinburgh Ci,4494,9,7,9,20,36,65,-29,30
Cowdenbeath,4494,10,4,10,22,24,56,-32,22
Montrose,4495,1,24,7,5,64,36,28,79
Peterhead,4495,2,24,4,8,81,38,43,76
Stenhousem'r,4495,3,16,8,12,56,46,10,56
Stirling,4495,4,16,6,14,60,52,8,54
Clyde,4495,5,14,10,12,52,49,3,52
Elgin,4495,6,14,6,16,55,65,-10,48
Annan Athlet,4495,7,12,11,13,50,41,9,47
Berwick,4495,8,8,11,17,30,59,-29,35
Edinburgh Ci,4495,9,7,9,20,36,64,-28,30
Cowdenbeath,4495,10,4,10,22,23,57,-34,22
Montrose,4496,1,23,8,5,60,35,25,77
Peterhead,4496,2,23,5,8,78,39,39,74
Stirling,4496,3,16,7,13,62,53,9,55
Stenhousem'r,4496,4,15,9,12,57,48,9,54
Clyde,4496,5,15,9,12,53,48,5,54
Elgin,4496,6,14,7,15,54,61,-7,49
Annan Athlet,4496,7,12,11,13,49,41,8,47
Berwick,4496,8,8,10,18,29,60,-31,34
Edinburgh Ci,4496,9,7,10,19,37,61,-24,31
Cowdenbeath,4496,10,4,10,22,23,56,-33,22
Montrose,4497,1,23,8,5,59,34,25,77
Peterhead,4497,2,24,4,8,78,38,40,76
Stirling,4497,3,16,7,13,63,54,9,55
Stenhousem'r,4497,4,15,9,12,58,49,9,54
Clyde,4497,5,14,10,12,52,49,3,52
Elgin,4497,6,14,7,15,53,60,-7,49
Annan Athlet,4497,7,11,11,14,48,43,5,44
Berwick,4497,8,8,11,17,30,59,-29,35
Edinburgh Ci,4497,9,7,9,20,36,61,-25,30
Cowdenbeath,4497,10,5,10,21,25,55,-30,25
Montrose,4498,1,24,7,5,61,35,26,79
Peterhead,4498,2,23,4,9,77,39,38,73
Stirling,4498,3,17,6,13,66,51,15,57
Stenhousem'r,4498,4,15,8,13,55,52,3,53
Clyde,4498,5,14,9,13,51,50,1,51
Elgin,4498,6,14,6,16,54,62,-8,48
Annan Athlet,4498,7,11,11,14,48,43,5,44
Berwick,4498,8,9,10,17,31,58,-27,37
Edinburgh Ci,4498,9,8,9,19,37,60,-23,33
Cowdenbeath,4498,10,5,10,21,25,55,-30,25
Montrose,4499,1,24,7,5,62,36,26,79
Peterhead,4499,2,24,4,8,79,38,41,76
Stirling,4499,3,17,6,13,61,51,10,57
Clyde,4499,4,15,9,12,54,49,5,54
Stenhousem'r,4499,5,15,8,13,55,47,8,53
Elgin,4499,6,14,6,16,55,63,-8,48
Annan Athlet,4499,7,12,11,13,49,42,7,47
Berwick,4499,8,8,10,18,30,61,-31,34
Edinburgh Ci,4499,9,7,9,20,36,62,-26,30
Cowdenbeath,4499,10,4,10,22,24,56,-32,22
Montrose,4500,1,24,7,5,61,34,27,79
Peterhead,4500,2,24,4,8,80,38,42,76
Stirling,4500,3,17,6,13,61,51,10,57
Stenhousem'r,4500,4,15,8,13,55,47,8,53
Clyde,4500,5,14,10,12,52,49,3,52
Elgin,4500,6,14,6,16,53,62,-9,48
Annan Athlet,4500,7,11,11,14,47,42,5,44
Berwick,4500,8,8,11,17,30,59,-29,35
Edinburgh Ci,4500,9,7,9,20,36,63,-27,30
Cowdenbeath,4500,10,5,10,21,24,54,-30,25
Montrose,4501,1,24,7,5,61,34,27,79
Peterhead,4501,2,24,4,8,80,40,40,76
Stirling,4501,3,17,6,13,63,51,12,57
Stenhousem'r,4501,4,15,8,13,55,49,6,53
Clyde,4501,5,14,10,12,51,48,3,52
Elgin,4501,6,14,6,16,53,62,-9,48
Annan Athlet,4501,7,11,11,14,47,42,5,44
Berwick,4501,8,8,11,17,29,58,-29,35
Edinburgh Ci,4501,9,7,9,20,38,63,-25,30
Cowdenbeath,4501,10,5,10,21,24,54,-30,25
Montrose,4502,1,23,8,5,61,36,25,77
Peterhead,4502,2,24,4,8,81,39,42,76
Stenhousem'r,4502,3,16,8,12,56,46,10,56
Stirling,4502,4,16,6,14,60,52,8,54
Clyde,4502,5,15,9,12,54,49,5,54
Elgin,4502,6,14,7,15,55,62,-7,49
Annan Athlet,4502,7,12,11,13,48,41,7,47
Berwick,4502,8,8,10,18,30,61,-31,34
Edinburgh Ci,4502,9,7,9,20,37,64,-27,30
Cowdenbeath,4502,10,4,10,22,23,55,-32,22
Montrose,4503,1,24,7,5,62,34,28,79
Peterhead,4503,2,23,4,9,78,43,35,73
Stirling,4503,3,17,6,13,62,51,11,57
Stenhousem'r,4503,4,15,8,13,55,48,7,53
Clyde,4503,5,14,10,12,52,49,3,52
Elgin,4503,6,14,6,16,53,63,-10,48
Annan Athlet,4503,7,11,12,13,48,42,6,45
Berwick,4503,8,8,11,17,30,59,-29,35
Edinburgh Ci,4503,9,8,9,19,41,61,-20,33
Cowdenbeath,4503,10,4,11,21,24,55,-31,23
Montrose,4504,1,24,7,5,61,35,26,79
Peterhead,4504,2,24,4,8,80,38,42,76
Stirling,4504,3,17,6,13,65,51,14,57
Stenhousem'r,4504,4,15,8,13,55,51,4,53
Clyde,4504,5,14,10,12,52,49,3,52
Elgin,4504,6,14,6,16,54,62,-8,48
Annan Athlet,4504,7,11,12,13,47,41,6,45
Berwick,4504,8,8,11,17,30,59,-29,35
Edinburgh Ci,4504,9,7,9,20,36,63,-27,30
Cowdenbeath,4504,10,4,11,21,23,54,-31,23
Montrose,4505,1,24,7,5,61,34,27,79
Peterhead,4505,2,24,4,8,80,38,42,76
Stirling,4505,3,17,6,13,64,54,10,57
Stenhousem'r,4505,4,15,8,13,58,50,8,53
Clyde,4505,5,14,9,13,52,50,2,51
Elgin,4505,6,14,6,16,53,62,-9,48
Annan Athlet,4505,7,12,11,13,49,41,8,47
Berwick,4505,8,9,10,17,31,59,-28,37
Edinburgh Ci,4505,9,7,9,20,36,63,-27,30
Cowdenbeath,4505,10,4,10,22,23,56,-33,22
Montrose,4506,1,23,7,6,59,36,23,76
Peterhead,4506,2,23,4,9,77,39,38,73
Stenhousem'r,4506,3,16,8,12,59,47,12,56
Stirling,4506,4,16,6,14,61,55,6,54
Clyde,4506,5,15,9,12,53,48,5,54
Elgin,4506,6,15,6,15,55,60,-5,51
Annan Athlet,4506,7,11,12,13,47,41,6,45
Berwick,4506,8,8,10,18,29,60,-31,34
Edinburgh Ci,4506,9,8,9,19,37,60,-23,33
Cowdenbeath,4506,10,4,11,21,23,54,-31,23
Montrose,4507,1,23,8,5,60,35,25,77
Peterhead,4507,2,24,4,8,81,38,43,76
Stenhousem'r,4507,3,16,8,12,57,47,10,56
Stirling,4507,4,16,6,14,61,53,8,54
Clyde,4507,5,14,10,12,53,50,3,52
Elgin,4507,6,14,7,15,54,61,-7,49
Annan Athlet,4507,7,11,12,13,47,41,6,45
Berwick,4507,8,8,11,17,31,60,-29,35
Edinburgh Ci,4507,9,7,9,20,36,64,-28,30
Cowdenbeath,4507,10,4,11,21,23,54,-31,23
Peterhead,4508,1,24,4,8,83,39,44,76
Montrose,4508,2,23,7,6,60,36,24,76
Stirling,4508,3,17,6,13,64,51,13,57
Stenhousem'r,4508,4,15,8,13,55,50,5,53
Clyde,4508,5,14,9,13,51,49,2,51
Elgin,4508,6,15,6,15,55,61,-6,51
Annan Athlet,4508,7,11,11,14,48,43,5,44
Berwick,4508,8,9,10,17,30,58,-28,37
Edinburgh Ci,4508,9,7,9,20,37,66,-29,30
Cowdenbeath,4508,10,5,10,21,25,55,-30,25
Montrose,4509,1,24,7,5,60,34,26,79
Peterhead,4509,2,24,4,8,80,38,42,76
Stirling,4509,3,17,6,13,63,52,11,57
Clyde,4509,4,15,9,12,53,48,5,54
Stenhousem'r,4509,5,15,8,13,56,49,7,53
Elgin,4509,6,14,6,16,53,61,-8,48
Annan Athlet,4509,7,12,11,13,49,41,8,47
Berwick,4509,8,8,10,18,29,60,-31,34
Edinburgh Ci,4509,9,7,9,20,36,63,-27,30
Cowdenbeath,4509,10,4,10,22,23,56,-33,22
Montrose,4510,1,23,7,6,60,36,24,76
Peterhead,4510,2,23,5,8,79,40,39,74
Stirling,4510,3,17,6,13,63,51,12,57
Clyde,4510,4,15,9,12,52,48,4,54
Stenhousem'r,4510,5,15,8,13,55,49,6,53
Elgin,4510,6,15,6,15,55,61,-6,51
Annan Athlet,4510,7,11,11,14,49,45,4,44
Berwick,4510,8,8,10,18,29,59,-30,34
Edinburgh Ci,4510,9,7,10,19,38,62,-24,31
Cowdenbeath,4510,10,5,10,21,27,56,-29,25
Montrose,4511,1,24,7,5,62,34,28,79
Peterhead,4511,2,24,4,8,79,39,40,76
Stirling,4511,3,17,6,13,63,51,12,57
Clyde,4511,4,15,9,12,52,48,4,54
Stenhousem'r,4511,5,15,8,13,55,49,6,53
Elgin,4511,6,14,6,16,53,63,-10,48
Annan Athlet,4511,7,12,11,13,49,41,8,47
Berwick,4511,8,8,10,18,29,59,-30,34
Edinburgh Ci,4511,9,7,9,20,37,62,-25,30
Cowdenbeath,4511,10,4,10,22,23,56,-33,22
Montrose,4512,1,24,7,5,62,35,27,79
Peterhead,4512,2,23,5,8,77,38,39,74
Stenhousem'r,4512,3,16,8,12,57,47,10,56
Stirling,4512,4,16,6,14,61,53,8,54
Clyde,4512,5,14,10,12,52,49,3,52
Elgin,4512,6,14,6,16,54,63,-9,48
Annan Athlet,4512,7,11,11,14,48,44,4,44
Berwick,4512,8,8,11,17,30,59,-29,35
Edinburgh Ci,4512,9,7,10,19,36,60,-24,31
Cowdenbeath,4512,10,5,10,21,26,55,-29,25
Montrose,4513,1,23,8,5,59,34,25,77
Peterhead,4513,2,24,4,8,81,40,41,76
Stenhousem'r,4513,3,16,8,12,58,47,11,56
Clyde,4513,4,15,9,12,57,49,8,54
Stirling,4513,5,16,6,14,61,54,7,54
Elgin,4513,6,14,7,15,53,60,-7,49
Annan Athlet,4513,7,12,11,13,49,41,8,47
Berwick,4513,8,8,10,18,30,64,-34,34
Edinburgh Ci,4513,9,7,9,20,38,64,-26,30
Cowdenbeath,4513,10,4,10,22,23,56,-33,22
Montrose,4514,1,24,7,5,61,35,26,79
Peterhead,4514,2,24,4,8,81,39,42,76
Stenhousem'r,4514,3,16,8,12,56,46,10,56
Stirling,4514,4,16,6,14,60,52,8,54
Clyde,4514,5,14,10,12,51,48,3,52
Elgin,4514,6,14,6,16,54,62,-8,48
Annan Athlet,4514,7,11,11,14,47,42,5,44
Berwick,4514,8,8,11,17,29,58,-29,35
Edinburgh Ci,4514,9,7,9,20,37,64,-27,30
Cowdenbeath,4514,10,5,10,21,24,54,-30,25
Montrose,4515,1,23,8,5,61,36,25,77
Peterhead,4515,2,23,4,9,77,39,38,73
Stirling,4515,3,16,7,13,63,54,9,55
Stenhousem'r,4515,4,15,9,12,58,49,9,54
Clyde,4515,5,15,9,12,52,48,4,54
Elgin,4515,6,14,7,15,55,62,-7,49
Annan Athlet,4515,7,11,11,14,48,44,4,44
Berwick,4515,8,8,10,18,29,59,-30,34
Edinburgh Ci,4515,9,8,9,19,37,60,-23,33
Cowdenbeath,4515,10,5,10,21,26,55,-29,25
Montrose,4516,1,24,7,5,60,34,26,79
Peterhead,4516,2,24,4,8,78,38,40,76
Stirling,4516,3,16,7,13,60,51,9,55
Stenhousem'r,4516,4,15,9,12,55,46,9,54
Clyde,4516,5,15,9,12,54,50,4,54
Elgin,4516,6,14,6,16,53,61,-8,48
Annan Athlet,4516,7,12,11,13,48,41,7,47
Berwick,4516,8,8,10,18,31,61,-30,34
Edinburgh Ci,4516,9,7,9,20,36,61,-25,30
Cowdenbeath,4516,10,4,10,22,23,55,-32,22
Peterhead,4517,1,24,4,8,83,38,45,76
Montrose,4517,2,23,7,6,60,36,24,76
Stirling,4517,3,16,7,13,61,52,9,55
Stenhousem'r,4517,4,15,9,12,56,47,9,54
Clyde,4517,5,14,9,13,52,50,2,51
Elgin,4517,6,15,6,15,55,61,-6,51
Annan Athlet,4517,7,11,12,13,50,44,6,45
Berwick,4517,8,9,10,17,31,59,-28,37
Edinburgh Ci,4517,9,7,9,20,36,66,-30,30
Cowdenbeath,4517,10,4,11,21,26,57,-31,23
Montrose,4518,1,23,7,6,59,35,24,76
Peterhead,4518,2,23,4,9,77,41,36,73
Stenhousem'r,4518,3,16,8,12,57,46,11,56
Stirling,4518,4,16,6,14,60,53,7,54
Clyde,4518,5,15,9,12,55,48,7,54
Elgin,4518,6,15,6,15,54,60,-6,51
Annan Athlet,4518,7,11,12,13,48,42,6,45
Berwick,4518,8,8,10,18,29,62,-33,34
Edinburgh Ci,4518,9,8,9,19,39,60,-21,33
Cowdenbeath,4518,10,4,11,21,24,55,-31,23
Montrose,4519,1,24,7,5,62,35,27,79
Peterhead,4519,2,23,5,8,78,39,39,74
Stirling,4519,3,17,6,13,62,52,10,57
Stenhousem'r,4519,4,15,8,13,56,48,8,53
Clyde,4519,5,14,10,12,52,49,3,52
Elgin,4519,6,14,6,16,54,63,-9,48
Annan Athlet,4519,7,11,11,14,49,44,5,44
Berwick,4519,8,8,11,17,30,59,-29,35
Edinburgh Ci,4519,9,7,10,19,37,61,-24,31
Cowdenbeath,4519,10,5,10,21,26,56,-30,25
Montrose,4520,1,24,7,5,63,35,28,79
Peterhead,4520,2,24,4,8,80,39,41,76
Stirling,4520,3,17,6,13,62,52,10,57
Clyde,4520,4,15,9,12,54,49,5,54
Stenhousem'r,4520,5,15,8,13,56,48,8,53
Elgin,4520,6,14,6,16,54,64,-10,48
Annan Athlet,4520,7,11,12,13,48,42,6,45
Berwick,4520,8,8,10,18,30,61,-31,34
Edinburgh Ci,4520,9,7,9,20,37,63,-26,30
Cowdenbeath,4520,10,4,11,21,24,55,-31,23
Montrose,4521,1,23,8,5,60,35,25,77
Peterhead,4521,2,24,4,8,79,39,40,76
Stirling,4521,3,17,6,13,62,51,11,57
Stenhousem'r,4521,4,15,8,13,55,48,7,53
Clyde,4521,5,14,9,13,51,52,-1,51
Elgin,4521,6,14,7,15,54,61,-7,49
Annan Athlet,4521,7,11,12,13,47,41,6,45
Berwick,4521,8,9,10,17,33,58,-25,37
Edinburgh Ci,4521,9,7,9,20,37,62,-25,30
Cowdenbeath,4521,10,4,11,21,23,54,-31,23
Peterhead,4522,1,24,4,8,80,38,42,76
Montrose,4522,2,23,7,6,59,36,23,76
Stenhousem'r,4522,3,16,8,12,57,47,10,56
Stirling,4522,4,16,6,14,61,53,8,54
Clyde,4522,5,14,9,13,52,50,2,51
Elgin,4522,6,15,6,15,55,60,-5,51
Annan Athlet,4522,7,11,12,13,49,43,6,45
Berwick,4522,8,9,10,17,31,59,-28,37
Edinburgh Ci,4522,9,7,9,20,36,63,-27,30
Cowdenbeath,4522,10,4,11,21,25,56,-31,23
Montrose,4523,1,24,7,5,67,35,32,79
Peterhead,4523,2,24,4,8,79,38,41,76
Stirling,4523,3,16,7,13,63,54,9,55
Stenhousem'r,4523,4,15,9,12,58,49,9,54
Clyde,4523,5,15,9,12,53,48,5,54
Elgin,4523,6,14,6,16,54,68,-14,48
Annan Athlet,4523,7,12,11,13,49,41,8,47
Berwick,4523,8,8,10,18,29,60,-31,34
Edinburgh Ci,4523,9,7,9,20,36,62,-26,30
Cowdenbeath,4523,10,4,10,22,23,56,-33,22
Peterhead,4524,1,24,4,8,84,38,46,76
Montrose,4524,2,23,7,6,60,36,24,76
Stirling,4524,3,17,6,13,61,51,10,57
Clyde,4524,4,15,9,12,53,48,5,54
Stenhousem'r,4524,5,15,8,13,55,47,8,53
Elgin,4524,6,15,6,15,55,61,-6,51
Annan Athlet,4524,7,11,12,13,47,41,6,45
Berwick,4524,8,8,10,18,29,60,-31,34
Edinburgh Ci,4524,9,7,9,20,36,67,-31,30
Cowdenbeath,4524,10,4,11,21,23,54,-31,23
Peterhead,4525,1,24,4,8,81,38,43,76
Montrose,4525,2,23,7,6,60,36,24,76
Stirling,4525,3,17,6,13,62,51,11,57
Clyde,4525,4,15,9,12,54,49,5,54
Stenhousem'r,4525,5,15,8,13,55,48,7,53
Elgin,4525,6,15,6,15,55,61,-6,51
Annan Athlet,4525,7,12,11,13,50,41,9,47
Berwick,4525,8,8,10,18,30,61,-31,34
Edinburgh Ci,4525,9,7,9,20,36,64,-28,30
Cowdenbeath,4525,10,4,10,22,23,57,-34,22
Montrose,4526,1,24,7,5,61,35,26,79
Peterhead,4526,2,24,4,8,79,39,40,76
Stirling,4526,3,16,7,13,62,53,9,55
Stenhousem'r,4526,4,15,9,12,57,48,9,54
Clyde,4526,5,14,9,13,51,49,2,51
Elgin,4526,6,14,6,16,54,62,-8,48
Annan Athlet,4526,7,11,12,13,47,41,6,45
Berwick,4526,8,9,10,17,30,58,-28,37
Edinburgh Ci,4526,9,7,9,20,37,62,-25,30
Cowdenbeath,4526,10,4,11,21,23,54,-31,23
Montrose,4527,1,23,8,5,60,35,25,77
Peterhead,4527,2,24,4,8,80,40,40,76
Stenhousem'r,4527,3,16,8,12,57,47,10,56
Stirling,4527,4,16,6,14,61,53,8,54
Clyde,4527,5,14,9,13,52,50,2,51
Elgin,4527,6,14,7,15,54,61,-7,49
Annan Athlet,4527,7,11,11,14,47,43,4,44
Berwick,4527,8,9,10,17,31,59,-28,37
Edinburgh Ci,4527,9,7,9,20,38,63,-25,30
Cowdenbeath,4527,10,5,10,21,25,54,-29,25
Montrose,4528,1,24,7,5,63,36,27,79
Peterhead,4528,2,23,4,9,78,40,38,73
Stenhousem'r,4528,3,16,8,12,58,48,10,56
Stirling,4528,4,16,6,14,62,54,8,54
Clyde,4528,5,15,9,12,53,48,5,54
Elgin,4528,6,14,6,16,55,64,-9,48
Annan Athlet,4528,7,12,11,13,49,42,7,47
Berwick,4528,8,8,10,18,29,60,-31,34
Edinburgh Ci,4528,9,8,9,19,38,61,-23,33
Cowdenbeath,4528,10,4,10,22,24,56,-32,22
Montrose,4529,1,24,7,5,62,34,28,79
Peterhead,4529,2,24,4,8,80,40,40,76
Stirling,4529,3,17,6,13,63,51,12,57
Stenhousem'r,4529,4,15,8,13,55,49,6,53
Clyde,4529,5,14,10,12,52,49,3,52
Elgin,4529,6,14,6,16,53,63,-10,48
Annan Athlet,4529,7,11,12,13,47,41,6,45
Berwick,4529,8,8,11,17,30,59,-29,35
Edinburgh Ci,4529,9,7,9,20,38,63,-25,30
Cowdenbeath,4529,10,4,11,21,23,54,-31,23
Montrose,4530,1,24,7,5,63,35,28,79
Peterhead,4530,2,24,4,8,80,40,40,76
Stirling,4530,3,16,7,13,60,51,9,55
Stenhousem'r,4530,4,15,9,12,55,46,9,54
Clyde,4530,5,15,9,12,54,49,5,54
Elgin,4530,6,14,6,16,54,64,-10,48
Annan Athlet,4530,7,11,11,14,47,42,5,44
Berwick,4530,8,8,10,18,30,61,-31,34
Edinburgh Ci,4530,9,7,9,20,38,63,-25,30
Cowdenbeath,4530,10,5,10,21,24,54,-30,25
Montrose,4531,1,23,8,5,60,35,25,77
Peterhead,4531,2,24,4,8,81,38,43,76
Stirling,4531,3,17,6,13,62,52,10,57
Clyde,4531,4,15,9,12,55,49,6,54
Stenhousem'r,4531,5,15,8,13,56,48,8,53
Elgin,4531,6,14,7,15,54,61,-7,49
Annan Athlet,4531,7,12,11,13,48,41,7,47
Berwick,4531,8,8,10,18,30,62,-32,34
Edinburgh Ci,4531,9,7,9,20,36,64,-28,30
Cowdenbeath,4531,10,4,10,22,23,55,-32,22
Montrose,4532,1,24,7,5,61,34,27,79
Peterhead,4532,2,23,5,8,78,39,39,74
Stirling,4532,3,16,7,13,62,53,9,55
Stenhousem'r,4532,4,15,9,12,57,48,9,54
Clyde,4532,5,15,9,12,53,49,4,54
Elgin,4532,6,14,6,16,53,62,-9,48
Annan Athlet,4532,7,12,11,13,48,41,7,47
Berwick,4532,8,8,10,18,30,60,-30,34
Edinburgh Ci,4532,9,7,10,19,37,61,-24,31
Cowdenbeath,4532,10,4,10,22,23,55,-32,22
Montrose,4533,1,24,7,5,61,35,26,79
Peterhead,4533,2,24,4,8,81,38,43,76
Stenhousem'r,4533,3,16,8,12,57,47,10,56
Stirling,4533,4,16,6,14,61,53,8,54
Clyde,4533,5,15,9,12,54,49,5,54
Elgin,4533,6,14,6,16,54,62,-8,48
Annan Athlet,4533,7,12,11,13,48,41,7,47
Berwick,4533,8,8,10,18,30,61,-31,34
Edinburgh Ci,4533,9,7,9,20,36,64,-28,30
Cowdenbeath,4533,10,4,10,22,23,55,-32,22
Montrose,4534,1,24,7,5,62,35,27,79
Peterhead,4534,2,23,5,8,78,39,39,74
Stirling,4534,3,17,6,13,61,51,10,57
Stenhousem'r,4534,4,15,8,13,55,47,8,53
Clyde,4534,5,14,9,13,52,52,0,51
Elgin,4534,6,14,6,16,54,63,-9,48
Annan Athlet,4534,7,12,11,13,48,41,7,47
Berwick,4534,8,9,10,17,33,59,-26,37
Edinburgh Ci,4534,9,7,10,19,37,61,-24,31
Cowdenbeath,4534,10,4,10,22,23,55,-32,22
Montrose,4535,1,24,7,5,63,35,28,79
Peterhead,4535,2,23,5,8,79,40,39,74
Stirling,4535,3,16,7,13,61,52,9,55
Stenhousem'r,4535,4,15,9,12,56,47,9,54
Clyde,4535,5,14,10,12,52,49,3,52
Elgin,4535,6,14,6,16,54,64,-10,48
Annan Athlet,4535,7,12,11,13,49,41,8,47
Berwick,4535,8,8,11,17,30,59,-29,35
Edinburgh Ci,4535,9,7,10,19,38,62,-24,31
Cowdenbeath,4535,10,4,10,22,23,56,-33,22
Montrose,4536,1,24,7,5,61,34,27,79
Peterhead,4536,2,24,4,8,78,38,40,76
Stirling,4536,3,17,6,13,63,52,11,57
Clyde,4536,4,15,9,12,52,48,4,54
Stenhousem'r,4536,5,15,8,13,56,49,7,53
Elgin,4536,6,14,6,16,53,62,-9,48
Annan Athlet,4536,7,12,11,13,48,41,7,47
Berwick,4536,8,8,10,18,29,59,-30,34
Edinburgh Ci,4536,9,7,9,20,36,61,-25,30
Cowdenbeath,4536,10,4,10,22,23,55,-32,22
Peterhead,4537,1,24,4,8,79,38,41,76
Montrose,4537,2,23,7,6,60,37,23,76
Stirling,4537,3,16,7,13,60,51,9,55
Stenhousem'r,4537,4,15,9,12,55,46,9,54
Clyde,4537,5,15,9,12,53,48,5,54
Elgin,4537,6,15,6,15,56,61,-5,51
Annan Athlet,4537,7,11,12,13,47,41,6,45
Berwick,4537,8,8,10,18,29,60,-31,34
Edinburgh Ci,4537,9,7,9,20,36,62,-26,30
Cowdenbeath,4537,10,4,11,21,23,54,-31,23
Montrose,4538,1,24,7,5,63,37,26,79
Peterhead,4538,2,24,4,8,81,41,40,76
Stirling,4538,3,17,6,13,63,53,10,57
Clyde,4538,4,15,9,12,52,48,4,54
Stenhousem'r,4538,5,15,8,13,57,49,8,53
Elgin,4538,6,14,6,16,56,64,-8,48
Annan Athlet,4538,7,12,11,13,50,42,8,47
Berwick,4538,8,8,10,18,29,59,-30,34
Edinburgh Ci,4538,9,7,9,20,39,64,-25,30
Cowdenbeath,4538,10,4,10,22,24,57,-33,22
Peterhead,4539,1,24,4,8,80,39,41,76
Montrose,4539,2,23,7,6,60,36,24,76
Stenhousem'r,4539,3,16,8,12,57,46,11,56
Stirling,4539,4,16,6,14,60,53,7,54
Clyde,4539,5,15,9,12,54,49,5,54
Elgin,4539,6,15,6,15,55,61,-6,51
Annan Athlet,4539,7,12,11,13,51,43,8,47
Berwick,4539,8,8,10,18,30,61,-31,34
Edinburgh Ci,4539,9,7,9,20,37,63,-26,30
Cowdenbeath,4539,10,4,10,22,25,58,-33,22
Montrose,4540,1,23,8,5,62,37,25,77
Peterhead,4540,2,24,4,8,80,38,42,76
Stirling,4540,3,16,7,13,60,51,9,55
Stenhousem'r,4540,4,15,9,12,55,46,9,54
Clyde,4540,5,14,10,12,52,49,3,52
Elgin,4540,6,14,7,15,56,63,-7,49
Annan Athlet,4540,7,11,11,14,47,42,5,44
Berwick,4540,8,8,11,17,30,59,-29,35
Edinburgh Ci,4540,9,7,9,20,36,63,-27,30
Cowdenbeath,4540,10,5,10,21,24,54,-30,25
Montrose,4541,1,24,7,5,61,34,27,79
Peterhead,4541,2,24,4,8,82,39,43,76
Stirling,4541,3,17,6,13,63,52,11,57
Stenhousem'r,4541,4,15,8,13,56,49,7,53
Clyde,4541,5,14,10,12,53,50,3,52
Elgin,4541,6,14,6,16,53,62,-9,48
Annan Athlet,4541,7,12,11,13,49,42,7,47
Berwick,4541,8,8,11,17,31,60,-29,35
Edinburgh Ci,4541,9,7,9,20,37,65,-28,30
Cowdenbeath,4541,10,4,10,22,24,56,-32,22
Peterhead,4542,1,24,4,8,80,40,40,76
Montrose,4542,2,23,7,6,59,35,24,76
Stirling,4542,3,17,6,13,62,52,10,57
Clyde,4542,4,15,9,12,53,48,5,54
Stenhousem'r,4542,5,15,8,13,56,48,8,53
Elgin,4542,6,15,6,15,54,60,-6,51
Annan Athlet,4542,7,12,11,13,48,41,7,47
Berwick,4542,8,8,10,18,29,60,-31,34
Edinburgh Ci,4542,9,7,9,20,38,63,-25,30
Cowdenbeath,4542,10,4,10,22,23,55,-32,22
Montrose,4543,1,23,8,5,60,35,25,77
Peterhead,4543,2,24,4,8,80,38,42,76
Stenhousem'r,4543,3,16,8,12,57,47,10,56
Stirling,4543,4,16,6,14,61,53,8,54
Clyde,4543,5,14,10,12,53,50,3,52
Elgin,4543,6,14,7,15,54,61,-7,49
Annan Athlet,4543,7,11,12,13,48,42,6,45
Berwick,4543,8,8,11,17,31,60,-29,35
Edinburgh Ci,4543,9,7,9,20,36,63,-27,30
Cowdenbeath,4543,10,4,11,21,24,55,-31,23
Montrose,4544,1,23,8,5,61,36,25,77
Peterhead,4544,2,23,5,8,77,38,39,74
Stenhousem'r,4544,3,16,8,12,56,46,10,56
Stirling,4544,4,16,6,14,60,52,8,54
Clyde,4544,5,15,9,12,53,49,4,54
Elgin,4544,6,14,7,15,55,62,-7,49
Annan Athlet,4544,7,11,11,14,47,44,3,44
Berwick,4544,8,8,10,18,30,60,-30,34
Edinburgh Ci,4544,9,7,10,19,36,60,-24,31
Cowdenbeath,4544,10,5,10,21,26,54,-28,25
Montrose,4545,1,24,7,5,64,35,29,79
Peterhead,4545,2,24,4,8,80,39,41,76
Stirling,4545,3,16,7,13,60,51,9,55
Stenhousem'r,4545,4,15,9,12,55,46,9,54
Clyde,4545,5,14,9,13,51,49,2,51
Elgin,4545,6,14,6,16,54,65,-11,48
Annan Athlet,4545,7,11,12,13,48,42,6,45
Berwick,4545,8,9,10,17,30,58,-28,37
Edinburgh Ci,4545,9,7,9,20,37,63,-26,30
Cowdenbeath,4545,10,4,11,21,24,55,-31,23
Montrose,4546,1,24,7,5,60,34,26,79
Peterhead,4546,2,24,4,8,82,39,43,76
Stirling,4546,3,17,6,13,63,51,12,57
Stenhousem'r,4546,4,15,8,13,55,49,6,53
Clyde,4546,5,14,10,12,51,48,3,52
Elgin,4546,6,14,6,16,53,61,-8,48
Annan Athlet,4546,7,11,11,14,47,43,4,44
Berwick,4546,8,8,11,17,29,58,-29,35
Edinburgh Ci,4546,9,7,9,20,37,65,-28,30
Cowdenbeath,4546,10,5,10,21,25,54,-29,25
Montrose,4547,1,23,8,5,60,35,25,77
Peterhead,4547,2,24,4,8,81,38,43,76
Stenhousem'r,4547,3,16,8,12,57,47,10,56
Stirling,4547,4,16,6,14,61,53,8,54
Clyde,4547,5,15,9,12,56,48,8,54
Elgin,4547,6,14,7,15,54,61,-7,49
Annan Athlet,4547,7,11,12,13,47,41,6,45
Berwick,4547,8,8,10,18,29,63,-34,34
Edinburgh Ci,4547,9,7,9,20,36,64,-28,30
Cowdenbeath,4547,10,4,11,21,23,54,-31,23
Montrose,4548,1,24,7,5,61,35,26,79
Peterhead,4548,2,24,4,8,80,39,41,76
Stirling,4548,3,17,6,13,64,53,11,57
Clyde,4548,4,15,9,12,52,48,4,54
Stenhousem'r,4548,5,15,8,13,57,50,7,53
Elgin,4548,6,14,6,16,54,62,-8,48
Annan Athlet,4548,7,12,11,13,48,41,7,47
Berwick,4548,8,8,10,18,29,59,-30,34
Edinburgh Ci,4548,9,7,9,20,37,63,-26,30
Cowdenbeath,4548,10,4,10,22,23,55,-32,22
Montrose,4549,1,24,7,5,61,35,26,79
Peterhead,4549,2,24,4,8,83,38,45,76
Stirling,4549,3,16,7,13,61,52,9,55
Stenhousem'r,4549,4,15,9,12,56,47,9,54
Clyde,4549,5,15,9,12,53,48,5,54
Elgin,4549,6,14,6,16,54,62,-8,48
Annan Athlet,4549,7,12,11,13,51,41,10,47
Berwick,4549,8,8,10,18,29,60,-31,34
Edinburgh Ci,4549,9,7,9,20,36,66,-30,30
Cowdenbeath,4549,10,4,10,22,23,58,-35,22
Montrose,4550,1,23,8,5,62,37,25,77
Peterhead,4550,2,24,4,8,78,38,40,76
Stenhousem'r,4550,3,16,8,12,59,48,11,56
Stirling,4550,4,16,6,14,62,55,7,54
Clyde,4550,5,15,9,12,53,48,5,54
Elgin,4550,6,14,7,15,56,63,-7,49
Annan Athlet,4550,7,11,11,14,47,42,5,44
Berwick,4550,8,8,10,18,29,60,-31,34
Edinburgh Ci,4550,9,7,9,20,36,61,-25,30
Cowdenbeath,4550,10,5,10,21,24,54,-30,25
Peterhead,4551,1,24,4,8,80,39,41,76
Montrose,4551,2,23,7,6,59,37,22,76
Stenhousem'r,4551,3,16,8,12,58,48,10,56
Stirling,4551,4,16,6,14,62,54,8,54
Clyde,4551,5,14,9,13,51,49,2,51
Elgin,4551,6,15,6,15,56,60,-4,51
Annan Athlet,4551,7,12,11,13,49,42,7,47
Berwick,4551,8,9,10,17,30,58,-28,37
Edinburgh Ci,4551,9,7,9,20,37,63,-26,30
Cowdenbeath,4551,10,4,10,22,24,56,-32,22
Montrose,4552,1,23,8,5,60,35,25,77
Peterhead,4552,2,23,5,8,78,39,39,74
Stirling,4552,3,17,6,13,61,51,10,57
Clyde,4552,4,15,9,12,56,48,8,54
Stenhousem'r,4552,5,15,8,13,55,47,8,53
Elgin,4552,6,14,7,15,54,61,-7,49
Annan Athlet,4552,7,11,11,14,47,43,4,44
Berwick,4552,8,8,10,18,29,63,-34,34
Edinburgh Ci,4552,9,7,10,19,37,61,-24,31
Cowdenbeath,4552,10,5,10,21,25,54,-29,25
Peterhead,4553,1,24,4,8,79,39,40,76
Montrose,4553,2,23,7,6,60,37,23,76
Stirling,4553,3,17,6,13,61,51,10,57
Clyde,4553,4,15,9,12,53,48,5,54
Stenhousem'r,4553,5,15,8,13,55,47,8,53
Elgin,4553,6,15,6,15,56,61,-5,51
Annan Athlet,4553,7,11,12,13,47,41,6,45
Berwick,4553,8,8,10,18,29,60,-31,34
Edinburgh Ci,4553,9,7,9,20,37,62,-25,30
Cowdenbeath,4553,10,4,11,21,23,54,-31,23
Montrose,4554,1,23,7,6,60,36,24,76
Peterhead,4554,2,23,4,9,77,39,38,73
Stirling,4554,3,16,7,13,61,52,9,55
Stenhousem'r,4554,4,15,9,12,56,47,9,54
Clyde,4554,5,14,10,12,51,48,3,52
Elgin,4554,6,15,6,15,55,61,-6,51
Annan Athlet,4554,7,12,11,13,49,42,7,47
Berwick,4554,8,8,11,17,29,58,-29,35
Edinburgh Ci,4554,9,8,9,19,37,60,-23,33
Cowdenbeath,4554,10,4,10,22,24,56,-32,22
Montrose,4555,1,23,8,5,60,35,25,77
Peterhead,4555,2,24,4,8,79,39,40,76
Stirling,4555,3,17,6,13,62,51,11,57
Stenhousem'r,4555,4,15,8,13,55,48,7,53
Clyde,4555,5,14,10,12,52,49,3,52
Elgin,4555,6,14,7,15,54,61,-7,49
Annan Athlet,4555,7,11,12,13,48,42,6,45
Berwick,4555,8,8,11,17,30,59,-29,35
Edinburgh Ci,4555,9,7,9,20,37,62,-25,30
Cowdenbeath,4555,10,4,11,21,24,55,-31,23
Montrose,4556,1,23,8,5,59,34,25,77
Peterhead,4556,2,23,4,9,78,41,37,73
Stirling,4556,3,16,7,13,60,51,9,55
Stenhousem'r,4556,4,15,9,12,55,46,9,54
Clyde,4556,5,14,10,12,52,49,3,52
Elgin,4556,6,14,7,15,53,60,-7,49
Annan Athlet,4556,7,11,11,14,47,43,4,44
Berwick,4556,8,8,11,17,30,59,-29,35
Edinburgh Ci,4556,9,8,9,19,39,61,-22,33
Cowdenbeath,4556,10,5,10,21,25,54,-29,25
Montrose,4557,1,23,8,5,61,36,25,77
Peterhead,4557,2,24,4,8,82,39,43,76
Stirling,4557,3,17,6,13,64,52,12,57
Clyde,4557,4,15,9,12,55,49,6,54
Stenhousem'r,4557,5,15,8,13,56,50,6,53
Elgin,4557,6,14,7,15,55,62,-7,49
Annan Athlet,4557,7,11,11,14,48,43,5,44
Berwick,4557,8,8,10,18,30,62,-32,34
Edinburgh Ci,4557,9,7,9,20,37,65,-28,30
Cowdenbeath,4557,10,5,10,21,25,55,-30,25
Montrose,4558,1,24,7,5,61,35,26,79
Peterhead,4558,2,24,4,8,81,38,43,76
Stirling,4558,3,17,6,13,62,52,10,57
Stenhousem'r,4558,4,15,8,13,56,48,8,53
Clyde,4558,5,14,9,13,51,49,2,51
Elgin,4558,6,14,6,16,54,62,-8,48
Annan Athlet,4558,7,12,11,13,48,41,7,47
Berwick,4558,8,9,10,17,30,58,-28,37
Edinburgh Ci,4558,9,7,9,20,36,64,-28,30
Cowdenbeath,4558,10,4,10,22,23,55,-32,22
Montrose,4559,1,24,7,5,64,37,27,79
Peterhead,4559,2,24,4,8,79,38,41,76
Stenhousem'r,4559,3,16,8,12,58,48,10,56
Stirling,4559,4,16,6,14,62,54,8,54
Clyde,4559,5,14,9,13,51,49,2,51
Elgin,4559,6,14,6,16,56,65,-9,48
Annan Athlet,4559,7,11,12,13,48,42,6,45
Berwick,4559,8,9,10,17,30,58,-28,37
Edinburgh Ci,4559,9,7,9,20,36,62,-26,30
Cowdenbeath,4559,10,4,11,21,24,55,-31,23
Montrose,4560,1,23,8,5,59,34,25,77
Peterhead,4560,2,23,4,9,77,41,36,73
Stirling,4560,3,17,6,13,61,51,10,57
Clyde,4560,4,15,9,12,53,48,5,54
Stenhousem'r,4560,5,15,8,13,55,47,8,53
Elgin,4560,6,14,7,15,53,60,-7,49
Annan Athlet,4560,7,11,11,14,47,42,5,44
Berwick,4560,8,8,10,18,29,60,-31,34
Edinburgh Ci,4560,9,8,9,19,39,60,-21,33
Cowdenbeath,4560,10,5,10,21,24,54,-30,25
Montrose,4561,1,23,7,6,60,36,24,76
Peterhead,4561,2,23,4,9,78,41,37,73
Stirling,4561,3,17,6,13,62,52,10,57
Clyde,4561,4,15,9,12,53,48,5,54
Stenhousem'r,4561,5,15,8,13,56,48,8,53
Elgin,4561,6,15,6,15,55,61,-6,51
Annan Athlet,4561,7,11,11,14,47,44,3,44
Berwick,4561,8,8,10,18,29,60,-31,34
Edinburgh Ci,4561,9,8,9,19,39,61,-22,33
Cowdenbeath,4561,10,5,10,21,26,54,-28,25
Peterhead,4562,1,24,4,8,81,41,40,76
Montrose,4562,2,23,7,6,60,36,24,76
Stirling,4562,3,17,6,13,62,51,11,57
Clyde,4562,4,15,9,12,53,49,4,54
Stenhousem'r,4562,5,15,8,13,55,48,7,53
Elgin,4562,6,15,6,15,55,61,-6,51
Annan Athlet,4562,7,11,12,13,48,42,6,45
Berwick,4562,8,8,10,18,30,60,-30,34
Edinburgh Ci,4562,9,7,9,20,39,64,-25,30
Cowdenbeath,4562,10,4,11,21,24,55,-31,23
Montrose,4563,1,23,7,6,60,38,22,76
Peterhead,4563,2,23,5,8,78,39,39,74
Stirling,4563,3,17,6,13,62,51,11,57
Stenhousem'r,4563,4,15,8,13,55,48,7,53
Clyde,4563,5,14,10,12,53,50,3,52
Elgin,4563,6,15,6,15,57,61,-4,51
Annan Athlet,4563,7,11,11,14,47,42,5,44
Berwick,4563,8,8,11,17,31,60,-29,35
Edinburgh Ci,4563,9,7,10,19,37,61,-24,31
Cowdenbeath,4563,10,5,10,21,24,54,-30,25
Montrose,4564,1,24,7,5,60,34,26,79
Peterhead,4564,2,23,5,8,79,40,39,74
Stenhousem'r,4564,3,16,8,12,56,46,10,56
Stirling,4564,4,16,6,14,60,52,8,54
Clyde,4564,5,14,10,12,51,48,3,52
Elgin,4564,6,14,6,16,53,61,-8,48
Annan Athlet,4564,7,11,11,14,48,43,5,44
Berwick,4564,8,8,11,17,29,58,-29,35
Edinburgh Ci,4564,9,7,10,19,38,62,-24,31
Cowdenbeath,4564,10,5,10,21,25,55,-30,25
Montrose,4565,1,24,7,5,61,34,27,79
Peterhead,4565,2,24,4,8,79,38,41,76
Stirling,4565,3,17,6,13,62,52,10,57
Clyde,4565,4,15,9,12,54,48,6,54
Stenhousem'r,4565,5,15,8,13,56,48,8,53
Elgin,4565,6,14,6,16,53,62,-9,48
Annan Athlet,4565,7,11,12,13,47,41,6,45
Berwick,4565,8,8,10,18,29,61,-32,34
Edinburgh Ci,4565,9,7,9,20,36,62,-26,30
Cowdenbeath,4565,10,4,11,21,23,54,-31,23
Montrose,4566,1,23,8,5,61,36,25,77
Peterhead,4566,2,24,4,8,79,39,40,76
Stenhousem'r,4566,3,16,8,12,59,49,10,56
Stirling,4566,4,16,6,14,63,55,8,54
Clyde,4566,5,14,10,12,53,50,3,52
Elgin,4566,6,14,7,15,55,62,-7,49
Annan Athlet,4566,7,11,12,13,49,43,6,45
Berwick,4566,8,8,11,17,31,60,-29,35
Edinburgh Ci,4566,9,7,9,20,37,62,-25,30
Cowdenbeath,4566,10,4,11,21,25,56,-31,23
Montrose,4567,1,24,7,5,61,34,27,79
Peterhead,4567,2,23,4,9,78,41,37,73
Stirling,4567,3,16,7,13,62,53,9,55
Stenhousem'r,4567,4,15,9,12,57,48,9,54
Clyde,4567,5,15,9,12,53,49,4,54
Elgin,4567,6,14,6,16,53,62,-9,48
Annan Athlet,4567,7,12,11,13,48,41,7,47
Berwick,4567,8,8,10,18,30,60,-30,34
Edinburgh Ci,4567,9,8,9,19,39,61,-22,33
Cowdenbeath,4567,10,4,10,22,23,55,-32,22
Montrose,4568,1,23,8,5,60,35,25,77
Peterhead,4568,2,24,4,8,81,38,43,76
Stirling,4568,3,17,6,13,62,51,11,57
Stenhousem'r,4568,4,15,8,13,55,48,7,53
Clyde,4568,5,14,9,13,54,52,2,51
Elgin,4568,6,14,7,15,54,61,-7,49
Annan Athlet,4568,7,11,11,14,47,43,4,44
Berwick,4568,8,9,10,17,33,61,-28,37
Edinburgh Ci,4568,9,7,9,20,36,64,-28,30
Cowdenbeath,4568,10,5,10,21,25,54,-29,25
Montrose,4569,1,24,7,5,63,34,29,79
Peterhead,4569,2,24,4,8,80,39,41,76
Stenhousem'r,4569,3,16,8,12,57,47,10,56
Stirling,4569,4,16,6,14,61,53,8,54
Clyde,4569,5,15,9,12,54,49,5,54
Elgin,4569,6,14,6,16,53,64,-11,48
Annan Athlet,4569,7,11,12,13,48,42,6,45
Berwick,4569,8,8,10,18,30,61,-31,34
Edinburgh Ci,4569,9,7,9,20,37,63,-26,30
Cowdenbeath,4569,10,4,11,21,24,55,-31,23
Montrose,4570,1,24,7,5,63,35,28,79
Peterhead,4570,2,24,4,8,79,39,40,76
Stirling,4570,3,16,7,13,62,53,9,55
Stenhousem'r,4570,4,15,9,12,57,48,9,54
Clyde,4570,5,14,10,12,52,49,3,52
Elgin,4570,6,14,6,16,54,64,-10,48
Annan Athlet,4570,7,11,12,13,48,42,6,45
Berwick,4570,8,8,11,17,30,59,-29,35
Edinburgh Ci,4570,9,7,9,20,37,62,-25,30
Cowdenbeath,4570,10,4,11,21,24,55,-31,23
Montrose,4571,1,24,7,5,61,34,27,79
Peterhead,4571,2,24,4,8,79,39,40,76
Stirling,4571,3,17,6,13,64,51,13,57
Clyde,4571,4,15,9,12,52,48,4,54
Stenhousem'r,4571,5,15,8,13,55,50,5,53
Elgin,4571,6,14,6,16,53,62,-9,48
Annan Athlet,4571,7,12,11,13,49,41,8,47
Berwick,4571,8,8,10,18,29,59,-30,34
Edinburgh Ci,4571,9,7,9,20,37,62,-25,30
Cowdenbeath,4571,10,4,10,22,23,56,-33,22
Montrose,4572,1,24,7,5,62,36,26,79
Peterhead,4572,2,24,4,8,79,38,41,76
Stenhousem'r,4572,3,16,8,12,56,46,10,56
Stirling,4572,4,16,6,14,60,52,8,54
Clyde,4572,5,14,10,12,52,49,3,52
Elgin,4572,6,14,6,16,55,63,-8,48
Annan Athlet,4572,7,12,11,13,49,42,7,47
Berwick,4572,8,8,11,17,30,59,-29,35
Edinburgh Ci,4572,9,7,9,20,36,62,-26,30
Cowdenbeath,4572,10,4,10,22,24,56,-32,22
Peterhead,4573,1,24,4,8,79,38,41,76
Montrose,4573,2,23,7,6,60,36,24,76
Stirling,4573,3,17,6,13,63,53,10,57
Clyde,4573,4,15,9,12,54,48,6,54
Stenhousem'r,4573,5,15,8,13,57,49,8,53
Elgin,4573,6,15,6,15,55,61,-6,51
Annan Athlet,4573,7,12,11,13,49,41,8,47
Berwick,4573,8,8,10,18,29,61,-32,34
Edinburgh Ci,4573,9,7,9,20,36,62,-26,30
Cowdenbeath,4573,10,4,10,22,23,56,-33,22
Montrose,4574,1,23,8,5,61,36,25,77
Peterhead,4574,2,24,4,8,80,38,42,76
Stirling,4574,3,17,6,13,64,51,13,57
Stenhousem'r,4574,4,15,8,13,55,50,5,53
Clyde,4574,5,14,9,13,51,49,2,51
Elgin,4574,6,14,7,15,55,62,-7,49
Annan Athlet,4574,7,11,11,14,49,46,3,44
Berwick,4574,8,9,10,17,30,58,-28,37
Edinburgh Ci,4574,9,7,9,20,36,63,-27,30
Cowdenbeath,4574,10,5,10,21,28,56,-28,25
Montrose,4575,1,24,7,5,62,35,27,79
Peterhead,4575,2,24,4,8,78,38,40,76
Stirling,4575,3,17,6,13,62,52,10,57
Stenhousem'r,4575,4,15,8,13,56,48,8,53
Clyde,4575,5,14,9,13,54,52,2,51
Elgin,4575,6,14,6,16,54,63,-9,48
Annan Athlet,4575,7,11,12,13,48,42,6,45
Berwick,4575,8,9,10,17,33,61,-28,37
Edinburgh Ci,4575,9,7,9,20,36,61,-25,30
Cowdenbeath,4575,10,4,11,21,24,55,-31,23
Montrose,4576,1,24,7,5,60,34,26,79
Peterhead,4576,2,24,4,8,80,39,41,76
Stirling,4576,3,17,6,13,62,51,11,57
Clyde,4576,4,15,9,12,53,48,5,54
Stenhousem'r,4576,5,15,8,13,55,48,7,53
Elgin,4576,6,14,6,16,53,61,-8,48
Annan Athlet,4576,7,12,11,13,49,41,8,47
Berwick,4576,8,8,10,18,29,60,-31,34
Edinburgh Ci,4576,9,7,9,20,37,63,-26,30
Cowdenbeath,4576,10,4,10,22,23,56,-33,22
Montrose,4577,1,24,7,5,61,34,27,79
Peterhead,4577,2,24,4,8,82,39,43,76
Stenhousem'r,4577,3,16,8,12,58,48,10,56
Stirling,4577,4,16,6,14,62,54,8,54
Clyde,4577,5,15,9,12,56,50,6,54
Elgin,4577,6,14,6,16,53,62,-9,48
Annan Athlet,4577,7,11,12,13,48,42,6,45
Berwick,4577,8,8,10,18,31,63,-32,34
Edinburgh Ci,4577,9,7,9,20,37,65,-28,30
Cowdenbeath,4577,10,4,11,21,24,55,-31,23
Peterhead,4578,1,24,4,8,79,38,41,76
Montrose,4578,2,23,7,6,60,37,23,76
Stirling,4578,3,17,6,13,63,52,11,57
Clyde,4578,4,15,9,12,53,49,4,54
Stenhousem'r,4578,5,15,8,13,56,49,7,53
Elgin,4578,6,15,6,15,56,61,-5,51
Annan Athlet,4578,7,12,11,13,49,41,8,47
Berwick,4578,8,8,10,18,30,60,-30,34
Edinburgh Ci,4578,9,7,9,20,36,62,-26,30
Cowdenbeath,4578,10,4,10,22,23,56,-33,22
Montrose,4579,1,23,8,5,60,35,25,77
Peterhead,4579,2,24,4,8,79,38,41,76
Stirling,4579,3,17,6,13,63,53,10,57
Clyde,4579,4,15,9,12,52,48,4,54
Stenhousem'r,4579,5,15,8,13,57,49,8,53
Elgin,4579,6,14,7,15,54,61,-7,49
Annan Athlet,4579,7,11,12,13,47,41,6,45
Berwick,4579,8,8,10,18,29,59,-30,34
Edinburgh Ci,4579,9,7,9,20,36,62,-26,30
Cowdenbeath,4579,10,4,11,21,23,54,-31,23
Montrose,4580,1,24,7,5,63,34,29,79
Peterhead,4580,2,24,4,8,83,38,45,76
Stenhousem'r,4580,3,16,8,12,57,47,10,56
Stirling,4580,4,16,6,14,61,53,8,54
Clyde,4580,5,14,9,13,52,50,2,51
Elgin,4580,6,14,6,16,53,64,-11,48
Annan Athlet,4580,7,11,12,13,48,42,6,45
Berwick,4580,8,9,10,17,31,59,-28,37
Edinburgh Ci,4580,9,7,9,20,36,66,-30,30
Cowdenbeath,4580,10,4,11,21,24,55,-31,23
Montrose,4581,1,24,7,5,61,34,27,79
Peterhead,4581,2,24,4,8,80,38,42,76
Stenhousem'r,4581,3,16,8,12,58,48,10,56
Stirling,4581,4,16,6,14,62,54,8,54
Clyde,4581,5,14,10,12,54,51,3,52
Elgin,4581,6,14,6,16,53,62,-9,48
Annan Athlet,4581,7,12,11,13,50,41,9,47
Berwick,4581,8,8,11,17,32,61,-29,35
Edinburgh Ci,4581,9,7,9,20,36,63,-27,30
Cowdenbeath,4581,10,4,10,22,23,57,-34,22
Montrose,4582,1,24,7,5,61,35,26,79
Peterhead,4582,2,24,4,8,80,39,41,76
Stirling,4582,3,16,7,13,61,52,9,55
Stenhousem'r,4582,4,15,9,12,56,47,9,54
Clyde,4582,5,15,9,12,53,48,5,54
Elgin,4582,6,14,6,16,54,62,-8,48
Annan Athlet,4582,7,11,12,13,48,42,6,45
Berwick,4582,8,8,10,18,29,60,-31,34
Edinburgh Ci,4582,9,7,9,20,37,63,-26,30
Cowdenbeath,4582,10,4,11,21,24,55,-31,23
Peterhead,4583,1,24,4,8,80,38,42,76
Montrose,4583,2,23,7,6,59,35,24,76
Stirling,4583,3,17,6,13,63,51,12,57
Clyde,4583,4,15,9,12,52,48,4,54
Stenhousem'r,4583,5,15,8,13,55,49,6,53
Elgin,4583,6,15,6,15,54,60,-6,51
Annan Athlet,4583,7,11,12,13,48,42,6,45
Berwick,4583,8,8,10,18,29,59,-30,34
Edinburgh Ci,4583,9,7,9,20,36,63,-27,30
Cowdenbeath,4583,10,4,11,21,24,55,-31,23
Montrose,4584,1,24,7,5,62,35,27,79
Peterhead,4584,2,23,5,8,78,39,39,74
Stirling,4584,3,16,7,13,63,54,9,55
Stenhousem'r,4584,4,15,9,12,58,49,9,54
Clyde,4584,5,14,9,13,52,51,1,51
Elgin,4584,6,14,6,16,54,63,-9,48
Annan Athlet,4584,7,12,11,13,48,41,7,47
Berwick,4584,8,9,10,17,32,59,-27,37
Edinburgh Ci,4584,9,7,10,19,37,61,-24,31
Cowdenbeath,4584,10,4,10,22,23,55,-32,22
Montrose,4585,1,24,7,5,63,34,29,79
Peterhead,4585,2,24,4,8,78,38,40,76
Stirling,4585,3,17,6,13,66,53,13,57
Stenhousem'r,4585,4,15,8,13,57,52,5,53
Clyde,4585,5,14,10,12,51,48,3,52
Elgin,4585,6,14,6,16,53,64,-11,48
Annan Athlet,4585,7,11,11,14,47,43,4,44
Berwick,4585,8,8,11,17,29,58,-29,35
Edinburgh Ci,4585,9,7,9,20,36,61,-25,30
Cowdenbeath,4585,10,5,10,21,25,54,-29,25
Peterhead,4586,1,24,4,8,79,39,40,76
Montrose,4586,2,23,7,6,59,35,24,76
Stirling,4586,3,17,6,13,63,52,11,57
Clyde,4586,4,15,9,12,57,48,9,54
Stenhousem'r,4586,5,15,8,13,56,49,7,53
Elgin,4586,6,15,6,15,54,60,-6,51
Annan Athlet,4586,7,12,11,13,50,41,9,47
Berwick,4586,8,8,10,18,29,64,-35,34
Edinburgh Ci,4586,9,7,9,20,37,62,-25,30
Cowdenbeath,4586,10,4,10,22,23,57,-34,22
Montrose,4587,1,23,7,6,59,35,24,76
Peterhead,4587,2,23,4,9,78,40,38,73
Stenhousem'r,4587,3,16,8,12,57,46,11,56
Stirling,4587,4,16,6,14,60,53,7,54
Clyde,4587,5,14,9,13,52,50,2,51
Elgin,4587,6,15,6,15,54,60,-6,51
Annan Athlet,4587,7,11,11,14,49,44,5,44
Berwick,4587,8,9,10,17,31,59,-28,37
Edinburgh Ci,4587,9,8,9,19,38,61,-23,33
Cowdenbeath,4587,10,5,10,21,26,56,-30,25
Montrose,4588,1,24,7,5,63,35,28,79
Peterhead,4588,2,24,4,8,84,39,45,76
Stirling,4588,3,17,6,13,62,51,11,57
Clyde,4588,4,15,9,12,52,48,4,54
Stenhousem'r,4588,5,15,8,13,55,48,7,53
Elgin,4588,6,14,6,16,54,64,-10,48
Annan Athlet,4588,7,11,12,13,47,41,6,45
Berwick,4588,8,8,10,18,29,59,-30,34
Edinburgh Ci,4588,9,7,9,20,37,67,-30,30
Cowdenbeath,4588,10,4,11,21,23,54,-31,23
Montrose,4589,1,23,8,5,60,35,25,77
Peterhead,4589,2,24,4,8,78,38,40,76
Stirling,4589,3,17,6,13,63,53,10,57
Clyde,4589,4,15,9,12,54,50,4,54
Stenhousem'r,4589,5,15,8,13,57,49,8,53
Elgin,4589,6,14,7,15,54,61,-7,49
Annan Athlet,4589,7,11,12,13,48,42,6,45
Berwick,4589,8,8,10,18,31,61,-30,34
Edinburgh Ci,4589,9,7,9,20,36,61,-25,30
Cowdenbeath,4589,10,4,11,21,24,55,-31,23
Peterhead,4590,1,24,4,8,82,40,42,76
Montrose,4590,2,23,7,6,61,37,24,76
Stenhousem'r,4590,3,16,8,12,58,47,11,56
Stirling,4590,4,16,6,14,61,54,7,54
Clyde,4590,5,15,9,12,53,49,4,54
Elgin,4590,6,15,6,15,56,62,-6,51
Annan Athlet,4590,7,11,11,14,47,42,5,44
Berwick,4590,8,8,10,18,30,60,-30,34
Edinburgh Ci,4590,9,7,9,20,38,65,-27,30
Cowdenbeath,4590,10,5,10,21,24,54,-30,25
Montrose,4591,1,24,7,5,62,35,27,79
Peterhead,4591,2,24,4,8,79,39,40,76
Stirling,4591,3,17,6,13,62,52,10,57
Clyde,4591,4,15,9,12,53,49,4,54
Stenhousem'r,4591,5,15,8,13,56,48,8,53
Elgin,4591,6,14,6,16,54,63,-9,48
Annan Athlet,4591,7,11,12,13,48,42,6,45
Berwick,4591,8,8,10,18,30,60,-30,34
Edinburgh Ci,4591,9,7,9,20,37,62,-25,30
Cowdenbeath,4591,10,4,11,21,24,55,-31,23
Montrose,4592,1,24,7,5,61,35,26,79
Peterhead,4592,2,24,4,8,83,40,43,76
Stenhousem'r,4592,3,16,8,12,57,47,10,56
Stirling,4592,4,16,6,14,61,53,8,54
Clyde,4592,5,15,9,12,53,49,4,54
Elgin,4592,6,14,6,16,54,62,-8,48
Annan Athlet,4592,7,11,12,13,47,41,6,45
Berwick,4592,8,8,10,18,30,60,-30,34
Edinburgh Ci,4592,9,7,9,20,38,66,-28,30
Cowdenbeath,4592,10,4,11,21,23,54,-31,23
Peterhead,4593,1,24,4,8,81,38,43,76
Montrose,4593,2,23,7,6,60,37,23,76
Stenhousem'r,4593,3,16,8,12,56,46,10,56
Stirling,4593,4,16,6,14,60,52,8,54
Clyde,4593,5,15,9,12,53,48,5,54
Elgin,4593,6,15,6,15,56,61,-5,51
Annan Athlet,4593,7,12,11,13,52,41,11,47
Berwick,4593,8,8,10,18,29,60,-31,34
Edinburgh Ci,4593,9,7,9,20,36,64,-28,30
Cowdenbeath,4593,10,4,10,22,23,59,-36,22
Montrose,4594,1,24,7,5,61,35,26,79
Peterhead,4594,2,24,4,8,79,38,41,76
Stenhousem'r,4594,3,16,8,12,57,47,10,56
Stirling,4594,4,16,6,14,61,53,8,54
Clyde,4594,5,15,9,12,53,48,5,54
Elgin,4594,6,14,6,16,54,62,-8,48
Annan Athlet,4594,7,12,11,13,48,41,7,47
Berwick,4594,8,8,10,18,29,60,-31,34
Edinburgh Ci,4594,9,7,9,20,36,62,-26,30
Cowdenbeath,4594,10,4,10,22,23,55,-32,22
Peterhead,4595,1,24,4,8,78,38,40,76
Montrose,4595,2,23,7,6,60,36,24,76
Stirling,4595,3,17,6,13,64,54,10,57
Stenhousem'r,4595,4,15,8,13,58,50,8,53
Clyde,4595,5,14,9,13,51,52,-1,51
Elgin,4595,6,15,6,15,55,61,-6,51
Annan Athlet,4595,7,11,12,13,47,41,6,45
Berwick,4595,8,9,10,17,33,58,-25,37
Edinburgh Ci,4595,9,7,9,20,36,61,-25,30
Cowdenbeath,4595,10,4,11,21,23,54,-31,23
Montrose,4596,1,24,7,5,63,34,29,79
Peterhead,4596,2,24,4,8,80,38,42,76
Stirling,4596,3,17,6,13,63,51,12,57
Clyde,4596,4,15,9,12,53,49,4,54
Stenhousem'r,4596,5,15,8,13,55,49,6,53
Elgin,4596,6,14,6,16,53,64,-11,48
Annan Athlet,4596,7,12,11,13,49,42,7,47
Berwick,4596,8,8,10,18,30,60,-30,34
Edinburgh Ci,4596,9,7,9,20,36,63,-27,30
Cowdenbeath,4596,10,4,10,22,24,56,-32,22
Montrose,4597,1,24,7,5,63,34,29,79
Peterhead,4597,2,24,4,8,79,39,40,76
Stirling,4597,3,17,6,13,61,51,10,57
Stenhousem'r,4597,4,15,8,13,55,47,8,53
Clyde,4597,5,14,9,13,51,50,1,51
Elgin,4597,6,14,6,16,53,64,-11,48
Annan Athlet,4597,7,11,11,14,47,43,4,44
Berwick,4597,8,9,10,17,31,58,-27,37
Edinburgh Ci,4597,9,7,9,20,37,62,-25,30
Cowdenbeath,4597,10,5,10,21,25,54,-29,25
Peterhead,4598,1,24,4,8,79,38,41,76
Montrose,4598,2,23,7,6,59,36,23,76
Stirling,4598,3,17,6,13,62,52,10,57
Stenhousem'r,4598,4,15,8,13,56,48,8,53
Clyde,4598,5,14,10,12,52,49,3,52
Elgin,4598,6,15,6,15,55,60,-5,51
Annan Athlet,4598,7,12,11,13,49,41,8,47
Berwick,4598,8,8,11,17,30,59,-29,35
Edinburgh Ci,4598,9,7,9,20,36,62,-26,30
Cowdenbeath,4598,10,4,10,22,23,56,-33,22
Montrose,4599,1,24,7,5,61,35,26,79
Peterhead,4599,2,24,4,8,78,38,40,76
Stirling,4599,3,17,6,13,62,51,11,57
Clyde,4599,4,15,9,12,53,49,4,54
Stenhousem'r,4599,5,15,8,13,55,48,7,53
Elgin,4599,6,14,6,16,54,62,-8,48
Annan Athlet,4599,7,12,11,13,48,41,7,47
Berwick,4599,8,8,10,18,30,60,-30,34
Edinburgh Ci,4599,9,7,9,20,36,61,-25,30
Cowdenbeath,4599,10,4,10,22,23,55,-32,22
Peterhead,4600,1,24,4,8,80,38,42,76
Montrose,4600,2,23,7,6,59,37,22,76
Stirling,4600,3,17,6,13,61,51,10,57
Clyde,4600,4,15,9,12,53,48,5,54
Stenhousem'r,4600,5,15,8,13,55,47,8,53
Elgin,4600,6,15,6,15,56,60,-4,51
Annan Athlet,4600,7,11,11,14,47,42,5,44
Berwick,4600,8,8,10,18,29,60,-31,34
Edinburgh Ci,4600,9,7,9,20,36,63,-27,30
Cowdenbeath,4600,10,5,10,21,24,54,-30,25
Montrose,4601,1,23,7,6,60,38,22,76
Peterhead,4601,2,23,5,8,78,39,39,74
Stirling,4601,3,16,7,13,61,52,9,55
Stenhousem'r,4601,4,15,9,12,56,47,9,54
Clyde,4601,5,15,9,12,52,48,4,54
Elgin,4601,6,15,6,15,57,61,-4,51
Annan Athlet,4601,7,12,11,13,51,41,10,47
Berwick,4601,8,8,10,18,29,59,-30,34
Edinburgh Ci,4601,9,7,10,19,37,61,-24,31
Cowdenbeath,4601,10,4,10,22,23,58,-35,22
Peterhead,4602,1,24,4,8,83,40,43,76
Montrose,4602,2,23,7,6,60,36,24,76
Stenhousem'r,4602,3,16,8,12,57,47,10,56
Stirling,4602,4,16,6,14,61,53,8,54
Clyde,4602,5,15,9,12,53,48,5,54
Elgin,4602,6,15,6,15,55,61,-6,51
Annan Athlet,4602,7,11,12,13,48,42,6,45
Berwick,4602,8,8,10,18,29,60,-31,34
Edinburgh Ci,4602,9,7,9,20,38,66,-28,30
Cowdenbeath,4602,10,4,11,21,24,55,-31,23
Montrose,4603,1,24,7,5,61,35,26,79
Peterhead,4603,2,24,4,8,78,38,40,76
Stirling,4603,3,16,7,13,62,53,9,55
Stenhousem'r,4603,4,15,9,12,57,48,9,54
Clyde,4603,5,15,9,12,56,48,8,54
Elgin,4603,6,14,6,16,54,62,-8,48
Annan Athlet,4603,7,11,12,13,47,41,6,45
Berwick,4603,8,8,10,18,29,63,-34,34
Edinburgh Ci,4603,9,7,9,20,36,61,-25,30
Cowdenbeath,4603,10,4,11,21,23,54,-31,23
Montrose,4604,1,24,7,5,61,34,27,79
Peterhead,4604,2,24,4,8,80,38,42,76
Stirling,4604,3,17,6,13,62,51,11,57
Clyde,4604,4,15,9,12,53,48,5,54
Stenhousem'r,4604,5,15,8,13,55,48,7,53
Elgin,4604,6,14,6,16,53,62,-9,48
Annan Athlet,4604,7,12,11,13,49,41,8,47
Berwick,4604,8,8,10,18,29,60,-31,34
Edinburgh Ci,4604,9,7,9,20,36,63,-27,30
Cowdenbeath,4604,10,4,10,22,23,56,-33,22
Montrose,4605,1,24,7,5,62,34,28,79
Peterhead,4605,2,24,4,8,80,38,42,76
Stirling,4605,3,16,7,13,63,54,9,55
Stenhousem'r,4605,4,15,9,12,58,49,9,54
Clyde,4605,5,15,9,12,53,48,5,54
Elgin,4605,6,14,6,16,53,63,-10,48
Annan Athlet,4605,7,11,11,14,47,43,4,44
Berwick,4605,8,8,10,18,29,60,-31,34
Edinburgh Ci,4605,9,7,9,20,36,63,-27,30
Cowdenbeath,4605,10,5,10,21,25,54,-29,25
Montrose,4606,1,24,7,5,63,36,27,79
Peterhead,4606,2,24,4,8,78,38,40,76
Stirling,4606,3,16,7,13,60,51,9,55
Stenhousem'r,4606,4,15,9,12,55,46,9,54
Clyde,4606,5,15,9,12,53,48,5,54
Elgin,4606,6,14,6,16,55,64,-9,48
Annan Athlet,4606,7,11,12,13,48,42,6,45
Berwick,4606,8,8,10,18,29,60,-31,34
Edinburgh Ci,4606,9,7,9,20,36,61,-25,30
Cowdenbeath,4606,10,4,11,21,24,55,-31,23
Montrose,4607,1,24,7,5,63,34,29,79
Peterhead,4607,2,23,5,8,78,39,39,74
Stirling,4607,3,17,6,13,62,51,11,57
Clyde,4607,4,15,9,12,55,49,6,54
Stenhousem'r,4607,5,15,8,13,55,48,7,53
Elgin,4607,6,14,6,16,53,64,-11,48
Annan Athlet,4607,7,11,11,14,48,44,4,44
Berwick,4607,8,8,10,18,30,62,-32,34
Edinburgh Ci,4607,9,7,10,19,37,61,-24,31
Cowdenbeath,4607,10,5,10,21,26,55,-29,25
Montrose,4608,1,24,7,5,63,35,28,79
Peterhead,4608,2,23,5,8,78,39,39,74
Stirling,4608,3,17,6,13,62,52,10,57
Stenhousem'r,4608,4,15,8,13,56,48,8,53
Clyde,4608,5,14,10,12,52,49,3,52
Elgin,4608,6,14,6,16,54,64,-10,48
Annan Athlet,4608,7,11,11,14,48,44,4,44
Berwick,4608,8,8,11,17,30,59,-29,35
Edinburgh Ci,4608,9,7,10,19,37,61,-24,31
Cowdenbeath,4608,10,5,10,21,26,55,-29,25
Montrose,4609,1,24,7,5,61,35,26,79
Peterhead,4609,2,24,4,8,81,38,43,76
Stirling,4609,3,17,6,13,62,51,11,57
Clyde,4609,4,15,9,12,53,48,5,54
Stenhousem'r,4609,5,15,8,13,55,48,7,53
Elgin,4609,6,14,6,16,54,62,-8,48
Annan Athlet,4609,7,11,11,14,47,42,5,44
Berwick,4609,8,8,10,18,29,60,-31,34
Edinburgh Ci,4609,9,7,9,20,36,64,-28,30
Cowdenbeath,4609,10,5,10,21,24,54,-30,25
Montrose,4610,1,24,7,5,62,34,28,79
Peterhead,4610,2,23,4,9,77,39,38,73
Stirling,4610,3,16,7,13,60,51,9,55
Stenhousem'r,4610,4,15,9,12,55,46,9,54
Clyde,4610,5,14,10,12,52,49,3,52
Elgin,4610,6,14,6,16,53,63,-10,48
Annan Athlet,4610,7,11,11,14,48,44,4,44
Berwick,4610,8,8,11,17,30,59,-29,35
Edinburgh Ci,4610,9,8,9,19,37,60,-23,33
Cowdenbeath,4610,10,5,10,21,26,55,-29,25
Peterhead,4611,1,24,4,8,80,40,40,76
Montrose,4611,2,23,7,6,59,38,21,76
Stirling,4611,3,17,6,13,61,51,10,57
Stenhousem'r,4611,4,15,8,13,55,47,8,53
Clyde,4611,5,14,9,13,51,49,2,51
Elgin,4611,6,15,6,15,57,60,-3,51
Annan Athlet,4611,7,11,11,14,47,43,4,44
Berwick,4611,8,9,10,17,30,58,-28,37
Edinburgh Ci,4611,9,7,9,20,38,63,-25,30
Cowdenbeath,4611,10,5,10,21,25,54,-29,25
Montrose,4612,1,23,7,6,59,35,24,76
Peterhead,4612,2,23,5,8,78,39,39,74
Stirling,4612,3,17,6,13,61,51,10,57
Clyde,4612,4,15,9,12,54,48,6,54
Stenhousem'r,4612,5,15,8,13,55,47,8,53
Elgin,4612,6,15,6,15,54,60,-6,51
Annan Athlet,4612,7,11,12,13,48,42,6,45
Berwick,4612,8,8,10,18,29,61,-32,34
Edinburgh Ci,4612,9,7,10,19,37,61,-24,31
Cowdenbeath,4612,10,4,11,21,24,55,-31,23
Montrose,4613,1,24,7,5,61,35,26,79
Peterhead,4613,2,24,4,8,80,39,41,76
Stirling,4613,3,17,6,13,62,52,10,57
Clyde,4613,4,15,9,12,52,48,4,54
Stenhousem'r,4613,5,15,8,13,56,48,8,53
Elgin,4613,6,14,6,16,54,62,-8,48
Annan Athlet,4613,7,12,11,13,49,41,8,47
Berwick,4613,8,8,10,18,29,59,-30,34
Edinburgh Ci,4613,9,7,9,20,37,63,-26,30
Cowdenbeath,4613,10,4,10,22,23,56,-33,22
Montrose,4614,1,24,7,5,65,34,31,79
Peterhead,4614,2,24,4,8,81,39,42,76
Stirling,4614,3,16,7,13,61,52,9,55
Stenhousem'r,4614,4,15,9,12,56,47,9,54
Clyde,4614,5,14,10,12,53,50,3,52
Elgin,4614,6,14,6,16,53,66,-13,48
Annan Athlet,4614,7,11,11,14,49,44,5,44
Berwick,4614,8,8,11,17,31,60,-29,35
Edinburgh Ci,4614,9,7,9,20,37,64,-27,30
Cowdenbeath,4614,10,5,10,21,26,56,-30,25
Montrose,4615,1,23,8,5,60,35,25,77
Peterhead,4615,2,24,4,8,79,39,40,76
Stirling,4615,3,17,6,13,63,52,11,57
Stenhousem'r,4615,4,15,8,13,56,49,7,53
Clyde,4615,5,14,10,12,52,49,3,52
Elgin,4615,6,14,7,15,54,61,-7,49
Annan Athlet,4615,7,11,11,14,47,44,3,44
Berwick,4615,8,8,11,17,30,59,-29,35
Edinburgh Ci,4615,9,7,9,20,37,62,-25,30
Cowdenbeath,4615,10,5,10,21,26,54,-28,25
Peterhead,4616,1,24,4,8,83,39,44,76
Montrose,4616,2,23,7,6,60,36,24,76
Stirling,4616,3,16,7,13,61,52,9,55
Stenhousem'r,4616,4,15,9,12,56,47,9,54
Clyde,4616,5,15,9,12,53,49,4,54
Elgin,4616,6,15,6,15,55,61,-6,51
Annan Athlet,4616,7,12,11,13,48,41,7,47
Berwick,4616,8,8,10,18,30,60,-30,34
Edinburgh Ci,4616,9,7,9,20,37,66,-29,30
Cowdenbeath,4616,10,4,10,22,23,55,-32,22
Montrose,4617,1,23,8,5,59,34,25,77
Peterhead,4617,2,24,4,8,80,39,41,76
Stirling,4617,3,16,7,13,62,53,9,55
Stenhousem'r,4617,4,15,9,12,57,48,9,54
Clyde,4617,5,14,10,12,51,48,3,52
Elgin,4617,6,14,7,15,53,60,-7,49
Annan Athlet,4617,7,11,12,13,49,43,6,45
Berwick,4617,8,8,11,17,29,58,-29,35
Edinburgh Ci,4617,9,7,9,20,37,63,-26,30
Cowdenbeath,4617,10,4,11,21,25,56,-31,23
Peterhead,4618,1,24,4,8,80,38,42,76
Montrose,4618,2,23,7,6,60,37,23,76
Stirling,4618,3,17,6,13,62,52,10,57
Stenhousem'r,4618,4,15,8,13,56,48,8,53
Clyde,4618,5,14,10,12,52,49,3,52
Elgin,4618,6,15,6,15,56,61,-5,51
Annan Athlet,4618,7,11,12,13,48,42,6,45
Berwick,4618,8,8,11,17,30,59,-29,35
Edinburgh Ci,4618,9,7,9,20,36,63,-27,30
Cowdenbeath,4618,10,4,11,21,24,55,-31,23
Peterhead,4619,1,24,4,8,81,38,43,76
Montrose,4619,2,23,7,6,60,36,24,76
Stirling,4619,3,16,7,13,61,52,9,55
Stenhousem'r,4619,4,15,9,12,56,47,9,54
Clyde,4619,5,15,9,12,54,48,6,54
Elgin,4619,6,15,6,15,55,61,-6,51
Annan Athlet,4619,7,11,12,13,48,42,6,45
Berwick,4619,8,8,10,18,29,61,-32,34
Edinburgh Ci,4619,9,7,9,20,36,64,-28,30
Cowdenbeath,4619,10,4,11,21,24,55,-31,23
Montrose,4620,1,24,7,5,62,36,26,79
Peterhead,4620,2,24,4,8,80,39,41,76
Stirling,4620,3,17,6,13,64,53,11,57
Clyde,4620,4,15,9,12,54,49,5,54
Stenhousem'r,4620,5,15,8,13,57,50,7,53
Elgin,4620,6,14,6,16,55,63,-8,48
Annan Athlet,4620,7,11,11,14,47,44,3,44
Berwick,4620,8,8,10,18,30,61,-31,34
Edinburgh Ci,4620,9,7,9,20,37,63,-26,30
Cowdenbeath,4620,10,5,10,21,26,54,-28,25
Montrose,4621,1,23,8,5,60,35,25,77
Peterhead,4621,2,24,4,8,81,39,42,76
Stirling,4621,3,17,6,13,63,51,12,57
Clyde,4621,4,15,9,12,54,48,6,54
Stenhousem'r,4621,5,15,8,13,55,49,6,53
Elgin,4621,6,14,7,15,54,61,-7,49
Annan Athlet,4621,7,11,12,13,48,42,6,45
Berwick,4621,8,8,10,18,29,61,-32,34
Edinburgh Ci,4621,9,7,9,20,37,64,-27,30
Cowdenbeath,4621,10,4,11,21,24,55,-31,23
Peterhead,4622,1,24,4,8,79,38,41,76
Montrose,4622,2,23,7,6,59,35,24,76
Stirling,4622,3,17,6,13,63,53,10,57
Clyde,4622,4,15,9,12,53,49,4,54
Stenhousem'r,4622,5,15,8,13,57,49,8,53
Elgin,4622,6,15,6,15,54,60,-6,51
Annan Athlet,4622,7,12,11,13,48,41,7,47
Berwick,4622,8,8,10,18,30,60,-30,34
Edinburgh Ci,4622,9,7,9,20,36,62,-26,30
Cowdenbeath,4622,10,4,10,22,23,55,-32,22
Montrose,4623,1,23,8,5,60,35,25,77
Peterhead,4623,2,24,4,8,80,39,41,76
Stirling,4623,3,16,7,13,61,52,9,55
Stenhousem'r,4623,4,15,9,12,56,47,9,54
Clyde,4623,5,15,9,12,55,50,5,54
Elgin,4623,6,14,7,15,54,61,-7,49
Annan Athlet,4623,7,11,11,14,47,43,4,44
Berwick,4623,8,8,10,18,31,62,-31,34
Edinburgh Ci,4623,9,7,9,20,37,63,-26,30
Cowdenbeath,4623,10,5,10,21,25,54,-29,25
Montrose,4624,1,24,7,5,60,34,26,79
Peterhead,4624,2,24,4,8,81,39,42,76
Stirling,4624,3,17,6,13,63,51,12,57
Stenhousem'r,4624,4,15,8,13,55,49,6,53
Clyde,4624,5,14,10,12,52,49,3,52
Elgin,4624,6,14,6,16,53,61,-8,48
Annan Athlet,4624,7,11,12,13,49,43,6,45
Berwick,4624,8,8,11,17,30,59,-29,35
Edinburgh Ci,4624,9,7,9,20,37,64,-27,30
Cowdenbeath,4624,10,4,11,21,25,56,-31,23
Montrose,4625,1,24,7,5,61,34,27,79
Peterhead,4625,2,23,4,9,78,42,36,73
Stirling,4625,3,16,7,13,62,53,9,55
Stenhousem'r,4625,4,15,9,12,57,48,9,54
Clyde,4625,5,15,9,12,55,50,5,54
Elgin,4625,6,14,6,16,53,62,-9,48
Annan Athlet,4625,7,11,12,13,47,41,6,45
Berwick,4625,8,8,10,18,31,62,-31,34
Edinburgh Ci,4625,9,8,9,19,40,61,-21,33
Cowdenbeath,4625,10,4,11,21,23,54,-31,23
Peterhead,4626,1,24,4,8,81,38,43,76
Montrose,4626,2,23,7,6,59,36,23,76
Stirling,4626,3,17,6,13,62,52,10,57
Stenhousem'r,4626,4,15,8,13,56,48,8,53
Clyde,4626,5,14,10,12,52,49,3,52
Elgin,4626,6,15,6,15,55,60,-5,51
Annan Athlet,4626,7,11,12,13,47,41,6,45
Berwick,4626,8,8,11,17,30,59,-29,35
Edinburgh Ci,4626,9,7,9,20,36,64,-28,30
Cowdenbeath,4626,10,4,11,21,23,54,-31,23
Peterhead,4627,1,24,4,8,79,39,40,76
Montrose,4627,2,23,7,6,60,36,24,76
Stirling,4627,3,16,7,13,61,52,9,55
Stenhousem'r,4627,4,15,9,12,56,47,9,54
Clyde,4627,5,14,10,12,52,49,3,52
Elgin,4627,6,15,6,15,55,61,-6,51
Annan Athlet,4627,7,11,12,13,47,41,6,45
Berwick,4627,8,8,11,17,30,59,-29,35
Edinburgh Ci,4627,9,7,9,20,37,62,-25,30
Cowdenbeath,4627,10,4,11,21,23,54,-31,23
Montrose,4628,1,24,7,5,64,36,28,79
Peterhead,4628,2,24,4,8,80,38,42,76
Stirling,4628,3,17,6,13,63,51,12,57
Stenhousem'r,4628,4,15,8,13,55,49,6,53
Clyde,4628,5,14,9,13,51,49,2,51
Elgin,4628,6,14,6,16,55,65,-10,48
Annan Athlet,4628,7,11,11,14,47,43,4,44
Berwick,4628,8,9,10,17,30,58,-28,37
Edinburgh Ci,4628,9,7,9,20,36,63,-27,30
Cowdenbeath,4628,10,5,10,21,25,54,-29,25
Peterhead,4629,1,24,4,8,80,39,41,76
Montrose,4629,2,23,7,6,59,39,20,76
Stenhousem'r,4629,3,16,8,12,56,46,10,56
Stirling,4629,4,16,6,14,60,52,8,54
Clyde,4629,5,15,9,12,55,48,7,54
Elgin,4629,6,15,6,15,58,60,-2,51
Annan Athlet,4629,7,11,11,14,48,43,5,44
Berwick,4629,8,8,10,18,29,62,-33,34
Edinburgh Ci,4629,9,7,9,20,37,63,-26,30
Cowdenbeath,4629,10,5,10,21,25,55,-30,25
Montrose,4630,1,24,7,5,61,35,26,79
Peterhead,4630,2,23,4,9,77,39,38,73
Stenhousem'r,4630,3,16,8,12,58,48,10,56
Stirling,4630,4,16,6,14,62,54,8,54
Clyde,4630,5,15,9,12,54,48,6,54
Elgin,4630,6,14,6,16,54,62,-8,48
Annan Athlet,4630,7,11,12,13,48,42,6,45
Berwick,4630,8,8,10,18,29,61,-32,34
Edinburgh Ci,4630,9,8,9,19,37,60,-23,33
Cowdenbeath,4630,10,4,11,21,24,55,-31,23
Montrose,4631,1,24,7,5,63,37,26,79
Peterhead,4631,2,24,4,8,80,38,42,76
Stirling,4631,3,17,6,13,64,51,13,57
Stenhousem'r,4631,4,15,8,13,55,50,5,53
Clyde,4631,5,14,10,12,51,48,3,52
Elgin,4631,6,14,6,16,56,64,-8,48
Annan Athlet,4631,7,11,11,14,48,43,5,44
Berwick,4631,8,8,11,17,29,58,-29,35
Edinburgh Ci,4631,9,7,9,20,36,63,-27,30
Cowdenbeath,4631,10,5,10,21,25,55,-30,25
Peterhead,4632,1,24,4,8,80,39,41,76
Montrose,4632,2,23,7,6,60,37,23,76
Stirling,4632,3,16,7,13,62,53,9,55
Stenhousem'r,4632,4,15,9,12,57,48,9,54
Clyde,4632,5,15,9,12,53,49,4,54
Elgin,4632,6,15,6,15,56,61,-5,51
Annan Athlet,4632,7,11,11,14,47,42,5,44
Berwick,4632,8,8,10,18,30,60,-30,34
Edinburgh Ci,4632,9,7,9,20,37,63,-26,30
Cowdenbeath,4632,10,5,10,21,24,54,-30,25
Montrose,4633,1,24,7,5,61,34,27,79
Peterhead,4633,2,24,4,8,78,38,40,76
Stenhousem'r,4633,3,16,8,12,56,46,10,56
Stirling,4633,4,16,6,14,60,52,8,54
Clyde,4633,5,15,9,12,53,49,4,54
Elgin,4633,6,14,6,16,53,62,-9,48
Annan Athlet,4633,7,12,11,13,48,41,7,47
Berwick,4633,8,8,10,18,30,60,-30,34
Edinburgh Ci,4633,9,7,9,20,36,61,-25,30
Cowdenbeath,4633,10,4,10,22,23,55,-32,22
Montrose,4634,1,24,7,5,61,34,27,79
Peterhead,4634,2,24,4,8,80,39,41,76
Stirling,4634,3,16,7,13,61,52,9,55
Stenhousem'r,4634,4,15,9,12,56,47,9,54
Clyde,4634,5,14,10,12,51,48,3,52
Elgin,4634,6,14,6,16,53,62,-9,48
Annan Athlet,4634,7,11,12,13,48,42,6,45
Berwick,4634,8,8,11,17,29,58,-29,35
Edinburgh Ci,4634,9,7,9,20,37,63,-26,30
Cowdenbeath,4634,10,4,11,21,24,55,-31,23
Montrose,4635,1,23,7,6,59,37,22,76
Peterhead,4635,2,23,5,8,79,40,39,74
Stirling,4635,3,17,6,13,63,53,10,57
Clyde,4635,4,15,9,12,53,49,4,54
Stenhousem'r,4635,5,15,8,13,57,49,8,53
Elgin,4635,6,15,6,15,56,60,-4,51
Annan Athlet,4635,7,11,11,14,47,42,5,44
Berwick,4635,8,8,10,18,30,60,-30,34
Edinburgh Ci,4635,9,7,10,19,38,62,-24,31
Cowdenbeath,4635,10,5,10,21,24,54,-30,25
Montrose,4636,1,24,7,5,61,35,26,79
Peterhead,4636,2,24,4,8,78,38,40,76
Stirling,4636,3,17,6,13,63,52,11,57
Stenhousem'r,4636,4,15,8,13,56,49,7,53
Clyde,4636,5,14,10,12,51,48,3,52
Elgin,4636,6,14,6,16,54,62,-8,48
Annan Athlet,4636,7,11,12,13,48,42,6,45
Berwick,4636,8,8,11,17,29,58,-29,35
Edinburgh Ci,4636,9,7,9,20,36,61,-25,30
Cowdenbeath,4636,10,4,11,21,24,55,-31,23
Montrose,4637,1,23,7,6,60,38,22,76
Peterhead,4637,2,23,5,8,77,38,39,74
Stenhousem'r,4637,3,16,8,12,59,47,12,56
Stirling,4637,4,16,6,14,61,55,6,54
Clyde,4637,5,15,9,12,53,49,4,54
Elgin,4637,6,15,6,15,57,61,-4,51
Annan Athlet,4637,7,12,11,13,48,41,7,47
Berwick,4637,8,8,10,18,30,60,-30,34
Edinburgh Ci,4637,9,7,10,19,36,60,-24,31
Cowdenbeath,4637,10,4,10,22,23,55,-32,22
Montrose,4638,1,24,7,5,63,35,28,79
Peterhead,4638,2,23,5,8,77,38,39,74
Stirling,4638,3,17,6,13,63,53,10,57
Stenhousem'r,4638,4,15,8,13,57,49,8,53
Clyde,4638,5,14,9,13,52,51,1,51
Elgin,4638,6,14,6,16,54,64,-10,48
Annan Athlet,4638,7,11,11,14,47,43,4,44
Berwick,4638,8,9,10,17,32,59,-27,37
Edinburgh Ci,4638,9,7,10,19,36,60,-24,31
Cowdenbeath,4638,10,5,10,21,25,54,-29,25
Montrose,4639,1,24,7,5,61,35,26,79
Peterhead,4639,2,23,5,8,78,39,39,74
Stirling,4639,3,17,6,13,62,52,10,57
Clyde,4639,4,15,9,12,56,51,5,54
Stenhousem'r,4639,5,15,8,13,56,48,8,53
Elgin,4639,6,14,6,16,54,62,-8,48
Annan Athlet,4639,7,11,12,13,48,42,6,45
Berwick,4639,8,8,10,18,32,63,-31,34
Edinburgh Ci,4639,9,7,10,19,37,61,-24,31
Cowdenbeath,4639,10,4,11,21,24,55,-31,23
Montrose,4640,1,24,7,5,63,34,29,79
Peterhead,4640,2,24,4,8,79,38,41,76
Stirling,4640,3,17,6,13,63,53,10,57
Clyde,4640,4,15,9,12,56,48,8,54
Stenhousem'r,4640,5,15,8,13,57,49,8,53
Elgin,4640,6,14,6,16,53,64,-11,48
Annan Athlet,4640,7,11,12,13,48,42,6,45
Berwick,4640,8,8,10,18,29,63,-34,34
Edinburgh Ci,4640,9,7,9,20,36,62,-26,30
Cowdenbeath,4640,10,4,11,21,24,55,-31,23
Montrose,4641,1,24,7,5,62,34,28,79
Peterhead,4641,2,24,4,8,79,38,41,76
Stirling,4641,3,16,7,13,64,55,9,55
Stenhousem'r,4641,4,15,9,12,59,50,9,54
Clyde,4641,5,15,9,12,54,49,5,54
Elgin,4641,6,14,6,16,53,63,-10,48
Annan Athlet,4641,7,11,12,13,48,42,6,45
Berwick,4641,8,8,10,18,30,61,-31,34
Edinburgh Ci,4641,9,7,9,20,36,62,-26,30
Cowdenbeath,4641,10,4,11,21,24,55,-31,23
Montrose,4642,1,23,8,5,59,34,25,77
Peterhead,4642,2,23,5,8,78,39,39,74
Stirling,4642,3,17,6,13,64,52,12,57
Stenhousem'r,4642,4,15,8,13,56,50,6,53
Clyde,4642,5,14,10,12,55,52,3,52
Elgin,4642,6,14,7,15,53,60,-7,49
Annan Athlet,4642,7,12,11,13,48,41,7,47
Berwick,4642,8,8,11,17,33,62,-29,35
Edinburgh Ci,4642,9,7,10,19,37,61,-24,31
Cowdenbeath,4642,10,4,10,22,23,55,-32,22
Montrose,4643,1,24,7,5,62,34,28,79
Peterhead,4643,2,24,4,8,79,39,40,76
Stirling,4643,3,17,6,13,61,51,10,57
Stenhousem'r,4643,4,15,8,13,55,47,8,53
Clyde,4643,5,14,9,13,51,49,2,51
Elgin,4643,6,14,6,16,53,63,-10,48
Annan Athlet,4643,7,12,11,13,48,41,7,47
Berwick,4643,8,9,10,17,30,58,-28,37
Edinburgh Ci,4643,9,7,9,20,37,62,-25,30
Cowdenbeath,4643,10,4,10,22,23,55,-32,22
Montrose,4644,1,23,7,6,61,37,24,76
Peterhead,4644,2,23,4,9,78,40,38,73
Stirling,4644,3,16,7,13,60,51,9,55
Stenhousem'r,4644,4,15,9,12,55,46,9,54
Clyde,4644,5,15,9,12,55,49,6,54
Elgin,4644,6,15,6,15,56,62,-6,51
Annan Athlet,4644,7,11,11,14,47,43,4,44
Berwick,4644,8,8,10,18,30,62,-32,34
Edinburgh Ci,4644,9,8,9,19,38,61,-23,33
Cowdenbeath,4644,10,5,10,21,25,54,-29,25
Montrose,4645,1,23,8,5,62,37,25,77
Peterhead,4645,2,24,4,8,79,38,41,76
Stirling,4645,3,17,6,13,64,53,11,57
Clyde,4645,4,15,9,12,52,48,4,54
Stenhousem'r,4645,5,15,8,13,57,50,7,53
Elgin,4645,6,14,7,15,56,63,-7,49
Annan Athlet,4645,7,11,11,14,47,42,5,44
Berwick,4645,8,8,10,18,29,59,-30,34
Edinburgh Ci,4645,9,7,9,20,36,62,-26,30
Cowdenbeath,4645,10,5,10,21,24,54,-30,25
Peterhead,4646,1,24,4,8,78,38,40,76
Montrose,4646,2,23,7,6,59,35,24,76
Stirling,4646,3,16,7,13,64,55,9,55
Stenhousem'r,4646,4,15,9,12,59,50,9,54
Clyde,4646,5,15,9,12,56,49,7,54
Elgin,4646,6,15,6,15,54,60,-6,51
Annan Athlet,4646,7,11,11,14,47,42,5,44
Berwick,4646,8,8,10,18,30,63,-33,34
Edinburgh Ci,4646,9,7,9,20,36,61,-25,30
Cowdenbeath,4646,10,5,10,21,24,54,-30,25
Montrose,4647,1,24,7,5,60,34,26,79
Peterhead,4647,2,23,4,9,77,39,38,73
Stirling,4647,3,17,6,13,62,52,10,57
Clyde,4647,4,15,9,12,52,48,4,54
Stenhousem'r,4647,5,15,8,13,56,48,8,53
Elgin,4647,6,14,6,16,53,61,-8,48
Annan Athlet,4647,7,12,11,13,49,41,8,47
Berwick,4647,8,8,10,18,29,59,-30,34
Edinburgh Ci,4647,9,8,9,19,37,60,-23,33
Cowdenbeath,4647,10,4,10,22,23,56,-33,22
Montrose,4648,1,24,7,5,62,35,27,79
Peterhead,4648,2,23,4,9,79,41,38,73
Stenhousem'r,4648,3,16,8,12,56,46,10,56
Stirling,4648,4,16,6,14,60,52,8,54
Clyde,4648,5,15,9,12,53,48,5,54
Elgin,4648,6,14,6,16,54,63,-9,48
Annan Athlet,4648,7,11,11,14,47,43,4,44
Berwick,4648,8,8,10,18,29,60,-31,34
Edinburgh Ci,4648,9,8,9,19,39,62,-23,33
Cowdenbeath,4648,10,5,10,21,25,54,-29,25
Montrose,4649,1,24,7,5,61,35,26,79
Peterhead,4649,2,23,4,9,78,40,38,73
Stirling,4649,3,17,6,13,61,51,10,57
Clyde,4649,4,15,9,12,53,48,5,54
Stenhousem'r,4649,5,15,8,13,55,47,8,53
Elgin,4649,6,14,6,16,54,62,-8,48
Annan Athlet,4649,7,11,11,14,47,42,5,44
Berwick,4649,8,8,10,18,29,60,-31,34
Edinburgh Ci,4649,9,8,9,19,38,61,-23,33
Cowdenbeath,4649,10,5,10,21,24,54,-30,25
Montrose,4650,1,24,7,5,61,35,26,79
Peterhead,4650,2,24,4,8,79,38,41,76
Stenhousem'r,4650,3,16,8,12,56,46,10,56
Stirling,4650,4,16,6,14,60,52,8,54
Clyde,4650,5,15,9,12,54,48,6,54
Elgin,4650,6,14,6,16,54,62,-8,48
Annan Athlet,4650,7,11,12,13,48,42,6,45
Berwick,4650,8,8,10,18,29,61,-32,34
Edinburgh Ci,4650,9,7,9,20,36,62,-26,30
Cowdenbeath,4650,10,4,11,21,24,55,-31,23
Peterhead,4651,1,24,4,8,80,39,41,76
Montrose,4651,2,23,7,6,59,35,24,76
Stirling,4651,3,17,6,13,62,52,10,57
Clyde,4651,4,15,9,12,58,50,8,54
Stenhousem'r,4651,5,15,8,13,56,48,8,53
Elgin,4651,6,15,6,15,54,60,-6,51
Annan Athlet,4651,7,12,11,13,48,41,7,47
Berwick,4651,8,8,10,18,31,65,-34,34
Edinburgh Ci,4651,9,7,9,20,37,63,-26,30
Cowdenbeath,4651,10,4,10,22,23,55,-32,22
Montrose,4652,1,24,7,5,64,35,29,79
Peterhead,4652,2,24,4,8,81,39,42,76
Stirling,4652,3,17,6,13,61,51,10,57
Clyde,4652,4,15,9,12,53,48,5,54
Stenhousem'r,4652,5,15,8,13,55,47,8,53
Elgin,4652,6,14,6,16,54,65,-11,48
Annan Athlet,4652,7,12,11,13,49,41,8,47
Berwick,4652,8,8,10,18,29,60,-31,34
Edinburgh Ci,4652,9,7,9,20,37,64,-27,30
Cowdenbeath,4652,10,4,10,22,23,56,-33,22
Montrose,4653,1,23,8,5,60,35,25,77
Peterhead,4653,2,24,4,8,79,38,41,76
Stirling,4653,3,16,7,13,61,52,9,55
Stenhousem'r,4653,4,15,9,12,56,47,9,54
Clyde,4653,5,15,9,12,53,48,5,54
Elgin,4653,6,14,7,15,54,61,-7,49
Annan Athlet,4653,7,11,11,14,48,44,4,44
Berwick,4653,8,8,10,18,29,60,-31,34
Edinburgh Ci,4653,9,7,9,20,36,62,-26,30
Cowdenbeath,4653,10,5,10,21,26,55,-29,25
Montrose,4654,1,24,7,5,61,34,27,79
Peterhead,4654,2,23,5,8,78,39,39,74
Stirling,4654,3,17,6,13,63,51,12,57
Clyde,4654,4,15,9,12,53,48,5,54
Stenhousem'r,4654,5,15,8,13,55,49,6,53
Elgin,4654,6,14,6,16,53,62,-9,48
Annan Athlet,4654,7,12,11,13,48,41,7,47
Berwick,4654,8,8,10,18,29,60,-31,34
Edinburgh Ci,4654,9,7,10,19,37,61,-24,31
Cowdenbeath,4654,10,4,10,22,23,55,-32,22
Montrose,4655,1,24,7,5,60,34,26,79
Peterhead,4655,2,24,4,8,81,39,42,76
Stenhousem'r,4655,3,16,8,12,58,46,12,56
Stirling,4655,4,16,6,14,60,54,6,54
Clyde,4655,5,14,10,12,52,49,3,52
Elgin,4655,6,14,6,16,53,61,-8,48
Annan Athlet,4655,7,11,11,14,47,42,5,44
Berwick,4655,8,8,11,17,30,59,-29,35
Edinburgh Ci,4655,9,7,9,20,37,64,-27,30
Cowdenbeath,4655,10,5,10,21,24,54,-30,25
Montrose,4656,1,24,7,5,61,35,26,79
Peterhead,4656,2,23,5,8,78,39,39,74
Stirling,4656,3,17,6,13,63,52,11,57
Clyde,4656,4,15,9,12,52,48,4,54
Stenhousem'r,4656,5,15,8,13,56,49,7,53
Elgin,4656,6,14,6,16,54,62,-8,48
Annan Athlet,4656,7,11,12,13,48,42,6,45
Berwick,4656,8,8,10,18,29,59,-30,34
Edinburgh Ci,4656,9,7,10,19,37,61,-24,31
Cowdenbeath,4656,10,4,11,21,24,55,-31,23
Peterhead,4657,1,24,4,8,81,40,41,76
Montrose,4657,2,23,7,6,59,37,22,76
Stirling,4657,3,17,6,13,63,53,10,57
Clyde,4657,4,15,9,12,54,49,5,54
Stenhousem'r,4657,5,15,8,13,57,49,8,53
Elgin,4657,6,15,6,15,56,60,-4,51
Annan Athlet,4657,7,11,12,13,48,42,6,45
Berwick,4657,8,8,10,18,30,61,-31,34
Edinburgh Ci,4657,9,7,9,20,38,64,-26,30
Cowdenbeath,4657,10,4,11,21,24,55,-31,23
Montrose,4658,1,23,8,5,59,34,25,77
Peterhead,4658,2,24,4,8,81,40,41,76
Stirling,4658,3,16,7,13,63,54,9,55
Stenhousem'r,4658,4,15,9,12,58,49,9,54
Clyde,4658,5,15,9,12,56,49,7,54
Elgin,4658,6,14,7,15,53,60,-7,49
Annan Athlet,4658,7,12,11,13,48,41,7,47
Berwick,4658,8,8,10,18,30,63,-33,34
Edinburgh Ci,4658,9,7,9,20,38,64,-26,30
Cowdenbeath,4658,10,4,10,22,23,55,-32,22
Montrose,4659,1,24,7,5,60,34,26,79
Peterhead,4659,2,24,4,8,79,38,41,76
Stenhousem'r,4659,3,16,8,12,56,46,10,56
Stirling,4659,4,16,6,14,60,52,8,54
Clyde,4659,5,15,9,12,54,48,6,54
Elgin,4659,6,14,6,16,53,61,-8,48
Annan Athlet,4659,7,12,11,13,50,42,8,47
Berwick,4659,8,8,10,18,29,61,-32,34
Edinburgh Ci,4659,9,7,9,20,36,62,-26,30
Cowdenbeath,4659,10,4,10,22,24,57,-33,22
Montrose,4660,1,24,7,5,61,35,26,79
Peterhead,4660,2,24,4,8,82,39,43,76
Stirling,4660,3,16,7,13,60,51,9,55
Stenhousem'r,4660,4,15,9,12,55,46,9,54
Clyde,4660,5,14,10,12,52,49,3,52
Elgin,4660,6,14,6,16,54,62,-8,48
Annan Athlet,4660,7,11,11,14,48,43,5,44
Berwick,4660,8,8,11,17,30,59,-29,35
Edinburgh Ci,4660,9,7,9,20,37,65,-28,30
Cowdenbeath,4660,10,5,10,21,25,55,-30,25
Peterhead,4661,1,24,4,8,81,38,43,76
Montrose,4661,2,23,7,6,60,36,24,76
Stirling,4661,3,17,6,13,64,51,13,57
Stenhousem'r,4661,4,15,8,13,55,50,5,53
Clyde,4661,5,14,10,12,51,48,3,52
Elgin,4661,6,15,6,15,55,61,-6,51
Annan Athlet,4661,7,11,11,14,47,43,4,44
Berwick,4661,8,8,11,17,29,58,-29,35
Edinburgh Ci,4661,9,7,9,20,36,64,-28,30
Cowdenbeath,4661,10,5,10,21,25,54,-29,25
Montrose,4662,1,24,7,5,61,34,27,79
Peterhead,4662,2,23,5,8,78,39,39,74
Stenhousem'r,4662,3,16,8,12,57,46,11,56
Stirling,4662,4,16,6,14,60,53,7,54
Clyde,4662,5,14,10,12,54,51,3,52
Elgin,4662,6,14,6,16,53,62,-9,48
Annan Athlet,4662,7,11,12,13,48,42,6,45
Berwick,4662,8,8,11,17,32,61,-29,35
Edinburgh Ci,4662,9,7,10,19,37,61,-24,31
Cowdenbeath,4662,10,4,11,21,24,55,-31,23
Montrose,4663,1,23,8,5,59,34,25,77
Peterhead,4663,2,24,4,8,83,38,45,76
Stirling,4663,3,16,7,13,61,52,9,55
Stenhousem'r,4663,4,15,9,12,56,47,9,54
Clyde,4663,5,15,9,12,52,48,4,54
Elgin,4663,6,14,7,15,53,60,-7,49
Annan Athlet,4663,7,12,11,13,49,42,7,47
Berwick,4663,8,8,10,18,29,59,-30,34
Edinburgh Ci,4663,9,7,9,20,36,66,-30,30
Cowdenbeath,4663,10,4,10,22,24,56,-32,22
Montrose,4664,1,23,8,5,60,35,25,77
Peterhead,4664,2,24,4,8,79,38,41,76
Stirling,4664,3,17,6,13,63,51,12,57
Clyde,4664,4,15,9,12,53,48,5,54
Stenhousem'r,4664,5,15,8,13,55,49,6,53
Elgin,4664,6,14,7,15,54,61,-7,49
Annan Athlet,4664,7,11,11,14,47,42,5,44
Berwick,4664,8,8,10,18,29,60,-31,34
Edinburgh Ci,4664,9,7,9,20,36,62,-26,30
Cowdenbeath,4664,10,5,10,21,24,54,-30,25
Peterhead,4665,1,24,4,8,82,39,43,76
Montrose,4665,2,23,7,6,59,35,24,76
Stirling,4665,3,17,6,13,65,51,14,57
Stenhousem'r,4665,4,15,8,13,55,51,4,53
Clyde,4665,5,14,10,12,52,49,3,52
Elgin,4665,6,15,6,15,54,60,-6,51
Annan Athlet,4665,7,11,12,13,48,42,6,45
Berwick,4665,8,8,11,17,30,59,-29,35
Edinburgh Ci,4665,9,7,9,20,37,65,-28,30
Cowdenbeath,4665,10,4,11,21,24,55,-31,23
Montrose,4666,1,24,7,5,64,36,28,79
Peterhead,4666,2,24,4,8,80,40,40,76
Stirling,4666,3,17,6,13,66,52,14,57
Stenhousem'r,4666,4,15,8,13,56,52,4,53
Clyde,4666,5,14,10,12,52,49,3,52
Elgin,4666,6,14,6,16,55,65,-10,48
Annan Athlet,4666,7,11,12,13,47,41,6,45
Berwick,4666,8,8,11,17,30,59,-29,35
Edinburgh Ci,4666,9,7,9,20,38,63,-25,30
Cowdenbeath,4666,10,4,11,21,23,54,-31,23
Peterhead,4667,1,24,4,8,82,39,43,76
Montrose,4667,2,23,7,6,60,36,24,76
Stirling,4667,3,16,7,13,61,52,9,55
Stenhousem'r,4667,4,15,9,12,56,47,9,54
Clyde,4667,5,14,10,12,54,51,3,52
Elgin,4667,6,15,6,15,55,61,-6,51
Annan Athlet,4667,7,11,12,13,48,42,6,45
Berwick,4667,8,8,11,17,32,61,-29,35
Edinburgh Ci,4667,9,7,9,20,37,65,-28,30
Cowdenbeath,4667,10,4,11,21,24,55,-31,23
Montrose,4668,1,24,7,5,61,35,26,79
Peterhead,4668,2,23,4,9,77,39,38,73
Stirling,4668,3,17,6,13,66,53,13,57
Stenhousem'r,4668,4,15,8,13,57,52,5,53
Clyde,4668,5,14,10,12,53,50,3,52
Elgin,4668,6,14,6,16,54,62,-8,48
Annan Athlet,4668,7,12,11,13,48,41,7,47
Berwick,4668,8,8,11,17,31,60,-29,35
Edinburgh Ci,4668,9,8,9,19,37,60,-23,33
Cowdenbeath,4668,10,4,10,22,23,55,-32,22
Montrose,4669,1,23,8,5,59,34,25,77
Peterhead,4669,2,24,4,8,80,39,41,76
Stenhousem'r,4669,3,16,8,12,58,48,10,56
Stirling,4669,4,16,6,14,62,54,8,54
Clyde,4669,5,15,9,12,54,48,6,54
Elgin,4669,6,14,7,15,53,60,-7,49
Annan Athlet,4669,7,11,11,14,47,42,5,44
Berwick,4669,8,8,10,18,29,61,-32,34
Edinburgh Ci,4669,9,7,9,20,37,63,-26,30
Cowdenbeath,4669,10,5,10,21,24,54,-30,25
Montrose,4670,1,24,7,5,61,35,26,79
Peterhead,4670,2,24,4,8,81,38,43,76
Stirling,4670,3,16,7,13,60,51,9,55
Stenhousem'r,4670,4,15,9,12,55,46,9,54
Clyde,4670,5,14,10,12,52,49,3,52
Elgin,4670,6,14,6,16,54,62,-8,48
Annan Athlet,4670,7,12,11,13,49,41,8,47
Berwick,4670,8,8,11,17,30,59,-29,35
Edinburgh Ci,4670,9,7,9,20,36,64,-28,30
Cowdenbeath,4670,10,4,10,22,23,56,-33,22
Montrose,4671,1,23,8,5,60,35,25,77
Peterhead,4671,2,23,5,8,79,40,39,74
Stirling,4671,3,17,6,13,62,52,10,57
Clyde,4671,4,15,9,12,53,48,5,54
Stenhousem'r,4671,5,15,8,13,56,48,8,53
Elgin,4671,6,14,7,15,54,61,-7,49
Annan Athlet,4671,7,11,11,14,48,43,5,44
Berwick,4671,8,8,10,18,29,60,-31,34
Edinburgh Ci,4671,9,7,10,19,38,62,-24,31
Cowdenbeath,4671,10,5,10,21,25,55,-30,25
Montrose,4672,1,24,7,5,61,34,27,79
Peterhead,4672,2,24,4,8,80,38,42,76
Stirling,4672,3,17,6,13,62,51,11,57
Clyde,4672,4,15,9,12,53,49,4,54
Stenhousem'r,4672,5,15,8,13,55,48,7,53
Elgin,4672,6,14,6,16,53,62,-9,48
Annan Athlet,4672,7,12,11,13,50,43,7,47
Berwick,4672,8,8,10,18,30,60,-30,34
Edinburgh Ci,4672,9,7,9,20,36,63,-27,30
Cowdenbeath,4672,10,4,10,22,25,57,-32,22
Montrose,4673,1,24,7,5,62,34,28,79
Peterhead,4673,2,24,4,8,79,38,41,76
Stenhousem'r,4673,3,16,8,12,57,47,10,56
Stirling,4673,4,16,6,14,61,53,8,54
Clyde,4673,5,15,9,12,52,48,4,54
Elgin,4673,6,14,6,16,53,63,-10,48
Annan Athlet,4673,7,11,12,13,47,41,6,45
Berwick,4673,8,8,10,18,29,59,-30,34
Edinburgh Ci,4673,9,7,9,20,36,62,-26,30
Cowdenbeath,4673,10,4,11,21,23,54,-31,23
Montrose,4674,1,23,8,5,59,34,25,77
Peterhead,4674,2,24,4,8,80,39,41,76
Stirling,4674,3,17,6,13,63,52,11,57
Clyde,4674,4,15,9,12,55,48,7,54
Stenhousem'r,4674,5,15,8,13,56,49,7,53
Elgin,4674,6,14,7,15,53,60,-7,49
Annan Athlet,4674,7,12,11,13,51,42,9,47
Berwick,4674,8,8,10,18,29,62,-33,34
Edinburgh Ci,4674,9,7,9,20,37,63,-26,30
Cowdenbeath,4674,10,4,10,22,24,58,-34,22
Montrose,4675,1,24,7,5,64,34,30,79
Peterhead,4675,2,24,4,8,83,41,42,76
Stirling,4675,3,16,7,13,60,51,9,55
Stenhousem'r,4675,4,15,9,12,55,46,9,54
Clyde,4675,5,15,9,12,56,48,8,54
Elgin,4675,6,14,6,16,53,65,-12,48
Annan Athlet,4675,7,11,12,13,47,41,6,45
Berwick,4675,8,8,10,18,29,63,-34,34
Edinburgh Ci,4675,9,7,9,20,39,66,-27,30
Cowdenbeath,4675,10,4,11,21,23,54,-31,23
Montrose,4676,1,24,7,5,62,36,26,79
Peterhead,4676,2,23,5,8,79,40,39,74
Stenhousem'r,4676,3,16,8,12,58,48,10,56
Stirling,4676,4,16,6,14,62,54,8,54
Clyde,4676,5,14,10,12,52,49,3,52
Elgin,4676,6,14,6,16,55,63,-8,48
Annan Athlet,4676,7,11,12,13,49,43,6,45
Berwick,4676,8,8,11,17,30,59,-29,35
Edinburgh Ci,4676,9,7,10,19,38,62,-24,31
Cowdenbeath,4676,10,4,11,21,25,56,-31,23
Peterhead,4677,1,24,4,8,80,38,42,76
Montrose,4677,2,23,7,6,59,35,24,76
Stirling,4677,3,17,6,13,62,51,11,57
Stenhousem'r,4677,4,15,8,13,55,48,7,53
Clyde,4677,5,14,9,13,52,50,2,51
Elgin,4677,6,15,6,15,54,60,-6,51
Annan Athlet,4677,7,12,11,13,49,41,8,47
Berwick,4677,8,9,10,17,31,59,-28,37
Edinburgh Ci,4677,9,7,9,20,36,63,-27,30
Cowdenbeath,4677,10,4,10,22,23,56,-33,22
Montrose,4678,1,23,8,5,60,35,25,77
Peterhead,4678,2,23,5,8,78,39,39,74
Stirling,4678,3,16,7,13,62,53,9,55
Stenhousem'r,4678,4,15,9,12,57,48,9,54
Clyde,4678,5,14,10,12,52,49,3,52
Elgin,4678,6,14,7,15,54,61,-7,49
Annan Athlet,4678,7,11,11,14,47,43,4,44
Berwick,4678,8,8,11,17,30,59,-29,35
Edinburgh Ci,4678,9,7,10,19,37,61,-24,31
Cowdenbeath,4678,10,5,10,21,25,54,-29,25
Peterhead,4679,1,24,4,8,83,38,45,76
Montrose,4679,2,23,7,6,59,35,24,76
Stirling,4679,3,17,6,13,62,51,11,57
Stenhousem'r,4679,4,15,8,13,55,48,7,53
Clyde,4679,5,14,10,12,51,48,3,52
Elgin,4679,6,15,6,15,54,60,-6,51
Annan Athlet,4679,7,12,11,13,50,41,9,47
Berwick,4679,8,8,11,17,29,58,-29,35
Edinburgh Ci,4679,9,7,9,20,36,66,-30,30
Cowdenbeath,4679,10,4,10,22,23,57,-34,22
Peterhead,4680,1,24,4,8,81,38,43,76
Montrose,4680,2,23,7,6,61,37,24,76
Stirling,4680,3,17,6,13,62,51,11,57
Stenhousem'r,4680,4,15,8,13,55,48,7,53
Clyde,4680,5,14,9,13,51,49,2,51
Elgin,4680,6,15,6,15,56,62,-6,51
Annan Athlet,4680,7,12,11,13,48,41,7,47
Berwick,4680,8,9,10,17,30,58,-28,37
Edinburgh Ci,4680,9,7,9,20,36,64,-28,30
Cowdenbeath,4680,10,4,10,22,23,55,-32,22
Montrose,4681,1,24,7,5,61,35,26,79
Peterhead,4681,2,24,4,8,80,38,42,76
Stirling,4681,3,17,6,13,61,51,10,57
Stenhousem'r,4681,4,15,8,13,55,47,8,53
Clyde,4681,5,14,9,13,52,50,2,51
Elgin,4681,6,14,6,16,54,62,-8,48
Annan Athlet,4681,7,12,11,13,49,41,8,47
Berwick,4681,8,9,10,17,31,59,-28,37
Edinburgh Ci,4681,9,7,9,20,36,63,-27,30
Cowdenbeath,4681,10,4,10,22,23,56,-33,22
Montrose,4682,1,24,7,5,61,34,27,79
Peterhead,4682,2,23,5,8,77,38,39,74
Stenhousem'r,4682,3,16,8,12,57,46,11,56
Stirling,4682,4,16,6,14,60,53,7,54
Clyde,4682,5,15,9,12,52,48,4,54
Elgin,4682,6,14,6,16,53,62,-9,48
Annan Athlet,4682,7,11,12,13,47,41,6,45
Berwick,4682,8,8,10,18,29,59,-30,34
Edinburgh Ci,4682,9,7,10,19,36,60,-24,31
Cowdenbeath,4682,10,4,11,21,23,54,-31,23
Montrose,4683,1,24,7,5,61,34,27,79
Peterhead,4683,2,24,4,8,79,38,41,76
Stirling,4683,3,17,6,13,61,51,10,57
Clyde,4683,4,15,9,12,55,49,6,54
Stenhousem'r,4683,5,15,8,13,55,47,8,53
Elgin,4683,6,14,6,16,53,62,-9,48
Annan Athlet,4683,7,12,11,13,49,41,8,47
Berwick,4683,8,8,10,18,30,62,-32,34
Edinburgh Ci,4683,9,7,9,20,36,62,-26,30
Cowdenbeath,4683,10,4,10,22,23,56,-33,22
Montrose,4684,1,24,7,5,61,35,26,79
Peterhead,4684,2,23,5,8,78,39,39,74
Stenhousem'r,4684,3,16,8,12,57,47,10,56
Stirling,4684,4,16,6,14,61,53,8,54
Clyde,4684,5,14,9,13,52,50,2,51
Elgin,4684,6,14,6,16,54,62,-8,48
Annan Athlet,4684,7,11,11,14,47,44,3,44
Berwick,4684,8,9,10,17,31,59,-28,37
Edinburgh Ci,4684,9,7,10,19,37,61,-24,31
Cowdenbeath,4684,10,5,10,21,26,54,-28,25
Montrose,4685,1,24,7,5,60,34,26,79
Peterhead,4685,2,24,4,8,80,39,41,76
Stirling,4685,3,17,6,13,61,51,10,57
Stenhousem'r,4685,4,15,8,13,55,47,8,53
Clyde,4685,5,14,9,13,51,49,2,51
Elgin,4685,6,14,6,16,53,61,-8,48
Annan Athlet,4685,7,11,11,14,47,43,4,44
Berwick,4685,8,9,10,17,30,58,-28,37
Edinburgh Ci,4685,9,7,9,20,37,63,-26,30
Cowdenbeath,4685,10,5,10,21,25,54,-29,25
Montrose,4686,1,23,8,5,60,35,25,77
Peterhead,4686,2,24,4,8,79,38,41,76
Stirling,4686,3,17,6,13,64,51,13,57
Stenhousem'r,4686,4,15,8,13,55,50,5,53
Clyde,4686,5,14,9,13,51,49,2,51
Elgin,4686,6,14,7,15,54,61,-7,49
Annan Athlet,4686,7,11,11,14,48,43,5,44
Berwick,4686,8,9,10,17,30,58,-28,37
Edinburgh Ci,4686,9,7,9,20,36,62,-26,30
Cowdenbeath,4686,10,5,10,21,25,55,-30,25
Montrose,4687,1,23,8,5,60,35,25,77
Peterhead,4687,2,24,4,8,81,38,43,76
Stenhousem'r,4687,3,16,8,12,57,47,10,56
Stirling,4687,4,16,6,14,61,53,8,54
Clyde,4687,5,14,9,13,53,51,2,51
Elgin,4687,6,14,7,15,54,61,-7,49
Annan Athlet,4687,7,11,12,13,47,41,6,45
Berwick,4687,8,9,10,17,32,60,-28,37
Edinburgh Ci,4687,9,7,9,20,36,64,-28,30
Cowdenbeath,4687,10,4,11,21,23,54,-31,23
Montrose,4688,1,24,7,5,61,34,27,79
Peterhead,4688,2,24,4,8,78,38,40,76
Stirling,4688,3,17,6,13,63,51,12,57
Stenhousem'r,4688,4,15,8,13,55,49,6,53
Clyde,4688,5,14,9,13,52,51,1,51
Elgin,4688,6,14,6,16,53,62,-9,48
Annan Athlet,4688,7,12,11,13,49,42,7,47
Berwick,4688,8,9,10,17,32,59,-27,37
Edinburgh Ci,4688,9,7,9,20,36,61,-25,30
Cowdenbeath,4688,10,4,10,22,24,56,-32,22
Montrose,4689,1,24,7,5,60,34,26,79
Peterhead,4689,2,24,4,8,81,39,42,76
Stirling,4689,3,17,6,13,63,53,10,57
Stenhousem'r,4689,4,15,8,13,57,49,8,53
Clyde,4689,5,14,10,12,52,49,3,52
Elgin,4689,6,14,6,16,53,61,-8,48
Annan Athlet,4689,7,12,11,13,50,41,9,47
Berwick,4689,8,8,11,17,30,59,-29,35
Edinburgh Ci,4689,9,7,9,20,37,64,-27,30
Cowdenbeath,4689,10,4,10,22,23,57,-34,22
Peterhead,4690,1,24,4,8,78,38,40,76
Montrose,4690,2,23,7,6,59,35,24,76
Stirling,4690,3,16,7,13,63,54,9,55
Stenhousem'r,4690,4,15,9,12,58,49,9,54
Clyde,4690,5,15,9,12,53,48,5,54
Elgin,4690,6,15,6,15,54,60,-6,51
Annan Athlet,4690,7,12,11,13,48,41,7,47
Berwick,4690,8,8,10,18,29,60,-31,34
Edinburgh Ci,4690,9,7,9,20,36,61,-25,30
Cowdenbeath,4690,10,4,10,22,23,55,-32,22
Montrose,4691,1,24,7,5,60,34,26,79
Peterhead,4691,2,24,4,8,79,38,41,76
Stirling,4691,3,17,6,13,61,51,10,57
Clyde,4691,4,15,9,12,54,49,5,54
Stenhousem'r,4691,5,15,8,13,55,47,8,53
Elgin,4691,6,14,6,16,53,61,-8,48
Annan Athlet,4691,7,11,11,14,47,42,5,44
Berwick,4691,8,8,10,18,30,61,-31,34
Edinburgh Ci,4691,9,7,9,20,36,62,-26,30
Cowdenbeath,4691,10,5,10,21,24,54,-30,25
Montrose,4692,1,24,7,5,62,35,27,79
Peterhead,4692,2,24,4,8,79,39,40,76
Stenhousem'r,4692,3,16,8,12,56,46,10,56
Stirling,4692,4,16,6,14,60,52,8,54
Clyde,4692,5,14,10,12,52,49,3,52
Elgin,4692,6,14,6,16,54,63,-9,48
Annan Athlet,4692,7,11,12,13,48,42,6,45
Berwick,4692,8,8,11,17,30,59,-29,35
Edinburgh Ci,4692,9,7,9,20,37,62,-25,30
Cowdenbeath,4692,10,4,11,21,24,55,-31,23
Montrose,4693,1,24,7,5,60,34,26,79
Peterhead,4693,2,24,4,8,79,38,41,76
Stirling,4693,3,17,6,13,64,51,13,57
Clyde,4693,4,15,9,12,53,49,4,54
Stenhousem'r,4693,5,15,8,13,55,50,5,53
Elgin,4693,6,14,6,16,53,61,-8,48
Annan Athlet,4693,7,12,11,13,48,41,7,47
Berwick,4693,8,8,10,18,30,60,-30,34
Edinburgh Ci,4693,9,7,9,20,36,62,-26,30
Cowdenbeath,4693,10,4,10,22,23,55,-32,22
Montrose,4694,1,24,7,5,61,34,27,79
Peterhead,4694,2,24,4,8,81,40,41,76
Stenhousem'r,4694,3,16,8,12,57,46,11,56
Stirling,4694,4,16,6,14,60,53,7,54
Clyde,4694,5,15,9,12,55,48,7,54
Elgin,4694,6,14,6,16,53,62,-9,48
Annan Athlet,4694,7,11,12,13,47,41,6,45
Berwick,4694,8,8,10,18,29,62,-33,34
Edinburgh Ci,4694,9,7,9,20,38,64,-26,30
Cowdenbeath,4694,10,4,11,21,23,54,-31,23
Montrose,4695,1,24,7,5,62,34,28,79
Peterhead,4695,2,24,4,8,79,38,41,76
Stirling,4695,3,17,6,13,63,52,11,57
Clyde,4695,4,15,9,12,52,48,4,54
Stenhousem'r,4695,5,15,8,13,56,49,7,53
Elgin,4695,6,14,6,16,53,63,-10,48
Annan Athlet,4695,7,12,11,13,49,42,7,47
Berwick,4695,8,8,10,18,29,59,-30,34
Edinburgh Ci,4695,9,7,9,20,36,62,-26,30
Cowdenbeath,4695,10,4,10,22,24,56,-32,22
Montrose,4696,1,24,7,5,63,34,29,79
Peterhead,4696,2,24,4,8,80,39,41,76
Stenhousem'r,4696,3,16,8,12,58,46,12,56
Stirling,4696,4,16,6,14,60,54,6,54
Clyde,4696,5,14,9,13,51,49,2,51
Elgin,4696,6,14,6,16,53,64,-11,48
Annan Athlet,4696,7,11,11,14,47,42,5,44
Berwick,4696,8,9,10,17,30,58,-28,37
Edinburgh Ci,4696,9,7,9,20,37,63,-26,30
Cowdenbeath,4696,10,5,10,21,24,54,-30,25
Montrose,4697,1,23,8,5,60,35,25,77
Peterhead,4697,2,24,4,8,79,38,41,76
Stirling,4697,3,16,7,13,63,54,9,55
Stenhousem'r,4697,4,15,9,12,58,49,9,54
Clyde,4697,5,15,9,12,53,48,5,54
Elgin,4697,6,14,7,15,54,61,-7,49
Annan Athlet,4697,7,12,11,13,48,41,7,47
Berwick,4697,8,8,10,18,29,60,-31,34
Edinburgh Ci,4697,9,7,9,20,36,62,-26,30
Cowdenbeath,4697,10,4,10,22,23,55,-32,22
Montrose,4698,1,23,8,5,61,36,25,77
Peterhead,4698,2,23,5,8,78,39,39,74
Stenhousem'r,4698,3,16,8,12,57,47,10,56
Stirling,4698,4,16,6,14,61,53,8,54
Clyde,4698,5,14,10,12,52,49,3,52
Elgin,4698,6,14,7,15,55,62,-7,49
Annan Athlet,4698,7,11,12,13,48,42,6,45
Berwick,4698,8,8,11,17,30,59,-29,35
Edinburgh Ci,4698,9,7,10,19,37,61,-24,31
Cowdenbeath,4698,10,4,11,21,24,55,-31,23
Montrose,4699,1,23,7,6,60,37,23,76
Peterhead,4699,2,23,4,9,77,40,37,73
Stirling,4699,3,17,6,13,62,51,11,57
Clyde,4699,4,15,9,12,54,50,4,54
Stenhousem'r,4699,5,15,8,13,55,48,7,53
Elgin,4699,6,15,6,15,56,61,-5,51
Annan Athlet,4699,7,12,11,13,50,43,7,47
Berwick,4699,8,8,10,18,31,61,-30,34
Edinburgh Ci,4699,9,8,9,19,38,60,-22,33
Cowdenbeath,4699,10,4,10,22,25,57,-32,22
Montrose,4700,1,24,7,5,61,34,27,79
Peterhead,4700,2,24,4,8,81,40,41,76
Stirling,4700,3,17,6,13,62,51,11,57
Stenhousem'r,4700,4,15,8,13,55,48,7,53
Clyde,4700,5,14,10,12,52,49,3,52
Elgin,4700,6,14,6,16,53,62,-9,48
Annan Athlet,4700,7,11,11,14,48,43,5,44
Berwick,4700,8,8,11,17,30,59,-29,35
Edinburgh Ci,4700,9,7,9,20,38,64,-26,30
Cowdenbeath,4700,10,5,10,21,25,55,-30,25
Montrose,4701,1,24,7,5,63,37,26,79
Peterhead,4701,2,24,4,8,82,39,43,76
Stirling,4701,3,17,6,13,65,52,13,57
Clyde,4701,4,15,9,12,53,49,4,54
Stenhousem'r,4701,5,15,8,13,56,51,5,53
Elgin,4701,6,14,6,16,56,64,-8,48
Annan Athlet,4701,7,12,11,13,49,42,7,47
Berwick,4701,8,8,10,18,30,60,-30,34
Edinburgh Ci,4701,9,7,9,20,37,65,-28,30
Cowdenbeath,4701,10,4,10,22,24,56,-32,22
Montrose,4702,1,24,7,5,61,34,27,79
Peterhead,4702,2,23,5,8,79,40,39,74
Stenhousem'r,4702,3,16,8,12,57,47,10,56
Stirling,4702,4,16,6,14,61,53,8,54
Clyde,4702,5,15,9,12,52,48,4,54
Elgin,4702,6,14,6,16,53,62,-9,48
Annan Athlet,4702,7,11,12,13,47,41,6,45
Berwick,4702,8,8,10,18,29,59,-30,34
Edinburgh Ci,4702,9,7,10,19,38,62,-24,31
Cowdenbeath,4702,10,4,11,21,23,54,-31,23
Montrose,4703,1,24,7,5,62,34,28,79
Peterhead,4703,2,24,4,8,81,39,42,76
Stirling,4703,3,17,6,13,61,51,10,57
Clyde,4703,4,15,9,12,54,49,5,54
Stenhousem'r,4703,5,15,8,13,55,47,8,53
Elgin,4703,6,14,6,16,53,63,-10,48
Annan Athlet,4703,7,11,11,14,47,43,4,44
Berwick,4703,8,8,10,18,30,61,-31,34
Edinburgh Ci,4703,9,7,9,20,37,64,-27,30
Cowdenbeath,4703,10,5,10,21,25,54,-29,25
Peterhead,4704,1,24,4,8,82,42,40,76
Montrose,4704,2,23,7,6,59,35,24,76
Stirling,4704,3,16,7,13,62,53,9,55
Stenhousem'r,4704,4,15,9,12,57,48,9,54
Clyde,4704,5,14,9,13,51,50,1,51
Elgin,4704,6,15,6,15,54,60,-6,51
Annan Athlet,4704,7,12,11,13,49,41,8,47
Berwick,4704,8,9,10,17,31,58,-27,37
Edinburgh Ci,4704,9,7,9,20,40,65,-25,30
Cowdenbeath,4704,10,4,10,22,23,56,-33,22
Montrose,4705,1,23,8,5,60,35,25,77
Peterhead,4705,2,24,4,8,79,38,41,76
Stenhousem'r,4705,3,16,8,12,59,47,12,56
Stirling,4705,4,16,6,14,61,55,6,54
Clyde,4705,5,15,9,12,54,50,4,54
Elgin,4705,6,14,7,15,54,61,-7,49
Annan Athlet,4705,7,11,12,13,48,42,6,45
Berwick,4705,8,8,10,18,31,61,-30,34
Edinburgh Ci,4705,9,7,9,20,36,62,-26,30
Cowdenbeath,4705,10,4,11,21,24,55,-31,23
Peterhead,4706,1,24,4,8,79,39,40,76
Montrose,4706,2,23,7,6,60,36,24,76
Stirling,4706,3,17,6,13,61,51,10,57
Stenhousem'r,4706,4,15,8,13,55,47,8,53
Clyde,4706,5,14,10,12,53,50,3,52
Elgin,4706,6,15,6,15,55,61,-6,51
Annan Athlet,4706,7,11,11,14,48,45,3,44
Berwick,4706,8,8,11,17,31,60,-29,35
Edinburgh Ci,4706,9,7,9,20,37,62,-25,30
Cowdenbeath,4706,10,5,10,21,27,55,-28,25
Montrose,4707,1,23,8,5,61,36,25,77
Peterhead,4707,2,23,5,8,78,39,39,74
Stenhousem'r,4707,3,16,8,12,57,46,11,56
Stirling,4707,4,16,6,14,60,53,7,54
Clyde,4707,5,14,9,13,51,50,1,51
Elgin,4707,6,14,7,15,55,62,-7,49
Annan Athlet,4707,7,11,12,13,48,42,6,45
Berwick,4707,8,9,10,17,31,58,-27,37
Edinburgh Ci,4707,9,7,10,19,37,61,-24,31
Cowdenbeath,4707,10,4,11,21,24,55,-31,23
Montrose,4708,1,24,7,5,64,37,27,79
Peterhead,4708,2,24,4,8,81,38,43,76
Stirling,4708,3,17,6,13,62,51,11,57
Clyde,4708,4,15,9,12,53,49,4,54
Stenhousem'r,4708,5,15,8,13,55,48,7,53
Elgin,4708,6,14,6,16,56,65,-9,48
Annan Athlet,4708,7,11,11,14,47,42,5,44
Berwick,4708,8,8,10,18,30,60,-30,34
Edinburgh Ci,4708,9,7,9,20,36,64,-28,30
Cowdenbeath,4708,10,5,10,21,24,54,-30,25
Montrose,4709,1,24,7,5,61,35,26,79
Peterhead,4709,2,23,5,8,78,39,39,74
Stirling,4709,3,16,7,13,62,53,9,55
Stenhousem'r,4709,4,15,9,12,57,48,9,54
Clyde,4709,5,14,9,13,52,50,2,51
Elgin,4709,6,14,6,16,54,62,-8,48
Annan Athlet,4709,7,12,11,13,48,41,7,47
Berwick,4709,8,9,10,17,31,59,-28,37
Edinburgh Ci,4709,9,7,10,19,37,61,-24,31
Cowdenbeath,4709,10,4,10,22,23,55,-32,22
Montrose,4710,1,23,7,6,60,36,24,76
Peterhead,4710,2,23,5,8,77,38,39,74
Stirling,4710,3,17,6,13,63,52,11,57
Stenhousem'r,4710,4,15,8,13,56,49,7,53
Clyde,4710,5,14,9,13,51,49,2,51
Elgin,4710,6,15,6,15,55,61,-6,51
Annan Athlet,4710,7,11,11,14,47,42,5,44
Berwick,4710,8,9,10,17,30,58,-28,37
Edinburgh Ci,4710,9,7,10,19,36,60,-24,31
Cowdenbeath,4710,10,5,10,21,24,54,-30,25
Montrose,4711,1,24,7,5,61,34,27,79
Peterhead,4711,2,24,4,8,82,39,43,76
Stirling,4711,3,17,6,13,64,53,11,57
Stenhousem'r,4711,4,15,8,13,57,50,7,53
Clyde,4711,5,14,9,13,52,51,1,51
Elgin,4711,6,14,6,16,53,62,-9,48
Annan Athlet,4711,7,12,11,13,48,41,7,47
Berwick,4711,8,9,10,17,32,59,-27,37
Edinburgh Ci,4711,9,7,9,20,37,65,-28,30
Cowdenbeath,4711,10,4,10,22,23,55,-32,22
Montrose,4712,1,24,7,5,62,35,27,79
Peterhead,4712,2,24,4,8,78,38,40,76
Stirling,4712,3,16,7,13,62,53,9,55
Stenhousem'r,4712,4,15,9,12,57,48,9,54
Clyde,4712,5,15,9,12,53,49,4,54
Elgin,4712,6,14,6,16,54,63,-9,48
Annan Athlet,4712,7,11,11,14,47,42,5,44
Berwick,4712,8,8,10,18,30,60,-30,34
Edinburgh Ci,4712,9,7,9,20,36,61,-25,30
Cowdenbeath,4712,10,5,10,21,24,54,-30,25
Montrose,4713,1,23,8,5,60,35,25,77
Peterhead,4713,2,24,4,8,81,40,41,76
Stirling,4713,3,16,7,13,61,52,9,55
Stenhousem'r,4713,4,15,9,12,56,47,9,54
Clyde,4713,5,15,9,12,52,48,4,54
Elgin,4713,6,14,7,15,54,61,-7,49
Annan Athlet,4713,7,11,11,14,47,44,3,44
Berwick,4713,8,8,10,18,29,59,-30,34
Edinburgh Ci,4713,9,7,9,20,38,64,-26,30
Cowdenbeath,4713,10,5,10,21,26,54,-28,25
Montrose,4714,1,24,7,5,63,35,28,79
Peterhead,4714,2,23,5,8,81,42,39,74
Stirling,4714,3,16,7,13,60,51,9,55
Stenhousem'r,4714,4,15,9,12,55,46,9,54
Clyde,4714,5,15,9,12,54,48,6,54
Elgin,4714,6,14,6,16,54,64,-10,48
Annan Athlet,4714,7,12,11,13,48,41,7,47
Berwick,4714,8,8,10,18,29,61,-32,34
Edinburgh Ci,4714,9,7,10,19,40,64,-24,31
Cowdenbeath,4714,10,4,10,22,23,55,-32,22
Montrose,4715,1,23,8,5,60,35,25,77
Peterhead,4715,2,23,5,8,78,39,39,74
Stenhousem'r,4715,3,16,8,12,57,47,10,56
Stirling,4715,4,16,6,14,61,53,8,54
Clyde,4715,5,14,9,13,52,51,1,51
Elgin,4715,6,14,7,15,54,61,-7,49
Annan Athlet,4715,7,11,12,13,48,42,6,45
Berwick,4715,8,9,10,17,32,59,-27,37
Edinburgh Ci,4715,9,7,10,19,37,61,-24,31
Cowdenbeath,4715,10,4,11,21,24,55,-31,23
Montrose,4716,1,24,7,5,66,37,29,79
Peterhead,4716,2,24,4,8,80,38,42,76
Stenhousem'r,4716,3,16,8,12,59,48,11,56
Stirling,4716,4,16,6,14,62,55,7,54
Clyde,4716,5,15,9,12,53,48,5,54
Elgin,4716,6,14,6,16,56,67,-11,48
Annan Athlet,4716,7,11,12,13,48,42,6,45
Berwick,4716,8,8,10,18,29,60,-31,34
Edinburgh Ci,4716,9,7,9,20,36,63,-27,30
Cowdenbeath,4716,10,4,11,21,24,55,-31,23
Peterhead,4717,1,24,4,8,80,40,40,76
Montrose,4717,2,23,7,6,60,37,23,76
Stirling,4717,3,17,6,13,63,52,11,57
Stenhousem'r,4717,4,15,8,13,56,49,7,53
Clyde,4717,5,14,9,13,51,49,2,51
Elgin,4717,6,15,6,15,56,61,-5,51
Annan Athlet,4717,7,11,11,14,47,42,5,44
Berwick,4717,8,9,10,17,30,58,-28,37
Edinburgh Ci,4717,9,7,9,20,38,63,-25,30
Cowdenbeath,4717,10,5,10,21,24,54,-30,25
Montrose,4718,1,24,7,5,63,35,28,79
Peterhead,4718,2,24,4,8,79,39,40,76
Stenhousem'r,4718,3,16,8,12,58,46,12,56
Stirling,4718,4,16,6,14,60,54,6,54
Clyde,4718,5,14,9,13,52,50,2,51
Elgin,4718,6,14,6,16,54,64,-10,48
Annan Athlet,4718,7,11,12,13,48,42,6,45
Berwick,4718,8,9,10,17,31,59,-28,37
Edinburgh Ci,4718,9,7,9,20,37,62,-25,30
Cowdenbeath,4718,10,4,11,21,24,55,-31,23
Montrose,4719,1,24,7,5,62,35,27,79
Peterhead,4719,2,24,4,8,79,39,40,76
Stenhousem'r,4719,3,16,8,12,57,47,10,56
Stirling,4719,4,16,6,14,61,53,8,54
Clyde,4719,5,15,9,12,53,49,4,54
Elgin,4719,6,14,6,16,54,63,-9,48
Annan Athlet,4719,7,11,12,13,47,41,6,45
Berwick,4719,8,8,10,18,30,60,-30,34
Edinburgh Ci,4719,9,7,9,20,37,62,-25,30
Cowdenbeath,4719,10,4,11,21,23,54,-31,23
Montrose,4720,1,24,7,5,62,35,27,79
Peterhead,4720,2,24,4,8,81,38,43,76
Stenhousem'r,4720,3,16,8,12,57,46,11,56
Stirling,4720,4,16,6,14,60,53,7,54
Clyde,4720,5,15,9,12,53,49,4,54
Elgin,4720,6,14,6,16,54,63,-9,48
Annan Athlet,4720,7,11,12,13,47,41,6,45
Berwick,4720,8,8,10,18,30,60,-30,34
Edinburgh Ci,4720,9,7,9,20,36,64,-28,30
Cowdenbeath,4720,10,4,11,21,23,54,-31,23
Montrose,4721,1,24,7,5,63,34,29,79
Peterhead,4721,2,24,4,8,80,38,42,76
Stirling,4721,3,17,6,13,64,52,12,57
Stenhousem'r,4721,4,15,8,13,56,50,6,53
Clyde,4721,5,14,10,12,53,50,3,52
Elgin,4721,6,14,6,16,53,64,-11,48
Annan Athlet,4721,7,11,12,13,48,42,6,45
Berwick,4721,8,8,11,17,31,60,-29,35
Edinburgh Ci,4721,9,7,9,20,36,63,-27,30
Cowdenbeath,4721,10,4,11,21,24,55,-31,23
Montrose,4722,1,24,7,5,61,35,26,79
Peterhead,4722,2,24,4,8,82,38,44,76
Stenhousem'r,4722,3,16,8,12,58,48,10,56
Stirling,4722,4,16,6,14,62,54,8,54
Clyde,4722,5,14,9,13,51,49,2,51
Elgin,4722,6,14,6,16,54,62,-8,48
Annan Athlet,4722,7,11,11,14,47,43,4,44
Berwick,4722,8,9,10,17,30,58,-28,37
Edinburgh Ci,4722,9,7,9,20,36,65,-29,30
Cowdenbeath,4722,10,5,10,21,25,54,-29,25
Montrose,4723,1,23,8,5,59,34,25,77
Peterhead,4723,2,24,4,8,80,39,41,76
Stirling,4723,3,17,6,13,62,52,10,57
Stenhousem'r,4723,4,15,8,13,56,48,8,53
Clyde,4723,5,14,9,13,51,49,2,51
Elgin,4723,6,14,7,15,53,60,-7,49
Annan Athlet,4723,7,12,11,13,49,42,7,47
Berwick,4723,8,9,10,17,30,58,-28,37
Edinburgh Ci,4723,9,7,9,20,37,63,-26,30
Cowdenbeath,4723,10,4,10,22,24,56,-32,22
Montrose,4724,1,24,7,5,63,34,29,79
Peterhead,4724,2,23,5,8,80,41,39,74
Stirling,4724,3,16,7,13,62,53,9,55
Stenhousem'r,4724,4,15,9,12,57,48,9,54
Clyde,4724,5,14,9,13,51,49,2,51
Elgin,4724,6,14,6,16,53,64,-11,48
Annan Athlet,4724,7,12,11,13,49,41,8,47
Berwick,4724,8,9,10,17,30,58,-28,37
Edinburgh Ci,4724,9,7,10,19,39,63,-24,31
Cowdenbeath,4724,10,4,10,22,23,56,-33,22
Montrose,4725,1,24,7,5,61,35,26,79
Peterhead,4725,2,24,4,8,79,38,41,76
Stirling,4725,3,17,6,13,65,51,14,57
Clyde,4725,4,15,9,12,53,49,4,54
Stenhousem'r,4725,5,15,8,13,55,51,4,53
Elgin,4725,6,14,6,16,54,62,-8,48
Annan Athlet,4725,7,12,11,13,49,41,8,47
Berwick,4725,8,8,10,18,30,60,-30,34
Edinburgh Ci,4725,9,7,9,20,36,62,-26,30
Cowdenbeath,4725,10,4,10,22,23,56,-33,22
Peterhead,4726,1,24,4,8,82,38,44,76
Montrose,4726,2,23,7,6,59,36,23,76
Stirling,4726,3,16,7,13,61,52,9,55
Stenhousem'r,4726,4,15,9,12,56,47,9,54
Clyde,4726,5,14,9,13,52,50,2,51
Elgin,4726,6,15,6,15,55,60,-5,51
Annan Athlet,4726,7,11,11,14,47,42,5,44
Berwick,4726,8,9,10,17,31,59,-28,37
Edinburgh Ci,4726,9,7,9,20,36,65,-29,30
Cowdenbeath,4726,10,5,10,21,24,54,-30,25
Montrose,4727,1,23,8,5,60,35,25,77
Peterhead,4727,2,23,5,8,79,40,39,74
Stenhousem'r,4727,3,16,8,12,58,47,11,56
Stirling,4727,4,16,6,14,61,54,7,54
Clyde,4727,5,14,10,12,52,49,3,52
Elgin,4727,6,14,7,15,54,61,-7,49
Annan Athlet,4727,7,12,11,13,49,42,7,47
Berwick,4727,8,8,11,17,30,59,-29,35
Edinburgh Ci,4727,9,7,10,19,38,62,-24,31
Cowdenbeath,4727,10,4,10,22,24,56,-32,22
Montrose,4728,1,24,7,5,60,34,26,79
Peterhead,4728,2,23,4,9,77,39,38,73
Stirling,4728,3,16,7,13,61,52,9,55
Clyde,4728,4,15,9,12,58,48,10,54
Stenhousem'r,4728,5,15,9,12,56,47,9,54
Elgin,4728,6,14,6,16,53,61,-8,48
Annan Athlet,4728,7,11,12,13,48,42,6,45
Berwick,4728,8,8,10,18,29,65,-36,34
Edinburgh Ci,4728,9,8,9,19,37,60,-23,33
Cowdenbeath,4728,10,4,11,21,24,55,-31,23
Peterhead,4729,1,24,4,8,79,38,41,76
Montrose,4729,2,23,7,6,60,36,24,76
Stirling,4729,3,17,6,13,62,52,10,57
Stenhousem'r,4729,4,15,8,13,56,48,8,53
Clyde,4729,5,14,10,12,51,48,3,52
Elgin,4729,6,15,6,15,55,61,-6,51
Annan Athlet,4729,7,11,11,14,47,43,4,44
Berwick,4729,8,8,11,17,29,58,-29,35
Edinburgh Ci,4729,9,7,9,20,36,62,-26,30
Cowdenbeath,4729,10,5,10,21,25,54,-29,25
Montrose,4730,1,24,7,5,63,35,28,79
Peterhead,4730,2,23,4,9,80,42,38,73
Stirling,4730,3,17,6,13,61,51,10,57
Stenhousem'r,4730,4,15,8,13,55,47,8,53
Clyde,4730,5,14,10,12,52,49,3,52
Elgin,4730,6,14,6,16,54,64,-10,48
Annan Athlet,4730,7,11,12,13,47,41,6,45
Berwick,4730,8,8,11,17,30,59,-29,35
Edinburgh Ci,4730,9,8,9,19,40,63,-23,33
Cowdenbeath,4730,10,4,11,21,23,54,-31,23
Montrose,4731,1,24,7,5,62,36,26,79
Peterhead,4731,2,24,4,8,81,39,42,76
Stirling,4731,3,17,6,13,64,52,12,57
Stenhousem'r,4731,4,15,8,13,56,50,6,53
Clyde,4731,5,14,9,13,51,51,0,51
Elgin,4731,6,14,6,16,55,63,-8,48
Annan Athlet,4731,7,11,12,13,47,41,6,45
Berwick,4731,8,9,10,17,32,58,-26,37
Edinburgh Ci,4731,9,7,9,20,37,64,-27,30
Cowdenbeath,4731,10,4,11,21,23,54,-31,23
Montrose,4732,1,24,7,5,61,34,27,79
Peterhead,4732,2,23,5,8,77,38,39,74
Stirling,4732,3,17,6,13,61,51,10,57
Clyde,4732,4,15,9,12,53,48,5,54
Stenhousem'r,4732,5,15,8,13,55,47,8,53
Elgin,4732,6,14,6,16,53,62,-9,48
Annan Athlet,4732,7,12,11,13,48,41,7,47
Berwick,4732,8,8,10,18,29,60,-31,34
Edinburgh Ci,4732,9,7,10,19,36,60,-24,31
Cowdenbeath,4732,10,4,10,22,23,55,-32,22
Peterhead,4733,1,24,4,8,81,38,43,76
Montrose,4733,2,23,7,6,60,38,22,76
Stirling,4733,3,17,6,13,61,51,10,57
Stenhousem'r,4733,4,15,8,13,55,47,8,53
Clyde,4733,5,14,9,13,51,50,1,51
Elgin,4733,6,15,6,15,57,61,-4,51
Annan Athlet,4733,7,12,11,13,49,41,8,47
Berwick,4733,8,9,10,17,31,58,-27,37
Edinburgh Ci,4733,9,7,9,20,36,64,-28,30
Cowdenbeath,4733,10,4,10,22,23,56,-33,22
Montrose,4734,1,24,7,5,61,34,27,79
Peterhead,4734,2,24,4,8,79,39,40,76
Stirling,4734,3,17,6,13,62,51,11,57
Clyde,4734,4,15,9,12,55,49,6,54
Stenhousem'r,4734,5,15,8,13,55,48,7,53
Elgin,4734,6,14,6,16,53,62,-9,48
Annan Athlet,4734,7,11,11,14,49,44,5,44
Berwick,4734,8,8,10,18,30,62,-32,34
Edinburgh Ci,4734,9,7,9,20,37,62,-25,30
Cowdenbeath,4734,10,5,10,21,26,56,-30,25
Montrose,4735,1,23,7,6,59,35,24,76
Peterhead,4735,2,23,5,8,77,38,39,74
Stirling,4735,3,17,6,13,68,53,15,57
Stenhousem'r,4735,4,15,8,13,57,54,3,53
Clyde,4735,5,14,10,12,51,48,3,52
Elgin,4735,6,15,6,15,54,60,-6,51
Annan Athlet,4735,7,12,11,13,48,41,7,47
Berwick,4735,8,8,11,17,29,58,-29,35
Edinburgh Ci,4735,9,7,10,19,36,60,-24,31
Cowdenbeath,4735,10,4,10,22,23,55,-32,22
Montrose,4736,1,24,7,5,61,35,26,79
Peterhead,4736,2,24,4,8,79,38,41,76
Stirling,4736,3,17,6,13,62,51,11,57
Clyde,4736,4,15,9,12,53,49,4,54
Stenhousem'r,4736,5,15,8,13,55,48,7,53
Elgin,4736,6,14,6,16,54,62,-8,48
Annan Athlet,4736,7,11,11,14,48,43,5,44
Berwick,4736,8,8,10,18,30,60,-30,34
Edinburgh Ci,4736,9,7,9,20,36,62,-26,30
Cowdenbeath,4736,10,5,10,21,25,55,-30,25
Montrose,4737,1,23,8,5,59,34,25,77
Peterhead,4737,2,24,4,8,80,40,40,76
Stirling,4737,3,17,6,13,63,51,12,57
Stenhousem'r,4737,4,15,8,13,55,49,6,53
Clyde,4737,5,14,9,13,52,51,1,51
Elgin,4737,6,14,7,15,53,60,-7,49
Annan Athlet,4737,7,12,11,13,48,41,7,47
Berwick,4737,8,9,10,17,32,59,-27,37
Edinburgh Ci,4737,9,7,9,20,38,63,-25,30
Cowdenbeath,4737,10,4,10,22,23,55,-32,22
Montrose,4738,1,23,8,5,61,36,25,77
Peterhead,4738,2,24,4,8,81,40,41,76
Stenhousem'r,4738,3,16,8,12,57,47,10,56
Stirling,4738,4,16,6,14,61,53,8,54
Clyde,4738,5,15,9,12,52,48,4,54
Elgin,4738,6,14,7,15,55,62,-7,49
Annan Athlet,4738,7,11,12,13,47,41,6,45
Berwick,4738,8,8,10,18,29,59,-30,34
Edinburgh Ci,4738,9,7,9,20,38,64,-26,30
Cowdenbeath,4738,10,4,11,21,23,54,-31,23
Peterhead,4739,1,24,4,8,79,39,40,76
Montrose,4739,2,23,7,6,60,36,24,76
Stirling,4739,3,17,6,13,64,51,13,57
Stenhousem'r,4739,4,15,8,13,55,50,5,53
Clyde,4739,5,14,10,12,51,48,3,52
Elgin,4739,6,15,6,15,55,61,-6,51
Annan Athlet,4739,7,11,11,14,47,42,5,44
Berwick,4739,8,8,11,17,29,58,-29,35
Edinburgh Ci,4739,9,7,9,20,37,62,-25,30
Cowdenbeath,4739,10,5,10,21,24,54,-30,25
Montrose,4740,1,24,7,5,64,35,29,79
Peterhead,4740,2,23,5,8,78,39,39,74
Stenhousem'r,4740,3,16,8,12,57,46,11,56
Stirling,4740,4,16,6,14,60,53,7,54
Clyde,4740,5,15,9,12,52,48,4,54
Elgin,4740,6,14,6,16,54,65,-11,48
Annan Athlet,4740,7,12,11,13,52,41,11,47
Berwick,4740,8,8,10,18,29,59,-30,34
Edinburgh Ci,4740,9,7,10,19,37,61,-24,31
Cowdenbeath,4740,10,4,10,22,23,59,-36,22
Montrose,4741,1,24,7,5,61,35,26,79
Peterhead,4741,2,24,4,8,81,38,43,76
Stirling,4741,3,17,6,13,61,51,10,57
Clyde,4741,4,15,9,12,54,49,5,54
Stenhousem'r,4741,5,15,8,13,55,47,8,53
Elgin,4741,6,14,6,16,54,62,-8,48
Annan Athlet,4741,7,11,11,14,48,46,2,44
Berwick,4741,8,8,10,18,30,61,-31,34
Edinburgh Ci,4741,9,7,9,20,36,64,-28,30
Cowdenbeath,4741,10,5,10,21,28,55,-27,25
Montrose,4742,1,24,7,5,61,35,26,79
Peterhead,4742,2,24,4,8,83,39,44,76
Stirling,4742,3,17,6,13,63,52,11,57
Clyde,4742,4,15,9,12,52,48,4,54
Stenhousem'r,4742,5,15,8,13,56,49,7,53
Elgin,4742,6,14,6,16,54,62,-8,48
Annan Athlet,4742,7,11,11,14,48,44,4,44
Berwick,4742,8,8,10,18,29,59,-30,34
Edinburgh Ci,4742,9,7,9,20,37,66,-29,30
Cowdenbeath,4742,10,5,10,21,26,55,-29,25
Montrose,4743,1,23,8,5,63,38,25,77
Peterhead,4743,2,23,5,8,77,38,39,74
Stirling,4743,3,17,6,13,61,51,10,57
Stenhousem'r,4743,4,15,8,13,55,47,8,53
Clyde,4743,5,14,9,13,52,50,2,51
Elgin,4743,6,14,7,15,57,64,-7,49
Annan Athlet,4743,7,12,11,13,51,43,8,47
Berwick,4743,8,9,10,17,31,59,-28,37
Edinburgh Ci,4743,9,7,10,19,36,60,-24,31
Cowdenbeath,4743,10,4,10,22,25,58,-33,22
Montrose,4744,1,24,7,5,63,34,29,79
Peterhead,4744,2,24,4,8,81,38,43,76
Stirling,4744,3,17,6,13,63,52,11,57
Clyde,4744,4,15,9,12,54,48,6,54
Stenhousem'r,4744,5,15,8,13,56,49,7,53
Elgin,4744,6,14,6,16,53,64,-11,48
Annan Athlet,4744,7,11,12,13,48,42,6,45
Berwick,4744,8,8,10,18,29,61,-32,34
Edinburgh Ci,4744,9,7,9,20,36,64,-28,30
Cowdenbeath,4744,10,4,11,21,24,55,-31,23
Montrose,4745,1,24,7,5,61,35,26,79
Peterhead,4745,2,24,4,8,79,39,40,76
Stirling,4745,3,17,6,13,63,52,11,57
Stenhousem'r,4745,4,15,8,13,56,49,7,53
Clyde,4745,5,14,9,13,52,50,2,51
Elgin,4745,6,14,6,16,54,62,-8,48
Annan Athlet,4745,7,11,12,13,47,41,6,45
Berwick,4745,8,9,10,17,31,59,-28,37
Edinburgh Ci,4745,9,7,9,20,37,62,-25,30
Cowdenbeath,4745,10,4,11,21,23,54,-31,23
Peterhead,4746,1,24,4,8,81,40,41,76
Montrose,4746,2,23,7,6,59,36,23,76
Stirling,4746,3,17,6,13,63,51,12,57
Clyde,4746,4,15,9,12,55,51,4,54
Stenhousem'r,4746,5,15,8,13,55,49,6,53
Elgin,4746,6,15,6,15,55,60,-5,51
Annan Athlet,4746,7,11,12,13,48,42,6,45
Berwick,4746,8,8,10,18,32,62,-30,34
Edinburgh Ci,4746,9,7,9,20,38,64,-26,30
Cowdenbeath,4746,10,4,11,21,24,55,-31,23
Peterhead,4747,1,24,4,8,81,39,42,76
Montrose,4747,2,23,7,6,61,38,23,76
Stirling,4747,3,16,7,13,62,53,9,55
Stenhousem'r,4747,4,15,9,12,57,48,9,54
Clyde,4747,5,15,9,12,52,48,4,54
Elgin,4747,6,15,6,15,57,62,-5,51
Annan Athlet,4747,7,12,11,13,48,41,7,47
Berwick,4747,8,8,10,18,29,59,-30,34
Edinburgh Ci,4747,9,7,9,20,37,64,-27,30
Cowdenbeath,4747,10,4,10,22,23,55,-32,22
Montrose,4748,1,23,8,5,60,35,25,77
Peterhead,4748,2,23,5,8,78,39,39,74
Stirling,4748,3,16,7,13,62,53,9,55
Stenhousem'r,4748,4,15,9,12,57,48,9,54
Clyde,4748,5,15,9,12,53,49,4,54
Elgin,4748,6,14,7,15,54,61,-7,49
Annan Athlet,4748,7,11,11,14,47,42,5,44
Berwick,4748,8,8,10,18,30,60,-30,34
Edinburgh Ci,4748,9,7,10,19,37,61,-24,31
Cowdenbeath,4748,10,5,10,21,24,54,-30,25
Montrose,4749,1,24,7,5,64,35,29,79
Peterhead,4749,2,24,4,8,79,38,41,76
Stirling,4749,3,16,7,13,61,52,9,55
Stenhousem'r,4749,4,15,9,12,56,47,9,54
Clyde,4749,5,14,9,13,53,51,2,51
Elgin,4749,6,14,6,16,54,65,-11,48
Annan Athlet,4749,7,11,11,14,47,44,3,44
Berwick,4749,8,9,10,17,32,60,-28,37
Edinburgh Ci,4749,9,7,9,20,36,62,-26,30
Cowdenbeath,4749,10,5,10,21,26,54,-28,25
Peterhead,4750,1,24,4,8,78,38,40,76
Montrose,4750,2,23,7,6,60,36,24,76
Stirling,4750,3,17,6,13,62,52,10,57
Clyde,4750,4,15,9,12,52,48,4,54
Stenhousem'r,4750,5,15,8,13,56,48,8,53
Elgin,4750,6,15,6,15,55,61,-6,51
Annan Athlet,4750,7,12,11,13,49,42,7,47
Berwick,4750,8,8,10,18,29,59,-30,34
Edinburgh Ci,4750,9,7,9,20,36,61,-25,30
Cowdenbeath,4750,10,4,10,22,24,56,-32,22
Peterhead,4751,1,24,4,8,81,38,43,76
Montrose,4751,2,23,7,6,59,37,22,76
Stirling,4751,3,17,6,13,62,51,11,57
Stenhousem'r,4751,4,15,8,13,55,48,7,53
Clyde,4751,5,14,9,13,52,50,2,51
Elgin,4751,6,15,6,15,56,60,-4,51
Annan Athlet,4751,7,12,11,13,49,42,7,47
Berwick,4751,8,9,10,17,31,59,-28,37
Edinburgh Ci,4751,9,7,9,20,36,64,-28,30
Cowdenbeath,4751,10,4,10,22,24,56,-32,22
Peterhead,4752,1,24,4,8,80,40,40,76
Montrose,4752,2,23,7,6,60,37,23,76
Stirling,4752,3,16,7,13,60,51,9,55
Stenhousem'r,4752,4,15,9,12,55,46,9,54
Clyde,4752,5,15,9,12,53,48,5,54
Elgin,4752,6,15,6,15,56,61,-5,51
Annan Athlet,4752,7,12,11,13,48,41,7,47
Berwick,4752,8,8,10,18,29,60,-31,34
Edinburgh Ci,4752,9,7,9,20,38,63,-25,30
Cowdenbeath,4752,10,4,10,22,23,55,-32,22
Montrose,4753,1,24,7,5,62,35,27,79
Peterhead,4753,2,24,4,8,80,39,41,76
Stenhousem'r,4753,3,16,8,12,56,46,10,56
Stirling,4753,4,16,6,14,60,52,8,54
Clyde,4753,5,15,9,12,56,49,7,54
Elgin,4753,6,14,6,16,54,63,-9,48
Annan Athlet,4753,7,11,11,14,48,44,4,44
Berwick,4753,8,8,10,18,30,63,-33,34
Edinburgh Ci,4753,9,7,9,20,37,63,-26,30
Cowdenbeath,4753,10,5,10,21,26,55,-29,25
Montrose,4754,1,24,7,5,63,36,27,79
Peterhead,4754,2,24,4,8,79,38,41,76
Stirling,4754,3,17,6,13,61,51,10,57
Clyde,4754,4,15,9,12,54,49,5,54
Stenhousem'r,4754,5,15,8,13,55,47,8,53
Elgin,4754,6,14,6,16,55,64,-9,48
Annan Athlet,4754,7,11,12,13,49,43,6,45
Berwick,4754,8,8,10,18,30,61,-31,34
Edinburgh Ci,4754,9,7,9,20,36,62,-26,30
Cowdenbeath,4754,10,4,11,21,25,56,-31,23
Peterhead,4755,1,24,4,8,81,38,43,76
Montrose,4755,2,23,7,6,61,37,24,76
Stirling,4755,3,16,7,13,60,51,9,55
Stenhousem'r,4755,4,15,9,12,55,46,9,54
Clyde,4755,5,14,10,12,53,50,3,52
Elgin,4755,6,15,6,15,56,62,-6,51
Annan Athlet,4755,7,11,11,14,47,43,4,44
Berwick,4755,8,8,11,17,31,60,-29,35
Edinburgh Ci,4755,9,7,9,20,36,64,-28,30
Cowdenbeath,4755,10,5,10,21,25,54,-29,25
Montrose,4756,1,24,7,5,61,34,27,79
Peterhead,4756,2,24,4,8,81,39,42,76
Stirling,4756,3,16,7,13,61,52,9,55
Stenhousem'r,4756,4,15,9,12,56,47,9,54
Clyde,4756,5,15,9,12,54,49,5,54
Elgin,4756,6,14,6,16,53,62,-9,48
Annan Athlet,4756,7,12,11,13,51,44,7,47
Berwick,4756,8,8,10,18,30,61,-31,34
Edinburgh Ci,4756,9,7,9,20,37,64,-27,30
Cowdenbeath,4756,10,4,10,22,26,58,-32,22
Peterhead,4757,1,24,4,8,82,39,43,76
Montrose,4757,2,23,7,6,60,36,24,76
Stirling,4757,3,17,6,13,63,52,11,57
Stenhousem'r,4757,4,15,8,13,56,49,7,53
Clyde,4757,5,14,9,13,53,51,2,51
Elgin,4757,6,15,6,15,55,61,-6,51
Annan Athlet,4757,7,11,11,14,48,43,5,44
Berwick,4757,8,9,10,17,32,60,-28,37
Edinburgh Ci,4757,9,7,9,20,37,65,-28,30
Cowdenbeath,4757,10,5,10,21,25,55,-30,25
Montrose,4758,1,24,7,5,62,35,27,79
Peterhead,4758,2,24,4,8,79,38,41,76
Stirling,4758,3,16,7,13,60,51,9,55
Stenhousem'r,4758,4,15,9,12,55,46,9,54
Clyde,4758,5,15,9,12,53,48,5,54
Elgin,4758,6,14,6,16,54,63,-9,48
Annan Athlet,4758,7,12,11,13,49,41,8,47
Berwick,4758,8,8,10,18,29,60,-31,34
Edinburgh Ci,4758,9,7,9,20,36,62,-26,30
Cowdenbeath,4758,10,4,10,22,23,56,-33,22
Montrose,4759,1,24,7,5,62,34,28,79
Peterhead,4759,2,23,5,8,78,39,39,74
Stirling,4759,3,17,6,13,63,52,11,57
Clyde,4759,4,15,9,12,55,49,6,54
Stenhousem'r,4759,5,15,8,13,56,49,7,53
Elgin,4759,6,14,6,16,53,63,-10,48
Annan Athlet,4759,7,12,11,13,48,41,7,47
Berwick,4759,8,8,10,18,30,62,-32,34
Edinburgh Ci,4759,9,7,10,19,37,61,-24,31
Cowdenbeath,4759,10,4,10,22,23,55,-32,22
Montrose,4760,1,23,8,5,60,35,25,77
Peterhead,4760,2,23,5,8,78,39,39,74
Stenhousem'r,4760,3,16,8,12,58,47,11,56
Stirling,4760,4,16,6,14,61,54,7,54
Clyde,4760,5,15,9,12,52,48,4,54
Elgin,4760,6,14,7,15,54,61,-7,49
Annan Athlet,4760,7,12,11,13,48,41,7,47
Berwick,4760,8,8,10,18,29,59,-30,34
Edinburgh Ci,4760,9,7,10,19,37,61,-24,31
Cowdenbeath,4760,10,4,10,22,23,55,-32,22
Montrose,4761,1,23,7,6,62,38,24,76
Peterhead,4761,2,23,4,9,78,40,38,73
Stirling,4761,3,17,6,13,61,51,10,57
Clyde,4761,4,15,9,12,53,49,4,54
Stenhousem'r,4761,5,15,8,13,55,47,8,53
Elgin,4761,6,15,6,15,57,63,-6,51
Annan Athlet,4761,7,12,11,13,48,41,7,47
Berwick,4761,8,8,10,18,30,60,-30,34
Edinburgh Ci,4761,9,8,9,19,38,61,-23,33
Cowdenbeath,4761,10,4,10,22,23,55,-32,22
Montrose,4762,1,24,7,5,62,35,27,79
Peterhead,4762,2,24,4,8,79,38,41,76
Stirling,4762,3,17,6,13,62,51,11,57
Stenhousem'r,4762,4,15,8,13,55,48,7,53
Clyde,4762,5,14,10,12,51,48,3,52
Elgin,4762,6,14,6,16,54,63,-9,48
Annan Athlet,4762,7,12,11,13,49,41,8,47
Berwick,4762,8,8,11,17,29,58,-29,35
Edinburgh Ci,4762,9,7,9,20,36,62,-26,30
Cowdenbeath,4762,10,4,10,22,23,56,-33,22
Montrose,4763,1,24,7,5,62,35,27,79
Peterhead,4763,2,24,4,8,78,38,40,76
Stirling,4763,3,17,6,13,64,53,11,57
Stenhousem'r,4763,4,15,8,13,57,50,7,53
Clyde,4763,5,14,10,12,51,48,3,52
Elgin,4763,6,14,6,16,54,63,-9,48
Annan Athlet,4763,7,11,11,14,47,42,5,44
Berwick,4763,8,8,11,17,29,58,-29,35
Edinburgh Ci,4763,9,7,9,20,36,61,-25,30
Cowdenbeath,4763,10,5,10,21,24,54,-30,25
Montrose,4764,1,24,7,5,60,34,26,79
Peterhead,4764,2,23,5,8,78,39,39,74
Stenhousem'r,4764,3,16,8,12,57,46,11,56
Stirling,4764,4,16,6,14,60,53,7,54
Clyde,4764,5,15,9,12,54,48,6,54
Elgin,4764,6,14,6,16,53,61,-8,48
Annan Athlet,4764,7,11,12,13,48,42,6,45
Berwick,4764,8,8,10,18,29,61,-32,34
Edinburgh Ci,4764,9,7,10,19,37,61,-24,31
Cowdenbeath,4764,10,4,11,21,24,55,-31,23
Montrose,4765,1,23,8,5,59,34,25,77
Peterhead,4765,2,24,4,8,81,40,41,76
Stirling,4765,3,17,6,13,63,51,12,57
Clyde,4765,4,15,9,12,55,48,7,54
Stenhousem'r,4765,5,15,8,13,55,49,6,53
Elgin,4765,6,14,7,15,53,60,-7,49
Annan Athlet,4765,7,11,12,13,48,42,6,45
Berwick,4765,8,8,10,18,29,62,-33,34
Edinburgh Ci,4765,9,7,9,20,38,64,-26,30
Cowdenbeath,4765,10,4,11,21,24,55,-31,23
Montrose,4766,1,24,7,5,64,37,27,79
Peterhead,4766,2,24,4,8,83,40,43,76
Stirling,4766,3,17,6,13,61,51,10,57
Clyde,4766,4,15,9,12,55,49,6,54
Stenhousem'r,4766,5,15,8,13,55,47,8,53
Elgin,4766,6,14,6,16,56,65,-9,48
Annan Athlet,4766,7,12,11,13,49,42,7,47
Berwick,4766,8,8,10,18,30,62,-32,34
Edinburgh Ci,4766,9,7,9,20,38,66,-28,30
Cowdenbeath,4766,10,4,10,22,24,56,-32,22
Montrose,4767,1,24,7,5,62,34,28,79
Peterhead,4767,2,24,4,8,80,39,41,76
Stirling,4767,3,17,6,13,62,52,10,57
Clyde,4767,4,15,9,12,52,48,4,54
Stenhousem'r,4767,5,15,8,13,56,48,8,53
Elgin,4767,6,14,6,16,53,63,-10,48
Annan Athlet,4767,7,11,12,13,47,41,6,45
Berwick,4767,8,8,10,18,29,59,-30,34
Edinburgh Ci,4767,9,7,9,20,37,63,-26,30
Cowdenbeath,4767,10,4,11,21,23,54,-31,23
Montrose,4768,1,24,7,5,61,35,26,79
Peterhead,4768,2,23,5,8,78,39,39,74
Stirling,4768,3,16,7,13,63,54,9,55
Stenhousem'r,4768,4,15,9,12,58,49,9,54
Clyde,4768,5,15,9,12,55,48,7,54
Elgin,4768,6,14,6,16,54,62,-8,48
Annan Athlet,4768,7,11,11,14,47,42,5,44
Berwick,4768,8,8,10,18,29,62,-33,34
Edinburgh Ci,4768,9,7,10,19,37,61,-24,31
Cowdenbeath,4768,10,5,10,21,24,54,-30,25
Montrose,4769,1,24,7,5,62,36,26,79
Peterhead,4769,2,23,4,9,79,42,37,73
Stenhousem'r,4769,3,16,8,12,56,46,10,56
Stirling,4769,4,16,6,14,60,52,8,54
Clyde,4769,5,14,9,13,51,49,2,51
Elgin,4769,6,14,6,16,55,63,-8,48
Annan Athlet,4769,7,12,11,13,49,41,8,47
Berwick,4769,8,9,10,17,30,58,-28,37
Edinburgh Ci,4769,9,8,9,19,40,62,-22,33
Cowdenbeath,4769,10,4,10,22,23,56,-33,22
Montrose,4770,1,24,7,5,62,34,28,79
Peterhead,4770,2,24,4,8,79,39,40,76
Stirling,4770,3,17,6,13,63,52,11,57
Stenhousem'r,4770,4,15,8,13,56,49,7,53
Clyde,4770,5,14,10,12,52,49,3,52
Elgin,4770,6,14,6,16,53,63,-10,48
Annan Athlet,4770,7,12,11,13,49,41,8,47
Berwick,4770,8,8,11,17,30,59,-29,35
Edinburgh Ci,4770,9,7,9,20,37,62,-25,30
Cowdenbeath,4770,10,4,10,22,23,56,-33,22
Montrose,4771,1,24,7,5,63,36,27,79
Peterhead,4771,2,23,5,8,78,39,39,74
Stirling,4771,3,17,6,13,63,53,10,57
Clyde,4771,4,15,9,12,53,48,5,54
Stenhousem'r,4771,5,15,8,13,57,49,8,53
Elgin,4771,6,14,6,16,55,64,-9,48
Annan Athlet,4771,7,12,11,13,48,41,7,47
Berwick,4771,8,8,10,18,29,60,-31,34
Edinburgh Ci,4771,9,7,10,19,37,61,-24,31
Cowdenbeath,4771,10,4,10,22,23,55,-32,22
Peterhead,4772,1,24,4,8,82,38,44,76
Montrose,4772,2,23,7,6,59,35,24,76
Stirling,4772,3,17,6,13,63,51,12,57
Stenhousem'r,4772,4,15,8,13,55,49,6,53
Clyde,4772,5,14,9,13,52,50,2,51
Elgin,4772,6,15,6,15,54,60,-6,51
Annan Athlet,4772,7,12,11,13,49,42,7,47
Berwick,4772,8,9,10,17,31,59,-28,37
Edinburgh Ci,4772,9,7,9,20,36,65,-29,30
Cowdenbeath,4772,10,4,10,22,24,56,-32,22
Montrose,4773,1,24,7,5,64,34,30,79
Peterhead,4773,2,24,4,8,81,39,42,76
Stenhousem'r,4773,3,16,8,12,57,47,10,56
Stirling,4773,4,16,6,14,61,53,8,54
Clyde,4773,5,15,9,12,53,48,5,54
Elgin,4773,6,14,6,16,53,65,-12,48
Annan Athlet,4773,7,11,11,14,47,42,5,44
Berwick,4773,8,8,10,18,29,60,-31,34
Edinburgh Ci,4773,9,7,9,20,37,64,-27,30
Cowdenbeath,4773,10,5,10,21,24,54,-30,25
Montrose,4774,1,23,8,5,60,35,25,77
Peterhead,4774,2,23,5,8,77,38,39,74
Stenhousem'r,4774,3,16,8,12,57,46,11,56
Stirling,4774,4,16,6,14,60,53,7,54
Clyde,4774,5,14,10,12,51,48,3,52
Elgin,4774,6,14,7,15,54,61,-7,49
Annan Athlet,4774,7,11,12,13,48,42,6,45
Berwick,4774,8,8,11,17,29,58,-29,35
Edinburgh Ci,4774,9,7,10,19,36,60,-24,31
Cowdenbeath,4774,10,4,11,21,24,55,-31,23
Montrose,4775,1,24,7,5,62,34,28,79
Peterhead,4775,2,24,4,8,83,38,45,76
Stenhousem'r,4775,3,16,8,12,58,48,10,56
Stirling,4775,4,16,6,14,62,54,8,54
Clyde,4775,5,14,9,13,52,50,2,51
Elgin,4775,6,14,6,16,53,63,-10,48
Annan Athlet,4775,7,12,11,13,49,42,7,47
Berwick,4775,8,9,10,17,31,59,-28,37
Edinburgh Ci,4775,9,7,9,20,36,66,-30,30
Cowdenbeath,4775,10,4,10,22,24,56,-32,22
Montrose,4776,1,24,7,5,62,34,28,79
Peterhead,4776,2,24,4,8,81,39,42,76
Stirling,4776,3,17,6,13,62,51,11,57
Clyde,4776,4,15,9,12,52,48,4,54
Stenhousem'r,4776,5,15,8,13,55,48,7,53
Elgin,4776,6,14,6,16,53,63,-10,48
Annan Athlet,4776,7,12,11,13,50,41,9,47
Berwick,4776,8,8,10,18,29,59,-30,34
Edinburgh Ci,4776,9,7,9,20,37,64,-27,30
Cowdenbeath,4776,10,4,10,22,23,57,-34,22
Montrose,4777,1,24,7,5,62,34,28,79
Peterhead,4777,2,23,4,9,79,41,38,73
Stirling,4777,3,17,6,13,62,51,11,57
Clyde,4777,4,15,9,12,54,48,6,54
Stenhousem'r,4777,5,15,8,13,55,48,7,53
Elgin,4777,6,14,6,16,53,63,-10,48
Annan Athlet,4777,7,12,11,13,48,41,7,47
Berwick,4777,8,8,10,18,29,61,-32,34
Edinburgh Ci,4777,9,8,9,19,39,62,-23,33
Cowdenbeath,4777,10,4,10,22,23,55,-32,22
Montrose,4778,1,23,8,5,60,35,25,77
Peterhead,4778,2,24,4,8,79,39,40,76
Stenhousem'r,4778,3,16,8,12,56,46,10,56
Stirling,4778,4,16,6,14,60,52,8,54
Clyde,4778,5,15,9,12,53,49,4,54
Elgin,4778,6,14,7,15,54,61,-7,49
Annan Athlet,4778,7,12,11,13,48,41,7,47
Berwick,4778,8,8,10,18,30,60,-30,34
Edinburgh Ci,4778,9,7,9,20,37,62,-25,30
Cowdenbeath,4778,10,4,10,22,23,55,-32,22
Montrose,4779,1,24,7,5,62,34,28,79
Peterhead,4779,2,24,4,8,81,38,43,76
Stenhousem'r,4779,3,16,8,12,56,46,10,56
Stirling,4779,4,16,6,14,60,52,8,54
Clyde,4779,5,15,9,12,55,51,4,54
Elgin,4779,6,14,6,16,53,63,-10,48
Annan Athlet,4779,7,11,11,14,47,43,4,44
Berwick,4779,8,8,10,18,32,62,-30,34
Edinburgh Ci,4779,9,7,9,20,36,64,-28,30
Cowdenbeath,4779,10,5,10,21,25,54,-29,25
Montrose,4780,1,24,7,5,63,34,29,79
Peterhead,4780,2,23,5,8,78,39,39,74
Stirling,4780,3,17,6,13,65,54,11,57
Clyde,4780,4,15,9,12,57,49,8,54
Stenhousem'r,4780,5,15,8,13,58,51,7,53
Elgin,4780,6,14,6,16,53,64,-11,48
Annan Athlet,4780,7,12,11,13,48,41,7,47
Berwick,4780,8,8,10,18,30,64,-34,34
Edinburgh Ci,4780,9,7,10,19,37,61,-24,31
Cowdenbeath,4780,10,4,10,22,23,55,-32,22
Montrose,4781,1,24,7,5,62,36,26,79
Peterhead,4781,2,24,4,8,79,38,41,76
Stirling,4781,3,17,6,13,63,51,12,57
Clyde,4781,4,15,9,12,56,48,8,54
Stenhousem'r,4781,5,15,8,13,55,49,6,53
Elgin,4781,6,14,6,16,55,63,-8,48
Annan Athlet,4781,7,11,12,13,47,41,6,45
Berwick,4781,8,8,10,18,29,63,-34,34
Edinburgh Ci,4781,9,7,9,20,36,62,-26,30
Cowdenbeath,4781,10,4,11,21,23,54,-31,23
Montrose,4782,1,23,7,6,59,35,24,76
Peterhead,4782,2,23,5,8,77,38,39,74
Stenhousem'r,4782,3,16,8,12,57,47,10,56
Stirling,4782,4,16,6,14,61,53,8,54
Clyde,4782,5,15,9,12,54,49,5,54
Elgin,4782,6,15,6,15,54,60,-6,51
Annan Athlet,4782,7,12,11,13,48,41,7,47
Berwick,4782,8,8,10,18,30,61,-31,34
Edinburgh Ci,4782,9,7,10,19,36,60,-24,31
Cowdenbeath,4782,10,4,10,22,23,55,-32,22
Montrose,4783,1,24,7,5,60,34,26,79
Peterhead,4783,2,24,4,8,78,38,40,76
Stirling,4783,3,17,6,13,62,52,10,57
Stenhousem'r,4783,4,15,8,13,56,48,8,53
Clyde,4783,5,14,10,12,52,49,3,52
Elgin,4783,6,14,6,16,53,61,-8,48
Annan Athlet,4783,7,12,11,13,49,42,7,47
Berwick,4783,8,8,11,17,30,59,-29,35
Edinburgh Ci,4783,9,7,9,20,36,61,-25,30
Cowdenbeath,4783,10,4,10,22,24,56,-32,22
Peterhead,4784,1,24,4,8,80,38,42,76
Montrose,4784,2,23,7,6,62,38,24,76
Stenhousem'r,4784,3,16,8,12,58,48,10,56
Stirling,4784,4,16,6,14,62,54,8,54
Clyde,4784,5,15,9,12,54,48,6,54
Elgin,4784,6,15,6,15,57,63,-6,51
Annan Athlet,4784,7,11,11,14,47,42,5,44
Berwick,4784,8,8,10,18,29,61,-32,34
Edinburgh Ci,4784,9,7,9,20,36,63,-27,30
Cowdenbeath,4784,10,5,10,21,24,54,-30,25
Montrose,4785,1,24,7,5,61,34,27,79
Peterhead,4785,2,24,4,8,79,38,41,76
Stirling,4785,3,16,7,13,61,52,9,55
Stenhousem'r,4785,4,15,9,12,56,47,9,54
Clyde,4785,5,15,9,12,52,48,4,54
Elgin,4785,6,14,6,16,53,62,-9,48
Annan Athlet,4785,7,11,12,13,49,43,6,45
Berwick,4785,8,8,10,18,29,59,-30,34
Edinburgh Ci,4785,9,7,9,20,36,62,-26,30
Cowdenbeath,4785,10,4,11,21,25,56,-31,23
Montrose,4786,1,24,7,5,63,35,28,79
Peterhead,4786,2,24,4,8,79,38,41,76
Stenhousem'r,4786,3,16,8,12,56,46,10,56
Stirling,4786,4,16,6,14,60,52,8,54
Clyde,4786,5,15,9,12,53,48,5,54
Elgin,4786,6,14,6,16,54,64,-10,48
Annan Athlet,4786,7,11,12,13,48,42,6,45
Berwick,4786,8,8,10,18,29,60,-31,34
Edinburgh Ci,4786,9,7,9,20,36,62,-26,30
Cowdenbeath,4786,10,4,11,21,24,55,-31,23
Montrose,4787,1,24,7,5,62,35,27,79
Peterhead,4787,2,24,4,8,81,40,41,76
Stirling,4787,3,16,7,13,60,51,9,55
Stenhousem'r,4787,4,15,9,12,55,46,9,54
Clyde,4787,5,15,9,12,53,49,4,54
Elgin,4787,6,14,6,16,54,63,-9,48
Annan Athlet,4787,7,11,11,14,47,42,5,44
Berwick,4787,8,8,10,18,30,60,-30,34
Edinburgh Ci,4787,9,7,9,20,38,64,-26,30
Cowdenbeath,4787,10,5,10,21,24,54,-30,25
Montrose,4788,1,23,8,5,59,34,25,77
Peterhead,4788,2,24,4,8,81,40,41,76
Stenhousem'r,4788,3,16,8,12,58,47,11,56
Stirling,4788,4,16,6,14,61,54,7,54
Clyde,4788,5,15,9,12,54,48,6,54
Elgin,4788,6,14,7,15,53,60,-7,49
Annan Athlet,4788,7,11,11,14,48,44,4,44
Berwick,4788,8,8,10,18,29,61,-32,34
Edinburgh Ci,4788,9,7,9,20,38,64,-26,30
Cowdenbeath,4788,10,5,10,21,26,55,-29,25
Peterhead,4789,1,24,4,8,80,40,40,76
Montrose,4789,2,23,7,6,60,37,23,76
Stenhousem'r,4789,3,16,8,12,56,46,10,56
Stirling,4789,4,16,6,14,60,52,8,54
Clyde,4789,5,15,9,12,53,49,4,54
Elgin,4789,6,15,6,15,56,61,-5,51
Annan Athlet,4789,7,11,11,14,47,42,5,44
Berwick,4789,8,8,10,18,30,60,-30,34
Edinburgh Ci,4789,9,7,9,20,38,63,-25,30
Cowdenbeath,4789,10,5,10,21,24,54,-30,25
Montrose,4790,1,24,7,5,61,34,27,79
Peterhead,4790,2,24,4,8,78,38,40,76
Stirling,4790,3,17,6,13,61,51,10,57
Stenhousem'r,4790,4,15,8,13,55,47,8,53
Clyde,4790,5,14,10,12,51,48,3,52
Elgin,4790,6,14,6,16,53,62,-9,48
Annan Athlet,4790,7,11,12,13,47,41,6,45
Berwick,4790,8,8,11,17,29,58,-29,35
Edinburgh Ci,4790,9,7,9,20,36,61,-25,30
Cowdenbeath,4790,10,4,11,21,23,54,-31,23
Peterhead,4791,1,24,4,8,80,38,42,76
Montrose,4791,2,23,7,6,59,36,23,76
Stirling,4791,3,16,7,13,61,52,9,55
Stenhousem'r,4791,4,15,9,12,56,47,9,54
Clyde,4791,5,15,9,12,54,48,6,54
Elgin,4791,6,15,6,15,55,60,-5,51
Annan Athlet,4791,7,11,12,13,48,42,6,45
Berwick,4791,8,8,10,18,29,61,-32,34
Edinburgh Ci,4791,9,7,9,20,36,63,-27,30
Cowdenbeath,4791,10,4,11,21,24,55,-31,23
Montrose,4792,1,24,7,5,62,36,26,79
Peterhead,4792,2,23,5,8,77,38,39,74
Stirling,4792,3,16,7,13,62,53,9,55
Stenhousem'r,4792,4,15,9,12,57,48,9,54
Clyde,4792,5,14,9,13,52,51,1,51
Elgin,4792,6,14,6,16,55,63,-8,48
Annan Athlet,4792,7,11,12,13,48,42,6,45
Berwick,4792,8,9,10,17,32,59,-27,37
Edinburgh Ci,4792,9,7,10,19,36,60,-24,31
Cowdenbeath,4792,10,4,11,21,24,55,-31,23
Montrose,4793,1,24,7,5,61,34,27,79
Peterhead,4793,2,23,5,8,77,38,39,74
Stenhousem'r,4793,3,16,8,12,58,47,11,56
Stirling,4793,4,16,6,14,61,54,7,54
Clyde,4793,5,15,9,12,55,50,5,54
Elgin,4793,6,14,6,16,53,62,-9,48
Annan Athlet,4793,7,12,11,13,50,41,9,47
Berwick,4793,8,8,10,18,31,62,-31,34
Edinburgh Ci,4793,9,7,10,19,36,60,-24,31
Cowdenbeath,4793,10,4,10,22,23,57,-34,22
Peterhead,4794,1,24,4,8,79,39,40,76
Montrose,4794,2,23,7,6,60,36,24,76
Stirling,4794,3,17,6,13,62,52,10,57
Clyde,4794,4,15,9,12,53,48,5,54
Stenhousem'r,4794,5,15,8,13,56,48,8,53
Elgin,4794,6,15,6,15,55,61,-6,51
Annan Athlet,4794,7,12,11,13,49,41,8,47
Berwick,4794,8,8,10,18,29,60,-31,34
Edinburgh Ci,4794,9,7,9,20,37,62,-25,30
Cowdenbeath,4794,10,4,10,22,23,56,-33,22
Montrose,4795,1,24,7,5,61,35,26,79
Peterhead,4795,2,24,4,8,78,38,40,76
Stirling,4795,3,17,6,13,61,51,10,57
Clyde,4795,4,15,9,12,53,49,4,54
Stenhousem'r,4795,5,15,8,13,55,47,8,53
Elgin,4795,6,14,6,16,54,62,-8,48
Annan Athlet,4795,7,11,12,13,47,41,6,45
Berwick,4795,8,8,10,18,30,60,-30,34
Edinburgh Ci,4795,9,7,9,20,36,61,-25,30
Cowdenbeath,4795,10,4,11,21,23,54,-31,23
Montrose,4796,1,23,8,5,59,34,25,77
Peterhead,4796,2,24,4,8,81,39,42,76
Stirling,4796,3,17,6,13,63,52,11,57
Clyde,4796,4,15,9,12,53,48,5,54
Stenhousem'r,4796,5,15,8,13,56,49,7,53
Elgin,4796,6,14,7,15,53,60,-7,49
Annan Athlet,4796,7,12,11,13,48,41,7,47
Berwick,4796,8,8,10,18,29,60,-31,34
Edinburgh Ci,4796,9,7,9,20,37,64,-27,30
Cowdenbeath,4796,10,4,10,22,23,55,-32,22
Montrose,4797,1,24,7,5,63,34,29,79
Peterhead,4797,2,24,4,8,82,39,43,76
Stirling,4797,3,17,6,13,62,51,11,57
Stenhousem'r,4797,4,15,8,13,55,48,7,53
Clyde,4797,5,14,9,13,52,50,2,51
Elgin,4797,6,14,6,16,53,64,-11,48
Annan Athlet,4797,7,12,11,13,49,42,7,47
Berwick,4797,8,9,10,17,31,59,-28,37
Edinburgh Ci,4797,9,7,9,20,37,65,-28,30
Cowdenbeath,4797,10,4,10,22,24,56,-32,22
Montrose,4798,1,24,7,5,61,35,26,79
Peterhead,4798,2,23,4,9,78,40,38,73
Stirling,4798,3,17,6,13,61,51,10,57
Clyde,4798,4,15,9,12,53,49,4,54
Stenhousem'r,4798,5,15,8,13,55,47,8,53
Elgin,4798,6,14,6,16,54,62,-8,48
Annan Athlet,4798,7,11,11,14,47,43,4,44
Berwick,4798,8,8,10,18,30,60,-30,34
Edinburgh Ci,4798,9,8,9,19,38,61,-23,33
Cowdenbeath,4798,10,5,10,21,25,54,-29,25
Montrose,4799,1,24,7,5,63,35,28,79
Peterhead,4799,2,24,4,8,81,39,42,76
Stirling,4799,3,17,6,13,65,53,12,57
Clyde,4799,4,15,9,12,53,49,4,54
Stenhousem'r,4799,5,15,8,13,57,51,6,53
Elgin,4799,6,14,6,16,54,64,-10,48
Annan Athlet,4799,7,12,11,13,48,41,7,47
Berwick,4799,8,8,10,18,30,60,-30,34
Edinburgh Ci,4799,9,7,9,20,37,64,-27,30
Cowdenbeath,4799,10,4,10,22,23,55,-32,22
Peterhead,4800,1,24,4,8,80,39,41,76
Montrose,4800,2,23,7,6,60,36,24,76
Stirling,4800,3,17,6,13,64,52,12,57
Clyde,4800,4,15,9,12,56,48,8,54
Stenhousem'r,4800,5,15,8,13,56,50,6,53
Elgin,4800,6,15,6,15,55,61,-6,51
Annan Athlet,4800,7,12,11,13,50,41,9,47
Berwick,4800,8,8,10,18,29,63,-34,34
Edinburgh Ci,4800,9,7,9,20,37,63,-26,30
Cowdenbeath,4800,10,4,10,22,23,57,-34,22
Montrose,4801,1,24,7,5,61,34,27,79
Peterhead,4801,2,24,4,8,80,38,42,76
Stirling,4801,3,17,6,13,62,51,11,57
Clyde,4801,4,15,9,12,53,48,5,54
Stenhousem'r,4801,5,15,8,13,55,48,7,53
Elgin,4801,6,14,6,16,53,62,-9,48
Annan Athlet,4801,7,11,11,14,47,42,5,44
Berwick,4801,8,8,10,18,29,60,-31,34
Edinburgh Ci,4801,9,7,9,20,36,63,-27,30
Cowdenbeath,4801,10,5,10,21,24,54,-30,25
Montrose,4802,1,24,7,5,61,34,27,79
Peterhead,4802,2,23,5,8,77,38,39,74
Stirling,4802,3,17,6,13,63,53,10,57
Clyde,4802,4,15,9,12,55,48,7,54
Stenhousem'r,4802,5,15,8,13,57,49,8,53
Elgin,4802,6,14,6,16,53,62,-9,48
Annan Athlet,4802,7,12,11,13,51,43,8,47
Berwick,4802,8,8,10,18,29,62,-33,34
Edinburgh Ci,4802,9,7,10,19,36,60,-24,31
Cowdenbeath,4802,10,4,10,22,25,58,-33,22
Peterhead,4803,1,24,4,8,78,38,40,76
Montrose,4803,2,23,7,6,60,36,24,76
Stirling,4803,3,16,7,13,60,51,9,55
Stenhousem'r,4803,4,15,9,12,55,46,9,54
Clyde,4803,5,14,10,12,52,49,3,52
Elgin,4803,6,15,6,15,55,61,-6,51
Annan Athlet,4803,7,12,11,13,49,42,7,47
Berwick,4803,8,8,11,17,30,59,-29,35
Edinburgh Ci,4803,9,7,9,20,36,61,-25,30
Cowdenbeath,4803,10,4,10,22,24,56,-32,22
Montrose,4804,1,23,8,5,61,36,25,77
Peterhead,4804,2,24,4,8,82,39,43,76
Stirling,4804,3,17,6,13,61,51,10,57
Clyde,4804,4,15,9,12,53,49,4,54
Stenhousem'r,4804,5,15,8,13,55,47,8,53
Elgin,4804,6,14,7,15,55,62,-7,49
Annan Athlet,4804,7,12,11,13,48,41,7,47
Berwick,4804,8,8,10,18,30,60,-30,34
Edinburgh Ci,4804,9,7,9,20,37,65,-28,30
Cowdenbeath,4804,10,4,10,22,23,55,-32,22
Montrose,4805,1,23,8,5,61,36,25,77
Peterhead,4805,2,24,4,8,79,38,41,76
Stenhousem'r,4805,3,16,8,12,56,46,10,56
Stirling,4805,4,16,6,14,60,52,8,54
Clyde,4805,5,14,10,12,53,50,3,52
Elgin,4805,6,14,7,15,55,62,-7,49
Annan Athlet,4805,7,12,11,13,49,41,8,47
Berwick,4805,8,8,11,17,31,60,-29,35
Edinburgh Ci,4805,9,7,9,20,36,62,-26,30
Cowdenbeath,4805,10,4,10,22,23,56,-33,22
Montrose,4806,1,24,7,5,61,34,27,79
Peterhead,4806,2,24,4,8,82,40,42,76
Stirling,4806,3,17,6,13,63,52,11,57
Clyde,4806,4,15,9,12,53,49,4,54
Stenhousem'r,4806,5,15,8,13,56,49,7,53
Elgin,4806,6,14,6,16,53,62,-9,48
Annan Athlet,4806,7,12,11,13,49,42,7,47
Berwick,4806,8,8,10,18,30,60,-30,34
Edinburgh Ci,4806,9,7,9,20,38,65,-27,30
Cowdenbeath,4806,10,4,10,22,24,56,-32,22
Montrose,4807,1,23,8,5,60,35,25,77
Peterhead,4807,2,23,4,9,78,42,36,73
Stirling,4807,3,17,6,13,65,52,13,57
Stenhousem'r,4807,4,15,8,13,56,51,5,53
Clyde,4807,5,14,10,12,53,50,3,52
Elgin,4807,6,14,7,15,54,61,-7,49
Annan Athlet,4807,7,12,11,13,48,41,7,47
Berwick,4807,8,8,11,17,31,60,-29,35
Edinburgh Ci,4807,9,8,9,19,40,61,-21,33
Cowdenbeath,4807,10,4,10,22,23,55,-32,22
Montrose,4808,1,23,8,5,60,35,25,77
Peterhead,4808,2,24,4,8,83,41,42,76
Stirling,4808,3,16,7,13,63,54,9,55
Stenhousem'r,4808,4,15,9,12,58,49,9,54
Clyde,4808,5,14,10,12,51,48,3,52
Elgin,4808,6,14,7,15,54,61,-7,49
Annan Athlet,4808,7,12,11,13,50,42,8,47
Berwick,4808,8,8,11,17,29,58,-29,35
Edinburgh Ci,4808,9,7,9,20,39,66,-27,30
Cowdenbeath,4808,10,4,10,22,24,57,-33,22
Montrose,4809,1,24,7,5,62,35,27,79
Peterhead,4809,2,24,4,8,79,38,41,76
Stirling,4809,3,17,6,13,64,52,12,57
Stenhousem'r,4809,4,15,8,13,56,50,6,53
Clyde,4809,5,14,10,12,51,48,3,52
Elgin,4809,6,14,6,16,54,63,-9,48
Annan Athlet,4809,7,11,11,14,47,42,5,44
Berwick,4809,8,8,11,17,29,58,-29,35
Edinburgh Ci,4809,9,7,9,20,36,62,-26,30
Cowdenbeath,4809,10,5,10,21,24,54,-30,25
Montrose,4810,1,24,7,5,62,34,28,79
Peterhead,4810,2,24,4,8,78,38,40,76
Stirling,4810,3,17,6,13,61,51,10,57
Clyde,4810,4,15,9,12,55,50,5,54
Stenhousem'r,4810,5,15,8,13,55,47,8,53
Elgin,4810,6,14,6,16,53,63,-10,48
Annan Athlet,4810,7,11,12,13,47,41,6,45
Berwick,4810,8,8,10,18,31,62,-31,34
Edinburgh Ci,4810,9,7,9,20,36,61,-25,30
Cowdenbeath,4810,10,4,11,21,23,54,-31,23
Montrose,4811,1,24,7,5,63,34,29,79
Peterhead,4811,2,23,5,8,77,38,39,74
Stirling,4811,3,17,6,13,63,51,12,57
Stenhousem'r,4811,4,15,8,13,55,49,6,53
Clyde,4811,5,14,10,12,52,49,3,52
Elgin,4811,6,14,6,16,53,64,-11,48
Annan Athlet,4811,7,12,11,13,49,42,7,47
Berwick,4811,8,8,11,17,30,59,-29,35
Edinburgh Ci,4811,9,7,10,19,36,60,-24,31
Cowdenbeath,4811,10,4,10,22,24,56,-32,22
Peterhead,4812,1,24,4,8,82,38,44,76
Montrose,4812,2,23,7,6,59,35,24,76
Stirling,4812,3,17,6,13,64,52,12,57
Clyde,4812,4,15,9,12,53,49,4,54
Stenhousem'r,4812,5,15,8,13,56,50,6,53
Elgin,4812,6,15,6,15,54,60,-6,51
Annan Athlet,4812,7,12,11,13,50,41,9,47
Berwick,4812,8,8,10,18,30,60,-30,34
Edinburgh Ci,4812,9,7,9,20,36,65,-29,30
Cowdenbeath,4812,10,4,10,22,23,57,-34,22
Montrose,4813,1,23,7,6,60,38,22,76
Peterhead,4813,2,23,4,9,78,40,38,73
Stirling,4813,3,16,7,13,61,52,9,55
Stenhousem'r,4813,4,15,9,12,56,47,9,54
Clyde,4813,5,15,9,12,53,49,4,54
Elgin,4813,6,15,6,15,57,61,-4,51
Annan Athlet,4813,7,12,11,13,48,41,7,47
Berwick,4813,8,8,10,18,30,60,-30,34
Edinburgh Ci,4813,9,8,9,19,38,61,-23,33
Cowdenbeath,4813,10,4,10,22,23,55,-32,22
Montrose,4814,1,24,7,5,63,34,29,79
Peterhead,4814,2,24,4,8,83,38,45,76
Stirling,4814,3,17,6,13,62,51,11,57
Stenhousem'r,4814,4,15,8,13,55,48,7,53
Clyde,4814,5,14,9,13,51,49,2,51
Elgin,4814,6,14,6,16,53,64,-11,48
Annan Athlet,4814,7,11,12,13,47,41,6,45
Berwick,4814,8,9,10,17,30,58,-28,37
Edinburgh Ci,4814,9,7,9,20,36,66,-30,30
Cowdenbeath,4814,10,4,11,21,23,54,-31,23
Montrose,4815,1,24,7,5,62,36,26,79
Peterhead,4815,2,24,4,8,79,39,40,76
Stenhousem'r,4815,3,16,8,12,58,46,12,56
Stirling,4815,4,16,6,14,60,54,6,54
Clyde,4815,5,15,9,12,54,48,6,54
Elgin,4815,6,14,6,16,55,63,-8,48
Annan Athlet,4815,7,11,11,14,48,44,4,44
Berwick,4815,8,8,10,18,29,61,-32,34
Edinburgh Ci,4815,9,7,9,20,37,62,-25,30
Cowdenbeath,4815,10,5,10,21,26,55,-29,25
Peterhead,4816,1,24,4,8,80,38,42,76
Montrose,4816,2,23,7,6,59,35,24,76
Stirling,4816,3,17,6,13,65,52,13,57
Clyde,4816,4,15,9,12,53,49,4,54
Stenhousem'r,4816,5,15,8,13,56,51,5,53
Elgin,4816,6,15,6,15,54,60,-6,51
Annan Athlet,4816,7,12,11,13,48,41,7,47
Berwick,4816,8,8,10,18,30,60,-30,34
Edinburgh Ci,4816,9,7,9,20,36,63,-27,30
Cowdenbeath,4816,10,4,10,22,23,55,-32,22
Montrose,4817,1,23,8,5,61,36,25,77
Peterhead,4817,2,23,5,8,78,39,39,74
Stirling,4817,3,16,7,13,62,53,9,55
Stenhousem'r,4817,4,15,9,12,57,48,9,54
Clyde,4817,5,15,9,12,53,49,4,54
Elgin,4817,6,14,7,15,55,62,-7,49
Annan Athlet,4817,7,12,11,13,48,41,7,47
Berwick,4817,8,8,10,18,30,60,-30,34
Edinburgh Ci,4817,9,7,10,19,37,61,-24,31
Cowdenbeath,4817,10,4,10,22,23,55,-32,22
Montrose,4818,1,24,7,5,62,36,26,79
Peterhead,4818,2,23,5,8,77,38,39,74
Stirling,4818,3,16,7,13,61,52,9,55
Stenhousem'r,4818,4,15,9,12,56,47,9,54
Clyde,4818,5,15,9,12,55,48,7,54
Elgin,4818,6,14,6,16,55,63,-8,48
Annan Athlet,4818,7,11,11,14,47,42,5,44
Berwick,4818,8,8,10,18,29,62,-33,34
Edinburgh Ci,4818,9,7,10,19,36,60,-24,31
Cowdenbeath,4818,10,5,10,21,24,54,-30,25
Peterhead,4819,1,24,4,8,82,39,43,76
Montrose,4819,2,23,7,6,60,37,23,76
Stenhousem'r,4819,3,16,8,12,57,47,10,56
Stirling,4819,4,16,6,14,61,53,8,54
Clyde,4819,5,15,9,12,56,51,5,54
Elgin,4819,6,15,6,15,56,61,-5,51
Annan Athlet,4819,7,11,12,13,47,41,6,45
Berwick,4819,8,8,10,18,32,63,-31,34
Edinburgh Ci,4819,9,7,9,20,37,65,-28,30
Cowdenbeath,4819,10,4,11,21,23,54,-31,23
Montrose,4820,1,24,7,5,62,36,26,79
Peterhead,4820,2,24,4,8,79,38,41,76
Stenhousem'r,4820,3,16,8,12,57,47,10,56
Stirling,4820,4,16,6,14,61,53,8,54
Clyde,4820,5,15,9,12,54,48,6,54
Elgin,4820,6,14,6,16,55,63,-8,48
Annan Athlet,4820,7,11,12,13,48,42,6,45
Berwick,4820,8,8,10,18,29,61,-32,34
Edinburgh Ci,4820,9,7,9,20,36,62,-26,30
Cowdenbeath,4820,10,4,11,21,24,55,-31,23
Montrose,4821,1,24,7,5,63,34,29,79
Peterhead,4821,2,24,4,8,82,41,41,76
Stenhousem'r,4821,3,16,8,12,59,48,11,56
Stirling,4821,4,16,6,14,62,55,7,54
Clyde,4821,5,15,9,12,53,48,5,54
Elgin,4821,6,14,6,16,53,64,-11,48
Annan Athlet,4821,7,12,11,13,48,41,7,47
Berwick,4821,8,8,10,18,29,60,-31,34
Edinburgh Ci,4821,9,7,9,20,39,65,-26,30
Cowdenbeath,4821,10,4,10,22,23,55,-32,22
Montrose,4822,1,24,7,5,61,34,27,79
Peterhead,4822,2,23,4,9,77,39,38,73
Stirling,4822,3,17,6,13,63,51,12,57
Stenhousem'r,4822,4,15,8,13,55,49,6,53
Clyde,4822,5,14,10,12,51,48,3,52
Elgin,4822,6,14,6,16,53,62,-9,48
Annan Athlet,4822,7,11,11,14,47,42,5,44
Berwick,4822,8,8,11,17,29,58,-29,35
Edinburgh Ci,4822,9,8,9,19,37,60,-23,33
Cowdenbeath,4822,10,5,10,21,24,54,-30,25
Peterhead,4823,1,24,4,8,83,39,44,76
Montrose,4823,2,23,7,6,60,37,23,76
Stirling,4823,3,17,6,13,62,51,11,57
Clyde,4823,4,15,9,12,54,49,5,54
Stenhousem'r,4823,5,15,8,13,55,48,7,53
Elgin,4823,6,15,6,15,56,61,-5,51
Annan Athlet,4823,7,12,11,13,49,42,7,47
Berwick,4823,8,8,10,18,30,61,-31,34
Edinburgh Ci,4823,9,7,9,20,37,66,-29,30
Cowdenbeath,4823,10,4,10,22,24,56,-32,22
Montrose,4824,1,23,7,6,59,35,24,76
Peterhead,4824,2,23,5,8,79,40,39,74
Stirling,4824,3,16,7,13,61,52,9,55
Stenhousem'r,4824,4,15,9,12,56,47,9,54
Clyde,4824,5,15,9,12,53,49,4,54
Elgin,4824,6,15,6,15,54,60,-6,51
Annan Athlet,4824,7,11,12,13,47,41,6,45
Berwick,4824,8,8,10,18,30,60,-30,34
Edinburgh Ci,4824,9,7,10,19,38,62,-24,31
Cowdenbeath,4824,10,4,11,21,23,54,-31,23
Montrose,4825,1,24,7,5,61,35,26,79
Peterhead,4825,2,24,4,8,80,38,42,76
Stirling,4825,3,17,6,13,64,52,12,57
Stenhousem'r,4825,4,15,8,13,56,50,6,53
Clyde,4825,5,14,10,12,51,48,3,52
Elgin,4825,6,14,6,16,54,62,-8,48
Annan Athlet,4825,7,12,11,13,49,42,7,47
Berwick,4825,8,8,11,17,29,58,-29,35
Edinburgh Ci,4825,9,7,9,20,36,63,-27,30
Cowdenbeath,4825,10,4,10,22,24,56,-32,22
Montrose,4826,1,24,7,5,62,35,27,79
Peterhead,4826,2,24,4,8,81,38,43,76
Stirling,4826,3,16,7,13,61,52,9,55
Stenhousem'r,4826,4,15,9,12,56,47,9,54
Clyde,4826,5,14,9,13,51,49,2,51
Elgin,4826,6,14,6,16,54,63,-9,48
Annan Athlet,4826,7,11,11,14,47,42,5,44
Berwick,4826,8,9,10,17,30,58,-28,37
Edinburgh Ci,4826,9,7,9,20,36,64,-28,30
Cowdenbeath,4826,10,5,10,21,24,54,-30,25
Montrose,4827,1,23,8,5,59,34,25,77
Peterhead,4827,2,24,4,8,80,38,42,76
Stirling,4827,3,17,6,13,64,53,11,57
Clyde,4827,4,15,9,12,52,48,4,54
Stenhousem'r,4827,5,15,8,13,57,50,7,53
Elgin,4827,6,14,7,15,53,60,-7,49
Annan Athlet,4827,7,11,11,14,47,46,1,44
Berwick,4827,8,8,10,18,29,59,-30,34
Edinburgh Ci,4827,9,7,9,20,36,63,-27,30
Cowdenbeath,4827,10,5,10,21,28,54,-26,25
Montrose,4828,1,24,7,5,63,34,29,79
Peterhead,4828,2,24,4,8,81,41,40,76
Stenhousem'r,4828,3,16,8,12,58,47,11,56
Stirling,4828,4,16,6,14,61,54,7,54
Clyde,4828,5,15,9,12,52,48,4,54
Elgin,4828,6,14,6,16,53,64,-11,48
Annan Athlet,4828,7,11,12,13,47,41,6,45
Berwick,4828,8,8,10,18,29,59,-30,34
Edinburgh Ci,4828,9,7,9,20,39,64,-25,30
Cowdenbeath,4828,10,4,11,21,23,54,-31,23
Montrose,4829,1,23,8,5,60,35,25,77
Peterhead,4829,2,24,4,8,79,38,41,76
Stenhousem'r,4829,3,16,8,12,57,47,10,56
Stirling,4829,4,16,6,14,61,53,8,54
Clyde,4829,5,15,9,12,52,48,4,54
Elgin,4829,6,14,7,15,54,61,-7,49
Annan Athlet,4829,7,11,12,13,47,41,6,45
Berwick,4829,8,8,10,18,29,59,-30,34
Edinburgh Ci,4829,9,7,9,20,36,62,-26,30
Cowdenbeath,4829,10,4,11,21,23,54,-31,23
Montrose,4830,1,24,7,5,63,34,29,79
Peterhead,4830,2,24,4,8,81,39,42,76
Stirling,4830,3,17,6,13,63,53,10,57
Stenhousem'r,4830,4,15,8,13,57,49,8,53
Clyde,4830,5,14,9,13,52,51,1,51
Elgin,4830,6,14,6,16,53,64,-11,48
Annan Athlet,4830,7,11,12,13,48,42,6,45
Berwick,4830,8,9,10,17,32,59,-27,37
Edinburgh Ci,4830,9,7,9,20,37,64,-27,30
Cowdenbeath,4830,10,4,11,21,24,55,-31,23
Montrose,4831,1,23,8,5,60,35,25,77
Peterhead,4831,2,24,4,8,79,38,41,76
Stirling,4831,3,17,6,13,62,52,10,57
Stenhousem'r,4831,4,15,8,13,56,48,8,53
Clyde,4831,5,14,10,12,52,49,3,52
Elgin,4831,6,14,7,15,54,61,-7,49
Annan Athlet,4831,7,11,12,13,47,41,6,45
Berwick,4831,8,8,11,17,30,59,-29,35
Edinburgh Ci,4831,9,7,9,20,36,62,-26,30
Cowdenbeath,4831,10,4,11,21,23,54,-31,23
Montrose,4832,1,24,7,5,65,34,31,79
Peterhead,4832,2,24,4,8,79,38,41,76
Stenhousem'r,4832,3,16,8,12,57,47,10,56
Stirling,4832,4,16,6,14,61,53,8,54
Clyde,4832,5,15,9,12,53,48,5,54
Elgin,4832,6,14,6,16,53,66,-13,48
Annan Athlet,4832,7,11,12,13,48,42,6,45
Berwick,4832,8,8,10,18,29,60,-31,34
Edinburgh Ci,4832,9,7,9,20,36,62,-26,30
Cowdenbeath,4832,10,4,11,21,24,55,-31,23
Montrose,4833,1,24,7,5,66,34,32,79
Peterhead,4833,2,23,5,8,80,41,39,74
Stenhousem'r,4833,3,16,8,12,59,48,11,56
Stirling,4833,4,16,6,14,62,55,7,54
Clyde,4833,5,15,9,12,54,48,6,54
Elgin,4833,6,14,6,16,53,67,-14,48
Annan Athlet,4833,7,11,12,13,47,41,6,45
Berwick,4833,8,8,10,18,29,61,-32,34
Edinburgh Ci,4833,9,7,10,19,39,63,-24,31
Cowdenbeath,4833,10,4,11,21,23,54,-31,23
Montrose,4834,1,24,7,5,61,34,27,79
Peterhead,4834,2,23,4,9,77,39,38,73
Stenhousem'r,4834,3,16,8,12,57,47,10,56
Stirling,4834,4,16,6,14,61,53,8,54
Clyde,4834,5,15,9,12,55,50,5,54
Elgin,4834,6,14,6,16,53,62,-9,48
Annan Athlet,4834,7,11,11,14,47,42,5,44
Berwick,4834,8,8,10,18,31,62,-31,34
Edinburgh Ci,4834,9,8,9,19,37,60,-23,33
Cowdenbeath,4834,10,5,10,21,24,54,-30,25
Peterhead,4835,1,24,4,8,80,38,42,76
Montrose,4835,2,23,7,6,60,37,23,76
Stirling,4835,3,17,6,13,62,51,11,57
Clyde,4835,4,15,9,12,53,48,5,54
Stenhousem'r,4835,5,15,8,13,55,48,7,53
Elgin,4835,6,15,6,15,56,61,-5,51
Annan Athlet,4835,7,11,12,13,50,44,6,45
Berwick,4835,8,8,10,18,29,60,-31,34
Edinburgh Ci,4835,9,7,9,20,36,63,-27,30
Cowdenbeath,4835,10,4,11,21,26,57,-31,23
Montrose,4836,1,23,8,5,60,35,25,77
Peterhead,4836,2,23,4,9,77,39,38,73
Stirling,4836,3,17,6,13,65,51,14,57
Clyde,4836,4,15,9,12,52,48,4,54
Stenhousem'r,4836,5,15,8,13,55,51,4,53
Elgin,4836,6,14,7,15,54,61,-7,49
Annan Athlet,4836,7,11,12,13,48,42,6,45
Berwick,4836,8,8,10,18,29,59,-30,34
Edinburgh Ci,4836,9,8,9,19,37,60,-23,33
Cowdenbeath,4836,10,4,11,21,24,55,-31,23
Montrose,4837,1,24,7,5,60,34,26,79
Peterhead,4837,2,23,5,8,80,41,39,74
Stirling,4837,3,16,7,13,61,52,9,55
Stenhousem'r,4837,4,15,9,12,56,47,9,54
Clyde,4837,5,15,9,12,54,48,6,54
Elgin,4837,6,14,6,16,53,61,-8,48
Annan Athlet,4837,7,11,11,14,48,44,4,44
Berwick,4837,8,8,10,18,29,61,-32,34
Edinburgh Ci,4837,9,7,10,19,39,63,-24,31
Cowdenbeath,4837,10,5,10,21,26,55,-29,25
Montrose,4838,1,23,8,5,61,36,25,77
Peterhead,4838,2,24,4,8,81,38,43,76
Stirling,4838,3,17,6,13,62,51,11,57
Stenhousem'r,4838,4,15,8,13,55,48,7,53
Clyde,4838,5,14,10,12,52,49,3,52
Elgin,4838,6,14,7,15,55,62,-7,49
Annan Athlet,4838,7,12,11,13,49,42,7,47
Berwick,4838,8,8,11,17,30,59,-29,35
Edinburgh Ci,4838,9,7,9,20,36,64,-28,30
Cowdenbeath,4838,10,4,10,22,24,56,-32,22
Montrose,4839,1,24,7,5,62,34,28,79
Peterhead,4839,2,24,4,8,79,39,40,76
Stirling,4839,3,17,6,13,63,51,12,57
Stenhousem'r,4839,4,15,8,13,55,49,6,53
Clyde,4839,5,14,9,13,52,50,2,51
Elgin,4839,6,14,6,16,53,63,-10,48
Annan Athlet,4839,7,12,11,13,48,41,7,47
Berwick,4839,8,9,10,17,31,59,-28,37
Edinburgh Ci,4839,9,7,9,20,37,62,-25,30
Cowdenbeath,4839,10,4,10,22,23,55,-32,22
Montrose,4840,1,24,7,5,62,34,28,79
Peterhead,4840,2,24,4,8,80,38,42,76
Stenhousem'r,4840,3,16,8,12,59,49,10,56
Stirling,4840,4,16,6,14,63,55,8,54
Clyde,4840,5,14,10,12,51,48,3,52
Elgin,4840,6,14,6,16,53,63,-10,48
Annan Athlet,4840,7,11,12,13,47,41,6,45
Berwick,4840,8,8,11,17,29,58,-29,35
Edinburgh Ci,4840,9,7,9,20,36,63,-27,30
Cowdenbeath,4840,10,4,11,21,23,54,-31,23
Montrose,4841,1,24,7,5,62,36,26,79
Peterhead,4841,2,24,4,8,80,38,42,76
Stirling,4841,3,16,7,13,61,52,9,55
Stenhousem'r,4841,4,15,9,12,56,47,9,54
Clyde,4841,5,14,10,12,52,49,3,52
Elgin,4841,6,14,6,16,55,63,-8,48
Annan Athlet,4841,7,12,11,13,48,41,7,47
Berwick,4841,8,8,11,17,30,59,-29,35
Edinburgh Ci,4841,9,7,9,20,36,63,-27,30
Cowdenbeath,4841,10,4,10,22,23,55,-32,22
Peterhead,4842,1,24,4,8,79,39,40,76
Montrose,4842,2,23,7,6,59,35,24,76
Stirling,4842,3,17,6,13,63,52,11,57
Clyde,4842,4,15,9,12,52,48,4,54
Stenhousem'r,4842,5,15,8,13,56,49,7,53
Elgin,4842,6,15,6,15,54,60,-6,51
Annan Athlet,4842,7,12,11,13,50,41,9,47
Berwick,4842,8,8,10,18,29,59,-30,34
Edinburgh Ci,4842,9,7,9,20,37,62,-25,30
Cowdenbeath,4842,10,4,10,22,23,57,-34,22
Peterhead,4843,1,24,4,8,78,38,40,76
Montrose,4843,2,23,7,6,59,35,24,76
Stenhousem'r,4843,3,16,8,12,58,47,11,56
Stirling,4843,4,16,6,14,61,54,7,54
Clyde,4843,5,14,10,12,51,48,3,52
Elgin,4843,6,15,6,15,54,60,-6,51
Annan Athlet,4843,7,12,11,13,49,41,8,47
Berwick,4843,8,8,11,17,29,58,-29,35
Edinburgh Ci,4843,9,7,9,20,36,61,-25,30
Cowdenbeath,4843,10,4,10,22,23,56,-33,22
Montrose,4844,1,24,7,5,61,34,27,79
Peterhead,4844,2,24,4,8,79,39,40,76
Stirling,4844,3,17,6,13,66,52,14,57
Stenhousem'r,4844,4,15,8,13,56,52,4,53
Clyde,4844,5,14,9,13,51,50,1,51
Elgin,4844,6,14,6,16,53,62,-9,48
Annan Athlet,4844,7,11,12,13,49,43,6,45
Berwick,4844,8,9,10,17,31,58,-27,37
Edinburgh Ci,4844,9,7,9,20,37,62,-25,30
Cowdenbeath,4844,10,4,11,21,25,56,-31,23
Montrose,4845,1,24,7,5,61,35,26,79
Peterhead,4845,2,24,4,8,78,38,40,76
Stirling,4845,3,17,6,13,62,52,10,57
Stenhousem'r,4845,4,15,8,13,56,48,8,53
Clyde,4845,5,14,9,13,52,52,0,51
Elgin,4845,6,14,6,16,54,62,-8,48
Annan Athlet,4845,7,11,12,13,47,41,6,45
Berwick,4845,8,9,10,17,33,59,-26,37
Edinburgh Ci,4845,9,7,9,20,36,61,-25,30
Cowdenbeath,4845,10,4,11,21,23,54,-31,23
Montrose,4846,1,23,8,5,60,35,25,77
Peterhead,4846,2,24,4,8,80,38,42,76
Stenhousem'r,4846,3,16,8,12,57,46,11,56
Stirling,4846,4,16,6,14,60,53,7,54
Clyde,4846,5,15,9,12,52,48,4,54
Elgin,4846,6,14,7,15,54,61,-7,49
Annan Athlet,4846,7,12,11,13,49,41,8,47
Berwick,4846,8,8,10,18,29,59,-30,34
Edinburgh Ci,4846,9,7,9,20,36,63,-27,30
Cowdenbeath,4846,10,4,10,22,23,56,-33,22
Montrose,4847,1,24,7,5,63,35,28,79
Peterhead,4847,2,24,4,8,82,39,43,76
Stirling,4847,3,17,6,13,62,51,11,57
Stenhousem'r,4847,4,15,8,13,55,48,7,53
Clyde,4847,5,14,9,13,52,50,2,51
Elgin,4847,6,14,6,16,54,64,-10,48
Annan Athlet,4847,7,12,11,13,48,41,7,47
Berwick,4847,8,9,10,17,31,59,-28,37
Edinburgh Ci,4847,9,7,9,20,37,65,-28,30
Cowdenbeath,4847,10,4,10,22,23,55,-32,22
Montrose,4848,1,24,7,5,62,34,28,79
Peterhead,4848,2,24,4,8,80,38,42,76
Stirling,4848,3,16,7,13,61,52,9,55
Stenhousem'r,4848,4,15,9,12,56,47,9,54
Clyde,4848,5,14,9,13,52,50,2,51
Elgin,4848,6,14,6,16,53,63,-10,48
Annan Athlet,4848,7,12,11,13,48,41,7,47
Berwick,4848,8,9,10,17,31,59,-28,37
Edinburgh Ci,4848,9,7,9,20,36,63,-27,30
Cowdenbeath,4848,10,4,10,22,23,55,-32,22
Montrose,4849,1,24,7,5,62,34,28,79
Peterhead,4849,2,23,5,8,78,39,39,74
Stirling,4849,3,16,7,13,62,53,9,55
Stenhousem'r,4849,4,15,9,12,57,48,9,54
Clyde,4849,5,14,9,13,51,49,2,51
Elgin,4849,6,14,6,16,53,63,-10,48
Annan Athlet,4849,7,12,11,13,49,42,7,47
Berwick,4849,8,9,10,17,30,58,-28,37
Edinburgh Ci,4849,9,7,10,19,37,61,-24,31
Cowdenbeath,4849,10,4,10,22,24,56,-32,22
Peterhead,4850,1,24,4,8,80,39,41,76
Montrose,4850,2,23,7,6,61,37,24,76
Stirling,4850,3,17,6,13,62,52,10,57
Clyde,4850,4,15,9,12,53,49,4,54
Stenhousem'r,4850,5,15,8,13,56,48,8,53
Elgin,4850,6,15,6,15,56,62,-6,51
Annan Athlet,4850,7,12,11,13,50,42,8,47
Berwick,4850,8,8,10,18,30,60,-30,34
Edinburgh Ci,4850,9,7,9,20,37,63,-26,30
Cowdenbeath,4850,10,4,10,22,24,57,-33,22
Montrose,4851,1,24,7,5,60,34,26,79
Peterhead,4851,2,23,5,8,78,39,39,74
Stenhousem'r,4851,3,16,8,12,57,47,10,56
Stirling,4851,4,16,6,14,61,53,8,54
Clyde,4851,5,15,9,12,52,48,4,54
Elgin,4851,6,14,6,16,53,61,-8,48
Annan Athlet,4851,7,11,11,14,47,42,5,44
Berwick,4851,8,8,10,18,29,59,-30,34
Edinburgh Ci,4851,9,7,10,19,37,61,-24,31
Cowdenbeath,4851,10,5,10,21,24,54,-30,25
Peterhead,4852,1,24,4,8,81,40,41,76
Montrose,4852,2,23,7,6,60,36,24,76
Stirling,4852,3,16,7,13,61,52,9,55
Stenhousem'r,4852,4,15,9,12,56,47,9,54
Clyde,4852,5,14,9,13,51,50,1,51
Elgin,4852,6,15,6,15,55,61,-6,51
Annan Athlet,4852,7,11,12,13,48,42,6,45
Berwick,4852,8,9,10,17,31,58,-27,37
Edinburgh Ci,4852,9,7,9,20,38,64,-26,30
Cowdenbeath,4852,10,4,11,21,24,55,-31,23
Montrose,4853,1,23,8,5,62,37,25,77
Peterhead,4853,2,24,4,8,79,38,41,76
Stenhousem'r,4853,3,16,8,12,60,50,10,56
Stirling,4853,4,16,6,14,64,56,8,54
Clyde,4853,5,15,9,12,52,48,4,54
Elgin,4853,6,14,7,15,56,63,-7,49
Annan Athlet,4853,7,11,12,13,48,42,6,45
Berwick,4853,8,8,10,18,29,59,-30,34
Edinburgh Ci,4853,9,7,9,20,36,62,-26,30
Cowdenbeath,4853,10,4,11,21,24,55,-31,23
Montrose,4854,1,23,8,5,61,36,25,77
Peterhead,4854,2,24,4,8,81,38,43,76
Stirling,4854,3,17,6,13,61,51,10,57
Stenhousem'r,4854,4,15,8,13,55,47,8,53
Clyde,4854,5,14,9,13,52,50,2,51
Elgin,4854,6,14,7,15,55,62,-7,49
Annan Athlet,4854,7,11,12,13,48,42,6,45
Berwick,4854,8,9,10,17,31,59,-28,37
Edinburgh Ci,4854,9,7,9,20,36,64,-28,30
Cowdenbeath,4854,10,4,11,21,24,55,-31,23
Montrose,4855,1,24,7,5,63,35,28,79
Peterhead,4855,2,24,4,8,78,38,40,76
Stirling,4855,3,16,7,13,62,53,9,55
Stenhousem'r,4855,4,15,9,12,57,48,9,54
Clyde,4855,5,15,9,12,54,50,4,54
Elgin,4855,6,14,6,16,54,64,-10,48
Annan Athlet,4855,7,12,11,13,51,41,10,47
Berwick,4855,8,8,10,18,31,61,-30,34
Edinburgh Ci,4855,9,7,9,20,36,61,-25,30
Cowdenbeath,4855,10,4,10,22,23,58,-35,22
Montrose,4856,1,24,7,5,62,35,27,79
Peterhead,4856,2,24,4,8,82,39,43,76
Stirling,4856,3,16,7,13,61,52,9,55
Stenhousem'r,4856,4,15,9,12,56,47,9,54
Clyde,4856,5,14,9,13,51,49,2,51
Elgin,4856,6,14,6,16,54,63,-9,48
Annan Athlet,4856,7,11,11,14,48,43,5,44
Berwick,4856,8,9,10,17,30,58,-28,37
Edinburgh Ci,4856,9,7,9,20,37,65,-28,30
Cowdenbeath,4856,10,5,10,21,25,55,-30,25
Montrose,4857,1,24,7,5,63,34,29,79
Peterhead,4857,2,24,4,8,79,38,41,76
Stenhousem'r,4857,3,16,8,12,57,47,10,56
Stirling,4857,4,16,6,14,61,53,8,54
Clyde,4857,5,15,9,12,52,48,4,54
Elgin,4857,6,14,6,16,53,64,-11,48
Annan Athlet,4857,7,11,12,13,48,42,6,45
Berwick,4857,8,8,10,18,29,59,-30,34
Edinburgh Ci,4857,9,7,9,20,36,62,-26,30
Cowdenbeath,4857,10,4,11,21,24,55,-31,23
Montrose,4858,1,24,7,5,60,34,26,79
Peterhead,4858,2,23,4,9,78,41,37,73
Stirling,4858,3,17,6,13,64,52,12,57
Stenhousem'r,4858,4,15,8,13,56,50,6,53
Clyde,4858,5,14,10,12,52,49,3,52
Elgin,4858,6,14,6,16,53,61,-8,48
Annan Athlet,4858,7,11,11,14,47,42,5,44
Berwick,4858,8,8,11,17,30,59,-29,35
Edinburgh Ci,4858,9,8,9,19,39,61,-22,33
Cowdenbeath,4858,10,5,10,21,24,54,-30,25
Montrose,4859,1,24,7,5,62,36,26,79
Peterhead,4859,2,24,4,8,78,38,40,76
Stenhousem'r,4859,3,16,8,12,56,46,10,56
Stirling,4859,4,16,6,14,60,52,8,54
Clyde,4859,5,14,9,13,51,49,2,51
Elgin,4859,6,14,6,16,55,63,-8,48
Annan Athlet,4859,7,11,11,14,47,42,5,44
Berwick,4859,8,9,10,17,30,58,-28,37
Edinburgh Ci,4859,9,7,9,20,36,61,-25,30
Cowdenbeath,4859,10,5,10,21,24,54,-30,25
Montrose,4860,1,23,8,5,59,34,25,77
Peterhead,4860,2,23,4,9,77,40,37,73
Stenhousem'r,4860,3,16,8,12,57,47,10,56
Stirling,4860,4,16,6,14,61,53,8,54
Clyde,4860,5,15,9,12,53,48,5,54
Elgin,4860,6,14,7,15,53,60,-7,49
Annan Athlet,4860,7,11,11,14,47,42,5,44
Berwick,4860,8,8,10,18,29,60,-31,34
Edinburgh Ci,4860,9,8,9,19,38,60,-22,33
Cowdenbeath,4860,10,5,10,21,24,54,-30,25
Montrose,4861,1,24,7,5,62,34,28,79
Peterhead,4861,2,24,4,8,80,40,40,76
Stenhousem'r,4861,3,16,8,12,58,47,11,56
Stirling,4861,4,16,6,14,61,54,7,54
Clyde,4861,5,15,9,12,55,49,6,54
Elgin,4861,6,14,6,16,53,63,-10,48
Annan Athlet,4861,7,11,12,13,49,43,6,45
Berwick,4861,8,8,10,18,30,62,-32,34
Edinburgh Ci,4861,9,7,9,20,38,63,-25,30
Cowdenbeath,4861,10,4,11,21,25,56,-31,23
Montrose,4862,1,23,8,5,59,34,25,77
Peterhead,4862,2,24,4,8,80,38,42,76
Stirling,4862,3,17,6,13,62,52,10,57
Stenhousem'r,4862,4,15,8,13,56,48,8,53
Clyde,4862,5,14,10,12,52,49,3,52
Elgin,4862,6,14,7,15,53,60,-7,49
Annan Athlet,4862,7,11,12,13,48,42,6,45
Berwick,4862,8,8,11,17,30,59,-29,35
Edinburgh Ci,4862,9,7,9,20,36,63,-27,30
Cowdenbeath,4862,10,4,11,21,24,55,-31,23
Montrose,4863,1,24,7,5,63,35,28,79
Peterhead,4863,2,24,4,8,79,39,40,76
Stirling,4863,3,17,6,13,62,52,10,57
Stenhousem'r,4863,4,15,8,13,56,48,8,53
Clyde,4863,5,14,10,12,52,49,3,52
Elgin,4863,6,14,6,16,54,64,-10,48
Annan Athlet,4863,7,12,11,13,48,41,7,47
Berwick,4863,8,8,11,17,30,59,-29,35
Edinburgh Ci,4863,9,7,9,20,37,62,-25,30
Cowdenbeath,4863,10,4,10,22,23,55,-32,22
Montrose,4864,1,23,8,5,59,34,25,77
Peterhead,4864,2,24,4,8,83,39,44,76
Stirling,4864,3,17,6,13,63,53,10,57
Clyde,4864,4,15,9,12,52,48,4,54
Stenhousem'r,4864,5,15,8,13,57,49,8,53
Elgin,4864,6,14,7,15,53,60,-7,49
Annan Athlet,4864,7,12,11,13,48,41,7,47
Berwick,4864,8,8,10,18,29,59,-30,34
Edinburgh Ci,4864,9,7,9,20,37,66,-29,30
Cowdenbeath,4864,10,4,10,22,23,55,-32,22
Montrose,4865,1,23,8,5,61,36,25,77
Peterhead,4865,2,23,4,9,79,41,38,73
Stirling,4865,3,17,6,13,63,52,11,57
Stenhousem'r,4865,4,15,8,13,56,49,7,53
Clyde,4865,5,14,9,13,52,50,2,51
Elgin,4865,6,14,7,15,55,62,-7,49
Annan Athlet,4865,7,11,12,13,48,42,6,45
Berwick,4865,8,9,10,17,31,59,-28,37
Edinburgh Ci,4865,9,8,9,19,39,62,-23,33
Cowdenbeath,4865,10,4,11,21,24,55,-31,23
Montrose,4866,1,23,8,5,60,35,25,77
Peterhead,4866,2,23,5,8,77,38,39,74
Stirling,4866,3,17,6,13,62,52,10,57
Stenhousem'r,4866,4,15,8,13,56,48,8,53
Clyde,4866,5,14,9,13,51,49,2,51
Elgin,4866,6,14,7,15,54,61,-7,49
Annan Athlet,4866,7,11,11,14,48,43,5,44
Berwick,4866,8,9,10,17,30,58,-28,37
Edinburgh Ci,4866,9,7,10,19,36,60,-24,31
Cowdenbeath,4866,10,5,10,21,25,55,-30,25
Montrose,4867,1,23,8,5,60,35,25,77
Peterhead,4867,2,24,4,8,79,39,40,76
Stirling,4867,3,17,6,13,62,52,10,57
Clyde,4867,4,15,9,12,54,48,6,54
Stenhousem'r,4867,5,15,8,13,56,48,8,53
Elgin,4867,6,14,7,15,54,61,-7,49
Annan Athlet,4867,7,11,11,14,48,43,5,44
Berwick,4867,8,8,10,18,29,61,-32,34
Edinburgh Ci,4867,9,7,9,20,37,62,-25,30
Cowdenbeath,4867,10,5,10,21,25,55,-30,25
Montrose,4868,1,23,8,5,61,36,25,77
Peterhead,4868,2,24,4,8,80,38,42,76
Stirling,4868,3,17,6,13,63,51,12,57
Clyde,4868,4,15,9,12,53,48,5,54
Stenhousem'r,4868,5,15,8,13,55,49,6,53
Elgin,4868,6,14,7,15,55,62,-7,49
Annan Athlet,4868,7,12,11,13,49,42,7,47
Berwick,4868,8,8,10,18,29,60,-31,34
Edinburgh Ci,4868,9,7,9,20,36,63,-27,30
Cowdenbeath,4868,10,4,10,22,24,56,-32,22
Montrose,4869,1,23,8,5,59,34,25,77
Peterhead,4869,2,24,4,8,82,40,42,76
Stenhousem'r,4869,3,16,8,12,56,46,10,56
Stirling,4869,4,16,6,14,60,52,8,54
Clyde,4869,5,15,9,12,52,48,4,54
Elgin,4869,6,14,7,15,53,60,-7,49
Annan Athlet,4869,7,11,11,14,47,43,4,44
Berwick,4869,8,8,10,18,29,59,-30,34
Edinburgh Ci,4869,9,7,9,20,38,65,-27,30
Cowdenbeath,4869,10,5,10,21,25,54,-29,25
Montrose,4870,1,23,8,5,60,35,25,77
Peterhead,4870,2,24,4,8,80,38,42,76
Stirling,4870,3,17,6,13,61,51,10,57
Clyde,4870,4,15,9,12,53,49,4,54
Stenhousem'r,4870,5,15,8,13,55,47,8,53
Elgin,4870,6,14,7,15,54,61,-7,49
Annan Athlet,4870,7,11,11,14,48,44,4,44
Berwick,4870,8,8,10,18,30,60,-30,34
Edinburgh Ci,4870,9,7,9,20,36,63,-27,30
Cowdenbeath,4870,10,5,10,21,26,55,-29,25
Montrose,4871,1,24,7,5,61,34,27,79
Peterhead,4871,2,24,4,8,82,41,41,76
Stirling,4871,3,17,6,13,61,51,10,57
Stenhousem'r,4871,4,15,8,13,55,47,8,53
Clyde,4871,5,14,10,12,51,48,3,52
Elgin,4871,6,14,6,16,53,62,-9,48
Annan Athlet,4871,7,12,11,13,48,41,7,47
Berwick,4871,8,8,11,17,29,58,-29,35
Edinburgh Ci,4871,9,7,9,20,39,65,-26,30
Cowdenbeath,4871,10,4,10,22,23,55,-32,22
Montrose,4872,1,23,8,5,60,35,25,77
Peterhead,4872,2,24,4,8,80,38,42,76
Stirling,4872,3,16,7,13,61,52,9,55
Stenhousem'r,4872,4,15,9,12,56,47,9,54
Clyde,4872,5,15,9,12,53,49,4,54
Elgin,4872,6,14,7,15,54,61,-7,49
Annan Athlet,4872,7,11,12,13,47,41,6,45
Berwick,4872,8,8,10,18,30,60,-30,34
Edinburgh Ci,4872,9,7,9,20,36,63,-27,30
Cowdenbeath,4872,10,4,11,21,23,54,-31,23
Peterhead,4873,1,24,4,8,79,39,40,76
Montrose,4873,2,23,7,6,59,35,24,76
Stirling,4873,3,17,6,13,63,52,11,57
Stenhousem'r,4873,4,15,8,13,56,49,7,53
Clyde,4873,5,14,9,13,51,49,2,51
Elgin,4873,6,15,6,15,54,60,-6,51
Annan Athlet,4873,7,11,11,14,47,42,5,44
Berwick,4873,8,9,10,17,30,58,-28,37
Edinburgh Ci,4873,9,7,9,20,37,62,-25,30
Cowdenbeath,4873,10,5,10,21,24,54,-30,25
Montrose,4874,1,24,7,5,62,34,28,79
Peterhead,4874,2,24,4,8,82,38,44,76
Stirling,4874,3,17,6,13,65,53,12,57
Clyde,4874,4,15,9,12,53,48,5,54
Stenhousem'r,4874,5,15,8,13,57,51,6,53
Elgin,4874,6,14,6,16,53,63,-10,48
Annan Athlet,4874,7,11,11,14,47,42,5,44
Berwick,4874,8,8,10,18,29,60,-31,34
Edinburgh Ci,4874,9,7,9,20,36,65,-29,30
Cowdenbeath,4874,10,5,10,21,24,54,-30,25
Montrose,4875,1,24,7,5,62,36,26,79
Peterhead,4875,2,24,4,8,80,38,42,76
Stirling,4875,3,17,6,13,61,51,10,57
Stenhousem'r,4875,4,15,8,13,55,47,8,53
Clyde,4875,5,14,10,12,52,49,3,52
Elgin,4875,6,14,6,16,55,63,-8,48
Annan Athlet,4875,7,12,11,13,49,41,8,47
Berwick,4875,8,8,11,17,30,59,-29,35
Edinburgh Ci,4875,9,7,9,20,36,63,-27,30
Cowdenbeath,4875,10,4,10,22,23,56,-33,22
Montrose,4876,1,24,7,5,62,35,27,79
Peterhead,4876,2,24,4,8,79,38,41,76
Stirling,4876,3,17,6,13,61,51,10,57
Clyde,4876,4,15,9,12,53,48,5,54
Stenhousem'r,4876,5,15,8,13,55,47,8,53
Elgin,4876,6,14,6,16,54,63,-9,48
Annan Athlet,4876,7,11,11,14,48,43,5,44
Berwick,4876,8,8,10,18,29,60,-31,34
Edinburgh Ci,4876,9,7,9,20,36,62,-26,30
Cowdenbeath,4876,10,5,10,21,25,55,-30,25
Montrose,4877,1,24,7,5,62,34,28,79
Peterhead,4877,2,23,5,8,78,39,39,74
Stirling,4877,3,16,7,13,60,51,9,55
Stenhousem'r,4877,4,15,9,12,55,46,9,54
Clyde,4877,5,15,9,12,54,49,5,54
Elgin,4877,6,14,6,16,53,63,-10,48
Annan Athlet,4877,7,11,12,13,47,41,6,45
Berwick,4877,8,8,10,18,30,61,-31,34
Edinburgh Ci,4877,9,7,10,19,37,61,-24,31
Cowdenbeath,4877,10,4,11,21,23,54,-31,23
Montrose,4878,1,24,7,5,61,35,26,79
Peterhead,4878,2,24,4,8,78,38,40,76
Stenhousem'r,4878,3,16,8,12,57,46,11,56
Stirling,4878,4,16,6,14,60,53,7,54
Clyde,4878,5,15,9,12,56,49,7,54
Elgin,4878,6,14,6,16,54,62,-8,48
Annan Athlet,4878,7,11,12,13,47,41,6,45
Berwick,4878,8,8,10,18,30,63,-33,34
Edinburgh Ci,4878,9,7,9,20,36,61,-25,30
Cowdenbeath,4878,10,4,11,21,23,54,-31,23
Montrose,4879,1,24,7,5,62,34,28,79
Peterhead,4879,2,23,4,9,78,40,38,73
Stenhousem'r,4879,3,16,8,12,56,46,10,56
Stirling,4879,4,16,6,14,60,52,8,54
Clyde,4879,5,15,9,12,56,50,6,54
Elgin,4879,6,14,6,16,53,63,-10,48
Annan Athlet,4879,7,11,11,14,47,44,3,44
Berwick,4879,8,8,10,18,31,63,-32,34
Edinburgh Ci,4879,9,8,9,19,38,61,-23,33
Cowdenbeath,4879,10,5,10,21,26,54,-28,25
Montrose,4880,1,23,8,5,59,34,25,77
Peterhead,4880,2,24,4,8,79,39,40,76
Stirling,4880,3,17,6,13,62,52,10,57
Stenhousem'r,4880,4,15,8,13,56,48,8,53
Clyde,4880,5,14,10,12,52,49,3,52
Elgin,4880,6,14,7,15,53,60,-7,49
Annan Athlet,4880,7,12,11,13,50,41,9,47
Berwick,4880,8,8,11,17,30,59,-29,35
Edinburgh Ci,4880,9,7,9,20,37,62,-25,30
Cowdenbeath,4880,10,4,10,22,23,57,-34,22
Montrose,4881,1,23,8,5,60,35,25,77
Peterhead,4881,2,24,4,8,82,40,42,76
Stenhousem'r,4881,3,16,8,12,56,46,10,56
Stirling,4881,4,16,6,14,60,52,8,54
Clyde,4881,5,15,9,12,53,49,4,54
Elgin,4881,6,14,7,15,54,61,-7,49
Annan Athlet,4881,7,12,11,13,50,42,8,47
Berwick,4881,8,8,10,18,30,60,-30,34
Edinburgh Ci,4881,9,7,9,20,38,65,-27,30
Cowdenbeath,4881,10,4,10,22,24,57,-33,22
Montrose,4882,1,24,7,5,63,35,28,79
Peterhead,4882,2,24,4,8,82,40,42,76
Stirling,4882,3,17,6,13,61,51,10,57
Clyde,4882,4,15,9,12,53,49,4,54
Stenhousem'r,4882,5,15,8,13,55,47,8,53
Elgin,4882,6,14,6,16,54,64,-10,48
Annan Athlet,4882,7,11,11,14,47,43,4,44
Berwick,4882,8,8,10,18,30,60,-30,34
Edinburgh Ci,4882,9,7,9,20,38,65,-27,30
Cowdenbeath,4882,10,5,10,21,25,54,-29,25
Montrose,4883,1,24,7,5,61,34,27,79
Peterhead,4883,2,24,4,8,79,38,41,76
Stirling,4883,3,17,6,13,63,52,11,57
Clyde,4883,4,15,9,12,54,50,4,54
Stenhousem'r,4883,5,15,8,13,56,49,7,53
Elgin,4883,6,14,6,16,53,62,-9,48
Annan Athlet,4883,7,11,12,13,49,43,6,45
Berwick,4883,8,8,10,18,31,61,-30,34
Edinburgh Ci,4883,9,7,9,20,36,62,-26,30
Cowdenbeath,4883,10,4,11,21,25,56,-31,23
Montrose,4884,1,24,7,5,61,35,26,79
Peterhead,4884,2,24,4,8,82,39,43,76
Stirling,4884,3,17,6,13,63,51,12,57
Stenhousem'r,4884,4,15,8,13,55,49,6,53
Clyde,4884,5,14,10,12,52,49,3,52
Elgin,4884,6,14,6,16,54,62,-8,48
Annan Athlet,4884,7,12,11,13,50,43,7,47
Berwick,4884,8,8,11,17,30,59,-29,35
Edinburgh Ci,4884,9,7,9,20,37,65,-28,30
Cowdenbeath,4884,10,4,10,22,25,57,-32,22
Montrose,4885,1,24,7,5,64,35,29,79
Peterhead,4885,2,23,4,9,78,40,38,73
Stirling,4885,3,16,7,13,61,52,9,55
Stenhousem'r,4885,4,15,9,12,56,47,9,54
Clyde,4885,5,14,10,12,52,49,3,52
Elgin,4885,6,14,6,16,54,65,-11,48
Annan Athlet,4885,7,12,11,13,48,41,7,47
Berwick,4885,8,8,11,17,30,59,-29,35
Edinburgh Ci,4885,9,8,9,19,38,61,-23,33
Cowdenbeath,4885,10,4,10,22,23,55,-32,22
Montrose,4886,1,24,7,5,62,34,28,79
Peterhead,4886,2,24,4,8,80,38,42,76
Stirling,4886,3,17,6,13,61,51,10,57
Stenhousem'r,4886,4,15,8,13,55,47,8,53
Clyde,4886,5,14,10,12,52,49,3,52
Elgin,4886,6,14,6,16,53,63,-10,48
Annan Athlet,4886,7,11,11,14,49,44,5,44
Berwick,4886,8,8,11,17,30,59,-29,35
Edinburgh Ci,4886,9,7,9,20,36,63,-27,30
Cowdenbeath,4886,10,5,10,21,26,56,-30,25
Montrose,4887,1,24,7,5,61,34,27,79
Peterhead,4887,2,23,4,9,78,41,37,73
Stirling,4887,3,16,7,13,62,53,9,55
Stenhousem'r,4887,4,15,9,12,57,48,9,54
Clyde,4887,5,15,9,12,55,48,7,54
Elgin,4887,6,14,6,16,53,62,-9,48
Annan Athlet,4887,7,11,11,14,48,43,5,44
Berwick,4887,8,8,10,18,29,62,-33,34
Edinburgh Ci,4887,9,8,9,19,39,61,-22,33
Cowdenbeath,4887,10,5,10,21,25,55,-30,25
Montrose,4888,1,24,7,5,60,34,26,79
Peterhead,4888,2,24,4,8,79,38,41,76
Stirling,4888,3,16,7,13,61,52,9,55
Stenhousem'r,4888,4,15,9,12,56,47,9,54
Clyde,4888,5,15,9,12,52,48,4,54
Elgin,4888,6,14,6,16,53,61,-8,48
Annan Athlet,4888,7,12,11,13,49,41,8,47
Berwick,4888,8,8,10,18,29,59,-30,34
Edinburgh Ci,4888,9,7,9,20,36,62,-26,30
Cowdenbeath,4888,10,4,10,22,23,56,-33,22
Peterhead,4889,1,24,4,8,80,39,41,76
Montrose,4889,2,23,7,6,59,36,23,76
Stenhousem'r,4889,3,16,8,12,57,46,11,56
Stirling,4889,4,16,6,14,60,53,7,54
Clyde,4889,5,14,9,13,51,49,2,51
Elgin,4889,6,15,6,15,55,60,-5,51
Annan Athlet,4889,7,11,12,13,47,41,6,45
Berwick,4889,8,9,10,17,30,58,-28,37
Edinburgh Ci,4889,9,7,9,20,37,63,-26,30
Cowdenbeath,4889,10,4,11,21,23,54,-31,23
Montrose,4890,1,23,8,5,59,34,25,77
Peterhead,4890,2,24,4,8,80,38,42,76
Stirling,4890,3,17,6,13,65,51,14,57
Clyde,4890,4,15,9,12,56,48,8,54
Stenhousem'r,4890,5,15,8,13,55,51,4,53
Elgin,4890,6,14,7,15,53,60,-7,49
Annan Athlet,4890,7,11,11,14,47,43,4,44
Berwick,4890,8,8,10,18,29,63,-34,34
Edinburgh Ci,4890,9,7,9,20,36,63,-27,30
Cowdenbeath,4890,10,5,10,21,25,54,-29,25
Montrose,4891,1,23,7,6,60,36,24,76
Peterhead,4891,2,23,5,8,80,41,39,74
Stirling,4891,3,17,6,13,64,52,12,57
Clyde,4891,4,15,9,12,55,49,6,54
Stenhousem'r,4891,5,15,8,13,56,50,6,53
Elgin,4891,6,15,6,15,55,61,-6,51
Annan Athlet,4891,7,12,11,13,51,43,8,47
Berwick,4891,8,8,10,18,30,62,-32,34
Edinburgh Ci,4891,9,7,10,19,39,63,-24,31
Cowdenbeath,4891,10,4,10,22,25,58,-33,22
Peterhead,4892,1,24,4,8,81,38,43,76
Montrose,4892,2,23,7,6,60,38,22,76
Stirling,4892,3,16,7,13,62,53,9,55
Stenhousem'r,4892,4,15,9,12,57,48,9,54
Clyde,4892,5,14,10,12,52,49,3,52
Elgin,4892,6,15,6,15,57,61,-4,51
Annan Athlet,4892,7,11,11,14,48,43,5,44
Berwick,4892,8,8,11,17,30,59,-29,35
Edinburgh Ci,4892,9,7,9,20,36,64,-28,30
Cowdenbeath,4892,10,5,10,21,25,55,-30,25
Montrose,4893,1,24,7,5,61,35,26,79
Peterhead,4893,2,23,5,8,78,39,39,74
Stirling,4893,3,17,6,13,63,52,11,57
Clyde,4893,4,15,9,12,54,49,5,54
Stenhousem'r,4893,5,15,8,13,56,49,7,53
Elgin,4893,6,14,6,16,54,62,-8,48
Annan Athlet,4893,7,11,11,14,48,44,4,44
Berwick,4893,8,8,10,18,30,61,-31,34
Edinburgh Ci,4893,9,7,10,19,37,61,-24,31
Cowdenbeath,4893,10,5,10,21,26,55,-29,25
Montrose,4894,1,24,7,5,63,35,28,79
Peterhead,4894,2,24,4,8,80,38,42,76
Stenhousem'r,4894,3,16,8,12,58,48,10,56
Stirling,4894,4,16,6,14,62,54,8,54
Clyde,4894,5,14,9,13,53,51,2,51
Elgin,4894,6,14,6,16,54,64,-10,48
Annan Athlet,4894,7,12,11,13,49,41,8,47
Berwick,4894,8,9,10,17,32,60,-28,37
Edinburgh Ci,4894,9,7,9,20,36,63,-27,30
Cowdenbeath,4894,10,4,10,22,23,56,-33,22
Montrose,4895,1,23,8,5,60,35,25,77
Peterhead,4895,2,24,4,8,79,38,41,76
Stirling,4895,3,17,6,13,63,52,11,57
Stenhousem'r,4895,4,15,8,13,56,49,7,53
Clyde,4895,5,14,10,12,52,49,3,52
Elgin,4895,6,14,7,15,54,61,-7,49
Annan Athlet,4895,7,12,11,13,49,41,8,47
Berwick,4895,8,8,11,17,30,59,-29,35
Edinburgh Ci,4895,9,7,9,20,36,62,-26,30
Cowdenbeath,4895,10,4,10,22,23,56,-33,22
Montrose,4896,1,23,8,5,60,35,25,77
Peterhead,4896,2,23,4,9,77,39,38,73
Stirling,4896,3,17,6,13,62,51,11,57
Clyde,4896,4,15,9,12,54,48,6,54
Stenhousem'r,4896,5,15,8,13,55,48,7,53
Elgin,4896,6,14,7,15,54,61,-7,49
Annan Athlet,4896,7,11,11,14,47,43,4,44
Berwick,4896,8,8,10,18,29,61,-32,34
Edinburgh Ci,4896,9,8,9,19,37,60,-23,33
Cowdenbeath,4896,10,5,10,21,25,54,-29,25
Montrose,4897,1,24,7,5,61,35,26,79
Peterhead,4897,2,24,4,8,79,39,40,76
Stenhousem'r,4897,3,16,8,12,57,47,10,56
Stirling,4897,4,16,6,14,61,53,8,54
Clyde,4897,5,14,10,12,52,49,3,52
Elgin,4897,6,14,6,16,54,62,-8,48
Annan Athlet,4897,7,11,11,14,47,43,4,44
Berwick,4897,8,8,11,17,30,59,-29,35
Edinburgh Ci,4897,9,7,9,20,37,62,-25,30
Cowdenbeath,4897,10,5,10,21,25,54,-29,25
Montrose,4898,1,24,7,5,63,35,28,79
Peterhead,4898,2,23,5,8,80,41,39,74
Stenhousem'r,4898,3,16,8,12,57,46,11,56
Stirling,4898,4,16,6,14,60,53,7,54
Clyde,4898,5,15,9,12,55,49,6,54
Elgin,4898,6,14,6,16,54,64,-10,48
Annan Athlet,4898,7,11,11,14,47,44,3,44
Berwick,4898,8,8,10,18,30,62,-32,34
Edinburgh Ci,4898,9,7,10,19,39,63,-24,31
Cowdenbeath,4898,10,5,10,21,26,54,-28,25
Montrose,4899,1,24,7,5,60,34,26,79
Peterhead,4899,2,23,4,9,78,40,38,73
Stirling,4899,3,17,6,13,62,51,11,57
Stenhousem'r,4899,4,15,8,13,55,48,7,53
Clyde,4899,5,14,9,13,51,49,2,51
Elgin,4899,6,14,6,16,53,61,-8,48
Annan Athlet,4899,7,12,11,13,48,41,7,47
Berwick,4899,8,9,10,17,30,58,-28,37
Edinburgh Ci,4899,9,8,9,19,38,61,-23,33
Cowdenbeath,4899,10,4,10,22,23,55,-32,22
Peterhead,4900,1,24,4,8,78,38,40,76
Montrose,4900,2,23,7,6,59,36,23,76
Stirling,4900,3,17,6,13,63,52,11,57
Clyde,4900,4,15,9,12,54,48,6,54
Stenhousem'r,4900,5,15,8,13,56,49,7,53
Elgin,4900,6,15,6,15,55,60,-5,51
Annan Athlet,4900,7,11,12,13,48,42,6,45
Berwick,4900,8,8,10,18,29,61,-32,34
Edinburgh Ci,4900,9,7,9,20,36,61,-25,30
Cowdenbeath,4900,10,4,11,21,24,55,-31,23
Montrose,4901,1,24,7,5,61,34,27,79
Peterhead,4901,2,24,4,8,80,40,40,76
Stirling,4901,3,17,6,13,61,51,10,57
Stenhousem'r,4901,4,15,8,13,55,47,8,53
Clyde,4901,5,14,10,12,53,50,3,52
Elgin,4901,6,14,6,16,53,62,-9,48
Annan Athlet,4901,7,11,12,13,48,42,6,45
Berwick,4901,8,8,11,17,31,60,-29,35
Edinburgh Ci,4901,9,7,9,20,38,63,-25,30
Cowdenbeath,4901,10,4,11,21,24,55,-31,23
Montrose,4902,1,23,8,5,60,35,25,77
Peterhead,4902,2,24,4,8,79,39,40,76
Stirling,4902,3,17,6,13,63,51,12,57
Stenhousem'r,4902,4,15,8,13,55,49,6,53
Clyde,4902,5,14,9,13,51,49,2,51
Elgin,4902,6,14,7,15,54,61,-7,49
Annan Athlet,4902,7,12,11,13,49,41,8,47
Berwick,4902,8,9,10,17,30,58,-28,37
Edinburgh Ci,4902,9,7,9,20,37,62,-25,30
Cowdenbeath,4902,10,4,10,22,23,56,-33,22
Peterhead,4903,1,24,4,8,79,39,40,76
Montrose,4903,2,23,7,6,59,35,24,76
Stenhousem'r,4903,3,16,8,12,57,46,11,56
Stirling,4903,4,16,6,14,60,53,7,54
Clyde,4903,5,15,9,12,55,50,5,54
Elgin,4903,6,15,6,15,54,60,-6,51
Annan Athlet,4903,7,11,11,14,48,44,4,44
Berwick,4903,8,8,10,18,31,62,-31,34
Edinburgh Ci,4903,9,7,9,20,37,62,-25,30
Cowdenbeath,4903,10,5,10,21,26,55,-29,25
Montrose,4904,1,24,7,5,60,34,26,79
Peterhead,4904,2,24,4,8,78,38,40,76
Stirling,4904,3,17,6,13,62,51,11,57
Stenhousem'r,4904,4,15,8,13,55,48,7,53
Clyde,4904,5,14,10,12,52,49,3,52
Elgin,4904,6,14,6,16,53,61,-8,48
Annan Athlet,4904,7,11,11,14,48,43,5,44
Berwick,4904,8,8,11,17,30,59,-29,35
Edinburgh Ci,4904,9,7,9,20,36,61,-25,30
Cowdenbeath,4904,10,5,10,21,25,55,-30,25
Montrose,4905,1,24,7,5,62,35,27,79
Peterhead,4905,2,24,4,8,83,39,44,76
Stirling,4905,3,17,6,13,62,52,10,57
Stenhousem'r,4905,4,15,8,13,56,48,8,53
Clyde,4905,5,14,10,12,52,49,3,52
Elgin,4905,6,14,6,16,54,63,-9,48
Annan Athlet,4905,7,12,11,13,48,41,7,47
Berwick,4905,8,8,11,17,30,59,-29,35
Edinburgh Ci,4905,9,7,9,20,37,66,-29,30
Cowdenbeath,4905,10,4,10,22,23,55,-32,22
Montrose,4906,1,24,7,5,61,35,26,79
Peterhead,4906,2,24,4,8,80,38,42,76
Stirling,4906,3,16,7,13,61,52,9,55
Stenhousem'r,4906,4,15,9,12,56,47,9,54
Clyde,4906,5,15,9,12,53,49,4,54
Elgin,4906,6,14,6,16,54,62,-8,48
Annan Athlet,4906,7,11,12,13,47,41,6,45
Berwick,4906,8,8,10,18,30,60,-30,34
Edinburgh Ci,4906,9,7,9,20,36,63,-27,30
Cowdenbeath,4906,10,4,11,21,23,54,-31,23
Peterhead,4907,1,24,4,8,80,38,42,76
Montrose,4907,2,23,7,6,60,37,23,76
Stirling,4907,3,17,6,13,62,52,10,57
Stenhousem'r,4907,4,15,8,13,56,48,8,53
Clyde,4907,5,14,10,12,52,49,3,52
Elgin,4907,6,15,6,15,56,61,-5,51
Annan Athlet,4907,7,11,11,14,48,44,4,44
Berwick,4907,8,8,11,17,30,59,-29,35
Edinburgh Ci,4907,9,7,9,20,36,63,-27,30
Cowdenbeath,4907,10,5,10,21,26,55,-29,25
Peterhead,4908,1,24,4,8,81,40,41,76
Montrose,4908,2,23,7,6,60,37,23,76
Stirling,4908,3,17,6,13,62,52,10,57
Clyde,4908,4,15,9,12,52,48,4,54
Stenhousem'r,4908,5,15,8,13,56,48,8,53
Elgin,4908,6,15,6,15,56,61,-5,51
Annan Athlet,4908,7,12,11,13,49,42,7,47
Berwick,4908,8,8,10,18,29,59,-30,34
Edinburgh Ci,4908,9,7,9,20,38,64,-26,30
Cowdenbeath,4908,10,4,10,22,24,56,-32,22
Peterhead,4909,1,24,4,8,80,39,41,76
Montrose,4909,2,23,7,6,60,39,21,76
Stirling,4909,3,17,6,13,62,52,10,57
Clyde,4909,4,15,9,12,54,48,6,54
Stenhousem'r,4909,5,15,8,13,56,48,8,53
Elgin,4909,6,15,6,15,58,61,-3,51
Annan Athlet,4909,7,11,11,14,48,43,5,44
Berwick,4909,8,8,10,18,29,61,-32,34
Edinburgh Ci,4909,9,7,9,20,37,63,-26,30
Cowdenbeath,4909,10,5,10,21,25,55,-30,25
Montrose,4910,1,23,8,5,61,36,25,77
Peterhead,4910,2,24,4,8,78,38,40,76
Stirling,4910,3,17,6,13,61,51,10,57
Clyde,4910,4,15,9,12,53,49,4,54
Stenhousem'r,4910,5,15,8,13,55,47,8,53
Elgin,4910,6,14,7,15,55,62,-7,49
Annan Athlet,4910,7,12,11,13,50,42,8,47
Berwick,4910,8,8,10,18,30,60,-30,34
Edinburgh Ci,4910,9,7,9,20,36,61,-25,30
Cowdenbeath,4910,10,4,10,22,24,57,-33,22
Montrose,4911,1,23,8,5,61,36,25,77
Peterhead,4911,2,24,4,8,79,38,41,76
Stirling,4911,3,17,6,13,63,52,11,57
Clyde,4911,4,15,9,12,54,48,6,54
Stenhousem'r,4911,5,15,8,13,56,49,7,53
Elgin,4911,6,14,7,15,55,62,-7,49
Annan Athlet,4911,7,11,11,14,47,43,4,44
Berwick,4911,8,8,10,18,29,61,-32,34
Edinburgh Ci,4911,9,7,9,20,36,62,-26,30
Cowdenbeath,4911,10,5,10,21,25,54,-29,25
Montrose,4912,1,24,7,5,61,35,26,79
Peterhead,4912,2,24,4,8,80,38,42,76
Stirling,4912,3,17,6,13,61,51,10,57
Clyde,4912,4,15,9,12,52,48,4,54
Stenhousem'r,4912,5,15,8,13,55,47,8,53
Elgin,4912,6,14,6,16,54,62,-8,48
Annan Athlet,4912,7,12,11,13,48,41,7,47
Berwick,4912,8,8,10,18,29,59,-30,34
Edinburgh Ci,4912,9,7,9,20,36,63,-27,30
Cowdenbeath,4912,10,4,10,22,23,55,-32,22
Montrose,4913,1,23,8,5,61,36,25,77
Peterhead,4913,2,23,4,9,77,39,38,73
Stenhousem'r,4913,3,16,8,12,57,47,10,56
Stirling,4913,4,16,6,14,61,53,8,54
Clyde,4913,5,14,10,12,51,48,3,52
Elgin,4913,6,14,7,15,55,62,-7,49
Annan Athlet,4913,7,12,11,13,49,42,7,47
Berwick,4913,8,8,11,17,29,58,-29,35
Edinburgh Ci,4913,9,8,9,19,37,60,-23,33
Cowdenbeath,4913,10,4,10,22,24,56,-32,22
Montrose,4914,1,23,8,5,60,35,25,77
Peterhead,4914,2,24,4,8,78,38,40,76
Stirling,4914,3,17,6,13,63,52,11,57
Stenhousem'r,4914,4,15,8,13,56,49,7,53
Clyde,4914,5,14,10,12,52,49,3,52
Elgin,4914,6,14,7,15,54,61,-7,49
Annan Athlet,4914,7,12,11,13,48,41,7,47
Berwick,4914,8,8,11,17,30,59,-29,35
Edinburgh Ci,4914,9,7,9,20,36,61,-25,30
Cowdenbeath,4914,10,4,10,22,23,55,-32,22
Montrose,4915,1,24,7,5,62,35,27,79
Peterhead,4915,2,24,4,8,79,39,40,76
Stirling,4915,3,17,6,13,62,51,11,57
Clyde,4915,4,15,9,12,56,48,8,54
Stenhousem'r,4915,5,15,8,13,55,48,7,53
Elgin,4915,6,14,6,16,54,63,-9,48
Annan Athlet,4915,7,11,12,13,48,42,6,45
Berwick,4915,8,8,10,18,29,63,-34,34
Edinburgh Ci,4915,9,7,9,20,37,62,-25,30
Cowdenbeath,4915,10,4,11,21,24,55,-31,23
Montrose,4916,1,24,7,5,62,35,27,79
Peterhead,4916,2,24,4,8,81,38,43,76
Stirling,4916,3,17,6,13,62,52,10,57
Clyde,4916,4,15,9,12,53,48,5,54
Stenhousem'r,4916,5,15,8,13,56,48,8,53
Elgin,4916,6,14,6,16,54,63,-9,48
Annan Athlet,4916,7,12,11,13,48,41,7,47
Berwick,4916,8,8,10,18,29,60,-31,34
Edinburgh Ci,4916,9,7,9,20,36,64,-28,30
Cowdenbeath,4916,10,4,10,22,23,55,-32,22
Montrose,4917,1,24,7,5,60,34,26,79
Peterhead,4917,2,24,4,8,80,40,40,76
Stirling,4917,3,17,6,13,63,51,12,57
Clyde,4917,4,15,9,12,55,49,6,54
Stenhousem'r,4917,5,15,8,13,55,49,6,53
Elgin,4917,6,14,6,16,53,61,-8,48
Annan Athlet,4917,7,11,12,13,48,42,6,45
Berwick,4917,8,8,10,18,30,62,-32,34
Edinburgh Ci,4917,9,7,9,20,38,63,-25,30
Cowdenbeath,4917,10,4,11,21,24,55,-31,23
Montrose,4918,1,23,7,6,60,38,22,76
Peterhead,4918,2,23,5,8,77,38,39,74
Stenhousem'r,4918,3,16,8,12,58,48,10,56
Stirling,4918,4,16,6,14,62,54,8,54
Clyde,4918,5,15,9,12,54,48,6,54
Elgin,4918,6,15,6,15,57,61,-4,51
Annan Athlet,4918,7,11,12,13,49,43,6,45
Berwick,4918,8,8,10,18,29,61,-32,34
Edinburgh Ci,4918,9,7,10,19,36,60,-24,31
Cowdenbeath,4918,10,4,11,21,25,56,-31,23
Montrose,4919,1,24,7,5,62,36,26,79
Peterhead,4919,2,24,4,8,80,38,42,76
Stenhousem'r,4919,3,16,8,12,57,46,11,56
Stirling,4919,4,16,6,14,60,53,7,54
Clyde,4919,5,15,9,12,54,49,5,54
Elgin,4919,6,14,6,16,55,63,-8,48
Annan Athlet,4919,7,12,11,13,49,41,8,47
Berwick,4919,8,8,10,18,30,61,-31,34
Edinburgh Ci,4919,9,7,9,20,36,63,-27,30
Cowdenbeath,4919,10,4,10,22,23,56,-33,22
Montrose,4920,1,24,7,5,63,36,27,79
Peterhead,4920,2,24,4,8,80,38,42,76
Stirling,4920,3,17,6,13,64,53,11,57
Stenhousem'r,4920,4,15,8,13,57,50,7,53
Clyde,4920,5,14,9,13,51,49,2,51
Elgin,4920,6,14,6,16,55,64,-9,48
Annan Athlet,4920,7,11,12,13,50,44,6,45
Berwick,4920,8,9,10,17,30,58,-28,37
Edinburgh Ci,4920,9,7,9,20,36,63,-27,30
Cowdenbeath,4920,10,4,11,21,26,57,-31,23
Montrose,4921,1,23,8,5,61,36,25,77
Peterhead,4921,2,24,4,8,80,38,42,76
Stirling,4921,3,17,6,13,65,55,10,57
Stenhousem'r,4921,4,15,8,13,59,51,8,53
Clyde,4921,5,14,10,12,52,49,3,52
Elgin,4921,6,14,7,15,55,62,-7,49
Annan Athlet,4921,7,11,11,14,47,44,3,44
Berwick,4921,8,8,11,17,30,59,-29,35
Edinburgh Ci,4921,9,7,9,20,36,63,-27,30
Cowdenbeath,4921,10,5,10,21,26,54,-28,25
Montrose,4922,1,24,7,5,65,34,31,79
Peterhead,4922,2,23,5,8,79,40,39,74
Stenhousem'r,4922,3,16,8,12,57,47,10,56
Stirling,4922,4,16,6,14,61,53,8,54
Clyde,4922,5,14,10,12,51,48,3,52
Elgin,4922,6,14,6,16,53,66,-13,48
Annan Athlet,4922,7,12,11,13,48,41,7,47
Berwick,4922,8,8,11,17,29,58,-29,35
Edinburgh Ci,4922,9,7,10,19,38,62,-24,31
Cowdenbeath,4922,10,4,10,22,23,55,-32,22
Montrose,4923,1,24,7,5,60,34,26,79
Peterhead,4923,2,24,4,8,79,39,40,76
Stirling,4923,3,16,7,13,62,53,9,55
Stenhousem'r,4923,4,15,9,12,57,48,9,54
Clyde,4923,5,14,10,12,52,49,3,52
Elgin,4923,6,14,6,16,53,61,-8,48
Annan Athlet,4923,7,12,11,13,50,41,9,47
Berwick,4923,8,8,11,17,30,59,-29,35
Edinburgh Ci,4923,9,7,9,20,37,62,-25,30
Cowdenbeath,4923,10,4,10,22,23,57,-34,22
Montrose,4924,1,24,7,5,61,35,26,79
Peterhead,4924,2,24,4,8,79,38,41,76
Stirling,4924,3,17,6,13,63,52,11,57
Clyde,4924,4,15,9,12,53,49,4,54
Stenhousem'r,4924,5,15,8,13,56,49,7,53
Elgin,4924,6,14,6,16,54,62,-8,48
Annan Athlet,4924,7,12,11,13,49,42,7,47
Berwick,4924,8,8,10,18,30,60,-30,34
Edinburgh Ci,4924,9,7,9,20,36,62,-26,30
Cowdenbeath,4924,10,4,10,22,24,56,-32,22
Montrose,4925,1,24,7,5,61,35,26,79
Peterhead,4925,2,24,4,8,80,38,42,76
Stirling,4925,3,17,6,13,62,52,10,57
Stenhousem'r,4925,4,15,8,13,56,48,8,53
Clyde,4925,5,14,9,13,51,49,2,51
Elgin,4925,6,14,6,16,54,62,-8,48
Annan Athlet,4925,7,12,11,13,48,41,7,47
Berwick,4925,8,9,10,17,30,58,-28,37
Edinburgh Ci,4925,9,7,9,20,36,63,-27,30
Cowdenbeath,4925,10,4,10,22,23,55,-32,22
Montrose,4926,1,23,8,5,59,34,25,77
Peterhead,4926,2,24,4,8,81,39,42,76
Stirling,4926,3,17,6,13,65,52,13,57
Stenhousem'r,4926,4,15,8,13,56,51,5,53
Clyde,4926,5,14,10,12,51,48,3,52
Elgin,4926,6,14,7,15,53,60,-7,49
Annan Athlet,4926,7,11,11,14,49,45,4,44
Berwick,4926,8,8,11,17,29,58,-29,35
Edinburgh Ci,4926,9,7,9,20,37,64,-27,30
Cowdenbeath,4926,10,5,10,21,27,56,-29,25
Montrose,4927,1,24,7,5,63,36,27,79
Peterhead,4927,2,23,5,8,77,38,39,74
Stenhousem'r,4927,3,16,8,12,57,46,11,56
Stirling,4927,4,16,6,14,60,53,7,54
Clyde,4927,5,14,10,12,52,49,3,52
Elgin,4927,6,14,6,16,55,64,-9,48
Annan Athlet,4927,7,11,11,14,47,43,4,44
Berwick,4927,8,8,11,17,30,59,-29,35
Edinburgh Ci,4927,9,7,10,19,36,60,-24,31
Cowdenbeath,4927,10,5,10,21,25,54,-29,25
Peterhead,4928,1,24,4,8,79,39,40,76
Montrose,4928,2,23,7,6,60,37,23,76
Stirling,4928,3,17,6,13,62,51,11,57
Clyde,4928,4,15,9,12,53,48,5,54
Stenhousem'r,4928,5,15,8,13,55,48,7,53
Elgin,4928,6,15,6,15,56,61,-5,51
Annan Athlet,4928,7,11,12,13,49,43,6,45
Berwick,4928,8,8,10,18,29,60,-31,34
Edinburgh Ci,4928,9,7,9,20,37,62,-25,30
Cowdenbeath,4928,10,4,11,21,25,56,-31,23
Montrose,4929,1,24,7,5,61,35,26,79
Peterhead,4929,2,24,4,8,78,38,40,76
Stenhousem'r,4929,3,16,8,12,57,46,11,56
Stirling,4929,4,16,6,14,60,53,7,54
Clyde,4929,5,15,9,12,54,49,5,54
Elgin,4929,6,14,6,16,54,62,-8,48
Annan Athlet,4929,7,11,11,14,47,43,4,44
Berwick,4929,8,8,10,18,30,61,-31,34
Edinburgh Ci,4929,9,7,9,20,36,61,-25,30
Cowdenbeath,4929,10,5,10,21,25,54,-29,25
Montrose,4930,1,24,7,5,61,35,26,79
Peterhead,4930,2,23,4,9,77,39,38,73
Stirling,4930,3,17,6,13,64,53,11,57
Stenhousem'r,4930,4,15,8,13,57,50,7,53
Clyde,4930,5,14,10,12,53,50,3,52
Elgin,4930,6,14,6,16,54,62,-8,48
Annan Athlet,4930,7,12,11,13,51,41,10,47
Berwick,4930,8,8,11,17,31,60,-29,35
Edinburgh Ci,4930,9,8,9,19,37,60,-23,33
Cowdenbeath,4930,10,4,10,22,23,58,-35,22
Montrose,4931,1,23,7,6,60,36,24,76
Peterhead,4931,2,23,4,9,79,41,38,73
Stirling,4931,3,17,6,13,62,51,11,57
Stenhousem'r,4931,4,15,8,13,55,48,7,53
Clyde,4931,5,14,10,12,55,52,3,52
Elgin,4931,6,15,6,15,55,61,-6,51
Annan Athlet,4931,7,11,11,14,48,47,1,44
Berwick,4931,8,8,11,17,33,62,-29,35
Edinburgh Ci,4931,9,8,9,19,39,62,-23,33
Cowdenbeath,4931,10,5,10,21,29,55,-26,25
Montrose,4932,1,24,7,5,60,34,26,79
Peterhead,4932,2,24,4,8,81,38,43,76
Stirling,4932,3,17,6,13,62,51,11,57
Clyde,4932,4,15,9,12,52,48,4,54
Stenhousem'r,4932,5,15,8,13,55,48,7,53
Elgin,4932,6,14,6,16,53,61,-8,48
Annan Athlet,4932,7,11,11,14,47,42,5,44
Berwick,4932,8,8,10,18,29,59,-30,34
Edinburgh Ci,4932,9,7,9,20,36,64,-28,30
Cowdenbeath,4932,10,5,10,21,24,54,-30,25
Montrose,4933,1,24,7,5,61,34,27,79
Peterhead,4933,2,24,4,8,80,38,42,76
Stenhousem'r,4933,3,16,8,12,57,47,10,56
Stirling,4933,4,16,6,14,61,53,8,54
Clyde,4933,5,15,9,12,53,48,5,54
Elgin,4933,6,14,6,16,53,62,-9,48
Annan Athlet,4933,7,12,11,13,51,41,10,47
Berwick,4933,8,8,10,18,29,60,-31,34
Edinburgh Ci,4933,9,7,9,20,36,63,-27,30
Cowdenbeath,4933,10,4,10,22,23,58,-35,22
Montrose,4934,1,24,7,5,60,34,26,79
Peterhead,4934,2,23,5,8,79,40,39,74
Stenhousem'r,4934,3,16,8,12,58,48,10,56
Stirling,4934,4,16,6,14,62,54,8,54
Clyde,4934,5,15,9,12,52,48,4,54
Elgin,4934,6,14,6,16,53,61,-8,48
Annan Athlet,4934,7,12,11,13,48,41,7,47
Berwick,4934,8,8,10,18,29,59,-30,34
Edinburgh Ci,4934,9,7,10,19,38,62,-24,31
Cowdenbeath,4934,10,4,10,22,23,55,-32,22
Montrose,4935,1,24,7,5,61,34,27,79
Peterhead,4935,2,23,5,8,77,38,39,74
Stenhousem'r,4935,3,16,8,12,57,46,11,56
Stirling,4935,4,16,6,14,60,53,7,54
Clyde,4935,5,15,9,12,54,48,6,54
Elgin,4935,6,14,6,16,53,62,-9,48
Annan Athlet,4935,7,11,12,13,48,42,6,45
Berwick,4935,8,8,10,18,29,61,-32,34
Edinburgh Ci,4935,9,7,10,19,36,60,-24,31
Cowdenbeath,4935,10,4,11,21,24,55,-31,23
Montrose,4936,1,24,7,5,63,34,29,79
Peterhead,4936,2,24,4,8,80,38,42,76
Stenhousem'r,4936,3,16,8,12,56,46,10,56
Stirling,4936,4,16,6,14,60,52,8,54
Clyde,4936,5,14,10,12,52,49,3,52
Elgin,4936,6,14,6,16,53,64,-11,48
Annan Athlet,4936,7,12,11,13,49,42,7,47
Berwick,4936,8,8,11,17,30,59,-29,35
Edinburgh Ci,4936,9,7,9,20,36,63,-27,30
Cowdenbeath,4936,10,4,10,22,24,56,-32,22
Peterhead,4937,1,24,4,8,79,38,41,76
Montrose,4937,2,23,7,6,59,37,22,76
Stirling,4937,3,17,6,13,63,53,10,57
Stenhousem'r,4937,4,15,8,13,57,49,8,53
Clyde,4937,5,14,9,13,52,50,2,51
Elgin,4937,6,15,6,15,56,60,-4,51
Annan Athlet,4937,7,12,11,13,48,41,7,47
Berwick,4937,8,9,10,17,31,59,-28,37
Edinburgh Ci,4937,9,7,9,20,36,62,-26,30
Cowdenbeath,4937,10,4,10,22,23,55,-32,22
Montrose,4938,1,24,7,5,63,35,28,79
Peterhead,4938,2,23,4,9,78,40,38,73
Stirling,4938,3,17,6,13,64,54,10,57
Clyde,4938,4,15,9,12,55,49,6,54
Stenhousem'r,4938,5,15,8,13,58,50,8,53
Elgin,4938,6,14,6,16,54,64,-10,48
Annan Athlet,4938,7,12,11,13,49,42,7,47
Berwick,4938,8,8,10,18,30,62,-32,34
Edinburgh Ci,4938,9,8,9,19,38,61,-23,33
Cowdenbeath,4938,10,4,10,22,24,56,-32,22
Montrose,4939,1,23,8,5,61,36,25,77
Peterhead,4939,2,24,4,8,80,39,41,76
Stenhousem'r,4939,3,16,8,12,57,47,10,56
Stirling,4939,4,16,6,14,61,53,8,54
Clyde,4939,5,14,10,12,52,49,3,52
Elgin,4939,6,14,7,15,55,62,-7,49
Annan Athlet,4939,7,11,11,14,47,43,4,44
Berwick,4939,8,8,11,17,30,59,-29,35
Edinburgh Ci,4939,9,7,9,20,37,63,-26,30
Cowdenbeath,4939,10,5,10,21,25,54,-29,25
Montrose,4940,1,24,7,5,60,34,26,79
Peterhead,4940,2,24,4,8,83,39,44,76
Stirling,4940,3,16,7,13,61,52,9,55
Stenhousem'r,4940,4,15,9,12,56,47,9,54
Clyde,4940,5,14,9,13,53,51,2,51
Elgin,4940,6,14,6,16,53,61,-8,48
Annan Athlet,4940,7,11,11,14,47,42,5,44
Berwick,4940,8,9,10,17,32,60,-28,37
Edinburgh Ci,4940,9,7,9,20,37,66,-29,30
Cowdenbeath,4940,10,5,10,21,24,54,-30,25
Montrose,4941,1,24,7,5,62,34,28,79
Peterhead,4941,2,24,4,8,79,39,40,76
Stenhousem'r,4941,3,16,8,12,57,47,10,56
Stirling,4941,4,16,6,14,61,53,8,54
Clyde,4941,5,15,9,12,52,48,4,54
Elgin,4941,6,14,6,16,53,63,-10,48
Annan Athlet,4941,7,11,11,14,47,43,4,44
Berwick,4941,8,8,10,18,29,59,-30,34
Edinburgh Ci,4941,9,7,9,20,37,62,-25,30
Cowdenbeath,4941,10,5,10,21,25,54,-29,25
Montrose,4942,1,24,7,5,63,35,28,79
Peterhead,4942,2,24,4,8,78,38,40,76
Stirling,4942,3,17,6,13,61,51,10,57
Clyde,4942,4,15,9,12,56,49,7,54
Stenhousem'r,4942,5,15,8,13,55,47,8,53
Elgin,4942,6,14,6,16,54,64,-10,48
Annan Athlet,4942,7,12,11,13,50,42,8,47
Berwick,4942,8,8,10,18,30,63,-33,34
Edinburgh Ci,4942,9,7,9,20,36,61,-25,30
Cowdenbeath,4942,10,4,10,22,24,57,-33,22
Peterhead,4943,1,24,4,8,79,39,40,76
Montrose,4943,2,23,7,6,61,37,24,76
Stenhousem'r,4943,3,16,8,12,57,47,10,56
Stirling,4943,4,16,6,14,61,53,8,54
Clyde,4943,5,14,9,13,51,51,0,51
Elgin,4943,6,15,6,15,56,62,-6,51
Annan Athlet,4943,7,11,12,13,47,41,6,45
Berwick,4943,8,9,10,17,32,58,-26,37
Edinburgh Ci,4943,9,7,9,20,37,62,-25,30
Cowdenbeath,4943,10,4,11,21,23,54,-31,23
Peterhead,4944,1,24,4,8,79,39,40,76
Montrose,4944,2,23,7,6,60,36,24,76
Stirling,4944,3,16,7,13,62,53,9,55
Stenhousem'r,4944,4,15,9,12,57,48,9,54
Clyde,4944,5,15,9,12,52,48,4,54
Elgin,4944,6,15,6,15,55,61,-6,51
Annan Athlet,4944,7,11,12,13,47,41,6,45
Berwick,4944,8,8,10,18,29,59,-30,34
Edinburgh Ci,4944,9,7,9,20,37,62,-25,30
Cowdenbeath,4944,10,4,11,21,23,54,-31,23
Peterhead,4945,1,24,4,8,79,39,40,76
Montrose,4945,2,23,7,6,60,36,24,76
Stirling,4945,3,17,6,13,63,51,12,57
Stenhousem'r,4945,4,15,8,13,55,49,6,53
Clyde,4945,5,14,9,13,51,50,1,51
Elgin,4945,6,15,6,15,55,61,-6,51
Annan Athlet,4945,7,11,11,14,47,42,5,44
Berwick,4945,8,9,10,17,31,58,-27,37
Edinburgh Ci,4945,9,7,9,20,37,62,-25,30
Cowdenbeath,4945,10,5,10,21,24,54,-30,25
Montrose,4946,1,24,7,5,61,35,26,79
Peterhead,4946,2,24,4,8,80,40,40,76
Stirling,4946,3,16,7,13,61,52,9,55
Stenhousem'r,4946,4,15,9,12,56,47,9,54
Clyde,4946,5,14,10,12,52,49,3,52
Elgin,4946,6,14,6,16,54,62,-8,48
Annan Athlet,4946,7,11,12,13,48,42,6,45
Berwick,4946,8,8,11,17,30,59,-29,35
Edinburgh Ci,4946,9,7,9,20,38,63,-25,30
Cowdenbeath,4946,10,4,11,21,24,55,-31,23
Montrose,4947,1,23,8,5,60,35,25,77
Peterhead,4947,2,24,4,8,80,39,41,76
Stirling,4947,3,17,6,13,62,51,11,57
Stenhousem'r,4947,4,15,8,13,55,48,7,53
Clyde,4947,5,14,9,13,51,49,2,51
Elgin,4947,6,14,7,15,54,61,-7,49
Annan Athlet,4947,7,11,11,14,47,44,3,44
Berwick,4947,8,9,10,17,30,58,-28,37
Edinburgh Ci,4947,9,7,9,20,37,63,-26,30
Cowdenbeath,4947,10,5,10,21,26,54,-28,25
Montrose,4948,1,23,8,5,60,35,25,77
Peterhead,4948,2,24,4,8,82,39,43,76
Stenhousem'r,4948,3,16,8,12,58,47,11,56
Stirling,4948,4,16,6,14,61,54,7,54
Clyde,4948,5,14,10,12,51,48,3,52
Elgin,4948,6,14,7,15,54,61,-7,49
Annan Athlet,4948,7,11,12,13,47,41,6,45
Berwick,4948,8,8,11,17,29,58,-29,35
Edinburgh Ci,4948,9,7,9,20,37,65,-28,30
Cowdenbeath,4948,10,4,11,21,23,54,-31,23
Montrose,4949,1,24,7,5,62,35,27,79
Peterhead,4949,2,24,4,8,82,39,43,76
Stirling,4949,3,17,6,13,63,51,12,57
Clyde,4949,4,15,9,12,54,48,6,54
Stenhousem'r,4949,5,15,8,13,55,49,6,53
Elgin,4949,6,14,6,16,54,63,-9,48
Annan Athlet,4949,7,11,11,14,48,44,4,44
Berwick,4949,8,8,10,18,29,61,-32,34
Edinburgh Ci,4949,9,7,9,20,37,65,-28,30
Cowdenbeath,4949,10,5,10,21,26,55,-29,25
Montrose,4950,1,24,7,5,63,34,29,79
Peterhead,4950,2,24,4,8,78,38,40,76
Stirling,4950,3,17,6,13,62,52,10,57
Clyde,4950,4,15,9,12,55,49,6,54
Stenhousem'r,4950,5,15,8,13,56,48,8,53
Elgin,4950,6,14,6,16,53,64,-11,48
Annan Athlet,4950,7,11,12,13,49,43,6,45
Berwick,4950,8,8,10,18,30,62,-32,34
Edinburgh Ci,4950,9,7,9,20,36,61,-25,30
Cowdenbeath,4950,10,4,11,21,25,56,-31,23
Montrose,4951,1,23,8,5,61,36,25,77
Peterhead,4951,2,23,5,8,79,40,39,74
Stenhousem'r,4951,3,16,8,12,59,48,11,56
Stirling,4951,4,16,6,14,62,55,7,54
Clyde,4951,5,15,9,12,54,50,4,54
Elgin,4951,6,14,7,15,55,62,-7,49
Annan Athlet,4951,7,11,11,14,48,43,5,44
Berwick,4951,8,8,10,18,31,61,-30,34
Edinburgh Ci,4951,9,7,10,19,38,62,-24,31
Cowdenbeath,4951,10,5,10,21,25,55,-30,25
Montrose,4952,1,24,7,5,63,36,27,79
Peterhead,4952,2,23,5,8,79,40,39,74
Stirling,4952,3,16,7,13,63,54,9,55
Stenhousem'r,4952,4,15,9,12,58,49,9,54
Clyde,4952,5,14,10,12,52,49,3,52
Elgin,4952,6,14,6,16,55,64,-9,48
Annan Athlet,4952,7,12,11,13,48,41,7,47
Berwick,4952,8,8,11,17,30,59,-29,35
Edinburgh Ci,4952,9,7,10,19,38,62,-24,31
Cowdenbeath,4952,10,4,10,22,23,55,-32,22
Montrose,4953,1,23,7,6,60,37,23,76
Peterhead,4953,2,23,5,8,80,41,39,74
Stirling,4953,3,17,6,13,63,51,12,57
Clyde,4953,4,15,9,12,55,48,7,54
Stenhousem'r,4953,5,15,8,13,55,49,6,53
Elgin,4953,6,15,6,15,56,61,-5,51
Annan Athlet,4953,7,11,11,14,47,42,5,44
Berwick,4953,8,8,10,18,29,62,-33,34
Edinburgh Ci,4953,9,7,10,19,39,63,-24,31
Cowdenbeath,4953,10,5,10,21,24,54,-30,25
Peterhead,4954,1,24,4,8,80,39,41,76
Montrose,4954,2,23,7,6,60,37,23,76
Stirling,4954,3,17,6,13,61,51,10,57
Stenhousem'r,4954,4,15,8,13,55,47,8,53
Clyde,4954,5,14,9,13,51,49,2,51
Elgin,4954,6,15,6,15,56,61,-5,51
Annan Athlet,4954,7,11,11,14,47,43,4,44
Berwick,4954,8,9,10,17,30,58,-28,37
Edinburgh Ci,4954,9,7,9,20,37,63,-26,30
Cowdenbeath,4954,10,5,10,21,25,54,-29,25
Montrose,4955,1,23,8,5,60,35,25,77
Peterhead,4955,2,24,4,8,80,38,42,76
Stirling,4955,3,17,6,13,63,53,10,57
Clyde,4955,4,15,9,12,54,49,5,54
Stenhousem'r,4955,5,15,8,13,57,49,8,53
Elgin,4955,6,14,7,15,54,61,-7,49
Annan Athlet,4955,7,11,11,14,48,43,5,44
Berwick,4955,8,8,10,18,30,61,-31,34
Edinburgh Ci,4955,9,7,9,20,36,63,-27,30
Cowdenbeath,4955,10,5,10,21,25,55,-30,25
Montrose,4956,1,24,7,5,62,34,28,79
Peterhead,4956,2,24,4,8,81,39,42,76
Stirling,4956,3,17,6,13,61,51,10,57
Clyde,4956,4,15,9,12,52,48,4,54
Stenhousem'r,4956,5,15,8,13,55,47,8,53
Elgin,4956,6,14,6,16,53,63,-10,48
Annan Athlet,4956,7,11,11,14,47,42,5,44
Berwick,4956,8,8,10,18,29,59,-30,34
Edinburgh Ci,4956,9,7,9,20,37,64,-27,30
Cowdenbeath,4956,10,5,10,21,24,54,-30,25
Montrose,4957,1,24,7,5,61,34,27,79
Peterhead,4957,2,23,5,8,79,40,39,74
Stirling,4957,3,16,7,13,61,52,9,55
Stenhousem'r,4957,4,15,9,12,56,47,9,54
Clyde,4957,5,15,9,12,53,49,4,54
Elgin,4957,6,14,6,16,53,62,-9,48
Annan Athlet,4957,7,11,11,14,47,42,5,44
Berwick,4957,8,8,10,18,30,60,-30,34
Edinburgh Ci,4957,9,7,10,19,38,62,-24,31
Cowdenbeath,4957,10,5,10,21,24,54,-30,25
Montrose,4958,1,23,7,6,59,36,23,76
Peterhead,4958,2,23,4,9,78,40,38,73
Stirling,4958,3,16,7,13,60,51,9,55
Stenhousem'r,4958,4,15,9,12,55,46,9,54
Clyde,4958,5,15,9,12,56,51,5,54
Elgin,4958,6,15,6,15,55,60,-5,51
Annan Athlet,4958,7,12,11,13,48,41,7,47
Berwick,4958,8,8,10,18,32,63,-31,34
Edinburgh Ci,4958,9,8,9,19,38,61,-23,33
Cowdenbeath,4958,10,4,10,22,23,55,-32,22
Montrose,4959,1,24,7,5,64,35,29,79
Peterhead,4959,2,24,4,8,82,38,44,76
Stirling,4959,3,17,6,13,63,51,12,57
Stenhousem'r,4959,4,15,8,13,55,49,6,53
Clyde,4959,5,14,10,12,51,48,3,52
Elgin,4959,6,14,6,16,54,65,-11,48
Annan Athlet,4959,7,12,11,13,51,42,9,47
Berwick,4959,8,8,11,17,29,58,-29,35
Edinburgh Ci,4959,9,7,9,20,36,65,-29,30
Cowdenbeath,4959,10,4,10,22,24,58,-34,22
Montrose,4960,1,24,7,5,62,34,28,79
Peterhead,4960,2,23,5,8,78,39,39,74
Stirling,4960,3,16,7,13,60,51,9,55
Stenhousem'r,4960,4,15,9,12,55,46,9,54
Clyde,4960,5,14,9,13,52,50,2,51
Elgin,4960,6,14,6,16,53,63,-10,48
Annan Athlet,4960,7,11,12,13,47,41,6,45
Berwick,4960,8,9,10,17,31,59,-28,37
Edinburgh Ci,4960,9,7,10,19,37,61,-24,31
Cowdenbeath,4960,10,4,11,21,23,54,-31,23
Montrose,4961,1,24,7,5,62,34,28,79
Peterhead,4961,2,24,4,8,80,40,40,76
Stirling,4961,3,17,6,13,63,51,12,57
Clyde,4961,4,15,9,12,53,48,5,54
Stenhousem'r,4961,5,15,8,13,55,49,6,53
Elgin,4961,6,14,6,16,53,63,-10,48
Annan Athlet,4961,7,12,11,13,52,41,11,47
Berwick,4961,8,8,10,18,29,60,-31,34
Edinburgh Ci,4961,9,7,9,20,38,63,-25,30
Cowdenbeath,4961,10,4,10,22,23,59,-36,22
Montrose,4962,1,24,7,5,61,35,26,79
Peterhead,4962,2,24,4,8,82,40,42,76
Stenhousem'r,4962,3,16,8,12,57,46,11,56
Clyde,4962,4,15,9,12,58,49,9,54
Stirling,4962,5,16,6,14,60,53,7,54
Elgin,4962,6,14,6,16,54,62,-8,48
Annan Athlet,4962,7,11,11,14,48,43,5,44
Berwick,4962,8,8,10,18,30,65,-35,34
Edinburgh Ci,4962,9,7,9,20,38,65,-27,30
Cowdenbeath,4962,10,5,10,21,25,55,-30,25
Montrose,4963,1,24,7,5,60,34,26,79
Peterhead,4963,2,24,4,8,79,38,41,76
Stenhousem'r,4963,3,16,8,12,57,47,10,56
Stirling,4963,4,16,6,14,61,53,8,54
Clyde,4963,5,15,9,12,55,50,5,54
Elgin,4963,6,14,6,16,53,61,-8,48
Annan Athlet,4963,7,12,11,13,49,42,7,47
Berwick,4963,8,8,10,18,31,62,-31,34
Edinburgh Ci,4963,9,7,9,20,36,62,-26,30
Cowdenbeath,4963,10,4,10,22,24,56,-32,22
Montrose,4964,1,23,8,5,61,36,25,77
Peterhead,4964,2,24,4,8,84,39,45,76
Stirling,4964,3,17,6,13,62,51,11,57
Clyde,4964,4,15,9,12,53,49,4,54
Stenhousem'r,4964,5,15,8,13,55,48,7,53
Elgin,4964,6,14,7,15,55,62,-7,49
Annan Athlet,4964,7,11,11,14,47,43,4,44
Berwick,4964,8,8,10,18,30,60,-30,34
Edinburgh Ci,4964,9,7,9,20,37,67,-30,30
Cowdenbeath,4964,10,5,10,21,25,54,-29,25
Peterhead,4965,1,24,4,8,81,40,41,76
Montrose,4965,2,23,7,6,60,36,24,76
Stirling,4965,3,16,7,13,61,52,9,55
Stenhousem'r,4965,4,15,9,12,56,47,9,54
Clyde,4965,5,15,9,12,55,49,6,54
Elgin,4965,6,15,6,15,55,61,-6,51
Annan Athlet,4965,7,12,11,13,50,42,8,47
Berwick,4965,8,8,10,18,30,62,-32,34
Edinburgh Ci,4965,9,7,9,20,38,64,-26,30
Cowdenbeath,4965,10,4,10,22,24,57,-33,22
Montrose,4966,1,24,7,5,64,37,27,79
Peterhead,4966,2,24,4,8,79,38,41,76
Stenhousem'r,4966,3,16,8,12,58,48,10,56
Stirling,4966,4,16,6,14,62,54,8,54
Clyde,4966,5,15,9,12,55,49,6,54
Elgin,4966,6,14,6,16,56,65,-9,48
Annan Athlet,4966,7,11,11,14,47,44,3,44
Berwick,4966,8,8,10,18,30,62,-32,34
Edinburgh Ci,4966,9,7,9,20,36,62,-26,30
Cowdenbeath,4966,10,5,10,21,26,54,-28,25
Montrose,4967,1,23,8,5,60,35,25,77
Peterhead,4967,2,24,4,8,80,39,41,76
Stenhousem'r,4967,3,16,8,12,57,47,10,56
Stirling,4967,4,16,6,14,61,53,8,54
Clyde,4967,5,15,9,12,55,48,7,54
Elgin,4967,6,14,7,15,54,61,-7,49
Annan Athlet,4967,7,11,12,13,47,41,6,45
Berwick,4967,8,8,10,18,29,62,-33,34
Edinburgh Ci,4967,9,7,9,20,37,63,-26,30
Cowdenbeath,4967,10,4,11,21,23,54,-31,23
Montrose,4968,1,24,7,5,60,34,26,79
Peterhead,4968,2,23,4,9,77,39,38,73
Stirling,4968,3,16,7,13,64,55,9,55
Stenhousem'r,4968,4,15,9,12,59,50,9,54
Clyde,4968,5,14,9,13,51,50,1,51
Elgin,4968,6,14,6,16,53,61,-8,48
Annan Athlet,4968,7,12,11,13,48,41,7,47
Berwick,4968,8,9,10,17,31,58,-27,37
Edinburgh Ci,4968,9,8,9,19,37,60,-23,33
Cowdenbeath,4968,10,4,10,22,23,55,-32,22
Montrose,4969,1,23,8,5,59,34,25,77
Peterhead,4969,2,24,4,8,83,39,44,76
Stirling,4969,3,16,7,13,61,52,9,55
Stenhousem'r,4969,4,15,9,12,56,47,9,54
Clyde,4969,5,15,9,12,54,49,5,54
Elgin,4969,6,14,7,15,53,60,-7,49
Annan Athlet,4969,7,11,11,14,48,43,5,44
Berwick,4969,8,8,10,18,30,61,-31,34
Edinburgh Ci,4969,9,7,9,20,37,66,-29,30
Cowdenbeath,4969,10,5,10,21,25,55,-30,25
Montrose,4970,1,24,7,5,60,34,26,79
Peterhead,4970,2,23,5,8,78,39,39,74
Stenhousem'r,4970,3,16,8,12,58,47,11,56
Stirling,4970,4,16,6,14,61,54,7,54
Clyde,4970,5,14,9,13,51,50,1,51
Elgin,4970,6,14,6,16,53,61,-8,48
Annan Athlet,4970,7,11,11,14,47,43,4,44
Berwick,4970,8,9,10,17,31,58,-27,37
Edinburgh Ci,4970,9,7,10,19,37,61,-24,31
Cowdenbeath,4970,10,5,10,21,25,54,-29,25
Montrose,4971,1,24,7,5,65,34,31,79
Peterhead,4971,2,24,4,8,82,38,44,76
Stirling,4971,3,16,7,13,61,52,9,55
Stenhousem'r,4971,4,15,9,12,56,47,9,54
Clyde,4971,5,15,9,12,52,48,4,54
Elgin,4971,6,14,6,16,53,66,-13,48
Annan Athlet,4971,7,12,11,13,50,41,9,47
Berwick,4971,8,8,10,18,29,59,-30,34
Edinburgh Ci,4971,9,7,9,20,36,65,-29,30
Cowdenbeath,4971,10,4,10,22,23,57,-34,22
Montrose,4972,1,24,7,5,63,35,28,79
Peterhead,4972,2,24,4,8,79,39,40,76
Stirling,4972,3,17,6,13,61,51,10,57
Clyde,4972,4,15,9,12,54,48,6,54
Stenhousem'r,4972,5,15,8,13,55,47,8,53
Elgin,4972,6,14,6,16,54,64,-10,48
Annan Athlet,4972,7,12,11,13,49,42,7,47
Berwick,4972,8,8,10,18,29,61,-32,34
Edinburgh Ci,4972,9,7,9,20,37,62,-25,30
Cowdenbeath,4972,10,4,10,22,24,56,-32,22
Montrose,4973,1,24,7,5,60,34,26,79
Peterhead,4973,2,23,5,8,79,40,39,74
Stirling,4973,3,17,6,13,61,51,10,57
Stenhousem'r,4973,4,15,8,13,55,47,8,53
Clyde,4973,5,14,9,13,51,51,0,51
Elgin,4973,6,14,6,16,53,61,-8,48
Annan Athlet,4973,7,12,11,13,51,44,7,47
Berwick,4973,8,9,10,17,32,58,-26,37
Edinburgh Ci,4973,9,7,10,19,38,62,-24,31
Cowdenbeath,4973,10,4,10,22,26,58,-32,22
Montrose,4974,1,23,8,5,61,36,25,77
Peterhead,4974,2,24,4,8,78,38,40,76
Stenhousem'r,4974,3,16,8,12,59,46,13,56
Stirling,4974,4,16,6,14,60,55,5,54
Clyde,4974,5,15,9,12,52,48,4,54
Elgin,4974,6,14,7,15,55,62,-7,49
Annan Athlet,4974,7,11,12,13,47,41,6,45
Berwick,4974,8,8,10,18,29,59,-30,34
Edinburgh Ci,4974,9,7,9,20,36,61,-25,30
Cowdenbeath,4974,10,4,11,21,23,54,-31,23
Montrose,4975,1,24,7,5,62,35,27,79
Peterhead,4975,2,24,4,8,78,38,40,76
Stirling,4975,3,17,6,13,61,51,10,57
Clyde,4975,4,15,9,12,54,49,5,54
Stenhousem'r,4975,5,15,8,13,55,47,8,53
Elgin,4975,6,14,6,16,54,63,-9,48
Annan Athlet,4975,7,11,12,13,48,42,6,45
Berwick,4975,8,8,10,18,30,61,-31,34
Edinburgh Ci,4975,9,7,9,20,36,61,-25,30
Cowdenbeath,4975,10,4,11,21,24,55,-31,23
Montrose,4976,1,23,8,5,60,35,25,77
Peterhead,4976,2,24,4,8,79,38,41,76
Stirling,4976,3,17,6,13,64,51,13,57
Clyde,4976,4,15,9,12,52,48,4,54
Stenhousem'r,4976,5,15,8,13,55,50,5,53
Elgin,4976,6,14,7,15,54,61,-7,49
Annan Athlet,4976,7,11,11,14,47,42,5,44
Berwick,4976,8,8,10,18,29,59,-30,34
Edinburgh Ci,4976,9,7,9,20,36,62,-26,30
Cowdenbeath,4976,10,5,10,21,24,54,-30,25
Montrose,4977,1,24,7,5,63,34,29,79
Peterhead,4977,2,24,4,8,80,38,42,76
Stenhousem'r,4977,3,16,8,12,59,48,11,56
Stirling,4977,4,16,6,14,62,55,7,54
Clyde,4977,5,15,9,12,53,48,5,54
Elgin,4977,6,14,6,16,53,64,-11,48
Annan Athlet,4977,7,11,11,14,48,43,5,44
Berwick,4977,8,8,10,18,29,60,-31,34
Edinburgh Ci,4977,9,7,9,20,36,63,-27,30
Cowdenbeath,4977,10,5,10,21,25,55,-30,25
Montrose,4978,1,24,7,5,61,35,26,79
Peterhead,4978,2,23,5,8,79,40,39,74
Stirling,4978,3,17,6,13,62,51,11,57
Clyde,4978,4,15,9,12,53,48,5,54
Stenhousem'r,4978,5,15,8,13,55,48,7,53
Elgin,4978,6,14,6,16,54,62,-8,48
Annan Athlet,4978,7,11,11,14,47,42,5,44
Berwick,4978,8,8,10,18,29,60,-31,34
Edinburgh Ci,4978,9,7,10,19,38,62,-24,31
Cowdenbeath,4978,10,5,10,21,24,54,-30,25
Montrose,4979,1,24,7,5,62,36,26,79
Peterhead,4979,2,23,4,9,77,40,37,73
Stirling,4979,3,17,6,13,61,51,10,57
Clyde,4979,4,15,9,12,53,48,5,54
Stenhousem'r,4979,5,15,8,13,55,47,8,53
Elgin,4979,6,14,6,16,55,63,-8,48
Annan Athlet,4979,7,12,11,13,49,41,8,47
Berwick,4979,8,8,10,18,29,60,-31,34
Edinburgh Ci,4979,9,8,9,19,38,60,-22,33
Cowdenbeath,4979,10,4,10,22,23,56,-33,22
Montrose,4980,1,24,7,5,62,35,27,79
Peterhead,4980,2,24,4,8,81,40,41,76
Stirling,4980,3,17,6,13,63,53,10,57
Clyde,4980,4,15,9,12,53,48,5,54
Stenhousem'r,4980,5,15,8,13,57,49,8,53
Elgin,4980,6,14,6,16,54,63,-9,48
Annan Athlet,4980,7,11,11,14,48,44,4,44
Berwick,4980,8,8,10,18,29,60,-31,34
Edinburgh Ci,4980,9,7,9,20,38,64,-26,30
Cowdenbeath,4980,10,5,10,21,26,55,-29,25
Montrose,4981,1,24,7,5,60,34,26,79
Peterhead,4981,2,24,4,8,78,38,40,76
Stirling,4981,3,16,7,13,60,51,9,55
Stenhousem'r,4981,4,15,9,12,55,46,9,54
Clyde,4981,5,14,9,13,51,50,1,51
Elgin,4981,6,14,6,16,53,61,-8,48
Annan Athlet,4981,7,11,11,14,47,42,5,44
Berwick,4981,8,9,10,17,31,58,-27,37
Edinburgh Ci,4981,9,7,9,20,36,61,-25,30
Cowdenbeath,4981,10,5,10,21,24,54,-30,25
Montrose,4982,1,24,7,5,61,34,27,79
Peterhead,4982,2,24,4,8,80,38,42,76
Stenhousem'r,4982,3,16,8,12,58,47,11,56
Stirling,4982,4,16,6,14,61,54,7,54
Clyde,4982,5,15,9,12,54,48,6,54
Elgin,4982,6,14,6,16,53,62,-9,48
Annan Athlet,4982,7,11,12,13,47,41,6,45
Berwick,4982,8,8,10,18,29,61,-32,34
Edinburgh Ci,4982,9,7,9,20,36,63,-27,30
Cowdenbeath,4982,10,4,11,21,23,54,-31,23
Montrose,4983,1,23,8,5,61,36,25,77
Peterhead,4983,2,24,4,8,84,39,45,76
Stirling,4983,3,17,6,13,64,53,11,57
Clyde,4983,4,15,9,12,53,48,5,54
Stenhousem'r,4983,5,15,8,13,57,50,7,53
Elgin,4983,6,14,7,15,55,62,-7,49
Annan Athlet,4983,7,11,11,14,49,44,5,44
Berwick,4983,8,8,10,18,29,60,-31,34
Edinburgh Ci,4983,9,7,9,20,37,67,-30,30
Cowdenbeath,4983,10,5,10,21,26,56,-30,25
Montrose,4984,1,24,7,5,63,34,29,79
Peterhead,4984,2,24,4,8,82,41,41,76
Stirling,4984,3,17,6,13,65,52,13,57
Stenhousem'r,4984,4,15,8,13,56,51,5,53
Clyde,4984,5,14,9,13,51,50,1,51
Elgin,4984,6,14,6,16,53,64,-11,48
Annan Athlet,4984,7,12,11,13,49,41,8,47
Berwick,4984,8,9,10,17,31,58,-27,37
Edinburgh Ci,4984,9,7,9,20,39,65,-26,30
Cowdenbeath,4984,10,4,10,22,23,56,-33,22
Montrose,4985,1,24,7,5,64,35,29,79
Peterhead,4985,2,24,4,8,79,38,41,76
Stenhousem'r,4985,3,16,8,12,57,47,10,56
Stirling,4985,4,16,6,14,61,53,8,54
Clyde,4985,5,15,9,12,52,48,4,54
Elgin,4985,6,14,6,16,54,65,-11,48
Annan Athlet,4985,7,11,12,13,48,42,6,45
Berwick,4985,8,8,10,18,29,59,-30,34
Edinburgh Ci,4985,9,7,9,20,36,62,-26,30
Cowdenbeath,4985,10,4,11,21,24,55,-31,23
Montrose,4986,1,23,8,5,60,35,25,77
Peterhead,4986,2,24,4,8,82,38,44,76
Stenhousem'r,4986,3,16,8,12,57,47,10,56
Stirling,4986,4,16,6,14,61,53,8,54
Clyde,4986,5,14,10,12,52,49,3,52
Elgin,4986,6,14,7,15,54,61,-7,49
Annan Athlet,4986,7,11,11,14,48,43,5,44
Berwick,4986,8,8,11,17,30,59,-29,35
Edinburgh Ci,4986,9,7,9,20,36,65,-29,30
Cowdenbeath,4986,10,5,10,21,25,55,-30,25
Montrose,4987,1,24,7,5,61,35,26,79
Peterhead,4987,2,24,4,8,80,40,40,76
Stirling,4987,3,16,7,13,60,51,9,55
Stenhousem'r,4987,4,15,9,12,55,46,9,54
Clyde,4987,5,14,9,13,52,50,2,51
Elgin,4987,6,14,6,16,54,62,-8,48
Annan Athlet,4987,7,11,11,14,50,46,4,44
Berwick,4987,8,9,10,17,31,59,-28,37
Edinburgh Ci,4987,9,7,9,20,38,63,-25,30
Cowdenbeath,4987,10,5,10,21,28,57,-29,25
Montrose,4988,1,24,7,5,63,35,28,79
Peterhead,4988,2,24,4,8,80,39,41,76
Stirling,4988,3,17,6,13,63,53,10,57
Clyde,4988,4,15,9,12,53,49,4,54
Stenhousem'r,4988,5,15,8,13,57,49,8,53
Elgin,4988,6,14,6,16,54,64,-10,48
Annan Athlet,4988,7,12,11,13,50,42,8,47
Berwick,4988,8,8,10,18,30,60,-30,34
Edinburgh Ci,4988,9,7,9,20,37,63,-26,30
Cowdenbeath,4988,10,4,10,22,24,57,-33,22
Peterhead,4989,1,24,4,8,82,40,42,76
Montrose,4989,2,23,7,6,59,35,24,76
Stirling,4989,3,17,6,13,61,51,10,57
Stenhousem'r,4989,4,15,8,13,55,47,8,53
Clyde,4989,5,14,10,12,52,49,3,52
Elgin,4989,6,15,6,15,54,60,-6,51
Annan Athlet,4989,7,11,11,14,47,42,5,44
Berwick,4989,8,8,11,17,30,59,-29,35
Edinburgh Ci,4989,9,7,9,20,38,65,-27,30
Cowdenbeath,4989,10,5,10,21,24,54,-30,25
Montrose,4990,1,24,7,5,65,36,29,79
Peterhead,4990,2,23,5,8,79,40,39,74
Stenhousem'r,4990,3,16,8,12,57,46,11,56
Stirling,4990,4,16,6,14,60,53,7,54
Clyde,4990,5,14,10,12,51,48,3,52
Elgin,4990,6,14,6,16,55,66,-11,48
Annan Athlet,4990,7,11,12,13,47,41,6,45
Berwick,4990,8,8,11,17,29,58,-29,35
Edinburgh Ci,4990,9,7,10,19,38,62,-24,31
Cowdenbeath,4990,10,4,11,21,23,54,-31,23
Montrose,4991,1,24,7,5,61,34,27,79
Peterhead,4991,2,24,4,8,79,39,40,76
Stirling,4991,3,16,7,13,61,52,9,55
Stenhousem'r,4991,4,15,9,12,56,47,9,54
Clyde,4991,5,15,9,12,53,49,4,54
Elgin,4991,6,14,6,16,53,62,-9,48
Annan Athlet,4991,7,11,11,14,47,43,4,44
Berwick,4991,8,8,10,18,30,60,-30,34
Edinburgh Ci,4991,9,7,9,20,37,62,-25,30
Cowdenbeath,4991,10,5,10,21,25,54,-29,25
Montrose,4992,1,24,7,5,62,35,27,79
Peterhead,4992,2,24,4,8,80,38,42,76
Stirling,4992,3,17,6,13,61,51,10,57
Clyde,4992,4,15,9,12,52,48,4,54
Stenhousem'r,4992,5,15,8,13,55,47,8,53
Elgin,4992,6,14,6,16,54,63,-9,48
Annan Athlet,4992,7,11,12,13,47,41,6,45
Berwick,4992,8,8,10,18,29,59,-30,34
Edinburgh Ci,4992,9,7,9,20,36,63,-27,30
Cowdenbeath,4992,10,4,11,21,23,54,-31,23
Montrose,4993,1,24,7,5,63,35,28,79
Peterhead,4993,2,24,4,8,81,40,41,76
Stirling,4993,3,16,7,13,61,52,9,55
Stenhousem'r,4993,4,15,9,12,56,47,9,54
Clyde,4993,5,15,9,12,54,48,6,54
Elgin,4993,6,14,6,16,54,64,-10,48
Annan Athlet,4993,7,11,12,13,49,43,6,45
Berwick,4993,8,8,10,18,29,61,-32,34
Edinburgh Ci,4993,9,7,9,20,38,64,-26,30
Cowdenbeath,4993,10,4,11,21,25,56,-31,23
Montrose,4994,1,24,7,5,61,34,27,79
Peterhead,4994,2,24,4,8,80,38,42,76
Stirling,4994,3,16,7,13,63,54,9,55
Stenhousem'r,4994,4,15,9,12,58,49,9,54
Clyde,4994,5,15,9,12,53,49,4,54
Elgin,4994,6,14,6,16,53,62,-9,48
Annan Athlet,4994,7,11,11,14,47,42,5,44
Berwick,4994,8,8,10,18,30,60,-30,34
Edinburgh Ci,4994,9,7,9,20,36,63,-27,30
Cowdenbeath,4994,10,5,10,21,24,54,-30,25
Montrose,4995,1,23,8,5,60,35,25,77
Peterhead,4995,2,24,4,8,82,38,44,76
Stirling,4995,3,16,7,13,63,54,9,55
Stenhousem'r,4995,4,15,9,12,58,49,9,54
Clyde,4995,5,15,9,12,53,49,4,54
Elgin,4995,6,14,7,15,54,61,-7,49
Annan Athlet,4995,7,11,11,14,50,45,5,44
Berwick,4995,8,8,10,18,30,60,-30,34
Edinburgh Ci,4995,9,7,9,20,36,65,-29,30
Cowdenbeath,4995,10,5,10,21,27,57,-30,25
Montrose,4996,1,23,8,5,59,34,25,77
Peterhead,4996,2,24,4,8,85,40,45,76
Stirling,4996,3,17,6,13,62,51,11,57
Clyde,4996,4,15,9,12,53,48,5,54
Stenhousem'r,4996,5,15,8,13,55,48,7,53
Elgin,4996,6,14,7,15,53,60,-7,49
Annan Athlet,4996,7,12,11,13,50,43,7,47
Berwick,4996,8,8,10,18,29,60,-31,34
Edinburgh Ci,4996,9,7,9,20,38,68,-30,30
Cowdenbeath,4996,10,4,10,22,25,57,-32,22
Montrose,4997,1,23,8,5,61,36,25,77
Peterhead,4997,2,24,4,8,78,38,40,76
Stirling,4997,3,17,6,13,63,53,10,57
Clyde,4997,4,15,9,12,54,48,6,54
Stenhousem'r,4997,5,15,8,13,57,49,8,53
Elgin,4997,6,14,7,15,55,62,-7,49
Annan Athlet,4997,7,11,11,14,47,42,5,44
Berwick,4997,8,8,10,18,29,61,-32,34
Edinburgh Ci,4997,9,7,9,20,36,61,-25,30
Cowdenbeath,4997,10,5,10,21,24,54,-30,25
Montrose,4998,1,23,8,5,60,35,25,77
Peterhead,4998,2,24,4,8,78,38,40,76
Stenhousem'r,4998,3,16,8,12,58,47,11,56
Stirling,4998,4,16,6,14,61,54,7,54
Clyde,4998,5,14,10,12,52,49,3,52
Elgin,4998,6,14,7,15,54,61,-7,49
Annan Athlet,4998,7,12,11,13,49,42,7,47
Berwick,4998,8,8,11,17,30,59,-29,35
Edinburgh Ci,4998,9,7,9,20,36,61,-25,30
Cowdenbeath,4998,10,4,10,22,24,56,-32,22
Montrose,4999,1,23,8,5,59,34,25,77
Peterhead,4999,2,23,4,9,77,39,38,73
Stenhousem'r,4999,3,16,8,12,57,47,10,56
Stirling,4999,4,16,6,14,61,53,8,54
Clyde,4999,5,14,10,12,52,49,3,52
Elgin,4999,6,14,7,15,53,60,-7,49
Annan Athlet,4999,7,11,12,13,47,41,6,45
Berwick,4999,8,8,11,17,30,59,-29,35
Edinburgh Ci,4999,9,8,9,19,37,60,-23,33
Cowdenbeath,4999,10,4,11,21,23,54,-31,23
Peterhead,5000,1,24,4,8,80,38,42,76
Montrose,5000,2,23,7,6,60,36,24,76
Stenhousem'r,5000,3,16,8,12,56,46,10,56
Stirling,5000,4,16,6,14,60,52,8,54
Clyde,5000,5,14,10,12,52,49,3,52
Elgin,5000,6,15,6,15,55,61,-6,51
Annan Athlet,5000,7,12,11,13,48,41,7,47
Berwick,5000,8,8,11,17,30,59,-29,35
Edinburgh Ci,5000,9,7,9,20,36,63,-27,30
Cowdenbeath,5000,10,4,10,22,23,55,-32,22
Montrose,5001,1,24,7,5,62,34,28,79
Peterhead,5001,2,24,4,8,82,38,44,76
Stenhousem'r,5001,3,16,8,12,57,47,10,56
Stirling,5001,4,16,6,14,61,53,8,54
Clyde,5001,5,14,10,12,53,50,3,52
Elgin,5001,6,14,6,16,53,63,-10,48
Annan Athlet,5001,7,12,11,13,49,41,8,47
Berwick,5001,8,8,11,17,31,60,-29,35
Edinburgh Ci,5001,9,7,9,20,36,65,-29,30
Cowdenbeath,5001,10,4,10,22,23,56,-33,22
Peterhead,5002,1,24,4,8,79,39,40,76
Montrose,5002,2,23,7,6,59,35,24,76
Stirling,5002,3,16,7,13,63,54,9,55
Stenhousem'r,5002,4,15,9,12,58,49,9,54
Clyde,5002,5,15,9,12,54,49,5,54
Elgin,5002,6,15,6,15,54,60,-6,51
Annan Athlet,5002,7,12,11,13,50,41,9,47
Berwick,5002,8,8,10,18,30,61,-31,34
Edinburgh Ci,5002,9,7,9,20,37,62,-25,30
Cowdenbeath,5002,10,4,10,22,23,57,-34,22
Montrose,5003,1,24,7,5,60,34,26,79
Peterhead,5003,2,23,5,8,78,39,39,74
Stirling,5003,3,16,7,13,60,51,9,55
Stenhousem'r,5003,4,15,9,12,55,46,9,54
Clyde,5003,5,15,9,12,54,50,4,54
Elgin,5003,6,14,6,16,53,61,-8,48
Annan Athlet,5003,7,11,12,13,47,41,6,45
Berwick,5003,8,8,10,18,31,61,-30,34
Edinburgh Ci,5003,9,7,10,19,37,61,-24,31
Cowdenbeath,5003,10,4,11,21,23,54,-31,23
Montrose,5004,1,23,8,5,60,35,25,77
Peterhead,5004,2,23,5,8,80,41,39,74
Stirling,5004,3,17,6,13,62,52,10,57
Clyde,5004,4,15,9,12,53,49,4,54
Stenhousem'r,5004,5,15,8,13,56,48,8,53
Elgin,5004,6,14,7,15,54,61,-7,49
Annan Athlet,5004,7,12,11,13,49,41,8,47
Berwick,5004,8,8,10,18,30,60,-30,34
Edinburgh Ci,5004,9,7,10,19,39,63,-24,31
Cowdenbeath,5004,10,4,10,22,23,56,-33,22
Montrose,5005,1,24,7,5,61,34,27,79
Peterhead,5005,2,23,4,9,78,41,37,73
Stirling,5005,3,17,6,13,63,52,11,57
Clyde,5005,4,15,9,12,55,48,7,54
Stenhousem'r,5005,5,15,8,13,56,49,7,53
Elgin,5005,6,14,6,16,53,62,-9,48
Annan Athlet,5005,7,11,12,13,50,44,6,45
Berwick,5005,8,8,10,18,29,62,-33,34
Edinburgh Ci,5005,9,8,9,19,39,61,-22,33
Cowdenbeath,5005,10,4,11,21,26,57,-31,23
Montrose,5006,1,24,7,5,66,36,30,79
Peterhead,5006,2,24,4,8,82,39,43,76
Stirling,5006,3,17,6,13,65,54,11,57
Stenhousem'r,5006,4,15,8,13,58,51,7,53
Clyde,5006,5,14,10,12,51,48,3,52
Elgin,5006,6,14,6,16,55,67,-12,48
Annan Athlet,5006,7,12,11,13,48,41,7,47
Berwick,5006,8,8,11,17,29,58,-29,35
Edinburgh Ci,5006,9,7,9,20,37,65,-28,30
Cowdenbeath,5006,10,4,10,22,23,55,-32,22
Montrose,5007,1,24,7,5,61,34,27,79
Peterhead,5007,2,24,4,8,80,40,40,76
Stirling,5007,3,17,6,13,62,52,10,57
Stenhousem'r,5007,4,15,8,13,56,48,8,53
Clyde,5007,5,14,10,12,52,49,3,52
Elgin,5007,6,14,6,16,53,62,-9,48
Annan Athlet,5007,7,11,12,13,48,42,6,45
Berwick,5007,8,8,11,17,30,59,-29,35
Edinburgh Ci,5007,9,7,9,20,38,63,-25,30
Cowdenbeath,5007,10,4,11,21,24,55,-31,23
Peterhead,5008,1,24,4,8,83,38,45,76
Montrose,5008,2,23,7,6,59,35,24,76
Stirling,5008,3,17,6,13,64,51,13,57
Stenhousem'r,5008,4,15,8,13,55,50,5,53
Clyde,5008,5,14,9,13,51,51,0,51
Elgin,5008,6,15,6,15,54,60,-6,51
Annan Athlet,5008,7,11,11,14,48,43,5,44
Berwick,5008,8,9,10,17,32,58,-26,37
Edinburgh Ci,5008,9,7,9,20,36,66,-30,30
Cowdenbeath,5008,10,5,10,21,25,55,-30,25
Montrose,5009,1,24,7,5,64,35,29,79
Peterhead,5009,2,24,4,8,80,39,41,76
Stenhousem'r,5009,3,16,8,12,58,48,10,56
Stirling,5009,4,16,6,14,62,54,8,54
Clyde,5009,5,15,9,12,55,49,6,54
Elgin,5009,6,14,6,16,54,65,-11,48
Annan Athlet,5009,7,12,11,13,50,43,7,47
Berwick,5009,8,8,10,18,30,62,-32,34
Edinburgh Ci,5009,9,7,9,20,37,63,-26,30
Cowdenbeath,5009,10,4,10,22,25,57,-32,22
Montrose,5010,1,23,8,5,60,35,25,77
Peterhead,5010,2,23,5,8,77,38,39,74
Stirling,5010,3,17,6,13,64,52,12,57
Clyde,5010,4,15,9,12,55,49,6,54
Stenhousem'r,5010,5,15,8,13,56,50,6,53
Elgin,5010,6,14,7,15,54,61,-7,49
Annan Athlet,5010,7,12,11,13,49,42,7,47
Berwick,5010,8,8,10,18,30,62,-32,34
Edinburgh Ci,5010,9,7,10,19,36,60,-24,31
Cowdenbeath,5010,10,4,10,22,24,56,-32,22
Montrose,5011,1,24,7,5,63,34,29,79
Peterhead,5011,2,24,4,8,80,38,42,76
Stenhousem'r,5011,3,16,8,12,56,46,10,56
Stirling,5011,4,16,6,14,60,52,8,54
Clyde,5011,5,15,9,12,55,50,5,54
Elgin,5011,6,14,6,16,53,64,-11,48
Annan Athlet,5011,7,11,11,14,48,43,5,44
Berwick,5011,8,8,10,18,31,62,-31,34
Edinburgh Ci,5011,9,7,9,20,36,63,-27,30
Cowdenbeath,5011,10,5,10,21,25,55,-30,25
Montrose,5012,1,24,7,5,64,35,29,79
Peterhead,5012,2,24,4,8,80,39,41,76
Stirling,5012,3,17,6,13,62,51,11,57
Clyde,5012,4,15,9,12,54,50,4,54
Stenhousem'r,5012,5,15,8,13,55,48,7,53
Elgin,5012,6,14,6,16,54,65,-11,48
Annan Athlet,5012,7,11,11,14,48,45,3,44
Berwick,5012,8,8,10,18,31,61,-30,34
Edinburgh Ci,5012,9,7,9,20,37,63,-26,30
Cowdenbeath,5012,10,5,10,21,27,55,-28,25
Montrose,5013,1,23,8,5,59,34,25,77
Peterhead,5013,2,24,4,8,81,38,43,76
Stirling,5013,3,16,7,13,61,52,9,55
Stenhousem'r,5013,4,15,9,12,56,47,9,54
Clyde,5013,5,15,9,12,55,51,4,54
Elgin,5013,6,14,7,15,53,60,-7,49
Annan Athlet,5013,7,12,11,13,49,42,7,47
Berwick,5013,8,8,10,18,32,62,-30,34
Edinburgh Ci,5013,9,7,9,20,36,64,-28,30
Cowdenbeath,5013,10,4,10,22,24,56,-32,22
Peterhead,5014,1,24,4,8,80,38,42,76
Montrose,5014,2,23,7,6,60,36,24,76
Stenhousem'r,5014,3,16,8,12,56,46,10,56
Stirling,5014,4,16,6,14,60,52,8,54
Clyde,5014,5,14,9,13,51,50,1,51
Elgin,5014,6,15,6,15,55,61,-6,51
Annan Athlet,5014,7,11,11,14,48,43,5,44
Berwick,5014,8,9,10,17,31,58,-27,37
Edinburgh Ci,5014,9,7,9,20,36,63,-27,30
Cowdenbeath,5014,10,5,10,21,25,55,-30,25
Montrose,5015,1,24,7,5,60,34,26,79
Peterhead,5015,2,23,4,9,78,40,38,73
Stirling,5015,3,17,6,13,63,52,11,57
Clyde,5015,4,15,9,12,53,48,5,54
Stenhousem'r,5015,5,15,8,13,56,49,7,53
Elgin,5015,6,14,6,16,53,61,-8,48
Annan Athlet,5015,7,12,11,13,50,41,9,47
Berwick,5015,8,8,10,18,29,60,-31,34
Edinburgh Ci,5015,9,8,9,19,38,61,-23,33
Cowdenbeath,5015,10,4,10,22,23,57,-34,22
Montrose,5016,1,23,8,5,60,35,25,77
Peterhead,5016,2,24,4,8,78,38,40,76
Stenhousem'r,5016,3,16,8,12,58,46,12,56
Stirling,5016,4,16,6,14,60,54,6,54
Clyde,5016,5,14,10,12,52,49,3,52
Elgin,5016,6,14,7,15,54,61,-7,49
Annan Athlet,5016,7,12,11,13,50,43,7,47
Berwick,5016,8,8,11,17,30,59,-29,35
Edinburgh Ci,5016,9,7,9,20,36,61,-25,30
Cowdenbeath,5016,10,4,10,22,25,57,-32,22
Montrose,5017,1,23,8,5,60,35,25,77
Peterhead,5017,2,24,4,8,79,39,40,76
Stenhousem'r,5017,3,16,8,12,57,46,11,56
Stirling,5017,4,16,6,14,60,53,7,54
Clyde,5017,5,15,9,12,53,48,5,54
Elgin,5017,6,14,7,15,54,61,-7,49
Annan Athlet,5017,7,11,12,13,48,42,6,45
Berwick,5017,8,8,10,18,29,60,-31,34
Edinburgh Ci,5017,9,7,9,20,37,62,-25,30
Cowdenbeath,5017,10,4,11,21,24,55,-31,23
Montrose,5018,1,23,7,6,59,35,24,76
Peterhead,5018,2,23,5,8,79,40,39,74
Stenhousem'r,5018,3,16,8,12,57,47,10,56
Stirling,5018,4,16,6,14,61,53,8,54
Clyde,5018,5,14,10,12,52,49,3,52
Elgin,5018,6,15,6,15,54,60,-6,51
Annan Athlet,5018,7,11,11,14,47,43,4,44
Berwick,5018,8,8,11,17,30,59,-29,35
Edinburgh Ci,5018,9,7,10,19,38,62,-24,31
Cowdenbeath,5018,10,5,10,21,25,54,-29,25
Montrose,5019,1,23,7,6,59,35,24,76
Peterhead,5019,2,23,4,9,79,41,38,73
Stirling,5019,3,17,6,13,64,51,13,57
Stenhousem'r,5019,4,15,8,13,55,50,5,53
Clyde,5019,5,14,9,13,53,53,0,51
Elgin,5019,6,15,6,15,54,60,-6,51
Annan Athlet,5019,7,11,11,14,48,45,3,44
Berwick,5019,8,9,10,17,34,60,-26,37
Edinburgh Ci,5019,9,8,9,19,39,62,-23,33
Cowdenbeath,5019,10,5,10,21,27,55,-28,25
Montrose,5020,1,23,8,5,60,35,25,77
Peterhead,5020,2,24,4,8,83,39,44,76
Stirling,5020,3,16,7,13,61,52,9,55
Stenhousem'r,5020,4,15,9,12,56,47,9,54
Clyde,5020,5,15,9,12,54,48,6,54
Elgin,5020,6,14,7,15,54,61,-7,49
Annan Athlet,5020,7,11,12,13,48,42,6,45
Berwick,5020,8,8,10,18,29,61,-32,34
Edinburgh Ci,5020,9,7,9,20,37,66,-29,30
Cowdenbeath,5020,10,4,11,21,24,55,-31,23
Montrose,5021,1,24,7,5,62,35,27,79
Peterhead,5021,2,24,4,8,81,38,43,76
Stirling,5021,3,17,6,13,62,51,11,57
Clyde,5021,4,15,9,12,54,50,4,54
Stenhousem'r,5021,5,15,8,13,55,48,7,53
Elgin,5021,6,14,6,16,54,63,-9,48
Annan Athlet,5021,7,11,12,13,48,42,6,45
Berwick,5021,8,8,10,18,31,61,-30,34
Edinburgh Ci,5021,9,7,9,20,36,64,-28,30
Cowdenbeath,5021,10,4,11,21,24,55,-31,23
Peterhead,5022,1,24,4,8,84,41,43,76
Montrose,5022,2,23,7,6,59,35,24,76
Stirling,5022,3,16,7,13,62,53,9,55
Stenhousem'r,5022,4,15,9,12,57,48,9,54
Clyde,5022,5,15,9,12,53,48,5,54
Elgin,5022,6,15,6,15,54,60,-6,51
Annan Athlet,5022,7,11,11,14,47,42,5,44
Berwick,5022,8,8,10,18,29,60,-31,34
Edinburgh Ci,5022,9,7,9,20,39,67,-28,30
Cowdenbeath,5022,10,5,10,21,24,54,-30,25
Montrose,5023,1,23,8,5,60,35,25,77
Peterhead,5023,2,24,4,8,81,38,43,76
Stirling,5023,3,16,7,13,61,52,9,55
Stenhousem'r,5023,4,15,9,12,56,47,9,54
Clyde,5023,5,15,9,12,55,48,7,54
Elgin,5023,6,14,7,15,54,61,-7,49
Annan Athlet,5023,7,11,12,13,47,41,6,45
Berwick,5023,8,8,10,18,29,62,-33,34
Edinburgh Ci,5023,9,7,9,20,36,64,-28,30
Cowdenbeath,5023,10,4,11,21,23,54,-31,23
Montrose,5024,1,23,7,6,60,37,23,76
Peterhead,5024,2,23,4,9,77,40,37,73
Stirling,5024,3,16,7,13,60,51,9,55
Stenhousem'r,5024,4,15,9,12,55,46,9,54
Clyde,5024,5,15,9,12,53,49,4,54
Elgin,5024,6,15,6,15,56,61,-5,51
Annan Athlet,5024,7,11,11,14,47,43,4,44
Berwick,5024,8,8,10,18,30,60,-30,34
Edinburgh Ci,5024,9,8,9,19,38,60,-22,33
Cowdenbeath,5024,10,5,10,21,25,54,-29,25
Montrose,5025,1,23,8,5,60,35,25,77
Peterhead,5025,2,24,4,8,79,38,41,76
Stenhousem'r,5025,3,16,8,12,58,47,11,56
Stirling,5025,4,16,6,14,61,54,7,54
Clyde,5025,5,15,9,12,55,49,6,54
Elgin,5025,6,14,7,15,54,61,-7,49
Annan Athlet,5025,7,11,11,14,47,43,4,44
Berwick,5025,8,8,10,18,30,62,-32,34
Edinburgh Ci,5025,9,7,9,20,36,62,-26,30
Cowdenbeath,5025,10,5,10,21,25,54,-29,25
Peterhead,5026,1,24,4,8,78,38,40,76
Montrose,5026,2,23,7,6,60,36,24,76
Stirling,5026,3,17,6,13,62,52,10,57
Clyde,5026,4,15,9,12,54,50,4,54
Stenhousem'r,5026,5,15,8,13,56,48,8,53
Elgin,5026,6,15,6,15,55,61,-6,51
Annan Athlet,5026,7,11,12,13,47,41,6,45
Berwick,5026,8,8,10,18,31,61,-30,34
Edinburgh Ci,5026,9,7,9,20,36,61,-25,30
Cowdenbeath,5026,10,4,11,21,23,54,-31,23
Montrose,5027,1,24,7,5,60,34,26,79
Peterhead,5027,2,24,4,8,79,39,40,76
Stenhousem'r,5027,3,16,8,12,56,46,10,56
Stirling,5027,4,16,6,14,60,52,8,54
Clyde,5027,5,15,9,12,55,51,4,54
Elgin,5027,6,14,6,16,53,61,-8,48
Annan Athlet,5027,7,11,12,13,49,43,6,45
Berwick,5027,8,8,10,18,32,62,-30,34
Edinburgh Ci,5027,9,7,9,20,37,62,-25,30
Cowdenbeath,5027,10,4,11,21,25,56,-31,23
Montrose,5028,1,23,8,5,61,36,25,77
Peterhead,5028,2,23,5,8,78,39,39,74
Stirling,5028,3,17,6,13,63,51,12,57
Stenhousem'r,5028,4,15,8,13,55,49,6,53
Clyde,5028,5,14,10,12,52,49,3,52
Elgin,5028,6,14,7,15,55,62,-7,49
Annan Athlet,5028,7,11,11,14,48,43,5,44
Berwick,5028,8,8,11,17,30,59,-29,35
Edinburgh Ci,5028,9,7,10,19,37,61,-24,31
Cowdenbeath,5028,10,5,10,21,25,55,-30,25
Montrose,5029,1,24,7,5,60,34,26,79
Peterhead,5029,2,23,5,8,78,39,39,74
Stirling,5029,3,17,6,13,62,52,10,57
Stenhousem'r,5029,4,15,8,13,56,48,8,53
Clyde,5029,5,14,10,12,52,49,3,52
Elgin,5029,6,14,6,16,53,61,-8,48
Annan Athlet,5029,7,11,12,13,48,42,6,45
Berwick,5029,8,8,11,17,30,59,-29,35
Edinburgh Ci,5029,9,7,10,19,37,61,-24,31
Cowdenbeath,5029,10,4,11,21,24,55,-31,23
Montrose,5030,1,24,7,5,61,34,27,79
Peterhead,5030,2,24,4,8,81,39,42,76
Stirling,5030,3,17,6,13,61,51,10,57
Clyde,5030,4,15,9,12,53,48,5,54
Stenhousem'r,5030,5,15,8,13,55,47,8,53
Elgin,5030,6,14,6,16,53,62,-9,48
Annan Athlet,5030,7,12,11,13,50,43,7,47
Berwick,5030,8,8,10,18,29,60,-31,34
Edinburgh Ci,5030,9,7,9,20,37,64,-27,30
Cowdenbeath,5030,10,4,10,22,25,57,-32,22
Montrose,5031,1,24,7,5,61,35,26,79
Peterhead,5031,2,24,4,8,82,40,42,76
Stirling,5031,3,17,6,13,65,52,13,57
Clyde,5031,4,15,9,12,54,48,6,54
Stenhousem'r,5031,5,15,8,13,56,51,5,53
Elgin,5031,6,14,6,16,54,62,-8,48
Annan Athlet,5031,7,11,11,14,47,42,5,44
Berwick,5031,8,8,10,18,29,61,-32,34
Edinburgh Ci,5031,9,7,9,20,38,65,-27,30
Cowdenbeath,5031,10,5,10,21,24,54,-30,25
Montrose,5032,1,24,7,5,61,34,27,79
Peterhead,5032,2,24,4,8,80,39,41,76
Stirling,5032,3,17,6,13,62,52,10,57
Clyde,5032,4,15,9,12,54,50,4,54
Stenhousem'r,5032,5,15,8,13,56,48,8,53
Elgin,5032,6,14,6,16,53,62,-9,48
Annan Athlet,5032,7,11,11,14,47,42,5,44
Berwick,5032,8,8,10,18,31,61,-30,34
Edinburgh Ci,5032,9,7,9,20,37,63,-26,30
Cowdenbeath,5032,10,5,10,21,24,54,-30,25
Peterhead,5033,1,24,4,8,79,38,41,76
Montrose,5033,2,23,7,6,60,36,24,76
Stenhousem'r,5033,3,16,8,12,57,46,11,56
Stirling,5033,4,16,6,14,60,53,7,54
Clyde,5033,5,15,9,12,53,48,5,54
Elgin,5033,6,15,6,15,55,61,-6,51
Annan Athlet,5033,7,11,12,13,48,42,6,45
Berwick,5033,8,8,10,18,29,60,-31,34
Edinburgh Ci,5033,9,7,9,20,36,62,-26,30
Cowdenbeath,5033,10,4,11,21,24,55,-31,23
Montrose,5034,1,23,8,5,60,35,25,77
Peterhead,5034,2,24,4,8,80,38,42,76
Stenhousem'r,5034,3,16,8,12,58,46,12,56
Stirling,5034,4,16,6,14,60,54,6,54
Clyde,5034,5,14,10,12,51,48,3,52
Elgin,5034,6,14,7,15,54,61,-7,49
Annan Athlet,5034,7,12,11,13,49,42,7,47
Berwick,5034,8,8,11,17,29,58,-29,35
Edinburgh Ci,5034,9,7,9,20,36,63,-27,30
Cowdenbeath,5034,10,4,10,22,24,56,-32,22
Peterhead,5035,1,24,4,8,80,39,41,76
Montrose,5035,2,23,7,6,59,35,24,76
Stirling,5035,3,16,7,13,61,52,9,55
Stenhousem'r,5035,4,15,9,12,56,47,9,54
Clyde,5035,5,14,10,12,52,49,3,52
Elgin,5035,6,15,6,15,54,60,-6,51
Annan Athlet,5035,7,11,12,13,49,43,6,45
Berwick,5035,8,8,11,17,30,59,-29,35
Edinburgh Ci,5035,9,7,9,20,37,63,-26,30
Cowdenbeath,5035,10,4,11,21,25,56,-31,23
Montrose,5036,1,24,7,5,62,34,28,79
Peterhead,5036,2,24,4,8,82,38,44,76
Stenhousem'r,5036,3,16,8,12,57,46,11,56
Stirling,5036,4,16,6,14,60,53,7,54
Clyde,5036,5,14,9,13,51,51,0,51
Elgin,5036,6,14,6,16,53,63,-10,48
Annan Athlet,5036,7,12,11,13,50,42,8,47
Berwick,5036,8,9,10,17,32,58,-26,37
Edinburgh Ci,5036,9,7,9,20,36,65,-29,30
Cowdenbeath,5036,10,4,10,22,24,57,-33,22
Montrose,5037,1,23,8,5,60,35,25,77
Peterhead,5037,2,24,4,8,79,39,40,76
Stenhousem'r,5037,3,16,8,12,58,48,10,56
Stirling,5037,4,16,6,14,62,54,8,54
Clyde,5037,5,14,10,12,52,49,3,52
Elgin,5037,6,14,7,15,54,61,-7,49
Annan Athlet,5037,7,11,12,13,47,41,6,45
Berwick,5037,8,8,11,17,30,59,-29,35
Edinburgh Ci,5037,9,7,9,20,37,62,-25,30
Cowdenbeath,5037,10,4,11,21,23,54,-31,23
Montrose,5038,1,24,7,5,60,34,26,79
Peterhead,5038,2,24,4,8,79,38,41,76
Stirling,5038,3,17,6,13,62,52,10,57
Clyde,5038,4,15,9,12,54,49,5,54
Stenhousem'r,5038,5,15,8,13,56,48,8,53
Elgin,5038,6,14,6,16,53,61,-8,48
Annan Athlet,5038,7,12,11,13,50,42,8,47
Berwick,5038,8,8,10,18,30,61,-31,34
Edinburgh Ci,5038,9,7,9,20,36,62,-26,30
Cowdenbeath,5038,10,4,10,22,24,57,-33,22
Montrose,5039,1,23,8,5,61,36,25,77
Peterhead,5039,2,24,4,8,80,39,41,76
Stirling,5039,3,17,6,13,61,51,10,57
Clyde,5039,4,15,9,12,54,48,6,54
Stenhousem'r,5039,5,15,8,13,55,47,8,53
Elgin,5039,6,14,7,15,55,62,-7,49
Annan Athlet,5039,7,11,12,13,48,42,6,45
Berwick,5039,8,8,10,18,29,61,-32,34
Edinburgh Ci,5039,9,7,9,20,37,63,-26,30
Cowdenbeath,5039,10,4,11,21,24,55,-31,23
Montrose,5040,1,23,8,5,61,36,25,77
Peterhead,5040,2,23,5,8,78,39,39,74
Stirling,5040,3,16,7,13,61,52,9,55
Stenhousem'r,5040,4,15,9,12,56,47,9,54
Clyde,5040,5,15,9,12,55,49,6,54
Elgin,5040,6,14,7,15,55,62,-7,49
Annan Athlet,5040,7,12,11,13,49,42,7,47
Berwick,5040,8,8,10,18,30,62,-32,34
Edinburgh Ci,5040,9,7,10,19,37,61,-24,31
Cowdenbeath,5040,10,4,10,22,24,56,-32,22
Montrose,5041,1,23,8,5,61,36,25,77
Peterhead,5041,2,24,4,8,81,39,42,76
Stenhousem'r,5041,3,16,8,12,57,47,10,56
Stirling,5041,4,16,6,14,61,53,8,54
Clyde,5041,5,15,9,12,55,49,6,54
Elgin,5041,6,14,7,15,55,62,-7,49
Annan Athlet,5041,7,12,11,13,48,41,7,47
Berwick,5041,8,8,10,18,30,62,-32,34
Edinburgh Ci,5041,9,7,9,20,37,64,-27,30
Cowdenbeath,5041,10,4,10,22,23,55,-32,22
Montrose,5042,1,24,7,5,61,34,27,79
Peterhead,5042,2,24,4,8,80,38,42,76
Stirling,5042,3,17,6,13,62,52,10,57
Clyde,5042,4,15,9,12,54,50,4,54
Stenhousem'r,5042,5,15,8,13,56,48,8,53
Elgin,5042,6,14,6,16,53,62,-9,48
Annan Athlet,5042,7,11,12,13,48,42,6,45
Berwick,5042,8,8,10,18,31,61,-30,34
Edinburgh Ci,5042,9,7,9,20,36,63,-27,30
Cowdenbeath,5042,10,4,11,21,24,55,-31,23
Peterhead,5043,1,24,4,8,80,38,42,76
Montrose,5043,2,23,7,6,59,35,24,76
Stirling,5043,3,16,7,13,61,52,9,55
Stenhousem'r,5043,4,15,9,12,56,47,9,54
Clyde,5043,5,14,10,12,52,49,3,52
Elgin,5043,6,15,6,15,54,60,-6,51
Annan Athlet,5043,7,12,11,13,49,42,7,47
Berwick,5043,8,8,11,17,30,59,-29,35
Edinburgh Ci,5043,9,7,9,20,36,63,-27,30
Cowdenbeath,5043,10,4,10,22,24,56,-32,22
Montrose,5044,1,23,7,6,59,36,23,76
Peterhead,5044,2,23,5,8,77,38,39,74
Stirling,5044,3,17,6,13,61,51,10,57
Clyde,5044,4,15,9,12,53,48,5,54
Stenhousem'r,5044,5,15,8,13,55,47,8,53
Elgin,5044,6,15,6,15,55,60,-5,51
Annan Athlet,5044,7,12,11,13,50,41,9,47
Berwick,5044,8,8,10,18,29,60,-31,34
Edinburgh Ci,5044,9,7,10,19,36,60,-24,31
Cowdenbeath,5044,10,4,10,22,23,57,-34,22
Montrose,5045,1,23,8,5,59,34,25,77
Peterhead,5045,2,24,4,8,81,38,43,76
Stirling,5045,3,17,6,13,64,52,12,57
Clyde,5045,4,15,9,12,53,48,5,54
Stenhousem'r,5045,5,15,8,13,56,50,6,53
Elgin,5045,6,14,7,15,53,60,-7,49
Annan Athlet,5045,7,11,11,14,47,42,5,44
Berwick,5045,8,8,10,18,29,60,-31,34
Edinburgh Ci,5045,9,7,9,20,36,64,-28,30
Cowdenbeath,5045,10,5,10,21,24,54,-30,25
Montrose,5046,1,24,7,5,61,34,27,79
Peterhead,5046,2,24,4,8,79,39,40,76
Stirling,5046,3,17,6,13,61,51,10,57
Stenhousem'r,5046,4,15,8,13,55,47,8,53
Clyde,5046,5,14,10,12,52,49,3,52
Elgin,5046,6,14,6,16,53,62,-9,48
Annan Athlet,5046,7,11,12,13,50,44,6,45
Berwick,5046,8,8,11,17,30,59,-29,35
Edinburgh Ci,5046,9,7,9,20,37,62,-25,30
Cowdenbeath,5046,10,4,11,21,26,57,-31,23
Montrose,5047,1,23,8,5,60,35,25,77
Peterhead,5047,2,24,4,8,80,38,42,76
Stirling,5047,3,17,6,13,63,52,11,57
Clyde,5047,4,15,9,12,53,48,5,54
Stenhousem'r,5047,5,15,8,13,56,49,7,53
Elgin,5047,6,14,7,15,54,61,-7,49
Annan Athlet,5047,7,11,12,13,48,42,6,45
Berwick,5047,8,8,10,18,29,60,-31,34
Edinburgh Ci,5047,9,7,9,20,36,63,-27,30
Cowdenbeath,5047,10,4,11,21,24,55,-31,23
Montrose,5048,1,24,7,5,62,34,28,79
Peterhead,5048,2,24,4,8,80,38,42,76
Stirling,5048,3,17,6,13,64,51,13,57
Clyde,5048,4,15,9,12,54,49,5,54
Stenhousem'r,5048,5,15,8,13,55,50,5,53
Elgin,5048,6,14,6,16,53,63,-10,48
Annan Athlet,5048,7,11,12,13,47,41,6,45
Berwick,5048,8,8,10,18,30,61,-31,34
Edinburgh Ci,5048,9,7,9,20,36,63,-27,30
Cowdenbeath,5048,10,4,11,21,23,54,-31,23
Montrose,5049,1,24,7,5,64,35,29,79
Peterhead,5049,2,23,5,8,78,39,39,74
Stenhousem'r,5049,3,16,8,12,59,49,10,56
Stirling,5049,4,16,6,14,63,55,8,54
Clyde,5049,5,14,9,13,52,50,2,51
Elgin,5049,6,14,6,16,54,65,-11,48
Annan Athlet,5049,7,11,12,13,47,41,6,45
Berwick,5049,8,9,10,17,31,59,-28,37
Edinburgh Ci,5049,9,7,10,19,37,61,-24,31
Cowdenbeath,5049,10,4,11,21,23,54,-31,23
Montrose,5050,1,24,7,5,62,35,27,79
Peterhead,5050,2,24,4,8,80,39,41,76
Stirling,5050,3,17,6,13,63,52,11,57
Clyde,5050,4,15,9,12,52,48,4,54
Stenhousem'r,5050,5,15,8,13,56,49,7,53
Elgin,5050,6,14,6,16,54,63,-9,48
Annan Athlet,5050,7,12,11,13,48,41,7,47
Berwick,5050,8,8,10,18,29,59,-30,34
Edinburgh Ci,5050,9,7,9,20,37,63,-26,30
Cowdenbeath,5050,10,4,10,22,23,55,-32,22
Montrose,5051,1,24,7,5,63,34,29,79
Peterhead,5051,2,24,4,8,80,38,42,76
Stenhousem'r,5051,3,16,8,12,57,47,10,56
Stirling,5051,4,16,6,14,61,53,8,54
Clyde,5051,5,15,9,12,53,49,4,54
Elgin,5051,6,14,6,16,53,64,-11,48
Annan Athlet,5051,7,11,11,14,47,43,4,44
Berwick,5051,8,8,10,18,30,60,-30,34
Edinburgh Ci,5051,9,7,9,20,36,63,-27,30
Cowdenbeath,5051,10,5,10,21,25,54,-29,25
Peterhead,5052,1,24,4,8,78,38,40,76
Montrose,5052,2,23,7,6,59,36,23,76
Stirling,5052,3,17,6,13,63,52,11,57
Clyde,5052,4,15,9,12,52,48,4,54
Stenhousem'r,5052,5,15,8,13,56,49,7,53
Elgin,5052,6,15,6,15,55,60,-5,51
Annan Athlet,5052,7,12,11,13,51,42,9,47
Berwick,5052,8,8,10,18,29,59,-30,34
Edinburgh Ci,5052,9,7,9,20,36,61,-25,30
Cowdenbeath,5052,10,4,10,22,24,58,-34,22
Montrose,5053,1,24,7,5,61,35,26,79
Peterhead,5053,2,24,4,8,80,40,40,76
Stirling,5053,3,17,6,13,61,51,10,57
Stenhousem'r,5053,4,15,8,13,55,47,8,53
Clyde,5053,5,14,10,12,53,50,3,52
Elgin,5053,6,14,6,16,54,62,-8,48
Annan Athlet,5053,7,11,11,14,47,42,5,44
Berwick,5053,8,8,11,17,31,60,-29,35
Edinburgh Ci,5053,9,7,9,20,38,63,-25,30
Cowdenbeath,5053,10,5,10,21,24,54,-30,25
Montrose,5054,1,24,7,5,61,34,27,79
Peterhead,5054,2,24,4,8,81,39,42,76
Stenhousem'r,5054,3,16,8,12,58,48,10,56
Stirling,5054,4,16,6,14,62,54,8,54
Clyde,5054,5,15,9,12,52,48,4,54
Elgin,5054,6,14,6,16,53,62,-9,48
Annan Athlet,5054,7,12,11,13,51,42,9,47
Berwick,5054,8,8,10,18,29,59,-30,34
Edinburgh Ci,5054,9,7,9,20,37,64,-27,30
Cowdenbeath,5054,10,4,10,22,24,58,-34,22
Peterhead,5055,1,24,4,8,79,39,40,76
Montrose,5055,2,23,7,6,59,36,23,76
Stirling,5055,3,17,6,13,61,51,10,57
Clyde,5055,4,15,9,12,54,48,6,54
Stenhousem'r,5055,5,15,8,13,55,47,8,53
Elgin,5055,6,15,6,15,55,60,-5,51
Annan Athlet,5055,7,11,11,14,47,42,5,44
Berwick,5055,8,8,10,18,29,61,-32,34
Edinburgh Ci,5055,9,7,9,20,37,62,-25,30
Cowdenbeath,5055,10,5,10,21,24,54,-30,25
Montrose,5056,1,23,7,6,60,36,24,76
Peterhead,5056,2,23,5,8,79,40,39,74
Stirling,5056,3,16,7,13,61,52,9,55
Stenhousem'r,5056,4,15,9,12,56,47,9,54
Clyde,5056,5,14,10,12,52,49,3,52
Elgin,5056,6,15,6,15,55,61,-6,51
Annan Athlet,5056,7,11,11,14,48,43,5,44
Berwick,5056,8,8,11,17,30,59,-29,35
Edinburgh Ci,5056,9,7,10,19,38,62,-24,31
Cowdenbeath,5056,10,5,10,21,25,55,-30,25
Montrose,5057,1,24,7,5,61,35,26,79
Peterhead,5057,2,23,5,8,78,39,39,74
Stenhousem'r,5057,3,16,8,12,58,48,10,56
Stirling,5057,4,16,6,14,62,54,8,54
Clyde,5057,5,15,9,12,55,50,5,54
Elgin,5057,6,14,6,16,54,62,-8,48
Annan Athlet,5057,7,11,12,13,47,41,6,45
Berwick,5057,8,8,10,18,31,62,-31,34
Edinburgh Ci,5057,9,7,10,19,37,61,-24,31
Cowdenbeath,5057,10,4,11,21,23,54,-31,23
Montrose,5058,1,23,8,5,60,35,25,77
Peterhead,5058,2,24,4,8,83,39,44,76
Stenhousem'r,5058,3,16,8,12,57,47,10,56
Stirling,5058,4,16,6,14,61,53,8,54
Clyde,5058,5,14,10,12,53,50,3,52
Elgin,5058,6,14,7,15,54,61,-7,49
Annan Athlet,5058,7,11,12,13,48,42,6,45
Berwick,5058,8,8,11,17,31,60,-29,35
Edinburgh Ci,5058,9,7,9,20,37,66,-29,30
Cowdenbeath,5058,10,4,11,21,24,55,-31,23
Montrose,5059,1,24,7,5,63,35,28,79
Peterhead,5059,2,24,4,8,81,40,41,76
Stirling,5059,3,17,6,13,61,51,10,57
Stenhousem'r,5059,4,15,8,13,55,47,8,53
Clyde,5059,5,14,9,13,51,49,2,51
Elgin,5059,6,14,6,16,54,64,-10,48
Annan Athlet,5059,7,12,11,13,49,42,7,47
Berwick,5059,8,9,10,17,30,58,-28,37
Edinburgh Ci,5059,9,7,9,20,38,64,-26,30
Cowdenbeath,5059,10,4,10,22,24,56,-32,22
Montrose,5060,1,24,7,5,62,34,28,79
Peterhead,5060,2,24,4,8,79,38,41,76
Stirling,5060,3,17,6,13,65,51,14,57
Clyde,5060,4,15,9,12,55,48,7,54
Stenhousem'r,5060,5,15,8,13,55,51,4,53
Elgin,5060,6,14,6,16,53,63,-10,48
Annan Athlet,5060,7,12,11,13,49,41,8,47
Berwick,5060,8,8,10,18,29,62,-33,34
Edinburgh Ci,5060,9,7,9,20,36,62,-26,30
Cowdenbeath,5060,10,4,10,22,23,56,-33,22
Montrose,5061,1,24,7,5,62,36,26,79
Peterhead,5061,2,24,4,8,78,38,40,76
Stirling,5061,3,17,6,13,64,53,11,57
Stenhousem'r,5061,4,15,8,13,57,50,7,53
Clyde,5061,5,14,9,13,52,51,1,51
Elgin,5061,6,14,6,16,55,63,-8,48
Annan Athlet,5061,7,11,11,14,47,42,5,44
Berwick,5061,8,9,10,17,32,59,-27,37
Edinburgh Ci,5061,9,7,9,20,36,61,-25,30
Cowdenbeath,5061,10,5,10,21,24,54,-30,25
Montrose,5062,1,23,8,5,59,34,25,77
Peterhead,5062,2,24,4,8,82,38,44,76
Stirling,5062,3,16,7,13,62,53,9,55
Stenhousem'r,5062,4,15,9,12,57,48,9,54
Clyde,5062,5,15,9,12,54,50,4,54
Elgin,5062,6,14,7,15,53,60,-7,49
Annan Athlet,5062,7,12,11,13,48,41,7,47
Berwick,5062,8,8,10,18,31,61,-30,34
Edinburgh Ci,5062,9,7,9,20,36,65,-29,30
Cowdenbeath,5062,10,4,10,22,23,55,-32,22
Montrose,5063,1,24,7,5,63,34,29,79
Peterhead,5063,2,24,4,8,79,38,41,76
Stirling,5063,3,16,7,13,61,52,9,55
Stenhousem'r,5063,4,15,9,12,56,47,9,54
Clyde,5063,5,15,9,12,53,48,5,54
Elgin,5063,6,14,6,16,53,64,-11,48
Annan Athlet,5063,7,12,11,13,50,42,8,47
Berwick,5063,8,8,10,18,29,60,-31,34
Edinburgh Ci,5063,9,7,9,20,36,62,-26,30
Cowdenbeath,5063,10,4,10,22,24,57,-33,22
Montrose,5064,1,24,7,5,61,35,26,79
Peterhead,5064,2,24,4,8,79,38,41,76
Stirling,5064,3,17,6,13,61,51,10,57
Clyde,5064,4,15,9,12,54,50,4,54
Stenhousem'r,5064,5,15,8,13,55,47,8,53
Elgin,5064,6,14,6,16,54,62,-8,48
Annan Athlet,5064,7,11,11,14,49,44,5,44
Berwick,5064,8,8,10,18,31,61,-30,34
Edinburgh Ci,5064,9,7,9,20,36,62,-26,30
Cowdenbeath,5064,10,5,10,21,26,56,-30,25
Montrose,5065,1,24,7,5,61,35,26,79
Peterhead,5065,2,24,4,8,80,39,41,76
Stenhousem'r,5065,3,16,8,12,56,46,10,56
Stirling,5065,4,16,6,14,60,52,8,54
Clyde,5065,5,14,10,12,53,50,3,52
Elgin,5065,6,14,6,16,54,62,-8,48
Annan Athlet,5065,7,12,11,13,49,41,8,47
Berwick,5065,8,8,11,17,31,60,-29,35
Edinburgh Ci,5065,9,7,9,20,37,63,-26,30
Cowdenbeath,5065,10,4,10,22,23,56,-33,22
Montrose,5066,1,24,7,5,60,34,26,79
Peterhead,5066,2,24,4,8,79,38,41,76
Stirling,5066,3,17,6,13,61,51,10,57
Stenhousem'r,5066,4,15,8,13,55,47,8,53
Clyde,5066,5,14,10,12,51,48,3,52
Elgin,5066,6,14,6,16,53,61,-8,48
Annan Athlet,5066,7,11,11,14,47,42,5,44
Berwick,5066,8,8,11,17,29,58,-29,35
Edinburgh Ci,5066,9,7,9,20,36,62,-26,30
Cowdenbeath,5066,10,5,10,21,24,54,-30,25
Montrose,5067,1,24,7,5,62,35,27,79
Peterhead,5067,2,24,4,8,80,38,42,76
Stirling,5067,3,17,6,13,64,54,10,57
Clyde,5067,4,15,9,12,55,49,6,54
Stenhousem'r,5067,5,15,8,13,58,50,8,53
Elgin,5067,6,14,6,16,54,63,-9,48
Annan Athlet,5067,7,11,12,13,48,42,6,45
Berwick,5067,8,8,10,18,30,62,-32,34
Edinburgh Ci,5067,9,7,9,20,36,63,-27,30
Cowdenbeath,5067,10,4,11,21,24,55,-31,23
Peterhead,5068,1,24,4,8,82,38,44,76
Montrose,5068,2,23,7,6,59,36,23,76
Stirling,5068,3,16,7,13,61,52,9,55
Stenhousem'r,5068,4,15,9,12,56,47,9,54
Clyde,5068,5,15,9,12,53,48,5,54
Elgin,5068,6,15,6,15,55,60,-5,51
Annan Athlet,5068,7,12,11,13,48,41,7,47
Berwick,5068,8,8,10,18,29,60,-31,34
Edinburgh Ci,5068,9,7,9,20,36,65,-29,30
Cowdenbeath,5068,10,4,10,22,23,55,-32,22
Peterhead,5069,1,24,4,8,82,38,44,76
Montrose,5069,2,23,7,6,61,37,24,76
Stenhousem'r,5069,3,16,8,12,57,47,10,56
Stirling,5069,4,16,6,14,61,53,8,54
Clyde,5069,5,15,9,12,52,48,4,54
Elgin,5069,6,15,6,15,56,62,-6,51
Annan Athlet,5069,7,11,12,13,48,42,6,45
Berwick,5069,8,8,10,18,29,59,-30,34
Edinburgh Ci,5069,9,7,9,20,36,65,-29,30
Cowdenbeath,5069,10,4,11,21,24,55,-31,23
Montrose,5070,1,24,7,5,61,35,26,79
Peterhead,5070,2,24,4,8,80,39,41,76
Stenhousem'r,5070,3,16,8,12,56,46,10,56
Stirling,5070,4,16,6,14,60,52,8,54
Clyde,5070,5,14,10,12,52,49,3,52
Elgin,5070,6,14,6,16,54,62,-8,48
Annan Athlet,5070,7,11,12,13,48,42,6,45
Berwick,5070,8,8,11,17,30,59,-29,35
Edinburgh Ci,5070,9,7,9,20,37,63,-26,30
Cowdenbeath,5070,10,4,11,21,24,55,-31,23
Montrose,5071,1,23,7,6,61,38,23,76
Peterhead,5071,2,23,5,8,80,41,39,74
Stirling,5071,3,17,6,13,63,52,11,57
Clyde,5071,4,15,9,12,52,48,4,54
Stenhousem'r,5071,5,15,8,13,56,49,7,53
Elgin,5071,6,15,6,15,57,62,-5,51
Annan Athlet,5071,7,12,11,13,49,41,8,47
Berwick,5071,8,8,10,18,29,59,-30,34
Edinburgh Ci,5071,9,7,10,19,39,63,-24,31
Cowdenbeath,5071,10,4,10,22,23,56,-33,22
Montrose,5072,1,24,7,5,60,34,26,79
Peterhead,5072,2,24,4,8,82,38,44,76
Stenhousem'r,5072,3,16,8,12,58,47,11,56
Stirling,5072,4,16,6,14,61,54,7,54
Clyde,5072,5,14,10,12,52,49,3,52
Elgin,5072,6,14,6,16,53,61,-8,48
Annan Athlet,5072,7,12,11,13,49,42,7,47
Berwick,5072,8,8,11,17,30,59,-29,35
Edinburgh Ci,5072,9,7,9,20,36,65,-29,30
Cowdenbeath,5072,10,4,10,22,24,56,-32,22
Montrose,5073,1,24,7,5,61,34,27,79
Peterhead,5073,2,24,4,8,81,38,43,76
Stenhousem'r,5073,3,16,8,12,59,48,11,56
Stirling,5073,4,16,6,14,62,55,7,54
Clyde,5073,5,14,10,12,51,48,3,52
Elgin,5073,6,14,6,16,53,62,-9,48
Annan Athlet,5073,7,11,12,13,47,41,6,45
Berwick,5073,8,8,11,17,29,58,-29,35
Edinburgh Ci,5073,9,7,9,20,36,64,-28,30
Cowdenbeath,5073,10,4,11,21,23,54,-31,23
Montrose,5074,1,24,7,5,63,34,29,79
Peterhead,5074,2,24,4,8,81,40,41,76
Stenhousem'r,5074,3,16,8,12,57,46,11,56
Stirling,5074,4,16,6,14,60,53,7,54
Clyde,5074,5,15,9,12,53,48,5,54
Elgin,5074,6,14,6,16,53,64,-11,48
Annan Athlet,5074,7,12,11,13,49,42,7,47
Berwick,5074,8,8,10,18,29,60,-31,34
Edinburgh Ci,5074,9,7,9,20,38,64,-26,30
Cowdenbeath,5074,10,4,10,22,24,56,-32,22
Peterhead,5075,1,24,4,8,82,38,44,76
Montrose,5075,2,23,7,6,60,36,24,76
Stenhousem'r,5075,3,16,8,12,57,47,10,56
Stirling,5075,4,16,6,14,61,53,8,54
Clyde,5075,5,14,10,12,51,48,3,52
Elgin,5075,6,15,6,15,55,61,-6,51
Annan Athlet,5075,7,12,11,13,48,41,7,47
Berwick,5075,8,8,11,17,29,58,-29,35
Edinburgh Ci,5075,9,7,9,20,36,65,-29,30
Cowdenbeath,5075,10,4,10,22,23,55,-32,22
Montrose,5076,1,23,8,5,59,34,25,77
Peterhead,5076,2,23,5,8,78,39,39,74
Stirling,5076,3,17,6,13,63,51,12,57
Clyde,5076,4,15,9,12,53,48,5,54
Stenhousem'r,5076,5,15,8,13,55,49,6,53
Elgin,5076,6,14,7,15,53,60,-7,49
Annan Athlet,5076,7,12,11,13,48,41,7,47
Berwick,5076,8,8,10,18,29,60,-31,34
Edinburgh Ci,5076,9,7,10,19,37,61,-24,31
Cowdenbeath,5076,10,4,10,22,23,55,-32,22
Montrose,5077,1,23,8,5,61,36,25,77
Peterhead,5077,2,24,4,8,79,39,40,76
Stirling,5077,3,16,7,13,62,53,9,55
Stenhousem'r,5077,4,15,9,12,57,48,9,54
Clyde,5077,5,14,10,12,53,50,3,52
Elgin,5077,6,14,7,15,55,62,-7,49
Annan Athlet,5077,7,11,11,14,47,42,5,44
Berwick,5077,8,8,11,17,31,60,-29,35
Edinburgh Ci,5077,9,7,9,20,37,62,-25,30
Cowdenbeath,5077,10,5,10,21,24,54,-30,25
Peterhead,5078,1,24,4,8,80,38,42,76
Montrose,5078,2,23,7,6,60,36,24,76
Stirling,5078,3,17,6,13,62,52,10,57
Stenhousem'r,5078,4,15,8,13,56,48,8,53
Clyde,5078,5,14,10,12,52,49,3,52
Elgin,5078,6,15,6,15,55,61,-6,51
Annan Athlet,5078,7,11,12,13,49,43,6,45
Berwick,5078,8,8,11,17,30,59,-29,35
Edinburgh Ci,5078,9,7,9,20,36,63,-27,30
Cowdenbeath,5078,10,4,11,21,25,56,-31,23
Montrose,5079,1,23,8,5,60,35,25,77
Peterhead,5079,2,24,4,8,82,38,44,76
Stenhousem'r,5079,3,16,8,12,56,46,10,56
Stirling,5079,4,16,6,14,60,52,8,54
Clyde,5079,5,14,9,13,52,50,2,51
Elgin,5079,6,14,7,15,54,61,-7,49
Annan Athlet,5079,7,12,11,13,48,41,7,47
Berwick,5079,8,9,10,17,31,59,-28,37
Edinburgh Ci,5079,9,7,9,20,36,65,-29,30
Cowdenbeath,5079,10,4,10,22,23,55,-32,22
Montrose,5080,1,24,7,5,62,34,28,79
Peterhead,5080,2,24,4,8,79,38,41,76
Stirling,5080,3,17,6,13,61,51,10,57
Clyde,5080,4,15,9,12,53,49,4,54
Stenhousem'r,5080,5,15,8,13,55,47,8,53
Elgin,5080,6,14,6,16,53,63,-10,48
Annan Athlet,5080,7,11,11,14,47,42,5,44
Berwick,5080,8,8,10,18,30,60,-30,34
Edinburgh Ci,5080,9,7,9,20,36,62,-26,30
Cowdenbeath,5080,10,5,10,21,24,54,-30,25
Peterhead,5081,1,24,4,8,78,38,40,76
Montrose,5081,2,23,7,6,59,35,24,76
Stenhousem'r,5081,3,16,8,12,58,48,10,56
Stirling,5081,4,16,6,14,62,54,8,54
Clyde,5081,5,14,9,13,51,51,0,51
Elgin,5081,6,15,6,15,54,60,-6,51
Annan Athlet,5081,7,11,12,13,48,42,6,45
Berwick,5081,8,9,10,17,32,58,-26,37
Edinburgh Ci,5081,9,7,9,20,36,61,-25,30
Cowdenbeath,5081,10,4,11,21,24,55,-31,23
Montrose,5082,1,24,7,5,62,36,26,79
Peterhead,5082,2,24,4,8,79,38,41,76
Stirling,5082,3,17,6,13,62,51,11,57
Clyde,5082,4,15,9,12,54,49,5,54
Stenhousem'r,5082,5,15,8,13,55,48,7,53
Elgin,5082,6,14,6,16,55,63,-8,48
Annan Athlet,5082,7,12,11,13,50,41,9,47
Berwick,5082,8,8,10,18,30,61,-31,34
Edinburgh Ci,5082,9,7,9,20,36,62,-26,30
Cowdenbeath,5082,10,4,10,22,23,57,-34,22
Montrose,5083,1,24,7,5,60,34,26,79
Peterhead,5083,2,24,4,8,79,38,41,76
Stenhousem'r,5083,3,16,8,12,56,46,10,56
Stirling,5083,4,16,6,14,60,52,8,54
Clyde,5083,5,15,9,12,53,49,4,54
Elgin,5083,6,14,6,16,53,61,-8,48
Annan Athlet,5083,7,12,11,13,51,41,10,47
Berwick,5083,8,8,10,18,30,60,-30,34
Edinburgh Ci,5083,9,7,9,20,36,62,-26,30
Cowdenbeath,5083,10,4,10,22,23,58,-35,22
Montrose,5084,1,24,7,5,62,35,27,79
Peterhead,5084,2,24,4,8,80,38,42,76
Stenhousem'r,5084,3,16,8,12,56,46,10,56
Stirling,5084,4,16,6,14,60,52,8,54
Clyde,5084,5,15,9,12,55,49,6,54
Elgin,5084,6,14,6,16,54,63,-9,48
Annan Athlet,5084,7,12,11,13,50,41,9,47
Berwick,5084,8,8,10,18,30,62,-32,34
Edinburgh Ci,5084,9,7,9,20,36,63,-27,30
Cowdenbeath,5084,10,4,10,22,23,57,-34,22
Montrose,5085,1,23,8,5,59,34,25,77
Peterhead,5085,2,24,4,8,80,39,41,76
Stirling,5085,3,17,6,13,64,51,13,57
Clyde,5085,4,15,9,12,52,48,4,54
Stenhousem'r,5085,5,15,8,13,55,50,5,53
Elgin,5085,6,14,7,15,53,60,-7,49
Annan Athlet,5085,7,12,11,13,48,41,7,47
Berwick,5085,8,8,10,18,29,59,-30,34
Edinburgh Ci,5085,9,7,9,20,37,63,-26,30
Cowdenbeath,5085,10,4,10,22,23,55,-32,22
Montrose,5086,1,24,7,5,62,35,27,79
Peterhead,5086,2,24,4,8,85,39,46,76
Stirling,5086,3,17,6,13,64,52,12,57
Stenhousem'r,5086,4,15,8,13,56,50,6,53
Clyde,5086,5,14,10,12,52,49,3,52
Elgin,5086,6,14,6,16,54,63,-9,48
Annan Athlet,5086,7,11,12,13,50,44,6,45
Berwick,5086,8,8,11,17,30,59,-29,35
Edinburgh Ci,5086,9,7,9,20,37,68,-31,30
Cowdenbeath,5086,10,4,11,21,26,57,-31,23
Montrose,5087,1,24,7,5,61,34,27,79
Peterhead,5087,2,24,4,8,80,38,42,76
Stirling,5087,3,16,7,13,61,52,9,55
Stenhousem'r,5087,4,15,9,12,56,47,9,54
Clyde,5087,5,14,9,13,51,49,2,51
Elgin,5087,6,14,6,16,53,62,-9,48
Annan Athlet,5087,7,11,12,13,48,42,6,45
Berwick,5087,8,9,10,17,30,58,-28,37
Edinburgh Ci,5087,9,7,9,20,36,63,-27,30
Cowdenbeath,5087,10,4,11,21,24,55,-31,23
Montrose,5088,1,23,7,6,59,35,24,76
Peterhead,5088,2,23,5,8,79,40,39,74
Stirling,5088,3,17,6,13,63,52,11,57
Clyde,5088,4,15,9,12,53,49,4,54
Stenhousem'r,5088,5,15,8,13,56,49,7,53
Elgin,5088,6,15,6,15,54,60,-6,51
Annan Athlet,5088,7,11,12,13,47,41,6,45
Berwick,5088,8,8,10,18,30,60,-30,34
Edinburgh Ci,5088,9,7,10,19,38,62,-24,31
Cowdenbeath,5088,10,4,11,21,23,54,-31,23
Montrose,5089,1,23,8,5,60,35,25,77
Peterhead,5089,2,23,5,8,78,39,39,74
Stirling,5089,3,17,6,13,62,51,11,57
Stenhousem'r,5089,4,15,8,13,55,48,7,53
Clyde,5089,5,14,9,13,51,50,1,51
Elgin,5089,6,14,7,15,54,61,-7,49
Annan Athlet,5089,7,11,12,13,48,42,6,45
Berwick,5089,8,9,10,17,31,58,-27,37
Edinburgh Ci,5089,9,7,10,19,37,61,-24,31
Cowdenbeath,5089,10,4,11,21,24,55,-31,23
Montrose,5090,1,24,7,5,61,35,26,79
Peterhead,5090,2,24,4,8,80,39,41,76
Stirling,5090,3,17,6,13,62,51,11,57
Stenhousem'r,5090,4,15,8,13,55,48,7,53
Clyde,5090,5,14,9,13,52,50,2,51
Elgin,5090,6,14,6,16,54,62,-8,48
Annan Athlet,5090,7,12,11,13,48,41,7,47
Berwick,5090,8,9,10,17,31,59,-28,37
Edinburgh Ci,5090,9,7,9,20,37,63,-26,30
Cowdenbeath,5090,10,4,10,22,23,55,-32,22
Peterhead,5091,1,24,4,8,80,39,41,76
Montrose,5091,2,23,7,6,59,36,23,76
Stirling,5091,3,17,6,13,62,52,10,57
Clyde,5091,4,15,9,12,54,48,6,54
Stenhousem'r,5091,5,15,8,13,56,48,8,53
Elgin,5091,6,15,6,15,55,60,-5,51
Annan Athlet,5091,7,12,11,13,48,41,7,47
Berwick,5091,8,8,10,18,29,61,-32,34
Edinburgh Ci,5091,9,7,9,20,37,63,-26,30
Cowdenbeath,5091,10,4,10,22,23,55,-32,22
Montrose,5092,1,23,8,5,60,35,25,77
Peterhead,5092,2,24,4,8,81,39,42,76
Stenhousem'r,5092,3,16,8,12,60,49,11,56
Stirling,5092,4,16,6,14,63,56,7,54
Clyde,5092,5,15,9,12,52,48,4,54
Elgin,5092,6,14,7,15,54,61,-7,49
Annan Athlet,5092,7,11,11,14,48,43,5,44
Berwick,5092,8,8,10,18,29,59,-30,34
Edinburgh Ci,5092,9,7,9,20,37,64,-27,30
Cowdenbeath,5092,10,5,10,21,25,55,-30,25
Montrose,5093,1,24,7,5,61,35,26,79
Peterhead,5093,2,23,4,9,77,39,38,73
Stirling,5093,3,17,6,13,62,52,10,57
Stenhousem'r,5093,4,15,8,13,56,48,8,53
Clyde,5093,5,14,9,13,51,50,1,51
Elgin,5093,6,14,6,16,54,62,-8,48
Annan Athlet,5093,7,11,11,14,47,43,4,44
Berwick,5093,8,9,10,17,31,58,-27,37
Edinburgh Ci,5093,9,8,9,19,37,60,-23,33
Cowdenbeath,5093,10,5,10,21,25,54,-29,25
Montrose,5094,1,24,7,5,63,35,28,79
Peterhead,5094,2,23,5,8,77,38,39,74
Stenhousem'r,5094,3,16,8,12,59,49,10,56
Stirling,5094,4,16,6,14,63,55,8,54
Clyde,5094,5,14,10,12,51,48,3,52
Elgin,5094,6,14,6,16,54,64,-10,48
Annan Athlet,5094,7,12,11,13,49,41,8,47
Berwick,5094,8,8,11,17,29,58,-29,35
Edinburgh Ci,5094,9,7,10,19,36,60,-24,31
Cowdenbeath,5094,10,4,10,22,23,56,-33,22
Montrose,5095,1,23,8,5,62,37,25,77
Peterhead,5095,2,24,4,8,79,39,40,76
Stenhousem'r,5095,3,16,8,12,58,48,10,56
Stirling,5095,4,16,6,14,62,54,8,54
Clyde,5095,5,15,9,12,54,48,6,54
Elgin,5095,6,14,7,15,56,63,-7,49
Annan Athlet,5095,7,11,11,14,47,43,4,44
Berwick,5095,8,8,10,18,29,61,-32,34
Edinburgh Ci,5095,9,7,9,20,37,62,-25,30
Cowdenbeath,5095,10,5,10,21,25,54,-29,25
Montrose,5096,1,24,7,5,61,34,27,79
Peterhead,5096,2,24,4,8,78,38,40,76
Stenhousem'r,5096,3,16,8,12,56,46,10,56
Stirling,5096,4,16,6,14,60,52,8,54
Clyde,5096,5,15,9,12,56,49,7,54
Elgin,5096,6,14,6,16,53,62,-9,48
Annan Athlet,5096,7,11,12,13,48,42,6,45
Berwick,5096,8,8,10,18,30,63,-33,34
Edinburgh Ci,5096,9,7,9,20,36,61,-25,30
Cowdenbeath,5096,10,4,11,21,24,55,-31,23
Montrose,5097,1,24,7,5,67,34,33,79
Peterhead,5097,2,23,5,8,79,40,39,74
Stirling,5097,3,17,6,13,61,51,10,57
Clyde,5097,4,15,9,12,52,48,4,54
Stenhousem'r,5097,5,15,8,13,55,47,8,53
Elgin,5097,6,14,6,16,53,68,-15,48
Annan Athlet,5097,7,12,11,13,48,41,7,47
Berwick,5097,8,8,10,18,29,59,-30,34
Edinburgh Ci,5097,9,7,10,19,38,62,-24,31
Cowdenbeath,5097,10,4,10,22,23,55,-32,22
Montrose,5098,1,24,7,5,64,34,30,79
Peterhead,5098,2,23,4,9,77,41,36,73
Stirling,5098,3,17,6,13,66,51,15,57
Clyde,5098,4,15,9,12,54,48,6,54
Stenhousem'r,5098,5,15,8,13,55,52,3,53
Elgin,5098,6,14,6,16,53,65,-12,48
Annan Athlet,5098,7,11,11,14,47,42,5,44
Berwick,5098,8,8,10,18,29,61,-32,34
Edinburgh Ci,5098,9,8,9,19,39,60,-21,33
Cowdenbeath,5098,10,5,10,21,24,54,-30,25
Montrose,5099,1,24,7,5,61,35,26,79
Peterhead,5099,2,24,4,8,80,39,41,76
Stirling,5099,3,17,6,13,61,51,10,57
Stenhousem'r,5099,4,15,8,13,55,47,8,53
Clyde,5099,5,14,9,13,51,49,2,51
Elgin,5099,6,14,6,16,54,62,-8,48
Annan Athlet,5099,7,12,11,13,50,41,9,47
Berwick,5099,8,9,10,17,30,58,-28,37
Edinburgh Ci,5099,9,7,9,20,37,63,-26,30
Cowdenbeath,5099,10,4,10,22,23,57,-34,22
Montrose,5100,1,24,7,5,63,34,29,79
Peterhead,5100,2,24,4,8,79,38,41,76
Stirling,5100,3,17,6,13,61,51,10,57
Clyde,5100,4,15,9,12,53,49,4,54
Stenhousem'r,5100,5,15,8,13,55,47,8,53
Elgin,5100,6,14,6,16,53,64,-11,48
Annan Athlet,5100,7,12,11,13,50,42,8,47
Berwick,5100,8,8,10,18,30,60,-30,34
Edinburgh Ci,5100,9,7,9,20,36,62,-26,30
Cowdenbeath,5100,10,4,10,22,24,57,-33,22
Montrose,5101,1,24,7,5,61,34,27,79
Peterhead,5101,2,24,4,8,81,39,42,76
Stenhousem'r,5101,3,16,8,12,59,46,13,56
Stirling,5101,4,16,6,14,60,55,5,54
Clyde,5101,5,14,9,13,53,51,2,51
Elgin,5101,6,14,6,16,53,62,-9,48
Annan Athlet,5101,7,11,11,14,48,43,5,44
Berwick,5101,8,9,10,17,32,60,-28,37
Edinburgh Ci,5101,9,7,9,20,37,64,-27,30
Cowdenbeath,5101,10,5,10,21,25,55,-30,25
Montrose,5102,1,24,7,5,61,34,27,79
Peterhead,5102,2,24,4,8,80,39,41,76
Stirling,5102,3,16,7,13,61,52,9,55
Stenhousem'r,5102,4,15,9,12,56,47,9,54
Clyde,5102,5,14,10,12,51,48,3,52
Elgin,5102,6,14,6,16,53,62,-9,48
Annan Athlet,5102,7,11,11,14,48,43,5,44
Berwick,5102,8,8,11,17,29,58,-29,35
Edinburgh Ci,5102,9,7,9,20,37,63,-26,30
Cowdenbeath,5102,10,5,10,21,25,55,-30,25
Montrose,5103,1,24,7,5,63,34,29,79
Peterhead,5103,2,24,4,8,81,38,43,76
Stirling,5103,3,17,6,13,62,51,11,57
Stenhousem'r,5103,4,15,8,13,55,48,7,53
Clyde,5103,5,14,10,12,52,49,3,52
Elgin,5103,6,14,6,16,53,64,-11,48
Annan Athlet,5103,7,11,11,14,47,42,5,44
Berwick,5103,8,8,11,17,30,59,-29,35
Edinburgh Ci,5103,9,7,9,20,36,64,-28,30
Cowdenbeath,5103,10,5,10,21,24,54,-30,25
Montrose,5104,1,24,7,5,61,34,27,79
Peterhead,5104,2,24,4,8,81,38,43,76
Stenhousem'r,5104,3,16,8,12,58,48,10,56
Stirling,5104,4,16,6,14,62,54,8,54
Clyde,5104,5,15,9,12,54,48,6,54
Elgin,5104,6,14,6,16,53,62,-9,48
Annan Athlet,5104,7,11,12,13,48,42,6,45
Berwick,5104,8,8,10,18,29,61,-32,34
Edinburgh Ci,5104,9,7,9,20,36,64,-28,30
Cowdenbeath,5104,10,4,11,21,24,55,-31,23
Peterhead,5105,1,24,4,8,80,39,41,76
Montrose,5105,2,23,7,6,59,36,23,76
Stirling,5105,3,17,6,13,61,51,10,57
Stenhousem'r,5105,4,15,8,13,55,47,8,53
Clyde,5105,5,14,10,12,52,49,3,52
Elgin,5105,6,15,6,15,55,60,-5,51
Annan Athlet,5105,7,12,11,13,49,41,8,47
Berwick,5105,8,8,11,17,30,59,-29,35
Edinburgh Ci,5105,9,7,9,20,37,63,-26,30
Cowdenbeath,5105,10,4,10,22,23,56,-33,22
Montrose,5106,1,24,7,5,62,35,27,79
Peterhead,5106,2,24,4,8,80,39,41,76
Stirling,5106,3,17,6,13,64,52,12,57
Clyde,5106,4,15,9,12,54,49,5,54
Stenhousem'r,5106,5,15,8,13,56,50,6,53
Elgin,5106,6,14,6,16,54,63,-9,48
Annan Athlet,5106,7,11,11,14,49,44,5,44
Berwick,5106,8,8,10,18,30,61,-31,34
Edinburgh Ci,5106,9,7,9,20,37,63,-26,30
Cowdenbeath,5106,10,5,10,21,26,56,-30,25
Montrose,5107,1,24,7,5,65,35,30,79
Peterhead,5107,2,24,4,8,79,39,40,76
Stirling,5107,3,17,6,13,63,52,11,57
Clyde,5107,4,15,9,12,52,48,4,54
Stenhousem'r,5107,5,15,8,13,56,49,7,53
Elgin,5107,6,14,6,16,54,66,-12,48
Annan Athlet,5107,7,11,11,14,47,42,5,44
Berwick,5107,8,8,10,18,29,59,-30,34
Edinburgh Ci,5107,9,7,9,20,37,62,-25,30
Cowdenbeath,5107,10,5,10,21,24,54,-30,25
Peterhead,5108,1,24,4,8,80,38,42,76
Montrose,5108,2,23,7,6,59,36,23,76
Stirling,5108,3,17,6,13,64,51,13,57
Clyde,5108,4,15,9,12,52,48,4,54
Stenhousem'r,5108,5,15,8,13,55,50,5,53
Elgin,5108,6,15,6,15,55,60,-5,51
Annan Athlet,5108,7,11,11,14,47,43,4,44
Berwick,5108,8,8,10,18,29,59,-30,34
Edinburgh Ci,5108,9,7,9,20,36,63,-27,30
Cowdenbeath,5108,10,5,10,21,25,54,-29,25
Montrose,5109,1,24,7,5,61,35,26,79
Peterhead,5109,2,24,4,8,79,38,41,76
Stirling,5109,3,17,6,13,62,51,11,57
Stenhousem'r,5109,4,15,8,13,55,48,7,53
Clyde,5109,5,14,10,12,52,49,3,52
Elgin,5109,6,14,6,16,54,62,-8,48
Annan Athlet,5109,7,12,11,13,49,42,7,47
Berwick,5109,8,8,11,17,30,59,-29,35
Edinburgh Ci,5109,9,7,9,20,36,62,-26,30
Cowdenbeath,5109,10,4,10,22,24,56,-32,22
Montrose,5110,1,23,7,6,59,36,23,76
Peterhead,5110,2,23,4,9,77,41,36,73
Stirling,5110,3,16,7,13,60,51,9,55
Stenhousem'r,5110,4,15,9,12,55,46,9,54
Clyde,5110,5,14,9,13,52,50,2,51
Elgin,5110,6,15,6,15,55,60,-5,51
Annan Athlet,5110,7,12,11,13,49,41,8,47
Berwick,5110,8,9,10,17,31,59,-28,37
Edinburgh Ci,5110,9,8,9,19,39,60,-21,33
Cowdenbeath,5110,10,4,10,22,23,56,-33,22
Montrose,5111,1,23,8,5,62,37,25,77
Peterhead,5111,2,24,4,8,79,38,41,76
Stirling,5111,3,17,6,13,63,52,11,57
Stenhousem'r,5111,4,15,8,13,56,49,7,53
Clyde,5111,5,14,10,12,51,48,3,52
Elgin,5111,6,14,7,15,56,63,-7,49
Annan Athlet,5111,7,12,11,13,48,41,7,47
Berwick,5111,8,8,11,17,29,58,-29,35
Edinburgh Ci,5111,9,7,9,20,36,62,-26,30
Cowdenbeath,5111,10,4,10,22,23,55,-32,22
Montrose,5112,1,24,7,5,62,34,28,79
Peterhead,5112,2,24,4,8,79,38,41,76
Stenhousem'r,5112,3,16,8,12,56,46,10,56
Stirling,5112,4,16,6,14,60,52,8,54
Clyde,5112,5,15,9,12,53,49,4,54
Elgin,5112,6,14,6,16,53,63,-10,48
Annan Athlet,5112,7,11,11,14,47,42,5,44
Berwick,5112,8,8,10,18,30,60,-30,34
Edinburgh Ci,5112,9,7,9,20,36,62,-26,30
Cowdenbeath,5112,10,5,10,21,24,54,-30,25
Montrose,5113,1,23,8,5,61,36,25,77
Peterhead,5113,2,24,4,8,80,39,41,76
Stirling,5113,3,17,6,13,62,51,11,57
Clyde,5113,4,15,9,12,52,48,4,54
Stenhousem'r,5113,5,15,8,13,55,48,7,53
Elgin,5113,6,14,7,15,55,62,-7,49
Annan Athlet,5113,7,12,11,13,49,42,7,47
Berwick,5113,8,8,10,18,29,59,-30,34
Edinburgh Ci,5113,9,7,9,20,37,63,-26,30
Cowdenbeath,5113,10,4,10,22,24,56,-32,22
Peterhead,5114,1,24,4,8,80,38,42,76
Montrose,5114,2,23,7,6,61,37,24,76
Stenhousem'r,5114,3,16,8,12,58,48,10,56
Stirling,5114,4,16,6,14,62,54,8,54
Clyde,5114,5,14,9,13,51,49,2,51
Elgin,5114,6,15,6,15,56,62,-6,51
Annan Athlet,5114,7,11,12,13,47,41,6,45
Berwick,5114,8,9,10,17,30,58,-28,37
Edinburgh Ci,5114,9,7,9,20,36,63,-27,30
Cowdenbeath,5114,10,4,11,21,23,54,-31,23
Montrose,5115,1,24,7,5,61,35,26,79
Peterhead,5115,2,24,4,8,79,38,41,76
Stirling,5115,3,17,6,13,61,51,10,57
Stenhousem'r,5115,4,15,8,13,55,47,8,53
Clyde,5115,5,14,10,12,53,50,3,52
Elgin,5115,6,14,6,16,54,62,-8,48
Annan Athlet,5115,7,12,11,13,50,43,7,47
Berwick,5115,8,8,11,17,31,60,-29,35
Edinburgh Ci,5115,9,7,9,20,36,62,-26,30
Cowdenbeath,5115,10,4,10,22,25,57,-32,22
Peterhead,5116,1,24,4,8,79,39,40,76
Montrose,5116,2,23,7,6,60,36,24,76
Stenhousem'r,5116,3,16,8,12,58,47,11,56
Stirling,5116,4,16,6,14,61,54,7,54
Clyde,5116,5,15,9,12,54,48,6,54
Elgin,5116,6,15,6,15,55,61,-6,51
Annan Athlet,5116,7,11,11,14,47,42,5,44
Berwick,5116,8,8,10,18,29,61,-32,34
Edinburgh Ci,5116,9,7,9,20,37,62,-25,30
Cowdenbeath,5116,10,5,10,21,24,54,-30,25
Montrose,5117,1,23,8,5,62,37,25,77
Peterhead,5117,2,23,5,8,78,39,39,74
Stenhousem'r,5117,3,16,8,12,58,47,11,56
Stirling,5117,4,16,6,14,61,54,7,54
Clyde,5117,5,14,9,13,51,49,2,51
Elgin,5117,6,14,7,15,56,63,-7,49
Annan Athlet,5117,7,11,11,14,48,43,5,44
Berwick,5117,8,9,10,17,30,58,-28,37
Edinburgh Ci,5117,9,7,10,19,37,61,-24,31
Cowdenbeath,5117,10,5,10,21,25,55,-30,25
Montrose,5118,1,24,7,5,63,36,27,79
Peterhead,5118,2,24,4,8,80,38,42,76
Stirling,5118,3,17,6,13,65,51,14,57
Clyde,5118,4,15,9,12,55,50,5,54
Stenhousem'r,5118,5,15,8,13,55,51,4,53
Elgin,5118,6,14,6,16,55,64,-9,48
Annan Athlet,5118,7,11,11,14,47,43,4,44
Berwick,5118,8,8,10,18,31,62,-31,34
Edinburgh Ci,5118,9,7,9,20,36,63,-27,30
Cowdenbeath,5118,10,5,10,21,25,54,-29,25
Montrose,5119,1,23,7,6,61,39,22,76
Peterhead,5119,2,23,4,9,77,40,37,73
Stirling,5119,3,17,6,13,64,51,13,57
Clyde,5119,4,15,9,12,53,48,5,54
Stenhousem'r,5119,5,15,8,13,55,50,5,53
Elgin,5119,6,15,6,15,58,62,-4,51
Annan Athlet,5119,7,11,11,14,48,43,5,44
Berwick,5119,8,8,10,18,29,60,-31,34
Edinburgh Ci,5119,9,8,9,19,38,60,-22,33
Cowdenbeath,5119,10,5,10,21,25,55,-30,25
Montrose,5120,1,23,8,5,60,35,25,77
Peterhead,5120,2,24,4,8,81,39,42,76
Stirling,5120,3,17,6,13,62,52,10,57
Clyde,5120,4,15,9,12,53,49,4,54
Stenhousem'r,5120,5,15,8,13,56,48,8,53
Elgin,5120,6,14,7,15,54,61,-7,49
Annan Athlet,5120,7,11,12,13,48,42,6,45
Berwick,5120,8,8,10,18,30,60,-30,34
Edinburgh Ci,5120,9,7,9,20,37,64,-27,30
Cowdenbeath,5120,10,4,11,21,24,55,-31,23
Montrose,5121,1,24,7,5,61,34,27,79
Peterhead,5121,2,24,4,8,80,38,42,76
Stirling,5121,3,17,6,13,62,51,11,57
Stenhousem'r,5121,4,15,8,13,55,48,7,53
Clyde,5121,5,14,9,13,51,50,1,51
Elgin,5121,6,14,6,16,53,62,-9,48
Annan Athlet,5121,7,11,12,13,48,42,6,45
Berwick,5121,8,9,10,17,31,58,-27,37
Edinburgh Ci,5121,9,7,9,20,36,63,-27,30
Cowdenbeath,5121,10,4,11,21,24,55,-31,23
Peterhead,5122,1,24,4,8,80,38,42,76
Montrose,5122,2,23,7,6,60,36,24,76
Stirling,5122,3,16,7,13,61,52,9,55
Stenhousem'r,5122,4,15,9,12,56,47,9,54
Clyde,5122,5,14,9,13,52,50,2,51
Elgin,5122,6,15,6,15,55,61,-6,51
Annan Athlet,5122,7,12,11,13,48,41,7,47
Berwick,5122,8,9,10,17,31,59,-28,37
Edinburgh Ci,5122,9,7,9,20,36,63,-27,30
Cowdenbeath,5122,10,4,10,22,23,55,-32,22
Peterhead,5123,1,24,4,8,81,39,42,76
Montrose,5123,2,23,7,6,60,36,24,76
Stirling,5123,3,17,6,13,63,51,12,57
Stenhousem'r,5123,4,15,8,13,55,49,6,53
Clyde,5123,5,14,9,13,52,51,1,51
Elgin,5123,6,15,6,15,55,61,-6,51
Annan Athlet,5123,7,11,11,14,47,43,4,44
Berwick,5123,8,9,10,17,32,59,-27,37
Edinburgh Ci,5123,9,7,9,20,37,64,-27,30
Cowdenbeath,5123,10,5,10,21,25,54,-29,25
Montrose,5124,1,23,8,5,60,35,25,77
Peterhead,5124,2,23,5,8,78,39,39,74
Stenhousem'r,5124,3,16,8,12,56,46,10,56
Stirling,5124,4,16,6,14,60,52,8,54
Clyde,5124,5,14,10,12,51,48,3,52
Elgin,5124,6,14,7,15,54,61,-7,49
Annan Athlet,5124,7,11,11,14,47,43,4,44
Berwick,5124,8,8,11,17,29,58,-29,35
Edinburgh Ci,5124,9,7,10,19,37,61,-24,31
Cowdenbeath,5124,10,5,10,21,25,54,-29,25
Montrose,5125,1,24,7,5,62,36,26,79
Peterhead,5125,2,24,4,8,81,38,43,76
Stirling,5125,3,17,6,13,61,51,10,57
Clyde,5125,4,15,9,12,53,49,4,54
Stenhousem'r,5125,5,15,8,13,55,47,8,53
Elgin,5125,6,14,6,16,55,63,-8,48
Annan Athlet,5125,7,12,11,13,48,41,7,47
Berwick,5125,8,8,10,18,30,60,-30,34
Edinburgh Ci,5125,9,7,9,20,36,64,-28,30
Cowdenbeath,5125,10,4,10,22,23,55,-32,22
Peterhead,5126,1,24,4,8,78,38,40,76
Montrose,5126,2,23,7,6,59,36,23,76
Stirling,5126,3,17,6,13,61,51,10,57
Stenhousem'r,5126,4,15,8,13,55,47,8,53
Clyde,5126,5,14,9,13,51,49,2,51
Elgin,5126,6,15,6,15,55,60,-5,51
Annan Athlet,5126,7,12,11,13,50,43,7,47
Berwick,5126,8,9,10,17,30,58,-28,37
Edinburgh Ci,5126,9,7,9,20,36,61,-25,30
Cowdenbeath,5126,10,4,10,22,25,57,-32,22
Montrose,5127,1,23,8,5,60,35,25,77
Peterhead,5127,2,23,5,8,77,38,39,74
Stirling,5127,3,17,6,13,63,53,10,57
Clyde,5127,4,15,9,12,54,49,5,54
Stenhousem'r,5127,5,15,8,13,57,49,8,53
Elgin,5127,6,14,7,15,54,61,-7,49
Annan Athlet,5127,7,12,11,13,48,41,7,47
Berwick,5127,8,8,10,18,30,61,-31,34
Edinburgh Ci,5127,9,7,10,19,36,60,-24,31
Cowdenbeath,5127,10,4,10,22,23,55,-32,22
Montrose,5128,1,23,7,6,62,38,24,76
Peterhead,5128,2,23,5,8,77,38,39,74
Stirling,5128,3,17,6,13,62,51,11,57
Stenhousem'r,5128,4,15,8,13,55,48,7,53
Clyde,5128,5,14,9,13,51,49,2,51
Elgin,5128,6,15,6,15,57,63,-6,51
Annan Athlet,5128,7,11,12,13,48,42,6,45
Berwick,5128,8,9,10,17,30,58,-28,37
Edinburgh Ci,5128,9,7,10,19,36,60,-24,31
Cowdenbeath,5128,10,4,11,21,24,55,-31,23
Montrose,5129,1,24,7,5,63,35,28,79
Peterhead,5129,2,23,5,8,78,39,39,74
Stirling,5129,3,16,7,13,63,54,9,55
Stenhousem'r,5129,4,15,9,12,58,49,9,54
Clyde,5129,5,15,9,12,55,48,7,54
Elgin,5129,6,14,6,16,54,64,-10,48
Annan Athlet,5129,7,11,11,14,47,42,5,44
Berwick,5129,8,8,10,18,29,62,-33,34
Edinburgh Ci,5129,9,7,10,19,37,61,-24,31
Cowdenbeath,5129,10,5,10,21,24,54,-30,25
Montrose,5130,1,23,8,5,60,35,25,77
Peterhead,5130,2,23,5,8,78,39,39,74
Stirling,5130,3,17,6,13,61,51,10,57
Clyde,5130,4,15,9,12,52,48,4,54
Stenhousem'r,5130,5,15,8,13,55,47,8,53
Elgin,5130,6,14,7,15,54,61,-7,49
Annan Athlet,5130,7,11,12,13,47,41,6,45
Berwick,5130,8,8,10,18,29,59,-30,34
Edinburgh Ci,5130,9,7,10,19,37,61,-24,31
Cowdenbeath,5130,10,4,11,21,23,54,-31,23
Montrose,5131,1,24,7,5,63,35,28,79
Peterhead,5131,2,24,4,8,79,38,41,76
Stenhousem'r,5131,3,16,8,12,57,47,10,56
Stirling,5131,4,16,6,14,61,53,8,54
Clyde,5131,5,15,9,12,52,48,4,54
Elgin,5131,6,14,6,16,54,64,-10,48
Annan Athlet,5131,7,12,11,13,48,41,7,47
Berwick,5131,8,8,10,18,29,59,-30,34
Edinburgh Ci,5131,9,7,9,20,36,62,-26,30
Cowdenbeath,5131,10,4,10,22,23,55,-32,22
Montrose,5132,1,23,8,5,60,35,25,77
Peterhead,5132,2,24,4,8,79,39,40,76
Stenhousem'r,5132,3,16,8,12,57,46,11,56
Stirling,5132,4,16,6,14,60,53,7,54
Clyde,5132,5,14,9,13,51,49,2,51
Elgin,5132,6,14,7,15,54,61,-7,49
Annan Athlet,5132,7,11,12,13,47,41,6,45
Berwick,5132,8,9,10,17,30,58,-28,37
Edinburgh Ci,5132,9,7,9,20,37,62,-25,30
Cowdenbeath,5132,10,4,11,21,23,54,-31,23
Montrose,5133,1,24,7,5,64,34,30,79
Peterhead,5133,2,23,5,8,78,39,39,74
Stenhousem'r,5133,3,16,8,12,59,47,12,56
Stirling,5133,4,16,6,14,61,55,6,54
Clyde,5133,5,15,9,12,55,49,6,54
Elgin,5133,6,14,6,16,53,65,-12,48
Annan Athlet,5133,7,11,11,14,48,43,5,44
Berwick,5133,8,8,10,18,30,62,-32,34
Edinburgh Ci,5133,9,7,10,19,37,61,-24,31
Cowdenbeath,5133,10,5,10,21,25,55,-30,25
Montrose,5134,1,23,8,5,60,35,25,77
Peterhead,5134,2,24,4,8,81,38,43,76
Stirling,5134,3,16,7,13,63,54,9,55
Stenhousem'r,5134,4,15,9,12,58,49,9,54
Clyde,5134,5,14,10,12,52,49,3,52
Elgin,5134,6,14,7,15,54,61,-7,49
Annan Athlet,5134,7,11,11,14,48,43,5,44
Berwick,5134,8,8,11,17,30,59,-29,35
Edinburgh Ci,5134,9,7,9,20,36,64,-28,30
Cowdenbeath,5134,10,5,10,21,25,55,-30,25
Montrose,5135,1,24,7,5,61,35,26,79
Peterhead,5135,2,24,4,8,79,38,41,76
Stenhousem'r,5135,3,16,8,12,57,46,11,56
Stirling,5135,4,16,6,14,60,53,7,54
Clyde,5135,5,15,9,12,53,48,5,54
Elgin,5135,6,14,6,16,54,62,-8,48
Annan Athlet,5135,7,12,11,13,49,42,7,47
Berwick,5135,8,8,10,18,29,60,-31,34
Edinburgh Ci,5135,9,7,9,20,36,62,-26,30
Cowdenbeath,5135,10,4,10,22,24,56,-32,22
Montrose,5136,1,23,7,6,59,35,24,76
Peterhead,5136,2,23,5,8,79,40,39,74
Stirling,5136,3,16,7,13,60,51,9,55
Stenhousem'r,5136,4,15,9,12,55,46,9,54
Clyde,5136,5,14,10,12,53,50,3,52
Elgin,5136,6,15,6,15,54,60,-6,51
Annan Athlet,5136,7,11,11,14,48,43,5,44
Berwick,5136,8,8,11,17,31,60,-29,35
Edinburgh Ci,5136,9,7,10,19,38,62,-24,31
Cowdenbeath,5136,10,5,10,21,25,55,-30,25
Montrose,5137,1,24,7,5,60,34,26,79
Peterhead,5137,2,24,4,8,80,38,42,76
Stirling,5137,3,17,6,13,64,51,13,57
Clyde,5137,4,15,9,12,55,49,6,54
Stenhousem'r,5137,5,15,8,13,55,50,5,53
Elgin,5137,6,14,6,16,53,61,-8,48
Annan Athlet,5137,7,11,11,14,47,43,4,44
Berwick,5137,8,8,10,18,30,62,-32,34
Edinburgh Ci,5137,9,7,9,20,36,63,-27,30
Cowdenbeath,5137,10,5,10,21,25,54,-29,25
Montrose,5138,1,24,7,5,62,34,28,79
Peterhead,5138,2,24,4,8,80,38,42,76
Stirling,5138,3,17,6,13,65,51,14,57
Stenhousem'r,5138,4,15,8,13,55,51,4,53
Clyde,5138,5,14,9,13,53,51,2,51
Elgin,5138,6,14,6,16,53,63,-10,48
Annan Athlet,5138,7,12,11,13,50,41,9,47
Berwick,5138,8,9,10,17,32,60,-28,37
Edinburgh Ci,5138,9,7,9,20,36,63,-27,30
Cowdenbeath,5138,10,4,10,22,23,57,-34,22
Montrose,5139,1,23,8,5,60,35,25,77
Peterhead,5139,2,24,4,8,80,38,42,76
Stirling,5139,3,17,6,13,63,51,12,57
Clyde,5139,4,15,9,12,55,49,6,54
Stenhousem'r,5139,5,15,8,13,55,49,6,53
Elgin,5139,6,14,7,15,54,61,-7,49
Annan Athlet,5139,7,11,12,13,48,42,6,45
Berwick,5139,8,8,10,18,30,62,-32,34
Edinburgh Ci,5139,9,7,9,20,36,63,-27,30
Cowdenbeath,5139,10,4,11,21,24,55,-31,23
Montrose,5140,1,24,7,5,60,34,26,79
Peterhead,5140,2,23,5,8,79,40,39,74
Stirling,5140,3,16,7,13,61,52,9,55
Stenhousem'r,5140,4,15,9,12,56,47,9,54
Clyde,5140,5,15,9,12,54,49,5,54
Elgin,5140,6,14,6,16,53,61,-8,48
Annan Athlet,5140,7,12,11,13,51,42,9,47
Berwick,5140,8,8,10,18,30,61,-31,34
Edinburgh Ci,5140,9,7,10,19,38,62,-24,31
Cowdenbeath,5140,10,4,10,22,24,58,-34,22
Montrose,5141,1,23,8,5,62,37,25,77
Peterhead,5141,2,24,4,8,82,41,41,76
Stirling,5141,3,16,7,13,61,52,9,55
Stenhousem'r,5141,4,15,9,12,56,47,9,54
Clyde,5141,5,15,9,12,53,49,4,54
Elgin,5141,6,14,7,15,56,63,-7,49
Annan Athlet,5141,7,11,12,13,48,42,6,45
Berwick,5141,8,8,10,18,30,60,-30,34
Edinburgh Ci,5141,9,7,9,20,39,65,-26,30
Cowdenbeath,5141,10,4,11,21,24,55,-31,23
Peterhead,5142,1,24,4,8,80,39,41,76
Montrose,5142,2,23,7,6,60,37,23,76
Stirling,5142,3,16,7,13,62,53,9,55
Stenhousem'r,5142,4,15,9,12,57,48,9,54
Clyde,5142,5,15,9,12,56,48,8,54
Elgin,5142,6,15,6,15,56,61,-5,51
Annan Athlet,5142,7,11,12,13,48,42,6,45
Berwick,5142,8,8,10,18,29,63,-34,34
Edinburgh Ci,5142,9,7,9,20,37,63,-26,30
Cowdenbeath,5142,10,4,11,21,24,55,-31,23
Montrose,5143,1,23,8,5,61,36,25,77
Peterhead,5143,2,24,4,8,80,39,41,76
Stirling,5143,3,17,6,13,63,52,11,57
Clyde,5143,4,15,9,12,54,48,6,54
Stenhousem'r,5143,5,15,8,13,56,49,7,53
Elgin,5143,6,14,7,15,55,62,-7,49
Annan Athlet,5143,7,12,11,13,48,41,7,47
Berwick,5143,8,8,10,18,29,61,-32,34
Edinburgh Ci,5143,9,7,9,20,37,63,-26,30
Cowdenbeath,5143,10,4,10,22,23,55,-32,22
Montrose,5144,1,24,7,5,63,36,27,79
Peterhead,5144,2,23,4,9,79,41,38,73
Stirling,5144,3,17,6,13,65,52,13,57
Clyde,5144,4,15,9,12,53,48,5,54
Stenhousem'r,5144,5,15,8,13,56,51,5,53
Elgin,5144,6,14,6,16,55,64,-9,48
Annan Athlet,5144,7,11,12,13,48,42,6,45
Berwick,5144,8,8,10,18,29,60,-31,34
Edinburgh Ci,5144,9,8,9,19,39,62,-23,33
Cowdenbeath,5144,10,4,11,21,24,55,-31,23
Montrose,5145,1,24,7,5,61,34,27,79
Peterhead,5145,2,24,4,8,84,38,46,76
Stenhousem'r,5145,3,16,8,12,57,47,10,56
Stirling,5145,4,16,6,14,61,53,8,54
Clyde,5145,5,15,9,12,54,50,4,54
Elgin,5145,6,14,6,16,53,62,-9,48
Annan Athlet,5145,7,12,11,13,50,42,8,47
Berwick,5145,8,8,10,18,31,61,-30,34
Edinburgh Ci,5145,9,7,9,20,36,67,-31,30
Cowdenbeath,5145,10,4,10,22,24,57,-33,22
Montrose,5146,1,23,8,5,60,35,25,77
Peterhead,5146,2,24,4,8,81,39,42,76
Stirling,5146,3,16,7,13,62,53,9,55
Stenhousem'r,5146,4,15,9,12,57,48,9,54
Clyde,5146,5,14,10,12,52,49,3,52
Elgin,5146,6,14,7,15,54,61,-7,49
Annan Athlet,5146,7,11,11,14,47,43,4,44
Berwick,5146,8,8,11,17,30,59,-29,35
Edinburgh Ci,5146,9,7,9,20,37,64,-27,30
Cowdenbeath,5146,10,5,10,21,25,54,-29,25
Montrose,5147,1,24,7,5,60,34,26,79
Peterhead,5147,2,24,4,8,80,39,41,76
Stenhousem'r,5147,3,16,8,12,59,48,11,56
Stirling,5147,4,16,6,14,62,55,7,54
Clyde,5147,5,15,9,12,53,48,5,54
Elgin,5147,6,14,6,16,53,61,-8,48
Annan Athlet,5147,7,12,11,13,49,41,8,47
Berwick,5147,8,8,10,18,29,60,-31,34
Edinburgh Ci,5147,9,7,9,20,37,63,-26,30
Cowdenbeath,5147,10,4,10,22,23,56,-33,22
Montrose,5148,1,23,7,6,60,38,22,76
Peterhead,5148,2,23,4,9,78,40,38,73
Stenhousem'r,5148,3,16,8,12,59,49,10,56
Stirling,5148,4,16,6,14,63,55,8,54
Clyde,5148,5,15,9,12,54,49,5,54
Elgin,5148,6,15,6,15,57,61,-4,51
Annan Athlet,5148,7,12,11,13,48,41,7,47
Berwick,5148,8,8,10,18,30,61,-31,34
Edinburgh Ci,5148,9,8,9,19,38,61,-23,33
Cowdenbeath,5148,10,4,10,22,23,55,-32,22
Montrose,5149,1,24,7,5,63,34,29,79
Peterhead,5149,2,24,4,8,78,38,40,76
Stirling,5149,3,17,6,13,62,52,10,57
Stenhousem'r,5149,4,15,8,13,56,48,8,53
Clyde,5149,5,14,9,13,52,50,2,51
Elgin,5149,6,14,6,16,53,64,-11,48
Annan Athlet,5149,7,11,12,13,50,44,6,45
Berwick,5149,8,9,10,17,31,59,-28,37
Edinburgh Ci,5149,9,7,9,20,36,61,-25,30
Cowdenbeath,5149,10,4,11,21,26,57,-31,23
Montrose,5150,1,24,7,5,61,34,27,79
Peterhead,5150,2,24,4,8,79,38,41,76
Stirling,5150,3,17,6,13,63,52,11,57
Clyde,5150,4,15,9,12,55,50,5,54
Stenhousem'r,5150,5,15,8,13,56,49,7,53
Elgin,5150,6,14,6,16,53,62,-9,48
Annan Athlet,5150,7,12,11,13,48,41,7,47
Berwick,5150,8,8,10,18,31,62,-31,34
Edinburgh Ci,5150,9,7,9,20,36,62,-26,30
Cowdenbeath,5150,10,4,10,22,23,55,-32,22
Montrose,5151,1,24,7,5,62,35,27,79
Peterhead,5151,2,24,4,8,82,38,44,76
Stirling,5151,3,16,7,13,61,52,9,55
Stenhousem'r,5151,4,15,9,12,56,47,9,54
Clyde,5151,5,15,9,12,54,49,5,54
Elgin,5151,6,14,6,16,54,63,-9,48
Annan Athlet,5151,7,12,11,13,49,42,7,47
Berwick,5151,8,8,10,18,30,61,-31,34
Edinburgh Ci,5151,9,7,9,20,36,65,-29,30
Cowdenbeath,5151,10,4,10,22,24,56,-32,22
Montrose,5152,1,23,8,5,60,35,25,77
Peterhead,5152,2,24,4,8,81,38,43,76
Stirling,5152,3,17,6,13,62,51,11,57
Stenhousem'r,5152,4,15,8,13,55,48,7,53
Clyde,5152,5,14,10,12,52,49,3,52
Elgin,5152,6,14,7,15,54,61,-7,49
Annan Athlet,5152,7,12,11,13,48,41,7,47
Berwick,5152,8,8,11,17,30,59,-29,35
Edinburgh Ci,5152,9,7,9,20,36,64,-28,30
Cowdenbeath,5152,10,4,10,22,23,55,-32,22
Peterhead,5153,1,24,4,8,79,39,40,76
Montrose,5153,2,23,7,6,59,35,24,76
Stirling,5153,3,16,7,13,61,52,9,55
Stenhousem'r,5153,4,15,9,12,56,47,9,54
Clyde,5153,5,15,9,12,52,48,4,54
Elgin,5153,6,15,6,15,54,60,-6,51
Annan Athlet,5153,7,11,11,14,48,43,5,44
Berwick,5153,8,8,10,18,29,59,-30,34
Edinburgh Ci,5153,9,7,9,20,37,62,-25,30
Cowdenbeath,5153,10,5,10,21,25,55,-30,25
Montrose,5154,1,24,7,5,61,34,27,79
Peterhead,5154,2,23,5,8,78,39,39,74
Stirling,5154,3,16,7,13,64,55,9,55
Stenhousem'r,5154,4,15,9,12,59,50,9,54
Clyde,5154,5,15,9,12,53,48,5,54
Elgin,5154,6,14,6,16,53,62,-9,48
Annan Athlet,5154,7,11,12,13,47,41,6,45
Berwick,5154,8,8,10,18,29,60,-31,34
Edinburgh Ci,5154,9,7,10,19,37,61,-24,31
Cowdenbeath,5154,10,4,11,21,23,54,-31,23
Montrose,5155,1,24,7,5,61,34,27,79
Peterhead,5155,2,24,4,8,79,38,41,76
Stenhousem'r,5155,3,16,8,12,57,46,11,56
Stirling,5155,4,16,6,14,60,53,7,54
Clyde,5155,5,14,9,13,51,50,1,51
Elgin,5155,6,14,6,16,53,62,-9,48
Annan Athlet,5155,7,11,11,14,48,43,5,44
Berwick,5155,8,9,10,17,31,58,-27,37
Edinburgh Ci,5155,9,7,9,20,36,62,-26,30
Cowdenbeath,5155,10,5,10,21,25,55,-30,25
Montrose,5156,1,23,8,5,60,35,25,77
Peterhead,5156,2,23,5,8,79,40,39,74
Stirling,5156,3,17,6,13,63,51,12,57
Stenhousem'r,5156,4,15,8,13,55,49,6,53
Clyde,5156,5,14,10,12,52,49,3,52
Elgin,5156,6,14,7,15,54,61,-7,49
Annan Athlet,5156,7,11,11,14,48,43,5,44
Berwick,5156,8,8,11,17,30,59,-29,35
Edinburgh Ci,5156,9,7,10,19,38,62,-24,31
Cowdenbeath,5156,10,5,10,21,25,55,-30,25
Montrose,5157,1,24,7,5,65,34,31,79
Peterhead,5157,2,24,4,8,82,40,42,76
Stirling,5157,3,17,6,13,63,53,10,57
Stenhousem'r,5157,4,15,8,13,57,49,8,53
Clyde,5157,5,14,10,12,51,48,3,52
Elgin,5157,6,14,6,16,53,66,-13,48
Annan Athlet,5157,7,12,11,13,48,41,7,47
Berwick,5157,8,8,11,17,29,58,-29,35
Edinburgh Ci,5157,9,7,9,20,38,65,-27,30
Cowdenbeath,5157,10,4,10,22,23,55,-32,22
Peterhead,5158,1,24,4,8,78,38,40,76
Montrose,5158,2,23,7,6,59,35,24,76
Stirling,5158,3,17,6,13,62,52,10,57
Stenhousem'r,5158,4,15,8,13,56,48,8,53
Clyde,5158,5,14,9,13,53,51,2,51
Elgin,5158,6,15,6,15,54,60,-6,51
Annan Athlet,5158,7,12,11,13,50,42,8,47
Berwick,5158,8,9,10,17,32,60,-28,37
Edinburgh Ci,5158,9,7,9,20,36,61,-25,30
Cowdenbeath,5158,10,4,10,22,24,57,-33,22
Peterhead,5159,1,24,4,8,81,38,43,76
Montrose,5159,2,23,7,6,61,37,24,76
Stenhousem'r,5159,3,16,8,12,56,46,10,56
Stirling,5159,4,16,6,14,60,52,8,54
Clyde,5159,5,15,9,12,53,48,5,54
Elgin,5159,6,15,6,15,56,62,-6,51
Annan Athlet,5159,7,12,11,13,49,41,8,47
Berwick,5159,8,8,10,18,29,60,-31,34
Edinburgh Ci,5159,9,7,9,20,36,64,-28,30
Cowdenbeath,5159,10,4,10,22,23,56,-33,22
Peterhead,5160,1,24,4,8,81,38,43,76
Montrose,5160,2,23,7,6,59,36,23,76
Stirling,5160,3,17,6,13,62,51,11,57
Clyde,5160,4,15,9,12,53,49,4,54
Stenhousem'r,5160,5,15,8,13,55,48,7,53
Elgin,5160,6,15,6,15,55,60,-5,51
Annan Athlet,5160,7,12,11,13,50,43,7,47
Berwick,5160,8,8,10,18,30,60,-30,34
Edinburgh Ci,5160,9,7,9,20,36,64,-28,30
Cowdenbeath,5160,10,4,10,22,25,57,-32,22
Peterhead,5161,1,24,4,8,83,38,45,76
Montrose,5161,2,23,7,6,60,37,23,76
Stirling,5161,3,17,6,13,63,51,12,57
Stenhousem'r,5161,4,15,8,13,55,49,6,53
Clyde,5161,5,14,10,12,51,48,3,52
Elgin,5161,6,15,6,15,56,61,-5,51
Annan Athlet,5161,7,11,12,13,49,43,6,45
Berwick,5161,8,8,11,17,29,58,-29,35
Edinburgh Ci,5161,9,7,9,20,36,66,-30,30
Cowdenbeath,5161,10,4,11,21,25,56,-31,23
Montrose,5162,1,24,7,5,62,36,26,79
Peterhead,5162,2,23,4,9,77,39,38,73
Stirling,5162,3,16,7,13,61,52,9,55
Stenhousem'r,5162,4,15,9,12,56,47,9,54
Clyde,5162,5,14,10,12,52,49,3,52
Elgin,5162,6,14,6,16,55,63,-8,48
Annan Athlet,5162,7,12,11,13,49,41,8,47
Berwick,5162,8,8,11,17,30,59,-29,35
Edinburgh Ci,5162,9,8,9,19,37,60,-23,33
Cowdenbeath,5162,10,4,10,22,23,56,-33,22
Montrose,5163,1,24,7,5,61,35,26,79
Peterhead,5163,2,24,4,8,80,39,41,76
Stirling,5163,3,17,6,13,63,51,12,57
Stenhousem'r,5163,4,15,8,13,55,49,6,53
Clyde,5163,5,14,9,13,51,49,2,51
Elgin,5163,6,14,6,16,54,62,-8,48
Annan Athlet,5163,7,11,11,14,47,42,5,44
Berwick,5163,8,9,10,17,30,58,-28,37
Edinburgh Ci,5163,9,7,9,20,37,63,-26,30
Cowdenbeath,5163,10,5,10,21,24,54,-30,25
Montrose,5164,1,23,8,5,61,36,25,77
Peterhead,5164,2,23,4,9,78,41,37,73
Stenhousem'r,5164,3,16,8,12,56,46,10,56
Stirling,5164,4,16,6,14,60,52,8,54
Clyde,5164,5,15,9,12,53,48,5,54
Elgin,5164,6,14,7,15,55,62,-7,49
Annan Athlet,5164,7,12,11,13,48,41,7,47
Berwick,5164,8,8,10,18,29,60,-31,34
Edinburgh Ci,5164,9,8,9,19,39,61,-22,33
Cowdenbeath,5164,10,4,10,22,23,55,-32,22
Montrose,5165,1,24,7,5,61,34,27,79
Peterhead,5165,2,24,4,8,83,39,44,76
Stirling,5165,3,17,6,13,63,52,11,57
Clyde,5165,4,15,9,12,53,49,4,54
Stenhousem'r,5165,5,15,8,13,56,49,7,53
Elgin,5165,6,14,6,16,53,62,-9,48
Annan Athlet,5165,7,11,11,14,47,42,5,44
Berwick,5165,8,8,10,18,30,60,-30,34
Edinburgh Ci,5165,9,7,9,20,37,66,-29,30
Cowdenbeath,5165,10,5,10,21,24,54,-30,25
Montrose,5166,1,24,7,5,62,36,26,79
Peterhead,5166,2,24,4,8,83,41,42,76
Stenhousem'r,5166,3,16,8,12,56,46,10,56
Stirling,5166,4,16,6,14,60,52,8,54
Clyde,5166,5,15,9,12,53,48,5,54
Elgin,5166,6,14,6,16,55,63,-8,48
Annan Athlet,5166,7,11,12,13,48,42,6,45
Berwick,5166,8,8,10,18,29,60,-31,34
Edinburgh Ci,5166,9,7,9,20,39,66,-27,30
Cowdenbeath,5166,10,4,11,21,24,55,-31,23
Montrose,5167,1,24,7,5,62,35,27,79
Peterhead,5167,2,24,4,8,79,39,40,76
Stirling,5167,3,17,6,13,61,51,10,57
Stenhousem'r,5167,4,15,8,13,55,47,8,53
Clyde,5167,5,14,10,12,51,48,3,52
Elgin,5167,6,14,6,16,54,63,-9,48
Annan Athlet,5167,7,11,11,14,47,43,4,44
Berwick,5167,8,8,11,17,29,58,-29,35
Edinburgh Ci,5167,9,7,9,20,37,62,-25,30
Cowdenbeath,5167,10,5,10,21,25,54,-29,25
Montrose,5168,1,24,7,5,63,35,28,79
Peterhead,5168,2,23,4,9,77,39,38,73
Stirling,5168,3,17,6,13,64,52,12,57
Clyde,5168,4,15,9,12,54,49,5,54
Stenhousem'r,5168,5,15,8,13,56,50,6,53
Elgin,5168,6,14,6,16,54,64,-10,48
Annan Athlet,5168,7,11,12,13,47,41,6,45
Berwick,5168,8,8,10,18,30,61,-31,34
Edinburgh Ci,5168,9,8,9,19,37,60,-23,33
Cowdenbeath,5168,10,4,11,21,23,54,-31,23
Montrose,5169,1,24,7,5,60,34,26,79
Peterhead,5169,2,24,4,8,81,38,43,76
Stenhousem'r,5169,3,16,8,12,57,47,10,56
Stirling,5169,4,16,6,14,61,53,8,54
Clyde,5169,5,15,9,12,54,50,4,54
Elgin,5169,6,14,6,16,53,61,-8,48
Annan Athlet,5169,7,11,12,13,47,41,6,45
Berwick,5169,8,8,10,18,31,61,-30,34
Edinburgh Ci,5169,9,7,9,20,36,64,-28,30
Cowdenbeath,5169,10,4,11,21,23,54,-31,23
Montrose,5170,1,24,7,5,61,34,27,79
Peterhead,5170,2,23,5,8,77,38,39,74
Stirling,5170,3,16,7,13,61,52,9,55
Stenhousem'r,5170,4,15,9,12,56,47,9,54
Clyde,5170,5,15,9,12,52,48,4,54
Elgin,5170,6,14,6,16,53,62,-9,48
Annan Athlet,5170,7,12,11,13,49,42,7,47
Berwick,5170,8,8,10,18,29,59,-30,34
Edinburgh Ci,5170,9,7,10,19,36,60,-24,31
Cowdenbeath,5170,10,4,10,22,24,56,-32,22
Montrose,5171,1,23,8,5,60,35,25,77
Peterhead,5171,2,24,4,8,81,38,43,76
Stenhousem'r,5171,3,16,8,12,57,47,10,56
Stirling,5171,4,16,6,14,61,53,8,54
Clyde,5171,5,14,10,12,53,50,3,52
Elgin,5171,6,14,7,15,54,61,-7,49
Annan Athlet,5171,7,11,11,14,47,43,4,44
Berwick,5171,8,8,11,17,31,60,-29,35
Edinburgh Ci,5171,9,7,9,20,36,64,-28,30
Cowdenbeath,5171,10,5,10,21,25,54,-29,25
Montrose,5172,1,24,7,5,63,35,28,79
Peterhead,5172,2,24,4,8,80,39,41,76
Stirling,5172,3,17,6,13,62,51,11,57
Stenhousem'r,5172,4,15,8,13,55,48,7,53
Clyde,5172,5,14,9,13,52,50,2,51
Elgin,5172,6,14,6,16,54,64,-10,48
Annan Athlet,5172,7,12,11,13,48,41,7,47
Berwick,5172,8,9,10,17,31,59,-28,37
Edinburgh Ci,5172,9,7,9,20,37,63,-26,30
Cowdenbeath,5172,10,4,10,22,23,55,-32,22
Montrose,5173,1,24,7,5,60,34,26,79
Peterhead,5173,2,24,4,8,78,38,40,76
Stirling,5173,3,16,7,13,61,52,9,55
Clyde,5173,4,15,9,12,59,48,11,54
Stenhousem'r,5173,5,15,9,12,56,47,9,54
Elgin,5173,6,14,6,16,53,61,-8,48
Annan Athlet,5173,7,12,11,13,49,41,8,47
Berwick,5173,8,8,10,18,29,66,-37,34
Edinburgh Ci,5173,9,7,9,20,36,61,-25,30
Cowdenbeath,5173,10,4,10,22,23,56,-33,22
Montrose,5174,1,23,8,5,59,34,25,77
Peterhead,5174,2,23,5,8,79,40,39,74
Stirling,5174,3,17,6,13,63,52,11,57
Stenhousem'r,5174,4,15,8,13,56,49,7,53
Clyde,5174,5,14,10,12,53,50,3,52
Elgin,5174,6,14,7,15,53,60,-7,49
Annan Athlet,5174,7,11,11,14,47,44,3,44
Berwick,5174,8,8,11,17,31,60,-29,35
Edinburgh Ci,5174,9,7,10,19,38,62,-24,31
Cowdenbeath,5174,10,5,10,21,26,54,-28,25
Montrose,5175,1,23,8,5,59,34,25,77
Peterhead,5175,2,24,4,8,79,39,40,76
Stirling,5175,3,17,6,13,64,54,10,57
Stenhousem'r,5175,4,15,8,13,58,50,8,53
Clyde,5175,5,14,9,13,52,50,2,51
Elgin,5175,6,14,7,15,53,60,-7,49
Annan Athlet,5175,7,11,11,14,48,43,5,44
Berwick,5175,8,9,10,17,31,59,-28,37
Edinburgh Ci,5175,9,7,9,20,37,62,-25,30
Cowdenbeath,5175,10,5,10,21,25,55,-30,25
Montrose,5176,1,24,7,5,61,35,26,79
Peterhead,5176,2,24,4,8,80,39,41,76
Stirling,5176,3,16,7,13,63,54,9,55
Stenhousem'r,5176,4,15,9,12,58,49,9,54
Clyde,5176,5,14,9,13,51,49,2,51
Elgin,5176,6,14,6,16,54,62,-8,48
Annan Athlet,5176,7,11,11,14,47,42,5,44
Berwick,5176,8,9,10,17,30,58,-28,37
Edinburgh Ci,5176,9,7,9,20,37,63,-26,30
Cowdenbeath,5176,10,5,10,21,24,54,-30,25
Montrose,5177,1,23,7,6,60,37,23,76
Peterhead,5177,2,23,5,8,78,39,39,74
Stirling,5177,3,17,6,13,62,51,11,57
Stenhousem'r,5177,4,15,8,13,55,48,7,53
Clyde,5177,5,14,10,12,52,49,3,52
Elgin,5177,6,15,6,15,56,61,-5,51
Annan Athlet,5177,7,11,12,13,48,42,6,45
Berwick,5177,8,8,11,17,30,59,-29,35
Edinburgh Ci,5177,9,7,10,19,37,61,-24,31
Cowdenbeath,5177,10,4,11,21,24,55,-31,23
Montrose,5178,1,24,7,5,61,35,26,79
Peterhead,5178,2,23,4,9,78,40,38,73
Stenhousem'r,5178,3,16,8,12,56,46,10,56
Stirling,5178,4,16,6,14,60,52,8,54
Clyde,5178,5,15,9,12,54,48,6,54
Elgin,5178,6,14,6,16,54,62,-8,48
Annan Athlet,5178,7,12,11,13,50,42,8,47
Berwick,5178,8,8,10,18,29,61,-32,34
Edinburgh Ci,5178,9,8,9,19,38,61,-23,33
Cowdenbeath,5178,10,4,10,22,24,57,-33,22
Montrose,5179,1,23,8,5,60,35,25,77
Peterhead,5179,2,24,4,8,80,38,42,76
Stirling,5179,3,16,7,13,61,52,9,55
Stenhousem'r,5179,4,15,9,12,56,47,9,54
Clyde,5179,5,15,9,12,53,48,5,54
Elgin,5179,6,14,7,15,54,61,-7,49
Annan Athlet,5179,7,11,12,13,47,41,6,45
Berwick,5179,8,8,10,18,29,60,-31,34
Edinburgh Ci,5179,9,7,9,20,36,63,-27,30
Cowdenbeath,5179,10,4,11,21,23,54,-31,23
Montrose,5180,1,24,7,5,62,34,28,79
Peterhead,5180,2,23,5,8,78,39,39,74
Stirling,5180,3,17,6,13,64,51,13,57
Stenhousem'r,5180,4,15,8,13,55,50,5,53
Clyde,5180,5,14,9,13,52,50,2,51
Elgin,5180,6,14,6,16,53,63,-10,48
Annan Athlet,5180,7,12,11,13,48,41,7,47
Berwick,5180,8,9,10,17,31,59,-28,37
Edinburgh Ci,5180,9,7,10,19,37,61,-24,31
Cowdenbeath,5180,10,4,10,22,23,55,-32,22
Peterhead,5181,1,24,4,8,80,39,41,76
Montrose,5181,2,23,7,6,60,36,24,76
Stenhousem'r,5181,3,16,8,12,57,46,11,56
Clyde,5181,4,15,9,12,57,48,9,54
Stirling,5181,5,16,6,14,60,53,7,54
Elgin,5181,6,15,6,15,55,61,-6,51
Annan Athlet,5181,7,12,11,13,51,42,9,47
Berwick,5181,8,8,10,18,29,64,-35,34
Edinburgh Ci,5181,9,7,9,20,37,63,-26,30
Cowdenbeath,5181,10,4,10,22,24,58,-34,22
Montrose,5182,1,24,7,5,60,34,26,79
Peterhead,5182,2,24,4,8,80,39,41,76
Stirling,5182,3,16,7,13,61,52,9,55
Stenhousem'r,5182,4,15,9,12,56,47,9,54
Clyde,5182,5,15,9,12,54,49,5,54
Elgin,5182,6,14,6,16,53,61,-8,48
Annan Athlet,5182,7,11,12,13,49,43,6,45
Berwick,5182,8,8,10,18,30,61,-31,34
Edinburgh Ci,5182,9,7,9,20,37,63,-26,30
Cowdenbeath,5182,10,4,11,21,25,56,-31,23
Montrose,5183,1,24,7,5,62,34,28,79
Peterhead,5183,2,24,4,8,79,38,41,76
Stenhousem'r,5183,3,16,8,12,57,47,10,56
Stirling,5183,4,16,6,14,61,53,8,54
Clyde,5183,5,15,9,12,55,48,7,54
Elgin,5183,6,14,6,16,53,63,-10,48
Annan Athlet,5183,7,11,12,13,48,42,6,45
Berwick,5183,8,8,10,18,29,62,-33,34
Edinburgh Ci,5183,9,7,9,20,36,62,-26,30
Cowdenbeath,5183,10,4,11,21,24,55,-31,23
Peterhead,5184,1,24,4,8,83,39,44,76
Montrose,5184,2,23,7,6,62,38,24,76
Stirling,5184,3,16,7,13,62,53,9,55
Stenhousem'r,5184,4,15,9,12,57,48,9,54
Clyde,5184,5,14,10,12,51,48,3,52
Elgin,5184,6,15,6,15,57,63,-6,51
Annan Athlet,5184,7,11,11,14,47,42,5,44
Berwick,5184,8,8,11,17,29,58,-29,35
Edinburgh Ci,5184,9,7,9,20,37,66,-29,30
Cowdenbeath,5184,10,5,10,21,24,54,-30,25
Montrose,5185,1,24,7,5,61,34,27,79
Peterhead,5185,2,24,4,8,80,38,42,76
Stirling,5185,3,16,7,13,63,54,9,55
Stenhousem'r,5185,4,15,9,12,58,49,9,54
Clyde,5185,5,15,9,12,52,48,4,54
Elgin,5185,6,14,6,16,53,62,-9,48
Annan Athlet,5185,7,11,11,14,47,43,4,44
Berwick,5185,8,8,10,18,29,59,-30,34
Edinburgh Ci,5185,9,7,9,20,36,63,-27,30
Cowdenbeath,5185,10,5,10,21,25,54,-29,25
Peterhead,5186,1,24,4,8,79,39,40,76
Montrose,5186,2,23,7,6,60,36,24,76
Stenhousem'r,5186,3,16,8,12,57,47,10,56
Stirling,5186,4,16,6,14,61,53,8,54
Clyde,5186,5,14,9,13,51,49,2,51
Elgin,5186,6,15,6,15,55,61,-6,51
Annan Athlet,5186,7,11,12,13,47,41,6,45
Berwick,5186,8,9,10,17,30,58,-28,37
Edinburgh Ci,5186,9,7,9,20,37,62,-25,30
Cowdenbeath,5186,10,4,11,21,23,54,-31,23
Montrose,5187,1,24,7,5,62,35,27,79
Peterhead,5187,2,24,4,8,81,39,42,76
Stirling,5187,3,16,7,13,61,52,9,55
Stenhousem'r,5187,4,15,9,12,56,47,9,54
Clyde,5187,5,15,9,12,56,49,7,54
Elgin,5187,6,14,6,16,54,63,-9,48
Annan Athlet,5187,7,12,11,13,49,42,7,47
Berwick,5187,8,8,10,18,30,63,-33,34
Edinburgh Ci,5187,9,7,9,20,37,64,-27,30
Cowdenbeath,5187,10,4,10,22,24,56,-32,22
Montrose,5188,1,24,7,5,61,35,26,79
Peterhead,5188,2,24,4,8,82,38,44,76
Stenhousem'r,5188,3,16,8,12,56,46,10,56
Stirling,5188,4,16,6,14,60,52,8,54
Clyde,5188,5,15,9,12,54,49,5,54
Elgin,5188,6,14,6,16,54,62,-8,48
Annan Athlet,5188,7,11,12,13,48,42,6,45
Berwick,5188,8,8,10,18,30,61,-31,34
Edinburgh Ci,5188,9,7,9,20,36,65,-29,30
Cowdenbeath,5188,10,4,11,21,24,55,-31,23
Peterhead,5189,1,24,4,8,82,38,44,76
Montrose,5189,2,23,7,6,59,35,24,76
Stirling,5189,3,17,6,13,61,51,10,57
Clyde,5189,4,15,9,12,54,50,4,54
Stenhousem'r,5189,5,15,8,13,55,47,8,53
Elgin,5189,6,15,6,15,54,60,-6,51
Annan Athlet,5189,7,11,11,14,47,43,4,44
Berwick,5189,8,8,10,18,31,61,-30,34
Edinburgh Ci,5189,9,7,9,20,36,65,-29,30
Cowdenbeath,5189,10,5,10,21,25,54,-29,25
Montrose,5190,1,23,8,5,60,35,25,77
Peterhead,5190,2,24,4,8,78,38,40,76
Stenhousem'r,5190,3,16,8,12,59,47,12,56
Stirling,5190,4,16,6,14,61,55,6,54
Clyde,5190,5,15,9,12,52,48,4,54
Elgin,5190,6,14,7,15,54,61,-7,49
Annan Athlet,5190,7,11,11,14,47,43,4,44
Berwick,5190,8,8,10,18,29,59,-30,34
Edinburgh Ci,5190,9,7,9,20,36,61,-25,30
Cowdenbeath,5190,10,5,10,21,25,54,-29,25
Montrose,5191,1,23,8,5,60,35,25,77
Peterhead,5191,2,24,4,8,82,38,44,76
Stirling,5191,3,17,6,13,62,52,10,57
Clyde,5191,4,15,9,12,55,48,7,54
Stenhousem'r,5191,5,15,8,13,56,48,8,53
Elgin,5191,6,14,7,15,54,61,-7,49
Annan Athlet,5191,7,11,11,14,47,43,4,44
Berwick,5191,8,8,10,18,29,62,-33,34
Edinburgh Ci,5191,9,7,9,20,36,65,-29,30
Cowdenbeath,5191,10,5,10,21,25,54,-29,25
Montrose,5192,1,24,7,5,61,35,26,79
Peterhead,5192,2,24,4,8,79,38,41,76
Stirling,5192,3,17,6,13,63,52,11,57
Clyde,5192,4,15,9,12,52,48,4,54
Stenhousem'r,5192,5,15,8,13,56,49,7,53
Elgin,5192,6,14,6,16,54,62,-8,48
Annan Athlet,5192,7,11,12,13,49,43,6,45
Berwick,5192,8,8,10,18,29,59,-30,34
Edinburgh Ci,5192,9,7,9,20,36,62,-26,30
Cowdenbeath,5192,10,4,11,21,25,56,-31,23
Montrose,5193,1,23,8,5,60,35,25,77
Peterhead,5193,2,23,4,9,78,40,38,73
Stirling,5193,3,16,7,13,62,53,9,55
Stenhousem'r,5193,4,15,9,12,57,48,9,54
Clyde,5193,5,15,9,12,54,48,6,54
Elgin,5193,6,14,7,15,54,61,-7,49
Annan Athlet,5193,7,11,11,14,49,44,5,44
Berwick,5193,8,8,10,18,29,61,-32,34
Edinburgh Ci,5193,9,8,9,19,38,61,-23,33
Cowdenbeath,5193,10,5,10,21,26,56,-30,25
Montrose,5194,1,24,7,5,61,35,26,79
Peterhead,5194,2,24,4,8,81,38,43,76
Stenhousem'r,5194,3,16,8,12,59,47,12,56
Stirling,5194,4,16,6,14,61,55,6,54
Clyde,5194,5,14,10,12,51,48,3,52
Elgin,5194,6,14,6,16,54,62,-8,48
Annan Athlet,5194,7,11,11,14,47,44,3,44
Berwick,5194,8,8,11,17,29,58,-29,35
Edinburgh Ci,5194,9,7,9,20,36,64,-28,30
Cowdenbeath,5194,10,5,10,21,26,54,-28,25
Montrose,5195,1,23,8,5,61,36,25,77
Peterhead,5195,2,24,4,8,80,39,41,76
Stirling,5195,3,16,7,13,62,53,9,55
Stenhousem'r,5195,4,15,9,12,57,48,9,54
Clyde,5195,5,14,10,12,51,48,3,52
Elgin,5195,6,14,7,15,55,62,-7,49
Annan Athlet,5195,7,11,12,13,47,41,6,45
Berwick,5195,8,8,11,17,29,58,-29,35
Edinburgh Ci,5195,9,7,9,20,37,63,-26,30
Cowdenbeath,5195,10,4,11,21,23,54,-31,23
Montrose,5196,1,23,8,5,62,37,25,77
Peterhead,5196,2,23,4,9,78,40,38,73
Stirling,5196,3,16,7,13,61,52,9,55
Stenhousem'r,5196,4,15,9,12,56,47,9,54
Clyde,5196,5,15,9,12,54,48,6,54
Elgin,5196,6,14,7,15,56,63,-7,49
Annan Athlet,5196,7,12,11,13,48,41,7,47
Berwick,5196,8,8,10,18,29,61,-32,34
Edinburgh Ci,5196,9,8,9,19,38,61,-23,33
Cowdenbeath,5196,10,4,10,22,23,55,-32,22
Montrose,5197,1,23,8,5,59,34,25,77
Peterhead,5197,2,24,4,8,80,39,41,76
Stenhousem'r,5197,3,16,8,12,59,46,13,56
Stirling,5197,4,16,6,14,60,55,5,54
Clyde,5197,5,15,9,12,54,49,5,54
Elgin,5197,6,14,7,15,53,60,-7,49
Annan Athlet,5197,7,11,12,13,50,44,6,45
Berwick,5197,8,8,10,18,30,61,-31,34
Edinburgh Ci,5197,9,7,9,20,37,63,-26,30
Cowdenbeath,5197,10,4,11,21,26,57,-31,23
Montrose,5198,1,23,8,5,61,36,25,77
Peterhead,5198,2,23,5,8,78,39,39,74
Stirling,5198,3,17,6,13,62,52,10,57
Stenhousem'r,5198,4,15,8,13,56,48,8,53
Clyde,5198,5,14,9,13,52,52,0,51
Elgin,5198,6,14,7,15,55,62,-7,49
Annan Athlet,5198,7,11,11,14,47,42,5,44
Berwick,5198,8,9,10,17,33,59,-26,37
Edinburgh Ci,5198,9,7,10,19,37,61,-24,31
Cowdenbeath,5198,10,5,10,21,24,54,-30,25
Montrose,5199,1,24,7,5,62,35,27,79
Peterhead,5199,2,24,4,8,79,39,40,76
Stirling,5199,3,17,6,13,64,53,11,57
Clyde,5199,4,15,9,12,52,48,4,54
Stenhousem'r,5199,5,15,8,13,57,50,7,53
Elgin,5199,6,14,6,16,54,63,-9,48
Annan Athlet,5199,7,11,11,14,47,44,3,44
Berwick,5199,8,8,10,18,29,59,-30,34
Edinburgh Ci,5199,9,7,9,20,37,62,-25,30
Cowdenbeath,5199,10,5,10,21,26,54,-28,25
Montrose,5200,1,24,7,5,60,34,26,79
Peterhead,5200,2,24,4,8,81,38,43,76
Stenhousem'r,5200,3,16,8,12,60,47,13,56
Stirling,5200,4,16,6,14,61,56,5,54
Clyde,5200,5,14,9,13,51,51,0,51
Elgin,5200,6,14,6,16,53,61,-8,48
Annan Athlet,5200,7,11,11,14,48,45,3,44
Berwick,5200,8,9,10,17,32,58,-26,37
Edinburgh Ci,5200,9,7,9,20,36,64,-28,30
Cowdenbeath,5200,10,5,10,21,27,55,-28,25
Montrose,5201,1,24,7,5,60,34,26,79
Peterhead,5201,2,23,5,8,79,40,39,74
Stirling,5201,3,17,6,13,62,52,10,57
Clyde,5201,4,15,9,12,56,49,7,54
Stenhousem'r,5201,5,15,8,13,56,48,8,53
Elgin,5201,6,14,6,16,53,61,-8,48
Annan Athlet,5201,7,12,11,13,48,41,7,47
Berwick,5201,8,8,10,18,30,63,-33,34
Edinburgh Ci,5201,9,7,10,19,38,62,-24,31
Cowdenbeath,5201,10,4,10,22,23,55,-32,22
Montrose,5202,1,24,7,5,64,36,28,79
Peterhead,5202,2,24,4,8,84,40,44,76
Stirling,5202,3,17,6,13,66,51,15,57
Clyde,5202,4,15,9,12,53,48,5,54
Stenhousem'r,5202,5,15,8,13,55,52,3,53
Elgin,5202,6,14,6,16,55,65,-10,48
Annan Athlet,5202,7,11,12,13,47,41,6,45
Berwick,5202,8,8,10,18,29,60,-31,34
Edinburgh Ci,5202,9,7,9,20,38,67,-29,30
Cowdenbeath,5202,10,4,11,21,23,54,-31,23
Montrose,5203,1,23,8,5,61,36,25,77
Peterhead,5203,2,24,4,8,80,38,42,76
Stirling,5203,3,17,6,13,62,51,11,57
Clyde,5203,4,15,9,12,55,50,5,54
Stenhousem'r,5203,5,15,8,13,55,48,7,53
Elgin,5203,6,14,7,15,55,62,-7,49
Annan Athlet,5203,7,11,11,14,47,42,5,44
Berwick,5203,8,8,10,18,31,62,-31,34
Edinburgh Ci,5203,9,7,9,20,36,63,-27,30
Cowdenbeath,5203,10,5,10,21,24,54,-30,25
Montrose,5204,1,24,7,5,62,35,27,79
Peterhead,5204,2,24,4,8,78,38,40,76
Stenhousem'r,5204,3,16,8,12,60,48,12,56
Stirling,5204,4,16,6,14,62,56,6,54
Clyde,5204,5,15,9,12,53,48,5,54
Elgin,5204,6,14,6,16,54,63,-9,48
Annan Athlet,5204,7,11,12,13,48,42,6,45
Berwick,5204,8,8,10,18,29,60,-31,34
Edinburgh Ci,5204,9,7,9,20,36,61,-25,30
Cowdenbeath,5204,10,4,11,21,24,55,-31,23
Montrose,5205,1,24,7,5,61,34,27,79
Peterhead,5205,2,23,4,9,77,39,38,73
Stirling,5205,3,17,6,13,62,51,11,57
Clyde,5205,4,15,9,12,55,50,5,54
Stenhousem'r,5205,5,15,8,13,55,48,7,53
Elgin,5205,6,14,6,16,53,62,-9,48
Annan Athlet,5205,7,11,12,13,47,41,6,45
Berwick,5205,8,8,10,18,31,62,-31,34
Edinburgh Ci,5205,9,8,9,19,37,60,-23,33
Cowdenbeath,5205,10,4,11,21,23,54,-31,23
Montrose,5206,1,24,7,5,61,34,27,79
Peterhead,5206,2,24,4,8,80,40,40,76
Stenhousem'r,5206,3,16,8,12,57,47,10,56
Stirling,5206,4,16,6,14,61,53,8,54
Clyde,5206,5,15,9,12,52,48,4,54
Elgin,5206,6,14,6,16,53,62,-9,48
Annan Athlet,5206,7,11,12,13,48,42,6,45
Berwick,5206,8,8,10,18,29,59,-30,34
Edinburgh Ci,5206,9,7,9,20,38,63,-25,30
Cowdenbeath,5206,10,4,11,21,24,55,-31,23
Montrose,5207,1,23,8,5,60,35,25,77
Peterhead,5207,2,24,4,8,80,39,41,76
Stirling,5207,3,16,7,13,63,54,9,55
Stenhousem'r,5207,4,15,9,12,58,49,9,54
Clyde,5207,5,14,10,12,52,49,3,52
Elgin,5207,6,14,7,15,54,61,-7,49
Annan Athlet,5207,7,11,11,14,48,43,5,44
Berwick,5207,8,8,11,17,30,59,-29,35
Edinburgh Ci,5207,9,7,9,20,37,63,-26,30
Cowdenbeath,5207,10,5,10,21,25,55,-30,25
Montrose,5208,1,24,7,5,60,34,26,79
Peterhead,5208,2,24,4,8,79,38,41,76
Stirling,5208,3,16,7,13,60,51,9,55
Stenhousem'r,5208,4,15,9,12,55,46,9,54
Clyde,5208,5,14,10,12,52,49,3,52
Elgin,5208,6,14,6,16,53,61,-8,48
Annan Athlet,5208,7,11,12,13,48,42,6,45
Berwick,5208,8,8,11,17,30,59,-29,35
Edinburgh Ci,5208,9,7,9,20,36,62,-26,30
Cowdenbeath,5208,10,4,11,21,24,55,-31,23
Montrose,5209,1,23,8,5,62,37,25,77
Peterhead,5209,2,23,4,9,77,39,38,73
Stenhousem'r,5209,3,16,8,12,58,47,11,56
Stirling,5209,4,16,6,14,61,54,7,54
Clyde,5209,5,14,10,12,53,50,3,52
Elgin,5209,6,14,7,15,56,63,-7,49
Annan Athlet,5209,7,11,12,13,49,43,6,45
Berwick,5209,8,8,11,17,31,60,-29,35
Edinburgh Ci,5209,9,8,9,19,37,60,-23,33
Cowdenbeath,5209,10,4,11,21,25,56,-31,23
Montrose,5210,1,24,7,5,61,34,27,79
Peterhead,5210,2,23,5,8,79,40,39,74
Stenhousem'r,5210,3,16,8,12,59,48,11,56
Stirling,5210,4,16,6,14,62,55,7,54
Clyde,5210,5,15,9,12,54,48,6,54
Elgin,5210,6,14,6,16,53,62,-9,48
Annan Athlet,5210,7,11,12,13,50,44,6,45
Berwick,5210,8,8,10,18,29,61,-32,34
Edinburgh Ci,5210,9,7,10,19,38,62,-24,31
Cowdenbeath,5210,10,4,11,21,26,57,-31,23
Montrose,5211,1,23,8,5,60,35,25,77
Peterhead,5211,2,23,4,9,77,39,38,73
Stirling,5211,3,17,6,13,63,51,12,57
Clyde,5211,4,15,9,12,54,48,6,54
Stenhousem'r,5211,5,15,8,13,55,49,6,53
Elgin,5211,6,14,7,15,54,61,-7,49
Annan Athlet,5211,7,11,11,14,47,44,3,44
Berwick,5211,8,8,10,18,29,61,-32,34
Edinburgh Ci,5211,9,8,9,19,37,60,-23,33
Cowdenbeath,5211,10,5,10,21,26,54,-28,25
Montrose,5212,1,24,7,5,62,36,26,79
Peterhead,5212,2,23,5,8,79,40,39,74
Stirling,5212,3,17,6,13,64,54,10,57
Clyde,5212,4,15,9,12,54,48,6,54
Stenhousem'r,5212,5,15,8,13,58,50,8,53
Elgin,5212,6,14,6,16,55,63,-8,48
Annan Athlet,5212,7,12,11,13,48,41,7,47
Berwick,5212,8,8,10,18,29,61,-32,34
Edinburgh Ci,5212,9,7,10,19,38,62,-24,31
Cowdenbeath,5212,10,4,10,22,23,55,-32,22
Montrose,5213,1,23,8,5,60,35,25,77
Peterhead,5213,2,24,4,8,79,39,40,76
Stirling,5213,3,17,6,13,64,52,12,57
Clyde,5213,4,15,9,12,55,51,4,54
Stenhousem'r,5213,5,15,8,13,56,50,6,53
Elgin,5213,6,14,7,15,54,61,-7,49
Annan Athlet,5213,7,11,12,13,47,41,6,45
Berwick,5213,8,8,10,18,32,62,-30,34
Edinburgh Ci,5213,9,7,9,20,37,62,-25,30
Cowdenbeath,5213,10,4,11,21,23,54,-31,23
Montrose,5214,1,24,7,5,61,35,26,79
Peterhead,5214,2,24,4,8,79,38,41,76
Stirling,5214,3,16,7,13,60,51,9,55
Stenhousem'r,5214,4,15,9,12,55,46,9,54
Clyde,5214,5,14,9,13,51,49,2,51
Elgin,5214,6,14,6,16,54,62,-8,48
Annan Athlet,5214,7,12,11,13,49,42,7,47
Berwick,5214,8,9,10,17,30,58,-28,37
Edinburgh Ci,5214,9,7,9,20,36,62,-26,30
Cowdenbeath,5214,10,4,10,22,24,56,-32,22
Montrose,5215,1,23,8,5,60,35,25,77
Peterhead,5215,2,23,5,8,79,40,39,74
Stirling,5215,3,17,6,13,63,53,10,57
Stenhousem'r,5215,4,15,8,13,57,49,8,53
Clyde,5215,5,14,9,13,51,49,2,51
Elgin,5215,6,14,7,15,54,61,-7,49
Annan Athlet,5215,7,12,11,13,50,43,7,47
Berwick,5215,8,9,10,17,30,58,-28,37
Edinburgh Ci,5215,9,7,10,19,38,62,-24,31
Cowdenbeath,5215,10,4,10,22,25,57,-32,22
Peterhead,5216,1,24,4,8,78,38,40,76
Montrose,5216,2,23,7,6,61,38,23,76
Stirling,5216,3,17,6,13,64,52,12,57
Stenhousem'r,5216,4,15,8,13,56,50,6,53
Clyde,5216,5,14,9,13,51,51,0,51
Elgin,5216,6,15,6,15,57,62,-5,51
Annan Athlet,5216,7,11,12,13,47,41,6,45
Berwick,5216,8,9,10,17,32,58,-26,37
Edinburgh Ci,5216,9,7,9,20,36,61,-25,30
Cowdenbeath,5216,10,4,11,21,23,54,-31,23
Montrose,5217,1,24,7,5,60,34,26,79
Peterhead,5217,2,23,5,8,78,39,39,74
Stirling,5217,3,16,7,13,62,53,9,55
Stenhousem'r,5217,4,15,9,12,57,48,9,54
Clyde,5217,5,15,9,12,52,48,4,54
Elgin,5217,6,14,6,16,53,61,-8,48
Annan Athlet,5217,7,12,11,13,49,41,8,47
Berwick,5217,8,8,10,18,29,59,-30,34
Edinburgh Ci,5217,9,7,10,19,37,61,-24,31
Cowdenbeath,5217,10,4,10,22,23,56,-33,22
Montrose,5218,1,24,7,5,62,35,27,79
Peterhead,5218,2,24,4,8,84,39,45,76
Stirling,5218,3,17,6,13,62,52,10,57
Stenhousem'r,5218,4,15,8,13,56,48,8,53
Clyde,5218,5,14,10,12,52,49,3,52
Elgin,5218,6,14,6,16,54,63,-9,48
Annan Athlet,5218,7,11,12,13,48,42,6,45
Berwick,5218,8,8,11,17,30,59,-29,35
Edinburgh Ci,5218,9,7,9,20,37,67,-30,30
Cowdenbeath,5218,10,4,11,21,24,55,-31,23
Peterhead,5219,1,24,4,8,80,39,41,76
Montrose,5219,2,23,7,6,61,38,23,76
Stirling,5219,3,17,6,13,64,52,12,57
Stenhousem'r,5219,4,15,8,13,56,50,6,53
Clyde,5219,5,14,10,12,51,48,3,52
Elgin,5219,6,15,6,15,57,62,-5,51
Annan Athlet,5219,7,11,11,14,47,42,5,44
Berwick,5219,8,8,11,17,29,58,-29,35
Edinburgh Ci,5219,9,7,9,20,37,63,-26,30
Cowdenbeath,5219,10,5,10,21,24,54,-30,25
Montrose,5220,1,24,7,5,61,34,27,79
Peterhead,5220,2,24,4,8,81,40,41,76
Stirling,5220,3,16,7,13,61,52,9,55
Stenhousem'r,5220,4,15,9,12,56,47,9,54
Clyde,5220,5,14,10,12,52,49,3,52
Elgin,5220,6,14,6,16,53,62,-9,48
Annan Athlet,5220,7,12,11,13,50,42,8,47
Berwick,5220,8,8,11,17,30,59,-29,35
Edinburgh Ci,5220,9,7,9,20,38,64,-26,30
Cowdenbeath,5220,10,4,10,22,24,57,-33,22
Montrose,5221,1,24,7,5,64,34,30,79
Peterhead,5221,2,24,4,8,81,38,43,76
Stirling,5221,3,16,7,13,61,52,9,55
Stenhousem'r,5221,4,15,9,12,56,47,9,54
Clyde,5221,5,14,10,12,53,50,3,52
Elgin,5221,6,14,6,16,53,65,-12,48
Annan Athlet,5221,7,11,11,14,48,43,5,44
Berwick,5221,8,8,11,17,31,60,-29,35
Edinburgh Ci,5221,9,7,9,20,36,64,-28,30
Cowdenbeath,5221,10,5,10,21,25,55,-30,25
Montrose,5222,1,24,7,5,62,35,27,79
Peterhead,5222,2,23,5,8,79,40,39,74
Stenhousem'r,5222,3,16,8,12,57,47,10,56
Stirling,5222,4,16,6,14,61,53,8,54
Clyde,5222,5,14,10,12,51,48,3,52
Elgin,5222,6,14,6,16,54,63,-9,48
Annan Athlet,5222,7,12,11,13,49,42,7,47
Berwick,5222,8,8,11,17,29,58,-29,35
Edinburgh Ci,5222,9,7,10,19,38,62,-24,31
Cowdenbeath,5222,10,4,10,22,24,56,-32,22
Montrose,5223,1,24,7,5,61,34,27,79
Peterhead,5223,2,24,4,8,82,38,44,76
Stirling,5223,3,17,6,13,63,52,11,57
Stenhousem'r,5223,4,15,8,13,56,49,7,53
Clyde,5223,5,14,10,12,52,49,3,52
Elgin,5223,6,14,6,16,53,62,-9,48
Annan Athlet,5223,7,12,11,13,49,41,8,47
Berwick,5223,8,8,11,17,30,59,-29,35
Edinburgh Ci,5223,9,7,9,20,36,65,-29,30
Cowdenbeath,5223,10,4,10,22,23,56,-33,22
Montrose,5224,1,23,8,5,61,36,25,77
Peterhead,5224,2,24,4,8,79,38,41,76
Stirling,5224,3,16,7,13,61,52,9,55
Stenhousem'r,5224,4,15,9,12,56,47,9,54
Clyde,5224,5,15,9,12,54,49,5,54
Elgin,5224,6,14,7,15,55,62,-7,49
Annan Athlet,5224,7,12,11,13,48,41,7,47
Berwick,5224,8,8,10,18,30,61,-31,34
Edinburgh Ci,5224,9,7,9,20,36,62,-26,30
Cowdenbeath,5224,10,4,10,22,23,55,-32,22
Montrose,5225,1,24,7,5,62,35,27,79
Peterhead,5225,2,24,4,8,81,39,42,76
Stenhousem'r,5225,3,16,8,12,56,46,10,56
Stirling,5225,4,16,6,14,60,52,8,54
Clyde,5225,5,14,9,13,51,50,1,51
Elgin,5225,6,14,6,16,54,63,-9,48
Annan Athlet,5225,7,12,11,13,49,42,7,47
Berwick,5225,8,9,10,17,31,58,-27,37
Edinburgh Ci,5225,9,7,9,20,37,64,-27,30
Cowdenbeath,5225,10,4,10,22,24,56,-32,22
Montrose,5226,1,24,7,5,62,36,26,79
Peterhead,5226,2,23,5,8,77,38,39,74
Stirling,5226,3,16,7,13,60,51,9,55
Stenhousem'r,5226,4,15,9,12,55,46,9,54
Clyde,5226,5,15,9,12,53,49,4,54
Elgin,5226,6,14,6,16,55,63,-8,48
Annan Athlet,5226,7,11,11,14,49,45,4,44
Berwick,5226,8,8,10,18,30,60,-30,34
Edinburgh Ci,5226,9,7,10,19,36,60,-24,31
Cowdenbeath,5226,10,5,10,21,27,56,-29,25
Montrose,5227,1,24,7,5,61,34,27,79
Peterhead,5227,2,23,5,8,78,39,39,74
Stirling,5227,3,17,6,13,64,53,11,57
Clyde,5227,4,15,9,12,54,50,4,54
Stenhousem'r,5227,5,15,8,13,57,50,7,53
Elgin,5227,6,14,6,16,53,62,-9,48
Annan Athlet,5227,7,11,12,13,48,42,6,45
Berwick,5227,8,8,10,18,31,61,-30,34
Edinburgh Ci,5227,9,7,10,19,37,61,-24,31
Cowdenbeath,5227,10,4,11,21,24,55,-31,23
Montrose,5228,1,24,7,5,62,35,27,79
Peterhead,5228,2,24,4,8,81,38,43,76
Stenhousem'r,5228,3,16,8,12,57,46,11,56
Stirling,5228,4,16,6,14,60,53,7,54
Clyde,5228,5,15,9,12,53,49,4,54
Elgin,5228,6,14,6,16,54,63,-9,48
Annan Athlet,5228,7,11,11,14,47,42,5,44
Berwick,5228,8,8,10,18,30,60,-30,34
Edinburgh Ci,5228,9,7,9,20,36,64,-28,30
Cowdenbeath,5228,10,5,10,21,24,54,-30,25
Peterhead,5229,1,24,4,8,78,38,40,76
Montrose,5229,2,23,7,6,60,36,24,76
Stenhousem'r,5229,3,16,8,12,56,46,10,56
Stirling,5229,4,16,6,14,60,52,8,54
Clyde,5229,5,14,10,12,53,50,3,52
Elgin,5229,6,15,6,15,55,61,-6,51
Annan Athlet,5229,7,11,11,14,48,43,5,44
Berwick,5229,8,8,11,17,31,60,-29,35
Edinburgh Ci,5229,9,7,9,20,36,61,-25,30
Cowdenbeath,5229,10,5,10,21,25,55,-30,25
Montrose,5230,1,24,7,5,60,34,26,79
Peterhead,5230,2,23,4,9,77,40,37,73
Stirling,5230,3,16,7,13,63,54,9,55
Stenhousem'r,5230,4,15,9,12,58,49,9,54
Clyde,5230,5,15,9,12,52,48,4,54
Elgin,5230,6,14,6,16,53,61,-8,48
Annan Athlet,5230,7,11,11,14,47,42,5,44
Berwick,5230,8,8,10,18,29,59,-30,34
Edinburgh Ci,5230,9,8,9,19,38,60,-22,33
Cowdenbeath,5230,10,5,10,21,24,54,-30,25
Montrose,5231,1,24,7,5,60,34,26,79
Peterhead,5231,2,24,4,8,85,39,46,76
Stenhousem'r,5231,3,16,8,12,58,47,11,56
Stirling,5231,4,16,6,14,61,54,7,54
Clyde,5231,5,14,10,12,53,50,3,52
Elgin,5231,6,14,6,16,53,61,-8,48
Annan Athlet,5231,7,11,11,14,48,45,3,44
Berwick,5231,8,8,11,17,31,60,-29,35
Edinburgh Ci,5231,9,7,9,20,37,68,-31,30
Cowdenbeath,5231,10,5,10,21,27,55,-28,25
Montrose,5232,1,24,7,5,64,36,28,79
Peterhead,5232,2,23,5,8,78,39,39,74
Stenhousem'r,5232,3,16,8,12,59,48,11,56
Stirling,5232,4,16,6,14,62,55,7,54
Clyde,5232,5,14,10,12,52,49,3,52
Elgin,5232,6,14,6,16,55,65,-10,48
Annan Athlet,5232,7,12,11,13,48,41,7,47
Berwick,5232,8,8,11,17,30,59,-29,35
Edinburgh Ci,5232,9,7,10,19,37,61,-24,31
Cowdenbeath,5232,10,4,10,22,23,55,-32,22
Peterhead,5233,1,24,4,8,81,38,43,76
Montrose,5233,2,23,7,6,59,36,23,76
Stirling,5233,3,17,6,13,62,52,10,57
Stenhousem'r,5233,4,15,8,13,56,48,8,53
Clyde,5233,5,14,10,12,54,51,3,52
Elgin,5233,6,15,6,15,55,60,-5,51
Annan Athlet,5233,7,11,11,14,47,42,5,44
Berwick,5233,8,8,11,17,32,61,-29,35
Edinburgh Ci,5233,9,7,9,20,36,64,-28,30
Cowdenbeath,5233,10,5,10,21,24,54,-30,25
Montrose,5234,1,24,7,5,61,35,26,79
Peterhead,5234,2,24,4,8,79,39,40,76
Stirling,5234,3,16,7,13,61,52,9,55
Stenhousem'r,5234,4,15,9,12,56,47,9,54
Clyde,5234,5,15,9,12,52,48,4,54
Elgin,5234,6,14,6,16,54,62,-8,48
Annan Athlet,5234,7,12,11,13,49,42,7,47
Berwick,5234,8,8,10,18,29,59,-30,34
Edinburgh Ci,5234,9,7,9,20,37,62,-25,30
Cowdenbeath,5234,10,4,10,22,24,56,-32,22
Montrose,5235,1,23,8,5,59,34,25,77
Peterhead,5235,2,23,4,9,77,39,38,73
Stenhousem'r,5235,3,16,8,12,56,46,10,56
Stirling,5235,4,16,6,14,60,52,8,54
Clyde,5235,5,15,9,12,52,48,4,54
Elgin,5235,6,14,7,15,53,60,-7,49
Annan Athlet,5235,7,11,12,13,47,41,6,45
Berwick,5235,8,8,10,18,29,59,-30,34
Edinburgh Ci,5235,9,8,9,19,37,60,-23,33
Cowdenbeath,5235,10,4,11,21,23,54,-31,23
Montrose,5236,1,24,7,5,61,35,26,79
Peterhead,5236,2,24,4,8,81,41,40,76
Stirling,5236,3,16,7,13,62,53,9,55
Stenhousem'r,5236,4,15,9,12,57,48,9,54
Clyde,5236,5,15,9,12,52,48,4,54
Elgin,5236,6,14,6,16,54,62,-8,48
Annan Athlet,5236,7,11,12,13,48,42,6,45
Berwick,5236,8,8,10,18,29,59,-30,34
Edinburgh Ci,5236,9,7,9,20,39,64,-25,30
Cowdenbeath,5236,10,4,11,21,24,55,-31,23
Peterhead,5237,1,24,4,8,79,38,41,76
Montrose,5237,2,23,7,6,59,35,24,76
Stenhousem'r,5237,3,16,8,12,58,48,10,56
Stirling,5237,4,16,6,14,62,54,8,54
Clyde,5237,5,14,10,12,52,49,3,52
Elgin,5237,6,15,6,15,54,60,-6,51
Annan Athlet,5237,7,11,11,14,47,43,4,44
Berwick,5237,8,8,11,17,30,59,-29,35
Edinburgh Ci,5237,9,7,9,20,36,62,-26,30
Cowdenbeath,5237,10,5,10,21,25,54,-29,25
Montrose,5238,1,24,7,5,63,34,29,79
Peterhead,5238,2,23,5,8,79,40,39,74
Stenhousem'r,5238,3,16,8,12,58,47,11,56
Stirling,5238,4,16,6,14,61,54,7,54
Clyde,5238,5,15,9,12,54,49,5,54
Elgin,5238,6,14,6,16,53,64,-11,48
Annan Athlet,5238,7,11,12,13,47,41,6,45
Berwick,5238,8,8,10,18,30,61,-31,34
Edinburgh Ci,5238,9,7,10,19,38,62,-24,31
Cowdenbeath,5238,10,4,11,21,23,54,-31,23
Montrose,5239,1,24,7,5,61,35,26,79
Peterhead,5239,2,23,5,8,79,40,39,74
Stirling,5239,3,16,7,13,61,52,9,55
Stenhousem'r,5239,4,15,9,12,56,47,9,54
Clyde,5239,5,14,9,13,54,52,2,51
Elgin,5239,6,14,6,16,54,62,-8,48
Annan Athlet,5239,7,11,12,13,49,43,6,45
Berwick,5239,8,9,10,17,33,61,-28,37
Edinburgh Ci,5239,9,7,10,19,38,62,-24,31
Cowdenbeath,5239,10,4,11,21,25,56,-31,23
Peterhead,5240,1,24,4,8,79,39,40,76
Montrose,5240,2,23,7,6,59,36,23,76
Stirling,5240,3,17,6,13,62,51,11,57
Clyde,5240,4,15,9,12,54,48,6,54
Stenhousem'r,5240,5,15,8,13,55,48,7,53
Elgin,5240,6,15,6,15,55,60,-5,51
Annan Athlet,5240,7,12,11,13,49,41,8,47
Berwick,5240,8,8,10,18,29,61,-32,34
Edinburgh Ci,5240,9,7,9,20,37,62,-25,30
Cowdenbeath,5240,10,4,10,22,23,56,-33,22
Montrose,5241,1,23,8,5,62,37,25,77
Peterhead,5241,2,24,4,8,80,38,42,76
Stenhousem'r,5241,3,16,8,12,56,46,10,56
Stirling,5241,4,16,6,14,60,52,8,54
Clyde,5241,5,15,9,12,52,48,4,54
Elgin,5241,6,14,7,15,56,63,-7,49
Annan Athlet,5241,7,12,11,13,48,41,7,47
Berwick,5241,8,8,10,18,29,59,-30,34
Edinburgh Ci,5241,9,7,9,20,36,63,-27,30
Cowdenbeath,5241,10,4,10,22,23,55,-32,22
Montrose,5242,1,24,7,5,60,34,26,79
Peterhead,5242,2,24,4,8,80,38,42,76
Stirling,5242,3,16,7,13,60,51,9,55
Stenhousem'r,5242,4,15,9,12,55,46,9,54
Clyde,5242,5,15,9,12,52,48,4,54
Elgin,5242,6,14,6,16,53,61,-8,48
Annan Athlet,5242,7,11,12,13,48,42,6,45
Berwick,5242,8,8,10,18,29,59,-30,34
Edinburgh Ci,5242,9,7,9,20,36,63,-27,30
Cowdenbeath,5242,10,4,11,21,24,55,-31,23
Montrose,5243,1,24,7,5,60,34,26,79
Peterhead,5243,2,24,4,8,79,38,41,76
Stirling,5243,3,17,6,13,63,51,12,57
Stenhousem'r,5243,4,15,8,13,55,49,6,53
Clyde,5243,5,14,10,12,54,51,3,52
Elgin,5243,6,14,6,16,53,61,-8,48
Annan Athlet,5243,7,12,11,13,49,41,8,47
Berwick,5243,8,8,11,17,32,61,-29,35
Edinburgh Ci,5243,9,7,9,20,36,62,-26,30
Cowdenbeath,5243,10,4,10,22,23,56,-33,22
Montrose,5244,1,23,8,5,59,34,25,77
Peterhead,5244,2,23,4,9,78,40,38,73
Stenhousem'r,5244,3,16,8,12,56,46,10,56
Stirling,5244,4,16,6,14,60,52,8,54
Clyde,5244,5,14,9,13,51,49,2,51
Elgin,5244,6,14,7,15,53,60,-7,49
Annan Athlet,5244,7,11,12,13,47,41,6,45
Berwick,5244,8,9,10,17,30,58,-28,37
Edinburgh Ci,5244,9,8,9,19,38,61,-23,33
Cowdenbeath,5244,10,4,11,21,23,54,-31,23
Montrose,5245,1,24,7,5,64,35,29,79
Peterhead,5245,2,23,4,9,77,39,38,73
Stirling,5245,3,17,6,13,62,52,10,57
Clyde,5245,4,15,9,12,52,48,4,54
Stenhousem'r,5245,5,15,8,13,56,48,8,53
Elgin,5245,6,14,6,16,54,65,-11,48
Annan Athlet,5245,7,12,11,13,49,41,8,47
Berwick,5245,8,8,10,18,29,59,-30,34
Edinburgh Ci,5245,9,8,9,19,37,60,-23,33
Cowdenbeath,5245,10,4,10,22,23,56,-33,22
Montrose,5246,1,23,7,6,59,36,23,76
Peterhead,5246,2,23,5,8,79,40,39,74
Stirling,5246,3,16,7,13,61,52,9,55
Stenhousem'r,5246,4,15,9,12,56,47,9,54
Clyde,5246,5,14,10,12,51,48,3,52
Elgin,5246,6,15,6,15,55,60,-5,51
Annan Athlet,5246,7,12,11,13,48,41,7,47
Berwick,5246,8,8,11,17,29,58,-29,35
Edinburgh Ci,5246,9,7,10,19,38,62,-24,31
Cowdenbeath,5246,10,4,10,22,23,55,-32,22
Montrose,5247,1,24,7,5,63,35,28,79
Peterhead,5247,2,23,4,9,78,40,38,73
Stirling,5247,3,16,7,13,60,51,9,55
Stenhousem'r,5247,4,15,9,12,55,46,9,54
Clyde,5247,5,14,9,13,51,51,0,51
Elgin,5247,6,14,6,16,54,64,-10,48
Annan Athlet,5247,7,11,11,14,47,42,5,44
Berwick,5247,8,9,10,17,32,58,-26,37
Edinburgh Ci,5247,9,8,9,19,38,61,-23,33
Cowdenbeath,5247,10,5,10,21,24,54,-30,25
Montrose,5248,1,24,7,5,63,35,28,79
Peterhead,5248,2,23,5,8,78,39,39,74
Stirling,5248,3,17,6,13,61,51,10,57
Clyde,5248,4,15,9,12,53,48,5,54
Stenhousem'r,5248,5,15,8,13,55,47,8,53
Elgin,5248,6,14,6,16,54,64,-10,48
Annan Athlet,5248,7,12,11,13,51,42,9,47
Berwick,5248,8,8,10,18,29,60,-31,34
Edinburgh Ci,5248,9,7,10,19,37,61,-24,31
Cowdenbeath,5248,10,4,10,22,24,58,-34,22
Peterhead,5249,1,24,4,8,80,39,41,76
Montrose,5249,2,23,7,6,59,37,22,76
Stirling,5249,3,17,6,13,65,51,14,57
Stenhousem'r,5249,4,15,8,13,55,51,4,53
Clyde,5249,5,14,10,12,53,50,3,52
Elgin,5249,6,15,6,15,56,60,-4,51
Annan Athlet,5249,7,11,11,14,47,43,4,44
Berwick,5249,8,8,11,17,31,60,-29,35
Edinburgh Ci,5249,9,7,9,20,37,63,-26,30
Cowdenbeath,5249,10,5,10,21,25,54,-29,25
Montrose,5250,1,24,7,5,62,35,27,79
Peterhead,5250,2,24,4,8,80,38,42,76
Stirling,5250,3,16,7,13,64,55,9,55
Stenhousem'r,5250,4,15,9,12,59,50,9,54
Clyde,5250,5,14,9,13,51,49,2,51
Elgin,5250,6,14,6,16,54,63,-9,48
Annan Athlet,5250,7,12,11,13,50,43,7,47
Berwick,5250,8,9,10,17,30,58,-28,37
Edinburgh Ci,5250,9,7,9,20,36,63,-27,30
Cowdenbeath,5250,10,4,10,22,25,57,-32,22
Peterhead,5251,1,24,4,8,85,38,47,76
Montrose,5251,2,23,7,6,59,35,24,76
Stirling,5251,3,16,7,13,60,51,9,55
Stenhousem'r,5251,4,15,9,12,55,46,9,54
Clyde,5251,5,15,9,12,52,48,4,54
Elgin,5251,6,15,6,15,54,60,-6,51
Annan Athlet,5251,7,11,12,13,47,41,6,45
Berwick,5251,8,8,10,18,29,59,-30,34
Edinburgh Ci,5251,9,7,9,20,36,68,-32,30
Cowdenbeath,5251,10,4,11,21,23,54,-31,23
Peterhead,5252,1,24,4,8,79,39,40,76
Montrose,5252,2,23,7,6,59,35,24,76
Stenhousem'r,5252,3,16,8,12,59,47,12,56
Stirling,5252,4,16,6,14,61,55,6,54
Clyde,5252,5,14,9,13,51,49,2,51
Elgin,5252,6,15,6,15,54,60,-6,51
Annan Athlet,5252,7,12,11,13,48,41,7,47
Berwick,5252,8,9,10,17,30,58,-28,37
Edinburgh Ci,5252,9,7,9,20,37,62,-25,30
Cowdenbeath,5252,10,4,10,22,23,55,-32,22
Peterhead,5253,1,24,4,8,83,39,44,76
Montrose,5253,2,23,7,6,59,36,23,76
Stirling,5253,3,17,6,13,62,51,11,57
Clyde,5253,4,15,9,12,55,49,6,54
Stenhousem'r,5253,5,15,8,13,55,48,7,53
Elgin,5253,6,15,6,15,55,60,-5,51
Annan Athlet,5253,7,11,11,14,47,42,5,44
Berwick,5253,8,8,10,18,30,62,-32,34
Edinburgh Ci,5253,9,7,9,20,37,66,-29,30
Cowdenbeath,5253,10,5,10,21,24,54,-30,25
Montrose,5254,1,23,7,6,59,36,23,76
Peterhead,5254,2,23,5,8,79,40,39,74
Stirling,5254,3,17,6,13,63,52,11,57
Stenhousem'r,5254,4,15,8,13,56,49,7,53
Clyde,5254,5,14,10,12,52,49,3,52
Elgin,5254,6,15,6,15,55,60,-5,51
Annan Athlet,5254,7,12,11,13,49,41,8,47
Berwick,5254,8,8,11,17,30,59,-29,35
Edinburgh Ci,5254,9,7,10,19,38,62,-24,31
Cowdenbeath,5254,10,4,10,22,23,56,-33,22
Peterhead,5255,1,24,4,8,78,38,40,76
Montrose,5255,2,23,7,6,60,37,23,76
Stirling,5255,3,17,6,13,63,53,10,57
Stenhousem'r,5255,4,15,8,13,57,49,8,53
Clyde,5255,5,14,9,13,51,50,1,51
Elgin,5255,6,15,6,15,56,61,-5,51
Annan Athlet,5255,7,12,11,13,51,42,9,47
Berwick,5255,8,9,10,17,31,58,-27,37
Edinburgh Ci,5255,9,7,9,20,36,61,-25,30
Cowdenbeath,5255,10,4,10,22,24,58,-34,22
Montrose,5256,1,23,8,5,61,36,25,77
Peterhead,5256,2,24,4,8,85,40,45,76
Stirling,5256,3,16,7,13,60,51,9,55
Stenhousem'r,5256,4,15,9,12,55,46,9,54
Clyde,5256,5,14,10,12,51,48,3,52
Elgin,5256,6,14,7,15,55,62,-7,49
Annan Athlet,5256,7,11,11,14,47,44,3,44
Berwick,5256,8,8,11,17,29,58,-29,35
Edinburgh Ci,5256,9,7,9,20,38,68,-30,30
Cowdenbeath,5256,10,5,10,21,26,54,-28,25
Montrose,5257,1,24,7,5,61,34,27,79
Peterhead,5257,2,24,4,8,80,38,42,76
Stirling,5257,3,16,7,13,62,53,9,55
Stenhousem'r,5257,4,15,9,12,57,48,9,54
Clyde,5257,5,15,9,12,52,48,4,54
Elgin,5257,6,14,6,16,53,62,-9,48
Annan Athlet,5257,7,11,11,14,48,45,3,44
Berwick,5257,8,8,10,18,29,59,-30,34
Edinburgh Ci,5257,9,7,9,20,36,63,-27,30
Cowdenbeath,5257,10,5,10,21,27,55,-28,25
Montrose,5258,1,24,7,5,62,34,28,79
Peterhead,5258,2,24,4,8,81,39,42,76
Stirling,5258,3,16,7,13,61,52,9,55
Stenhousem'r,5258,4,15,9,12,56,47,9,54
Clyde,5258,5,15,9,12,52,48,4,54
Elgin,5258,6,14,6,16,53,63,-10,48
Annan Athlet,5258,7,11,12,13,47,41,6,45
Berwick,5258,8,8,10,18,29,59,-30,34
Edinburgh Ci,5258,9,7,9,20,37,64,-27,30
Cowdenbeath,5258,10,4,11,21,23,54,-31,23
Montrose,5259,1,23,7,6,59,37,22,76
Peterhead,5259,2,23,5,8,77,38,39,74
Stirling,5259,3,17,6,13,64,52,12,57
Stenhousem'r,5259,4,15,8,13,56,50,6,53
Clyde,5259,5,14,9,13,52,50,2,51
Elgin,5259,6,15,6,15,56,60,-4,51
Annan Athlet,5259,7,11,12,13,47,41,6,45
Berwick,5259,8,9,10,17,31,59,-28,37
Edinburgh Ci,5259,9,7,10,19,36,60,-24,31
Cowdenbeath,5259,10,4,11,21,23,54,-31,23
Montrose,5260,1,24,7,5,62,34,28,79
Peterhead,5260,2,24,4,8,82,38,44,76
Stirling,5260,3,17,6,13,66,52,14,57
Clyde,5260,4,15,9,12,53,48,5,54
Stenhousem'r,5260,5,15,8,13,56,52,4,53
Elgin,5260,6,14,6,16,53,63,-10,48
Annan Athlet,5260,7,11,12,13,50,44,6,45
Berwick,5260,8,8,10,18,29,60,-31,34
Edinburgh Ci,5260,9,7,9,20,36,65,-29,30
Cowdenbeath,5260,10,4,11,21,26,57,-31,23
Montrose,5261,1,24,7,5,61,35,26,79
Peterhead,5261,2,24,4,8,81,39,42,76
Stirling,5261,3,17,6,13,62,52,10,57
Stenhousem'r,5261,4,15,8,13,56,48,8,53
Clyde,5261,5,14,10,12,52,49,3,52
Elgin,5261,6,14,6,16,54,62,-8,48
Annan Athlet,5261,7,11,11,14,48,44,4,44
Berwick,5261,8,8,11,17,30,59,-29,35
Edinburgh Ci,5261,9,7,9,20,37,64,-27,30
Cowdenbeath,5261,10,5,10,21,26,55,-29,25
Montrose,5262,1,24,7,5,63,35,28,79
Peterhead,5262,2,24,4,8,79,38,41,76
Stirling,5262,3,17,6,13,61,51,10,57
Stenhousem'r,5262,4,15,8,13,55,47,8,53
Clyde,5262,5,14,9,13,51,49,2,51
Elgin,5262,6,14,6,16,54,64,-10,48
Annan Athlet,5262,7,11,11,14,47,43,4,44
Berwick,5262,8,9,10,17,30,58,-28,37
Edinburgh Ci,5262,9,7,9,20,36,62,-26,30
Cowdenbeath,5262,10,5,10,21,25,54,-29,25
Montrose,5263,1,23,8,5,59,34,25,77
Peterhead,5263,2,24,4,8,79,38,41,76
Stirling,5263,3,17,6,13,62,52,10,57
Clyde,5263,4,15,9,12,52,48,4,54
Stenhousem'r,5263,5,15,8,13,56,48,8,53
Elgin,5263,6,14,7,15,53,60,-7,49
Annan Athlet,5263,7,12,11,13,48,41,7,47
Berwick,5263,8,8,10,18,29,59,-30,34
Edinburgh Ci,5263,9,7,9,20,36,62,-26,30
Cowdenbeath,5263,10,4,10,22,23,55,-32,22
Montrose,5264,1,24,7,5,61,35,26,79
Peterhead,5264,2,23,4,9,77,40,37,73
Stirling,5264,3,17,6,13,61,51,10,57
Clyde,5264,4,15,9,12,55,50,5,54
Stenhousem'r,5264,5,15,8,13,55,47,8,53
Elgin,5264,6,14,6,16,54,62,-8,48
Annan Athlet,5264,7,11,12,13,47,41,6,45
Berwick,5264,8,8,10,18,31,62,-31,34
Edinburgh Ci,5264,9,8,9,19,38,60,-22,33
Cowdenbeath,5264,10,4,11,21,23,54,-31,23
Peterhead,5265,1,24,4,8,80,38,42,76
Montrose,5265,2,23,7,6,61,37,24,76
Stenhousem'r,5265,3,16,8,12,57,47,10,56
Stirling,5265,4,16,6,14,61,53,8,54
Clyde,5265,5,15,9,12,53,48,5,54
Elgin,5265,6,15,6,15,56,62,-6,51
Annan Athlet,5265,7,11,11,14,47,43,4,44
Berwick,5265,8,8,10,18,29,60,-31,34
Edinburgh Ci,5265,9,7,9,20,36,63,-27,30
Cowdenbeath,5265,10,5,10,21,25,54,-29,25
Montrose,5266,1,24,7,5,63,36,27,79
Peterhead,5266,2,23,4,9,77,39,38,73
Stirling,5266,3,17,6,13,63,51,12,57
Clyde,5266,4,15,9,12,53,48,5,54
Stenhousem'r,5266,5,15,8,13,55,49,6,53
Elgin,5266,6,14,6,16,55,64,-9,48
Annan Athlet,5266,7,12,11,13,50,41,9,47
Berwick,5266,8,8,10,18,29,60,-31,34
Edinburgh Ci,5266,9,8,9,19,37,60,-23,33
Cowdenbeath,5266,10,4,10,22,23,57,-34,22
Montrose,5267,1,24,7,5,63,36,27,79
Peterhead,5267,2,24,4,8,84,41,43,76
Stirling,5267,3,16,7,13,61,52,9,55
Stenhousem'r,5267,4,15,9,12,56,47,9,54
Clyde,5267,5,14,10,12,52,49,3,52
Elgin,5267,6,14,6,16,55,64,-9,48
Annan Athlet,5267,7,11,11,14,47,43,4,44
Berwick,5267,8,8,11,17,30,59,-29,35
Edinburgh Ci,5267,9,7,9,20,39,67,-28,30
Cowdenbeath,5267,10,5,10,21,25,54,-29,25
Montrose,5268,1,23,8,5,61,36,25,77
Peterhead,5268,2,24,4,8,81,38,43,76
Stirling,5268,3,17,6,13,62,51,11,57
Stenhousem'r,5268,4,15,8,13,55,48,7,53
Clyde,5268,5,14,9,13,51,50,1,51
Elgin,5268,6,14,7,15,55,62,-7,49
Annan Athlet,5268,7,11,11,14,47,42,5,44
Berwick,5268,8,9,10,17,31,58,-27,37
Edinburgh Ci,5268,9,7,9,20,36,64,-28,30
Cowdenbeath,5268,10,5,10,21,24,54,-30,25
Peterhead,5269,1,24,4,8,81,38,43,76
Montrose,5269,2,23,7,6,60,37,23,76
Stirling,5269,3,16,7,13,61,52,9,55
Stenhousem'r,5269,4,15,9,12,56,47,9,54
Clyde,5269,5,15,9,12,53,48,5,54
Elgin,5269,6,15,6,15,56,61,-5,51
Annan Athlet,5269,7,11,11,14,47,43,4,44
Berwick,5269,8,8,10,18,29,60,-31,34
Edinburgh Ci,5269,9,7,9,20,36,64,-28,30
Cowdenbeath,5269,10,5,10,21,25,54,-29,25
Montrose,5270,1,24,7,5,64,36,28,79
Peterhead,5270,2,24,4,8,81,39,42,76
Stenhousem'r,5270,3,16,8,12,57,46,11,56
Stirling,5270,4,16,6,14,60,53,7,54
Clyde,5270,5,15,9,12,53,48,5,54
Elgin,5270,6,14,6,16,55,65,-10,48
Annan Athlet,5270,7,12,11,13,51,42,9,47
Berwick,5270,8,8,10,18,29,60,-31,34
Edinburgh Ci,5270,9,7,9,20,37,64,-27,30
Cowdenbeath,5270,10,4,10,22,24,58,-34,22
Montrose,5271,1,24,7,5,63,35,28,79
Peterhead,5271,2,24,4,8,81,39,42,76
Stirling,5271,3,16,7,13,63,54,9,55
Stenhousem'r,5271,4,15,9,12,58,49,9,54
Clyde,5271,5,15,9,12,52,48,4,54
Elgin,5271,6,14,6,16,54,64,-10,48
Annan Athlet,5271,7,11,12,13,49,43,6,45
Berwick,5271,8,8,10,18,29,59,-30,34
Edinburgh Ci,5271,9,7,9,20,37,64,-27,30
Cowdenbeath,5271,10,4,11,21,25,56,-31,23
Montrose,5272,1,24,7,5,61,35,26,79
Peterhead,5272,2,23,4,9,78,40,38,73
Stirling,5272,3,16,7,13,60,51,9,55
Stenhousem'r,5272,4,15,9,12,55,46,9,54
Clyde,5272,5,15,9,12,53,48,5,54
Elgin,5272,6,14,6,16,54,62,-8,48
Annan Athlet,5272,7,11,11,14,47,45,2,44
Berwick,5272,8,8,10,18,29,60,-31,34
Edinburgh Ci,5272,9,8,9,19,38,61,-23,33
Cowdenbeath,5272,10,5,10,21,27,54,-27,25
Montrose,5273,1,24,7,5,64,34,30,79
Peterhead,5273,2,24,4,8,78,38,40,76
Stirling,5273,3,17,6,13,62,51,11,57
Stenhousem'r,5273,4,15,8,13,55,48,7,53
Clyde,5273,5,14,10,12,52,49,3,52
Elgin,5273,6,14,6,16,53,65,-12,48
Annan Athlet,5273,7,11,12,13,49,43,6,45
Berwick,5273,8,8,11,17,30,59,-29,35
Edinburgh Ci,5273,9,7,9,20,36,61,-25,30
Cowdenbeath,5273,10,4,11,21,25,56,-31,23
Montrose,5274,1,23,8,5,60,35,25,77
Peterhead,5274,2,23,5,8,78,39,39,74
Stirling,5274,3,17,6,13,62,51,11,57
Clyde,5274,4,15,9,12,54,48,6,54
Stenhousem'r,5274,5,15,8,13,55,48,7,53
Elgin,5274,6,14,7,15,54,61,-7,49
Annan Athlet,5274,7,12,11,13,51,44,7,47
Berwick,5274,8,8,10,18,29,61,-32,34
Edinburgh Ci,5274,9,7,10,19,37,61,-24,31
Cowdenbeath,5274,10,4,10,22,26,58,-32,22
Montrose,5275,1,23,8,5,59,34,25,77
Peterhead,5275,2,24,4,8,79,39,40,76
Stirling,5275,3,16,7,13,61,52,9,55
Stenhousem'r,5275,4,15,9,12,56,47,9,54
Clyde,5275,5,14,10,12,51,48,3,52
Elgin,5275,6,14,7,15,53,60,-7,49
Annan Athlet,5275,7,12,11,13,48,41,7,47
Berwick,5275,8,8,11,17,29,58,-29,35
Edinburgh Ci,5275,9,7,9,20,37,62,-25,30
Cowdenbeath,5275,10,4,10,22,23,55,-32,22
Montrose,5276,1,23,8,5,60,35,25,77
Peterhead,5276,2,24,4,8,79,39,40,76
Stenhousem'r,5276,3,16,8,12,56,46,10,56
Stirling,5276,4,16,6,14,60,52,8,54
Clyde,5276,5,14,9,13,53,52,1,51
Elgin,5276,6,14,7,15,54,61,-7,49
Annan Athlet,5276,7,11,12,13,47,41,6,45
Berwick,5276,8,9,10,17,33,60,-27,37
Edinburgh Ci,5276,9,7,9,20,37,62,-25,30
Cowdenbeath,5276,10,4,11,21,23,54,-31,23
Montrose,5277,1,23,8,5,60,35,25,77
Peterhead,5277,2,24,4,8,80,38,42,76
Stirling,5277,3,16,7,13,62,53,9,55
Stenhousem'r,5277,4,15,9,12,57,48,9,54
Clyde,5277,5,15,9,12,53,48,5,54
Elgin,5277,6,14,7,15,54,61,-7,49
Annan Athlet,5277,7,12,11,13,49,41,8,47
Berwick,5277,8,8,10,18,29,60,-31,34
Edinburgh Ci,5277,9,7,9,20,36,63,-27,30
Cowdenbeath,5277,10,4,10,22,23,56,-33,22
Montrose,5278,1,24,7,5,62,34,28,79
Peterhead,5278,2,24,4,8,78,38,40,76
Stenhousem'r,5278,3,16,8,12,59,49,10,56
Stirling,5278,4,16,6,14,63,55,8,54
Clyde,5278,5,14,10,12,52,49,3,52
Elgin,5278,6,14,6,16,53,63,-10,48
Annan Athlet,5278,7,12,11,13,50,41,9,47
Berwick,5278,8,8,11,17,30,59,-29,35
Edinburgh Ci,5278,9,7,9,20,36,61,-25,30
Cowdenbeath,5278,10,4,10,22,23,57,-34,22
Montrose,5279,1,24,7,5,62,35,27,79
Peterhead,5279,2,24,4,8,80,38,42,76
Stirling,5279,3,16,7,13,61,52,9,55
Stenhousem'r,5279,4,15,9,12,56,47,9,54
Clyde,5279,5,15,9,12,53,49,4,54
Elgin,5279,6,14,6,16,54,63,-9,48
Annan Athlet,5279,7,11,12,13,49,43,6,45
Berwick,5279,8,8,10,18,30,60,-30,34
Edinburgh Ci,5279,9,7,9,20,36,63,-27,30
Cowdenbeath,5279,10,4,11,21,25,56,-31,23
Montrose,5280,1,24,7,5,61,34,27,79
Peterhead,5280,2,24,4,8,82,40,42,76
Stenhousem'r,5280,3,16,8,12,57,46,11,56
Stirling,5280,4,16,6,14,60,53,7,54
Clyde,5280,5,14,9,13,52,50,2,51
Elgin,5280,6,14,6,16,53,62,-9,48
Annan Athlet,5280,7,12,11,13,50,41,9,47
Berwick,5280,8,9,10,17,31,59,-28,37
Edinburgh Ci,5280,9,7,9,20,38,65,-27,30
Cowdenbeath,5280,10,4,10,22,23,57,-34,22
Montrose,5281,1,24,7,5,63,36,27,79
Peterhead,5281,2,24,4,8,82,38,44,76
Stenhousem'r,5281,3,16,8,12,56,46,10,56
Stirling,5281,4,16,6,14,60,52,8,54
Clyde,5281,5,15,9,12,54,49,5,54
Elgin,5281,6,14,6,16,55,64,-9,48
Annan Athlet,5281,7,11,11,14,48,43,5,44
Berwick,5281,8,8,10,18,30,61,-31,34
Edinburgh Ci,5281,9,7,9,20,36,65,-29,30
Cowdenbeath,5281,10,5,10,21,25,55,-30,25
Peterhead,5282,1,24,4,8,81,39,42,76
Montrose,5282,2,23,7,6,60,37,23,76
Stirling,5282,3,17,6,13,63,52,11,57
Stenhousem'r,5282,4,15,8,13,56,49,7,53
Clyde,5282,5,14,10,12,51,48,3,52
Elgin,5282,6,15,6,15,56,61,-5,51
Annan Athlet,5282,7,12,11,13,50,41,9,47
Berwick,5282,8,8,11,17,29,58,-29,35
Edinburgh Ci,5282,9,7,9,20,37,64,-27,30
Cowdenbeath,5282,10,4,10,22,23,57,-34,22
Peterhead,5283,1,24,4,8,80,38,42,76
Montrose,5283,2,23,7,6,62,39,23,76
Stirling,5283,3,17,6,13,64,52,12,57
Stenhousem'r,5283,4,15,8,13,56,50,6,53
Clyde,5283,5,14,10,12,52,49,3,52
Elgin,5283,6,15,6,15,58,63,-5,51
Annan Athlet,5283,7,12,11,13,49,42,7,47
Berwick,5283,8,8,11,17,30,59,-29,35
Edinburgh Ci,5283,9,7,9,20,36,63,-27,30
Cowdenbeath,5283,10,4,10,22,24,56,-32,22
Montrose,5284,1,24,7,5,64,37,27,79
Peterhead,5284,2,24,4,8,80,39,41,76
Stirling,5284,3,17,6,13,62,51,11,57
Stenhousem'r,5284,4,15,8,13,55,48,7,53
Clyde,5284,5,14,10,12,54,51,3,52
Elgin,5284,6,14,6,16,56,65,-9,48
Annan Athlet,5284,7,12,11,13,50,42,8,47
Berwick,5284,8,8,11,17,32,61,-29,35
Edinburgh Ci,5284,9,7,9,20,37,63,-26,30
Cowdenbeath,5284,10,4,10,22,24,57,-33,22
Montrose,5285,1,24,7,5,63,34,29,79
Peterhead,5285,2,24,4,8,79,38,41,76
Stirling,5285,3,16,7,13,61,52,9,55
Stenhousem'r,5285,4,15,9,12,56,47,9,54
Clyde,5285,5,14,10,12,53,50,3,52
Elgin,5285,6,14,6,16,53,64,-11,48
Annan Athlet,5285,7,12,11,13,50,41,9,47
Berwick,5285,8,8,11,17,31,60,-29,35
Edinburgh Ci,5285,9,7,9,20,36,62,-26,30
Cowdenbeath,5285,10,4,10,22,23,57,-34,22
Montrose,5286,1,24,7,5,61,34,27,79
Peterhead,5286,2,24,4,8,78,38,40,76
Stenhousem'r,5286,3,16,8,12,56,46,10,56
Stirling,5286,4,16,6,14,60,52,8,54
Clyde,5286,5,15,9,12,54,50,4,54
Elgin,5286,6,14,6,16,53,62,-9,48
Annan Athlet,5286,7,12,11,13,50,41,9,47
Berwick,5286,8,8,10,18,31,61,-30,34
Edinburgh Ci,5286,9,7,9,20,36,61,-25,30
Cowdenbeath,5286,10,4,10,22,23,57,-34,22
Montrose,5287,1,24,7,5,62,36,26,79
Peterhead,5287,2,24,4,8,80,39,41,76
Stirling,5287,3,16,7,13,61,52,9,55
Stenhousem'r,5287,4,15,9,12,56,47,9,54
Clyde,5287,5,15,9,12,53,48,5,54
Elgin,5287,6,14,6,16,55,63,-8,48
Annan Athlet,5287,7,11,11,14,48,43,5,44
Berwick,5287,8,8,10,18,29,60,-31,34
Edinburgh Ci,5287,9,7,9,20,37,63,-26,30
Cowdenbeath,5287,10,5,10,21,25,55,-30,25
Montrose,5288,1,24,7,5,61,35,26,79
Peterhead,5288,2,23,5,8,78,39,39,74
Stirling,5288,3,17,6,13,62,52,10,57
Stenhousem'r,5288,4,15,8,13,56,48,8,53
Clyde,5288,5,14,10,12,52,49,3,52
Elgin,5288,6,14,6,16,54,62,-8,48
Annan Athlet,5288,7,11,11,14,48,43,5,44
Berwick,5288,8,8,11,17,30,59,-29,35
Edinburgh Ci,5288,9,7,10,19,37,61,-24,31
Cowdenbeath,5288,10,5,10,21,25,55,-30,25
Montrose,5289,1,23,7,6,59,36,23,76
Peterhead,5289,2,23,4,9,77,39,38,73
Stenhousem'r,5289,3,16,8,12,58,48,10,56
Stirling,5289,4,16,6,14,62,54,8,54
Clyde,5289,5,15,9,12,53,48,5,54
Elgin,5289,6,15,6,15,55,60,-5,51
Annan Athlet,5289,7,12,11,13,50,41,9,47
Berwick,5289,8,8,10,18,29,60,-31,34
Edinburgh Ci,5289,9,8,9,19,37,60,-23,33
Cowdenbeath,5289,10,4,10,22,23,57,-34,22
Montrose,5290,1,24,7,5,61,34,27,79
Peterhead,5290,2,24,4,8,83,38,45,76
Stirling,5290,3,16,7,13,62,53,9,55
Stenhousem'r,5290,4,15,9,12,57,48,9,54
Clyde,5290,5,15,9,12,54,50,4,54
Elgin,5290,6,14,6,16,53,62,-9,48
Annan Athlet,5290,7,11,12,13,48,42,6,45
Berwick,5290,8,8,10,18,31,61,-30,34
Edinburgh Ci,5290,9,7,9,20,36,66,-30,30
Cowdenbeath,5290,10,4,11,21,24,55,-31,23
Montrose,5291,1,24,7,5,64,34,30,79
Peterhead,5291,2,23,4,9,77,40,37,73
Stirling,5291,3,17,6,13,62,51,11,57
Stenhousem'r,5291,4,15,8,13,55,48,7,53
Clyde,5291,5,14,10,12,52,49,3,52
Elgin,5291,6,14,6,16,53,65,-12,48
Annan Athlet,5291,7,11,12,13,48,42,6,45
Berwick,5291,8,8,11,17,30,59,-29,35
Edinburgh Ci,5291,9,8,9,19,38,60,-22,33
Cowdenbeath,5291,10,4,11,21,24,55,-31,23
Peterhead,5292,1,24,4,8,81,39,42,76
Montrose,5292,2,23,7,6,59,35,24,76
Stirling,5292,3,17,6,13,62,52,10,57
Clyde,5292,4,15,9,12,53,48,5,54
Stenhousem'r,5292,5,15,8,13,56,48,8,53
Elgin,5292,6,15,6,15,54,60,-6,51
Annan Athlet,5292,7,12,11,13,51,41,10,47
Berwick,5292,8,8,10,18,29,60,-31,34
Edinburgh Ci,5292,9,7,9,20,37,64,-27,30
Cowdenbeath,5292,10,4,10,22,23,58,-35,22
Montrose,5293,1,23,8,5,62,37,25,77
Peterhead,5293,2,24,4,8,79,39,40,76
Stirling,5293,3,16,7,13,61,52,9,55
Stenhousem'r,5293,4,15,9,12,56,47,9,54
Clyde,5293,5,15,9,12,53,49,4,54
Elgin,5293,6,14,7,15,56,63,-7,49
Annan Athlet,5293,7,11,12,13,47,41,6,45
Berwick,5293,8,8,10,18,30,60,-30,34
Edinburgh Ci,5293,9,7,9,20,37,62,-25,30
Cowdenbeath,5293,10,4,11,21,23,54,-31,23
Montrose,5294,1,24,7,5,63,35,28,79
Peterhead,5294,2,24,4,8,80,39,41,76
Stenhousem'r,5294,3,16,8,12,57,47,10,56
Stirling,5294,4,16,6,14,61,53,8,54
Clyde,5294,5,14,10,12,52,49,3,52
Elgin,5294,6,14,6,16,54,64,-10,48
Annan Athlet,5294,7,11,12,13,47,41,6,45
Berwick,5294,8,8,11,17,30,59,-29,35
Edinburgh Ci,5294,9,7,9,20,37,63,-26,30
Cowdenbeath,5294,10,4,11,21,23,54,-31,23
Montrose,5295,1,23,8,5,60,35,25,77
Peterhead,5295,2,24,4,8,79,38,41,76
Stenhousem'r,5295,3,16,8,12,57,46,11,56
Stirling,5295,4,16,6,14,60,53,7,54
Clyde,5295,5,15,9,12,52,48,4,54
Elgin,5295,6,14,7,15,54,61,-7,49
Annan Athlet,5295,7,11,11,14,47,42,5,44
Berwick,5295,8,8,10,18,29,59,-30,34
Edinburgh Ci,5295,9,7,9,20,36,62,-26,30
Cowdenbeath,5295,10,5,10,21,24,54,-30,25
Montrose,5296,1,24,7,5,62,35,27,79
Peterhead,5296,2,23,4,9,77,41,36,73
Stenhousem'r,5296,3,16,8,12,58,48,10,56
Stirling,5296,4,16,6,14,62,54,8,54
Clyde,5296,5,14,9,13,51,49,2,51
Elgin,5296,6,14,6,16,54,63,-9,48
Annan Athlet,5296,7,11,12,13,47,41,6,45
Berwick,5296,8,9,10,17,30,58,-28,37
Edinburgh Ci,5296,9,8,9,19,39,60,-21,33
Cowdenbeath,5296,10,4,11,21,23,54,-31,23
Montrose,5297,1,24,7,5,64,34,30,79
Peterhead,5297,2,23,5,8,78,39,39,74
Stenhousem'r,5297,3,16,8,12,58,46,12,56
Clyde,5297,4,15,9,12,57,49,8,54
Stirling,5297,5,16,6,14,60,54,6,54
Elgin,5297,6,14,6,16,53,65,-12,48
Annan Athlet,5297,7,12,11,13,48,41,7,47
Berwick,5297,8,8,10,18,30,64,-34,34
Edinburgh Ci,5297,9,7,10,19,37,61,-24,31
Cowdenbeath,5297,10,4,10,22,23,55,-32,22
Peterhead,5298,1,24,4,8,82,39,43,76
Montrose,5298,2,23,7,6,59,36,23,76
Stenhousem'r,5298,3,16,8,12,60,46,14,56
Stirling,5298,4,16,6,14,60,56,4,54
Clyde,5298,5,15,9,12,52,48,4,54
Elgin,5298,6,15,6,15,55,60,-5,51
Annan Athlet,5298,7,12,11,13,49,42,7,47
Berwick,5298,8,8,10,18,29,59,-30,34
Edinburgh Ci,5298,9,7,9,20,37,65,-28,30
Cowdenbeath,5298,10,4,10,22,24,56,-32,22
Montrose,5299,1,24,7,5,63,36,27,79
Peterhead,5299,2,24,4,8,84,39,45,76
Stirling,5299,3,17,6,13,61,51,10,57
Clyde,5299,4,15,9,12,55,49,6,54
Stenhousem'r,5299,5,15,8,13,55,47,8,53
Elgin,5299,6,14,6,16,55,64,-9,48
Annan Athlet,5299,7,12,11,13,49,42,7,47
Berwick,5299,8,8,10,18,30,62,-32,34
Edinburgh Ci,5299,9,7,9,20,37,67,-30,30
Cowdenbeath,5299,10,4,10,22,24,56,-32,22
Montrose,5300,1,24,7,5,61,34,27,79
Peterhead,5300,2,24,4,8,79,38,41,76
Stenhousem'r,5300,3,16,8,12,57,47,10,56
Stirling,5300,4,16,6,14,61,53,8,54
Clyde,5300,5,14,9,13,52,50,2,51
Elgin,5300,6,14,6,16,53,62,-9,48
Annan Athlet,5300,7,11,12,13,48,42,6,45
Berwick,5300,8,9,10,17,31,59,-28,37
Edinburgh Ci,5300,9,7,9,20,36,62,-26,30
Cowdenbeath,5300,10,4,11,21,24,55,-31,23
Peterhead,5301,1,24,4,8,80,40,40,76
Montrose,5301,2,23,7,6,60,38,22,76
Stenhousem'r,5301,3,16,8,12,58,48,10,56
Stirling,5301,4,16,6,14,62,54,8,54
Clyde,5301,5,15,9,12,52,48,4,54
Elgin,5301,6,15,6,15,57,61,-4,51
Annan Athlet,5301,7,11,12,13,49,43,6,45
Berwick,5301,8,8,10,18,29,59,-30,34
Edinburgh Ci,5301,9,7,9,20,38,63,-25,30
Cowdenbeath,5301,10,4,11,21,25,56,-31,23
Montrose,5302,1,23,8,5,60,35,25,77
Peterhead,5302,2,24,4,8,82,38,44,76
Stenhousem'r,5302,3,16,8,12,57,47,10,56
Stirling,5302,4,16,6,14,61,53,8,54
Clyde,5302,5,14,10,12,53,50,3,52
Elgin,5302,6,14,7,15,54,61,-7,49
Annan Athlet,5302,7,12,11,13,48,41,7,47
Berwick,5302,8,8,11,17,31,60,-29,35
Edinburgh Ci,5302,9,7,9,20,36,65,-29,30
Cowdenbeath,5302,10,4,10,22,23,55,-32,22
Peterhead,5303,1,24,4,8,78,38,40,76
Montrose,5303,2,23,7,6,59,36,23,76
Stirling,5303,3,17,6,13,63,52,11,57
Clyde,5303,4,15,9,12,52,48,4,54
Stenhousem'r,5303,5,15,8,13,56,49,7,53
Elgin,5303,6,15,6,15,55,60,-5,51
Annan Athlet,5303,7,11,11,14,48,44,4,44
Berwick,5303,8,8,10,18,29,59,-30,34
Edinburgh Ci,5303,9,7,9,20,36,61,-25,30
Cowdenbeath,5303,10,5,10,21,26,55,-29,25
Montrose,5304,1,24,7,5,61,34,27,79
Peterhead,5304,2,24,4,8,79,39,40,76
Stirling,5304,3,16,7,13,62,53,9,55
Stenhousem'r,5304,4,15,9,12,57,48,9,54
Clyde,5304,5,15,9,12,54,49,5,54
Elgin,5304,6,14,6,16,53,62,-9,48
Annan Athlet,5304,7,11,12,13,47,41,6,45
Berwick,5304,8,8,10,18,30,61,-31,34
Edinburgh Ci,5304,9,7,9,20,37,62,-25,30
Cowdenbeath,5304,10,4,11,21,23,54,-31,23
Montrose,5305,1,23,7,6,61,37,24,76
Peterhead,5305,2,23,5,8,78,39,39,74
Stenhousem'r,5305,3,16,8,12,58,47,11,56
Stirling,5305,4,16,6,14,61,54,7,54
Clyde,5305,5,15,9,12,52,48,4,54
Elgin,5305,6,15,6,15,56,62,-6,51
Annan Athlet,5305,7,11,11,14,47,42,5,44
Berwick,5305,8,8,10,18,29,59,-30,34
Edinburgh Ci,5305,9,7,10,19,37,61,-24,31
Cowdenbeath,5305,10,5,10,21,24,54,-30,25
Montrose,5306,1,24,7,5,61,34,27,79
Peterhead,5306,2,23,5,8,79,40,39,74
Stenhousem'r,5306,3,16,8,12,58,47,11,56
Stirling,5306,4,16,6,14,61,54,7,54
Clyde,5306,5,15,9,12,52,48,4,54
Elgin,5306,6,14,6,16,53,62,-9,48
Annan Athlet,5306,7,11,12,13,47,41,6,45
Berwick,5306,8,8,10,18,29,59,-30,34
Edinburgh Ci,5306,9,7,10,19,38,62,-24,31
Cowdenbeath,5306,10,4,11,21,23,54,-31,23
Montrose,5307,1,24,7,5,63,34,29,79
Peterhead,5307,2,24,4,8,80,40,40,76
Stirling,5307,3,17,6,13,63,52,11,57
Clyde,5307,4,15,9,12,52,48,4,54
Stenhousem'r,5307,5,15,8,13,56,49,7,53
Elgin,5307,6,14,6,16,53,64,-11,48
Annan Athlet,5307,7,11,12,13,48,42,6,45
Berwick,5307,8,8,10,18,29,59,-30,34
Edinburgh Ci,5307,9,7,9,20,38,63,-25,30
Cowdenbeath,5307,10,4,11,21,24,55,-31,23
Montrose,5308,1,24,7,5,60,34,26,79
Peterhead,5308,2,24,4,8,78,38,40,76
Stirling,5308,3,16,7,13,62,53,9,55
Stenhousem'r,5308,4,15,9,12,57,48,9,54
Clyde,5308,5,14,10,12,51,48,3,52
Elgin,5308,6,14,6,16,53,61,-8,48
Annan Athlet,5308,7,12,11,13,50,41,9,47
Berwick,5308,8,8,11,17,29,58,-29,35
Edinburgh Ci,5308,9,7,9,20,36,61,-25,30
Cowdenbeath,5308,10,4,10,22,23,57,-34,22
Montrose,5309,1,24,7,5,61,34,27,79
Peterhead,5309,2,24,4,8,81,40,41,76
Stirling,5309,3,17,6,13,64,51,13,57
Stenhousem'r,5309,4,15,8,13,55,50,5,53
Clyde,5309,5,14,9,13,51,49,2,51
Elgin,5309,6,14,6,16,53,62,-9,48
Annan Athlet,5309,7,11,11,14,47,42,5,44
Berwick,5309,8,9,10,17,30,58,-28,37
Edinburgh Ci,5309,9,7,9,20,38,64,-26,30
Cowdenbeath,5309,10,5,10,21,24,54,-30,25
Montrose,5310,1,24,7,5,63,35,28,79
Peterhead,5310,2,24,4,8,80,40,40,76
Stirling,5310,3,17,6,13,63,51,12,57
Clyde,5310,4,15,9,12,53,48,5,54
Stenhousem'r,5310,5,15,8,13,55,49,6,53
Elgin,5310,6,14,6,16,54,64,-10,48
Annan Athlet,5310,7,11,12,13,47,41,6,45
Berwick,5310,8,8,10,18,29,60,-31,34
Edinburgh Ci,5310,9,7,9,20,38,63,-25,30
Cowdenbeath,5310,10,4,11,21,23,54,-31,23
Montrose,5311,1,24,7,5,62,36,26,79
Peterhead,5311,2,24,4,8,78,38,40,76
Stirling,5311,3,17,6,13,64,51,13,57
Stenhousem'r,5311,4,15,8,13,55,50,5,53
Clyde,5311,5,14,10,12,51,48,3,52
Elgin,5311,6,14,6,16,55,63,-8,48
Annan Athlet,5311,7,11,12,13,49,43,6,45
Berwick,5311,8,8,11,17,29,58,-29,35
Edinburgh Ci,5311,9,7,9,20,36,61,-25,30
Cowdenbeath,5311,10,4,11,21,25,56,-31,23
Montrose,5312,1,24,7,5,61,35,26,79
Peterhead,5312,2,23,4,9,77,39,38,73
Stenhousem'r,5312,3,16,8,12,57,47,10,56
Stirling,5312,4,16,6,14,61,53,8,54
Clyde,5312,5,14,10,12,53,50,3,52
Elgin,5312,6,14,6,16,54,62,-8,48
Annan Athlet,5312,7,12,11,13,48,41,7,47
Berwick,5312,8,8,11,17,31,60,-29,35
Edinburgh Ci,5312,9,8,9,19,37,60,-23,33
Cowdenbeath,5312,10,4,10,22,23,55,-32,22
Montrose,5313,1,24,7,5,61,35,26,79
Peterhead,5313,2,24,4,8,81,38,43,76
Stirling,5313,3,17,6,13,62,51,11,57
Clyde,5313,4,15,9,12,53,48,5,54
Stenhousem'r,5313,5,15,8,13,55,48,7,53
Elgin,5313,6,14,6,16,54,62,-8,48
Annan Athlet,5313,7,11,11,14,47,42,5,44
Berwick,5313,8,8,10,18,29,60,-31,34
Edinburgh Ci,5313,9,7,9,20,36,64,-28,30
Cowdenbeath,5313,10,5,10,21,24,54,-30,25
Montrose,5314,1,24,7,5,62,36,26,79
Peterhead,5314,2,24,4,8,79,38,41,76
Stenhousem'r,5314,3,16,8,12,57,46,11,56
Stirling,5314,4,16,6,14,60,53,7,54
Clyde,5314,5,15,9,12,52,48,4,54
Elgin,5314,6,14,6,16,55,63,-8,48
Annan Athlet,5314,7,11,12,13,47,41,6,45
Berwick,5314,8,8,10,18,29,59,-30,34
Edinburgh Ci,5314,9,7,9,20,36,62,-26,30
Cowdenbeath,5314,10,4,11,21,23,54,-31,23
Peterhead,5315,1,24,4,8,79,38,41,76
Montrose,5315,2,23,7,6,60,36,24,76
Stirling,5315,3,17,6,13,63,51,12,57
Stenhousem'r,5315,4,15,8,13,55,49,6,53
Clyde,5315,5,14,10,12,51,48,3,52
Elgin,5315,6,15,6,15,55,61,-6,51
Annan Athlet,5315,7,11,11,14,48,43,5,44
Berwick,5315,8,8,11,17,29,58,-29,35
Edinburgh Ci,5315,9,7,9,20,36,62,-26,30
Cowdenbeath,5315,10,5,10,21,25,55,-30,25
Montrose,5316,1,24,7,5,61,35,26,79
Peterhead,5316,2,24,4,8,82,40,42,76
Stirling,5316,3,16,7,13,61,52,9,55
Stenhousem'r,5316,4,15,9,12,56,47,9,54
Clyde,5316,5,15,9,12,54,48,6,54
Elgin,5316,6,14,6,16,54,62,-8,48
Annan Athlet,5316,7,11,11,14,48,43,5,44
Berwick,5316,8,8,10,18,29,61,-32,34
Edinburgh Ci,5316,9,7,9,20,38,65,-27,30
Cowdenbeath,5316,10,5,10,21,25,55,-30,25
Montrose,5317,1,23,8,5,60,35,25,77
Peterhead,5317,2,23,5,8,77,38,39,74
Stirling,5317,3,16,7,13,61,52,9,55
Stenhousem'r,5317,4,15,9,12,56,47,9,54
Clyde,5317,5,14,9,13,51,49,2,51
Elgin,5317,6,14,7,15,54,61,-7,49
Annan Athlet,5317,7,11,12,13,48,42,6,45
Berwick,5317,8,9,10,17,30,58,-28,37
Edinburgh Ci,5317,9,7,10,19,36,60,-24,31
Cowdenbeath,5317,10,4,11,21,24,55,-31,23
Montrose,5318,1,24,7,5,62,35,27,79
Peterhead,5318,2,24,4,8,79,38,41,76
Stenhousem'r,5318,3,16,8,12,57,46,11,56
Stirling,5318,4,16,6,14,60,53,7,54
Clyde,5318,5,15,9,12,54,48,6,54
Elgin,5318,6,14,6,16,54,63,-9,48
Annan Athlet,5318,7,12,11,13,51,41,10,47
Berwick,5318,8,8,10,18,29,61,-32,34
Edinburgh Ci,5318,9,7,9,20,36,62,-26,30
Cowdenbeath,5318,10,4,10,22,23,58,-35,22
Montrose,5319,1,24,7,5,62,36,26,79
Peterhead,5319,2,24,4,8,80,39,41,76
Stenhousem'r,5319,3,16,8,12,56,46,10,56
Stirling,5319,4,16,6,14,60,52,8,54
Clyde,5319,5,15,9,12,52,48,4,54
Elgin,5319,6,14,6,16,55,63,-8,48
Annan Athlet,5319,7,11,12,13,47,41,6,45
Berwick,5319,8,8,10,18,29,59,-30,34
Edinburgh Ci,5319,9,7,9,20,37,63,-26,30
Cowdenbeath,5319,10,4,11,21,23,54,-31,23
Montrose,5320,1,24,7,5,62,34,28,79
Peterhead,5320,2,23,5,8,79,40,39,74
Stirling,5320,3,17,6,13,63,51,12,57
Stenhousem'r,5320,4,15,8,13,55,49,6,53
Clyde,5320,5,14,9,13,52,50,2,51
Elgin,5320,6,14,6,16,53,63,-10,48
Annan Athlet,5320,7,11,12,13,47,41,6,45
Berwick,5320,8,9,10,17,31,59,-28,37
Edinburgh Ci,5320,9,7,10,19,38,62,-24,31
Cowdenbeath,5320,10,4,11,21,23,54,-31,23
Montrose,5321,1,23,8,5,62,37,25,77
Peterhead,5321,2,24,4,8,80,38,42,76
Stirling,5321,3,17,6,13,62,52,10,57
Clyde,5321,4,15,9,12,54,48,6,54
Stenhousem'r,5321,5,15,8,13,56,48,8,53
Elgin,5321,6,14,7,15,56,63,-7,49
Annan Athlet,5321,7,11,12,13,47,41,6,45
Berwick,5321,8,8,10,18,29,61,-32,34
Edinburgh Ci,5321,9,7,9,20,36,63,-27,30
Cowdenbeath,5321,10,4,11,21,23,54,-31,23
Montrose,5322,1,24,7,5,63,35,28,79
Peterhead,5322,2,24,4,8,82,39,43,76
Stirling,5322,3,17,6,13,61,51,10,57
Stenhousem'r,5322,4,15,8,13,55,47,8,53
Clyde,5322,5,14,9,13,51,49,2,51
Elgin,5322,6,14,6,16,54,64,-10,48
Annan Athlet,5322,7,12,11,13,48,41,7,47
Berwick,5322,8,9,10,17,30,58,-28,37
Edinburgh Ci,5322,9,7,9,20,37,65,-28,30
Cowdenbeath,5322,10,4,10,22,23,55,-32,22
Montrose,5323,1,23,8,5,60,35,25,77
Peterhead,5323,2,24,4,8,78,38,40,76
Stenhousem'r,5323,3,16,8,12,59,48,11,56
Stirling,5323,4,16,6,14,62,55,7,54
Clyde,5323,5,14,9,13,52,50,2,51
Elgin,5323,6,14,7,15,54,61,-7,49
Annan Athlet,5323,7,11,11,14,48,44,4,44
Berwick,5323,8,9,10,17,31,59,-28,37
Edinburgh Ci,5323,9,7,9,20,36,61,-25,30
Cowdenbeath,5323,10,5,10,21,26,55,-29,25
Montrose,5324,1,24,7,5,60,34,26,79
Peterhead,5324,2,24,4,8,81,40,41,76
Stirling,5324,3,17,6,13,65,51,14,57
Stenhousem'r,5324,4,15,8,13,55,51,4,53
Clyde,5324,5,14,9,13,52,50,2,51
Elgin,5324,6,14,6,16,53,61,-8,48
Annan Athlet,5324,7,11,11,14,47,42,5,44
Berwick,5324,8,9,10,17,31,59,-28,37
Edinburgh Ci,5324,9,7,9,20,38,64,-26,30
Cowdenbeath,5324,10,5,10,21,24,54,-30,25
Montrose,5325,1,24,7,5,61,34,27,79
Peterhead,5325,2,24,4,8,78,38,40,76
Stirling,5325,3,17,6,13,63,52,11,57
Clyde,5325,4,15,9,12,53,48,5,54
Stenhousem'r,5325,5,15,8,13,56,49,7,53
Elgin,5325,6,14,6,16,53,62,-9,48
Annan Athlet,5325,7,12,11,13,48,41,7,47
Berwick,5325,8,8,10,18,29,60,-31,34
Edinburgh Ci,5325,9,7,9,20,36,61,-25,30
Cowdenbeath,5325,10,4,10,22,23,55,-32,22
Montrose,5326,1,24,7,5,63,36,27,79
Peterhead,5326,2,24,4,8,80,40,40,76
Stirling,5326,3,17,6,13,63,51,12,57
Clyde,5326,4,15,9,12,53,49,4,54
Stenhousem'r,5326,5,15,8,13,55,49,6,53
Elgin,5326,6,14,6,16,55,64,-9,48
Annan Athlet,5326,7,11,11,14,47,42,5,44
Berwick,5326,8,8,10,18,30,60,-30,34
Edinburgh Ci,5326,9,7,9,20,38,63,-25,30
Cowdenbeath,5326,10,5,10,21,24,54,-30,25
Montrose,5327,1,24,7,5,61,34,27,79
Peterhead,5327,2,24,4,8,81,39,42,76
Stirling,5327,3,17,6,13,64,52,12,57
Clyde,5327,4,15,9,12,55,49,6,54
Stenhousem'r,5327,5,15,8,13,56,50,6,53
Elgin,5327,6,14,6,16,53,62,-9,48
Annan Athlet,5327,7,12,11,13,49,42,7,47
Berwick,5327,8,8,10,18,30,62,-32,34
Edinburgh Ci,5327,9,7,9,20,37,64,-27,30
Cowdenbeath,5327,10,4,10,22,24,56,-32,22
Montrose,5328,1,24,7,5,61,35,26,79
Peterhead,5328,2,24,4,8,82,40,42,76
Stirling,5328,3,16,7,13,61,52,9,55
Stenhousem'r,5328,4,15,9,12,56,47,9,54
Clyde,5328,5,15,9,12,55,49,6,54
Elgin,5328,6,14,6,16,54,62,-8,48
Annan Athlet,5328,7,12,11,13,48,41,7,47
Berwick,5328,8,8,10,18,30,62,-32,34
Edinburgh Ci,5328,9,7,9,20,38,65,-27,30
Cowdenbeath,5328,10,4,10,22,23,55,-32,22
Montrose,5329,1,24,7,5,61,35,26,79
Peterhead,5329,2,24,4,8,79,39,40,76
Stirling,5329,3,16,7,13,62,53,9,55
Stenhousem'r,5329,4,15,9,12,57,48,9,54
Clyde,5329,5,15,9,12,52,48,4,54
Elgin,5329,6,14,6,16,54,62,-8,48
Annan Athlet,5329,7,11,12,13,47,41,6,45
Berwick,5329,8,8,10,18,29,59,-30,34
Edinburgh Ci,5329,9,7,9,20,37,62,-25,30
Cowdenbeath,5329,10,4,11,21,23,54,-31,23
Montrose,5330,1,24,7,5,62,36,26,79
Peterhead,5330,2,24,4,8,79,39,40,76
Stirling,5330,3,17,6,13,64,52,12,57
Clyde,5330,4,15,9,12,53,49,4,54
Stenhousem'r,5330,5,15,8,13,56,50,6,53
Elgin,5330,6,14,6,16,55,63,-8,48
Annan Athlet,5330,7,11,12,13,48,42,6,45
Berwick,5330,8,8,10,18,30,60,-30,34
Edinburgh Ci,5330,9,7,9,20,37,62,-25,30
Cowdenbeath,5330,10,4,11,21,24,55,-31,23
Montrose,5331,1,23,8,5,60,35,25,77
Peterhead,5331,2,24,4,8,80,40,40,76
Stirling,5331,3,17,6,13,62,51,11,57
Clyde,5331,4,15,9,12,52,48,4,54
Stenhousem'r,5331,5,15,8,13,55,48,7,53
Elgin,5331,6,14,7,15,54,61,-7,49
Annan Athlet,5331,7,11,12,13,48,42,6,45
Berwick,5331,8,8,10,18,29,59,-30,34
Edinburgh Ci,5331,9,7,9,20,38,63,-25,30
Cowdenbeath,5331,10,4,11,21,24,55,-31,23
Montrose,5332,1,23,8,5,60,35,25,77
Peterhead,5332,2,24,4,8,83,39,44,76
Stenhousem'r,5332,3,16,8,12,57,46,11,56
Stirling,5332,4,16,6,14,60,53,7,54
Clyde,5332,5,14,10,12,52,49,3,52
Elgin,5332,6,14,7,15,54,61,-7,49
Annan Athlet,5332,7,12,11,13,49,42,7,47
Berwick,5332,8,8,11,17,30,59,-29,35
Edinburgh Ci,5332,9,7,9,20,37,66,-29,30
Cowdenbeath,5332,10,4,10,22,24,56,-32,22
Montrose,5333,1,24,7,5,60,34,26,79
Peterhead,5333,2,23,4,9,77,39,38,73
Stirling,5333,3,16,7,13,61,52,9,55
Stenhousem'r,5333,4,15,9,12,56,47,9,54
Clyde,5333,5,15,9,12,54,50,4,54
Elgin,5333,6,14,6,16,53,61,-8,48
Annan Athlet,5333,7,12,11,13,49,41,8,47
Berwick,5333,8,8,10,18,31,61,-30,34
Edinburgh Ci,5333,9,8,9,19,37,60,-23,33
Cowdenbeath,5333,10,4,10,22,23,56,-33,22
Montrose,5334,1,24,7,5,63,37,26,79
Peterhead,5334,2,24,4,8,80,38,42,76
Stenhousem'r,5334,3,16,8,12,58,47,11,56
Stirling,5334,4,16,6,14,61,54,7,54
Clyde,5334,5,15,9,12,55,49,6,54
Elgin,5334,6,14,6,16,56,64,-8,48
Annan Athlet,5334,7,11,11,14,47,42,5,44
Berwick,5334,8,8,10,18,30,62,-32,34
Edinburgh Ci,5334,9,7,9,20,36,63,-27,30
Cowdenbeath,5334,10,5,10,21,24,54,-30,25
Montrose,5335,1,24,7,5,62,34,28,79
Peterhead,5335,2,24,4,8,81,39,42,76
Stirling,5335,3,17,6,13,62,51,11,57
Stenhousem'r,5335,4,15,8,13,55,48,7,53
Clyde,5335,5,14,9,13,52,50,2,51
Elgin,5335,6,14,6,16,53,63,-10,48
Annan Athlet,5335,7,11,12,13,48,42,6,45
Berwick,5335,8,9,10,17,31,59,-28,37
Edinburgh Ci,5335,9,7,9,20,37,64,-27,30
Cowdenbeath,5335,10,4,11,21,24,55,-31,23
Montrose,5336,1,24,7,5,61,35,26,79
Peterhead,5336,2,24,4,8,82,40,42,76
Stirling,5336,3,16,7,13,61,52,9,55
Stenhousem'r,5336,4,15,9,12,56,47,9,54
Clyde,5336,5,15,9,12,53,49,4,54
Elgin,5336,6,14,6,16,54,62,-8,48
Annan Athlet,5336,7,11,12,13,50,44,6,45
Berwick,5336,8,8,10,18,30,60,-30,34
Edinburgh Ci,5336,9,7,9,20,38,65,-27,30
Cowdenbeath,5336,10,4,11,21,26,57,-31,23
Peterhead,5337,1,24,4,8,80,38,42,76
Montrose,5337,2,23,7,6,60,36,24,76
Stirling,5337,3,17,6,13,63,52,11,57
Clyde,5337,4,15,9,12,52,48,4,54
Stenhousem'r,5337,5,15,8,13,56,49,7,53
Elgin,5337,6,15,6,15,55,61,-6,51
Annan Athlet,5337,7,11,12,13,47,41,6,45
Berwick,5337,8,8,10,18,29,59,-30,34
Edinburgh Ci,5337,9,7,9,20,36,63,-27,30
Cowdenbeath,5337,10,4,11,21,23,54,-31,23
Montrose,5338,1,24,7,5,60,34,26,79
Peterhead,5338,2,24,4,8,81,38,43,76
Stenhousem'r,5338,3,16,8,12,59,47,12,56
Stirling,5338,4,16,6,14,61,55,6,54
Clyde,5338,5,15,9,12,53,48,5,54
Elgin,5338,6,14,6,16,53,61,-8,48
Annan Athlet,5338,7,11,11,14,47,43,4,44
Berwick,5338,8,8,10,18,29,60,-31,34
Edinburgh Ci,5338,9,7,9,20,36,64,-28,30
Cowdenbeath,5338,10,5,10,21,25,54,-29,25
Montrose,5339,1,24,7,5,61,34,27,79
Peterhead,5339,2,23,5,8,81,42,39,74
Stenhousem'r,5339,3,16,8,12,57,47,10,56
Stirling,5339,4,16,6,14,61,53,8,54
Clyde,5339,5,15,9,12,53,48,5,54
Elgin,5339,6,14,6,16,53,62,-9,48
Annan Athlet,5339,7,11,11,14,47,44,3,44
Berwick,5339,8,8,10,18,29,60,-31,34
Edinburgh Ci,5339,9,7,10,19,40,64,-24,31
Cowdenbeath,5339,10,5,10,21,26,54,-28,25
Montrose,5340,1,23,8,5,60,35,25,77
Peterhead,5340,2,24,4,8,83,38,45,76
Stenhousem'r,5340,3,16,8,12,61,49,12,56
Stirling,5340,4,16,6,14,63,57,6,54
Clyde,5340,5,15,9,12,53,48,5,54
Elgin,5340,6,14,7,15,54,61,-7,49
Annan Athlet,5340,7,11,11,14,47,42,5,44
Berwick,5340,8,8,10,18,29,60,-31,34
Edinburgh Ci,5340,9,7,9,20,36,66,-30,30
Cowdenbeath,5340,10,5,10,21,24,54,-30,25
Montrose,5341,1,24,7,5,60,34,26,79
Peterhead,5341,2,24,4,8,82,38,44,76
Stirling,5341,3,16,7,13,62,53,9,55
Stenhousem'r,5341,4,15,9,12,57,48,9,54
Clyde,5341,5,15,9,12,53,49,4,54
Elgin,5341,6,14,6,16,53,61,-8,48
Annan Athlet,5341,7,12,11,13,48,41,7,47
Berwick,5341,8,8,10,18,30,60,-30,34
Edinburgh Ci,5341,9,7,9,20,36,65,-29,30
Cowdenbeath,5341,10,4,10,22,23,55,-32,22
Montrose,5342,1,24,7,5,61,34,27,79
Peterhead,5342,2,23,4,9,77,41,36,73
Stirling,5342,3,17,6,13,65,53,12,57
Clyde,5342,4,15,9,12,52,48,4,54
Stenhousem'r,5342,5,15,8,13,57,51,6,53
Elgin,5342,6,14,6,16,53,62,-9,48
Annan Athlet,5342,7,11,11,14,47,42,5,44
Berwick,5342,8,8,10,18,29,59,-30,34
Edinburgh Ci,5342,9,8,9,19,39,60,-21,33
Cowdenbeath,5342,10,5,10,21,24,54,-30,25
Montrose,5343,1,24,7,5,60,34,26,79
Peterhead,5343,2,24,4,8,81,39,42,76
Stirling,5343,3,16,7,13,60,51,9,55
Stenhousem'r,5343,4,15,9,12,55,46,9,54
Clyde,5343,5,15,9,12,52,48,4,54
Elgin,5343,6,14,6,16,53,61,-8,48
Annan Athlet,5343,7,12,11,13,49,41,8,47
Berwick,5343,8,8,10,18,29,59,-30,34
Edinburgh Ci,5343,9,7,9,20,37,64,-27,30
Cowdenbeath,5343,10,4,10,22,23,56,-33,22
Montrose,5344,1,24,7,5,61,35,26,79
Peterhead,5344,2,24,4,8,80,38,42,76
Stirling,5344,3,17,6,13,61,51,10,57
Clyde,5344,4,15,9,12,52,48,4,54
Stenhousem'r,5344,5,15,8,13,55,47,8,53
Elgin,5344,6,14,6,16,54,62,-8,48
Annan Athlet,5344,7,12,11,13,48,41,7,47
Berwick,5344,8,8,10,18,29,59,-30,34
Edinburgh Ci,5344,9,7,9,20,36,63,-27,30
Cowdenbeath,5344,10,4,10,22,23,55,-32,22
Montrose,5345,1,23,8,5,60,35,25,77
Peterhead,5345,2,23,4,9,78,41,37,73
Stirling,5345,3,17,6,13,62,51,11,57
Stenhousem'r,5345,4,15,8,13,55,48,7,53
Clyde,5345,5,14,10,12,53,50,3,52
Elgin,5345,6,14,7,15,54,61,-7,49
Annan Athlet,5345,7,11,12,13,47,41,6,45
Berwick,5345,8,8,11,17,31,60,-29,35
Edinburgh Ci,5345,9,8,9,19,39,61,-22,33
Cowdenbeath,5345,10,4,11,21,23,54,-31,23
Montrose,5346,1,24,7,5,60,34,26,79
Peterhead,5346,2,24,4,8,80,39,41,76
Stirling,5346,3,17,6,13,64,51,13,57
Clyde,5346,4,15,9,12,54,49,5,54
Stenhousem'r,5346,5,15,8,13,55,50,5,53
Elgin,5346,6,14,6,16,53,61,-8,48
Annan Athlet,5346,7,12,11,13,49,41,8,47
Berwick,5346,8,8,10,18,30,61,-31,34
Edinburgh Ci,5346,9,7,9,20,37,63,-26,30
Cowdenbeath,5346,10,4,10,22,23,56,-33,22
Montrose,5347,1,23,7,6,60,37,23,76
Peterhead,5347,2,23,5,8,79,40,39,74
Stirling,5347,3,17,6,13,63,51,12,57
Clyde,5347,4,15,9,12,53,48,5,54
Stenhousem'r,5347,5,15,8,13,55,49,6,53
Elgin,5347,6,15,6,15,56,61,-5,51
Annan Athlet,5347,7,12,11,13,49,41,8,47
Berwick,5347,8,8,10,18,29,60,-31,34
Edinburgh Ci,5347,9,7,10,19,38,62,-24,31
Cowdenbeath,5347,10,4,10,22,23,56,-33,22
Montrose,5348,1,24,7,5,63,34,29,79
Peterhead,5348,2,24,4,8,82,38,44,76
Stirling,5348,3,17,6,13,64,52,12,57
Clyde,5348,4,15,9,12,53,48,5,54
Stenhousem'r,5348,5,15,8,13,56,50,6,53
Elgin,5348,6,14,6,16,53,64,-11,48
Annan Athlet,5348,7,11,12,13,47,41,6,45
Berwick,5348,8,8,10,18,29,60,-31,34
Edinburgh Ci,5348,9,7,9,20,36,65,-29,30
Cowdenbeath,5348,10,4,11,21,23,54,-31,23
Montrose,5349,1,23,8,5,59,34,25,77
Peterhead,5349,2,24,4,8,81,39,42,76
Stirling,5349,3,17,6,13,63,53,10,57
Clyde,5349,4,15,9,12,55,49,6,54
Stenhousem'r,5349,5,15,8,13,57,49,8,53
Elgin,5349,6,14,7,15,53,60,-7,49
Annan Athlet,5349,7,11,12,13,47,41,6,45
Berwick,5349,8,8,10,18,30,62,-32,34
Edinburgh Ci,5349,9,7,9,20,37,64,-27,30
Cowdenbeath,5349,10,4,11,21,23,54,-31,23
Montrose,5350,1,24,7,5,60,34,26,79
Peterhead,5350,2,24,4,8,79,39,40,76
Stirling,5350,3,16,7,13,61,52,9,55
Stenhousem'r,5350,4,15,9,12,56,47,9,54
Clyde,5350,5,15,9,12,53,49,4,54
Elgin,5350,6,14,6,16,53,61,-8,48
Annan Athlet,5350,7,12,11,13,49,41,8,47
Berwick,5350,8,8,10,18,30,60,-30,34
Edinburgh Ci,5350,9,7,9,20,37,62,-25,30
Cowdenbeath,5350,10,4,10,22,23,56,-33,22
Montrose,5351,1,24,7,5,60,34,26,79
Peterhead,5351,2,24,4,8,79,39,40,76
Stenhousem'r,5351,3,16,8,12,57,47,10,56
Stirling,5351,4,16,6,14,61,53,8,54
Clyde,5351,5,15,9,12,53,48,5,54
Elgin,5351,6,14,6,16,53,61,-8,48
Annan Athlet,5351,7,12,11,13,48,41,7,47
Berwick,5351,8,8,10,18,29,60,-31,34
Edinburgh Ci,5351,9,7,9,20,37,62,-25,30
Cowdenbeath,5351,10,4,10,22,23,55,-32,22
Peterhead,5352,1,24,4,8,78,38,40,76
Montrose,5352,2,23,7,6,60,36,24,76
Stirling,5352,3,17,6,13,62,52,10,57
Clyde,5352,4,15,9,12,55,49,6,54
Stenhousem'r,5352,5,15,8,13,56,48,8,53
Elgin,5352,6,15,6,15,55,61,-6,51
Annan Athlet,5352,7,11,12,13,47,41,6,45
Berwick,5352,8,8,10,18,30,62,-32,34
Edinburgh Ci,5352,9,7,9,20,36,61,-25,30
Cowdenbeath,5352,10,4,11,21,23,54,-31,23
Montrose,5353,1,24,7,5,60,34,26,79
Peterhead,5353,2,24,4,8,79,38,41,76
Stenhousem'r,5353,3,16,8,12,58,47,11,56
Stirling,5353,4,16,6,14,61,54,7,54
Clyde,5353,5,15,9,12,53,49,4,54
Elgin,5353,6,14,6,16,53,61,-8,48
Annan Athlet,5353,7,12,11,13,50,42,8,47
Berwick,5353,8,8,10,18,30,60,-30,34
Edinburgh Ci,5353,9,7,9,20,36,62,-26,30
Cowdenbeath,5353,10,4,10,22,24,57,-33,22
Peterhead,5354,1,24,4,8,80,38,42,76
Montrose,5354,2,23,7,6,59,35,24,76
Stirling,5354,3,17,6,13,61,51,10,57
Clyde,5354,4,15,9,12,53,48,5,54
Stenhousem'r,5354,5,15,8,13,55,47,8,53
Elgin,5354,6,15,6,15,54,60,-6,51
Annan Athlet,5354,7,11,11,14,48,43,5,44
Berwick,5354,8,8,10,18,29,60,-31,34
Edinburgh Ci,5354,9,7,9,20,36,63,-27,30
Cowdenbeath,5354,10,5,10,21,25,55,-30,25
Montrose,5355,1,23,8,5,61,36,25,77
Peterhead,5355,2,24,4,8,78,38,40,76
Stirling,5355,3,17,6,13,61,51,10,57
Clyde,5355,4,15,9,12,52,48,4,54
Stenhousem'r,5355,5,15,8,13,55,47,8,53
Elgin,5355,6,14,7,15,55,62,-7,49
Annan Athlet,5355,7,11,11,14,47,42,5,44
Berwick,5355,8,8,10,18,29,59,-30,34
Edinburgh Ci,5355,9,7,9,20,36,61,-25,30
Cowdenbeath,5355,10,5,10,21,24,54,-30,25
Peterhead,5356,1,24,4,8,79,38,41,76
Montrose,5356,2,23,7,6,59,37,22,76
Stirling,5356,3,17,6,13,64,53,11,57
Clyde,5356,4,15,9,12,52,48,4,54
Stenhousem'r,5356,5,15,8,13,57,50,7,53
Elgin,5356,6,15,6,15,56,60,-4,51
Annan Athlet,5356,7,11,12,13,47,41,6,45
Berwick,5356,8,8,10,18,29,59,-30,34
Edinburgh Ci,5356,9,7,9,20,36,62,-26,30
Cowdenbeath,5356,10,4,11,21,23,54,-31,23
Montrose,5357,1,24,7,5,61,35,26,79
Peterhead,5357,2,24,4,8,81,40,41,76
Stenhousem'r,5357,3,16,8,12,57,46,11,56
Clyde,5357,4,15,9,12,56,48,8,54
Stirling,5357,5,16,6,14,60,53,7,54
Elgin,5357,6,14,6,16,54,62,-8,48
Annan Athlet,5357,7,12,11,13,50,41,9,47
Berwick,5357,8,8,10,18,29,63,-34,34
Edinburgh Ci,5357,9,7,9,20,38,64,-26,30
Cowdenbeath,5357,10,4,10,22,23,57,-34,22
Montrose,5358,1,24,7,5,60,34,26,79
Peterhead,5358,2,23,4,9,77,40,37,73
Stirling,5358,3,16,7,13,60,51,9,55
Stenhousem'r,5358,4,15,9,12,55,46,9,54
Clyde,5358,5,14,10,12,51,48,3,52
Elgin,5358,6,14,6,16,53,61,-8,48
Annan Athlet,5358,7,12,11,13,49,41,8,47
Berwick,5358,8,8,11,17,29,58,-29,35
Edinburgh Ci,5358,9,8,9,19,38,60,-22,33
Cowdenbeath,5358,10,4,10,22,23,56,-33,22
Montrose,5359,1,24,7,5,62,35,27,79
Peterhead,5359,2,23,4,9,78,40,38,73
Stirling,5359,3,17,6,13,63,51,12,57
Clyde,5359,4,15,9,12,53,49,4,54
Stenhousem'r,5359,5,15,8,13,55,49,6,53
Elgin,5359,6,14,6,16,54,63,-9,48
Annan Athlet,5359,7,11,11,14,47,43,4,44
Berwick,5359,8,8,10,18,30,60,-30,34
Edinburgh Ci,5359,9,8,9,19,38,61,-23,33
Cowdenbeath,5359,10,5,10,21,25,54,-29,25
Montrose,5360,1,23,8,5,61,36,25,77
Peterhead,5360,2,24,4,8,80,38,42,76
Stenhousem'r,5360,3,16,8,12,59,46,13,56
Stirling,5360,4,16,6,14,60,55,5,54
Clyde,5360,5,15,9,12,52,48,4,54
Elgin,5360,6,14,7,15,55,62,-7,49
Annan Athlet,5360,7,12,11,13,49,42,7,47
Berwick,5360,8,8,10,18,29,59,-30,34
Edinburgh Ci,5360,9,7,9,20,36,63,-27,30
Cowdenbeath,5360,10,4,10,22,24,56,-32,22
Montrose,5361,1,24,7,5,61,35,26,79
Peterhead,5361,2,24,4,8,79,39,40,76
Stirling,5361,3,17,6,13,63,51,12,57
Clyde,5361,4,15,9,12,54,49,5,54
Stenhousem'r,5361,5,15,8,13,55,49,6,53
Elgin,5361,6,14,6,16,54,62,-8,48
Annan Athlet,5361,7,11,12,13,47,41,6,45
Berwick,5361,8,8,10,18,30,61,-31,34
Edinburgh Ci,5361,9,7,9,20,37,62,-25,30
Cowdenbeath,5361,10,4,11,21,23,54,-31,23
Peterhead,5362,1,24,4,8,78,38,40,76
Montrose,5362,2,23,7,6,59,36,23,76
Stenhousem'r,5362,3,16,8,12,56,46,10,56
Stirling,5362,4,16,6,14,60,52,8,54
Clyde,5362,5,15,9,12,52,48,4,54
Elgin,5362,6,15,6,15,55,60,-5,51
Annan Athlet,5362,7,11,12,13,49,43,6,45
Berwick,5362,8,8,10,18,29,59,-30,34
Edinburgh Ci,5362,9,7,9,20,36,61,-25,30
Cowdenbeath,5362,10,4,11,21,25,56,-31,23
Montrose,5363,1,24,7,5,63,36,27,79
Peterhead,5363,2,24,4,8,81,39,42,76
Stenhousem'r,5363,3,16,8,12,56,46,10,56
Stirling,5363,4,16,6,14,60,52,8,54
Clyde,5363,5,15,9,12,53,48,5,54
Elgin,5363,6,14,6,16,55,64,-9,48
Annan Athlet,5363,7,12,11,13,49,42,7,47
Berwick,5363,8,8,10,18,29,60,-31,34
Edinburgh Ci,5363,9,7,9,20,37,64,-27,30
Cowdenbeath,5363,10,4,10,22,24,56,-32,22
Montrose,5364,1,23,8,5,60,35,25,77
Peterhead,5364,2,24,4,8,80,38,42,76
Stirling,5364,3,17,6,13,63,51,12,57
Clyde,5364,4,15,9,12,55,48,7,54
Stenhousem'r,5364,5,15,8,13,55,49,6,53
Elgin,5364,6,14,7,15,54,61,-7,49
Annan Athlet,5364,7,11,12,13,47,41,6,45
Berwick,5364,8,8,10,18,29,62,-33,34
Edinburgh Ci,5364,9,7,9,20,36,63,-27,30
Cowdenbeath,5364,10,4,11,21,23,54,-31,23
Montrose,5365,1,23,8,5,61,36,25,77
Peterhead,5365,2,24,4,8,84,38,46,76
Stirling,5365,3,16,7,13,61,52,9,55
Stenhousem'r,5365,4,15,9,12,56,47,9,54
Clyde,5365,5,14,9,13,51,49,2,51
Elgin,5365,6,14,7,15,55,62,-7,49
Annan Athlet,5365,7,11,11,14,48,43,5,44
Berwick,5365,8,9,10,17,30,58,-28,37
Edinburgh Ci,5365,9,7,9,20,36,67,-31,30
Cowdenbeath,5365,10,5,10,21,25,55,-30,25
Peterhead,5366,1,24,4,8,79,38,41,76
Montrose,5366,2,23,7,6,60,36,24,76
Stirling,5366,3,17,6,13,63,52,11,57
Stenhousem'r,5366,4,15,8,13,56,49,7,53
Clyde,5366,5,14,9,13,51,50,1,51
Elgin,5366,6,15,6,15,55,61,-6,51
Annan Athlet,5366,7,12,11,13,48,41,7,47
Berwick,5366,8,9,10,17,31,58,-27,37
Edinburgh Ci,5366,9,7,9,20,36,62,-26,30
Cowdenbeath,5366,10,4,10,22,23,55,-32,22
Montrose,5367,1,23,7,6,61,37,24,76
Peterhead,5367,2,23,5,8,78,39,39,74
Stenhousem'r,5367,3,16,8,12,58,46,12,56
Stirling,5367,4,16,6,14,60,54,6,54
Clyde,5367,5,15,9,12,54,48,6,54
Elgin,5367,6,15,6,15,56,62,-6,51
Annan Athlet,5367,7,11,12,13,47,41,6,45
Berwick,5367,8,8,10,18,29,61,-32,34
Edinburgh Ci,5367,9,7,10,19,37,61,-24,31
Cowdenbeath,5367,10,4,11,21,23,54,-31,23
Montrose,5368,1,24,7,5,62,34,28,79
Peterhead,5368,2,23,5,8,77,38,39,74
Stirling,5368,3,16,7,13,62,53,9,55
Stenhousem'r,5368,4,15,9,12,57,48,9,54
Clyde,5368,5,15,9,12,53,48,5,54
Elgin,5368,6,14,6,16,53,63,-10,48
Annan Athlet,5368,7,12,11,13,51,41,10,47
Berwick,5368,8,8,10,18,29,60,-31,34
Edinburgh Ci,5368,9,7,10,19,36,60,-24,31
Cowdenbeath,5368,10,4,10,22,23,58,-35,22
Peterhead,5369,1,24,4,8,81,39,42,76
Montrose,5369,2,23,7,6,59,35,24,76
Stirling,5369,3,17,6,13,64,51,13,57
Stenhousem'r,5369,4,15,8,13,55,50,5,53
Clyde,5369,5,14,10,12,53,50,3,52
Elgin,5369,6,15,6,15,54,60,-6,51
Annan Athlet,5369,7,11,11,14,48,44,4,44
Berwick,5369,8,8,11,17,31,60,-29,35
Edinburgh Ci,5369,9,7,9,20,37,64,-27,30
Cowdenbeath,5369,10,5,10,21,26,55,-29,25
Peterhead,5370,1,24,4,8,81,39,42,76
Montrose,5370,2,23,7,6,60,39,21,76
Stenhousem'r,5370,3,16,8,12,59,47,12,56
Stirling,5370,4,16,6,14,61,55,6,54
Clyde,5370,5,14,9,13,52,50,2,51
Elgin,5370,6,15,6,15,58,61,-3,51
Annan Athlet,5370,7,11,12,13,47,41,6,45
Berwick,5370,8,9,10,17,31,59,-28,37
Edinburgh Ci,5370,9,7,9,20,37,64,-27,30
Cowdenbeath,5370,10,4,11,21,23,54,-31,23
Montrose,5371,1,24,7,5,61,34,27,79
Peterhead,5371,2,24,4,8,79,38,41,76
Stenhousem'r,5371,3,16,8,12,57,47,10,56
Stirling,5371,4,16,6,14,61,53,8,54
Clyde,5371,5,15,9,12,54,49,5,54
Elgin,5371,6,14,6,16,53,62,-9,48
Annan Athlet,5371,7,12,11,13,49,41,8,47
Berwick,5371,8,8,10,18,30,61,-31,34
Edinburgh Ci,5371,9,7,9,20,36,62,-26,30
Cowdenbeath,5371,10,4,10,22,23,56,-33,22
Montrose,5372,1,24,7,5,61,35,26,79
Peterhead,5372,2,24,4,8,80,38,42,76
Stenhousem'r,5372,3,16,8,12,58,48,10,56
Stirling,5372,4,16,6,14,62,54,8,54
Clyde,5372,5,14,10,12,51,48,3,52
Elgin,5372,6,14,6,16,54,62,-8,48
Annan Athlet,5372,7,11,12,13,51,45,6,45
Berwick,5372,8,8,11,17,29,58,-29,35
Edinburgh Ci,5372,9,7,9,20,36,63,-27,30
Cowdenbeath,5372,10,4,11,21,27,58,-31,23
Montrose,5373,1,24,7,5,62,36,26,79
Peterhead,5373,2,24,4,8,82,40,42,76
Stenhousem'r,5373,3,16,8,12,57,47,10,56
Stirling,5373,4,16,6,14,61,53,8,54
Clyde,5373,5,14,10,12,51,48,3,52
Elgin,5373,6,14,6,16,55,63,-8,48
Annan Athlet,5373,7,11,11,14,49,44,5,44
Berwick,5373,8,8,11,17,29,58,-29,35
Edinburgh Ci,5373,9,7,9,20,38,65,-27,30
Cowdenbeath,5373,10,5,10,21,26,56,-30,25
Montrose,5374,1,23,8,5,59,34,25,77
Peterhead,5374,2,23,5,8,79,40,39,74
Stirling,5374,3,16,7,13,61,52,9,55
Stenhousem'r,5374,4,15,9,12,56,47,9,54
Clyde,5374,5,15,9,12,54,49,5,54
Elgin,5374,6,14,7,15,53,60,-7,49
Annan Athlet,5374,7,11,11,14,47,42,5,44
Berwick,5374,8,8,10,18,30,61,-31,34
Edinburgh Ci,5374,9,7,10,19,38,62,-24,31
Cowdenbeath,5374,10,5,10,21,24,54,-30,25
Montrose,5375,1,24,7,5,63,35,28,79
Peterhead,5375,2,24,4,8,78,38,40,76
Stirling,5375,3,16,7,13,62,53,9,55
Stenhousem'r,5375,4,15,9,12,57,48,9,54
Clyde,5375,5,15,9,12,54,49,5,54
Elgin,5375,6,14,6,16,54,64,-10,48
Annan Athlet,5375,7,11,11,14,47,44,3,44
Berwick,5375,8,8,10,18,30,61,-31,34
Edinburgh Ci,5375,9,7,9,20,36,61,-25,30
Cowdenbeath,5375,10,5,10,21,26,54,-28,25
Peterhead,5376,1,24,4,8,80,38,42,76
Montrose,5376,2,23,7,6,61,37,24,76
Stirling,5376,3,16,7,13,60,51,9,55
Stenhousem'r,5376,4,15,9,12,55,46,9,54
Clyde,5376,5,15,9,12,54,49,5,54
Elgin,5376,6,15,6,15,56,62,-6,51
Annan Athlet,5376,7,11,11,14,48,43,5,44
Berwick,5376,8,8,10,18,30,61,-31,34
Edinburgh Ci,5376,9,7,9,20,36,63,-27,30
Cowdenbeath,5376,10,5,10,21,25,55,-30,25
Montrose,5377,1,23,8,5,60,35,25,77
Peterhead,5377,2,23,5,8,79,40,39,74
Stenhousem'r,5377,3,16,8,12,60,47,13,56
Stirling,5377,4,16,6,14,61,56,5,54
Clyde,5377,5,15,9,12,53,48,5,54
Elgin,5377,6,14,7,15,54,61,-7,49
Annan Athlet,5377,7,12,11,13,49,41,8,47
Berwick,5377,8,8,10,18,29,60,-31,34
Edinburgh Ci,5377,9,7,10,19,38,62,-24,31
Cowdenbeath,5377,10,4,10,22,23,56,-33,22
Peterhead,5378,1,24,4,8,80,38,42,76
Montrose,5378,2,23,7,6,60,36,24,76
Stirling,5378,3,16,7,13,61,52,9,55
Stenhousem'r,5378,4,15,9,12,56,47,9,54
Clyde,5378,5,14,10,12,51,48,3,52
Elgin,5378,6,15,6,15,55,61,-6,51
Annan Athlet,5378,7,11,12,13,47,41,6,45
Berwick,5378,8,8,11,17,29,58,-29,35
Edinburgh Ci,5378,9,7,9,20,36,63,-27,30
Cowdenbeath,5378,10,4,11,21,23,54,-31,23
Montrose,5379,1,24,7,5,64,35,29,79
Peterhead,5379,2,24,4,8,80,38,42,76
Stirling,5379,3,17,6,13,62,52,10,57
Clyde,5379,4,15,9,12,53,49,4,54
Stenhousem'r,5379,5,15,8,13,56,48,8,53
Elgin,5379,6,14,6,16,54,65,-11,48
Annan Athlet,5379,7,12,11,13,49,42,7,47
Berwick,5379,8,8,10,18,30,60,-30,34
Edinburgh Ci,5379,9,7,9,20,36,63,-27,30
Cowdenbeath,5379,10,4,10,22,24,56,-32,22
Peterhead,5380,1,24,4,8,79,39,40,76
Montrose,5380,2,23,7,6,59,35,24,76
Stirling,5380,3,17,6,13,63,51,12,57
Clyde,5380,4,15,9,12,53,48,5,54
Stenhousem'r,5380,5,15,8,13,55,49,6,53
Elgin,5380,6,15,6,15,54,60,-6,51
Annan Athlet,5380,7,11,12,13,48,42,6,45
Berwick,5380,8,8,10,18,29,60,-31,34
Edinburgh Ci,5380,9,7,9,20,37,62,-25,30
Cowdenbeath,5380,10,4,11,21,24,55,-31,23
Montrose,5381,1,24,7,5,60,34,26,79
Peterhead,5381,2,24,4,8,79,39,40,76
Stirling,5381,3,17,6,13,63,52,11,57
Clyde,5381,4,15,9,12,54,49,5,54
Stenhousem'r,5381,5,15,8,13,56,49,7,53
Elgin,5381,6,14,6,16,53,61,-8,48
Annan Athlet,5381,7,11,11,14,48,43,5,44
Berwick,5381,8,8,10,18,30,61,-31,34
Edinburgh Ci,5381,9,7,9,20,37,62,-25,30
Cowdenbeath,5381,10,5,10,21,25,55,-30,25
Montrose,5382,1,24,7,5,62,36,26,79
Peterhead,5382,2,23,5,8,77,38,39,74
Stirling,5382,3,17,6,13,65,52,13,57
Clyde,5382,4,15,9,12,53,49,4,54
Stenhousem'r,5382,5,15,8,13,56,51,5,53
Elgin,5382,6,14,6,16,55,63,-8,48
Annan Athlet,5382,7,11,12,13,49,43,6,45
Berwick,5382,8,8,10,18,30,60,-30,34
Edinburgh Ci,5382,9,7,10,19,36,60,-24,31
Cowdenbeath,5382,10,4,11,21,25,56,-31,23
Montrose,5383,1,24,7,5,65,35,30,79
Peterhead,5383,2,24,4,8,81,38,43,76
Stirling,5383,3,16,7,13,62,53,9,55
Stenhousem'r,5383,4,15,9,12,57,48,9,54
Clyde,5383,5,15,9,12,53,48,5,54
Elgin,5383,6,14,6,16,54,66,-12,48
Annan Athlet,5383,7,12,11,13,48,41,7,47
Berwick,5383,8,8,10,18,29,60,-31,34
Edinburgh Ci,5383,9,7,9,20,36,64,-28,30
Cowdenbeath,5383,10,4,10,22,23,55,-32,22
Montrose,5384,1,24,7,5,61,35,26,79
Peterhead,5384,2,24,4,8,79,39,40,76
Stirling,5384,3,17,6,13,62,51,11,57
Clyde,5384,4,15,9,12,53,48,5,54
Stenhousem'r,5384,5,15,8,13,55,48,7,53
Elgin,5384,6,14,6,16,54,62,-8,48
Annan Athlet,5384,7,12,11,13,49,41,8,47
Berwick,5384,8,8,10,18,29,60,-31,34
Edinburgh Ci,5384,9,7,9,20,37,62,-25,30
Cowdenbeath,5384,10,4,10,22,23,56,-33,22
Montrose,5385,1,24,7,5,62,35,27,79
Peterhead,5385,2,24,4,8,81,38,43,76
Stirling,5385,3,16,7,13,61,52,9,55
Stenhousem'r,5385,4,15,9,12,56,47,9,54
Clyde,5385,5,15,9,12,52,48,4,54
Elgin,5385,6,14,6,16,54,63,-9,48
Annan Athlet,5385,7,12,11,13,50,42,8,47
Berwick,5385,8,8,10,18,29,59,-30,34
Edinburgh Ci,5385,9,7,9,20,36,64,-28,30
Cowdenbeath,5385,10,4,10,22,24,57,-33,22
Montrose,5386,1,23,8,5,59,34,25,77
Peterhead,5386,2,24,4,8,78,38,40,76
Stirling,5386,3,16,7,13,61,52,9,55
Stenhousem'r,5386,4,15,9,12,56,47,9,54
Clyde,5386,5,15,9,12,55,48,7,54
Elgin,5386,6,14,7,15,53,60,-7,49
Annan Athlet,5386,7,12,11,13,48,41,7,47
Berwick,5386,8,8,10,18,29,62,-33,34
Edinburgh Ci,5386,9,7,9,20,36,61,-25,30
Cowdenbeath,5386,10,4,10,22,23,55,-32,22
Montrose,5387,1,24,7,5,64,36,28,79
Peterhead,5387,2,24,4,8,79,38,41,76
Stirling,5387,3,17,6,13,64,52,12,57
Stenhousem'r,5387,4,15,8,13,56,50,6,53
Clyde,5387,5,14,10,12,52,49,3,52
Elgin,5387,6,14,6,16,55,65,-10,48
Annan Athlet,5387,7,12,11,13,48,41,7,47
Berwick,5387,8,8,11,17,30,59,-29,35
Edinburgh Ci,5387,9,7,9,20,36,62,-26,30
Cowdenbeath,5387,10,4,10,22,23,55,-32,22
Montrose,5388,1,24,7,5,61,35,26,79
Peterhead,5388,2,23,5,8,77,38,39,74
Stenhousem'r,5388,3,16,8,12,58,47,11,56
Stirling,5388,4,16,6,14,61,54,7,54
Clyde,5388,5,15,9,12,55,48,7,54
Elgin,5388,6,14,6,16,54,62,-8,48
Annan Athlet,5388,7,11,12,13,47,41,6,45
Berwick,5388,8,8,10,18,29,62,-33,34
Edinburgh Ci,5388,9,7,10,19,36,60,-24,31
Cowdenbeath,5388,10,4,11,21,23,54,-31,23
Montrose,5389,1,24,7,5,61,35,26,79
Peterhead,5389,2,24,4,8,79,39,40,76
Stirling,5389,3,17,6,13,62,52,10,57
Stenhousem'r,5389,4,15,8,13,56,48,8,53
Clyde,5389,5,14,10,12,53,50,3,52
Elgin,5389,6,14,6,16,54,62,-8,48
Annan Athlet,5389,7,11,12,13,48,42,6,45
Berwick,5389,8,8,11,17,31,60,-29,35
Edinburgh Ci,5389,9,7,9,20,37,62,-25,30
Cowdenbeath,5389,10,4,11,21,24,55,-31,23
Peterhead,5390,1,24,4,8,79,38,41,76
Montrose,5390,2,23,7,6,59,36,23,76
Stirling,5390,3,17,6,13,62,51,11,57
Stenhousem'r,5390,4,15,8,13,55,48,7,53
Clyde,5390,5,14,10,12,53,50,3,52
Elgin,5390,6,15,6,15,55,60,-5,51
Annan Athlet,5390,7,11,11,14,47,42,5,44
Berwick,5390,8,8,11,17,31,60,-29,35
Edinburgh Ci,5390,9,7,9,20,36,62,-26,30
Cowdenbeath,5390,10,5,10,21,24,54,-30,25
Montrose,5391,1,24,7,5,62,34,28,79
Peterhead,5391,2,24,4,8,79,39,40,76
Stenhousem'r,5391,3,16,8,12,56,46,10,56
Stirling,5391,4,16,6,14,60,52,8,54
Clyde,5391,5,15,9,12,54,48,6,54
Elgin,5391,6,14,6,16,53,63,-10,48
Annan Athlet,5391,7,11,12,13,47,41,6,45
Berwick,5391,8,8,10,18,29,61,-32,34
Edinburgh Ci,5391,9,7,9,20,37,62,-25,30
Cowdenbeath,5391,10,4,11,21,23,54,-31,23
Montrose,5392,1,24,7,5,62,36,26,79
Peterhead,5392,2,24,4,8,81,39,42,76
Stenhousem'r,5392,3,16,8,12,57,46,11,56
Stirling,5392,4,16,6,14,60,53,7,54
Clyde,5392,5,15,9,12,54,49,5,54
Elgin,5392,6,14,6,16,55,63,-8,48
Annan Athlet,5392,7,12,11,13,50,42,8,47
Berwick,5392,8,8,10,18,30,61,-31,34
Edinburgh Ci,5392,9,7,9,20,37,64,-27,30
Cowdenbeath,5392,10,4,10,22,24,57,-33,22
Montrose,5393,1,23,7,6,59,35,24,76
Peterhead,5393,2,23,4,9,77,40,37,73
Stenhousem'r,5393,3,16,8,12,57,46,11,56
Stirling,5393,4,16,6,14,60,53,7,54
Clyde,5393,5,14,9,13,54,52,2,51
Elgin,5393,6,15,6,15,54,60,-6,51
Annan Athlet,5393,7,11,12,13,47,41,6,45
Berwick,5393,8,9,10,17,33,61,-28,37
Edinburgh Ci,5393,9,8,9,19,38,60,-22,33
Cowdenbeath,5393,10,4,11,21,23,54,-31,23
Montrose,5394,1,23,8,5,60,35,25,77
Peterhead,5394,2,23,4,9,78,40,38,73
Stenhousem'r,5394,3,16,8,12,56,46,10,56
Stirling,5394,4,16,6,14,60,52,8,54
Clyde,5394,5,14,10,12,51,48,3,52
Elgin,5394,6,14,7,15,54,61,-7,49
Annan Athlet,5394,7,11,12,13,48,42,6,45
Berwick,5394,8,8,11,17,29,58,-29,35
Edinburgh Ci,5394,9,8,9,19,38,61,-23,33
Cowdenbeath,5394,10,4,11,21,24,55,-31,23
Montrose,5395,1,23,8,5,60,35,25,77
Peterhead,5395,2,24,4,8,78,38,40,76
Stirling,5395,3,16,7,13,63,54,9,55
Stenhousem'r,5395,4,15,9,12,58,49,9,54
Clyde,5395,5,14,9,13,52,50,2,51
Elgin,5395,6,14,7,15,54,61,-7,49
Annan Athlet,5395,7,12,11,13,48,41,7,47
Berwick,5395,8,9,10,17,31,59,-28,37
Edinburgh Ci,5395,9,7,9,20,36,61,-25,30
Cowdenbeath,5395,10,4,10,22,23,55,-32,22
Montrose,5396,1,23,8,5,61,36,25,77
Peterhead,5396,2,24,4,8,78,38,40,76
Stirling,5396,3,16,7,13,61,52,9,55
Stenhousem'r,5396,4,15,9,12,56,47,9,54
Clyde,5396,5,15,9,12,54,50,4,54
Elgin,5396,6,14,7,15,55,62,-7,49
Annan Athlet,5396,7,11,11,14,48,43,5,44
Berwick,5396,8,8,10,18,31,61,-30,34
Edinburgh Ci,5396,9,7,9,20,36,61,-25,30
Cowdenbeath,5396,10,5,10,21,25,55,-30,25
Montrose,5397,1,23,8,5,61,36,25,77
Peterhead,5397,2,24,4,8,85,39,46,76
Stenhousem'r,5397,3,16,8,12,57,46,11,56
Stirling,5397,4,16,6,14,60,53,7,54
Clyde,5397,5,14,9,13,52,50,2,51
Elgin,5397,6,14,7,15,55,62,-7,49
Annan Athlet,5397,7,11,11,14,47,46,1,44
Berwick,5397,8,9,10,17,31,59,-28,37
Edinburgh Ci,5397,9,7,9,20,37,68,-31,30
Cowdenbeath,5397,10,5,10,21,28,54,-26,25
Montrose,5398,1,23,8,5,60,35,25,77
Peterhead,5398,2,23,5,8,79,40,39,74
Stirling,5398,3,17,6,13,63,52,11,57
Stenhousem'r,5398,4,15,8,13,56,49,7,53
Clyde,5398,5,14,9,13,52,51,1,51
Elgin,5398,6,14,7,15,54,61,-7,49
Annan Athlet,5398,7,12,11,13,49,41,8,47
Berwick,5398,8,9,10,17,32,59,-27,37
Edinburgh Ci,5398,9,7,10,19,38,62,-24,31
Cowdenbeath,5398,10,4,10,22,23,56,-33,22
Montrose,5399,1,24,7,5,61,34,27,79
Peterhead,5399,2,24,4,8,84,42,42,76
Stenhousem'r,5399,3,16,8,12,57,47,10,56
Stirling,5399,4,16,6,14,61,53,8,54
Clyde,5399,5,14,9,13,51,50,1,51
Elgin,5399,6,14,6,16,53,62,-9,48
Annan Athlet,5399,7,11,11,14,47,42,5,44
Berwick,5399,8,9,10,17,31,58,-27,37
Edinburgh Ci,5399,9,7,9,20,40,67,-27,30
Cowdenbeath,5399,10,5,10,21,24,54,-30,25
Montrose,5400,1,24,7,5,61,34,27,79
Peterhead,5400,2,24,4,8,81,41,40,76
Stirling,5400,3,17,6,13,63,52,11,57
Stenhousem'r,5400,4,15,8,13,56,49,7,53
Clyde,5400,5,14,10,12,52,49,3,52
Elgin,5400,6,14,6,16,53,62,-9,48
Annan Athlet,5400,7,12,11,13,49,42,7,47
Berwick,5400,8,8,11,17,30,59,-29,35
Edinburgh Ci,5400,9,7,9,20,39,64,-25,30
Cowdenbeath,5400,10,4,10,22,24,56,-32,22
Montrose,5401,1,24,7,5,60,34,26,79
Peterhead,5401,2,23,5,8,78,39,39,74
Stirling,5401,3,17,6,13,63,53,10,57
Stenhousem'r,5401,4,15,8,13,57,49,8,53
Clyde,5401,5,14,9,13,51,49,2,51
Elgin,5401,6,14,6,16,53,61,-8,48
Annan Athlet,5401,7,12,11,13,49,42,7,47
Berwick,5401,8,9,10,17,30,58,-28,37
Edinburgh Ci,5401,9,7,10,19,37,61,-24,31
Cowdenbeath,5401,10,4,10,22,24,56,-32,22
Peterhead,5402,1,24,4,8,79,38,41,76
Montrose,5402,2,23,7,6,59,36,23,76
Stenhousem'r,5402,3,16,8,12,58,48,10,56
Stirling,5402,4,16,6,14,62,54,8,54
Clyde,5402,5,15,9,12,53,48,5,54
Elgin,5402,6,15,6,15,55,60,-5,51
Annan Athlet,5402,7,11,11,14,47,42,5,44
Berwick,5402,8,8,10,18,29,60,-31,34
Edinburgh Ci,5402,9,7,9,20,36,62,-26,30
Cowdenbeath,5402,10,5,10,21,24,54,-30,25
Montrose,5403,1,24,7,5,62,34,28,79
Peterhead,5403,2,24,4,8,82,39,43,76
Stenhousem'r,5403,3,16,8,12,58,47,11,56
Stirling,5403,4,16,6,14,61,54,7,54
Clyde,5403,5,14,10,12,51,48,3,52
Elgin,5403,6,14,6,16,53,63,-10,48
Annan Athlet,5403,7,12,11,13,48,41,7,47
Berwick,5403,8,8,11,17,29,58,-29,35
Edinburgh Ci,5403,9,7,9,20,37,65,-28,30
Cowdenbeath,5403,10,4,10,22,23,55,-32,22
Montrose,5404,1,23,8,5,60,35,25,77
Peterhead,5404,2,24,4,8,79,39,40,76
Stirling,5404,3,16,7,13,60,51,9,55
Stenhousem'r,5404,4,15,9,12,55,46,9,54
Clyde,5404,5,15,9,12,53,48,5,54
Elgin,5404,6,14,7,15,54,61,-7,49
Annan Athlet,5404,7,11,12,13,48,42,6,45
Berwick,5404,8,8,10,18,29,60,-31,34
Edinburgh Ci,5404,9,7,9,20,37,62,-25,30
Cowdenbeath,5404,10,4,11,21,24,55,-31,23
Montrose,5405,1,24,7,5,62,34,28,79
Peterhead,5405,2,24,4,8,79,38,41,76
Stirling,5405,3,17,6,13,62,51,11,57
Stenhousem'r,5405,4,15,8,13,55,48,7,53
Clyde,5405,5,14,9,13,51,49,2,51
Elgin,5405,6,14,6,16,53,63,-10,48
Annan Athlet,5405,7,12,11,13,49,41,8,47
Berwick,5405,8,9,10,17,30,58,-28,37
Edinburgh Ci,5405,9,7,9,20,36,62,-26,30
Cowdenbeath,5405,10,4,10,22,23,56,-33,22
Montrose,5406,1,23,8,5,60,35,25,77
Peterhead,5406,2,24,4,8,82,38,44,76
Stirling,5406,3,17,6,13,63,52,11,57
Clyde,5406,4,15,9,12,53,49,4,54
Stenhousem'r,5406,5,15,8,13,56,49,7,53
Elgin,5406,6,14,7,15,54,61,-7,49
Annan Athlet,5406,7,11,11,14,47,42,5,44
Berwick,5406,8,8,10,18,30,60,-30,34
Edinburgh Ci,5406,9,7,9,20,36,65,-29,30
Cowdenbeath,5406,10,5,10,21,24,54,-30,25
Montrose,5407,1,24,7,5,63,35,28,79
Peterhead,5407,2,24,4,8,82,39,43,76
Stenhousem'r,5407,3,16,8,12,57,47,10,56
Stirling,5407,4,16,6,14,61,53,8,54
Clyde,5407,5,15,9,12,52,48,4,54
Elgin,5407,6,14,6,16,54,64,-10,48
Annan Athlet,5407,7,11,12,13,48,42,6,45
Berwick,5407,8,8,10,18,29,59,-30,34
Edinburgh Ci,5407,9,7,9,20,37,65,-28,30
Cowdenbeath,5407,10,4,11,21,24,55,-31,23
Montrose,5408,1,23,7,6,61,37,24,76
Peterhead,5408,2,23,4,9,78,41,37,73
Stenhousem'r,5408,3,16,8,12,58,48,10,56
Stirling,5408,4,16,6,14,62,54,8,54
Clyde,5408,5,15,9,12,55,49,6,54
Elgin,5408,6,15,6,15,56,62,-6,51
Annan Athlet,5408,7,11,12,13,49,43,6,45
Berwick,5408,8,8,10,18,30,62,-32,34
Edinburgh Ci,5408,9,8,9,19,39,61,-22,33
Cowdenbeath,5408,10,4,11,21,25,56,-31,23
Montrose,5409,1,24,7,5,61,34,27,79
Peterhead,5409,2,24,4,8,82,40,42,76
Stirling,5409,3,16,7,13,61,52,9,55
Stenhousem'r,5409,4,15,9,12,56,47,9,54
Clyde,5409,5,15,9,12,54,48,6,54
Elgin,5409,6,14,6,16,53,62,-9,48
Annan Athlet,5409,7,11,12,13,47,41,6,45
Berwick,5409,8,8,10,18,29,61,-32,34
Edinburgh Ci,5409,9,7,9,20,38,65,-27,30
Cowdenbeath,5409,10,4,11,21,23,54,-31,23
Montrose,5410,1,23,7,6,60,36,24,76
Peterhead,5410,2,23,4,9,79,41,38,73
Stirling,5410,3,17,6,13,68,52,16,57
Clyde,5410,4,15,9,12,54,49,5,54
Stenhousem'r,5410,5,15,8,13,56,54,2,53
Elgin,5410,6,15,6,15,55,61,-6,51
Annan Athlet,5410,7,12,11,13,48,41,7,47
Berwick,5410,8,8,10,18,30,61,-31,34
Edinburgh Ci,5410,9,8,9,19,39,62,-23,33
Cowdenbeath,5410,10,4,10,22,23,55,-32,22
Montrose,5411,1,24,7,5,61,34,27,79
Peterhead,5411,2,23,5,8,79,40,39,74
Stirling,5411,3,17,6,13,64,51,13,57
Clyde,5411,4,15,9,12,54,49,5,54
Stenhousem'r,5411,5,15,8,13,55,50,5,53
Elgin,5411,6,14,6,16,53,62,-9,48
Annan Athlet,5411,7,12,11,13,49,42,7,47
Berwick,5411,8,8,10,18,30,61,-31,34
Edinburgh Ci,5411,9,7,10,19,38,62,-24,31
Cowdenbeath,5411,10,4,10,22,24,56,-32,22
Montrose,5412,1,24,7,5,63,34,29,79
Peterhead,5412,2,24,4,8,78,38,40,76
Stenhousem'r,5412,3,16,8,12,58,48,10,56
Stirling,5412,4,16,6,14,62,54,8,54
Clyde,5412,5,15,9,12,54,49,5,54
Elgin,5412,6,14,6,16,53,64,-11,48
Annan Athlet,5412,7,11,11,14,47,42,5,44
Berwick,5412,8,8,10,18,30,61,-31,34
Edinburgh Ci,5412,9,7,9,20,36,61,-25,30
Cowdenbeath,5412,10,5,10,21,24,54,-30,25
Montrose,5413,1,23,8,5,61,36,25,77
Peterhead,5413,2,24,4,8,78,38,40,76
Stirling,5413,3,16,7,13,61,52,9,55
Stenhousem'r,5413,4,15,9,12,56,47,9,54
Clyde,5413,5,15,9,12,54,50,4,54
Elgin,5413,6,14,7,15,55,62,-7,49
Annan Athlet,5413,7,11,11,14,47,42,5,44
Berwick,5413,8,8,10,18,31,61,-30,34
Edinburgh Ci,5413,9,7,9,20,36,61,-25,30
Cowdenbeath,5413,10,5,10,21,24,54,-30,25
Montrose,5414,1,24,7,5,62,35,27,79
Peterhead,5414,2,23,5,8,79,40,39,74
Stirling,5414,3,16,7,13,62,53,9,55
Stenhousem'r,5414,4,15,9,12,57,48,9,54
Clyde,5414,5,14,10,12,53,50,3,52
Elgin,5414,6,14,6,16,54,63,-9,48
Annan Athlet,5414,7,12,11,13,48,41,7,47
Berwick,5414,8,8,11,17,31,60,-29,35
Edinburgh Ci,5414,9,7,10,19,38,62,-24,31
Cowdenbeath,5414,10,4,10,22,23,55,-32,22
Montrose,5415,1,23,8,5,62,37,25,77
Peterhead,5415,2,24,4,8,83,39,44,76
Stirling,5415,3,17,6,13,63,53,10,57
Stenhousem'r,5415,4,15,8,13,57,49,8,53
Clyde,5415,5,14,9,13,51,50,1,51
Elgin,5415,6,14,7,15,56,63,-7,49
Annan Athlet,5415,7,12,11,13,49,42,7,47
Berwick,5415,8,9,10,17,31,58,-27,37
Edinburgh Ci,5415,9,7,9,20,37,66,-29,30
Cowdenbeath,5415,10,4,10,22,24,56,-32,22
Montrose,5416,1,23,8,5,59,34,25,77
Peterhead,5416,2,23,5,8,80,41,39,74
Stirling,5416,3,16,7,13,61,52,9,55
Stenhousem'r,5416,4,15,9,12,56,47,9,54
Clyde,5416,5,15,9,12,55,48,7,54
Elgin,5416,6,14,7,15,53,60,-7,49
Annan Athlet,5416,7,12,11,13,50,42,8,47
Berwick,5416,8,8,10,18,29,62,-33,34
Edinburgh Ci,5416,9,7,10,19,39,63,-24,31
Cowdenbeath,5416,10,4,10,22,24,57,-33,22
Peterhead,5417,1,24,4,8,80,40,40,76
Montrose,5417,2,23,7,6,59,35,24,76
Stirling,5417,3,17,6,13,61,51,10,57
Clyde,5417,4,15,9,12,54,49,5,54
Stenhousem'r,5417,5,15,8,13,55,47,8,53
Elgin,5417,6,15,6,15,54,60,-6,51
Annan Athlet,5417,7,11,11,14,47,43,4,44
Berwick,5417,8,8,10,18,30,61,-31,34
Edinburgh Ci,5417,9,7,9,20,38,63,-25,30
Cowdenbeath,5417,10,5,10,21,25,54,-29,25
Montrose,5418,1,24,7,5,61,34,27,79
Peterhead,5418,2,24,4,8,79,38,41,76
Stirling,5418,3,17,6,13,63,51,12,57
Stenhousem'r,5418,4,15,8,13,55,49,6,53
Clyde,5418,5,14,10,12,53,50,3,52
Elgin,5418,6,14,6,16,53,62,-9,48
Annan Athlet,5418,7,11,12,13,47,41,6,45
Berwick,5418,8,8,11,17,31,60,-29,35
Edinburgh Ci,5418,9,7,9,20,36,62,-26,30
Cowdenbeath,5418,10,4,11,21,23,54,-31,23
Montrose,5419,1,24,7,5,62,34,28,79
Peterhead,5419,2,24,4,8,79,38,41,76
Stirling,5419,3,16,7,13,62,53,9,55
Stenhousem'r,5419,4,15,9,12,57,48,9,54
Clyde,5419,5,15,9,12,53,49,4,54
Elgin,5419,6,14,6,16,53,63,-10,48
Annan Athlet,5419,7,11,11,14,47,43,4,44
Berwick,5419,8,8,10,18,30,60,-30,34
Edinburgh Ci,5419,9,7,9,20,36,62,-26,30
Cowdenbeath,5419,10,5,10,21,25,54,-29,25
Montrose,5420,1,24,7,5,62,35,27,79
Peterhead,5420,2,24,4,8,79,39,40,76
Stirling,5420,3,17,6,13,61,51,10,57
Stenhousem'r,5420,4,15,8,13,55,47,8,53
Clyde,5420,5,14,10,12,52,49,3,52
Elgin,5420,6,14,6,16,54,63,-9,48
Annan Athlet,5420,7,11,11,14,48,43,5,44
Berwick,5420,8,8,11,17,30,59,-29,35
Edinburgh Ci,5420,9,7,9,20,37,62,-25,30
Cowdenbeath,5420,10,5,10,21,25,55,-30,25
Montrose,5421,1,23,8,5,62,37,25,77
Peterhead,5421,2,24,4,8,79,39,40,76
Stenhousem'r,5421,3,16,8,12,58,48,10,56
Stirling,5421,4,16,6,14,62,54,8,54
Clyde,5421,5,14,10,12,52,49,3,52
Elgin,5421,6,14,7,15,56,63,-7,49
Annan Athlet,5421,7,11,11,14,47,43,4,44
Berwick,5421,8,8,11,17,30,59,-29,35
Edinburgh Ci,5421,9,7,9,20,37,62,-25,30
Cowdenbeath,5421,10,5,10,21,25,54,-29,25
Montrose,5422,1,24,7,5,61,34,27,79
Peterhead,5422,2,24,4,8,80,38,42,76
Stirling,5422,3,16,7,13,60,51,9,55
Stenhousem'r,5422,4,15,9,12,55,46,9,54
Clyde,5422,5,15,9,12,53,48,5,54
Elgin,5422,6,14,6,16,53,62,-9,48
Annan Athlet,5422,7,11,11,14,47,42,5,44
Berwick,5422,8,8,10,18,29,60,-31,34
Edinburgh Ci,5422,9,7,9,20,36,63,-27,30
Cowdenbeath,5422,10,5,10,21,24,54,-30,25
Montrose,5423,1,24,7,5,62,35,27,79
Peterhead,5423,2,23,5,8,78,39,39,74
Stirling,5423,3,17,6,13,64,52,12,57
Clyde,5423,4,15,9,12,55,48,7,54
Stenhousem'r,5423,5,15,8,13,56,50,6,53
Elgin,5423,6,14,6,16,54,63,-9,48
Annan Athlet,5423,7,12,11,13,48,41,7,47
Berwick,5423,8,8,10,18,29,62,-33,34
Edinburgh Ci,5423,9,7,10,19,37,61,-24,31
Cowdenbeath,5423,10,4,10,22,23,55,-32,22
Montrose,5424,1,23,7,6,59,37,22,76
Peterhead,5424,2,23,4,9,79,42,37,73
Stirling,5424,3,17,6,13,65,53,12,57
Clyde,5424,4,15,9,12,53,48,5,54
Stenhousem'r,5424,5,15,8,13,57,51,6,53
Elgin,5424,6,15,6,15,56,60,-4,51
Annan Athlet,5424,7,12,11,13,49,42,7,47
Berwick,5424,8,8,10,18,29,60,-31,34
Edinburgh Ci,5424,9,8,9,19,40,62,-22,33
Cowdenbeath,5424,10,4,10,22,24,56,-32,22
Montrose,5425,1,24,7,5,62,35,27,79
Peterhead,5425,2,23,4,9,78,40,38,73
Stirling,5425,3,17,6,13,62,51,11,57
Clyde,5425,4,15,9,12,56,48,8,54
Stenhousem'r,5425,5,15,8,13,55,48,7,53
Elgin,5425,6,14,6,16,54,63,-9,48
Annan Athlet,5425,7,11,11,14,47,42,5,44
Berwick,5425,8,8,10,18,29,63,-34,34
Edinburgh Ci,5425,9,8,9,19,38,61,-23,33
Cowdenbeath,5425,10,5,10,21,24,54,-30,25
Montrose,5426,1,24,7,5,62,35,27,79
Peterhead,5426,2,24,4,8,85,38,47,76
Stirling,5426,3,17,6,13,62,51,11,57
Clyde,5426,4,15,9,12,53,49,4,54
Stenhousem'r,5426,5,15,8,13,55,48,7,53
Elgin,5426,6,14,6,16,54,63,-9,48
Annan Athlet,5426,7,12,11,13,50,43,7,47
Berwick,5426,8,8,10,18,30,60,-30,34
Edinburgh Ci,5426,9,7,9,20,36,68,-32,30
Cowdenbeath,5426,10,4,10,22,25,57,-32,22
Peterhead,5427,1,24,4,8,79,39,40,76
Montrose,5427,2,23,7,6,59,37,22,76
Stirling,5427,3,16,7,13,62,53,9,55
Stenhousem'r,5427,4,15,9,12,57,48,9,54
Clyde,5427,5,14,10,12,51,48,3,52
Elgin,5427,6,15,6,15,56,60,-4,51
Annan Athlet,5427,7,11,12,13,48,42,6,45
Berwick,5427,8,8,11,17,29,58,-29,35
Edinburgh Ci,5427,9,7,9,20,37,62,-25,30
Cowdenbeath,5427,10,4,11,21,24,55,-31,23
Montrose,5428,1,23,7,6,61,37,24,76
Peterhead,5428,2,23,5,8,79,40,39,74
Stirling,5428,3,16,7,13,62,53,9,55
Stenhousem'r,5428,4,15,9,12,57,48,9,54
Clyde,5428,5,15,9,12,53,48,5,54
Elgin,5428,6,15,6,15,56,62,-6,51
Annan Athlet,5428,7,11,12,13,48,42,6,45
Berwick,5428,8,8,10,18,29,60,-31,34
Edinburgh Ci,5428,9,7,10,19,38,62,-24,31
Cowdenbeath,5428,10,4,11,21,24,55,-31,23
Peterhead,5429,1,24,4,8,80,39,41,76
Montrose,5429,2,23,7,6,60,37,23,76
Stirling,5429,3,17,6,13,66,51,15,57
Clyde,5429,4,15,9,12,52,48,4,54
Stenhousem'r,5429,5,15,8,13,55,52,3,53
Elgin,5429,6,15,6,15,56,61,-5,51
Annan Athlet,5429,7,11,11,14,47,42,5,44
Berwick,5429,8,8,10,18,29,59,-30,34
Edinburgh Ci,5429,9,7,9,20,37,63,-26,30
Cowdenbeath,5429,10,5,10,21,24,54,-30,25
Peterhead,5430,1,24,4,8,81,40,41,76
Montrose,5430,2,23,7,6,59,35,24,76
Stirling,5430,3,17,6,13,61,51,10,57
Clyde,5430,4,15,9,12,52,48,4,54
Stenhousem'r,5430,5,15,8,13,55,47,8,53
Elgin,5430,6,15,6,15,54,60,-6,51
Annan Athlet,5430,7,12,11,13,49,41,8,47
Berwick,5430,8,8,10,18,29,59,-30,34
Edinburgh Ci,5430,9,7,9,20,38,64,-26,30
Cowdenbeath,5430,10,4,10,22,23,56,-33,22
Montrose,5431,1,23,8,5,59,34,25,77
Peterhead,5431,2,24,4,8,79,38,41,76
Stenhousem'r,5431,3,16,8,12,58,46,12,56
Stirling,5431,4,16,6,14,60,54,6,54
Clyde,5431,5,14,9,13,51,51,0,51
Elgin,5431,6,14,7,15,53,60,-7,49
Annan Athlet,5431,7,11,11,14,47,43,4,44
Berwick,5431,8,9,10,17,32,58,-26,37
Edinburgh Ci,5431,9,7,9,20,36,62,-26,30
Cowdenbeath,5431,10,5,10,21,25,54,-29,25
Montrose,5432,1,24,7,5,64,34,30,79
Peterhead,5432,2,24,4,8,78,38,40,76
Stirling,5432,3,16,7,13,62,53,9,55
Stenhousem'r,5432,4,15,9,12,57,48,9,54
Clyde,5432,5,15,9,12,53,49,4,54
Elgin,5432,6,14,6,16,53,65,-12,48
Annan Athlet,5432,7,11,12,13,47,41,6,45
Berwick,5432,8,8,10,18,30,60,-30,34
Edinburgh Ci,5432,9,7,9,20,36,61,-25,30
Cowdenbeath,5432,10,4,11,21,23,54,-31,23
Montrose,5433,1,23,7,6,59,37,22,76
Peterhead,5433,2,23,5,8,77,38,39,74
Stirling,5433,3,16,7,13,62,53,9,55
Stenhousem'r,5433,4,15,9,12,57,48,9,54
Clyde,5433,5,15,9,12,54,48,6,54
Elgin,5433,6,15,6,15,56,60,-4,51
Annan Athlet,5433,7,12,11,13,51,42,9,47
Berwick,5433,8,8,10,18,29,61,-32,34
Edinburgh Ci,5433,9,7,10,19,36,60,-24,31
Cowdenbeath,5433,10,4,10,22,24,58,-34,22
Montrose,5434,1,23,8,5,59,34,25,77
Peterhead,5434,2,24,4,8,79,39,40,76
Stirling,5434,3,16,7,13,63,54,9,55
Stenhousem'r,5434,4,15,9,12,58,49,9,54
Clyde,5434,5,15,9,12,53,49,4,54
Elgin,5434,6,14,7,15,53,60,-7,49
Annan Athlet,5434,7,11,12,13,48,42,6,45
Berwick,5434,8,8,10,18,30,60,-30,34
Edinburgh Ci,5434,9,7,9,20,37,62,-25,30
Cowdenbeath,5434,10,4,11,21,24,55,-31,23
Montrose,5435,1,24,7,5,63,37,26,79
Peterhead,5435,2,24,4,8,83,39,44,76
Stirling,5435,3,16,7,13,60,51,9,55
Stenhousem'r,5435,4,15,9,12,55,46,9,54
Clyde,5435,5,15,9,12,53,49,4,54
Elgin,5435,6,14,6,16,56,64,-8,48
Annan Athlet,5435,7,11,12,13,47,41,6,45
Berwick,5435,8,8,10,18,30,60,-30,34
Edinburgh Ci,5435,9,7,9,20,37,66,-29,30
Cowdenbeath,5435,10,4,11,21,23,54,-31,23
Montrose,5436,1,24,7,5,60,34,26,79
Peterhead,5436,2,24,4,8,79,39,40,76
Stirling,5436,3,16,7,13,63,54,9,55
Stenhousem'r,5436,4,15,9,12,58,49,9,54
Clyde,5436,5,15,9,12,52,48,4,54
Elgin,5436,6,14,6,16,53,61,-8,48
Annan Athlet,5436,7,11,12,13,47,41,6,45
Berwick,5436,8,8,10,18,29,59,-30,34
Edinburgh Ci,5436,9,7,9,20,37,62,-25,30
Cowdenbeath,5436,10,4,11,21,23,54,-31,23
Montrose,5437,1,24,7,5,61,35,26,79
Peterhead,5437,2,24,4,8,80,39,41,76
Stirling,5437,3,17,6,13,63,51,12,57
Clyde,5437,4,15,9,12,52,48,4,54
Stenhousem'r,5437,5,15,8,13,55,49,6,53
Elgin,5437,6,14,6,16,54,62,-8,48
Annan Athlet,5437,7,11,11,14,48,43,5,44
Berwick,5437,8,8,10,18,29,59,-30,34
Edinburgh Ci,5437,9,7,9,20,37,63,-26,30
Cowdenbeath,5437,10,5,10,21,25,55,-30,25
Montrose,5438,1,24,7,5,63,35,28,79
Peterhead,5438,2,24,4,8,80,38,42,76
Stirling,5438,3,17,6,13,61,51,10,57
Clyde,5438,4,15,9,12,53,49,4,54
Stenhousem'r,5438,5,15,8,13,55,47,8,53
Elgin,5438,6,14,6,16,54,64,-10,48
Annan Athlet,5438,7,11,12,13,48,42,6,45
Berwick,5438,8,8,10,18,30,60,-30,34
Edinburgh Ci,5438,9,7,9,20,36,63,-27,30
Cowdenbeath,5438,10,4,11,21,24,55,-31,23
Montrose,5439,1,23,8,5,59,34,25,77
Peterhead,5439,2,24,4,8,80,39,41,76
Stirling,5439,3,16,7,13,63,54,9,55
Stenhousem'r,5439,4,15,9,12,58,49,9,54
Clyde,5439,5,15,9,12,53,49,4,54
Elgin,5439,6,14,7,15,53,60,-7,49
Annan Athlet,5439,7,12,11,13,51,42,9,47
Berwick,5439,8,8,10,18,30,60,-30,34
Edinburgh Ci,5439,9,7,9,20,37,63,-26,30
Cowdenbeath,5439,10,4,10,22,24,58,-34,22
Montrose,5440,1,23,8,5,60,35,25,77
Peterhead,5440,2,23,5,8,77,38,39,74
Stirling,5440,3,17,6,13,62,52,10,57
Stenhousem'r,5440,4,15,8,13,56,48,8,53
Clyde,5440,5,14,10,12,53,50,3,52
Elgin,5440,6,14,7,15,54,61,-7,49
Annan Athlet,5440,7,11,11,14,47,42,5,44
Berwick,5440,8,8,11,17,31,60,-29,35
Edinburgh Ci,5440,9,7,10,19,36,60,-24,31
Cowdenbeath,5440,10,5,10,21,24,54,-30,25
Montrose,5441,1,24,7,5,61,34,27,79
Peterhead,5441,2,23,5,8,77,38,39,74
Stirling,5441,3,17,6,13,62,52,10,57
Stenhousem'r,5441,4,15,8,13,56,48,8,53
Clyde,5441,5,14,9,13,52,51,1,51
Elgin,5441,6,14,6,16,53,62,-9,48
Annan Athlet,5441,7,12,11,13,49,42,7,47
Berwick,5441,8,9,10,17,32,59,-27,37
Edinburgh Ci,5441,9,7,10,19,36,60,-24,31
Cowdenbeath,5441,10,4,10,22,24,56,-32,22
Montrose,5442,1,24,7,5,62,36,26,79
Peterhead,5442,2,24,4,8,79,38,41,76
Stenhousem'r,5442,3,16,8,12,57,47,10,56
Stirling,5442,4,16,6,14,61,53,8,54
Clyde,5442,5,15,9,12,54,49,5,54
Elgin,5442,6,14,6,16,55,63,-8,48
Annan Athlet,5442,7,12,11,13,50,41,9,47
Berwick,5442,8,8,10,18,30,61,-31,34
Edinburgh Ci,5442,9,7,9,20,36,62,-26,30
Cowdenbeath,5442,10,4,10,22,23,57,-34,22
Montrose,5443,1,24,7,5,60,34,26,79
Peterhead,5443,2,24,4,8,81,39,42,76
Stirling,5443,3,17,6,13,61,51,10,57
Stenhousem'r,5443,4,15,8,13,55,47,8,53
Clyde,5443,5,14,10,12,51,48,3,52
Elgin,5443,6,14,6,16,53,61,-8,48
Annan Athlet,5443,7,12,11,13,48,41,7,47
Berwick,5443,8,8,11,17,29,58,-29,35
Edinburgh Ci,5443,9,7,9,20,37,64,-27,30
Cowdenbeath,5443,10,4,10,22,23,55,-32,22
Montrose,5444,1,23,8,5,61,36,25,77
Peterhead,5444,2,23,5,8,79,40,39,74
Stirling,5444,3,16,7,13,62,53,9,55
Stenhousem'r,5444,4,15,9,12,57,48,9,54
Clyde,5444,5,14,10,12,53,50,3,52
Elgin,5444,6,14,7,15,55,62,-7,49
Annan Athlet,5444,7,12,11,13,48,41,7,47
Berwick,5444,8,8,11,17,31,60,-29,35
Edinburgh Ci,5444,9,7,10,19,38,62,-24,31
Cowdenbeath,5444,10,4,10,22,23,55,-32,22
Peterhead,5445,1,24,4,8,82,38,44,76
Montrose,5445,2,23,7,6,59,35,24,76
Stirling,5445,3,17,6,13,63,52,11,57
Stenhousem'r,5445,4,15,8,13,56,49,7,53
Clyde,5445,5,14,9,13,51,51,0,51
Elgin,5445,6,15,6,15,54,60,-6,51
Annan Athlet,5445,7,12,11,13,50,43,7,47
Berwick,5445,8,9,10,17,32,58,-26,37
Edinburgh Ci,5445,9,7,9,20,36,65,-29,30
Cowdenbeath,5445,10,4,10,22,25,57,-32,22
Montrose,5446,1,24,7,5,61,35,26,79
Peterhead,5446,2,24,4,8,79,38,41,76
Stirling,5446,3,17,6,13,62,52,10,57
Stenhousem'r,5446,4,15,8,13,56,48,8,53
Clyde,5446,5,14,9,13,53,51,2,51
Elgin,5446,6,14,6,16,54,62,-8,48
Annan Athlet,5446,7,11,11,14,47,43,4,44
Berwick,5446,8,9,10,17,32,60,-28,37
Edinburgh Ci,5446,9,7,9,20,36,62,-26,30
Cowdenbeath,5446,10,5,10,21,25,54,-29,25
Montrose,5447,1,23,8,5,62,37,25,77
Peterhead,5447,2,24,4,8,79,38,41,76
Stenhousem'r,5447,3,16,8,12,57,46,11,56
Stirling,5447,4,16,6,14,60,53,7,54
Clyde,5447,5,14,9,13,52,50,2,51
Elgin,5447,6,14,7,15,56,63,-7,49
Annan Athlet,5447,7,12,11,13,48,41,7,47
Berwick,5447,8,9,10,17,31,59,-28,37
Edinburgh Ci,5447,9,7,9,20,36,62,-26,30
Cowdenbeath,5447,10,4,10,22,23,55,-32,22
Montrose,5448,1,24,7,5,62,35,27,79
Peterhead,5448,2,24,4,8,78,38,40,76
Stirling,5448,3,16,7,13,61,52,9,55
Stenhousem'r,5448,4,15,9,12,56,47,9,54
Clyde,5448,5,15,9,12,53,49,4,54
Elgin,5448,6,14,6,16,54,63,-9,48
Annan Athlet,5448,7,11,11,14,47,42,5,44
Berwick,5448,8,8,10,18,30,60,-30,34
Edinburgh Ci,5448,9,7,9,20,36,61,-25,30
Cowdenbeath,5448,10,5,10,21,24,54,-30,25
Montrose,5449,1,24,7,5,60,34,26,79
Peterhead,5449,2,23,5,8,79,40,39,74
Stirling,5449,3,17,6,13,62,52,10,57
Stenhousem'r,5449,4,15,8,13,56,48,8,53
Clyde,5449,5,14,9,13,52,50,2,51
Elgin,5449,6,14,6,16,53,61,-8,48
Annan Athlet,5449,7,12,11,13,48,41,7,47
Berwick,5449,8,9,10,17,31,59,-28,37
Edinburgh Ci,5449,9,7,10,19,38,62,-24,31
Cowdenbeath,5449,10,4,10,22,23,55,-32,22
Montrose,5450,1,23,8,5,60,35,25,77
Peterhead,5450,2,24,4,8,80,39,41,76
Stirling,5450,3,17,6,13,62,52,10,57
Clyde,5450,4,15,9,12,54,48,6,54
Stenhousem'r,5450,5,15,8,13,56,48,8,53
Elgin,5450,6,14,7,15,54,61,-7,49
Annan Athlet,5450,7,12,11,13,48,41,7,47
Berwick,5450,8,8,10,18,29,61,-32,34
Edinburgh Ci,5450,9,7,9,20,37,63,-26,30
Cowdenbeath,5450,10,4,10,22,23,55,-32,22
Montrose,5451,1,24,7,5,64,36,28,79
Peterhead,5451,2,23,5,8,78,39,39,74
Stirling,5451,3,16,7,13,61,52,9,55
Stenhousem'r,5451,4,15,9,12,56,47,9,54
Clyde,5451,5,15,9,12,54,48,6,54
Elgin,5451,6,14,6,16,55,65,-10,48
Annan Athlet,5451,7,12,11,13,49,41,8,47
Berwick,5451,8,8,10,18,29,61,-32,34
Edinburgh Ci,5451,9,7,10,19,37,61,-24,31
Cowdenbeath,5451,10,4,10,22,23,56,-33,22
Montrose,5452,1,24,7,5,62,36,26,79
Peterhead,5452,2,24,4,8,80,38,42,76
Stirling,5452,3,16,7,13,61,52,9,55
Stenhousem'r,5452,4,15,9,12,56,47,9,54
Clyde,5452,5,15,9,12,54,48,6,54
Elgin,5452,6,14,6,16,55,63,-8,48
Annan Athlet,5452,7,12,11,13,49,42,7,47
Berwick,5452,8,8,10,18,29,61,-32,34
Edinburgh Ci,5452,9,7,9,20,36,63,-27,30
Cowdenbeath,5452,10,4,10,22,24,56,-32,22
Montrose,5453,1,24,7,5,63,34,29,79
Peterhead,5453,2,24,4,8,80,39,41,76
Stenhousem'r,5453,3,16,8,12,56,46,10,56
Stirling,5453,4,16,6,14,60,52,8,54
Clyde,5453,5,15,9,12,54,48,6,54
Elgin,5453,6,14,6,16,53,64,-11,48
Annan Athlet,5453,7,11,12,13,48,42,6,45
Berwick,5453,8,8,10,18,29,61,-32,34
Edinburgh Ci,5453,9,7,9,20,37,63,-26,30
Cowdenbeath,5453,10,4,11,21,24,55,-31,23
Montrose,5454,1,24,7,5,62,34,28,79
Peterhead,5454,2,23,5,8,79,40,39,74
Stirling,5454,3,17,6,13,62,52,10,57
Clyde,5454,4,15,9,12,54,48,6,54
Stenhousem'r,5454,5,15,8,13,56,48,8,53
Elgin,5454,6,14,6,16,53,63,-10,48
Annan Athlet,5454,7,12,11,13,48,41,7,47
Berwick,5454,8,8,10,18,29,61,-32,34
Edinburgh Ci,5454,9,7,10,19,38,62,-24,31
Cowdenbeath,5454,10,4,10,22,23,55,-32,22
Montrose,5455,1,23,7,6,60,36,24,76
Peterhead,5455,2,23,5,8,78,39,39,74
Stenhousem'r,5455,3,16,8,12,57,47,10,56
Stirling,5455,4,16,6,14,61,53,8,54
Clyde,5455,5,14,10,12,53,50,3,52
Elgin,5455,6,15,6,15,55,61,-6,51
Annan Athlet,5455,7,12,11,13,49,42,7,47
Berwick,5455,8,8,11,17,31,60,-29,35
Edinburgh Ci,5455,9,7,10,19,37,61,-24,31
Cowdenbeath,5455,10,4,10,22,24,56,-32,22
Montrose,5456,1,24,7,5,60,34,26,79
Peterhead,5456,2,24,4,8,79,39,40,76
Stirling,5456,3,17,6,13,63,53,10,57
Clyde,5456,4,15,9,12,54,49,5,54
Stenhousem'r,5456,5,15,8,13,57,49,8,53
Elgin,5456,6,14,6,16,53,61,-8,48
Annan Athlet,5456,7,11,11,14,47,43,4,44
Berwick,5456,8,8,10,18,30,61,-31,34
Edinburgh Ci,5456,9,7,9,20,37,62,-25,30
Cowdenbeath,5456,10,5,10,21,25,54,-29,25
Montrose,5457,1,24,7,5,61,34,27,79
Peterhead,5457,2,24,4,8,80,38,42,76
Stenhousem'r,5457,3,16,8,12,56,46,10,56
Stirling,5457,4,16,6,14,60,52,8,54
Clyde,5457,5,15,9,12,53,48,5,54
Elgin,5457,6,14,6,16,53,62,-9,48
Annan Athlet,5457,7,11,12,13,48,42,6,45
Berwick,5457,8,8,10,18,29,60,-31,34
Edinburgh Ci,5457,9,7,9,20,36,63,-27,30
Cowdenbeath,5457,10,4,11,21,24,55,-31,23
Montrose,5458,1,24,7,5,61,35,26,79
Peterhead,5458,2,24,4,8,79,38,41,76
Stirling,5458,3,16,7,13,61,52,9,55
Stenhousem'r,5458,4,15,9,12,56,47,9,54
Clyde,5458,5,15,9,12,54,50,4,54
Elgin,5458,6,14,6,16,54,62,-8,48
Annan Athlet,5458,7,12,11,13,50,42,8,47
Berwick,5458,8,8,10,18,31,61,-30,34
Edinburgh Ci,5458,9,7,9,20,36,62,-26,30
Cowdenbeath,5458,10,4,10,22,24,57,-33,22
Peterhead,5459,1,24,4,8,81,38,43,76
Montrose,5459,2,23,7,6,61,37,24,76
Stirling,5459,3,17,6,13,62,51,11,57
Clyde,5459,4,15,9,12,52,48,4,54
Stenhousem'r,5459,5,15,8,13,55,48,7,53
Elgin,5459,6,15,6,15,56,62,-6,51
Annan Athlet,5459,7,11,11,14,48,43,5,44
Berwick,5459,8,8,10,18,29,59,-30,34
Edinburgh Ci,5459,9,7,9,20,36,64,-28,30
Cowdenbeath,5459,10,5,10,21,25,55,-30,25
Montrose,5460,1,24,7,5,66,35,31,79
Peterhead,5460,2,24,4,8,79,38,41,76
Stirling,5460,3,17,6,13,62,51,11,57
Clyde,5460,4,15,9,12,53,48,5,54
Stenhousem'r,5460,5,15,8,13,55,48,7,53
Elgin,5460,6,14,6,16,54,67,-13,48
Annan Athlet,5460,7,11,11,14,47,43,4,44
Berwick,5460,8,8,10,18,29,60,-31,34
Edinburgh Ci,5460,9,7,9,20,36,62,-26,30
Cowdenbeath,5460,10,5,10,21,25,54,-29,25
Montrose,5461,1,23,8,5,62,37,25,77
Peterhead,5461,2,24,4,8,80,38,42,76
Stirling,5461,3,17,6,13,62,51,11,57
Stenhousem'r,5461,4,15,8,13,55,48,7,53
Clyde,5461,5,14,9,13,52,50,2,51
Elgin,5461,6,14,7,15,56,63,-7,49
Annan Athlet,5461,7,12,11,13,51,41,10,47
Berwick,5461,8,9,10,17,31,59,-28,37
Edinburgh Ci,5461,9,7,9,20,36,63,-27,30
Cowdenbeath,5461,10,4,10,22,23,58,-35,22
Peterhead,5462,1,24,4,8,80,38,42,76
Montrose,5462,2,23,7,6,60,36,24,76
Stirling,5462,3,16,7,13,60,51,9,55
Stenhousem'r,5462,4,15,9,12,55,46,9,54
Clyde,5462,5,14,10,12,53,50,3,52
Elgin,5462,6,15,6,15,55,61,-6,51
Annan Athlet,5462,7,11,12,13,47,41,6,45
Berwick,5462,8,8,11,17,31,60,-29,35
Edinburgh Ci,5462,9,7,9,20,36,63,-27,30
Cowdenbeath,5462,10,4,11,21,23,54,-31,23
Peterhead,5463,1,24,4,8,79,38,41,76
Montrose,5463,2,23,7,6,59,35,24,76
Stenhousem'r,5463,3,16,8,12,57,47,10,56
Stirling,5463,4,16,6,14,61,53,8,54
Clyde,5463,5,14,9,13,52,50,2,51
Elgin,5463,6,15,6,15,54,60,-6,51
Annan Athlet,5463,7,11,12,13,48,42,6,45
Berwick,5463,8,9,10,17,31,59,-28,37
Edinburgh Ci,5463,9,7,9,20,36,62,-26,30
Cowdenbeath,5463,10,4,11,21,24,55,-31,23
Montrose,5464,1,24,7,5,63,35,28,79
Peterhead,5464,2,24,4,8,80,40,40,76
Stirling,5464,3,16,7,13,61,52,9,55
Stenhousem'r,5464,4,15,9,12,56,47,9,54
Clyde,5464,5,15,9,12,53,49,4,54
Elgin,5464,6,14,6,16,54,64,-10,48
Annan Athlet,5464,7,12,11,13,49,42,7,47
Berwick,5464,8,8,10,18,30,60,-30,34
Edinburgh Ci,5464,9,7,9,20,38,63,-25,30
Cowdenbeath,5464,10,4,10,22,24,56,-32,22
Montrose,5465,1,24,7,5,61,34,27,79
Peterhead,5465,2,23,4,9,77,39,38,73
Stirling,5465,3,17,6,13,62,52,10,57
Stenhousem'r,5465,4,15,8,13,56,48,8,53
Clyde,5465,5,14,10,12,52,49,3,52
Elgin,5465,6,14,6,16,53,62,-9,48
Annan Athlet,5465,7,11,12,13,48,42,6,45
Berwick,5465,8,8,11,17,30,59,-29,35
Edinburgh Ci,5465,9,8,9,19,37,60,-23,33
Cowdenbeath,5465,10,4,11,21,24,55,-31,23
Montrose,5466,1,24,7,5,63,34,29,79
Peterhead,5466,2,24,4,8,81,38,43,76
Stenhousem'r,5466,3,16,8,12,56,46,10,56
Stirling,5466,4,16,6,14,60,52,8,54
Clyde,5466,5,14,9,13,52,50,2,51
Elgin,5466,6,14,6,16,53,64,-11,48
Annan Athlet,5466,7,12,11,13,48,41,7,47
Berwick,5466,8,9,10,17,31,59,-28,37
Edinburgh Ci,5466,9,7,9,20,36,64,-28,30
Cowdenbeath,5466,10,4,10,22,23,55,-32,22
Montrose,5467,1,24,7,5,60,34,26,79
Peterhead,5467,2,23,5,8,79,40,39,74
Stenhousem'r,5467,3,16,8,12,57,47,10,56
Stirling,5467,4,16,6,14,61,53,8,54
Clyde,5467,5,14,9,13,51,49,2,51
Elgin,5467,6,14,6,16,53,61,-8,48
Annan Athlet,5467,7,12,11,13,48,41,7,47
Berwick,5467,8,9,10,17,30,58,-28,37
Edinburgh Ci,5467,9,7,10,19,38,62,-24,31
Cowdenbeath,5467,10,4,10,22,23,55,-32,22
Montrose,5468,1,24,7,5,60,34,26,79
Peterhead,5468,2,24,4,8,83,38,45,76
Stenhousem'r,5468,3,16,8,12,57,47,10,56
Stirling,5468,4,16,6,14,61,53,8,54
Clyde,5468,5,14,9,13,52,50,2,51
Elgin,5468,6,14,6,16,53,61,-8,48
Annan Athlet,5468,7,11,11,14,48,45,3,44
Berwick,5468,8,9,10,17,31,59,-28,37
Edinburgh Ci,5468,9,7,9,20,36,66,-30,30
Cowdenbeath,5468,10,5,10,21,27,55,-28,25
Montrose,5469,1,23,7,6,61,38,23,76
Peterhead,5469,2,23,5,8,77,38,39,74
Stirling,5469,3,16,7,13,60,51,9,55
Stenhousem'r,5469,4,15,9,12,55,46,9,54
Clyde,5469,5,15,9,12,52,48,4,54
Elgin,5469,6,15,6,15,57,62,-5,51
Annan Athlet,5469,7,12,11,13,50,41,9,47
Berwick,5469,8,8,10,18,29,59,-30,34
Edinburgh Ci,5469,9,7,10,19,36,60,-24,31
Cowdenbeath,5469,10,4,10,22,23,57,-34,22
Peterhead,5470,1,24,4,8,81,38,43,76
Montrose,5470,2,23,7,6,59,36,23,76
Stirling,5470,3,16,7,13,61,52,9,55
Stenhousem'r,5470,4,15,9,12,56,47,9,54
Clyde,5470,5,15,9,12,53,49,4,54
Elgin,5470,6,15,6,15,55,60,-5,51
Annan Athlet,5470,7,11,11,14,47,42,5,44
Berwick,5470,8,8,10,18,30,60,-30,34
Edinburgh Ci,5470,9,7,9,20,36,64,-28,30
Cowdenbeath,5470,10,5,10,21,24,54,-30,25
Montrose,5471,1,24,7,5,62,36,26,79
Peterhead,5471,2,24,4,8,79,38,41,76
Stirling,5471,3,17,6,13,64,52,12,57
Clyde,5471,4,15,9,12,53,48,5,54
Stenhousem'r,5471,5,15,8,13,56,50,6,53
Elgin,5471,6,14,6,16,55,63,-8,48
Annan Athlet,5471,7,11,11,14,48,44,4,44
Berwick,5471,8,8,10,18,29,60,-31,34
Edinburgh Ci,5471,9,7,9,20,36,62,-26,30
Cowdenbeath,5471,10,5,10,21,26,55,-29,25
Montrose,5472,1,24,7,5,62,36,26,79
Peterhead,5472,2,24,4,8,83,38,45,76
Stirling,5472,3,16,7,13,61,52,9,55
Stenhousem'r,5472,4,15,9,12,56,47,9,54
Clyde,5472,5,15,9,12,53,49,4,54
Elgin,5472,6,14,6,16,55,63,-8,48
Annan Athlet,5472,7,11,12,13,47,41,6,45
Berwick,5472,8,8,10,18,30,60,-30,34
Edinburgh Ci,5472,9,7,9,20,36,66,-30,30
Cowdenbeath,5472,10,4,11,21,23,54,-31,23
Montrose,5473,1,24,7,5,63,37,26,79
Peterhead,5473,2,24,4,8,81,38,43,76
Stenhousem'r,5473,3,16,8,12,57,46,11,56
Stirling,5473,4,16,6,14,60,53,7,54
Clyde,5473,5,15,9,12,54,49,5,54
Elgin,5473,6,14,6,16,56,64,-8,48
Annan Athlet,5473,7,11,12,13,48,42,6,45
Berwick,5473,8,8,10,18,30,61,-31,34
Edinburgh Ci,5473,9,7,9,20,36,64,-28,30
Cowdenbeath,5473,10,4,11,21,24,55,-31,23
Montrose,5474,1,23,7,6,60,36,24,76
Peterhead,5474,2,23,5,8,78,39,39,74
Stirling,5474,3,16,7,13,61,52,9,55
Stenhousem'r,5474,4,15,9,12,56,47,9,54
Clyde,5474,5,15,9,12,53,48,5,54
Elgin,5474,6,15,6,15,55,61,-6,51
Annan Athlet,5474,7,11,11,14,48,43,5,44
Berwick,5474,8,8,10,18,29,60,-31,34
Edinburgh Ci,5474,9,7,10,19,37,61,-24,31
Cowdenbeath,5474,10,5,10,21,25,55,-30,25
Montrose,5475,1,24,7,5,62,35,27,79
Peterhead,5475,2,24,4,8,81,39,42,76
Stirling,5475,3,16,7,13,61,52,9,55
Stenhousem'r,5475,4,15,9,12,56,47,9,54
Clyde,5475,5,15,9,12,53,48,5,54
Elgin,5475,6,14,6,16,54,63,-9,48
Annan Athlet,5475,7,12,11,13,48,41,7,47
Berwick,5475,8,8,10,18,29,60,-31,34
Edinburgh Ci,5475,9,7,9,20,37,64,-27,30
Cowdenbeath,5475,10,4,10,22,23,55,-32,22
Montrose,5476,1,24,7,5,63,34,29,79
Peterhead,5476,2,24,4,8,80,38,42,76
Stirling,5476,3,16,7,13,60,51,9,55
Stenhousem'r,5476,4,15,9,12,55,46,9,54
Clyde,5476,5,15,9,12,53,49,4,54
Elgin,5476,6,14,6,16,53,64,-11,48
Annan Athlet,5476,7,12,11,13,50,42,8,47
Berwick,5476,8,8,10,18,30,60,-30,34
Edinburgh Ci,5476,9,7,9,20,36,63,-27,30
Cowdenbeath,5476,10,4,10,22,24,57,-33,22
Montrose,5477,1,24,7,5,63,35,28,79
Peterhead,5477,2,24,4,8,80,39,41,76
Stirling,5477,3,17,6,13,63,51,12,57
Stenhousem'r,5477,4,15,8,13,55,49,6,53
Clyde,5477,5,14,10,12,52,49,3,52
Elgin,5477,6,14,6,16,54,64,-10,48
Annan Athlet,5477,7,11,12,13,48,42,6,45
Berwick,5477,8,8,11,17,30,59,-29,35
Edinburgh Ci,5477,9,7,9,20,37,63,-26,30
Cowdenbeath,5477,10,4,11,21,24,55,-31,23
Montrose,5478,1,24,7,5,65,36,29,79
Peterhead,5478,2,24,4,8,79,39,40,76
Stirling,5478,3,17,6,13,63,53,10,57
Clyde,5478,4,15,9,12,54,50,4,54
Stenhousem'r,5478,5,15,8,13,57,49,8,53
Elgin,5478,6,14,6,16,55,66,-11,48
Annan Athlet,5478,7,11,11,14,47,43,4,44
Berwick,5478,8,8,10,18,31,61,-30,34
Edinburgh Ci,5478,9,7,9,20,37,62,-25,30
Cowdenbeath,5478,10,5,10,21,25,54,-29,25
Montrose,5479,1,23,8,5,60,35,25,77
Peterhead,5479,2,24,4,8,80,39,41,76
Stirling,5479,3,17,6,13,63,52,11,57
Clyde,5479,4,15,9,12,53,49,4,54
Stenhousem'r,5479,5,15,8,13,56,49,7,53
Elgin,5479,6,14,7,15,54,61,-7,49
Annan Athlet,5479,7,12,11,13,49,42,7,47
Berwick,5479,8,8,10,18,30,60,-30,34
Edinburgh Ci,5479,9,7,9,20,37,63,-26,30
Cowdenbeath,5479,10,4,10,22,24,56,-32,22
Montrose,5480,1,24,7,5,63,35,28,79
Peterhead,5480,2,24,4,8,81,38,43,76
Stirling,5480,3,17,6,13,62,52,10,57
Stenhousem'r,5480,4,15,8,13,56,48,8,53
Clyde,5480,5,14,9,13,53,51,2,51
Elgin,5480,6,14,6,16,54,64,-10,48
Annan Athlet,5480,7,12,11,13,49,42,7,47
Berwick,5480,8,9,10,17,32,60,-28,37
Edinburgh Ci,5480,9,7,9,20,36,64,-28,30
Cowdenbeath,5480,10,4,10,22,24,56,-32,22
Montrose,5481,1,24,7,5,62,34,28,79
Peterhead,5481,2,23,4,9,77,40,37,73
Stirling,5481,3,16,7,13,61,52,9,55
Stenhousem'r,5481,4,15,9,12,56,47,9,54
Clyde,5481,5,14,9,13,51,51,0,51
Elgin,5481,6,14,6,16,53,63,-10,48
Annan Athlet,5481,7,11,11,14,48,43,5,44
Berwick,5481,8,9,10,17,32,58,-26,37
Edinburgh Ci,5481,9,8,9,19,38,60,-22,33
Cowdenbeath,5481,10,5,10,21,25,55,-30,25
Montrose,5482,1,23,8,5,61,36,25,77
Peterhead,5482,2,24,4,8,80,38,42,76
Stenhousem'r,5482,3,16,8,12,57,46,11,56
Stirling,5482,4,16,6,14,60,53,7,54
Clyde,5482,5,15,9,12,53,48,5,54
Elgin,5482,6,14,7,15,55,62,-7,49
Annan Athlet,5482,7,12,11,13,48,41,7,47
Berwick,5482,8,8,10,18,29,60,-31,34
Edinburgh Ci,5482,9,7,9,20,36,63,-27,30
Cowdenbeath,5482,10,4,10,22,23,55,-32,22
Peterhead,5483,1,24,4,8,78,38,40,76
Montrose,5483,2,23,7,6,59,35,24,76
Stirling,5483,3,16,7,13,60,51,9,55
Stenhousem'r,5483,4,15,9,12,55,46,9,54
Clyde,5483,5,14,10,12,51,48,3,52
Elgin,5483,6,15,6,15,54,60,-6,51
Annan Athlet,5483,7,11,12,13,47,41,6,45
Berwick,5483,8,8,11,17,29,58,-29,35
Edinburgh Ci,5483,9,7,9,20,36,61,-25,30
Cowdenbeath,5483,10,4,11,21,23,54,-31,23
Montrose,5484,1,24,7,5,62,36,26,79
Peterhead,5484,2,24,4,8,81,39,42,76
Stenhousem'r,5484,3,16,8,12,58,46,12,56
Stirling,5484,4,16,6,14,60,54,6,54
Clyde,5484,5,15,9,12,54,50,4,54
Elgin,5484,6,14,6,16,55,63,-8,48
Annan Athlet,5484,7,11,12,13,47,41,6,45
Berwick,5484,8,8,10,18,31,61,-30,34
Edinburgh Ci,5484,9,7,9,20,37,64,-27,30
Cowdenbeath,5484,10,4,11,21,23,54,-31,23
Peterhead,5485,1,24,4,8,79,39,40,76
Montrose,5485,2,23,7,6,60,36,24,76
Stirling,5485,3,17,6,13,61,51,10,57
Stenhousem'r,5485,4,15,8,13,55,47,8,53
Clyde,5485,5,14,10,12,52,49,3,52
Elgin,5485,6,15,6,15,55,61,-6,51
Annan Athlet,5485,7,11,11,14,48,43,5,44
Berwick,5485,8,8,11,17,30,59,-29,35
Edinburgh Ci,5485,9,7,9,20,37,62,-25,30
Cowdenbeath,5485,10,5,10,21,25,55,-30,25
Montrose,5486,1,24,7,5,62,36,26,79
Peterhead,5486,2,24,4,8,78,38,40,76
Stirling,5486,3,16,7,13,63,54,9,55
Stenhousem'r,5486,4,15,9,12,58,49,9,54
Clyde,5486,5,14,10,12,52,49,3,52
Elgin,5486,6,14,6,16,55,63,-8,48
Annan Athlet,5486,7,11,11,14,47,42,5,44
Berwick,5486,8,8,11,17,30,59,-29,35
Edinburgh Ci,5486,9,7,9,20,36,61,-25,30
Cowdenbeath,5486,10,5,10,21,24,54,-30,25
Montrose,5487,1,23,7,6,59,37,22,76
Peterhead,5487,2,23,4,9,78,41,37,73
Stenhousem'r,5487,3,16,8,12,57,46,11,56
Stirling,5487,4,16,6,14,60,53,7,54
Clyde,5487,5,14,10,12,52,49,3,52
Elgin,5487,6,15,6,15,56,60,-4,51
Annan Athlet,5487,7,11,12,13,47,41,6,45
Berwick,5487,8,8,11,17,30,59,-29,35
Edinburgh Ci,5487,9,8,9,19,39,61,-22,33
Cowdenbeath,5487,10,4,11,21,23,54,-31,23
Montrose,5488,1,24,7,5,62,34,28,79
Peterhead,5488,2,24,4,8,81,38,43,76
Stirling,5488,3,17,6,13,63,52,11,57
Clyde,5488,4,15,9,12,52,48,4,54
Stenhousem'r,5488,5,15,8,13,56,49,7,53
Elgin,5488,6,14,6,16,53,63,-10,48
Annan Athlet,5488,7,12,11,13,48,41,7,47
Berwick,5488,8,8,10,18,29,59,-30,34
Edinburgh Ci,5488,9,7,9,20,36,64,-28,30
Cowdenbeath,5488,10,4,10,22,23,55,-32,22
Montrose,5489,1,24,7,5,63,34,29,79
Peterhead,5489,2,23,4,9,80,42,38,73
Stirling,5489,3,17,6,13,62,51,11,57
Stenhousem'r,5489,4,15,8,13,55,48,7,53
Clyde,5489,5,14,9,13,53,51,2,51
Elgin,5489,6,14,6,16,53,64,-11,48
Annan Athlet,5489,7,11,11,14,47,42,5,44
Berwick,5489,8,9,10,17,32,60,-28,37
Edinburgh Ci,5489,9,8,9,19,40,63,-23,33
Cowdenbeath,5489,10,5,10,21,24,54,-30,25
Montrose,5490,1,23,8,5,60,35,25,77
Peterhead,5490,2,23,5,8,80,41,39,74
Stirling,5490,3,16,7,13,62,53,9,55
Stenhousem'r,5490,4,15,9,12,57,48,9,54
Clyde,5490,5,15,9,12,54,48,6,54
Elgin,5490,6,14,7,15,54,61,-7,49
Annan Athlet,5490,7,12,11,13,48,41,7,47
Berwick,5490,8,8,10,18,29,61,-32,34
Edinburgh Ci,5490,9,7,10,19,39,63,-24,31
Cowdenbeath,5490,10,4,10,22,23,55,-32,22
Montrose,5491,1,24,7,5,60,34,26,79
Peterhead,5491,2,24,4,8,78,38,40,76
Stirling,5491,3,17,6,13,62,52,10,57
Clyde,5491,4,15,9,12,52,48,4,54
Stenhousem'r,5491,5,15,8,13,56,48,8,53
Elgin,5491,6,14,6,16,53,61,-8,48
Annan Athlet,5491,7,12,11,13,48,41,7,47
Berwick,5491,8,8,10,18,29,59,-30,34
Edinburgh Ci,5491,9,7,9,20,36,61,-25,30
Cowdenbeath,5491,10,4,10,22,23,55,-32,22
Montrose,5492,1,24,7,5,61,35,26,79
Peterhead,5492,2,24,4,8,79,39,40,76
Stirling,5492,3,17,6,13,61,51,10,57
Stenhousem'r,5492,4,15,8,13,55,47,8,53
Clyde,5492,5,14,9,13,53,52,1,51
Elgin,5492,6,14,6,16,54,62,-8,48
Annan Athlet,5492,7,12,11,13,49,42,7,47
Berwick,5492,8,9,10,17,33,60,-27,37
Edinburgh Ci,5492,9,7,9,20,37,62,-25,30
Cowdenbeath,5492,10,4,10,22,24,56,-32,22
Montrose,5493,1,23,7,6,60,36,24,76
Peterhead,5493,2,23,5,8,77,38,39,74
Stirling,5493,3,16,7,13,61,52,9,55
Stenhousem'r,5493,4,15,9,12,56,47,9,54
Clyde,5493,5,14,9,13,52,51,1,51
Elgin,5493,6,15,6,15,55,61,-6,51
Annan Athlet,5493,7,11,12,13,47,41,6,45
Berwick,5493,8,9,10,17,32,59,-27,37
Edinburgh Ci,5493,9,7,10,19,36,60,-24,31
Cowdenbeath,5493,10,4,11,21,23,54,-31,23
Montrose,5494,1,24,7,5,62,34,28,79
Peterhead,5494,2,24,4,8,81,38,43,76
Stirling,5494,3,17,6,13,63,52,11,57
Clyde,5494,4,15,9,12,52,48,4,54
Stenhousem'r,5494,5,15,8,13,56,49,7,53
Elgin,5494,6,14,6,16,53,63,-10,48
Annan Athlet,5494,7,12,11,13,48,41,7,47
Berwick,5494,8,8,10,18,29,59,-30,34
Edinburgh Ci,5494,9,7,9,20,36,64,-28,30
Cowdenbeath,5494,10,4,10,22,23,55,-32,22
Peterhead,5495,1,24,4,8,80,39,41,76
Montrose,5495,2,23,7,6,59,36,23,76
Stirling,5495,3,16,7,13,62,53,9,55
Stenhousem'r,5495,4,15,9,12,57,48,9,54
Clyde,5495,5,14,10,12,51,48,3,52
Elgin,5495,6,15,6,15,55,60,-5,51
Annan Athlet,5495,7,11,12,13,48,42,6,45
Berwick,5495,8,8,11,17,29,58,-29,35
Edinburgh Ci,5495,9,7,9,20,37,63,-26,30
Cowdenbeath,5495,10,4,11,21,24,55,-31,23
Montrose,5496,1,24,7,5,65,35,30,79
Peterhead,5496,2,24,4,8,80,38,42,76
Stenhousem'r,5496,3,16,8,12,57,47,10,56
Stirling,5496,4,16,6,14,61,53,8,54
Clyde,5496,5,15,9,12,54,50,4,54
Elgin,5496,6,14,6,16,54,66,-12,48
Annan Athlet,5496,7,12,11,13,49,42,7,47
Berwick,5496,8,8,10,18,31,61,-30,34
Edinburgh Ci,5496,9,7,9,20,36,63,-27,30
Cowdenbeath,5496,10,4,10,22,24,56,-32,22
Montrose,5497,1,24,7,5,62,34,28,79
Peterhead,5497,2,23,4,9,79,41,38,73
Stirling,5497,3,17,6,13,65,51,14,57
Clyde,5497,4,15,9,12,53,49,4,54
Stenhousem'r,5497,5,15,8,13,55,51,4,53
Elgin,5497,6,14,6,16,53,63,-10,48
Annan Athlet,5497,7,11,11,14,47,42,5,44
Berwick,5497,8,8,10,18,30,60,-30,34
Edinburgh Ci,5497,9,8,9,19,39,62,-23,33
Cowdenbeath,5497,10,5,10,21,24,54,-30,25
Montrose,5498,1,24,7,5,63,34,29,79
Peterhead,5498,2,24,4,8,81,40,41,76
Stirling,5498,3,16,7,13,61,52,9,55
Stenhousem'r,5498,4,15,9,12,56,47,9,54
Clyde,5498,5,15,9,12,53,49,4,54
Elgin,5498,6,14,6,16,53,64,-11,48
Annan Athlet,5498,7,11,11,14,47,42,5,44
Berwick,5498,8,8,10,18,30,60,-30,34
Edinburgh Ci,5498,9,7,9,20,38,64,-26,30
Cowdenbeath,5498,10,5,10,21,24,54,-30,25
Montrose,5499,1,24,7,5,63,34,29,79
Peterhead,5499,2,24,4,8,79,38,41,76
Stirling,5499,3,16,7,13,61,52,9,55
Stenhousem'r,5499,4,15,9,12,56,47,9,54
Clyde,5499,5,14,10,12,52,49,3,52
Elgin,5499,6,14,6,16,53,64,-11,48
Annan Athlet,5499,7,11,12,13,49,43,6,45
Berwick,5499,8,8,11,17,30,59,-29,35
Edinburgh Ci,5499,9,7,9,20,36,62,-26,30
Cowdenbeath,5499,10,4,11,21,25,56,-31,23
Montrose,5500,1,24,7,5,60,34,26,79
Peterhead,5500,2,24,4,8,81,38,43,76
Stirling,5500,3,16,7,13,60,51,9,55
Stenhousem'r,5500,4,15,9,12,55,46,9,54
Clyde,5500,5,15,9,12,54,49,5,54
Elgin,5500,6,14,6,16,53,61,-8,48
Annan Athlet,5500,7,11,12,13,47,41,6,45
Berwick,5500,8,8,10,18,30,61,-31,34
Edinburgh Ci,5500,9,7,9,20,36,64,-28,30
Cowdenbeath,5500,10,4,11,21,23,54,-31,23
Montrose,5501,1,24,7,5,63,36,27,79
Peterhead,5501,2,24,4,8,79,38,41,76
Stirling,5501,3,17,6,13,62,52,10,57
Clyde,5501,4,15,9,12,53,49,4,54
Stenhousem'r,5501,5,15,8,13,56,48,8,53
Elgin,5501,6,14,6,16,55,64,-9,48
Annan Athlet,5501,7,11,12,13,48,42,6,45
Berwick,5501,8,8,10,18,30,60,-30,34
Edinburgh Ci,5501,9,7,9,20,36,62,-26,30
Cowdenbeath,5501,10,4,11,21,24,55,-31,23
Montrose,5502,1,24,7,5,65,34,31,79
Peterhead,5502,2,24,4,8,80,39,41,76
Stirling,5502,3,16,7,13,61,52,9,55
Stenhousem'r,5502,4,15,9,12,56,47,9,54
Clyde,5502,5,15,9,12,54,49,5,54
Elgin,5502,6,14,6,16,53,66,-13,48
Annan Athlet,5502,7,11,11,14,47,42,5,44
Berwick,5502,8,8,10,18,30,61,-31,34
Edinburgh Ci,5502,9,7,9,20,37,63,-26,30
Cowdenbeath,5502,10,5,10,21,24,54,-30,25
Peterhead,5503,1,24,4,8,78,38,40,76
Montrose,5503,2,23,7,6,61,37,24,76
Stirling,5503,3,17,6,13,63,51,12,57
Stenhousem'r,5503,4,15,8,13,55,49,6,53
Clyde,5503,5,14,9,13,51,49,2,51
Elgin,5503,6,15,6,15,56,62,-6,51
Annan Athlet,5503,7,11,11,14,48,44,4,44
Berwick,5503,8,9,10,17,30,58,-28,37
Edinburgh Ci,5503,9,7,9,20,36,61,-25,30
Cowdenbeath,5503,10,5,10,21,26,55,-29,25
Montrose,5504,1,24,7,5,60,34,26,79
Peterhead,5504,2,24,4,8,81,39,42,76
Stirling,5504,3,17,6,13,65,52,13,57
Stenhousem'r,5504,4,15,8,13,56,51,5,53
Clyde,5504,5,14,9,13,51,49,2,51
Elgin,5504,6,14,6,16,53,61,-8,48
Annan Athlet,5504,7,12,11,13,49,42,7,47
Berwick,5504,8,9,10,17,30,58,-28,37
Edinburgh Ci,5504,9,7,9,20,37,64,-27,30
Cowdenbeath,5504,10,4,10,22,24,56,-32,22
Montrose,5505,1,24,7,5,61,34,27,79
Peterhead,5505,2,24,4,8,80,40,40,76
Stenhousem'r,5505,3,16,8,12,58,46,12,56
Stirling,5505,4,16,6,14,60,54,6,54
Clyde,5505,5,15,9,12,54,49,5,54
Elgin,5505,6,14,6,16,53,62,-9,48
Annan Athlet,5505,7,12,11,13,49,42,7,47
Berwick,5505,8,8,10,18,30,61,-31,34
Edinburgh Ci,5505,9,7,9,20,38,63,-25,30
Cowdenbeath,5505,10,4,10,22,24,56,-32,22
Montrose,5506,1,24,7,5,62,36,26,79
Peterhead,5506,2,24,4,8,80,38,42,76
Stenhousem'r,5506,3,16,8,12,56,46,10,56
Stirling,5506,4,16,6,14,60,52,8,54
Clyde,5506,5,15,9,12,53,48,5,54
Elgin,5506,6,14,6,16,55,63,-8,48
Annan Athlet,5506,7,12,11,13,48,41,7,47
Berwick,5506,8,8,10,18,29,60,-31,34
Edinburgh Ci,5506,9,7,9,20,36,63,-27,30
Cowdenbeath,5506,10,4,10,22,23,55,-32,22
Montrose,5507,1,24,7,5,60,34,26,79
Peterhead,5507,2,24,4,8,82,38,44,76
Stirling,5507,3,16,7,13,62,53,9,55
Stenhousem'r,5507,4,15,9,12,57,48,9,54
Clyde,5507,5,15,9,12,52,48,4,54
Elgin,5507,6,14,6,16,53,61,-8,48
Annan Athlet,5507,7,11,11,14,48,44,4,44
Berwick,5507,8,8,10,18,29,59,-30,34
Edinburgh Ci,5507,9,7,9,20,36,65,-29,30
Cowdenbeath,5507,10,5,10,21,26,55,-29,25
Montrose,5508,1,24,7,5,61,35,26,79
Peterhead,5508,2,24,4,8,79,38,41,76
Stirling,5508,3,17,6,13,63,53,10,57
Clyde,5508,4,15,9,12,53,48,5,54
Stenhousem'r,5508,5,15,8,13,57,49,8,53
Elgin,5508,6,14,6,16,54,62,-8,48
Annan Athlet,5508,7,11,11,14,47,42,5,44
Berwick,5508,8,8,10,18,29,60,-31,34
Edinburgh Ci,5508,9,7,9,20,36,62,-26,30
Cowdenbeath,5508,10,5,10,21,24,54,-30,25
Montrose,5509,1,23,8,5,60,35,25,77
Peterhead,5509,2,23,5,8,77,38,39,74
Stenhousem'r,5509,3,16,8,12,58,48,10,56
Stirling,5509,4,16,6,14,62,54,8,54
Clyde,5509,5,15,9,12,54,48,6,54
Elgin,5509,6,14,7,15,54,61,-7,49
Annan Athlet,5509,7,11,12,13,47,41,6,45
Berwick,5509,8,8,10,18,29,61,-32,34
Edinburgh Ci,5509,9,7,10,19,36,60,-24,31
Cowdenbeath,5509,10,4,11,21,23,54,-31,23
Montrose,5510,1,24,7,5,62,35,27,79
Peterhead,5510,2,24,4,8,79,39,40,76
Stirling,5510,3,17,6,13,63,51,12,57
Clyde,5510,4,15,9,12,54,48,6,54
Stenhousem'r,5510,5,15,8,13,55,49,6,53
Elgin,5510,6,14,6,16,54,63,-9,48
Annan Athlet,5510,7,12,11,13,49,41,8,47
Berwick,5510,8,8,10,18,29,61,-32,34
Edinburgh Ci,5510,9,7,9,20,37,62,-25,30
Cowdenbeath,5510,10,4,10,22,23,56,-33,22
Montrose,5511,1,24,7,5,65,35,30,79
Peterhead,5511,2,24,4,8,80,39,41,76
Stenhousem'r,5511,3,16,8,12,59,48,11,56
Stirling,5511,4,16,6,14,62,55,7,54
Clyde,5511,5,15,9,12,54,50,4,54
Elgin,5511,6,14,6,16,54,66,-12,48
Annan Athlet,5511,7,11,11,14,48,43,5,44
Berwick,5511,8,8,10,18,31,61,-30,34
Edinburgh Ci,5511,9,7,9,20,37,63,-26,30
Cowdenbeath,5511,10,5,10,21,25,55,-30,25
Peterhead,5512,1,24,4,8,81,40,41,76
Montrose,5512,2,23,7,6,61,37,24,76
Stirling,5512,3,16,7,13,60,51,9,55
Stenhousem'r,5512,4,15,9,12,55,46,9,54
Clyde,5512,5,15,9,12,52,48,4,54
Elgin,5512,6,15,6,15,56,62,-6,51
Annan Athlet,5512,7,12,11,13,51,42,9,47
Berwick,5512,8,8,10,18,29,59,-30,34
Edinburgh Ci,5512,9,7,9,20,38,64,-26,30
Cowdenbeath,5512,10,4,10,22,24,58,-34,22
Montrose,5513,1,24,7,5,63,35,28,79
Peterhead,5513,2,23,4,9,79,41,38,73
Stirling,5513,3,17,6,13,63,52,11,57
Clyde,5513,4,15,9,12,52,48,4,54
Stenhousem'r,5513,5,15,8,13,56,49,7,53
Elgin,5513,6,14,6,16,54,64,-10,48
Annan Athlet,5513,7,12,11,13,49,42,7,47
Berwick,5513,8,8,10,18,29,59,-30,34
Edinburgh Ci,5513,9,8,9,19,39,62,-23,33
Cowdenbeath,5513,10,4,10,22,24,56,-32,22
Montrose,5514,1,24,7,5,60,34,26,79
Peterhead,5514,2,24,4,8,80,38,42,76
Stenhousem'r,5514,3,16,8,12,57,47,10,56
Stirling,5514,4,16,6,14,61,53,8,54
Clyde,5514,5,15,9,12,53,48,5,54
Elgin,5514,6,14,6,16,53,61,-8,48
Annan Athlet,5514,7,12,11,13,48,41,7,47
Berwick,5514,8,8,10,18,29,60,-31,34
Edinburgh Ci,5514,9,7,9,20,36,63,-27,30
Cowdenbeath,5514,10,4,10,22,23,55,-32,22
Montrose,5515,1,24,7,5,61,35,26,79
Peterhead,5515,2,24,4,8,79,38,41,76
Stirling,5515,3,16,7,13,60,51,9,55
Stenhousem'r,5515,4,15,9,12,55,46,9,54
Clyde,5515,5,15,9,12,53,48,5,54
Elgin,5515,6,14,6,16,54,62,-8,48
Annan Athlet,5515,7,11,12,13,48,42,6,45
Berwick,5515,8,8,10,18,29,60,-31,34
Edinburgh Ci,5515,9,7,9,20,36,62,-26,30
Cowdenbeath,5515,10,4,11,21,24,55,-31,23
Montrose,5516,1,24,7,5,61,35,26,79
Peterhead,5516,2,24,4,8,84,38,46,76
Stenhousem'r,5516,3,16,8,12,57,47,10,56
Stirling,5516,4,16,6,14,61,53,8,54
Clyde,5516,5,14,9,13,51,50,1,51
Elgin,5516,6,14,6,16,54,62,-8,48
Annan Athlet,5516,7,11,12,13,49,43,6,45
Berwick,5516,8,9,10,17,31,58,-27,37
Edinburgh Ci,5516,9,7,9,20,36,67,-31,30
Cowdenbeath,5516,10,4,11,21,25,56,-31,23
Montrose,5517,1,24,7,5,65,36,29,79
Peterhead,5517,2,24,4,8,81,41,40,76
Stirling,5517,3,17,6,13,63,53,10,57
Clyde,5517,4,15,9,12,52,48,4,54
Stenhousem'r,5517,5,15,8,13,57,49,8,53
Elgin,5517,6,14,6,16,55,66,-11,48
Annan Athlet,5517,7,12,11,13,49,41,8,47
Berwick,5517,8,8,10,18,29,59,-30,34
Edinburgh Ci,5517,9,7,9,20,39,64,-25,30
Cowdenbeath,5517,10,4,10,22,23,56,-33,22
Peterhead,5518,1,24,4,8,81,40,41,76
Montrose,5518,2,23,7,6,59,36,23,76
Stirling,5518,3,17,6,13,66,55,11,57
Stenhousem'r,5518,4,15,8,13,59,52,7,53
Clyde,5518,5,14,10,12,51,48,3,52
Elgin,5518,6,15,6,15,55,60,-5,51
Annan Athlet,5518,7,12,11,13,48,41,7,47
Berwick,5518,8,8,11,17,29,58,-29,35
Edinburgh Ci,5518,9,7,9,20,38,64,-26,30
Cowdenbeath,5518,10,4,10,22,23,55,-32,22
Montrose,5519,1,23,8,5,61,36,25,77
Peterhead,5519,2,24,4,8,81,38,43,76
Stirling,5519,3,17,6,13,62,52,10,57
Clyde,5519,4,15,9,12,53,48,5,54
Stenhousem'r,5519,5,15,8,13,56,48,8,53
Elgin,5519,6,14,7,15,55,62,-7,49
Annan Athlet,5519,7,12,11,13,48,41,7,47
Berwick,5519,8,8,10,18,29,60,-31,34
Edinburgh Ci,5519,9,7,9,20,36,64,-28,30
Cowdenbeath,5519,10,4,10,22,23,55,-32,22
Montrose,5520,1,24,7,5,62,34,28,79
Peterhead,5520,2,24,4,8,81,38,43,76
Stirling,5520,3,17,6,13,62,52,10,57
Stenhousem'r,5520,4,15,8,13,56,48,8,53
Clyde,5520,5,14,10,12,52,49,3,52
Elgin,5520,6,14,6,16,53,63,-10,48
Annan Athlet,5520,7,11,11,14,47,42,5,44
Berwick,5520,8,8,11,17,30,59,-29,35
Edinburgh Ci,5520,9,7,9,20,36,64,-28,30
Cowdenbeath,5520,10,5,10,21,24,54,-30,25
Montrose,5521,1,23,8,5,59,34,25,77
Peterhead,5521,2,24,4,8,81,40,41,76
Stenhousem'r,5521,3,16,8,12,58,47,11,56
Stirling,5521,4,16,6,14,61,54,7,54
Clyde,5521,5,15,9,12,53,48,5,54
Elgin,5521,6,14,7,15,53,60,-7,49
Annan Athlet,5521,7,11,12,13,48,42,6,45
Berwick,5521,8,8,10,18,29,60,-31,34
Edinburgh Ci,5521,9,7,9,20,38,64,-26,30
Cowdenbeath,5521,10,4,11,21,24,55,-31,23
Montrose,5522,1,24,7,5,62,34,28,79
Peterhead,5522,2,24,4,8,78,38,40,76
Stenhousem'r,5522,3,16,8,12,56,46,10,56
Stirling,5522,4,16,6,14,60,52,8,54
Clyde,5522,5,14,9,13,52,50,2,51
Elgin,5522,6,14,6,16,53,63,-10,48
Annan Athlet,5522,7,11,11,14,50,46,4,44
Berwick,5522,8,9,10,17,31,59,-28,37
Edinburgh Ci,5522,9,7,9,20,36,61,-25,30
Cowdenbeath,5522,10,5,10,21,28,57,-29,25
Montrose,5523,1,24,7,5,62,34,28,79
Peterhead,5523,2,24,4,8,82,38,44,76
Stirling,5523,3,17,6,13,62,52,10,57
Stenhousem'r,5523,4,15,8,13,56,48,8,53
Clyde,5523,5,14,9,13,52,50,2,51
Elgin,5523,6,14,6,16,53,63,-10,48
Annan Athlet,5523,7,11,11,14,48,43,5,44
Berwick,5523,8,9,10,17,31,59,-28,37
Edinburgh Ci,5523,9,7,9,20,36,65,-29,30
Cowdenbeath,5523,10,5,10,21,25,55,-30,25
Montrose,5524,1,24,7,5,62,35,27,79
Peterhead,5524,2,24,4,8,79,39,40,76
Stirling,5524,3,17,6,13,61,51,10,57
Stenhousem'r,5524,4,15,8,13,55,47,8,53
Clyde,5524,5,14,10,12,51,48,3,52
Elgin,5524,6,14,6,16,54,63,-9,48
Annan Athlet,5524,7,11,11,14,47,43,4,44
Berwick,5524,8,8,11,17,29,58,-29,35
Edinburgh Ci,5524,9,7,9,20,37,62,-25,30
Cowdenbeath,5524,10,5,10,21,25,54,-29,25
Montrose,5525,1,24,7,5,64,38,26,79
Peterhead,5525,2,24,4,8,80,38,42,76
Stirling,5525,3,17,6,13,63,53,10,57
Stenhousem'r,5525,4,15,8,13,57,49,8,53
Clyde,5525,5,14,10,12,52,49,3,52
Elgin,5525,6,14,6,16,57,65,-8,48
Annan Athlet,5525,7,11,11,14,47,42,5,44
Berwick,5525,8,8,11,17,30,59,-29,35
Edinburgh Ci,5525,9,7,9,20,36,63,-27,30
Cowdenbeath,5525,10,5,10,21,24,54,-30,25
Peterhead,5526,1,24,4,8,81,39,42,76
Montrose,5526,2,23,7,6,60,36,24,76
Stirling,5526,3,17,6,13,63,52,11,57
Clyde,5526,4,15,9,12,53,48,5,54
Stenhousem'r,5526,5,15,8,13,56,49,7,53
Elgin,5526,6,15,6,15,55,61,-6,51
Annan Athlet,5526,7,12,11,13,50,41,9,47
Berwick,5526,8,8,10,18,29,60,-31,34
Edinburgh Ci,5526,9,7,9,20,37,64,-27,30
Cowdenbeath,5526,10,4,10,22,23,57,-34,22
Montrose,5527,1,24,7,5,63,35,28,79
Peterhead,5527,2,24,4,8,83,38,45,76
Stenhousem'r,5527,3,16,8,12,57,46,11,56
Clyde,5527,4,15,9,12,56,48,8,54
Stirling,5527,5,16,6,14,60,53,7,54
Elgin,5527,6,14,6,16,54,64,-10,48
Annan Athlet,5527,7,11,11,14,47,42,5,44
Berwick,5527,8,8,10,18,29,63,-34,34
Edinburgh Ci,5527,9,7,9,20,36,66,-30,30
Cowdenbeath,5527,10,5,10,21,24,54,-30,25
Montrose,5528,1,23,7,6,61,38,23,76
Peterhead,5528,2,23,4,9,78,40,38,73
Stenhousem'r,5528,3,16,8,12,58,47,11,56
Stirling,5528,4,16,6,14,61,54,7,54
Clyde,5528,5,14,9,13,51,49,2,51
Elgin,5528,6,15,6,15,57,62,-5,51
Annan Athlet,5528,7,12,11,13,49,41,8,47
Berwick,5528,8,9,10,17,30,58,-28,37
Edinburgh Ci,5528,9,8,9,19,38,61,-23,33
Cowdenbeath,5528,10,4,10,22,23,56,-33,22
Montrose,5529,1,24,7,5,60,34,26,79
Peterhead,5529,2,24,4,8,80,39,41,76
Stirling,5529,3,17,6,13,65,51,14,57
Clyde,5529,4,15,9,12,54,48,6,54
Stenhousem'r,5529,5,15,8,13,55,51,4,53
Elgin,5529,6,14,6,16,53,61,-8,48
Annan Athlet,5529,7,12,11,13,49,41,8,47
Berwick,5529,8,8,10,18,29,61,-32,34
Edinburgh Ci,5529,9,7,9,20,37,63,-26,30
Cowdenbeath,5529,10,4,10,22,23,56,-33,22
Montrose,5530,1,24,7,5,62,35,27,79
Peterhead,5530,2,24,4,8,81,39,42,76
Stenhousem'r,5530,3,16,8,12,57,46,11,56
Stirling,5530,4,16,6,14,60,53,7,54
Clyde,5530,5,14,10,12,53,50,3,52
Elgin,5530,6,14,6,16,54,63,-9,48
Annan Athlet,5530,7,12,11,13,48,41,7,47
Berwick,5530,8,8,11,17,31,60,-29,35
Edinburgh Ci,5530,9,7,9,20,37,64,-27,30
Cowdenbeath,5530,10,4,10,22,23,55,-32,22
Montrose,5531,1,23,7,6,60,36,24,76
Peterhead,5531,2,23,5,8,78,39,39,74
Stenhousem'r,5531,3,16,8,12,58,47,11,56
Stirling,5531,4,16,6,14,61,54,7,54
Clyde,5531,5,14,9,13,52,51,1,51
Elgin,5531,6,15,6,15,55,61,-6,51
Annan Athlet,5531,7,12,11,13,51,42,9,47
Berwick,5531,8,9,10,17,32,59,-27,37
Edinburgh Ci,5531,9,7,10,19,37,61,-24,31
Cowdenbeath,5531,10,4,10,22,24,58,-34,22
Montrose,5532,1,24,7,5,64,34,30,79
Peterhead,5532,2,24,4,8,79,39,40,76
Stirling,5532,3,17,6,13,62,52,10,57
Clyde,5532,4,15,9,12,53,48,5,54
Stenhousem'r,5532,5,15,8,13,56,48,8,53
Elgin,5532,6,14,6,16,53,65,-12,48
Annan Athlet,5532,7,11,11,14,47,42,5,44
Berwick,5532,8,8,10,18,29,60,-31,34
Edinburgh Ci,5532,9,7,9,20,37,62,-25,30
Cowdenbeath,5532,10,5,10,21,24,54,-30,25
Peterhead,5533,1,24,4,8,81,39,42,76
Montrose,5533,2,23,7,6,60,36,24,76
Stirling,5533,3,16,7,13,61,52,9,55
Stenhousem'r,5533,4,15,9,12,56,47,9,54
Clyde,5533,5,15,9,12,52,48,4,54
Elgin,5533,6,15,6,15,55,61,-6,51
Annan Athlet,5533,7,12,11,13,49,42,7,47
Berwick,5533,8,8,10,18,29,59,-30,34
Edinburgh Ci,5533,9,7,9,20,37,64,-27,30
Cowdenbeath,5533,10,4,10,22,24,56,-32,22
Montrose,5534,1,24,7,5,65,34,31,79
Peterhead,5534,2,24,4,8,78,38,40,76
Stirling,5534,3,17,6,13,63,52,11,57
Clyde,5534,4,15,9,12,53,49,4,54
Stenhousem'r,5534,5,15,8,13,56,49,7,53
Elgin,5534,6,14,6,16,53,66,-13,48
Annan Athlet,5534,7,12,11,13,49,41,8,47
Berwick,5534,8,8,10,18,30,60,-30,34
Edinburgh Ci,5534,9,7,9,20,36,61,-25,30
Cowdenbeath,5534,10,4,10,22,23,56,-33,22
Montrose,5535,1,23,8,5,60,35,25,77
Peterhead,5535,2,23,4,9,78,40,38,73
Stirling,5535,3,17,6,13,61,51,10,57
Stenhousem'r,5535,4,15,8,13,55,47,8,53
Clyde,5535,5,14,10,12,52,49,3,52
Elgin,5535,6,14,7,15,54,61,-7,49
Annan Athlet,5535,7,12,11,13,50,43,7,47
Berwick,5535,8,8,11,17,30,59,-29,35
Edinburgh Ci,5535,9,8,9,19,38,61,-23,33
Cowdenbeath,5535,10,4,10,22,25,57,-32,22
Peterhead,5536,1,24,4,8,79,39,40,76
Montrose,5536,2,23,7,6,59,35,24,76
Stirling,5536,3,17,6,13,62,52,10,57
Clyde,5536,4,15,9,12,53,49,4,54
Stenhousem'r,5536,5,15,8,13,56,48,8,53
Elgin,5536,6,15,6,15,54,60,-6,51
Annan Athlet,5536,7,11,12,13,47,41,6,45
Berwick,5536,8,8,10,18,30,60,-30,34
Edinburgh Ci,5536,9,7,9,20,37,62,-25,30
Cowdenbeath,5536,10,4,11,21,23,54,-31,23
Montrose,5537,1,24,7,5,62,35,27,79
Peterhead,5537,2,24,4,8,80,38,42,76
Stirling,5537,3,17,6,13,61,51,10,57
Stenhousem'r,5537,4,15,8,13,55,47,8,53
Clyde,5537,5,14,9,13,51,50,1,51
Elgin,5537,6,14,6,16,54,63,-9,48
Annan Athlet,5537,7,11,12,13,47,41,6,45
Berwick,5537,8,9,10,17,31,58,-27,37
Edinburgh Ci,5537,9,7,9,20,36,63,-27,30
Cowdenbeath,5537,10,4,11,21,23,54,-31,23
Peterhead,5538,1,24,4,8,80,38,42,76
Montrose,5538,2,23,7,6,59,37,22,76
Stirling,5538,3,16,7,13,61,52,9,55
Stenhousem'r,5538,4,15,9,12,56,47,9,54
Clyde,5538,5,15,9,12,52,48,4,54
Elgin,5538,6,15,6,15,56,60,-4,51
Annan Athlet,5538,7,12,11,13,49,42,7,47
Berwick,5538,8,8,10,18,29,59,-30,34
Edinburgh Ci,5538,9,7,9,20,36,63,-27,30
Cowdenbeath,5538,10,4,10,22,24,56,-32,22
Montrose,5539,1,24,7,5,61,34,27,79
Peterhead,5539,2,24,4,8,79,39,40,76
Stirling,5539,3,17,6,13,61,51,10,57
Clyde,5539,4,15,9,12,54,50,4,54
Stenhousem'r,5539,5,15,8,13,55,47,8,53
Elgin,5539,6,14,6,16,53,62,-9,48
Annan Athlet,5539,7,11,11,14,47,42,5,44
Berwick,5539,8,8,10,18,31,61,-30,34
Edinburgh Ci,5539,9,7,9,20,37,62,-25,30
Cowdenbeath,5539,10,5,10,21,24,54,-30,25
Montrose,5540,1,24,7,5,60,34,26,79
Peterhead,5540,2,23,4,9,78,40,38,73
Stirling,5540,3,16,7,13,61,52,9,55
Stenhousem'r,5540,4,15,9,12,56,47,9,54
Clyde,5540,5,15,9,12,53,48,5,54
Elgin,5540,6,14,6,16,53,61,-8,48
Annan Athlet,5540,7,12,11,13,48,41,7,47
Berwick,5540,8,8,10,18,29,60,-31,34
Edinburgh Ci,5540,9,8,9,19,38,61,-23,33
Cowdenbeath,5540,10,4,10,22,23,55,-32,22
Montrose,5541,1,24,7,5,62,35,27,79
Peterhead,5541,2,24,4,8,82,41,41,76
Stirling,5541,3,17,6,13,63,51,12,57
Clyde,5541,4,15,9,12,53,48,5,54
Stenhousem'r,5541,5,15,8,13,55,49,6,53
Elgin,5541,6,14,6,16,54,63,-9,48
Annan Athlet,5541,7,11,12,13,48,42,6,45
Berwick,5541,8,8,10,18,29,60,-31,34
Edinburgh Ci,5541,9,7,9,20,39,65,-26,30
Cowdenbeath,5541,10,4,11,21,24,55,-31,23
Montrose,5542,1,24,7,5,61,34,27,79
Peterhead,5542,2,24,4,8,82,38,44,76
Stirling,5542,3,17,6,13,62,51,11,57
Stenhousem'r,5542,4,15,8,13,55,48,7,53
Clyde,5542,5,14,9,13,52,50,2,51
Elgin,5542,6,14,6,16,53,62,-9,48
Annan Athlet,5542,7,12,11,13,51,42,9,47
Berwick,5542,8,9,10,17,31,59,-28,37
Edinburgh Ci,5542,9,7,9,20,36,65,-29,30
Cowdenbeath,5542,10,4,10,22,24,58,-34,22
Montrose,5543,1,24,7,5,60,34,26,79
Peterhead,5543,2,24,4,8,79,38,41,76
Stenhousem'r,5543,3,16,8,12,59,46,13,56
Stirling,5543,4,16,6,14,60,55,5,54
Clyde,5543,5,15,9,12,53,48,5,54
Elgin,5543,6,14,6,16,53,61,-8,48
Annan Athlet,5543,7,11,11,14,47,42,5,44
Berwick,5543,8,8,10,18,29,60,-31,34
Edinburgh Ci,5543,9,7,9,20,36,62,-26,30
Cowdenbeath,5543,10,5,10,21,24,54,-30,25
Montrose,5544,1,24,7,5,60,34,26,79
Peterhead,5544,2,23,5,8,79,40,39,74
Stirling,5544,3,17,6,13,62,52,10,57
Stenhousem'r,5544,4,15,8,13,56,48,8,53
Clyde,5544,5,14,9,13,51,51,0,51
Elgin,5544,6,14,6,16,53,61,-8,48
Annan Athlet,5544,7,11,11,14,48,43,5,44
Berwick,5544,8,9,10,17,32,58,-26,37
Edinburgh Ci,5544,9,7,10,19,38,62,-24,31
Cowdenbeath,5544,10,5,10,21,25,55,-30,25
Montrose,5545,1,24,7,5,67,34,33,79
Peterhead,5545,2,24,4,8,81,38,43,76
Stirling,5545,3,17,6,13,63,52,11,57
Clyde,5545,4,15,9,12,56,49,7,54
Stenhousem'r,5545,5,15,8,13,56,49,7,53
Elgin,5545,6,14,6,16,53,68,-15,48
Annan Athlet,5545,7,11,11,14,47,42,5,44
Berwick,5545,8,8,10,18,30,63,-33,34
Edinburgh Ci,5545,9,7,9,20,36,64,-28,30
Cowdenbeath,5545,10,5,10,21,24,54,-30,25
Montrose,5546,1,24,7,5,64,35,29,79
Peterhead,5546,2,23,5,8,77,38,39,74
Stirling,5546,3,17,6,13,64,52,12,57
Clyde,5546,4,15,9,12,54,48,6,54
Stenhousem'r,5546,5,15,8,13,56,50,6,53
Elgin,5546,6,14,6,16,54,65,-11,48
Annan Athlet,5546,7,12,11,13,50,42,8,47
Berwick,5546,8,8,10,18,29,61,-32,34
Edinburgh Ci,5546,9,7,10,19,36,60,-24,31
Cowdenbeath,5546,10,4,10,22,24,57,-33,22
Montrose,5547,1,23,8,5,61,36,25,77
Peterhead,5547,2,24,4,8,81,39,42,76
Stirling,5547,3,17,6,13,61,51,10,57
Clyde,5547,4,15,9,12,53,48,5,54
Stenhousem'r,5547,5,15,8,13,55,47,8,53
Elgin,5547,6,14,7,15,55,62,-7,49
Annan Athlet,5547,7,12,11,13,51,42,9,47
Berwick,5547,8,8,10,18,29,60,-31,34
Edinburgh Ci,5547,9,7,9,20,37,64,-27,30
Cowdenbeath,5547,10,4,10,22,24,58,-34,22
Montrose,5548,1,24,7,5,60,34,26,79
Peterhead,5548,2,24,4,8,80,40,40,76
Stirling,5548,3,17,6,13,66,53,13,57
Clyde,5548,4,15,9,12,53,49,4,54
Stenhousem'r,5548,5,15,8,13,57,52,5,53
Elgin,5548,6,14,6,16,53,61,-8,48
Annan Athlet,5548,7,11,11,14,47,44,3,44
Berwick,5548,8,8,10,18,30,60,-30,34
Edinburgh Ci,5548,9,7,9,20,38,63,-25,30
Cowdenbeath,5548,10,5,10,21,26,54,-28,25
Montrose,5549,1,24,7,5,62,35,27,79
Peterhead,5549,2,24,4,8,80,40,40,76
Stirling,5549,3,16,7,13,61,52,9,55
Stenhousem'r,5549,4,15,9,12,56,47,9,54
Clyde,5549,5,15,9,12,52,48,4,54
Elgin,5549,6,14,6,16,54,63,-9,48
Annan Athlet,5549,7,11,12,13,50,44,6,45
Berwick,5549,8,8,10,18,29,59,-30,34
Edinburgh Ci,5549,9,7,9,20,38,63,-25,30
Cowdenbeath,5549,10,4,11,21,26,57,-31,23
Montrose,5550,1,24,7,5,60,34,26,79
Peterhead,5550,2,24,4,8,81,39,42,76
Stenhousem'r,5550,3,16,8,12,58,47,11,56
Stirling,5550,4,16,6,14,61,54,7,54
Clyde,5550,5,15,9,12,55,48,7,54
Elgin,5550,6,14,6,16,53,61,-8,48
Annan Athlet,5550,7,11,11,14,48,43,5,44
Berwick,5550,8,8,10,18,29,62,-33,34
Edinburgh Ci,5550,9,7,9,20,37,64,-27,30
Cowdenbeath,5550,10,5,10,21,25,55,-30,25
Montrose,5551,1,23,7,6,60,36,24,76
Peterhead,5551,2,23,4,9,79,41,38,73
Stirling,5551,3,16,7,13,62,53,9,55
Stenhousem'r,5551,4,15,9,12,57,48,9,54
Clyde,5551,5,15,9,12,53,48,5,54
Elgin,5551,6,15,6,15,55,61,-6,51
Annan Athlet,5551,7,11,11,14,47,44,3,44
Berwick,5551,8,8,10,18,29,60,-31,34
Edinburgh Ci,5551,9,8,9,19,39,62,-23,33
Cowdenbeath,5551,10,5,10,21,26,54,-28,25
Montrose,5552,1,24,7,5,63,34,29,79
Peterhead,5552,2,24,4,8,79,38,41,76
Stirling,5552,3,16,7,13,60,51,9,55
Stenhousem'r,5552,4,15,9,12,55,46,9,54
Clyde,5552,5,14,9,13,52,51,1,51
Elgin,5552,6,14,6,16,53,64,-11,48
Annan Athlet,5552,7,12,11,13,48,41,7,47
Berwick,5552,8,9,10,17,32,59,-27,37
Edinburgh Ci,5552,9,7,9,20,36,62,-26,30
Cowdenbeath,5552,10,4,10,22,23,55,-32,22
Montrose,5553,1,24,7,5,64,36,28,79
Peterhead,5553,2,24,4,8,80,40,40,76
Stirling,5553,3,17,6,13,61,51,10,57
Stenhousem'r,5553,4,15,8,13,55,47,8,53
Clyde,5553,5,14,10,12,51,48,3,52
Elgin,5553,6,14,6,16,55,65,-10,48
Annan Athlet,5553,7,12,11,13,50,41,9,47
Berwick,5553,8,8,11,17,29,58,-29,35
Edinburgh Ci,5553,9,7,9,20,38,63,-25,30
Cowdenbeath,5553,10,4,10,22,23,57,-34,22
Montrose,5554,1,24,7,5,60,34,26,79
Peterhead,5554,2,24,4,8,80,38,42,76
Stirling,5554,3,16,7,13,62,53,9,55
Stenhousem'r,5554,4,15,9,12,57,48,9,54
Clyde,5554,5,15,9,12,52,48,4,54
Elgin,5554,6,14,6,16,53,61,-8,48
Annan Athlet,5554,7,12,11,13,49,41,8,47
Berwick,5554,8,8,10,18,29,59,-30,34
Edinburgh Ci,5554,9,7,9,20,36,63,-27,30
Cowdenbeath,5554,10,4,10,22,23,56,-33,22
Montrose,5555,1,23,7,6,60,36,24,76
Peterhead,5555,2,23,5,8,79,40,39,74
Stirling,5555,3,16,7,13,61,52,9,55
Stenhousem'r,5555,4,15,9,12,56,47,9,54
Clyde,5555,5,15,9,12,52,48,4,54
Elgin,5555,6,15,6,15,55,61,-6,51
Annan Athlet,5555,7,12,11,13,51,42,9,47
Berwick,5555,8,8,10,18,29,59,-30,34
Edinburgh Ci,5555,9,7,10,19,38,62,-24,31
Cowdenbeath,5555,10,4,10,22,24,58,-34,22
Peterhead,5556,1,24,4,8,81,39,42,76
Montrose,5556,2,23,7,6,59,37,22,76
Stenhousem'r,5556,3,16,8,12,56,46,10,56
Stirling,5556,4,16,6,14,60,52,8,54
Clyde,5556,5,15,9,12,53,49,4,54
Elgin,5556,6,15,6,15,56,60,-4,51
Annan Athlet,5556,7,12,11,13,49,42,7,47
Berwick,5556,8,8,10,18,30,60,-30,34
Edinburgh Ci,5556,9,7,9,20,37,64,-27,30
Cowdenbeath,5556,10,4,10,22,24,56,-32,22
Montrose,5557,1,24,7,5,60,34,26,79
Peterhead,5557,2,24,4,8,80,40,40,76
Stirling,5557,3,16,7,13,61,52,9,55
Stenhousem'r,5557,4,15,9,12,56,47,9,54
Clyde,5557,5,14,9,13,53,51,2,51
Elgin,5557,6,14,6,16,53,61,-8,48
Annan Athlet,5557,7,12,11,13,48,41,7,47
Berwick,5557,8,9,10,17,32,60,-28,37
Edinburgh Ci,5557,9,7,9,20,38,63,-25,30
Cowdenbeath,5557,10,4,10,22,23,55,-32,22
Montrose,5558,1,24,7,5,65,36,29,79
Peterhead,5558,2,24,4,8,82,39,43,76
Stirling,5558,3,17,6,13,61,51,10,57
Stenhousem'r,5558,4,15,8,13,55,47,8,53
Clyde,5558,5,14,9,13,51,49,2,51
Elgin,5558,6,14,6,16,55,66,-11,48
Annan Athlet,5558,7,12,11,13,50,41,9,47
Berwick,5558,8,9,10,17,30,58,-28,37
Edinburgh Ci,5558,9,7,9,20,37,65,-28,30
Cowdenbeath,5558,10,4,10,22,23,57,-34,22
Montrose,5559,1,23,8,5,59,34,25,77
Peterhead,5559,2,24,4,8,81,38,43,76
Stirling,5559,3,16,7,13,60,51,9,55
Stenhousem'r,5559,4,15,9,12,55,46,9,54
Clyde,5559,5,15,9,12,52,48,4,54
Elgin,5559,6,14,7,15,53,60,-7,49
Annan Athlet,5559,7,11,11,14,47,42,5,44
Berwick,5559,8,8,10,18,29,59,-30,34
Edinburgh Ci,5559,9,7,9,20,36,64,-28,30
Cowdenbeath,5559,10,5,10,21,24,54,-30,25
Montrose,5560,1,23,8,5,60,35,25,77
Peterhead,5560,2,24,4,8,82,39,43,76
Stirling,5560,3,17,6,13,63,51,12,57
Clyde,5560,4,15,9,12,55,49,6,54
Stenhousem'r,5560,5,15,8,13,55,49,6,53
Elgin,5560,6,14,7,15,54,61,-7,49
Annan Athlet,5560,7,11,12,13,48,42,6,45
Berwick,5560,8,8,10,18,30,62,-32,34
Edinburgh Ci,5560,9,7,9,20,37,65,-28,30
Cowdenbeath,5560,10,4,11,21,24,55,-31,23
Montrose,5561,1,23,8,5,60,35,25,77
Peterhead,5561,2,24,4,8,81,38,43,76
Stenhousem'r,5561,3,16,8,12,58,46,12,56
Stirling,5561,4,16,6,14,60,54,6,54
Clyde,5561,5,15,9,12,54,49,5,54
Elgin,5561,6,14,7,15,54,61,-7,49
Annan Athlet,5561,7,12,11,13,49,41,8,47
Berwick,5561,8,8,10,18,30,61,-31,34
Edinburgh Ci,5561,9,7,9,20,36,64,-28,30
Cowdenbeath,5561,10,4,10,22,23,56,-33,22
Montrose,5562,1,24,7,5,60,34,26,79
Peterhead,5562,2,23,4,9,78,40,38,73
Stirling,5562,3,17,6,13,61,51,10,57
Stenhousem'r,5562,4,15,8,13,55,47,8,53
Clyde,5562,5,14,9,13,51,51,0,51
Elgin,5562,6,14,6,16,53,61,-8,48
Annan Athlet,5562,7,11,11,14,48,44,4,44
Berwick,5562,8,9,10,17,32,58,-26,37
Edinburgh Ci,5562,9,8,9,19,38,61,-23,33
Cowdenbeath,5562,10,5,10,21,26,55,-29,25
Montrose,5563,1,24,7,5,62,35,27,79
Peterhead,5563,2,24,4,8,80,39,41,76
Stirling,5563,3,17,6,13,64,52,12,57
Stenhousem'r,5563,4,15,8,13,56,50,6,53
Clyde,5563,5,14,10,12,51,48,3,52
Elgin,5563,6,14,6,16,54,63,-9,48
Annan Athlet,5563,7,11,12,13,49,43,6,45
Berwick,5563,8,8,11,17,29,58,-29,35
Edinburgh Ci,5563,9,7,9,20,37,63,-26,30
Cowdenbeath,5563,10,4,11,21,25,56,-31,23
Montrose,5564,1,24,7,5,61,35,26,79
Peterhead,5564,2,24,4,8,80,39,41,76
Stenhousem'r,5564,3,16,8,12,60,49,11,56
Stirling,5564,4,16,6,14,63,56,7,54
Clyde,5564,5,15,9,12,53,48,5,54
Elgin,5564,6,14,6,16,54,62,-8,48
Annan Athlet,5564,7,11,11,14,47,43,4,44
Berwick,5564,8,8,10,18,29,60,-31,34
Edinburgh Ci,5564,9,7,9,20,37,63,-26,30
Cowdenbeath,5564,10,5,10,21,25,54,-29,25
Peterhead,5565,1,24,4,8,79,38,41,76
Montrose,5565,2,23,7,6,61,37,24,76
Stirling,5565,3,17,6,13,64,54,10,57
Clyde,5565,4,15,9,12,56,49,7,54
Stenhousem'r,5565,5,15,8,13,58,50,8,53
Elgin,5565,6,15,6,15,56,62,-6,51
Annan Athlet,5565,7,11,12,13,49,43,6,45
Berwick,5565,8,8,10,18,30,63,-33,34
Edinburgh Ci,5565,9,7,9,20,36,62,-26,30
Cowdenbeath,5565,10,4,11,21,25,56,-31,23
Montrose,5566,1,24,7,5,60,34,26,79
Peterhead,5566,2,24,4,8,80,39,41,76
Stirling,5566,3,17,6,13,63,51,12,57
Clyde,5566,4,15,9,12,55,48,7,54
Stenhousem'r,5566,5,15,8,13,55,49,6,53
Elgin,5566,6,14,6,16,53,61,-8,48
Annan Athlet,5566,7,11,12,13,47,41,6,45
Berwick,5566,8,8,10,18,29,62,-33,34
Edinburgh Ci,5566,9,7,9,20,37,63,-26,30
Cowdenbeath,5566,10,4,11,21,23,54,-31,23
Montrose,5567,1,23,8,5,61,36,25,77
Peterhead,5567,2,24,4,8,80,40,40,76
Stenhousem'r,5567,3,16,8,12,57,47,10,56
Stirling,5567,4,16,6,14,61,53,8,54
Clyde,5567,5,14,9,13,51,49,2,51
Elgin,5567,6,14,7,15,55,62,-7,49
Annan Athlet,5567,7,12,11,13,48,41,7,47
Berwick,5567,8,9,10,17,30,58,-28,37
Edinburgh Ci,5567,9,7,9,20,38,63,-25,30
Cowdenbeath,5567,10,4,10,22,23,55,-32,22
Peterhead,5568,1,24,4,8,78,38,40,76
Montrose,5568,2,23,7,6,61,37,24,76
Stirling,5568,3,17,6,13,62,51,11,57
Clyde,5568,4,15,9,12,52,48,4,54
Stenhousem'r,5568,5,15,8,13,55,48,7,53
Elgin,5568,6,15,6,15,56,62,-6,51
Annan Athlet,5568,7,11,12,13,48,42,6,45
Berwick,5568,8,8,10,18,29,59,-30,34
Edinburgh Ci,5568,9,7,9,20,36,61,-25,30
Cowdenbeath,5568,10,4,11,21,24,55,-31,23
Montrose,5569,1,23,8,5,59,34,25,77
Peterhead,5569,2,24,4,8,81,38,43,76
Stirling,5569,3,16,7,13,62,53,9,55
Stenhousem'r,5569,4,15,9,12,57,48,9,54
Clyde,5569,5,15,9,12,54,48,6,54
Elgin,5569,6,14,7,15,53,60,-7,49
Annan Athlet,5569,7,11,12,13,48,42,6,45
Berwick,5569,8,8,10,18,29,61,-32,34
Edinburgh Ci,5569,9,7,9,20,36,64,-28,30
Cowdenbeath,5569,10,4,11,21,24,55,-31,23
Montrose,5570,1,24,7,5,60,34,26,79
Peterhead,5570,2,24,4,8,80,38,42,76
Stirling,5570,3,16,7,13,62,53,9,55
Stenhousem'r,5570,4,15,9,12,57,48,9,54
Clyde,5570,5,15,9,12,53,49,4,54
Elgin,5570,6,14,6,16,53,61,-8,48
Annan Athlet,5570,7,11,11,14,48,43,5,44
Berwick,5570,8,8,10,18,30,60,-30,34
Edinburgh Ci,5570,9,7,9,20,36,63,-27,30
Cowdenbeath,5570,10,5,10,21,25,55,-30,25
Montrose,5571,1,24,7,5,62,34,28,79
Peterhead,5571,2,24,4,8,80,40,40,76
Stirling,5571,3,16,7,13,61,52,9,55
Stenhousem'r,5571,4,15,9,12,56,47,9,54
Clyde,5571,5,15,9,12,53,48,5,54
Elgin,5571,6,14,6,16,53,63,-10,48
Annan Athlet,5571,7,11,11,14,47,42,5,44
Berwick,5571,8,8,10,18,29,60,-31,34
Edinburgh Ci,5571,9,7,9,20,38,63,-25,30
Cowdenbeath,5571,10,5,10,21,24,54,-30,25
Montrose,5572,1,23,8,5,59,34,25,77
Peterhead,5572,2,24,4,8,82,38,44,76
Stenhousem'r,5572,3,16,8,12,60,46,14,56
Stirling,5572,4,16,6,14,60,56,4,54
Clyde,5572,5,14,10,12,51,48,3,52
Elgin,5572,6,14,7,15,53,60,-7,49
Annan Athlet,5572,7,12,11,13,50,43,7,47
Berwick,5572,8,8,11,17,29,58,-29,35
Edinburgh Ci,5572,9,7,9,20,36,65,-29,30
Cowdenbeath,5572,10,4,10,22,25,57,-32,22
Montrose,5573,1,23,8,5,60,35,25,77
Peterhead,5573,2,24,4,8,79,39,40,76
Stirling,5573,3,16,7,13,62,53,9,55
Stenhousem'r,5573,4,15,9,12,57,48,9,54
Clyde,5573,5,15,9,12,54,49,5,54
Elgin,5573,6,14,7,15,54,61,-7,49
Annan Athlet,5573,7,12,11,13,50,43,7,47
Berwick,5573,8,8,10,18,30,61,-31,34
Edinburgh Ci,5573,9,7,9,20,37,62,-25,30
Cowdenbeath,5573,10,4,10,22,25,57,-32,22
Montrose,5574,1,24,7,5,63,34,29,79
Peterhead,5574,2,24,4,8,80,38,42,76
Stirling,5574,3,17,6,13,62,51,11,57
Clyde,5574,4,15,9,12,52,48,4,54
Stenhousem'r,5574,5,15,8,13,55,48,7,53
Elgin,5574,6,14,6,16,53,64,-11,48
Annan Athlet,5574,7,11,12,13,48,42,6,45
Berwick,5574,8,8,10,18,29,59,-30,34
Edinburgh Ci,5574,9,7,9,20,36,63,-27,30
Cowdenbeath,5574,10,4,11,21,24,55,-31,23
Montrose,5575,1,24,7,5,60,34,26,79
Peterhead,5575,2,24,4,8,80,40,40,76
Stirling,5575,3,17,6,13,62,51,11,57
Stenhousem'r,5575,4,15,8,13,55,48,7,53
Clyde,5575,5,14,9,13,51,50,1,51
Elgin,5575,6,14,6,16,53,61,-8,48
Annan Athlet,5575,7,11,11,14,49,44,5,44
Berwick,5575,8,9,10,17,31,58,-27,37
Edinburgh Ci,5575,9,7,9,20,38,63,-25,30
Cowdenbeath,5575,10,5,10,21,26,56,-30,25
Montrose,5576,1,23,8,5,59,34,25,77
Peterhead,5576,2,23,4,9,79,41,38,73
Stirling,5576,3,16,7,13,62,53,9,55
Stenhousem'r,5576,4,15,9,12,57,48,9,54
Clyde,5576,5,14,10,12,51,48,3,52
Elgin,5576,6,14,7,15,53,60,-7,49
Annan Athlet,5576,7,11,12,13,47,41,6,45
Berwick,5576,8,8,11,17,29,58,-29,35
Edinburgh Ci,5576,9,8,9,19,39,62,-23,33
Cowdenbeath,5576,10,4,11,21,23,54,-31,23
Montrose,5577,1,23,7,6,59,35,24,76
Peterhead,5577,2,23,5,8,79,40,39,74
Stirling,5577,3,16,7,13,61,52,9,55
Stenhousem'r,5577,4,15,9,12,56,47,9,54
Clyde,5577,5,14,10,12,52,49,3,52
Elgin,5577,6,15,6,15,54,60,-6,51
Annan Athlet,5577,7,12,11,13,49,42,7,47
Berwick,5577,8,8,11,17,30,59,-29,35
Edinburgh Ci,5577,9,7,10,19,38,62,-24,31
Cowdenbeath,5577,10,4,10,22,24,56,-32,22
Montrose,5578,1,23,7,6,59,35,24,76
Peterhead,5578,2,23,4,9,77,39,38,73
Stenhousem'r,5578,3,16,8,12,57,47,10,56
Stirling,5578,4,16,6,14,61,53,8,54
Clyde,5578,5,15,9,12,52,48,4,54
Elgin,5578,6,15,6,15,54,60,-6,51
Annan Athlet,5578,7,11,11,14,47,42,5,44
Berwick,5578,8,8,10,18,29,59,-30,34
Edinburgh Ci,5578,9,8,9,19,37,60,-23,33
Cowdenbeath,5578,10,5,10,21,24,54,-30,25
Montrose,5579,1,24,7,5,62,34,28,79
Peterhead,5579,2,24,4,8,81,38,43,76
Stirling,5579,3,17,6,13,65,51,14,57
Clyde,5579,4,15,9,12,53,49,4,54
Stenhousem'r,5579,5,15,8,13,55,51,4,53
Elgin,5579,6,14,6,16,53,63,-10,48
Annan Athlet,5579,7,11,11,14,47,42,5,44
Berwick,5579,8,8,10,18,30,60,-30,34
Edinburgh Ci,5579,9,7,9,20,36,64,-28,30
Cowdenbeath,5579,10,5,10,21,24,54,-30,25
Montrose,5580,1,23,8,5,61,36,25,77
Peterhead,5580,2,23,4,9,79,41,38,73
Stirling,5580,3,17,6,13,62,51,11,57
Clyde,5580,4,15,9,12,54,50,4,54
Stenhousem'r,5580,5,15,8,13,55,48,7,53
Elgin,5580,6,14,7,15,55,62,-7,49
Annan Athlet,5580,7,11,12,13,48,42,6,45
Berwick,5580,8,8,10,18,31,61,-30,34
Edinburgh Ci,5580,9,8,9,19,39,62,-23,33
Cowdenbeath,5580,10,4,11,21,24,55,-31,23
Montrose,5581,1,24,7,5,60,34,26,79
Peterhead,5581,2,24,4,8,80,39,41,76
Stirling,5581,3,17,6,13,62,51,11,57
Clyde,5581,4,15,9,12,54,49,5,54
Stenhousem'r,5581,5,15,8,13,55,48,7,53
Elgin,5581,6,14,6,16,53,61,-8,48
Annan Athlet,5581,7,12,11,13,49,42,7,47
Berwick,5581,8,8,10,18,30,61,-31,34
Edinburgh Ci,5581,9,7,9,20,37,63,-26,30
Cowdenbeath,5581,10,4,10,22,24,56,-32,22
Montrose,5582,1,24,7,5,63,35,28,79
Peterhead,5582,2,23,4,9,79,41,38,73
Stirling,5582,3,17,6,13,61,51,10,57
Clyde,5582,4,15,9,12,55,49,6,54
Stenhousem'r,5582,5,15,8,13,55,47,8,53
Elgin,5582,6,14,6,16,54,64,-10,48
Annan Athlet,5582,7,11,12,13,49,43,6,45
Berwick,5582,8,8,10,18,30,62,-32,34
Edinburgh Ci,5582,9,8,9,19,39,62,-23,33
Cowdenbeath,5582,10,4,11,21,25,56,-31,23
Montrose,5583,1,24,7,5,61,34,27,79
Peterhead,5583,2,24,4,8,79,38,41,76
Stenhousem'r,5583,3,16,8,12,57,46,11,56
Clyde,5583,4,15,9,12,56,48,8,54
Stirling,5583,5,16,6,14,60,53,7,54
Elgin,5583,6,14,6,16,53,62,-9,48
Annan Athlet,5583,7,11,11,14,48,44,4,44
Berwick,5583,8,8,10,18,29,63,-34,34
Edinburgh Ci,5583,9,7,9,20,36,62,-26,30
Cowdenbeath,5583,10,5,10,21,26,55,-29,25
Montrose,5584,1,24,7,5,62,35,27,79
Peterhead,5584,2,24,4,8,78,38,40,76
Stirling,5584,3,16,7,13,61,52,9,55
Stenhousem'r,5584,4,15,9,12,56,47,9,54
Clyde,5584,5,15,9,12,52,48,4,54
Elgin,5584,6,14,6,16,54,63,-9,48
Annan Athlet,5584,7,11,12,13,48,42,6,45
Berwick,5584,8,8,10,18,29,59,-30,34
Edinburgh Ci,5584,9,7,9,20,36,61,-25,30
Cowdenbeath,5584,10,4,11,21,24,55,-31,23
Montrose,5585,1,24,7,5,60,34,26,79
Peterhead,5585,2,24,4,8,79,38,41,76
Stenhousem'r,5585,3,16,8,12,58,47,11,56
Stirling,5585,4,16,6,14,61,54,7,54
Clyde,5585,5,15,9,12,55,49,6,54
Elgin,5585,6,14,6,16,53,61,-8,48
Annan Athlet,5585,7,11,12,13,47,41,6,45
Berwick,5585,8,8,10,18,30,62,-32,34
Edinburgh Ci,5585,9,7,9,20,36,62,-26,30
Cowdenbeath,5585,10,4,11,21,23,54,-31,23
Montrose,5586,1,23,8,5,60,35,25,77
Peterhead,5586,2,23,4,9,78,40,38,73
Stenhousem'r,5586,3,16,8,12,58,47,11,56
Stirling,5586,4,16,6,14,61,54,7,54
Clyde,5586,5,14,9,13,51,49,2,51
Elgin,5586,6,14,7,15,54,61,-7,49
Annan Athlet,5586,7,12,11,13,49,41,8,47
Berwick,5586,8,9,10,17,30,58,-28,37
Edinburgh Ci,5586,9,8,9,19,38,61,-23,33
Cowdenbeath,5586,10,4,10,22,23,56,-33,22
Montrose,5587,1,24,7,5,63,34,29,79
Peterhead,5587,2,24,4,8,79,38,41,76
Stirling,5587,3,17,6,13,62,52,10,57
Clyde,5587,4,15,9,12,52,48,4,54
Stenhousem'r,5587,5,15,8,13,56,48,8,53
Elgin,5587,6,14,6,16,53,64,-11,48
Annan Athlet,5587,7,12,11,13,48,41,7,47
Berwick,5587,8,8,10,18,29,59,-30,34
Edinburgh Ci,5587,9,7,9,20,36,62,-26,30
Cowdenbeath,5587,10,4,10,22,23,55,-32,22
Montrose,5588,1,23,8,5,60,35,25,77
Peterhead,5588,2,24,4,8,79,39,40,76
Stenhousem'r,5588,3,16,8,12,56,46,10,56
Stirling,5588,4,16,6,14,60,52,8,54
Clyde,5588,5,15,9,12,53,48,5,54
Elgin,5588,6,14,7,15,54,61,-7,49
Annan Athlet,5588,7,12,11,13,48,41,7,47
Berwick,5588,8,8,10,18,29,60,-31,34
Edinburgh Ci,5588,9,7,9,20,37,62,-25,30
Cowdenbeath,5588,10,4,10,22,23,55,-32,22
Montrose,5589,1,23,8,5,61,36,25,77
Peterhead,5589,2,24,4,8,80,38,42,76
Stirling,5589,3,17,6,13,63,51,12,57
Stenhousem'r,5589,4,15,8,13,55,49,6,53
Clyde,5589,5,14,10,12,53,50,3,52
Elgin,5589,6,14,7,15,55,62,-7,49
Annan Athlet,5589,7,11,11,14,47,43,4,44
Berwick,5589,8,8,11,17,31,60,-29,35
Edinburgh Ci,5589,9,7,9,20,36,63,-27,30
Cowdenbeath,5589,10,5,10,21,25,54,-29,25
Montrose,5590,1,24,7,5,60,34,26,79
Peterhead,5590,2,24,4,8,79,39,40,76
Stirling,5590,3,17,6,13,62,52,10,57
Clyde,5590,4,15,9,12,54,49,5,54
Stenhousem'r,5590,5,15,8,13,56,48,8,53
Elgin,5590,6,14,6,16,53,61,-8,48
Annan Athlet,5590,7,12,11,13,49,42,7,47
Berwick,5590,8,8,10,18,30,61,-31,34
Edinburgh Ci,5590,9,7,9,20,37,62,-25,30
Cowdenbeath,5590,10,4,10,22,24,56,-32,22
Montrose,5591,1,23,8,5,60,35,25,77
Peterhead,5591,2,23,4,9,78,41,37,73
Stirling,5591,3,16,7,13,62,53,9,55
Stenhousem'r,5591,4,15,9,12,57,48,9,54
Clyde,5591,5,15,9,12,52,48,4,54
Elgin,5591,6,14,7,15,54,61,-7,49
Annan Athlet,5591,7,11,12,13,47,41,6,45
Berwick,5591,8,8,10,18,29,59,-30,34
Edinburgh Ci,5591,9,8,9,19,39,61,-22,33
Cowdenbeath,5591,10,4,11,21,23,54,-31,23
Montrose,5592,1,24,7,5,62,34,28,79
Peterhead,5592,2,24,4,8,81,39,42,76
Stirling,5592,3,17,6,13,62,51,11,57
Stenhousem'r,5592,4,15,8,13,55,48,7,53
Clyde,5592,5,14,10,12,53,50,3,52
Elgin,5592,6,14,6,16,53,63,-10,48
Annan Athlet,5592,7,12,11,13,48,41,7,47
Berwick,5592,8,8,11,17,31,60,-29,35
Edinburgh Ci,5592,9,7,9,20,37,64,-27,30
Cowdenbeath,5592,10,4,10,22,23,55,-32,22
Montrose,5593,1,24,7,5,62,34,28,79
Peterhead,5593,2,24,4,8,82,39,43,76
Stirling,5593,3,17,6,13,66,52,14,57
Clyde,5593,4,15,9,12,53,49,4,54
Stenhousem'r,5593,5,15,8,13,56,52,4,53
Elgin,5593,6,14,6,16,53,63,-10,48
Annan Athlet,5593,7,11,11,14,47,42,5,44
Berwick,5593,8,8,10,18,30,60,-30,34
Edinburgh Ci,5593,9,7,9,20,37,65,-28,30
Cowdenbeath,5593,10,5,10,21,24,54,-30,25
Montrose,5594,1,24,7,5,64,34,30,79
Peterhead,5594,2,23,4,9,78,41,37,73
Stirling,5594,3,16,7,13,61,52,9,55
Stenhousem'r,5594,4,15,9,12,56,47,9,54
Clyde,5594,5,15,9,12,53,48,5,54
Elgin,5594,6,14,6,16,53,65,-12,48
Annan Athlet,5594,7,11,11,14,47,43,4,44
Berwick,5594,8,8,10,18,29,60,-31,34
Edinburgh Ci,5594,9,8,9,19,39,61,-22,33
Cowdenbeath,5594,10,5,10,21,25,54,-29,25
Montrose,5595,1,23,8,5,60,35,25,77
Peterhead,5595,2,24,4,8,80,39,41,76
Stenhousem'r,5595,3,16,8,12,57,47,10,56
Stirling,5595,4,16,6,14,61,53,8,54
Clyde,5595,5,15,9,12,53,48,5,54
Elgin,5595,6,14,7,15,54,61,-7,49
Annan Athlet,5595,7,11,11,14,48,43,5,44
Berwick,5595,8,8,10,18,29,60,-31,34
Edinburgh Ci,5595,9,7,9,20,37,63,-26,30
Cowdenbeath,5595,10,5,10,21,25,55,-30,25
Peterhead,5596,1,24,4,8,79,39,40,76
Montrose,5596,2,23,7,6,61,37,24,76
Stirling,5596,3,17,6,13,63,51,12,57
Stenhousem'r,5596,4,15,8,13,55,49,6,53
Clyde,5596,5,14,9,13,52,50,2,51
Elgin,5596,6,15,6,15,56,62,-6,51
Annan Athlet,5596,7,12,11,13,48,41,7,47
Berwick,5596,8,9,10,17,31,59,-28,37
Edinburgh Ci,5596,9,7,9,20,37,62,-25,30
Cowdenbeath,5596,10,4,10,22,23,55,-32,22
Montrose,5597,1,24,7,5,60,34,26,79
Peterhead,5597,2,24,4,8,79,38,41,76
Stenhousem'r,5597,3,16,8,12,58,48,10,56
Stirling,5597,4,16,6,14,62,54,8,54
Clyde,5597,5,15,9,12,53,48,5,54
Elgin,5597,6,14,6,16,53,61,-8,48
Annan Athlet,5597,7,12,11,13,48,41,7,47
Berwick,5597,8,8,10,18,29,60,-31,34
Edinburgh Ci,5597,9,7,9,20,36,62,-26,30
Cowdenbeath,5597,10,4,10,22,23,55,-32,22
Peterhead,5598,1,24,4,8,84,40,44,76
Montrose,5598,2,23,7,6,59,36,23,76
Stirling,5598,3,17,6,13,65,52,13,57
Stenhousem'r,5598,4,15,8,13,56,51,5,53
Clyde,5598,5,14,9,13,51,49,2,51
Elgin,5598,6,15,6,15,55,60,-5,51
Annan Athlet,5598,7,12,11,13,49,41,8,47
Berwick,5598,8,9,10,17,30,58,-28,37
Edinburgh Ci,5598,9,7,9,20,38,67,-29,30
Cowdenbeath,5598,10,4,10,22,23,56,-33,22
Montrose,5599,1,23,8,5,60,35,25,77
Peterhead,5599,2,24,4,8,79,38,41,76
Stirling,5599,3,17,6,13,62,51,11,57
Clyde,5599,4,15,9,12,53,48,5,54
Stenhousem'r,5599,5,15,8,13,55,48,7,53
Elgin,5599,6,14,7,15,54,61,-7,49
Annan Athlet,5599,7,12,11,13,50,42,8,47
Berwick,5599,8,8,10,18,29,60,-31,34
Edinburgh Ci,5599,9,7,9,20,36,62,-26,30
Cowdenbeath,5599,10,4,10,22,24,57,-33,22
Montrose,5600,1,24,7,5,60,34,26,79
Peterhead,5600,2,23,5,8,80,41,39,74
Stirling,5600,3,16,7,13,63,54,9,55
Stenhousem'r,5600,4,15,9,12,58,49,9,54
Clyde,5600,5,14,9,13,52,50,2,51
Elgin,5600,6,14,6,16,53,61,-8,48
Annan Athlet,5600,7,12,11,13,48,41,7,47
Berwick,5600,8,9,10,17,31,59,-28,37
Edinburgh Ci,5600,9,7,10,19,39,63,-24,31
Cowdenbeath,5600,10,4,10,22,23,55,-32,22
Montrose,5601,1,24,7,5,61,34,27,79
Peterhead,5601,2,24,4,8,82,40,42,76
Stirling,5601,3,17,6,13,61,51,10,57
Clyde,5601,4,15,9,12,52,48,4,54
Stenhousem'r,5601,5,15,8,13,55,47,8,53
Elgin,5601,6,14,6,16,53,62,-9,48
Annan Athlet,5601,7,12,11,13,50,41,9,47
Berwick,5601,8,8,10,18,29,59,-30,34
Edinburgh Ci,5601,9,7,9,20,38,65,-27,30
Cowdenbeath,5601,10,4,10,22,23,57,-34,22
Peterhead,5602,1,24,4,8,81,39,42,76
Montrose,5602,2,23,7,6,59,35,24,76
Stirling,5602,3,16,7,13,60,51,9,55
Stenhousem'r,5602,4,15,9,12,55,46,9,54
Clyde,5602,5,15,9,12,54,50,4,54
Elgin,5602,6,15,6,15,54,60,-6,51
Annan Athlet,5602,7,11,11,14,49,44,5,44
Berwick,5602,8,8,10,18,31,61,-30,34
Edinburgh Ci,5602,9,7,9,20,37,64,-27,30
Cowdenbeath,5602,10,5,10,21,26,56,-30,25
Montrose,5603,1,24,7,5,62,35,27,79
Peterhead,5603,2,24,4,8,82,38,44,76
Stirling,5603,3,16,7,13,63,54,9,55
Stenhousem'r,5603,4,15,9,12,58,49,9,54
Clyde,5603,5,15,9,12,53,48,5,54
Elgin,5603,6,14,6,16,54,63,-9,48
Annan Athlet,5603,7,12,11,13,49,41,8,47
Berwick,5603,8,8,10,18,29,60,-31,34
Edinburgh Ci,5603,9,7,9,20,36,65,-29,30
Cowdenbeath,5603,10,4,10,22,23,56,-33,22
Peterhead,5604,1,24,4,8,81,40,41,76
Montrose,5604,2,23,7,6,59,36,23,76
Stirling,5604,3,16,7,13,62,53,9,55
Stenhousem'r,5604,4,15,9,12,57,48,9,54
Clyde,5604,5,15,9,12,53,49,4,54
Elgin,5604,6,15,6,15,55,60,-5,51
Annan Athlet,5604,7,12,11,13,48,41,7,47
Berwick,5604,8,8,10,18,30,60,-30,34
Edinburgh Ci,5604,9,7,9,20,38,64,-26,30
Cowdenbeath,5604,10,4,10,22,23,55,-32,22
Montrose,5605,1,24,7,5,64,34,30,79
Peterhead,5605,2,24,4,8,79,39,40,76
Stenhousem'r,5605,3,16,8,12,56,46,10,56
Stirling,5605,4,16,6,14,60,52,8,54
Clyde,5605,5,15,9,12,53,49,4,54
Elgin,5605,6,14,6,16,53,65,-12,48
Annan Athlet,5605,7,12,11,13,51,41,10,47
Berwick,5605,8,8,10,18,30,60,-30,34
Edinburgh Ci,5605,9,7,9,20,37,62,-25,30
Cowdenbeath,5605,10,4,10,22,23,58,-35,22
Montrose,5606,1,24,7,5,61,35,26,79
Peterhead,5606,2,24,4,8,83,41,42,76
Stirling,5606,3,16,7,13,62,53,9,55
Stenhousem'r,5606,4,15,9,12,57,48,9,54
Clyde,5606,5,15,9,12,53,48,5,54
Elgin,5606,6,14,6,16,54,62,-8,48
Annan Athlet,5606,7,11,12,13,47,41,6,45
Berwick,5606,8,8,10,18,29,60,-31,34
Edinburgh Ci,5606,9,7,9,20,39,66,-27,30
Cowdenbeath,5606,10,4,11,21,23,54,-31,23
Montrose,5607,1,23,8,5,60,35,25,77
Peterhead,5607,2,24,4,8,78,38,40,76
Stirling,5607,3,17,6,13,63,52,11,57
Stenhousem'r,5607,4,15,8,13,56,49,7,53
Clyde,5607,5,14,9,13,51,49,2,51
Elgin,5607,6,14,7,15,54,61,-7,49
Annan Athlet,5607,7,11,12,13,48,42,6,45
Berwick,5607,8,9,10,17,30,58,-28,37
Edinburgh Ci,5607,9,7,9,20,36,61,-25,30
Cowdenbeath,5607,10,4,11,21,24,55,-31,23
Montrose,5608,1,23,8,5,61,36,25,77
Peterhead,5608,2,24,4,8,80,39,41,76
Stirling,5608,3,17,6,13,61,51,10,57
Clyde,5608,4,15,9,12,54,48,6,54
Stenhousem'r,5608,5,15,8,13,55,47,8,53
Elgin,5608,6,14,7,15,55,62,-7,49
Annan Athlet,5608,7,12,11,13,48,41,7,47
Berwick,5608,8,8,10,18,29,61,-32,34
Edinburgh Ci,5608,9,7,9,20,37,63,-26,30
Cowdenbeath,5608,10,4,10,22,23,55,-32,22
Montrose,5609,1,24,7,5,60,34,26,79
Peterhead,5609,2,23,5,8,77,38,39,74
Stenhousem'r,5609,3,16,8,12,57,46,11,56
Stirling,5609,4,16,6,14,60,53,7,54
Clyde,5609,5,15,9,12,53,48,5,54
Elgin,5609,6,14,6,16,53,61,-8,48
Annan Athlet,5609,7,12,11,13,48,41,7,47
Berwick,5609,8,8,10,18,29,60,-31,34
Edinburgh Ci,5609,9,7,10,19,36,60,-24,31
Cowdenbeath,5609,10,4,10,22,23,55,-32,22
Montrose,5610,1,24,7,5,65,37,28,79
Peterhead,5610,2,24,4,8,80,40,40,76
Stenhousem'r,5610,3,16,8,12,59,49,10,56
Stirling,5610,4,16,6,14,63,55,8,54
Clyde,5610,5,15,9,12,54,50,4,54
Elgin,5610,6,14,6,16,56,66,-10,48
Annan Athlet,5610,7,11,11,14,47,42,5,44
Berwick,5610,8,8,10,18,31,61,-30,34
Edinburgh Ci,5610,9,7,9,20,38,63,-25,30
Cowdenbeath,5610,10,5,10,21,24,54,-30,25
Montrose,5611,1,23,7,6,61,37,24,76
Peterhead,5611,2,23,4,9,80,43,37,73
Stirling,5611,3,17,6,13,63,53,10,57
Stenhousem'r,5611,4,15,8,13,57,49,8,53
Clyde,5611,5,14,9,13,51,49,2,51
Elgin,5611,6,15,6,15,56,62,-6,51
Annan Athlet,5611,7,11,11,14,47,42,5,44
Berwick,5611,8,9,10,17,30,58,-28,37
Edinburgh Ci,5611,9,8,9,19,41,63,-22,33
Cowdenbeath,5611,10,5,10,21,24,54,-30,25
Montrose,5612,1,24,7,5,61,34,27,79
Peterhead,5612,2,24,4,8,80,38,42,76
Stenhousem'r,5612,3,16,8,12,56,46,10,56
Stirling,5612,4,16,6,14,60,52,8,54
Clyde,5612,5,15,9,12,56,48,8,54
Elgin,5612,6,14,6,16,53,62,-9,48
Annan Athlet,5612,7,11,12,13,47,41,6,45
Berwick,5612,8,8,10,18,29,63,-34,34
Edinburgh Ci,5612,9,7,9,20,36,63,-27,30
Cowdenbeath,5612,10,4,11,21,23,54,-31,23
Montrose,5613,1,24,7,5,62,34,28,79
Peterhead,5613,2,23,5,8,79,40,39,74
Stirling,5613,3,16,7,13,61,52,9,55
Stenhousem'r,5613,4,15,9,12,56,47,9,54
Clyde,5613,5,14,10,12,52,49,3,52
Elgin,5613,6,14,6,16,53,63,-10,48
Annan Athlet,5613,7,12,11,13,50,42,8,47
Berwick,5613,8,8,11,17,30,59,-29,35
Edinburgh Ci,5613,9,7,10,19,38,62,-24,31
Cowdenbeath,5613,10,4,10,22,24,57,-33,22
Montrose,5614,1,23,8,5,59,34,25,77
Peterhead,5614,2,24,4,8,80,38,42,76
Stenhousem'r,5614,3,16,8,12,56,46,10,56
Stirling,5614,4,16,6,14,60,52,8,54
Clyde,5614,5,15,9,12,54,50,4,54
Elgin,5614,6,14,7,15,53,60,-7,49
Annan Athlet,5614,7,11,12,13,47,41,6,45
Berwick,5614,8,8,10,18,31,61,-30,34
Edinburgh Ci,5614,9,7,9,20,36,63,-27,30
Cowdenbeath,5614,10,4,11,21,23,54,-31,23
Peterhead,5615,1,24,4,8,78,38,40,76
Montrose,5615,2,23,7,6,60,36,24,76
Stirling,5615,3,17,6,13,64,54,10,57
Stenhousem'r,5615,4,15,8,13,58,50,8,53
Clyde,5615,5,14,10,12,52,49,3,52
Elgin,5615,6,15,6,15,55,61,-6,51
Annan Athlet,5615,7,11,11,14,47,44,3,44
Berwick,5615,8,8,11,17,30,59,-29,35
Edinburgh Ci,5615,9,7,9,20,36,61,-25,30
Cowdenbeath,5615,10,5,10,21,26,54,-28,25
Montrose,5616,1,23,8,5,60,35,25,77
Peterhead,5616,2,24,4,8,78,38,40,76
Stirling,5616,3,17,6,13,63,52,11,57
Clyde,5616,4,15,9,12,54,49,5,54
Stenhousem'r,5616,5,15,8,13,56,49,7,53
Elgin,5616,6,14,7,15,54,61,-7,49
Annan Athlet,5616,7,11,11,14,47,43,4,44
Berwick,5616,8,8,10,18,30,61,-31,34
Edinburgh Ci,5616,9,7,9,20,36,61,-25,30
Cowdenbeath,5616,10,5,10,21,25,54,-29,25
Peterhead,5617,1,24,4,8,80,38,42,76
Montrose,5617,2,23,7,6,60,36,24,76
Stirling,5617,3,17,6,13,62,51,11,57
Stenhousem'r,5617,4,15,8,13,55,48,7,53
Clyde,5617,5,14,9,13,51,49,2,51
Elgin,5617,6,15,6,15,55,61,-6,51
Annan Athlet,5617,7,11,12,13,47,41,6,45
Berwick,5617,8,9,10,17,30,58,-28,37
Edinburgh Ci,5617,9,7,9,20,36,63,-27,30
Cowdenbeath,5617,10,4,11,21,23,54,-31,23
Montrose,5618,1,23,8,5,61,36,25,77
Peterhead,5618,2,23,5,8,77,38,39,74
Stirling,5618,3,17,6,13,61,51,10,57
Clyde,5618,4,15,9,12,57,49,8,54
Stenhousem'r,5618,5,15,8,13,55,47,8,53
Elgin,5618,6,14,7,15,55,62,-7,49
Annan Athlet,5618,7,11,11,14,49,44,5,44
Berwick,5618,8,8,10,18,30,64,-34,34
Edinburgh Ci,5618,9,7,10,19,36,60,-24,31
Cowdenbeath,5618,10,5,10,21,26,56,-30,25
Montrose,5619,1,24,7,5,61,35,26,79
Peterhead,5619,2,23,5,8,78,39,39,74
Stirling,5619,3,16,7,13,62,53,9,55
Stenhousem'r,5619,4,15,9,12,57,48,9,54
Clyde,5619,5,15,9,12,54,50,4,54
Elgin,5619,6,14,6,16,54,62,-8,48
Annan Athlet,5619,7,11,11,14,47,43,4,44
Berwick,5619,8,8,10,18,31,61,-30,34
Edinburgh Ci,5619,9,7,10,19,37,61,-24,31
Cowdenbeath,5619,10,5,10,21,25,54,-29,25
Montrose,5620,1,24,7,5,62,36,26,79
Peterhead,5620,2,23,5,8,79,40,39,74
Stirling,5620,3,16,7,13,63,54,9,55
Stenhousem'r,5620,4,15,9,12,58,49,9,54
Clyde,5620,5,15,9,12,53,48,5,54
Elgin,5620,6,14,6,16,55,63,-8,48
Annan Athlet,5620,7,12,11,13,50,41,9,47
Berwick,5620,8,8,10,18,29,60,-31,34
Edinburgh Ci,5620,9,7,10,19,38,62,-24,31
Cowdenbeath,5620,10,4,10,22,23,57,-34,22
Montrose,5621,1,24,7,5,61,34,27,79
Peterhead,5621,2,24,4,8,79,39,40,76
Stirling,5621,3,17,6,13,62,51,11,57
Clyde,5621,4,15,9,12,53,48,5,54
Stenhousem'r,5621,5,15,8,13,55,48,7,53
Elgin,5621,6,14,6,16,53,62,-9,48
Annan Athlet,5621,7,11,12,13,48,42,6,45
Berwick,5621,8,8,10,18,29,60,-31,34
Edinburgh Ci,5621,9,7,9,20,37,62,-25,30
Cowdenbeath,5621,10,4,11,21,24,55,-31,23
Montrose,5622,1,23,8,5,60,35,25,77
Peterhead,5622,2,24,4,8,81,41,40,76
Stirling,5622,3,16,7,13,61,52,9,55
Stenhousem'r,5622,4,15,9,12,56,47,9,54
Clyde,5622,5,15,9,12,54,49,5,54
Elgin,5622,6,14,7,15,54,61,-7,49
Annan Athlet,5622,7,11,12,13,47,41,6,45
Berwick,5622,8,8,10,18,30,61,-31,34
Edinburgh Ci,5622,9,7,9,20,39,64,-25,30
Cowdenbeath,5622,10,4,11,21,23,54,-31,23
Montrose,5623,1,24,7,5,60,34,26,79
Peterhead,5623,2,24,4,8,78,38,40,76
Stirling,5623,3,17,6,13,62,52,10,57
Stenhousem'r,5623,4,15,8,13,56,48,8,53
Clyde,5623,5,14,10,12,52,49,3,52
Elgin,5623,6,14,6,16,53,61,-8,48
Annan Athlet,5623,7,11,11,14,47,42,5,44
Berwick,5623,8,8,11,17,30,59,-29,35
Edinburgh Ci,5623,9,7,9,20,36,61,-25,30
Cowdenbeath,5623,10,5,10,21,24,54,-30,25
Montrose,5624,1,24,7,5,63,36,27,79
Peterhead,5624,2,24,4,8,78,38,40,76
Stirling,5624,3,17,6,13,62,51,11,57
Stenhousem'r,5624,4,15,8,13,55,48,7,53
Clyde,5624,5,14,10,12,53,50,3,52
Elgin,5624,6,14,6,16,55,64,-9,48
Annan Athlet,5624,7,11,12,13,48,42,6,45
Berwick,5624,8,8,11,17,31,60,-29,35
Edinburgh Ci,5624,9,7,9,20,36,61,-25,30
Cowdenbeath,5624,10,4,11,21,24,55,-31,23
Montrose,5625,1,24,7,5,64,36,28,79
Peterhead,5625,2,23,4,9,77,41,36,73
Stenhousem'r,5625,3,16,8,12,57,46,11,56
Stirling,5625,4,16,6,14,60,53,7,54
Clyde,5625,5,15,9,12,53,49,4,54
Elgin,5625,6,14,6,16,55,65,-10,48
Annan Athlet,5625,7,11,12,13,47,41,6,45
Berwick,5625,8,8,10,18,30,60,-30,34
Edinburgh Ci,5625,9,8,9,19,39,60,-21,33
Cowdenbeath,5625,10,4,11,21,23,54,-31,23
Montrose,5626,1,24,7,5,61,34,27,79
Peterhead,5626,2,24,4,8,81,40,41,76
Stenhousem'r,5626,3,16,8,12,57,46,11,56
Stirling,5626,4,16,6,14,60,53,7,54
Clyde,5626,5,15,9,12,52,48,4,54
Elgin,5626,6,14,6,16,53,62,-9,48
Annan Athlet,5626,7,11,12,13,47,41,6,45
Berwick,5626,8,8,10,18,29,59,-30,34
Edinburgh Ci,5626,9,7,9,20,38,64,-26,30
Cowdenbeath,5626,10,4,11,21,23,54,-31,23
Montrose,5627,1,24,7,5,61,34,27,79
Peterhead,5627,2,23,5,8,79,40,39,74
Stirling,5627,3,17,6,13,63,52,11,57
Clyde,5627,4,15,9,12,55,48,7,54
Stenhousem'r,5627,5,15,8,13,56,49,7,53
Elgin,5627,6,14,6,16,53,62,-9,48
Annan Athlet,5627,7,11,11,14,47,43,4,44
Berwick,5627,8,8,10,18,29,62,-33,34
Edinburgh Ci,5627,9,7,10,19,38,62,-24,31
Cowdenbeath,5627,10,5,10,21,25,54,-29,25
Peterhead,5628,1,24,4,8,79,38,41,76
Montrose,5628,2,23,7,6,59,35,24,76
Stirling,5628,3,16,7,13,61,52,9,55
Stenhousem'r,5628,4,15,9,12,56,47,9,54
Clyde,5628,5,15,9,12,52,48,4,54
Elgin,5628,6,15,6,15,54,60,-6,51
Annan Athlet,5628,7,11,11,14,49,44,5,44
Berwick,5628,8,8,10,18,29,59,-30,34
Edinburgh Ci,5628,9,7,9,20,36,62,-26,30
Cowdenbeath,5628,10,5,10,21,26,56,-30,25
Montrose,5629,1,24,7,5,61,35,26,79
Peterhead,5629,2,24,4,8,80,40,40,76
Stirling,5629,3,17,6,13,63,51,12,57
Stenhousem'r,5629,4,15,8,13,55,49,6,53
Clyde,5629,5,14,10,12,51,48,3,52
Elgin,5629,6,14,6,16,54,62,-8,48
Annan Athlet,5629,7,11,12,13,48,42,6,45
Berwick,5629,8,8,11,17,29,58,-29,35
Edinburgh Ci,5629,9,7,9,20,38,63,-25,30
Cowdenbeath,5629,10,4,11,21,24,55,-31,23
Montrose,5630,1,24,7,5,62,34,28,79
Peterhead,5630,2,23,5,8,80,41,39,74
Stirling,5630,3,17,6,13,64,52,12,57
Stenhousem'r,5630,4,15,8,13,56,50,6,53
Clyde,5630,5,14,9,13,51,49,2,51
Elgin,5630,6,14,6,16,53,63,-10,48
Annan Athlet,5630,7,12,11,13,49,42,7,47
Berwick,5630,8,9,10,17,30,58,-28,37
Edinburgh Ci,5630,9,7,10,19,39,63,-24,31
Cowdenbeath,5630,10,4,10,22,24,56,-32,22
Montrose,5631,1,23,8,5,60,35,25,77
Peterhead,5631,2,24,4,8,81,39,42,76
Stirling,5631,3,17,6,13,61,51,10,57
Clyde,5631,4,15,9,12,52,48,4,54
Stenhousem'r,5631,5,15,8,13,55,47,8,53
Elgin,5631,6,14,7,15,54,61,-7,49
Annan Athlet,5631,7,11,12,13,48,42,6,45
Berwick,5631,8,8,10,18,29,59,-30,34
Edinburgh Ci,5631,9,7,9,20,37,64,-27,30
Cowdenbeath,5631,10,4,11,21,24,55,-31,23
Peterhead,5632,1,24,4,8,79,38,41,76
Montrose,5632,2,23,7,6,59,38,21,76
Stenhousem'r,5632,3,16,8,12,56,46,10,56
Stirling,5632,4,16,6,14,60,52,8,54
Clyde,5632,5,15,9,12,53,48,5,54
Elgin,5632,6,15,6,15,57,60,-3,51
Annan Athlet,5632,7,11,12,13,48,42,6,45
Berwick,5632,8,8,10,18,29,60,-31,34
Edinburgh Ci,5632,9,7,9,20,36,62,-26,30
Cowdenbeath,5632,10,4,11,21,24,55,-31,23
Montrose,5633,1,23,8,5,59,34,25,77
Peterhead,5633,2,24,4,8,79,39,40,76
Stirling,5633,3,16,7,13,61,52,9,55
Stenhousem'r,5633,4,15,9,12,56,47,9,54
Clyde,5633,5,15,9,12,53,49,4,54
Elgin,5633,6,14,7,15,53,60,-7,49
Annan Athlet,5633,7,11,11,14,48,44,4,44
Berwick,5633,8,8,10,18,30,60,-30,34
Edinburgh Ci,5633,9,7,9,20,37,62,-25,30
Cowdenbeath,5633,10,5,10,21,26,55,-29,25
Montrose,5634,1,23,8,5,60,35,25,77
Peterhead,5634,2,24,4,8,80,39,41,76
Stenhousem'r,5634,3,16,8,12,58,48,10,56
Stirling,5634,4,16,6,14,62,54,8,54
Clyde,5634,5,15,9,12,54,48,6,54
Elgin,5634,6,14,7,15,54,61,-7,49
Annan Athlet,5634,7,12,11,13,49,42,7,47
Berwick,5634,8,8,10,18,29,61,-32,34
Edinburgh Ci,5634,9,7,9,20,37,63,-26,30
Cowdenbeath,5634,10,4,10,22,24,56,-32,22
Montrose,5635,1,23,8,5,60,35,25,77
Peterhead,5635,2,24,4,8,81,38,43,76
Stirling,5635,3,17,6,13,61,51,10,57
Stenhousem'r,5635,4,15,8,13,55,47,8,53
Clyde,5635,5,14,9,13,51,50,1,51
Elgin,5635,6,14,7,15,54,61,-7,49
Annan Athlet,5635,7,11,12,13,48,42,6,45
Berwick,5635,8,9,10,17,31,58,-27,37
Edinburgh Ci,5635,9,7,9,20,36,64,-28,30
Cowdenbeath,5635,10,4,11,21,24,55,-31,23
Montrose,5636,1,24,7,5,60,34,26,79
Peterhead,5636,2,24,4,8,81,38,43,76
Stirling,5636,3,17,6,13,62,51,11,57
Stenhousem'r,5636,4,15,8,13,55,48,7,53
Clyde,5636,5,14,9,13,51,49,2,51
Elgin,5636,6,14,6,16,53,61,-8,48
Annan Athlet,5636,7,11,12,13,48,42,6,45
Berwick,5636,8,9,10,17,30,58,-28,37
Edinburgh Ci,5636,9,7,9,20,36,64,-28,30
Cowdenbeath,5636,10,4,11,21,24,55,-31,23
Montrose,5637,1,24,7,5,62,34,28,79
Peterhead,5637,2,24,4,8,80,38,42,76
Stirling,5637,3,16,7,13,62,53,9,55
Stenhousem'r,5637,4,15,9,12,57,48,9,54
Clyde,5637,5,14,10,12,53,50,3,52
Elgin,5637,6,14,6,16,53,63,-10,48
Annan Athlet,5637,7,11,11,14,47,42,5,44
Berwick,5637,8,8,11,17,31,60,-29,35
Edinburgh Ci,5637,9,7,9,20,36,63,-27,30
Cowdenbeath,5637,10,5,10,21,24,54,-30,25
Montrose,5638,1,24,7,5,62,35,27,79
Peterhead,5638,2,23,5,8,77,38,39,74
Stirling,5638,3,17,6,13,61,51,10,57
Stenhousem'r,5638,4,15,8,13,55,47,8,53
Clyde,5638,5,14,10,12,54,51,3,52
Elgin,5638,6,14,6,16,54,63,-9,48
Annan Athlet,5638,7,11,12,13,49,43,6,45
Berwick,5638,8,8,11,17,32,61,-29,35
Edinburgh Ci,5638,9,7,10,19,36,60,-24,31
Cowdenbeath,5638,10,4,11,21,25,56,-31,23
Peterhead,5639,1,24,4,8,78,38,40,76
Montrose,5639,2,23,7,6,60,36,24,76
Stirling,5639,3,17,6,13,63,52,11,57
Clyde,5639,4,15,9,12,53,48,5,54
Stenhousem'r,5639,5,15,8,13,56,49,7,53
Elgin,5639,6,15,6,15,55,61,-6,51
Annan Athlet,5639,7,11,12,13,47,41,6,45
Berwick,5639,8,8,10,18,29,60,-31,34
Edinburgh Ci,5639,9,7,9,20,36,61,-25,30
Cowdenbeath,5639,10,4,11,21,23,54,-31,23
Montrose,5640,1,23,8,5,59,34,25,77
Peterhead,5640,2,24,4,8,81,40,41,76
Stirling,5640,3,16,7,13,60,51,9,55
Stenhousem'r,5640,4,15,9,12,55,46,9,54
Clyde,5640,5,14,10,12,53,50,3,52
Elgin,5640,6,14,7,15,53,60,-7,49
Annan Athlet,5640,7,11,11,14,47,42,5,44
Berwick,5640,8,8,11,17,31,60,-29,35
Edinburgh Ci,5640,9,7,9,20,38,64,-26,30
Cowdenbeath,5640,10,5,10,21,24,54,-30,25
Montrose,5641,1,24,7,5,62,35,27,79
Peterhead,5641,2,24,4,8,78,38,40,76
Stirling,5641,3,16,7,13,62,53,9,55
Stenhousem'r,5641,4,15,9,12,57,48,9,54
Clyde,5641,5,15,9,12,54,49,5,54
Elgin,5641,6,14,6,16,54,63,-9,48
Annan Athlet,5641,7,12,11,13,50,41,9,47
Berwick,5641,8,8,10,18,30,61,-31,34
Edinburgh Ci,5641,9,7,9,20,36,61,-25,30
Cowdenbeath,5641,10,4,10,22,23,57,-34,22
Montrose,5642,1,24,7,5,61,34,27,79
Peterhead,5642,2,24,4,8,80,38,42,76
Stirling,5642,3,17,6,13,63,52,11,57
Stenhousem'r,5642,4,15,8,13,56,49,7,53
Clyde,5642,5,14,10,12,52,49,3,52
Elgin,5642,6,14,6,16,53,62,-9,48
Annan Athlet,5642,7,12,11,13,49,42,7,47
Berwick,5642,8,8,11,17,30,59,-29,35
Edinburgh Ci,5642,9,7,9,20,36,63,-27,30
Cowdenbeath,5642,10,4,10,22,24,56,-32,22
Montrose,5643,1,24,7,5,61,34,27,79
Peterhead,5643,2,24,4,8,84,39,45,76
Stenhousem'r,5643,3,16,8,12,57,46,11,56
Stirling,5643,4,16,6,14,60,53,7,54
Clyde,5643,5,15,9,12,54,48,6,54
Elgin,5643,6,14,6,16,53,62,-9,48
Annan Athlet,5643,7,12,11,13,48,41,7,47
Berwick,5643,8,8,10,18,29,61,-32,34
Edinburgh Ci,5643,9,7,9,20,37,67,-30,30
Cowdenbeath,5643,10,4,10,22,23,55,-32,22
Montrose,5644,1,24,7,5,61,34,27,79
Peterhead,5644,2,23,4,9,77,39,38,73
Stirling,5644,3,17,6,13,63,53,10,57
Clyde,5644,4,15,9,12,53,48,5,54
Stenhousem'r,5644,5,15,8,13,57,49,8,53
Elgin,5644,6,14,6,16,53,62,-9,48
Annan Athlet,5644,7,12,11,13,51,43,8,47
Berwick,5644,8,8,10,18,29,60,-31,34
Edinburgh Ci,5644,9,8,9,19,37,60,-23,33
Cowdenbeath,5644,10,4,10,22,25,58,-33,22
Montrose,5645,1,23,8,5,60,35,25,77
Peterhead,5645,2,23,4,9,78,40,38,73
Stirling,5645,3,17,6,13,63,52,11,57
Stenhousem'r,5645,4,15,8,13,56,49,7,53
Clyde,5645,5,14,10,12,51,48,3,52
Elgin,5645,6,14,7,15,54,61,-7,49
Annan Athlet,5645,7,11,11,14,48,44,4,44
Berwick,5645,8,8,11,17,29,58,-29,35
Edinburgh Ci,5645,9,8,9,19,38,61,-23,33
Cowdenbeath,5645,10,5,10,21,26,55,-29,25
Montrose,5646,1,24,7,5,60,34,26,79
Peterhead,5646,2,24,4,8,82,41,41,76
Stirling,5646,3,17,6,13,62,51,11,57
Clyde,5646,4,15,9,12,54,49,5,54
Stenhousem'r,5646,5,15,8,13,55,48,7,53
Elgin,5646,6,14,6,16,53,61,-8,48
Annan Athlet,5646,7,11,11,14,48,43,5,44
Berwick,5646,8,8,10,18,30,61,-31,34
Edinburgh Ci,5646,9,7,9,20,39,65,-26,30
Cowdenbeath,5646,10,5,10,21,25,55,-30,25
Montrose,5647,1,24,7,5,62,34,28,79
Peterhead,5647,2,24,4,8,78,38,40,76
Stirling,5647,3,17,6,13,62,51,11,57
Clyde,5647,4,15,9,12,52,48,4,54
Stenhousem'r,5647,5,15,8,13,55,48,7,53
Elgin,5647,6,14,6,16,53,63,-10,48
Annan Athlet,5647,7,11,11,14,47,43,4,44
Berwick,5647,8,8,10,18,29,59,-30,34
Edinburgh Ci,5647,9,7,9,20,36,61,-25,30
Cowdenbeath,5647,10,5,10,21,25,54,-29,25
Montrose,5648,1,23,8,5,59,34,25,77
Peterhead,5648,2,23,5,8,79,40,39,74
Stirling,5648,3,16,7,13,61,52,9,55
Stenhousem'r,5648,4,15,9,12,56,47,9,54
Clyde,5648,5,15,9,12,53,48,5,54
Elgin,5648,6,14,7,15,53,60,-7,49
Annan Athlet,5648,7,11,11,14,47,42,5,44
Berwick,5648,8,8,10,18,29,60,-31,34
Edinburgh Ci,5648,9,7,10,19,38,62,-24,31
Cowdenbeath,5648,10,5,10,21,24,54,-30,25
Montrose,5649,1,24,7,5,62,34,28,79
Peterhead,5649,2,24,4,8,82,38,44,76
Stirling,5649,3,17,6,13,62,52,10,57
Clyde,5649,4,15,9,12,53,48,5,54
Stenhousem'r,5649,5,15,8,13,56,48,8,53
Elgin,5649,6,14,6,16,53,63,-10,48
Annan Athlet,5649,7,11,11,14,47,42,5,44
Berwick,5649,8,8,10,18,29,60,-31,34
Edinburgh Ci,5649,9,7,9,20,36,65,-29,30
Cowdenbeath,5649,10,5,10,21,24,54,-30,25
Montrose,5650,1,23,8,5,60,35,25,77
Peterhead,5650,2,24,4,8,81,40,41,76
Stenhousem'r,5650,3,16,8,12,57,46,11,56
Stirling,5650,4,16,6,14,60,53,7,54
Clyde,5650,5,15,9,12,52,48,4,54
Elgin,5650,6,14,7,15,54,61,-7,49
Annan Athlet,5650,7,11,11,14,47,42,5,44
Berwick,5650,8,8,10,18,29,59,-30,34
Edinburgh Ci,5650,9,7,9,20,38,64,-26,30
Cowdenbeath,5650,10,5,10,21,24,54,-30,25
Montrose,5651,1,23,8,5,60,35,25,77
Peterhead,5651,2,23,5,8,78,39,39,74
Stirling,5651,3,17,6,13,62,52,10,57
Stenhousem'r,5651,4,15,8,13,56,48,8,53
Clyde,5651,5,14,9,13,51,49,2,51
Elgin,5651,6,14,7,15,54,61,-7,49
Annan Athlet,5651,7,11,11,14,47,42,5,44
Berwick,5651,8,9,10,17,30,58,-28,37
Edinburgh Ci,5651,9,7,10,19,37,61,-24,31
Cowdenbeath,5651,10,5,10,21,24,54,-30,25
Montrose,5652,1,24,7,5,61,34,27,79
Peterhead,5652,2,24,4,8,83,38,45,76
Stirling,5652,3,16,7,13,60,51,9,55
Stenhousem'r,5652,4,15,9,12,55,46,9,54
Clyde,5652,5,14,9,13,51,50,1,51
Elgin,5652,6,14,6,16,53,62,-9,48
Annan Athlet,5652,7,12,11,13,50,43,7,47
Berwick,5652,8,9,10,17,31,58,-27,37
Edinburgh Ci,5652,9,7,9,20,36,66,-30,30
Cowdenbeath,5652,10,4,10,22,25,57,-32,22
Montrose,5653,1,24,7,5,61,34,27,79
Peterhead,5653,2,23,4,9,79,41,38,73
Stirling,5653,3,17,6,13,64,54,10,57
Stenhousem'r,5653,4,15,8,13,58,50,8,53
Clyde,5653,5,14,10,12,54,51,3,52
Elgin,5653,6,14,6,16,53,62,-9,48
Annan Athlet,5653,7,11,11,14,47,43,4,44
Berwick,5653,8,8,11,17,32,61,-29,35
Edinburgh Ci,5653,9,8,9,19,39,62,-23,33
Cowdenbeath,5653,10,5,10,21,25,54,-29,25
Montrose,5654,1,23,7,6,59,36,23,76
Peterhead,5654,2,23,5,8,77,38,39,74
Stirling,5654,3,17,6,13,63,51,12,57
Clyde,5654,4,15,9,12,54,49,5,54
Stenhousem'r,5654,5,15,8,13,55,49,6,53
Elgin,5654,6,15,6,15,55,60,-5,51
Annan Athlet,5654,7,12,11,13,49,41,8,47
Berwick,5654,8,8,10,18,30,61,-31,34
Edinburgh Ci,5654,9,7,10,19,36,60,-24,31
Cowdenbeath,5654,10,4,10,22,23,56,-33,22
Peterhead,5655,1,24,4,8,80,40,40,76
Montrose,5655,2,23,7,6,59,35,24,76
Stenhousem'r,5655,3,16,8,12,60,47,13,56
Stirling,5655,4,16,6,14,61,56,5,54
Clyde,5655,5,14,9,13,53,51,2,51
Elgin,5655,6,15,6,15,54,60,-6,51
Annan Athlet,5655,7,11,12,13,47,41,6,45
Berwick,5655,8,9,10,17,32,60,-28,37
Edinburgh Ci,5655,9,7,9,20,38,63,-25,30
Cowdenbeath,5655,10,4,11,21,23,54,-31,23
Peterhead,5656,1,24,4,8,80,38,42,76
Montrose,5656,2,23,7,6,62,38,24,76
Stirling,5656,3,17,6,13,66,51,15,57
Clyde,5656,4,15,9,12,56,48,8,54
Stenhousem'r,5656,5,15,8,13,55,52,3,53
Elgin,5656,6,15,6,15,57,63,-6,51
Annan Athlet,5656,7,11,11,14,47,42,5,44
Berwick,5656,8,8,10,18,29,63,-34,34
Edinburgh Ci,5656,9,7,9,20,36,63,-27,30
Cowdenbeath,5656,10,5,10,21,24,54,-30,25
Montrose,5657,1,24,7,5,65,36,29,79
Peterhead,5657,2,24,4,8,78,38,40,76
Stenhousem'r,5657,3,16,8,12,59,47,12,56
Stirling,5657,4,16,6,14,61,55,6,54
Clyde,5657,5,15,9,12,54,49,5,54
Elgin,5657,6,14,6,16,55,66,-11,48
Annan Athlet,5657,7,12,11,13,48,41,7,47
Berwick,5657,8,8,10,18,30,61,-31,34
Edinburgh Ci,5657,9,7,9,20,36,61,-25,30
Cowdenbeath,5657,10,4,10,22,23,55,-32,22
Montrose,5658,1,24,7,5,63,34,29,79
Peterhead,5658,2,24,4,8,83,40,43,76
Stenhousem'r,5658,3,16,8,12,56,46,10,56
Stirling,5658,4,16,6,14,60,52,8,54
Clyde,5658,5,15,9,12,54,49,5,54
Elgin,5658,6,14,6,16,53,64,-11,48
Annan Athlet,5658,7,11,11,14,47,42,5,44
Berwick,5658,8,8,10,18,30,61,-31,34
Edinburgh Ci,5658,9,7,9,20,38,66,-28,30
Cowdenbeath,5658,10,5,10,21,24,54,-30,25
Montrose,5659,1,24,7,5,62,36,26,79
Peterhead,5659,2,24,4,8,83,39,44,76
Stirling,5659,3,16,7,13,64,55,9,55
Stenhousem'r,5659,4,15,9,12,59,50,9,54
Clyde,5659,5,14,10,12,52,49,3,52
Elgin,5659,6,14,6,16,55,63,-8,48
Annan Athlet,5659,7,11,11,14,48,44,4,44
Berwick,5659,8,8,11,17,30,59,-29,35
Edinburgh Ci,5659,9,7,9,20,37,66,-29,30
Cowdenbeath,5659,10,5,10,21,26,55,-29,25
Montrose,5660,1,23,7,6,60,37,23,76
Peterhead,5660,2,23,5,8,79,40,39,74
Stirling,5660,3,17,6,13,63,51,12,57
Stenhousem'r,5660,4,15,8,13,55,49,6,53
Clyde,5660,5,14,10,12,51,48,3,52
Elgin,5660,6,15,6,15,56,61,-5,51
Annan Athlet,5660,7,11,12,13,48,42,6,45
Berwick,5660,8,8,11,17,29,58,-29,35
Edinburgh Ci,5660,9,7,10,19,38,62,-24,31
Cowdenbeath,5660,10,4,11,21,24,55,-31,23
Montrose,5661,1,23,8,5,60,35,25,77
Peterhead,5661,2,24,4,8,79,38,41,76
Stirling,5661,3,16,7,13,60,51,9,55
Stenhousem'r,5661,4,15,9,12,55,46,9,54
Clyde,5661,5,15,9,12,52,48,4,54
Elgin,5661,6,14,7,15,54,61,-7,49
Annan Athlet,5661,7,11,12,13,48,42,6,45
Berwick,5661,8,8,10,18,29,59,-30,34
Edinburgh Ci,5661,9,7,9,20,36,62,-26,30
Cowdenbeath,5661,10,4,11,21,24,55,-31,23
Montrose,5662,1,24,7,5,61,35,26,79
Peterhead,5662,2,23,4,9,78,40,38,73
Stirling,5662,3,17,6,13,63,52,11,57
Clyde,5662,4,15,9,12,54,48,6,54
Stenhousem'r,5662,5,15,8,13,56,49,7,53
Elgin,5662,6,14,6,16,54,62,-8,48
Annan Athlet,5662,7,12,11,13,48,41,7,47
Berwick,5662,8,8,10,18,29,61,-32,34
Edinburgh Ci,5662,9,8,9,19,38,61,-23,33
Cowdenbeath,5662,10,4,10,22,23,55,-32,22
Montrose,5663,1,23,8,5,62,37,25,77
Peterhead,5663,2,23,5,8,79,40,39,74
Stenhousem'r,5663,3,16,8,12,60,47,13,56
Clyde,5663,4,15,9,12,56,48,8,54
Stirling,5663,5,16,6,14,61,56,5,54
Elgin,5663,6,14,7,15,56,63,-7,49
Annan Athlet,5663,7,11,11,14,47,43,4,44
Berwick,5663,8,8,10,18,29,63,-34,34
Edinburgh Ci,5663,9,7,10,19,38,62,-24,31
Cowdenbeath,5663,10,5,10,21,25,54,-29,25
Montrose,5664,1,24,7,5,63,35,28,79
Peterhead,5664,2,23,4,9,79,41,38,73
Stirling,5664,3,17,6,13,63,53,10,57
Clyde,5664,4,15,9,12,53,48,5,54
Stenhousem'r,5664,5,15,8,13,57,49,8,53
Elgin,5664,6,14,6,16,54,64,-10,48
Annan Athlet,5664,7,11,11,14,47,42,5,44
Berwick,5664,8,8,10,18,29,60,-31,34
Edinburgh Ci,5664,9,8,9,19,39,62,-23,33
Cowdenbeath,5664,10,5,10,21,24,54,-30,25
Montrose,5665,1,24,7,5,62,34,28,79
Peterhead,5665,2,23,4,9,77,39,38,73
Stirling,5665,3,16,7,13,62,53,9,55
Stenhousem'r,5665,4,15,9,12,57,48,9,54
Clyde,5665,5,14,9,13,51,49,2,51
Elgin,5665,6,14,6,16,53,63,-10,48
Annan Athlet,5665,7,11,11,14,47,42,5,44
Berwick,5665,8,9,10,17,30,58,-28,37
Edinburgh Ci,5665,9,8,9,19,37,60,-23,33
Cowdenbeath,5665,10,5,10,21,24,54,-30,25
Montrose,5666,1,24,7,5,61,34,27,79
Peterhead,5666,2,24,4,8,78,38,40,76
Stirling,5666,3,17,6,13,62,51,11,57
Stenhousem'r,5666,4,15,8,13,55,48,7,53
Clyde,5666,5,14,10,12,52,49,3,52
Elgin,5666,6,14,6,16,53,62,-9,48
Annan Athlet,5666,7,12,11,13,49,41,8,47
Berwick,5666,8,8,11,17,30,59,-29,35
Edinburgh Ci,5666,9,7,9,20,36,61,-25,30
Cowdenbeath,5666,10,4,10,22,23,56,-33,22
Montrose,5667,1,24,7,5,62,35,27,79
Peterhead,5667,2,24,4,8,79,38,41,76
Stirling,5667,3,17,6,13,64,52,12,57
Clyde,5667,4,15,9,12,54,48,6,54
Stenhousem'r,5667,5,15,8,13,56,50,6,53
Elgin,5667,6,14,6,16,54,63,-9,48
Annan Athlet,5667,7,11,12,13,48,42,6,45
Berwick,5667,8,8,10,18,29,61,-32,34
Edinburgh Ci,5667,9,7,9,20,36,62,-26,30
Cowdenbeath,5667,10,4,11,21,24,55,-31,23
Montrose,5668,1,23,8,5,59,34,25,77
Peterhead,5668,2,24,4,8,84,38,46,76
Stirling,5668,3,17,6,13,62,51,11,57
Stenhousem'r,5668,4,15,8,13,55,48,7,53
Clyde,5668,5,14,10,12,52,49,3,52
Elgin,5668,6,14,7,15,53,60,-7,49
Annan Athlet,5668,7,11,11,14,47,42,5,44
Berwick,5668,8,8,11,17,30,59,-29,35
Edinburgh Ci,5668,9,7,9,20,36,67,-31,30
Cowdenbeath,5668,10,5,10,21,24,54,-30,25
Montrose,5669,1,23,7,6,59,35,24,76
Peterhead,5669,2,23,4,9,78,40,38,73
Stenhousem'r,5669,3,16,8,12,56,46,10,56
Stirling,5669,4,16,6,14,60,52,8,54
Clyde,5669,5,15,9,12,53,49,4,54
Elgin,5669,6,15,6,15,54,60,-6,51
Annan Athlet,5669,7,12,11,13,50,43,7,47
Berwick,5669,8,8,10,18,30,60,-30,34
Edinburgh Ci,5669,9,8,9,19,38,61,-23,33
Cowdenbeath,5669,10,4,10,22,25,57,-32,22
Montrose,5670,1,23,8,5,60,35,25,77
Peterhead,5670,2,24,4,8,80,39,41,76
Stirling,5670,3,17,6,13,61,51,10,57
Stenhousem'r,5670,4,15,8,13,55,47,8,53
Clyde,5670,5,14,9,13,51,49,2,51
Elgin,5670,6,14,7,15,54,61,-7,49
Annan Athlet,5670,7,11,11,14,47,42,5,44
Berwick,5670,8,9,10,17,30,58,-28,37
Edinburgh Ci,5670,9,7,9,20,37,63,-26,30
Cowdenbeath,5670,10,5,10,21,24,54,-30,25
Montrose,5671,1,23,7,6,60,36,24,76
Peterhead,5671,2,23,5,8,78,39,39,74
Stirling,5671,3,17,6,13,63,51,12,57
Stenhousem'r,5671,4,15,8,13,55,49,6,53
Clyde,5671,5,14,10,12,53,50,3,52
Elgin,5671,6,15,6,15,55,61,-6,51
Annan Athlet,5671,7,12,11,13,49,41,8,47
Berwick,5671,8,8,11,17,31,60,-29,35
Edinburgh Ci,5671,9,7,10,19,37,61,-24,31
Cowdenbeath,5671,10,4,10,22,23,56,-33,22
Montrose,5672,1,24,7,5,63,35,28,79
Peterhead,5672,2,23,5,8,78,39,39,74
Stirling,5672,3,17,6,13,63,52,11,57
Clyde,5672,4,15,9,12,53,48,5,54
Stenhousem'r,5672,5,15,8,13,56,49,7,53
Elgin,5672,6,14,6,16,54,64,-10,48
Annan Athlet,5672,7,11,11,14,47,44,3,44
Berwick,5672,8,8,10,18,29,60,-31,34
Edinburgh Ci,5672,9,7,10,19,37,61,-24,31
Cowdenbeath,5672,10,5,10,21,26,54,-28,25
Peterhead,5673,1,24,4,8,79,39,40,76
Montrose,5673,2,23,7,6,60,36,24,76
Stirling,5673,3,16,7,13,62,53,9,55
Stenhousem'r,5673,4,15,9,12,57,48,9,54
Clyde,5673,5,15,9,12,57,49,8,54
Elgin,5673,6,15,6,15,55,61,-6,51
Annan Athlet,5673,7,11,12,13,48,42,6,45
Berwick,5673,8,8,10,18,30,64,-34,34
Edinburgh Ci,5673,9,7,9,20,37,62,-25,30
Cowdenbeath,5673,10,4,11,21,24,55,-31,23
Montrose,5674,1,23,8,5,60,35,25,77
Peterhead,5674,2,24,4,8,80,39,41,76
Stirling,5674,3,16,7,13,61,52,9,55
Stenhousem'r,5674,4,15,9,12,56,47,9,54
Clyde,5674,5,15,9,12,54,48,6,54
Elgin,5674,6,14,7,15,54,61,-7,49
Annan Athlet,5674,7,12,11,13,49,42,7,47
Berwick,5674,8,8,10,18,29,61,-32,34
Edinburgh Ci,5674,9,7,9,20,37,63,-26,30
Cowdenbeath,5674,10,4,10,22,24,56,-32,22
Montrose,5675,1,23,8,5,60,35,25,77
Peterhead,5675,2,24,4,8,79,38,41,76
Stirling,5675,3,17,6,13,62,51,11,57
Clyde,5675,4,15,9,12,56,49,7,54
Stenhousem'r,5675,5,15,8,13,55,48,7,53
Elgin,5675,6,14,7,15,54,61,-7,49
Annan Athlet,5675,7,11,12,13,47,41,6,45
Berwick,5675,8,8,10,18,30,63,-33,34
Edinburgh Ci,5675,9,7,9,20,36,62,-26,30
Cowdenbeath,5675,10,4,11,21,23,54,-31,23
Montrose,5676,1,24,7,5,63,35,28,79
Peterhead,5676,2,24,4,8,81,38,43,76
Stirling,5676,3,17,6,13,64,53,11,57
Clyde,5676,4,15,9,12,55,49,6,54
Stenhousem'r,5676,5,15,8,13,57,50,7,53
Elgin,5676,6,14,6,16,54,64,-10,48
Annan Athlet,5676,7,11,11,14,48,43,5,44
Berwick,5676,8,8,10,18,30,62,-32,34
Edinburgh Ci,5676,9,7,9,20,36,64,-28,30
Cowdenbeath,5676,10,5,10,21,25,55,-30,25
Montrose,5677,1,24,7,5,62,35,27,79
Peterhead,5677,2,24,4,8,82,41,41,76
Stenhousem'r,5677,3,16,8,12,58,46,12,56
Stirling,5677,4,16,6,14,60,54,6,54
Clyde,5677,5,15,9,12,54,50,4,54
Elgin,5677,6,14,6,16,54,63,-9,48
Annan Athlet,5677,7,12,11,13,48,41,7,47
Berwick,5677,8,8,10,18,31,61,-30,34
Edinburgh Ci,5677,9,7,9,20,39,65,-26,30
Cowdenbeath,5677,10,4,10,22,23,55,-32,22
Montrose,5678,1,23,8,5,60,35,25,77
Peterhead,5678,2,24,4,8,79,38,41,76
Stirling,5678,3,16,7,13,61,52,9,55
Stenhousem'r,5678,4,15,9,12,56,47,9,54
Clyde,5678,5,15,9,12,53,49,4,54
Elgin,5678,6,14,7,15,54,61,-7,49
Annan Athlet,5678,7,12,11,13,49,41,8,47
Berwick,5678,8,8,10,18,30,60,-30,34
Edinburgh Ci,5678,9,7,9,20,36,62,-26,30
Cowdenbeath,5678,10,4,10,22,23,56,-33,22
Montrose,5679,1,24,7,5,61,34,27,79
Peterhead,5679,2,23,5,8,78,39,39,74
Stirling,5679,3,17,6,13,64,52,12,57
Stenhousem'r,5679,4,15,8,13,56,50,6,53
Clyde,5679,5,14,9,13,51,50,1,51
Elgin,5679,6,14,6,16,53,62,-9,48
Annan Athlet,5679,7,11,12,13,48,42,6,45
Berwick,5679,8,9,10,17,31,58,-27,37
Edinburgh Ci,5679,9,7,10,19,37,61,-24,31
Cowdenbeath,5679,10,4,11,21,24,55,-31,23
Peterhead,5680,1,24,4,8,79,38,41,76
Montrose,5680,2,23,7,6,59,35,24,76
Stirling,5680,3,16,7,13,64,55,9,55
Stenhousem'r,5680,4,15,9,12,59,50,9,54
Clyde,5680,5,15,9,12,55,50,5,54
Elgin,5680,6,15,6,15,54,60,-6,51
Annan Athlet,5680,7,12,11,13,48,41,7,47
Berwick,5680,8,8,10,18,31,62,-31,34
Edinburgh Ci,5680,9,7,9,20,36,62,-26,30
Cowdenbeath,5680,10,4,10,22,23,55,-32,22
Montrose,5681,1,24,7,5,62,36,26,79
Peterhead,5681,2,23,5,8,79,40,39,74
Stenhousem'r,5681,3,16,8,12,56,46,10,56
Stirling,5681,4,16,6,14,60,52,8,54
Clyde,5681,5,15,9,12,52,48,4,54
Elgin,5681,6,14,6,16,55,63,-8,48
Annan Athlet,5681,7,11,11,14,47,43,4,44
Berwick,5681,8,8,10,18,29,59,-30,34
Edinburgh Ci,5681,9,7,10,19,38,62,-24,31
Cowdenbeath,5681,10,5,10,21,25,54,-29,25
Montrose,5682,1,24,7,5,64,34,30,79
Peterhead,5682,2,24,4,8,79,38,41,76
Stirling,5682,3,17,6,13,63,52,11,57
Stenhousem'r,5682,4,15,8,13,56,49,7,53
Clyde,5682,5,14,10,12,52,49,3,52
Elgin,5682,6,14,6,16,53,65,-12,48
Annan Athlet,5682,7,11,11,14,47,42,5,44
Berwick,5682,8,8,11,17,30,59,-29,35
Edinburgh Ci,5682,9,7,9,20,36,62,-26,30
Cowdenbeath,5682,10,5,10,21,24,54,-30,25
Peterhead,5683,1,24,4,8,79,38,41,76
Montrose,5683,2,23,7,6,60,36,24,76
Stirling,5683,3,16,7,13,61,52,9,55
Clyde,5683,4,15,9,12,57,48,9,54
Stenhousem'r,5683,5,15,9,12,56,47,9,54
Elgin,5683,6,15,6,15,55,61,-6,51
Annan Athlet,5683,7,12,11,13,49,42,7,47
Berwick,5683,8,8,10,18,29,64,-35,34
Edinburgh Ci,5683,9,7,9,20,36,62,-26,30
Cowdenbeath,5683,10,4,10,22,24,56,-32,22
Montrose,5684,1,24,7,5,61,34,27,79
Peterhead,5684,2,24,4,8,78,38,40,76
Stirling,5684,3,16,7,13,62,53,9,55
Stenhousem'r,5684,4,15,9,12,57,48,9,54
Clyde,5684,5,15,9,12,52,48,4,54
Elgin,5684,6,14,6,16,53,62,-9,48
Annan Athlet,5684,7,11,11,14,47,42,5,44
Berwick,5684,8,8,10,18,29,59,-30,34
Edinburgh Ci,5684,9,7,9,20,36,61,-25,30
Cowdenbeath,5684,10,5,10,21,24,54,-30,25
Montrose,5685,1,24,7,5,63,35,28,79
Peterhead,5685,2,24,4,8,80,38,42,76
Stirling,5685,3,16,7,13,61,52,9,55
Stenhousem'r,5685,4,15,9,12,56,47,9,54
Clyde,5685,5,15,9,12,53,48,5,54
Elgin,5685,6,14,6,16,54,64,-10,48
Annan Athlet,5685,7,11,12,13,47,41,6,45
Berwick,5685,8,8,10,18,29,60,-31,34
Edinburgh Ci,5685,9,7,9,20,36,63,-27,30
Cowdenbeath,5685,10,4,11,21,23,54,-31,23
Montrose,5686,1,23,8,5,60,35,25,77
Peterhead,5686,2,24,4,8,80,39,41,76
Stenhousem'r,5686,3,16,8,12,58,46,12,56
Stirling,5686,4,16,6,14,60,54,6,54
Clyde,5686,5,15,9,12,54,49,5,54
Elgin,5686,6,14,7,15,54,61,-7,49
Annan Athlet,5686,7,11,12,13,48,42,6,45
Berwick,5686,8,8,10,18,30,61,-31,34
Edinburgh Ci,5686,9,7,9,20,37,63,-26,30
Cowdenbeath,5686,10,4,11,21,24,55,-31,23
Montrose,5687,1,24,7,5,60,34,26,79
Peterhead,5687,2,24,4,8,80,39,41,76
Stirling,5687,3,17,6,13,64,53,11,57
Stenhousem'r,5687,4,15,8,13,57,50,7,53
Clyde,5687,5,14,10,12,51,48,3,52
Elgin,5687,6,14,6,16,53,61,-8,48
Annan Athlet,5687,7,11,11,14,48,43,5,44
Berwick,5687,8,8,11,17,29,58,-29,35
Edinburgh Ci,5687,9,7,9,20,37,63,-26,30
Cowdenbeath,5687,10,5,10,21,25,55,-30,25
Montrose,5688,1,24,7,5,61,35,26,79
Peterhead,5688,2,23,5,8,79,40,39,74
Stirling,5688,3,17,6,13,63,51,12,57
Clyde,5688,4,15,9,12,53,49,4,54
Stenhousem'r,5688,5,15,8,13,55,49,6,53
Elgin,5688,6,14,6,16,54,62,-8,48
Annan Athlet,5688,7,12,11,13,48,41,7,47
Berwick,5688,8,8,10,18,30,60,-30,34
Edinburgh Ci,5688,9,7,10,19,38,62,-24,31
Cowdenbeath,5688,10,4,10,22,23,55,-32,22
Peterhead,5689,1,24,4,8,82,39,43,76
Montrose,5689,2,23,7,6,60,37,23,76
Stirling,5689,3,17,6,13,64,51,13,57
Clyde,5689,4,15,9,12,52,48,4,54
Stenhousem'r,5689,5,15,8,13,55,50,5,53
Elgin,5689,6,15,6,15,56,61,-5,51
Annan Athlet,5689,7,11,11,14,48,43,5,44
Berwick,5689,8,8,10,18,29,59,-30,34
Edinburgh Ci,5689,9,7,9,20,37,65,-28,30
Cowdenbeath,5689,10,5,10,21,25,55,-30,25
Montrose,5690,1,24,7,5,62,35,27,79
Peterhead,5690,2,24,4,8,79,38,41,76
Stirling,5690,3,17,6,13,63,52,11,57
Stenhousem'r,5690,4,15,8,13,56,49,7,53
Clyde,5690,5,14,9,13,51,49,2,51
Elgin,5690,6,14,6,16,54,63,-9,48
Annan Athlet,5690,7,12,11,13,50,41,9,47
Berwick,5690,8,9,10,17,30,58,-28,37
Edinburgh Ci,5690,9,7,9,20,36,62,-26,30
Cowdenbeath,5690,10,4,10,22,23,57,-34,22
Montrose,5691,1,24,7,5,63,35,28,79
Peterhead,5691,2,24,4,8,84,39,45,76
Stenhousem'r,5691,3,16,8,12,59,46,13,56
Stirling,5691,4,16,6,14,60,55,5,54
Clyde,5691,5,15,9,12,54,49,5,54
Elgin,5691,6,14,6,16,54,64,-10,48
Annan Athlet,5691,7,12,11,13,48,41,7,47
Berwick,5691,8,8,10,18,30,61,-31,34
Edinburgh Ci,5691,9,7,9,20,37,67,-30,30
Cowdenbeath,5691,10,4,10,22,23,55,-32,22
Peterhead,5692,1,24,4,8,82,38,44,76
Montrose,5692,2,23,7,6,60,36,24,76
Stirling,5692,3,17,6,13,63,52,11,57
Clyde,5692,4,15,9,12,54,50,4,54
Stenhousem'r,5692,5,15,8,13,56,49,7,53
Elgin,5692,6,15,6,15,55,61,-6,51
Annan Athlet,5692,7,11,12,13,49,43,6,45
Berwick,5692,8,8,10,18,31,61,-30,34
Edinburgh Ci,5692,9,7,9,20,36,65,-29,30
Cowdenbeath,5692,10,4,11,21,25,56,-31,23
Montrose,5693,1,23,8,5,61,36,25,77
Peterhead,5693,2,24,4,8,79,39,40,76
Stenhousem'r,5693,3,16,8,12,57,46,11,56
Stirling,5693,4,16,6,14,60,53,7,54
Clyde,5693,5,14,9,13,51,50,1,51
Elgin,5693,6,14,7,15,55,62,-7,49
Annan Athlet,5693,7,11,11,14,47,42,5,44
Berwick,5693,8,9,10,17,31,58,-27,37
Edinburgh Ci,5693,9,7,9,20,37,62,-25,30
Cowdenbeath,5693,10,5,10,21,24,54,-30,25
Montrose,5694,1,24,7,5,61,35,26,79
Peterhead,5694,2,24,4,8,80,39,41,76
Stirling,5694,3,16,7,13,63,54,9,55
Stenhousem'r,5694,4,15,9,12,58,49,9,54
Clyde,5694,5,14,10,12,51,48,3,52
Elgin,5694,6,14,6,16,54,62,-8,48
Annan Athlet,5694,7,11,12,13,48,42,6,45
Berwick,5694,8,8,11,17,29,58,-29,35
Edinburgh Ci,5694,9,7,9,20,37,63,-26,30
Cowdenbeath,5694,10,4,11,21,24,55,-31,23
Montrose,5695,1,23,8,5,61,36,25,77
Peterhead,5695,2,24,4,8,79,38,41,76
Stenhousem'r,5695,3,16,8,12,56,46,10,56
Stirling,5695,4,16,6,14,60,52,8,54
Clyde,5695,5,15,9,12,53,48,5,54
Elgin,5695,6,14,7,15,55,62,-7,49
Annan Athlet,5695,7,11,11,14,48,43,5,44
Berwick,5695,8,8,10,18,29,60,-31,34
Edinburgh Ci,5695,9,7,9,20,36,62,-26,30
Cowdenbeath,5695,10,5,10,21,25,55,-30,25
Peterhead,5696,1,24,4,8,78,38,40,76
Montrose,5696,2,23,7,6,60,37,23,76
Stenhousem'r,5696,3,16,8,12,59,47,12,56
Stirling,5696,4,16,6,14,61,55,6,54
Clyde,5696,5,14,10,12,52,49,3,52
Elgin,5696,6,15,6,15,56,61,-5,51
Annan Athlet,5696,7,11,11,14,48,43,5,44
Berwick,5696,8,8,11,17,30,59,-29,35
Edinburgh Ci,5696,9,7,9,20,36,61,-25,30
Cowdenbeath,5696,10,5,10,21,25,55,-30,25
Montrose,5697,1,24,7,5,65,35,30,79
Peterhead,5697,2,24,4,8,80,39,41,76
Stirling,5697,3,17,6,13,66,52,14,57
Stenhousem'r,5697,4,15,8,13,56,52,4,53
Clyde,5697,5,14,9,13,53,51,2,51
Elgin,5697,6,14,6,16,54,66,-12,48
Annan Athlet,5697,7,12,11,13,48,41,7,47
Berwick,5697,8,9,10,17,32,60,-28,37
Edinburgh Ci,5697,9,7,9,20,37,63,-26,30
Cowdenbeath,5697,10,4,10,22,23,55,-32,22
Montrose,5698,1,24,7,5,62,34,28,79
Peterhead,5698,2,24,4,8,80,38,42,76
Stirling,5698,3,16,7,13,62,53,9,55
Stenhousem'r,5698,4,15,9,12,57,48,9,54
Clyde,5698,5,15,9,12,52,48,4,54
Elgin,5698,6,14,6,16,53,63,-10,48
Annan Athlet,5698,7,12,11,13,50,41,9,47
Berwick,5698,8,8,10,18,29,59,-30,34
Edinburgh Ci,5698,9,7,9,20,36,63,-27,30
Cowdenbeath,5698,10,4,10,22,23,57,-34,22
Montrose,5699,1,24,7,5,65,37,28,79
Peterhead,5699,2,23,5,8,78,39,39,74
Stirling,5699,3,16,7,13,61,52,9,55
Stenhousem'r,5699,4,15,9,12,56,47,9,54
Clyde,5699,5,14,9,13,51,49,2,51
Elgin,5699,6,14,6,16,56,66,-10,48
Annan Athlet,5699,7,11,11,14,47,42,5,44
Berwick,5699,8,9,10,17,30,58,-28,37
Edinburgh Ci,5699,9,7,10,19,37,61,-24,31
Cowdenbeath,5699,10,5,10,21,24,54,-30,25
Montrose,5700,1,24,7,5,64,38,26,79
Peterhead,5700,2,23,4,9,79,41,38,73
Stirling,5700,3,17,6,13,63,51,12,57
Clyde,5700,4,15,9,12,52,48,4,54
Stenhousem'r,5700,5,15,8,13,55,49,6,53
Elgin,5700,6,14,6,16,57,65,-8,48
Annan Athlet,5700,7,11,11,14,48,43,5,44
Berwick,5700,8,8,10,18,29,59,-30,34
Edinburgh Ci,5700,9,8,9,19,39,62,-23,33
Cowdenbeath,5700,10,5,10,21,25,55,-30,25
Montrose,5701,1,23,8,5,59,34,25,77
Peterhead,5701,2,24,4,8,81,39,42,76
Stenhousem'r,5701,3,16,8,12,57,47,10,56
Stirling,5701,4,16,6,14,61,53,8,54
Clyde,5701,5,14,10,12,53,50,3,52
Elgin,5701,6,14,7,15,53,60,-7,49
Annan Athlet,5701,7,12,11,13,48,41,7,47
Berwick,5701,8,8,11,17,31,60,-29,35
Edinburgh Ci,5701,9,7,9,20,37,64,-27,30
Cowdenbeath,5701,10,4,10,22,23,55,-32,22
Montrose,5702,1,23,8,5,60,35,25,77
Peterhead,5702,2,24,4,8,80,40,40,76
Stirling,5702,3,17,6,13,65,54,11,57
Stenhousem'r,5702,4,15,8,13,58,51,7,53
Clyde,5702,5,14,9,13,51,50,1,51
Elgin,5702,6,14,7,15,54,61,-7,49
Annan Athlet,5702,7,12,11,13,49,41,8,47
Berwick,5702,8,9,10,17,31,58,-27,37
Edinburgh Ci,5702,9,7,9,20,38,63,-25,30
Cowdenbeath,5702,10,4,10,22,23,56,-33,22
Montrose,5703,1,24,7,5,61,34,27,79
Peterhead,5703,2,24,4,8,81,38,43,76
Stenhousem'r,5703,3,16,8,12,57,46,11,56
Stirling,5703,4,16,6,14,60,53,7,54
Clyde,5703,5,15,9,12,53,48,5,54
Elgin,5703,6,14,6,16,53,62,-9,48
Annan Athlet,5703,7,11,11,14,47,42,5,44
Berwick,5703,8,8,10,18,29,60,-31,34
Edinburgh Ci,5703,9,7,9,20,36,64,-28,30
Cowdenbeath,5703,10,5,10,21,24,54,-30,25
Montrose,5704,1,24,7,5,61,35,26,79
Peterhead,5704,2,24,4,8,80,38,42,76
Stirling,5704,3,17,6,13,62,51,11,57
Clyde,5704,4,15,9,12,53,48,5,54
Stenhousem'r,5704,5,15,8,13,55,48,7,53
Elgin,5704,6,14,6,16,54,62,-8,48
Annan Athlet,5704,7,11,11,14,47,42,5,44
Berwick,5704,8,8,10,18,29,60,-31,34
Edinburgh Ci,5704,9,7,9,20,36,63,-27,30
Cowdenbeath,5704,10,5,10,21,24,54,-30,25
Montrose,5705,1,24,7,5,60,34,26,79
Peterhead,5705,2,24,4,8,80,39,41,76
Stirling,5705,3,17,6,13,62,51,11,57
Stenhousem'r,5705,4,15,8,13,55,48,7,53
Clyde,5705,5,14,10,12,52,49,3,52
Elgin,5705,6,14,6,16,53,61,-8,48
Annan Athlet,5705,7,11,11,14,47,43,4,44
Berwick,5705,8,8,11,17,30,59,-29,35
Edinburgh Ci,5705,9,7,9,20,37,63,-26,30
Cowdenbeath,5705,10,5,10,21,25,54,-29,25
Peterhead,5706,1,24,4,8,79,38,41,76
Montrose,5706,2,23,7,6,60,37,23,76
Stirling,5706,3,17,6,13,61,51,10,57
Stenhousem'r,5706,4,15,8,13,55,47,8,53
Clyde,5706,5,14,10,12,53,50,3,52
Elgin,5706,6,15,6,15,56,61,-5,51
Annan Athlet,5706,7,11,11,14,48,43,5,44
Berwick,5706,8,8,11,17,31,60,-29,35
Edinburgh Ci,5706,9,7,9,20,36,62,-26,30
Cowdenbeath,5706,10,5,10,21,25,55,-30,25
Peterhead,5707,1,24,4,8,82,39,43,76
Montrose,5707,2,23,7,6,59,35,24,76
Stenhousem'r,5707,3,16,8,12,57,47,10,56
Stirling,5707,4,16,6,14,61,53,8,54
Clyde,5707,5,15,9,12,54,50,4,54
Elgin,5707,6,15,6,15,54,60,-6,51
Annan Athlet,5707,7,12,11,13,50,43,7,47
Berwick,5707,8,8,10,18,31,61,-30,34
Edinburgh Ci,5707,9,7,9,20,37,65,-28,30
Cowdenbeath,5707,10,4,10,22,25,57,-32,22
Montrose,5708,1,24,7,5,61,34,27,79
Peterhead,5708,2,23,5,8,77,38,39,74
Stirling,5708,3,17,6,13,61,51,10,57
Stenhousem'r,5708,4,15,8,13,55,47,8,53
Clyde,5708,5,14,9,13,51,49,2,51
Elgin,5708,6,14,6,16,53,62,-9,48
Annan Athlet,5708,7,11,11,14,48,44,4,44
Berwick,5708,8,9,10,17,30,58,-28,37
Edinburgh Ci,5708,9,7,10,19,36,60,-24,31
Cowdenbeath,5708,10,5,10,21,26,55,-29,25
Montrose,5709,1,24,7,5,62,34,28,79
Peterhead,5709,2,24,4,8,81,39,42,76
Stenhousem'r,5709,3,16,8,12,58,47,11,56
Stirling,5709,4,16,6,14,61,54,7,54
Clyde,5709,5,14,10,12,52,49,3,52
Elgin,5709,6,14,6,16,53,63,-10,48
Annan Athlet,5709,7,12,11,13,49,41,8,47
Berwick,5709,8,8,11,17,30,59,-29,35
Edinburgh Ci,5709,9,7,9,20,37,64,-27,30
Cowdenbeath,5709,10,4,10,22,23,56,-33,22
Peterhead,5710,1,24,4,8,78,38,40,76
Montrose,5710,2,23,7,6,59,35,24,76
Stirling,5710,3,17,6,13,62,52,10,57
Clyde,5710,4,15,9,12,53,48,5,54
Stenhousem'r,5710,5,15,8,13,56,48,8,53
Elgin,5710,6,15,6,15,54,60,-6,51
Annan Athlet,5710,7,12,11,13,48,41,7,47
Berwick,5710,8,8,10,18,29,60,-31,34
Edinburgh Ci,5710,9,7,9,20,36,61,-25,30
Cowdenbeath,5710,10,4,10,22,23,55,-32,22
Montrose,5711,1,24,7,5,60,34,26,79
Peterhead,5711,2,24,4,8,78,38,40,76
Stirling,5711,3,17,6,13,63,53,10,57
Stenhousem'r,5711,4,15,8,13,57,49,8,53
Clyde,5711,5,14,9,13,51,50,1,51
Elgin,5711,6,14,6,16,53,61,-8,48
Annan Athlet,5711,7,11,12,13,48,42,6,45
Berwick,5711,8,9,10,17,31,58,-27,37
Edinburgh Ci,5711,9,7,9,20,36,61,-25,30
Cowdenbeath,5711,10,4,11,21,24,55,-31,23
Montrose,5712,1,24,7,5,60,34,26,79
Peterhead,5712,2,24,4,8,81,38,43,76
Stirling,5712,3,17,6,13,63,52,11,57
Clyde,5712,4,15,9,12,53,48,5,54
Stenhousem'r,5712,5,15,8,13,56,49,7,53
Elgin,5712,6,14,6,16,53,61,-8,48
Annan Athlet,5712,7,11,12,13,48,42,6,45
Berwick,5712,8,8,10,18,29,60,-31,34
Edinburgh Ci,5712,9,7,9,20,36,64,-28,30
Cowdenbeath,5712,10,4,11,21,24,55,-31,23
Montrose,5713,1,24,7,5,60,34,26,79
Peterhead,5713,2,24,4,8,81,38,43,76
Stirling,5713,3,16,7,13,62,53,9,55
Stenhousem'r,5713,4,15,9,12,57,48,9,54
Clyde,5713,5,14,10,12,52,49,3,52
Elgin,5713,6,14,6,16,53,61,-8,48
Annan Athlet,5713,7,12,11,13,49,42,7,47
Berwick,5713,8,8,11,17,30,59,-29,35
Edinburgh Ci,5713,9,7,9,20,36,64,-28,30
Cowdenbeath,5713,10,4,10,22,24,56,-32,22
Montrose,5714,1,23,8,5,60,35,25,77
Peterhead,5714,2,24,4,8,78,38,40,76
Stirling,5714,3,17,6,13,63,52,11,57
Clyde,5714,4,15,9,12,53,48,5,54
Stenhousem'r,5714,5,15,8,13,56,49,7,53
Elgin,5714,6,14,7,15,54,61,-7,49
Annan Athlet,5714,7,12,11,13,50,42,8,47
Berwick,5714,8,8,10,18,29,60,-31,34
Edinburgh Ci,5714,9,7,9,20,36,61,-25,30
Cowdenbeath,5714,10,4,10,22,24,57,-33,22
Montrose,5715,1,24,7,5,62,35,27,79
Peterhead,5715,2,24,4,8,79,38,41,76
Stirling,5715,3,17,6,13,63,52,11,57
Clyde,5715,4,15,9,12,54,48,6,54
Stenhousem'r,5715,5,15,8,13,56,49,7,53
Elgin,5715,6,14,6,16,54,63,-9,48
Annan Athlet,5715,7,12,11,13,49,41,8,47
Berwick,5715,8,8,10,18,29,61,-32,34
Edinburgh Ci,5715,9,7,9,20,36,62,-26,30
Cowdenbeath,5715,10,4,10,22,23,56,-33,22
Montrose,5716,1,23,8,5,60,35,25,77
Peterhead,5716,2,24,4,8,81,38,43,76
Stirling,5716,3,17,6,13,62,51,11,57
Stenhousem'r,5716,4,15,8,13,55,48,7,53
Clyde,5716,5,14,9,13,52,50,2,51
Elgin,5716,6,14,7,15,54,61,-7,49
Annan Athlet,5716,7,12,11,13,48,41,7,47
Berwick,5716,8,9,10,17,31,59,-28,37
Edinburgh Ci,5716,9,7,9,20,36,64,-28,30
Cowdenbeath,5716,10,4,10,22,23,55,-32,22
Peterhead,5717,1,24,4,8,83,40,43,76
Montrose,5717,2,23,7,6,59,35,24,76
Stenhousem'r,5717,3,16,8,12,57,47,10,56
Stirling,5717,4,16,6,14,61,53,8,54
Clyde,5717,5,14,9,13,52,50,2,51
Elgin,5717,6,15,6,15,54,60,-6,51
Annan Athlet,5717,7,11,12,13,47,41,6,45
Berwick,5717,8,9,10,17,31,59,-28,37
Edinburgh Ci,5717,9,7,9,20,38,66,-28,30
Cowdenbeath,5717,10,4,11,21,23,54,-31,23
Montrose,5718,1,24,7,5,61,35,26,79
Peterhead,5718,2,23,5,8,79,40,39,74
Stirling,5718,3,17,6,13,62,52,10,57
Clyde,5718,4,15,9,12,54,49,5,54
Stenhousem'r,5718,5,15,8,13,56,48,8,53
Elgin,5718,6,14,6,16,54,62,-8,48
Annan Athlet,5718,7,11,11,14,47,43,4,44
Berwick,5718,8,8,10,18,30,61,-31,34
Edinburgh Ci,5718,9,7,10,19,38,62,-24,31
Cowdenbeath,5718,10,5,10,21,25,54,-29,25
Montrose,5719,1,23,8,5,59,34,25,77
Peterhead,5719,2,23,4,9,78,40,38,73
Stirling,5719,3,17,6,13,63,52,11,57
Clyde,5719,4,15,9,12,53,49,4,54
Stenhousem'r,5719,5,15,8,13,56,49,7,53
Elgin,5719,6,14,7,15,53,60,-7,49
Annan Athlet,5719,7,11,12,13,48,42,6,45
Berwick,5719,8,8,10,18,30,60,-30,34
Edinburgh Ci,5719,9,8,9,19,38,61,-23,33
Cowdenbeath,5719,10,4,11,21,24,55,-31,23
Montrose,5720,1,24,7,5,62,36,26,79
Peterhead,5720,2,23,5,8,77,38,39,74
Stirling,5720,3,16,7,13,62,53,9,55
Stenhousem'r,5720,4,15,9,12,57,48,9,54
Clyde,5720,5,14,9,13,52,50,2,51
Elgin,5720,6,14,6,16,55,63,-8,48
Annan Athlet,5720,7,12,11,13,48,41,7,47
Berwick,5720,8,9,10,17,31,59,-28,37
Edinburgh Ci,5720,9,7,10,19,36,60,-24,31
Cowdenbeath,5720,10,4,10,22,23,55,-32,22
Montrose,5721,1,24,7,5,61,34,27,79
Peterhead,5721,2,23,5,8,77,38,39,74
Stenhousem'r,5721,3,16,8,12,57,46,11,56
Stirling,5721,4,16,6,14,60,53,7,54
Clyde,5721,5,14,10,12,52,49,3,52
Elgin,5721,6,14,6,16,53,62,-9,48
Annan Athlet,5721,7,12,11,13,49,41,8,47
Berwick,5721,8,8,11,17,30,59,-29,35
Edinburgh Ci,5721,9,7,10,19,36,60,-24,31
Cowdenbeath,5721,10,4,10,22,23,56,-33,22
Montrose,5722,1,24,7,5,63,35,28,79
Peterhead,5722,2,24,4,8,83,38,45,76
Stenhousem'r,5722,3,16,8,12,57,47,10,56
Stirling,5722,4,16,6,14,61,53,8,54
Clyde,5722,5,15,9,12,52,48,4,54
Elgin,5722,6,14,6,16,54,64,-10,48
Annan Athlet,5722,7,12,11,13,49,42,7,47
Berwick,5722,8,8,10,18,29,59,-30,34
Edinburgh Ci,5722,9,7,9,20,36,66,-30,30
Cowdenbeath,5722,10,4,10,22,24,56,-32,22
Montrose,5723,1,23,8,5,62,37,25,77
Peterhead,5723,2,24,4,8,80,38,42,76
Stirling,5723,3,17,6,13,63,51,12,57
Clyde,5723,4,15,9,12,54,49,5,54
Stenhousem'r,5723,5,15,8,13,55,49,6,53
Elgin,5723,6,14,7,15,56,63,-7,49
Annan Athlet,5723,7,12,11,13,49,42,7,47
Berwick,5723,8,8,10,18,30,61,-31,34
Edinburgh Ci,5723,9,7,9,20,36,63,-27,30
Cowdenbeath,5723,10,4,10,22,24,56,-32,22
Montrose,5724,1,24,7,5,61,35,26,79
Peterhead,5724,2,24,4,8,80,39,41,76
Stirling,5724,3,16,7,13,62,53,9,55
Stenhousem'r,5724,4,15,9,12,57,48,9,54
Clyde,5724,5,14,10,12,52,49,3,52
Elgin,5724,6,14,6,16,54,62,-8,48
Annan Athlet,5724,7,11,12,13,48,42,6,45
Berwick,5724,8,8,11,17,30,59,-29,35
Edinburgh Ci,5724,9,7,9,20,37,63,-26,30
Cowdenbeath,5724,10,4,11,21,24,55,-31,23
Montrose,5725,1,23,8,5,60,35,25,77
Peterhead,5725,2,24,4,8,80,39,41,76
Stirling,5725,3,16,7,13,60,51,9,55
Stenhousem'r,5725,4,15,9,12,55,46,9,54
Clyde,5725,5,14,9,13,51,49,2,51
Elgin,5725,6,14,7,15,54,61,-7,49
Annan Athlet,5725,7,11,11,14,48,43,5,44
Berwick,5725,8,9,10,17,30,58,-28,37
Edinburgh Ci,5725,9,7,9,20,37,63,-26,30
Cowdenbeath,5725,10,5,10,21,25,55,-30,25
Peterhead,5726,1,24,4,8,79,39,40,76
Montrose,5726,2,23,7,6,60,37,23,76
Stirling,5726,3,17,6,13,63,53,10,57
Stenhousem'r,5726,4,15,8,13,57,49,8,53
Clyde,5726,5,14,9,13,51,49,2,51
Elgin,5726,6,15,6,15,56,61,-5,51
Annan Athlet,5726,7,11,12,13,47,41,6,45
Berwick,5726,8,9,10,17,30,58,-28,37
Edinburgh Ci,5726,9,7,9,20,37,62,-25,30
Cowdenbeath,5726,10,4,11,21,23,54,-31,23
Montrose,5727,1,23,8,5,60,35,25,77
Peterhead,5727,2,24,4,8,81,38,43,76
Stenhousem'r,5727,3,16,8,12,56,46,10,56
Stirling,5727,4,16,6,14,60,52,8,54
Clyde,5727,5,15,9,12,54,49,5,54
Elgin,5727,6,14,7,15,54,61,-7,49
Annan Athlet,5727,7,11,12,13,49,43,6,45
Berwick,5727,8,8,10,18,30,61,-31,34
Edinburgh Ci,5727,9,7,9,20,36,64,-28,30
Cowdenbeath,5727,10,4,11,21,25,56,-31,23
Montrose,5728,1,23,8,5,60,35,25,77
Peterhead,5728,2,24,4,8,82,40,42,76
Stenhousem'r,5728,3,16,8,12,59,46,13,56
Stirling,5728,4,16,6,14,60,55,5,54
Clyde,5728,5,15,9,12,54,49,5,54
Elgin,5728,6,14,7,15,54,61,-7,49
Annan Athlet,5728,7,12,11,13,48,41,7,47
Berwick,5728,8,8,10,18,30,61,-31,34
Edinburgh Ci,5728,9,7,9,20,38,65,-27,30
Cowdenbeath,5728,10,4,10,22,23,55,-32,22
Peterhead,5729,1,24,4,8,80,38,42,76
Montrose,5729,2,23,7,6,60,36,24,76
Stirling,5729,3,17,6,13,63,53,10,57
Clyde,5729,4,15,9,12,54,49,5,54
Stenhousem'r,5729,5,15,8,13,57,49,8,53
Elgin,5729,6,15,6,15,55,61,-6,51
Annan Athlet,5729,7,11,12,13,48,42,6,45
Berwick,5729,8,8,10,18,30,61,-31,34
Edinburgh Ci,5729,9,7,9,20,36,63,-27,30
Cowdenbeath,5729,10,4,11,21,24,55,-31,23
Montrose,5730,1,23,8,5,60,35,25,77
Peterhead,5730,2,23,5,8,78,39,39,74
Stirling,5730,3,17,6,13,63,52,11,57
Clyde,5730,4,15,9,12,55,48,7,54
Stenhousem'r,5730,5,15,8,13,56,49,7,53
Elgin,5730,6,14,7,15,54,61,-7,49
Annan Athlet,5730,7,11,12,13,47,41,6,45
Berwick,5730,8,8,10,18,29,62,-33,34
Edinburgh Ci,5730,9,7,10,19,37,61,-24,31
Cowdenbeath,5730,10,4,11,21,23,54,-31,23
Montrose,5731,1,24,7,5,61,34,27,79
Peterhead,5731,2,23,4,9,77,40,37,73
Stenhousem'r,5731,3,16,8,12,57,46,11,56
Stirling,5731,4,16,6,14,60,53,7,54
Clyde,5731,5,15,9,12,54,48,6,54
Elgin,5731,6,14,6,16,53,62,-9,48
Annan Athlet,5731,7,11,11,14,47,43,4,44
Berwick,5731,8,8,10,18,29,61,-32,34
Edinburgh Ci,5731,9,8,9,19,38,60,-22,33
Cowdenbeath,5731,10,5,10,21,25,54,-29,25
Montrose,5732,1,24,7,5,61,34,27,79
Peterhead,5732,2,23,5,8,78,39,39,74
Stenhousem'r,5732,3,16,8,12,59,47,12,56
Stirling,5732,4,16,6,14,61,55,6,54
Clyde,5732,5,15,9,12,55,49,6,54
Elgin,5732,6,14,6,16,53,62,-9,48
Annan Athlet,5732,7,12,11,13,48,41,7,47
Berwick,5732,8,8,10,18,30,62,-32,34
Edinburgh Ci,5732,9,7,10,19,37,61,-24,31
Cowdenbeath,5732,10,4,10,22,23,55,-32,22
Montrose,5733,1,23,8,5,61,36,25,77
Peterhead,5733,2,24,4,8,79,39,40,76
Stirling,5733,3,17,6,13,61,51,10,57
Clyde,5733,4,15,9,12,54,48,6,54
Stenhousem'r,5733,5,15,8,13,55,47,8,53
Elgin,5733,6,14,7,15,55,62,-7,49
Annan Athlet,5733,7,12,11,13,48,41,7,47
Berwick,5733,8,8,10,18,29,61,-32,34
Edinburgh Ci,5733,9,7,9,20,37,62,-25,30
Cowdenbeath,5733,10,4,10,22,23,55,-32,22
Montrose,5734,1,24,7,5,63,34,29,79
Peterhead,5734,2,23,5,8,81,42,39,74
Stenhousem'r,5734,3,16,8,12,59,46,13,56
Stirling,5734,4,16,6,14,60,55,5,54
Clyde,5734,5,15,9,12,54,49,5,54
Elgin,5734,6,14,6,16,53,64,-11,48
Annan Athlet,5734,7,11,12,13,47,41,6,45
Berwick,5734,8,8,10,18,30,61,-31,34
Edinburgh Ci,5734,9,7,10,19,40,64,-24,31
Cowdenbeath,5734,10,4,11,21,23,54,-31,23
Montrose,5735,1,24,7,5,62,34,28,79
Peterhead,5735,2,24,4,8,80,39,41,76
Stirling,5735,3,17,6,13,63,52,11,57
Stenhousem'r,5735,4,15,8,13,56,49,7,53
Clyde,5735,5,14,10,12,51,48,3,52
Elgin,5735,6,14,6,16,53,63,-10,48
Annan Athlet,5735,7,12,11,13,49,42,7,47
Berwick,5735,8,8,11,17,29,58,-29,35
Edinburgh Ci,5735,9,7,9,20,37,63,-26,30
Cowdenbeath,5735,10,4,10,22,24,56,-32,22
Montrose,5736,1,24,7,5,63,34,29,79
Peterhead,5736,2,24,4,8,81,39,42,76
Stirling,5736,3,17,6,13,64,52,12,57
Stenhousem'r,5736,4,15,8,13,56,50,6,53
Clyde,5736,5,14,9,13,51,49,2,51
Elgin,5736,6,14,6,16,53,64,-11,48
Annan Athlet,5736,7,12,11,13,50,41,9,47
Berwick,5736,8,9,10,17,30,58,-28,37
Edinburgh Ci,5736,9,7,9,20,37,64,-27,30
Cowdenbeath,5736,10,4,10,22,23,57,-34,22
Peterhead,5737,1,24,4,8,79,39,40,76
Montrose,5737,2,23,7,6,60,36,24,76
Stenhousem'r,5737,3,16,8,12,58,47,11,56
Stirling,5737,4,16,6,14,61,54,7,54
Clyde,5737,5,14,10,12,51,48,3,52
Elgin,5737,6,15,6,15,55,61,-6,51
Annan Athlet,5737,7,11,12,13,47,41,6,45
Berwick,5737,8,8,11,17,29,58,-29,35
Edinburgh Ci,5737,9,7,9,20,37,62,-25,30
Cowdenbeath,5737,10,4,11,21,23,54,-31,23
Montrose,5738,1,23,7,6,59,35,24,76
Peterhead,5738,2,23,5,8,78,39,39,74
Stirling,5738,3,17,6,13,62,52,10,57
Stenhousem'r,5738,4,15,8,13,56,48,8,53
Clyde,5738,5,14,10,12,51,48,3,52
Elgin,5738,6,15,6,15,54,60,-6,51
Annan Athlet,5738,7,12,11,13,48,41,7,47
Berwick,5738,8,8,11,17,29,58,-29,35
Edinburgh Ci,5738,9,7,10,19,37,61,-24,31
Cowdenbeath,5738,10,4,10,22,23,55,-32,22
Montrose,5739,1,23,8,5,61,36,25,77
Peterhead,5739,2,23,5,8,78,39,39,74
Stirling,5739,3,17,6,13,62,51,11,57
Stenhousem'r,5739,4,15,8,13,55,48,7,53
Clyde,5739,5,14,10,12,51,48,3,52
Elgin,5739,6,14,7,15,55,62,-7,49
Annan Athlet,5739,7,12,11,13,48,41,7,47
Berwick,5739,8,8,11,17,29,58,-29,35
Edinburgh Ci,5739,9,7,10,19,37,61,-24,31
Cowdenbeath,5739,10,4,10,22,23,55,-32,22
Montrose,5740,1,24,7,5,60,34,26,79
Peterhead,5740,2,23,5,8,78,39,39,74
Stenhousem'r,5740,3,16,8,12,56,46,10,56
Stirling,5740,4,16,6,14,60,52,8,54
Clyde,5740,5,15,9,12,55,49,6,54
Elgin,5740,6,14,6,16,53,61,-8,48
Annan Athlet,5740,7,11,11,14,47,42,5,44
Berwick,5740,8,8,10,18,30,62,-32,34
Edinburgh Ci,5740,9,7,10,19,37,61,-24,31
Cowdenbeath,5740,10,5,10,21,24,54,-30,25
Peterhead,5741,1,24,4,8,80,38,42,76
Montrose,5741,2,23,7,6,59,35,24,76
Stenhousem'r,5741,3,16,8,12,56,46,10,56
Stirling,5741,4,16,6,14,60,52,8,54
Clyde,5741,5,15,9,12,55,49,6,54
Elgin,5741,6,15,6,15,54,60,-6,51
Annan Athlet,5741,7,11,12,13,47,41,6,45
Berwick,5741,8,8,10,18,30,62,-32,34
Edinburgh Ci,5741,9,7,9,20,36,63,-27,30
Cowdenbeath,5741,10,4,11,21,23,54,-31,23
Montrose,5742,1,23,8,5,60,35,25,77
Peterhead,5742,2,23,5,8,79,40,39,74
Stirling,5742,3,17,6,13,61,51,10,57
Stenhousem'r,5742,4,15,8,13,55,47,8,53
Clyde,5742,5,14,10,12,52,49,3,52
Elgin,5742,6,14,7,15,54,61,-7,49
Annan Athlet,5742,7,12,11,13,49,41,8,47
Berwick,5742,8,8,11,17,30,59,-29,35
Edinburgh Ci,5742,9,7,10,19,38,62,-24,31
Cowdenbeath,5742,10,4,10,22,23,56,-33,22
Montrose,5743,1,24,7,5,62,34,28,79
Peterhead,5743,2,23,5,8,79,40,39,74
Stenhousem'r,5743,3,16,8,12,58,48,10,56
Stirling,5743,4,16,6,14,62,54,8,54
Clyde,5743,5,14,10,12,52,49,3,52
Elgin,5743,6,14,6,16,53,63,-10,48
Annan Athlet,5743,7,11,11,14,47,43,4,44
Berwick,5743,8,8,11,17,30,59,-29,35
Edinburgh Ci,5743,9,7,10,19,38,62,-24,31
Cowdenbeath,5743,10,5,10,21,25,54,-29,25
Montrose,5744,1,24,7,5,62,36,26,79
Peterhead,5744,2,24,4,8,81,39,42,76
Stirling,5744,3,16,7,13,61,52,9,55
Stenhousem'r,5744,4,15,9,12,56,47,9,54
Clyde,5744,5,14,10,12,52,49,3,52
Elgin,5744,6,14,6,16,55,63,-8,48
Annan Athlet,5744,7,12,11,13,48,41,7,47
Berwick,5744,8,8,11,17,30,59,-29,35
Edinburgh Ci,5744,9,7,9,20,37,64,-27,30
Cowdenbeath,5744,10,4,10,22,23,55,-32,22
Peterhead,5745,1,24,4,8,78,38,40,76
Montrose,5745,2,23,7,6,59,35,24,76
Stirling,5745,3,17,6,13,63,53,10,57
Clyde,5745,4,15,9,12,54,48,6,54
Stenhousem'r,5745,5,15,8,13,57,49,8,53
Elgin,5745,6,15,6,15,54,60,-6,51
Annan Athlet,5745,7,11,11,14,47,43,4,44
Berwick,5745,8,8,10,18,29,61,-32,34
Edinburgh Ci,5745,9,7,9,20,36,61,-25,30
Cowdenbeath,5745,10,5,10,21,25,54,-29,25
Montrose,5746,1,24,7,5,60,34,26,79
Peterhead,5746,2,24,4,8,80,38,42,76
Stirling,5746,3,17,6,13,62,51,11,57
Clyde,5746,4,15,9,12,55,48,7,54
Stenhousem'r,5746,5,15,8,13,55,48,7,53
Elgin,5746,6,14,6,16,53,61,-8,48
Annan Athlet,5746,7,12,11,13,48,41,7,47
Berwick,5746,8,8,10,18,29,62,-33,34
Edinburgh Ci,5746,9,7,9,20,36,63,-27,30
Cowdenbeath,5746,10,4,10,22,23,55,-32,22
Montrose,5747,1,24,7,5,60,34,26,79
Peterhead,5747,2,24,4,8,79,39,40,76
Stirling,5747,3,17,6,13,62,52,10,57
Stenhousem'r,5747,4,15,8,13,56,48,8,53
Clyde,5747,5,14,9,13,53,51,2,51
Elgin,5747,6,14,6,16,53,61,-8,48
Annan Athlet,5747,7,11,12,13,48,42,6,45
Berwick,5747,8,9,10,17,32,60,-28,37
Edinburgh Ci,5747,9,7,9,20,37,62,-25,30
Cowdenbeath,5747,10,4,11,21,24,55,-31,23
Montrose,5748,1,24,7,5,62,34,28,79
Peterhead,5748,2,24,4,8,84,38,46,76
Stenhousem'r,5748,3,16,8,12,57,47,10,56
Stirling,5748,4,16,6,14,61,53,8,54
Clyde,5748,5,14,10,12,52,49,3,52
Elgin,5748,6,14,6,16,53,63,-10,48
Annan Athlet,5748,7,11,11,14,47,42,5,44
Berwick,5748,8,8,11,17,30,59,-29,35
Edinburgh Ci,5748,9,7,9,20,36,67,-31,30
Cowdenbeath,5748,10,5,10,21,24,54,-30,25
Montrose,5749,1,23,8,5,61,36,25,77
Peterhead,5749,2,24,4,8,82,39,43,76
Stirling,5749,3,17,6,13,63,51,12,57
Stenhousem'r,5749,4,15,8,13,55,49,6,53
Clyde,5749,5,14,10,12,52,49,3,52
Elgin,5749,6,14,7,15,55,62,-7,49
Annan Athlet,5749,7,11,11,14,47,43,4,44
Berwick,5749,8,8,11,17,30,59,-29,35
Edinburgh Ci,5749,9,7,9,20,37,65,-28,30
Cowdenbeath,5749,10,5,10,21,25,54,-29,25
Montrose,5750,1,24,7,5,61,35,26,79
Peterhead,5750,2,24,4,8,81,38,43,76
Stenhousem'r,5750,3,16,8,12,57,46,11,56
Stirling,5750,4,16,6,14,60,53,7,54
Clyde,5750,5,15,9,12,52,48,4,54
Elgin,5750,6,14,6,16,54,62,-8,48
Annan Athlet,5750,7,11,12,13,48,42,6,45
Berwick,5750,8,8,10,18,29,59,-30,34
Edinburgh Ci,5750,9,7,9,20,36,64,-28,30
Cowdenbeath,5750,10,4,11,21,24,55,-31,23
Montrose,5751,1,24,7,5,62,34,28,79
Peterhead,5751,2,24,4,8,78,38,40,76
Stenhousem'r,5751,3,16,8,12,59,48,11,56
Stirling,5751,4,16,6,14,62,55,7,54
Clyde,5751,5,14,10,12,53,50,3,52
Elgin,5751,6,14,6,16,53,63,-10,48
Annan Athlet,5751,7,11,12,13,48,42,6,45
Berwick,5751,8,8,11,17,31,60,-29,35
Edinburgh Ci,5751,9,7,9,20,36,61,-25,30
Cowdenbeath,5751,10,4,11,21,24,55,-31,23
Peterhead,5752,1,24,4,8,79,38,41,76
Montrose,5752,2,23,7,6,59,36,23,76
Stenhousem'r,5752,3,16,8,12,57,46,11,56
Stirling,5752,4,16,6,14,60,53,7,54
Clyde,5752,5,15,9,12,52,48,4,54
Elgin,5752,6,15,6,15,55,60,-5,51
Annan Athlet,5752,7,11,11,14,48,43,5,44
Berwick,5752,8,8,10,18,29,59,-30,34
Edinburgh Ci,5752,9,7,9,20,36,62,-26,30
Cowdenbeath,5752,10,5,10,21,25,55,-30,25
Montrose,5753,1,24,7,5,63,37,26,79
Peterhead,5753,2,24,4,8,80,40,40,76
Stirling,5753,3,17,6,13,62,52,10,57
Stenhousem'r,5753,4,15,8,13,56,48,8,53
Clyde,5753,5,14,10,12,51,48,3,52
Elgin,5753,6,14,6,16,56,64,-8,48
Annan Athlet,5753,7,11,12,13,48,42,6,45
Berwick,5753,8,8,11,17,29,58,-29,35
Edinburgh Ci,5753,9,7,9,20,38,63,-25,30
Cowdenbeath,5753,10,4,11,21,24,55,-31,23
Montrose,5754,1,23,8,5,61,36,25,77
Peterhead,5754,2,24,4,8,83,39,44,76
Stirling,5754,3,17,6,13,62,52,10,57
Stenhousem'r,5754,4,15,8,13,56,48,8,53
Clyde,5754,5,14,9,13,51,51,0,51
Elgin,5754,6,14,7,15,55,62,-7,49
Annan Athlet,5754,7,12,11,13,51,41,10,47
Berwick,5754,8,9,10,17,32,58,-26,37
Edinburgh Ci,5754,9,7,9,20,37,66,-29,30
Cowdenbeath,5754,10,4,10,22,23,58,-35,22
Peterhead,5755,1,24,4,8,82,40,42,76
Montrose,5755,2,23,7,6,61,37,24,76
Stirling,5755,3,16,7,13,61,52,9,55
Stenhousem'r,5755,4,15,9,12,56,47,9,54
Clyde,5755,5,14,10,12,53,50,3,52
Elgin,5755,6,15,6,15,56,62,-6,51
Annan Athlet,5755,7,12,11,13,48,41,7,47
Berwick,5755,8,8,11,17,31,60,-29,35
Edinburgh Ci,5755,9,7,9,20,38,65,-27,30
Cowdenbeath,5755,10,4,10,22,23,55,-32,22
Montrose,5756,1,24,7,5,61,35,26,79
Peterhead,5756,2,23,4,9,78,40,38,73
Stenhousem'r,5756,3,16,8,12,56,46,10,56
Stirling,5756,4,16,6,14,60,52,8,54
Clyde,5756,5,15,9,12,53,49,4,54
Elgin,5756,6,14,6,16,54,62,-8,48
Annan Athlet,5756,7,12,11,13,48,41,7,47
Berwick,5756,8,8,10,18,30,60,-30,34
Edinburgh Ci,5756,9,8,9,19,38,61,-23,33
Cowdenbeath,5756,10,4,10,22,23,55,-32,22
Montrose,5757,1,24,7,5,61,35,26,79
Peterhead,5757,2,24,4,8,81,38,43,76
Stenhousem'r,5757,3,16,8,12,57,46,11,56
Stirling,5757,4,16,6,14,60,53,7,54
Clyde,5757,5,15,9,12,53,48,5,54
Elgin,5757,6,14,6,16,54,62,-8,48
Annan Athlet,5757,7,11,11,14,47,42,5,44
Berwick,5757,8,8,10,18,29,60,-31,34
Edinburgh Ci,5757,9,7,9,20,36,64,-28,30
Cowdenbeath,5757,10,5,10,21,24,54,-30,25
Montrose,5758,1,24,7,5,63,35,28,79
Peterhead,5758,2,24,4,8,81,38,43,76
Stirling,5758,3,16,7,13,61,52,9,55
Stenhousem'r,5758,4,15,9,12,56,47,9,54
Clyde,5758,5,14,10,12,52,49,3,52
Elgin,5758,6,14,6,16,54,64,-10,48
Annan Athlet,5758,7,11,12,13,47,41,6,45
Berwick,5758,8,8,11,17,30,59,-29,35
Edinburgh Ci,5758,9,7,9,20,36,64,-28,30
Cowdenbeath,5758,10,4,11,21,23,54,-31,23
Montrose,5759,1,24,7,5,60,34,26,79
Peterhead,5759,2,24,4,8,79,38,41,76
Stirling,5759,3,16,7,13,60,51,9,55
Stenhousem'r,5759,4,15,9,12,55,46,9,54
Clyde,5759,5,14,9,13,52,52,0,51
Elgin,5759,6,14,6,16,53,61,-8,48
Annan Athlet,5759,7,11,12,13,48,42,6,45
Berwick,5759,8,9,10,17,33,59,-26,37
Edinburgh Ci,5759,9,7,9,20,36,62,-26,30
Cowdenbeath,5759,10,4,11,21,24,55,-31,23
Montrose,5760,1,24,7,5,62,34,28,79
Peterhead,5760,2,23,5,8,79,40,39,74
Stirling,5760,3,17,6,13,62,51,11,57
Stenhousem'r,5760,4,15,8,13,55,48,7,53
Clyde,5760,5,14,10,12,51,48,3,52
Elgin,5760,6,14,6,16,53,63,-10,48
Annan Athlet,5760,7,11,11,14,47,43,4,44
Berwick,5760,8,8,11,17,29,58,-29,35
Edinburgh Ci,5760,9,7,10,19,38,62,-24,31
Cowdenbeath,5760,10,5,10,21,25,54,-29,25
Montrose,5761,1,23,8,5,61,36,25,77
Peterhead,5761,2,23,5,8,79,40,39,74
Stirling,5761,3,17,6,13,61,51,10,57
Stenhousem'r,5761,4,15,8,13,55,47,8,53
Clyde,5761,5,14,9,13,53,51,2,51
Elgin,5761,6,14,7,15,55,62,-7,49
Annan Athlet,5761,7,12,11,13,48,41,7,47
Berwick,5761,8,9,10,17,32,60,-28,37
Edinburgh Ci,5761,9,7,10,19,38,62,-24,31
Cowdenbeath,5761,10,4,10,22,23,55,-32,22
Peterhead,5762,1,24,4,8,80,38,42,76
Montrose,5762,2,23,7,6,59,35,24,76
Stirling,5762,3,17,6,13,64,52,12,57
Clyde,5762,4,15,9,12,52,48,4,54
Stenhousem'r,5762,5,15,8,13,56,50,6,53
Elgin,5762,6,15,6,15,54,60,-6,51
Annan Athlet,5762,7,12,11,13,50,42,8,47
Berwick,5762,8,8,10,18,29,59,-30,34
Edinburgh Ci,5762,9,7,9,20,36,63,-27,30
Cowdenbeath,5762,10,4,10,22,24,57,-33,22
Montrose,5763,1,23,7,6,60,36,24,76
Peterhead,5763,2,23,5,8,79,40,39,74
Stenhousem'r,5763,3,16,8,12,61,48,13,56
Stirling,5763,4,16,6,14,62,57,5,54
Clyde,5763,5,15,9,12,53,49,4,54
Elgin,5763,6,15,6,15,55,61,-6,51
Annan Athlet,5763,7,11,11,14,47,43,4,44
Berwick,5763,8,8,10,18,30,60,-30,34
Edinburgh Ci,5763,9,7,10,19,38,62,-24,31
Cowdenbeath,5763,10,5,10,21,25,54,-29,25
Montrose,5764,1,23,8,5,61,36,25,77
Peterhead,5764,2,23,5,8,79,40,39,74
Stenhousem'r,5764,3,16,8,12,59,47,12,56
Stirling,5764,4,16,6,14,61,55,6,54
Clyde,5764,5,15,9,12,52,48,4,54
Elgin,5764,6,14,7,15,55,62,-7,49
Annan Athlet,5764,7,12,11,13,48,41,7,47
Berwick,5764,8,8,10,18,29,59,-30,34
Edinburgh Ci,5764,9,7,10,19,38,62,-24,31
Cowdenbeath,5764,10,4,10,22,23,55,-32,22
Montrose,5765,1,24,7,5,60,34,26,79
Peterhead,5765,2,24,4,8,80,40,40,76
Stirling,5765,3,17,6,13,63,51,12,57
Clyde,5765,4,15,9,12,52,48,4,54
Stenhousem'r,5765,5,15,8,13,55,49,6,53
Elgin,5765,6,14,6,16,53,61,-8,48
Annan Athlet,5765,7,12,11,13,50,41,9,47
Berwick,5765,8,8,10,18,29,59,-30,34
Edinburgh Ci,5765,9,7,9,20,38,63,-25,30
Cowdenbeath,5765,10,4,10,22,23,57,-34,22
Montrose,5766,1,24,7,5,62,36,26,79
Peterhead,5766,2,24,4,8,81,38,43,76
Stirling,5766,3,16,7,13,61,52,9,55
Stenhousem'r,5766,4,15,9,12,56,47,9,54
Clyde,5766,5,15,9,12,52,48,4,54
Elgin,5766,6,14,6,16,55,63,-8,48
Annan Athlet,5766,7,11,11,14,48,44,4,44
Berwick,5766,8,8,10,18,29,59,-30,34
Edinburgh Ci,5766,9,7,9,20,36,64,-28,30
Cowdenbeath,5766,10,5,10,21,26,55,-29,25
Montrose,5767,1,24,7,5,61,35,26,79
Peterhead,5767,2,24,4,8,78,38,40,76
Stirling,5767,3,16,7,13,62,53,9,55
Stenhousem'r,5767,4,15,9,12,57,48,9,54
Clyde,5767,5,14,9,13,51,50,1,51
Elgin,5767,6,14,6,16,54,62,-8,48
Annan Athlet,5767,7,11,11,14,48,45,3,44
Berwick,5767,8,9,10,17,31,58,-27,37
Edinburgh Ci,5767,9,7,9,20,36,61,-25,30
Cowdenbeath,5767,10,5,10,21,27,55,-28,25
Peterhead,5768,1,24,4,8,80,39,41,76
Montrose,5768,2,23,7,6,59,36,23,76
Stenhousem'r,5768,3,16,8,12,59,47,12,56
Clyde,5768,4,15,9,12,57,49,8,54
Stirling,5768,5,16,6,14,61,55,6,54
Elgin,5768,6,15,6,15,55,60,-5,51
Annan Athlet,5768,7,11,12,13,48,42,6,45
Berwick,5768,8,8,10,18,30,64,-34,34
Edinburgh Ci,5768,9,7,9,20,37,63,-26,30
Cowdenbeath,5768,10,4,11,21,24,55,-31,23
Montrose,5769,1,23,8,5,61,36,25,77
Peterhead,5769,2,24,4,8,83,39,44,76
Stenhousem'r,5769,3,16,8,12,57,47,10,56
Stirling,5769,4,16,6,14,61,53,8,54
Clyde,5769,5,14,10,12,52,49,3,52
Elgin,5769,6,14,7,15,55,62,-7,49
Annan Athlet,5769,7,11,11,14,47,42,5,44
Berwick,5769,8,8,11,17,30,59,-29,35
Edinburgh Ci,5769,9,7,9,20,37,66,-29,30
Cowdenbeath,5769,10,5,10,21,24,54,-30,25
Montrose,5770,1,24,7,5,63,35,28,79
Peterhead,5770,2,24,4,8,79,39,40,76
Stirling,5770,3,17,6,13,63,51,12,57
Clyde,5770,4,15,9,12,53,49,4,54
Stenhousem'r,5770,5,15,8,13,55,49,6,53
Elgin,5770,6,14,6,16,54,64,-10,48
Annan Athlet,5770,7,12,11,13,50,41,9,47
Berwick,5770,8,8,10,18,30,60,-30,34
Edinburgh Ci,5770,9,7,9,20,37,62,-25,30
Cowdenbeath,5770,10,4,10,22,23,57,-34,22
Montrose,5771,1,24,7,5,65,34,31,79
Peterhead,5771,2,24,4,8,80,38,42,76
Stirling,5771,3,17,6,13,63,52,11,57
Clyde,5771,4,15,9,12,53,48,5,54
Stenhousem'r,5771,5,15,8,13,56,49,7,53
Elgin,5771,6,14,6,16,53,66,-13,48
Annan Athlet,5771,7,12,11,13,49,42,7,47
Berwick,5771,8,8,10,18,29,60,-31,34
Edinburgh Ci,5771,9,7,9,20,36,63,-27,30
Cowdenbeath,5771,10,4,10,22,24,56,-32,22
Montrose,5772,1,24,7,5,63,35,28,79
Peterhead,5772,2,23,5,8,79,40,39,74
Stirling,5772,3,16,7,13,61,52,9,55
Stenhousem'r,5772,4,15,9,12,56,47,9,54
Clyde,5772,5,15,9,12,55,51,4,54
Elgin,5772,6,14,6,16,54,64,-10,48
Annan Athlet,5772,7,12,11,13,49,42,7,47
Berwick,5772,8,8,10,18,32,62,-30,34
Edinburgh Ci,5772,9,7,10,19,38,62,-24,31
Cowdenbeath,5772,10,4,10,22,24,56,-32,22
Montrose,5773,1,24,7,5,61,34,27,79
Peterhead,5773,2,24,4,8,78,38,40,76
Stirling,5773,3,16,7,13,61,52,9,55
Stenhousem'r,5773,4,15,9,12,56,47,9,54
Clyde,5773,5,15,9,12,53,49,4,54
Elgin,5773,6,14,6,16,53,62,-9,48
Annan Athlet,5773,7,12,11,13,48,41,7,47
Berwick,5773,8,8,10,18,30,60,-30,34
Edinburgh Ci,5773,9,7,9,20,36,61,-25,30
Cowdenbeath,5773,10,4,10,22,23,55,-32,22
Montrose,5774,1,24,7,5,61,35,26,79
Peterhead,5774,2,24,4,8,78,38,40,76
Stirling,5774,3,17,6,13,62,51,11,57
Clyde,5774,4,15,9,12,55,48,7,54
Stenhousem'r,5774,5,15,8,13,55,48,7,53
Elgin,5774,6,14,6,16,54,62,-8,48
Annan Athlet,5774,7,12,11,13,49,42,7,47
Berwick,5774,8,8,10,18,29,62,-33,34
Edinburgh Ci,5774,9,7,9,20,36,61,-25,30
Cowdenbeath,5774,10,4,10,22,24,56,-32,22
Montrose,5775,1,23,8,5,62,37,25,77
Peterhead,5775,2,24,4,8,78,38,40,76
Stenhousem'r,5775,3,16,8,12,56,46,10,56
Stirling,5775,4,16,6,14,60,52,8,54
Clyde,5775,5,14,9,13,51,51,0,51
Elgin,5775,6,14,7,15,56,63,-7,49
Annan Athlet,5775,7,11,11,14,47,43,4,44
Berwick,5775,8,9,10,17,32,58,-26,37
Edinburgh Ci,5775,9,7,9,20,36,61,-25,30
Cowdenbeath,5775,10,5,10,21,25,54,-29,25
Montrose,5776,1,24,7,5,62,35,27,79
Peterhead,5776,2,24,4,8,79,39,40,76
Stirling,5776,3,16,7,13,60,51,9,55
Stenhousem'r,5776,4,15,9,12,55,46,9,54
Clyde,5776,5,14,9,13,51,49,2,51
Elgin,5776,6,14,6,16,54,63,-9,48
Annan Athlet,5776,7,11,12,13,48,42,6,45
Berwick,5776,8,9,10,17,30,58,-28,37
Edinburgh Ci,5776,9,7,9,20,37,62,-25,30
Cowdenbeath,5776,10,4,11,21,24,55,-31,23
Montrose,5777,1,23,8,5,60,35,25,77
Peterhead,5777,2,24,4,8,80,40,40,76
Stirling,5777,3,17,6,13,62,52,10,57
Stenhousem'r,5777,4,15,8,13,56,48,8,53
Clyde,5777,5,14,9,13,52,50,2,51
Elgin,5777,6,14,7,15,54,61,-7,49
Annan Athlet,5777,7,11,12,13,47,41,6,45
Berwick,5777,8,9,10,17,31,59,-28,37
Edinburgh Ci,5777,9,7,9,20,38,63,-25,30
Cowdenbeath,5777,10,4,11,21,23,54,-31,23
Montrose,5778,1,23,8,5,60,35,25,77
Peterhead,5778,2,23,5,8,79,40,39,74
Stenhousem'r,5778,3,16,8,12,57,47,10,56
Stirling,5778,4,16,6,14,61,53,8,54
Clyde,5778,5,15,9,12,54,48,6,54
Elgin,5778,6,14,7,15,54,61,-7,49
Annan Athlet,5778,7,11,11,14,47,42,5,44
Berwick,5778,8,8,10,18,29,61,-32,34
Edinburgh Ci,5778,9,7,10,19,38,62,-24,31
Cowdenbeath,5778,10,5,10,21,24,54,-30,25
Montrose,5779,1,24,7,5,61,35,26,79
Peterhead,5779,2,24,4,8,80,38,42,76
Stenhousem'r,5779,3,16,8,12,56,46,10,56
Stirling,5779,4,16,6,14,60,52,8,54
Clyde,5779,5,15,9,12,53,49,4,54
Elgin,5779,6,14,6,16,54,62,-8,48
Annan Athlet,5779,7,11,12,13,47,41,6,45
Berwick,5779,8,8,10,18,30,60,-30,34
Edinburgh Ci,5779,9,7,9,20,36,63,-27,30
Cowdenbeath,5779,10,4,11,21,23,54,-31,23
Montrose,5780,1,24,7,5,61,34,27,79
Peterhead,5780,2,24,4,8,83,39,44,76
Stirling,5780,3,17,6,13,63,52,11,57
Clyde,5780,4,15,9,12,52,48,4,54
Stenhousem'r,5780,5,15,8,13,56,49,7,53
Elgin,5780,6,14,6,16,53,62,-9,48
Annan Athlet,5780,7,12,11,13,49,41,8,47
Berwick,5780,8,8,10,18,29,59,-30,34
Edinburgh Ci,5780,9,7,9,20,37,66,-29,30
Cowdenbeath,5780,10,4,10,22,23,56,-33,22
Montrose,5781,1,24,7,5,61,35,26,79
Peterhead,5781,2,24,4,8,80,40,40,76
Stenhousem'r,5781,3,16,8,12,58,47,11,56
Stirling,5781,4,16,6,14,61,54,7,54
Clyde,5781,5,15,9,12,55,51,4,54
Elgin,5781,6,14,6,16,54,62,-8,48
Annan Athlet,5781,7,12,11,13,49,41,8,47
Berwick,5781,8,8,10,18,32,62,-30,34
Edinburgh Ci,5781,9,7,9,20,38,63,-25,30
Cowdenbeath,5781,10,4,10,22,23,56,-33,22
Montrose,5782,1,24,7,5,60,34,26,79
Peterhead,5782,2,24,4,8,81,39,42,76
Stenhousem'r,5782,3,16,8,12,57,47,10,56
Stirling,5782,4,16,6,14,61,53,8,54
Clyde,5782,5,14,9,13,51,50,1,51
Elgin,5782,6,14,6,16,53,61,-8,48
Annan Athlet,5782,7,11,12,13,47,41,6,45
Berwick,5782,8,9,10,17,31,58,-27,37
Edinburgh Ci,5782,9,7,9,20,37,64,-27,30
Cowdenbeath,5782,10,4,11,21,23,54,-31,23
Peterhead,5783,1,24,4,8,80,38,42,76
Montrose,5783,2,23,7,6,60,37,23,76
Stenhousem'r,5783,3,16,8,12,57,47,10,56
Stirling,5783,4,16,6,14,61,53,8,54
Clyde,5783,5,15,9,12,52,48,4,54
Elgin,5783,6,15,6,15,56,61,-5,51
Annan Athlet,5783,7,12,11,13,49,41,8,47
Berwick,5783,8,8,10,18,29,59,-30,34
Edinburgh Ci,5783,9,7,9,20,36,63,-27,30
Cowdenbeath,5783,10,4,10,22,23,56,-33,22
Montrose,5784,1,24,7,5,61,34,27,79
Peterhead,5784,2,24,4,8,81,38,43,76
Stirling,5784,3,17,6,13,63,51,12,57
Clyde,5784,4,15,9,12,52,48,4,54
Stenhousem'r,5784,5,15,8,13,55,49,6,53
Elgin,5784,6,14,6,16,53,62,-9,48
Annan Athlet,5784,7,12,11,13,49,41,8,47
Berwick,5784,8,8,10,18,29,59,-30,34
Edinburgh Ci,5784,9,7,9,20,36,64,-28,30
Cowdenbeath,5784,10,4,10,22,23,56,-33,22
Peterhead,5785,1,24,4,8,81,39,42,76
Montrose,5785,2,23,7,6,59,36,23,76
Stenhousem'r,5785,3,16,8,12,56,46,10,56
Stirling,5785,4,16,6,14,60,52,8,54
Clyde,5785,5,14,9,13,51,51,0,51
Elgin,5785,6,15,6,15,55,60,-5,51
Annan Athlet,5785,7,12,11,13,49,41,8,47
Berwick,5785,8,9,10,17,32,58,-26,37
Edinburgh Ci,5785,9,7,9,20,37,64,-27,30
Cowdenbeath,5785,10,4,10,22,23,56,-33,22
Montrose,5786,1,24,7,5,62,35,27,79
Peterhead,5786,2,24,4,8,79,38,41,76
Stirling,5786,3,17,6,13,63,52,11,57
Stenhousem'r,5786,4,15,8,13,56,49,7,53
Clyde,5786,5,14,10,12,52,49,3,52
Elgin,5786,6,14,6,16,54,63,-9,48
Annan Athlet,5786,7,11,12,13,48,42,6,45
Berwick,5786,8,8,11,17,30,59,-29,35
Edinburgh Ci,5786,9,7,9,20,36,62,-26,30
Cowdenbeath,5786,10,4,11,21,24,55,-31,23
Montrose,5787,1,24,7,5,60,34,26,79
Peterhead,5787,2,24,4,8,79,38,41,76
Stirling,5787,3,17,6,13,62,51,11,57
Clyde,5787,4,15,9,12,55,50,5,54
Stenhousem'r,5787,5,15,8,13,55,48,7,53
Elgin,5787,6,14,6,16,53,61,-8,48
Annan Athlet,5787,7,11,12,13,48,42,6,45
Berwick,5787,8,8,10,18,31,62,-31,34
Edinburgh Ci,5787,9,7,9,20,36,62,-26,30
Cowdenbeath,5787,10,4,11,21,24,55,-31,23
Montrose,5788,1,24,7,5,60,34,26,79
Peterhead,5788,2,24,4,8,83,40,43,76
Stirling,5788,3,17,6,13,61,51,10,57
Clyde,5788,4,15,9,12,54,48,6,54
Stenhousem'r,5788,5,15,8,13,55,47,8,53
Elgin,5788,6,14,6,16,53,61,-8,48
Annan Athlet,5788,7,11,11,14,47,42,5,44
Berwick,5788,8,8,10,18,29,61,-32,34
Edinburgh Ci,5788,9,7,9,20,38,66,-28,30
Cowdenbeath,5788,10,5,10,21,24,54,-30,25
Peterhead,5789,1,24,4,8,79,39,40,76
Montrose,5789,2,23,7,6,60,37,23,76
Stenhousem'r,5789,3,16,8,12,56,46,10,56
Stirling,5789,4,16,6,14,60,52,8,54
Clyde,5789,5,15,9,12,53,49,4,54
Elgin,5789,6,15,6,15,56,61,-5,51
Annan Athlet,5789,7,11,11,14,48,45,3,44
Berwick,5789,8,8,10,18,30,60,-30,34
Edinburgh Ci,5789,9,7,9,20,37,62,-25,30
Cowdenbeath,5789,10,5,10,21,27,55,-28,25
Montrose,5790,1,24,7,5,61,35,26,79
Peterhead,5790,2,24,4,8,79,39,40,76
Stirling,5790,3,17,6,13,63,53,10,57
Clyde,5790,4,15,9,12,52,48,4,54
Stenhousem'r,5790,5,15,8,13,57,49,8,53
Elgin,5790,6,14,6,16,54,62,-8,48
Annan Athlet,5790,7,11,11,14,47,42,5,44
Berwick,5790,8,8,10,18,29,59,-30,34
Edinburgh Ci,5790,9,7,9,20,37,62,-25,30
Cowdenbeath,5790,10,5,10,21,24,54,-30,25
Montrose,5791,1,24,7,5,64,34,30,79
Peterhead,5791,2,23,5,8,78,39,39,74
Stirling,5791,3,16,7,13,61,52,9,55
Stenhousem'r,5791,4,15,9,12,56,47,9,54
Clyde,5791,5,15,9,12,52,48,4,54
Elgin,5791,6,14,6,16,53,65,-12,48
Annan Athlet,5791,7,11,12,13,48,42,6,45
Berwick,5791,8,8,10,18,29,59,-30,34
Edinburgh Ci,5791,9,7,10,19,37,61,-24,31
Cowdenbeath,5791,10,4,11,21,24,55,-31,23
Montrose,5792,1,24,7,5,63,35,28,79
Peterhead,5792,2,24,4,8,79,38,41,76
Stirling,5792,3,17,6,13,64,52,12,57
Clyde,5792,4,15,9,12,53,49,4,54
Stenhousem'r,5792,5,15,8,13,56,50,6,53
Elgin,5792,6,14,6,16,54,64,-10,48
Annan Athlet,5792,7,11,12,13,47,41,6,45
Berwick,5792,8,8,10,18,30,60,-30,34
Edinburgh Ci,5792,9,7,9,20,36,62,-26,30
Cowdenbeath,5792,10,4,11,21,23,54,-31,23
Montrose,5793,1,23,7,6,61,37,24,76
Peterhead,5793,2,23,5,8,79,40,39,74
Stenhousem'r,5793,3,16,8,12,57,47,10,56
Stirling,5793,4,16,6,14,61,53,8,54
Clyde,5793,5,15,9,12,53,48,5,54
Elgin,5793,6,15,6,15,56,62,-6,51
Annan Athlet,5793,7,12,11,13,48,41,7,47
Berwick,5793,8,8,10,18,29,60,-31,34
Edinburgh Ci,5793,9,7,10,19,38,62,-24,31
Cowdenbeath,5793,10,4,10,22,23,55,-32,22
Montrose,5794,1,23,8,5,61,36,25,77
Peterhead,5794,2,24,4,8,81,38,43,76
Stirling,5794,3,16,7,13,61,52,9,55
Stenhousem'r,5794,4,15,9,12,56,47,9,54
Clyde,5794,5,15,9,12,53,49,4,54
Elgin,5794,6,14,7,15,55,62,-7,49
Annan Athlet,5794,7,12,11,13,48,41,7,47
Berwick,5794,8,8,10,18,30,60,-30,34
Edinburgh Ci,5794,9,7,9,20,36,64,-28,30
Cowdenbeath,5794,10,4,10,22,23,55,-32,22
Montrose,5795,1,23,8,5,60,35,25,77
Peterhead,5795,2,23,4,9,78,41,37,73
Stirling,5795,3,17,6,13,65,51,14,57
Stenhousem'r,5795,4,15,8,13,55,51,4,53
Clyde,5795,5,14,9,13,51,49,2,51
Elgin,5795,6,14,7,15,54,61,-7,49
Annan Athlet,5795,7,12,11,13,49,41,8,47
Berwick,5795,8,9,10,17,30,58,-28,37
Edinburgh Ci,5795,9,8,9,19,39,61,-22,33
Cowdenbeath,5795,10,4,10,22,23,56,-33,22
Montrose,5796,1,24,7,5,61,34,27,79
Peterhead,5796,2,23,4,9,78,40,38,73
Stirling,5796,3,16,7,13,61,52,9,55
Stenhousem'r,5796,4,15,9,12,56,47,9,54
Clyde,5796,5,14,9,13,52,50,2,51
Elgin,5796,6,14,6,16,53,62,-9,48
Annan Athlet,5796,7,11,12,13,47,41,6,45
Berwick,5796,8,9,10,17,31,59,-28,37
Edinburgh Ci,5796,9,8,9,19,38,61,-23,33
Cowdenbeath,5796,10,4,11,21,23,54,-31,23
Montrose,5797,1,23,8,5,60,35,25,77
Peterhead,5797,2,23,5,8,78,39,39,74
Stenhousem'r,5797,3,16,8,12,59,48,11,56
Stirling,5797,4,16,6,14,62,55,7,54
Clyde,5797,5,14,9,13,51,49,2,51
Elgin,5797,6,14,7,15,54,61,-7,49
Annan Athlet,5797,7,11,12,13,48,42,6,45
Berwick,5797,8,9,10,17,30,58,-28,37
Edinburgh Ci,5797,9,7,10,19,37,61,-24,31
Cowdenbeath,5797,10,4,11,21,24,55,-31,23
Montrose,5798,1,24,7,5,62,35,27,79
Peterhead,5798,2,24,4,8,79,38,41,76
Stenhousem'r,5798,3,16,8,12,58,48,10,56
Stirling,5798,4,16,6,14,62,54,8,54
Clyde,5798,5,14,9,13,51,49,2,51
Elgin,5798,6,14,6,16,54,63,-9,48
Annan Athlet,5798,7,11,12,13,47,41,6,45
Berwick,5798,8,9,10,17,30,58,-28,37
Edinburgh Ci,5798,9,7,9,20,36,62,-26,30
Cowdenbeath,5798,10,4,11,21,23,54,-31,23
Peterhead,5799,1,24,4,8,81,38,43,76
Montrose,5799,2,23,7,6,60,36,24,76
Stenhousem'r,5799,3,16,8,12,57,46,11,56
Stirling,5799,4,16,6,14,60,53,7,54
Clyde,5799,5,14,10,12,51,48,3,52
Elgin,5799,6,15,6,15,55,61,-6,51
Annan Athlet,5799,7,11,11,14,47,42,5,44
Berwick,5799,8,8,11,17,29,58,-29,35
Edinburgh Ci,5799,9,7,9,20,36,64,-28,30
Cowdenbeath,5799,10,5,10,21,24,54,-30,25
Montrose,5800,1,24,7,5,61,35,26,79
Peterhead,5800,2,24,4,8,81,38,43,76
Stirling,5800,3,16,7,13,60,51,9,55
Stenhousem'r,5800,4,15,9,12,55,46,9,54
Clyde,5800,5,15,9,12,54,49,5,54
Elgin,5800,6,14,6,16,54,62,-8,48
Annan Athlet,5800,7,12,11,13,49,42,7,47
Berwick,5800,8,8,10,18,30,61,-31,34
Edinburgh Ci,5800,9,7,9,20,36,64,-28,30
Cowdenbeath,5800,10,4,10,22,24,56,-32,22
Montrose,5801,1,23,8,5,62,37,25,77
Peterhead,5801,2,23,4,9,77,39,38,73
Stenhousem'r,5801,3,16,8,12,58,47,11,56
Stirling,5801,4,16,6,14,61,54,7,54
Clyde,5801,5,15,9,12,54,48,6,54
Elgin,5801,6,14,7,15,56,63,-7,49
Annan Athlet,5801,7,11,11,14,47,43,4,44
Berwick,5801,8,8,10,18,29,61,-32,34
Edinburgh Ci,5801,9,8,9,19,37,60,-23,33
Cowdenbeath,5801,10,5,10,21,25,54,-29,25
Montrose,5802,1,24,7,5,60,34,26,79
Peterhead,5802,2,24,4,8,78,38,40,76
Stirling,5802,3,17,6,13,63,52,11,57
Clyde,5802,4,15,9,12,55,49,6,54
Stenhousem'r,5802,5,15,8,13,56,49,7,53
Elgin,5802,6,14,6,16,53,61,-8,48
Annan Athlet,5802,7,12,11,13,48,41,7,47
Berwick,5802,8,8,10,18,30,62,-32,34
Edinburgh Ci,5802,9,7,9,20,36,61,-25,30
Cowdenbeath,5802,10,4,10,22,23,55,-32,22
Montrose,5803,1,24,7,5,60,34,26,79
Peterhead,5803,2,24,4,8,80,38,42,76
Stirling,5803,3,17,6,13,63,52,11,57
Stenhousem'r,5803,4,15,8,13,56,49,7,53
Clyde,5803,5,14,9,13,51,50,1,51
Elgin,5803,6,14,6,16,53,61,-8,48
Annan Athlet,5803,7,11,12,13,48,42,6,45
Berwick,5803,8,9,10,17,31,58,-27,37
Edinburgh Ci,5803,9,7,9,20,36,63,-27,30
Cowdenbeath,5803,10,4,11,21,24,55,-31,23
Montrose,5804,1,24,7,5,62,36,26,79
Peterhead,5804,2,24,4,8,78,38,40,76
Stirling,5804,3,16,7,13,63,54,9,55
Stenhousem'r,5804,4,15,9,12,58,49,9,54
Clyde,5804,5,15,9,12,53,48,5,54
Elgin,5804,6,14,6,16,55,63,-8,48
Annan Athlet,5804,7,12,11,13,48,41,7,47
Berwick,5804,8,8,10,18,29,60,-31,34
Edinburgh Ci,5804,9,7,9,20,36,61,-25,30
Cowdenbeath,5804,10,4,10,22,23,55,-32,22
Montrose,5805,1,24,7,5,61,35,26,79
Peterhead,5805,2,24,4,8,82,40,42,76
Stirling,5805,3,16,7,13,60,51,9,55
Stenhousem'r,5805,4,15,9,12,55,46,9,54
Clyde,5805,5,14,10,12,53,50,3,52
Elgin,5805,6,14,6,16,54,62,-8,48
Annan Athlet,5805,7,12,11,13,48,41,7,47
Berwick,5805,8,8,11,17,31,60,-29,35
Edinburgh Ci,5805,9,7,9,20,38,65,-27,30
Cowdenbeath,5805,10,4,10,22,23,55,-32,22
Montrose,5806,1,24,7,5,61,34,27,79
Peterhead,5806,2,24,4,8,81,38,43,76
Stirling,5806,3,17,6,13,63,52,11,57
Stenhousem'r,5806,4,15,8,13,56,49,7,53
Clyde,5806,5,14,10,12,52,49,3,52
Elgin,5806,6,14,6,16,53,62,-9,48
Annan Athlet,5806,7,12,11,13,49,42,7,47
Berwick,5806,8,8,11,17,30,59,-29,35
Edinburgh Ci,5806,9,7,9,20,36,64,-28,30
Cowdenbeath,5806,10,4,10,22,24,56,-32,22
Montrose,5807,1,24,7,5,61,34,27,79
Peterhead,5807,2,24,4,8,81,38,43,76
Stirling,5807,3,16,7,13,61,52,9,55
Stenhousem'r,5807,4,15,9,12,56,47,9,54
Clyde,5807,5,14,10,12,52,49,3,52
Elgin,5807,6,14,6,16,53,62,-9,48
Annan Athlet,5807,7,11,11,14,48,44,4,44
Berwick,5807,8,8,11,17,30,59,-29,35
Edinburgh Ci,5807,9,7,9,20,36,64,-28,30
Cowdenbeath,5807,10,5,10,21,26,55,-29,25
Peterhead,5808,1,24,4,8,80,39,41,76
Montrose,5808,2,23,7,6,61,37,24,76
Stirling,5808,3,17,6,13,63,52,11,57
Clyde,5808,4,15,9,12,52,48,4,54
Stenhousem'r,5808,5,15,8,13,56,49,7,53
Elgin,5808,6,15,6,15,56,62,-6,51
Annan Athlet,5808,7,12,11,13,50,41,9,47
Berwick,5808,8,8,10,18,29,59,-30,34
Edinburgh Ci,5808,9,7,9,20,37,63,-26,30
Cowdenbeath,5808,10,4,10,22,23,57,-34,22
Montrose,5809,1,24,7,5,65,34,31,79
Peterhead,5809,2,23,5,8,77,38,39,74
Stenhousem'r,5809,3,16,8,12,57,47,10,56
Stirling,5809,4,16,6,14,61,53,8,54
Clyde,5809,5,14,10,12,53,50,3,52
Elgin,5809,6,14,6,16,53,66,-13,48
Annan Athlet,5809,7,12,11,13,48,41,7,47
Berwick,5809,8,8,11,17,31,60,-29,35
Edinburgh Ci,5809,9,7,10,19,36,60,-24,31
Cowdenbeath,5809,10,4,10,22,23,55,-32,22
Montrose,5810,1,24,7,5,63,34,29,79
Peterhead,5810,2,24,4,8,79,39,40,76
Stenhousem'r,5810,3,16,8,12,57,47,10,56
Stirling,5810,4,16,6,14,61,53,8,54
Clyde,5810,5,15,9,12,54,49,5,54
Elgin,5810,6,14,6,16,53,64,-11,48
Annan Athlet,5810,7,12,11,13,48,41,7,47
Berwick,5810,8,8,10,18,30,61,-31,34
Edinburgh Ci,5810,9,7,9,20,37,62,-25,30
Cowdenbeath,5810,10,4,10,22,23,55,-32,22
Montrose,5811,1,24,7,5,60,34,26,79
Peterhead,5811,2,24,4,8,79,38,41,76
Stirling,5811,3,16,7,13,62,53,9,55
Stenhousem'r,5811,4,15,9,12,57,48,9,54
Clyde,5811,5,14,9,13,51,50,1,51
Elgin,5811,6,14,6,16,53,61,-8,48
Annan Athlet,5811,7,12,11,13,49,41,8,47
Berwick,5811,8,9,10,17,31,58,-27,37
Edinburgh Ci,5811,9,7,9,20,36,62,-26,30
Cowdenbeath,5811,10,4,10,22,23,56,-33,22
Montrose,5812,1,24,7,5,62,34,28,79
Peterhead,5812,2,23,5,8,78,39,39,74
Stirling,5812,3,17,6,13,61,51,10,57
Clyde,5812,4,15,9,12,53,49,4,54
Stenhousem'r,5812,5,15,8,13,55,47,8,53
Elgin,5812,6,14,6,16,53,63,-10,48
Annan Athlet,5812,7,12,11,13,52,41,11,47
Berwick,5812,8,8,10,18,30,60,-30,34
Edinburgh Ci,5812,9,7,10,19,37,61,-24,31
Cowdenbeath,5812,10,4,10,22,23,59,-36,22
Montrose,5813,1,24,7,5,64,34,30,79
Peterhead,5813,2,24,4,8,80,39,41,76
Stenhousem'r,5813,3,16,8,12,60,47,13,56
Clyde,5813,4,15,9,12,57,49,8,54
Stirling,5813,5,16,6,14,61,56,5,54
Elgin,5813,6,14,6,16,53,65,-12,48
Annan Athlet,5813,7,11,12,13,48,42,6,45
Berwick,5813,8,8,10,18,30,64,-34,34
Edinburgh Ci,5813,9,7,9,20,37,63,-26,30
Cowdenbeath,5813,10,4,11,21,24,55,-31,23
Montrose,5814,1,24,7,5,63,34,29,79
Peterhead,5814,2,24,4,8,81,38,43,76
Stirling,5814,3,17,6,13,64,52,12,57
Clyde,5814,4,15,9,12,53,49,4,54
Stenhousem'r,5814,5,15,8,13,56,50,6,53
Elgin,5814,6,14,6,16,53,64,-11,48
Annan Athlet,5814,7,11,11,14,47,44,3,44
Berwick,5814,8,8,10,18,30,60,-30,34
Edinburgh Ci,5814,9,7,9,20,36,64,-28,30
Cowdenbeath,5814,10,5,10,21,26,54,-28,25
Montrose,5815,1,24,7,5,63,36,27,79
Peterhead,5815,2,24,4,8,79,38,41,76
Stirling,5815,3,17,6,13,62,52,10,57
Stenhousem'r,5815,4,15,8,13,56,48,8,53
Clyde,5815,5,14,10,12,52,49,3,52
Elgin,5815,6,14,6,16,55,64,-9,48
Annan Athlet,5815,7,12,11,13,50,42,8,47
Berwick,5815,8,8,11,17,30,59,-29,35
Edinburgh Ci,5815,9,7,9,20,36,62,-26,30
Cowdenbeath,5815,10,4,10,22,24,57,-33,22
Montrose,5816,1,24,7,5,62,36,26,79
Peterhead,5816,2,24,4,8,79,38,41,76
Stirling,5816,3,17,6,13,64,53,11,57
Stenhousem'r,5816,4,15,8,13,57,50,7,53
Clyde,5816,5,14,10,12,53,50,3,52
Elgin,5816,6,14,6,16,55,63,-8,48
Annan Athlet,5816,7,12,11,13,49,42,7,47
Berwick,5816,8,8,11,17,31,60,-29,35
Edinburgh Ci,5816,9,7,9,20,36,62,-26,30
Cowdenbeath,5816,10,4,10,22,24,56,-32,22
Montrose,5817,1,24,7,5,61,34,27,79
Peterhead,5817,2,23,5,8,78,39,39,74
Stenhousem'r,5817,3,16,8,12,56,46,10,56
Stirling,5817,4,16,6,14,60,52,8,54
Clyde,5817,5,15,9,12,53,49,4,54
Elgin,5817,6,14,6,16,53,62,-9,48
Annan Athlet,5817,7,11,12,13,48,42,6,45
Berwick,5817,8,8,10,18,30,60,-30,34
Edinburgh Ci,5817,9,7,10,19,37,61,-24,31
Cowdenbeath,5817,10,4,11,21,24,55,-31,23
Montrose,5818,1,23,7,6,59,37,22,76
Peterhead,5818,2,23,5,8,77,38,39,74
Stirling,5818,3,16,7,13,62,53,9,55
Stenhousem'r,5818,4,15,9,12,57,48,9,54
Clyde,5818,5,15,9,12,55,48,7,54
Elgin,5818,6,15,6,15,56,60,-4,51
Annan Athlet,5818,7,12,11,13,48,41,7,47
Berwick,5818,8,8,10,18,29,62,-33,34
Edinburgh Ci,5818,9,7,10,19,36,60,-24,31
Cowdenbeath,5818,10,4,10,22,23,55,-32,22
Montrose,5819,1,24,7,5,65,34,31,79
Peterhead,5819,2,23,5,8,78,39,39,74
Stenhousem'r,5819,3,16,8,12,57,46,11,56
Stirling,5819,4,16,6,14,60,53,7,54
Clyde,5819,5,15,9,12,55,49,6,54
Elgin,5819,6,14,6,16,53,66,-13,48
Annan Athlet,5819,7,12,11,13,49,41,8,47
Berwick,5819,8,8,10,18,30,62,-32,34
Edinburgh Ci,5819,9,7,10,19,37,61,-24,31
Cowdenbeath,5819,10,4,10,22,23,56,-33,22
Montrose,5820,1,24,7,5,61,34,27,79
Peterhead,5820,2,23,5,8,77,38,39,74
Stirling,5820,3,17,6,13,63,53,10,57
Stenhousem'r,5820,4,15,8,13,57,49,8,53
Clyde,5820,5,14,9,13,53,52,1,51
Elgin,5820,6,14,6,16,53,62,-9,48
Annan Athlet,5820,7,12,11,13,49,41,8,47
Berwick,5820,8,9,10,17,33,60,-27,37
Edinburgh Ci,5820,9,7,10,19,36,60,-24,31
Cowdenbeath,5820,10,4,10,22,23,56,-33,22
Montrose,5821,1,24,7,5,63,35,28,79
Peterhead,5821,2,24,4,8,78,38,40,76
Stenhousem'r,5821,3,16,8,12,56,46,10,56
Stirling,5821,4,16,6,14,60,52,8,54
Clyde,5821,5,14,10,12,52,49,3,52
Elgin,5821,6,14,6,16,54,64,-10,48
Annan Athlet,5821,7,11,11,14,47,43,4,44
Berwick,5821,8,8,11,17,30,59,-29,35
Edinburgh Ci,5821,9,7,9,20,36,61,-25,30
Cowdenbeath,5821,10,5,10,21,25,54,-29,25
Montrose,5822,1,24,7,5,62,34,28,79
Peterhead,5822,2,24,4,8,81,38,43,76
Stenhousem'r,5822,3,16,8,12,59,49,10,56
Stirling,5822,4,16,6,14,63,55,8,54
Clyde,5822,5,15,9,12,53,49,4,54
Elgin,5822,6,14,6,16,53,63,-10,48
Annan Athlet,5822,7,11,11,14,47,43,4,44
Berwick,5822,8,8,10,18,30,60,-30,34
Edinburgh Ci,5822,9,7,9,20,36,64,-28,30
Cowdenbeath,5822,10,5,10,21,25,54,-29,25
Montrose,5823,1,24,7,5,64,35,29,79
Peterhead,5823,2,24,4,8,80,39,41,76
Stenhousem'r,5823,3,16,8,12,58,46,12,56
Stirling,5823,4,16,6,14,60,54,6,54
Clyde,5823,5,14,9,13,51,49,2,51
Elgin,5823,6,14,6,16,54,65,-11,48
Annan Athlet,5823,7,11,12,13,47,41,6,45
Berwick,5823,8,9,10,17,30,58,-28,37
Edinburgh Ci,5823,9,7,9,20,37,63,-26,30
Cowdenbeath,5823,10,4,11,21,23,54,-31,23
Montrose,5824,1,24,7,5,61,34,27,79
Peterhead,5824,2,23,4,9,78,40,38,73
Stirling,5824,3,16,7,13,60,51,9,55
Stenhousem'r,5824,4,15,9,12,55,46,9,54
Clyde,5824,5,14,10,12,52,49,3,52
Elgin,5824,6,14,6,16,53,62,-9,48
Annan Athlet,5824,7,11,12,13,48,42,6,45
Berwick,5824,8,8,11,17,30,59,-29,35
Edinburgh Ci,5824,9,8,9,19,38,61,-23,33
Cowdenbeath,5824,10,4,11,21,24,55,-31,23
Montrose,5825,1,24,7,5,62,34,28,79
Peterhead,5825,2,23,5,8,77,38,39,74
Stirling,5825,3,17,6,13,62,52,10,57
Clyde,5825,4,15,9,12,55,48,7,54
Stenhousem'r,5825,5,15,8,13,56,48,8,53
Elgin,5825,6,14,6,16,53,63,-10,48
Annan Athlet,5825,7,11,12,13,47,41,6,45
Berwick,5825,8,8,10,18,29,62,-33,34
Edinburgh Ci,5825,9,7,10,19,36,60,-24,31
Cowdenbeath,5825,10,4,11,21,23,54,-31,23
Montrose,5826,1,24,7,5,60,34,26,79
Peterhead,5826,2,23,5,8,78,39,39,74
Stenhousem'r,5826,3,16,8,12,57,47,10,56
Stirling,5826,4,16,6,14,61,53,8,54
Clyde,5826,5,15,9,12,54,49,5,54
Elgin,5826,6,14,6,16,53,61,-8,48
Annan Athlet,5826,7,11,11,14,47,42,5,44
Berwick,5826,8,8,10,18,30,61,-31,34
Edinburgh Ci,5826,9,7,10,19,37,61,-24,31
Cowdenbeath,5826,10,5,10,21,24,54,-30,25
Peterhead,5827,1,24,4,8,79,38,41,76
Montrose,5827,2,23,7,6,61,37,24,76
Stirling,5827,3,17,6,13,64,51,13,57
Stenhousem'r,5827,4,15,8,13,55,50,5,53
Clyde,5827,5,14,9,13,51,50,1,51
Elgin,5827,6,15,6,15,56,62,-6,51
Annan Athlet,5827,7,12,11,13,48,41,7,47
Berwick,5827,8,9,10,17,31,58,-27,37
Edinburgh Ci,5827,9,7,9,20,36,62,-26,30
Cowdenbeath,5827,10,4,10,22,23,55,-32,22
Montrose,5828,1,24,7,5,61,35,26,79
Peterhead,5828,2,24,4,8,79,38,41,76
Stirling,5828,3,16,7,13,60,51,9,55
Stenhousem'r,5828,4,15,9,12,55,46,9,54
Clyde,5828,5,14,9,13,51,49,2,51
Elgin,5828,6,14,6,16,54,62,-8,48
Annan Athlet,5828,7,12,11,13,49,41,8,47
Berwick,5828,8,9,10,17,30,58,-28,37
Edinburgh Ci,5828,9,7,9,20,36,62,-26,30
Cowdenbeath,5828,10,4,10,22,23,56,-33,22
Montrose,5829,1,23,8,5,61,36,25,77
Peterhead,5829,2,24,4,8,80,39,41,76
Stenhousem'r,5829,3,16,8,12,59,47,12,56
Stirling,5829,4,16,6,14,61,55,6,54
Clyde,5829,5,14,9,13,54,53,1,51
Elgin,5829,6,14,7,15,55,62,-7,49
Annan Athlet,5829,7,11,12,13,48,42,6,45
Berwick,5829,8,9,10,17,34,61,-27,37
Edinburgh Ci,5829,9,7,9,20,37,63,-26,30
Cowdenbeath,5829,10,4,11,21,24,55,-31,23
Peterhead,5830,1,24,4,8,80,39,41,76
Montrose,5830,2,23,7,6,61,37,24,76
Stirling,5830,3,17,6,13,61,51,10,57
Clyde,5830,4,15,9,12,53,48,5,54
Stenhousem'r,5830,5,15,8,13,55,47,8,53
Elgin,5830,6,15,6,15,56,62,-6,51
Annan Athlet,5830,7,11,11,14,47,44,3,44
Berwick,5830,8,8,10,18,29,60,-31,34
Edinburgh Ci,5830,9,7,9,20,37,63,-26,30
Cowdenbeath,5830,10,5,10,21,26,54,-28,25
Montrose,5831,1,23,8,5,60,35,25,77
Peterhead,5831,2,24,4,8,80,39,41,76
Stirling,5831,3,16,7,13,62,53,9,55
Stenhousem'r,5831,4,15,9,12,57,48,9,54
Clyde,5831,5,15,9,12,55,48,7,54
Elgin,5831,6,14,7,15,54,61,-7,49
Annan Athlet,5831,7,12,11,13,50,42,8,47
Berwick,5831,8,8,10,18,29,62,-33,34
Edinburgh Ci,5831,9,7,9,20,37,63,-26,30
Cowdenbeath,5831,10,4,10,22,24,57,-33,22
Montrose,5832,1,24,7,5,63,35,28,79
Peterhead,5832,2,23,4,9,79,41,38,73
Stirling,5832,3,16,7,13,61,52,9,55
Stenhousem'r,5832,4,15,9,12,56,47,9,54
Clyde,5832,5,14,10,12,53,50,3,52
Elgin,5832,6,14,6,16,54,64,-10,48
Annan Athlet,5832,7,12,11,13,48,41,7,47
Berwick,5832,8,8,11,17,31,60,-29,35
Edinburgh Ci,5832,9,8,9,19,39,62,-23,33
Cowdenbeath,5832,10,4,10,22,23,55,-32,22
Montrose,5833,1,24,7,5,60,34,26,79
Peterhead,5833,2,24,4,8,80,40,40,76
Stirling,5833,3,17,6,13,62,51,11,57
Stenhousem'r,5833,4,15,8,13,55,48,7,53
Clyde,5833,5,14,10,12,52,49,3,52
Elgin,5833,6,14,6,16,53,61,-8,48
Annan Athlet,5833,7,12,11,13,49,42,7,47
Berwick,5833,8,8,11,17,30,59,-29,35
Edinburgh Ci,5833,9,7,9,20,38,63,-25,30
Cowdenbeath,5833,10,4,10,22,24,56,-32,22
Montrose,5834,1,24,7,5,61,35,26,79
Peterhead,5834,2,23,5,8,78,39,39,74
Stirling,5834,3,16,7,13,62,53,9,55
Stenhousem'r,5834,4,15,9,12,57,48,9,54
Clyde,5834,5,14,10,12,53,50,3,52
Elgin,5834,6,14,6,16,54,62,-8,48
Annan Athlet,5834,7,12,11,13,49,42,7,47
Berwick,5834,8,8,11,17,31,60,-29,35
Edinburgh Ci,5834,9,7,10,19,37,61,-24,31
Cowdenbeath,5834,10,4,10,22,24,56,-32,22
Montrose,5835,1,24,7,5,63,35,28,79
Peterhead,5835,2,24,4,8,85,40,45,76
Stirling,5835,3,16,7,13,61,52,9,55
Stenhousem'r,5835,4,15,9,12,56,47,9,54
Clyde,5835,5,15,9,12,53,49,4,54
Elgin,5835,6,14,6,16,54,64,-10,48
Annan Athlet,5835,7,11,11,14,47,42,5,44
Berwick,5835,8,8,10,18,30,60,-30,34
Edinburgh Ci,5835,9,7,9,20,38,68,-30,30
Cowdenbeath,5835,10,5,10,21,24,54,-30,25
Montrose,5836,1,24,7,5,62,35,27,79
Peterhead,5836,2,24,4,8,79,39,40,76
Stirling,5836,3,16,7,13,60,51,9,55
Stenhousem'r,5836,4,15,9,12,55,46,9,54
Clyde,5836,5,15,9,12,54,50,4,54
Elgin,5836,6,14,6,16,54,63,-9,48
Annan Athlet,5836,7,11,12,13,48,42,6,45
Berwick,5836,8,8,10,18,31,61,-30,34
Edinburgh Ci,5836,9,7,9,20,37,62,-25,30
Cowdenbeath,5836,10,4,11,21,24,55,-31,23
Montrose,5837,1,24,7,5,63,36,27,79
Peterhead,5837,2,23,5,8,77,38,39,74
Stirling,5837,3,17,6,13,63,52,11,57
Stenhousem'r,5837,4,15,8,13,56,49,7,53
Clyde,5837,5,14,10,12,51,48,3,52
Elgin,5837,6,14,6,16,55,64,-9,48
Annan Athlet,5837,7,11,11,14,47,42,5,44
Berwick,5837,8,8,11,17,29,58,-29,35
Edinburgh Ci,5837,9,7,10,19,36,60,-24,31
Cowdenbeath,5837,10,5,10,21,24,54,-30,25
Montrose,5838,1,23,8,5,60,35,25,77
Peterhead,5838,2,24,4,8,79,39,40,76
Stirling,5838,3,17,6,13,61,51,10,57
Stenhousem'r,5838,4,15,8,13,55,47,8,53
Clyde,5838,5,14,9,13,52,50,2,51
Elgin,5838,6,14,7,15,54,61,-7,49
Annan Athlet,5838,7,11,12,13,48,42,6,45
Berwick,5838,8,9,10,17,31,59,-28,37
Edinburgh Ci,5838,9,7,9,20,37,62,-25,30
Cowdenbeath,5838,10,4,11,21,24,55,-31,23
Montrose,5839,1,24,7,5,61,34,27,79
Peterhead,5839,2,24,4,8,80,39,41,76
Stirling,5839,3,17,6,13,62,52,10,57
Stenhousem'r,5839,4,15,8,13,56,48,8,53
Clyde,5839,5,14,9,13,53,51,2,51
Elgin,5839,6,14,6,16,53,62,-9,48
Annan Athlet,5839,7,12,11,13,48,41,7,47
Berwick,5839,8,9,10,17,32,60,-28,37
Edinburgh Ci,5839,9,7,9,20,37,63,-26,30
Cowdenbeath,5839,10,4,10,22,23,55,-32,22
Montrose,5840,1,24,7,5,63,36,27,79
Peterhead,5840,2,24,4,8,78,38,40,76
Stirling,5840,3,16,7,13,62,53,9,55
Stenhousem'r,5840,4,15,9,12,57,48,9,54
Clyde,5840,5,14,10,12,53,50,3,52
Elgin,5840,6,14,6,16,55,64,-9,48
Annan Athlet,5840,7,12,11,13,50,41,9,47
Berwick,5840,8,8,11,17,31,60,-29,35
Edinburgh Ci,5840,9,7,9,20,36,61,-25,30
Cowdenbeath,5840,10,4,10,22,23,57,-34,22
Montrose,5841,1,24,7,5,60,34,26,79
Peterhead,5841,2,24,4,8,82,38,44,76
Stenhousem'r,5841,3,16,8,12,56,46,10,56
Stirling,5841,4,16,6,14,60,52,8,54
Clyde,5841,5,15,9,12,55,49,6,54
Elgin,5841,6,14,6,16,53,61,-8,48
Annan Athlet,5841,7,12,11,13,49,41,8,47
Berwick,5841,8,8,10,18,30,62,-32,34
Edinburgh Ci,5841,9,7,9,20,36,65,-29,30
Cowdenbeath,5841,10,4,10,22,23,56,-33,22
Montrose,5842,1,24,7,5,62,35,27,79
Peterhead,5842,2,24,4,8,79,39,40,76
Stenhousem'r,5842,3,16,8,12,59,47,12,56
Stirling,5842,4,16,6,14,61,55,6,54
Clyde,5842,5,14,10,12,51,48,3,52
Elgin,5842,6,14,6,16,54,63,-9,48
Annan Athlet,5842,7,12,11,13,49,41,8,47
Berwick,5842,8,8,11,17,29,58,-29,35
Edinburgh Ci,5842,9,7,9,20,37,62,-25,30
Cowdenbeath,5842,10,4,10,22,23,56,-33,22
Montrose,5843,1,23,7,6,59,37,22,76
Peterhead,5843,2,23,5,8,79,40,39,74
Stirling,5843,3,16,7,13,63,54,9,55
Stenhousem'r,5843,4,15,9,12,58,49,9,54
Clyde,5843,5,14,9,13,51,49,2,51
Elgin,5843,6,15,6,15,56,60,-4,51
Annan Athlet,5843,7,11,11,14,47,42,5,44
Berwick,5843,8,9,10,17,30,58,-28,37
Edinburgh Ci,5843,9,7,10,19,38,62,-24,31
Cowdenbeath,5843,10,5,10,21,24,54,-30,25
Montrose,5844,1,24,7,5,61,35,26,79
Peterhead,5844,2,24,4,8,80,38,42,76
Stirling,5844,3,16,7,13,60,51,9,55
Stenhousem'r,5844,4,15,9,12,55,46,9,54
Clyde,5844,5,15,9,12,54,49,5,54
Elgin,5844,6,14,6,16,54,62,-8,48
Annan Athlet,5844,7,11,11,14,47,42,5,44
Berwick,5844,8,8,10,18,30,61,-31,34
Edinburgh Ci,5844,9,7,9,20,36,63,-27,30
Cowdenbeath,5844,10,5,10,21,24,54,-30,25
Montrose,5845,1,24,7,5,61,34,27,79
Peterhead,5845,2,24,4,8,84,38,46,76
Stirling,5845,3,16,7,13,62,53,9,55
Stenhousem'r,5845,4,15,9,12,57,48,9,54
Clyde,5845,5,14,9,13,52,51,1,51
Elgin,5845,6,14,6,16,53,62,-9,48
Annan Athlet,5845,7,11,12,13,47,41,6,45
Berwick,5845,8,9,10,17,32,59,-27,37
Edinburgh Ci,5845,9,7,9,20,36,67,-31,30
Cowdenbeath,5845,10,4,11,21,23,54,-31,23
Montrose,5846,1,24,7,5,62,35,27,79
Peterhead,5846,2,24,4,8,81,39,42,76
Stirling,5846,3,16,7,13,63,54,9,55
Stenhousem'r,5846,4,15,9,12,58,49,9,54
Clyde,5846,5,14,10,12,53,50,3,52
Elgin,5846,6,14,6,16,54,63,-9,48
Annan Athlet,5846,7,12,11,13,49,42,7,47
Berwick,5846,8,8,11,17,31,60,-29,35
Edinburgh Ci,5846,9,7,9,20,37,64,-27,30
Cowdenbeath,5846,10,4,10,22,24,56,-32,22
Montrose,5847,1,23,8,5,60,35,25,77
Peterhead,5847,2,24,4,8,81,40,41,76
Stirling,5847,3,17,6,13,62,52,10,57
Clyde,5847,4,15,9,12,53,49,4,54
Stenhousem'r,5847,5,15,8,13,56,48,8,53
Elgin,5847,6,14,7,15,54,61,-7,49
Annan Athlet,5847,7,12,11,13,50,41,9,47
Berwick,5847,8,8,10,18,30,60,-30,34
Edinburgh Ci,5847,9,7,9,20,38,64,-26,30
Cowdenbeath,5847,10,4,10,22,23,57,-34,22
Montrose,5848,1,23,8,5,61,36,25,77
Peterhead,5848,2,23,5,8,80,41,39,74
Stenhousem'r,5848,3,16,8,12,60,47,13,56
Stirling,5848,4,16,6,14,61,56,5,54
Clyde,5848,5,15,9,12,54,49,5,54
Elgin,5848,6,14,7,15,55,62,-7,49
Annan Athlet,5848,7,11,12,13,47,41,6,45
Berwick,5848,8,8,10,18,30,61,-31,34
Edinburgh Ci,5848,9,7,10,19,39,63,-24,31
Cowdenbeath,5848,10,4,11,21,23,54,-31,23
Montrose,5849,1,24,7,5,61,35,26,79
Peterhead,5849,2,23,5,8,77,38,39,74
Stirling,5849,3,17,6,13,61,51,10,57
Clyde,5849,4,15,9,12,57,49,8,54
Stenhousem'r,5849,5,15,8,13,55,47,8,53
Elgin,5849,6,14,6,16,54,62,-8,48
Annan Athlet,5849,7,11,11,14,47,44,3,44
Berwick,5849,8,8,10,18,30,64,-34,34
Edinburgh Ci,5849,9,7,10,19,36,60,-24,31
Cowdenbeath,5849,10,5,10,21,26,54,-28,25
Montrose,5850,1,24,7,5,61,34,27,79
Peterhead,5850,2,23,5,8,79,40,39,74
Stirling,5850,3,17,6,13,62,51,11,57
Clyde,5850,4,15,9,12,54,50,4,54
Stenhousem'r,5850,5,15,8,13,55,48,7,53
Elgin,5850,6,14,6,16,53,62,-9,48
Annan Athlet,5850,7,11,12,13,48,42,6,45
Berwick,5850,8,8,10,18,31,61,-30,34
Edinburgh Ci,5850,9,7,10,19,38,62,-24,31
Cowdenbeath,5850,10,4,11,21,24,55,-31,23
Montrose,5851,1,24,7,5,62,35,27,79
Peterhead,5851,2,24,4,8,79,38,41,76
Stenhousem'r,5851,3,16,8,12,59,48,11,56
Stirling,5851,4,16,6,14,62,55,7,54
Clyde,5851,5,15,9,12,54,48,6,54
Elgin,5851,6,14,6,16,54,63,-9,48
Annan Athlet,5851,7,11,11,14,47,44,3,44
Berwick,5851,8,8,10,18,29,61,-32,34
Edinburgh Ci,5851,9,7,9,20,36,62,-26,30
Cowdenbeath,5851,10,5,10,21,26,54,-28,25
Montrose,5852,1,24,7,5,65,34,31,79
Peterhead,5852,2,23,5,8,77,38,39,74
Stirling,5852,3,17,6,13,62,51,11,57
Stenhousem'r,5852,4,15,8,13,55,48,7,53
Clyde,5852,5,14,10,12,51,48,3,52
Elgin,5852,6,14,6,16,53,66,-13,48
Annan Athlet,5852,7,12,11,13,48,41,7,47
Berwick,5852,8,8,11,17,29,58,-29,35
Edinburgh Ci,5852,9,7,10,19,36,60,-24,31
Cowdenbeath,5852,10,4,10,22,23,55,-32,22
Montrose,5853,1,24,7,5,60,34,26,79
Peterhead,5853,2,24,4,8,80,38,42,76
Stenhousem'r,5853,3,16,8,12,56,46,10,56
Stirling,5853,4,16,6,14,60,52,8,54
Clyde,5853,5,15,9,12,54,50,4,54
Elgin,5853,6,14,6,16,53,61,-8,48
Annan Athlet,5853,7,11,12,13,48,42,6,45
Berwick,5853,8,8,10,18,31,61,-30,34
Edinburgh Ci,5853,9,7,9,20,36,63,-27,30
Cowdenbeath,5853,10,4,11,21,24,55,-31,23
Montrose,5854,1,24,7,5,63,34,29,79
Peterhead,5854,2,24,4,8,80,39,41,76
Stirling,5854,3,17,6,13,63,52,11,57
Stenhousem'r,5854,4,15,8,13,56,49,7,53
Clyde,5854,5,14,9,13,51,50,1,51
Elgin,5854,6,14,6,16,53,64,-11,48
Annan Athlet,5854,7,11,12,13,48,42,6,45
Berwick,5854,8,9,10,17,31,58,-27,37
Edinburgh Ci,5854,9,7,9,20,37,63,-26,30
Cowdenbeath,5854,10,4,11,21,24,55,-31,23
Montrose,5855,1,24,7,5,61,35,26,79
Peterhead,5855,2,24,4,8,78,38,40,76
Stirling,5855,3,16,7,13,61,52,9,55
Stenhousem'r,5855,4,15,9,12,56,47,9,54
Clyde,5855,5,15,9,12,53,48,5,54
Elgin,5855,6,14,6,16,54,62,-8,48
Annan Athlet,5855,7,11,12,13,48,42,6,45
Berwick,5855,8,8,10,18,29,60,-31,34
Edinburgh Ci,5855,9,7,9,20,36,61,-25,30
Cowdenbeath,5855,10,4,11,21,24,55,-31,23
Peterhead,5856,1,24,4,8,81,39,42,76
Montrose,5856,2,23,7,6,59,35,24,76
Stenhousem'r,5856,3,16,8,12,58,47,11,56
Stirling,5856,4,16,6,14,61,54,7,54
Clyde,5856,5,15,9,12,53,48,5,54
Elgin,5856,6,15,6,15,54,60,-6,51
Annan Athlet,5856,7,12,11,13,48,41,7,47
Berwick,5856,8,8,10,18,29,60,-31,34
Edinburgh Ci,5856,9,7,9,20,37,64,-27,30
Cowdenbeath,5856,10,4,10,22,23,55,-32,22
Montrose,5857,1,24,7,5,66,34,32,79
Peterhead,5857,2,23,5,8,79,40,39,74
Stirling,5857,3,16,7,13,61,52,9,55
Stenhousem'r,5857,4,15,9,12,56,47,9,54
Clyde,5857,5,14,9,13,51,49,2,51
Elgin,5857,6,14,6,16,53,67,-14,48
Annan Athlet,5857,7,11,12,13,49,43,6,45
Berwick,5857,8,9,10,17,30,58,-28,37
Edinburgh Ci,5857,9,7,10,19,38,62,-24,31
Cowdenbeath,5857,10,4,11,21,25,56,-31,23
Montrose,5858,1,23,8,5,60,35,25,77
Peterhead,5858,2,24,4,8,78,38,40,76
Stirling,5858,3,16,7,13,61,52,9,55
Stenhousem'r,5858,4,15,9,12,56,47,9,54
Clyde,5858,5,14,10,12,52,49,3,52
Elgin,5858,6,14,7,15,54,61,-7,49
Annan Athlet,5858,7,11,11,14,47,42,5,44
Berwick,5858,8,8,11,17,30,59,-29,35
Edinburgh Ci,5858,9,7,9,20,36,61,-25,30
Cowdenbeath,5858,10,5,10,21,24,54,-30,25
Montrose,5859,1,24,7,5,62,36,26,79
Peterhead,5859,2,23,4,9,77,39,38,73
Stirling,5859,3,16,7,13,61,52,9,55
Stenhousem'r,5859,4,15,9,12,56,47,9,54
Clyde,5859,5,15,9,12,53,48,5,54
Elgin,5859,6,14,6,16,55,63,-8,48
Annan Athlet,5859,7,12,11,13,48,41,7,47
Berwick,5859,8,8,10,18,29,60,-31,34
Edinburgh Ci,5859,9,8,9,19,37,60,-23,33
Cowdenbeath,5859,10,4,10,22,23,55,-32,22
Montrose,5860,1,24,7,5,64,37,27,79
Peterhead,5860,2,24,4,8,81,39,42,76
Stirling,5860,3,17,6,13,62,51,11,57
Clyde,5860,4,15,9,12,52,48,4,54
Stenhousem'r,5860,5,15,8,13,55,48,7,53
Elgin,5860,6,14,6,16,56,65,-9,48
Annan Athlet,5860,7,11,11,14,47,43,4,44
Berwick,5860,8,8,10,18,29,59,-30,34
Edinburgh Ci,5860,9,7,9,20,37,64,-27,30
Cowdenbeath,5860,10,5,10,21,25,54,-29,25
Montrose,5861,1,23,7,6,59,35,24,76
Peterhead,5861,2,23,4,9,77,39,38,73
Stirling,5861,3,17,6,13,65,52,13,57
Clyde,5861,4,15,9,12,54,50,4,54
Stenhousem'r,5861,5,15,8,13,56,51,5,53
Elgin,5861,6,15,6,15,54,60,-6,51
Annan Athlet,5861,7,12,11,13,48,41,7,47
Berwick,5861,8,8,10,18,31,61,-30,34
Edinburgh Ci,5861,9,8,9,19,37,60,-23,33
Cowdenbeath,5861,10,4,10,22,23,55,-32,22
Peterhead,5862,1,24,4,8,80,38,42,76
Montrose,5862,2,23,7,6,59,35,24,76
Stirling,5862,3,16,7,13,61,52,9,55
Stenhousem'r,5862,4,15,9,12,56,47,9,54
Clyde,5862,5,14,10,12,52,49,3,52
Elgin,5862,6,15,6,15,54,60,-6,51
Annan Athlet,5862,7,12,11,13,48,41,7,47
Berwick,5862,8,8,11,17,30,59,-29,35
Edinburgh Ci,5862,9,7,9,20,36,63,-27,30
Cowdenbeath,5862,10,4,10,22,23,55,-32,22
Peterhead,5863,1,24,4,8,79,39,40,76
Montrose,5863,2,23,7,6,60,36,24,76
Stirling,5863,3,17,6,13,61,51,10,57
Stenhousem'r,5863,4,15,8,13,55,47,8,53
Clyde,5863,5,14,10,12,52,49,3,52
Elgin,5863,6,15,6,15,55,61,-6,51
Annan Athlet,5863,7,11,11,14,47,42,5,44
Berwick,5863,8,8,11,17,30,59,-29,35
Edinburgh Ci,5863,9,7,9,20,37,62,-25,30
Cowdenbeath,5863,10,5,10,21,24,54,-30,25
Montrose,5864,1,24,7,5,62,36,26,79
Peterhead,5864,2,24,4,8,80,39,41,76
Stirling,5864,3,17,6,13,64,51,13,57
Clyde,5864,4,15,9,12,54,49,5,54
Stenhousem'r,5864,5,15,8,13,55,50,5,53
Elgin,5864,6,14,6,16,55,63,-8,48
Annan Athlet,5864,7,11,11,14,48,43,5,44
Berwick,5864,8,8,10,18,30,61,-31,34
Edinburgh Ci,5864,9,7,9,20,37,63,-26,30
Cowdenbeath,5864,10,5,10,21,25,55,-30,25
Montrose,5865,1,24,7,5,60,34,26,79
Peterhead,5865,2,24,4,8,80,38,42,76
Stirling,5865,3,16,7,13,61,52,9,55
Stenhousem'r,5865,4,15,9,12,56,47,9,54
Clyde,5865,5,14,9,13,52,50,2,51
Elgin,5865,6,14,6,16,53,61,-8,48
Annan Athlet,5865,7,11,12,13,47,41,6,45
Berwick,5865,8,9,10,17,31,59,-28,37
Edinburgh Ci,5865,9,7,9,20,36,63,-27,30
Cowdenbeath,5865,10,4,11,21,23,54,-31,23
Peterhead,5866,1,24,4,8,79,39,40,76
Montrose,5866,2,23,7,6,60,36,24,76
Stenhousem'r,5866,3,16,8,12,59,46,13,56
Stirling,5866,4,16,6,14,60,55,5,54
Clyde,5866,5,14,10,12,52,49,3,52
Elgin,5866,6,15,6,15,55,61,-6,51
Annan Athlet,5866,7,12,11,13,49,41,8,47
Berwick,5866,8,8,11,17,30,59,-29,35
Edinburgh Ci,5866,9,7,9,20,37,62,-25,30
Cowdenbeath,5866,10,4,10,22,23,56,-33,22
Montrose,5867,1,24,7,5,63,34,29,79
Peterhead,5867,2,24,4,8,79,38,41,76
Stenhousem'r,5867,3,16,8,12,56,46,10,56
Stirling,5867,4,16,6,14,60,52,8,54
Clyde,5867,5,15,9,12,53,48,5,54
Elgin,5867,6,14,6,16,53,64,-11,48
Annan Athlet,5867,7,11,12,13,48,42,6,45
Berwick,5867,8,8,10,18,29,60,-31,34
Edinburgh Ci,5867,9,7,9,20,36,62,-26,30
Cowdenbeath,5867,10,4,11,21,24,55,-31,23
Montrose,5868,1,24,7,5,63,35,28,79
Peterhead,5868,2,24,4,8,82,40,42,76
Stenhousem'r,5868,3,16,8,12,56,46,10,56
Stirling,5868,4,16,6,14,60,52,8,54
Clyde,5868,5,15,9,12,53,49,4,54
Elgin,5868,6,14,6,16,54,64,-10,48
Annan Athlet,5868,7,11,11,14,47,42,5,44
Berwick,5868,8,8,10,18,30,60,-30,34
Edinburgh Ci,5868,9,7,9,20,38,65,-27,30
Cowdenbeath,5868,10,5,10,21,24,54,-30,25
Montrose,5869,1,24,7,5,62,36,26,79
Peterhead,5869,2,24,4,8,80,38,42,76
Stenhousem'r,5869,3,16,8,12,59,46,13,56
Stirling,5869,4,16,6,14,60,55,5,54
Clyde,5869,5,14,10,12,53,50,3,52
Elgin,5869,6,14,6,16,55,63,-8,48
Annan Athlet,5869,7,11,12,13,48,42,6,45
Berwick,5869,8,8,11,17,31,60,-29,35
Edinburgh Ci,5869,9,7,9,20,36,63,-27,30
Cowdenbeath,5869,10,4,11,21,24,55,-31,23
Montrose,5870,1,24,7,5,61,34,27,79
Peterhead,5870,2,24,4,8,81,41,40,76
Stirling,5870,3,16,7,13,62,53,9,55
Stenhousem'r,5870,4,15,9,12,57,48,9,54
Clyde,5870,5,15,9,12,55,48,7,54
Elgin,5870,6,14,6,16,53,62,-9,48
Annan Athlet,5870,7,11,11,14,47,43,4,44
Berwick,5870,8,8,10,18,29,62,-33,34
Edinburgh Ci,5870,9,7,9,20,39,64,-25,30
Cowdenbeath,5870,10,5,10,21,25,54,-29,25
Montrose,5871,1,24,7,5,60,34,26,79
Peterhead,5871,2,24,4,8,81,39,42,76
Stirling,5871,3,16,7,13,62,53,9,55
Stenhousem'r,5871,4,15,9,12,57,48,9,54
Clyde,5871,5,15,9,12,53,48,5,54
Elgin,5871,6,14,6,16,53,61,-8,48
Annan Athlet,5871,7,11,12,13,48,42,6,45
Berwick,5871,8,8,10,18,29,60,-31,34
Edinburgh Ci,5871,9,7,9,20,37,64,-27,30
Cowdenbeath,5871,10,4,11,21,24,55,-31,23
Peterhead,5872,1,24,4,8,79,38,41,76
Montrose,5872,2,23,7,6,60,37,23,76
Stirling,5872,3,17,6,13,62,52,10,57
Clyde,5872,4,15,9,12,54,49,5,54
Stenhousem'r,5872,5,15,8,13,56,48,8,53
Elgin,5872,6,15,6,15,56,61,-5,51
Annan Athlet,5872,7,12,11,13,48,41,7,47
Berwick,5872,8,8,10,18,30,61,-31,34
Edinburgh Ci,5872,9,7,9,20,36,62,-26,30
Cowdenbeath,5872,10,4,10,22,23,55,-32,22
Montrose,5873,1,24,7,5,61,34,27,79
Peterhead,5873,2,23,4,9,80,42,38,73
Stenhousem'r,5873,3,16,8,12,58,48,10,56
Stirling,5873,4,16,6,14,62,54,8,54
Clyde,5873,5,15,9,12,53,49,4,54
Elgin,5873,6,14,6,16,53,62,-9,48
Annan Athlet,5873,7,12,11,13,49,41,8,47
Berwick,5873,8,8,10,18,30,60,-30,34
Edinburgh Ci,5873,9,8,9,19,40,63,-23,33
Cowdenbeath,5873,10,4,10,22,23,56,-33,22
Montrose,5874,1,24,7,5,60,34,26,79
Peterhead,5874,2,24,4,8,79,38,41,76
Stirling,5874,3,17,6,13,64,53,11,57
Clyde,5874,4,15,9,12,53,48,5,54
Stenhousem'r,5874,5,15,8,13,57,50,7,53
Elgin,5874,6,14,6,16,53,61,-8,48
Annan Athlet,5874,7,12,11,13,50,42,8,47
Berwick,5874,8,8,10,18,29,60,-31,34
Edinburgh Ci,5874,9,7,9,20,36,62,-26,30
Cowdenbeath,5874,10,4,10,22,24,57,-33,22
Montrose,5875,1,24,7,5,62,34,28,79
Peterhead,5875,2,24,4,8,80,38,42,76
Stenhousem'r,5875,3,16,8,12,59,46,13,56
Stirling,5875,4,16,6,14,60,55,5,54
Clyde,5875,5,15,9,12,52,48,4,54
Elgin,5875,6,14,6,16,53,63,-10,48
Annan Athlet,5875,7,11,12,13,47,41,6,45
Berwick,5875,8,8,10,18,29,59,-30,34
Edinburgh Ci,5875,9,7,9,20,36,63,-27,30
Cowdenbeath,5875,10,4,11,21,23,54,-31,23
Montrose,5876,1,24,7,5,61,35,26,79
Peterhead,5876,2,24,4,8,78,38,40,76
Stirling,5876,3,16,7,13,60,51,9,55
Stenhousem'r,5876,4,15,9,12,55,46,9,54
Clyde,5876,5,15,9,12,54,48,6,54
Elgin,5876,6,14,6,16,54,62,-8,48
Annan Athlet,5876,7,11,11,14,47,42,5,44
Berwick,5876,8,8,10,18,29,61,-32,34
Edinburgh Ci,5876,9,7,9,20,36,61,-25,30
Cowdenbeath,5876,10,5,10,21,24,54,-30,25
Montrose,5877,1,24,7,5,60,34,26,79
Peterhead,5877,2,23,5,8,78,39,39,74
Stirling,5877,3,16,7,13,61,52,9,55
Stenhousem'r,5877,4,15,9,12,56,47,9,54
Clyde,5877,5,15,9,12,52,48,4,54
Elgin,5877,6,14,6,16,53,61,-8,48
Annan Athlet,5877,7,12,11,13,48,41,7,47
Berwick,5877,8,8,10,18,29,59,-30,34
Edinburgh Ci,5877,9,7,10,19,37,61,-24,31
Cowdenbeath,5877,10,4,10,22,23,55,-32,22
Montrose,5878,1,24,7,5,61,34,27,79
Peterhead,5878,2,24,4,8,81,38,43,76
Stirling,5878,3,17,6,13,63,51,12,57
Stenhousem'r,5878,4,15,8,13,55,49,6,53
Clyde,5878,5,14,9,13,54,53,1,51
Elgin,5878,6,14,6,16,53,62,-9,48
Annan Athlet,5878,7,11,11,14,48,43,5,44
Berwick,5878,8,9,10,17,34,61,-27,37
Edinburgh Ci,5878,9,7,9,20,36,64,-28,30
Cowdenbeath,5878,10,5,10,21,25,55,-30,25
Montrose,5879,1,24,7,5,61,35,26,79
Peterhead,5879,2,24,4,8,79,38,41,76
Stirling,5879,3,17,6,13,61,51,10,57
Stenhousem'r,5879,4,15,8,13,55,47,8,53
Clyde,5879,5,14,9,13,52,50,2,51
Elgin,5879,6,14,6,16,54,62,-8,48
Annan Athlet,5879,7,11,11,14,47,42,5,44
Berwick,5879,8,9,10,17,31,59,-28,37
Edinburgh Ci,5879,9,7,9,20,36,62,-26,30
Cowdenbeath,5879,10,5,10,21,24,54,-30,25
Montrose,5880,1,24,7,5,64,35,29,79
Peterhead,5880,2,24,4,8,82,39,43,76
Stirling,5880,3,16,7,13,60,51,9,55
Stenhousem'r,5880,4,15,9,12,55,46,9,54
Clyde,5880,5,15,9,12,52,48,4,54
Elgin,5880,6,14,6,16,54,65,-11,48
Annan Athlet,5880,7,11,12,13,47,41,6,45
Berwick,5880,8,8,10,18,29,59,-30,34
Edinburgh Ci,5880,9,7,9,20,37,65,-28,30
Cowdenbeath,5880,10,4,11,21,23,54,-31,23
Montrose,5881,1,23,7,6,59,37,22,76
Peterhead,5881,2,23,5,8,80,41,39,74
Stenhousem'r,5881,3,16,8,12,58,47,11,56
Stirling,5881,4,16,6,14,61,54,7,54
Clyde,5881,5,15,9,12,53,49,4,54
Elgin,5881,6,15,6,15,56,60,-4,51
Annan Athlet,5881,7,11,11,14,47,42,5,44
Berwick,5881,8,8,10,18,30,60,-30,34
Edinburgh Ci,5881,9,7,10,19,39,63,-24,31
Cowdenbeath,5881,10,5,10,21,24,54,-30,25
Montrose,5882,1,23,7,6,61,37,24,76
Peterhead,5882,2,23,5,8,79,40,39,74
Stirling,5882,3,17,6,13,62,51,11,57
Clyde,5882,4,15,9,12,54,48,6,54
Stenhousem'r,5882,5,15,8,13,55,48,7,53
Elgin,5882,6,15,6,15,56,62,-6,51
Annan Athlet,5882,7,11,11,14,47,42,5,44
Berwick,5882,8,8,10,18,29,61,-32,34
Edinburgh Ci,5882,9,7,10,19,38,62,-24,31
Cowdenbeath,5882,10,5,10,21,24,54,-30,25
Peterhead,5883,1,24,4,8,80,39,41,76
Montrose,5883,2,23,7,6,59,35,24,76
Stirling,5883,3,17,6,13,65,52,13,57
Clyde,5883,4,15,9,12,55,48,7,54
Stenhousem'r,5883,5,15,8,13,56,51,5,53
Elgin,5883,6,15,6,15,54,60,-6,51
Annan Athlet,5883,7,11,12,13,48,42,6,45
Berwick,5883,8,8,10,18,29,62,-33,34
Edinburgh Ci,5883,9,7,9,20,37,63,-26,30
Cowdenbeath,5883,10,4,11,21,24,55,-31,23
Peterhead,5884,1,24,4,8,81,39,42,76
Montrose,5884,2,23,7,6,61,37,24,76
Stirling,5884,3,16,7,13,62,53,9,55
Stenhousem'r,5884,4,15,9,12,57,48,9,54
Clyde,5884,5,14,9,13,51,50,1,51
Elgin,5884,6,15,6,15,56,62,-6,51
Annan Athlet,5884,7,11,11,14,48,43,5,44
Berwick,5884,8,9,10,17,31,58,-27,37
Edinburgh Ci,5884,9,7,9,20,37,64,-27,30
Cowdenbeath,5884,10,5,10,21,25,55,-30,25
Montrose,5885,1,23,8,5,59,34,25,77
Peterhead,5885,2,23,5,8,79,40,39,74
Stirling,5885,3,17,6,13,64,54,10,57
Stenhousem'r,5885,4,15,8,13,58,50,8,53
Clyde,5885,5,14,9,13,52,50,2,51
Elgin,5885,6,14,7,15,53,60,-7,49
Annan Athlet,5885,7,12,11,13,52,41,11,47
Berwick,5885,8,9,10,17,31,59,-28,37
Edinburgh Ci,5885,9,7,10,19,38,62,-24,31
Cowdenbeath,5885,10,4,10,22,23,59,-36,22
Montrose,5886,1,24,7,5,63,35,28,79
Peterhead,5886,2,24,4,8,79,38,41,76
Stirling,5886,3,16,7,13,62,53,9,55
Stenhousem'r,5886,4,15,9,12,57,48,9,54
Clyde,5886,5,15,9,12,54,49,5,54
Elgin,5886,6,14,6,16,54,64,-10,48
Annan Athlet,5886,7,11,11,14,47,42,5,44
Berwick,5886,8,8,10,18,30,61,-31,34
Edinburgh Ci,5886,9,7,9,20,36,62,-26,30
Cowdenbeath,5886,10,5,10,21,24,54,-30,25
Montrose,5887,1,24,7,5,63,34,29,79
Peterhead,5887,2,24,4,8,82,39,43,76
Stirling,5887,3,16,7,13,61,52,9,55
Stenhousem'r,5887,4,15,9,12,56,47,9,54
Clyde,5887,5,14,9,13,51,49,2,51
Elgin,5887,6,14,6,16,53,64,-11,48
Annan Athlet,5887,7,12,11,13,50,41,9,47
Berwick,5887,8,9,10,17,30,58,-28,37
Edinburgh Ci,5887,9,7,9,20,37,65,-28,30
Cowdenbeath,5887,10,4,10,22,23,57,-34,22
Montrose,5888,1,24,7,5,62,34,28,79
Peterhead,5888,2,24,4,8,80,38,42,76
Stirling,5888,3,17,6,13,62,51,11,57
Clyde,5888,4,15,9,12,53,49,4,54
Stenhousem'r,5888,5,15,8,13,55,48,7,53
Elgin,5888,6,14,6,16,53,63,-10,48
Annan Athlet,5888,7,12,11,13,49,41,8,47
Berwick,5888,8,8,10,18,30,60,-30,34
Edinburgh Ci,5888,9,7,9,20,36,63,-27,30
Cowdenbeath,5888,10,4,10,22,23,56,-33,22
Montrose,5889,1,24,7,5,63,35,28,79
Peterhead,5889,2,23,5,8,78,39,39,74
Stenhousem'r,5889,3,16,8,12,59,46,13,56
Stirling,5889,4,16,6,14,60,55,5,54
Clyde,5889,5,15,9,12,53,48,5,54
Elgin,5889,6,14,6,16,54,64,-10,48
Annan Athlet,5889,7,11,12,13,47,41,6,45
Berwick,5889,8,8,10,18,29,60,-31,34
Edinburgh Ci,5889,9,7,10,19,37,61,-24,31
Cowdenbeath,5889,10,4,11,21,23,54,-31,23
Montrose,5890,1,24,7,5,64,35,29,79
Peterhead,5890,2,24,4,8,79,38,41,76
Stirling,5890,3,17,6,13,62,52,10,57
Clyde,5890,4,15,9,12,52,48,4,54
Stenhousem'r,5890,5,15,8,13,56,48,8,53
Elgin,5890,6,14,6,16,54,65,-11,48
Annan Athlet,5890,7,11,12,13,47,41,6,45
Berwick,5890,8,8,10,18,29,59,-30,34
Edinburgh Ci,5890,9,7,9,20,36,62,-26,30
Cowdenbeath,5890,10,4,11,21,23,54,-31,23
Montrose,5891,1,23,7,6,59,35,24,76
Peterhead,5891,2,23,5,8,80,41,39,74
Stirling,5891,3,17,6,13,63,51,12,57
Clyde,5891,4,15,9,12,55,48,7,54
Stenhousem'r,5891,5,15,8,13,55,49,6,53
Elgin,5891,6,15,6,15,54,60,-6,51
Annan Athlet,5891,7,12,11,13,50,43,7,47
Berwick,5891,8,8,10,18,29,62,-33,34
Edinburgh Ci,5891,9,7,10,19,39,63,-24,31
Cowdenbeath,5891,10,4,10,22,25,57,-32,22
Montrose,5892,1,24,7,5,61,34,27,79
Peterhead,5892,2,24,4,8,78,38,40,76
Stirling,5892,3,17,6,13,61,51,10,57
Clyde,5892,4,15,9,12,53,48,5,54
Stenhousem'r,5892,5,15,8,13,55,47,8,53
Elgin,5892,6,14,6,16,53,62,-9,48
Annan Athlet,5892,7,12,11,13,49,42,7,47
Berwick,5892,8,8,10,18,29,60,-31,34
Edinburgh Ci,5892,9,7,9,20,36,61,-25,30
Cowdenbeath,5892,10,4,10,22,24,56,-32,22
Montrose,5893,1,24,7,5,62,35,27,79
Peterhead,5893,2,24,4,8,79,38,41,76
Stirling,5893,3,17,6,13,65,53,12,57
Clyde,5893,4,15,9,12,53,48,5,54
Stenhousem'r,5893,5,15,8,13,57,51,6,53
Elgin,5893,6,14,6,16,54,63,-9,48
Annan Athlet,5893,7,12,11,13,49,42,7,47
Berwick,5893,8,8,10,18,29,60,-31,34
Edinburgh Ci,5893,9,7,9,20,36,62,-26,30
Cowdenbeath,5893,10,4,10,22,24,56,-32,22
Montrose,5894,1,24,7,5,61,34,27,79
Peterhead,5894,2,24,4,8,83,39,44,76
Stirling,5894,3,17,6,13,61,51,10,57
Clyde,5894,4,15,9,12,53,48,5,54
Stenhousem'r,5894,5,15,8,13,55,47,8,53
Elgin,5894,6,14,6,16,53,62,-9,48
Annan Athlet,5894,7,12,11,13,48,41,7,47
Berwick,5894,8,8,10,18,29,60,-31,34
Edinburgh Ci,5894,9,7,9,20,37,66,-29,30
Cowdenbeath,5894,10,4,10,22,23,55,-32,22
Montrose,5895,1,23,8,5,59,34,25,77
Peterhead,5895,2,23,4,9,78,40,38,73
Stirling,5895,3,16,7,13,63,54,9,55
Stenhousem'r,5895,4,15,9,12,58,49,9,54
Clyde,5895,5,15,9,12,54,49,5,54
Elgin,5895,6,14,7,15,53,60,-7,49
Annan Athlet,5895,7,12,11,13,49,41,8,47
Berwick,5895,8,8,10,18,30,61,-31,34
Edinburgh Ci,5895,9,8,9,19,38,61,-23,33
Cowdenbeath,5895,10,4,10,22,23,56,-33,22
Montrose,5896,1,24,7,5,63,35,28,79
Peterhead,5896,2,24,4,8,79,39,40,76
Stirling,5896,3,16,7,13,62,53,9,55
Stenhousem'r,5896,4,15,9,12,57,48,9,54
Clyde,5896,5,14,9,13,52,51,1,51
Elgin,5896,6,14,6,16,54,64,-10,48
Annan Athlet,5896,7,11,11,14,47,42,5,44
Berwick,5896,8,9,10,17,32,59,-27,37
Edinburgh Ci,5896,9,7,9,20,37,62,-25,30
Cowdenbeath,5896,10,5,10,21,24,54,-30,25
Montrose,5897,1,23,7,6,61,39,22,76
Peterhead,5897,2,23,4,9,78,40,38,73
Stirling,5897,3,17,6,13,63,53,10,57
Stenhousem'r,5897,4,15,8,13,57,49,8,53
Clyde,5897,5,14,9,13,52,50,2,51
Elgin,5897,6,15,6,15,58,62,-4,51
Annan Athlet,5897,7,11,11,14,47,42,5,44
Berwick,5897,8,9,10,17,31,59,-28,37
Edinburgh Ci,5897,9,8,9,19,38,61,-23,33
Cowdenbeath,5897,10,5,10,21,24,54,-30,25
Montrose,5898,1,23,8,5,61,36,25,77
Peterhead,5898,2,23,4,9,79,41,38,73
Stirling,5898,3,17,6,13,63,53,10,57
Clyde,5898,4,15,9,12,56,48,8,54
Stenhousem'r,5898,5,15,8,13,57,49,8,53
Elgin,5898,6,14,7,15,55,62,-7,49
Annan Athlet,5898,7,11,12,13,47,41,6,45
Berwick,5898,8,8,10,18,29,63,-34,34
Edinburgh Ci,5898,9,8,9,19,39,62,-23,33
Cowdenbeath,5898,10,4,11,21,23,54,-31,23
Montrose,5899,1,24,7,5,62,34,28,79
Peterhead,5899,2,24,4,8,80,39,41,76
Stirling,5899,3,17,6,13,64,52,12,57
Clyde,5899,4,15,9,12,52,48,4,54
Stenhousem'r,5899,5,15,8,13,56,50,6,53
Elgin,5899,6,14,6,16,53,63,-10,48
Annan Athlet,5899,7,12,11,13,48,41,7,47
Berwick,5899,8,8,10,18,29,59,-30,34
Edinburgh Ci,5899,9,7,9,20,37,63,-26,30
Cowdenbeath,5899,10,4,10,22,23,55,-32,22
Montrose,5900,1,24,7,5,61,35,26,79
Peterhead,5900,2,24,4,8,78,38,40,76
Stirling,5900,3,17,6,13,65,51,14,57
Clyde,5900,4,15,9,12,54,49,5,54
Stenhousem'r,5900,5,15,8,13,55,51,4,53
Elgin,5900,6,14,6,16,54,62,-8,48
Annan Athlet,5900,7,12,11,13,48,41,7,47
Berwick,5900,8,8,10,18,30,61,-31,34
Edinburgh Ci,5900,9,7,9,20,36,61,-25,30
Cowdenbeath,5900,10,4,10,22,23,55,-32,22
Peterhead,5901,1,24,4,8,81,39,42,76
Montrose,5901,2,23,7,6,61,37,24,76
Stirling,5901,3,17,6,13,61,51,10,57
Stenhousem'r,5901,4,15,8,13,55,47,8,53
Clyde,5901,5,14,10,12,53,50,3,52
Elgin,5901,6,15,6,15,56,62,-6,51
Annan Athlet,5901,7,12,11,13,48,41,7,47
Berwick,5901,8,8,11,17,31,60,-29,35
Edinburgh Ci,5901,9,7,9,20,37,64,-27,30
Cowdenbeath,5901,10,4,10,22,23,55,-32,22
Montrose,5902,1,24,7,5,64,36,28,79
Peterhead,5902,2,24,4,8,82,38,44,76
Stirling,5902,3,17,6,13,63,51,12,57
Clyde,5902,4,15,9,12,54,50,4,54
Stenhousem'r,5902,5,15,8,13,55,49,6,53
Elgin,5902,6,14,6,16,55,65,-10,48
Annan Athlet,5902,7,11,11,14,48,44,4,44
Berwick,5902,8,8,10,18,31,61,-30,34
Edinburgh Ci,5902,9,7,9,20,36,65,-29,30
Cowdenbeath,5902,10,5,10,21,26,55,-29,25
Montrose,5903,1,24,7,5,62,34,28,79
Peterhead,5903,2,24,4,8,83,39,44,76
Stenhousem'r,5903,3,16,8,12,58,48,10,56
Stirling,5903,4,16,6,14,62,54,8,54
Clyde,5903,5,15,9,12,54,50,4,54
Elgin,5903,6,14,6,16,53,63,-10,48
Annan Athlet,5903,7,12,11,13,49,42,7,47
Berwick,5903,8,8,10,18,31,61,-30,34
Edinburgh Ci,5903,9,7,9,20,37,66,-29,30
Cowdenbeath,5903,10,4,10,22,24,56,-32,22
Montrose,5904,1,24,7,5,62,35,27,79
Peterhead,5904,2,24,4,8,80,40,40,76
Stenhousem'r,5904,3,16,8,12,57,47,10,56
Stirling,5904,4,16,6,14,61,53,8,54
Clyde,5904,5,14,10,12,52,49,3,52
Elgin,5904,6,14,6,16,54,63,-9,48
Annan Athlet,5904,7,12,11,13,48,41,7,47
Berwick,5904,8,8,11,17,30,59,-29,35
Edinburgh Ci,5904,9,7,9,20,38,63,-25,30
Cowdenbeath,5904,10,4,10,22,23,55,-32,22
Montrose,5905,1,24,7,5,65,34,31,79
Peterhead,5905,2,24,4,8,82,40,42,76
Stenhousem'r,5905,3,16,8,12,58,47,11,56
Stirling,5905,4,16,6,14,61,54,7,54
Clyde,5905,5,15,9,12,55,49,6,54
Elgin,5905,6,14,6,16,53,66,-13,48
Annan Athlet,5905,7,12,11,13,49,41,8,47
Berwick,5905,8,8,10,18,30,62,-32,34
Edinburgh Ci,5905,9,7,9,20,38,65,-27,30
Cowdenbeath,5905,10,4,10,22,23,56,-33,22
Montrose,5906,1,24,7,5,61,34,27,79
Peterhead,5906,2,23,4,9,77,40,37,73
Stirling,5906,3,17,6,13,63,52,11,57
Clyde,5906,4,15,9,12,55,48,7,54
Stenhousem'r,5906,5,15,8,13,56,49,7,53
Elgin,5906,6,14,6,16,53,62,-9,48
Annan Athlet,5906,7,12,11,13,51,42,9,47
Berwick,5906,8,8,10,18,29,62,-33,34
Edinburgh Ci,5906,9,8,9,19,38,60,-22,33
Cowdenbeath,5906,10,4,10,22,24,58,-34,22
Montrose,5907,1,24,7,5,61,35,26,79
Peterhead,5907,2,23,5,8,79,40,39,74
Stenhousem'r,5907,3,16,8,12,56,46,10,56
Stirling,5907,4,16,6,14,60,52,8,54
Clyde,5907,5,15,9,12,54,50,4,54
Elgin,5907,6,14,6,16,54,62,-8,48
Annan Athlet,5907,7,12,11,13,48,41,7,47
Berwick,5907,8,8,10,18,31,61,-30,34
Edinburgh Ci,5907,9,7,10,19,38,62,-24,31
Cowdenbeath,5907,10,4,10,22,23,55,-32,22
Montrose,5908,1,24,7,5,60,34,26,79
Peterhead,5908,2,24,4,8,80,39,41,76
Stirling,5908,3,17,6,13,61,51,10,57
Clyde,5908,4,15,9,12,53,49,4,54
Stenhousem'r,5908,5,15,8,13,55,47,8,53
Elgin,5908,6,14,6,16,53,61,-8,48
Annan Athlet,5908,7,11,11,14,47,42,5,44
Berwick,5908,8,8,10,18,30,60,-30,34
Edinburgh Ci,5908,9,7,9,20,37,63,-26,30
Cowdenbeath,5908,10,5,10,21,24,54,-30,25
Peterhead,5909,1,24,4,8,81,39,42,76
Montrose,5909,2,23,7,6,60,36,24,76
Stirling,5909,3,17,6,13,62,52,10,57
Stenhousem'r,5909,4,15,8,13,56,48,8,53
Clyde,5909,5,14,9,13,52,50,2,51
Elgin,5909,6,15,6,15,55,61,-6,51
Annan Athlet,5909,7,11,11,14,47,43,4,44
Berwick,5909,8,9,10,17,31,59,-28,37
Edinburgh Ci,5909,9,7,9,20,37,64,-27,30
Cowdenbeath,5909,10,5,10,21,25,54,-29,25
Montrose,5910,1,24,7,5,63,34,29,79
Peterhead,5910,2,24,4,8,82,42,40,76
Stirling,5910,3,16,7,13,61,52,9,55
Stenhousem'r,5910,4,15,9,12,56,47,9,54
Clyde,5910,5,14,9,13,51,51,0,51
Elgin,5910,6,14,6,16,53,64,-11,48
Annan Athlet,5910,7,11,11,14,47,42,5,44
Berwick,5910,8,9,10,17,32,58,-26,37
Edinburgh Ci,5910,9,7,9,20,40,65,-25,30
Cowdenbeath,5910,10,5,10,21,24,54,-30,25
Montrose,5911,1,24,7,5,62,36,26,79
Peterhead,5911,2,24,4,8,83,40,43,76
Stirling,5911,3,16,7,13,62,53,9,55
Stenhousem'r,5911,4,15,9,12,57,48,9,54
Clyde,5911,5,15,9,12,53,49,4,54
Elgin,5911,6,14,6,16,55,63,-8,48
Annan Athlet,5911,7,11,11,14,48,44,4,44
Berwick,5911,8,8,10,18,30,60,-30,34
Edinburgh Ci,5911,9,7,9,20,38,66,-28,30
Cowdenbeath,5911,10,5,10,21,26,55,-29,25
Montrose,5912,1,24,7,5,63,34,29,79
Peterhead,5912,2,23,4,9,77,39,38,73
Stirling,5912,3,17,6,13,61,51,10,57
Stenhousem'r,5912,4,15,8,13,55,47,8,53
Clyde,5912,5,14,10,12,51,48,3,52
Elgin,5912,6,14,6,16,53,64,-11,48
Annan Athlet,5912,7,11,11,14,47,43,4,44
Berwick,5912,8,8,11,17,29,58,-29,35
Edinburgh Ci,5912,9,8,9,19,37,60,-23,33
Cowdenbeath,5912,10,5,10,21,25,54,-29,25
Montrose,5913,1,24,7,5,63,34,29,79
Peterhead,5913,2,24,4,8,78,38,40,76
Stirling,5913,3,16,7,13,60,51,9,55
Stenhousem'r,5913,4,15,9,12,55,46,9,54
Clyde,5913,5,15,9,12,54,49,5,54
Elgin,5913,6,14,6,16,53,64,-11,48
Annan Athlet,5913,7,11,11,14,47,42,5,44
Berwick,5913,8,8,10,18,30,61,-31,34
Edinburgh Ci,5913,9,7,9,20,36,61,-25,30
Cowdenbeath,5913,10,5,10,21,24,54,-30,25
Montrose,5914,1,24,7,5,60,34,26,79
Peterhead,5914,2,23,5,8,79,40,39,74
Stirling,5914,3,17,6,13,65,54,11,57
Clyde,5914,4,15,9,12,52,48,4,54
Stenhousem'r,5914,5,15,8,13,58,51,7,53
Elgin,5914,6,14,6,16,53,61,-8,48
Annan Athlet,5914,7,11,11,14,47,42,5,44
Berwick,5914,8,8,10,18,29,59,-30,34
Edinburgh Ci,5914,9,7,10,19,38,62,-24,31
Cowdenbeath,5914,10,5,10,21,24,54,-30,25
Montrose,5915,1,24,7,5,62,36,26,79
Peterhead,5915,2,24,4,8,80,38,42,76
Stirling,5915,3,17,6,13,61,51,10,57
Clyde,5915,4,15,9,12,53,49,4,54
Stenhousem'r,5915,5,15,8,13,55,47,8,53
Elgin,5915,6,14,6,16,55,63,-8,48
Annan Athlet,5915,7,11,12,13,48,42,6,45
Berwick,5915,8,8,10,18,30,60,-30,34
Edinburgh Ci,5915,9,7,9,20,36,63,-27,30
Cowdenbeath,5915,10,4,11,21,24,55,-31,23
Montrose,5916,1,24,7,5,62,34,28,79
Peterhead,5916,2,24,4,8,80,39,41,76
Stenhousem'r,5916,3,16,8,12,59,48,11,56
Stirling,5916,4,16,6,14,62,55,7,54
Clyde,5916,5,15,9,12,53,48,5,54
Elgin,5916,6,14,6,16,53,63,-10,48
Annan Athlet,5916,7,11,12,13,47,41,6,45
Berwick,5916,8,8,10,18,29,60,-31,34
Edinburgh Ci,5916,9,7,9,20,37,63,-26,30
Cowdenbeath,5916,10,4,11,21,23,54,-31,23
Montrose,5917,1,24,7,5,62,34,28,79
Peterhead,5917,2,23,5,8,78,39,39,74
Stirling,5917,3,17,6,13,62,51,11,57
Clyde,5917,4,15,9,12,53,49,4,54
Stenhousem'r,5917,5,15,8,13,55,48,7,53
Elgin,5917,6,14,6,16,53,63,-10,48
Annan Athlet,5917,7,12,11,13,48,41,7,47
Berwick,5917,8,8,10,18,30,60,-30,34
Edinburgh Ci,5917,9,7,10,19,37,61,-24,31
Cowdenbeath,5917,10,4,10,22,23,55,-32,22
Montrose,5918,1,24,7,5,61,35,26,79
Peterhead,5918,2,24,4,8,78,38,40,76
Stenhousem'r,5918,3,16,8,12,58,48,10,56
Stirling,5918,4,16,6,14,62,54,8,54
Clyde,5918,5,15,9,12,53,48,5,54
Elgin,5918,6,14,6,16,54,62,-8,48
Annan Athlet,5918,7,11,12,13,48,42,6,45
Berwick,5918,8,8,10,18,29,60,-31,34
Edinburgh Ci,5918,9,7,9,20,36,61,-25,30
Cowdenbeath,5918,10,4,11,21,24,55,-31,23
Montrose,5919,1,23,7,6,59,35,24,76
Peterhead,5919,2,23,5,8,78,39,39,74
Stirling,5919,3,17,6,13,61,51,10,57
Stenhousem'r,5919,4,15,8,13,55,47,8,53
Clyde,5919,5,14,10,12,52,49,3,52
Elgin,5919,6,15,6,15,54,60,-6,51
Annan Athlet,5919,7,11,12,13,47,41,6,45
Berwick,5919,8,8,11,17,30,59,-29,35
Edinburgh Ci,5919,9,7,10,19,37,61,-24,31
Cowdenbeath,5919,10,4,11,21,23,54,-31,23
Montrose,5920,1,23,8,5,60,35,25,77
Peterhead,5920,2,24,4,8,81,38,43,76
Stirling,5920,3,17,6,13,62,51,11,57
Stenhousem'r,5920,4,15,8,13,55,48,7,53
Clyde,5920,5,14,10,12,52,49,3,52
Elgin,5920,6,14,7,15,54,61,-7,49
Annan Athlet,5920,7,11,11,14,47,43,4,44
Berwick,5920,8,8,11,17,30,59,-29,35
Edinburgh Ci,5920,9,7,9,20,36,64,-28,30
Cowdenbeath,5920,10,5,10,21,25,54,-29,25
Montrose,5921,1,23,8,5,60,35,25,77
Peterhead,5921,2,24,4,8,81,40,41,76
Stenhousem'r,5921,3,16,8,12,56,46,10,56
Stirling,5921,4,16,6,14,60,52,8,54
Clyde,5921,5,15,9,12,53,49,4,54
Elgin,5921,6,14,7,15,54,61,-7,49
Annan Athlet,5921,7,11,11,14,47,42,5,44
Berwick,5921,8,8,10,18,30,60,-30,34
Edinburgh Ci,5921,9,7,9,20,38,64,-26,30
Cowdenbeath,5921,10,5,10,21,24,54,-30,25
Montrose,5922,1,24,7,5,62,36,26,79
Peterhead,5922,2,24,4,8,79,39,40,76
Stirling,5922,3,17,6,13,62,52,10,57
Clyde,5922,4,15,9,12,54,48,6,54
Stenhousem'r,5922,5,15,8,13,56,48,8,53
Elgin,5922,6,14,6,16,55,63,-8,48
Annan Athlet,5922,7,12,11,13,49,41,8,47
Berwick,5922,8,8,10,18,29,61,-32,34
Edinburgh Ci,5922,9,7,9,20,37,62,-25,30
Cowdenbeath,5922,10,4,10,22,23,56,-33,22
Montrose,5923,1,24,7,5,62,35,27,79
Peterhead,5923,2,23,4,9,78,41,37,73
Stirling,5923,3,17,6,13,63,51,12,57
Clyde,5923,4,15,9,12,54,50,4,54
Stenhousem'r,5923,5,15,8,13,55,49,6,53
Elgin,5923,6,14,6,16,54,63,-9,48
Annan Athlet,5923,7,12,11,13,50,41,9,47
Berwick,5923,8,8,10,18,31,61,-30,34
Edinburgh Ci,5923,9,8,9,19,39,61,-22,33
Cowdenbeath,5923,10,4,10,22,23,57,-34,22
Montrose,5924,1,23,8,5,61,36,25,77
Peterhead,5924,2,23,4,9,78,40,38,73
Stirling,5924,3,17,6,13,62,52,10,57
Clyde,5924,4,15,9,12,53,49,4,54
Stenhousem'r,5924,5,15,8,13,56,48,8,53
Elgin,5924,6,14,7,15,55,62,-7,49
Annan Athlet,5924,7,11,11,14,47,42,5,44
Berwick,5924,8,8,10,18,30,60,-30,34
Edinburgh Ci,5924,9,8,9,19,38,61,-23,33
Cowdenbeath,5924,10,5,10,21,24,54,-30,25
Montrose,5925,1,24,7,5,60,34,26,79
Peterhead,5925,2,24,4,8,81,40,41,76
Stirling,5925,3,16,7,13,62,53,9,55
Stenhousem'r,5925,4,15,9,12,57,48,9,54
Clyde,5925,5,15,9,12,52,48,4,54
Elgin,5925,6,14,6,16,53,61,-8,48
Annan Athlet,5925,7,12,11,13,50,41,9,47
Berwick,5925,8,8,10,18,29,59,-30,34
Edinburgh Ci,5925,9,7,9,20,38,64,-26,30
Cowdenbeath,5925,10,4,10,22,23,57,-34,22
Montrose,5926,1,23,8,5,61,36,25,77
Peterhead,5926,2,23,4,9,77,39,38,73
Stenhousem'r,5926,3,16,8,12,57,47,10,56
Stirling,5926,4,16,6,14,61,53,8,54
Clyde,5926,5,14,10,12,51,48,3,52
Elgin,5926,6,14,7,15,55,62,-7,49
Annan Athlet,5926,7,11,11,14,47,43,4,44
Berwick,5926,8,8,11,17,29,58,-29,35
Edinburgh Ci,5926,9,8,9,19,37,60,-23,33
Cowdenbeath,5926,10,5,10,21,25,54,-29,25
Montrose,5927,1,23,8,5,60,35,25,77
Peterhead,5927,2,23,4,9,77,39,38,73
Stirling,5927,3,17,6,13,62,51,11,57
Clyde,5927,4,15,9,12,53,48,5,54
Stenhousem'r,5927,5,15,8,13,55,48,7,53
Elgin,5927,6,14,7,15,54,61,-7,49
Annan Athlet,5927,7,11,11,14,48,43,5,44
Berwick,5927,8,8,10,18,29,60,-31,34
Edinburgh Ci,5927,9,8,9,19,37,60,-23,33
Cowdenbeath,5927,10,5,10,21,25,55,-30,25
Montrose,5928,1,24,7,5,60,34,26,79
Peterhead,5928,2,24,4,8,80,39,41,76
Stirling,5928,3,17,6,13,64,52,12,57
Stenhousem'r,5928,4,15,8,13,56,50,6,53
Clyde,5928,5,14,10,12,51,48,3,52
Elgin,5928,6,14,6,16,53,61,-8,48
Annan Athlet,5928,7,11,11,14,47,42,5,44
Berwick,5928,8,8,11,17,29,58,-29,35
Edinburgh Ci,5928,9,7,9,20,37,63,-26,30
Cowdenbeath,5928,10,5,10,21,24,54,-30,25
Peterhead,5929,1,24,4,8,81,39,42,76
Montrose,5929,2,23,7,6,60,36,24,76
Stirling,5929,3,16,7,13,62,53,9,55
Stenhousem'r,5929,4,15,9,12,57,48,9,54
Clyde,5929,5,15,9,12,52,48,4,54
Elgin,5929,6,15,6,15,55,61,-6,51
Annan Athlet,5929,7,12,11,13,49,41,8,47
Berwick,5929,8,8,10,18,29,59,-30,34
Edinburgh Ci,5929,9,7,9,20,37,64,-27,30
Cowdenbeath,5929,10,4,10,22,23,56,-33,22
Montrose,5930,1,24,7,5,60,34,26,79
Peterhead,5930,2,24,4,8,79,38,41,76
Stirling,5930,3,16,7,13,61,52,9,55
Stenhousem'r,5930,4,15,9,12,56,47,9,54
Clyde,5930,5,15,9,12,53,48,5,54
Elgin,5930,6,14,6,16,53,61,-8,48
Annan Athlet,5930,7,11,12,13,47,41,6,45
Berwick,5930,8,8,10,18,29,60,-31,34
Edinburgh Ci,5930,9,7,9,20,36,62,-26,30
Cowdenbeath,5930,10,4,11,21,23,54,-31,23
Montrose,5931,1,24,7,5,61,35,26,79
Peterhead,5931,2,24,4,8,79,39,40,76
Stirling,5931,3,16,7,13,61,52,9,55
Stenhousem'r,5931,4,15,9,12,56,47,9,54
Clyde,5931,5,15,9,12,54,48,6,54
Elgin,5931,6,14,6,16,54,62,-8,48
Annan Athlet,5931,7,12,11,13,49,42,7,47
Berwick,5931,8,8,10,18,29,61,-32,34
Edinburgh Ci,5931,9,7,9,20,37,62,-25,30
Cowdenbeath,5931,10,4,10,22,24,56,-32,22
Montrose,5932,1,23,7,6,59,37,22,76
Peterhead,5932,2,23,5,8,78,39,39,74
Stenhousem'r,5932,3,16,8,12,57,47,10,56
Stirling,5932,4,16,6,14,61,53,8,54
Clyde,5932,5,14,10,12,53,50,3,52
Elgin,5932,6,15,6,15,56,60,-4,51
Annan Athlet,5932,7,12,11,13,48,41,7,47
Berwick,5932,8,8,11,17,31,60,-29,35
Edinburgh Ci,5932,9,7,10,19,37,61,-24,31
Cowdenbeath,5932,10,4,10,22,23,55,-32,22
Montrose,5933,1,23,8,5,61,36,25,77
Peterhead,5933,2,24,4,8,85,38,47,76
Stirling,5933,3,17,6,13,62,52,10,57
Stenhousem'r,5933,4,15,8,13,56,48,8,53
Clyde,5933,5,14,10,12,52,49,3,52
Elgin,5933,6,14,7,15,55,62,-7,49
Annan Athlet,5933,7,12,11,13,49,41,8,47
Berwick,5933,8,8,11,17,30,59,-29,35
Edinburgh Ci,5933,9,7,9,20,36,68,-32,30
Cowdenbeath,5933,10,4,10,22,23,56,-33,22
Peterhead,5934,1,24,4,8,80,39,41,76
Montrose,5934,2,23,7,6,59,35,24,76
Stenhousem'r,5934,3,16,8,12,57,46,11,56
Stirling,5934,4,16,6,14,60,53,7,54
Clyde,5934,5,15,9,12,53,48,5,54
Elgin,5934,6,15,6,15,54,60,-6,51
Annan Athlet,5934,7,12,11,13,49,42,7,47
Berwick,5934,8,8,10,18,29,60,-31,34
Edinburgh Ci,5934,9,7,9,20,37,63,-26,30
Cowdenbeath,5934,10,4,10,22,24,56,-32,22
Montrose,5935,1,24,7,5,61,34,27,79
Peterhead,5935,2,24,4,8,82,39,43,76
Stirling,5935,3,17,6,13,65,55,10,57
Clyde,5935,4,15,9,12,53,48,5,54
Stenhousem'r,5935,5,15,8,13,59,51,8,53
Elgin,5935,6,14,6,16,53,62,-9,48
Annan Athlet,5935,7,12,11,13,51,42,9,47
Berwick,5935,8,8,10,18,29,60,-31,34
Edinburgh Ci,5935,9,7,9,20,37,65,-28,30
Cowdenbeath,5935,10,4,10,22,24,58,-34,22
Montrose,5936,1,24,7,5,62,35,27,79
Peterhead,5936,2,23,5,8,78,39,39,74
Stenhousem'r,5936,3,16,8,12,58,48,10,56
Stirling,5936,4,16,6,14,62,54,8,54
Clyde,5936,5,15,9,12,53,49,4,54
Elgin,5936,6,14,6,16,54,63,-9,48
Annan Athlet,5936,7,12,11,13,48,41,7,47
Berwick,5936,8,8,10,18,30,60,-30,34
Edinburgh Ci,5936,9,7,10,19,37,61,-24,31
Cowdenbeath,5936,10,4,10,22,23,55,-32,22
Montrose,5937,1,24,7,5,62,34,28,79
Peterhead,5937,2,23,4,9,78,40,38,73
Stirling,5937,3,17,6,13,62,52,10,57
Stenhousem'r,5937,4,15,8,13,56,48,8,53
Clyde,5937,5,14,9,13,52,50,2,51
Elgin,5937,6,14,6,16,53,63,-10,48
Annan Athlet,5937,7,11,11,14,47,43,4,44
Berwick,5937,8,9,10,17,31,59,-28,37
Edinburgh Ci,5937,9,8,9,19,38,61,-23,33
Cowdenbeath,5937,10,5,10,21,25,54,-29,25
Montrose,5938,1,24,7,5,62,34,28,79
Peterhead,5938,2,24,4,8,80,40,40,76
Stenhousem'r,5938,3,16,8,12,57,47,10,56
Stirling,5938,4,16,6,14,61,53,8,54
Clyde,5938,5,14,10,12,51,48,3,52
Elgin,5938,6,14,6,16,53,63,-10,48
Annan Athlet,5938,7,12,11,13,49,41,8,47
Berwick,5938,8,8,11,17,29,58,-29,35
Edinburgh Ci,5938,9,7,9,20,38,63,-25,30
Cowdenbeath,5938,10,4,10,22,23,56,-33,22
Montrose,5939,1,24,7,5,61,34,27,79
Peterhead,5939,2,23,4,9,77,40,37,73
Stenhousem'r,5939,3,16,8,12,58,46,12,56
Stirling,5939,4,16,6,14,60,54,6,54
Clyde,5939,5,15,9,12,53,49,4,54
Elgin,5939,6,14,6,16,53,62,-9,48
Annan Athlet,5939,7,11,11,14,48,43,5,44
Berwick,5939,8,8,10,18,30,60,-30,34
Edinburgh Ci,5939,9,8,9,19,38,60,-22,33
Cowdenbeath,5939,10,5,10,21,25,55,-30,25
Montrose,5940,1,23,8,5,60,35,25,77
Peterhead,5940,2,24,4,8,78,38,40,76
Stirling,5940,3,16,7,13,61,52,9,55
Stenhousem'r,5940,4,15,9,12,56,47,9,54
Clyde,5940,5,15,9,12,55,49,6,54
Elgin,5940,6,14,7,15,54,61,-7,49
Annan Athlet,5940,7,11,11,14,47,44,3,44
Berwick,5940,8,8,10,18,30,62,-32,34
Edinburgh Ci,5940,9,7,9,20,36,61,-25,30
Cowdenbeath,5940,10,5,10,21,26,54,-28,25
Montrose,5941,1,24,7,5,60,34,26,79
Peterhead,5941,2,24,4,8,80,38,42,76
Stirling,5941,3,17,6,13,62,51,11,57
Stenhousem'r,5941,4,15,8,13,55,48,7,53
Clyde,5941,5,14,10,12,52,49,3,52
Elgin,5941,6,14,6,16,53,61,-8,48
Annan Athlet,5941,7,11,12,13,48,42,6,45
Berwick,5941,8,8,11,17,30,59,-29,35
Edinburgh Ci,5941,9,7,9,20,36,63,-27,30
Cowdenbeath,5941,10,4,11,21,24,55,-31,23
Montrose,5942,1,24,7,5,61,35,26,79
Peterhead,5942,2,24,4,8,81,38,43,76
Stenhousem'r,5942,3,16,8,12,58,46,12,56
Stirling,5942,4,16,6,14,60,54,6,54
Clyde,5942,5,15,9,12,52,48,4,54
Elgin,5942,6,14,6,16,54,62,-8,48
Annan Athlet,5942,7,12,11,13,49,41,8,47
Berwick,5942,8,8,10,18,29,59,-30,34
Edinburgh Ci,5942,9,7,9,20,36,64,-28,30
Cowdenbeath,5942,10,4,10,22,23,56,-33,22
Montrose,5943,1,23,8,5,59,34,25,77
Peterhead,5943,2,24,4,8,82,39,43,76
Stenhousem'r,5943,3,16,8,12,56,46,10,56
Stirling,5943,4,16,6,14,60,52,8,54
Clyde,5943,5,15,9,12,53,49,4,54
Elgin,5943,6,14,7,15,53,60,-7,49
Annan Athlet,5943,7,11,11,14,47,42,5,44
Berwick,5943,8,8,10,18,30,60,-30,34
Edinburgh Ci,5943,9,7,9,20,37,65,-28,30
Cowdenbeath,5943,10,5,10,21,24,54,-30,25
Montrose,5944,1,24,7,5,60,34,26,79
Peterhead,5944,2,24,4,8,81,38,43,76
Stirling,5944,3,16,7,13,61,52,9,55
Stenhousem'r,5944,4,15,9,12,56,47,9,54
Clyde,5944,5,15,9,12,52,48,4,54
Elgin,5944,6,14,6,16,53,61,-8,48
Annan Athlet,5944,7,11,11,14,48,43,5,44
Berwick,5944,8,8,10,18,29,59,-30,34
Edinburgh Ci,5944,9,7,9,20,36,64,-28,30
Cowdenbeath,5944,10,5,10,21,25,55,-30,25
Peterhead,5945,1,24,4,8,83,39,44,76
Montrose,5945,2,23,7,6,59,35,24,76
Stirling,5945,3,17,6,13,62,51,11,57
Stenhousem'r,5945,4,15,8,13,55,48,7,53
Clyde,5945,5,14,10,12,52,49,3,52
Elgin,5945,6,15,6,15,54,60,-6,51
Annan Athlet,5945,7,12,11,13,48,41,7,47
Berwick,5945,8,8,11,17,30,59,-29,35
Edinburgh Ci,5945,9,7,9,20,37,66,-29,30
Cowdenbeath,5945,10,4,10,22,23,55,-32,22
Montrose,5946,1,24,7,5,61,35,26,79
Peterhead,5946,2,24,4,8,80,38,42,76
Stenhousem'r,5946,3,16,8,12,58,48,10,56
Stirling,5946,4,16,6,14,62,54,8,54
Clyde,5946,5,15,9,12,54,49,5,54
Elgin,5946,6,14,6,16,54,62,-8,48
Annan Athlet,5946,7,11,11,14,49,45,4,44
Berwick,5946,8,8,10,18,30,61,-31,34
Edinburgh Ci,5946,9,7,9,20,36,63,-27,30
Cowdenbeath,5946,10,5,10,21,27,56,-29,25
Montrose,5947,1,24,7,5,60,34,26,79
Peterhead,5947,2,23,5,8,78,39,39,74
Stirling,5947,3,17,6,13,62,52,10,57
Clyde,5947,4,15,9,12,53,48,5,54
Stenhousem'r,5947,5,15,8,13,56,48,8,53
Elgin,5947,6,14,6,16,53,61,-8,48
Annan Athlet,5947,7,11,11,14,47,42,5,44
Berwick,5947,8,8,10,18,29,60,-31,34
Edinburgh Ci,5947,9,7,10,19,37,61,-24,31
Cowdenbeath,5947,10,5,10,21,24,54,-30,25
Peterhead,5948,1,24,4,8,79,38,41,76
Montrose,5948,2,23,7,6,60,37,23,76
Stenhousem'r,5948,3,16,8,12,57,46,11,56
Stirling,5948,4,16,6,14,60,53,7,54
Clyde,5948,5,15,9,12,54,48,6,54
Elgin,5948,6,15,6,15,56,61,-5,51
Annan Athlet,5948,7,12,11,13,49,41,8,47
Berwick,5948,8,8,10,18,29,61,-32,34
Edinburgh Ci,5948,9,7,9,20,36,62,-26,30
Cowdenbeath,5948,10,4,10,22,23,56,-33,22
Montrose,5949,1,24,7,5,61,35,26,79
Peterhead,5949,2,23,5,8,77,38,39,74
Stirling,5949,3,17,6,13,63,51,12,57
Stenhousem'r,5949,4,15,8,13,55,49,6,53
Clyde,5949,5,14,9,13,53,52,1,51
Elgin,5949,6,14,6,16,54,62,-8,48
Annan Athlet,5949,7,11,12,13,48,42,6,45
Berwick,5949,8,9,10,17,33,60,-27,37
Edinburgh Ci,5949,9,7,10,19,36,60,-24,31
Cowdenbeath,5949,10,4,11,21,24,55,-31,23
Montrose,5950,1,24,7,5,62,36,26,79
Peterhead,5950,2,24,4,8,79,39,40,76
Stenhousem'r,5950,3,16,8,12,58,46,12,56
Stirling,5950,4,16,6,14,60,54,6,54
Clyde,5950,5,14,10,12,54,51,3,52
Elgin,5950,6,14,6,16,55,63,-8,48
Annan Athlet,5950,7,11,12,13,48,42,6,45
Berwick,5950,8,8,11,17,32,61,-29,35
Edinburgh Ci,5950,9,7,9,20,37,62,-25,30
Cowdenbeath,5950,10,4,11,21,24,55,-31,23
Montrose,5951,1,23,8,5,60,35,25,77
Peterhead,5951,2,24,4,8,79,38,41,76
Stirling,5951,3,17,6,13,63,52,11,57
Clyde,5951,4,15,9,12,54,49,5,54
Stenhousem'r,5951,5,15,8,13,56,49,7,53
Elgin,5951,6,14,7,15,54,61,-7,49
Annan Athlet,5951,7,11,11,14,48,43,5,44
Berwick,5951,8,8,10,18,30,61,-31,34
Edinburgh Ci,5951,9,7,9,20,36,62,-26,30
Cowdenbeath,5951,10,5,10,21,25,55,-30,25
Montrose,5952,1,24,7,5,61,34,27,79
Peterhead,5952,2,24,4,8,79,39,40,76
Stirling,5952,3,17,6,13,61,51,10,57
Stenhousem'r,5952,4,15,8,13,55,47,8,53
Clyde,5952,5,14,9,13,51,49,2,51
Elgin,5952,6,14,6,16,53,62,-9,48
Annan Athlet,5952,7,11,12,13,48,42,6,45
Berwick,5952,8,9,10,17,30,58,-28,37
Edinburgh Ci,5952,9,7,9,20,37,62,-25,30
Cowdenbeath,5952,10,4,11,21,24,55,-31,23
Montrose,5953,1,24,7,5,63,36,27,79
Peterhead,5953,2,24,4,8,80,38,42,76
Stenhousem'r,5953,3,16,8,12,58,46,12,56
Stirling,5953,4,16,6,14,60,54,6,54
Clyde,5953,5,15,9,12,53,48,5,54
Elgin,5953,6,14,6,16,55,64,-9,48
Annan Athlet,5953,7,11,12,13,47,41,6,45
Berwick,5953,8,8,10,18,29,60,-31,34
Edinburgh Ci,5953,9,7,9,20,36,63,-27,30
Cowdenbeath,5953,10,4,11,21,23,54,-31,23
Montrose,5954,1,24,7,5,62,35,27,79
Peterhead,5954,2,23,5,8,79,40,39,74
Stirling,5954,3,16,7,13,61,52,9,55
Stenhousem'r,5954,4,15,9,12,56,47,9,54
Clyde,5954,5,15,9,12,54,48,6,54
Elgin,5954,6,14,6,16,54,63,-9,48
Annan Athlet,5954,7,12,11,13,49,41,8,47
Berwick,5954,8,8,10,18,29,61,-32,34
Edinburgh Ci,5954,9,7,10,19,38,62,-24,31
Cowdenbeath,5954,10,4,10,22,23,56,-33,22
Montrose,5955,1,24,7,5,63,36,27,79
Peterhead,5955,2,24,4,8,81,38,43,76
Stirling,5955,3,16,7,13,60,51,9,55
Stenhousem'r,5955,4,15,9,12,55,46,9,54
Clyde,5955,5,15,9,12,53,49,4,54
Elgin,5955,6,14,6,16,55,64,-9,48
Annan Athlet,5955,7,12,11,13,48,41,7,47
Berwick,5955,8,8,10,18,30,60,-30,34
Edinburgh Ci,5955,9,7,9,20,36,64,-28,30
Cowdenbeath,5955,10,4,10,22,23,55,-32,22
Montrose,5956,1,24,7,5,63,35,28,79
Peterhead,5956,2,24,4,8,80,39,41,76
Stirling,5956,3,17,6,13,61,51,10,57
Clyde,5956,4,15,9,12,53,48,5,54
Stenhousem'r,5956,5,15,8,13,55,47,8,53
Elgin,5956,6,14,6,16,54,64,-10,48
Annan Athlet,5956,7,12,11,13,48,41,7,47
Berwick,5956,8,8,10,18,29,60,-31,34
Edinburgh Ci,5956,9,7,9,20,37,63,-26,30
Cowdenbeath,5956,10,4,10,22,23,55,-32,22
Montrose,5957,1,24,7,5,61,35,26,79
Peterhead,5957,2,24,4,8,80,40,40,76
Stirling,5957,3,17,6,13,65,53,12,57
Clyde,5957,4,15,9,12,53,49,4,54
Stenhousem'r,5957,5,15,8,13,57,51,6,53
Elgin,5957,6,14,6,16,54,62,-8,48
Annan Athlet,5957,7,11,11,14,47,43,4,44
Berwick,5957,8,8,10,18,30,60,-30,34
Edinburgh Ci,5957,9,7,9,20,38,63,-25,30
Cowdenbeath,5957,10,5,10,21,25,54,-29,25
Montrose,5958,1,24,7,5,61,34,27,79
Peterhead,5958,2,24,4,8,80,39,41,76
Stirling,5958,3,17,6,13,64,52,12,57
Clyde,5958,4,15,9,12,52,48,4,54
Stenhousem'r,5958,5,15,8,13,56,50,6,53
Elgin,5958,6,14,6,16,53,62,-9,48
Annan Athlet,5958,7,12,11,13,49,42,7,47
Berwick,5958,8,8,10,18,29,59,-30,34
Edinburgh Ci,5958,9,7,9,20,37,63,-26,30
Cowdenbeath,5958,10,4,10,22,24,56,-32,22
Montrose,5959,1,24,7,5,60,34,26,79
Peterhead,5959,2,24,4,8,80,39,41,76
Stirling,5959,3,17,6,13,62,51,11,57
Clyde,5959,4,15,9,12,54,50,4,54
Stenhousem'r,5959,5,15,8,13,55,48,7,53
Elgin,5959,6,14,6,16,53,61,-8,48
Annan Athlet,5959,7,11,12,13,48,42,6,45
Berwick,5959,8,8,10,18,31,61,-30,34
Edinburgh Ci,5959,9,7,9,20,37,63,-26,30
Cowdenbeath,5959,10,4,11,21,24,55,-31,23
Montrose,5960,1,23,7,6,59,35,24,76
Peterhead,5960,2,23,5,8,79,40,39,74
Stenhousem'r,5960,3,16,8,12,58,46,12,56
Stirling,5960,4,16,6,14,60,54,6,54
Clyde,5960,5,14,9,13,51,49,2,51
Elgin,5960,6,15,6,15,54,60,-6,51
Annan Athlet,5960,7,11,11,14,47,43,4,44
Berwick,5960,8,9,10,17,30,58,-28,37
Edinburgh Ci,5960,9,7,10,19,38,62,-24,31
Cowdenbeath,5960,10,5,10,21,25,54,-29,25
Montrose,5961,1,23,7,6,59,36,23,76
Peterhead,5961,2,23,4,9,81,43,38,73
Stirling,5961,3,16,7,13,62,53,9,55
Stenhousem'r,5961,4,15,9,12,57,48,9,54
Clyde,5961,5,14,10,12,51,48,3,52
Elgin,5961,6,15,6,15,55,60,-5,51
Annan Athlet,5961,7,11,11,14,47,42,5,44
Berwick,5961,8,8,11,17,29,58,-29,35
Edinburgh Ci,5961,9,8,9,19,41,64,-23,33
Cowdenbeath,5961,10,5,10,21,24,54,-30,25
Montrose,5962,1,24,7,5,61,35,26,79
Peterhead,5962,2,24,4,8,80,39,41,76
Stirling,5962,3,16,7,13,62,53,9,55
Stenhousem'r,5962,4,15,9,12,57,48,9,54
Clyde,5962,5,14,10,12,53,50,3,52
Elgin,5962,6,14,6,16,54,62,-8,48
Annan Athlet,5962,7,11,11,14,47,43,4,44
Berwick,5962,8,8,11,17,31,60,-29,35
Edinburgh Ci,5962,9,7,9,20,37,63,-26,30
Cowdenbeath,5962,10,5,10,21,25,54,-29,25
Montrose,5963,1,23,8,5,60,35,25,77
Peterhead,5963,2,23,5,8,78,39,39,74
Stirling,5963,3,16,7,13,61,52,9,55
Stenhousem'r,5963,4,15,9,12,56,47,9,54
Clyde,5963,5,15,9,12,54,49,5,54
Elgin,5963,6,14,7,15,54,61,-7,49
Annan Athlet,5963,7,12,11,13,49,42,7,47
Berwick,5963,8,8,10,18,30,61,-31,34
Edinburgh Ci,5963,9,7,10,19,37,61,-24,31
Cowdenbeath,5963,10,4,10,22,24,56,-32,22
Montrose,5964,1,24,7,5,61,34,27,79
Peterhead,5964,2,24,4,8,83,41,42,76
Stirling,5964,3,16,7,13,62,53,9,55
Stenhousem'r,5964,4,15,9,12,57,48,9,54
Clyde,5964,5,14,10,12,51,48,3,52
Elgin,5964,6,14,6,16,53,62,-9,48
Annan Athlet,5964,7,12,11,13,48,41,7,47
Berwick,5964,8,8,11,17,29,58,-29,35
Edinburgh Ci,5964,9,7,9,20,39,66,-27,30
Cowdenbeath,5964,10,4,10,22,23,55,-32,22
Montrose,5965,1,24,7,5,62,34,28,79
Peterhead,5965,2,24,4,8,81,39,42,76
Stirling,5965,3,17,6,13,61,51,10,57
Clyde,5965,4,15,9,12,54,48,6,54
Stenhousem'r,5965,5,15,8,13,55,47,8,53
Elgin,5965,6,14,6,16,53,63,-10,48
Annan Athlet,5965,7,11,11,14,47,42,5,44
Berwick,5965,8,8,10,18,29,61,-32,34
Edinburgh Ci,5965,9,7,9,20,37,64,-27,30
Cowdenbeath,5965,10,5,10,21,24,54,-30,25
Montrose,5966,1,23,8,5,60,35,25,77
Peterhead,5966,2,24,4,8,80,40,40,76
Stenhousem'r,5966,3,16,8,12,56,46,10,56
Stirling,5966,4,16,6,14,60,52,8,54
Clyde,5966,5,14,9,13,51,50,1,51
Elgin,5966,6,14,7,15,54,61,-7,49
Annan Athlet,5966,7,12,11,13,48,41,7,47
Berwick,5966,8,9,10,17,31,58,-27,37
Edinburgh Ci,5966,9,7,9,20,38,63,-25,30
Cowdenbeath,5966,10,4,10,22,23,55,-32,22
Montrose,5967,1,24,7,5,61,34,27,79
Peterhead,5967,2,24,4,8,81,38,43,76
Stenhousem'r,5967,3,16,8,12,56,46,10,56
Stirling,5967,4,16,6,14,60,52,8,54
Clyde,5967,5,15,9,12,53,48,5,54
Elgin,5967,6,14,6,16,53,62,-9,48
Annan Athlet,5967,7,12,11,13,50,41,9,47
Berwick,5967,8,8,10,18,29,60,-31,34
Edinburgh Ci,5967,9,7,9,20,36,64,-28,30
Cowdenbeath,5967,10,4,10,22,23,57,-34,22
Montrose,5968,1,24,7,5,61,34,27,79
Peterhead,5968,2,23,4,9,79,41,38,73
Stirling,5968,3,16,7,13,60,51,9,55
Stenhousem'r,5968,4,15,9,12,55,46,9,54
Clyde,5968,5,15,9,12,55,48,7,54
Elgin,5968,6,14,6,16,53,62,-9,48
Annan Athlet,5968,7,12,11,13,50,43,7,47
Berwick,5968,8,8,10,18,29,62,-33,34
Edinburgh Ci,5968,9,8,9,19,39,62,-23,33
Cowdenbeath,5968,10,4,10,22,25,57,-32,22
Peterhead,5969,1,24,4,8,84,39,45,76
Montrose,5969,2,23,7,6,59,35,24,76
Stenhousem'r,5969,3,16,8,12,57,47,10,56
Stirling,5969,4,16,6,14,61,53,8,54
Clyde,5969,5,15,9,12,53,49,4,54
Elgin,5969,6,15,6,15,54,60,-6,51
Annan Athlet,5969,7,12,11,13,48,41,7,47
Berwick,5969,8,8,10,18,30,60,-30,34
Edinburgh Ci,5969,9,7,9,20,37,67,-30,30
Cowdenbeath,5969,10,4,10,22,23,55,-32,22
Montrose,5970,1,24,7,5,61,35,26,79
Peterhead,5970,2,24,4,8,82,40,42,76
Stenhousem'r,5970,3,16,8,12,57,46,11,56
Stirling,5970,4,16,6,14,60,53,7,54
Clyde,5970,5,15,9,12,56,49,7,54
Elgin,5970,6,14,6,16,54,62,-8,48
Annan Athlet,5970,7,12,11,13,49,42,7,47
Berwick,5970,8,8,10,18,30,63,-33,34
Edinburgh Ci,5970,9,7,9,20,38,65,-27,30
Cowdenbeath,5970,10,4,10,22,24,56,-32,22
Peterhead,5971,1,24,4,8,81,38,43,76
Montrose,5971,2,23,7,6,59,35,24,76
Stirling,5971,3,17,6,13,63,53,10,57
Clyde,5971,4,15,9,12,52,48,4,54
Stenhousem'r,5971,5,15,8,13,57,49,8,53
Elgin,5971,6,15,6,15,54,60,-6,51
Annan Athlet,5971,7,12,11,13,50,41,9,47
Berwick,5971,8,8,10,18,29,59,-30,34
Edinburgh Ci,5971,9,7,9,20,36,64,-28,30
Cowdenbeath,5971,10,4,10,22,23,57,-34,22
Montrose,5972,1,23,8,5,60,35,25,77
Peterhead,5972,2,24,4,8,84,39,45,76
Stirling,5972,3,17,6,13,63,51,12,57
Stenhousem'r,5972,4,15,8,13,55,49,6,53
Clyde,5972,5,14,9,13,52,50,2,51
Elgin,5972,6,14,7,15,54,61,-7,49
Annan Athlet,5972,7,12,11,13,49,42,7,47
Berwick,5972,8,9,10,17,31,59,-28,37
Edinburgh Ci,5972,9,7,9,20,37,67,-30,30
Cowdenbeath,5972,10,4,10,22,24,56,-32,22
Montrose,5973,1,24,7,5,60,34,26,79
Peterhead,5973,2,23,5,8,78,39,39,74
Stirling,5973,3,16,7,13,60,51,9,55
Stenhousem'r,5973,4,15,9,12,55,46,9,54
Clyde,5973,5,14,9,13,52,50,2,51
Elgin,5973,6,14,6,16,53,61,-8,48
Annan Athlet,5973,7,12,11,13,50,41,9,47
Berwick,5973,8,9,10,17,31,59,-28,37
Edinburgh Ci,5973,9,7,10,19,37,61,-24,31
Cowdenbeath,5973,10,4,10,22,23,57,-34,22
Montrose,5974,1,24,7,5,61,35,26,79
Peterhead,5974,2,24,4,8,81,40,41,76
Stirling,5974,3,16,7,13,62,53,9,55
Stenhousem'r,5974,4,15,9,12,57,48,9,54
Clyde,5974,5,15,9,12,52,48,4,54
Elgin,5974,6,14,6,16,54,62,-8,48
Annan Athlet,5974,7,11,12,13,48,42,6,45
Berwick,5974,8,8,10,18,29,59,-30,34
Edinburgh Ci,5974,9,7,9,20,38,64,-26,30
Cowdenbeath,5974,10,4,11,21,24,55,-31,23
Montrose,5975,1,24,7,5,60,34,26,79
Peterhead,5975,2,24,4,8,79,39,40,76
Stirling,5975,3,17,6,13,64,53,11,57
Clyde,5975,4,15,9,12,53,49,4,54
Stenhousem'r,5975,5,15,8,13,57,50,7,53
Elgin,5975,6,14,6,16,53,61,-8,48
Annan Athlet,5975,7,11,11,14,47,42,5,44
Berwick,5975,8,8,10,18,30,60,-30,34
Edinburgh Ci,5975,9,7,9,20,37,62,-25,30
Cowdenbeath,5975,10,5,10,21,24,54,-30,25
Montrose,5976,1,23,8,5,60,35,25,77
Peterhead,5976,2,24,4,8,78,38,40,76
Stenhousem'r,5976,3,16,8,12,60,48,12,56
Stirling,5976,4,16,6,14,62,56,6,54
Clyde,5976,5,15,9,12,54,48,6,54
Elgin,5976,6,14,7,15,54,61,-7,49
Annan Athlet,5976,7,12,11,13,50,42,8,47
Berwick,5976,8,8,10,18,29,61,-32,34
Edinburgh Ci,5976,9,7,9,20,36,61,-25,30
Cowdenbeath,5976,10,4,10,22,24,57,-33,22
Montrose,5977,1,24,7,5,61,35,26,79
Peterhead,5977,2,24,4,8,80,38,42,76
Stirling,5977,3,17,6,13,63,51,12,57
Clyde,5977,4,15,9,12,55,50,5,54
Stenhousem'r,5977,5,15,8,13,55,49,6,53
Elgin,5977,6,14,6,16,54,62,-8,48
Annan Athlet,5977,7,11,11,14,47,42,5,44
Berwick,5977,8,8,10,18,31,62,-31,34
Edinburgh Ci,5977,9,7,9,20,36,63,-27,30
Cowdenbeath,5977,10,5,10,21,24,54,-30,25
Montrose,5978,1,24,7,5,62,35,27,79
Peterhead,5978,2,24,4,8,79,38,41,76
Stirling,5978,3,17,6,13,62,51,11,57
Clyde,5978,4,15,9,12,53,49,4,54
Stenhousem'r,5978,5,15,8,13,55,48,7,53
Elgin,5978,6,14,6,16,54,63,-9,48
Annan Athlet,5978,7,12,11,13,48,41,7,47
Berwick,5978,8,8,10,18,30,60,-30,34
Edinburgh Ci,5978,9,7,9,20,36,62,-26,30
Cowdenbeath,5978,10,4,10,22,23,55,-32,22
Montrose,5979,1,24,7,5,60,34,26,79
Peterhead,5979,2,24,4,8,78,38,40,76
Stirling,5979,3,17,6,13,62,51,11,57
Clyde,5979,4,15,9,12,53,49,4,54
Stenhousem'r,5979,5,15,8,13,55,48,7,53
Elgin,5979,6,14,6,16,53,61,-8,48
Annan Athlet,5979,7,11,12,13,48,42,6,45
Berwick,5979,8,8,10,18,30,60,-30,34
Edinburgh Ci,5979,9,7,9,20,36,61,-25,30
Cowdenbeath,5979,10,4,11,21,24,55,-31,23
Montrose,5980,1,24,7,5,60,34,26,79
Peterhead,5980,2,23,4,9,79,41,38,73
Stirling,5980,3,16,7,13,61,52,9,55
Stenhousem'r,5980,4,15,9,12,56,47,9,54
Clyde,5980,5,15,9,12,54,48,6,54
Elgin,5980,6,14,6,16,53,61,-8,48
Annan Athlet,5980,7,12,11,13,49,42,7,47
Berwick,5980,8,8,10,18,29,61,-32,34
Edinburgh Ci,5980,9,8,9,19,39,62,-23,33
Cowdenbeath,5980,10,4,10,22,24,56,-32,22
Peterhead,5981,1,24,4,8,79,39,40,76
Montrose,5981,2,23,7,6,59,38,21,76
Stirling,5981,3,17,6,13,67,53,14,57
Stenhousem'r,5981,4,15,8,13,57,53,4,53
Clyde,5981,5,14,10,12,53,50,3,52
Elgin,5981,6,15,6,15,57,60,-3,51
Annan Athlet,5981,7,12,11,13,49,41,8,47
Berwick,5981,8,8,11,17,31,60,-29,35
Edinburgh Ci,5981,9,7,9,20,37,62,-25,30
Cowdenbeath,5981,10,4,10,22,23,56,-33,22
Peterhead,5982,1,24,4,8,82,39,43,76
Montrose,5982,2,23,7,6,59,38,21,76
Stenhousem'r,5982,3,16,8,12,56,46,10,56
Stirling,5982,4,16,6,14,60,52,8,54
Clyde,5982,5,15,9,12,54,48,6,54
Elgin,5982,6,15,6,15,57,60,-3,51
Annan Athlet,5982,7,11,12,13,49,43,6,45
Berwick,5982,8,8,10,18,29,61,-32,34
Edinburgh Ci,5982,9,7,9,20,37,65,-28,30
Cowdenbeath,5982,10,4,11,21,25,56,-31,23
Peterhead,5983,1,24,4,8,83,39,44,76
Montrose,5983,2,23,7,6,60,37,23,76
Stirling,5983,3,16,7,13,61,52,9,55
Stenhousem'r,5983,4,15,9,12,56,47,9,54
Clyde,5983,5,14,9,13,52,50,2,51
Elgin,5983,6,15,6,15,56,61,-5,51
Annan Athlet,5983,7,11,11,14,47,44,3,44
Berwick,5983,8,9,10,17,31,59,-28,37
Edinburgh Ci,5983,9,7,9,20,37,66,-29,30
Cowdenbeath,5983,10,5,10,21,26,54,-28,25
Montrose,5984,1,23,8,5,60,35,25,77
Peterhead,5984,2,24,4,8,81,39,42,76
Stenhousem'r,5984,3,16,8,12,59,46,13,56
Stirling,5984,4,16,6,14,60,55,5,54
Clyde,5984,5,15,9,12,54,50,4,54
Elgin,5984,6,14,7,15,54,61,-7,49
Annan Athlet,5984,7,11,12,13,48,42,6,45
Berwick,5984,8,8,10,18,31,61,-30,34
Edinburgh Ci,5984,9,7,9,20,37,64,-27,30
Cowdenbeath,5984,10,4,11,21,24,55,-31,23
Montrose,5985,1,24,7,5,62,34,28,79
Peterhead,5985,2,23,4,9,77,39,38,73
Stirling,5985,3,17,6,13,62,52,10,57
Clyde,5985,4,15,9,12,54,48,6,54
Stenhousem'r,5985,5,15,8,13,56,48,8,53
Elgin,5985,6,14,6,16,53,63,-10,48
Annan Athlet,5985,7,12,11,13,48,41,7,47
Berwick,5985,8,8,10,18,29,61,-32,34
Edinburgh Ci,5985,9,8,9,19,37,60,-23,33
Cowdenbeath,5985,10,4,10,22,23,55,-32,22
Montrose,5986,1,24,7,5,62,34,28,79
Peterhead,5986,2,24,4,8,82,38,44,76
Stenhousem'r,5986,3,16,8,12,58,48,10,56
Stirling,5986,4,16,6,14,62,54,8,54
Clyde,5986,5,14,9,13,52,50,2,51
Elgin,5986,6,14,6,16,53,63,-10,48
Annan Athlet,5986,7,11,12,13,47,41,6,45
Berwick,5986,8,9,10,17,31,59,-28,37
Edinburgh Ci,5986,9,7,9,20,36,65,-29,30
Cowdenbeath,5986,10,4,11,21,23,54,-31,23
Montrose,5987,1,24,7,5,61,34,27,79
Peterhead,5987,2,23,5,8,79,40,39,74
Stirling,5987,3,16,7,13,60,51,9,55
Stenhousem'r,5987,4,15,9,12,55,46,9,54
Clyde,5987,5,15,9,12,54,49,5,54
Elgin,5987,6,14,6,16,53,62,-9,48
Annan Athlet,5987,7,12,11,13,49,41,8,47
Berwick,5987,8,8,10,18,30,61,-31,34
Edinburgh Ci,5987,9,7,10,19,38,62,-24,31
Cowdenbeath,5987,10,4,10,22,23,56,-33,22
Montrose,5988,1,23,8,5,60,35,25,77
Peterhead,5988,2,24,4,8,80,38,42,76
Stirling,5988,3,16,7,13,61,52,9,55
Stenhousem'r,5988,4,15,9,12,56,47,9,54
Clyde,5988,5,14,10,12,51,48,3,52
Elgin,5988,6,14,7,15,54,61,-7,49
Annan Athlet,5988,7,12,11,13,49,41,8,47
Berwick,5988,8,8,11,17,29,58,-29,35
Edinburgh Ci,5988,9,7,9,20,36,63,-27,30
Cowdenbeath,5988,10,4,10,22,23,56,-33,22
Montrose,5989,1,24,7,5,61,35,26,79
Peterhead,5989,2,24,4,8,79,39,40,76
Stirling,5989,3,17,6,13,63,52,11,57
Stenhousem'r,5989,4,15,8,13,56,49,7,53
Clyde,5989,5,14,10,12,52,49,3,52
Elgin,5989,6,14,6,16,54,62,-8,48
Annan Athlet,5989,7,11,11,14,47,42,5,44
Berwick,5989,8,8,11,17,30,59,-29,35
Edinburgh Ci,5989,9,7,9,20,37,62,-25,30
Cowdenbeath,5989,10,5,10,21,24,54,-30,25
Montrose,5990,1,24,7,5,61,34,27,79
Peterhead,5990,2,24,4,8,80,38,42,76
Stirling,5990,3,17,6,13,62,52,10,57
Clyde,5990,4,15,9,12,53,49,4,54
Stenhousem'r,5990,5,15,8,13,56,48,8,53
Elgin,5990,6,14,6,16,53,62,-9,48
Annan Athlet,5990,7,12,11,13,50,42,8,47
Berwick,5990,8,8,10,18,30,60,-30,34
Edinburgh Ci,5990,9,7,9,20,36,63,-27,30
Cowdenbeath,5990,10,4,10,22,24,57,-33,22
Montrose,5991,1,23,8,5,60,35,25,77
Peterhead,5991,2,23,5,8,77,38,39,74
Stenhousem'r,5991,3,16,8,12,58,47,11,56
Stirling,5991,4,16,6,14,61,54,7,54
Clyde,5991,5,15,9,12,56,50,6,54
Elgin,5991,6,14,7,15,54,61,-7,49
Annan Athlet,5991,7,12,11,13,50,41,9,47
Berwick,5991,8,8,10,18,31,63,-32,34
Edinburgh Ci,5991,9,7,10,19,36,60,-24,31
Cowdenbeath,5991,10,4,10,22,23,57,-34,22
Montrose,5992,1,24,7,5,61,35,26,79
Peterhead,5992,2,24,4,8,79,38,41,76
Stenhousem'r,5992,3,16,8,12,56,46,10,56
Stirling,5992,4,16,6,14,60,52,8,54
Clyde,5992,5,15,9,12,54,48,6,54
Elgin,5992,6,14,6,16,54,62,-8,48
Annan Athlet,5992,7,11,12,13,48,42,6,45
Berwick,5992,8,8,10,18,29,61,-32,34
Edinburgh Ci,5992,9,7,9,20,36,62,-26,30
Cowdenbeath,5992,10,4,11,21,24,55,-31,23
Montrose,5993,1,23,8,5,60,35,25,77
Peterhead,5993,2,24,4,8,80,39,41,76
Stenhousem'r,5993,3,16,8,12,57,47,10,56
Stirling,5993,4,16,6,14,61,53,8,54
Clyde,5993,5,14,10,12,52,49,3,52
Elgin,5993,6,14,7,15,54,61,-7,49
Annan Athlet,5993,7,12,11,13,48,41,7,47
Berwick,5993,8,8,11,17,30,59,-29,35
Edinburgh Ci,5993,9,7,9,20,37,63,-26,30
Cowdenbeath,5993,10,4,10,22,23,55,-32,22
Montrose,5994,1,24,7,5,61,34,27,79
Peterhead,5994,2,24,4,8,80,39,41,76
Stirling,5994,3,17,6,13,62,52,10,57
Stenhousem'r,5994,4,15,8,13,56,48,8,53
Clyde,5994,5,14,9,13,51,53,-2,51
Elgin,5994,6,14,6,16,53,62,-9,48
Annan Athlet,5994,7,12,11,13,50,41,9,47
Berwick,5994,8,9,10,17,34,58,-24,37
Edinburgh Ci,5994,9,7,9,20,37,63,-26,30
Cowdenbeath,5994,10,4,10,22,23,57,-34,22
Montrose,5995,1,24,7,5,65,36,29,79
Peterhead,5995,2,24,4,8,80,39,41,76
Stirling,5995,3,17,6,13,65,51,14,57
Stenhousem'r,5995,4,15,8,13,55,51,4,53
Clyde,5995,5,14,9,13,51,50,1,51
Elgin,5995,6,14,6,16,55,66,-11,48
Annan Athlet,5995,7,12,11,13,48,41,7,47
Berwick,5995,8,9,10,17,31,58,-27,37
Edinburgh Ci,5995,9,7,9,20,37,63,-26,30
Cowdenbeath,5995,10,4,10,22,23,55,-32,22
Montrose,5996,1,23,8,5,60,35,25,77
Peterhead,5996,2,24,4,8,80,38,42,76
Stirling,5996,3,17,6,13,65,53,12,57
Clyde,5996,4,15,9,12,53,48,5,54
Stenhousem'r,5996,5,15,8,13,57,51,6,53
Elgin,5996,6,14,7,15,54,61,-7,49
Annan Athlet,5996,7,11,12,13,48,42,6,45
Berwick,5996,8,8,10,18,29,60,-31,34
Edinburgh Ci,5996,9,7,9,20,36,63,-27,30
Cowdenbeath,5996,10,4,11,21,24,55,-31,23
Montrose,5997,1,23,7,6,59,35,24,76
Peterhead,5997,2,23,5,8,78,39,39,74
Stirling,5997,3,17,6,13,64,51,13,57
Clyde,5997,4,15,9,12,52,48,4,54
Stenhousem'r,5997,5,15,8,13,55,50,5,53
Elgin,5997,6,15,6,15,54,60,-6,51
Annan Athlet,5997,7,11,12,13,49,43,6,45
Berwick,5997,8,8,10,18,29,59,-30,34
Edinburgh Ci,5997,9,7,10,19,37,61,-24,31
Cowdenbeath,5997,10,4,11,21,25,56,-31,23
Montrose,5998,1,23,7,6,59,36,23,76
Peterhead,5998,2,23,4,9,77,39,38,73
Stirling,5998,3,16,7,13,62,53,9,55
Stenhousem'r,5998,4,15,9,12,57,48,9,54
Clyde,5998,5,14,10,12,52,49,3,52
Elgin,5998,6,15,6,15,55,60,-5,51
Annan Athlet,5998,7,12,11,13,48,41,7,47
Berwick,5998,8,8,11,17,30,59,-29,35
Edinburgh Ci,5998,9,8,9,19,37,60,-23,33
Cowdenbeath,5998,10,4,10,22,23,55,-32,22
Montrose,5999,1,23,8,5,59,34,25,77
Peterhead,5999,2,24,4,8,79,39,40,76
Stirling,5999,3,17,6,13,64,52,12,57
Clyde,5999,4,15,9,12,56,49,7,54
Stenhousem'r,5999,5,15,8,13,56,50,6,53
Elgin,5999,6,14,7,15,53,60,-7,49
Annan Athlet,5999,7,12,11,13,49,42,7,47
Berwick,5999,8,8,10,18,30,63,-33,34
Edinburgh Ci,5999,9,7,9,20,37,62,-25,30
Cowdenbeath,5999,10,4,10,22,24,56,-32,22
Montrose,6000,1,23,8,5,59,34,25,77
Peterhead,6000,2,24,4,8,78,38,40,76
Stirling,6000,3,17,6,13,63,51,12,57
Stenhousem'r,6000,4,15,8,13,55,49,6,53
Clyde,6000,5,14,10,12,52,49,3,52
Elgin,6000,6,14,7,15,53,60,-7,49
Annan Athlet,6000,7,12,11,13,49,42,7,47
Berwick,6000,8,8,11,17,30,59,-29,35
Edinburgh Ci,6000,9,7,9,20,36,61,-25,30
Cowdenbeath,6000,10,4,10,22,24,56,-32,22
Montrose,6001,1,24,7,5,61,35,26,79
Peterhead,6001,2,23,5,8,78,39,39,74
Stirling,6001,3,17,6,13,63,52,11,57
Clyde,6001,4,15,9,12,55,50,5,54
Stenhousem'r,6001,5,15,8,13,56,49,7,53
Elgin,6001,6,14,6,16,54,62,-8,48
Annan Athlet,6001,7,12,11,13,49,41,8,47
Berwick,6001,8,8,10,18,31,62,-31,34
Edinburgh Ci,6001,9,7,10,19,37,61,-24,31
Cowdenbeath,6001,10,4,10,22,23,56,-33,22
Montrose,6002,1,23,8,5,60,35,25,77
Peterhead,6002,2,24,4,8,80,38,42,76
Stirling,6002,3,17,6,13,63,52,11,57
Clyde,6002,4,15,9,12,54,49,5,54
Stenhousem'r,6002,5,15,8,13,56,49,7,53
Elgin,6002,6,14,7,15,54,61,-7,49
Annan Athlet,6002,7,11,11,14,49,44,5,44
Berwick,6002,8,8,10,18,30,61,-31,34
Edinburgh Ci,6002,9,7,9,20,36,63,-27,30
Cowdenbeath,6002,10,5,10,21,26,56,-30,25
Peterhead,6003,1,24,4,8,80,39,41,76
Montrose,6003,2,23,7,6,60,37,23,76
Stirling,6003,3,17,6,13,62,52,10,57
Stenhousem'r,6003,4,15,8,13,56,48,8,53
Clyde,6003,5,14,10,12,52,49,3,52
Elgin,6003,6,15,6,15,56,61,-5,51
Annan Athlet,6003,7,11,12,13,48,42,6,45
Berwick,6003,8,8,11,17,30,59,-29,35
Edinburgh Ci,6003,9,7,9,20,37,63,-26,30
Cowdenbeath,6003,10,4,11,21,24,55,-31,23
Montrose,6004,1,24,7,5,61,34,27,79
Peterhead,6004,2,23,4,9,77,41,36,73
Stirling,6004,3,17,6,13,62,52,10,57
Clyde,6004,4,15,9,12,55,50,5,54
Stenhousem'r,6004,5,15,8,13,56,48,8,53
Elgin,6004,6,14,6,16,53,62,-9,48
Annan Athlet,6004,7,11,12,13,47,41,6,45
Berwick,6004,8,8,10,18,31,62,-31,34
Edinburgh Ci,6004,9,8,9,19,39,60,-21,33
Cowdenbeath,6004,10,4,11,21,23,54,-31,23
Montrose,6005,1,23,8,5,60,35,25,77
Peterhead,6005,2,24,4,8,78,38,40,76
Stirling,6005,3,17,6,13,61,51,10,57
Stenhousem'r,6005,4,15,8,13,55,47,8,53
Clyde,6005,5,14,10,12,53,50,3,52
Elgin,6005,6,14,7,15,54,61,-7,49
Annan Athlet,6005,7,11,11,14,47,44,3,44
Berwick,6005,8,8,11,17,31,60,-29,35
Edinburgh Ci,6005,9,7,9,20,36,61,-25,30
Cowdenbeath,6005,10,5,10,21,26,54,-28,25
Montrose,6006,1,24,7,5,61,34,27,79
Peterhead,6006,2,24,4,8,79,39,40,76
Stirling,6006,3,17,6,13,62,51,11,57
Stenhousem'r,6006,4,15,8,13,55,48,7,53
Clyde,6006,5,14,10,12,51,48,3,52
Elgin,6006,6,14,6,16,53,62,-9,48
Annan Athlet,6006,7,12,11,13,49,42,7,47
Berwick,6006,8,8,11,17,29,58,-29,35
Edinburgh Ci,6006,9,7,9,20,37,62,-25,30
Cowdenbeath,6006,10,4,10,22,24,56,-32,22
Montrose,6007,1,24,7,5,62,36,26,79
Peterhead,6007,2,24,4,8,79,38,41,76
Stirling,6007,3,16,7,13,61,52,9,55
Stenhousem'r,6007,4,15,9,12,56,47,9,54
Clyde,6007,5,14,10,12,51,48,3,52
Elgin,6007,6,14,6,16,55,63,-8,48
Annan Athlet,6007,7,12,11,13,48,41,7,47
Berwick,6007,8,8,11,17,29,58,-29,35
Edinburgh Ci,6007,9,7,9,20,36,62,-26,30
Cowdenbeath,6007,10,4,10,22,23,55,-32,22
Peterhead,6008,1,24,4,8,79,38,41,76
Montrose,6008,2,23,7,6,59,36,23,76
Stirling,6008,3,17,6,13,63,51,12,57
Stenhousem'r,6008,4,15,8,13,55,49,6,53
Clyde,6008,5,14,10,12,53,50,3,52
Elgin,6008,6,15,6,15,55,60,-5,51
Annan Athlet,6008,7,11,12,13,50,44,6,45
Berwick,6008,8,8,11,17,31,60,-29,35
Edinburgh Ci,6008,9,7,9,20,36,62,-26,30
Cowdenbeath,6008,10,4,11,21,26,57,-31,23
Montrose,6009,1,24,7,5,62,35,27,79
Peterhead,6009,2,24,4,8,80,39,41,76
Stenhousem'r,6009,3,16,8,12,60,49,11,56
Stirling,6009,4,16,6,14,63,56,7,54
Clyde,6009,5,14,9,13,52,51,1,51
Elgin,6009,6,14,6,16,54,63,-9,48
Annan Athlet,6009,7,11,12,13,48,42,6,45
Berwick,6009,8,9,10,17,32,59,-27,37
Edinburgh Ci,6009,9,7,9,20,37,63,-26,30
Cowdenbeath,6009,10,4,11,21,24,55,-31,23
Montrose,6010,1,24,7,5,62,35,27,79
Peterhead,6010,2,24,4,8,81,39,42,76
Stirling,6010,3,17,6,13,62,52,10,57
Stenhousem'r,6010,4,15,8,13,56,48,8,53
Clyde,6010,5,14,10,12,52,49,3,52
Elgin,6010,6,14,6,16,54,63,-9,48
Annan Athlet,6010,7,11,11,14,47,42,5,44
Berwick,6010,8,8,11,17,30,59,-29,35
Edinburgh Ci,6010,9,7,9,20,37,64,-27,30
Cowdenbeath,6010,10,5,10,21,24,54,-30,25
Montrose,6011,1,23,7,6,60,37,23,76
Peterhead,6011,2,23,5,8,80,41,39,74
Stenhousem'r,6011,3,16,8,12,60,49,11,56
Stirling,6011,4,16,6,14,63,56,7,54
Clyde,6011,5,15,9,12,52,48,4,54
Elgin,6011,6,15,6,15,56,61,-5,51
Annan Athlet,6011,7,12,11,13,49,42,7,47
Berwick,6011,8,8,10,18,29,59,-30,34
Edinburgh Ci,6011,9,7,10,19,39,63,-24,31
Cowdenbeath,6011,10,4,10,22,24,56,-32,22
Montrose,6012,1,24,7,5,62,34,28,79
Peterhead,6012,2,24,4,8,79,38,41,76
Stirling,6012,3,17,6,13,65,52,13,57
Stenhousem'r,6012,4,15,8,13,56,51,5,53
Clyde,6012,5,14,10,12,52,49,3,52
Elgin,6012,6,14,6,16,53,63,-10,48
Annan Athlet,6012,7,12,11,13,50,42,8,47
Berwick,6012,8,8,11,17,30,59,-29,35
Edinburgh Ci,6012,9,7,9,20,36,62,-26,30
Cowdenbeath,6012,10,4,10,22,24,57,-33,22
Peterhead,6013,1,24,4,8,83,38,45,76
Montrose,6013,2,23,7,6,60,36,24,76
Stirling,6013,3,16,7,13,61,52,9,55
Stenhousem'r,6013,4,15,9,12,56,47,9,54
Clyde,6013,5,15,9,12,53,48,5,54
Elgin,6013,6,15,6,15,55,61,-6,51
Annan Athlet,6013,7,12,11,13,48,41,7,47
Berwick,6013,8,8,10,18,29,60,-31,34
Edinburgh Ci,6013,9,7,9,20,36,66,-30,30
Cowdenbeath,6013,10,4,10,22,23,55,-32,22
Montrose,6014,1,23,7,6,59,35,24,76
Peterhead,6014,2,23,5,8,78,39,39,74
Stirling,6014,3,16,7,13,62,53,9,55
Stenhousem'r,6014,4,15,9,12,57,48,9,54
Clyde,6014,5,14,9,13,52,50,2,51
Elgin,6014,6,15,6,15,54,60,-6,51
Annan Athlet,6014,7,12,11,13,48,41,7,47
Berwick,6014,8,9,10,17,31,59,-28,37
Edinburgh Ci,6014,9,7,10,19,37,61,-24,31
Cowdenbeath,6014,10,4,10,22,23,55,-32,22
Montrose,6015,1,24,7,5,60,34,26,79
Peterhead,6015,2,23,5,8,79,40,39,74
Stirling,6015,3,17,6,13,65,51,14,57
Clyde,6015,4,15,9,12,53,49,4,54
Stenhousem'r,6015,5,15,8,13,55,51,4,53
Elgin,6015,6,14,6,16,53,61,-8,48
Annan Athlet,6015,7,12,11,13,49,42,7,47
Berwick,6015,8,8,10,18,30,60,-30,34
Edinburgh Ci,6015,9,7,10,19,38,62,-24,31
Cowdenbeath,6015,10,4,10,22,24,56,-32,22
Montrose,6016,1,24,7,5,61,34,27,79
Peterhead,6016,2,24,4,8,79,39,40,76
Stenhousem'r,6016,3,16,8,12,57,46,11,56
Stirling,6016,4,16,6,14,60,53,7,54
Clyde,6016,5,15,9,12,53,49,4,54
Elgin,6016,6,14,6,16,53,62,-9,48
Annan Athlet,6016,7,11,12,13,47,41,6,45
Berwick,6016,8,8,10,18,30,60,-30,34
Edinburgh Ci,6016,9,7,9,20,37,62,-25,30
Cowdenbeath,6016,10,4,11,21,23,54,-31,23
Montrose,6017,1,24,7,5,60,34,26,79
Peterhead,6017,2,23,5,8,78,39,39,74
Stirling,6017,3,17,6,13,63,51,12,57
Clyde,6017,4,15,9,12,53,48,5,54
Stenhousem'r,6017,5,15,8,13,55,49,6,53
Elgin,6017,6,14,6,16,53,61,-8,48
Annan Athlet,6017,7,11,11,14,47,43,4,44
Berwick,6017,8,8,10,18,29,60,-31,34
Edinburgh Ci,6017,9,7,10,19,37,61,-24,31
Cowdenbeath,6017,10,5,10,21,25,54,-29,25
Montrose,6018,1,23,8,5,60,35,25,77
Peterhead,6018,2,24,4,8,81,39,42,76
Stirling,6018,3,17,6,13,62,52,10,57
Clyde,6018,4,15,9,12,53,48,5,54
Stenhousem'r,6018,5,15,8,13,56,48,8,53
Elgin,6018,6,14,7,15,54,61,-7,49
Annan Athlet,6018,7,11,12,13,47,41,6,45
Berwick,6018,8,8,10,18,29,60,-31,34
Edinburgh Ci,6018,9,7,9,20,37,64,-27,30
Cowdenbeath,6018,10,4,11,21,23,54,-31,23
Peterhead,6019,1,24,4,8,78,38,40,76
Montrose,6019,2,23,7,6,60,36,24,76
Stirling,6019,3,17,6,13,65,51,14,57
Clyde,6019,4,15,9,12,53,48,5,54
Stenhousem'r,6019,5,15,8,13,55,51,4,53
Elgin,6019,6,15,6,15,55,61,-6,51
Annan Athlet,6019,7,11,11,14,48,43,5,44
Berwick,6019,8,8,10,18,29,60,-31,34
Edinburgh Ci,6019,9,7,9,20,36,61,-25,30
Cowdenbeath,6019,10,5,10,21,25,55,-30,25
Montrose,6020,1,24,7,5,63,35,28,79
Peterhead,6020,2,24,4,8,80,39,41,76
Stenhousem'r,6020,3,16,8,12,59,48,11,56
Stirling,6020,4,16,6,14,62,55,7,54
Clyde,6020,5,14,10,12,51,48,3,52
Elgin,6020,6,14,6,16,54,64,-10,48
Annan Athlet,6020,7,11,11,14,47,42,5,44
Berwick,6020,8,8,11,17,29,58,-29,35
Edinburgh Ci,6020,9,7,9,20,37,63,-26,30
Cowdenbeath,6020,10,5,10,21,24,54,-30,25
Montrose,6021,1,24,7,5,60,34,26,79
Peterhead,6021,2,24,4,8,79,38,41,76
Stirling,6021,3,17,6,13,63,52,11,57
Stenhousem'r,6021,4,15,8,13,56,49,7,53
Clyde,6021,5,14,9,13,51,49,2,51
Elgin,6021,6,14,6,16,53,61,-8,48
Annan Athlet,6021,7,11,11,14,47,42,5,44
Berwick,6021,8,9,10,17,30,58,-28,37
Edinburgh Ci,6021,9,7,9,20,36,62,-26,30
Cowdenbeath,6021,10,5,10,21,24,54,-30,25
Peterhead,6022,1,24,4,8,80,39,41,76
Montrose,6022,2,23,7,6,61,39,22,76
Stirling,6022,3,17,6,13,62,52,10,57
Clyde,6022,4,15,9,12,52,48,4,54
Stenhousem'r,6022,5,15,8,13,56,48,8,53
Elgin,6022,6,15,6,15,58,62,-4,51
Annan Athlet,6022,7,11,12,13,47,41,6,45
Berwick,6022,8,8,10,18,29,59,-30,34
Edinburgh Ci,6022,9,7,9,20,37,63,-26,30
Cowdenbeath,6022,10,4,11,21,23,54,-31,23
Montrose,6023,1,23,8,5,59,34,25,77
Peterhead,6023,2,24,4,8,79,38,41,76
Stirling,6023,3,16,7,13,60,51,9,55
Stenhousem'r,6023,4,15,9,12,55,46,9,54
Clyde,6023,5,15,9,12,54,49,5,54
Elgin,6023,6,14,7,15,53,60,-7,49
Annan Athlet,6023,7,11,12,13,48,42,6,45
Berwick,6023,8,8,10,18,30,61,-31,34
Edinburgh Ci,6023,9,7,9,20,36,62,-26,30
Cowdenbeath,6023,10,4,11,21,24,55,-31,23
Montrose,6024,1,24,7,5,61,34,27,79
Peterhead,6024,2,24,4,8,79,38,41,76
Stirling,6024,3,16,7,13,60,51,9,55
Stenhousem'r,6024,4,15,9,12,55,46,9,54
Clyde,6024,5,15,9,12,52,48,4,54
Elgin,6024,6,14,6,16,53,62,-9,48
Annan Athlet,6024,7,12,11,13,49,41,8,47
Berwick,6024,8,8,10,18,29,59,-30,34
Edinburgh Ci,6024,9,7,9,20,36,62,-26,30
Cowdenbeath,6024,10,4,10,22,23,56,-33,22
Montrose,6025,1,24,7,5,63,35,28,79
Peterhead,6025,2,24,4,8,79,39,40,76
Stirling,6025,3,17,6,13,62,52,10,57
Stenhousem'r,6025,4,15,8,13,56,48,8,53
Clyde,6025,5,14,9,13,51,49,2,51
Elgin,6025,6,14,6,16,54,64,-10,48
Annan Athlet,6025,7,11,12,13,48,42,6,45
Berwick,6025,8,9,10,17,30,58,-28,37
Edinburgh Ci,6025,9,7,9,20,37,62,-25,30
Cowdenbeath,6025,10,4,11,21,24,55,-31,23
Montrose,6026,1,23,8,5,59,34,25,77
Peterhead,6026,2,24,4,8,80,38,42,76
Stenhousem'r,6026,3,16,8,12,56,46,10,56
Stirling,6026,4,16,6,14,60,52,8,54
Clyde,6026,5,14,9,13,53,51,2,51
Elgin,6026,6,14,7,15,53,60,-7,49
Annan Athlet,6026,7,11,12,13,48,42,6,45
Berwick,6026,8,9,10,17,32,60,-28,37
Edinburgh Ci,6026,9,7,9,20,36,63,-27,30
Cowdenbeath,6026,10,4,11,21,24,55,-31,23
Montrose,6027,1,24,7,5,60,34,26,79
Peterhead,6027,2,23,5,8,78,39,39,74
Stenhousem'r,6027,3,16,8,12,58,47,11,56
Stirling,6027,4,16,6,14,61,54,7,54
Clyde,6027,5,15,9,12,52,48,4,54
Elgin,6027,6,14,6,16,53,61,-8,48
Annan Athlet,6027,7,11,11,14,48,43,5,44
Berwick,6027,8,8,10,18,29,59,-30,34
Edinburgh Ci,6027,9,7,10,19,37,61,-24,31
Cowdenbeath,6027,10,5,10,21,25,55,-30,25
Montrose,6028,1,24,7,5,62,34,28,79
Peterhead,6028,2,24,4,8,82,39,43,76
Stirling,6028,3,17,6,13,63,52,11,57
Clyde,6028,4,15,9,12,54,48,6,54
Stenhousem'r,6028,5,15,8,13,56,49,7,53
Elgin,6028,6,14,6,16,53,63,-10,48
Annan Athlet,6028,7,11,12,13,49,43,6,45
Berwick,6028,8,8,10,18,29,61,-32,34
Edinburgh Ci,6028,9,7,9,20,37,65,-28,30
Cowdenbeath,6028,10,4,11,21,25,56,-31,23
Peterhead,6029,1,24,4,8,79,39,40,76
Montrose,6029,2,23,7,6,60,36,24,76
Stirling,6029,3,17,6,13,63,53,10,57
Stenhousem'r,6029,4,15,8,13,57,49,8,53
Clyde,6029,5,14,10,12,53,50,3,52
Elgin,6029,6,15,6,15,55,61,-6,51
Annan Athlet,6029,7,12,11,13,49,41,8,47
Berwick,6029,8,8,11,17,31,60,-29,35
Edinburgh Ci,6029,9,7,9,20,37,62,-25,30
Cowdenbeath,6029,10,4,10,22,23,56,-33,22
Peterhead,6030,1,24,4,8,78,38,40,76
Montrose,6030,2,23,7,6,59,38,21,76
Stirling,6030,3,17,6,13,64,52,12,57
Stenhousem'r,6030,4,15,8,13,56,50,6,53
Clyde,6030,5,14,9,13,51,51,0,51
Elgin,6030,6,15,6,15,57,60,-3,51
Annan Athlet,6030,7,11,11,14,48,46,2,44
Berwick,6030,8,9,10,17,32,58,-26,37
Edinburgh Ci,6030,9,7,9,20,36,61,-25,30
Cowdenbeath,6030,10,5,10,21,28,55,-27,25
Peterhead,6031,1,24,4,8,80,40,40,76
Montrose,6031,2,23,7,6,60,36,24,76
Stirling,6031,3,17,6,13,63,51,12,57
Clyde,6031,4,15,9,12,53,48,5,54
Stenhousem'r,6031,5,15,8,13,55,49,6,53
Elgin,6031,6,15,6,15,55,61,-6,51
Annan Athlet,6031,7,11,11,14,47,42,5,44
Berwick,6031,8,8,10,18,29,60,-31,34
Edinburgh Ci,6031,9,7,9,20,38,63,-25,30
Cowdenbeath,6031,10,5,10,21,24,54,-30,25
Montrose,6032,1,24,7,5,62,34,28,79
Peterhead,6032,2,24,4,8,81,38,43,76
Stenhousem'r,6032,3,16,8,12,58,47,11,56
Stirling,6032,4,16,6,14,61,54,7,54
Clyde,6032,5,14,10,12,52,49,3,52
Elgin,6032,6,14,6,16,53,63,-10,48
Annan Athlet,6032,7,11,12,13,47,41,6,45
Berwick,6032,8,8,11,17,30,59,-29,35
Edinburgh Ci,6032,9,7,9,20,36,64,-28,30
Cowdenbeath,6032,10,4,11,21,23,54,-31,23
Montrose,6033,1,23,7,6,59,36,23,76
Peterhead,6033,2,23,5,8,78,39,39,74
Stirling,6033,3,17,6,13,61,51,10,57
Stenhousem'r,6033,4,15,8,13,55,47,8,53
Clyde,6033,5,14,9,13,51,51,0,51
Elgin,6033,6,15,6,15,55,60,-5,51
Annan Athlet,6033,7,12,11,13,49,41,8,47
Berwick,6033,8,9,10,17,32,58,-26,37
Edinburgh Ci,6033,9,7,10,19,37,61,-24,31
Cowdenbeath,6033,10,4,10,22,23,56,-33,22
Montrose,6034,1,24,7,5,62,36,26,79
Peterhead,6034,2,24,4,8,79,38,41,76
Stirling,6034,3,17,6,13,62,51,11,57
Clyde,6034,4,15,9,12,56,51,5,54
Stenhousem'r,6034,5,15,8,13,55,48,7,53
Elgin,6034,6,14,6,16,55,63,-8,48
Annan Athlet,6034,7,11,11,14,47,42,5,44
Berwick,6034,8,8,10,18,32,63,-31,34
Edinburgh Ci,6034,9,7,9,20,36,62,-26,30
Cowdenbeath,6034,10,5,10,21,24,54,-30,25
Montrose,6035,1,24,7,5,62,36,26,79
Peterhead,6035,2,24,4,8,81,38,43,76
Stenhousem'r,6035,3,16,8,12,59,49,10,56
Stirling,6035,4,16,6,14,63,55,8,54
Clyde,6035,5,15,9,12,56,48,8,54
Elgin,6035,6,14,6,16,55,63,-8,48
Annan Athlet,6035,7,12,11,13,50,41,9,47
Berwick,6035,8,8,10,18,29,63,-34,34
Edinburgh Ci,6035,9,7,9,20,36,64,-28,30
Cowdenbeath,6035,10,4,10,22,23,57,-34,22
Montrose,6036,1,23,8,5,59,34,25,77
Peterhead,6036,2,24,4,8,79,39,40,76
Stirling,6036,3,17,6,13,62,52,10,57
Stenhousem'r,6036,4,15,8,13,56,48,8,53
Clyde,6036,5,14,10,12,52,49,3,52
Elgin,6036,6,14,7,15,53,60,-7,49
Annan Athlet,6036,7,11,11,14,47,43,4,44
Berwick,6036,8,8,11,17,30,59,-29,35
Edinburgh Ci,6036,9,7,9,20,37,62,-25,30
Cowdenbeath,6036,10,5,10,21,25,54,-29,25
Montrose,6037,1,24,7,5,61,34,27,79
Peterhead,6037,2,24,4,8,81,39,42,76
Stirling,6037,3,16,7,13,61,52,9,55
Stenhousem'r,6037,4,15,9,12,56,47,9,54
Clyde,6037,5,14,9,13,51,49,2,51
Elgin,6037,6,14,6,16,53,62,-9,48
Annan Athlet,6037,7,12,11,13,50,41,9,47
Berwick,6037,8,9,10,17,30,58,-28,37
Edinburgh Ci,6037,9,7,9,20,37,64,-27,30
Cowdenbeath,6037,10,4,10,22,23,57,-34,22
Montrose,6038,1,23,8,5,61,36,25,77
Peterhead,6038,2,23,4,9,77,42,35,73
Stirling,6038,3,17,6,13,63,52,11,57
Stenhousem'r,6038,4,15,8,13,56,49,7,53
Clyde,6038,5,14,10,12,51,48,3,52
Elgin,6038,6,14,7,15,55,62,-7,49
Annan Athlet,6038,7,11,11,14,47,43,4,44
Berwick,6038,8,8,11,17,29,58,-29,35
Edinburgh Ci,6038,9,8,9,19,40,60,-20,33
Cowdenbeath,6038,10,5,10,21,25,54,-29,25
Montrose,6039,1,24,7,5,61,34,27,79
Peterhead,6039,2,24,4,8,80,38,42,76
Stenhousem'r,6039,3,16,8,12,57,47,10,56
Stirling,6039,4,16,6,14,61,53,8,54
Clyde,6039,5,15,9,12,54,49,5,54
Elgin,6039,6,14,6,16,53,62,-9,48
Annan Athlet,6039,7,11,12,13,48,42,6,45
Berwick,6039,8,8,10,18,30,61,-31,34
Edinburgh Ci,6039,9,7,9,20,36,63,-27,30
Cowdenbeath,6039,10,4,11,21,24,55,-31,23
Montrose,6040,1,23,7,6,59,35,24,76
Peterhead,6040,2,23,4,9,77,39,38,73
Stirling,6040,3,16,7,13,61,52,9,55
Stenhousem'r,6040,4,15,9,12,56,47,9,54
Clyde,6040,5,14,10,12,52,49,3,52
Elgin,6040,6,15,6,15,54,60,-6,51
Annan Athlet,6040,7,12,11,13,49,41,8,47
Berwick,6040,8,8,11,17,30,59,-29,35
Edinburgh Ci,6040,9,8,9,19,37,60,-23,33
Cowdenbeath,6040,10,4,10,22,23,56,-33,22
Montrose,6041,1,24,7,5,62,36,26,79
Peterhead,6041,2,24,4,8,81,41,40,76
Stenhousem'r,6041,3,16,8,12,56,46,10,56
Stirling,6041,4,16,6,14,60,52,8,54
Clyde,6041,5,15,9,12,54,50,4,54
Elgin,6041,6,14,6,16,55,63,-8,48
Annan Athlet,6041,7,11,11,14,47,43,4,44
Berwick,6041,8,8,10,18,31,61,-30,34
Edinburgh Ci,6041,9,7,9,20,39,64,-25,30
Cowdenbeath,6041,10,5,10,21,25,54,-29,25
Montrose,6042,1,24,7,5,61,34,27,79
Peterhead,6042,2,24,4,8,80,39,41,76
Stirling,6042,3,17,6,13,64,51,13,57
Stenhousem'r,6042,4,15,8,13,55,50,5,53
Clyde,6042,5,14,9,13,51,49,2,51
Elgin,6042,6,14,6,16,53,62,-9,48
Annan Athlet,6042,7,11,11,14,47,43,4,44
Berwick,6042,8,9,10,17,30,58,-28,37
Edinburgh Ci,6042,9,7,9,20,37,63,-26,30
Cowdenbeath,6042,10,5,10,21,25,54,-29,25
Montrose,6043,1,23,7,6,59,35,24,76
Peterhead,6043,2,23,5,8,79,40,39,74
Stirling,6043,3,16,7,13,61,52,9,55
Stenhousem'r,6043,4,15,9,12,56,47,9,54
Clyde,6043,5,15,9,12,54,48,6,54
Elgin,6043,6,15,6,15,54,60,-6,51
Annan Athlet,6043,7,11,12,13,47,41,6,45
Berwick,6043,8,8,10,18,29,61,-32,34
Edinburgh Ci,6043,9,7,10,19,38,62,-24,31
Cowdenbeath,6043,10,4,11,21,23,54,-31,23
Peterhead,6044,1,24,4,8,82,39,43,76
Montrose,6044,2,23,7,6,59,36,23,76
Stenhousem'r,6044,3,16,8,12,56,46,10,56
Stirling,6044,4,16,6,14,60,52,8,54
Clyde,6044,5,15,9,12,53,48,5,54
Elgin,6044,6,15,6,15,55,60,-5,51
Annan Athlet,6044,7,11,12,13,49,43,6,45
Berwick,6044,8,8,10,18,29,60,-31,34
Edinburgh Ci,6044,9,7,9,20,37,65,-28,30
Cowdenbeath,6044,10,4,11,21,25,56,-31,23
Montrose,6045,1,24,7,5,62,35,27,79
Peterhead,6045,2,24,4,8,79,39,40,76
Stirling,6045,3,16,7,13,60,51,9,55
Stenhousem'r,6045,4,15,9,12,55,46,9,54
Clyde,6045,5,15,9,12,55,48,7,54
Elgin,6045,6,14,6,16,54,63,-9,48
Annan Athlet,6045,7,11,11,14,47,42,5,44
Berwick,6045,8,8,10,18,29,62,-33,34
Edinburgh Ci,6045,9,7,9,20,37,62,-25,30
Cowdenbeath,6045,10,5,10,21,24,54,-30,25
Montrose,6046,1,23,8,5,60,35,25,77
Peterhead,6046,2,24,4,8,80,38,42,76
Stirling,6046,3,16,7,13,61,52,9,55
Stenhousem'r,6046,4,15,9,12,56,47,9,54
Clyde,6046,5,15,9,12,55,48,7,54
Elgin,6046,6,14,7,15,54,61,-7,49
Annan Athlet,6046,7,12,11,13,48,41,7,47
Berwick,6046,8,8,10,18,29,62,-33,34
Edinburgh Ci,6046,9,7,9,20,36,63,-27,30
Cowdenbeath,6046,10,4,10,22,23,55,-32,22
Montrose,6047,1,24,7,5,60,34,26,79
Peterhead,6047,2,24,4,8,78,38,40,76
Stirling,6047,3,16,7,13,61,52,9,55
Stenhousem'r,6047,4,15,9,12,56,47,9,54
Clyde,6047,5,15,9,12,52,48,4,54
Elgin,6047,6,14,6,16,53,61,-8,48
Annan Athlet,6047,7,12,11,13,50,43,7,47
Berwick,6047,8,8,10,18,29,59,-30,34
Edinburgh Ci,6047,9,7,9,20,36,61,-25,30
Cowdenbeath,6047,10,4,10,22,25,57,-32,22
Montrose,6048,1,24,7,5,60,34,26,79
Peterhead,6048,2,24,4,8,82,38,44,76
Stirling,6048,3,17,6,13,63,51,12,57
Clyde,6048,4,15,9,12,54,48,6,54
Stenhousem'r,6048,5,15,8,13,55,49,6,53
Elgin,6048,6,14,6,16,53,61,-8,48
Annan Athlet,6048,7,12,11,13,49,41,8,47
Berwick,6048,8,8,10,18,29,61,-32,34
Edinburgh Ci,6048,9,7,9,20,36,65,-29,30
Cowdenbeath,6048,10,4,10,22,23,56,-33,22
Montrose,6049,1,24,7,5,62,35,27,79
Peterhead,6049,2,24,4,8,79,39,40,76
Stirling,6049,3,17,6,13,63,53,10,57
Clyde,6049,4,15,9,12,55,49,6,54
Stenhousem'r,6049,5,15,8,13,57,49,8,53
Elgin,6049,6,14,6,16,54,63,-9,48
Annan Athlet,6049,7,12,11,13,49,42,7,47
Berwick,6049,8,8,10,18,30,62,-32,34
Edinburgh Ci,6049,9,7,9,20,37,62,-25,30
Cowdenbeath,6049,10,4,10,22,24,56,-32,22
Montrose,6050,1,24,7,5,60,34,26,79
Peterhead,6050,2,23,5,8,79,40,39,74
Stirling,6050,3,17,6,13,64,53,11,57
Clyde,6050,4,15,9,12,54,49,5,54
Stenhousem'r,6050,5,15,8,13,57,50,7,53
Elgin,6050,6,14,6,16,53,61,-8,48
Annan Athlet,6050,7,12,11,13,51,42,9,47
Berwick,6050,8,8,10,18,30,61,-31,34
Edinburgh Ci,6050,9,7,10,19,38,62,-24,31
Cowdenbeath,6050,10,4,10,22,24,58,-34,22
Peterhead,6051,1,24,4,8,78,38,40,76
Montrose,6051,2,23,7,6,59,37,22,76
Stirling,6051,3,16,7,13,61,52,9,55
Stenhousem'r,6051,4,15,9,12,56,47,9,54
Clyde,6051,5,14,9,13,52,50,2,51
Elgin,6051,6,15,6,15,56,60,-4,51
Annan Athlet,6051,7,12,11,13,49,42,7,47
Berwick,6051,8,9,10,17,31,59,-28,37
Edinburgh Ci,6051,9,7,9,20,36,61,-25,30
Cowdenbeath,6051,10,4,10,22,24,56,-32,22
Montrose,6052,1,24,7,5,60,34,26,79
Peterhead,6052,2,24,4,8,78,38,40,76
Stirling,6052,3,17,6,13,62,52,10,57
Clyde,6052,4,15,9,12,54,49,5,54
Stenhousem'r,6052,5,15,8,13,56,48,8,53
Elgin,6052,6,14,6,16,53,61,-8,48
Annan Athlet,6052,7,11,11,14,47,42,5,44
Berwick,6052,8,8,10,18,30,61,-31,34
Edinburgh Ci,6052,9,7,9,20,36,61,-25,30
Cowdenbeath,6052,10,5,10,21,24,54,-30,25
Peterhead,6053,1,24,4,8,80,39,41,76
Montrose,6053,2,23,7,6,60,36,24,76
Stenhousem'r,6053,3,16,8,12,56,46,10,56
Stirling,6053,4,16,6,14,60,52,8,54
Clyde,6053,5,15,9,12,53,48,5,54
Elgin,6053,6,15,6,15,55,61,-6,51
Annan Athlet,6053,7,11,11,14,47,42,5,44
Berwick,6053,8,8,10,18,29,60,-31,34
Edinburgh Ci,6053,9,7,9,20,37,63,-26,30
Cowdenbeath,6053,10,5,10,21,24,54,-30,25
Montrose,6054,1,24,7,5,61,34,27,79
Peterhead,6054,2,24,4,8,81,39,42,76
Stirling,6054,3,16,7,13,61,52,9,55
Stenhousem'r,6054,4,15,9,12,56,47,9,54
Clyde,6054,5,15,9,12,54,49,5,54
Elgin,6054,6,14,6,16,53,62,-9,48
Annan Athlet,6054,7,12,11,13,49,41,8,47
Berwick,6054,8,8,10,18,30,61,-31,34
Edinburgh Ci,6054,9,7,9,20,37,64,-27,30
Cowdenbeath,6054,10,4,10,22,23,56,-33,22
Peterhead,6055,1,24,4,8,80,38,42,76
Montrose,6055,2,23,7,6,61,37,24,76
Stirling,6055,3,17,6,13,61,51,10,57
Clyde,6055,4,15,9,12,54,48,6,54
Stenhousem'r,6055,5,15,8,13,55,47,8,53
Elgin,6055,6,15,6,15,56,62,-6,51
Annan Athlet,6055,7,12,11,13,49,42,7,47
Berwick,6055,8,8,10,18,29,61,-32,34
Edinburgh Ci,6055,9,7,9,20,36,63,-27,30
Cowdenbeath,6055,10,4,10,22,24,56,-32,22
Montrose,6056,1,24,7,5,63,34,29,79
Peterhead,6056,2,24,4,8,80,38,42,76
Stirling,6056,3,17,6,13,61,51,10,57
Stenhousem'r,6056,4,15,8,13,55,47,8,53
Clyde,6056,5,14,9,13,53,53,0,51
Elgin,6056,6,14,6,16,53,64,-11,48
Annan Athlet,6056,7,11,11,14,49,44,5,44
Berwick,6056,8,9,10,17,34,60,-26,37
Edinburgh Ci,6056,9,7,9,20,36,63,-27,30
Cowdenbeath,6056,10,5,10,21,26,56,-30,25
Peterhead,6057,1,24,4,8,81,39,42,76
Montrose,6057,2,23,7,6,59,36,23,76
Stirling,6057,3,16,7,13,61,52,9,55
Stenhousem'r,6057,4,15,9,12,56,47,9,54
Clyde,6057,5,15,9,12,52,48,4,54
Elgin,6057,6,15,6,15,55,60,-5,51
Annan Athlet,6057,7,11,11,14,47,43,4,44
Berwick,6057,8,8,10,18,29,59,-30,34
Edinburgh Ci,6057,9,7,9,20,37,64,-27,30
Cowdenbeath,6057,10,5,10,21,25,54,-29,25
Peterhead,6058,1,24,4,8,81,38,43,76
Montrose,6058,2,23,7,6,60,36,24,76
Stirling,6058,3,16,7,13,61,52,9,55
Stenhousem'r,6058,4,15,9,12,56,47,9,54
Clyde,6058,5,14,9,13,51,49,2,51
Elgin,6058,6,15,6,15,55,61,-6,51
Annan Athlet,6058,7,12,11,13,50,43,7,47
Berwick,6058,8,9,10,17,30,58,-28,37
Edinburgh Ci,6058,9,7,9,20,36,64,-28,30
Cowdenbeath,6058,10,4,10,22,25,57,-32,22
Montrose,6059,1,23,8,5,60,35,25,77
Peterhead,6059,2,23,5,8,79,40,39,74
Stirling,6059,3,17,6,13,61,51,10,57
Clyde,6059,4,15,9,12,54,49,5,54
Stenhousem'r,6059,5,15,8,13,55,47,8,53
Elgin,6059,6,14,7,15,54,61,-7,49
Annan Athlet,6059,7,11,11,14,47,45,2,44
Berwick,6059,8,8,10,18,30,61,-31,34
Edinburgh Ci,6059,9,7,10,19,38,62,-24,31
Cowdenbeath,6059,10,5,10,21,27,54,-27,25
Montrose,6060,1,23,8,5,61,36,25,77
Peterhead,6060,2,24,4,8,79,38,41,76
Stirling,6060,3,17,6,13,63,52,11,57
Stenhousem'r,6060,4,15,8,13,56,49,7,53
Clyde,6060,5,14,10,12,52,49,3,52
Elgin,6060,6,14,7,15,55,62,-7,49
Annan Athlet,6060,7,12,11,13,48,41,7,47
Berwick,6060,8,8,11,17,30,59,-29,35
Edinburgh Ci,6060,9,7,9,20,36,62,-26,30
Cowdenbeath,6060,10,4,10,22,23,55,-32,22
Montrose,6061,1,24,7,5,63,34,29,79
Peterhead,6061,2,24,4,8,80,38,42,76
Stirling,6061,3,17,6,13,62,51,11,57
Clyde,6061,4,15,9,12,56,48,8,54
Stenhousem'r,6061,5,15,8,13,55,48,7,53
Elgin,6061,6,14,6,16,53,64,-11,48
Annan Athlet,6061,7,12,11,13,48,41,7,47
Berwick,6061,8,8,10,18,29,63,-34,34
Edinburgh Ci,6061,9,7,9,20,36,63,-27,30
Cowdenbeath,6061,10,4,10,22,23,55,-32,22
Peterhead,6062,1,24,4,8,80,38,42,76
Montrose,6062,2,23,7,6,61,37,24,76
Stirling,6062,3,17,6,13,61,51,10,57
Clyde,6062,4,15,9,12,52,48,4,54
Stenhousem'r,6062,5,15,8,13,55,47,8,53
Elgin,6062,6,15,6,15,56,62,-6,51
Annan Athlet,6062,7,11,12,13,49,43,6,45
Berwick,6062,8,8,10,18,29,59,-30,34
Edinburgh Ci,6062,9,7,9,20,36,63,-27,30
Cowdenbeath,6062,10,4,11,21,25,56,-31,23
Peterhead,6063,1,24,4,8,79,38,41,76
Montrose,6063,2,23,7,6,60,36,24,76
Stirling,6063,3,17,6,13,62,51,11,57
Clyde,6063,4,15,9,12,53,48,5,54
Stenhousem'r,6063,5,15,8,13,55,48,7,53
Elgin,6063,6,15,6,15,55,61,-6,51
Annan Athlet,6063,7,11,12,13,48,42,6,45
Berwick,6063,8,8,10,18,29,60,-31,34
Edinburgh Ci,6063,9,7,9,20,36,62,-26,30
Cowdenbeath,6063,10,4,11,21,24,55,-31,23
Montrose,6064,1,23,8,5,59,34,25,77
Peterhead,6064,2,24,4,8,79,38,41,76
Stenhousem'r,6064,3,16,8,12,56,46,10,56
Stirling,6064,4,16,6,14,60,52,8,54
Clyde,6064,5,15,9,12,52,48,4,54
Elgin,6064,6,14,7,15,53,60,-7,49
Annan Athlet,6064,7,11,11,14,47,42,5,44
Berwick,6064,8,8,10,18,29,59,-30,34
Edinburgh Ci,6064,9,7,9,20,36,62,-26,30
Cowdenbeath,6064,10,5,10,21,24,54,-30,25
Montrose,6065,1,23,8,5,60,35,25,77
Peterhead,6065,2,24,4,8,81,39,42,76
Stenhousem'r,6065,3,16,8,12,57,46,11,56
Stirling,6065,4,16,6,14,60,53,7,54
Clyde,6065,5,14,10,12,52,49,3,52
Elgin,6065,6,14,7,15,54,61,-7,49
Annan Athlet,6065,7,11,12,13,48,42,6,45
Berwick,6065,8,8,11,17,30,59,-29,35
Edinburgh Ci,6065,9,7,9,20,37,64,-27,30
Cowdenbeath,6065,10,4,11,21,24,55,-31,23
Montrose,6066,1,24,7,5,61,35,26,79
Peterhead,6066,2,24,4,8,79,38,41,76
Stirling,6066,3,17,6,13,62,51,11,57
Clyde,6066,4,15,9,12,54,49,5,54
Stenhousem'r,6066,5,15,8,13,55,48,7,53
Elgin,6066,6,14,6,16,54,62,-8,48
Annan Athlet,6066,7,12,11,13,49,42,7,47
Berwick,6066,8,8,10,18,30,61,-31,34
Edinburgh Ci,6066,9,7,9,20,36,62,-26,30
Cowdenbeath,6066,10,4,10,22,24,56,-32,22
Montrose,6067,1,23,8,5,62,37,25,77
Peterhead,6067,2,24,4,8,80,38,42,76
Stirling,6067,3,16,7,13,63,54,9,55
Stenhousem'r,6067,4,15,9,12,58,49,9,54
Clyde,6067,5,15,9,12,52,48,4,54
Elgin,6067,6,14,7,15,56,63,-7,49
Annan Athlet,6067,7,11,12,13,47,41,6,45
Berwick,6067,8,8,10,18,29,59,-30,34
Edinburgh Ci,6067,9,7,9,20,36,63,-27,30
Cowdenbeath,6067,10,4,11,21,23,54,-31,23
Montrose,6068,1,24,7,5,61,35,26,79
Peterhead,6068,2,24,4,8,79,38,41,76
Stirling,6068,3,17,6,13,64,52,12,57
Stenhousem'r,6068,4,15,8,13,56,50,6,53
Clyde,6068,5,14,9,13,51,50,1,51
Elgin,6068,6,14,6,16,54,62,-8,48
Annan Athlet,6068,7,11,11,14,47,43,4,44
Berwick,6068,8,9,10,17,31,58,-27,37
Edinburgh Ci,6068,9,7,9,20,36,62,-26,30
Cowdenbeath,6068,10,5,10,21,25,54,-29,25
Peterhead,6069,1,24,4,8,83,39,44,76
Montrose,6069,2,23,7,6,60,36,24,76
Stirling,6069,3,17,6,13,61,51,10,57
Stenhousem'r,6069,4,15,8,13,55,47,8,53
Clyde,6069,5,14,10,12,52,49,3,52
Elgin,6069,6,15,6,15,55,61,-6,51
Annan Athlet,6069,7,11,11,14,47,42,5,44
Berwick,6069,8,8,11,17,30,59,-29,35
Edinburgh Ci,6069,9,7,9,20,37,66,-29,30
Cowdenbeath,6069,10,5,10,21,24,54,-30,25
Montrose,6070,1,24,7,5,62,35,27,79
Peterhead,6070,2,23,5,8,77,38,39,74
Stenhousem'r,6070,3,16,8,12,56,46,10,56
Stirling,6070,4,16,6,14,60,52,8,54
Clyde,6070,5,15,9,12,53,48,5,54
Elgin,6070,6,14,6,16,54,63,-9,48
Annan Athlet,6070,7,12,11,13,48,41,7,47
Berwick,6070,8,8,10,18,29,60,-31,34
Edinburgh Ci,6070,9,7,10,19,36,60,-24,31
Cowdenbeath,6070,10,4,10,22,23,55,-32,22
Montrose,6071,1,24,7,5,61,35,26,79
Peterhead,6071,2,23,5,8,78,39,39,74
Stirling,6071,3,17,6,13,61,51,10,57
Stenhousem'r,6071,4,15,8,13,55,47,8,53
Clyde,6071,5,14,10,12,51,48,3,52
Elgin,6071,6,14,6,16,54,62,-8,48
Annan Athlet,6071,7,12,11,13,48,41,7,47
Berwick,6071,8,8,11,17,29,58,-29,35
Edinburgh Ci,6071,9,7,10,19,37,61,-24,31
Cowdenbeath,6071,10,4,10,22,23,55,-32,22
Montrose,6072,1,24,7,5,62,36,26,79
Peterhead,6072,2,23,5,8,77,38,39,74
Stenhousem'r,6072,3,16,8,12,56,46,10,56
Stirling,6072,4,16,6,14,60,52,8,54
Clyde,6072,5,15,9,12,53,48,5,54
Elgin,6072,6,14,6,16,55,63,-8,48
Annan Athlet,6072,7,11,12,13,48,42,6,45
Berwick,6072,8,8,10,18,29,60,-31,34
Edinburgh Ci,6072,9,7,10,19,36,60,-24,31
Cowdenbeath,6072,10,4,11,21,24,55,-31,23
Montrose,6073,1,24,7,5,61,34,27,79
Peterhead,6073,2,24,4,8,81,38,43,76
Stirling,6073,3,17,6,13,62,52,10,57
Clyde,6073,4,15,9,12,52,48,4,54
Stenhousem'r,6073,5,15,8,13,56,48,8,53
Elgin,6073,6,14,6,16,53,62,-9,48
Annan Athlet,6073,7,11,12,13,48,42,6,45
Berwick,6073,8,8,10,18,29,59,-30,34
Edinburgh Ci,6073,9,7,9,20,36,64,-28,30
Cowdenbeath,6073,10,4,11,21,24,55,-31,23
Montrose,6074,1,24,7,5,61,35,26,79
Peterhead,6074,2,24,4,8,80,38,42,76
Stirling,6074,3,17,6,13,63,52,11,57
Clyde,6074,4,15,9,12,59,51,8,54
Stenhousem'r,6074,5,15,8,13,56,49,7,53
Elgin,6074,6,14,6,16,54,62,-8,48
Annan Athlet,6074,7,11,11,14,47,42,5,44
Berwick,6074,8,8,10,18,32,66,-34,34
Edinburgh Ci,6074,9,7,9,20,36,63,-27,30
Cowdenbeath,6074,10,5,10,21,24,54,-30,25
Montrose,6075,1,24,7,5,60,34,26,79
Peterhead,6075,2,23,4,9,79,41,38,73
Stirling,6075,3,16,7,13,61,52,9,55
Stenhousem'r,6075,4,15,9,12,56,47,9,54
Clyde,6075,5,15,9,12,56,50,6,54
Elgin,6075,6,14,6,16,53,61,-8,48
Annan Athlet,6075,7,12,11,13,50,42,8,47
Berwick,6075,8,8,10,18,31,63,-32,34
Edinburgh Ci,6075,9,8,9,19,39,62,-23,33
Cowdenbeath,6075,10,4,10,22,24,57,-33,22
Peterhead,6076,1,24,4,8,83,38,45,76
Montrose,6076,2,23,7,6,59,36,23,76
Stirling,6076,3,17,6,13,62,51,11,57
Clyde,6076,4,15,9,12,54,49,5,54
Stenhousem'r,6076,5,15,8,13,55,48,7,53
Elgin,6076,6,15,6,15,55,60,-5,51
Annan Athlet,6076,7,12,11,13,48,41,7,47
Berwick,6076,8,8,10,18,30,61,-31,34
Edinburgh Ci,6076,9,7,9,20,36,66,-30,30
Cowdenbeath,6076,10,4,10,22,23,55,-32,22
Montrose,6077,1,24,7,5,62,35,27,79
Peterhead,6077,2,24,4,8,80,38,42,76
Stenhousem'r,6077,3,16,8,12,59,49,10,56
Stirling,6077,4,16,6,14,63,55,8,54
Clyde,6077,5,14,9,13,51,49,2,51
Elgin,6077,6,14,6,16,54,63,-9,48
Annan Athlet,6077,7,12,11,13,48,41,7,47
Berwick,6077,8,9,10,17,30,58,-28,37
Edinburgh Ci,6077,9,7,9,20,36,63,-27,30
Cowdenbeath,6077,10,4,10,22,23,55,-32,22
Montrose,6078,1,23,7,6,61,38,23,76
Peterhead,6078,2,23,5,8,78,39,39,74
Stirling,6078,3,17,6,13,63,51,12,57
Stenhousem'r,6078,4,15,8,13,55,49,6,53
Clyde,6078,5,14,10,12,51,48,3,52
Elgin,6078,6,15,6,15,57,62,-5,51
Annan Athlet,6078,7,11,12,13,47,41,6,45
Berwick,6078,8,8,11,17,29,58,-29,35
Edinburgh Ci,6078,9,7,10,19,37,61,-24,31
Cowdenbeath,6078,10,4,11,21,23,54,-31,23
Peterhead,6079,1,24,4,8,79,38,41,76
Montrose,6079,2,23,7,6,60,37,23,76
Stenhousem'r,6079,3,16,8,12,56,46,10,56
Stirling,6079,4,16,6,14,60,52,8,54
Clyde,6079,5,14,10,12,54,51,3,52
Elgin,6079,6,15,6,15,56,61,-5,51
Annan Athlet,6079,7,12,11,13,49,41,8,47
Berwick,6079,8,8,11,17,32,61,-29,35
Edinburgh Ci,6079,9,7,9,20,36,62,-26,30
Cowdenbeath,6079,10,4,10,22,23,56,-33,22
Montrose,6080,1,23,7,6,59,36,23,76
Peterhead,6080,2,23,5,8,80,41,39,74
Stirling,6080,3,17,6,13,64,51,13,57
Clyde,6080,4,15,9,12,56,49,7,54
Stenhousem'r,6080,5,15,8,13,55,50,5,53
Elgin,6080,6,15,6,15,55,60,-5,51
Annan Athlet,6080,7,11,12,13,49,43,6,45
Berwick,6080,8,8,10,18,30,63,-33,34
Edinburgh Ci,6080,9,7,10,19,39,63,-24,31
Cowdenbeath,6080,10,4,11,21,25,56,-31,23
Montrose,6081,1,24,7,5,60,34,26,79
Peterhead,6081,2,24,4,8,80,40,40,76
Stirling,6081,3,16,7,13,62,53,9,55
Stenhousem'r,6081,4,15,9,12,57,48,9,54
Clyde,6081,5,15,9,12,53,48,5,54
Elgin,6081,6,14,6,16,53,61,-8,48
Annan Athlet,6081,7,11,12,13,50,44,6,45
Berwick,6081,8,8,10,18,29,60,-31,34
Edinburgh Ci,6081,9,7,9,20,38,63,-25,30
Cowdenbeath,6081,10,4,11,21,26,57,-31,23
Montrose,6082,1,23,8,5,60,35,25,77
Peterhead,6082,2,24,4,8,79,38,41,76
Stirling,6082,3,17,6,13,62,51,11,57
Stenhousem'r,6082,4,15,8,13,55,48,7,53
Clyde,6082,5,14,9,13,51,49,2,51
Elgin,6082,6,14,7,15,54,61,-7,49
Annan Athlet,6082,7,11,12,13,48,42,6,45
Berwick,6082,8,9,10,17,30,58,-28,37
Edinburgh Ci,6082,9,7,9,20,36,62,-26,30
Cowdenbeath,6082,10,4,11,21,24,55,-31,23
Montrose,6083,1,23,8,5,59,34,25,77
Peterhead,6083,2,23,5,8,78,39,39,74
Stenhousem'r,6083,3,16,8,12,56,46,10,56
Stirling,6083,4,16,6,14,60,52,8,54
Clyde,6083,5,14,9,13,52,51,1,51
Elgin,6083,6,14,7,15,53,60,-7,49
Annan Athlet,6083,7,12,11,13,48,41,7,47
Berwick,6083,8,9,10,17,32,59,-27,37
Edinburgh Ci,6083,9,7,10,19,37,61,-24,31
Cowdenbeath,6083,10,4,10,22,23,55,-32,22
Montrose,6084,1,24,7,5,62,36,26,79
Peterhead,6084,2,24,4,8,80,40,40,76
Stirling,6084,3,17,6,13,61,51,10,57
Clyde,6084,4,15,9,12,53,48,5,54
Stenhousem'r,6084,5,15,8,13,55,47,8,53
Elgin,6084,6,14,6,16,55,63,-8,48
Annan Athlet,6084,7,11,11,14,48,43,5,44
Berwick,6084,8,8,10,18,29,60,-31,34
Edinburgh Ci,6084,9,7,9,20,38,63,-25,30
Cowdenbeath,6084,10,5,10,21,25,55,-30,25
Montrose,6085,1,24,7,5,61,34,27,79
Peterhead,6085,2,24,4,8,80,39,41,76
Stirling,6085,3,17,6,13,61,51,10,57
Stenhousem'r,6085,4,15,8,13,55,47,8,53
Clyde,6085,5,14,10,12,51,48,3,52
Elgin,6085,6,14,6,16,53,62,-9,48
Annan Athlet,6085,7,11,12,13,49,43,6,45
Berwick,6085,8,8,11,17,29,58,-29,35
Edinburgh Ci,6085,9,7,9,20,37,63,-26,30
Cowdenbeath,6085,10,4,11,21,25,56,-31,23
Montrose,6086,1,24,7,5,62,35,27,79
Peterhead,6086,2,23,4,9,77,39,38,73
Stirling,6086,3,16,7,13,62,53,9,55
Stenhousem'r,6086,4,15,9,12,57,48,9,54
Clyde,6086,5,14,10,12,52,49,3,52
Elgin,6086,6,14,6,16,54,63,-9,48
Annan Athlet,6086,7,11,12,13,47,41,6,45
Berwick,6086,8,8,11,17,30,59,-29,35
Edinburgh Ci,6086,9,8,9,19,37,60,-23,33
Cowdenbeath,6086,10,4,11,21,23,54,-31,23
Montrose,6087,1,24,7,5,62,35,27,79
Peterhead,6087,2,24,4,8,79,38,41,76
Stenhousem'r,6087,3,16,8,12,56,46,10,56
Stirling,6087,4,16,6,14,60,52,8,54
Clyde,6087,5,14,10,12,51,48,3,52
Elgin,6087,6,14,6,16,54,63,-9,48
Annan Athlet,6087,7,12,11,13,51,41,10,47
Berwick,6087,8,8,11,17,29,58,-29,35
Edinburgh Ci,6087,9,7,9,20,36,62,-26,30
Cowdenbeath,6087,10,4,10,22,23,58,-35,22
Peterhead,6088,1,24,4,8,78,38,40,76
Montrose,6088,2,23,7,6,60,37,23,76
Stirling,6088,3,17,6,13,63,51,12,57
Stenhousem'r,6088,4,15,8,13,55,49,6,53
Clyde,6088,5,14,10,12,51,48,3,52
Elgin,6088,6,15,6,15,56,61,-5,51
Annan Athlet,6088,7,12,11,13,48,41,7,47
Berwick,6088,8,8,11,17,29,58,-29,35
Edinburgh Ci,6088,9,7,9,20,36,61,-25,30
Cowdenbeath,6088,10,4,10,22,23,55,-32,22
Peterhead,6089,1,24,4,8,84,41,43,76
Montrose,6089,2,23,7,6,62,38,24,76
Stirling,6089,3,16,7,13,62,53,9,55
Stenhousem'r,6089,4,15,9,12,57,48,9,54
Clyde,6089,5,15,9,12,53,48,5,54
Elgin,6089,6,15,6,15,57,63,-6,51
Annan Athlet,6089,7,11,11,14,47,42,5,44
Berwick,6089,8,8,10,18,29,60,-31,34
Edinburgh Ci,6089,9,7,9,20,39,67,-28,30
Cowdenbeath,6089,10,5,10,21,24,54,-30,25
Montrose,6090,1,24,7,5,64,36,28,79
Peterhead,6090,2,24,4,8,83,38,45,76
Stenhousem'r,6090,3,16,8,12,57,46,11,56
Stirling,6090,4,16,6,14,60,53,7,54
Clyde,6090,5,14,9,13,51,49,2,51
Elgin,6090,6,14,6,16,55,65,-10,48
Annan Athlet,6090,7,12,11,13,50,43,7,47
Berwick,6090,8,9,10,17,30,58,-28,37
Edinburgh Ci,6090,9,7,9,20,36,66,-30,30
Cowdenbeath,6090,10,4,10,22,25,57,-32,22
Montrose,6091,1,24,7,5,64,34,30,79
Peterhead,6091,2,24,4,8,80,39,41,76
Stirling,6091,3,16,7,13,60,51,9,55
Stenhousem'r,6091,4,15,9,12,55,46,9,54
Clyde,6091,5,14,10,12,54,51,3,52
Elgin,6091,6,14,6,16,53,65,-12,48
Annan Athlet,6091,7,12,11,13,49,41,8,47
Berwick,6091,8,8,11,17,32,61,-29,35
Edinburgh Ci,6091,9,7,9,20,37,63,-26,30
Cowdenbeath,6091,10,4,10,22,23,56,-33,22
Montrose,6092,1,23,8,5,60,35,25,77
Peterhead,6092,2,24,4,8,81,39,42,76
Stirling,6092,3,16,7,13,60,51,9,55
Stenhousem'r,6092,4,15,9,12,55,46,9,54
Clyde,6092,5,15,9,12,54,48,6,54
Elgin,6092,6,14,7,15,54,61,-7,49
Annan Athlet,6092,7,11,11,14,48,43,5,44
Berwick,6092,8,8,10,18,29,61,-32,34
Edinburgh Ci,6092,9,7,9,20,37,64,-27,30
Cowdenbeath,6092,10,5,10,21,25,55,-30,25
Montrose,6093,1,24,7,5,61,34,27,79
Peterhead,6093,2,23,4,9,78,42,36,73
Stenhousem'r,6093,3,16,8,12,57,47,10,56
Stirling,6093,4,16,6,14,61,53,8,54
Clyde,6093,5,15,9,12,52,48,4,54
Elgin,6093,6,14,6,16,53,62,-9,48
Annan Athlet,6093,7,12,11,13,48,41,7,47
Berwick,6093,8,8,10,18,29,59,-30,34
Edinburgh Ci,6093,9,8,9,19,40,61,-21,33
Cowdenbeath,6093,10,4,10,22,23,55,-32,22
Montrose,6094,1,23,8,5,61,36,25,77
Peterhead,6094,2,24,4,8,79,39,40,76
Stirling,6094,3,17,6,13,64,53,11,57
Clyde,6094,4,15,9,12,53,48,5,54
Stenhousem'r,6094,5,15,8,13,57,50,7,53
Elgin,6094,6,14,7,15,55,62,-7,49
Annan Athlet,6094,7,12,11,13,49,41,8,47
Berwick,6094,8,8,10,18,29,60,-31,34
Edinburgh Ci,6094,9,7,9,20,37,62,-25,30
Cowdenbeath,6094,10,4,10,22,23,56,-33,22
Montrose,6095,1,24,7,5,62,34,28,79
Peterhead,6095,2,24,4,8,80,38,42,76
Stenhousem'r,6095,3,16,8,12,58,48,10,56
Stirling,6095,4,16,6,14,62,54,8,54
Clyde,6095,5,14,10,12,51,48,3,52
Elgin,6095,6,14,6,16,53,63,-10,48
Annan Athlet,6095,7,11,11,14,47,42,5,44
Berwick,6095,8,8,11,17,29,58,-29,35
Edinburgh Ci,6095,9,7,9,20,36,63,-27,30
Cowdenbeath,6095,10,5,10,21,24,54,-30,25
Montrose,6096,1,23,8,5,61,36,25,77
Peterhead,6096,2,24,4,8,79,39,40,76
Stirling,6096,3,17,6,13,62,51,11,57
Clyde,6096,4,15,9,12,53,49,4,54
Stenhousem'r,6096,5,15,8,13,55,48,7,53
Elgin,6096,6,14,7,15,55,62,-7,49
Annan Athlet,6096,7,11,11,14,47,42,5,44
Berwick,6096,8,8,10,18,30,60,-30,34
Edinburgh Ci,6096,9,7,9,20,37,62,-25,30
Cowdenbeath,6096,10,5,10,21,24,54,-30,25
Montrose,6097,1,23,8,5,60,35,25,77
Peterhead,6097,2,24,4,8,79,39,40,76
Stirling,6097,3,16,7,13,62,53,9,55
Stenhousem'r,6097,4,15,9,12,57,48,9,54
Clyde,6097,5,15,9,12,53,49,4,54
Elgin,6097,6,14,7,15,54,61,-7,49
Annan Athlet,6097,7,12,11,13,48,41,7,47
Berwick,6097,8,8,10,18,30,60,-30,34
Edinburgh Ci,6097,9,7,9,20,37,62,-25,30
Cowdenbeath,6097,10,4,10,22,23,55,-32,22
Peterhead,6098,1,24,4,8,79,39,40,76
Montrose,6098,2,23,7,6,60,36,24,76
Stirling,6098,3,17,6,13,61,51,10,57
Clyde,6098,4,15,9,12,53,48,5,54
Stenhousem'r,6098,5,15,8,13,55,47,8,53
Elgin,6098,6,15,6,15,55,61,-6,51
Annan Athlet,6098,7,11,11,14,47,42,5,44
Berwick,6098,8,8,10,18,29,60,-31,34
Edinburgh Ci,6098,9,7,9,20,37,62,-25,30
Cowdenbeath,6098,10,5,10,21,24,54,-30,25
Peterhead,6099,1,24,4,8,80,39,41,76
Montrose,6099,2,23,7,6,60,36,24,76
Stenhousem'r,6099,3,16,8,12,57,47,10,56
Stirling,6099,4,16,6,14,61,53,8,54
Clyde,6099,5,14,10,12,52,49,3,52
Elgin,6099,6,15,6,15,55,61,-6,51
Annan Athlet,6099,7,11,12,13,48,42,6,45
Berwick,6099,8,8,11,17,30,59,-29,35
Edinburgh Ci,6099,9,7,9,20,37,63,-26,30
Cowdenbeath,6099,10,4,11,21,24,55,-31,23
Montrose,6100,1,24,7,5,61,34,27,79
Peterhead,6100,2,24,4,8,81,38,43,76
Stirling,6100,3,17,6,13,61,51,10,57
Clyde,6100,4,15,9,12,52,48,4,54
Stenhousem'r,6100,5,15,8,13,55,47,8,53
Elgin,6100,6,14,6,16,53,62,-9,48
Annan Athlet,6100,7,11,12,13,48,42,6,45
Berwick,6100,8,8,10,18,29,59,-30,34
Edinburgh Ci,6100,9,7,9,20,36,64,-28,30
Cowdenbeath,6100,10,4,11,21,24,55,-31,23
Montrose,6101,1,24,7,5,63,34,29,79
Peterhead,6101,2,24,4,8,80,39,41,76
Stirling,6101,3,17,6,13,62,51,11,57
Clyde,6101,4,15,9,12,53,49,4,54
Stenhousem'r,6101,5,15,8,13,55,48,7,53
Elgin,6101,6,14,6,16,53,64,-11,48
Annan Athlet,6101,7,11,12,13,47,41,6,45
Berwick,6101,8,8,10,18,30,60,-30,34
Edinburgh Ci,6101,9,7,9,20,37,63,-26,30
Cowdenbeath,6101,10,4,11,21,23,54,-31,23
Montrose,6102,1,24,7,5,61,34,27,79
Peterhead,6102,2,24,4,8,80,38,42,76
Stirling,6102,3,17,6,13,63,51,12,57
Stenhousem'r,6102,4,15,8,13,55,49,6,53
Clyde,6102,5,14,9,13,51,50,1,51
Elgin,6102,6,14,6,16,53,62,-9,48
Annan Athlet,6102,7,11,11,14,47,46,1,44
Berwick,6102,8,9,10,17,31,58,-27,37
Edinburgh Ci,6102,9,7,9,20,36,63,-27,30
Cowdenbeath,6102,10,5,10,21,28,54,-26,25
Peterhead,6103,1,24,4,8,80,40,40,76
Montrose,6103,2,23,7,6,59,36,23,76
Stenhousem'r,6103,3,16,8,12,57,47,10,56
Stirling,6103,4,16,6,14,61,53,8,54
Clyde,6103,5,15,9,12,53,49,4,54
Elgin,6103,6,15,6,15,55,60,-5,51
Annan Athlet,6103,7,11,12,13,47,41,6,45
Berwick,6103,8,8,10,18,30,60,-30,34
Edinburgh Ci,6103,9,7,9,20,38,63,-25,30
Cowdenbeath,6103,10,4,11,21,23,54,-31,23
Montrose,6104,1,23,8,5,60,35,25,77
Peterhead,6104,2,24,4,8,81,39,42,76
Stirling,6104,3,17,6,13,62,52,10,57
Stenhousem'r,6104,4,15,8,13,56,48,8,53
Clyde,6104,5,14,9,13,51,50,1,51
Elgin,6104,6,14,7,15,54,61,-7,49
Annan Athlet,6104,7,12,11,13,51,41,10,47
Berwick,6104,8,9,10,17,31,58,-27,37
Edinburgh Ci,6104,9,7,9,20,37,64,-27,30
Cowdenbeath,6104,10,4,10,22,23,58,-35,22
Montrose,6105,1,24,7,5,61,35,26,79
Peterhead,6105,2,24,4,8,78,38,40,76
Stirling,6105,3,17,6,13,61,51,10,57
Clyde,6105,4,15,9,12,54,50,4,54
Stenhousem'r,6105,5,15,8,13,55,47,8,53
Elgin,6105,6,14,6,16,54,62,-8,48
Annan Athlet,6105,7,11,11,14,48,43,5,44
Berwick,6105,8,8,10,18,31,61,-30,34
Edinburgh Ci,6105,9,7,9,20,36,61,-25,30
Cowdenbeath,6105,10,5,10,21,25,55,-30,25
Montrose,6106,1,24,7,5,62,36,26,79
Peterhead,6106,2,24,4,8,85,39,46,76
Stirling,6106,3,17,6,13,62,52,10,57
Clyde,6106,4,15,9,12,57,50,7,54
Stenhousem'r,6106,5,15,8,13,56,48,8,53
Elgin,6106,6,14,6,16,55,63,-8,48
Annan Athlet,6106,7,11,12,13,48,42,6,45
Berwick,6106,8,8,10,18,31,64,-33,34
Edinburgh Ci,6106,9,7,9,20,37,68,-31,30
Cowdenbeath,6106,10,4,11,21,24,55,-31,23
Montrose,6107,1,23,8,5,59,34,25,77
Peterhead,6107,2,23,4,9,78,40,38,73
Stenhousem'r,6107,3,16,8,12,57,47,10,56
Stirling,6107,4,16,6,14,61,53,8,54
Clyde,6107,5,15,9,12,56,50,6,54
Elgin,6107,6,14,7,15,53,60,-7,49
Annan Athlet,6107,7,12,11,13,48,41,7,47
Berwick,6107,8,8,10,18,31,63,-32,34
Edinburgh Ci,6107,9,8,9,19,38,61,-23,33
Cowdenbeath,6107,10,4,10,22,23,55,-32,22
Montrose,6108,1,24,7,5,62,36,26,79
Peterhead,6108,2,24,4,8,81,38,43,76
Stirling,6108,3,17,6,13,63,51,12,57
Stenhousem'r,6108,4,15,8,13,55,49,6,53
Clyde,6108,5,14,10,12,51,48,3,52
Elgin,6108,6,14,6,16,55,63,-8,48
Annan Athlet,6108,7,11,11,14,47,42,5,44
Berwick,6108,8,8,11,17,29,58,-29,35
Edinburgh Ci,6108,9,7,9,20,36,64,-28,30
Cowdenbeath,6108,10,5,10,21,24,54,-30,25
Montrose,6109,1,23,8,5,59,34,25,77
Peterhead,6109,2,24,4,8,79,39,40,76
Stirling,6109,3,17,6,13,62,52,10,57
Clyde,6109,4,15,9,12,53,48,5,54
Stenhousem'r,6109,5,15,8,13,56,48,8,53
Elgin,6109,6,14,7,15,53,60,-7,49
Annan Athlet,6109,7,11,12,13,48,42,6,45
Berwick,6109,8,8,10,18,29,60,-31,34
Edinburgh Ci,6109,9,7,9,20,37,62,-25,30
Cowdenbeath,6109,10,4,11,21,24,55,-31,23
Montrose,6110,1,24,7,5,62,34,28,79
Peterhead,6110,2,23,5,8,79,40,39,74
Stirling,6110,3,16,7,13,60,51,9,55
Stenhousem'r,6110,4,15,9,12,55,46,9,54
Clyde,6110,5,15,9,12,55,49,6,54
Elgin,6110,6,14,6,16,53,63,-10,48
Annan Athlet,6110,7,11,11,14,47,42,5,44
Berwick,6110,8,8,10,18,30,62,-32,34
Edinburgh Ci,6110,9,7,10,19,38,62,-24,31
Cowdenbeath,6110,10,5,10,21,24,54,-30,25
Montrose,6111,1,24,7,5,61,35,26,79
Peterhead,6111,2,24,4,8,79,39,40,76
Stirling,6111,3,16,7,13,60,51,9,55
Stenhousem'r,6111,4,15,9,12,55,46,9,54
Clyde,6111,5,15,9,12,52,48,4,54
Elgin,6111,6,14,6,16,54,62,-8,48
Annan Athlet,6111,7,11,11,14,47,42,5,44
Berwick,6111,8,8,10,18,29,59,-30,34
Edinburgh Ci,6111,9,7,9,20,37,62,-25,30
Cowdenbeath,6111,10,5,10,21,24,54,-30,25
Montrose,6112,1,23,8,5,61,36,25,77
Peterhead,6112,2,23,4,9,78,40,38,73
Stirling,6112,3,17,6,13,61,51,10,57
Clyde,6112,4,15,9,12,54,48,6,54
Stenhousem'r,6112,5,15,8,13,55,47,8,53
Elgin,6112,6,14,7,15,55,62,-7,49
Annan Athlet,6112,7,12,11,13,48,41,7,47
Berwick,6112,8,8,10,18,29,61,-32,34
Edinburgh Ci,6112,9,8,9,19,38,61,-23,33
Cowdenbeath,6112,10,4,10,22,23,55,-32,22
Montrose,6113,1,24,7,5,60,34,26,79
Peterhead,6113,2,24,4,8,83,38,45,76
Stirling,6113,3,17,6,13,63,52,11,57
Stenhousem'r,6113,4,15,8,13,56,49,7,53
Clyde,6113,5,14,9,13,51,49,2,51
Elgin,6113,6,14,6,16,53,61,-8,48
Annan Athlet,6113,7,11,11,14,47,42,5,44
Berwick,6113,8,9,10,17,30,58,-28,37
Edinburgh Ci,6113,9,7,9,20,36,66,-30,30
Cowdenbeath,6113,10,5,10,21,24,54,-30,25
Montrose,6114,1,24,7,5,62,34,28,79
Peterhead,6114,2,24,4,8,82,38,44,76
Stirling,6114,3,17,6,13,64,52,12,57
Stenhousem'r,6114,4,15,8,13,56,50,6,53
Clyde,6114,5,14,9,13,53,53,0,51
Elgin,6114,6,14,6,16,53,63,-10,48
Annan Athlet,6114,7,11,12,13,47,41,6,45
Berwick,6114,8,9,10,17,34,60,-26,37
Edinburgh Ci,6114,9,7,9,20,36,65,-29,30
Cowdenbeath,6114,10,4,11,21,23,54,-31,23
Montrose,6115,1,24,7,5,61,35,26,79
Peterhead,6115,2,23,5,8,77,38,39,74
Stirling,6115,3,17,6,13,63,51,12,57
Clyde,6115,4,15,9,12,53,49,4,54
Stenhousem'r,6115,5,15,8,13,55,49,6,53
Elgin,6115,6,14,6,16,54,62,-8,48
Annan Athlet,6115,7,11,11,14,47,42,5,44
Berwick,6115,8,8,10,18,30,60,-30,34
Edinburgh Ci,6115,9,7,10,19,36,60,-24,31
Cowdenbeath,6115,10,5,10,21,24,54,-30,25
Montrose,6116,1,23,8,5,60,35,25,77
Peterhead,6116,2,24,4,8,78,38,40,76
Stenhousem'r,6116,3,16,8,12,57,46,11,56
Stirling,6116,4,16,6,14,60,53,7,54
Clyde,6116,5,14,9,13,51,50,1,51
Elgin,6116,6,14,7,15,54,61,-7,49
Annan Athlet,6116,7,12,11,13,49,42,7,47
Berwick,6116,8,9,10,17,31,58,-27,37
Edinburgh Ci,6116,9,7,9,20,36,61,-25,30
Cowdenbeath,6116,10,4,10,22,24,56,-32,22
Montrose,6117,1,24,7,5,62,35,27,79
Peterhead,6117,2,23,5,8,78,39,39,74
Stirling,6117,3,17,6,13,65,54,11,57
Stenhousem'r,6117,4,15,8,13,58,51,7,53
Clyde,6117,5,14,9,13,52,50,2,51
Elgin,6117,6,14,6,16,54,63,-9,48
Annan Athlet,6117,7,12,11,13,50,43,7,47
Berwick,6117,8,9,10,17,31,59,-28,37
Edinburgh Ci,6117,9,7,10,19,37,61,-24,31
Cowdenbeath,6117,10,4,10,22,25,57,-32,22
Peterhead,6118,1,24,4,8,82,41,41,76
Montrose,6118,2,23,7,6,60,36,24,76
Stenhousem'r,6118,3,16,8,12,59,49,10,56
Stirling,6118,4,16,6,14,63,55,8,54
Clyde,6118,5,14,10,12,52,49,3,52
Elgin,6118,6,15,6,15,55,61,-6,51
Annan Athlet,6118,7,11,11,14,47,43,4,44
Berwick,6118,8,8,11,17,30,59,-29,35
Edinburgh Ci,6118,9,7,9,20,39,65,-26,30
Cowdenbeath,6118,10,5,10,21,25,54,-29,25
Montrose,6119,1,23,8,5,60,35,25,77
Peterhead,6119,2,24,4,8,81,39,42,76
Stirling,6119,3,17,6,13,62,51,11,57
Stenhousem'r,6119,4,15,8,13,55,48,7,53
Clyde,6119,5,14,10,12,53,50,3,52
Elgin,6119,6,14,7,15,54,61,-7,49
Annan Athlet,6119,7,11,11,14,48,44,4,44
Berwick,6119,8,8,11,17,31,60,-29,35
Edinburgh Ci,6119,9,7,9,20,37,64,-27,30
Cowdenbeath,6119,10,5,10,21,26,55,-29,25
Montrose,6120,1,23,7,6,59,35,24,76
Peterhead,6120,2,23,4,9,79,41,38,73
Stirling,6120,3,17,6,13,62,52,10,57
Stenhousem'r,6120,4,15,8,13,56,48,8,53
Clyde,6120,5,14,9,13,51,50,1,51
Elgin,6120,6,15,6,15,54,60,-6,51
Annan Athlet,6120,7,11,11,14,48,43,5,44
Berwick,6120,8,9,10,17,31,58,-27,37
Edinburgh Ci,6120,9,8,9,19,39,62,-23,33
Cowdenbeath,6120,10,5,10,21,25,55,-30,25
Montrose,6121,1,24,7,5,62,35,27,79
Peterhead,6121,2,23,4,9,78,41,37,73
Stirling,6121,3,16,7,13,61,52,9,55
Stenhousem'r,6121,4,15,9,12,56,47,9,54
Clyde,6121,5,14,10,12,53,50,3,52
Elgin,6121,6,14,6,16,54,63,-9,48
Annan Athlet,6121,7,11,11,14,47,45,2,44
Berwick,6121,8,8,11,17,31,60,-29,35
Edinburgh Ci,6121,9,8,9,19,39,61,-22,33
Cowdenbeath,6121,10,5,10,21,27,54,-27,25
Montrose,6122,1,24,7,5,61,34,27,79
Peterhead,6122,2,24,4,8,81,38,43,76
Stirling,6122,3,17,6,13,64,53,11,57
Clyde,6122,4,15,9,12,54,48,6,54
Stenhousem'r,6122,5,15,8,13,57,50,7,53
Elgin,6122,6,14,6,16,53,62,-9,48
Annan Athlet,6122,7,11,12,13,47,41,6,45
Berwick,6122,8,8,10,18,29,61,-32,34
Edinburgh Ci,6122,9,7,9,20,36,64,-28,30
Cowdenbeath,6122,10,4,11,21,23,54,-31,23
Montrose,6123,1,23,8,5,60,35,25,77
Peterhead,6123,2,24,4,8,78,38,40,76
Stenhousem'r,6123,3,16,8,12,58,48,10,56
Stirling,6123,4,16,6,14,62,54,8,54
Clyde,6123,5,15,9,12,54,48,6,54
Elgin,6123,6,14,7,15,54,61,-7,49
Annan Athlet,6123,7,11,12,13,47,41,6,45
Berwick,6123,8,8,10,18,29,61,-32,34
Edinburgh Ci,6123,9,7,9,20,36,61,-25,30
Cowdenbeath,6123,10,4,11,21,23,54,-31,23
Montrose,6124,1,24,7,5,63,36,27,79
Peterhead,6124,2,24,4,8,78,38,40,76
Stirling,6124,3,17,6,13,66,51,15,57
Clyde,6124,4,15,9,12,52,48,4,54
Stenhousem'r,6124,5,15,8,13,55,52,3,53
Elgin,6124,6,14,6,16,55,64,-9,48
Annan Athlet,6124,7,12,11,13,48,41,7,47
Berwick,6124,8,8,10,18,29,59,-30,34
Edinburgh Ci,6124,9,7,9,20,36,61,-25,30
Cowdenbeath,6124,10,4,10,22,23,55,-32,22
Montrose,6125,1,23,8,5,61,36,25,77
Peterhead,6125,2,24,4,8,80,38,42,76
Stenhousem'r,6125,3,16,8,12,56,46,10,56
Stirling,6125,4,16,6,14,60,52,8,54
Clyde,6125,5,14,9,13,51,50,1,51
Elgin,6125,6,14,7,15,55,62,-7,49
Annan Athlet,6125,7,12,11,13,48,41,7,47
Berwick,6125,8,9,10,17,31,58,-27,37
Edinburgh Ci,6125,9,7,9,20,36,63,-27,30
Cowdenbeath,6125,10,4,10,22,23,55,-32,22
Montrose,6126,1,24,7,5,63,34,29,79
Peterhead,6126,2,23,4,9,77,41,36,73
Stirling,6126,3,17,6,13,62,52,10,57
Clyde,6126,4,15,9,12,52,48,4,54
Stenhousem'r,6126,5,15,8,13,56,48,8,53
Elgin,6126,6,14,6,16,53,64,-11,48
Annan Athlet,6126,7,11,12,13,48,42,6,45
Berwick,6126,8,8,10,18,29,59,-30,34
Edinburgh Ci,6126,9,8,9,19,39,60,-21,33
Cowdenbeath,6126,10,4,11,21,24,55,-31,23
Peterhead,6127,1,24,4,8,80,38,42,76
Montrose,6127,2,23,7,6,59,35,24,76
Stirling,6127,3,17,6,13,61,51,10,57
Stenhousem'r,6127,4,15,8,13,55,47,8,53
Clyde,6127,5,14,10,12,52,49,3,52
Elgin,6127,6,15,6,15,54,60,-6,51
Annan Athlet,6127,7,12,11,13,48,41,7,47
Berwick,6127,8,8,11,17,30,59,-29,35
Edinburgh Ci,6127,9,7,9,20,36,63,-27,30
Cowdenbeath,6127,10,4,10,22,23,55,-32,22
Montrose,6128,1,24,7,5,60,34,26,79
Peterhead,6128,2,24,4,8,79,38,41,76
Stirling,6128,3,17,6,13,63,53,10,57
Clyde,6128,4,15,9,12,54,48,6,54
Stenhousem'r,6128,5,15,8,13,57,49,8,53
Elgin,6128,6,14,6,16,53,61,-8,48
Annan Athlet,6128,7,12,11,13,49,41,8,47
Berwick,6128,8,8,10,18,29,61,-32,34
Edinburgh Ci,6128,9,7,9,20,36,62,-26,30
Cowdenbeath,6128,10,4,10,22,23,56,-33,22
Montrose,6129,1,23,8,5,59,34,25,77
Peterhead,6129,2,24,4,8,79,38,41,76
Stenhousem'r,6129,3,16,8,12,60,46,14,56
Stirling,6129,4,16,6,14,60,56,4,54
Clyde,6129,5,15,9,12,52,48,4,54
Elgin,6129,6,14,7,15,53,60,-7,49
Annan Athlet,6129,7,11,12,13,48,42,6,45
Berwick,6129,8,8,10,18,29,59,-30,34
Edinburgh Ci,6129,9,7,9,20,36,62,-26,30
Cowdenbeath,6129,10,4,11,21,24,55,-31,23
Montrose,6130,1,24,7,5,61,34,27,79
Peterhead,6130,2,24,4,8,79,39,40,76
Stirling,6130,3,17,6,13,62,52,10,57
Stenhousem'r,6130,4,15,8,13,56,48,8,53
Clyde,6130,5,14,10,12,51,48,3,52
Elgin,6130,6,14,6,16,53,62,-9,48
Annan Athlet,6130,7,11,12,13,47,41,6,45
Berwick,6130,8,8,11,17,29,58,-29,35
Edinburgh Ci,6130,9,7,9,20,37,62,-25,30
Cowdenbeath,6130,10,4,11,21,23,54,-31,23
Peterhead,6131,1,24,4,8,80,39,41,76
Montrose,6131,2,23,7,6,59,35,24,76
Stirling,6131,3,17,6,13,64,51,13,57
Stenhousem'r,6131,4,15,8,13,55,50,5,53
Clyde,6131,5,14,10,12,51,48,3,52
Elgin,6131,6,15,6,15,54,60,-6,51
Annan Athlet,6131,7,12,11,13,48,41,7,47
Berwick,6131,8,8,11,17,29,58,-29,35
Edinburgh Ci,6131,9,7,9,20,37,63,-26,30
Cowdenbeath,6131,10,4,10,22,23,55,-32,22
Montrose,6132,1,24,7,5,64,34,30,79
Peterhead,6132,2,24,4,8,82,38,44,76
Stirling,6132,3,16,7,13,61,52,9,55
Stenhousem'r,6132,4,15,9,12,56,47,9,54
Clyde,6132,5,15,9,12,53,49,4,54
Elgin,6132,6,14,6,16,53,65,-12,48
Annan Athlet,6132,7,12,11,13,49,41,8,47
Berwick,6132,8,8,10,18,30,60,-30,34
Edinburgh Ci,6132,9,7,9,20,36,65,-29,30
Cowdenbeath,6132,10,4,10,22,23,56,-33,22
Montrose,6133,1,23,8,5,60,35,25,77
Peterhead,6133,2,24,4,8,81,38,43,76
Stirling,6133,3,17,6,13,63,51,12,57
Clyde,6133,4,15,9,12,52,48,4,54
Stenhousem'r,6133,5,15,8,13,55,49,6,53
Elgin,6133,6,14,7,15,54,61,-7,49
Annan Athlet,6133,7,11,12,13,48,42,6,45
Berwick,6133,8,8,10,18,29,59,-30,34
Edinburgh Ci,6133,9,7,9,20,36,64,-28,30
Cowdenbeath,6133,10,4,11,21,24,55,-31,23
Montrose,6134,1,24,7,5,63,36,27,79
Peterhead,6134,2,24,4,8,80,38,42,76
Stirling,6134,3,16,7,13,63,54,9,55
Stenhousem'r,6134,4,15,9,12,58,49,9,54
Clyde,6134,5,14,10,12,54,51,3,52
Elgin,6134,6,14,6,16,55,64,-9,48
Annan Athlet,6134,7,12,11,13,50,42,8,47
Berwick,6134,8,8,11,17,32,61,-29,35
Edinburgh Ci,6134,9,7,9,20,36,63,-27,30
Cowdenbeath,6134,10,4,10,22,24,57,-33,22
Montrose,6135,1,24,7,5,60,34,26,79
Peterhead,6135,2,24,4,8,80,39,41,76
Stenhousem'r,6135,3,16,8,12,56,46,10,56
Stirling,6135,4,16,6,14,60,52,8,54
Clyde,6135,5,14,10,12,51,48,3,52
Elgin,6135,6,14,6,16,53,61,-8,48
Annan Athlet,6135,7,11,11,14,47,42,5,44
Berwick,6135,8,8,11,17,29,58,-29,35
Edinburgh Ci,6135,9,7,9,20,37,63,-26,30
Cowdenbeath,6135,10,5,10,21,24,54,-30,25
Montrose,6136,1,24,7,5,62,35,27,79
Peterhead,6136,2,24,4,8,79,39,40,76
Stenhousem'r,6136,3,16,8,12,57,46,11,56
Stirling,6136,4,16,6,14,60,53,7,54
Clyde,6136,5,15,9,12,54,49,5,54
Elgin,6136,6,14,6,16,54,63,-9,48
Annan Athlet,6136,7,12,11,13,49,42,7,47
Berwick,6136,8,8,10,18,30,61,-31,34
Edinburgh Ci,6136,9,7,9,20,37,62,-25,30
Cowdenbeath,6136,10,4,10,22,24,56,-32,22
Peterhead,6137,1,24,4,8,80,40,40,76
Montrose,6137,2,23,7,6,61,37,24,76
Stenhousem'r,6137,3,16,8,12,57,47,10,56
Stirling,6137,4,16,6,14,61,53,8,54
Clyde,6137,5,15,9,12,53,48,5,54
Elgin,6137,6,15,6,15,56,62,-6,51
Annan Athlet,6137,7,11,11,14,47,43,4,44
Berwick,6137,8,8,10,18,29,60,-31,34
Edinburgh Ci,6137,9,7,9,20,38,63,-25,30
Cowdenbeath,6137,10,5,10,21,25,54,-29,25
Peterhead,6138,1,24,4,8,81,40,41,76
Montrose,6138,2,23,7,6,59,35,24,76
Stirling,6138,3,16,7,13,61,52,9,55
Stenhousem'r,6138,4,15,9,12,56,47,9,54
Clyde,6138,5,15,9,12,53,48,5,54
Elgin,6138,6,15,6,15,54,60,-6,51
Annan Athlet,6138,7,11,12,13,49,43,6,45
Berwick,6138,8,8,10,18,29,60,-31,34
Edinburgh Ci,6138,9,7,9,20,38,64,-26,30
Cowdenbeath,6138,10,4,11,21,25,56,-31,23
Montrose,6139,1,24,7,5,63,36,27,79
Peterhead,6139,2,24,4,8,81,39,42,76
Stirling,6139,3,16,7,13,61,52,9,55
Stenhousem'r,6139,4,15,9,12,56,47,9,54
Clyde,6139,5,15,9,12,54,48,6,54
Elgin,6139,6,14,6,16,55,64,-9,48
Annan Athlet,6139,7,12,11,13,49,41,8,47
Berwick,6139,8,8,10,18,29,61,-32,34
Edinburgh Ci,6139,9,7,9,20,37,64,-27,30
Cowdenbeath,6139,10,4,10,22,23,56,-33,22
Montrose,6140,1,24,7,5,62,35,27,79
Peterhead,6140,2,23,5,8,77,38,39,74
Stenhousem'r,6140,3,16,8,12,58,47,11,56
Stirling,6140,4,16,6,14,61,54,7,54
Clyde,6140,5,15,9,12,54,49,5,54
Elgin,6140,6,14,6,16,54,63,-9,48
Annan Athlet,6140,7,11,11,14,48,44,4,44
Berwick,6140,8,8,10,18,30,61,-31,34
Edinburgh Ci,6140,9,7,10,19,36,60,-24,31
Cowdenbeath,6140,10,5,10,21,26,55,-29,25
Montrose,6141,1,24,7,5,62,35,27,79
Peterhead,6141,2,24,4,8,79,38,41,76
Stirling,6141,3,16,7,13,62,53,9,55
Stenhousem'r,6141,4,15,9,12,57,48,9,54
Clyde,6141,5,15,9,12,56,50,6,54
Elgin,6141,6,14,6,16,54,63,-9,48
Annan Athlet,6141,7,12,11,13,49,41,8,47
Berwick,6141,8,8,10,18,31,63,-32,34
Edinburgh Ci,6141,9,7,9,20,36,62,-26,30
Cowdenbeath,6141,10,4,10,22,23,56,-33,22
Peterhead,6142,1,24,4,8,81,38,43,76
Montrose,6142,2,23,7,6,60,37,23,76
Stirling,6142,3,17,6,13,62,52,10,57
Clyde,6142,4,15,9,12,54,49,5,54
Stenhousem'r,6142,5,15,8,13,56,48,8,53
Elgin,6142,6,15,6,15,56,61,-5,51
Annan Athlet,6142,7,11,12,13,49,43,6,45
Berwick,6142,8,8,10,18,30,61,-31,34
Edinburgh Ci,6142,9,7,9,20,36,64,-28,30
Cowdenbeath,6142,10,4,11,21,25,56,-31,23
Montrose,6143,1,23,8,5,60,35,25,77
Peterhead,6143,2,24,4,8,81,38,43,76
Stirling,6143,3,17,6,13,63,52,11,57
Clyde,6143,4,15,9,12,53,49,4,54
Stenhousem'r,6143,5,15,8,13,56,49,7,53
Elgin,6143,6,14,7,15,54,61,-7,49
Annan Athlet,6143,7,11,11,14,47,42,5,44
Berwick,6143,8,8,10,18,30,60,-30,34
Edinburgh Ci,6143,9,7,9,20,36,64,-28,30
Cowdenbeath,6143,10,5,10,21,24,54,-30,25
Montrose,6144,1,24,7,5,62,36,26,79
Peterhead,6144,2,23,4,9,77,39,38,73
Stirling,6144,3,17,6,13,64,52,12,57
Stenhousem'r,6144,4,15,8,13,56,50,6,53
Clyde,6144,5,14,10,12,52,49,3,52
Elgin,6144,6,14,6,16,55,63,-8,48
Annan Athlet,6144,7,11,11,14,47,42,5,44
Berwick,6144,8,8,11,17,30,59,-29,35
Edinburgh Ci,6144,9,8,9,19,37,60,-23,33
Cowdenbeath,6144,10,5,10,21,24,54,-30,25
Montrose,6145,1,23,8,5,59,34,25,77
Peterhead,6145,2,24,4,8,80,40,40,76
Stenhousem'r,6145,3,16,8,12,58,46,12,56
Stirling,6145,4,16,6,14,60,54,6,54
Clyde,6145,5,15,9,12,54,50,4,54
Elgin,6145,6,14,7,15,53,60,-7,49
Annan Athlet,6145,7,11,12,13,48,42,6,45
Berwick,6145,8,8,10,18,31,61,-30,34
Edinburgh Ci,6145,9,7,9,20,38,63,-25,30
Cowdenbeath,6145,10,4,11,21,24,55,-31,23
Montrose,6146,1,24,7,5,61,35,26,79
Peterhead,6146,2,24,4,8,78,38,40,76
Stirling,6146,3,17,6,13,64,52,12,57
Stenhousem'r,6146,4,15,8,13,56,50,6,53
Clyde,6146,5,14,9,13,51,50,1,51
Elgin,6146,6,14,6,16,54,62,-8,48
Annan Athlet,6146,7,11,12,13,47,41,6,45
Berwick,6146,8,9,10,17,31,58,-27,37
Edinburgh Ci,6146,9,7,9,20,36,61,-25,30
Cowdenbeath,6146,10,4,11,21,23,54,-31,23
Montrose,6147,1,24,7,5,64,36,28,79
Peterhead,6147,2,23,4,9,77,39,38,73
Stenhousem'r,6147,3,16,8,12,57,47,10,56
Stirling,6147,4,16,6,14,61,53,8,54
Clyde,6147,5,15,9,12,52,48,4,54
Elgin,6147,6,14,6,16,55,65,-10,48
Annan Athlet,6147,7,12,11,13,48,41,7,47
Berwick,6147,8,8,10,18,29,59,-30,34
Edinburgh Ci,6147,9,8,9,19,37,60,-23,33
Cowdenbeath,6147,10,4,10,22,23,55,-32,22
Montrose,6148,1,24,7,5,61,34,27,79
Peterhead,6148,2,24,4,8,80,39,41,76
Stirling,6148,3,17,6,13,61,51,10,57
Stenhousem'r,6148,4,15,8,13,55,47,8,53
Clyde,6148,5,14,10,12,52,49,3,52
Elgin,6148,6,14,6,16,53,62,-9,48
Annan Athlet,6148,7,11,11,14,47,42,5,44
Berwick,6148,8,8,11,17,30,59,-29,35
Edinburgh Ci,6148,9,7,9,20,37,63,-26,30
Cowdenbeath,6148,10,5,10,21,24,54,-30,25
Montrose,6149,1,23,8,5,61,36,25,77
Peterhead,6149,2,24,4,8,80,39,41,76
Stirling,6149,3,17,6,13,61,51,10,57
Clyde,6149,4,15,9,12,53,48,5,54
Stenhousem'r,6149,5,15,8,13,55,47,8,53
Elgin,6149,6,14,7,15,55,62,-7,49
Annan Athlet,6149,7,11,12,13,47,41,6,45
Berwick,6149,8,8,10,18,29,60,-31,34
Edinburgh Ci,6149,9,7,9,20,37,63,-26,30
Cowdenbeath,6149,10,4,11,21,23,54,-31,23
Montrose,6150,1,24,7,5,61,34,27,79
Peterhead,6150,2,24,4,8,78,38,40,76
Stirling,6150,3,17,6,13,62,52,10,57
Clyde,6150,4,15,9,12,54,48,6,54
Stenhousem'r,6150,5,15,8,13,56,48,8,53
Elgin,6150,6,14,6,16,53,62,-9,48
Annan Athlet,6150,7,11,11,14,47,42,5,44
Berwick,6150,8,8,10,18,29,61,-32,34
Edinburgh Ci,6150,9,7,9,20,36,61,-25,30
Cowdenbeath,6150,10,5,10,21,24,54,-30,25
Montrose,6151,1,24,7,5,62,36,26,79
Peterhead,6151,2,24,4,8,81,38,43,76
Stenhousem'r,6151,3,16,8,12,58,48,10,56
Stirling,6151,4,16,6,14,62,54,8,54
Clyde,6151,5,15,9,12,52,48,4,54
Elgin,6151,6,14,6,16,55,63,-8,48
Annan Athlet,6151,7,11,11,14,47,43,4,44
Berwick,6151,8,8,10,18,29,59,-30,34
Edinburgh Ci,6151,9,7,9,20,36,64,-28,30
Cowdenbeath,6151,10,5,10,21,25,54,-29,25
Montrose,6152,1,23,8,5,59,34,25,77
Peterhead,6152,2,24,4,8,78,38,40,76
Stirling,6152,3,17,6,13,63,51,12,57
Clyde,6152,4,15,9,12,52,48,4,54
Stenhousem'r,6152,5,15,8,13,55,49,6,53
Elgin,6152,6,14,7,15,53,60,-7,49
Annan Athlet,6152,7,12,11,13,49,41,8,47
Berwick,6152,8,8,10,18,29,59,-30,34
Edinburgh Ci,6152,9,7,9,20,36,61,-25,30
Cowdenbeath,6152,10,4,10,22,23,56,-33,22
Montrose,6153,1,24,7,5,60,34,26,79
Peterhead,6153,2,24,4,8,80,38,42,76
Stenhousem'r,6153,3,16,8,12,56,46,10,56
Stirling,6153,4,16,6,14,60,52,8,54
Clyde,6153,5,15,9,12,53,48,5,54
Elgin,6153,6,14,6,16,53,61,-8,48
Annan Athlet,6153,7,12,11,13,49,41,8,47
Berwick,6153,8,8,10,18,29,60,-31,34
Edinburgh Ci,6153,9,7,9,20,36,63,-27,30
Cowdenbeath,6153,10,4,10,22,23,56,-33,22
Montrose,6154,1,24,7,5,61,35,26,79
Peterhead,6154,2,24,4,8,78,38,40,76
Stirling,6154,3,17,6,13,61,51,10,57
Clyde,6154,4,15,9,12,54,49,5,54
Stenhousem'r,6154,5,15,8,13,55,47,8,53
Elgin,6154,6,14,6,16,54,62,-8,48
Annan Athlet,6154,7,11,11,14,47,42,5,44
Berwick,6154,8,8,10,18,30,61,-31,34
Edinburgh Ci,6154,9,7,9,20,36,61,-25,30
Cowdenbeath,6154,10,5,10,21,24,54,-30,25
Montrose,6155,1,24,7,5,61,34,27,79
Peterhead,6155,2,23,4,9,77,40,37,73
Stirling,6155,3,17,6,13,61,51,10,57
Stenhousem'r,6155,4,15,8,13,55,47,8,53
Clyde,6155,5,14,9,13,51,49,2,51
Elgin,6155,6,14,6,16,53,62,-9,48
Annan Athlet,6155,7,12,11,13,49,42,7,47
Berwick,6155,8,9,10,17,30,58,-28,37
Edinburgh Ci,6155,9,8,9,19,38,60,-22,33
Cowdenbeath,6155,10,4,10,22,24,56,-32,22
Montrose,6156,1,24,7,5,63,36,27,79
Peterhead,6156,2,24,4,8,80,38,42,76
Stirling,6156,3,17,6,13,63,53,10,57
Clyde,6156,4,15,9,12,52,48,4,54
Stenhousem'r,6156,5,15,8,13,57,49,8,53
Elgin,6156,6,14,6,16,55,64,-9,48
Annan Athlet,6156,7,11,11,14,48,43,5,44
Berwick,6156,8,8,10,18,29,59,-30,34
Edinburgh Ci,6156,9,7,9,20,36,63,-27,30
Cowdenbeath,6156,10,5,10,21,25,55,-30,25
Peterhead,6157,1,24,4,8,80,40,40,76
Montrose,6157,2,23,7,6,59,35,24,76
Stirling,6157,3,17,6,13,61,51,10,57
Clyde,6157,4,15,9,12,54,49,5,54
Stenhousem'r,6157,5,15,8,13,55,47,8,53
Elgin,6157,6,15,6,15,54,60,-6,51
Annan Athlet,6157,7,11,12,13,47,41,6,45
Berwick,6157,8,8,10,18,30,61,-31,34
Edinburgh Ci,6157,9,7,9,20,38,63,-25,30
Cowdenbeath,6157,10,4,11,21,23,54,-31,23
Montrose,6158,1,24,7,5,62,36,26,79
Peterhead,6158,2,24,4,8,81,40,41,76
Stenhousem'r,6158,3,16,8,12,57,47,10,56
Stirling,6158,4,16,6,14,61,53,8,54
Clyde,6158,5,15,9,12,53,48,5,54
Elgin,6158,6,14,6,16,55,63,-8,48
Annan Athlet,6158,7,11,11,14,47,46,1,44
Berwick,6158,8,8,10,18,29,60,-31,34
Edinburgh Ci,6158,9,7,9,20,38,64,-26,30
Cowdenbeath,6158,10,5,10,21,28,54,-26,25
Montrose,6159,1,24,7,5,61,35,26,79
Peterhead,6159,2,24,4,8,80,40,40,76
Stenhousem'r,6159,3,16,8,12,59,47,12,56
Stirling,6159,4,16,6,14,61,55,6,54
Clyde,6159,5,15,9,12,53,49,4,54
Elgin,6159,6,14,6,16,54,62,-8,48
Annan Athlet,6159,7,11,12,13,47,41,6,45
Berwick,6159,8,8,10,18,30,60,-30,34
Edinburgh Ci,6159,9,7,9,20,38,63,-25,30
Cowdenbeath,6159,10,4,11,21,23,54,-31,23
Montrose,6160,1,24,7,5,61,35,26,79
Peterhead,6160,2,24,4,8,83,39,44,76
Stenhousem'r,6160,3,16,8,12,56,46,10,56
Stirling,6160,4,16,6,14,60,52,8,54
Clyde,6160,5,15,9,12,55,50,5,54
Elgin,6160,6,14,6,16,54,62,-8,48
Annan Athlet,6160,7,11,11,14,48,44,4,44
Berwick,6160,8,8,10,18,31,62,-31,34
Edinburgh Ci,6160,9,7,9,20,37,66,-29,30
Cowdenbeath,6160,10,5,10,21,26,55,-29,25
Montrose,6161,1,24,7,5,62,35,27,79
Peterhead,6161,2,24,4,8,79,39,40,76
Stirling,6161,3,17,6,13,63,52,11,57
Clyde,6161,4,15,9,12,54,50,4,54
Stenhousem'r,6161,5,15,8,13,56,49,7,53
Elgin,6161,6,14,6,16,54,63,-9,48
Annan Athlet,6161,7,12,11,13,49,42,7,47
Berwick,6161,8,8,10,18,31,61,-30,34
Edinburgh Ci,6161,9,7,9,20,37,62,-25,30
Cowdenbeath,6161,10,4,10,22,24,56,-32,22
Montrose,6162,1,24,7,5,62,35,27,79
Peterhead,6162,2,24,4,8,78,38,40,76
Stenhousem'r,6162,3,16,8,12,57,47,10,56
Stirling,6162,4,16,6,14,61,53,8,54
Clyde,6162,5,14,10,12,52,49,3,52
Elgin,6162,6,14,6,16,54,63,-9,48
Annan Athlet,6162,7,12,11,13,51,42,9,47
Berwick,6162,8,8,11,17,30,59,-29,35
Edinburgh Ci,6162,9,7,9,20,36,61,-25,30
Cowdenbeath,6162,10,4,10,22,24,58,-34,22
Montrose,6163,1,24,7,5,63,34,29,79
Peterhead,6163,2,24,4,8,79,38,41,76
Stirling,6163,3,16,7,13,61,52,9,55
Stenhousem'r,6163,4,15,9,12,56,47,9,54
Clyde,6163,5,14,10,12,53,50,3,52
Elgin,6163,6,14,6,16,53,64,-11,48
Annan Athlet,6163,7,12,11,13,50,41,9,47
Berwick,6163,8,8,11,17,31,60,-29,35
Edinburgh Ci,6163,9,7,9,20,36,62,-26,30
Cowdenbeath,6163,10,4,10,22,23,57,-34,22
Montrose,6164,1,24,7,5,61,35,26,79
Peterhead,6164,2,24,4,8,80,38,42,76
Stirling,6164,3,17,6,13,62,52,10,57
Stenhousem'r,6164,4,15,8,13,56,48,8,53
Clyde,6164,5,14,10,12,52,49,3,52
Elgin,6164,6,14,6,16,54,62,-8,48
Annan Athlet,6164,7,12,11,13,48,41,7,47
Berwick,6164,8,8,11,17,30,59,-29,35
Edinburgh Ci,6164,9,7,9,20,36,63,-27,30
Cowdenbeath,6164,10,4,10,22,23,55,-32,22
Peterhead,6165,1,24,4,8,80,38,42,76
Montrose,6165,2,23,7,6,59,37,22,76
Stenhousem'r,6165,3,16,8,12,56,46,10,56
Stirling,6165,4,16,6,14,60,52,8,54
Clyde,6165,5,14,10,12,54,51,3,52
Elgin,6165,6,15,6,15,56,60,-4,51
Annan Athlet,6165,7,12,11,13,48,41,7,47
Berwick,6165,8,8,11,17,32,61,-29,35
Edinburgh Ci,6165,9,7,9,20,36,63,-27,30
Cowdenbeath,6165,10,4,10,22,23,55,-32,22
Montrose,6166,1,24,7,5,63,35,28,79
Peterhead,6166,2,24,4,8,82,38,44,76
Stenhousem'r,6166,3,16,8,12,57,47,10,56
Stirling,6166,4,16,6,14,61,53,8,54
Clyde,6166,5,15,9,12,52,48,4,54
Elgin,6166,6,14,6,16,54,64,-10,48
Annan Athlet,6166,7,11,12,13,49,43,6,45
Berwick,6166,8,8,10,18,29,59,-30,34
Edinburgh Ci,6166,9,7,9,20,36,65,-29,30
Cowdenbeath,6166,10,4,11,21,25,56,-31,23
Peterhead,6167,1,24,4,8,84,38,46,76
Montrose,6167,2,23,7,6,59,35,24,76
Stirling,6167,3,16,7,13,63,54,9,55
Stenhousem'r,6167,4,15,9,12,58,49,9,54
Clyde,6167,5,14,10,12,53,50,3,52
Elgin,6167,6,15,6,15,54,60,-6,51
Annan Athlet,6167,7,12,11,13,50,42,8,47
Berwick,6167,8,8,11,17,31,60,-29,35
Edinburgh Ci,6167,9,7,9,20,36,67,-31,30
Cowdenbeath,6167,10,4,10,22,24,57,-33,22
Montrose,6168,1,24,7,5,63,34,29,79
Peterhead,6168,2,24,4,8,78,38,40,76
Stirling,6168,3,17,6,13,61,51,10,57
Clyde,6168,4,15,9,12,55,49,6,54
Stenhousem'r,6168,5,15,8,13,55,47,8,53
Elgin,6168,6,14,6,16,53,64,-11,48
Annan Athlet,6168,7,12,11,13,49,41,8,47
Berwick,6168,8,8,10,18,30,62,-32,34
Edinburgh Ci,6168,9,7,9,20,36,61,-25,30
Cowdenbeath,6168,10,4,10,22,23,56,-33,22
Montrose,6169,1,24,7,5,61,35,26,79
Peterhead,6169,2,23,5,8,78,39,39,74
Stenhousem'r,6169,3,16,8,12,56,46,10,56
Stirling,6169,4,16,6,14,60,52,8,54
Clyde,6169,5,15,9,12,54,50,4,54
Elgin,6169,6,14,6,16,54,62,-8,48
Annan Athlet,6169,7,11,12,13,47,41,6,45
Berwick,6169,8,8,10,18,31,61,-30,34
Edinburgh Ci,6169,9,7,10,19,37,61,-24,31
Cowdenbeath,6169,10,4,11,21,23,54,-31,23
Montrose,6170,1,24,7,5,61,34,27,79
Peterhead,6170,2,23,5,8,78,39,39,74
Stenhousem'r,6170,3,16,8,12,57,47,10,56
Stirling,6170,4,16,6,14,61,53,8,54
Clyde,6170,5,14,10,12,52,49,3,52
Elgin,6170,6,14,6,16,53,62,-9,48
Annan Athlet,6170,7,11,11,14,48,43,5,44
Berwick,6170,8,8,11,17,30,59,-29,35
Edinburgh Ci,6170,9,7,10,19,37,61,-24,31
Cowdenbeath,6170,10,5,10,21,25,55,-30,25
Montrose,6171,1,23,8,5,60,35,25,77
Peterhead,6171,2,23,5,8,77,38,39,74
Stenhousem'r,6171,3,16,8,12,58,48,10,56
Stirling,6171,4,16,6,14,62,54,8,54
Clyde,6171,5,14,9,13,54,52,2,51
Elgin,6171,6,14,7,15,54,61,-7,49
Annan Athlet,6171,7,12,11,13,49,41,8,47
Berwick,6171,8,9,10,17,33,61,-28,37
Edinburgh Ci,6171,9,7,10,19,36,60,-24,31
Cowdenbeath,6171,10,4,10,22,23,56,-33,22
Montrose,6172,1,24,7,5,62,34,28,79
Peterhead,6172,2,24,4,8,81,39,42,76
Stenhousem'r,6172,3,16,8,12,58,46,12,56
Stirling,6172,4,16,6,14,60,54,6,54
Clyde,6172,5,14,10,12,53,50,3,52
Elgin,6172,6,14,6,16,53,63,-10,48
Annan Athlet,6172,7,11,12,13,48,42,6,45
Berwick,6172,8,8,11,17,31,60,-29,35
Edinburgh Ci,6172,9,7,9,20,37,64,-27,30
Cowdenbeath,6172,10,4,11,21,24,55,-31,23
Montrose,6173,1,23,8,5,59,34,25,77
Peterhead,6173,2,23,4,9,78,40,38,73
Stirling,6173,3,17,6,13,65,51,14,57
Stenhousem'r,6173,4,15,8,13,55,51,4,53
Clyde,6173,5,14,10,12,51,48,3,52
Elgin,6173,6,14,7,15,53,60,-7,49
Annan Athlet,6173,7,11,12,13,47,41,6,45
Berwick,6173,8,8,11,17,29,58,-29,35
Edinburgh Ci,6173,9,8,9,19,38,61,-23,33
Cowdenbeath,6173,10,4,11,21,23,54,-31,23
Montrose,6174,1,24,7,5,62,35,27,79
Peterhead,6174,2,24,4,8,81,38,43,76
Stirling,6174,3,16,7,13,62,53,9,55
Stenhousem'r,6174,4,15,9,12,57,48,9,54
Clyde,6174,5,15,9,12,54,50,4,54
Elgin,6174,6,14,6,16,54,63,-9,48
Annan Athlet,6174,7,12,11,13,49,42,7,47
Berwick,6174,8,8,10,18,31,61,-30,34
Edinburgh Ci,6174,9,7,9,20,36,64,-28,30
Cowdenbeath,6174,10,4,10,22,24,56,-32,22
Montrose,6175,1,23,8,5,60,35,25,77
Peterhead,6175,2,24,4,8,80,39,41,76
Stenhousem'r,6175,3,16,8,12,58,48,10,56
Stirling,6175,4,16,6,14,62,54,8,54
Clyde,6175,5,14,9,13,51,50,1,51
Elgin,6175,6,14,7,15,54,61,-7,49
Annan Athlet,6175,7,11,12,13,48,42,6,45
Berwick,6175,8,9,10,17,31,58,-27,37
Edinburgh Ci,6175,9,7,9,20,37,63,-26,30
Cowdenbeath,6175,10,4,11,21,24,55,-31,23
Montrose,6176,1,24,7,5,62,34,28,79
Peterhead,6176,2,24,4,8,83,38,45,76
Stirling,6176,3,17,6,13,63,52,11,57
Clyde,6176,4,15,9,12,52,48,4,54
Stenhousem'r,6176,5,15,8,13,56,49,7,53
Elgin,6176,6,14,6,16,53,63,-10,48
Annan Athlet,6176,7,12,11,13,48,41,7,47
Berwick,6176,8,8,10,18,29,59,-30,34
Edinburgh Ci,6176,9,7,9,20,36,66,-30,30
Cowdenbeath,6176,10,4,10,22,23,55,-32,22
Montrose,6177,1,24,7,5,60,34,26,79
Peterhead,6177,2,23,5,8,77,38,39,74
Stenhousem'r,6177,3,16,8,12,57,46,11,56
Stirling,6177,4,16,6,14,60,53,7,54
Clyde,6177,5,15,9,12,53,48,5,54
Elgin,6177,6,14,6,16,53,61,-8,48
Annan Athlet,6177,7,12,11,13,49,41,8,47
Berwick,6177,8,8,10,18,29,60,-31,34
Edinburgh Ci,6177,9,7,10,19,36,60,-24,31
Cowdenbeath,6177,10,4,10,22,23,56,-33,22
Montrose,6178,1,24,7,5,64,34,30,79
Peterhead,6178,2,24,4,8,80,40,40,76
Stirling,6178,3,16,7,13,61,52,9,55
Stenhousem'r,6178,4,15,9,12,56,47,9,54
Clyde,6178,5,14,9,13,52,50,2,51
Elgin,6178,6,14,6,16,53,65,-12,48
Annan Athlet,6178,7,11,12,13,47,41,6,45
Berwick,6178,8,9,10,17,31,59,-28,37
Edinburgh Ci,6178,9,7,9,20,38,63,-25,30
Cowdenbeath,6178,10,4,11,21,23,54,-31,23
Peterhead,6179,1,24,4,8,78,38,40,76
Montrose,6179,2,23,7,6,60,36,24,76
Stirling,6179,3,16,7,13,62,53,9,55
Stenhousem'r,6179,4,15,9,12,57,48,9,54
Clyde,6179,5,14,9,13,51,49,2,51
Elgin,6179,6,15,6,15,55,61,-6,51
Annan Athlet,6179,7,11,12,13,47,41,6,45
Berwick,6179,8,9,10,17,30,58,-28,37
Edinburgh Ci,6179,9,7,9,20,36,61,-25,30
Cowdenbeath,6179,10,4,11,21,23,54,-31,23
Montrose,6180,1,24,7,5,62,34,28,79
Peterhead,6180,2,24,4,8,79,38,41,76
Stenhousem'r,6180,3,16,8,12,58,48,10,56
Stirling,6180,4,16,6,14,62,54,8,54
Clyde,6180,5,15,9,12,52,48,4,54
Elgin,6180,6,14,6,16,53,63,-10,48
Annan Athlet,6180,7,11,12,13,48,42,6,45
Berwick,6180,8,8,10,18,29,59,-30,34
Edinburgh Ci,6180,9,7,9,20,36,62,-26,30
Cowdenbeath,6180,10,4,11,21,24,55,-31,23
Montrose,6181,1,23,8,5,60,35,25,77
Peterhead,6181,2,24,4,8,80,39,41,76
Stirling,6181,3,17,6,13,62,51,11,57
Clyde,6181,4,15,9,12,52,48,4,54
Stenhousem'r,6181,5,15,8,13,55,48,7,53
Elgin,6181,6,14,7,15,54,61,-7,49
Annan Athlet,6181,7,11,11,14,47,45,2,44
Berwick,6181,8,8,10,18,29,59,-30,34
Edinburgh Ci,6181,9,7,9,20,37,63,-26,30
Cowdenbeath,6181,10,5,10,21,27,54,-27,25
Peterhead,6182,1,24,4,8,82,38,44,76
Montrose,6182,2,23,7,6,59,35,24,76
Stenhousem'r,6182,3,16,8,12,57,46,11,56
Stirling,6182,4,16,6,14,60,53,7,54
Clyde,6182,5,15,9,12,53,48,5,54
Elgin,6182,6,15,6,15,54,60,-6,51
Annan Athlet,6182,7,11,11,14,47,44,3,44
Berwick,6182,8,8,10,18,29,60,-31,34
Edinburgh Ci,6182,9,7,9,20,36,65,-29,30
Cowdenbeath,6182,10,5,10,21,26,54,-28,25
Peterhead,6183,1,24,4,8,80,38,42,76
Montrose,6183,2,23,7,6,60,36,24,76
Stirling,6183,3,17,6,13,62,51,11,57
Clyde,6183,4,15,9,12,55,48,7,54
Stenhousem'r,6183,5,15,8,13,55,48,7,53
Elgin,6183,6,15,6,15,55,61,-6,51
Annan Athlet,6183,7,11,11,14,47,43,4,44
Berwick,6183,8,8,10,18,29,62,-33,34
Edinburgh Ci,6183,9,7,9,20,36,63,-27,30
Cowdenbeath,6183,10,5,10,21,25,54,-29,25
Montrose,6184,1,24,7,5,61,35,26,79
Peterhead,6184,2,24,4,8,79,38,41,76
Stirling,6184,3,16,7,13,61,52,9,55
Stenhousem'r,6184,4,15,9,12,56,47,9,54
Clyde,6184,5,15,9,12,52,48,4,54
Elgin,6184,6,14,6,16,54,62,-8,48
Annan Athlet,6184,7,11,11,14,48,43,5,44
Berwick,6184,8,8,10,18,29,59,-30,34
Edinburgh Ci,6184,9,7,9,20,36,62,-26,30
Cowdenbeath,6184,10,5,10,21,25,55,-30,25
Peterhead,6185,1,24,4,8,79,38,41,76
Montrose,6185,2,23,7,6,59,35,24,76
Stenhousem'r,6185,3,16,8,12,57,46,11,56
Stirling,6185,4,16,6,14,60,53,7,54
Clyde,6185,5,15,9,12,54,48,6,54
Elgin,6185,6,15,6,15,54,60,-6,51
Annan Athlet,6185,7,11,11,14,47,43,4,44
Berwick,6185,8,8,10,18,29,61,-32,34
Edinburgh Ci,6185,9,7,9,20,36,62,-26,30
Cowdenbeath,6185,10,5,10,21,25,54,-29,25
Montrose,6186,1,24,7,5,60,34,26,79
Peterhead,6186,2,23,5,8,79,40,39,74
Stirling,6186,3,17,6,13,63,53,10,57
Clyde,6186,4,15,9,12,55,48,7,54
Stenhousem'r,6186,5,15,8,13,57,49,8,53
Elgin,6186,6,14,6,16,53,61,-8,48
Annan Athlet,6186,7,12,11,13,49,42,7,47
Berwick,6186,8,8,10,18,29,62,-33,34
Edinburgh Ci,6186,9,7,10,19,38,62,-24,31
Cowdenbeath,6186,10,4,10,22,24,56,-32,22
Peterhead,6187,1,24,4,8,81,38,43,76
Montrose,6187,2,23,7,6,60,37,23,76
Stirling,6187,3,16,7,13,61,52,9,55
Stenhousem'r,6187,4,15,9,12,56,47,9,54
Clyde,6187,5,15,9,12,53,49,4,54
Elgin,6187,6,15,6,15,56,61,-5,51
Annan Athlet,6187,7,12,11,13,49,41,8,47
Berwick,6187,8,8,10,18,30,60,-30,34
Edinburgh Ci,6187,9,7,9,20,36,64,-28,30
Cowdenbeath,6187,10,4,10,22,23,56,-33,22
Montrose,6188,1,24,7,5,62,34,28,79
Peterhead,6188,2,24,4,8,79,38,41,76
Stirling,6188,3,17,6,13,63,51,12,57
Stenhousem'r,6188,4,15,8,13,55,49,6,53
Clyde,6188,5,14,10,12,52,49,3,52
Elgin,6188,6,14,6,16,53,63,-10,48
Annan Athlet,6188,7,12,11,13,49,41,8,47
Berwick,6188,8,8,11,17,30,59,-29,35
Edinburgh Ci,6188,9,7,9,20,36,62,-26,30
Cowdenbeath,6188,10,4,10,22,23,56,-33,22
Montrose,6189,1,24,7,5,60,34,26,79
Peterhead,6189,2,24,4,8,82,39,43,76
Stirling,6189,3,16,7,13,61,52,9,55
Stenhousem'r,6189,4,15,9,12,56,47,9,54
Clyde,6189,5,14,9,13,53,51,2,51
Elgin,6189,6,14,6,16,53,61,-8,48
Annan Athlet,6189,7,11,12,13,47,41,6,45
Berwick,6189,8,9,10,17,32,60,-28,37
Edinburgh Ci,6189,9,7,9,20,37,65,-28,30
Cowdenbeath,6189,10,4,11,21,23,54,-31,23
Montrose,6190,1,24,7,5,60,34,26,79
Peterhead,6190,2,24,4,8,78,38,40,76
Stirling,6190,3,17,6,13,64,52,12,57
Stenhousem'r,6190,4,15,8,13,56,50,6,53
Clyde,6190,5,14,10,12,51,48,3,52
Elgin,6190,6,14,6,16,53,61,-8,48
Annan Athlet,6190,7,11,12,13,47,41,6,45
Berwick,6190,8,8,11,17,29,58,-29,35
Edinburgh Ci,6190,9,7,9,20,36,61,-25,30
Cowdenbeath,6190,10,4,11,21,23,54,-31,23
Montrose,6191,1,23,8,5,59,34,25,77
Peterhead,6191,2,24,4,8,79,38,41,76
Stirling,6191,3,17,6,13,62,52,10,57
Clyde,6191,4,15,9,12,53,49,4,54
Stenhousem'r,6191,5,15,8,13,56,48,8,53
Elgin,6191,6,14,7,15,53,60,-7,49
Annan Athlet,6191,7,12,11,13,48,41,7,47
Berwick,6191,8,8,10,18,30,60,-30,34
Edinburgh Ci,6191,9,7,9,20,36,62,-26,30
Cowdenbeath,6191,10,4,10,22,23,55,-32,22
Montrose,6192,1,24,7,5,63,35,28,79
Peterhead,6192,2,24,4,8,80,40,40,76
Stirling,6192,3,17,6,13,62,51,11,57
Stenhousem'r,6192,4,15,8,13,55,48,7,53
Clyde,6192,5,14,10,12,52,49,3,52
Elgin,6192,6,14,6,16,54,64,-10,48
Annan Athlet,6192,7,12,11,13,49,41,8,47
Berwick,6192,8,8,11,17,30,59,-29,35
Edinburgh Ci,6192,9,7,9,20,38,63,-25,30
Cowdenbeath,6192,10,4,10,22,23,56,-33,22
Peterhead,6193,1,24,4,8,81,41,40,76
Montrose,6193,2,23,7,6,60,36,24,76
Stirling,6193,3,17,6,13,62,52,10,57
Clyde,6193,4,15,9,12,55,49,6,54
Stenhousem'r,6193,5,15,8,13,56,48,8,53
Elgin,6193,6,15,6,15,55,61,-6,51
Annan Athlet,6193,7,12,11,13,49,41,8,47
Berwick,6193,8,8,10,18,30,62,-32,34
Edinburgh Ci,6193,9,7,9,20,39,64,-25,30
Cowdenbeath,6193,10,4,10,22,23,56,-33,22
Montrose,6194,1,23,8,5,60,35,25,77
Peterhead,6194,2,24,4,8,81,38,43,76
Stenhousem'r,6194,3,16,8,12,57,46,11,56
Stirling,6194,4,16,6,14,60,53,7,54
Clyde,6194,5,15,9,12,52,48,4,54
Elgin,6194,6,14,7,15,54,61,-7,49
Annan Athlet,6194,7,12,11,13,48,41,7,47
Berwick,6194,8,8,10,18,29,59,-30,34
Edinburgh Ci,6194,9,7,9,20,36,64,-28,30
Cowdenbeath,6194,10,4,10,22,23,55,-32,22
Montrose,6195,1,23,7,6,60,36,24,76
Peterhead,6195,2,23,5,8,78,39,39,74
Stenhousem'r,6195,3,16,8,12,58,48,10,56
Stirling,6195,4,16,6,14,62,54,8,54
Clyde,6195,5,15,9,12,55,50,5,54
Elgin,6195,6,15,6,15,55,61,-6,51
Annan Athlet,6195,7,12,11,13,48,41,7,47
Berwick,6195,8,8,10,18,31,62,-31,34
Edinburgh Ci,6195,9,7,10,19,37,61,-24,31
Cowdenbeath,6195,10,4,10,22,23,55,-32,22
Montrose,6196,1,24,7,5,61,34,27,79
Peterhead,6196,2,24,4,8,83,39,44,76
Stirling,6196,3,17,6,13,62,51,11,57
Stenhousem'r,6196,4,15,8,13,55,48,7,53
Clyde,6196,5,14,10,12,52,49,3,52
Elgin,6196,6,14,6,16,53,62,-9,48
Annan Athlet,6196,7,11,11,14,47,43,4,44
Berwick,6196,8,8,11,17,30,59,-29,35
Edinburgh Ci,6196,9,7,9,20,37,66,-29,30
Cowdenbeath,6196,10,5,10,21,25,54,-29,25
Montrose,6197,1,23,8,5,59,34,25,77
Peterhead,6197,2,24,4,8,80,39,41,76
Stenhousem'r,6197,3,16,8,12,57,47,10,56
Stirling,6197,4,16,6,14,61,53,8,54
Clyde,6197,5,15,9,12,55,49,6,54
Elgin,6197,6,14,7,15,53,60,-7,49
Annan Athlet,6197,7,12,11,13,48,41,7,47
Berwick,6197,8,8,10,18,30,62,-32,34
Edinburgh Ci,6197,9,7,9,20,37,63,-26,30
Cowdenbeath,6197,10,4,10,22,23,55,-32,22
Montrose,6198,1,23,8,5,60,35,25,77
Peterhead,6198,2,24,4,8,82,38,44,76
Stirling,6198,3,16,7,13,60,51,9,55
Stenhousem'r,6198,4,15,9,12,55,46,9,54
Clyde,6198,5,14,10,12,52,49,3,52
Elgin,6198,6,14,7,15,54,61,-7,49
Annan Athlet,6198,7,12,11,13,48,41,7,47
Berwick,6198,8,8,11,17,30,59,-29,35
Edinburgh Ci,6198,9,7,9,20,36,65,-29,30
Cowdenbeath,6198,10,4,10,22,23,55,-32,22
Montrose,6199,1,24,7,5,62,35,27,79
Peterhead,6199,2,24,4,8,78,38,40,76
Stirling,6199,3,17,6,13,64,51,13,57
Stenhousem'r,6199,4,15,8,13,55,50,5,53
Clyde,6199,5,14,9,13,52,51,1,51
Elgin,6199,6,14,6,16,54,63,-9,48
Annan Athlet,6199,7,12,11,13,50,42,8,47
Berwick,6199,8,9,10,17,32,59,-27,37
Edinburgh Ci,6199,9,7,9,20,36,61,-25,30
Cowdenbeath,6199,10,4,10,22,24,57,-33,22
Montrose,6200,1,24,7,5,61,34,27,79
Peterhead,6200,2,23,4,9,77,40,37,73
Stirling,6200,3,17,6,13,62,52,10,57
Clyde,6200,4,15,9,12,53,49,4,54
Stenhousem'r,6200,5,15,8,13,56,48,8,53
Elgin,6200,6,14,6,16,53,62,-9,48
Annan Athlet,6200,7,11,11,14,47,42,5,44
Berwick,6200,8,8,10,18,30,60,-30,34
Edinburgh Ci,6200,9,8,9,19,38,60,-22,33
Cowdenbeath,6200,10,5,10,21,24,54,-30,25
Peterhead,6201,1,24,4,8,83,38,45,76
Montrose,6201,2,23,7,6,59,35,24,76
Stirling,6201,3,16,7,13,61,52,9,55
Stenhousem'r,6201,4,15,9,12,56,47,9,54
Clyde,6201,5,15,9,12,56,49,7,54
Elgin,6201,6,15,6,15,54,60,-6,51
Annan Athlet,6201,7,12,11,13,50,43,7,47
Berwick,6201,8,8,10,18,30,63,-33,34
Edinburgh Ci,6201,9,7,9,20,36,66,-30,30
Cowdenbeath,6201,10,4,10,22,25,57,-32,22
Peterhead,6202,1,24,4,8,79,38,41,76
Montrose,6202,2,23,7,6,59,36,23,76
Stenhousem'r,6202,3,16,8,12,59,49,10,56
Stirling,6202,4,16,6,14,63,55,8,54
Clyde,6202,5,14,9,13,52,51,1,51
Elgin,6202,6,15,6,15,55,60,-5,51
Annan Athlet,6202,7,12,11,13,49,41,8,47
Berwick,6202,8,9,10,17,32,59,-27,37
Edinburgh Ci,6202,9,7,9,20,36,62,-26,30
Cowdenbeath,6202,10,4,10,22,23,56,-33,22
Montrose,6203,1,23,8,5,59,34,25,77
Peterhead,6203,2,24,4,8,79,38,41,76
Stenhousem'r,6203,3,16,8,12,58,47,11,56
Stirling,6203,4,16,6,14,61,54,7,54
Clyde,6203,5,15,9,12,54,48,6,54
Elgin,6203,6,14,7,15,53,60,-7,49
Annan Athlet,6203,7,11,12,13,47,41,6,45
Berwick,6203,8,8,10,18,29,61,-32,34
Edinburgh Ci,6203,9,7,9,20,36,62,-26,30
Cowdenbeath,6203,10,4,11,21,23,54,-31,23
Montrose,6204,1,24,7,5,60,34,26,79
Peterhead,6204,2,24,4,8,78,38,40,76
Stirling,6204,3,17,6,13,61,51,10,57
Stenhousem'r,6204,4,15,8,13,55,47,8,53
Clyde,6204,5,14,10,12,53,50,3,52
Elgin,6204,6,14,6,16,53,61,-8,48
Annan Athlet,6204,7,11,11,14,47,42,5,44
Berwick,6204,8,8,11,17,31,60,-29,35
Edinburgh Ci,6204,9,7,9,20,36,61,-25,30
Cowdenbeath,6204,10,5,10,21,24,54,-30,25
Montrose,6205,1,24,7,5,60,34,26,79
Peterhead,6205,2,23,5,8,77,38,39,74
Stirling,6205,3,16,7,13,61,52,9,55
Stenhousem'r,6205,4,15,9,12,56,47,9,54
Clyde,6205,5,15,9,12,54,48,6,54
Elgin,6205,6,14,6,16,53,61,-8,48
Annan Athlet,6205,7,11,12,13,48,42,6,45
Berwick,6205,8,8,10,18,29,61,-32,34
Edinburgh Ci,6205,9,7,10,19,36,60,-24,31
Cowdenbeath,6205,10,4,11,21,24,55,-31,23
Montrose,6206,1,24,7,5,63,35,28,79
Peterhead,6206,2,24,4,8,79,38,41,76
Stirling,6206,3,17,6,13,62,51,11,57
Clyde,6206,4,15,9,12,53,48,5,54
Stenhousem'r,6206,5,15,8,13,55,48,7,53
Elgin,6206,6,14,6,16,54,64,-10,48
Annan Athlet,6206,7,11,12,13,48,42,6,45
Berwick,6206,8,8,10,18,29,60,-31,34
Edinburgh Ci,6206,9,7,9,20,36,62,-26,30
Cowdenbeath,6206,10,4,11,21,24,55,-31,23
Montrose,6207,1,24,7,5,60,34,26,79
Peterhead,6207,2,24,4,8,82,39,43,76
Stirling,6207,3,17,6,13,62,51,11,57
Clyde,6207,4,15,9,12,53,48,5,54
Stenhousem'r,6207,5,15,8,13,55,48,7,53
Elgin,6207,6,14,6,16,53,61,-8,48
Annan Athlet,6207,7,11,12,13,47,41,6,45
Berwick,6207,8,8,10,18,29,60,-31,34
Edinburgh Ci,6207,9,7,9,20,37,65,-28,30
Cowdenbeath,6207,10,4,11,21,23,54,-31,23
Montrose,6208,1,24,7,5,62,34,28,79
Peterhead,6208,2,23,5,8,79,40,39,74
Stirling,6208,3,16,7,13,61,52,9,55
Stenhousem'r,6208,4,15,9,12,56,47,9,54
Clyde,6208,5,15,9,12,52,48,4,54
Elgin,6208,6,14,6,16,53,63,-10,48
Annan Athlet,6208,7,11,12,13,51,45,6,45
Berwick,6208,8,8,10,18,29,59,-30,34
Edinburgh Ci,6208,9,7,10,19,38,62,-24,31
Cowdenbeath,6208,10,4,11,21,27,58,-31,23
Montrose,6209,1,23,8,5,61,36,25,77
Peterhead,6209,2,23,5,8,77,38,39,74
Stirling,6209,3,17,6,13,63,53,10,57
Clyde,6209,4,15,9,12,54,50,4,54
Stenhousem'r,6209,5,15,8,13,57,49,8,53
Elgin,6209,6,14,7,15,55,62,-7,49
Annan Athlet,6209,7,11,11,14,48,43,5,44
Berwick,6209,8,8,10,18,31,61,-30,34
Edinburgh Ci,6209,9,7,10,19,36,60,-24,31
Cowdenbeath,6209,10,5,10,21,25,55,-30,25
Montrose,6210,1,24,7,5,60,34,26,79
Peterhead,6210,2,24,4,8,78,38,40,76
Stirling,6210,3,17,6,13,62,52,10,57
Clyde,6210,4,15,9,12,53,49,4,54
Stenhousem'r,6210,5,15,8,13,56,48,8,53
Elgin,6210,6,14,6,16,53,61,-8,48
Annan Athlet,6210,7,12,11,13,49,41,8,47
Berwick,6210,8,8,10,18,30,60,-30,34
Edinburgh Ci,6210,9,7,9,20,36,61,-25,30
Cowdenbeath,6210,10,4,10,22,23,56,-33,22
Montrose,6211,1,24,7,5,63,34,29,79
Peterhead,6211,2,24,4,8,83,39,44,76
Stirling,6211,3,17,6,13,62,51,11,57
Clyde,6211,4,15,9,12,53,49,4,54
Stenhousem'r,6211,5,15,8,13,55,48,7,53
Elgin,6211,6,14,6,16,53,64,-11,48
Annan Athlet,6211,7,12,11,13,48,41,7,47
Berwick,6211,8,8,10,18,30,60,-30,34
Edinburgh Ci,6211,9,7,9,20,37,66,-29,30
Cowdenbeath,6211,10,4,10,22,23,55,-32,22
Peterhead,6212,1,24,4,8,81,38,43,76
Montrose,6212,2,23,7,6,59,36,23,76
Stenhousem'r,6212,3,16,8,12,58,47,11,56
Stirling,6212,4,16,6,14,61,54,7,54
Clyde,6212,5,15,9,12,52,48,4,54
Elgin,6212,6,15,6,15,55,60,-5,51
Annan Athlet,6212,7,11,11,14,47,42,5,44
Berwick,6212,8,8,10,18,29,59,-30,34
Edinburgh Ci,6212,9,7,9,20,36,64,-28,30
Cowdenbeath,6212,10,5,10,21,24,54,-30,25
Montrose,6213,1,24,7,5,61,35,26,79
Peterhead,6213,2,23,5,8,78,39,39,74
Stirling,6213,3,17,6,13,63,51,12,57
Stenhousem'r,6213,4,15,8,13,55,49,6,53
Clyde,6213,5,14,10,12,52,49,3,52
Elgin,6213,6,14,6,16,54,62,-8,48
Annan Athlet,6213,7,11,12,13,47,41,6,45
Berwick,6213,8,8,11,17,30,59,-29,35
Edinburgh Ci,6213,9,7,10,19,37,61,-24,31
Cowdenbeath,6213,10,4,11,21,23,54,-31,23
Montrose,6214,1,24,7,5,63,35,28,79
Peterhead,6214,2,24,4,8,82,40,42,76
Stenhousem'r,6214,3,16,8,12,58,47,11,56
Stirling,6214,4,16,6,14,61,54,7,54
Clyde,6214,5,14,10,12,53,50,3,52
Elgin,6214,6,14,6,16,54,64,-10,48
Annan Athlet,6214,7,12,11,13,48,41,7,47
Berwick,6214,8,8,11,17,31,60,-29,35
Edinburgh Ci,6214,9,7,9,20,38,65,-27,30
Cowdenbeath,6214,10,4,10,22,23,55,-32,22
Montrose,6215,1,24,7,5,62,34,28,79
Peterhead,6215,2,24,4,8,80,39,41,76
Stenhousem'r,6215,3,16,8,12,57,46,11,56
Stirling,6215,4,16,6,14,60,53,7,54
Clyde,6215,5,15,9,12,53,49,4,54
Elgin,6215,6,14,6,16,53,63,-10,48
Annan Athlet,6215,7,11,12,13,47,41,6,45
Berwick,6215,8,8,10,18,30,60,-30,34
Edinburgh Ci,6215,9,7,9,20,37,63,-26,30
Cowdenbeath,6215,10,4,11,21,23,54,-31,23
Montrose,6216,1,24,7,5,60,34,26,79
Peterhead,6216,2,23,5,8,77,38,39,74
Stenhousem'r,6216,3,16,8,12,56,46,10,56
Stirling,6216,4,16,6,14,60,52,8,54
Clyde,6216,5,14,9,13,51,49,2,51
Elgin,6216,6,14,6,16,53,61,-8,48
Annan Athlet,6216,7,11,11,14,48,44,4,44
Berwick,6216,8,9,10,17,30,58,-28,37
Edinburgh Ci,6216,9,7,10,19,36,60,-24,31
Cowdenbeath,6216,10,5,10,21,26,55,-29,25
Montrose,6217,1,24,7,5,61,35,26,79
Peterhead,6217,2,24,4,8,83,39,44,76
Stirling,6217,3,16,7,13,60,51,9,55
Stenhousem'r,6217,4,15,9,12,55,46,9,54
Clyde,6217,5,14,10,12,51,48,3,52
Elgin,6217,6,14,6,16,54,62,-8,48
Annan Athlet,6217,7,12,11,13,50,41,9,47
Berwick,6217,8,8,11,17,29,58,-29,35
Edinburgh Ci,6217,9,7,9,20,37,66,-29,30
Cowdenbeath,6217,10,4,10,22,23,57,-34,22
Peterhead,6218,1,24,4,8,79,39,40,76
Montrose,6218,2,23,7,6,60,38,22,76
Stirling,6218,3,17,6,13,62,52,10,57
Clyde,6218,4,15,9,12,53,48,5,54
Stenhousem'r,6218,5,15,8,13,56,48,8,53
Elgin,6218,6,15,6,15,57,61,-4,51
Annan Athlet,6218,7,11,12,13,48,42,6,45
Berwick,6218,8,8,10,18,29,60,-31,34
Edinburgh Ci,6218,9,7,9,20,37,62,-25,30
Cowdenbeath,6218,10,4,11,21,24,55,-31,23
Montrose,6219,1,23,8,5,59,34,25,77
Peterhead,6219,2,24,4,8,80,39,41,76
Stirling,6219,3,17,6,13,63,53,10,57
Clyde,6219,4,15,9,12,52,48,4,54
Stenhousem'r,6219,5,15,8,13,57,49,8,53
Elgin,6219,6,14,7,15,53,60,-7,49
Annan Athlet,6219,7,11,12,13,47,41,6,45
Berwick,6219,8,8,10,18,29,59,-30,34
Edinburgh Ci,6219,9,7,9,20,37,63,-26,30
Cowdenbeath,6219,10,4,11,21,23,54,-31,23
Peterhead,6220,1,24,4,8,80,38,42,76
Montrose,6220,2,23,7,6,59,36,23,76
Stirling,6220,3,17,6,13,64,53,11,57
Clyde,6220,4,15,9,12,54,49,5,54
Stenhousem'r,6220,5,15,8,13,57,50,7,53
Elgin,6220,6,15,6,15,55,60,-5,51
Annan Athlet,6220,7,12,11,13,48,41,7,47
Berwick,6220,8,8,10,18,30,61,-31,34
Edinburgh Ci,6220,9,7,9,20,36,63,-27,30
Cowdenbeath,6220,10,4,10,22,23,55,-32,22
Montrose,6221,1,24,7,5,61,35,26,79
Peterhead,6221,2,24,4,8,79,38,41,76
Stenhousem'r,6221,3,16,8,12,57,47,10,56
Stirling,6221,4,16,6,14,61,53,8,54
Clyde,6221,5,14,9,13,51,49,2,51
Elgin,6221,6,14,6,16,54,62,-8,48
Annan Athlet,6221,7,12,11,13,50,42,8,47
Berwick,6221,8,9,10,17,30,58,-28,37
Edinburgh Ci,6221,9,7,9,20,36,62,-26,30
Cowdenbeath,6221,10,4,10,22,24,57,-33,22
Montrose,6222,1,24,7,5,64,35,29,79
Peterhead,6222,2,24,4,8,79,39,40,76
Stirling,6222,3,17,6,13,63,52,11,57
Clyde,6222,4,15,9,12,53,48,5,54
Stenhousem'r,6222,5,15,8,13,56,49,7,53
Elgin,6222,6,14,6,16,54,65,-11,48
Annan Athlet,6222,7,12,11,13,50,41,9,47
Berwick,6222,8,8,10,18,29,60,-31,34
Edinburgh Ci,6222,9,7,9,20,37,62,-25,30
Cowdenbeath,6222,10,4,10,22,23,57,-34,22
Montrose,6223,1,23,7,6,59,35,24,76
Peterhead,6223,2,23,5,8,78,39,39,74
Stirling,6223,3,16,7,13,61,52,9,55
Stenhousem'r,6223,4,15,9,12,56,47,9,54
Clyde,6223,5,14,10,12,52,49,3,52
Elgin,6223,6,15,6,15,54,60,-6,51
Annan Athlet,6223,7,12,11,13,49,42,7,47
Berwick,6223,8,8,11,17,30,59,-29,35
Edinburgh Ci,6223,9,7,10,19,37,61,-24,31
Cowdenbeath,6223,10,4,10,22,24,56,-32,22
Montrose,6224,1,24,7,5,63,36,27,79
Peterhead,6224,2,24,4,8,80,39,41,76
Stirling,6224,3,17,6,13,62,51,11,57
Clyde,6224,4,15,9,12,54,50,4,54
Stenhousem'r,6224,5,15,8,13,55,48,7,53
Elgin,6224,6,14,6,16,55,64,-9,48
Annan Athlet,6224,7,11,11,14,47,42,5,44
Berwick,6224,8,8,10,18,31,61,-30,34
Edinburgh Ci,6224,9,7,9,20,37,63,-26,30
Cowdenbeath,6224,10,5,10,21,24,54,-30,25
Montrose,6225,1,24,7,5,63,34,29,79
Peterhead,6225,2,24,4,8,81,40,41,76
Stirling,6225,3,17,6,13,63,51,12,57
Clyde,6225,4,15,9,12,55,49,6,54
Stenhousem'r,6225,5,15,8,13,55,49,6,53
Elgin,6225,6,14,6,16,53,64,-11,48
Annan Athlet,6225,7,12,11,13,48,41,7,47
Berwick,6225,8,8,10,18,30,62,-32,34
Edinburgh Ci,6225,9,7,9,20,38,64,-26,30
Cowdenbeath,6225,10,4,10,22,23,55,-32,22
Montrose,6226,1,24,7,5,65,36,29,79
Peterhead,6226,2,24,4,8,81,39,42,76
Stirling,6226,3,17,6,13,61,51,10,57
Stenhousem'r,6226,4,15,8,13,55,47,8,53
Clyde,6226,5,14,10,12,54,51,3,52
Elgin,6226,6,14,6,16,55,66,-11,48
Annan Athlet,6226,7,11,12,13,47,41,6,45
Berwick,6226,8,8,11,17,32,61,-29,35
Edinburgh Ci,6226,9,7,9,20,37,64,-27,30
Cowdenbeath,6226,10,4,11,21,23,54,-31,23
Montrose,6227,1,24,7,5,61,34,27,79
Peterhead,6227,2,24,4,8,81,38,43,76
Stirling,6227,3,17,6,13,63,53,10,57
Clyde,6227,4,15,9,12,53,48,5,54
Stenhousem'r,6227,5,15,8,13,57,49,8,53
Elgin,6227,6,14,6,16,53,62,-9,48
Annan Athlet,6227,7,11,12,13,49,43,6,45
Berwick,6227,8,8,10,18,29,60,-31,34
Edinburgh Ci,6227,9,7,9,20,36,64,-28,30
Cowdenbeath,6227,10,4,11,21,25,56,-31,23
Montrose,6228,1,24,7,5,63,34,29,79
Peterhead,6228,2,23,4,9,77,40,37,73
Stirling,6228,3,17,6,13,64,53,11,57
Stenhousem'r,6228,4,15,8,13,57,50,7,53
Clyde,6228,5,14,9,13,51,51,0,51
Elgin,6228,6,14,6,16,53,64,-11,48
Annan Athlet,6228,7,11,12,13,48,42,6,45
Berwick,6228,8,9,10,17,32,58,-26,37
Edinburgh Ci,6228,9,8,9,19,38,60,-22,33
Cowdenbeath,6228,10,4,11,21,24,55,-31,23
Montrose,6229,1,24,7,5,61,34,27,79
Peterhead,6229,2,24,4,8,79,38,41,76
Stirling,6229,3,17,6,13,61,51,10,57
Clyde,6229,4,15,9,12,53,49,4,54
Stenhousem'r,6229,5,15,8,13,55,47,8,53
Elgin,6229,6,14,6,16,53,62,-9,48
Annan Athlet,6229,7,11,11,14,47,42,5,44
Berwick,6229,8,8,10,18,30,60,-30,34
Edinburgh Ci,6229,9,7,9,20,36,62,-26,30
Cowdenbeath,6229,10,5,10,21,24,54,-30,25
Peterhead,6230,1,24,4,8,80,40,40,76
Montrose,6230,2,23,7,6,59,35,24,76
Stenhousem'r,6230,3,16,8,12,56,46,10,56
Stirling,6230,4,16,6,14,60,52,8,54
Clyde,6230,5,14,9,13,52,51,1,51
Elgin,6230,6,15,6,15,54,60,-6,51
Annan Athlet,6230,7,11,12,13,48,42,6,45
Berwick,6230,8,9,10,17,32,59,-27,37
Edinburgh Ci,6230,9,7,9,20,38,63,-25,30
Cowdenbeath,6230,10,4,11,21,24,55,-31,23
Montrose,6231,1,23,8,5,60,35,25,77
Peterhead,6231,2,24,4,8,79,39,40,76
Stirling,6231,3,17,6,13,64,53,11,57
Clyde,6231,4,15,9,12,54,48,6,54
Stenhousem'r,6231,5,15,8,13,57,50,7,53
Elgin,6231,6,14,7,15,54,61,-7,49
Annan Athlet,6231,7,12,11,13,49,41,8,47
Berwick,6231,8,8,10,18,29,61,-32,34
Edinburgh Ci,6231,9,7,9,20,37,62,-25,30
Cowdenbeath,6231,10,4,10,22,23,56,-33,22
Montrose,6232,1,24,7,5,63,35,28,79
Peterhead,6232,2,24,4,8,80,38,42,76
Stirling,6232,3,17,6,13,62,51,11,57
Stenhousem'r,6232,4,15,8,13,55,48,7,53
Clyde,6232,5,14,9,13,52,50,2,51
Elgin,6232,6,14,6,16,54,64,-10,48
Annan Athlet,6232,7,11,12,13,48,42,6,45
Berwick,6232,8,9,10,17,31,59,-28,37
Edinburgh Ci,6232,9,7,9,20,36,63,-27,30
Cowdenbeath,6232,10,4,11,21,24,55,-31,23
Peterhead,6233,1,24,4,8,81,38,43,76
Montrose,6233,2,23,7,6,60,38,22,76
Stirling,6233,3,17,6,13,65,53,12,57
Stenhousem'r,6233,4,15,8,13,57,51,6,53
Clyde,6233,5,14,10,12,53,50,3,52
Elgin,6233,6,15,6,15,57,61,-4,51
Annan Athlet,6233,7,11,12,13,51,45,6,45
Berwick,6233,8,8,11,17,31,60,-29,35
Edinburgh Ci,6233,9,7,9,20,36,64,-28,30
Cowdenbeath,6233,10,4,11,21,27,58,-31,23
Montrose,6234,1,24,7,5,63,35,28,79
Peterhead,6234,2,24,4,8,80,39,41,76
Stirling,6234,3,16,7,13,61,52,9,55
Stenhousem'r,6234,4,15,9,12,56,47,9,54
Clyde,6234,5,14,10,12,52,49,3,52
Elgin,6234,6,14,6,16,54,64,-10,48
Annan Athlet,6234,7,11,12,13,47,41,6,45
Berwick,6234,8,8,11,17,30,59,-29,35
Edinburgh Ci,6234,9,7,9,20,37,63,-26,30
Cowdenbeath,6234,10,4,11,21,23,54,-31,23
Montrose,6235,1,24,7,5,62,35,27,79
Peterhead,6235,2,23,4,9,77,39,38,73
Stirling,6235,3,16,7,13,63,54,9,55
Stenhousem'r,6235,4,15,9,12,58,49,9,54
Clyde,6235,5,15,9,12,53,49,4,54
Elgin,6235,6,14,6,16,54,63,-9,48
Annan Athlet,6235,7,11,12,13,48,42,6,45
Berwick,6235,8,8,10,18,30,60,-30,34
Edinburgh Ci,6235,9,8,9,19,37,60,-23,33
Cowdenbeath,6235,10,4,11,21,24,55,-31,23
Montrose,6236,1,24,7,5,61,35,26,79
Peterhead,6236,2,23,4,9,77,39,38,73
Stenhousem'r,6236,3,16,8,12,57,46,11,56
Stirling,6236,4,16,6,14,60,53,7,54
Clyde,6236,5,14,9,13,51,50,1,51
Elgin,6236,6,14,6,16,54,62,-8,48
Annan Athlet,6236,7,12,11,13,49,41,8,47
Berwick,6236,8,9,10,17,31,58,-27,37
Edinburgh Ci,6236,9,8,9,19,37,60,-23,33
Cowdenbeath,6236,10,4,10,22,23,56,-33,22
Montrose,6237,1,24,7,5,61,35,26,79
Peterhead,6237,2,24,4,8,81,39,42,76
Stirling,6237,3,17,6,13,61,51,10,57
Clyde,6237,4,15,9,12,53,49,4,54
Stenhousem'r,6237,5,15,8,13,55,47,8,53
Elgin,6237,6,14,6,16,54,62,-8,48
Annan Athlet,6237,7,11,11,14,47,42,5,44
Berwick,6237,8,8,10,18,30,60,-30,34
Edinburgh Ci,6237,9,7,9,20,37,64,-27,30
Cowdenbeath,6237,10,5,10,21,24,54,-30,25
Montrose,6238,1,23,8,5,62,37,25,77
Peterhead,6238,2,24,4,8,81,38,43,76
Stirling,6238,3,16,7,13,60,51,9,55
Stenhousem'r,6238,4,15,9,12,55,46,9,54
Clyde,6238,5,15,9,12,54,50,4,54
Elgin,6238,6,14,7,15,56,63,-7,49
Annan Athlet,6238,7,11,11,14,47,46,1,44
Berwick,6238,8,8,10,18,31,61,-30,34
Edinburgh Ci,6238,9,7,9,20,36,64,-28,30
Cowdenbeath,6238,10,5,10,21,28,54,-26,25
Montrose,6239,1,24,7,5,63,36,27,79
Peterhead,6239,2,24,4,8,80,40,40,76
Stirling,6239,3,16,7,13,61,52,9,55
Stenhousem'r,6239,4,15,9,12,56,47,9,54
Clyde,6239,5,15,9,12,54,50,4,54
Elgin,6239,6,14,6,16,55,64,-9,48
Annan Athlet,6239,7,11,11,14,48,43,5,44
Berwick,6239,8,8,10,18,31,61,-30,34
Edinburgh Ci,6239,9,7,9,20,38,63,-25,30
Cowdenbeath,6239,10,5,10,21,25,55,-30,25
Montrose,6240,1,24,7,5,60,34,26,79
Peterhead,6240,2,24,4,8,78,38,40,76
Stenhousem'r,6240,3,16,8,12,57,47,10,56
Stirling,6240,4,16,6,14,61,53,8,54
Clyde,6240,5,15,9,12,54,48,6,54
Elgin,6240,6,14,6,16,53,61,-8,48
Annan Athlet,6240,7,12,11,13,48,41,7,47
Berwick,6240,8,8,10,18,29,61,-32,34
Edinburgh Ci,6240,9,7,9,20,36,61,-25,30
Cowdenbeath,6240,10,4,10,22,23,55,-32,22
Montrose,6241,1,24,7,5,62,35,27,79
Peterhead,6241,2,24,4,8,79,38,41,76
Stenhousem'r,6241,3,16,8,12,58,48,10,56
Stirling,6241,4,16,6,14,62,54,8,54
Clyde,6241,5,14,10,12,51,48,3,52
Elgin,6241,6,14,6,16,54,63,-9,48
Annan Athlet,6241,7,12,11,13,48,41,7,47
Berwick,6241,8,8,11,17,29,58,-29,35
Edinburgh Ci,6241,9,7,9,20,36,62,-26,30
Cowdenbeath,6241,10,4,10,22,23,55,-32,22
Montrose,6242,1,24,7,5,61,35,26,79
Peterhead,6242,2,24,4,8,82,39,43,76
Stirling,6242,3,17,6,13,64,52,12,57
Stenhousem'r,6242,4,15,8,13,56,50,6,53
Clyde,6242,5,14,10,12,52,49,3,52
Elgin,6242,6,14,6,16,54,62,-8,48
Annan Athlet,6242,7,12,11,13,49,41,8,47
Berwick,6242,8,8,11,17,30,59,-29,35
Edinburgh Ci,6242,9,7,9,20,37,65,-28,30
Cowdenbeath,6242,10,4,10,22,23,56,-33,22
Montrose,6243,1,24,7,5,61,35,26,79
Peterhead,6243,2,23,5,8,78,39,39,74
Stirling,6243,3,17,6,13,62,52,10,57
Stenhousem'r,6243,4,15,8,13,56,48,8,53
Clyde,6243,5,14,10,12,51,48,3,52
Elgin,6243,6,14,6,16,54,62,-8,48
Annan Athlet,6243,7,12,11,13,49,41,8,47
Berwick,6243,8,8,11,17,29,58,-29,35
Edinburgh Ci,6243,9,7,10,19,37,61,-24,31
Cowdenbeath,6243,10,4,10,22,23,56,-33,22
Montrose,6244,1,23,8,5,60,35,25,77
Peterhead,6244,2,24,4,8,81,38,43,76
Stirling,6244,3,17,6,13,61,51,10,57
Clyde,6244,4,15,9,12,53,49,4,54
Stenhousem'r,6244,5,15,8,13,55,47,8,53
Elgin,6244,6,14,7,15,54,61,-7,49
Annan Athlet,6244,7,11,12,13,47,41,6,45
Berwick,6244,8,8,10,18,30,60,-30,34
Edinburgh Ci,6244,9,7,9,20,36,64,-28,30
Cowdenbeath,6244,10,4,11,21,23,54,-31,23
Montrose,6245,1,24,7,5,60,34,26,79
Peterhead,6245,2,24,4,8,81,38,43,76
Stirling,6245,3,17,6,13,61,51,10,57
Clyde,6245,4,15,9,12,55,50,5,54
Stenhousem'r,6245,5,15,8,13,55,47,8,53
Elgin,6245,6,14,6,16,53,61,-8,48
Annan Athlet,6245,7,11,11,14,47,42,5,44
Berwick,6245,8,8,10,18,31,62,-31,34
Edinburgh Ci,6245,9,7,9,20,36,64,-28,30
Cowdenbeath,6245,10,5,10,21,24,54,-30,25
Montrose,6246,1,24,7,5,60,34,26,79
Peterhead,6246,2,24,4,8,81,38,43,76
Stenhousem'r,6246,3,16,8,12,58,47,11,56
Stirling,6246,4,16,6,14,61,54,7,54
Clyde,6246,5,15,9,12,55,48,7,54
Elgin,6246,6,14,6,16,53,61,-8,48
Annan Athlet,6246,7,11,11,14,47,42,5,44
Berwick,6246,8,8,10,18,29,62,-33,34
Edinburgh Ci,6246,9,7,9,20,36,64,-28,30
Cowdenbeath,6246,10,5,10,21,24,54,-30,25
Montrose,6247,1,23,8,5,61,36,25,77
Peterhead,6247,2,24,4,8,82,39,43,76
Stenhousem'r,6247,3,16,8,12,57,47,10,56
Stirling,6247,4,16,6,14,61,53,8,54
Clyde,6247,5,15,9,12,54,48,6,54
Elgin,6247,6,14,7,15,55,62,-7,49
Annan Athlet,6247,7,12,11,13,49,42,7,47
Berwick,6247,8,8,10,18,29,61,-32,34
Edinburgh Ci,6247,9,7,9,20,37,65,-28,30
Cowdenbeath,6247,10,4,10,22,24,56,-32,22
Montrose,6248,1,23,8,5,60,35,25,77
Peterhead,6248,2,24,4,8,79,39,40,76
Stenhousem'r,6248,3,16,8,12,57,47,10,56
Stirling,6248,4,16,6,14,61,53,8,54
Clyde,6248,5,15,9,12,53,48,5,54
Elgin,6248,6,14,7,15,54,61,-7,49
Annan Athlet,6248,7,12,11,13,48,41,7,47
Berwick,6248,8,8,10,18,29,60,-31,34
Edinburgh Ci,6248,9,7,9,20,37,62,-25,30
Cowdenbeath,6248,10,4,10,22,23,55,-32,22
Montrose,6249,1,24,7,5,61,34,27,79
Peterhead,6249,2,23,5,8,77,38,39,74
Stirling,6249,3,17,6,13,64,53,11,57
Stenhousem'r,6249,4,15,8,13,57,50,7,53
Clyde,6249,5,14,9,13,52,50,2,51
Elgin,6249,6,14,6,16,53,62,-9,48
Annan Athlet,6249,7,12,11,13,48,41,7,47
Berwick,6249,8,9,10,17,31,59,-28,37
Edinburgh Ci,6249,9,7,10,19,36,60,-24,31
Cowdenbeath,6249,10,4,10,22,23,55,-32,22
Montrose,6250,1,24,7,5,61,35,26,79
Peterhead,6250,2,24,4,8,81,39,42,76
Stirling,6250,3,17,6,13,63,53,10,57
Clyde,6250,4,15,9,12,54,48,6,54
Stenhousem'r,6250,5,15,8,13,57,49,8,53
Elgin,6250,6,14,6,16,54,62,-8,48
Annan Athlet,6250,7,12,11,13,48,41,7,47
Berwick,6250,8,8,10,18,29,61,-32,34
Edinburgh Ci,6250,9,7,9,20,37,64,-27,30
Cowdenbeath,6250,10,4,10,22,23,55,-32,22
Montrose,6251,1,24,7,5,62,34,28,79
Peterhead,6251,2,24,4,8,84,39,45,76
Stirling,6251,3,17,6,13,62,52,10,57
Stenhousem'r,6251,4,15,8,13,56,48,8,53
Clyde,6251,5,14,9,13,52,50,2,51
Elgin,6251,6,14,6,16,53,63,-10,48
Annan Athlet,6251,7,12,11,13,48,41,7,47
Berwick,6251,8,9,10,17,31,59,-28,37
Edinburgh Ci,6251,9,7,9,20,37,67,-30,30
Cowdenbeath,6251,10,4,10,22,23,55,-32,22
Montrose,6252,1,23,8,5,60,35,25,77
Peterhead,6252,2,24,4,8,80,40,40,76
Stirling,6252,3,17,6,13,63,53,10,57
Clyde,6252,4,15,9,12,54,49,5,54
Stenhousem'r,6252,5,15,8,13,57,49,8,53
Elgin,6252,6,14,7,15,54,61,-7,49
Annan Athlet,6252,7,12,11,13,48,41,7,47
Berwick,6252,8,8,10,18,30,61,-31,34
Edinburgh Ci,6252,9,7,9,20,38,63,-25,30
Cowdenbeath,6252,10,4,10,22,23,55,-32,22
Montrose,6253,1,24,7,5,62,35,27,79
Peterhead,6253,2,24,4,8,78,38,40,76
Stirling,6253,3,17,6,13,61,51,10,57
Clyde,6253,4,15,9,12,56,48,8,54
Stenhousem'r,6253,5,15,8,13,55,47,8,53
Elgin,6253,6,14,6,16,54,63,-9,48
Annan Athlet,6253,7,12,11,13,49,42,7,47
Berwick,6253,8,8,10,18,29,63,-34,34
Edinburgh Ci,6253,9,7,9,20,36,61,-25,30
Cowdenbeath,6253,10,4,10,22,24,56,-32,22
Montrose,6254,1,24,7,5,63,35,28,79
Peterhead,6254,2,24,4,8,84,38,46,76
Stirling,6254,3,17,6,13,64,52,12,57
Stenhousem'r,6254,4,15,8,13,56,50,6,53
Clyde,6254,5,14,9,13,53,51,2,51
Elgin,6254,6,14,6,16,54,64,-10,48
Annan Athlet,6254,7,12,11,13,49,42,7,47
Berwick,6254,8,9,10,17,32,60,-28,37
Edinburgh Ci,6254,9,7,9,20,36,67,-31,30
Cowdenbeath,6254,10,4,10,22,24,56,-32,22
Montrose,6255,1,24,7,5,62,36,26,79
Peterhead,6255,2,24,4,8,82,38,44,76
Stenhousem'r,6255,3,16,8,12,57,46,11,56
Stirling,6255,4,16,6,14,60,53,7,54
Clyde,6255,5,15,9,12,53,48,5,54
Elgin,6255,6,14,6,16,55,63,-8,48
Annan Athlet,6255,7,11,11,14,47,42,5,44
Berwick,6255,8,8,10,18,29,60,-31,34
Edinburgh Ci,6255,9,7,9,20,36,65,-29,30
Cowdenbeath,6255,10,5,10,21,24,54,-30,25
Montrose,6256,1,24,7,5,62,35,27,79
Peterhead,6256,2,24,4,8,80,38,42,76
Stirling,6256,3,17,6,13,63,52,11,57
Stenhousem'r,6256,4,15,8,13,56,49,7,53
Clyde,6256,5,14,10,12,53,50,3,52
Elgin,6256,6,14,6,16,54,63,-9,48
Annan Athlet,6256,7,12,11,13,50,42,8,47
Berwick,6256,8,8,11,17,31,60,-29,35
Edinburgh Ci,6256,9,7,9,20,36,63,-27,30
Cowdenbeath,6256,10,4,10,22,24,57,-33,22
Montrose,6257,1,24,7,5,62,35,27,79
Peterhead,6257,2,23,5,8,78,39,39,74
Stirling,6257,3,17,6,13,61,51,10,57
Clyde,6257,4,15,9,12,53,49,4,54
Stenhousem'r,6257,5,15,8,13,55,47,8,53
Elgin,6257,6,14,6,16,54,63,-9,48
Annan Athlet,6257,7,12,11,13,51,44,7,47
Berwick,6257,8,8,10,18,30,60,-30,34
Edinburgh Ci,6257,9,7,10,19,37,61,-24,31
Cowdenbeath,6257,10,4,10,22,26,58,-32,22
Montrose,6258,1,23,7,6,59,37,22,76
Peterhead,6258,2,23,5,8,77,38,39,74
Stenhousem'r,6258,3,16,8,12,58,47,11,56
Stirling,6258,4,16,6,14,61,54,7,54
Clyde,6258,5,14,9,13,51,50,1,51
Elgin,6258,6,15,6,15,56,60,-4,51
Annan Athlet,6258,7,12,11,13,50,42,8,47
Berwick,6258,8,9,10,17,31,58,-27,37
Edinburgh Ci,6258,9,7,10,19,36,60,-24,31
Cowdenbeath,6258,10,4,10,22,24,57,-33,22
Peterhead,6259,1,24,4,8,82,39,43,76
Montrose,6259,2,23,7,6,60,36,24,76
Stenhousem'r,6259,3,16,8,12,57,47,10,56
Stirling,6259,4,16,6,14,61,53,8,54
Clyde,6259,5,15,9,12,54,49,5,54
Elgin,6259,6,15,6,15,55,61,-6,51
Annan Athlet,6259,7,11,12,13,48,42,6,45
Berwick,6259,8,8,10,18,30,61,-31,34
Edinburgh Ci,6259,9,7,9,20,37,65,-28,30
Cowdenbeath,6259,10,4,11,21,24,55,-31,23
Montrose,6260,1,23,8,5,59,34,25,77
Peterhead,6260,2,23,5,8,78,39,39,74
Stirling,6260,3,17,6,13,63,51,12,57
Clyde,6260,4,15,9,12,54,48,6,54
Stenhousem'r,6260,5,15,8,13,55,49,6,53
Elgin,6260,6,14,7,15,53,60,-7,49
Annan Athlet,6260,7,11,11,14,47,43,4,44
Berwick,6260,8,8,10,18,29,61,-32,34
Edinburgh Ci,6260,9,7,10,19,37,61,-24,31
Cowdenbeath,6260,10,5,10,21,25,54,-29,25
Montrose,6261,1,23,8,5,60,35,25,77
Peterhead,6261,2,23,4,9,78,40,38,73
Stirling,6261,3,17,6,13,63,51,12,57
Clyde,6261,4,15,9,12,52,48,4,54
Stenhousem'r,6261,5,15,8,13,55,49,6,53
Elgin,6261,6,14,7,15,54,61,-7,49
Annan Athlet,6261,7,11,11,14,47,42,5,44
Berwick,6261,8,8,10,18,29,59,-30,34
Edinburgh Ci,6261,9,8,9,19,38,61,-23,33
Cowdenbeath,6261,10,5,10,21,24,54,-30,25
Montrose,6262,1,24,7,5,61,35,26,79
Peterhead,6262,2,23,5,8,79,40,39,74
Stirling,6262,3,16,7,13,61,52,9,55
Stenhousem'r,6262,4,15,9,12,56,47,9,54
Clyde,6262,5,15,9,12,54,49,5,54
Elgin,6262,6,14,6,16,54,62,-8,48
Annan Athlet,6262,7,12,11,13,48,41,7,47
Berwick,6262,8,8,10,18,30,61,-31,34
Edinburgh Ci,6262,9,7,10,19,38,62,-24,31
Cowdenbeath,6262,10,4,10,22,23,55,-32,22
Montrose,6263,1,24,7,5,60,34,26,79
Peterhead,6263,2,24,4,8,82,38,44,76
Stenhousem'r,6263,3,16,8,12,57,47,10,56
Stirling,6263,4,16,6,14,61,53,8,54
Clyde,6263,5,15,9,12,53,49,4,54
Elgin,6263,6,14,6,16,53,61,-8,48
Annan Athlet,6263,7,11,12,13,49,43,6,45
Berwick,6263,8,8,10,18,30,60,-30,34
Edinburgh Ci,6263,9,7,9,20,36,65,-29,30
Cowdenbeath,6263,10,4,11,21,25,56,-31,23
Montrose,6264,1,24,7,5,60,34,26,79
Peterhead,6264,2,23,5,8,79,40,39,74
Stenhousem'r,6264,3,16,8,12,58,47,11,56
Stirling,6264,4,16,6,14,61,54,7,54
Clyde,6264,5,15,9,12,52,48,4,54
Elgin,6264,6,14,6,16,53,61,-8,48
Annan Athlet,6264,7,11,11,14,47,42,5,44
Berwick,6264,8,8,10,18,29,59,-30,34
Edinburgh Ci,6264,9,7,10,19,38,62,-24,31
Cowdenbeath,6264,10,5,10,21,24,54,-30,25
Montrose,6265,1,24,7,5,61,35,26,79
Peterhead,6265,2,24,4,8,81,38,43,76
Stirling,6265,3,17,6,13,61,51,10,57
Clyde,6265,4,15,9,12,53,48,5,54
Stenhousem'r,6265,5,15,8,13,55,47,8,53
Elgin,6265,6,14,6,16,54,62,-8,48
Annan Athlet,6265,7,11,12,13,48,42,6,45
Berwick,6265,8,8,10,18,29,60,-31,34
Edinburgh Ci,6265,9,7,9,20,36,64,-28,30
Cowdenbeath,6265,10,4,11,21,24,55,-31,23
Montrose,6266,1,24,7,5,61,34,27,79
Peterhead,6266,2,23,5,8,77,38,39,74
Stirling,6266,3,16,7,13,61,52,9,55
Stenhousem'r,6266,4,15,9,12,56,47,9,54
Clyde,6266,5,15,9,12,53,48,5,54
Elgin,6266,6,14,6,16,53,62,-9,48
Annan Athlet,6266,7,11,12,13,47,41,6,45
Berwick,6266,8,8,10,18,29,60,-31,34
Edinburgh Ci,6266,9,7,10,19,36,60,-24,31
Cowdenbeath,6266,10,4,11,21,23,54,-31,23
Montrose,6267,1,24,7,5,61,34,27,79
Peterhead,6267,2,24,4,8,82,40,42,76
Stenhousem'r,6267,3,16,8,12,59,46,13,56
Clyde,6267,4,15,9,12,56,50,6,54
Stirling,6267,5,16,6,14,60,55,5,54
Elgin,6267,6,14,6,16,53,62,-9,48
Annan Athlet,6267,7,12,11,13,49,42,7,47
Berwick,6267,8,8,10,18,31,63,-32,34
Edinburgh Ci,6267,9,7,9,20,38,65,-27,30
Cowdenbeath,6267,10,4,10,22,24,56,-32,22
Peterhead,6268,1,24,4,8,80,39,41,76
Montrose,6268,2,23,7,6,60,36,24,76
Stirling,6268,3,17,6,13,62,51,11,57
Clyde,6268,4,15,9,12,54,48,6,54
Stenhousem'r,6268,5,15,8,13,55,48,7,53
Elgin,6268,6,15,6,15,55,61,-6,51
Annan Athlet,6268,7,11,11,14,47,42,5,44
Berwick,6268,8,8,10,18,29,61,-32,34
Edinburgh Ci,6268,9,7,9,20,37,63,-26,30
Cowdenbeath,6268,10,5,10,21,24,54,-30,25
Montrose,6269,1,24,7,5,61,35,26,79
Peterhead,6269,2,24,4,8,79,38,41,76
Stirling,6269,3,16,7,13,61,52,9,55
Stenhousem'r,6269,4,15,9,12,56,47,9,54
Clyde,6269,5,14,9,13,52,50,2,51
Elgin,6269,6,14,6,16,54,62,-8,48
Annan Athlet,6269,7,11,11,14,47,43,4,44
Berwick,6269,8,9,10,17,31,59,-28,37
Edinburgh Ci,6269,9,7,9,20,36,62,-26,30
Cowdenbeath,6269,10,5,10,21,25,54,-29,25
Montrose,6270,1,24,7,5,61,35,26,79
Peterhead,6270,2,24,4,8,80,40,40,76
Stirling,6270,3,16,7,13,61,52,9,55
Stenhousem'r,6270,4,15,9,12,56,47,9,54
Clyde,6270,5,15,9,12,53,49,4,54
Elgin,6270,6,14,6,16,54,62,-8,48
Annan Athlet,6270,7,11,11,14,49,45,4,44
Berwick,6270,8,8,10,18,30,60,-30,34
Edinburgh Ci,6270,9,7,9,20,38,63,-25,30
Cowdenbeath,6270,10,5,10,21,27,56,-29,25
Montrose,6271,1,23,8,5,60,35,25,77
Peterhead,6271,2,24,4,8,81,39,42,76
Stirling,6271,3,17,6,13,64,52,12,57
Clyde,6271,4,15,9,12,54,48,6,54
Stenhousem'r,6271,5,15,8,13,56,50,6,53
Elgin,6271,6,14,7,15,54,61,-7,49
Annan Athlet,6271,7,11,11,14,48,44,4,44
Berwick,6271,8,8,10,18,29,61,-32,34
Edinburgh Ci,6271,9,7,9,20,37,64,-27,30
Cowdenbeath,6271,10,5,10,21,26,55,-29,25
Montrose,6272,1,24,7,5,60,34,26,79
Peterhead,6272,2,24,4,8,81,38,43,76
Stirling,6272,3,16,7,13,61,52,9,55
Stenhousem'r,6272,4,15,9,12,56,47,9,54
Clyde,6272,5,14,10,12,51,48,3,52
Elgin,6272,6,14,6,16,53,61,-8,48
Annan Athlet,6272,7,11,11,14,47,43,4,44
Berwick,6272,8,8,11,17,29,58,-29,35
Edinburgh Ci,6272,9,7,9,20,36,64,-28,30
Cowdenbeath,6272,10,5,10,21,25,54,-29,25
Montrose,6273,1,24,7,5,63,36,27,79
Peterhead,6273,2,24,4,8,81,38,43,76
Stirling,6273,3,17,6,13,62,52,10,57
Clyde,6273,4,15,9,12,53,49,4,54
Stenhousem'r,6273,5,15,8,13,56,48,8,53
Elgin,6273,6,14,6,16,55,64,-9,48
Annan Athlet,6273,7,11,12,13,47,41,6,45
Berwick,6273,8,8,10,18,30,60,-30,34
Edinburgh Ci,6273,9,7,9,20,36,64,-28,30
Cowdenbeath,6273,10,4,11,21,23,54,-31,23
Montrose,6274,1,24,7,5,64,35,29,79
Peterhead,6274,2,24,4,8,81,39,42,76
Stirling,6274,3,17,6,13,64,53,11,57
Clyde,6274,4,15,9,12,53,48,5,54
Stenhousem'r,6274,5,15,8,13,57,50,7,53
Elgin,6274,6,14,6,16,54,65,-11,48
Annan Athlet,6274,7,11,11,14,47,42,5,44
Berwick,6274,8,8,10,18,29,60,-31,34
Edinburgh Ci,6274,9,7,9,20,37,64,-27,30
Cowdenbeath,6274,10,5,10,21,24,54,-30,25
Montrose,6275,1,23,8,5,62,37,25,77
Peterhead,6275,2,24,4,8,82,40,42,76
Stirling,6275,3,17,6,13,62,52,10,57
Clyde,6275,4,15,9,12,53,49,4,54
Stenhousem'r,6275,5,15,8,13,56,48,8,53
Elgin,6275,6,14,7,15,56,63,-7,49
Annan Athlet,6275,7,11,12,13,47,41,6,45
Berwick,6275,8,8,10,18,30,60,-30,34
Edinburgh Ci,6275,9,7,9,20,38,65,-27,30
Cowdenbeath,6275,10,4,11,21,23,54,-31,23
Montrose,6276,1,24,7,5,63,34,29,79
Peterhead,6276,2,23,5,8,78,39,39,74
Stirling,6276,3,17,6,13,61,51,10,57
Stenhousem'r,6276,4,15,8,13,55,47,8,53
Clyde,6276,5,14,9,13,52,51,1,51
Elgin,6276,6,14,6,16,53,64,-11,48
Annan Athlet,6276,7,11,12,13,48,42,6,45
Berwick,6276,8,9,10,17,32,59,-27,37
Edinburgh Ci,6276,9,7,10,19,37,61,-24,31
Cowdenbeath,6276,10,4,11,21,24,55,-31,23
Montrose,6277,1,24,7,5,61,35,26,79
Peterhead,6277,2,24,4,8,83,38,45,76
Stirling,6277,3,17,6,13,62,52,10,57
Clyde,6277,4,15,9,12,54,49,5,54
Stenhousem'r,6277,5,15,8,13,56,48,8,53
Elgin,6277,6,14,6,16,54,62,-8,48
Annan Athlet,6277,7,11,12,13,47,41,6,45
Berwick,6277,8,8,10,18,30,61,-31,34
Edinburgh Ci,6277,9,7,9,20,36,66,-30,30
Cowdenbeath,6277,10,4,11,21,23,54,-31,23
Montrose,6278,1,24,7,5,60,34,26,79
Peterhead,6278,2,24,4,8,82,40,42,76
Stenhousem'r,6278,3,16,8,12,56,46,10,56
Stirling,6278,4,16,6,14,60,52,8,54
Clyde,6278,5,15,9,12,55,48,7,54
Elgin,6278,6,14,6,16,53,61,-8,48
Annan Athlet,6278,7,11,12,13,48,42,6,45
Berwick,6278,8,8,10,18,29,62,-33,34
Edinburgh Ci,6278,9,7,9,20,38,65,-27,30
Cowdenbeath,6278,10,4,11,21,24,55,-31,23
Montrose,6279,1,24,7,5,61,35,26,79
Peterhead,6279,2,24,4,8,82,40,42,76
Stirling,6279,3,17,6,13,61,51,10,57
Stenhousem'r,6279,4,15,8,13,55,47,8,53
Clyde,6279,5,14,9,13,51,50,1,51
Elgin,6279,6,14,6,16,54,62,-8,48
Annan Athlet,6279,7,12,11,13,48,41,7,47
Berwick,6279,8,9,10,17,31,58,-27,37
Edinburgh Ci,6279,9,7,9,20,38,65,-27,30
Cowdenbeath,6279,10,4,10,22,23,55,-32,22
Montrose,6280,1,24,7,5,62,36,26,79
Peterhead,6280,2,24,4,8,83,39,44,76
Stirling,6280,3,16,7,13,62,53,9,55
Stenhousem'r,6280,4,15,9,12,57,48,9,54
Clyde,6280,5,15,9,12,53,49,4,54
Elgin,6280,6,14,6,16,55,63,-8,48
Annan Athlet,6280,7,11,12,13,48,42,6,45
Berwick,6280,8,8,10,18,30,60,-30,34
Edinburgh Ci,6280,9,7,9,20,37,66,-29,30
Cowdenbeath,6280,10,4,11,21,24,55,-31,23
Montrose,6281,1,24,7,5,64,34,30,79
Peterhead,6281,2,23,5,8,78,39,39,74
Stenhousem'r,6281,3,16,8,12,57,46,11,56
Stirling,6281,4,16,6,14,60,53,7,54
Clyde,6281,5,14,10,12,52,49,3,52
Elgin,6281,6,14,6,16,53,65,-12,48
Annan Athlet,6281,7,12,11,13,49,41,8,47
Berwick,6281,8,8,11,17,30,59,-29,35
Edinburgh Ci,6281,9,7,10,19,37,61,-24,31
Cowdenbeath,6281,10,4,10,22,23,56,-33,22
Montrose,6282,1,24,7,5,62,34,28,79
Peterhead,6282,2,24,4,8,82,39,43,76
Stirling,6282,3,16,7,13,61,52,9,55
Stenhousem'r,6282,4,15,9,12,56,47,9,54
Clyde,6282,5,15,9,12,56,50,6,54
Elgin,6282,6,14,6,16,53,63,-10,48
Annan Athlet,6282,7,12,11,13,49,42,7,47
Berwick,6282,8,8,10,18,31,63,-32,34
Edinburgh Ci,6282,9,7,9,20,37,65,-28,30
Cowdenbeath,6282,10,4,10,22,24,56,-32,22
Montrose,6283,1,24,7,5,61,35,26,79
Peterhead,6283,2,23,5,8,78,39,39,74
Stirling,6283,3,17,6,13,63,53,10,57
Clyde,6283,4,15,9,12,54,49,5,54
Stenhousem'r,6283,5,15,8,13,57,49,8,53
Elgin,6283,6,14,6,16,54,62,-8,48
Annan Athlet,6283,7,12,11,13,50,43,7,47
Berwick,6283,8,8,10,18,30,61,-31,34
Edinburgh Ci,6283,9,7,10,19,37,61,-24,31
Cowdenbeath,6283,10,4,10,22,25,57,-32,22
Montrose,6284,1,24,7,5,61,35,26,79
Peterhead,6284,2,23,5,8,78,39,39,74
Stenhousem'r,6284,3,16,8,12,56,46,10,56
Stirling,6284,4,16,6,14,60,52,8,54
Clyde,6284,5,15,9,12,52,48,4,54
Elgin,6284,6,14,6,16,54,62,-8,48
Annan Athlet,6284,7,11,11,14,47,42,5,44
Berwick,6284,8,8,10,18,29,59,-30,34
Edinburgh Ci,6284,9,7,10,19,37,61,-24,31
Cowdenbeath,6284,10,5,10,21,24,54,-30,25
Montrose,6285,1,24,7,5,62,34,28,79
Peterhead,6285,2,24,4,8,79,38,41,76
Stirling,6285,3,17,6,13,62,51,11,57
Clyde,6285,4,15,9,12,53,48,5,54
Stenhousem'r,6285,5,15,8,13,55,48,7,53
Elgin,6285,6,14,6,16,53,63,-10,48
Annan Athlet,6285,7,12,11,13,50,42,8,47
Berwick,6285,8,8,10,18,29,60,-31,34
Edinburgh Ci,6285,9,7,9,20,36,62,-26,30
Cowdenbeath,6285,10,4,10,22,24,57,-33,22
Montrose,6286,1,24,7,5,63,34,29,79
Peterhead,6286,2,24,4,8,80,38,42,76
Stirling,6286,3,17,6,13,62,51,11,57
Clyde,6286,4,15,9,12,54,50,4,54
Stenhousem'r,6286,5,15,8,13,55,48,7,53
Elgin,6286,6,14,6,16,53,64,-11,48
Annan Athlet,6286,7,11,12,13,47,41,6,45
Berwick,6286,8,8,10,18,31,61,-30,34
Edinburgh Ci,6286,9,7,9,20,36,63,-27,30
Cowdenbeath,6286,10,4,11,21,23,54,-31,23
Montrose,6287,1,24,7,5,62,36,26,79
Peterhead,6287,2,23,5,8,80,41,39,74
Stirling,6287,3,17,6,13,61,51,10,57
Clyde,6287,4,15,9,12,55,48,7,54
Stenhousem'r,6287,5,15,8,13,55,47,8,53
Elgin,6287,6,14,6,16,55,63,-8,48
Annan Athlet,6287,7,11,12,13,49,43,6,45
Berwick,6287,8,8,10,18,29,62,-33,34
Edinburgh Ci,6287,9,7,10,19,39,63,-24,31
Cowdenbeath,6287,10,4,11,21,25,56,-31,23
Montrose,6288,1,24,7,5,63,35,28,79
Peterhead,6288,2,24,4,8,82,40,42,76
Stirling,6288,3,17,6,13,64,51,13,57
Clyde,6288,4,15,9,12,52,48,4,54
Stenhousem'r,6288,5,15,8,13,55,50,5,53
Elgin,6288,6,14,6,16,54,64,-10,48
Annan Athlet,6288,7,11,12,13,48,42,6,45
Berwick,6288,8,8,10,18,29,59,-30,34
Edinburgh Ci,6288,9,7,9,20,38,65,-27,30
Cowdenbeath,6288,10,4,11,21,24,55,-31,23
Montrose,6289,1,23,8,5,59,34,25,77
Peterhead,6289,2,24,4,8,80,38,42,76
Stirling,6289,3,17,6,13,63,52,11,57
Clyde,6289,4,15,9,12,55,50,5,54
Stenhousem'r,6289,5,15,8,13,56,49,7,53
Elgin,6289,6,14,7,15,53,60,-7,49
Annan Athlet,6289,7,12,11,13,49,42,7,47
Berwick,6289,8,8,10,18,31,62,-31,34
Edinburgh Ci,6289,9,7,9,20,36,63,-27,30
Cowdenbeath,6289,10,4,10,22,24,56,-32,22
Montrose,6290,1,24,7,5,61,34,27,79
Peterhead,6290,2,23,4,9,77,39,38,73
Stirling,6290,3,17,6,13,61,51,10,57
Stenhousem'r,6290,4,15,8,13,55,47,8,53
Clyde,6290,5,14,10,12,53,50,3,52
Elgin,6290,6,14,6,16,53,62,-9,48
Annan Athlet,6290,7,12,11,13,48,41,7,47
Berwick,6290,8,8,11,17,31,60,-29,35
Edinburgh Ci,6290,9,8,9,19,37,60,-23,33
Cowdenbeath,6290,10,4,10,22,23,55,-32,22
Montrose,6291,1,24,7,5,61,34,27,79
Peterhead,6291,2,23,4,9,78,40,38,73
Stirling,6291,3,17,6,13,63,52,11,57
Clyde,6291,4,15,9,12,52,48,4,54
Stenhousem'r,6291,5,15,8,13,56,49,7,53
Elgin,6291,6,14,6,16,53,62,-9,48
Annan Athlet,6291,7,11,11,14,47,42,5,44
Berwick,6291,8,8,10,18,29,59,-30,34
Edinburgh Ci,6291,9,8,9,19,38,61,-23,33
Cowdenbeath,6291,10,5,10,21,24,54,-30,25
Montrose,6292,1,23,8,5,60,35,25,77
Peterhead,6292,2,23,5,8,81,42,39,74
Stenhousem'r,6292,3,16,8,12,56,46,10,56
Stirling,6292,4,16,6,14,60,52,8,54
Clyde,6292,5,14,9,13,52,50,2,51
Elgin,6292,6,14,7,15,54,61,-7,49
Annan Athlet,6292,7,12,11,13,48,41,7,47
Berwick,6292,8,9,10,17,31,59,-28,37
Edinburgh Ci,6292,9,7,10,19,40,64,-24,31
Cowdenbeath,6292,10,4,10,22,23,55,-32,22
Montrose,6293,1,24,7,5,62,35,27,79
Peterhead,6293,2,23,5,8,80,41,39,74
Stirling,6293,3,17,6,13,62,52,10,57
Clyde,6293,4,15,9,12,54,48,6,54
Stenhousem'r,6293,5,15,8,13,56,48,8,53
Elgin,6293,6,14,6,16,54,63,-9,48
Annan Athlet,6293,7,11,11,14,47,43,4,44
Berwick,6293,8,8,10,18,29,61,-32,34
Edinburgh Ci,6293,9,7,10,19,39,63,-24,31
Cowdenbeath,6293,10,5,10,21,25,54,-29,25
Montrose,6294,1,24,7,5,64,35,29,79
Peterhead,6294,2,23,5,8,77,38,39,74
Stirling,6294,3,17,6,13,61,51,10,57
Clyde,6294,4,15,9,12,52,48,4,54
Stenhousem'r,6294,5,15,8,13,55,47,8,53
Elgin,6294,6,14,6,16,54,65,-11,48
Annan Athlet,6294,7,12,11,13,49,41,8,47
Berwick,6294,8,8,10,18,29,59,-30,34
Edinburgh Ci,6294,9,7,10,19,36,60,-24,31
Cowdenbeath,6294,10,4,10,22,23,56,-33,22
Montrose,6295,1,24,7,5,61,35,26,79
Peterhead,6295,2,24,4,8,78,38,40,76
Stirling,6295,3,17,6,13,63,51,12,57
Stenhousem'r,6295,4,15,8,13,55,49,6,53
Clyde,6295,5,14,10,12,52,49,3,52
Elgin,6295,6,14,6,16,54,62,-8,48
Annan Athlet,6295,7,11,11,14,48,43,5,44
Berwick,6295,8,8,11,17,30,59,-29,35
Edinburgh Ci,6295,9,7,9,20,36,61,-25,30
Cowdenbeath,6295,10,5,10,21,25,55,-30,25
Montrose,6296,1,24,7,5,61,35,26,79
Peterhead,6296,2,23,5,8,78,39,39,74
Stenhousem'r,6296,3,16,8,12,57,47,10,56
Stirling,6296,4,16,6,14,61,53,8,54
Clyde,6296,5,15,9,12,52,48,4,54
Elgin,6296,6,14,6,16,54,62,-8,48
Annan Athlet,6296,7,11,12,13,48,42,6,45
Berwick,6296,8,8,10,18,29,59,-30,34
Edinburgh Ci,6296,9,7,10,19,37,61,-24,31
Cowdenbeath,6296,10,4,11,21,24,55,-31,23
Montrose,6297,1,23,8,5,62,37,25,77
Peterhead,6297,2,23,4,9,77,39,38,73
Stirling,6297,3,17,6,13,64,52,12,57
Stenhousem'r,6297,4,15,8,13,56,50,6,53
Clyde,6297,5,14,10,12,52,49,3,52
Elgin,6297,6,14,7,15,56,63,-7,49
Annan Athlet,6297,7,11,12,13,47,41,6,45
Berwick,6297,8,8,11,17,30,59,-29,35
Edinburgh Ci,6297,9,8,9,19,37,60,-23,33
Cowdenbeath,6297,10,4,11,21,23,54,-31,23
Montrose,6298,1,24,7,5,62,35,27,79
Peterhead,6298,2,23,5,8,79,40,39,74
Stirling,6298,3,17,6,13,63,52,11,57
Stenhousem'r,6298,4,15,8,13,56,49,7,53
Clyde,6298,5,14,10,12,52,49,3,52
Elgin,6298,6,14,6,16,54,63,-9,48
Annan Athlet,6298,7,12,11,13,49,41,8,47
Berwick,6298,8,8,11,17,30,59,-29,35
Edinburgh Ci,6298,9,7,10,19,38,62,-24,31
Cowdenbeath,6298,10,4,10,22,23,56,-33,22
Montrose,6299,1,24,7,5,63,34,29,79
Peterhead,6299,2,23,4,9,77,40,37,73
Stenhousem'r,6299,3,16,8,12,58,48,10,56
Stirling,6299,4,16,6,14,62,54,8,54
Clyde,6299,5,15,9,12,52,48,4,54
Elgin,6299,6,14,6,16,53,64,-11,48
Annan Athlet,6299,7,11,11,14,48,45,3,44
Berwick,6299,8,8,10,18,29,59,-30,34
Edinburgh Ci,6299,9,8,9,19,38,60,-22,33
Cowdenbeath,6299,10,5,10,21,27,55,-28,25
Montrose,6300,1,23,8,5,59,34,25,77
Peterhead,6300,2,24,4,8,81,38,43,76
Stirling,6300,3,17,6,13,62,52,10,57
Clyde,6300,4,15,9,12,56,48,8,54
Stenhousem'r,6300,5,15,8,13,56,48,8,53
Elgin,6300,6,14,7,15,53,60,-7,49
Annan Athlet,6300,7,12,11,13,48,41,7,47
Berwick,6300,8,8,10,18,29,63,-34,34
Edinburgh Ci,6300,9,7,9,20,36,64,-28,30
Cowdenbeath,6300,10,4,10,22,23,55,-32,22
Montrose,6301,1,24,7,5,62,35,27,79
Peterhead,6301,2,24,4,8,80,39,41,76
Stirling,6301,3,17,6,13,65,53,12,57
Stenhousem'r,6301,4,15,8,13,57,51,6,53
Clyde,6301,5,14,10,12,51,48,3,52
Elgin,6301,6,14,6,16,54,63,-9,48
Annan Athlet,6301,7,11,12,13,48,42,6,45
Berwick,6301,8,8,11,17,29,58,-29,35
Edinburgh Ci,6301,9,7,9,20,37,63,-26,30
Cowdenbeath,6301,10,4,11,21,24,55,-31,23
Montrose,6302,1,23,8,5,60,35,25,77
Peterhead,6302,2,24,4,8,79,39,40,76
Stirling,6302,3,17,6,13,63,51,12,57
Clyde,6302,4,15,9,12,53,48,5,54
Stenhousem'r,6302,5,15,8,13,55,49,6,53
Elgin,6302,6,14,7,15,54,61,-7,49
Annan Athlet,6302,7,11,12,13,48,42,6,45
Berwick,6302,8,8,10,18,29,60,-31,34
Edinburgh Ci,6302,9,7,9,20,37,62,-25,30
Cowdenbeath,6302,10,4,11,21,24,55,-31,23
Montrose,6303,1,24,7,5,61,34,27,79
Peterhead,6303,2,24,4,8,84,38,46,76
Stirling,6303,3,16,7,13,61,52,9,55
Stenhousem'r,6303,4,15,9,12,56,47,9,54
Clyde,6303,5,14,10,12,52,49,3,52
Elgin,6303,6,14,6,16,53,62,-9,48
Annan Athlet,6303,7,12,11,13,50,42,8,47
Berwick,6303,8,8,11,17,30,59,-29,35
Edinburgh Ci,6303,9,7,9,20,36,67,-31,30
Cowdenbeath,6303,10,4,10,22,24,57,-33,22
Montrose,6304,1,24,7,5,62,34,28,79
Peterhead,6304,2,24,4,8,79,38,41,76
Stenhousem'r,6304,3,16,8,12,57,47,10,56
Stirling,6304,4,16,6,14,61,53,8,54
Clyde,6304,5,14,9,13,51,50,1,51
Elgin,6304,6,14,6,16,53,63,-10,48
Annan Athlet,6304,7,11,11,14,47,42,5,44
Berwick,6304,8,9,10,17,31,58,-27,37
Edinburgh Ci,6304,9,7,9,20,36,62,-26,30
Cowdenbeath,6304,10,5,10,21,24,54,-30,25
Peterhead,6305,1,24,4,8,79,39,40,76
Montrose,6305,2,23,7,6,59,35,24,76
Stenhousem'r,6305,3,16,8,12,56,46,10,56
Stirling,6305,4,16,6,14,60,52,8,54
Clyde,6305,5,14,9,13,51,49,2,51
Elgin,6305,6,15,6,15,54,60,-6,51
Annan Athlet,6305,7,11,12,13,48,42,6,45
Berwick,6305,8,9,10,17,30,58,-28,37
Edinburgh Ci,6305,9,7,9,20,37,62,-25,30
Cowdenbeath,6305,10,4,11,21,24,55,-31,23
Peterhead,6306,1,24,4,8,78,38,40,76
Montrose,6306,2,23,7,6,59,35,24,76
Stenhousem'r,6306,3,16,8,12,58,48,10,56
Stirling,6306,4,16,6,14,62,54,8,54
Clyde,6306,5,15,9,12,54,50,4,54
Elgin,6306,6,15,6,15,54,60,-6,51
Annan Athlet,6306,7,12,11,13,49,41,8,47
Berwick,6306,8,8,10,18,31,61,-30,34
Edinburgh Ci,6306,9,7,9,20,36,61,-25,30
Cowdenbeath,6306,10,4,10,22,23,56,-33,22
Montrose,6307,1,23,8,5,61,36,25,77
Peterhead,6307,2,24,4,8,79,39,40,76
Stirling,6307,3,17,6,13,63,53,10,57
Clyde,6307,4,15,9,12,55,49,6,54
Stenhousem'r,6307,5,15,8,13,57,49,8,53
Elgin,6307,6,14,7,15,55,62,-7,49
Annan Athlet,6307,7,11,11,14,47,42,5,44
Berwick,6307,8,8,10,18,30,62,-32,34
Edinburgh Ci,6307,9,7,9,20,37,62,-25,30
Cowdenbeath,6307,10,5,10,21,24,54,-30,25
Peterhead,6308,1,24,4,8,80,38,42,76
Montrose,6308,2,23,7,6,60,36,24,76
Stirling,6308,3,17,6,13,63,51,12,57
Clyde,6308,4,15,9,12,54,48,6,54
Stenhousem'r,6308,5,15,8,13,55,49,6,53
Elgin,6308,6,15,6,15,55,61,-6,51
Annan Athlet,6308,7,12,11,13,48,41,7,47
Berwick,6308,8,8,10,18,29,61,-32,34
Edinburgh Ci,6308,9,7,9,20,36,63,-27,30
Cowdenbeath,6308,10,4,10,22,23,55,-32,22
Montrose,6309,1,24,7,5,60,34,26,79
Peterhead,6309,2,23,4,9,77,39,38,73
Stirling,6309,3,17,6,13,61,51,10,57
Stenhousem'r,6309,4,15,8,13,55,47,8,53
Clyde,6309,5,14,10,12,51,48,3,52
Elgin,6309,6,14,6,16,53,61,-8,48
Annan Athlet,6309,7,12,11,13,48,41,7,47
Berwick,6309,8,8,11,17,29,58,-29,35
Edinburgh Ci,6309,9,8,9,19,37,60,-23,33
Cowdenbeath,6309,10,4,10,22,23,55,-32,22
Montrose,6310,1,24,7,5,61,35,26,79
Peterhead,6310,2,24,4,8,79,38,41,76
Stirling,6310,3,17,6,13,61,51,10,57
Stenhousem'r,6310,4,15,8,13,55,47,8,53
Clyde,6310,5,14,10,12,52,49,3,52
Elgin,6310,6,14,6,16,54,62,-8,48
Annan Athlet,6310,7,11,11,14,47,45,2,44
Berwick,6310,8,8,11,17,30,59,-29,35
Edinburgh Ci,6310,9,7,9,20,36,62,-26,30
Cowdenbeath,6310,10,5,10,21,27,54,-27,25
Montrose,6311,1,24,7,5,62,34,28,79
Peterhead,6311,2,23,5,8,80,41,39,74
Stenhousem'r,6311,3,16,8,12,58,47,11,56
Stirling,6311,4,16,6,14,61,54,7,54
Clyde,6311,5,14,9,13,51,50,1,51
Elgin,6311,6,14,6,16,53,63,-10,48
Annan Athlet,6311,7,12,11,13,49,42,7,47
Berwick,6311,8,9,10,17,31,58,-27,37
Edinburgh Ci,6311,9,7,10,19,39,63,-24,31
Cowdenbeath,6311,10,4,10,22,24,56,-32,22
Montrose,6312,1,24,7,5,63,35,28,79
Peterhead,6312,2,24,4,8,82,39,43,76
Stirling,6312,3,16,7,13,62,53,9,55
Stenhousem'r,6312,4,15,9,12,57,48,9,54
Clyde,6312,5,15,9,12,54,48,6,54
Elgin,6312,6,14,6,16,54,64,-10,48
Annan Athlet,6312,7,12,11,13,50,41,9,47
Berwick,6312,8,8,10,18,29,61,-32,34
Edinburgh Ci,6312,9,7,9,20,37,65,-28,30
Cowdenbeath,6312,10,4,10,22,23,57,-34,22
Montrose,6313,1,24,7,5,60,34,26,79
Peterhead,6313,2,23,4,9,78,40,38,73
Stirling,6313,3,16,7,13,62,53,9,55
Stenhousem'r,6313,4,15,9,12,57,48,9,54
Clyde,6313,5,15,9,12,53,48,5,54
Elgin,6313,6,14,6,16,53,61,-8,48
Annan Athlet,6313,7,12,11,13,48,41,7,47
Berwick,6313,8,8,10,18,29,60,-31,34
Edinburgh Ci,6313,9,8,9,19,38,61,-23,33
Cowdenbeath,6313,10,4,10,22,23,55,-32,22
Montrose,6314,1,23,8,5,59,34,25,77
Peterhead,6314,2,24,4,8,81,39,42,76
Stirling,6314,3,16,7,13,60,51,9,55
Stenhousem'r,6314,4,15,9,12,55,46,9,54
Clyde,6314,5,15,9,12,53,48,5,54
Elgin,6314,6,14,7,15,53,60,-7,49
Annan Athlet,6314,7,11,12,13,47,41,6,45
Berwick,6314,8,8,10,18,29,60,-31,34
Edinburgh Ci,6314,9,7,9,20,37,64,-27,30
Cowdenbeath,6314,10,4,11,21,23,54,-31,23
Montrose,6315,1,24,7,5,60,34,26,79
Peterhead,6315,2,24,4,8,81,39,42,76
Stenhousem'r,6315,3,16,8,12,56,46,10,56
Stirling,6315,4,16,6,14,60,52,8,54
Clyde,6315,5,14,10,12,53,50,3,52
Elgin,6315,6,14,6,16,53,61,-8,48
Annan Athlet,6315,7,11,11,14,47,42,5,44
Berwick,6315,8,8,11,17,31,60,-29,35
Edinburgh Ci,6315,9,7,9,20,37,64,-27,30
Cowdenbeath,6315,10,5,10,21,24,54,-30,25
Montrose,6316,1,23,8,5,59,34,25,77
Peterhead,6316,2,24,4,8,80,38,42,76
Stenhousem'r,6316,3,16,8,12,58,46,12,56
Stirling,6316,4,16,6,14,60,54,6,54
Clyde,6316,5,15,9,12,54,50,4,54
Elgin,6316,6,14,7,15,53,60,-7,49
Annan Athlet,6316,7,11,11,14,47,42,5,44
Berwick,6316,8,8,10,18,31,61,-30,34
Edinburgh Ci,6316,9,7,9,20,36,63,-27,30
Cowdenbeath,6316,10,5,10,21,24,54,-30,25
Montrose,6317,1,24,7,5,61,34,27,79
Peterhead,6317,2,24,4,8,81,40,41,76
Stenhousem'r,6317,3,16,8,12,56,46,10,56
Stirling,6317,4,16,6,14,60,52,8,54
Clyde,6317,5,14,10,12,52,49,3,52
Elgin,6317,6,14,6,16,53,62,-9,48
Annan Athlet,6317,7,11,12,13,47,41,6,45
Berwick,6317,8,8,11,17,30,59,-29,35
Edinburgh Ci,6317,9,7,9,20,38,64,-26,30
Cowdenbeath,6317,10,4,11,21,23,54,-31,23
Peterhead,6318,1,24,4,8,79,39,40,76
Montrose,6318,2,23,7,6,60,36,24,76
Stenhousem'r,6318,3,16,8,12,57,47,10,56
Stirling,6318,4,16,6,14,61,53,8,54
Clyde,6318,5,15,9,12,52,48,4,54
Elgin,6318,6,15,6,15,55,61,-6,51
Annan Athlet,6318,7,12,11,13,49,41,8,47
Berwick,6318,8,8,10,18,29,59,-30,34
Edinburgh Ci,6318,9,7,9,20,37,62,-25,30
Cowdenbeath,6318,10,4,10,22,23,56,-33,22
Montrose,6319,1,24,7,5,61,34,27,79
Peterhead,6319,2,23,5,8,80,41,39,74
Stirling,6319,3,17,6,13,63,52,11,57
Clyde,6319,4,15,9,12,53,49,4,54
Stenhousem'r,6319,5,15,8,13,56,49,7,53
Elgin,6319,6,14,6,16,53,62,-9,48
Annan Athlet,6319,7,11,12,13,48,42,6,45
Berwick,6319,8,8,10,18,30,60,-30,34
Edinburgh Ci,6319,9,7,10,19,39,63,-24,31
Cowdenbeath,6319,10,4,11,21,24,55,-31,23
Montrose,6320,1,23,8,5,59,34,25,77
Peterhead,6320,2,24,4,8,81,39,42,76
Stenhousem'r,6320,3,16,8,12,60,48,12,56
Stirling,6320,4,16,6,14,62,56,6,54
Clyde,6320,5,14,9,13,51,49,2,51
Elgin,6320,6,14,7,15,53,60,-7,49
Annan Athlet,6320,7,11,11,14,48,44,4,44
Berwick,6320,8,9,10,17,30,58,-28,37
Edinburgh Ci,6320,9,7,9,20,37,64,-27,30
Cowdenbeath,6320,10,5,10,21,26,55,-29,25
Peterhead,6321,1,24,4,8,79,38,41,76
Montrose,6321,2,23,7,6,59,35,24,76
Stirling,6321,3,17,6,13,64,53,11,57
Clyde,6321,4,15,9,12,54,49,5,54
Stenhousem'r,6321,5,15,8,13,57,50,7,53
Elgin,6321,6,15,6,15,54,60,-6,51
Annan Athlet,6321,7,12,11,13,49,41,8,47
Berwick,6321,8,8,10,18,30,61,-31,34
Edinburgh Ci,6321,9,7,9,20,36,62,-26,30
Cowdenbeath,6321,10,4,10,22,23,56,-33,22
Peterhead,6322,1,24,4,8,82,40,42,76
Montrose,6322,2,23,7,6,59,35,24,76
Stirling,6322,3,16,7,13,62,53,9,55
Stenhousem'r,6322,4,15,9,12,57,48,9,54
Clyde,6322,5,15,9,12,53,49,4,54
Elgin,6322,6,15,6,15,54,60,-6,51
Annan Athlet,6322,7,11,12,13,48,42,6,45
Berwick,6322,8,8,10,18,30,60,-30,34
Edinburgh Ci,6322,9,7,9,20,38,65,-27,30
Cowdenbeath,6322,10,4,11,21,24,55,-31,23
Montrose,6323,1,23,8,5,60,35,25,77
Peterhead,6323,2,24,4,8,80,38,42,76
Stirling,6323,3,17,6,13,61,51,10,57
Clyde,6323,4,15,9,12,55,48,7,54
Stenhousem'r,6323,5,15,8,13,55,47,8,53
Elgin,6323,6,14,7,15,54,61,-7,49
Annan Athlet,6323,7,12,11,13,51,43,8,47
Berwick,6323,8,8,10,18,29,62,-33,34
Edinburgh Ci,6323,9,7,9,20,36,63,-27,30
Cowdenbeath,6323,10,4,10,22,25,58,-33,22
Montrose,6324,1,24,7,5,60,34,26,79
Peterhead,6324,2,24,4,8,83,38,45,76
Stirling,6324,3,16,7,13,63,54,9,55
Stenhousem'r,6324,4,15,9,12,58,49,9,54
Clyde,6324,5,15,9,12,53,49,4,54
Elgin,6324,6,14,6,16,53,61,-8,48
Annan Athlet,6324,7,11,12,13,48,42,6,45
Berwick,6324,8,8,10,18,30,60,-30,34
Edinburgh Ci,6324,9,7,9,20,36,66,-30,30
Cowdenbeath,6324,10,4,11,21,24,55,-31,23
Montrose,6325,1,23,8,5,59,34,25,77
Peterhead,6325,2,24,4,8,80,38,42,76
Stirling,6325,3,17,6,13,63,52,11,57
Clyde,6325,4,15,9,12,54,48,6,54
Stenhousem'r,6325,5,15,8,13,56,49,7,53
Elgin,6325,6,14,7,15,53,60,-7,49
Annan Athlet,6325,7,12,11,13,49,41,8,47
Berwick,6325,8,8,10,18,29,61,-32,34
Edinburgh Ci,6325,9,7,9,20,36,63,-27,30
Cowdenbeath,6325,10,4,10,22,23,56,-33,22
Montrose,6326,1,24,7,5,60,34,26,79
Peterhead,6326,2,24,4,8,81,38,43,76
Stirling,6326,3,17,6,13,63,52,11,57
Clyde,6326,4,15,9,12,53,49,4,54
Stenhousem'r,6326,5,15,8,13,56,49,7,53
Elgin,6326,6,14,6,16,53,61,-8,48
Annan Athlet,6326,7,12,11,13,48,41,7,47
Berwick,6326,8,8,10,18,30,60,-30,34
Edinburgh Ci,6326,9,7,9,20,36,64,-28,30
Cowdenbeath,6326,10,4,10,22,23,55,-32,22
Montrose,6327,1,24,7,5,62,35,27,79
Peterhead,6327,2,23,5,8,79,40,39,74
Stenhousem'r,6327,3,16,8,12,58,46,12,56
Stirling,6327,4,16,6,14,60,54,6,54
Clyde,6327,5,15,9,12,53,48,5,54
Elgin,6327,6,14,6,16,54,63,-9,48
Annan Athlet,6327,7,11,11,14,47,45,2,44
Berwick,6327,8,8,10,18,29,60,-31,34
Edinburgh Ci,6327,9,7,10,19,38,62,-24,31
Cowdenbeath,6327,10,5,10,21,27,54,-27,25
Montrose,6328,1,24,7,5,61,34,27,79
Peterhead,6328,2,23,5,8,79,40,39,74
Stirling,6328,3,16,7,13,60,51,9,55
Stenhousem'r,6328,4,15,9,12,55,46,9,54
Clyde,6328,5,15,9,12,55,51,4,54
Elgin,6328,6,14,6,16,53,62,-9,48
Annan Athlet,6328,7,11,11,14,49,45,4,44
Berwick,6328,8,8,10,18,32,62,-30,34
Edinburgh Ci,6328,9,7,10,19,38,62,-24,31
Cowdenbeath,6328,10,5,10,21,27,56,-29,25
Montrose,6329,1,23,8,5,62,37,25,77
Peterhead,6329,2,24,4,8,79,38,41,76
Stirling,6329,3,16,7,13,61,52,9,55
Stenhousem'r,6329,4,15,9,12,56,47,9,54
Clyde,6329,5,15,9,12,54,49,5,54
Elgin,6329,6,14,7,15,56,63,-7,49
Annan Athlet,6329,7,12,11,13,48,41,7,47
Berwick,6329,8,8,10,18,30,61,-31,34
Edinburgh Ci,6329,9,7,9,20,36,62,-26,30
Cowdenbeath,6329,10,4,10,22,23,55,-32,22
Montrose,6330,1,24,7,5,61,35,26,79
Peterhead,6330,2,24,4,8,79,38,41,76
Stirling,6330,3,17,6,13,62,52,10,57
Clyde,6330,4,15,9,12,54,49,5,54
Stenhousem'r,6330,5,15,8,13,56,48,8,53
Elgin,6330,6,14,6,16,54,62,-8,48
Annan Athlet,6330,7,12,11,13,48,41,7,47
Berwick,6330,8,8,10,18,30,61,-31,34
Edinburgh Ci,6330,9,7,9,20,36,62,-26,30
Cowdenbeath,6330,10,4,10,22,23,55,-32,22
Montrose,6331,1,24,7,5,61,35,26,79
Peterhead,6331,2,24,4,8,82,38,44,76
Stirling,6331,3,17,6,13,62,52,10,57
Stenhousem'r,6331,4,15,8,13,56,48,8,53
Clyde,6331,5,14,9,13,53,51,2,51
Elgin,6331,6,14,6,16,54,62,-8,48
Annan Athlet,6331,7,11,11,14,48,43,5,44
Berwick,6331,8,9,10,17,32,60,-28,37
Edinburgh Ci,6331,9,7,9,20,36,65,-29,30
Cowdenbeath,6331,10,5,10,21,25,55,-30,25
Montrose,6332,1,23,8,5,61,36,25,77
Peterhead,6332,2,23,4,9,78,40,38,73
Stenhousem'r,6332,3,16,8,12,58,46,12,56
Stirling,6332,4,16,6,14,60,54,6,54
Clyde,6332,5,15,9,12,52,48,4,54
Elgin,6332,6,14,7,15,55,62,-7,49
Annan Athlet,6332,7,12,11,13,49,41,8,47
Berwick,6332,8,8,10,18,29,59,-30,34
Edinburgh Ci,6332,9,8,9,19,38,61,-23,33
Cowdenbeath,6332,10,4,10,22,23,56,-33,22
Montrose,6333,1,23,8,5,60,35,25,77
Peterhead,6333,2,24,4,8,79,38,41,76
Stirling,6333,3,17,6,13,63,51,12,57
Clyde,6333,4,15,9,12,55,49,6,54
Stenhousem'r,6333,5,15,8,13,55,49,6,53
Elgin,6333,6,14,7,15,54,61,-7,49
Annan Athlet,6333,7,12,11,13,49,41,8,47
Berwick,6333,8,8,10,18,30,62,-32,34
Edinburgh Ci,6333,9,7,9,20,36,62,-26,30
Cowdenbeath,6333,10,4,10,22,23,56,-33,22
Montrose,6334,1,23,8,5,60,35,25,77
Peterhead,6334,2,24,4,8,79,39,40,76
Stenhousem'r,6334,3,16,8,12,57,47,10,56
Stirling,6334,4,16,6,14,61,53,8,54
Clyde,6334,5,15,9,12,53,48,5,54
Elgin,6334,6,14,7,15,54,61,-7,49
Annan Athlet,6334,7,11,11,14,48,46,2,44
Berwick,6334,8,8,10,18,29,60,-31,34
Edinburgh Ci,6334,9,7,9,20,37,62,-25,30
Cowdenbeath,6334,10,5,10,21,28,55,-27,25
Montrose,6335,1,24,7,5,61,34,27,79
Peterhead,6335,2,24,4,8,81,39,42,76
Stirling,6335,3,17,6,13,62,52,10,57
Clyde,6335,4,15,9,12,54,48,6,54
Stenhousem'r,6335,5,15,8,13,56,48,8,53
Elgin,6335,6,14,6,16,53,62,-9,48
Annan Athlet,6335,7,12,11,13,49,41,8,47
Berwick,6335,8,8,10,18,29,61,-32,34
Edinburgh Ci,6335,9,7,9,20,37,64,-27,30
Cowdenbeath,6335,10,4,10,22,23,56,-33,22
Montrose,6336,1,24,7,5,63,35,28,79
Peterhead,6336,2,24,4,8,80,39,41,76
Stirling,6336,3,17,6,13,64,51,13,57
Clyde,6336,4,15,9,12,54,49,5,54
Stenhousem'r,6336,5,15,8,13,55,50,5,53
Elgin,6336,6,14,6,16,54,64,-10,48
Annan Athlet,6336,7,11,12,13,48,42,6,45
Berwick,6336,8,8,10,18,30,61,-31,34
Edinburgh Ci,6336,9,7,9,20,37,63,-26,30
Cowdenbeath,6336,10,4,11,21,24,55,-31,23
Montrose,6337,1,24,7,5,61,34,27,79
Peterhead,6337,2,24,4,8,79,39,40,76
Stirling,6337,3,17,6,13,62,52,10,57
Stenhousem'r,6337,4,15,8,13,56,48,8,53
Clyde,6337,5,14,10,12,52,49,3,52
Elgin,6337,6,14,6,16,53,62,-9,48
Annan Athlet,6337,7,11,12,13,48,42,6,45
Berwick,6337,8,8,11,17,30,59,-29,35
Edinburgh Ci,6337,9,7,9,20,37,62,-25,30
Cowdenbeath,6337,10,4,11,21,24,55,-31,23
Montrose,6338,1,24,7,5,62,36,26,79
Peterhead,6338,2,24,4,8,79,39,40,76
Stirling,6338,3,16,7,13,62,53,9,55
Stenhousem'r,6338,4,15,9,12,57,48,9,54
Clyde,6338,5,14,9,13,52,51,1,51
Elgin,6338,6,14,6,16,55,63,-8,48
Annan Athlet,6338,7,11,11,14,47,43,4,44
Berwick,6338,8,9,10,17,32,59,-27,37
Edinburgh Ci,6338,9,7,9,20,37,62,-25,30
Cowdenbeath,6338,10,5,10,21,25,54,-29,25
Montrose,6339,1,23,8,5,60,35,25,77
Peterhead,6339,2,23,4,9,78,40,38,73
Stirling,6339,3,17,6,13,62,51,11,57
Clyde,6339,4,15,9,12,53,49,4,54
Stenhousem'r,6339,5,15,8,13,55,48,7,53
Elgin,6339,6,14,7,15,54,61,-7,49
Annan Athlet,6339,7,11,11,14,47,42,5,44
Berwick,6339,8,8,10,18,30,60,-30,34
Edinburgh Ci,6339,9,8,9,19,38,61,-23,33
Cowdenbeath,6339,10,5,10,21,24,54,-30,25
Montrose,6340,1,23,8,5,61,36,25,77
Peterhead,6340,2,24,4,8,78,38,40,76
Stirling,6340,3,17,6,13,62,52,10,57
Clyde,6340,4,15,9,12,54,48,6,54
Stenhousem'r,6340,5,15,8,13,56,48,8,53
Elgin,6340,6,14,7,15,55,62,-7,49
Annan Athlet,6340,7,12,11,13,48,41,7,47
Berwick,6340,8,8,10,18,29,61,-32,34
Edinburgh Ci,6340,9,7,9,20,36,61,-25,30
Cowdenbeath,6340,10,4,10,22,23,55,-32,22
Montrose,6341,1,24,7,5,61,34,27,79
Peterhead,6341,2,24,4,8,80,38,42,76
Stirling,6341,3,17,6,13,62,51,11,57
Stenhousem'r,6341,4,15,8,13,55,48,7,53
Clyde,6341,5,14,9,13,51,50,1,51
Elgin,6341,6,14,6,16,53,62,-9,48
Annan Athlet,6341,7,12,11,13,49,42,7,47
Berwick,6341,8,9,10,17,31,58,-27,37
Edinburgh Ci,6341,9,7,9,20,36,63,-27,30
Cowdenbeath,6341,10,4,10,22,24,56,-32,22
Montrose,6342,1,23,8,5,60,35,25,77
Peterhead,6342,2,24,4,8,78,38,40,76
Stenhousem'r,6342,3,16,8,12,59,49,10,56
Stirling,6342,4,16,6,14,63,55,8,54
Clyde,6342,5,15,9,12,53,48,5,54
Elgin,6342,6,14,7,15,54,61,-7,49
Annan Athlet,6342,7,11,11,14,48,43,5,44
Berwick,6342,8,8,10,18,29,60,-31,34
Edinburgh Ci,6342,9,7,9,20,36,61,-25,30
Cowdenbeath,6342,10,5,10,21,25,55,-30,25
Montrose,6343,1,23,8,5,60,35,25,77
Peterhead,6343,2,24,4,8,79,38,41,76
Stenhousem'r,6343,3,16,8,12,57,47,10,56
Stirling,6343,4,16,6,14,61,53,8,54
Clyde,6343,5,15,9,12,55,48,7,54
Elgin,6343,6,14,7,15,54,61,-7,49
Annan Athlet,6343,7,12,11,13,50,41,9,47
Berwick,6343,8,8,10,18,29,62,-33,34
Edinburgh Ci,6343,9,7,9,20,36,62,-26,30
Cowdenbeath,6343,10,4,10,22,23,57,-34,22
Peterhead,6344,1,24,4,8,86,38,48,76
Montrose,6344,2,23,7,6,59,35,24,76
Stirling,6344,3,17,6,13,62,52,10,57
Clyde,6344,4,15,9,12,53,48,5,54
Stenhousem'r,6344,5,15,8,13,56,48,8,53
Elgin,6344,6,15,6,15,54,60,-6,51
Annan Athlet,6344,7,11,11,14,48,44,4,44
Berwick,6344,8,8,10,18,29,60,-31,34
Edinburgh Ci,6344,9,7,9,20,36,69,-33,30
Cowdenbeath,6344,10,5,10,21,26,55,-29,25
Montrose,6345,1,24,7,5,61,34,27,79
Peterhead,6345,2,24,4,8,79,38,41,76
Stirling,6345,3,16,7,13,60,51,9,55
Stenhousem'r,6345,4,15,9,12,55,46,9,54
Clyde,6345,5,15,9,12,55,49,6,54
Elgin,6345,6,14,6,16,53,62,-9,48
Annan Athlet,6345,7,11,12,13,47,41,6,45
Berwick,6345,8,8,10,18,30,62,-32,34
Edinburgh Ci,6345,9,7,9,20,36,62,-26,30
Cowdenbeath,6345,10,4,11,21,23,54,-31,23
Montrose,6346,1,24,7,5,60,34,26,79
Peterhead,6346,2,23,4,9,77,39,38,73
Stirling,6346,3,17,6,13,63,51,12,57
Stenhousem'r,6346,4,15,8,13,55,49,6,53
Clyde,6346,5,14,9,13,51,49,2,51
Elgin,6346,6,14,6,16,53,61,-8,48
Annan Athlet,6346,7,12,11,13,49,41,8,47
Berwick,6346,8,9,10,17,30,58,-28,37
Edinburgh Ci,6346,9,8,9,19,37,60,-23,33
Cowdenbeath,6346,10,4,10,22,23,56,-33,22
Montrose,6347,1,23,8,5,59,34,25,77
Peterhead,6347,2,24,4,8,79,38,41,76
Stirling,6347,3,17,6,13,63,53,10,57
Clyde,6347,4,15,9,12,54,48,6,54
Stenhousem'r,6347,5,15,8,13,57,49,8,53
Elgin,6347,6,14,7,15,53,60,-7,49
Annan Athlet,6347,7,11,12,13,48,42,6,45
Berwick,6347,8,8,10,18,29,61,-32,34
Edinburgh Ci,6347,9,7,9,20,36,62,-26,30
Cowdenbeath,6347,10,4,11,21,24,55,-31,23
Montrose,6348,1,24,7,5,60,34,26,79
Peterhead,6348,2,24,4,8,82,38,44,76
Stenhousem'r,6348,3,16,8,12,59,47,12,56
Stirling,6348,4,16,6,14,61,55,6,54
Clyde,6348,5,14,9,13,52,50,2,51
Elgin,6348,6,14,6,16,53,61,-8,48
Annan Athlet,6348,7,12,11,13,48,41,7,47
Berwick,6348,8,9,10,17,31,59,-28,37
Edinburgh Ci,6348,9,7,9,20,36,65,-29,30
Cowdenbeath,6348,10,4,10,22,23,55,-32,22
Montrose,6349,1,24,7,5,60,34,26,79
Peterhead,6349,2,24,4,8,81,41,40,76
Stirling,6349,3,17,6,13,67,53,14,57
Clyde,6349,4,15,9,12,55,48,7,54
Stenhousem'r,6349,5,15,8,13,57,53,4,53
Elgin,6349,6,14,6,16,53,61,-8,48
Annan Athlet,6349,7,12,11,13,50,42,8,47
Berwick,6349,8,8,10,18,29,62,-33,34
Edinburgh Ci,6349,9,7,9,20,39,64,-25,30
Cowdenbeath,6349,10,4,10,22,24,57,-33,22
Montrose,6350,1,23,8,5,59,34,25,77
Peterhead,6350,2,24,4,8,78,38,40,76
Stenhousem'r,6350,3,16,8,12,57,47,10,56
Stirling,6350,4,16,6,14,61,53,8,54
Clyde,6350,5,15,9,12,54,48,6,54
Elgin,6350,6,14,7,15,53,60,-7,49
Annan Athlet,6350,7,12,11,13,49,42,7,47
Berwick,6350,8,8,10,18,29,61,-32,34
Edinburgh Ci,6350,9,7,9,20,36,61,-25,30
Cowdenbeath,6350,10,4,10,22,24,56,-32,22
Montrose,6351,1,23,8,5,61,36,25,77
Peterhead,6351,2,24,4,8,80,38,42,76
Stirling,6351,3,16,7,13,62,53,9,55
Stenhousem'r,6351,4,15,9,12,57,48,9,54
Clyde,6351,5,14,10,12,52,49,3,52
Elgin,6351,6,14,7,15,55,62,-7,49
Annan Athlet,6351,7,11,12,13,47,41,6,45
Berwick,6351,8,8,11,17,30,59,-29,35
Edinburgh Ci,6351,9,7,9,20,36,63,-27,30
Cowdenbeath,6351,10,4,11,21,23,54,-31,23
Montrose,6352,1,24,7,5,62,36,26,79
Peterhead,6352,2,24,4,8,80,39,41,76
Stirling,6352,3,16,7,13,62,53,9,55
Stenhousem'r,6352,4,15,9,12,57,48,9,54
Clyde,6352,5,14,9,13,51,49,2,51
Elgin,6352,6,14,6,16,55,63,-8,48
Annan Athlet,6352,7,12,11,13,48,41,7,47
Berwick,6352,8,9,10,17,30,58,-28,37
Edinburgh Ci,6352,9,7,9,20,37,63,-26,30
Cowdenbeath,6352,10,4,10,22,23,55,-32,22
Peterhead,6353,1,24,4,8,80,39,41,76
Montrose,6353,2,23,7,6,60,37,23,76
Stirling,6353,3,17,6,13,62,52,10,57
Stenhousem'r,6353,4,15,8,13,56,48,8,53
Clyde,6353,5,14,9,13,53,51,2,51
Elgin,6353,6,15,6,15,56,61,-5,51
Annan Athlet,6353,7,11,12,13,47,41,6,45
Berwick,6353,8,9,10,17,32,60,-28,37
Edinburgh Ci,6353,9,7,9,20,37,63,-26,30
Cowdenbeath,6353,10,4,11,21,23,54,-31,23
Montrose,6354,1,23,7,6,60,36,24,76
Peterhead,6354,2,23,5,8,78,39,39,74
Stenhousem'r,6354,3,16,8,12,58,46,12,56
Clyde,6354,4,15,9,12,56,48,8,54
Stirling,6354,5,16,6,14,60,54,6,54
Elgin,6354,6,15,6,15,55,61,-6,51
Annan Athlet,6354,7,12,11,13,50,41,9,47
Berwick,6354,8,8,10,18,29,63,-34,34
Edinburgh Ci,6354,9,7,10,19,37,61,-24,31
Cowdenbeath,6354,10,4,10,22,23,57,-34,22
Montrose,6355,1,23,8,5,61,36,25,77
Peterhead,6355,2,23,5,8,80,41,39,74
Stenhousem'r,6355,3,16,8,12,57,47,10,56
Stirling,6355,4,16,6,14,61,53,8,54
Clyde,6355,5,14,10,12,51,48,3,52
Elgin,6355,6,14,7,15,55,62,-7,49
Annan Athlet,6355,7,11,11,14,47,44,3,44
Berwick,6355,8,8,11,17,29,58,-29,35
Edinburgh Ci,6355,9,7,10,19,39,63,-24,31
Cowdenbeath,6355,10,5,10,21,26,54,-28,25
Montrose,6356,1,24,7,5,61,34,27,79
Peterhead,6356,2,23,5,8,77,38,39,74
Stirling,6356,3,17,6,13,62,51,11,57
Clyde,6356,4,15,9,12,55,51,4,54
Stenhousem'r,6356,5,15,8,13,55,48,7,53
Elgin,6356,6,14,6,16,53,62,-9,48
Annan Athlet,6356,7,11,11,14,47,43,4,44
Berwick,6356,8,8,10,18,32,62,-30,34
Edinburgh Ci,6356,9,7,10,19,36,60,-24,31
Cowdenbeath,6356,10,5,10,21,25,54,-29,25
Montrose,6357,1,24,7,5,61,35,26,79
Peterhead,6357,2,24,4,8,79,39,40,76
Stenhousem'r,6357,3,16,8,12,56,46,10,56
Stirling,6357,4,16,6,14,60,52,8,54
Clyde,6357,5,15,9,12,53,48,5,54
Elgin,6357,6,14,6,16,54,62,-8,48
Annan Athlet,6357,7,11,11,14,47,43,4,44
Berwick,6357,8,8,10,18,29,60,-31,34
Edinburgh Ci,6357,9,7,9,20,37,62,-25,30
Cowdenbeath,6357,10,5,10,21,25,54,-29,25
Montrose,6358,1,23,8,5,60,35,25,77
Peterhead,6358,2,24,4,8,78,38,40,76
Stirling,6358,3,17,6,13,62,51,11,57
Clyde,6358,4,15,9,12,55,48,7,54
Stenhousem'r,6358,5,15,8,13,55,48,7,53
Elgin,6358,6,14,7,15,54,61,-7,49
Annan Athlet,6358,7,12,11,13,48,41,7,47
Berwick,6358,8,8,10,18,29,62,-33,34
Edinburgh Ci,6358,9,7,9,20,36,61,-25,30
Cowdenbeath,6358,10,4,10,22,23,55,-32,22
Montrose,6359,1,24,7,5,63,35,28,79
Peterhead,6359,2,23,4,9,78,40,38,73
Stenhousem'r,6359,3,16,8,12,57,47,10,56
Stirling,6359,4,16,6,14,61,53,8,54
Clyde,6359,5,15,9,12,53,48,5,54
Elgin,6359,6,14,6,16,54,64,-10,48
Annan Athlet,6359,7,12,11,13,48,41,7,47
Berwick,6359,8,8,10,18,29,60,-31,34
Edinburgh Ci,6359,9,8,9,19,38,61,-23,33
Cowdenbeath,6359,10,4,10,22,23,55,-32,22
Montrose,6360,1,24,7,5,61,34,27,79
Peterhead,6360,2,24,4,8,81,38,43,76
Stirling,6360,3,17,6,13,62,51,11,57
Clyde,6360,4,15,9,12,52,48,4,54
Stenhousem'r,6360,5,15,8,13,55,48,7,53
Elgin,6360,6,14,6,16,53,62,-9,48
Annan Athlet,6360,7,11,12,13,47,41,6,45
Berwick,6360,8,8,10,18,29,59,-30,34
Edinburgh Ci,6360,9,7,9,20,36,64,-28,30
Cowdenbeath,6360,10,4,11,21,23,54,-31,23
Montrose,6361,1,24,7,5,61,35,26,79
Peterhead,6361,2,24,4,8,81,40,41,76
Stenhousem'r,6361,3,16,8,12,57,47,10,56
Stirling,6361,4,16,6,14,61,53,8,54
Clyde,6361,5,15,9,12,53,49,4,54
Elgin,6361,6,14,6,16,54,62,-8,48
Annan Athlet,6361,7,12,11,13,49,42,7,47
Berwick,6361,8,8,10,18,30,60,-30,34
Edinburgh Ci,6361,9,7,9,20,38,64,-26,30
Cowdenbeath,6361,10,4,10,22,24,56,-32,22
Montrose,6362,1,24,7,5,61,35,26,79
Peterhead,6362,2,23,5,8,78,39,39,74
Stenhousem'r,6362,3,16,8,12,57,47,10,56
Stirling,6362,4,16,6,14,61,53,8,54
Clyde,6362,5,14,10,12,53,50,3,52
Elgin,6362,6,14,6,16,54,62,-8,48
Annan Athlet,6362,7,12,11,13,50,43,7,47
Berwick,6362,8,8,11,17,31,60,-29,35
Edinburgh Ci,6362,9,7,10,19,37,61,-24,31
Cowdenbeath,6362,10,4,10,22,25,57,-32,22
Montrose,6363,1,23,8,5,60,35,25,77
Peterhead,6363,2,23,4,9,77,40,37,73
Stenhousem'r,6363,3,16,8,12,59,49,10,56
Stirling,6363,4,16,6,14,63,55,8,54
Clyde,6363,5,14,10,12,52,49,3,52
Elgin,6363,6,14,7,15,54,61,-7,49
Annan Athlet,6363,7,12,11,13,51,43,8,47
Berwick,6363,8,8,11,17,30,59,-29,35
Edinburgh Ci,6363,9,8,9,19,38,60,-22,33
Cowdenbeath,6363,10,4,10,22,25,58,-33,22
Montrose,6364,1,24,7,5,63,34,29,79
Peterhead,6364,2,24,4,8,80,38,42,76
Stirling,6364,3,17,6,13,62,52,10,57
Stenhousem'r,6364,4,15,8,13,56,48,8,53
Clyde,6364,5,14,9,13,51,49,2,51
Elgin,6364,6,14,6,16,53,64,-11,48
Annan Athlet,6364,7,12,11,13,48,41,7,47
Berwick,6364,8,9,10,17,30,58,-28,37
Edinburgh Ci,6364,9,7,9,20,36,63,-27,30
Cowdenbeath,6364,10,4,10,22,23,55,-32,22
Montrose,6365,1,24,7,5,60,34,26,79
Peterhead,6365,2,24,4,8,82,38,44,76
Stirling,6365,3,16,7,13,60,51,9,55
Stenhousem'r,6365,4,15,9,12,55,46,9,54
Clyde,6365,5,15,9,12,53,48,5,54
Elgin,6365,6,14,6,16,53,61,-8,48
Annan Athlet,6365,7,12,11,13,49,41,8,47
Berwick,6365,8,8,10,18,29,60,-31,34
Edinburgh Ci,6365,9,7,9,20,36,65,-29,30
Cowdenbeath,6365,10,4,10,22,23,56,-33,22
Montrose,6366,1,23,8,5,59,34,25,77
Peterhead,6366,2,24,4,8,81,38,43,76
Stirling,6366,3,16,7,13,61,52,9,55
Stenhousem'r,6366,4,15,9,12,56,47,9,54
Clyde,6366,5,14,10,12,52,49,3,52
Elgin,6366,6,14,7,15,53,60,-7,49
Annan Athlet,6366,7,12,11,13,48,41,7,47
Berwick,6366,8,8,11,17,30,59,-29,35
Edinburgh Ci,6366,9,7,9,20,36,64,-28,30
Cowdenbeath,6366,10,4,10,22,23,55,-32,22
Montrose,6367,1,24,7,5,63,34,29,79
Peterhead,6367,2,24,4,8,83,40,43,76
Stirling,6367,3,17,6,13,63,51,12,57
Clyde,6367,4,15,9,12,53,48,5,54
Stenhousem'r,6367,5,15,8,13,55,49,6,53
Elgin,6367,6,14,6,16,53,64,-11,48
Annan Athlet,6367,7,11,12,13,49,43,6,45
Berwick,6367,8,8,10,18,29,60,-31,34
Edinburgh Ci,6367,9,7,9,20,38,66,-28,30
Cowdenbeath,6367,10,4,11,21,25,56,-31,23
Montrose,6368,1,23,8,5,62,37,25,77
Peterhead,6368,2,24,4,8,79,39,40,76
Stirling,6368,3,16,7,13,61,52,9,55
Stenhousem'r,6368,4,15,9,12,56,47,9,54
Clyde,6368,5,14,10,12,52,49,3,52
Elgin,6368,6,14,7,15,56,63,-7,49
Annan Athlet,6368,7,11,11,14,48,43,5,44
Berwick,6368,8,8,11,17,30,59,-29,35
Edinburgh Ci,6368,9,7,9,20,37,62,-25,30
Cowdenbeath,6368,10,5,10,21,25,55,-30,25
Montrose,6369,1,24,7,5,61,35,26,79
Peterhead,6369,2,24,4,8,79,38,41,76
Stirling,6369,3,16,7,13,61,52,9,55
Stenhousem'r,6369,4,15,9,12,56,47,9,54
Clyde,6369,5,14,10,12,52,49,3,52
Elgin,6369,6,14,6,16,54,62,-8,48
Annan Athlet,6369,7,12,11,13,48,41,7,47
Berwick,6369,8,8,11,17,30,59,-29,35
Edinburgh Ci,6369,9,7,9,20,36,62,-26,30
Cowdenbeath,6369,10,4,10,22,23,55,-32,22
Montrose,6370,1,24,7,5,63,36,27,79
Peterhead,6370,2,24,4,8,78,38,40,76
Stirling,6370,3,16,7,13,61,52,9,55
Stenhousem'r,6370,4,15,9,12,56,47,9,54
Clyde,6370,5,15,9,12,56,48,8,54
Elgin,6370,6,14,6,16,55,64,-9,48
Annan Athlet,6370,7,11,12,13,47,41,6,45
Berwick,6370,8,8,10,18,29,63,-34,34
Edinburgh Ci,6370,9,7,9,20,36,61,-25,30
Cowdenbeath,6370,10,4,11,21,23,54,-31,23
Montrose,6371,1,23,8,5,60,35,25,77
Peterhead,6371,2,24,4,8,81,38,43,76
Stirling,6371,3,17,6,13,66,55,11,57
Stenhousem'r,6371,4,15,8,13,59,52,7,53
Clyde,6371,5,14,9,13,51,50,1,51
Elgin,6371,6,14,7,15,54,61,-7,49
Annan Athlet,6371,7,12,11,13,49,42,7,47
Berwick,6371,8,9,10,17,31,58,-27,37
Edinburgh Ci,6371,9,7,9,20,36,64,-28,30
Cowdenbeath,6371,10,4,10,22,24,56,-32,22
Montrose,6372,1,24,7,5,61,34,27,79
Peterhead,6372,2,24,4,8,79,38,41,76
Stirling,6372,3,17,6,13,63,51,12,57
Stenhousem'r,6372,4,15,8,13,55,49,6,53
Clyde,6372,5,14,10,12,52,49,3,52
Elgin,6372,6,14,6,16,53,62,-9,48
Annan Athlet,6372,7,11,11,14,47,43,4,44
Berwick,6372,8,8,11,17,30,59,-29,35
Edinburgh Ci,6372,9,7,9,20,36,62,-26,30
Cowdenbeath,6372,10,5,10,21,25,54,-29,25
Montrose,6373,1,23,8,5,60,35,25,77
Peterhead,6373,2,23,4,9,78,40,38,73
Stenhousem'r,6373,3,16,8,12,58,46,12,56
Stirling,6373,4,16,6,14,60,54,6,54
Clyde,6373,5,15,9,12,53,49,4,54
Elgin,6373,6,14,7,15,54,61,-7,49
Annan Athlet,6373,7,11,11,14,48,43,5,44
Berwick,6373,8,8,10,18,30,60,-30,34
Edinburgh Ci,6373,9,8,9,19,38,61,-23,33
Cowdenbeath,6373,10,5,10,21,25,55,-30,25
Montrose,6374,1,24,7,5,62,34,28,79
Peterhead,6374,2,24,4,8,82,38,44,76
Stirling,6374,3,16,7,13,62,53,9,55
Stenhousem'r,6374,4,15,9,12,57,48,9,54
Clyde,6374,5,15,9,12,54,49,5,54
Elgin,6374,6,14,6,16,53,63,-10,48
Annan Athlet,6374,7,12,11,13,48,41,7,47
Berwick,6374,8,8,10,18,30,61,-31,34
Edinburgh Ci,6374,9,7,9,20,36,65,-29,30
Cowdenbeath,6374,10,4,10,22,23,55,-32,22
Montrose,6375,1,23,8,5,60,35,25,77
Peterhead,6375,2,23,4,9,77,39,38,73
Stirling,6375,3,17,6,13,63,52,11,57
Stenhousem'r,6375,4,15,8,13,56,49,7,53
Clyde,6375,5,14,9,13,51,49,2,51
Elgin,6375,6,14,7,15,54,61,-7,49
Annan Athlet,6375,7,11,12,13,48,42,6,45
Berwick,6375,8,9,10,17,30,58,-28,37
Edinburgh Ci,6375,9,8,9,19,37,60,-23,33
Cowdenbeath,6375,10,4,11,21,24,55,-31,23
Montrose,6376,1,23,7,6,59,35,24,76
Peterhead,6376,2,23,5,8,78,39,39,74
Stenhousem'r,6376,3,16,8,12,58,47,11,56
Stirling,6376,4,16,6,14,61,54,7,54
Clyde,6376,5,15,9,12,54,48,6,54
Elgin,6376,6,15,6,15,54,60,-6,51
Annan Athlet,6376,7,12,11,13,49,41,8,47
Berwick,6376,8,8,10,18,29,61,-32,34
Edinburgh Ci,6376,9,7,10,19,37,61,-24,31
Cowdenbeath,6376,10,4,10,22,23,56,-33,22
Montrose,6377,1,23,8,5,60,35,25,77
Peterhead,6377,2,23,5,8,78,39,39,74
Stenhousem'r,6377,3,16,8,12,58,47,11,56
Stirling,6377,4,16,6,14,61,54,7,54
Clyde,6377,5,15,9,12,53,49,4,54
Elgin,6377,6,14,7,15,54,61,-7,49
Annan Athlet,6377,7,11,11,14,47,42,5,44
Berwick,6377,8,8,10,18,30,60,-30,34
Edinburgh Ci,6377,9,7,10,19,37,61,-24,31
Cowdenbeath,6377,10,5,10,21,24,54,-30,25
Montrose,6378,1,24,7,5,60,34,26,79
Peterhead,6378,2,24,4,8,79,39,40,76
Stirling,6378,3,17,6,13,63,53,10,57
Stenhousem'r,6378,4,15,8,13,57,49,8,53
Clyde,6378,5,14,10,12,51,48,3,52
Elgin,6378,6,14,6,16,53,61,-8,48
Annan Athlet,6378,7,12,11,13,52,44,8,47
Berwick,6378,8,8,11,17,29,58,-29,35
Edinburgh Ci,6378,9,7,9,20,37,62,-25,30
Cowdenbeath,6378,10,4,10,22,26,59,-33,22
Montrose,6379,1,23,8,5,61,36,25,77
Peterhead,6379,2,24,4,8,79,39,40,76
Stirling,6379,3,17,6,13,62,51,11,57
Clyde,6379,4,15,9,12,54,48,6,54
Stenhousem'r,6379,5,15,8,13,55,48,7,53
Elgin,6379,6,14,7,15,55,62,-7,49
Annan Athlet,6379,7,11,11,14,47,42,5,44
Berwick,6379,8,8,10,18,29,61,-32,34
Edinburgh Ci,6379,9,7,9,20,37,62,-25,30
Cowdenbeath,6379,10,5,10,21,24,54,-30,25
Montrose,6380,1,23,8,5,59,34,25,77
Peterhead,6380,2,24,4,8,79,38,41,76
Stenhousem'r,6380,3,16,8,12,56,46,10,56
Stirling,6380,4,16,6,14,60,52,8,54
Clyde,6380,5,14,10,12,52,49,3,52
Elgin,6380,6,14,7,15,53,60,-7,49
Annan Athlet,6380,7,12,11,13,50,43,7,47
Berwick,6380,8,8,11,17,30,59,-29,35
Edinburgh Ci,6380,9,7,9,20,36,62,-26,30
Cowdenbeath,6380,10,4,10,22,25,57,-32,22
Montrose,6381,1,24,7,5,61,34,27,79
Peterhead,6381,2,24,4,8,80,38,42,76
Stirling,6381,3,17,6,13,62,51,11,57
Clyde,6381,4,15,9,12,53,48,5,54
Stenhousem'r,6381,5,15,8,13,55,48,7,53
Elgin,6381,6,14,6,16,53,62,-9,48
Annan Athlet,6381,7,12,11,13,48,41,7,47
Berwick,6381,8,8,10,18,29,60,-31,34
Edinburgh Ci,6381,9,7,9,20,36,63,-27,30
Cowdenbeath,6381,10,4,10,22,23,55,-32,22
Montrose,6382,1,24,7,5,62,35,27,79
Peterhead,6382,2,24,4,8,79,39,40,76
Stenhousem'r,6382,3,16,8,12,57,47,10,56
Clyde,6382,4,15,9,12,57,48,9,54
Stirling,6382,5,16,6,14,61,53,8,54
Elgin,6382,6,14,6,16,54,63,-9,48
Annan Athlet,6382,7,11,11,14,47,42,5,44
Berwick,6382,8,8,10,18,29,64,-35,34
Edinburgh Ci,6382,9,7,9,20,37,62,-25,30
Cowdenbeath,6382,10,5,10,21,24,54,-30,25
Peterhead,6383,1,24,4,8,83,38,45,76
Montrose,6383,2,23,7,6,60,36,24,76
Stirling,6383,3,17,6,13,63,53,10,57
Clyde,6383,4,15,9,12,55,48,7,54
Stenhousem'r,6383,5,15,8,13,57,49,8,53
Elgin,6383,6,15,6,15,55,61,-6,51
Annan Athlet,6383,7,12,11,13,50,41,9,47
Berwick,6383,8,8,10,18,29,62,-33,34
Edinburgh Ci,6383,9,7,9,20,36,66,-30,30
Cowdenbeath,6383,10,4,10,22,23,57,-34,22
Peterhead,6384,1,24,4,8,79,38,41,76
Montrose,6384,2,23,7,6,59,36,23,76
Stenhousem'r,6384,3,16,8,12,57,46,11,56
Stirling,6384,4,16,6,14,60,53,7,54
Clyde,6384,5,15,9,12,55,49,6,54
Elgin,6384,6,15,6,15,55,60,-5,51
Annan Athlet,6384,7,12,11,13,51,42,9,47
Berwick,6384,8,8,10,18,30,62,-32,34
Edinburgh Ci,6384,9,7,9,20,36,62,-26,30
Cowdenbeath,6384,10,4,10,22,24,58,-34,22
Peterhead,6385,1,24,4,8,78,38,40,76
Montrose,6385,2,23,7,6,60,36,24,76
Stirling,6385,3,17,6,13,63,51,12,57
Clyde,6385,4,15,9,12,54,49,5,54
Stenhousem'r,6385,5,15,8,13,55,49,6,53
Elgin,6385,6,15,6,15,55,61,-6,51
Annan Athlet,6385,7,11,11,14,47,43,4,44
Berwick,6385,8,8,10,18,30,61,-31,34
Edinburgh Ci,6385,9,7,9,20,36,61,-25,30
Cowdenbeath,6385,10,5,10,21,25,54,-29,25
Peterhead,6386,1,24,4,8,79,38,41,76
Montrose,6386,2,23,7,6,60,36,24,76
Stenhousem'r,6386,3,16,8,12,57,46,11,56
Stirling,6386,4,16,6,14,60,53,7,54
Clyde,6386,5,15,9,12,52,48,4,54
Elgin,6386,6,15,6,15,55,61,-6,51
Annan Athlet,6386,7,11,12,13,48,42,6,45
Berwick,6386,8,8,10,18,29,59,-30,34
Edinburgh Ci,6386,9,7,9,20,36,62,-26,30
Cowdenbeath,6386,10,4,11,21,24,55,-31,23
Montrose,6387,1,24,7,5,62,35,27,79
Peterhead,6387,2,24,4,8,78,38,40,76
Stirling,6387,3,17,6,13,62,52,10,57
Stenhousem'r,6387,4,15,8,13,56,48,8,53
Clyde,6387,5,14,10,12,51,48,3,52
Elgin,6387,6,14,6,16,54,63,-9,48
Annan Athlet,6387,7,11,12,13,49,43,6,45
Berwick,6387,8,8,11,17,29,58,-29,35
Edinburgh Ci,6387,9,7,9,20,36,61,-25,30
Cowdenbeath,6387,10,4,11,21,25,56,-31,23
Peterhead,6388,1,24,4,8,82,39,43,76
Montrose,6388,2,23,7,6,60,36,24,76
Stirling,6388,3,16,7,13,64,55,9,55
Stenhousem'r,6388,4,15,9,12,59,50,9,54
Clyde,6388,5,15,9,12,54,49,5,54
Elgin,6388,6,15,6,15,55,61,-6,51
Annan Athlet,6388,7,12,11,13,48,41,7,47
Berwick,6388,8,8,10,18,30,61,-31,34
Edinburgh Ci,6388,9,7,9,20,37,65,-28,30
Cowdenbeath,6388,10,4,10,22,23,55,-32,22
Peterhead,6389,1,24,4,8,78,38,40,76
Montrose,6389,2,23,7,6,59,35,24,76
Stenhousem'r,6389,3,16,8,12,59,47,12,56
Stirling,6389,4,16,6,14,61,55,6,54
Clyde,6389,5,15,9,12,55,50,5,54
Elgin,6389,6,15,6,15,54,60,-6,51
Annan Athlet,6389,7,11,12,13,47,41,6,45
Berwick,6389,8,8,10,18,31,62,-31,34
Edinburgh Ci,6389,9,7,9,20,36,61,-25,30
Cowdenbeath,6389,10,4,11,21,23,54,-31,23
Montrose,6390,1,23,8,5,62,37,25,77
Peterhead,6390,2,24,4,8,79,38,41,76
Stirling,6390,3,16,7,13,63,54,9,55
Stenhousem'r,6390,4,15,9,12,58,49,9,54
Clyde,6390,5,15,9,12,54,48,6,54
Elgin,6390,6,14,7,15,56,63,-7,49
Annan Athlet,6390,7,11,12,13,48,42,6,45
Berwick,6390,8,8,10,18,29,61,-32,34
Edinburgh Ci,6390,9,7,9,20,36,62,-26,30
Cowdenbeath,6390,10,4,11,21,24,55,-31,23
Montrose,6391,1,23,8,5,60,35,25,77
Peterhead,6391,2,24,4,8,79,39,40,76
Stirling,6391,3,16,7,13,60,51,9,55
Stenhousem'r,6391,4,15,9,12,55,46,9,54
Clyde,6391,5,15,9,12,52,48,4,54
Elgin,6391,6,14,7,15,54,61,-7,49
Annan Athlet,6391,7,11,11,14,47,42,5,44
Berwick,6391,8,8,10,18,29,59,-30,34
Edinburgh Ci,6391,9,7,9,20,37,62,-25,30
Cowdenbeath,6391,10,5,10,21,24,54,-30,25
Montrose,6392,1,24,7,5,61,35,26,79
Peterhead,6392,2,23,5,8,79,40,39,74
Stirling,6392,3,17,6,13,63,51,12,57
Clyde,6392,4,15,9,12,54,49,5,54
Stenhousem'r,6392,5,15,8,13,55,49,6,53
Elgin,6392,6,14,6,16,54,62,-8,48
Annan Athlet,6392,7,11,11,14,48,43,5,44
Berwick,6392,8,8,10,18,30,61,-31,34
Edinburgh Ci,6392,9,7,10,19,38,62,-24,31
Cowdenbeath,6392,10,5,10,21,25,55,-30,25
Montrose,6393,1,23,8,5,60,35,25,77
Peterhead,6393,2,24,4,8,79,39,40,76
Stirling,6393,3,16,7,13,61,52,9,55
Stenhousem'r,6393,4,15,9,12,56,47,9,54
Clyde,6393,5,14,9,13,51,49,2,51
Elgin,6393,6,14,7,15,54,61,-7,49
Annan Athlet,6393,7,12,11,13,49,41,8,47
Berwick,6393,8,9,10,17,30,58,-28,37
Edinburgh Ci,6393,9,7,9,20,37,62,-25,30
Cowdenbeath,6393,10,4,10,22,23,56,-33,22
Montrose,6394,1,24,7,5,60,34,26,79
Peterhead,6394,2,24,4,8,80,38,42,76
Stirling,6394,3,17,6,13,62,52,10,57
Clyde,6394,4,15,9,12,54,48,6,54
Stenhousem'r,6394,5,15,8,13,56,48,8,53
Elgin,6394,6,14,6,16,53,61,-8,48
Annan Athlet,6394,7,11,12,13,47,41,6,45
Berwick,6394,8,8,10,18,29,61,-32,34
Edinburgh Ci,6394,9,7,9,20,36,63,-27,30
Cowdenbeath,6394,10,4,11,21,23,54,-31,23
Montrose,6395,1,24,7,5,60,34,26,79
Peterhead,6395,2,23,5,8,78,39,39,74
Stirling,6395,3,17,6,13,61,51,10,57
Clyde,6395,4,15,9,12,53,49,4,54
Stenhousem'r,6395,5,15,8,13,55,47,8,53
Elgin,6395,6,14,6,16,53,61,-8,48
Annan Athlet,6395,7,11,12,13,48,42,6,45
Berwick,6395,8,8,10,18,30,60,-30,34
Edinburgh Ci,6395,9,7,10,19,37,61,-24,31
Cowdenbeath,6395,10,4,11,21,24,55,-31,23
Montrose,6396,1,23,8,5,60,35,25,77
Peterhead,6396,2,24,4,8,82,40,42,76
Stirling,6396,3,16,7,13,61,52,9,55
Stenhousem'r,6396,4,15,9,12,56,47,9,54
Clyde,6396,5,15,9,12,53,49,4,54
Elgin,6396,6,14,7,15,54,61,-7,49
Annan Athlet,6396,7,11,11,14,47,42,5,44
Berwick,6396,8,8,10,18,30,60,-30,34
Edinburgh Ci,6396,9,7,9,20,38,65,-27,30
Cowdenbeath,6396,10,5,10,21,24,54,-30,25
Montrose,6397,1,24,7,5,61,34,27,79
Peterhead,6397,2,23,5,8,78,39,39,74
Stirling,6397,3,17,6,13,63,51,12,57
Clyde,6397,4,15,9,12,54,49,5,54
Stenhousem'r,6397,5,15,8,13,55,49,6,53
Elgin,6397,6,14,6,16,53,62,-9,48
Annan Athlet,6397,7,11,11,14,47,42,5,44
Berwick,6397,8,8,10,18,30,61,-31,34
Edinburgh Ci,6397,9,7,10,19,37,61,-24,31
Cowdenbeath,6397,10,5,10,21,24,54,-30,25
Montrose,6398,1,24,7,5,60,34,26,79
Peterhead,6398,2,24,4,8,82,38,44,76
Stenhousem'r,6398,3,16,8,12,57,46,11,56
Stirling,6398,4,16,6,14,60,53,7,54
Clyde,6398,5,14,10,12,51,48,3,52
Elgin,6398,6,14,6,16,53,61,-8,48
Annan Athlet,6398,7,11,11,14,48,43,5,44
Berwick,6398,8,8,11,17,29,58,-29,35
Edinburgh Ci,6398,9,7,9,20,36,65,-29,30
Cowdenbeath,6398,10,5,10,21,25,55,-30,25
Montrose,6399,1,24,7,5,63,35,28,79
Peterhead,6399,2,24,4,8,82,40,42,76
Stirling,6399,3,17,6,13,63,52,11,57
Clyde,6399,4,15,9,12,54,49,5,54
Stenhousem'r,6399,5,15,8,13,56,49,7,53
Elgin,6399,6,14,6,16,54,64,-10,48
Annan Athlet,6399,7,11,11,14,47,43,4,44
Berwick,6399,8,8,10,18,30,61,-31,34
Edinburgh Ci,6399,9,7,9,20,38,65,-27,30
Cowdenbeath,6399,10,5,10,21,25,54,-29,25
Montrose,6400,1,24,7,5,62,35,27,79
Peterhead,6400,2,24,4,8,78,38,40,76
Stirling,6400,3,17,6,13,63,51,12,57
Clyde,6400,4,15,9,12,52,48,4,54
Stenhousem'r,6400,5,15,8,13,55,49,6,53
Elgin,6400,6,14,6,16,54,63,-9,48
Annan Athlet,6400,7,11,11,14,47,43,4,44
Berwick,6400,8,8,10,18,29,59,-30,34
Edinburgh Ci,6400,9,7,9,20,36,61,-25,30
Cowdenbeath,6400,10,5,10,21,25,54,-29,25
Montrose,6401,1,23,8,5,60,35,25,77
Peterhead,6401,2,24,4,8,82,40,42,76
Stirling,6401,3,17,6,13,64,52,12,57
Clyde,6401,4,15,9,12,53,48,5,54
Stenhousem'r,6401,5,15,8,13,56,50,6,53
Elgin,6401,6,14,7,15,54,61,-7,49
Annan Athlet,6401,7,12,11,13,49,41,8,47
Berwick,6401,8,8,10,18,29,60,-31,34
Edinburgh Ci,6401,9,7,9,20,38,65,-27,30
Cowdenbeath,6401,10,4,10,22,23,56,-33,22
Montrose,6402,1,23,8,5,59,34,25,77
Peterhead,6402,2,23,5,8,78,39,39,74
Stenhousem'r,6402,3,16,8,12,60,49,11,56
Stirling,6402,4,16,6,14,63,56,7,54
Clyde,6402,5,15,9,12,53,49,4,54
Elgin,6402,6,14,7,15,53,60,-7,49
Annan Athlet,6402,7,12,11,13,48,41,7,47
Berwick,6402,8,8,10,18,30,60,-30,34
Edinburgh Ci,6402,9,7,10,19,37,61,-24,31
Cowdenbeath,6402,10,4,10,22,23,55,-32,22
Montrose,6403,1,23,8,5,61,36,25,77
Peterhead,6403,2,23,5,8,78,39,39,74
Stenhousem'r,6403,3,16,8,12,58,47,11,56
Stirling,6403,4,16,6,14,61,54,7,54
Clyde,6403,5,15,9,12,54,50,4,54
Elgin,6403,6,14,7,15,55,62,-7,49
Annan Athlet,6403,7,12,11,13,50,41,9,47
Berwick,6403,8,8,10,18,31,61,-30,34
Edinburgh Ci,6403,9,7,10,19,37,61,-24,31
Cowdenbeath,6403,10,4,10,22,23,57,-34,22
Peterhead,6404,1,24,4,8,79,38,41,76
Montrose,6404,2,23,7,6,62,39,23,76
Stirling,6404,3,16,7,13,62,53,9,55
Stenhousem'r,6404,4,15,9,12,57,48,9,54
Clyde,6404,5,15,9,12,53,48,5,54
Elgin,6404,6,15,6,15,58,63,-5,51
Annan Athlet,6404,7,11,11,14,47,42,5,44
Berwick,6404,8,8,10,18,29,60,-31,34
Edinburgh Ci,6404,9,7,9,20,36,62,-26,30
Cowdenbeath,6404,10,5,10,21,24,54,-30,25
Peterhead,6405,1,24,4,8,79,39,40,76
Montrose,6405,2,23,7,6,59,35,24,76
Stirling,6405,3,17,6,13,62,51,11,57
Stenhousem'r,6405,4,15,8,13,55,48,7,53
Clyde,6405,5,14,9,13,51,50,1,51
Elgin,6405,6,15,6,15,54,60,-6,51
Annan Athlet,6405,7,12,11,13,49,42,7,47
Berwick,6405,8,9,10,17,31,58,-27,37
Edinburgh Ci,6405,9,7,9,20,37,62,-25,30
Cowdenbeath,6405,10,4,10,22,24,56,-32,22
Montrose,6406,1,23,8,5,60,35,25,77
Peterhead,6406,2,24,4,8,79,38,41,76
Stirling,6406,3,17,6,13,64,52,12,57
Clyde,6406,4,15,9,12,55,51,4,54
Stenhousem'r,6406,5,15,8,13,56,50,6,53
Elgin,6406,6,14,7,15,54,61,-7,49
Annan Athlet,6406,7,12,11,13,49,42,7,47
Berwick,6406,8,8,10,18,32,62,-30,34
Edinburgh Ci,6406,9,7,9,20,36,62,-26,30
Cowdenbeath,6406,10,4,10,22,24,56,-32,22
Montrose,6407,1,24,7,5,61,34,27,79
Peterhead,6407,2,24,4,8,81,39,42,76
Stirling,6407,3,17,6,13,63,52,11,57
Stenhousem'r,6407,4,15,8,13,56,49,7,53
Clyde,6407,5,14,9,13,52,51,1,51
Elgin,6407,6,14,6,16,53,62,-9,48
Annan Athlet,6407,7,11,12,13,48,42,6,45
Berwick,6407,8,9,10,17,32,59,-27,37
Edinburgh Ci,6407,9,7,9,20,37,64,-27,30
Cowdenbeath,6407,10,4,11,21,24,55,-31,23
Peterhead,6408,1,24,4,8,79,39,40,76
Montrose,6408,2,23,7,6,59,36,23,76
Stirling,6408,3,17,6,13,62,52,10,57
Clyde,6408,4,15,9,12,53,49,4,54
Stenhousem'r,6408,5,15,8,13,56,48,8,53
Elgin,6408,6,15,6,15,55,60,-5,51
Annan Athlet,6408,7,11,11,14,47,42,5,44
Berwick,6408,8,8,10,18,30,60,-30,34
Edinburgh Ci,6408,9,7,9,20,37,62,-25,30
Cowdenbeath,6408,10,5,10,21,24,54,-30,25
Peterhead,6409,1,24,4,8,80,40,40,76
Montrose,6409,2,23,7,6,60,36,24,76
Stirling,6409,3,17,6,13,63,53,10,57
Clyde,6409,4,15,9,12,52,48,4,54
Stenhousem'r,6409,5,15,8,13,57,49,8,53
Elgin,6409,6,15,6,15,55,61,-6,51
Annan Athlet,6409,7,11,12,13,49,43,6,45
Berwick,6409,8,8,10,18,29,59,-30,34
Edinburgh Ci,6409,9,7,9,20,38,63,-25,30
Cowdenbeath,6409,10,4,11,21,25,56,-31,23
Montrose,6410,1,24,7,5,61,35,26,79
Peterhead,6410,2,24,4,8,80,39,41,76
Stirling,6410,3,17,6,13,64,54,10,57
Stenhousem'r,6410,4,15,8,13,58,50,8,53
Clyde,6410,5,14,10,12,52,49,3,52
Elgin,6410,6,14,6,16,54,62,-8,48
Annan Athlet,6410,7,12,11,13,49,41,8,47
Berwick,6410,8,8,11,17,30,59,-29,35
Edinburgh Ci,6410,9,7,9,20,37,63,-26,30
Cowdenbeath,6410,10,4,10,22,23,56,-33,22
Montrose,6411,1,24,7,5,66,34,32,79
Peterhead,6411,2,24,4,8,79,39,40,76
Stenhousem'r,6411,3,16,8,12,58,47,11,56
Stirling,6411,4,16,6,14,61,54,7,54
Clyde,6411,5,15,9,12,53,48,5,54
Elgin,6411,6,14,6,16,53,67,-14,48
Annan Athlet,6411,7,11,11,14,48,43,5,44
Berwick,6411,8,8,10,18,29,60,-31,34
Edinburgh Ci,6411,9,7,9,20,37,62,-25,30
Cowdenbeath,6411,10,5,10,21,25,55,-30,25
Montrose,6412,1,24,7,5,60,34,26,79
Peterhead,6412,2,24,4,8,81,39,42,76
Stirling,6412,3,17,6,13,63,52,11,57
Clyde,6412,4,15,9,12,54,48,6,54
Stenhousem'r,6412,5,15,8,13,56,49,7,53
Elgin,6412,6,14,6,16,53,61,-8,48
Annan Athlet,6412,7,11,11,14,47,43,4,44
Berwick,6412,8,8,10,18,29,61,-32,34
Edinburgh Ci,6412,9,7,9,20,37,64,-27,30
Cowdenbeath,6412,10,5,10,21,25,54,-29,25
Montrose,6413,1,23,8,5,60,35,25,77
Peterhead,6413,2,24,4,8,80,38,42,76
Stirling,6413,3,17,6,13,63,52,11,57
Stenhousem'r,6413,4,15,8,13,56,49,7,53
Clyde,6413,5,14,10,12,53,50,3,52
Elgin,6413,6,14,7,15,54,61,-7,49
Annan Athlet,6413,7,11,12,13,48,42,6,45
Berwick,6413,8,8,11,17,31,60,-29,35
Edinburgh Ci,6413,9,7,9,20,36,63,-27,30
Cowdenbeath,6413,10,4,11,21,24,55,-31,23
Montrose,6414,1,24,7,5,62,35,27,79
Peterhead,6414,2,23,4,9,77,41,36,73
Stirling,6414,3,17,6,13,63,51,12,57
Stenhousem'r,6414,4,15,8,13,55,49,6,53
Clyde,6414,5,14,10,12,52,49,3,52
Elgin,6414,6,14,6,16,54,63,-9,48
Annan Athlet,6414,7,11,11,14,47,42,5,44
Berwick,6414,8,8,11,17,30,59,-29,35
Edinburgh Ci,6414,9,8,9,19,39,60,-21,33
Cowdenbeath,6414,10,5,10,21,24,54,-30,25
Montrose,6415,1,23,7,6,61,37,24,76
Peterhead,6415,2,23,5,8,79,40,39,74
Stirling,6415,3,17,6,13,62,52,10,57
Clyde,6415,4,15,9,12,54,50,4,54
Stenhousem'r,6415,5,15,8,13,56,48,8,53
Elgin,6415,6,15,6,15,56,62,-6,51
Annan Athlet,6415,7,11,11,14,47,43,4,44
Berwick,6415,8,8,10,18,31,61,-30,34
Edinburgh Ci,6415,9,7,10,19,38,62,-24,31
Cowdenbeath,6415,10,5,10,21,25,54,-29,25
Peterhead,6416,1,24,4,8,80,39,41,76
Montrose,6416,2,23,7,6,59,36,23,76
Stirling,6416,3,16,7,13,61,52,9,55
Stenhousem'r,6416,4,15,9,12,56,47,9,54
Clyde,6416,5,14,10,12,51,48,3,52
Elgin,6416,6,15,6,15,55,60,-5,51
Annan Athlet,6416,7,12,11,13,49,42,7,47
Berwick,6416,8,8,11,17,29,58,-29,35
Edinburgh Ci,6416,9,7,9,20,37,63,-26,30
Cowdenbeath,6416,10,4,10,22,24,56,-32,22
Montrose,6417,1,24,7,5,63,34,29,79
Peterhead,6417,2,24,4,8,79,38,41,76
Stirling,6417,3,16,7,13,61,52,9,55
Stenhousem'r,6417,4,15,9,12,56,47,9,54
Clyde,6417,5,15,9,12,53,49,4,54
Elgin,6417,6,14,6,16,53,64,-11,48
Annan Athlet,6417,7,11,12,13,47,41,6,45
Berwick,6417,8,8,10,18,30,60,-30,34
Edinburgh Ci,6417,9,7,9,20,36,62,-26,30
Cowdenbeath,6417,10,4,11,21,23,54,-31,23
Montrose,6418,1,24,7,5,62,34,28,79
Peterhead,6418,2,24,4,8,79,39,40,76
Stenhousem'r,6418,3,16,8,12,56,46,10,56
Stirling,6418,4,16,6,14,60,52,8,54
Clyde,6418,5,14,9,13,52,50,2,51
Elgin,6418,6,14,6,16,53,63,-10,48
Annan Athlet,6418,7,12,11,13,49,41,8,47
Berwick,6418,8,9,10,17,31,59,-28,37
Edinburgh Ci,6418,9,7,9,20,37,62,-25,30
Cowdenbeath,6418,10,4,10,22,23,56,-33,22
Montrose,6419,1,23,8,5,59,34,25,77
Peterhead,6419,2,24,4,8,80,38,42,76
Stenhousem'r,6419,3,16,8,12,57,47,10,56
Stirling,6419,4,16,6,14,61,53,8,54
Clyde,6419,5,14,10,12,52,49,3,52
Elgin,6419,6,14,7,15,53,60,-7,49
Annan Athlet,6419,7,11,12,13,48,42,6,45
Berwick,6419,8,8,11,17,30,59,-29,35
Edinburgh Ci,6419,9,7,9,20,36,63,-27,30
Cowdenbeath,6419,10,4,11,21,24,55,-31,23
Peterhead,6420,1,24,4,8,81,40,41,76
Montrose,6420,2,23,7,6,60,37,23,76
Stirling,6420,3,17,6,13,61,51,10,57
Stenhousem'r,6420,4,15,8,13,55,47,8,53
Clyde,6420,5,14,9,13,53,51,2,51
Elgin,6420,6,15,6,15,56,61,-5,51
Annan Athlet,6420,7,11,11,14,48,45,3,44
Berwick,6420,8,9,10,17,32,60,-28,37
Edinburgh Ci,6420,9,7,9,20,38,64,-26,30
Cowdenbeath,6420,10,5,10,21,27,55,-28,25
Montrose,6421,1,24,7,5,61,34,27,79
Peterhead,6421,2,24,4,8,79,39,40,76
Stenhousem'r,6421,3,16,8,12,57,46,11,56
Stirling,6421,4,16,6,14,60,53,7,54
Clyde,6421,5,14,10,12,51,48,3,52
Elgin,6421,6,14,6,16,53,62,-9,48
Annan Athlet,6421,7,11,12,13,47,41,6,45
Berwick,6421,8,8,11,17,29,58,-29,35
Edinburgh Ci,6421,9,7,9,20,37,62,-25,30
Cowdenbeath,6421,10,4,11,21,23,54,-31,23
Peterhead,6422,1,24,4,8,79,39,40,76
Montrose,6422,2,23,7,6,60,37,23,76
Stirling,6422,3,17,6,13,62,52,10,57
Clyde,6422,4,15,9,12,54,48,6,54
Stenhousem'r,6422,5,15,8,13,56,48,8,53
Elgin,6422,6,15,6,15,56,61,-5,51
Annan Athlet,6422,7,12,11,13,49,41,8,47
Berwick,6422,8,8,10,18,29,61,-32,34
Edinburgh Ci,6422,9,7,9,20,37,62,-25,30
Cowdenbeath,6422,10,4,10,22,23,56,-33,22
Montrose,6423,1,24,7,5,61,34,27,79
Peterhead,6423,2,23,5,8,78,39,39,74
Stirling,6423,3,17,6,13,63,51,12,57
Clyde,6423,4,15,9,12,53,49,4,54
Stenhousem'r,6423,5,15,8,13,55,49,6,53
Elgin,6423,6,14,6,16,53,62,-9,48
Annan Athlet,6423,7,11,11,14,47,43,4,44
Berwick,6423,8,8,10,18,30,60,-30,34
Edinburgh Ci,6423,9,7,10,19,37,61,-24,31
Cowdenbeath,6423,10,5,10,21,25,54,-29,25
Montrose,6424,1,24,7,5,61,35,26,79
Peterhead,6424,2,24,4,8,81,38,43,76
Stirling,6424,3,17,6,13,62,51,11,57
Stenhousem'r,6424,4,15,8,13,55,48,7,53
Clyde,6424,5,14,9,13,51,49,2,51
Elgin,6424,6,14,6,16,54,62,-8,48
Annan Athlet,6424,7,11,11,14,47,42,5,44
Berwick,6424,8,9,10,17,30,58,-28,37
Edinburgh Ci,6424,9,7,9,20,36,64,-28,30
Cowdenbeath,6424,10,5,10,21,24,54,-30,25
Montrose,6425,1,24,7,5,62,35,27,79
Peterhead,6425,2,24,4,8,82,38,44,76
Stirling,6425,3,17,6,13,62,51,11,57
Clyde,6425,4,15,9,12,55,49,6,54
Stenhousem'r,6425,5,15,8,13,55,48,7,53
Elgin,6425,6,14,6,16,54,63,-9,48
Annan Athlet,6425,7,12,11,13,50,42,8,47
Berwick,6425,8,8,10,18,30,62,-32,34
Edinburgh Ci,6425,9,7,9,20,36,65,-29,30
Cowdenbeath,6425,10,4,10,22,24,57,-33,22
Montrose,6426,1,24,7,5,64,34,30,79
Peterhead,6426,2,24,4,8,81,39,42,76
Stenhousem'r,6426,3,16,8,12,58,48,10,56
Stirling,6426,4,16,6,14,62,54,8,54
Clyde,6426,5,14,10,12,52,49,3,52
Elgin,6426,6,14,6,16,53,65,-12,48
Annan Athlet,6426,7,12,11,13,49,41,8,47
Berwick,6426,8,8,11,17,30,59,-29,35
Edinburgh Ci,6426,9,7,9,20,37,64,-27,30
Cowdenbeath,6426,10,4,10,22,23,56,-33,22
Montrose,6427,1,23,8,5,60,35,25,77
Peterhead,6427,2,24,4,8,79,38,41,76
Stirling,6427,3,17,6,13,62,52,10,57
Stenhousem'r,6427,4,15,8,13,56,48,8,53
Clyde,6427,5,14,9,13,52,50,2,51
Elgin,6427,6,14,7,15,54,61,-7,49
Annan Athlet,6427,7,11,12,13,48,42,6,45
Berwick,6427,8,9,10,17,31,59,-28,37
Edinburgh Ci,6427,9,7,9,20,36,62,-26,30
Cowdenbeath,6427,10,4,11,21,24,55,-31,23
Montrose,6428,1,24,7,5,62,35,27,79
Peterhead,6428,2,23,4,9,78,41,37,73
Stirling,6428,3,16,7,13,62,53,9,55
Stenhousem'r,6428,4,15,9,12,57,48,9,54
Clyde,6428,5,15,9,12,52,48,4,54
Elgin,6428,6,14,6,16,54,63,-9,48
Annan Athlet,6428,7,11,12,13,47,41,6,45
Berwick,6428,8,8,10,18,29,59,-30,34
Edinburgh Ci,6428,9,8,9,19,39,61,-22,33
Cowdenbeath,6428,10,4,11,21,23,54,-31,23
Montrose,6429,1,24,7,5,60,34,26,79
Peterhead,6429,2,23,4,9,78,40,38,73
Stirling,6429,3,16,7,13,60,51,9,55
Stenhousem'r,6429,4,15,9,12,55,46,9,54
Clyde,6429,5,15,9,12,55,48,7,54
Elgin,6429,6,14,6,16,53,61,-8,48
Annan Athlet,6429,7,11,11,14,48,43,5,44
Berwick,6429,8,8,10,18,29,62,-33,34
Edinburgh Ci,6429,9,8,9,19,38,61,-23,33
Cowdenbeath,6429,10,5,10,21,25,55,-30,25
Montrose,6430,1,24,7,5,63,34,29,79
Peterhead,6430,2,24,4,8,81,40,41,76
Stirling,6430,3,17,6,13,64,51,13,57
Stenhousem'r,6430,4,15,8,13,55,50,5,53
Clyde,6430,5,14,9,13,52,50,2,51
Elgin,6430,6,14,6,16,53,64,-11,48
Annan Athlet,6430,7,11,11,14,47,43,4,44
Berwick,6430,8,9,10,17,31,59,-28,37
Edinburgh Ci,6430,9,7,9,20,38,64,-26,30
Cowdenbeath,6430,10,5,10,21,25,54,-29,25
Montrose,6431,1,24,7,5,62,34,28,79
Peterhead,6431,2,24,4,8,80,38,42,76
Stenhousem'r,6431,3,16,8,12,59,48,11,56
Stirling,6431,4,16,6,14,62,55,7,54
Clyde,6431,5,15,9,12,55,51,4,54
Elgin,6431,6,14,6,16,53,63,-10,48
Annan Athlet,6431,7,11,11,14,47,42,5,44
Berwick,6431,8,8,10,18,32,62,-30,34
Edinburgh Ci,6431,9,7,9,20,36,63,-27,30
Cowdenbeath,6431,10,5,10,21,24,54,-30,25
Montrose,6432,1,23,8,5,60,35,25,77
Peterhead,6432,2,24,4,8,83,38,45,76
Stirling,6432,3,17,6,13,62,51,11,57
Stenhousem'r,6432,4,15,8,13,55,48,7,53
Clyde,6432,5,14,10,12,52,49,3,52
Elgin,6432,6,14,7,15,54,61,-7,49
Annan Athlet,6432,7,11,11,14,47,43,4,44
Berwick,6432,8,8,11,17,30,59,-29,35
Edinburgh Ci,6432,9,7,9,20,36,66,-30,30
Cowdenbeath,6432,10,5,10,21,25,54,-29,25
Montrose,6433,1,24,7,5,62,35,27,79
Peterhead,6433,2,24,4,8,79,38,41,76
Stenhousem'r,6433,3,16,8,12,57,46,11,56
Stirling,6433,4,16,6,14,60,53,7,54
Clyde,6433,5,14,10,12,53,50,3,52
Elgin,6433,6,14,6,16,54,63,-9,48
Annan Athlet,6433,7,12,11,13,49,42,7,47
Berwick,6433,8,8,11,17,31,60,-29,35
Edinburgh Ci,6433,9,7,9,20,36,62,-26,30
Cowdenbeath,6433,10,4,10,22,24,56,-32,22
Montrose,6434,1,23,8,5,60,35,25,77
Peterhead,6434,2,24,4,8,82,40,42,76
Stirling,6434,3,16,7,13,60,51,9,55
Stenhousem'r,6434,4,15,9,12,55,46,9,54
Clyde,6434,5,15,9,12,54,48,6,54
Elgin,6434,6,14,7,15,54,61,-7,49
Annan Athlet,6434,7,11,11,14,48,43,5,44
Berwick,6434,8,8,10,18,29,61,-32,34
Edinburgh Ci,6434,9,7,9,20,38,65,-27,30
Cowdenbeath,6434,10,5,10,21,25,55,-30,25
Montrose,6435,1,23,8,5,59,34,25,77
Peterhead,6435,2,24,4,8,81,40,41,76
Stirling,6435,3,17,6,13,62,52,10,57
Stenhousem'r,6435,4,15,8,13,56,48,8,53
Clyde,6435,5,14,10,12,51,48,3,52
Elgin,6435,6,14,7,15,53,60,-7,49
Annan Athlet,6435,7,11,12,13,48,42,6,45
Berwick,6435,8,8,11,17,29,58,-29,35
Edinburgh Ci,6435,9,7,9,20,38,64,-26,30
Cowdenbeath,6435,10,4,11,21,24,55,-31,23
Montrose,6436,1,24,7,5,61,34,27,79
Peterhead,6436,2,24,4,8,79,38,41,76
Stenhousem'r,6436,3,16,8,12,56,46,10,56
Stirling,6436,4,16,6,14,60,52,8,54
Clyde,6436,5,14,10,12,52,49,3,52
Elgin,6436,6,14,6,16,53,62,-9,48
Annan Athlet,6436,7,11,12,13,49,43,6,45
Berwick,6436,8,8,11,17,30,59,-29,35
Edinburgh Ci,6436,9,7,9,20,36,62,-26,30
Cowdenbeath,6436,10,4,11,21,25,56,-31,23
Montrose,6437,1,23,8,5,60,35,25,77
Peterhead,6437,2,24,4,8,83,42,41,76
Stenhousem'r,6437,3,16,8,12,57,47,10,56
Stirling,6437,4,16,6,14,61,53,8,54
Clyde,6437,5,15,9,12,55,49,6,54
Elgin,6437,6,14,7,15,54,61,-7,49
Annan Athlet,6437,7,12,11,13,49,41,8,47
Berwick,6437,8,8,10,18,30,62,-32,34
Edinburgh Ci,6437,9,7,9,20,40,66,-26,30
Cowdenbeath,6437,10,4,10,22,23,56,-33,22
Montrose,6438,1,24,7,5,65,37,28,79
Peterhead,6438,2,24,4,8,79,39,40,76
Stirling,6438,3,16,7,13,61,52,9,55
Stenhousem'r,6438,4,15,9,12,56,47,9,54
Clyde,6438,5,14,9,13,52,50,2,51
Elgin,6438,6,14,6,16,56,66,-10,48
Annan Athlet,6438,7,11,11,14,47,43,4,44
Berwick,6438,8,9,10,17,31,59,-28,37
Edinburgh Ci,6438,9,7,9,20,37,62,-25,30
Cowdenbeath,6438,10,5,10,21,25,54,-29,25
Montrose,6439,1,24,7,5,63,34,29,79
Peterhead,6439,2,24,4,8,80,38,42,76
Stirling,6439,3,16,7,13,63,54,9,55
Stenhousem'r,6439,4,15,9,12,58,49,9,54
Clyde,6439,5,15,9,12,54,49,5,54
Elgin,6439,6,14,6,16,53,64,-11,48
Annan Athlet,6439,7,12,11,13,49,42,7,47
Berwick,6439,8,8,10,18,30,61,-31,34
Edinburgh Ci,6439,9,7,9,20,36,63,-27,30
Cowdenbeath,6439,10,4,10,22,24,56,-32,22
Montrose,6440,1,23,7,6,61,37,24,76
Peterhead,6440,2,23,4,9,77,39,38,73
Stirling,6440,3,17,6,13,63,52,11,57
Clyde,6440,4,15,9,12,54,48,6,54
Stenhousem'r,6440,5,15,8,13,56,49,7,53
Elgin,6440,6,15,6,15,56,62,-6,51
Annan Athlet,6440,7,11,11,14,48,44,4,44
Berwick,6440,8,8,10,18,29,61,-32,34
Edinburgh Ci,6440,9,8,9,19,37,60,-23,33
Cowdenbeath,6440,10,5,10,21,26,55,-29,25
Montrose,6441,1,24,7,5,65,34,31,79
Peterhead,6441,2,24,4,8,79,39,40,76
Stirling,6441,3,17,6,13,63,53,10,57
Clyde,6441,4,15,9,12,55,49,6,54
Stenhousem'r,6441,5,15,8,13,57,49,8,53
Elgin,6441,6,14,6,16,53,66,-13,48
Annan Athlet,6441,7,12,11,13,48,41,7,47
Berwick,6441,8,8,10,18,30,62,-32,34
Edinburgh Ci,6441,9,7,9,20,37,62,-25,30
Cowdenbeath,6441,10,4,10,22,23,55,-32,22
Peterhead,6442,1,24,4,8,79,38,41,76
Montrose,6442,2,23,7,6,60,36,24,76
Stenhousem'r,6442,3,16,8,12,57,47,10,56
Stirling,6442,4,16,6,14,61,53,8,54
Clyde,6442,5,14,9,13,51,50,1,51
Elgin,6442,6,15,6,15,55,61,-6,51
Annan Athlet,6442,7,11,12,13,48,42,6,45
Berwick,6442,8,9,10,17,31,58,-27,37
Edinburgh Ci,6442,9,7,9,20,36,62,-26,30
Cowdenbeath,6442,10,4,11,21,24,55,-31,23
Montrose,6443,1,23,8,5,60,35,25,77
Peterhead,6443,2,24,4,8,80,38,42,76
Stirling,6443,3,17,6,13,63,52,11,57
Stenhousem'r,6443,4,15,8,13,56,49,7,53
Clyde,6443,5,14,10,12,51,48,3,52
Elgin,6443,6,14,7,15,54,61,-7,49
Annan Athlet,6443,7,12,11,13,50,42,8,47
Berwick,6443,8,8,11,17,29,58,-29,35
Edinburgh Ci,6443,9,7,9,20,36,63,-27,30
Cowdenbeath,6443,10,4,10,22,24,57,-33,22
Montrose,6444,1,24,7,5,60,34,26,79
Peterhead,6444,2,24,4,8,78,38,40,76
Stirling,6444,3,16,7,13,61,52,9,55
Stenhousem'r,6444,4,15,9,12,56,47,9,54
Clyde,6444,5,15,9,12,54,48,6,54
Elgin,6444,6,14,6,16,53,61,-8,48
Annan Athlet,6444,7,11,11,14,47,42,5,44
Berwick,6444,8,8,10,18,29,61,-32,34
Edinburgh Ci,6444,9,7,9,20,36,61,-25,30
Cowdenbeath,6444,10,5,10,21,24,54,-30,25
Montrose,6445,1,24,7,5,63,35,28,79
Peterhead,6445,2,23,5,8,78,39,39,74
Stenhousem'r,6445,3,16,8,12,58,48,10,56
Stirling,6445,4,16,6,14,62,54,8,54
Clyde,6445,5,14,9,13,51,49,2,51
Elgin,6445,6,14,6,16,54,64,-10,48
Annan Athlet,6445,7,11,11,14,47,42,5,44
Berwick,6445,8,9,10,17,30,58,-28,37
Edinburgh Ci,6445,9,7,10,19,37,61,-24,31
Cowdenbeath,6445,10,5,10,21,24,54,-30,25
Montrose,6446,1,23,7,6,60,36,24,76
Peterhead,6446,2,23,5,8,77,38,39,74
Stirling,6446,3,17,6,13,61,51,10,57
Clyde,6446,4,15,9,12,52,48,4,54
Stenhousem'r,6446,5,15,8,13,55,47,8,53
Elgin,6446,6,15,6,15,55,61,-6,51
Annan Athlet,6446,7,11,12,13,48,42,6,45
Berwick,6446,8,8,10,18,29,59,-30,34
Edinburgh Ci,6446,9,7,10,19,36,60,-24,31
Cowdenbeath,6446,10,4,11,21,24,55,-31,23
Montrose,6447,1,23,8,5,60,35,25,77
Peterhead,6447,2,23,4,9,77,40,37,73
Stirling,6447,3,17,6,13,63,51,12,57
Stenhousem'r,6447,4,15,8,13,55,49,6,53
Clyde,6447,5,14,9,13,52,50,2,51
Elgin,6447,6,14,7,15,54,61,-7,49
Annan Athlet,6447,7,11,12,13,48,42,6,45
Berwick,6447,8,9,10,17,31,59,-28,37
Edinburgh Ci,6447,9,8,9,19,38,60,-22,33
Cowdenbeath,6447,10,4,11,21,24,55,-31,23
Montrose,6448,1,24,7,5,61,35,26,79
Peterhead,6448,2,24,4,8,84,41,43,76
Stirling,6448,3,16,7,13,63,54,9,55
Stenhousem'r,6448,4,15,9,12,58,49,9,54
Clyde,6448,5,15,9,12,55,49,6,54
Elgin,6448,6,14,6,16,54,62,-8,48
Annan Athlet,6448,7,11,11,14,47,42,5,44
Berwick,6448,8,8,10,18,30,62,-32,34
Edinburgh Ci,6448,9,7,9,20,39,67,-28,30
Cowdenbeath,6448,10,5,10,21,24,54,-30,25
Montrose,6449,1,24,7,5,65,35,30,79
Peterhead,6449,2,24,4,8,80,40,40,76
Stenhousem'r,6449,3,16,8,12,59,47,12,56
Stirling,6449,4,16,6,14,61,55,6,54
Clyde,6449,5,14,10,12,51,48,3,52
Elgin,6449,6,14,6,16,54,66,-12,48
Annan Athlet,6449,7,12,11,13,49,41,8,47
Berwick,6449,8,8,11,17,29,58,-29,35
Edinburgh Ci,6449,9,7,9,20,38,63,-25,30
Cowdenbeath,6449,10,4,10,22,23,56,-33,22
Montrose,6450,1,24,7,5,60,34,26,79
Peterhead,6450,2,23,5,8,78,39,39,74
Stirling,6450,3,17,6,13,61,51,10,57
Stenhousem'r,6450,4,15,8,13,55,47,8,53
Clyde,6450,5,14,9,13,52,50,2,51
Elgin,6450,6,14,6,16,53,61,-8,48
Annan Athlet,6450,7,11,11,14,48,44,4,44
Berwick,6450,8,9,10,17,31,59,-28,37
Edinburgh Ci,6450,9,7,10,19,37,61,-24,31
Cowdenbeath,6450,10,5,10,21,26,55,-29,25
Peterhead,6451,1,24,4,8,81,39,42,76
Montrose,6451,2,23,7,6,60,36,24,76
Stirling,6451,3,16,7,13,61,52,9,55
Stenhousem'r,6451,4,15,9,12,56,47,9,54
Clyde,6451,5,14,10,12,52,49,3,52
Elgin,6451,6,15,6,15,55,61,-6,51
Annan Athlet,6451,7,12,11,13,49,42,7,47
Berwick,6451,8,8,11,17,30,59,-29,35
Edinburgh Ci,6451,9,7,9,20,37,64,-27,30
Cowdenbeath,6451,10,4,10,22,24,56,-32,22
Montrose,6452,1,24,7,5,62,34,28,79
Peterhead,6452,2,23,5,8,78,39,39,74
Stirling,6452,3,17,6,13,63,51,12,57
Clyde,6452,4,15,9,12,52,48,4,54
Stenhousem'r,6452,5,15,8,13,55,49,6,53
Elgin,6452,6,14,6,16,53,63,-10,48
Annan Athlet,6452,7,12,11,13,48,41,7,47
Berwick,6452,8,8,10,18,29,59,-30,34
Edinburgh Ci,6452,9,7,10,19,37,61,-24,31
Cowdenbeath,6452,10,4,10,22,23,55,-32,22
Montrose,6453,1,23,8,5,61,36,25,77
Peterhead,6453,2,24,4,8,79,39,40,76
Stirling,6453,3,17,6,13,62,52,10,57
Clyde,6453,4,15,9,12,54,49,5,54
Stenhousem'r,6453,5,15,8,13,56,48,8,53
Elgin,6453,6,14,7,15,55,62,-7,49
Annan Athlet,6453,7,12,11,13,50,43,7,47
Berwick,6453,8,8,10,18,30,61,-31,34
Edinburgh Ci,6453,9,7,9,20,37,62,-25,30
Cowdenbeath,6453,10,4,10,22,25,57,-32,22
Montrose,6454,1,24,7,5,61,34,27,79
Peterhead,6454,2,24,4,8,82,39,43,76
Stirling,6454,3,16,7,13,63,54,9,55
Stenhousem'r,6454,4,15,9,12,58,49,9,54
Clyde,6454,5,14,10,12,54,51,3,52
Elgin,6454,6,14,6,16,53,62,-9,48
Annan Athlet,6454,7,11,11,14,47,42,5,44
Berwick,6454,8,8,11,17,32,61,-29,35
Edinburgh Ci,6454,9,7,9,20,37,65,-28,30
Cowdenbeath,6454,10,5,10,21,24,54,-30,25
Montrose,6455,1,24,7,5,61,34,27,79
Peterhead,6455,2,24,4,8,81,39,42,76
Stirling,6455,3,16,7,13,62,53,9,55
Stenhousem'r,6455,4,15,9,12,57,48,9,54
Clyde,6455,5,15,9,12,54,49,5,54
Elgin,6455,6,14,6,16,53,62,-9,48
Annan Athlet,6455,7,12,11,13,48,41,7,47
Berwick,6455,8,8,10,18,30,61,-31,34
Edinburgh Ci,6455,9,7,9,20,37,64,-27,30
Cowdenbeath,6455,10,4,10,22,23,55,-32,22
Peterhead,6456,1,24,4,8,80,38,42,76
Montrose,6456,2,23,7,6,59,35,24,76
Stenhousem'r,6456,3,16,8,12,57,47,10,56
Stirling,6456,4,16,6,14,61,53,8,54
Clyde,6456,5,15,9,12,53,49,4,54
Elgin,6456,6,15,6,15,54,60,-6,51
Annan Athlet,6456,7,12,11,13,48,41,7,47
Berwick,6456,8,8,10,18,30,60,-30,34
Edinburgh Ci,6456,9,7,9,20,36,63,-27,30
Cowdenbeath,6456,10,4,10,22,23,55,-32,22
Peterhead,6457,1,24,4,8,79,39,40,76
Montrose,6457,2,23,7,6,60,36,24,76
Stirling,6457,3,16,7,13,61,52,9,55
Stenhousem'r,6457,4,15,9,12,56,47,9,54
Clyde,6457,5,15,9,12,56,49,7,54
Elgin,6457,6,15,6,15,55,61,-6,51
Annan Athlet,6457,7,11,11,14,47,42,5,44
Berwick,6457,8,8,10,18,30,63,-33,34
Edinburgh Ci,6457,9,7,9,20,37,62,-25,30
Cowdenbeath,6457,10,5,10,21,24,54,-30,25
Montrose,6458,1,24,7,5,61,35,26,79
Peterhead,6458,2,23,4,9,79,42,37,73
Stenhousem'r,6458,3,16,8,12,57,46,11,56
Stirling,6458,4,16,6,14,60,53,7,54
Clyde,6458,5,15,9,12,53,48,5,54
Elgin,6458,6,14,6,16,54,62,-8,48
Annan Athlet,6458,7,12,11,13,49,41,8,47
Berwick,6458,8,8,10,18,29,60,-31,34
Edinburgh Ci,6458,9,8,9,19,40,62,-22,33
Cowdenbeath,6458,10,4,10,22,23,56,-33,22
Montrose,6459,1,23,8,5,59,34,25,77
Peterhead,6459,2,24,4,8,82,38,44,76
Stirling,6459,3,17,6,13,66,53,13,57
Clyde,6459,4,15,9,12,55,48,7,54
Stenhousem'r,6459,5,15,8,13,57,52,5,53
Elgin,6459,6,14,7,15,53,60,-7,49
Annan Athlet,6459,7,12,11,13,49,41,8,47
Berwick,6459,8,8,10,18,29,62,-33,34
Edinburgh Ci,6459,9,7,9,20,36,65,-29,30
Cowdenbeath,6459,10,4,10,22,23,56,-33,22
Montrose,6460,1,24,7,5,63,34,29,79
Peterhead,6460,2,24,4,8,78,38,40,76
Stirling,6460,3,16,7,13,61,52,9,55
Stenhousem'r,6460,4,15,9,12,56,47,9,54
Clyde,6460,5,15,9,12,54,49,5,54
Elgin,6460,6,14,6,16,53,64,-11,48
Annan Athlet,6460,7,12,11,13,48,41,7,47
Berwick,6460,8,8,10,18,30,61,-31,34
Edinburgh Ci,6460,9,7,9,20,36,61,-25,30
Cowdenbeath,6460,10,4,10,22,23,55,-32,22
Montrose,6461,1,24,7,5,62,35,27,79
Peterhead,6461,2,24,4,8,82,39,43,76
Stirling,6461,3,17,6,13,62,51,11,57
Stenhousem'r,6461,4,15,8,13,55,48,7,53
Clyde,6461,5,14,9,13,52,50,2,51
Elgin,6461,6,14,6,16,54,63,-9,48
Annan Athlet,6461,7,12,11,13,48,41,7,47
Berwick,6461,8,9,10,17,31,59,-28,37
Edinburgh Ci,6461,9,7,9,20,37,65,-28,30
Cowdenbeath,6461,10,4,10,22,23,55,-32,22
Montrose,6462,1,24,7,5,63,34,29,79
Peterhead,6462,2,23,4,9,77,40,37,73
Stenhousem'r,6462,3,16,8,12,58,48,10,56
Stirling,6462,4,16,6,14,62,54,8,54
Clyde,6462,5,14,9,13,51,50,1,51
Elgin,6462,6,14,6,16,53,64,-11,48
Annan Athlet,6462,7,11,11,14,47,42,5,44
Berwick,6462,8,9,10,17,31,58,-27,37
Edinburgh Ci,6462,9,8,9,19,38,60,-22,33
Cowdenbeath,6462,10,5,10,21,24,54,-30,25
Montrose,6463,1,24,7,5,63,34,29,79
Peterhead,6463,2,24,4,8,81,38,43,76
Stirling,6463,3,16,7,13,61,52,9,55
Stenhousem'r,6463,4,15,9,12,56,47,9,54
Clyde,6463,5,14,9,13,52,50,2,51
Elgin,6463,6,14,6,16,53,64,-11,48
Annan Athlet,6463,7,11,12,13,47,41,6,45
Berwick,6463,8,9,10,17,31,59,-28,37
Edinburgh Ci,6463,9,7,9,20,36,64,-28,30
Cowdenbeath,6463,10,4,11,21,23,54,-31,23
Montrose,6464,1,24,7,5,61,34,27,79
Peterhead,6464,2,24,4,8,81,39,42,76
Stenhousem'r,6464,3,16,8,12,58,48,10,56
Stirling,6464,4,16,6,14,62,54,8,54
Clyde,6464,5,14,9,13,52,50,2,51
Elgin,6464,6,14,6,16,53,62,-9,48
Annan Athlet,6464,7,11,11,14,47,42,5,44
Berwick,6464,8,9,10,17,31,59,-28,37
Edinburgh Ci,6464,9,7,9,20,37,64,-27,30
Cowdenbeath,6464,10,5,10,21,24,54,-30,25
Peterhead,6465,1,24,4,8,80,38,42,76
Montrose,6465,2,23,7,6,59,35,24,76
Stirling,6465,3,17,6,13,64,53,11,57
Stenhousem'r,6465,4,15,8,13,57,50,7,53
Clyde,6465,5,14,9,13,52,50,2,51
Elgin,6465,6,15,6,15,54,60,-6,51
Annan Athlet,6465,7,11,12,13,47,41,6,45
Berwick,6465,8,9,10,17,31,59,-28,37
Edinburgh Ci,6465,9,7,9,20,36,63,-27,30
Cowdenbeath,6465,10,4,11,21,23,54,-31,23
Peterhead,6466,1,24,4,8,78,38,40,76
Montrose,6466,2,23,7,6,59,36,23,76
Stenhousem'r,6466,3,16,8,12,59,49,10,56
Stirling,6466,4,16,6,14,63,55,8,54
Clyde,6466,5,14,9,13,51,49,2,51
Elgin,6466,6,15,6,15,55,60,-5,51
Annan Athlet,6466,7,12,11,13,49,41,8,47
Berwick,6466,8,9,10,17,30,58,-28,37
Edinburgh Ci,6466,9,7,9,20,36,61,-25,30
Cowdenbeath,6466,10,4,10,22,23,56,-33,22
Montrose,6467,1,24,7,5,65,35,30,79
Peterhead,6467,2,24,4,8,78,38,40,76
Stirling,6467,3,17,6,13,62,52,10,57
Stenhousem'r,6467,4,15,8,13,56,48,8,53
Clyde,6467,5,14,9,13,52,50,2,51
Elgin,6467,6,14,6,16,54,66,-12,48
Annan Athlet,6467,7,12,11,13,48,41,7,47
Berwick,6467,8,9,10,17,31,59,-28,37
Edinburgh Ci,6467,9,7,9,20,36,61,-25,30
Cowdenbeath,6467,10,4,10,22,23,55,-32,22
Montrose,6468,1,24,7,5,62,36,26,79
Peterhead,6468,2,24,4,8,82,38,44,76
Stenhousem'r,6468,3,16,8,12,56,46,10,56
Stirling,6468,4,16,6,14,60,52,8,54
Clyde,6468,5,14,10,12,53,50,3,52
Elgin,6468,6,14,6,16,55,63,-8,48
Annan Athlet,6468,7,12,11,13,52,41,11,47
Berwick,6468,8,8,11,17,31,60,-29,35
Edinburgh Ci,6468,9,7,9,20,36,65,-29,30
Cowdenbeath,6468,10,4,10,22,23,59,-36,22
Peterhead,6469,1,24,4,8,81,40,41,76
Montrose,6469,2,23,7,6,60,36,24,76
Stirling,6469,3,17,6,13,64,51,13,57
Clyde,6469,4,15,9,12,53,49,4,54
Stenhousem'r,6469,5,15,8,13,55,50,5,53
Elgin,6469,6,15,6,15,55,61,-6,51
Annan Athlet,6469,7,11,12,13,49,43,6,45
Berwick,6469,8,8,10,18,30,60,-30,34
Edinburgh Ci,6469,9,7,9,20,38,64,-26,30
Cowdenbeath,6469,10,4,11,21,25,56,-31,23
Montrose,6470,1,23,8,5,60,35,25,77
Peterhead,6470,2,24,4,8,80,38,42,76
Stenhousem'r,6470,3,16,8,12,57,46,11,56
Stirling,6470,4,16,6,14,60,53,7,54
Clyde,6470,5,15,9,12,54,48,6,54
Elgin,6470,6,14,7,15,54,61,-7,49
Annan Athlet,6470,7,11,12,13,47,41,6,45
Berwick,6470,8,8,10,18,29,61,-32,34
Edinburgh Ci,6470,9,7,9,20,36,63,-27,30
Cowdenbeath,6470,10,4,11,21,23,54,-31,23
Montrose,6471,1,23,8,5,59,34,25,77
Peterhead,6471,2,24,4,8,81,39,42,76
Stenhousem'r,6471,3,16,8,12,58,48,10,56
Stirling,6471,4,16,6,14,62,54,8,54
Clyde,6471,5,15,9,12,52,48,4,54
Elgin,6471,6,14,7,15,53,60,-7,49
Annan Athlet,6471,7,11,11,14,48,43,5,44
Berwick,6471,8,8,10,18,29,59,-30,34
Edinburgh Ci,6471,9,7,9,20,37,64,-27,30
Cowdenbeath,6471,10,5,10,21,25,55,-30,25
Montrose,6472,1,24,7,5,61,35,26,79
Peterhead,6472,2,24,4,8,79,38,41,76
Stirling,6472,3,17,6,13,64,52,12,57
Clyde,6472,4,15,9,12,53,48,5,54
Stenhousem'r,6472,5,15,8,13,56,50,6,53
Elgin,6472,6,14,6,16,54,62,-8,48
Annan Athlet,6472,7,12,11,13,51,42,9,47
Berwick,6472,8,8,10,18,29,60,-31,34
Edinburgh Ci,6472,9,7,9,20,36,62,-26,30
Cowdenbeath,6472,10,4,10,22,24,58,-34,22
Montrose,6473,1,24,7,5,61,35,26,79
Peterhead,6473,2,24,4,8,81,38,43,76
Stenhousem'r,6473,3,16,8,12,56,46,10,56
Stirling,6473,4,16,6,14,60,52,8,54
Clyde,6473,5,15,9,12,52,48,4,54
Elgin,6473,6,14,6,16,54,62,-8,48
Annan Athlet,6473,7,11,12,13,47,41,6,45
Berwick,6473,8,8,10,18,29,59,-30,34
Edinburgh Ci,6473,9,7,9,20,36,64,-28,30
Cowdenbeath,6473,10,4,11,21,23,54,-31,23
Montrose,6474,1,24,7,5,62,35,27,79
Peterhead,6474,2,24,4,8,80,38,42,76
Stenhousem'r,6474,3,16,8,12,56,46,10,56
Stirling,6474,4,16,6,14,60,52,8,54
Clyde,6474,5,14,10,12,51,48,3,52
Elgin,6474,6,14,6,16,54,63,-9,48
Annan Athlet,6474,7,11,11,14,49,45,4,44
Berwick,6474,8,8,11,17,29,58,-29,35
Edinburgh Ci,6474,9,7,9,20,36,63,-27,30
Cowdenbeath,6474,10,5,10,21,27,56,-29,25
Montrose,6475,1,24,7,5,60,34,26,79
Peterhead,6475,2,24,4,8,80,39,41,76
Stirling,6475,3,17,6,13,64,52,12,57
Clyde,6475,4,15,9,12,53,48,5,54
Stenhousem'r,6475,5,15,8,13,56,50,6,53
Elgin,6475,6,14,6,16,53,61,-8,48
Annan Athlet,6475,7,11,12,13,48,42,6,45
Berwick,6475,8,8,10,18,29,60,-31,34
Edinburgh Ci,6475,9,7,9,20,37,63,-26,30
Cowdenbeath,6475,10,4,11,21,24,55,-31,23
Montrose,6476,1,24,7,5,60,34,26,79
Peterhead,6476,2,23,4,9,78,40,38,73
Stirling,6476,3,16,7,13,63,54,9,55
Stenhousem'r,6476,4,15,9,12,58,49,9,54
Clyde,6476,5,15,9,12,53,49,4,54
Elgin,6476,6,14,6,16,53,61,-8,48
Annan Athlet,6476,7,11,12,13,48,42,6,45
Berwick,6476,8,8,10,18,30,60,-30,34
Edinburgh Ci,6476,9,8,9,19,38,61,-23,33
Cowdenbeath,6476,10,4,11,21,24,55,-31,23
Montrose,6477,1,24,7,5,65,35,30,79
Peterhead,6477,2,24,4,8,79,39,40,76
Stirling,6477,3,17,6,13,62,52,10,57
Stenhousem'r,6477,4,15,8,13,56,48,8,53
Clyde,6477,5,14,10,12,54,51,3,52
Elgin,6477,6,14,6,16,54,66,-12,48
Annan Athlet,6477,7,11,12,13,48,42,6,45
Berwick,6477,8,8,11,17,32,61,-29,35
Edinburgh Ci,6477,9,7,9,20,37,62,-25,30
Cowdenbeath,6477,10,4,11,21,24,55,-31,23
Peterhead,6478,1,24,4,8,81,41,40,76
Montrose,6478,2,23,7,6,61,38,23,76
Stirling,6478,3,17,6,13,62,51,11,57
Clyde,6478,4,15,9,12,54,49,5,54
Stenhousem'r,6478,5,15,8,13,55,48,7,53
Elgin,6478,6,15,6,15,57,62,-5,51
Annan Athlet,6478,7,12,11,13,48,41,7,47
Berwick,6478,8,8,10,18,30,61,-31,34
Edinburgh Ci,6478,9,7,9,20,39,64,-25,30
Cowdenbeath,6478,10,4,10,22,23,55,-32,22
Montrose,6479,1,23,8,5,60,35,25,77
Peterhead,6479,2,24,4,8,81,39,42,76
Stenhousem'r,6479,3,16,8,12,57,47,10,56
Stirling,6479,4,16,6,14,61,53,8,54
Clyde,6479,5,15,9,12,55,48,7,54
Elgin,6479,6,14,7,15,54,61,-7,49
Annan Athlet,6479,7,11,12,13,49,43,6,45
Berwick,6479,8,8,10,18,29,62,-33,34
Edinburgh Ci,6479,9,7,9,20,37,64,-27,30
Cowdenbeath,6479,10,4,11,21,25,56,-31,23
Montrose,6480,1,24,7,5,60,34,26,79
Peterhead,6480,2,24,4,8,83,38,45,76
Stirling,6480,3,17,6,13,66,53,13,57
Stenhousem'r,6480,4,15,8,13,57,52,5,53
Clyde,6480,5,14,9,13,53,51,2,51
Elgin,6480,6,14,6,16,53,61,-8,48
Annan Athlet,6480,7,12,11,13,48,41,7,47
Berwick,6480,8,9,10,17,32,60,-28,37
Edinburgh Ci,6480,9,7,9,20,36,66,-30,30
Cowdenbeath,6480,10,4,10,22,23,55,-32,22
Peterhead,6481,1,24,4,8,79,39,40,76
Montrose,6481,2,23,7,6,59,35,24,76
Stirling,6481,3,17,6,13,61,51,10,57
Stenhousem'r,6481,4,15,8,13,55,47,8,53
Clyde,6481,5,14,9,13,51,49,2,51
Elgin,6481,6,15,6,15,54,60,-6,51
Annan Athlet,6481,7,11,12,13,47,41,6,45
Berwick,6481,8,9,10,17,30,58,-28,37
Edinburgh Ci,6481,9,7,9,20,37,62,-25,30
Cowdenbeath,6481,10,4,11,21,23,54,-31,23
Montrose,6482,1,24,7,5,60,34,26,79
Peterhead,6482,2,24,4,8,80,40,40,76
Stirling,6482,3,17,6,13,62,52,10,57
Stenhousem'r,6482,4,15,8,13,56,48,8,53
Clyde,6482,5,14,10,12,51,48,3,52
Elgin,6482,6,14,6,16,53,61,-8,48
Annan Athlet,6482,7,12,11,13,48,41,7,47
Berwick,6482,8,8,11,17,29,58,-29,35
Edinburgh Ci,6482,9,7,9,20,38,63,-25,30
Cowdenbeath,6482,10,4,10,22,23,55,-32,22
Peterhead,6483,1,24,4,8,81,39,42,76
Montrose,6483,2,23,7,6,60,36,24,76
Stirling,6483,3,17,6,13,64,51,13,57
Stenhousem'r,6483,4,15,8,13,55,50,5,53
Clyde,6483,5,14,10,12,52,49,3,52
Elgin,6483,6,15,6,15,55,61,-6,51
Annan Athlet,6483,7,12,11,13,49,42,7,47
Berwick,6483,8,8,11,17,30,59,-29,35
Edinburgh Ci,6483,9,7,9,20,37,64,-27,30
Cowdenbeath,6483,10,4,10,22,24,56,-32,22
Montrose,6484,1,23,8,5,59,34,25,77
Peterhead,6484,2,24,4,8,78,38,40,76
Stirling,6484,3,16,7,13,61,52,9,55
Stenhousem'r,6484,4,15,9,12,56,47,9,54
Clyde,6484,5,15,9,12,52,48,4,54
Elgin,6484,6,14,7,15,53,60,-7,49
Annan Athlet,6484,7,11,12,13,47,41,6,45
Berwick,6484,8,8,10,18,29,59,-30,34
Edinburgh Ci,6484,9,7,9,20,36,61,-25,30
Cowdenbeath,6484,10,4,11,21,23,54,-31,23
Montrose,6485,1,23,7,6,59,35,24,76
Peterhead,6485,2,23,5,8,78,39,39,74
Stirling,6485,3,17,6,13,64,54,10,57
Stenhousem'r,6485,4,15,8,13,58,50,8,53
Clyde,6485,5,14,10,12,52,49,3,52
Elgin,6485,6,15,6,15,54,60,-6,51
Annan Athlet,6485,7,12,11,13,49,42,7,47
Berwick,6485,8,8,11,17,30,59,-29,35
Edinburgh Ci,6485,9,7,10,19,37,61,-24,31
Cowdenbeath,6485,10,4,10,22,24,56,-32,22
Peterhead,6486,1,24,4,8,81,38,43,76
Montrose,6486,2,23,7,6,59,35,24,76
Stenhousem'r,6486,3,16,8,12,58,46,12,56
Stirling,6486,4,16,6,14,60,54,6,54
Clyde,6486,5,15,9,12,54,48,6,54
Elgin,6486,6,15,6,15,54,60,-6,51
Annan Athlet,6486,7,11,12,13,48,42,6,45
Berwick,6486,8,8,10,18,29,61,-32,34
Edinburgh Ci,6486,9,7,9,20,36,64,-28,30
Cowdenbeath,6486,10,4,11,21,24,55,-31,23
Montrose,6487,1,24,7,5,62,34,28,79
Peterhead,6487,2,24,4,8,79,38,41,76
Stenhousem'r,6487,3,16,8,12,57,47,10,56
Stirling,6487,4,16,6,14,61,53,8,54
Clyde,6487,5,14,9,13,52,50,2,51
Elgin,6487,6,14,6,16,53,63,-10,48
Annan Athlet,6487,7,12,11,13,48,41,7,47
Berwick,6487,8,9,10,17,31,59,-28,37
Edinburgh Ci,6487,9,7,9,20,36,62,-26,30
Cowdenbeath,6487,10,4,10,22,23,55,-32,22
Montrose,6488,1,24,7,5,62,35,27,79
Peterhead,6488,2,23,5,8,80,41,39,74
Stirling,6488,3,17,6,13,62,51,11,57
Clyde,6488,4,15,9,12,53,48,5,54
Stenhousem'r,6488,5,15,8,13,55,48,7,53
Elgin,6488,6,14,6,16,54,63,-9,48
Annan Athlet,6488,7,11,12,13,49,43,6,45
Berwick,6488,8,8,10,18,29,60,-31,34
Edinburgh Ci,6488,9,7,10,19,39,63,-24,31
Cowdenbeath,6488,10,4,11,21,25,56,-31,23
Montrose,6489,1,23,8,5,61,36,25,77
Peterhead,6489,2,24,4,8,81,39,42,76
Stirling,6489,3,17,6,13,63,52,11,57
Clyde,6489,4,15,9,12,53,48,5,54
Stenhousem'r,6489,5,15,8,13,56,49,7,53
Elgin,6489,6,14,7,15,55,62,-7,49
Annan Athlet,6489,7,12,11,13,48,41,7,47
Berwick,6489,8,8,10,18,29,60,-31,34
Edinburgh Ci,6489,9,7,9,20,37,64,-27,30
Cowdenbeath,6489,10,4,10,22,23,55,-32,22
Montrose,6490,1,24,7,5,60,34,26,79
Peterhead,6490,2,24,4,8,80,39,41,76
Stenhousem'r,6490,3,16,8,12,57,46,11,56
Stirling,6490,4,16,6,14,60,53,7,54
Clyde,6490,5,14,10,12,52,49,3,52
Elgin,6490,6,14,6,16,53,61,-8,48
Annan Athlet,6490,7,11,11,14,47,42,5,44
Berwick,6490,8,8,11,17,30,59,-29,35
Edinburgh Ci,6490,9,7,9,20,37,63,-26,30
Cowdenbeath,6490,10,5,10,21,24,54,-30,25
Montrose,6491,1,23,8,5,61,36,25,77
Peterhead,6491,2,24,4,8,81,41,40,76
Stenhousem'r,6491,3,16,8,12,58,47,11,56
Stirling,6491,4,16,6,14,61,54,7,54
Clyde,6491,5,15,9,12,53,49,4,54
Elgin,6491,6,14,7,15,55,62,-7,49
Annan Athlet,6491,7,11,12,13,47,41,6,45
Berwick,6491,8,8,10,18,30,60,-30,34
Edinburgh Ci,6491,9,7,9,20,39,64,-25,30
Cowdenbeath,6491,10,4,11,21,23,54,-31,23
Montrose,6492,1,24,7,5,63,35,28,79
Peterhead,6492,2,24,4,8,79,39,40,76
Stirling,6492,3,17,6,13,63,53,10,57
Clyde,6492,4,15,9,12,53,48,5,54
Stenhousem'r,6492,5,15,8,13,57,49,8,53
Elgin,6492,6,14,6,16,54,64,-10,48
Annan Athlet,6492,7,12,11,13,48,41,7,47
Berwick,6492,8,8,10,18,29,60,-31,34
Edinburgh Ci,6492,9,7,9,20,37,62,-25,30
Cowdenbeath,6492,10,4,10,22,23,55,-32,22
Montrose,6493,1,24,7,5,65,35,30,79
Peterhead,6493,2,23,5,8,77,38,39,74
Stirling,6493,3,17,6,13,64,53,11,57
Stenhousem'r,6493,4,15,8,13,57,50,7,53
Clyde,6493,5,14,10,12,51,48,3,52
Elgin,6493,6,14,6,16,54,66,-12,48
Annan Athlet,6493,7,12,11,13,48,41,7,47
Berwick,6493,8,8,11,17,29,58,-29,35
Edinburgh Ci,6493,9,7,10,19,36,60,-24,31
Cowdenbeath,6493,10,4,10,22,23,55,-32,22
Montrose,6494,1,24,7,5,61,35,26,79
Peterhead,6494,2,24,4,8,81,38,43,76
Stirling,6494,3,16,7,13,61,52,9,55
Stenhousem'r,6494,4,15,9,12,56,47,9,54
Clyde,6494,5,14,9,13,52,50,2,51
Elgin,6494,6,14,6,16,54,62,-8,48
Annan Athlet,6494,7,11,12,13,50,44,6,45
Berwick,6494,8,9,10,17,31,59,-28,37
Edinburgh Ci,6494,9,7,9,20,36,64,-28,30
Cowdenbeath,6494,10,4,11,21,26,57,-31,23
Montrose,6495,1,24,7,5,62,35,27,79
Peterhead,6495,2,24,4,8,80,39,41,76
Stenhousem'r,6495,3,16,8,12,56,46,10,56
Stirling,6495,4,16,6,14,60,52,8,54
Clyde,6495,5,15,9,12,53,48,5,54
Elgin,6495,6,14,6,16,54,63,-9,48
Annan Athlet,6495,7,11,12,13,48,42,6,45
Berwick,6495,8,8,10,18,29,60,-31,34
Edinburgh Ci,6495,9,7,9,20,37,63,-26,30
Cowdenbeath,6495,10,4,11,21,24,55,-31,23
Peterhead,6496,1,24,4,8,81,40,41,76
Montrose,6496,2,23,7,6,59,36,23,76
Stenhousem'r,6496,3,16,8,12,59,46,13,56
Clyde,6496,4,15,9,12,55,48,7,54
Stirling,6496,5,16,6,14,60,55,5,54
Elgin,6496,6,15,6,15,55,60,-5,51
Annan Athlet,6496,7,12,11,13,50,42,8,47
Berwick,6496,8,8,10,18,29,62,-33,34
Edinburgh Ci,6496,9,7,9,20,38,64,-26,30
Cowdenbeath,6496,10,4,10,22,24,57,-33,22
Montrose,6497,1,24,7,5,63,37,26,79
Peterhead,6497,2,24,4,8,82,38,44,76
Stirling,6497,3,17,6,13,65,51,14,57
Stenhousem'r,6497,4,15,8,13,55,51,4,53
Clyde,6497,5,14,10,12,51,48,3,52
Elgin,6497,6,14,6,16,56,64,-8,48
Annan Athlet,6497,7,12,11,13,49,41,8,47
Berwick,6497,8,8,11,17,29,58,-29,35
Edinburgh Ci,6497,9,7,9,20,36,65,-29,30
Cowdenbeath,6497,10,4,10,22,23,56,-33,22
Montrose,6498,1,23,7,6,61,38,23,76
Peterhead,6498,2,23,5,8,78,39,39,74
Stirling,6498,3,16,7,13,60,51,9,55
Stenhousem'r,6498,4,15,9,12,55,46,9,54
Clyde,6498,5,15,9,12,54,48,6,54
Elgin,6498,6,15,6,15,57,62,-5,51
Annan Athlet,6498,7,11,12,13,49,43,6,45
Berwick,6498,8,8,10,18,29,61,-32,34
Edinburgh Ci,6498,9,7,10,19,37,61,-24,31
Cowdenbeath,6498,10,4,11,21,25,56,-31,23
Peterhead,6499,1,24,4,8,84,38,46,76
Montrose,6499,2,23,7,6,59,35,24,76
Stirling,6499,3,16,7,13,61,52,9,55
Stenhousem'r,6499,4,15,9,12,56,47,9,54
Clyde,6499,5,15,9,12,56,51,5,54
Elgin,6499,6,15,6,15,54,60,-6,51
Annan Athlet,6499,7,11,11,14,47,42,5,44
Berwick,6499,8,8,10,18,32,63,-31,34
Edinburgh Ci,6499,9,7,9,20,36,67,-31,30
Cowdenbeath,6499,10,5,10,21,24,54,-30,25
Montrose,6500,1,24,7,5,64,36,28,79
Peterhead,6500,2,24,4,8,82,38,44,76
Stirling,6500,3,17,6,13,61,51,10,57
Clyde,6500,4,15,9,12,54,48,6,54
Stenhousem'r,6500,5,15,8,13,55,47,8,53
Elgin,6500,6,14,6,16,55,65,-10,48
Annan Athlet,6500,7,12,11,13,49,41,8,47
Berwick,6500,8,8,10,18,29,61,-32,34
Edinburgh Ci,6500,9,7,9,20,36,65,-29,30
Cowdenbeath,6500,10,4,10,22,23,56,-33,22
Peterhead,6501,1,24,4,8,82,38,44,76
Montrose,6501,2,23,7,6,61,39,22,76
Stirling,6501,3,16,7,13,61,52,9,55
Stenhousem'r,6501,4,15,9,12,56,47,9,54
Clyde,6501,5,14,9,13,52,50,2,51
Elgin,6501,6,15,6,15,58,62,-4,51
Annan Athlet,6501,7,11,12,13,48,42,6,45
Berwick,6501,8,9,10,17,31,59,-28,37
Edinburgh Ci,6501,9,7,9,20,36,65,-29,30
Cowdenbeath,6501,10,4,11,21,24,55,-31,23
Montrose,6502,1,24,7,5,61,35,26,79
Peterhead,6502,2,23,4,9,78,40,38,73
Stirling,6502,3,16,7,13,63,54,9,55
Stenhousem'r,6502,4,15,9,12,58,49,9,54
Clyde,6502,5,14,10,12,53,50,3,52
Elgin,6502,6,14,6,16,54,62,-8,48
Annan Athlet,6502,7,12,11,13,49,41,8,47
Berwick,6502,8,8,11,17,31,60,-29,35
Edinburgh Ci,6502,9,8,9,19,38,61,-23,33
Cowdenbeath,6502,10,4,10,22,23,56,-33,22
Montrose,6503,1,23,8,5,59,34,25,77
Peterhead,6503,2,24,4,8,78,38,40,76
Stenhousem'r,6503,3,16,8,12,59,48,11,56
Stirling,6503,4,16,6,14,62,55,7,54
Clyde,6503,5,15,9,12,53,48,5,54
Elgin,6503,6,14,7,15,53,60,-7,49
Annan Athlet,6503,7,12,11,13,50,42,8,47
Berwick,6503,8,8,10,18,29,60,-31,34
Edinburgh Ci,6503,9,7,9,20,36,61,-25,30
Cowdenbeath,6503,10,4,10,22,24,57,-33,22
Montrose,6504,1,24,7,5,61,34,27,79
Peterhead,6504,2,23,4,9,79,41,38,73
Stirling,6504,3,17,6,13,62,51,11,57
Clyde,6504,4,15,9,12,60,49,11,54
Stenhousem'r,6504,5,15,8,13,55,48,7,53
Elgin,6504,6,14,6,16,53,62,-9,48
Annan Athlet,6504,7,11,12,13,47,41,6,45
Berwick,6504,8,8,10,18,30,67,-37,34
Edinburgh Ci,6504,9,8,9,19,39,62,-23,33
Cowdenbeath,6504,10,4,11,21,23,54,-31,23
Montrose,6505,1,24,7,5,61,35,26,79
Peterhead,6505,2,24,4,8,82,39,43,76
Stirling,6505,3,16,7,13,61,52,9,55
Stenhousem'r,6505,4,15,9,12,56,47,9,54
Clyde,6505,5,15,9,12,54,50,4,54
Elgin,6505,6,14,6,16,54,62,-8,48
Annan Athlet,6505,7,11,11,14,47,43,4,44
Berwick,6505,8,8,10,18,31,61,-30,34
Edinburgh Ci,6505,9,7,9,20,37,65,-28,30
Cowdenbeath,6505,10,5,10,21,25,54,-29,25
Peterhead,6506,1,24,4,8,84,39,45,76
Montrose,6506,2,23,7,6,61,37,24,76
Stirling,6506,3,17,6,13,62,52,10,57
Clyde,6506,4,15,9,12,53,49,4,54
Stenhousem'r,6506,5,15,8,13,56,48,8,53
Elgin,6506,6,15,6,15,56,62,-6,51
Annan Athlet,6506,7,12,11,13,49,41,8,47
Berwick,6506,8,8,10,18,30,60,-30,34
Edinburgh Ci,6506,9,7,9,20,37,67,-30,30
Cowdenbeath,6506,10,4,10,22,23,56,-33,22
Peterhead,6507,1,24,4,8,78,38,40,76
Montrose,6507,2,23,7,6,61,37,24,76
Stirling,6507,3,17,6,13,63,53,10,57
Clyde,6507,4,15,9,12,52,48,4,54
Stenhousem'r,6507,5,15,8,13,57,49,8,53
Elgin,6507,6,15,6,15,56,62,-6,51
Annan Athlet,6507,7,12,11,13,49,41,8,47
Berwick,6507,8,8,10,18,29,59,-30,34
Edinburgh Ci,6507,9,7,9,20,36,61,-25,30
Cowdenbeath,6507,10,4,10,22,23,56,-33,22
Montrose,6508,1,24,7,5,62,36,26,79
Peterhead,6508,2,24,4,8,80,38,42,76
Stirling,6508,3,17,6,13,63,52,11,57
Clyde,6508,4,15,9,12,52,48,4,54
Stenhousem'r,6508,5,15,8,13,56,49,7,53
Elgin,6508,6,14,6,16,55,63,-8,48
Annan Athlet,6508,7,11,11,14,47,42,5,44
Berwick,6508,8,8,10,18,29,59,-30,34
Edinburgh Ci,6508,9,7,9,20,36,63,-27,30
Cowdenbeath,6508,10,5,10,21,24,54,-30,25
Montrose,6509,1,24,7,5,62,36,26,79
Peterhead,6509,2,24,4,8,81,38,43,76
Stirling,6509,3,16,7,13,60,51,9,55
Stenhousem'r,6509,4,15,9,12,55,46,9,54
Clyde,6509,5,15,9,12,53,48,5,54
Elgin,6509,6,14,6,16,55,63,-8,48
Annan Athlet,6509,7,12,11,13,52,41,11,47
Berwick,6509,8,8,10,18,29,60,-31,34
Edinburgh Ci,6509,9,7,9,20,36,64,-28,30
Cowdenbeath,6509,10,4,10,22,23,59,-36,22
Montrose,6510,1,23,8,5,60,35,25,77
Peterhead,6510,2,23,4,9,77,39,38,73
Stirling,6510,3,16,7,13,60,51,9,55
Stenhousem'r,6510,4,15,9,12,55,46,9,54
Clyde,6510,5,15,9,12,53,48,5,54
Elgin,6510,6,14,7,15,54,61,-7,49
Annan Athlet,6510,7,11,11,14,47,44,3,44
Berwick,6510,8,8,10,18,29,60,-31,34
Edinburgh Ci,6510,9,8,9,19,37,60,-23,33
Cowdenbeath,6510,10,5,10,21,26,54,-28,25
Montrose,6511,1,24,7,5,61,35,26,79
Peterhead,6511,2,24,4,8,78,38,40,76
Stirling,6511,3,16,7,13,61,52,9,55
Stenhousem'r,6511,4,15,9,12,56,47,9,54
Clyde,6511,5,14,9,13,51,49,2,51
Elgin,6511,6,14,6,16,54,62,-8,48
Annan Athlet,6511,7,11,11,14,47,42,5,44
Berwick,6511,8,9,10,17,30,58,-28,37
Edinburgh Ci,6511,9,7,9,20,36,61,-25,30
Cowdenbeath,6511,10,5,10,21,24,54,-30,25
Montrose,6512,1,24,7,5,61,35,26,79
Peterhead,6512,2,24,4,8,80,38,42,76
Stenhousem'r,6512,3,16,8,12,56,46,10,56
Stirling,6512,4,16,6,14,60,52,8,54
Clyde,6512,5,14,9,13,52,50,2,51
Elgin,6512,6,14,6,16,54,62,-8,48
Annan Athlet,6512,7,11,11,14,47,43,4,44
Berwick,6512,8,9,10,17,31,59,-28,37
Edinburgh Ci,6512,9,7,9,20,36,63,-27,30
Cowdenbeath,6512,10,5,10,21,25,54,-29,25
Montrose,6513,1,24,7,5,62,35,27,79
Peterhead,6513,2,24,4,8,78,38,40,76
Stirling,6513,3,17,6,13,61,51,10,57
Clyde,6513,4,15,9,12,54,49,5,54
Stenhousem'r,6513,5,15,8,13,55,47,8,53
Elgin,6513,6,14,6,16,54,63,-9,48
Annan Athlet,6513,7,12,11,13,49,41,8,47
Berwick,6513,8,8,10,18,30,61,-31,34
Edinburgh Ci,6513,9,7,9,20,36,61,-25,30
Cowdenbeath,6513,10,4,10,22,23,56,-33,22
Montrose,6514,1,24,7,5,60,34,26,79
Peterhead,6514,2,24,4,8,81,40,41,76
Stirling,6514,3,17,6,13,62,52,10,57
Clyde,6514,4,15,9,12,54,49,5,54
Stenhousem'r,6514,5,15,8,13,56,48,8,53
Elgin,6514,6,14,6,16,53,61,-8,48
Annan Athlet,6514,7,11,11,14,47,42,5,44
Berwick,6514,8,8,10,18,30,61,-31,34
Edinburgh Ci,6514,9,7,9,20,38,64,-26,30
Cowdenbeath,6514,10,5,10,21,24,54,-30,25
Montrose,6515,1,23,8,5,60,35,25,77
Peterhead,6515,2,24,4,8,79,38,41,76
Stenhousem'r,6515,3,16,8,12,57,47,10,56
Stirling,6515,4,16,6,14,61,53,8,54
Clyde,6515,5,14,9,13,51,49,2,51
Elgin,6515,6,14,7,15,54,61,-7,49
Annan Athlet,6515,7,11,12,13,48,42,6,45
Berwick,6515,8,9,10,17,30,58,-28,37
Edinburgh Ci,6515,9,7,9,20,36,62,-26,30
Cowdenbeath,6515,10,4,11,21,24,55,-31,23
Montrose,6516,1,23,8,5,61,36,25,77
Peterhead,6516,2,24,4,8,79,38,41,76
Stirling,6516,3,17,6,13,63,52,11,57
Clyde,6516,4,15,9,12,53,48,5,54
Stenhousem'r,6516,5,15,8,13,56,49,7,53
Elgin,6516,6,14,7,15,55,62,-7,49
Annan Athlet,6516,7,11,12,13,49,43,6,45
Berwick,6516,8,8,10,18,29,60,-31,34
Edinburgh Ci,6516,9,7,9,20,36,62,-26,30
Cowdenbeath,6516,10,4,11,21,25,56,-31,23
Montrose,6517,1,24,7,5,62,34,28,79
Peterhead,6517,2,23,4,9,77,40,37,73
Stirling,6517,3,16,7,13,62,53,9,55
Stenhousem'r,6517,4,15,9,12,57,48,9,54
Clyde,6517,5,14,10,12,52,49,3,52
Elgin,6517,6,14,6,16,53,63,-10,48
Annan Athlet,6517,7,11,12,13,48,42,6,45
Berwick,6517,8,8,11,17,30,59,-29,35
Edinburgh Ci,6517,9,8,9,19,38,60,-22,33
Cowdenbeath,6517,10,4,11,21,24,55,-31,23
Peterhead,6518,1,24,4,8,79,38,41,76
Montrose,6518,2,23,7,6,60,36,24,76
Stirling,6518,3,17,6,13,62,52,10,57
Clyde,6518,4,15,9,12,53,48,5,54
Stenhousem'r,6518,5,15,8,13,56,48,8,53
Elgin,6518,6,15,6,15,55,61,-6,51
Annan Athlet,6518,7,11,11,14,48,43,5,44
Berwick,6518,8,8,10,18,29,60,-31,34
Edinburgh Ci,6518,9,7,9,20,36,62,-26,30
Cowdenbeath,6518,10,5,10,21,25,55,-30,25
Peterhead,6519,1,24,4,8,79,39,40,76
Montrose,6519,2,23,7,6,60,37,23,76
Stenhousem'r,6519,3,16,8,12,57,47,10,56
Stirling,6519,4,16,6,14,61,53,8,54
Clyde,6519,5,15,9,12,54,48,6,54
Elgin,6519,6,15,6,15,56,61,-5,51
Annan Athlet,6519,7,11,11,14,48,43,5,44
Berwick,6519,8,8,10,18,29,61,-32,34
Edinburgh Ci,6519,9,7,9,20,37,62,-25,30
Cowdenbeath,6519,10,5,10,21,25,55,-30,25
Montrose,6520,1,24,7,5,61,35,26,79
Peterhead,6520,2,24,4,8,82,38,44,76
Stirling,6520,3,16,7,13,61,52,9,55
Stenhousem'r,6520,4,15,9,12,56,47,9,54
Clyde,6520,5,15,9,12,53,48,5,54
Elgin,6520,6,14,6,16,54,62,-8,48
Annan Athlet,6520,7,11,11,14,47,42,5,44
Berwick,6520,8,8,10,18,29,60,-31,34
Edinburgh Ci,6520,9,7,9,20,36,65,-29,30
Cowdenbeath,6520,10,5,10,21,24,54,-30,25
Montrose,6521,1,23,8,5,59,34,25,77
Peterhead,6521,2,24,4,8,81,38,43,76
Stirling,6521,3,17,6,13,61,51,10,57
Clyde,6521,4,15,9,12,55,49,6,54
Stenhousem'r,6521,5,15,8,13,55,47,8,53
Elgin,6521,6,14,7,15,53,60,-7,49
Annan Athlet,6521,7,11,12,13,48,42,6,45
Berwick,6521,8,8,10,18,30,62,-32,34
Edinburgh Ci,6521,9,7,9,20,36,64,-28,30
Cowdenbeath,6521,10,4,11,21,24,55,-31,23
Montrose,6522,1,23,8,5,60,35,25,77
Peterhead,6522,2,24,4,8,78,38,40,76
Stenhousem'r,6522,3,16,8,12,57,47,10,56
Stirling,6522,4,16,6,14,61,53,8,54
Clyde,6522,5,15,9,12,54,49,5,54
Elgin,6522,6,14,7,15,54,61,-7,49
Annan Athlet,6522,7,11,11,14,47,42,5,44
Berwick,6522,8,8,10,18,30,61,-31,34
Edinburgh Ci,6522,9,7,9,20,36,61,-25,30
Cowdenbeath,6522,10,5,10,21,24,54,-30,25
Montrose,6523,1,24,7,5,63,34,29,79
Peterhead,6523,2,24,4,8,82,39,43,76
Stenhousem'r,6523,3,16,8,12,57,47,10,56
Stirling,6523,4,16,6,14,61,53,8,54
Clyde,6523,5,14,10,12,51,48,3,52
Elgin,6523,6,14,6,16,53,64,-11,48
Annan Athlet,6523,7,11,11,14,48,45,3,44
Berwick,6523,8,8,11,17,29,58,-29,35
Edinburgh Ci,6523,9,7,9,20,37,65,-28,30
Cowdenbeath,6523,10,5,10,21,27,55,-28,25
Montrose,6524,1,24,7,5,64,36,28,79
Peterhead,6524,2,24,4,8,79,39,40,76
Stirling,6524,3,17,6,13,63,52,11,57
Stenhousem'r,6524,4,15,8,13,56,49,7,53
Clyde,6524,5,14,10,12,52,49,3,52
Elgin,6524,6,14,6,16,55,65,-10,48
Annan Athlet,6524,7,11,12,13,48,42,6,45
Berwick,6524,8,8,11,17,30,59,-29,35
Edinburgh Ci,6524,9,7,9,20,37,62,-25,30
Cowdenbeath,6524,10,4,11,21,24,55,-31,23
Montrose,6525,1,24,7,5,60,34,26,79
Peterhead,6525,2,24,4,8,82,38,44,76
Stirling,6525,3,17,6,13,63,52,11,57
Stenhousem'r,6525,4,15,8,13,56,49,7,53
Clyde,6525,5,14,10,12,52,49,3,52
Elgin,6525,6,14,6,16,53,61,-8,48
Annan Athlet,6525,7,11,11,14,47,42,5,44
Berwick,6525,8,8,11,17,30,59,-29,35
Edinburgh Ci,6525,9,7,9,20,36,65,-29,30
Cowdenbeath,6525,10,5,10,21,24,54,-30,25
Peterhead,6526,1,24,4,8,80,39,41,76
Montrose,6526,2,23,7,6,59,35,24,76
Stirling,6526,3,16,7,13,62,53,9,55
Stenhousem'r,6526,4,15,9,12,57,48,9,54
Clyde,6526,5,15,9,12,53,48,5,54
Elgin,6526,6,15,6,15,54,60,-6,51
Annan Athlet,6526,7,11,12,13,48,42,6,45
Berwick,6526,8,8,10,18,29,60,-31,34
Edinburgh Ci,6526,9,7,9,20,37,63,-26,30
Cowdenbeath,6526,10,4,11,21,24,55,-31,23
Montrose,6527,1,23,8,5,61,36,25,77
Peterhead,6527,2,24,4,8,79,39,40,76
Stenhousem'r,6527,3,16,8,12,59,49,10,56
Stirling,6527,4,16,6,14,63,55,8,54
Clyde,6527,5,15,9,12,54,49,5,54
Elgin,6527,6,14,7,15,55,62,-7,49
Annan Athlet,6527,7,12,11,13,50,41,9,47
Berwick,6527,8,8,10,18,30,61,-31,34
Edinburgh Ci,6527,9,7,9,20,37,62,-25,30
Cowdenbeath,6527,10,4,10,22,23,57,-34,22
Montrose,6528,1,24,7,5,61,34,27,79
Peterhead,6528,2,24,4,8,80,38,42,76
Stirling,6528,3,16,7,13,60,51,9,55
Stenhousem'r,6528,4,15,9,12,55,46,9,54
Clyde,6528,5,14,10,12,52,49,3,52
Elgin,6528,6,14,6,16,53,62,-9,48
Annan Athlet,6528,7,12,11,13,50,42,8,47
Berwick,6528,8,8,11,17,30,59,-29,35
Edinburgh Ci,6528,9,7,9,20,36,63,-27,30
Cowdenbeath,6528,10,4,10,22,24,57,-33,22
Peterhead,6529,1,24,4,8,79,38,41,76
Montrose,6529,2,23,7,6,59,36,23,76
Stenhousem'r,6529,3,16,8,12,56,46,10,56
Stirling,6529,4,16,6,14,60,52,8,54
Clyde,6529,5,14,10,12,51,48,3,52
Elgin,6529,6,15,6,15,55,60,-5,51
Annan Athlet,6529,7,11,12,13,48,42,6,45
Berwick,6529,8,8,11,17,29,58,-29,35
Edinburgh Ci,6529,9,7,9,20,36,62,-26,30
Cowdenbeath,6529,10,4,11,21,24,55,-31,23
Peterhead,6530,1,24,4,8,79,39,40,76
Montrose,6530,2,23,7,6,60,36,24,76
Stirling,6530,3,17,6,13,61,51,10,57
Clyde,6530,4,15,9,12,55,48,7,54
Stenhousem'r,6530,5,15,8,13,55,47,8,53
Elgin,6530,6,15,6,15,55,61,-6,51
Annan Athlet,6530,7,12,11,13,49,42,7,47
Berwick,6530,8,8,10,18,29,62,-33,34
Edinburgh Ci,6530,9,7,9,20,37,62,-25,30
Cowdenbeath,6530,10,4,10,22,24,56,-32,22
Montrose,6531,1,24,7,5,61,35,26,79
Peterhead,6531,2,24,4,8,83,38,45,76
Stenhousem'r,6531,3,16,8,12,57,47,10,56
Stirling,6531,4,16,6,14,61,53,8,54
Clyde,6531,5,15,9,12,53,48,5,54
Elgin,6531,6,14,6,16,54,62,-8,48
Annan Athlet,6531,7,12,11,13,49,41,8,47
Berwick,6531,8,8,10,18,29,60,-31,34
Edinburgh Ci,6531,9,7,9,20,36,66,-30,30
Cowdenbeath,6531,10,4,10,22,23,56,-33,22
Montrose,6532,1,24,7,5,63,35,28,79
Peterhead,6532,2,24,4,8,83,39,44,76
Stenhousem'r,6532,3,16,8,12,57,47,10,56
Stirling,6532,4,16,6,14,61,53,8,54
Clyde,6532,5,14,9,13,51,49,2,51
Elgin,6532,6,14,6,16,54,64,-10,48
Annan Athlet,6532,7,12,11,13,49,41,8,47
Berwick,6532,8,9,10,17,30,58,-28,37
Edinburgh Ci,6532,9,7,9,20,37,66,-29,30
Cowdenbeath,6532,10,4,10,22,23,56,-33,22
Montrose,6533,1,24,7,5,61,35,26,79
Peterhead,6533,2,24,4,8,79,38,41,76
Stenhousem'r,6533,3,16,8,12,57,47,10,56
Stirling,6533,4,16,6,14,61,53,8,54
Clyde,6533,5,15,9,12,54,49,5,54
Elgin,6533,6,14,6,16,54,62,-8,48
Annan Athlet,6533,7,12,11,13,48,41,7,47
Berwick,6533,8,8,10,18,30,61,-31,34
Edinburgh Ci,6533,9,7,9,20,36,62,-26,30
Cowdenbeath,6533,10,4,10,22,23,55,-32,22
Montrose,6534,1,24,7,5,63,35,28,79
Peterhead,6534,2,24,4,8,80,40,40,76
Stenhousem'r,6534,3,16,8,12,59,46,13,56
Stirling,6534,4,16,6,14,60,55,5,54
Clyde,6534,5,15,9,12,52,48,4,54
Elgin,6534,6,14,6,16,54,64,-10,48
Annan Athlet,6534,7,12,11,13,49,41,8,47
Berwick,6534,8,8,10,18,29,59,-30,34
Edinburgh Ci,6534,9,7,9,20,38,63,-25,30
Cowdenbeath,6534,10,4,10,22,23,56,-33,22
Montrose,6535,1,24,7,5,60,34,26,79
Peterhead,6535,2,24,4,8,81,39,42,76
Stenhousem'r,6535,3,16,8,12,56,46,10,56
Stirling,6535,4,16,6,14,60,52,8,54
Clyde,6535,5,15,9,12,53,49,4,54
Elgin,6535,6,14,6,16,53,61,-8,48
Annan Athlet,6535,7,11,11,14,47,42,5,44
Berwick,6535,8,8,10,18,30,60,-30,34
Edinburgh Ci,6535,9,7,9,20,37,64,-27,30
Cowdenbeath,6535,10,5,10,21,24,54,-30,25
Montrose,6536,1,24,7,5,62,35,27,79
Peterhead,6536,2,24,4,8,80,38,42,76
Stirling,6536,3,16,7,13,62,53,9,55
Stenhousem'r,6536,4,15,9,12,57,48,9,54
Clyde,6536,5,14,10,12,51,48,3,52
Elgin,6536,6,14,6,16,54,63,-9,48
Annan Athlet,6536,7,12,11,13,48,41,7,47
Berwick,6536,8,8,11,17,29,58,-29,35
Edinburgh Ci,6536,9,7,9,20,36,63,-27,30
Cowdenbeath,6536,10,4,10,22,23,55,-32,22
Montrose,6537,1,24,7,5,62,36,26,79
Peterhead,6537,2,23,5,8,79,40,39,74
Stirling,6537,3,17,6,13,63,53,10,57
Stenhousem'r,6537,4,15,8,13,57,49,8,53
Clyde,6537,5,14,9,13,51,49,2,51
Elgin,6537,6,14,6,16,55,63,-8,48
Annan Athlet,6537,7,11,12,13,47,41,6,45
Berwick,6537,8,9,10,17,30,58,-28,37
Edinburgh Ci,6537,9,7,10,19,38,62,-24,31
Cowdenbeath,6537,10,4,11,21,23,54,-31,23
Montrose,6538,1,24,7,5,64,35,29,79
Peterhead,6538,2,23,4,9,78,40,38,73
Stirling,6538,3,17,6,13,61,51,10,57
Clyde,6538,4,15,9,12,52,48,4,54
Stenhousem'r,6538,5,15,8,13,55,47,8,53
Elgin,6538,6,14,6,16,54,65,-11,48
Annan Athlet,6538,7,11,12,13,47,41,6,45
Berwick,6538,8,8,10,18,29,59,-30,34
Edinburgh Ci,6538,9,8,9,19,38,61,-23,33
Cowdenbeath,6538,10,4,11,21,23,54,-31,23
Montrose,6539,1,24,7,5,61,34,27,79
Peterhead,6539,2,24,4,8,81,38,43,76
Stirling,6539,3,17,6,13,61,51,10,57
Clyde,6539,4,15,9,12,56,49,7,54
Stenhousem'r,6539,5,15,8,13,55,47,8,53
Elgin,6539,6,14,6,16,53,62,-9,48
Annan Athlet,6539,7,11,12,13,49,43,6,45
Berwick,6539,8,8,10,18,30,63,-33,34
Edinburgh Ci,6539,9,7,9,20,36,64,-28,30
Cowdenbeath,6539,10,4,11,21,25,56,-31,23
Montrose,6540,1,23,7,6,63,39,24,76
Peterhead,6540,2,23,4,9,77,39,38,73
Stirling,6540,3,16,7,13,60,51,9,55
Stenhousem'r,6540,4,15,9,12,55,46,9,54
Clyde,6540,5,14,9,13,51,49,2,51
Elgin,6540,6,15,6,15,58,64,-6,51
Annan Athlet,6540,7,11,11,14,47,42,5,44
Berwick,6540,8,9,10,17,30,58,-28,37
Edinburgh Ci,6540,9,8,9,19,37,60,-23,33
Cowdenbeath,6540,10,5,10,21,24,54,-30,25
Montrose,6541,1,23,8,5,61,36,25,77
Peterhead,6541,2,24,4,8,79,39,40,76
Stirling,6541,3,17,6,13,62,51,11,57
Clyde,6541,4,15,9,12,52,48,4,54
Stenhousem'r,6541,5,15,8,13,55,48,7,53
Elgin,6541,6,14,7,15,55,62,-7,49
Annan Athlet,6541,7,11,11,14,48,45,3,44
Berwick,6541,8,8,10,18,29,59,-30,34
Edinburgh Ci,6541,9,7,9,20,37,62,-25,30
Cowdenbeath,6541,10,5,10,21,27,55,-28,25
Montrose,6542,1,24,7,5,61,35,26,79
Peterhead,6542,2,24,4,8,79,38,41,76
Stirling,6542,3,16,7,13,61,52,9,55
Stenhousem'r,6542,4,15,9,12,56,47,9,54
Clyde,6542,5,15,9,12,53,49,4,54
Elgin,6542,6,14,6,16,54,62,-8,48
Annan Athlet,6542,7,12,11,13,48,41,7,47
Berwick,6542,8,8,10,18,30,60,-30,34
Edinburgh Ci,6542,9,7,9,20,36,62,-26,30
Cowdenbeath,6542,10,4,10,22,23,55,-32,22
Montrose,6543,1,23,7,6,60,36,24,76
Peterhead,6543,2,23,5,8,78,39,39,74
Stirling,6543,3,17,6,13,62,51,11,57
Stenhousem'r,6543,4,15,8,13,55,48,7,53
Clyde,6543,5,14,9,13,52,51,1,51
Elgin,6543,6,15,6,15,55,61,-6,51
Annan Athlet,6543,7,12,11,13,51,41,10,47
Berwick,6543,8,9,10,17,32,59,-27,37
Edinburgh Ci,6543,9,7,10,19,37,61,-24,31
Cowdenbeath,6543,10,4,10,22,23,58,-35,22
Peterhead,6544,1,24,4,8,79,38,41,76
Montrose,6544,2,23,7,6,61,37,24,76
Stenhousem'r,6544,3,16,8,12,61,47,14,56
Stirling,6544,4,16,6,14,61,57,4,54
Clyde,6544,5,14,9,13,53,51,2,51
Elgin,6544,6,15,6,15,56,62,-6,51
Annan Athlet,6544,7,11,12,13,47,41,6,45
Berwick,6544,8,9,10,17,32,60,-28,37
Edinburgh Ci,6544,9,7,9,20,36,62,-26,30
Cowdenbeath,6544,10,4,11,21,23,54,-31,23
Montrose,6545,1,24,7,5,63,35,28,79
Peterhead,6545,2,24,4,8,79,39,40,76
Stenhousem'r,6545,3,16,8,12,57,47,10,56
Stirling,6545,4,16,6,14,61,53,8,54
Clyde,6545,5,15,9,12,54,48,6,54
Elgin,6545,6,14,6,16,54,64,-10,48
Annan Athlet,6545,7,12,11,13,51,42,9,47
Berwick,6545,8,8,10,18,29,61,-32,34
Edinburgh Ci,6545,9,7,9,20,37,62,-25,30
Cowdenbeath,6545,10,4,10,22,24,58,-34,22
Peterhead,6546,1,24,4,8,79,38,41,76
Montrose,6546,2,23,7,6,59,35,24,76
Stirling,6546,3,17,6,13,61,51,10,57
Clyde,6546,4,15,9,12,55,48,7,54
Stenhousem'r,6546,5,15,8,13,55,47,8,53
Elgin,6546,6,15,6,15,54,60,-6,51
Annan Athlet,6546,7,11,11,14,47,42,5,44
Berwick,6546,8,8,10,18,29,62,-33,34
Edinburgh Ci,6546,9,7,9,20,36,62,-26,30
Cowdenbeath,6546,10,5,10,21,24,54,-30,25
Montrose,6547,1,24,7,5,61,35,26,79
Peterhead,6547,2,23,4,9,77,39,38,73
Stirling,6547,3,17,6,13,61,51,10,57
Stenhousem'r,6547,4,15,8,13,55,47,8,53
Clyde,6547,5,14,10,12,51,48,3,52
Elgin,6547,6,14,6,16,54,62,-8,48
Annan Athlet,6547,7,11,12,13,48,42,6,45
Berwick,6547,8,8,11,17,29,58,-29,35
Edinburgh Ci,6547,9,8,9,19,37,60,-23,33
Cowdenbeath,6547,10,4,11,21,24,55,-31,23
Montrose,6548,1,23,8,5,59,34,25,77
Peterhead,6548,2,24,4,8,82,38,44,76
Stenhousem'r,6548,3,16,8,12,58,48,10,56
Stirling,6548,4,16,6,14,62,54,8,54
Clyde,6548,5,14,9,13,51,49,2,51
Elgin,6548,6,14,7,15,53,60,-7,49
Annan Athlet,6548,7,11,12,13,48,42,6,45
Berwick,6548,8,9,10,17,30,58,-28,37
Edinburgh Ci,6548,9,7,9,20,36,65,-29,30
Cowdenbeath,6548,10,4,11,21,24,55,-31,23
Montrose,6549,1,24,7,5,60,34,26,79
Peterhead,6549,2,24,4,8,81,39,42,76
Stirling,6549,3,17,6,13,62,52,10,57
Stenhousem'r,6549,4,15,8,13,56,48,8,53
Clyde,6549,5,14,9,13,52,50,2,51
Elgin,6549,6,14,6,16,53,61,-8,48
Annan Athlet,6549,7,12,11,13,50,41,9,47
Berwick,6549,8,9,10,17,31,59,-28,37
Edinburgh Ci,6549,9,7,9,20,37,64,-27,30
Cowdenbeath,6549,10,4,10,22,23,57,-34,22
Montrose,6550,1,24,7,5,61,35,26,79
Peterhead,6550,2,24,4,8,81,38,43,76
Stirling,6550,3,17,6,13,61,51,10,57
Clyde,6550,4,15,9,12,55,49,6,54
Stenhousem'r,6550,5,15,8,13,55,47,8,53
Elgin,6550,6,14,6,16,54,62,-8,48
Annan Athlet,6550,7,11,12,13,48,42,6,45
Berwick,6550,8,8,10,18,30,62,-32,34
Edinburgh Ci,6550,9,7,9,20,36,64,-28,30
Cowdenbeath,6550,10,4,11,21,24,55,-31,23
Montrose,6551,1,23,8,5,59,34,25,77
Peterhead,6551,2,24,4,8,79,39,40,76
Stirling,6551,3,16,7,13,62,53,9,55
Stenhousem'r,6551,4,15,9,12,57,48,9,54
Clyde,6551,5,15,9,12,54,48,6,54
Elgin,6551,6,14,7,15,53,60,-7,49
Annan Athlet,6551,7,11,11,14,47,42,5,44
Berwick,6551,8,8,10,18,29,61,-32,34
Edinburgh Ci,6551,9,7,9,20,37,62,-25,30
Cowdenbeath,6551,10,5,10,21,24,54,-30,25
Montrose,6552,1,23,8,5,59,34,25,77
Peterhead,6552,2,23,4,9,79,41,38,73
Stirling,6552,3,16,7,13,63,54,9,55
Stenhousem'r,6552,4,15,9,12,58,49,9,54
Clyde,6552,5,14,10,12,52,49,3,52
Elgin,6552,6,14,7,15,53,60,-7,49
Annan Athlet,6552,7,11,12,13,47,41,6,45
Berwick,6552,8,8,11,17,30,59,-29,35
Edinburgh Ci,6552,9,8,9,19,39,62,-23,33
Cowdenbeath,6552,10,4,11,21,23,54,-31,23
Montrose,6553,1,24,7,5,61,35,26,79
Peterhead,6553,2,23,5,8,79,40,39,74
Stirling,6553,3,17,6,13,63,52,11,57
Stenhousem'r,6553,4,15,8,13,56,49,7,53
Clyde,6553,5,14,9,13,51,49,2,51
Elgin,6553,6,14,6,16,54,62,-8,48
Annan Athlet,6553,7,12,11,13,48,41,7,47
Berwick,6553,8,9,10,17,30,58,-28,37
Edinburgh Ci,6553,9,7,10,19,38,62,-24,31
Cowdenbeath,6553,10,4,10,22,23,55,-32,22
Montrose,6554,1,24,7,5,61,34,27,79
Peterhead,6554,2,23,5,8,79,40,39,74
Stirling,6554,3,16,7,13,62,53,9,55
Stenhousem'r,6554,4,15,9,12,57,48,9,54
Clyde,6554,5,15,9,12,54,48,6,54
Elgin,6554,6,14,6,16,53,62,-9,48
Annan Athlet,6554,7,11,12,13,48,42,6,45
Berwick,6554,8,8,10,18,29,61,-32,34
Edinburgh Ci,6554,9,7,10,19,38,62,-24,31
Cowdenbeath,6554,10,4,11,21,24,55,-31,23
Montrose,6555,1,24,7,5,60,34,26,79
Peterhead,6555,2,23,5,8,77,38,39,74
Stenhousem'r,6555,3,16,8,12,57,47,10,56
Stirling,6555,4,16,6,14,61,53,8,54
Clyde,6555,5,15,9,12,56,51,5,54
Elgin,6555,6,14,6,16,53,61,-8,48
Annan Athlet,6555,7,11,12,13,49,43,6,45
Berwick,6555,8,8,10,18,32,63,-31,34
Edinburgh Ci,6555,9,7,10,19,36,60,-24,31
Cowdenbeath,6555,10,4,11,21,25,56,-31,23
Montrose,6556,1,24,7,5,63,35,28,79
Peterhead,6556,2,24,4,8,83,38,45,76
Stirling,6556,3,17,6,13,63,53,10,57
Clyde,6556,4,15,9,12,54,50,4,54
Stenhousem'r,6556,5,15,8,13,57,49,8,53
Elgin,6556,6,14,6,16,54,64,-10,48
Annan Athlet,6556,7,11,11,14,47,42,5,44
Berwick,6556,8,8,10,18,31,61,-30,34
Edinburgh Ci,6556,9,7,9,20,36,66,-30,30
Cowdenbeath,6556,10,5,10,21,24,54,-30,25
Peterhead,6557,1,24,4,8,82,38,44,76
Montrose,6557,2,23,7,6,60,36,24,76
Stirling,6557,3,16,7,13,62,53,9,55
Stenhousem'r,6557,4,15,9,12,57,48,9,54
Clyde,6557,5,15,9,12,53,48,5,54
Elgin,6557,6,15,6,15,55,61,-6,51
Annan Athlet,6557,7,11,12,13,48,42,6,45
Berwick,6557,8,8,10,18,29,60,-31,34
Edinburgh Ci,6557,9,7,9,20,36,65,-29,30
Cowdenbeath,6557,10,4,11,21,24,55,-31,23
Montrose,6558,1,23,8,5,60,35,25,77
Peterhead,6558,2,24,4,8,79,39,40,76
Stenhousem'r,6558,3,16,8,12,57,47,10,56
Stirling,6558,4,16,6,14,61,53,8,54
Clyde,6558,5,14,10,12,52,49,3,52
Elgin,6558,6,14,7,15,54,61,-7,49
Annan Athlet,6558,7,11,12,13,48,42,6,45
Berwick,6558,8,8,11,17,30,59,-29,35
Edinburgh Ci,6558,9,7,9,20,37,62,-25,30
Cowdenbeath,6558,10,4,11,21,24,55,-31,23
Montrose,6559,1,24,7,5,62,35,27,79
Peterhead,6559,2,23,4,9,78,41,37,73
Stenhousem'r,6559,3,16,8,12,58,47,11,56
Stirling,6559,4,16,6,14,61,54,7,54
Clyde,6559,5,15,9,12,53,49,4,54
Elgin,6559,6,14,6,16,54,63,-9,48
Annan Athlet,6559,7,12,11,13,49,42,7,47
Berwick,6559,8,8,10,18,30,60,-30,34
Edinburgh Ci,6559,9,8,9,19,39,61,-22,33
Cowdenbeath,6559,10,4,10,22,24,56,-32,22
Peterhead,6560,1,24,4,8,79,39,40,76
Montrose,6560,2,23,7,6,59,35,24,76
Stenhousem'r,6560,3,16,8,12,57,47,10,56
Stirling,6560,4,16,6,14,61,53,8,54
Clyde,6560,5,15,9,12,54,48,6,54
Elgin,6560,6,15,6,15,54,60,-6,51
Annan Athlet,6560,7,11,12,13,49,43,6,45
Berwick,6560,8,8,10,18,29,61,-32,34
Edinburgh Ci,6560,9,7,9,20,37,62,-25,30
Cowdenbeath,6560,10,4,11,21,25,56,-31,23
Montrose,6561,1,24,7,5,61,34,27,79
Peterhead,6561,2,23,5,8,78,39,39,74
Stirling,6561,3,17,6,13,63,52,11,57
Stenhousem'r,6561,4,15,8,13,56,49,7,53
Clyde,6561,5,14,9,13,53,53,0,51
Elgin,6561,6,14,6,16,53,62,-9,48
Annan Athlet,6561,7,12,11,13,50,42,8,47
Berwick,6561,8,9,10,17,34,60,-26,37
Edinburgh Ci,6561,9,7,10,19,37,61,-24,31
Cowdenbeath,6561,10,4,10,22,24,57,-33,22
Montrose,6562,1,24,7,5,60,34,26,79
Peterhead,6562,2,24,4,8,81,40,41,76
Stirling,6562,3,17,6,13,63,53,10,57
Clyde,6562,4,15,9,12,55,49,6,54
Stenhousem'r,6562,5,15,8,13,57,49,8,53
Elgin,6562,6,14,6,16,53,61,-8,48
Annan Athlet,6562,7,12,11,13,51,42,9,47
Berwick,6562,8,8,10,18,30,62,-32,34
Edinburgh Ci,6562,9,7,9,20,38,64,-26,30
Cowdenbeath,6562,10,4,10,22,24,58,-34,22
Montrose,6563,1,24,7,5,61,34,27,79
Peterhead,6563,2,24,4,8,78,38,40,76
Stenhousem'r,6563,3,16,8,12,56,46,10,56
Stirling,6563,4,16,6,14,60,52,8,54
Clyde,6563,5,14,9,13,52,50,2,51
Elgin,6563,6,14,6,16,53,62,-9,48
Annan Athlet,6563,7,11,11,14,47,43,4,44
Berwick,6563,8,9,10,17,31,59,-28,37
Edinburgh Ci,6563,9,7,9,20,36,61,-25,30
Cowdenbeath,6563,10,5,10,21,25,54,-29,25
Montrose,6564,1,24,7,5,60,34,26,79
Peterhead,6564,2,24,4,8,81,39,42,76
Stirling,6564,3,17,6,13,62,52,10,57
Stenhousem'r,6564,4,15,8,13,56,48,8,53
Clyde,6564,5,14,9,13,51,49,2,51
Elgin,6564,6,14,6,16,53,61,-8,48
Annan Athlet,6564,7,11,11,14,47,43,4,44
Berwick,6564,8,9,10,17,30,58,-28,37
Edinburgh Ci,6564,9,7,9,20,37,64,-27,30
Cowdenbeath,6564,10,5,10,21,25,54,-29,25
Peterhead,6565,1,24,4,8,79,38,41,76
Montrose,6565,2,23,7,6,59,35,24,76
Stirling,6565,3,17,6,13,61,51,10,57
Stenhousem'r,6565,4,15,8,13,55,47,8,53
Clyde,6565,5,14,10,12,51,48,3,52
Elgin,6565,6,15,6,15,54,60,-6,51
Annan Athlet,6565,7,11,12,13,48,42,6,45
Berwick,6565,8,8,11,17,29,58,-29,35
Edinburgh Ci,6565,9,7,9,20,36,62,-26,30
Cowdenbeath,6565,10,4,11,21,24,55,-31,23
Peterhead,6566,1,24,4,8,79,39,40,76
Montrose,6566,2,23,7,6,59,38,21,76
Stenhousem'r,6566,3,16,8,12,57,47,10,56
Stirling,6566,4,16,6,14,61,53,8,54
Clyde,6566,5,15,9,12,54,48,6,54
Elgin,6566,6,15,6,15,57,60,-3,51
Annan Athlet,6566,7,11,12,13,49,43,6,45
Berwick,6566,8,8,10,18,29,61,-32,34
Edinburgh Ci,6566,9,7,9,20,37,62,-25,30
Cowdenbeath,6566,10,4,11,21,25,56,-31,23
Montrose,6567,1,23,8,5,60,35,25,77
Peterhead,6567,2,23,5,8,77,38,39,74
Stirling,6567,3,16,7,13,62,53,9,55
Stenhousem'r,6567,4,15,9,12,57,48,9,54
Clyde,6567,5,14,10,12,53,50,3,52
Elgin,6567,6,14,7,15,54,61,-7,49
Annan Athlet,6567,7,11,12,13,47,41,6,45
Berwick,6567,8,8,11,17,31,60,-29,35
Edinburgh Ci,6567,9,7,10,19,36,60,-24,31
Cowdenbeath,6567,10,4,11,21,23,54,-31,23
Montrose,6568,1,23,8,5,61,36,25,77
Peterhead,6568,2,24,4,8,79,38,41,76
Stirling,6568,3,17,6,13,63,52,11,57
Stenhousem'r,6568,4,15,8,13,56,49,7,53
Clyde,6568,5,14,9,13,51,50,1,51
Elgin,6568,6,14,7,15,55,62,-7,49
Annan Athlet,6568,7,12,11,13,49,42,7,47
Berwick,6568,8,9,10,17,31,58,-27,37
Edinburgh Ci,6568,9,7,9,20,36,62,-26,30
Cowdenbeath,6568,10,4,10,22,24,56,-32,22
Montrose,6569,1,24,7,5,61,34,27,79
Peterhead,6569,2,24,4,8,80,39,41,76
Stenhousem'r,6569,3,16,8,12,58,47,11,56
Stirling,6569,4,16,6,14,61,54,7,54
Clyde,6569,5,14,9,13,51,50,1,51
Elgin,6569,6,14,6,16,53,62,-9,48
Annan Athlet,6569,7,11,12,13,49,43,6,45
Berwick,6569,8,9,10,17,31,58,-27,37
Edinburgh Ci,6569,9,7,9,20,37,63,-26,30
Cowdenbeath,6569,10,4,11,21,25,56,-31,23
Montrose,6570,1,23,8,5,59,34,25,77
Peterhead,6570,2,23,5,8,77,38,39,74
Stirling,6570,3,16,7,13,61,52,9,55
Stenhousem'r,6570,4,15,9,12,56,47,9,54
Clyde,6570,5,14,10,12,52,49,3,52
Elgin,6570,6,14,7,15,53,60,-7,49
Annan Athlet,6570,7,11,12,13,47,41,6,45
Berwick,6570,8,8,11,17,30,59,-29,35
Edinburgh Ci,6570,9,7,10,19,36,60,-24,31
Cowdenbeath,6570,10,4,11,21,23,54,-31,23
Montrose,6571,1,24,7,5,61,34,27,79
Peterhead,6571,2,24,4,8,80,40,40,76
Stirling,6571,3,17,6,13,62,51,11,57
Clyde,6571,4,15,9,12,53,49,4,54
Stenhousem'r,6571,5,15,8,13,55,48,7,53
Elgin,6571,6,14,6,16,53,62,-9,48
Annan Athlet,6571,7,11,11,14,49,44,5,44
Berwick,6571,8,8,10,18,30,60,-30,34
Edinburgh Ci,6571,9,7,9,20,38,63,-25,30
Cowdenbeath,6571,10,5,10,21,26,56,-30,25
Montrose,6572,1,24,7,5,60,34,26,79
Peterhead,6572,2,23,5,8,78,39,39,74
Stirling,6572,3,17,6,13,61,51,10,57
Clyde,6572,4,15,9,12,54,48,6,54
Stenhousem'r,6572,5,15,8,13,55,47,8,53
Elgin,6572,6,14,6,16,53,61,-8,48
Annan Athlet,6572,7,11,11,14,47,42,5,44
Berwick,6572,8,8,10,18,29,61,-32,34
Edinburgh Ci,6572,9,7,10,19,37,61,-24,31
Cowdenbeath,6572,10,5,10,21,24,54,-30,25
Montrose,6573,1,24,7,5,62,34,28,79
Peterhead,6573,2,24,4,8,82,40,42,76
Stirling,6573,3,17,6,13,61,51,10,57
Clyde,6573,4,15,9,12,54,48,6,54
Stenhousem'r,6573,5,15,8,13,55,47,8,53
Elgin,6573,6,14,6,16,53,63,-10,48
Annan Athlet,6573,7,11,12,13,47,41,6,45
Berwick,6573,8,8,10,18,29,61,-32,34
Edinburgh Ci,6573,9,7,9,20,38,65,-27,30
Cowdenbeath,6573,10,4,11,21,23,54,-31,23
Montrose,6574,1,24,7,5,60,34,26,79
Peterhead,6574,2,23,4,9,77,40,37,73
Stenhousem'r,6574,3,16,8,12,57,47,10,56
Stirling,6574,4,16,6,14,61,53,8,54
Clyde,6574,5,15,9,12,52,48,4,54
Elgin,6574,6,14,6,16,53,61,-8,48
Annan Athlet,6574,7,12,11,13,49,42,7,47
Berwick,6574,8,8,10,18,29,59,-30,34
Edinburgh Ci,6574,9,8,9,19,38,60,-22,33
Cowdenbeath,6574,10,4,10,22,24,56,-32,22
Montrose,6575,1,24,7,5,61,34,27,79
Peterhead,6575,2,23,5,8,78,39,39,74
Stirling,6575,3,17,6,13,65,52,13,57
Stenhousem'r,6575,4,15,8,13,56,51,5,53
Clyde,6575,5,14,10,12,53,50,3,52
Elgin,6575,6,14,6,16,53,62,-9,48
Annan Athlet,6575,7,11,11,14,47,42,5,44
Berwick,6575,8,8,11,17,31,60,-29,35
Edinburgh Ci,6575,9,7,10,19,37,61,-24,31
Cowdenbeath,6575,10,5,10,21,24,54,-30,25
Montrose,6576,1,23,8,5,59,34,25,77
Peterhead,6576,2,23,4,9,78,41,37,73
Stirling,6576,3,17,6,13,63,53,10,57
Stenhousem'r,6576,4,15,8,13,57,49,8,53
Clyde,6576,5,14,9,13,51,49,2,51
Elgin,6576,6,14,7,15,53,60,-7,49
Annan Athlet,6576,7,12,11,13,48,41,7,47
Berwick,6576,8,9,10,17,30,58,-28,37
Edinburgh Ci,6576,9,8,9,19,39,61,-22,33
Cowdenbeath,6576,10,4,10,22,23,55,-32,22
Montrose,6577,1,24,7,5,62,36,26,79
Peterhead,6577,2,24,4,8,79,38,41,76
Stirling,6577,3,17,6,13,64,53,11,57
Clyde,6577,4,15,9,12,54,48,6,54
Stenhousem'r,6577,5,15,8,13,57,50,7,53
Elgin,6577,6,14,6,16,55,63,-8,48
Annan Athlet,6577,7,11,12,13,47,41,6,45
Berwick,6577,8,8,10,18,29,61,-32,34
Edinburgh Ci,6577,9,7,9,20,36,62,-26,30
Cowdenbeath,6577,10,4,11,21,23,54,-31,23
Montrose,6578,1,24,7,5,61,35,26,79
Peterhead,6578,2,24,4,8,81,40,41,76
Stirling,6578,3,17,6,13,62,51,11,57
Clyde,6578,4,15,9,12,53,49,4,54
Stenhousem'r,6578,5,15,8,13,55,48,7,53
Elgin,6578,6,14,6,16,54,62,-8,48
Annan Athlet,6578,7,12,11,13,51,43,8,47
Berwick,6578,8,8,10,18,30,60,-30,34
Edinburgh Ci,6578,9,7,9,20,38,64,-26,30
Cowdenbeath,6578,10,4,10,22,25,58,-33,22
Montrose,6579,1,23,8,5,59,34,25,77
Peterhead,6579,2,24,4,8,80,40,40,76
Stirling,6579,3,17,6,13,62,52,10,57
Stenhousem'r,6579,4,15,8,13,56,48,8,53
Clyde,6579,5,14,10,12,53,50,3,52
Elgin,6579,6,14,7,15,53,60,-7,49
Annan Athlet,6579,7,11,12,13,48,42,6,45
Berwick,6579,8,8,11,17,31,60,-29,35
Edinburgh Ci,6579,9,7,9,20,38,63,-25,30
Cowdenbeath,6579,10,4,11,21,24,55,-31,23
Peterhead,6580,1,24,4,8,80,38,42,76
Montrose,6580,2,23,7,6,59,35,24,76
Stirling,6580,3,17,6,13,65,51,14,57
Clyde,6580,4,15,9,12,53,48,5,54
Stenhousem'r,6580,5,15,8,13,55,51,4,53
Elgin,6580,6,15,6,15,54,60,-6,51
Annan Athlet,6580,7,12,11,13,49,42,7,47
Berwick,6580,8,8,10,18,29,60,-31,34
Edinburgh Ci,6580,9,7,9,20,36,63,-27,30
Cowdenbeath,6580,10,4,10,22,24,56,-32,22
Montrose,6581,1,24,7,5,60,34,26,79
Peterhead,6581,2,23,4,9,77,39,38,73
Stirling,6581,3,17,6,13,63,53,10,57
Stenhousem'r,6581,4,15,8,13,57,49,8,53
Clyde,6581,5,14,10,12,53,50,3,52
Elgin,6581,6,14,6,16,53,61,-8,48
Annan Athlet,6581,7,11,11,14,47,42,5,44
Berwick,6581,8,8,11,17,31,60,-29,35
Edinburgh Ci,6581,9,8,9,19,37,60,-23,33
Cowdenbeath,6581,10,5,10,21,24,54,-30,25
Montrose,6582,1,24,7,5,62,34,28,79
Peterhead,6582,2,24,4,8,79,38,41,76
Stirling,6582,3,17,6,13,62,52,10,57
Clyde,6582,4,15,9,12,53,49,4,54
Stenhousem'r,6582,5,15,8,13,56,48,8,53
Elgin,6582,6,14,6,16,53,63,-10,48
Annan Athlet,6582,7,11,12,13,48,42,6,45
Berwick,6582,8,8,10,18,30,60,-30,34
Edinburgh Ci,6582,9,7,9,20,36,62,-26,30
Cowdenbeath,6582,10,4,11,21,24,55,-31,23
Montrose,6583,1,24,7,5,63,34,29,79
Peterhead,6583,2,24,4,8,80,38,42,76
Stenhousem'r,6583,3,16,8,12,57,46,11,56
Stirling,6583,4,16,6,14,60,53,7,54
Clyde,6583,5,14,10,12,53,50,3,52
Elgin,6583,6,14,6,16,53,64,-11,48
Annan Athlet,6583,7,12,11,13,48,41,7,47
Berwick,6583,8,8,11,17,31,60,-29,35
Edinburgh Ci,6583,9,7,9,20,36,63,-27,30
Cowdenbeath,6583,10,4,10,22,23,55,-32,22
Montrose,6584,1,24,7,5,65,34,31,79
Peterhead,6584,2,24,4,8,81,38,43,76
Stirling,6584,3,16,7,13,62,53,9,55
Stenhousem'r,6584,4,15,9,12,57,48,9,54
Clyde,6584,5,15,9,12,54,48,6,54
Elgin,6584,6,14,6,16,53,66,-13,48
Annan Athlet,6584,7,11,11,14,47,42,5,44
Berwick,6584,8,8,10,18,29,61,-32,34
Edinburgh Ci,6584,9,7,9,20,36,64,-28,30
Cowdenbeath,6584,10,5,10,21,24,54,-30,25
Montrose,6585,1,23,8,5,61,36,25,77
Peterhead,6585,2,24,4,8,81,39,42,76
Stenhousem'r,6585,3,16,8,12,56,46,10,56
Stirling,6585,4,16,6,14,60,52,8,54
Clyde,6585,5,14,9,13,52,50,2,51
Elgin,6585,6,14,7,15,55,62,-7,49
Annan Athlet,6585,7,11,11,14,48,43,5,44
Berwick,6585,8,9,10,17,31,59,-28,37
Edinburgh Ci,6585,9,7,9,20,37,64,-27,30
Cowdenbeath,6585,10,5,10,21,25,55,-30,25
Montrose,6586,1,23,8,5,60,35,25,77
Peterhead,6586,2,24,4,8,80,39,41,76
Stirling,6586,3,17,6,13,63,52,11,57
Clyde,6586,4,15,9,12,53,48,5,54
Stenhousem'r,6586,5,15,8,13,56,49,7,53
Elgin,6586,6,14,7,15,54,61,-7,49
Annan Athlet,6586,7,12,11,13,48,41,7,47
Berwick,6586,8,8,10,18,29,60,-31,34
Edinburgh Ci,6586,9,7,9,20,37,63,-26,30
Cowdenbeath,6586,10,4,10,22,23,55,-32,22
Montrose,6587,1,23,8,5,61,36,25,77
Peterhead,6587,2,24,4,8,78,38,40,76
Stirling,6587,3,16,7,13,62,53,9,55
Stenhousem'r,6587,4,15,9,12,57,48,9,54
Clyde,6587,5,15,9,12,53,48,5,54
Elgin,6587,6,14,7,15,55,62,-7,49
Annan Athlet,6587,7,11,11,14,48,43,5,44
Berwick,6587,8,8,10,18,29,60,-31,34
Edinburgh Ci,6587,9,7,9,20,36,61,-25,30
Cowdenbeath,6587,10,5,10,21,25,55,-30,25
Montrose,6588,1,23,8,5,61,36,25,77
Peterhead,6588,2,24,4,8,82,38,44,76
Stirling,6588,3,17,6,13,62,51,11,57
Clyde,6588,4,15,9,12,55,49,6,54
Stenhousem'r,6588,5,15,8,13,55,48,7,53
Elgin,6588,6,14,7,15,55,62,-7,49
Annan Athlet,6588,7,12,11,13,50,41,9,47
Berwick,6588,8,8,10,18,30,62,-32,34
Edinburgh Ci,6588,9,7,9,20,36,65,-29,30
Cowdenbeath,6588,10,4,10,22,23,57,-34,22
Montrose,6589,1,23,7,6,61,37,24,76
Peterhead,6589,2,23,5,8,79,40,39,74
Stirling,6589,3,17,6,13,64,53,11,57
Clyde,6589,4,15,9,12,53,48,5,54
Stenhousem'r,6589,5,15,8,13,57,50,7,53
Elgin,6589,6,15,6,15,56,62,-6,51
Annan Athlet,6589,7,12,11,13,49,42,7,47
Berwick,6589,8,8,10,18,29,60,-31,34
Edinburgh Ci,6589,9,7,10,19,38,62,-24,31
Cowdenbeath,6589,10,4,10,22,24,56,-32,22
Peterhead,6590,1,24,4,8,81,40,41,76
Montrose,6590,2,23,7,6,60,37,23,76
Stirling,6590,3,17,6,13,63,52,11,57
Stenhousem'r,6590,4,15,8,13,56,49,7,53
Clyde,6590,5,14,10,12,52,49,3,52
Elgin,6590,6,15,6,15,56,61,-5,51
Annan Athlet,6590,7,11,12,13,49,43,6,45
Berwick,6590,8,8,11,17,30,59,-29,35
Edinburgh Ci,6590,9,7,9,20,38,64,-26,30
Cowdenbeath,6590,10,4,11,21,25,56,-31,23
Montrose,6591,1,24,7,5,63,36,27,79
Peterhead,6591,2,24,4,8,82,39,43,76
Stirling,6591,3,16,7,13,62,53,9,55
Stenhousem'r,6591,4,15,9,12,57,48,9,54
Clyde,6591,5,14,10,12,52,49,3,52
Elgin,6591,6,14,6,16,55,64,-9,48
Annan Athlet,6591,7,11,11,14,47,42,5,44
Berwick,6591,8,8,11,17,30,59,-29,35
Edinburgh Ci,6591,9,7,9,20,37,65,-28,30
Cowdenbeath,6591,10,5,10,21,24,54,-30,25
Montrose,6592,1,23,8,5,61,36,25,77
Peterhead,6592,2,24,4,8,82,39,43,76
Stirling,6592,3,17,6,13,62,51,11,57
Clyde,6592,4,15,9,12,53,48,5,54
Stenhousem'r,6592,5,15,8,13,55,48,7,53
Elgin,6592,6,14,7,15,55,62,-7,49
Annan Athlet,6592,7,11,12,13,48,42,6,45
Berwick,6592,8,8,10,18,29,60,-31,34
Edinburgh Ci,6592,9,7,9,20,37,65,-28,30
Cowdenbeath,6592,10,4,11,21,24,55,-31,23
Montrose,6593,1,24,7,5,61,35,26,79
Peterhead,6593,2,24,4,8,83,41,42,76
Stenhousem'r,6593,3,16,8,12,59,47,12,56
Stirling,6593,4,16,6,14,61,55,6,54
Clyde,6593,5,14,9,13,52,52,0,51
Elgin,6593,6,14,6,16,54,62,-8,48
Annan Athlet,6593,7,11,12,13,47,41,6,45
Berwick,6593,8,9,10,17,33,59,-26,37
Edinburgh Ci,6593,9,7,9,20,39,66,-27,30
Cowdenbeath,6593,10,4,11,21,23,54,-31,23
Montrose,6594,1,24,7,5,61,35,26,79
Peterhead,6594,2,24,4,8,78,38,40,76
Stirling,6594,3,17,6,13,62,52,10,57
Clyde,6594,4,15,9,12,53,49,4,54
Stenhousem'r,6594,5,15,8,13,56,48,8,53
Elgin,6594,6,14,6,16,54,62,-8,48
Annan Athlet,6594,7,12,11,13,49,41,8,47
Berwick,6594,8,8,10,18,30,60,-30,34
Edinburgh Ci,6594,9,7,9,20,36,61,-25,30
Cowdenbeath,6594,10,4,10,22,23,56,-33,22
Montrose,6595,1,24,7,5,60,34,26,79
Peterhead,6595,2,24,4,8,80,38,42,76
Stenhousem'r,6595,3,16,8,12,57,47,10,56
Stirling,6595,4,16,6,14,61,53,8,54
Clyde,6595,5,15,9,12,55,51,4,54
Elgin,6595,6,14,6,16,53,61,-8,48
Annan Athlet,6595,7,11,12,13,48,42,6,45
Berwick,6595,8,8,10,18,32,62,-30,34
Edinburgh Ci,6595,9,7,9,20,36,63,-27,30
Cowdenbeath,6595,10,4,11,21,24,55,-31,23
Peterhead,6596,1,24,4,8,78,38,40,76
Montrose,6596,2,23,7,6,59,35,24,76
Stirling,6596,3,17,6,13,63,52,11,57
Stenhousem'r,6596,4,15,8,13,56,49,7,53
Clyde,6596,5,14,9,13,52,51,1,51
Elgin,6596,6,15,6,15,54,60,-6,51
Annan Athlet,6596,7,12,11,13,49,42,7,47
Berwick,6596,8,9,10,17,32,59,-27,37
Edinburgh Ci,6596,9,7,9,20,36,61,-25,30
Cowdenbeath,6596,10,4,10,22,24,56,-32,22
Montrose,6597,1,24,7,5,62,35,27,79
Peterhead,6597,2,24,4,8,80,39,41,76
Stenhousem'r,6597,3,16,8,12,56,46,10,56
Stirling,6597,4,16,6,14,60,52,8,54
Clyde,6597,5,14,10,12,53,50,3,52
Elgin,6597,6,14,6,16,54,63,-9,48
Annan Athlet,6597,7,12,11,13,48,41,7,47
Berwick,6597,8,8,11,17,31,60,-29,35
Edinburgh Ci,6597,9,7,9,20,37,63,-26,30
Cowdenbeath,6597,10,4,10,22,23,55,-32,22
Montrose,6598,1,24,7,5,61,35,26,79
Peterhead,6598,2,24,4,8,80,38,42,76
Stenhousem'r,6598,3,16,8,12,57,47,10,56
Stirling,6598,4,16,6,14,61,53,8,54
Clyde,6598,5,14,9,13,52,50,2,51
Elgin,6598,6,14,6,16,54,62,-8,48
Annan Athlet,6598,7,11,11,14,47,44,3,44
Berwick,6598,8,9,10,17,31,59,-28,37
Edinburgh Ci,6598,9,7,9,20,36,63,-27,30
Cowdenbeath,6598,10,5,10,21,26,54,-28,25
Montrose,6599,1,24,7,5,64,36,28,79
Peterhead,6599,2,23,5,8,77,38,39,74
Stirling,6599,3,17,6,13,64,52,12,57
Stenhousem'r,6599,4,15,8,13,56,50,6,53
Clyde,6599,5,14,9,13,51,49,2,51
Elgin,6599,6,14,6,16,55,65,-10,48
Annan Athlet,6599,7,11,11,14,47,44,3,44
Berwick,6599,8,9,10,17,30,58,-28,37
Edinburgh Ci,6599,9,7,10,19,36,60,-24,31
Cowdenbeath,6599,10,5,10,21,26,54,-28,25
Montrose,6600,1,23,8,5,62,37,25,77
Peterhead,6600,2,24,4,8,79,38,41,76
Stirling,6600,3,17,6,13,63,53,10,57
Stenhousem'r,6600,4,15,8,13,57,49,8,53
Clyde,6600,5,14,9,13,51,49,2,51
Elgin,6600,6,14,7,15,56,63,-7,49
Annan Athlet,6600,7,12,11,13,50,41,9,47
Berwick,6600,8,9,10,17,30,58,-28,37
Edinburgh Ci,6600,9,7,9,20,36,62,-26,30
Cowdenbeath,6600,10,4,10,22,23,57,-34,22
Montrose,6601,1,24,7,5,61,35,26,79
Peterhead,6601,2,24,4,8,80,38,42,76
Stirling,6601,3,17,6,13,63,52,11,57
Clyde,6601,4,15,9,12,56,48,8,54
Stenhousem'r,6601,5,15,8,13,56,49,7,53
Elgin,6601,6,14,6,16,54,62,-8,48
Annan Athlet,6601,7,12,11,13,49,41,8,47
Berwick,6601,8,8,10,18,29,63,-34,34
Edinburgh Ci,6601,9,7,9,20,36,63,-27,30
Cowdenbeath,6601,10,4,10,22,23,56,-33,22
Montrose,6602,1,24,7,5,60,34,26,79
Peterhead,6602,2,24,4,8,80,38,42,76
Stirling,6602,3,16,7,13,60,51,9,55
Stenhousem'r,6602,4,15,9,12,55,46,9,54
Clyde,6602,5,15,9,12,53,49,4,54
Elgin,6602,6,14,6,16,53,61,-8,48
Annan Athlet,6602,7,11,11,14,47,42,5,44
Berwick,6602,8,8,10,18,30,60,-30,34
Edinburgh Ci,6602,9,7,9,20,36,63,-27,30
Cowdenbeath,6602,10,5,10,21,24,54,-30,25
Montrose,6603,1,24,7,5,61,34,27,79
Peterhead,6603,2,23,5,8,78,39,39,74
Stenhousem'r,6603,3,16,8,12,56,46,10,56
Stirling,6603,4,16,6,14,60,52,8,54
Clyde,6603,5,15,9,12,53,48,5,54
Elgin,6603,6,14,6,16,53,62,-9,48
Annan Athlet,6603,7,11,11,14,47,43,4,44
Berwick,6603,8,8,10,18,29,60,-31,34
Edinburgh Ci,6603,9,7,10,19,37,61,-24,31
Cowdenbeath,6603,10,5,10,21,25,54,-29,25
Montrose,6604,1,24,7,5,62,35,27,79
Peterhead,6604,2,24,4,8,79,38,41,76
Stirling,6604,3,17,6,13,65,51,14,57
Clyde,6604,4,15,9,12,54,50,4,54
Stenhousem'r,6604,5,15,8,13,55,51,4,53
Elgin,6604,6,14,6,16,54,63,-9,48
Annan Athlet,6604,7,11,11,14,47,42,5,44
Berwick,6604,8,8,10,18,31,61,-30,34
Edinburgh Ci,6604,9,7,9,20,36,62,-26,30
Cowdenbeath,6604,10,5,10,21,24,54,-30,25
Montrose,6605,1,23,8,5,60,35,25,77
Peterhead,6605,2,23,5,8,78,39,39,74
Stirling,6605,3,17,6,13,62,52,10,57
Clyde,6605,4,15,9,12,52,48,4,54
Stenhousem'r,6605,5,15,8,13,56,48,8,53
Elgin,6605,6,14,7,15,54,61,-7,49
Annan Athlet,6605,7,12,11,13,50,41,9,47
Berwick,6605,8,8,10,18,29,59,-30,34
Edinburgh Ci,6605,9,7,10,19,37,61,-24,31
Cowdenbeath,6605,10,4,10,22,23,57,-34,22
Montrose,6606,1,24,7,5,64,34,30,79
Peterhead,6606,2,24,4,8,78,38,40,76
Stirling,6606,3,17,6,13,63,52,11,57
Clyde,6606,4,15,9,12,52,48,4,54
Stenhousem'r,6606,5,15,8,13,56,49,7,53
Elgin,6606,6,14,6,16,53,65,-12,48
Annan Athlet,6606,7,11,12,13,48,42,6,45
Berwick,6606,8,8,10,18,29,59,-30,34
Edinburgh Ci,6606,9,7,9,20,36,61,-25,30
Cowdenbeath,6606,10,4,11,21,24,55,-31,23
Montrose,6607,1,24,7,5,64,37,27,79
Peterhead,6607,2,23,4,9,77,39,38,73
Stirling,6607,3,17,6,13,61,51,10,57
Stenhousem'r,6607,4,15,8,13,55,47,8,53
Clyde,6607,5,14,9,13,51,49,2,51
Elgin,6607,6,14,6,16,56,65,-9,48
Annan Athlet,6607,7,12,11,13,50,42,8,47
Berwick,6607,8,9,10,17,30,58,-28,37
Edinburgh Ci,6607,9,8,9,19,37,60,-23,33
Cowdenbeath,6607,10,4,10,22,24,57,-33,22
Montrose,6608,1,23,7,6,60,36,24,76
Peterhead,6608,2,23,4,9,77,39,38,73
Stirling,6608,3,16,7,13,62,53,9,55
Stenhousem'r,6608,4,15,9,12,57,48,9,54
Clyde,6608,5,14,9,13,55,53,2,51
Elgin,6608,6,15,6,15,55,61,-6,51
Annan Athlet,6608,7,12,11,13,51,43,8,47
Berwick,6608,8,9,10,17,34,62,-28,37
Edinburgh Ci,6608,9,8,9,19,37,60,-23,33
Cowdenbeath,6608,10,4,10,22,25,58,-33,22
Montrose,6609,1,24,7,5,62,34,28,79
Peterhead,6609,2,24,4,8,81,39,42,76
Stenhousem'r,6609,3,16,8,12,56,46,10,56
Stirling,6609,4,16,6,14,60,52,8,54
Clyde,6609,5,15,9,12,53,48,5,54
Elgin,6609,6,14,6,16,53,63,-10,48
Annan Athlet,6609,7,11,11,14,49,45,4,44
Berwick,6609,8,8,10,18,29,60,-31,34
Edinburgh Ci,6609,9,7,9,20,37,64,-27,30
Cowdenbeath,6609,10,5,10,21,27,56,-29,25
Montrose,6610,1,23,8,5,60,35,25,77
Peterhead,6610,2,23,5,8,78,39,39,74
Stirling,6610,3,16,7,13,61,52,9,55
Stenhousem'r,6610,4,15,9,12,56,47,9,54
Clyde,6610,5,14,9,13,52,50,2,51
Elgin,6610,6,14,7,15,54,61,-7,49
Annan Athlet,6610,7,12,11,13,51,42,9,47
Berwick,6610,8,9,10,17,31,59,-28,37
Edinburgh Ci,6610,9,7,10,19,37,61,-24,31
Cowdenbeath,6610,10,4,10,22,24,58,-34,22
Montrose,6611,1,24,7,5,61,35,26,79
Peterhead,6611,2,23,4,9,77,39,38,73
Stirling,6611,3,16,7,13,61,52,9,55
Stenhousem'r,6611,4,15,9,12,56,47,9,54
Clyde,6611,5,14,10,12,51,48,3,52
Elgin,6611,6,14,6,16,54,62,-8,48
Annan Athlet,6611,7,12,11,13,48,41,7,47
Berwick,6611,8,8,11,17,29,58,-29,35
Edinburgh Ci,6611,9,8,9,19,37,60,-23,33
Cowdenbeath,6611,10,4,10,22,23,55,-32,22
Peterhead,6612,1,24,4,8,78,38,40,76
Montrose,6612,2,23,7,6,59,35,24,76
Stirling,6612,3,17,6,13,62,52,10,57
Clyde,6612,4,15,9,12,55,48,7,54
Stenhousem'r,6612,5,15,8,13,56,48,8,53
Elgin,6612,6,15,6,15,54,60,-6,51
Annan Athlet,6612,7,11,12,13,48,42,6,45
Berwick,6612,8,8,10,18,29,62,-33,34
Edinburgh Ci,6612,9,7,9,20,36,61,-25,30
Cowdenbeath,6612,10,4,11,21,24,55,-31,23
Montrose,6613,1,24,7,5,63,34,29,79
Peterhead,6613,2,24,4,8,79,38,41,76
Stirling,6613,3,17,6,13,64,53,11,57
Clyde,6613,4,15,9,12,53,49,4,54
Stenhousem'r,6613,5,15,8,13,57,50,7,53
Elgin,6613,6,14,6,16,53,64,-11,48
Annan Athlet,6613,7,12,11,13,49,42,7,47
Berwick,6613,8,8,10,18,30,60,-30,34
Edinburgh Ci,6613,9,7,9,20,36,62,-26,30
Cowdenbeath,6613,10,4,10,22,24,56,-32,22
Montrose,6614,1,24,7,5,61,35,26,79
Peterhead,6614,2,24,4,8,79,39,40,76
Stirling,6614,3,16,7,13,61,52,9,55
Stenhousem'r,6614,4,15,9,12,56,47,9,54
Clyde,6614,5,15,9,12,55,50,5,54
Elgin,6614,6,14,6,16,54,62,-8,48
Annan Athlet,6614,7,12,11,13,48,41,7,47
Berwick,6614,8,8,10,18,31,62,-31,34
Edinburgh Ci,6614,9,7,9,20,37,62,-25,30
Cowdenbeath,6614,10,4,10,22,23,55,-32,22
Montrose,6615,1,23,8,5,59,34,25,77
Peterhead,6615,2,24,4,8,82,38,44,76
Stirling,6615,3,16,7,13,62,53,9,55
Stenhousem'r,6615,4,15,9,12,57,48,9,54
Clyde,6615,5,15,9,12,57,49,8,54
Elgin,6615,6,14,7,15,53,60,-7,49
Annan Athlet,6615,7,11,11,14,47,42,5,44
Berwick,6615,8,8,10,18,30,64,-34,34
Edinburgh Ci,6615,9,7,9,20,36,65,-29,30
Cowdenbeath,6615,10,5,10,21,24,54,-30,25
Montrose,6616,1,23,8,5,60,35,25,77
Peterhead,6616,2,23,5,8,78,39,39,74
Stenhousem'r,6616,3,16,8,12,57,46,11,56
Stirling,6616,4,16,6,14,60,53,7,54
Clyde,6616,5,15,9,12,53,49,4,54
Elgin,6616,6,14,7,15,54,61,-7,49
Annan Athlet,6616,7,11,11,14,48,44,4,44
Berwick,6616,8,8,10,18,30,60,-30,34
Edinburgh Ci,6616,9,7,10,19,37,61,-24,31
Cowdenbeath,6616,10,5,10,21,26,55,-29,25
Montrose,6617,1,24,7,5,61,35,26,79
Peterhead,6617,2,24,4,8,79,39,40,76
Stirling,6617,3,17,6,13,61,51,10,57
Clyde,6617,4,15,9,12,54,48,6,54
Stenhousem'r,6617,5,15,8,13,55,47,8,53
Elgin,6617,6,14,6,16,54,62,-8,48
Annan Athlet,6617,7,12,11,13,49,41,8,47
Berwick,6617,8,8,10,18,29,61,-32,34
Edinburgh Ci,6617,9,7,9,20,37,62,-25,30
Cowdenbeath,6617,10,4,10,22,23,56,-33,22
Montrose,6618,1,24,7,5,62,36,26,79
Peterhead,6618,2,24,4,8,80,38,42,76
Stirling,6618,3,17,6,13,62,51,11,57
Clyde,6618,4,15,9,12,52,48,4,54
Stenhousem'r,6618,5,15,8,13,55,48,7,53
Elgin,6618,6,14,6,16,55,63,-8,48
Annan Athlet,6618,7,12,11,13,48,41,7,47
Berwick,6618,8,8,10,18,29,59,-30,34
Edinburgh Ci,6618,9,7,9,20,36,63,-27,30
Cowdenbeath,6618,10,4,10,22,23,55,-32,22
Montrose,6619,1,24,7,5,62,34,28,79
Peterhead,6619,2,23,5,8,78,39,39,74
Stirling,6619,3,16,7,13,63,54,9,55
Stenhousem'r,6619,4,15,9,12,58,49,9,54
Clyde,6619,5,14,9,13,53,51,2,51
Elgin,6619,6,14,6,16,53,63,-10,48
Annan Athlet,6619,7,12,11,13,49,41,8,47
Berwick,6619,8,9,10,17,32,60,-28,37
Edinburgh Ci,6619,9,7,10,19,37,61,-24,31
Cowdenbeath,6619,10,4,10,22,23,56,-33,22
Montrose,6620,1,23,8,5,59,34,25,77
Peterhead,6620,2,23,5,8,77,38,39,74
Stirling,6620,3,17,6,13,62,52,10,57
Clyde,6620,4,15,9,12,54,48,6,54
Stenhousem'r,6620,5,15,8,13,56,48,8,53
Elgin,6620,6,14,7,15,53,60,-7,49
Annan Athlet,6620,7,12,11,13,49,41,8,47
Berwick,6620,8,8,10,18,29,61,-32,34
Edinburgh Ci,6620,9,7,10,19,36,60,-24,31
Cowdenbeath,6620,10,4,10,22,23,56,-33,22
Montrose,6621,1,23,7,6,60,38,22,76
Peterhead,6621,2,23,5,8,79,40,39,74
Stirling,6621,3,17,6,13,61,51,10,57
Stenhousem'r,6621,4,15,8,13,55,47,8,53
Clyde,6621,5,14,10,12,53,50,3,52
Elgin,6621,6,15,6,15,57,61,-4,51
Annan Athlet,6621,7,11,12,13,48,42,6,45
Berwick,6621,8,8,11,17,31,60,-29,35
Edinburgh Ci,6621,9,7,10,19,38,62,-24,31
Cowdenbeath,6621,10,4,11,21,24,55,-31,23
Montrose,6622,1,24,7,5,60,34,26,79
Peterhead,6622,2,24,4,8,78,38,40,76
Stirling,6622,3,17,6,13,65,52,13,57
Clyde,6622,4,15,9,12,54,50,4,54
Stenhousem'r,6622,5,15,8,13,56,51,5,53
Elgin,6622,6,14,6,16,53,61,-8,48
Annan Athlet,6622,7,12,11,13,50,41,9,47
Berwick,6622,8,8,10,18,31,61,-30,34
Edinburgh Ci,6622,9,7,9,20,36,61,-25,30
Cowdenbeath,6622,10,4,10,22,23,57,-34,22
Montrose,6623,1,24,7,5,60,34,26,79
Peterhead,6623,2,24,4,8,79,38,41,76
Stirling,6623,3,17,6,13,61,51,10,57
Clyde,6623,4,15,9,12,55,48,7,54
Stenhousem'r,6623,5,15,8,13,55,47,8,53
Elgin,6623,6,14,6,16,53,61,-8,48
Annan Athlet,6623,7,11,11,14,48,44,4,44
Berwick,6623,8,8,10,18,29,62,-33,34
Edinburgh Ci,6623,9,7,9,20,36,62,-26,30
Cowdenbeath,6623,10,5,10,21,26,55,-29,25
Montrose,6624,1,23,7,6,60,36,24,76
Peterhead,6624,2,23,4,9,77,40,37,73
Stenhousem'r,6624,3,16,8,12,58,46,12,56
Stirling,6624,4,16,6,14,60,54,6,54
Clyde,6624,5,15,9,12,54,50,4,54
Elgin,6624,6,15,6,15,55,61,-6,51
Annan Athlet,6624,7,11,11,14,48,43,5,44
Berwick,6624,8,8,10,18,31,61,-30,34
Edinburgh Ci,6624,9,8,9,19,38,60,-22,33
Cowdenbeath,6624,10,5,10,21,25,55,-30,25
Peterhead,6625,1,24,4,8,80,40,40,76
Montrose,6625,2,23,7,6,60,36,24,76
Stirling,6625,3,17,6,13,62,52,10,57
Clyde,6625,4,15,9,12,54,49,5,54
Stenhousem'r,6625,5,15,8,13,56,48,8,53
Elgin,6625,6,15,6,15,55,61,-6,51
Annan Athlet,6625,7,11,11,14,47,43,4,44
Berwick,6625,8,8,10,18,30,61,-31,34
Edinburgh Ci,6625,9,7,9,20,38,63,-25,30
Cowdenbeath,6625,10,5,10,21,25,54,-29,25
Montrose,6626,1,24,7,5,62,35,27,79
Peterhead,6626,2,24,4,8,80,38,42,76
Stirling,6626,3,17,6,13,62,52,10,57
Clyde,6626,4,15,9,12,54,50,4,54
Stenhousem'r,6626,5,15,8,13,56,48,8,53
Elgin,6626,6,14,6,16,54,63,-9,48
Annan Athlet,6626,7,12,11,13,50,41,9,47
Berwick,6626,8,8,10,18,31,61,-30,34
Edinburgh Ci,6626,9,7,9,20,36,63,-27,30
Cowdenbeath,6626,10,4,10,22,23,57,-34,22
Montrose,6627,1,24,7,5,61,35,26,79
Peterhead,6627,2,23,4,9,77,40,37,73
Stenhousem'r,6627,3,16,8,12,56,46,10,56
Stirling,6627,4,16,6,14,60,52,8,54
Clyde,6627,5,14,10,12,52,49,3,52
Elgin,6627,6,14,6,16,54,62,-8,48
Annan Athlet,6627,7,11,12,13,47,41,6,45
Berwick,6627,8,8,11,17,30,59,-29,35
Edinburgh Ci,6627,9,8,9,19,38,60,-22,33
Cowdenbeath,6627,10,4,11,21,23,54,-31,23
Montrose,6628,1,23,8,5,60,35,25,77
Peterhead,6628,2,24,4,8,78,38,40,76
Stirling,6628,3,16,7,13,61,52,9,55
Stenhousem'r,6628,4,15,9,12,56,47,9,54
Clyde,6628,5,15,9,12,53,48,5,54
Elgin,6628,6,14,7,15,54,61,-7,49
Annan Athlet,6628,7,11,11,14,47,42,5,44
Berwick,6628,8,8,10,18,29,60,-31,34
Edinburgh Ci,6628,9,7,9,20,36,61,-25,30
Cowdenbeath,6628,10,5,10,21,24,54,-30,25
Montrose,6629,1,24,7,5,61,34,27,79
Peterhead,6629,2,24,4,8,82,39,43,76
Stirling,6629,3,17,6,13,62,51,11,57
Stenhousem'r,6629,4,15,8,13,55,48,7,53
Clyde,6629,5,14,9,13,52,51,1,51
Elgin,6629,6,14,6,16,53,62,-9,48
Annan Athlet,6629,7,11,11,14,47,42,5,44
Berwick,6629,8,9,10,17,32,59,-27,37
Edinburgh Ci,6629,9,7,9,20,37,65,-28,30
Cowdenbeath,6629,10,5,10,21,24,54,-30,25
Montrose,6630,1,23,8,5,59,34,25,77
Peterhead,6630,2,23,5,8,79,40,39,74
Stenhousem'r,6630,3,16,8,12,56,46,10,56
Stirling,6630,4,16,6,14,60,52,8,54
Clyde,6630,5,14,10,12,51,48,3,52
Elgin,6630,6,14,7,15,53,60,-7,49
Annan Athlet,6630,7,12,11,13,48,41,7,47
Berwick,6630,8,8,11,17,29,58,-29,35
Edinburgh Ci,6630,9,7,10,19,38,62,-24,31
Cowdenbeath,6630,10,4,10,22,23,55,-32,22
Montrose,6631,1,24,7,5,61,34,27,79
Peterhead,6631,2,24,4,8,79,39,40,76
Stirling,6631,3,16,7,13,62,53,9,55
Stenhousem'r,6631,4,15,9,12,57,48,9,54
Clyde,6631,5,15,9,12,53,48,5,54
Elgin,6631,6,14,6,16,53,62,-9,48
Annan Athlet,6631,7,11,11,14,48,43,5,44
Berwick,6631,8,8,10,18,29,60,-31,34
Edinburgh Ci,6631,9,7,9,20,37,62,-25,30
Cowdenbeath,6631,10,5,10,21,25,55,-30,25
Montrose,6632,1,23,8,5,60,35,25,77
Peterhead,6632,2,23,5,8,79,40,39,74
Stirling,6632,3,16,7,13,60,51,9,55
Stenhousem'r,6632,4,15,9,12,55,46,9,54
Clyde,6632,5,15,9,12,55,50,5,54
Elgin,6632,6,14,7,15,54,61,-7,49
Annan Athlet,6632,7,12,11,13,50,41,9,47
Berwick,6632,8,8,10,18,31,62,-31,34
Edinburgh Ci,6632,9,7,10,19,38,62,-24,31
Cowdenbeath,6632,10,4,10,22,23,57,-34,22
Montrose,6633,1,24,7,5,61,35,26,79
Peterhead,6633,2,23,5,8,80,41,39,74
Stirling,6633,3,17,6,13,63,52,11,57
Stenhousem'r,6633,4,15,8,13,56,49,7,53
Clyde,6633,5,14,9,13,51,49,2,51
Elgin,6633,6,14,6,16,54,62,-8,48
Annan Athlet,6633,7,12,11,13,50,41,9,47
Berwick,6633,8,9,10,17,30,58,-28,37
Edinburgh Ci,6633,9,7,10,19,39,63,-24,31
Cowdenbeath,6633,10,4,10,22,23,57,-34,22
Montrose,6634,1,23,8,5,61,36,25,77
Peterhead,6634,2,24,4,8,79,38,41,76
Stirling,6634,3,17,6,13,64,51,13,57
Stenhousem'r,6634,4,15,8,13,55,50,5,53
Clyde,6634,5,14,9,13,51,51,0,51
Elgin,6634,6,14,7,15,55,62,-7,49
Annan Athlet,6634,7,12,11,13,51,42,9,47
Berwick,6634,8,9,10,17,32,58,-26,37
Edinburgh Ci,6634,9,7,9,20,36,62,-26,30
Cowdenbeath,6634,10,4,10,22,24,58,-34,22
Montrose,6635,1,23,8,5,59,34,25,77
Peterhead,6635,2,23,5,8,78,39,39,74
Stirling,6635,3,17,6,13,64,53,11,57
Clyde,6635,4,15,9,12,56,50,6,54
Stenhousem'r,6635,5,15,8,13,57,50,7,53
Elgin,6635,6,14,7,15,53,60,-7,49
Annan Athlet,6635,7,11,12,13,47,41,6,45
Berwick,6635,8,8,10,18,31,63,-32,34
Edinburgh Ci,6635,9,7,10,19,37,61,-24,31
Cowdenbeath,6635,10,4,11,21,23,54,-31,23
Peterhead,6636,1,24,4,8,81,38,43,76
Montrose,6636,2,23,7,6,60,36,24,76
Stirling,6636,3,17,6,13,64,51,13,57
Clyde,6636,4,15,9,12,54,50,4,54
Stenhousem'r,6636,5,15,8,13,55,50,5,53
Elgin,6636,6,15,6,15,55,61,-6,51
Annan Athlet,6636,7,11,12,13,49,43,6,45
Berwick,6636,8,8,10,18,31,61,-30,34
Edinburgh Ci,6636,9,7,9,20,36,64,-28,30
Cowdenbeath,6636,10,4,11,21,25,56,-31,23
Montrose,6637,1,23,8,5,60,35,25,77
Peterhead,6637,2,24,4,8,79,39,40,76
Stenhousem'r,6637,3,16,8,12,57,47,10,56
Stirling,6637,4,16,6,14,61,53,8,54
Clyde,6637,5,15,9,12,52,48,4,54
Elgin,6637,6,14,7,15,54,61,-7,49
Annan Athlet,6637,7,12,11,13,49,42,7,47
Berwick,6637,8,8,10,18,29,59,-30,34
Edinburgh Ci,6637,9,7,9,20,37,62,-25,30
Cowdenbeath,6637,10,4,10,22,24,56,-32,22
Montrose,6638,1,23,7,6,60,36,24,76
Peterhead,6638,2,23,4,9,77,39,38,73
Stenhousem'r,6638,3,16,8,12,58,48,10,56
Stirling,6638,4,16,6,14,62,54,8,54
Clyde,6638,5,15,9,12,52,48,4,54
Elgin,6638,6,15,6,15,55,61,-6,51
Annan Athlet,6638,7,11,12,13,48,42,6,45
Berwick,6638,8,8,10,18,29,59,-30,34
Edinburgh Ci,6638,9,8,9,19,37,60,-23,33
Cowdenbeath,6638,10,4,11,21,24,55,-31,23
Montrose,6639,1,24,7,5,61,35,26,79
Peterhead,6639,2,24,4,8,81,40,41,76
Stenhousem'r,6639,3,16,8,12,58,46,12,56
Stirling,6639,4,16,6,14,60,54,6,54
Clyde,6639,5,15,9,12,53,48,5,54
Elgin,6639,6,14,6,16,54,62,-8,48
Annan Athlet,6639,7,11,11,14,49,44,5,44
Berwick,6639,8,8,10,18,29,60,-31,34
Edinburgh Ci,6639,9,7,9,20,38,64,-26,30
Cowdenbeath,6639,10,5,10,21,26,56,-30,25
Montrose,6640,1,24,7,5,61,34,27,79
Peterhead,6640,2,24,4,8,79,39,40,76
Stirling,6640,3,17,6,13,61,51,10,57
Clyde,6640,4,15,9,12,55,48,7,54
Stenhousem'r,6640,5,15,8,13,55,47,8,53
Elgin,6640,6,14,6,16,53,62,-9,48
Annan Athlet,6640,7,12,11,13,49,42,7,47
Berwick,6640,8,8,10,18,29,62,-33,34
Edinburgh Ci,6640,9,7,9,20,37,62,-25,30
Cowdenbeath,6640,10,4,10,22,24,56,-32,22
Montrose,6641,1,24,7,5,61,35,26,79
Peterhead,6641,2,24,4,8,81,41,40,76
Stirling,6641,3,17,6,13,62,51,11,57
Clyde,6641,4,15,9,12,54,48,6,54
Stenhousem'r,6641,5,15,8,13,55,48,7,53
Elgin,6641,6,14,6,16,54,62,-8,48
Annan Athlet,6641,7,12,11,13,48,41,7,47
Berwick,6641,8,8,10,18,29,61,-32,34
Edinburgh Ci,6641,9,7,9,20,39,64,-25,30
Cowdenbeath,6641,10,4,10,22,23,55,-32,22
Montrose,6642,1,24,7,5,60,34,26,79
Peterhead,6642,2,24,4,8,79,38,41,76
Stirling,6642,3,17,6,13,61,51,10,57
Clyde,6642,4,15,9,12,55,49,6,54
Stenhousem'r,6642,5,15,8,13,55,47,8,53
Elgin,6642,6,14,6,16,53,61,-8,48
Annan Athlet,6642,7,11,12,13,47,41,6,45
Berwick,6642,8,8,10,18,30,62,-32,34
Edinburgh Ci,6642,9,7,9,20,36,62,-26,30
Cowdenbeath,6642,10,4,11,21,23,54,-31,23
Peterhead,6643,1,24,4,8,82,40,42,76
Montrose,6643,2,23,7,6,61,37,24,76
Stirling,6643,3,17,6,13,63,51,12,57
Clyde,6643,4,15,9,12,53,48,5,54
Stenhousem'r,6643,5,15,8,13,55,49,6,53
Elgin,6643,6,15,6,15,56,62,-6,51
Annan Athlet,6643,7,11,11,14,48,44,4,44
Berwick,6643,8,8,10,18,29,60,-31,34
Edinburgh Ci,6643,9,7,9,20,38,65,-27,30
Cowdenbeath,6643,10,5,10,21,26,55,-29,25
Montrose,6644,1,24,7,5,61,34,27,79
Peterhead,6644,2,24,4,8,82,39,43,76
Stirling,6644,3,17,6,13,63,53,10,57
Stenhousem'r,6644,4,15,8,13,57,49,8,53
Clyde,6644,5,14,10,12,52,49,3,52
Elgin,6644,6,14,6,16,53,62,-9,48
Annan Athlet,6644,7,11,12,13,48,42,6,45
Berwick,6644,8,8,11,17,30,59,-29,35
Edinburgh Ci,6644,9,7,9,20,37,65,-28,30
Cowdenbeath,6644,10,4,11,21,24,55,-31,23
Montrose,6645,1,24,7,5,62,35,27,79
Peterhead,6645,2,24,4,8,79,39,40,76
Stirling,6645,3,17,6,13,61,51,10,57
Stenhousem'r,6645,4,15,8,13,55,47,8,53
Clyde,6645,5,14,10,12,53,50,3,52
Elgin,6645,6,14,6,16,54,63,-9,48
Annan Athlet,6645,7,11,11,14,47,44,3,44
Berwick,6645,8,8,11,17,31,60,-29,35
Edinburgh Ci,6645,9,7,9,20,37,62,-25,30
Cowdenbeath,6645,10,5,10,21,26,54,-28,25
Montrose,6646,1,24,7,5,62,34,28,79
Peterhead,6646,2,24,4,8,79,38,41,76
Stirling,6646,3,17,6,13,63,52,11,57
Stenhousem'r,6646,4,15,8,13,56,49,7,53
Clyde,6646,5,14,10,12,52,49,3,52
Elgin,6646,6,14,6,16,53,63,-10,48
Annan Athlet,6646,7,11,11,14,48,43,5,44
Berwick,6646,8,8,11,17,30,59,-29,35
Edinburgh Ci,6646,9,7,9,20,36,62,-26,30
Cowdenbeath,6646,10,5,10,21,25,55,-30,25
Montrose,6647,1,24,7,5,61,35,26,79
Peterhead,6647,2,24,4,8,83,38,45,76
Stirling,6647,3,17,6,13,61,51,10,57
Stenhousem'r,6647,4,15,8,13,55,47,8,53
Clyde,6647,5,14,9,13,51,49,2,51
Elgin,6647,6,14,6,16,54,62,-8,48
Annan Athlet,6647,7,11,12,13,49,43,6,45
Berwick,6647,8,9,10,17,30,58,-28,37
Edinburgh Ci,6647,9,7,9,20,36,66,-30,30
Cowdenbeath,6647,10,4,11,21,25,56,-31,23
Montrose,6648,1,24,7,5,61,34,27,79
Peterhead,6648,2,24,4,8,80,38,42,76
Stenhousem'r,6648,3,16,8,12,57,47,10,56
Stirling,6648,4,16,6,14,61,53,8,54
Clyde,6648,5,15,9,12,53,49,4,54
Elgin,6648,6,14,6,16,53,62,-9,48
Annan Athlet,6648,7,12,11,13,48,41,7,47
Berwick,6648,8,8,10,18,30,60,-30,34
Edinburgh Ci,6648,9,7,9,20,36,63,-27,30
Cowdenbeath,6648,10,4,10,22,23,55,-32,22
Montrose,6649,1,24,7,5,62,34,28,79
Peterhead,6649,2,24,4,8,79,38,41,76
Stenhousem'r,6649,3,16,8,12,57,47,10,56
Stirling,6649,4,16,6,14,61,53,8,54
Clyde,6649,5,15,9,12,52,48,4,54
Elgin,6649,6,14,6,16,53,63,-10,48
Annan Athlet,6649,7,11,11,14,47,43,4,44
Berwick,6649,8,8,10,18,29,59,-30,34
Edinburgh Ci,6649,9,7,9,20,36,62,-26,30
Cowdenbeath,6649,10,5,10,21,25,54,-29,25
Montrose,6650,1,24,7,5,63,35,28,79
Peterhead,6650,2,23,4,9,77,39,38,73
Stirling,6650,3,17,6,13,61,51,10,57
Stenhousem'r,6650,4,15,8,13,55,47,8,53
Clyde,6650,5,14,9,13,51,49,2,51
Elgin,6650,6,14,6,16,54,64,-10,48
Annan Athlet,6650,7,11,12,13,48,42,6,45
Berwick,6650,8,9,10,17,30,58,-28,37
Edinburgh Ci,6650,9,8,9,19,37,60,-23,33
Cowdenbeath,6650,10,4,11,21,24,55,-31,23
Montrose,6651,1,24,7,5,61,35,26,79
Peterhead,6651,2,23,5,8,78,39,39,74
Stenhousem'r,6651,3,16,8,12,56,46,10,56
Stirling,6651,4,16,6,14,60,52,8,54
Clyde,6651,5,15,9,12,54,50,4,54
Elgin,6651,6,14,6,16,54,62,-8,48
Annan Athlet,6651,7,12,11,13,48,41,7,47
Berwick,6651,8,8,10,18,31,61,-30,34
Edinburgh Ci,6651,9,7,10,19,37,61,-24,31
Cowdenbeath,6651,10,4,10,22,23,55,-32,22
Montrose,6652,1,24,7,5,62,35,27,79
Peterhead,6652,2,24,4,8,81,40,41,76
Stenhousem'r,6652,3,16,8,12,57,47,10,56
Stirling,6652,4,16,6,14,61,53,8,54
Clyde,6652,5,15,9,12,52,48,4,54
Elgin,6652,6,14,6,16,54,63,-9,48
Annan Athlet,6652,7,12,11,13,48,41,7,47
Berwick,6652,8,8,10,18,29,59,-30,34
Edinburgh Ci,6652,9,7,9,20,38,64,-26,30
Cowdenbeath,6652,10,4,10,22,23,55,-32,22
Montrose,6653,1,24,7,5,60,34,26,79
Peterhead,6653,2,24,4,8,80,38,42,76
Stirling,6653,3,17,6,13,62,51,11,57
Clyde,6653,4,15,9,12,54,48,6,54
Stenhousem'r,6653,5,15,8,13,55,48,7,53
Elgin,6653,6,14,6,16,53,61,-8,48
Annan Athlet,6653,7,12,11,13,48,41,7,47
Berwick,6653,8,8,10,18,29,61,-32,34
Edinburgh Ci,6653,9,7,9,20,36,63,-27,30
Cowdenbeath,6653,10,4,10,22,23,55,-32,22
Montrose,6654,1,24,7,5,63,37,26,79
Peterhead,6654,2,23,5,8,78,39,39,74
Stirling,6654,3,17,6,13,62,52,10,57
Clyde,6654,4,15,9,12,54,48,6,54
Stenhousem'r,6654,5,15,8,13,56,48,8,53
Elgin,6654,6,14,6,16,56,64,-8,48
Annan Athlet,6654,7,12,11,13,52,43,9,47
Berwick,6654,8,8,10,18,29,61,-32,34
Edinburgh Ci,6654,9,7,10,19,37,61,-24,31
Cowdenbeath,6654,10,4,10,22,25,59,-34,22
Montrose,6655,1,24,7,5,64,35,29,79
Peterhead,6655,2,24,4,8,80,38,42,76
Stirling,6655,3,17,6,13,61,51,10,57
Stenhousem'r,6655,4,15,8,13,55,47,8,53
Clyde,6655,5,14,10,12,51,48,3,52
Elgin,6655,6,14,6,16,54,65,-11,48
Annan Athlet,6655,7,11,12,13,48,42,6,45
Berwick,6655,8,8,11,17,29,58,-29,35
Edinburgh Ci,6655,9,7,9,20,36,63,-27,30
Cowdenbeath,6655,10,4,11,21,24,55,-31,23
Montrose,6656,1,24,7,5,61,34,27,79
Peterhead,6656,2,24,4,8,81,38,43,76
Stirling,6656,3,17,6,13,62,51,11,57
Stenhousem'r,6656,4,15,8,13,55,48,7,53
Clyde,6656,5,14,10,12,53,50,3,52
Elgin,6656,6,14,6,16,53,62,-9,48
Annan Athlet,6656,7,11,11,14,48,44,4,44
Berwick,6656,8,8,11,17,31,60,-29,35
Edinburgh Ci,6656,9,7,9,20,36,64,-28,30
Cowdenbeath,6656,10,5,10,21,26,55,-29,25
Montrose,6657,1,24,7,5,60,34,26,79
Peterhead,6657,2,24,4,8,79,38,41,76
Stirling,6657,3,17,6,13,61,51,10,57
Stenhousem'r,6657,4,15,8,13,55,47,8,53
Clyde,6657,5,14,10,12,54,51,3,52
Elgin,6657,6,14,6,16,53,61,-8,48
Annan Athlet,6657,7,12,11,13,49,42,7,47
Berwick,6657,8,8,11,17,32,61,-29,35
Edinburgh Ci,6657,9,7,9,20,36,62,-26,30
Cowdenbeath,6657,10,4,10,22,24,56,-32,22
Montrose,6658,1,23,7,6,60,37,23,76
Peterhead,6658,2,23,4,9,80,43,37,73
Stirling,6658,3,17,6,13,63,52,11,57
Clyde,6658,4,15,9,12,55,48,7,54
Stenhousem'r,6658,5,15,8,13,56,49,7,53
Elgin,6658,6,15,6,15,56,61,-5,51
Annan Athlet,6658,7,12,11,13,48,41,7,47
Berwick,6658,8,8,10,18,29,62,-33,34
Edinburgh Ci,6658,9,8,9,19,41,63,-22,33
Cowdenbeath,6658,10,4,10,22,23,55,-32,22
Montrose,6659,1,24,7,5,61,35,26,79
Peterhead,6659,2,24,4,8,80,39,41,76
Stirling,6659,3,17,6,13,62,52,10,57
Clyde,6659,4,15,9,12,54,49,5,54
Stenhousem'r,6659,5,15,8,13,56,48,8,53
Elgin,6659,6,14,6,16,54,62,-8,48
Annan Athlet,6659,7,11,12,13,49,43,6,45
Berwick,6659,8,8,10,18,30,61,-31,34
Edinburgh Ci,6659,9,7,9,20,37,63,-26,30
Cowdenbeath,6659,10,4,11,21,25,56,-31,23
Montrose,6660,1,24,7,5,62,34,28,79
Peterhead,6660,2,23,5,8,78,39,39,74
Stirling,6660,3,17,6,13,62,52,10,57
Stenhousem'r,6660,4,15,8,13,56,48,8,53
Clyde,6660,5,14,10,12,53,50,3,52
Elgin,6660,6,14,6,16,53,63,-10,48
Annan Athlet,6660,7,12,11,13,50,42,8,47
Berwick,6660,8,8,11,17,31,60,-29,35
Edinburgh Ci,6660,9,7,10,19,37,61,-24,31
Cowdenbeath,6660,10,4,10,22,24,57,-33,22
Montrose,6661,1,23,8,5,61,36,25,77
Peterhead,6661,2,24,4,8,79,38,41,76
Stirling,6661,3,16,7,13,61,52,9,55
Stenhousem'r,6661,4,15,9,12,56,47,9,54
Clyde,6661,5,15,9,12,52,48,4,54
Elgin,6661,6,14,7,15,55,62,-7,49
Annan Athlet,6661,7,11,11,14,47,43,4,44
Berwick,6661,8,8,10,18,29,59,-30,34
Edinburgh Ci,6661,9,7,9,20,36,62,-26,30
Cowdenbeath,6661,10,5,10,21,25,54,-29,25
Montrose,6662,1,23,8,5,60,35,25,77
Peterhead,6662,2,24,4,8,81,39,42,76
Stirling,6662,3,17,6,13,63,51,12,57
Clyde,6662,4,15,9,12,53,48,5,54
Stenhousem'r,6662,5,15,8,13,55,49,6,53
Elgin,6662,6,14,7,15,54,61,-7,49
Annan Athlet,6662,7,12,11,13,48,41,7,47
Berwick,6662,8,8,10,18,29,60,-31,34
Edinburgh Ci,6662,9,7,9,20,37,64,-27,30
Cowdenbeath,6662,10,4,10,22,23,55,-32,22
Peterhead,6663,1,24,4,8,79,39,40,76
Montrose,6663,2,23,7,6,59,35,24,76
Stirling,6663,3,17,6,13,62,52,10,57
Clyde,6663,4,15,9,12,53,48,5,54
Stenhousem'r,6663,5,15,8,13,56,48,8,53
Elgin,6663,6,15,6,15,54,60,-6,51
Annan Athlet,6663,7,11,11,14,49,44,5,44
Berwick,6663,8,8,10,18,29,60,-31,34
Edinburgh Ci,6663,9,7,9,20,37,62,-25,30
Cowdenbeath,6663,10,5,10,21,26,56,-30,25
Montrose,6664,1,23,8,5,61,36,25,77
Peterhead,6664,2,24,4,8,82,40,42,76
Stirling,6664,3,16,7,13,63,54,9,55
Stenhousem'r,6664,4,15,9,12,58,49,9,54
Clyde,6664,5,15,9,12,53,48,5,54
Elgin,6664,6,14,7,15,55,62,-7,49
Annan Athlet,6664,7,12,11,13,49,41,8,47
Berwick,6664,8,8,10,18,29,60,-31,34
Edinburgh Ci,6664,9,7,9,20,38,65,-27,30
Cowdenbeath,6664,10,4,10,22,23,56,-33,22
Montrose,6665,1,24,7,5,61,35,26,79
Peterhead,6665,2,24,4,8,79,39,40,76
Stirling,6665,3,17,6,13,62,52,10,57
Clyde,6665,4,15,9,12,57,49,8,54
Stenhousem'r,6665,5,15,8,13,56,48,8,53
Elgin,6665,6,14,6,16,54,62,-8,48
Annan Athlet,6665,7,11,12,13,49,43,6,45
Berwick,6665,8,8,10,18,30,64,-34,34
Edinburgh Ci,6665,9,7,9,20,37,62,-25,30
Cowdenbeath,6665,10,4,11,21,25,56,-31,23
Montrose,6666,1,24,7,5,63,35,28,79
Peterhead,6666,2,24,4,8,81,39,42,76
Stenhousem'r,6666,3,16,8,12,56,46,10,56
Stirling,6666,4,16,6,14,60,52,8,54
Clyde,6666,5,15,9,12,53,48,5,54
Elgin,6666,6,14,6,16,54,64,-10,48
Annan Athlet,6666,7,12,11,13,49,42,7,47
Berwick,6666,8,8,10,18,29,60,-31,34
Edinburgh Ci,6666,9,7,9,20,37,64,-27,30
Cowdenbeath,6666,10,4,10,22,24,56,-32,22
Montrose,6667,1,24,7,5,61,35,26,79
Peterhead,6667,2,24,4,8,80,39,41,76
Stirling,6667,3,17,6,13,62,51,11,57
Clyde,6667,4,15,9,12,52,48,4,54
Stenhousem'r,6667,5,15,8,13,55,48,7,53
Elgin,6667,6,14,6,16,54,62,-8,48
Annan Athlet,6667,7,11,11,14,47,42,5,44
Berwick,6667,8,8,10,18,29,59,-30,34
Edinburgh Ci,6667,9,7,9,20,37,63,-26,30
Cowdenbeath,6667,10,5,10,21,24,54,-30,25
Montrose,6668,1,24,7,5,61,34,27,79
Peterhead,6668,2,23,4,9,77,41,36,73
Stirling,6668,3,17,6,13,61,51,10,57
Clyde,6668,4,15,9,12,56,50,6,54
Stenhousem'r,6668,5,15,8,13,55,47,8,53
Elgin,6668,6,14,6,16,53,62,-9,48
Annan Athlet,6668,7,11,11,14,48,43,5,44
Berwick,6668,8,8,10,18,31,63,-32,34
Edinburgh Ci,6668,9,8,9,19,39,60,-21,33
Cowdenbeath,6668,10,5,10,21,25,55,-30,25
Montrose,6669,1,24,7,5,61,35,26,79
Peterhead,6669,2,24,4,8,79,39,40,76
Stirling,6669,3,16,7,13,61,52,9,55
Stenhousem'r,6669,4,15,9,12,56,47,9,54
Clyde,6669,5,15,9,12,53,48,5,54
Elgin,6669,6,14,6,16,54,62,-8,48
Annan Athlet,6669,7,12,11,13,48,41,7,47
Berwick,6669,8,8,10,18,29,60,-31,34
Edinburgh Ci,6669,9,7,9,20,37,62,-25,30
Cowdenbeath,6669,10,4,10,22,23,55,-32,22
Montrose,6670,1,24,7,5,61,34,27,79
Peterhead,6670,2,24,4,8,79,38,41,76
Stirling,6670,3,17,6,13,61,51,10,57
Stenhousem'r,6670,4,15,8,13,55,47,8,53
Clyde,6670,5,14,9,13,52,51,1,51
Elgin,6670,6,14,6,16,53,62,-9,48
Annan Athlet,6670,7,12,11,13,50,43,7,47
Berwick,6670,8,9,10,17,32,59,-27,37
Edinburgh Ci,6670,9,7,9,20,36,62,-26,30
Cowdenbeath,6670,10,4,10,22,25,57,-32,22
Montrose,6671,1,23,8,5,60,35,25,77
Peterhead,6671,2,24,4,8,81,39,42,76
Stirling,6671,3,16,7,13,61,52,9,55
Stenhousem'r,6671,4,15,9,12,56,47,9,54
Clyde,6671,5,14,10,12,51,48,3,52
Elgin,6671,6,14,7,15,54,61,-7,49
Annan Athlet,6671,7,11,12,13,48,42,6,45
Berwick,6671,8,8,11,17,29,58,-29,35
Edinburgh Ci,6671,9,7,9,20,37,64,-27,30
Cowdenbeath,6671,10,4,11,21,24,55,-31,23
Montrose,6672,1,24,7,5,61,35,26,79
Peterhead,6672,2,24,4,8,80,39,41,76
Stirling,6672,3,16,7,13,62,53,9,55
Stenhousem'r,6672,4,15,9,12,57,48,9,54
Clyde,6672,5,14,10,12,52,49,3,52
Elgin,6672,6,14,6,16,54,62,-8,48
Annan Athlet,6672,7,11,11,14,48,44,4,44
Berwick,6672,8,8,11,17,30,59,-29,35
Edinburgh Ci,6672,9,7,9,20,37,63,-26,30
Cowdenbeath,6672,10,5,10,21,26,55,-29,25
Montrose,6673,1,24,7,5,63,37,26,79
Peterhead,6673,2,24,4,8,79,39,40,76
Stirling,6673,3,17,6,13,62,51,11,57
Stenhousem'r,6673,4,15,8,13,55,48,7,53
Clyde,6673,5,14,9,13,52,50,2,51
Elgin,6673,6,14,6,16,56,64,-8,48
Annan Athlet,6673,7,12,11,13,52,42,10,47
Berwick,6673,8,9,10,17,31,59,-28,37
Edinburgh Ci,6673,9,7,9,20,37,62,-25,30
Cowdenbeath,6673,10,4,10,22,24,59,-35,22
Peterhead,6674,1,24,4,8,80,39,41,76
Montrose,6674,2,23,7,6,59,35,24,76
Stirling,6674,3,17,6,13,62,51,11,57
Stenhousem'r,6674,4,15,8,13,55,48,7,53
Clyde,6674,5,14,9,13,51,49,2,51
Elgin,6674,6,15,6,15,54,60,-6,51
Annan Athlet,6674,7,11,12,13,49,43,6,45
Berwick,6674,8,9,10,17,30,58,-28,37
Edinburgh Ci,6674,9,7,9,20,37,63,-26,30
Cowdenbeath,6674,10,4,11,21,25,56,-31,23
Montrose,6675,1,24,7,5,61,35,26,79
Peterhead,6675,2,24,4,8,79,39,40,76
Stirling,6675,3,17,6,13,64,52,12,57
Stenhousem'r,6675,4,15,8,13,56,50,6,53
Clyde,6675,5,14,10,12,51,48,3,52
Elgin,6675,6,14,6,16,54,62,-8,48
Annan Athlet,6675,7,12,11,13,48,41,7,47
Berwick,6675,8,8,11,17,29,58,-29,35
Edinburgh Ci,6675,9,7,9,20,37,62,-25,30
Cowdenbeath,6675,10,4,10,22,23,55,-32,22
Montrose,6676,1,24,7,5,62,34,28,79
Peterhead,6676,2,24,4,8,79,38,41,76
Stenhousem'r,6676,3,16,8,12,58,48,10,56
Stirling,6676,4,16,6,14,62,54,8,54
Clyde,6676,5,15,9,12,54,48,6,54
Elgin,6676,6,14,6,16,53,63,-10,48
Annan Athlet,6676,7,11,12,13,47,41,6,45
Berwick,6676,8,8,10,18,29,61,-32,34
Edinburgh Ci,6676,9,7,9,20,36,62,-26,30
Cowdenbeath,6676,10,4,11,21,23,54,-31,23
Montrose,6677,1,24,7,5,60,34,26,79
Peterhead,6677,2,23,4,9,78,40,38,73
Stirling,6677,3,16,7,13,61,52,9,55
Stenhousem'r,6677,4,15,9,12,56,47,9,54
Clyde,6677,5,15,9,12,53,49,4,54
Elgin,6677,6,14,6,16,53,61,-8,48
Annan Athlet,6677,7,11,11,14,47,42,5,44
Berwick,6677,8,8,10,18,30,60,-30,34
Edinburgh Ci,6677,9,8,9,19,38,61,-23,33
Cowdenbeath,6677,10,5,10,21,24,54,-30,25
Montrose,6678,1,24,7,5,63,34,29,79
Peterhead,6678,2,24,4,8,81,40,41,76
Stirling,6678,3,17,6,13,64,53,11,57
Clyde,6678,4,15,9,12,54,50,4,54
Stenhousem'r,6678,5,15,8,13,57,50,7,53
Elgin,6678,6,14,6,16,53,64,-11,48
Annan Athlet,6678,7,11,12,13,48,42,6,45
Berwick,6678,8,8,10,18,31,61,-30,34
Edinburgh Ci,6678,9,7,9,20,38,64,-26,30
Cowdenbeath,6678,10,4,11,21,24,55,-31,23
Montrose,6679,1,24,7,5,61,35,26,79
Peterhead,6679,2,24,4,8,79,39,40,76
Stirling,6679,3,17,6,13,62,51,11,57
Clyde,6679,4,15,9,12,54,49,5,54
Stenhousem'r,6679,5,15,8,13,55,48,7,53
Elgin,6679,6,14,6,16,54,62,-8,48
Annan Athlet,6679,7,11,11,14,47,42,5,44
Berwick,6679,8,8,10,18,30,61,-31,34
Edinburgh Ci,6679,9,7,9,20,37,62,-25,30
Cowdenbeath,6679,10,5,10,21,24,54,-30,25
Montrose,6680,1,24,7,5,62,35,27,79
Peterhead,6680,2,23,4,9,77,39,38,73
Stirling,6680,3,17,6,13,65,51,14,57
Clyde,6680,4,15,9,12,52,48,4,54
Stenhousem'r,6680,5,15,8,13,55,51,4,53
Elgin,6680,6,14,6,16,54,63,-9,48
Annan Athlet,6680,7,11,12,13,50,44,6,45
Berwick,6680,8,8,10,18,29,59,-30,34
Edinburgh Ci,6680,9,8,9,19,37,60,-23,33
Cowdenbeath,6680,10,4,11,21,26,57,-31,23
Montrose,6681,1,24,7,5,63,34,29,79
Peterhead,6681,2,23,5,8,78,39,39,74
Stirling,6681,3,16,7,13,61,52,9,55
Stenhousem'r,6681,4,15,9,12,56,47,9,54
Clyde,6681,5,15,9,12,54,49,5,54
Elgin,6681,6,14,6,16,53,64,-11,48
Annan Athlet,6681,7,11,12,13,49,43,6,45
Berwick,6681,8,8,10,18,30,61,-31,34
Edinburgh Ci,6681,9,7,10,19,37,61,-24,31
Cowdenbeath,6681,10,4,11,21,25,56,-31,23
Montrose,6682,1,24,7,5,64,35,29,79
Peterhead,6682,2,23,4,9,77,39,38,73
Stirling,6682,3,17,6,13,62,51,11,57
Clyde,6682,4,15,9,12,55,48,7,54
Stenhousem'r,6682,5,15,8,13,55,48,7,53
Elgin,6682,6,14,6,16,54,65,-11,48
Annan Athlet,6682,7,11,12,13,47,41,6,45
Berwick,6682,8,8,10,18,29,62,-33,34
Edinburgh Ci,6682,9,8,9,19,37,60,-23,33
Cowdenbeath,6682,10,4,11,21,23,54,-31,23
Montrose,6683,1,23,8,5,59,34,25,77
Peterhead,6683,2,24,4,8,82,40,42,76
Stirling,6683,3,17,6,13,63,52,11,57
Stenhousem'r,6683,4,15,8,13,56,49,7,53
Clyde,6683,5,14,9,13,51,49,2,51
Elgin,6683,6,14,7,15,53,60,-7,49
Annan Athlet,6683,7,11,12,13,49,43,6,45
Berwick,6683,8,9,10,17,30,58,-28,37
Edinburgh Ci,6683,9,7,9,20,38,65,-27,30
Cowdenbeath,6683,10,4,11,21,25,56,-31,23
Montrose,6684,1,24,7,5,63,37,26,79
Peterhead,6684,2,24,4,8,81,40,41,76
Stenhousem'r,6684,3,16,8,12,58,46,12,56
Stirling,6684,4,16,6,14,60,54,6,54
Clyde,6684,5,15,9,12,52,48,4,54
Elgin,6684,6,14,6,16,56,64,-8,48
Annan Athlet,6684,7,12,11,13,48,41,7,47
Berwick,6684,8,8,10,18,29,59,-30,34
Edinburgh Ci,6684,9,7,9,20,38,64,-26,30
Cowdenbeath,6684,10,4,10,22,23,55,-32,22
Montrose,6685,1,23,8,5,61,36,25,77
Peterhead,6685,2,24,4,8,81,40,41,76
Stirling,6685,3,17,6,13,62,51,11,57
Stenhousem'r,6685,4,15,8,13,55,48,7,53
Clyde,6685,5,14,9,13,52,50,2,51
Elgin,6685,6,14,7,15,55,62,-7,49
Annan Athlet,6685,7,12,11,13,48,41,7,47
Berwick,6685,8,9,10,17,31,59,-28,37
Edinburgh Ci,6685,9,7,9,20,38,64,-26,30
Cowdenbeath,6685,10,4,10,22,23,55,-32,22
Montrose,6686,1,23,8,5,60,35,25,77
Peterhead,6686,2,24,4,8,78,38,40,76
Stirling,6686,3,17,6,13,62,52,10,57
Clyde,6686,4,15,9,12,54,49,5,54
Stenhousem'r,6686,5,15,8,13,56,48,8,53
Elgin,6686,6,14,7,15,54,61,-7,49
Annan Athlet,6686,7,12,11,13,49,42,7,47
Berwick,6686,8,8,10,18,30,61,-31,34
Edinburgh Ci,6686,9,7,9,20,36,61,-25,30
Cowdenbeath,6686,10,4,10,22,24,56,-32,22
Peterhead,6687,1,24,4,8,79,38,41,76
Montrose,6687,2,23,7,6,59,35,24,76
Stirling,6687,3,17,6,13,63,52,11,57
Clyde,6687,4,15,9,12,53,48,5,54
Stenhousem'r,6687,5,15,8,13,56,49,7,53
Elgin,6687,6,15,6,15,54,60,-6,51
Annan Athlet,6687,7,12,11,13,48,41,7,47
Berwick,6687,8,8,10,18,29,60,-31,34
Edinburgh Ci,6687,9,7,9,20,36,62,-26,30
Cowdenbeath,6687,10,4,10,22,23,55,-32,22
Montrose,6688,1,24,7,5,61,35,26,79
Peterhead,6688,2,24,4,8,81,38,43,76
Stirling,6688,3,17,6,13,62,52,10,57
Clyde,6688,4,15,9,12,52,48,4,54
Stenhousem'r,6688,5,15,8,13,56,48,8,53
Elgin,6688,6,14,6,16,54,62,-8,48
Annan Athlet,6688,7,11,12,13,48,42,6,45
Berwick,6688,8,8,10,18,29,59,-30,34
Edinburgh Ci,6688,9,7,9,20,36,64,-28,30
Cowdenbeath,6688,10,4,11,21,24,55,-31,23
Montrose,6689,1,24,7,5,61,35,26,79
Peterhead,6689,2,24,4,8,80,38,42,76
Stirling,6689,3,17,6,13,61,51,10,57
Stenhousem'r,6689,4,15,8,13,55,47,8,53
Clyde,6689,5,14,10,12,51,48,3,52
Elgin,6689,6,14,6,16,54,62,-8,48
Annan Athlet,6689,7,12,11,13,48,41,7,47
Berwick,6689,8,8,11,17,29,58,-29,35
Edinburgh Ci,6689,9,7,9,20,36,63,-27,30
Cowdenbeath,6689,10,4,10,22,23,55,-32,22
Montrose,6690,1,24,7,5,62,36,26,79
Peterhead,6690,2,24,4,8,79,38,41,76
Stenhousem'r,6690,3,16,8,12,58,46,12,56
Stirling,6690,4,16,6,14,60,54,6,54
Clyde,6690,5,15,9,12,54,49,5,54
Elgin,6690,6,14,6,16,55,63,-8,48
Annan Athlet,6690,7,12,11,13,50,43,7,47
Berwick,6690,8,8,10,18,30,61,-31,34
Edinburgh Ci,6690,9,7,9,20,36,62,-26,30
Cowdenbeath,6690,10,4,10,22,25,57,-32,22
Montrose,6691,1,23,8,5,60,35,25,77
Peterhead,6691,2,24,4,8,83,40,43,76
Stirling,6691,3,16,7,13,60,51,9,55
Stenhousem'r,6691,4,15,9,12,55,46,9,54
Clyde,6691,5,15,9,12,53,49,4,54
Elgin,6691,6,14,7,15,54,61,-7,49
Annan Athlet,6691,7,12,11,13,48,41,7,47
Berwick,6691,8,8,10,18,30,60,-30,34
Edinburgh Ci,6691,9,7,9,20,38,66,-28,30
Cowdenbeath,6691,10,4,10,22,23,55,-32,22
Montrose,6692,1,24,7,5,63,36,27,79
Peterhead,6692,2,24,4,8,81,40,41,76
Stenhousem'r,6692,3,16,8,12,58,46,12,56
Stirling,6692,4,16,6,14,60,54,6,54
Clyde,6692,5,15,9,12,54,48,6,54
Elgin,6692,6,14,6,16,55,64,-9,48
Annan Athlet,6692,7,11,12,13,48,42,6,45
Berwick,6692,8,8,10,18,29,61,-32,34
Edinburgh Ci,6692,9,7,9,20,38,64,-26,30
Cowdenbeath,6692,10,4,11,21,24,55,-31,23
Montrose,6693,1,23,8,5,59,34,25,77
Peterhead,6693,2,24,4,8,81,39,42,76
Stenhousem'r,6693,3,16,8,12,56,46,10,56
Stirling,6693,4,16,6,14,60,52,8,54
Clyde,6693,5,15,9,12,52,48,4,54
Elgin,6693,6,14,7,15,53,60,-7,49
Annan Athlet,6693,7,11,12,13,48,42,6,45
Berwick,6693,8,8,10,18,29,59,-30,34
Edinburgh Ci,6693,9,7,9,20,37,64,-27,30
Cowdenbeath,6693,10,4,11,21,24,55,-31,23
Montrose,6694,1,24,7,5,61,35,26,79
Peterhead,6694,2,24,4,8,80,39,41,76
Stirling,6694,3,16,7,13,63,54,9,55
Stenhousem'r,6694,4,15,9,12,58,49,9,54
Clyde,6694,5,15,9,12,55,48,7,54
Elgin,6694,6,14,6,16,54,62,-8,48
Annan Athlet,6694,7,11,11,14,47,44,3,44
Berwick,6694,8,8,10,18,29,62,-33,34
Edinburgh Ci,6694,9,7,9,20,37,63,-26,30
Cowdenbeath,6694,10,5,10,21,26,54,-28,25
Peterhead,6695,1,24,4,8,81,39,42,76
Montrose,6695,2,23,7,6,60,36,24,76
Stirling,6695,3,17,6,13,62,52,10,57
Clyde,6695,4,15,9,12,54,49,5,54
Stenhousem'r,6695,5,15,8,13,56,48,8,53
Elgin,6695,6,15,6,15,55,61,-6,51
Annan Athlet,6695,7,12,11,13,48,41,7,47
Berwick,6695,8,8,10,18,30,61,-31,34
Edinburgh Ci,6695,9,7,9,20,37,64,-27,30
Cowdenbeath,6695,10,4,10,22,23,55,-32,22
Montrose,6696,1,24,7,5,60,34,26,79
Peterhead,6696,2,23,5,8,78,39,39,74
Stirling,6696,3,17,6,13,63,53,10,57
Clyde,6696,4,15,9,12,54,49,5,54
Stenhousem'r,6696,5,15,8,13,57,49,8,53
Elgin,6696,6,14,6,16,53,61,-8,48
Annan Athlet,6696,7,11,12,13,49,43,6,45
Berwick,6696,8,8,10,18,30,61,-31,34
Edinburgh Ci,6696,9,7,10,19,37,61,-24,31
Cowdenbeath,6696,10,4,11,21,25,56,-31,23
Montrose,6697,1,23,7,6,59,35,24,76
Peterhead,6697,2,23,5,8,78,39,39,74
Stirling,6697,3,16,7,13,61,52,9,55
Stenhousem'r,6697,4,15,9,12,56,47,9,54
Clyde,6697,5,15,9,12,53,49,4,54
Elgin,6697,6,15,6,15,54,60,-6,51
Annan Athlet,6697,7,11,12,13,48,42,6,45
Berwick,6697,8,8,10,18,30,60,-30,34
Edinburgh Ci,6697,9,7,10,19,37,61,-24,31
Cowdenbeath,6697,10,4,11,21,24,55,-31,23
Montrose,6698,1,24,7,5,66,34,32,79
Peterhead,6698,2,24,4,8,79,38,41,76
Stirling,6698,3,17,6,13,61,51,10,57
Clyde,6698,4,15,9,12,52,48,4,54
Stenhousem'r,6698,5,15,8,13,55,47,8,53
Elgin,6698,6,14,6,16,53,67,-14,48
Annan Athlet,6698,7,12,11,13,50,43,7,47
Berwick,6698,8,8,10,18,29,59,-30,34
Edinburgh Ci,6698,9,7,9,20,36,62,-26,30
Cowdenbeath,6698,10,4,10,22,25,57,-32,22
Montrose,6699,1,24,7,5,61,35,26,79
Peterhead,6699,2,24,4,8,80,39,41,76
Stirling,6699,3,17,6,13,62,52,10,57
Clyde,6699,4,15,9,12,54,48,6,54
Stenhousem'r,6699,5,15,8,13,56,48,8,53
Elgin,6699,6,14,6,16,54,62,-8,48
Annan Athlet,6699,7,11,11,14,47,42,5,44
Berwick,6699,8,8,10,18,29,61,-32,34
Edinburgh Ci,6699,9,7,9,20,37,63,-26,30
Cowdenbeath,6699,10,5,10,21,24,54,-30,25
Montrose,6700,1,24,7,5,63,35,28,79
Peterhead,6700,2,24,4,8,79,38,41,76
Stirling,6700,3,17,6,13,63,51,12,57
Stenhousem'r,6700,4,15,8,13,55,49,6,53
Clyde,6700,5,14,9,13,52,50,2,51
Elgin,6700,6,14,6,16,54,64,-10,48
Annan Athlet,6700,7,12,11,13,49,42,7,47
Berwick,6700,8,9,10,17,31,59,-28,37
Edinburgh Ci,6700,9,7,9,20,36,62,-26,30
Cowdenbeath,6700,10,4,10,22,24,56,-32,22
Montrose,6701,1,23,8,5,60,35,25,77
Peterhead,6701,2,24,4,8,79,39,40,76
Stirling,6701,3,17,6,13,61,51,10,57
Clyde,6701,4,15,9,12,53,48,5,54
Stenhousem'r,6701,5,15,8,13,55,47,8,53
Elgin,6701,6,14,7,15,54,61,-7,49
Annan Athlet,6701,7,11,11,14,49,44,5,44
Berwick,6701,8,8,10,18,29,60,-31,34
Edinburgh Ci,6701,9,7,9,20,37,62,-25,30
Cowdenbeath,6701,10,5,10,21,26,56,-30,25
Montrose,6702,1,24,7,5,65,35,30,79
Peterhead,6702,2,24,4,8,80,38,42,76
Stirling,6702,3,16,7,13,62,53,9,55
Stenhousem'r,6702,4,15,9,12,57,48,9,54
Clyde,6702,5,14,10,12,52,49,3,52
Elgin,6702,6,14,6,16,54,66,-12,48
Annan Athlet,6702,7,11,11,14,48,43,5,44
Berwick,6702,8,8,11,17,30,59,-29,35
Edinburgh Ci,6702,9,7,9,20,36,63,-27,30
Cowdenbeath,6702,10,5,10,21,25,55,-30,25
Montrose,6703,1,24,7,5,60,34,26,79
Peterhead,6703,2,23,5,8,77,38,39,74
Stirling,6703,3,17,6,13,62,52,10,57
Stenhousem'r,6703,4,15,8,13,56,48,8,53
Clyde,6703,5,14,9,13,51,51,0,51
Elgin,6703,6,14,6,16,53,61,-8,48
Annan Athlet,6703,7,11,11,14,47,43,4,44
Berwick,6703,8,9,10,17,32,58,-26,37
Edinburgh Ci,6703,9,7,10,19,36,60,-24,31
Cowdenbeath,6703,10,5,10,21,25,54,-29,25
Montrose,6704,1,24,7,5,61,35,26,79
Peterhead,6704,2,24,4,8,83,40,43,76
Stirling,6704,3,17,6,13,62,52,10,57
Clyde,6704,4,15,9,12,53,48,5,54
Stenhousem'r,6704,5,15,8,13,56,48,8,53
Elgin,6704,6,14,6,16,54,62,-8,48
Annan Athlet,6704,7,11,11,14,47,45,2,44
Berwick,6704,8,8,10,18,29,60,-31,34
Edinburgh Ci,6704,9,7,9,20,38,66,-28,30
Cowdenbeath,6704,10,5,10,21,27,54,-27,25
Montrose,6705,1,24,7,5,60,34,26,79
Peterhead,6705,2,24,4,8,80,38,42,76
Stirling,6705,3,17,6,13,61,51,10,57
Stenhousem'r,6705,4,15,8,13,55,47,8,53
Clyde,6705,5,14,10,12,51,48,3,52
Elgin,6705,6,14,6,16,53,61,-8,48
Annan Athlet,6705,7,11,12,13,48,42,6,45
Berwick,6705,8,8,11,17,29,58,-29,35
Edinburgh Ci,6705,9,7,9,20,36,63,-27,30
Cowdenbeath,6705,10,4,11,21,24,55,-31,23
Montrose,6706,1,23,8,5,59,34,25,77
Peterhead,6706,2,24,4,8,80,39,41,76
Stirling,6706,3,17,6,13,61,51,10,57
Stenhousem'r,6706,4,15,8,13,55,47,8,53
Clyde,6706,5,14,10,12,53,50,3,52
Elgin,6706,6,14,7,15,53,60,-7,49
Annan Athlet,6706,7,11,11,14,47,42,5,44
Berwick,6706,8,8,11,17,31,60,-29,35
Edinburgh Ci,6706,9,7,9,20,37,63,-26,30
Cowdenbeath,6706,10,5,10,21,24,54,-30,25
Montrose,6707,1,24,7,5,62,35,27,79
Peterhead,6707,2,24,4,8,79,39,40,76
Stirling,6707,3,16,7,13,61,52,9,55
Stenhousem'r,6707,4,15,9,12,56,47,9,54
Clyde,6707,5,14,9,13,51,49,2,51
Elgin,6707,6,14,6,16,54,63,-9,48
Annan Athlet,6707,7,11,12,13,48,42,6,45
Berwick,6707,8,9,10,17,30,58,-28,37
Edinburgh Ci,6707,9,7,9,20,37,62,-25,30
Cowdenbeath,6707,10,4,11,21,24,55,-31,23
Peterhead,6708,1,24,4,8,80,39,41,76
Montrose,6708,2,23,7,6,60,36,24,76
Stenhousem'r,6708,3,16,8,12,58,47,11,56
Stirling,6708,4,16,6,14,61,54,7,54
Clyde,6708,5,14,10,12,53,50,3,52
Elgin,6708,6,15,6,15,55,61,-6,51
Annan Athlet,6708,7,11,11,14,47,42,5,44
Berwick,6708,8,8,11,17,31,60,-29,35
Edinburgh Ci,6708,9,7,9,20,37,63,-26,30
Cowdenbeath,6708,10,5,10,21,24,54,-30,25
Montrose,6709,1,23,8,5,62,37,25,77
Peterhead,6709,2,24,4,8,79,39,40,76
Stirling,6709,3,17,6,13,62,52,10,57
Clyde,6709,4,15,9,12,53,49,4,54
Stenhousem'r,6709,5,15,8,13,56,48,8,53
Elgin,6709,6,14,7,15,56,63,-7,49
Annan Athlet,6709,7,11,11,14,48,43,5,44
Berwick,6709,8,8,10,18,30,60,-30,34
Edinburgh Ci,6709,9,7,9,20,37,62,-25,30
Cowdenbeath,6709,10,5,10,21,25,55,-30,25
Montrose,6710,1,23,8,5,62,37,25,77
Peterhead,6710,2,24,4,8,83,39,44,76
Stirling,6710,3,16,7,13,60,51,9,55
Stenhousem'r,6710,4,15,9,12,55,46,9,54
Clyde,6710,5,15,9,12,52,48,4,54
Elgin,6710,6,14,7,15,56,63,-7,49
Annan Athlet,6710,7,11,11,14,47,43,4,44
Berwick,6710,8,8,10,18,29,59,-30,34
Edinburgh Ci,6710,9,7,9,20,37,66,-29,30
Cowdenbeath,6710,10,5,10,21,25,54,-29,25
Montrose,6711,1,23,8,5,60,35,25,77
Peterhead,6711,2,23,4,9,78,41,37,73
Stirling,6711,3,17,6,13,62,52,10,57
Stenhousem'r,6711,4,15,8,13,56,48,8,53
Clyde,6711,5,14,10,12,52,49,3,52
Elgin,6711,6,14,7,15,54,61,-7,49
Annan Athlet,6711,7,12,11,13,48,41,7,47
Berwick,6711,8,8,11,17,30,59,-29,35
Edinburgh Ci,6711,9,8,9,19,39,61,-22,33
Cowdenbeath,6711,10,4,10,22,23,55,-32,22
Montrose,6712,1,24,7,5,63,35,28,79
Peterhead,6712,2,24,4,8,82,38,44,76
Stenhousem'r,6712,3,16,8,12,59,46,13,56
Stirling,6712,4,16,6,14,60,55,5,54
Clyde,6712,5,14,9,13,52,51,1,51
Elgin,6712,6,14,6,16,54,64,-10,48
Annan Athlet,6712,7,11,12,13,48,42,6,45
Berwick,6712,8,9,10,17,32,59,-27,37
Edinburgh Ci,6712,9,7,9,20,36,65,-29,30
Cowdenbeath,6712,10,4,11,21,24,55,-31,23
Montrose,6713,1,24,7,5,61,35,26,79
Peterhead,6713,2,24,4,8,81,40,41,76
Stirling,6713,3,17,6,13,65,53,12,57
Stenhousem'r,6713,4,15,8,13,57,51,6,53
Clyde,6713,5,14,9,13,51,49,2,51
Elgin,6713,6,14,6,16,54,62,-8,48
Annan Athlet,6713,7,12,11,13,49,42,7,47
Berwick,6713,8,9,10,17,30,58,-28,37
Edinburgh Ci,6713,9,7,9,20,38,64,-26,30
Cowdenbeath,6713,10,4,10,22,24,56,-32,22
Montrose,6714,1,23,7,6,59,35,24,76
Peterhead,6714,2,23,4,9,79,41,38,73
Stirling,6714,3,17,6,13,62,52,10,57
Stenhousem'r,6714,4,15,8,13,56,48,8,53
Clyde,6714,5,14,9,13,51,49,2,51
Elgin,6714,6,15,6,15,54,60,-6,51
Annan Athlet,6714,7,12,11,13,49,41,8,47
Berwick,6714,8,9,10,17,30,58,-28,37
Edinburgh Ci,6714,9,8,9,19,39,62,-23,33
Cowdenbeath,6714,10,4,10,22,23,56,-33,22
Montrose,6715,1,24,7,5,63,35,28,79
Peterhead,6715,2,23,5,8,78,39,39,74
Stenhousem'r,6715,3,16,8,12,58,48,10,56
Stirling,6715,4,16,6,14,62,54,8,54
Clyde,6715,5,15,9,12,52,48,4,54
Elgin,6715,6,14,6,16,54,64,-10,48
Annan Athlet,6715,7,11,11,14,47,43,4,44
Berwick,6715,8,8,10,18,29,59,-30,34
Edinburgh Ci,6715,9,7,10,19,37,61,-24,31
Cowdenbeath,6715,10,5,10,21,25,54,-29,25
Montrose,6716,1,24,7,5,62,36,26,79
Peterhead,6716,2,24,4,8,81,38,43,76
Stenhousem'r,6716,3,16,8,12,59,46,13,56
Stirling,6716,4,16,6,14,60,55,5,54
Clyde,6716,5,15,9,12,55,50,5,54
Elgin,6716,6,14,6,16,55,63,-8,48
Annan Athlet,6716,7,11,11,14,47,42,5,44
Berwick,6716,8,8,10,18,31,62,-31,34
Edinburgh Ci,6716,9,7,9,20,36,64,-28,30
Cowdenbeath,6716,10,5,10,21,24,54,-30,25
Montrose,6717,1,24,7,5,61,35,26,79
Peterhead,6717,2,24,4,8,80,38,42,76
Stirling,6717,3,17,6,13,64,52,12,57
Stenhousem'r,6717,4,15,8,13,56,50,6,53
Clyde,6717,5,14,9,13,51,49,2,51
Elgin,6717,6,14,6,16,54,62,-8,48
Annan Athlet,6717,7,12,11,13,48,41,7,47
Berwick,6717,8,9,10,17,30,58,-28,37
Edinburgh Ci,6717,9,7,9,20,36,63,-27,30
Cowdenbeath,6717,10,4,10,22,23,55,-32,22
Montrose,6718,1,23,7,6,59,35,24,76
Peterhead,6718,2,23,4,9,81,43,38,73
Stirling,6718,3,17,6,13,62,51,11,57
Stenhousem'r,6718,4,15,8,13,55,48,7,53
Clyde,6718,5,14,10,12,52,49,3,52
Elgin,6718,6,15,6,15,54,60,-6,51
Annan Athlet,6718,7,11,12,13,49,43,6,45
Berwick,6718,8,8,11,17,30,59,-29,35
Edinburgh Ci,6718,9,8,9,19,41,64,-23,33
Cowdenbeath,6718,10,4,11,21,25,56,-31,23
Montrose,6719,1,24,7,5,61,35,26,79
Peterhead,6719,2,24,4,8,81,39,42,76
Stirling,6719,3,16,7,13,61,52,9,55
Stenhousem'r,6719,4,15,9,12,56,47,9,54
Clyde,6719,5,15,9,12,57,49,8,54
Elgin,6719,6,14,6,16,54,62,-8,48
Annan Athlet,6719,7,11,12,13,48,42,6,45
Berwick,6719,8,8,10,18,30,64,-34,34
Edinburgh Ci,6719,9,7,9,20,37,64,-27,30
Cowdenbeath,6719,10,4,11,21,24,55,-31,23
Montrose,6720,1,24,7,5,60,34,26,79
Peterhead,6720,2,23,5,8,79,40,39,74
Stirling,6720,3,17,6,13,63,53,10,57
Stenhousem'r,6720,4,15,8,13,57,49,8,53
Clyde,6720,5,14,10,12,52,49,3,52
Elgin,6720,6,14,6,16,53,61,-8,48
Annan Athlet,6720,7,12,11,13,49,41,8,47
Berwick,6720,8,8,11,17,30,59,-29,35
Edinburgh Ci,6720,9,7,10,19,38,62,-24,31
Cowdenbeath,6720,10,4,10,22,23,56,-33,22
Montrose,6721,1,24,7,5,64,34,30,79
Peterhead,6721,2,23,5,8,78,39,39,74
Stirling,6721,3,17,6,13,63,53,10,57
Stenhousem'r,6721,4,15,8,13,57,49,8,53
Clyde,6721,5,14,10,12,51,48,3,52
Elgin,6721,6,14,6,16,53,65,-12,48
Annan Athlet,6721,7,11,12,13,48,42,6,45
Berwick,6721,8,8,11,17,29,58,-29,35
Edinburgh Ci,6721,9,7,10,19,37,61,-24,31
Cowdenbeath,6721,10,4,11,21,24,55,-31,23
Montrose,6722,1,24,7,5,62,35,27,79
Peterhead,6722,2,24,4,8,82,39,43,76
Stirling,6722,3,16,7,13,60,51,9,55
Stenhousem'r,6722,4,15,9,12,55,46,9,54
Clyde,6722,5,14,9,13,52,50,2,51
Elgin,6722,6,14,6,16,54,63,-9,48
Annan Athlet,6722,7,12,11,13,50,43,7,47
Berwick,6722,8,9,10,17,31,59,-28,37
Edinburgh Ci,6722,9,7,9,20,37,65,-28,30
Cowdenbeath,6722,10,4,10,22,25,57,-32,22
Montrose,6723,1,24,7,5,61,34,27,79
Peterhead,6723,2,24,4,8,79,38,41,76
Stirling,6723,3,17,6,13,62,51,11,57
Stenhousem'r,6723,4,15,8,13,55,48,7,53
Clyde,6723,5,14,10,12,51,48,3,52
Elgin,6723,6,14,6,16,53,62,-9,48
Annan Athlet,6723,7,11,12,13,48,42,6,45
Berwick,6723,8,8,11,17,29,58,-29,35
Edinburgh Ci,6723,9,7,9,20,36,62,-26,30
Cowdenbeath,6723,10,4,11,21,24,55,-31,23
Montrose,6724,1,24,7,5,62,35,27,79
Peterhead,6724,2,23,5,8,80,41,39,74
Stirling,6724,3,16,7,13,62,53,9,55
Stenhousem'r,6724,4,15,9,12,57,48,9,54
Clyde,6724,5,15,9,12,55,48,7,54
Elgin,6724,6,14,6,16,54,63,-9,48
Annan Athlet,6724,7,11,11,14,47,42,5,44
Berwick,6724,8,8,10,18,29,62,-33,34
Edinburgh Ci,6724,9,7,10,19,39,63,-24,31
Cowdenbeath,6724,10,5,10,21,24,54,-30,25
Montrose,6725,1,24,7,5,61,34,27,79
Peterhead,6725,2,23,5,8,79,40,39,74
Stirling,6725,3,17,6,13,61,51,10,57
Clyde,6725,4,15,9,12,53,48,5,54
Stenhousem'r,6725,5,15,8,13,55,47,8,53
Elgin,6725,6,14,6,16,53,62,-9,48
Annan Athlet,6725,7,11,12,13,48,42,6,45
Berwick,6725,8,8,10,18,29,60,-31,34
Edinburgh Ci,6725,9,7,10,19,38,62,-24,31
Cowdenbeath,6725,10,4,11,21,24,55,-31,23
Peterhead,6726,1,24,4,8,80,40,40,76
Montrose,6726,2,23,7,6,61,37,24,76
Stirling,6726,3,17,6,13,63,52,11,57
Clyde,6726,4,15,9,12,59,49,10,54
Stenhousem'r,6726,5,15,8,13,56,49,7,53
Elgin,6726,6,15,6,15,56,62,-6,51
Annan Athlet,6726,7,11,12,13,47,41,6,45
Berwick,6726,8,8,10,18,30,66,-36,34
Edinburgh Ci,6726,9,7,9,20,38,63,-25,30
Cowdenbeath,6726,10,4,11,21,23,54,-31,23
Peterhead,6727,1,24,4,8,78,38,40,76
Montrose,6727,2,23,7,6,60,36,24,76
Stenhousem'r,6727,3,16,8,12,56,46,10,56
Stirling,6727,4,16,6,14,60,52,8,54
Clyde,6727,5,15,9,12,53,48,5,54
Elgin,6727,6,15,6,15,55,61,-6,51
Annan Athlet,6727,7,11,12,13,49,43,6,45
Berwick,6727,8,8,10,18,29,60,-31,34
Edinburgh Ci,6727,9,7,9,20,36,61,-25,30
Cowdenbeath,6727,10,4,11,21,25,56,-31,23
Peterhead,6728,1,24,4,8,83,39,44,76
Montrose,6728,2,23,7,6,59,36,23,76
Stenhousem'r,6728,3,16,8,12,57,47,10,56
Stirling,6728,4,16,6,14,61,53,8,54
Clyde,6728,5,14,9,13,52,50,2,51
Elgin,6728,6,15,6,15,55,60,-5,51
Annan Athlet,6728,7,11,12,13,47,41,6,45
Berwick,6728,8,9,10,17,31,59,-28,37
Edinburgh Ci,6728,9,7,9,20,37,66,-29,30
Cowdenbeath,6728,10,4,11,21,23,54,-31,23
Montrose,6729,1,24,7,5,64,34,30,79
Peterhead,6729,2,24,4,8,79,38,41,76
Stirling,6729,3,17,6,13,61,51,10,57
Clyde,6729,4,15,9,12,54,48,6,54
Stenhousem'r,6729,5,15,8,13,55,47,8,53
Elgin,6729,6,14,6,16,53,65,-12,48
Annan Athlet,6729,7,11,11,14,48,44,4,44
Berwick,6729,8,8,10,18,29,61,-32,34
Edinburgh Ci,6729,9,7,9,20,36,62,-26,30
Cowdenbeath,6729,10,5,10,21,26,55,-29,25
Montrose,6730,1,23,8,5,60,35,25,77
Peterhead,6730,2,23,5,8,77,38,39,74
Stirling,6730,3,16,7,13,61,52,9,55
Stenhousem'r,6730,4,15,9,12,56,47,9,54
Clyde,6730,5,15,9,12,52,48,4,54
Elgin,6730,6,14,7,15,54,61,-7,49
Annan Athlet,6730,7,12,11,13,50,42,8,47
Berwick,6730,8,8,10,18,29,59,-30,34
Edinburgh Ci,6730,9,7,10,19,36,60,-24,31
Cowdenbeath,6730,10,4,10,22,24,57,-33,22
Montrose,6731,1,24,7,5,65,35,30,79
Peterhead,6731,2,24,4,8,79,38,41,76
Stirling,6731,3,17,6,13,61,51,10,57
Stenhousem'r,6731,4,15,8,13,55,47,8,53
Clyde,6731,5,14,10,12,52,49,3,52
Elgin,6731,6,14,6,16,54,66,-12,48
Annan Athlet,6731,7,12,11,13,48,41,7,47
Berwick,6731,8,8,11,17,30,59,-29,35
Edinburgh Ci,6731,9,7,9,20,36,62,-26,30
Cowdenbeath,6731,10,4,10,22,23,55,-32,22
Montrose,6732,1,23,7,6,59,36,23,76
Peterhead,6732,2,23,4,9,77,39,38,73
Stirling,6732,3,17,6,13,63,53,10,57
Clyde,6732,4,15,9,12,55,49,6,54
Stenhousem'r,6732,5,15,8,13,57,49,8,53
Elgin,6732,6,15,6,15,55,60,-5,51
Annan Athlet,6732,7,11,11,14,47,45,2,44
Berwick,6732,8,8,10,18,30,62,-32,34
Edinburgh Ci,6732,9,8,9,19,37,60,-23,33
Cowdenbeath,6732,10,5,10,21,27,54,-27,25
Peterhead,6733,1,24,4,8,80,39,41,76
Montrose,6733,2,23,7,6,59,35,24,76
Stirling,6733,3,17,6,13,62,51,11,57
Clyde,6733,4,15,9,12,53,49,4,54
Stenhousem'r,6733,5,15,8,13,55,48,7,53
Elgin,6733,6,15,6,15,54,60,-6,51
Annan Athlet,6733,7,12,11,13,52,42,10,47
Berwick,6733,8,8,10,18,30,60,-30,34
Edinburgh Ci,6733,9,7,9,20,37,63,-26,30
Cowdenbeath,6733,10,4,10,22,24,59,-35,22
Montrose,6734,1,24,7,5,61,35,26,79
Peterhead,6734,2,24,4,8,80,39,41,76
Stirling,6734,3,16,7,13,62,53,9,55
Stenhousem'r,6734,4,15,9,12,57,48,9,54
Clyde,6734,5,14,10,12,52,49,3,52
Elgin,6734,6,14,6,16,54,62,-8,48
Annan Athlet,6734,7,11,12,13,47,41,6,45
Berwick,6734,8,8,11,17,30,59,-29,35
Edinburgh Ci,6734,9,7,9,20,37,63,-26,30
Cowdenbeath,6734,10,4,11,21,23,54,-31,23
Montrose,6735,1,24,7,5,60,34,26,79
Peterhead,6735,2,24,4,8,80,40,40,76
Stirling,6735,3,16,7,13,63,54,9,55
Stenhousem'r,6735,4,15,9,12,58,49,9,54
Clyde,6735,5,15,9,12,52,48,4,54
Elgin,6735,6,14,6,16,53,61,-8,48
Annan Athlet,6735,7,11,12,13,48,42,6,45
Berwick,6735,8,8,10,18,29,59,-30,34
Edinburgh Ci,6735,9,7,9,20,38,63,-25,30
Cowdenbeath,6735,10,4,11,21,24,55,-31,23
Montrose,6736,1,23,8,5,61,36,25,77
Peterhead,6736,2,24,4,8,82,38,44,76
Stirling,6736,3,16,7,13,63,54,9,55
Stenhousem'r,6736,4,15,9,12,58,49,9,54
Clyde,6736,5,15,9,12,52,48,4,54
Elgin,6736,6,14,7,15,55,62,-7,49
Annan Athlet,6736,7,12,11,13,48,41,7,47
Berwick,6736,8,8,10,18,29,59,-30,34
Edinburgh Ci,6736,9,7,9,20,36,65,-29,30
Cowdenbeath,6736,10,4,10,22,23,55,-32,22
Montrose,6737,1,24,7,5,61,35,26,79
Peterhead,6737,2,24,4,8,81,39,42,76
Stirling,6737,3,17,6,13,61,51,10,57
Stenhousem'r,6737,4,15,8,13,55,47,8,53
Clyde,6737,5,14,9,13,51,49,2,51
Elgin,6737,6,14,6,16,54,62,-8,48
Annan Athlet,6737,7,11,12,13,48,42,6,45
Berwick,6737,8,9,10,17,30,58,-28,37
Edinburgh Ci,6737,9,7,9,20,37,64,-27,30
Cowdenbeath,6737,10,4,11,21,24,55,-31,23
Montrose,6738,1,23,8,5,60,35,25,77
Peterhead,6738,2,24,4,8,81,41,40,76
Stenhousem'r,6738,3,16,8,12,59,47,12,56
Stirling,6738,4,16,6,14,61,55,6,54
Clyde,6738,5,15,9,12,54,49,5,54
Elgin,6738,6,14,7,15,54,61,-7,49
Annan Athlet,6738,7,12,11,13,49,41,8,47
Berwick,6738,8,8,10,18,30,61,-31,34
Edinburgh Ci,6738,9,7,9,20,39,64,-25,30
Cowdenbeath,6738,10,4,10,22,23,56,-33,22
Montrose,6739,1,24,7,5,60,34,26,79
Peterhead,6739,2,24,4,8,82,38,44,76
Stenhousem'r,6739,3,16,8,12,56,46,10,56
Stirling,6739,4,16,6,14,60,52,8,54
Clyde,6739,5,15,9,12,52,48,4,54
Elgin,6739,6,14,6,16,53,61,-8,48
Annan Athlet,6739,7,12,11,13,50,43,7,47
Berwick,6739,8,8,10,18,29,59,-30,34
Edinburgh Ci,6739,9,7,9,20,36,65,-29,30
Cowdenbeath,6739,10,4,10,22,25,57,-32,22
Montrose,6740,1,24,7,5,60,34,26,79
Peterhead,6740,2,24,4,8,79,39,40,76
Stenhousem'r,6740,3,16,8,12,57,47,10,56
Stirling,6740,4,16,6,14,61,53,8,54
Clyde,6740,5,15,9,12,52,48,4,54
Elgin,6740,6,14,6,16,53,61,-8,48
Annan Athlet,6740,7,12,11,13,51,42,9,47
Berwick,6740,8,8,10,18,29,59,-30,34
Edinburgh Ci,6740,9,7,9,20,37,62,-25,30
Cowdenbeath,6740,10,4,10,22,24,58,-34,22
Montrose,6741,1,23,8,5,59,34,25,77
Peterhead,6741,2,24,4,8,81,40,41,76
Stirling,6741,3,17,6,13,66,53,13,57
Clyde,6741,4,15,9,12,53,48,5,54
Stenhousem'r,6741,5,15,8,13,57,52,5,53
Elgin,6741,6,14,7,15,53,60,-7,49
Annan Athlet,6741,7,12,11,13,49,42,7,47
Berwick,6741,8,8,10,18,29,60,-31,34
Edinburgh Ci,6741,9,7,9,20,38,64,-26,30
Cowdenbeath,6741,10,4,10,22,24,56,-32,22
Montrose,6742,1,24,7,5,62,34,28,79
Peterhead,6742,2,24,4,8,80,38,42,76
Stirling,6742,3,16,7,13,61,52,9,55
Stenhousem'r,6742,4,15,9,12,56,47,9,54
Clyde,6742,5,15,9,12,53,49,4,54
Elgin,6742,6,14,6,16,53,63,-10,48
Annan Athlet,6742,7,12,11,13,49,42,7,47
Berwick,6742,8,8,10,18,30,60,-30,34
Edinburgh Ci,6742,9,7,9,20,36,63,-27,30
Cowdenbeath,6742,10,4,10,22,24,56,-32,22
Montrose,6743,1,24,7,5,61,35,26,79
Peterhead,6743,2,24,4,8,78,38,40,76
Stirling,6743,3,16,7,13,62,53,9,55
Stenhousem'r,6743,4,15,9,12,57,48,9,54
Clyde,6743,5,14,9,13,52,50,2,51
Elgin,6743,6,14,6,16,54,62,-8,48
Annan Athlet,6743,7,12,11,13,48,41,7,47
Berwick,6743,8,9,10,17,31,59,-28,37
Edinburgh Ci,6743,9,7,9,20,36,61,-25,30
Cowdenbeath,6743,10,4,10,22,23,55,-32,22
Montrose,6744,1,24,7,5,61,34,27,79
Peterhead,6744,2,24,4,8,80,38,42,76
Stirling,6744,3,17,6,13,62,51,11,57
Clyde,6744,4,15,9,12,54,49,5,54
Stenhousem'r,6744,5,15,8,13,55,48,7,53
Elgin,6744,6,14,6,16,53,62,-9,48
Annan Athlet,6744,7,11,12,13,47,41,6,45
Berwick,6744,8,8,10,18,30,61,-31,34
Edinburgh Ci,6744,9,7,9,20,36,63,-27,30
Cowdenbeath,6744,10,4,11,21,23,54,-31,23
Montrose,6745,1,23,8,5,62,37,25,77
Peterhead,6745,2,24,4,8,80,38,42,76
Stirling,6745,3,16,7,13,62,53,9,55
Stenhousem'r,6745,4,15,9,12,57,48,9,54
Clyde,6745,5,15,9,12,53,49,4,54
Elgin,6745,6,14,7,15,56,63,-7,49
Annan Athlet,6745,7,12,11,13,50,42,8,47
Berwick,6745,8,8,10,18,30,60,-30,34
Edinburgh Ci,6745,9,7,9,20,36,63,-27,30
Cowdenbeath,6745,10,4,10,22,24,57,-33,22
Montrose,6746,1,24,7,5,61,35,26,79
Peterhead,6746,2,24,4,8,82,39,43,76
Stirling,6746,3,17,6,13,62,51,11,57
Stenhousem'r,6746,4,15,8,13,55,48,7,53
Clyde,6746,5,14,9,13,51,50,1,51
Elgin,6746,6,14,6,16,54,62,-8,48
Annan Athlet,6746,7,11,12,13,48,42,6,45
Berwick,6746,8,9,10,17,31,58,-27,37
Edinburgh Ci,6746,9,7,9,20,37,65,-28,30
Cowdenbeath,6746,10,4,11,21,24,55,-31,23
Montrose,6747,1,24,7,5,60,34,26,79
Peterhead,6747,2,24,4,8,79,38,41,76
Stirling,6747,3,17,6,13,62,51,11,57
Clyde,6747,4,15,9,12,52,48,4,54
Stenhousem'r,6747,5,15,8,13,55,48,7,53
Elgin,6747,6,14,6,16,53,61,-8,48
Annan Athlet,6747,7,11,12,13,47,41,6,45
Berwick,6747,8,8,10,18,29,59,-30,34
Edinburgh Ci,6747,9,7,9,20,36,62,-26,30
Cowdenbeath,6747,10,4,11,21,23,54,-31,23
Montrose,6748,1,24,7,5,60,34,26,79
Peterhead,6748,2,24,4,8,82,38,44,76
Stirling,6748,3,17,6,13,65,52,13,57
Clyde,6748,4,15,9,12,53,49,4,54
Stenhousem'r,6748,5,15,8,13,56,51,5,53
Elgin,6748,6,14,6,16,53,61,-8,48
Annan Athlet,6748,7,12,11,13,49,42,7,47
Berwick,6748,8,8,10,18,30,60,-30,34
Edinburgh Ci,6748,9,7,9,20,36,65,-29,30
Cowdenbeath,6748,10,4,10,22,24,56,-32,22
Montrose,6749,1,24,7,5,61,35,26,79
Peterhead,6749,2,24,4,8,81,38,43,76
Stenhousem'r,6749,3,16,8,12,56,46,10,56
Stirling,6749,4,16,6,14,60,52,8,54
Clyde,6749,5,15,9,12,53,48,5,54
Elgin,6749,6,14,6,16,54,62,-8,48
Annan Athlet,6749,7,12,11,13,48,41,7,47
Berwick,6749,8,8,10,18,29,60,-31,34
Edinburgh Ci,6749,9,7,9,20,36,64,-28,30
Cowdenbeath,6749,10,4,10,22,23,55,-32,22
Montrose,6750,1,24,7,5,61,34,27,79
Peterhead,6750,2,23,5,8,78,39,39,74
Stenhousem'r,6750,3,16,8,12,56,46,10,56
Stirling,6750,4,16,6,14,60,52,8,54
Clyde,6750,5,15,9,12,53,49,4,54
Elgin,6750,6,14,6,16,53,62,-9,48
Annan Athlet,6750,7,12,11,13,49,41,8,47
Berwick,6750,8,8,10,18,30,60,-30,34
Edinburgh Ci,6750,9,7,10,19,37,61,-24,31
Cowdenbeath,6750,10,4,10,22,23,56,-33,22
Peterhead,6751,1,24,4,8,82,39,43,76
Montrose,6751,2,23,7,6,60,37,23,76
Stenhousem'r,6751,3,16,8,12,59,46,13,56
Stirling,6751,4,16,6,14,60,55,5,54
Clyde,6751,5,15,9,12,53,48,5,54
Elgin,6751,6,15,6,15,56,61,-5,51
Annan Athlet,6751,7,11,12,13,47,41,6,45
Berwick,6751,8,8,10,18,29,60,-31,34
Edinburgh Ci,6751,9,7,9,20,37,65,-28,30
Cowdenbeath,6751,10,4,11,21,23,54,-31,23
Montrose,6752,1,24,7,5,62,35,27,79
Peterhead,6752,2,23,5,8,79,40,39,74
Stirling,6752,3,17,6,13,62,52,10,57
Stenhousem'r,6752,4,15,8,13,56,48,8,53
Clyde,6752,5,14,9,13,53,51,2,51
Elgin,6752,6,14,6,16,54,63,-9,48
Annan Athlet,6752,7,11,11,14,47,43,4,44
Berwick,6752,8,9,10,17,32,60,-28,37
Edinburgh Ci,6752,9,7,10,19,38,62,-24,31
Cowdenbeath,6752,10,5,10,21,25,54,-29,25
Montrose,6753,1,24,7,5,63,36,27,79
Peterhead,6753,2,23,4,9,78,40,38,73
Stirling,6753,3,17,6,13,63,53,10,57
Clyde,6753,4,15,9,12,55,49,6,54
Stenhousem'r,6753,5,15,8,13,57,49,8,53
Elgin,6753,6,14,6,16,55,64,-9,48
Annan Athlet,6753,7,12,11,13,48,41,7,47
Berwick,6753,8,8,10,18,30,62,-32,34
Edinburgh Ci,6753,9,8,9,19,38,61,-23,33
Cowdenbeath,6753,10,4,10,22,23,55,-32,22
Montrose,6754,1,24,7,5,62,34,28,79
Peterhead,6754,2,24,4,8,79,38,41,76
Stirling,6754,3,17,6,13,63,51,12,57
Clyde,6754,4,15,9,12,55,50,5,54
Stenhousem'r,6754,5,15,8,13,55,49,6,53
Elgin,6754,6,14,6,16,53,63,-10,48
Annan Athlet,6754,7,11,11,14,48,43,5,44
Berwick,6754,8,8,10,18,31,62,-31,34
Edinburgh Ci,6754,9,7,9,20,36,62,-26,30
Cowdenbeath,6754,10,5,10,21,25,55,-30,25
Montrose,6755,1,24,7,5,61,34,27,79
Peterhead,6755,2,23,5,8,77,38,39,74
Stenhousem'r,6755,3,16,8,12,59,48,11,56
Stirling,6755,4,16,6,14,62,55,7,54
Clyde,6755,5,15,9,12,53,49,4,54
Elgin,6755,6,14,6,16,53,62,-9,48
Annan Athlet,6755,7,12,11,13,50,42,8,47
Berwick,6755,8,8,10,18,30,60,-30,34
Edinburgh Ci,6755,9,7,10,19,36,60,-24,31
Cowdenbeath,6755,10,4,10,22,24,57,-33,22
Montrose,6756,1,24,7,5,61,34,27,79
Peterhead,6756,2,24,4,8,79,39,40,76
Stenhousem'r,6756,3,16,8,12,56,46,10,56
Stirling,6756,4,16,6,14,60,52,8,54
Clyde,6756,5,15,9,12,53,49,4,54
Elgin,6756,6,14,6,16,53,62,-9,48
Annan Athlet,6756,7,12,11,13,48,41,7,47
Berwick,6756,8,8,10,18,30,60,-30,34
Edinburgh Ci,6756,9,7,9,20,37,62,-25,30
Cowdenbeath,6756,10,4,10,22,23,55,-32,22
Montrose,6757,1,24,7,5,62,34,28,79
Peterhead,6757,2,23,4,9,78,40,38,73
Stenhousem'r,6757,3,16,8,12,57,47,10,56
Stirling,6757,4,16,6,14,61,53,8,54
Clyde,6757,5,14,10,12,51,48,3,52
Elgin,6757,6,14,6,16,53,63,-10,48
Annan Athlet,6757,7,12,11,13,50,41,9,47
Berwick,6757,8,8,11,17,29,58,-29,35
Edinburgh Ci,6757,9,8,9,19,38,61,-23,33
Cowdenbeath,6757,10,4,10,22,23,57,-34,22
Peterhead,6758,1,24,4,8,80,39,41,76
Montrose,6758,2,23,7,6,60,37,23,76
Stirling,6758,3,16,7,13,61,52,9,55
Stenhousem'r,6758,4,15,9,12,56,47,9,54
Clyde,6758,5,14,9,13,52,50,2,51
Elgin,6758,6,15,6,15,56,61,-5,51
Annan Athlet,6758,7,11,12,13,47,41,6,45
Berwick,6758,8,9,10,17,31,59,-28,37
Edinburgh Ci,6758,9,7,9,20,37,63,-26,30
Cowdenbeath,6758,10,4,11,21,23,54,-31,23
Montrose,6759,1,24,7,5,62,35,27,79
Peterhead,6759,2,24,4,8,80,39,41,76
Stenhousem'r,6759,3,16,8,12,58,46,12,56
Stirling,6759,4,16,6,14,60,54,6,54
Clyde,6759,5,15,9,12,53,48,5,54
Elgin,6759,6,14,6,16,54,63,-9,48
Annan Athlet,6759,7,11,11,14,48,43,5,44
Berwick,6759,8,8,10,18,29,60,-31,34
Edinburgh Ci,6759,9,7,9,20,37,63,-26,30
Cowdenbeath,6759,10,5,10,21,25,55,-30,25
Montrose,6760,1,23,7,6,61,37,24,76
Peterhead,6760,2,23,5,8,77,38,39,74
Stirling,6760,3,17,6,13,63,52,11,57
Stenhousem'r,6760,4,15,8,13,56,49,7,53
Clyde,6760,5,14,9,13,51,51,0,51
Elgin,6760,6,15,6,15,56,62,-6,51
Annan Athlet,6760,7,12,11,13,49,42,7,47
Berwick,6760,8,9,10,17,32,58,-26,37
Edinburgh Ci,6760,9,7,10,19,36,60,-24,31
Cowdenbeath,6760,10,4,10,22,24,56,-32,22
Peterhead,6761,1,24,4,8,80,39,41,76
Montrose,6761,2,23,7,6,61,37,24,76
Stirling,6761,3,16,7,13,62,53,9,55
Stenhousem'r,6761,4,15,9,12,57,48,9,54
Clyde,6761,5,15,9,12,53,49,4,54
Elgin,6761,6,15,6,15,56,62,-6,51
Annan Athlet,6761,7,11,12,13,47,41,6,45
Berwick,6761,8,8,10,18,30,60,-30,34
Edinburgh Ci,6761,9,7,9,20,37,63,-26,30
Cowdenbeath,6761,10,4,11,21,23,54,-31,23
Montrose,6762,1,24,7,5,61,34,27,79
Peterhead,6762,2,24,4,8,81,38,43,76
Stenhousem'r,6762,3,16,8,12,56,46,10,56
Stirling,6762,4,16,6,14,60,52,8,54
Clyde,6762,5,14,9,13,51,51,0,51
Elgin,6762,6,14,6,16,53,62,-9,48
Annan Athlet,6762,7,11,12,13,48,42,6,45
Berwick,6762,8,9,10,17,32,58,-26,37
Edinburgh Ci,6762,9,7,9,20,36,64,-28,30
Cowdenbeath,6762,10,4,11,21,24,55,-31,23
Montrose,6763,1,24,7,5,60,34,26,79
Peterhead,6763,2,24,4,8,79,38,41,76
Stirling,6763,3,17,6,13,63,51,12,57
Clyde,6763,4,15,9,12,54,48,6,54
Stenhousem'r,6763,5,15,8,13,55,49,6,53
Elgin,6763,6,14,6,16,53,61,-8,48
Annan Athlet,6763,7,11,11,14,47,42,5,44
Berwick,6763,8,8,10,18,29,61,-32,34
Edinburgh Ci,6763,9,7,9,20,36,62,-26,30
Cowdenbeath,6763,10,5,10,21,24,54,-30,25
Montrose,6764,1,24,7,5,62,35,27,79
Peterhead,6764,2,24,4,8,80,39,41,76
Stenhousem'r,6764,3,16,8,12,57,46,11,56
Stirling,6764,4,16,6,14,60,53,7,54
Clyde,6764,5,15,9,12,53,49,4,54
Elgin,6764,6,14,6,16,54,63,-9,48
Annan Athlet,6764,7,12,11,13,50,41,9,47
Berwick,6764,8,8,10,18,30,60,-30,34
Edinburgh Ci,6764,9,7,9,20,37,63,-26,30
Cowdenbeath,6764,10,4,10,22,23,57,-34,22
Montrose,6765,1,23,8,5,61,36,25,77
Peterhead,6765,2,24,4,8,80,38,42,76
Stirling,6765,3,17,6,13,64,51,13,57
Stenhousem'r,6765,4,15,8,13,55,50,5,53
Clyde,6765,5,14,10,12,52,49,3,52
Elgin,6765,6,14,7,15,55,62,-7,49
Annan Athlet,6765,7,11,12,13,48,42,6,45
Berwick,6765,8,8,11,17,30,59,-29,35
Edinburgh Ci,6765,9,7,9,20,36,63,-27,30
Cowdenbeath,6765,10,4,11,21,24,55,-31,23
Montrose,6766,1,24,7,5,60,34,26,79
Peterhead,6766,2,24,4,8,80,38,42,76
Stirling,6766,3,17,6,13,63,53,10,57
Stenhousem'r,6766,4,15,8,13,57,49,8,53
Clyde,6766,5,14,9,13,51,49,2,51
Elgin,6766,6,14,6,16,53,61,-8,48
Annan Athlet,6766,7,12,11,13,49,42,7,47
Berwick,6766,8,9,10,17,30,58,-28,37
Edinburgh Ci,6766,9,7,9,20,36,63,-27,30
Cowdenbeath,6766,10,4,10,22,24,56,-32,22
Montrose,6767,1,24,7,5,62,34,28,79
Peterhead,6767,2,24,4,8,81,38,43,76
Stirling,6767,3,16,7,13,61,52,9,55
Stenhousem'r,6767,4,15,9,12,56,47,9,54
Clyde,6767,5,14,9,13,51,51,0,51
Elgin,6767,6,14,6,16,53,63,-10,48
Annan Athlet,6767,7,12,11,13,50,43,7,47
Berwick,6767,8,9,10,17,32,58,-26,37
Edinburgh Ci,6767,9,7,9,20,36,64,-28,30
Cowdenbeath,6767,10,4,10,22,25,57,-32,22
Montrose,6768,1,23,8,5,60,35,25,77
Peterhead,6768,2,24,4,8,83,38,45,76
Stirling,6768,3,17,6,13,63,53,10,57
Clyde,6768,4,15,9,12,52,48,4,54
Stenhousem'r,6768,5,15,8,13,57,49,8,53
Elgin,6768,6,14,7,15,54,61,-7,49
Annan Athlet,6768,7,12,11,13,49,41,8,47
Berwick,6768,8,8,10,18,29,59,-30,34
Edinburgh Ci,6768,9,7,9,20,36,66,-30,30
Cowdenbeath,6768,10,4,10,22,23,56,-33,22
Montrose,6769,1,24,7,5,61,34,27,79
Peterhead,6769,2,24,4,8,80,38,42,76
Stenhousem'r,6769,3,16,8,12,56,46,10,56
Stirling,6769,4,16,6,14,60,52,8,54
Clyde,6769,5,15,9,12,52,48,4,54
Elgin,6769,6,14,6,16,53,62,-9,48
Annan Athlet,6769,7,11,12,13,48,42,6,45
Berwick,6769,8,8,10,18,29,59,-30,34
Edinburgh Ci,6769,9,7,9,20,36,63,-27,30
Cowdenbeath,6769,10,4,11,21,24,55,-31,23
Montrose,6770,1,23,8,5,59,34,25,77
Peterhead,6770,2,23,5,8,78,39,39,74
Stenhousem'r,6770,3,16,8,12,60,49,11,56
Stirling,6770,4,16,6,14,63,56,7,54
Clyde,6770,5,14,9,13,51,49,2,51
Elgin,6770,6,14,7,15,53,60,-7,49
Annan Athlet,6770,7,12,11,13,49,41,8,47
Berwick,6770,8,9,10,17,30,58,-28,37
Edinburgh Ci,6770,9,7,10,19,37,61,-24,31
Cowdenbeath,6770,10,4,10,22,23,56,-33,22
Montrose,6771,1,24,7,5,60,34,26,79
Peterhead,6771,2,24,4,8,79,38,41,76
Stenhousem'r,6771,3,16,8,12,57,47,10,56
Stirling,6771,4,16,6,14,61,53,8,54
Clyde,6771,5,15,9,12,55,49,6,54
Elgin,6771,6,14,6,16,53,61,-8,48
Annan Athlet,6771,7,12,11,13,49,41,8,47
Berwick,6771,8,8,10,18,30,62,-32,34
Edinburgh Ci,6771,9,7,9,20,36,62,-26,30
Cowdenbeath,6771,10,4,10,22,23,56,-33,22
Montrose,6772,1,24,7,5,63,36,27,79
Peterhead,6772,2,24,4,8,82,38,44,76
Stirling,6772,3,16,7,13,62,53,9,55
Stenhousem'r,6772,4,15,9,12,57,48,9,54
Clyde,6772,5,14,10,12,52,49,3,52
Elgin,6772,6,14,6,16,55,64,-9,48
Annan Athlet,6772,7,11,11,14,47,43,4,44
Berwick,6772,8,8,11,17,30,59,-29,35
Edinburgh Ci,6772,9,7,9,20,36,65,-29,30
Cowdenbeath,6772,10,5,10,21,25,54,-29,25
Montrose,6773,1,24,7,5,61,35,26,79
Peterhead,6773,2,24,4,8,78,38,40,76
Stenhousem'r,6773,3,16,8,12,56,46,10,56
Stirling,6773,4,16,6,14,60,52,8,54
Clyde,6773,5,14,9,13,52,50,2,51
Elgin,6773,6,14,6,16,54,62,-8,48
Annan Athlet,6773,7,11,12,13,48,42,6,45
Berwick,6773,8,9,10,17,31,59,-28,37
Edinburgh Ci,6773,9,7,9,20,36,61,-25,30
Cowdenbeath,6773,10,4,11,21,24,55,-31,23
Montrose,6774,1,23,8,5,59,34,25,77
Peterhead,6774,2,24,4,8,82,38,44,76
Stirling,6774,3,16,7,13,61,52,9,55
Stenhousem'r,6774,4,15,9,12,56,47,9,54
Clyde,6774,5,14,9,13,51,50,1,51
Elgin,6774,6,14,7,15,53,60,-7,49
Annan Athlet,6774,7,12,11,13,48,41,7,47
Berwick,6774,8,9,10,17,31,58,-27,37
Edinburgh Ci,6774,9,7,9,20,36,65,-29,30
Cowdenbeath,6774,10,4,10,22,23,55,-32,22
Montrose,6775,1,24,7,5,62,34,28,79
Peterhead,6775,2,24,4,8,78,38,40,76
Stenhousem'r,6775,3,16,8,12,56,46,10,56
Stirling,6775,4,16,6,14,60,52,8,54
Clyde,6775,5,14,10,12,51,48,3,52
Elgin,6775,6,14,6,16,53,63,-10,48
Annan Athlet,6775,7,11,11,14,47,43,4,44
Berwick,6775,8,8,11,17,29,58,-29,35
Edinburgh Ci,6775,9,7,9,20,36,61,-25,30
Cowdenbeath,6775,10,5,10,21,25,54,-29,25
Montrose,6776,1,24,7,5,63,34,29,79
Peterhead,6776,2,24,4,8,80,40,40,76
Stenhousem'r,6776,3,16,8,12,57,46,11,56
Stirling,6776,4,16,6,14,60,53,7,54
Clyde,6776,5,15,9,12,55,48,7,54
Elgin,6776,6,14,6,16,53,64,-11,48
Annan Athlet,6776,7,12,11,13,49,41,8,47
Berwick,6776,8,8,10,18,29,62,-33,34
Edinburgh Ci,6776,9,7,9,20,38,63,-25,30
Cowdenbeath,6776,10,4,10,22,23,56,-33,22
Montrose,6777,1,24,7,5,63,34,29,79
Peterhead,6777,2,24,4,8,83,38,45,76
Stirling,6777,3,17,6,13,64,53,11,57
Clyde,6777,4,15,9,12,56,49,7,54
Stenhousem'r,6777,5,15,8,13,57,50,7,53
Elgin,6777,6,14,6,16,53,64,-11,48
Annan Athlet,6777,7,12,11,13,51,42,9,47
Berwick,6777,8,8,10,18,30,63,-33,34
Edinburgh Ci,6777,9,7,9,20,36,66,-30,30
Cowdenbeath,6777,10,4,10,22,24,58,-34,22
Montrose,6778,1,24,7,5,60,34,26,79
Peterhead,6778,2,24,4,8,79,38,41,76
Stirling,6778,3,17,6,13,64,52,12,57
Stenhousem'r,6778,4,15,8,13,56,50,6,53
Clyde,6778,5,14,10,12,52,49,3,52
Elgin,6778,6,14,6,16,53,61,-8,48
Annan Athlet,6778,7,11,12,13,48,42,6,45
Berwick,6778,8,8,11,17,30,59,-29,35
Edinburgh Ci,6778,9,7,9,20,36,62,-26,30
Cowdenbeath,6778,10,4,11,21,24,55,-31,23
Montrose,6779,1,24,7,5,60,34,26,79
Peterhead,6779,2,24,4,8,81,39,42,76
Stirling,6779,3,17,6,13,62,52,10,57
Clyde,6779,4,15,9,12,53,48,5,54
Stenhousem'r,6779,5,15,8,13,56,48,8,53
Elgin,6779,6,14,6,16,53,61,-8,48
Annan Athlet,6779,7,11,11,14,48,43,5,44
Berwick,6779,8,8,10,18,29,60,-31,34
Edinburgh Ci,6779,9,7,9,20,37,64,-27,30
Cowdenbeath,6779,10,5,10,21,25,55,-30,25
Montrose,6780,1,24,7,5,62,35,27,79
Peterhead,6780,2,24,4,8,80,39,41,76
Stirling,6780,3,17,6,13,63,53,10,57
Stenhousem'r,6780,4,15,8,13,57,49,8,53
Clyde,6780,5,14,10,12,54,51,3,52
Elgin,6780,6,14,6,16,54,63,-9,48
Annan Athlet,6780,7,11,11,14,47,42,5,44
Berwick,6780,8,8,11,17,32,61,-29,35
Edinburgh Ci,6780,9,7,9,20,37,63,-26,30
Cowdenbeath,6780,10,5,10,21,24,54,-30,25
Montrose,6781,1,24,7,5,63,35,28,79
Peterhead,6781,2,23,4,9,78,40,38,73
Stirling,6781,3,17,6,13,62,52,10,57
Stenhousem'r,6781,4,15,8,13,56,48,8,53
Clyde,6781,5,14,9,13,52,50,2,51
Elgin,6781,6,14,6,16,54,64,-10,48
Annan Athlet,6781,7,12,11,13,49,42,7,47
Berwick,6781,8,9,10,17,31,59,-28,37
Edinburgh Ci,6781,9,8,9,19,38,61,-23,33
Cowdenbeath,6781,10,4,10,22,24,56,-32,22
Montrose,6782,1,23,8,5,60,35,25,77
Peterhead,6782,2,24,4,8,79,39,40,76
Stenhousem'r,6782,3,16,8,12,58,48,10,56
Stirling,6782,4,16,6,14,62,54,8,54
Clyde,6782,5,15,9,12,56,49,7,54
Elgin,6782,6,14,7,15,54,61,-7,49
Annan Athlet,6782,7,12,11,13,50,42,8,47
Berwick,6782,8,8,10,18,30,63,-33,34
Edinburgh Ci,6782,9,7,9,20,37,62,-25,30
Cowdenbeath,6782,10,4,10,22,24,57,-33,22
Montrose,6783,1,24,7,5,62,35,27,79
Peterhead,6783,2,24,4,8,80,39,41,76
Stirling,6783,3,16,7,13,61,52,9,55
Stenhousem'r,6783,4,15,9,12,56,47,9,54
Clyde,6783,5,15,9,12,54,49,5,54
Elgin,6783,6,14,6,16,54,63,-9,48
Annan Athlet,6783,7,12,11,13,49,41,8,47
Berwick,6783,8,8,10,18,30,61,-31,34
Edinburgh Ci,6783,9,7,9,20,37,63,-26,30
Cowdenbeath,6783,10,4,10,22,23,56,-33,22
Montrose,6784,1,24,7,5,61,34,27,79
Peterhead,6784,2,24,4,8,79,39,40,76
Stirling,6784,3,16,7,13,61,52,9,55
Stenhousem'r,6784,4,15,9,12,56,47,9,54
Clyde,6784,5,15,9,12,52,48,4,54
Elgin,6784,6,14,6,16,53,62,-9,48
Annan Athlet,6784,7,11,12,13,47,41,6,45
Berwick,6784,8,8,10,18,29,59,-30,34
Edinburgh Ci,6784,9,7,9,20,37,62,-25,30
Cowdenbeath,6784,10,4,11,21,23,54,-31,23
Montrose,6785,1,24,7,5,62,34,28,79
Peterhead,6785,2,24,4,8,79,39,40,76
Stirling,6785,3,17,6,13,62,52,10,57
Clyde,6785,4,15,9,12,53,49,4,54
Stenhousem'r,6785,5,15,8,13,56,48,8,53
Elgin,6785,6,14,6,16,53,63,-10,48
Annan Athlet,6785,7,11,11,14,48,44,4,44
Berwick,6785,8,8,10,18,30,60,-30,34
Edinburgh Ci,6785,9,7,9,20,37,62,-25,30
Cowdenbeath,6785,10,5,10,21,26,55,-29,25
Montrose,6786,1,24,7,5,61,34,27,79
Peterhead,6786,2,24,4,8,78,38,40,76
Stirling,6786,3,17,6,13,63,52,11,57
Clyde,6786,4,15,9,12,53,48,5,54
Stenhousem'r,6786,5,15,8,13,56,49,7,53
Elgin,6786,6,14,6,16,53,62,-9,48
Annan Athlet,6786,7,12,11,13,50,41,9,47
Berwick,6786,8,8,10,18,29,60,-31,34
Edinburgh Ci,6786,9,7,9,20,36,61,-25,30
Cowdenbeath,6786,10,4,10,22,23,57,-34,22
Montrose,6787,1,24,7,5,61,35,26,79
Peterhead,6787,2,24,4,8,80,38,42,76
Stirling,6787,3,16,7,13,60,51,9,55
Stenhousem'r,6787,4,15,9,12,55,46,9,54
Clyde,6787,5,15,9,12,55,50,5,54
Elgin,6787,6,14,6,16,54,62,-8,48
Annan Athlet,6787,7,11,12,13,49,43,6,45
Berwick,6787,8,8,10,18,31,62,-31,34
Edinburgh Ci,6787,9,7,9,20,36,63,-27,30
Cowdenbeath,6787,10,4,11,21,25,56,-31,23
Montrose,6788,1,24,7,5,62,34,28,79
Peterhead,6788,2,24,4,8,81,39,42,76
Stenhousem'r,6788,3,16,8,12,57,47,10,56
Stirling,6788,4,16,6,14,61,53,8,54
Clyde,6788,5,14,9,13,51,50,1,51
Elgin,6788,6,14,6,16,53,63,-10,48
Annan Athlet,6788,7,11,11,14,48,44,4,44
Berwick,6788,8,9,10,17,31,58,-27,37
Edinburgh Ci,6788,9,7,9,20,37,64,-27,30
Cowdenbeath,6788,10,5,10,21,26,55,-29,25
Montrose,6789,1,24,7,5,64,36,28,79
Peterhead,6789,2,24,4,8,82,40,42,76
Stirling,6789,3,16,7,13,62,53,9,55
Stenhousem'r,6789,4,15,9,12,57,48,9,54
Clyde,6789,5,14,9,13,53,51,2,51
Elgin,6789,6,14,6,16,55,65,-10,48
Annan Athlet,6789,7,11,11,14,47,42,5,44
Berwick,6789,8,9,10,17,32,60,-28,37
Edinburgh Ci,6789,9,7,9,20,38,65,-27,30
Cowdenbeath,6789,10,5,10,21,24,54,-30,25
Montrose,6790,1,24,7,5,60,34,26,79
Peterhead,6790,2,24,4,8,81,38,43,76
Stirling,6790,3,17,6,13,63,52,11,57
Clyde,6790,4,15,9,12,53,48,5,54
Stenhousem'r,6790,5,15,8,13,56,49,7,53
Elgin,6790,6,14,6,16,53,61,-8,48
Annan Athlet,6790,7,11,11,14,48,43,5,44
Berwick,6790,8,8,10,18,29,60,-31,34
Edinburgh Ci,6790,9,7,9,20,36,64,-28,30
Cowdenbeath,6790,10,5,10,21,25,55,-30,25
Montrose,6791,1,24,7,5,61,35,26,79
Peterhead,6791,2,24,4,8,79,38,41,76
Stenhousem'r,6791,3,16,8,12,57,46,11,56
Stirling,6791,4,16,6,14,60,53,7,54
Clyde,6791,5,15,9,12,53,48,5,54
Elgin,6791,6,14,6,16,54,62,-8,48
Annan Athlet,6791,7,11,11,14,47,43,4,44
Berwick,6791,8,8,10,18,29,60,-31,34
Edinburgh Ci,6791,9,7,9,20,36,62,-26,30
Cowdenbeath,6791,10,5,10,21,25,54,-29,25
Montrose,6792,1,24,7,5,61,35,26,79
Peterhead,6792,2,24,4,8,79,38,41,76
Stirling,6792,3,17,6,13,64,51,13,57
Stenhousem'r,6792,4,15,8,13,55,50,5,53
Clyde,6792,5,14,10,12,53,50,3,52
Elgin,6792,6,14,6,16,54,62,-8,48
Annan Athlet,6792,7,11,11,14,48,43,5,44
Berwick,6792,8,8,11,17,31,60,-29,35
Edinburgh Ci,6792,9,7,9,20,36,62,-26,30
Cowdenbeath,6792,10,5,10,21,25,55,-30,25
Montrose,6793,1,24,7,5,62,35,27,79
Peterhead,6793,2,23,5,8,77,38,39,74
Stirling,6793,3,17,6,13,64,52,12,57
Stenhousem'r,6793,4,15,8,13,56,50,6,53
Clyde,6793,5,14,10,12,52,49,3,52
Elgin,6793,6,14,6,16,54,63,-9,48
Annan Athlet,6793,7,12,11,13,48,41,7,47
Berwick,6793,8,8,11,17,30,59,-29,35
Edinburgh Ci,6793,9,7,10,19,36,60,-24,31
Cowdenbeath,6793,10,4,10,22,23,55,-32,22
Montrose,6794,1,23,8,5,60,35,25,77
Peterhead,6794,2,24,4,8,82,39,43,76
Stirling,6794,3,16,7,13,60,51,9,55
Stenhousem'r,6794,4,15,9,12,55,46,9,54
Clyde,6794,5,15,9,12,54,48,6,54
Elgin,6794,6,14,7,15,54,61,-7,49
Annan Athlet,6794,7,11,11,14,47,43,4,44
Berwick,6794,8,8,10,18,29,61,-32,34
Edinburgh Ci,6794,9,7,9,20,37,65,-28,30
Cowdenbeath,6794,10,5,10,21,25,54,-29,25
Montrose,6795,1,24,7,5,62,34,28,79
Peterhead,6795,2,24,4,8,81,39,42,76
Stirling,6795,3,16,7,13,63,54,9,55
Stenhousem'r,6795,4,15,9,12,58,49,9,54
Clyde,6795,5,15,9,12,52,48,4,54
Elgin,6795,6,14,6,16,53,63,-10,48
Annan Athlet,6795,7,12,11,13,49,42,7,47
Berwick,6795,8,8,10,18,29,59,-30,34
Edinburgh Ci,6795,9,7,9,20,37,64,-27,30
Cowdenbeath,6795,10,4,10,22,24,56,-32,22
Montrose,6796,1,24,7,5,62,36,26,79
Peterhead,6796,2,24,4,8,79,38,41,76
Stirling,6796,3,17,6,13,62,52,10,57
Clyde,6796,4,15,9,12,53,49,4,54
Stenhousem'r,6796,5,15,8,13,56,48,8,53
Elgin,6796,6,14,6,16,55,63,-8,48
Annan Athlet,6796,7,12,11,13,49,42,7,47
Berwick,6796,8,8,10,18,30,60,-30,34
Edinburgh Ci,6796,9,7,9,20,36,62,-26,30
Cowdenbeath,6796,10,4,10,22,24,56,-32,22
Montrose,6797,1,23,7,6,60,36,24,76
Peterhead,6797,2,23,5,8,77,38,39,74
Stenhousem'r,6797,3,16,8,12,58,47,11,56
Stirling,6797,4,16,6,14,61,54,7,54
Clyde,6797,5,15,9,12,53,48,5,54
Elgin,6797,6,15,6,15,55,61,-6,51
Annan Athlet,6797,7,12,11,13,49,42,7,47
Berwick,6797,8,8,10,18,29,60,-31,34
Edinburgh Ci,6797,9,7,10,19,36,60,-24,31
Cowdenbeath,6797,10,4,10,22,24,56,-32,22
Montrose,6798,1,24,7,5,61,34,27,79
Peterhead,6798,2,24,4,8,80,38,42,76
Stirling,6798,3,17,6,13,61,51,10,57
Stenhousem'r,6798,4,15,8,13,55,47,8,53
Clyde,6798,5,14,10,12,51,48,3,52
Elgin,6798,6,14,6,16,53,62,-9,48
Annan Athlet,6798,7,11,12,13,47,41,6,45
Berwick,6798,8,8,11,17,29,58,-29,35
Edinburgh Ci,6798,9,7,9,20,36,63,-27,30
Cowdenbeath,6798,10,4,11,21,23,54,-31,23
Montrose,6799,1,24,7,5,61,35,26,79
Peterhead,6799,2,24,4,8,80,38,42,76
Stenhousem'r,6799,3,16,8,12,57,47,10,56
Stirling,6799,4,16,6,14,61,53,8,54
Clyde,6799,5,15,9,12,56,48,8,54
Elgin,6799,6,14,6,16,54,62,-8,48
Annan Athlet,6799,7,12,11,13,48,41,7,47
Berwick,6799,8,8,10,18,29,63,-34,34
Edinburgh Ci,6799,9,7,9,20,36,63,-27,30
Cowdenbeath,6799,10,4,10,22,23,55,-32,22
Peterhead,6800,1,24,4,8,84,39,45,76
Montrose,6800,2,23,7,6,60,38,22,76
Stirling,6800,3,16,7,13,62,53,9,55
Stenhousem'r,6800,4,15,9,12,57,48,9,54
Clyde,6800,5,15,9,12,52,48,4,54
Elgin,6800,6,15,6,15,57,61,-4,51
Annan Athlet,6800,7,12,11,13,50,41,9,47
Berwick,6800,8,8,10,18,29,59,-30,34
Edinburgh Ci,6800,9,7,9,20,37,67,-30,30
Cowdenbeath,6800,10,4,10,22,23,57,-34,22
Montrose,6801,1,24,7,5,65,35,30,79
Peterhead,6801,2,24,4,8,81,38,43,76
Stirling,6801,3,17,6,13,63,52,11,57
Stenhousem'r,6801,4,15,8,13,56,49,7,53
Clyde,6801,5,14,9,13,52,50,2,51
Elgin,6801,6,14,6,16,54,66,-12,48
Annan Athlet,6801,7,12,11,13,51,42,9,47
Berwick,6801,8,9,10,17,31,59,-28,37
Edinburgh Ci,6801,9,7,9,20,36,64,-28,30
Cowdenbeath,6801,10,4,10,22,24,58,-34,22
Montrose,6802,1,24,7,5,64,35,29,79
Peterhead,6802,2,24,4,8,79,39,40,76
Stirling,6802,3,16,7,13,61,52,9,55
Stenhousem'r,6802,4,15,9,12,56,47,9,54
Clyde,6802,5,14,9,13,52,50,2,51
Elgin,6802,6,14,6,16,54,65,-11,48
Annan Athlet,6802,7,12,11,13,48,41,7,47
Berwick,6802,8,9,10,17,31,59,-28,37
Edinburgh Ci,6802,9,7,9,20,37,62,-25,30
Cowdenbeath,6802,10,4,10,22,23,55,-32,22
Montrose,6803,1,24,7,5,61,34,27,79
Peterhead,6803,2,23,4,9,78,41,37,73
Stirling,6803,3,16,7,13,62,53,9,55
Stenhousem'r,6803,4,15,9,12,57,48,9,54
Clyde,6803,5,15,9,12,53,48,5,54
Elgin,6803,6,14,6,16,53,62,-9,48
Annan Athlet,6803,7,11,11,14,47,43,4,44
Berwick,6803,8,8,10,18,29,60,-31,34
Edinburgh Ci,6803,9,8,9,19,39,61,-22,33
Cowdenbeath,6803,10,5,10,21,25,54,-29,25
Montrose,6804,1,24,7,5,61,34,27,79
Peterhead,6804,2,24,4,8,79,39,40,76
Stenhousem'r,6804,3,16,8,12,56,46,10,56
Stirling,6804,4,16,6,14,60,52,8,54
Clyde,6804,5,14,9,13,51,49,2,51
Elgin,6804,6,14,6,16,53,62,-9,48
Annan Athlet,6804,7,12,11,13,49,42,7,47
Berwick,6804,8,9,10,17,30,58,-28,37
Edinburgh Ci,6804,9,7,9,20,37,62,-25,30
Cowdenbeath,6804,10,4,10,22,24,56,-32,22
Montrose,6805,1,24,7,5,61,34,27,79
Peterhead,6805,2,24,4,8,84,38,46,76
Stenhousem'r,6805,3,16,8,12,57,46,11,56
Stirling,6805,4,16,6,14,60,53,7,54
Clyde,6805,5,14,10,12,51,48,3,52
Elgin,6805,6,14,6,16,53,62,-9,48
Annan Athlet,6805,7,11,11,14,47,43,4,44
Berwick,6805,8,8,11,17,29,58,-29,35
Edinburgh Ci,6805,9,7,9,20,36,67,-31,30
Cowdenbeath,6805,10,5,10,21,25,54,-29,25
Montrose,6806,1,23,8,5,60,35,25,77
Peterhead,6806,2,24,4,8,82,38,44,76
Stirling,6806,3,16,7,13,61,52,9,55
Stenhousem'r,6806,4,15,9,12,56,47,9,54
Clyde,6806,5,15,9,12,54,50,4,54
Elgin,6806,6,14,7,15,54,61,-7,49
Annan Athlet,6806,7,12,11,13,50,42,8,47
Berwick,6806,8,8,10,18,31,61,-30,34
Edinburgh Ci,6806,9,7,9,20,36,65,-29,30
Cowdenbeath,6806,10,4,10,22,24,57,-33,22
Montrose,6807,1,24,7,5,60,34,26,79
Peterhead,6807,2,24,4,8,79,39,40,76
Stenhousem'r,6807,3,16,8,12,58,48,10,56
Stirling,6807,4,16,6,14,62,54,8,54
Clyde,6807,5,15,9,12,53,48,5,54
Elgin,6807,6,14,6,16,53,61,-8,48
Annan Athlet,6807,7,12,11,13,50,42,8,47
Berwick,6807,8,8,10,18,29,60,-31,34
Edinburgh Ci,6807,9,7,9,20,37,62,-25,30
Cowdenbeath,6807,10,4,10,22,24,57,-33,22
Montrose,6808,1,24,7,5,60,34,26,79
Peterhead,6808,2,23,5,8,79,40,39,74
Stenhousem'r,6808,3,16,8,12,59,47,12,56
Stirling,6808,4,16,6,14,61,55,6,54
Clyde,6808,5,15,9,12,53,49,4,54
Elgin,6808,6,14,6,16,53,61,-8,48
Annan Athlet,6808,7,12,11,13,49,41,8,47
Berwick,6808,8,8,10,18,30,60,-30,34
Edinburgh Ci,6808,9,7,10,19,38,62,-24,31
Cowdenbeath,6808,10,4,10,22,23,56,-33,22
Peterhead,6809,1,24,4,8,80,38,42,76
Montrose,6809,2,23,7,6,59,35,24,76
Stirling,6809,3,16,7,13,62,53,9,55
Stenhousem'r,6809,4,15,9,12,57,48,9,54
Clyde,6809,5,14,9,13,51,49,2,51
Elgin,6809,6,15,6,15,54,60,-6,51
Annan Athlet,6809,7,11,11,14,47,42,5,44
Berwick,6809,8,9,10,17,30,58,-28,37
Edinburgh Ci,6809,9,7,9,20,36,63,-27,30
Cowdenbeath,6809,10,5,10,21,24,54,-30,25
Montrose,6810,1,23,8,5,59,34,25,77
Peterhead,6810,2,24,4,8,81,38,43,76
Stirling,6810,3,17,6,13,62,52,10,57
Clyde,6810,4,15,9,12,54,49,5,54
Stenhousem'r,6810,5,15,8,13,56,48,8,53
Elgin,6810,6,14,7,15,53,60,-7,49
Annan Athlet,6810,7,11,11,14,47,42,5,44
Berwick,6810,8,8,10,18,30,61,-31,34
Edinburgh Ci,6810,9,7,9,20,36,64,-28,30
Cowdenbeath,6810,10,5,10,21,24,54,-30,25
Montrose,6811,1,24,7,5,62,35,27,79
Peterhead,6811,2,24,4,8,81,39,42,76
Stirling,6811,3,17,6,13,62,52,10,57
Stenhousem'r,6811,4,15,8,13,56,48,8,53
Clyde,6811,5,14,10,12,51,48,3,52
Elgin,6811,6,14,6,16,54,63,-9,48
Annan Athlet,6811,7,11,12,13,48,42,6,45
Berwick,6811,8,8,11,17,29,58,-29,35
Edinburgh Ci,6811,9,7,9,20,37,64,-27,30
Cowdenbeath,6811,10,4,11,21,24,55,-31,23
Montrose,6812,1,24,7,5,61,34,27,79
Peterhead,6812,2,24,4,8,80,39,41,76
Stenhousem'r,6812,3,16,8,12,56,46,10,56
Stirling,6812,4,16,6,14,60,52,8,54
Clyde,6812,5,15,9,12,55,48,7,54
Elgin,6812,6,14,6,16,53,62,-9,48
Annan Athlet,6812,7,12,11,13,49,41,8,47
Berwick,6812,8,8,10,18,29,62,-33,34
Edinburgh Ci,6812,9,7,9,20,37,63,-26,30
Cowdenbeath,6812,10,4,10,22,23,56,-33,22
Montrose,6813,1,23,8,5,60,35,25,77
Peterhead,6813,2,24,4,8,80,40,40,76
Stirling,6813,3,17,6,13,64,52,12,57
Stenhousem'r,6813,4,15,8,13,56,50,6,53
Clyde,6813,5,14,10,12,51,48,3,52
Elgin,6813,6,14,7,15,54,61,-7,49
Annan Athlet,6813,7,11,11,14,47,43,4,44
Berwick,6813,8,8,11,17,29,58,-29,35
Edinburgh Ci,6813,9,7,9,20,38,63,-25,30
Cowdenbeath,6813,10,5,10,21,25,54,-29,25
Montrose,6814,1,24,7,5,62,34,28,79
Peterhead,6814,2,24,4,8,80,38,42,76
Stirling,6814,3,16,7,13,60,51,9,55
Stenhousem'r,6814,4,15,9,12,55,46,9,54
Clyde,6814,5,15,9,12,53,48,5,54
Elgin,6814,6,14,6,16,53,63,-10,48
Annan Athlet,6814,7,11,11,14,48,43,5,44
Berwick,6814,8,8,10,18,29,60,-31,34
Edinburgh Ci,6814,9,7,9,20,36,63,-27,30
Cowdenbeath,6814,10,5,10,21,25,55,-30,25
Montrose,6815,1,24,7,5,60,34,26,79
Peterhead,6815,2,23,5,8,78,39,39,74
Stenhousem'r,6815,3,16,8,12,59,47,12,56
Stirling,6815,4,16,6,14,61,55,6,54
Clyde,6815,5,14,10,12,53,50,3,52
Elgin,6815,6,14,6,16,53,61,-8,48
Annan Athlet,6815,7,11,12,13,47,41,6,45
Berwick,6815,8,8,11,17,31,60,-29,35
Edinburgh Ci,6815,9,7,10,19,37,61,-24,31
Cowdenbeath,6815,10,4,11,21,23,54,-31,23
Montrose,6816,1,24,7,5,65,37,28,79
Peterhead,6816,2,24,4,8,78,38,40,76
Stirling,6816,3,17,6,13,63,53,10,57
Stenhousem'r,6816,4,15,8,13,57,49,8,53
Clyde,6816,5,14,9,13,51,49,2,51
Elgin,6816,6,14,6,16,56,66,-10,48
Annan Athlet,6816,7,11,12,13,47,41,6,45
Berwick,6816,8,9,10,17,30,58,-28,37
Edinburgh Ci,6816,9,7,9,20,36,61,-25,30
Cowdenbeath,6816,10,4,11,21,23,54,-31,23
Montrose,6817,1,23,8,5,61,36,25,77
Peterhead,6817,2,23,5,8,78,39,39,74
Stenhousem'r,6817,3,16,8,12,59,48,11,56
Stirling,6817,4,16,6,14,62,55,7,54
Clyde,6817,5,14,9,13,52,51,1,51
Elgin,6817,6,14,7,15,55,62,-7,49
Annan Athlet,6817,7,12,11,13,48,41,7,47
Berwick,6817,8,9,10,17,32,59,-27,37
Edinburgh Ci,6817,9,7,10,19,37,61,-24,31
Cowdenbeath,6817,10,4,10,22,23,55,-32,22
Montrose,6818,1,24,7,5,62,34,28,79
Peterhead,6818,2,23,5,8,78,39,39,74
Stirling,6818,3,17,6,13,62,52,10,57
Clyde,6818,4,15,9,12,53,49,4,54
Stenhousem'r,6818,5,15,8,13,56,48,8,53
Elgin,6818,6,14,6,16,53,63,-10,48
Annan Athlet,6818,7,11,12,13,48,42,6,45
Berwick,6818,8,8,10,18,30,60,-30,34
Edinburgh Ci,6818,9,7,10,19,37,61,-24,31
Cowdenbeath,6818,10,4,11,21,24,55,-31,23
Montrose,6819,1,23,8,5,61,36,25,77
Peterhead,6819,2,24,4,8,80,38,42,76
Stenhousem'r,6819,3,16,8,12,56,46,10,56
Stirling,6819,4,16,6,14,60,52,8,54
Clyde,6819,5,15,9,12,52,48,4,54
Elgin,6819,6,14,7,15,55,62,-7,49
Annan Athlet,6819,7,11,11,14,47,42,5,44
Berwick,6819,8,8,10,18,29,59,-30,34
Edinburgh Ci,6819,9,7,9,20,36,63,-27,30
Cowdenbeath,6819,10,5,10,21,24,54,-30,25
Peterhead,6820,1,24,4,8,79,39,40,76
Montrose,6820,2,23,7,6,60,37,23,76
Stenhousem'r,6820,3,16,8,12,56,46,10,56
Stirling,6820,4,16,6,14,60,52,8,54
Clyde,6820,5,15,9,12,53,48,5,54
Elgin,6820,6,15,6,15,56,61,-5,51
Annan Athlet,6820,7,11,11,14,47,42,5,44
Berwick,6820,8,8,10,18,29,60,-31,34
Edinburgh Ci,6820,9,7,9,20,37,62,-25,30
Cowdenbeath,6820,10,5,10,21,24,54,-30,25
Montrose,6821,1,24,7,5,64,37,27,79
Peterhead,6821,2,23,5,8,77,38,39,74
Stirling,6821,3,16,7,13,63,54,9,55
Stenhousem'r,6821,4,15,9,12,58,49,9,54
Clyde,6821,5,15,9,12,53,49,4,54
Elgin,6821,6,14,6,16,56,65,-9,48
Annan Athlet,6821,7,11,12,13,48,42,6,45
Berwick,6821,8,8,10,18,30,60,-30,34
Edinburgh Ci,6821,9,7,10,19,36,60,-24,31
Cowdenbeath,6821,10,4,11,21,24,55,-31,23
Montrose,6822,1,23,7,6,59,36,23,76
Peterhead,6822,2,23,5,8,78,39,39,74
Stirling,6822,3,16,7,13,61,52,9,55
Stenhousem'r,6822,4,15,9,12,56,47,9,54
Clyde,6822,5,15,9,12,54,48,6,54
Elgin,6822,6,15,6,15,55,60,-5,51
Annan Athlet,6822,7,12,11,13,49,42,7,47
Berwick,6822,8,8,10,18,29,61,-32,34
Edinburgh Ci,6822,9,7,10,19,37,61,-24,31
Cowdenbeath,6822,10,4,10,22,24,56,-32,22
Montrose,6823,1,24,7,5,61,34,27,79
Peterhead,6823,2,24,4,8,80,40,40,76
Stirling,6823,3,17,6,13,62,51,11,57
Clyde,6823,4,15,9,12,52,48,4,54
Stenhousem'r,6823,5,15,8,13,55,48,7,53
Elgin,6823,6,14,6,16,53,62,-9,48
Annan Athlet,6823,7,11,11,14,48,43,5,44
Berwick,6823,8,8,10,18,29,59,-30,34
Edinburgh Ci,6823,9,7,9,20,38,63,-25,30
Cowdenbeath,6823,10,5,10,21,25,55,-30,25
Peterhead,6824,1,24,4,8,81,39,42,76
Montrose,6824,2,23,7,6,60,36,24,76
Stirling,6824,3,17,6,13,61,51,10,57
Clyde,6824,4,15,9,12,53,48,5,54
Stenhousem'r,6824,5,15,8,13,55,47,8,53
Elgin,6824,6,15,6,15,55,61,-6,51
Annan Athlet,6824,7,11,11,14,48,43,5,44
Berwick,6824,8,8,10,18,29,60,-31,34
Edinburgh Ci,6824,9,7,9,20,37,64,-27,30
Cowdenbeath,6824,10,5,10,21,25,55,-30,25
Montrose,6825,1,24,7,5,61,34,27,79
Peterhead,6825,2,23,5,8,78,39,39,74
Stirling,6825,3,17,6,13,63,51,12,57
Clyde,6825,4,15,9,12,54,48,6,54
Stenhousem'r,6825,5,15,8,13,55,49,6,53
Elgin,6825,6,14,6,16,53,62,-9,48
Annan Athlet,6825,7,11,11,14,49,44,5,44
Berwick,6825,8,8,10,18,29,61,-32,34
Edinburgh Ci,6825,9,7,10,19,37,61,-24,31
Cowdenbeath,6825,10,5,10,21,26,56,-30,25
Montrose,6826,1,24,7,5,61,35,26,79
Peterhead,6826,2,24,4,8,85,38,47,76
Stirling,6826,3,16,7,13,62,53,9,55
Stenhousem'r,6826,4,15,9,12,57,48,9,54
Clyde,6826,5,14,9,13,51,51,0,51
Elgin,6826,6,14,6,16,54,62,-8,48
Annan Athlet,6826,7,12,11,13,50,42,8,47
Berwick,6826,8,9,10,17,32,58,-26,37
Edinburgh Ci,6826,9,7,9,20,36,68,-32,30
Cowdenbeath,6826,10,4,10,22,24,57,-33,22
Montrose,6827,1,24,7,5,60,34,26,79
Peterhead,6827,2,24,4,8,79,39,40,76
Stirling,6827,3,17,6,13,62,52,10,57
Stenhousem'r,6827,4,15,8,13,56,48,8,53
Clyde,6827,5,14,9,13,51,49,2,51
Elgin,6827,6,14,6,16,53,61,-8,48
Annan Athlet,6827,7,11,11,14,47,43,4,44
Berwick,6827,8,9,10,17,30,58,-28,37
Edinburgh Ci,6827,9,7,9,20,37,62,-25,30
Cowdenbeath,6827,10,5,10,21,25,54,-29,25
Montrose,6828,1,24,7,5,62,35,27,79
Peterhead,6828,2,24,4,8,79,38,41,76
Stenhousem'r,6828,3,16,8,12,59,47,12,56
Clyde,6828,4,15,9,12,58,48,10,54
Stirling,6828,5,16,6,14,61,55,6,54
Elgin,6828,6,14,6,16,54,63,-9,48
Annan Athlet,6828,7,11,11,14,48,43,5,44
Berwick,6828,8,8,10,18,29,65,-36,34
Edinburgh Ci,6828,9,7,9,20,36,62,-26,30
Cowdenbeath,6828,10,5,10,21,25,55,-30,25
Montrose,6829,1,23,8,5,60,35,25,77
Peterhead,6829,2,24,4,8,81,39,42,76
Stenhousem'r,6829,3,16,8,12,57,46,11,56
Stirling,6829,4,16,6,14,60,53,7,54
Clyde,6829,5,14,10,12,52,49,3,52
Elgin,6829,6,14,7,15,54,61,-7,49
Annan Athlet,6829,7,11,12,13,48,42,6,45
Berwick,6829,8,8,11,17,30,59,-29,35
Edinburgh Ci,6829,9,7,9,20,37,64,-27,30
Cowdenbeath,6829,10,4,11,21,24,55,-31,23
Montrose,6830,1,24,7,5,60,34,26,79
Peterhead,6830,2,24,4,8,79,39,40,76
Stirling,6830,3,16,7,13,61,52,9,55
Stenhousem'r,6830,4,15,9,12,56,47,9,54
Clyde,6830,5,14,10,12,51,48,3,52
Elgin,6830,6,14,6,16,53,61,-8,48
Annan Athlet,6830,7,12,11,13,48,41,7,47
Berwick,6830,8,8,11,17,29,58,-29,35
Edinburgh Ci,6830,9,7,9,20,37,62,-25,30
Cowdenbeath,6830,10,4,10,22,23,55,-32,22
Montrose,6831,1,23,7,6,59,37,22,76
Peterhead,6831,2,23,5,8,79,40,39,74
Stirling,6831,3,17,6,13,61,51,10,57
Stenhousem'r,6831,4,15,8,13,55,47,8,53
Clyde,6831,5,14,10,12,54,51,3,52
Elgin,6831,6,15,6,15,56,60,-4,51
Annan Athlet,6831,7,11,11,14,47,44,3,44
Berwick,6831,8,8,11,17,32,61,-29,35
Edinburgh Ci,6831,9,7,10,19,38,62,-24,31
Cowdenbeath,6831,10,5,10,21,26,54,-28,25
Montrose,6832,1,23,8,5,61,36,25,77
Peterhead,6832,2,24,4,8,82,38,44,76
Stirling,6832,3,17,6,13,63,51,12,57
Stenhousem'r,6832,4,15,8,13,55,49,6,53
Clyde,6832,5,14,10,12,52,49,3,52
Elgin,6832,6,14,7,15,55,62,-7,49
Annan Athlet,6832,7,11,12,13,47,41,6,45
Berwick,6832,8,8,11,17,30,59,-29,35
Edinburgh Ci,6832,9,7,9,20,36,65,-29,30
Cowdenbeath,6832,10,4,11,21,23,54,-31,23
Montrose,6833,1,24,7,5,62,35,27,79
Peterhead,6833,2,23,4,9,80,42,38,73
Stirling,6833,3,17,6,13,62,51,11,57
Clyde,6833,4,15,9,12,53,48,5,54
Stenhousem'r,6833,5,15,8,13,55,48,7,53
Elgin,6833,6,14,6,16,54,63,-9,48
Annan Athlet,6833,7,12,11,13,50,41,9,47
Berwick,6833,8,8,10,18,29,60,-31,34
Edinburgh Ci,6833,9,8,9,19,40,63,-23,33
Cowdenbeath,6833,10,4,10,22,23,57,-34,22
Montrose,6834,1,23,8,5,59,34,25,77
Peterhead,6834,2,23,5,8,78,39,39,74
Stenhousem'r,6834,3,16,8,12,56,46,10,56
Stirling,6834,4,16,6,14,60,52,8,54
Clyde,6834,5,14,9,13,52,51,1,51
Elgin,6834,6,14,7,15,53,60,-7,49
Annan Athlet,6834,7,11,12,13,48,42,6,45
Berwick,6834,8,9,10,17,32,59,-27,37
Edinburgh Ci,6834,9,7,10,19,37,61,-24,31
Cowdenbeath,6834,10,4,11,21,24,55,-31,23
Montrose,6835,1,24,7,5,61,34,27,79
Peterhead,6835,2,24,4,8,81,39,42,76
Stirling,6835,3,17,6,13,62,51,11,57
Clyde,6835,4,15,9,12,53,48,5,54
Stenhousem'r,6835,5,15,8,13,55,48,7,53
Elgin,6835,6,14,6,16,53,62,-9,48
Annan Athlet,6835,7,12,11,13,49,41,8,47
Berwick,6835,8,8,10,18,29,60,-31,34
Edinburgh Ci,6835,9,7,9,20,37,64,-27,30
Cowdenbeath,6835,10,4,10,22,23,56,-33,22
Montrose,6836,1,24,7,5,62,34,28,79
Peterhead,6836,2,24,4,8,78,38,40,76
Stirling,6836,3,17,6,13,63,53,10,57
Clyde,6836,4,15,9,12,55,48,7,54
Stenhousem'r,6836,5,15,8,13,57,49,8,53
Elgin,6836,6,14,6,16,53,63,-10,48
Annan Athlet,6836,7,12,11,13,51,41,10,47
Berwick,6836,8,8,10,18,29,62,-33,34
Edinburgh Ci,6836,9,7,9,20,36,61,-25,30
Cowdenbeath,6836,10,4,10,22,23,58,-35,22
Montrose,6837,1,24,7,5,64,34,30,79
Peterhead,6837,2,23,4,9,77,39,38,73
Stirling,6837,3,17,6,13,63,52,11,57
Clyde,6837,4,15,9,12,54,48,6,54
Stenhousem'r,6837,5,15,8,13,56,49,7,53
Elgin,6837,6,14,6,16,53,65,-12,48
Annan Athlet,6837,7,11,11,14,47,43,4,44
Berwick,6837,8,8,10,18,29,61,-32,34
Edinburgh Ci,6837,9,8,9,19,37,60,-23,33
Cowdenbeath,6837,10,5,10,21,25,54,-29,25
Montrose,6838,1,23,8,5,60,35,25,77
Peterhead,6838,2,23,4,9,77,40,37,73
Stirling,6838,3,16,7,13,61,52,9,55
Stenhousem'r,6838,4,15,9,12,56,47,9,54
Clyde,6838,5,15,9,12,56,48,8,54
Elgin,6838,6,14,7,15,54,61,-7,49
Annan Athlet,6838,7,11,11,14,47,42,5,44
Berwick,6838,8,8,10,18,29,63,-34,34
Edinburgh Ci,6838,9,8,9,19,38,60,-22,33
Cowdenbeath,6838,10,5,10,21,24,54,-30,25
Montrose,6839,1,24,7,5,64,36,28,79
Peterhead,6839,2,24,4,8,79,38,41,76
Stenhousem'r,6839,3,16,8,12,57,47,10,56
Stirling,6839,4,16,6,14,61,53,8,54
Clyde,6839,5,14,10,12,53,50,3,52
Elgin,6839,6,14,6,16,55,65,-10,48
Annan Athlet,6839,7,11,11,14,48,44,4,44
Berwick,6839,8,8,11,17,31,60,-29,35
Edinburgh Ci,6839,9,7,9,20,36,62,-26,30
Cowdenbeath,6839,10,5,10,21,26,55,-29,25
Montrose,6840,1,24,7,5,62,34,28,79
Peterhead,6840,2,24,4,8,81,39,42,76
Stirling,6840,3,17,6,13,65,52,13,57
Clyde,6840,4,15,9,12,54,48,6,54
Stenhousem'r,6840,5,15,8,13,56,51,5,53
Elgin,6840,6,14,6,16,53,63,-10,48
Annan Athlet,6840,7,12,11,13,49,41,8,47
Berwick,6840,8,8,10,18,29,61,-32,34
Edinburgh Ci,6840,9,7,9,20,37,64,-27,30
Cowdenbeath,6840,10,4,10,22,23,56,-33,22
Montrose,6841,1,24,7,5,62,35,27,79
Peterhead,6841,2,23,5,8,79,40,39,74
Stirling,6841,3,17,6,13,63,52,11,57
Stenhousem'r,6841,4,15,8,13,56,49,7,53
Clyde,6841,5,14,9,13,52,50,2,51
Elgin,6841,6,14,6,16,54,63,-9,48
Annan Athlet,6841,7,12,11,13,49,42,7,47
Berwick,6841,8,9,10,17,31,59,-28,37
Edinburgh Ci,6841,9,7,10,19,38,62,-24,31
Cowdenbeath,6841,10,4,10,22,24,56,-32,22
Montrose,6842,1,23,8,5,60,35,25,77
Peterhead,6842,2,24,4,8,79,38,41,76
Stirling,6842,3,17,6,13,62,52,10,57
Stenhousem'r,6842,4,15,8,13,56,48,8,53
Clyde,6842,5,14,10,12,51,48,3,52
Elgin,6842,6,14,7,15,54,61,-7,49
Annan Athlet,6842,7,12,11,13,50,42,8,47
Berwick,6842,8,8,11,17,29,58,-29,35
Edinburgh Ci,6842,9,7,9,20,36,62,-26,30
Cowdenbeath,6842,10,4,10,22,24,57,-33,22
Montrose,6843,1,23,7,6,60,37,23,76
Peterhead,6843,2,23,4,9,80,42,38,73
Stirling,6843,3,16,7,13,61,52,9,55
Stenhousem'r,6843,4,15,9,12,56,47,9,54
Clyde,6843,5,15,9,12,53,49,4,54
Elgin,6843,6,15,6,15,56,61,-5,51
Annan Athlet,6843,7,12,11,13,49,42,7,47
Berwick,6843,8,8,10,18,30,60,-30,34
Edinburgh Ci,6843,9,8,9,19,40,63,-23,33
Cowdenbeath,6843,10,4,10,22,24,56,-32,22
Montrose,6844,1,23,8,5,60,35,25,77
Peterhead,6844,2,24,4,8,79,39,40,76
Stirling,6844,3,16,7,13,61,52,9,55
Stenhousem'r,6844,4,15,9,12,56,47,9,54
Clyde,6844,5,14,10,12,51,48,3,52
Elgin,6844,6,14,7,15,54,61,-7,49
Annan Athlet,6844,7,12,11,13,49,41,8,47
Berwick,6844,8,8,11,17,29,58,-29,35
Edinburgh Ci,6844,9,7,9,20,37,62,-25,30
Cowdenbeath,6844,10,4,10,22,23,56,-33,22
Peterhead,6845,1,24,4,8,80,38,42,76
Montrose,6845,2,23,7,6,59,35,24,76
Stirling,6845,3,17,6,13,63,51,12,57
Clyde,6845,4,15,9,12,54,48,6,54
Stenhousem'r,6845,5,15,8,13,55,49,6,53
Elgin,6845,6,15,6,15,54,60,-6,51
Annan Athlet,6845,7,11,12,13,47,41,6,45
Berwick,6845,8,8,10,18,29,61,-32,34
Edinburgh Ci,6845,9,7,9,20,36,63,-27,30
Cowdenbeath,6845,10,4,11,21,23,54,-31,23
Montrose,6846,1,24,7,5,60,34,26,79
Peterhead,6846,2,23,5,8,80,41,39,74
Stirling,6846,3,16,7,13,60,51,9,55
Stenhousem'r,6846,4,15,9,12,55,46,9,54
Clyde,6846,5,14,9,13,51,51,0,51
Elgin,6846,6,14,6,16,53,61,-8,48
Annan Athlet,6846,7,12,11,13,49,42,7,47
Berwick,6846,8,9,10,17,32,58,-26,37
Edinburgh Ci,6846,9,7,10,19,39,63,-24,31
Cowdenbeath,6846,10,4,10,22,24,56,-32,22
Montrose,6847,1,24,7,5,62,36,26,79
Peterhead,6847,2,24,4,8,83,39,44,76
Stirling,6847,3,17,6,13,64,52,12,57
Clyde,6847,4,15,9,12,52,48,4,54
Stenhousem'r,6847,5,15,8,13,56,50,6,53
Elgin,6847,6,14,6,16,55,63,-8,48
Annan Athlet,6847,7,11,12,13,47,41,6,45
Berwick,6847,8,8,10,18,29,59,-30,34
Edinburgh Ci,6847,9,7,9,20,37,66,-29,30
Cowdenbeath,6847,10,4,11,21,23,54,-31,23
Montrose,6848,1,24,7,5,61,35,26,79
Peterhead,6848,2,24,4,8,80,40,40,76
Stenhousem'r,6848,3,16,8,12,58,48,10,56
Stirling,6848,4,16,6,14,62,54,8,54
Clyde,6848,5,15,9,12,54,48,6,54
Elgin,6848,6,14,6,16,54,62,-8,48
Annan Athlet,6848,7,11,12,13,48,42,6,45
Berwick,6848,8,8,10,18,29,61,-32,34
Edinburgh Ci,6848,9,7,9,20,38,63,-25,30
Cowdenbeath,6848,10,4,11,21,24,55,-31,23
Montrose,6849,1,24,7,5,61,34,27,79
Peterhead,6849,2,23,4,9,77,39,38,73
Stenhousem'r,6849,3,16,8,12,58,47,11,56
Stirling,6849,4,16,6,14,61,54,7,54
Clyde,6849,5,15,9,12,53,49,4,54
Elgin,6849,6,14,6,16,53,62,-9,48
Annan Athlet,6849,7,11,12,13,47,41,6,45
Berwick,6849,8,8,10,18,30,60,-30,34
Edinburgh Ci,6849,9,8,9,19,37,60,-23,33
Cowdenbeath,6849,10,4,11,21,23,54,-31,23
Montrose,6850,1,24,7,5,62,35,27,79
Peterhead,6850,2,24,4,8,80,38,42,76
Stirling,6850,3,16,7,13,61,52,9,55
Stenhousem'r,6850,4,15,9,12,56,47,9,54
Clyde,6850,5,15,9,12,54,49,5,54
Elgin,6850,6,14,6,16,54,63,-9,48
Annan Athlet,6850,7,11,12,13,47,41,6,45
Berwick,6850,8,8,10,18,30,61,-31,34
Edinburgh Ci,6850,9,7,9,20,36,63,-27,30
Cowdenbeath,6850,10,4,11,21,23,54,-31,23
Peterhead,6851,1,24,4,8,80,39,41,76
Montrose,6851,2,23,7,6,60,36,24,76
Stirling,6851,3,17,6,13,63,51,12,57
Clyde,6851,4,15,9,12,52,48,4,54
Stenhousem'r,6851,5,15,8,13,55,49,6,53
Elgin,6851,6,15,6,15,55,61,-6,51
Annan Athlet,6851,7,11,12,13,47,41,6,45
Berwick,6851,8,8,10,18,29,59,-30,34
Edinburgh Ci,6851,9,7,9,20,37,63,-26,30
Cowdenbeath,6851,10,4,11,21,23,54,-31,23
Montrose,6852,1,24,7,5,63,34,29,79
Peterhead,6852,2,24,4,8,80,38,42,76
Stenhousem'r,6852,3,16,8,12,58,48,10,56
Stirling,6852,4,16,6,14,62,54,8,54
Clyde,6852,5,15,9,12,55,49,6,54
Elgin,6852,6,14,6,16,53,64,-11,48
Annan Athlet,6852,7,12,11,13,50,42,8,47
Berwick,6852,8,8,10,18,30,62,-32,34
Edinburgh Ci,6852,9,7,9,20,36,63,-27,30
Cowdenbeath,6852,10,4,10,22,24,57,-33,22
Montrose,6853,1,24,7,5,61,34,27,79
Peterhead,6853,2,23,4,9,79,42,37,73
Stirling,6853,3,16,7,13,63,54,9,55
Stenhousem'r,6853,4,15,9,12,58,49,9,54
Clyde,6853,5,14,10,12,52,49,3,52
Elgin,6853,6,14,6,16,53,62,-9,48
Annan Athlet,6853,7,11,11,14,47,43,4,44
Berwick,6853,8,8,11,17,30,59,-29,35
Edinburgh Ci,6853,9,8,9,19,40,62,-22,33
Cowdenbeath,6853,10,5,10,21,25,54,-29,25
Montrose,6854,1,24,7,5,63,35,28,79
Peterhead,6854,2,24,4,8,79,38,41,76
Stirling,6854,3,17,6,13,61,51,10,57
Stenhousem'r,6854,4,15,8,13,55,47,8,53
Clyde,6854,5,14,10,12,53,50,3,52
Elgin,6854,6,14,6,16,54,64,-10,48
Annan Athlet,6854,7,11,11,14,47,42,5,44
Berwick,6854,8,8,11,17,31,60,-29,35
Edinburgh Ci,6854,9,7,9,20,36,62,-26,30
Cowdenbeath,6854,10,5,10,21,24,54,-30,25
Peterhead,6855,1,24,4,8,79,38,41,76
Montrose,6855,2,23,7,6,61,37,24,76
Stirling,6855,3,16,7,13,62,53,9,55
Stenhousem'r,6855,4,15,9,12,57,48,9,54
Clyde,6855,5,14,10,12,53,50,3,52
Elgin,6855,6,15,6,15,56,62,-6,51
Annan Athlet,6855,7,12,11,13,49,41,8,47
Berwick,6855,8,8,11,17,31,60,-29,35
Edinburgh Ci,6855,9,7,9,20,36,62,-26,30
Cowdenbeath,6855,10,4,10,22,23,56,-33,22
Montrose,6856,1,24,7,5,62,35,27,79
Peterhead,6856,2,24,4,8,82,39,43,76
Stenhousem'r,6856,3,16,8,12,57,46,11,56
Stirling,6856,4,16,6,14,60,53,7,54
Clyde,6856,5,15,9,12,53,48,5,54
Elgin,6856,6,14,6,16,54,63,-9,48
Annan Athlet,6856,7,11,11,14,47,44,3,44
Berwick,6856,8,8,10,18,29,60,-31,34
Edinburgh Ci,6856,9,7,9,20,37,65,-28,30
Cowdenbeath,6856,10,5,10,21,26,54,-28,25
Montrose,6857,1,24,7,5,63,35,28,79
Peterhead,6857,2,24,4,8,82,38,44,76
Stenhousem'r,6857,3,16,8,12,58,48,10,56
Stirling,6857,4,16,6,14,62,54,8,54
Clyde,6857,5,15,9,12,54,48,6,54
Elgin,6857,6,14,6,16,54,64,-10,48
Annan Athlet,6857,7,11,12,13,49,43,6,45
Berwick,6857,8,8,10,18,29,61,-32,34
Edinburgh Ci,6857,9,7,9,20,36,65,-29,30
Cowdenbeath,6857,10,4,11,21,25,56,-31,23
Montrose,6858,1,24,7,5,61,34,27,79
Peterhead,6858,2,24,4,8,81,38,43,76
Stirling,6858,3,17,6,13,62,52,10,57
Stenhousem'r,6858,4,15,8,13,56,48,8,53
Clyde,6858,5,14,10,12,51,48,3,52
Elgin,6858,6,14,6,16,53,62,-9,48
Annan Athlet,6858,7,12,11,13,48,41,7,47
Berwick,6858,8,8,11,17,29,58,-29,35
Edinburgh Ci,6858,9,7,9,20,36,64,-28,30
Cowdenbeath,6858,10,4,10,22,23,55,-32,22
Montrose,6859,1,23,8,5,60,35,25,77
Peterhead,6859,2,23,5,8,78,39,39,74
Stirling,6859,3,17,6,13,64,51,13,57
Clyde,6859,4,15,9,12,54,49,5,54
Stenhousem'r,6859,5,15,8,13,55,50,5,53
Elgin,6859,6,14,7,15,54,61,-7,49
Annan Athlet,6859,7,11,11,14,47,43,4,44
Berwick,6859,8,8,10,18,30,61,-31,34
Edinburgh Ci,6859,9,7,10,19,37,61,-24,31
Cowdenbeath,6859,10,5,10,21,25,54,-29,25
Montrose,6860,1,24,7,5,64,36,28,79
Peterhead,6860,2,24,4,8,82,39,43,76
Stirling,6860,3,17,6,13,61,51,10,57
Stenhousem'r,6860,4,15,8,13,55,47,8,53
Clyde,6860,5,14,10,12,52,49,3,52
Elgin,6860,6,14,6,16,55,65,-10,48
Annan Athlet,6860,7,12,11,13,49,41,8,47
Berwick,6860,8,8,11,17,30,59,-29,35
Edinburgh Ci,6860,9,7,9,20,37,65,-28,30
Cowdenbeath,6860,10,4,10,22,23,56,-33,22
Montrose,6861,1,24,7,5,60,34,26,79
Peterhead,6861,2,24,4,8,80,38,42,76
Stirling,6861,3,17,6,13,62,51,11,57
Stenhousem'r,6861,4,15,8,13,55,48,7,53
Clyde,6861,5,14,10,12,52,49,3,52
Elgin,6861,6,14,6,16,53,61,-8,48
Annan Athlet,6861,7,11,12,13,50,44,6,45
Berwick,6861,8,8,11,17,30,59,-29,35
Edinburgh Ci,6861,9,7,9,20,36,63,-27,30
Cowdenbeath,6861,10,4,11,21,26,57,-31,23
Montrose,6862,1,24,7,5,60,34,26,79
Peterhead,6862,2,24,4,8,81,38,43,76
Stirling,6862,3,17,6,13,63,53,10,57
Stenhousem'r,6862,4,15,8,13,57,49,8,53
Clyde,6862,5,14,9,13,51,49,2,51
Elgin,6862,6,14,6,16,53,61,-8,48
Annan Athlet,6862,7,11,12,13,49,43,6,45
Berwick,6862,8,9,10,17,30,58,-28,37
Edinburgh Ci,6862,9,7,9,20,36,64,-28,30
Cowdenbeath,6862,10,4,11,21,25,56,-31,23
Montrose,6863,1,24,7,5,60,34,26,79
Peterhead,6863,2,24,4,8,79,38,41,76
Stirling,6863,3,16,7,13,62,53,9,55
Stenhousem'r,6863,4,15,9,12,57,48,9,54
Clyde,6863,5,14,10,12,51,48,3,52
Elgin,6863,6,14,6,16,53,61,-8,48
Annan Athlet,6863,7,11,12,13,48,42,6,45
Berwick,6863,8,8,11,17,29,58,-29,35
Edinburgh Ci,6863,9,7,9,20,36,62,-26,30
Cowdenbeath,6863,10,4,11,21,24,55,-31,23
Montrose,6864,1,24,7,5,60,34,26,79
Peterhead,6864,2,24,4,8,79,38,41,76
Stenhousem'r,6864,3,16,8,12,56,46,10,56
Stirling,6864,4,16,6,14,60,52,8,54
Clyde,6864,5,15,9,12,54,48,6,54
Elgin,6864,6,14,6,16,53,61,-8,48
Annan Athlet,6864,7,12,11,13,48,41,7,47
Berwick,6864,8,8,10,18,29,61,-32,34
Edinburgh Ci,6864,9,7,9,20,36,62,-26,30
Cowdenbeath,6864,10,4,10,22,23,55,-32,22
Montrose,6865,1,24,7,5,62,36,26,79
Peterhead,6865,2,24,4,8,81,39,42,76
Stirling,6865,3,16,7,13,63,54,9,55
Stenhousem'r,6865,4,15,9,12,58,49,9,54
Clyde,6865,5,14,9,13,51,52,-1,51
Elgin,6865,6,14,6,16,55,63,-8,48
Annan Athlet,6865,7,12,11,13,50,41,9,47
Berwick,6865,8,9,10,17,33,58,-25,37
Edinburgh Ci,6865,9,7,9,20,37,64,-27,30
Cowdenbeath,6865,10,4,10,22,23,57,-34,22
Montrose,6866,1,24,7,5,60,34,26,79
Peterhead,6866,2,24,4,8,81,39,42,76
Stenhousem'r,6866,3,16,8,12,57,47,10,56
Stirling,6866,4,16,6,14,61,53,8,54
Clyde,6866,5,15,9,12,52,48,4,54
Elgin,6866,6,14,6,16,53,61,-8,48
Annan Athlet,6866,7,12,11,13,48,41,7,47
Berwick,6866,8,8,10,18,29,59,-30,34
Edinburgh Ci,6866,9,7,9,20,37,64,-27,30
Cowdenbeath,6866,10,4,10,22,23,55,-32,22
Montrose,6867,1,24,7,5,62,34,28,79
Peterhead,6867,2,24,4,8,80,39,41,76
Stirling,6867,3,17,6,13,62,51,11,57
Clyde,6867,4,15,9,12,54,48,6,54
Stenhousem'r,6867,5,15,8,13,55,48,7,53
Elgin,6867,6,14,6,16,53,63,-10,48
Annan Athlet,6867,7,11,12,13,48,42,6,45
Berwick,6867,8,8,10,18,29,61,-32,34
Edinburgh Ci,6867,9,7,9,20,37,63,-26,30
Cowdenbeath,6867,10,4,11,21,24,55,-31,23
Montrose,6868,1,24,7,5,62,34,28,79
Peterhead,6868,2,23,4,9,77,40,37,73
Stenhousem'r,6868,3,16,8,12,60,48,12,56
Stirling,6868,4,16,6,14,62,56,6,54
Clyde,6868,5,15,9,12,54,49,5,54
Elgin,6868,6,14,6,16,53,63,-10,48
Annan Athlet,6868,7,12,11,13,49,42,7,47
Berwick,6868,8,8,10,18,30,61,-31,34
Edinburgh Ci,6868,9,8,9,19,38,60,-22,33
Cowdenbeath,6868,10,4,10,22,24,56,-32,22
Montrose,6869,1,24,7,5,63,34,29,79
Peterhead,6869,2,24,4,8,81,38,43,76
Stirling,6869,3,17,6,13,62,51,11,57
Clyde,6869,4,15,9,12,55,49,6,54
Stenhousem'r,6869,5,15,8,13,55,48,7,53
Elgin,6869,6,14,6,16,53,64,-11,48
Annan Athlet,6869,7,12,11,13,49,41,8,47
Berwick,6869,8,8,10,18,30,62,-32,34
Edinburgh Ci,6869,9,7,9,20,36,64,-28,30
Cowdenbeath,6869,10,4,10,22,23,56,-33,22
Montrose,6870,1,24,7,5,61,35,26,79
Peterhead,6870,2,24,4,8,81,39,42,76
Stirling,6870,3,17,6,13,61,51,10,57
Clyde,6870,4,15,9,12,54,48,6,54
Stenhousem'r,6870,5,15,8,13,55,47,8,53
Elgin,6870,6,14,6,16,54,62,-8,48
Annan Athlet,6870,7,11,12,13,48,42,6,45
Berwick,6870,8,8,10,18,29,61,-32,34
Edinburgh Ci,6870,9,7,9,20,37,64,-27,30
Cowdenbeath,6870,10,4,11,21,24,55,-31,23
Montrose,6871,1,24,7,5,62,35,27,79
Peterhead,6871,2,23,5,8,78,39,39,74
Stirling,6871,3,17,6,13,61,51,10,57
Clyde,6871,4,15,9,12,53,48,5,54
Stenhousem'r,6871,5,15,8,13,55,47,8,53
Elgin,6871,6,14,6,16,54,63,-9,48
Annan Athlet,6871,7,12,11,13,48,41,7,47
Berwick,6871,8,8,10,18,29,60,-31,34
Edinburgh Ci,6871,9,7,10,19,37,61,-24,31
Cowdenbeath,6871,10,4,10,22,23,55,-32,22
Montrose,6872,1,24,7,5,60,34,26,79
Peterhead,6872,2,24,4,8,82,39,43,76
Stenhousem'r,6872,3,16,8,12,58,47,11,56
Stirling,6872,4,16,6,14,61,54,7,54
Clyde,6872,5,14,10,12,51,48,3,52
Elgin,6872,6,14,6,16,53,61,-8,48
Annan Athlet,6872,7,12,11,13,51,42,9,47
Berwick,6872,8,8,11,17,29,58,-29,35
Edinburgh Ci,6872,9,7,9,20,37,65,-28,30
Cowdenbeath,6872,10,4,10,22,24,58,-34,22
Montrose,6873,1,24,7,5,61,34,27,79
Peterhead,6873,2,24,4,8,79,38,41,76
Stirling,6873,3,16,7,13,61,52,9,55
Stenhousem'r,6873,4,15,9,12,56,47,9,54
Clyde,6873,5,14,10,12,52,49,3,52
Elgin,6873,6,14,6,16,53,62,-9,48
Annan Athlet,6873,7,11,12,13,47,41,6,45
Berwick,6873,8,8,11,17,30,59,-29,35
Edinburgh Ci,6873,9,7,9,20,36,62,-26,30
Cowdenbeath,6873,10,4,11,21,23,54,-31,23
Montrose,6874,1,24,7,5,62,35,27,79
Peterhead,6874,2,24,4,8,82,38,44,76
Stirling,6874,3,17,6,13,64,52,12,57
Clyde,6874,4,15,9,12,54,48,6,54
Stenhousem'r,6874,5,15,8,13,56,50,6,53
Elgin,6874,6,14,6,16,54,63,-9,48
Annan Athlet,6874,7,11,11,14,48,43,5,44
Berwick,6874,8,8,10,18,29,61,-32,34
Edinburgh Ci,6874,9,7,9,20,36,65,-29,30
Cowdenbeath,6874,10,5,10,21,25,55,-30,25
Montrose,6875,1,24,7,5,63,35,28,79
Peterhead,6875,2,24,4,8,82,41,41,76
Stirling,6875,3,17,6,13,62,52,10,57
Clyde,6875,4,15,9,12,53,49,4,54
Stenhousem'r,6875,5,15,8,13,56,48,8,53
Elgin,6875,6,14,6,16,54,64,-10,48
Annan Athlet,6875,7,12,11,13,49,41,8,47
Berwick,6875,8,8,10,18,30,60,-30,34
Edinburgh Ci,6875,9,7,9,20,39,65,-26,30
Cowdenbeath,6875,10,4,10,22,23,56,-33,22
Montrose,6876,1,24,7,5,63,35,28,79
Peterhead,6876,2,23,4,9,78,40,38,73
Stirling,6876,3,17,6,13,63,53,10,57
Stenhousem'r,6876,4,15,8,13,57,49,8,53
Clyde,6876,5,14,9,13,52,50,2,51
Elgin,6876,6,14,6,16,54,64,-10,48
Annan Athlet,6876,7,11,12,13,49,43,6,45
Berwick,6876,8,9,10,17,31,59,-28,37
Edinburgh Ci,6876,9,8,9,19,38,61,-23,33
Cowdenbeath,6876,10,4,11,21,25,56,-31,23
Montrose,6877,1,24,7,5,61,34,27,79
Peterhead,6877,2,23,5,8,79,40,39,74
Stirling,6877,3,16,7,13,60,51,9,55
Stenhousem'r,6877,4,15,9,12,55,46,9,54
Clyde,6877,5,14,10,12,52,49,3,52
Elgin,6877,6,14,6,16,53,62,-9,48
Annan Athlet,6877,7,11,12,13,49,43,6,45
Berwick,6877,8,8,11,17,30,59,-29,35
Edinburgh Ci,6877,9,7,10,19,38,62,-24,31
Cowdenbeath,6877,10,4,11,21,25,56,-31,23
Peterhead,6878,1,24,4,8,80,39,41,76
Montrose,6878,2,23,7,6,61,37,24,76
Stirling,6878,3,16,7,13,60,51,9,55
Stenhousem'r,6878,4,15,9,12,55,46,9,54
Clyde,6878,5,15,9,12,56,48,8,54
Elgin,6878,6,15,6,15,56,62,-6,51
Annan Athlet,6878,7,11,12,13,47,41,6,45
Berwick,6878,8,8,10,18,29,63,-34,34
Edinburgh Ci,6878,9,7,9,20,37,63,-26,30
Cowdenbeath,6878,10,4,11,21,23,54,-31,23
Montrose,6879,1,24,7,5,64,34,30,79
Peterhead,6879,2,24,4,8,80,38,42,76
Stirling,6879,3,17,6,13,63,51,12,57
Stenhousem'r,6879,4,15,8,13,55,49,6,53
Clyde,6879,5,14,10,12,51,48,3,52
Elgin,6879,6,14,6,16,53,65,-12,48
Annan Athlet,6879,7,11,12,13,47,41,6,45
Berwick,6879,8,8,11,17,29,58,-29,35
Edinburgh Ci,6879,9,7,9,20,36,63,-27,30
Cowdenbeath,6879,10,4,11,21,23,54,-31,23
Montrose,6880,1,24,7,5,60,34,26,79
Peterhead,6880,2,24,4,8,80,39,41,76
Stirling,6880,3,17,6,13,62,52,10,57
Clyde,6880,4,15,9,12,53,48,5,54
Stenhousem'r,6880,5,15,8,13,56,48,8,53
Elgin,6880,6,14,6,16,53,61,-8,48
Annan Athlet,6880,7,11,11,14,47,43,4,44
Berwick,6880,8,8,10,18,29,60,-31,34
Edinburgh Ci,6880,9,7,9,20,37,63,-26,30
Cowdenbeath,6880,10,5,10,21,25,54,-29,25
Montrose,6881,1,24,7,5,62,35,27,79
Peterhead,6881,2,23,5,8,79,40,39,74
Stirling,6881,3,17,6,13,64,53,11,57
Clyde,6881,4,15,9,12,54,50,4,54
Stenhousem'r,6881,5,15,8,13,57,50,7,53
Elgin,6881,6,14,6,16,54,63,-9,48
Annan Athlet,6881,7,11,12,13,48,42,6,45
Berwick,6881,8,8,10,18,31,61,-30,34
Edinburgh Ci,6881,9,7,10,19,38,62,-24,31
Cowdenbeath,6881,10,4,11,21,24,55,-31,23
Montrose,6882,1,24,7,5,60,34,26,79
Peterhead,6882,2,24,4,8,79,39,40,76
Stenhousem'r,6882,3,16,8,12,58,48,10,56
Stirling,6882,4,16,6,14,62,54,8,54
Clyde,6882,5,15,9,12,54,48,6,54
Elgin,6882,6,14,6,16,53,61,-8,48
Annan Athlet,6882,7,11,11,14,47,43,4,44
Berwick,6882,8,8,10,18,29,61,-32,34
Edinburgh Ci,6882,9,7,9,20,37,62,-25,30
Cowdenbeath,6882,10,5,10,21,25,54,-29,25
Montrose,6883,1,24,7,5,61,34,27,79
Peterhead,6883,2,24,4,8,80,40,40,76
Stenhousem'r,6883,3,16,8,12,58,47,11,56
Stirling,6883,4,16,6,14,61,54,7,54
Clyde,6883,5,14,9,13,51,49,2,51
Elgin,6883,6,14,6,16,53,62,-9,48
Annan Athlet,6883,7,11,12,13,48,42,6,45
Berwick,6883,8,9,10,17,30,58,-28,37
Edinburgh Ci,6883,9,7,9,20,38,63,-25,30
Cowdenbeath,6883,10,4,11,21,24,55,-31,23
Montrose,6884,1,24,7,5,60,34,26,79
Peterhead,6884,2,24,4,8,82,39,43,76
Stirling,6884,3,17,6,13,62,52,10,57
Stenhousem'r,6884,4,15,8,13,56,48,8,53
Clyde,6884,5,14,9,13,52,50,2,51
Elgin,6884,6,14,6,16,53,61,-8,48
Annan Athlet,6884,7,12,11,13,49,41,8,47
Berwick,6884,8,9,10,17,31,59,-28,37
Edinburgh Ci,6884,9,7,9,20,37,65,-28,30
Cowdenbeath,6884,10,4,10,22,23,56,-33,22
Montrose,6885,1,23,8,5,59,34,25,77
Peterhead,6885,2,24,4,8,83,39,44,76
Stirling,6885,3,16,7,13,62,53,9,55
Stenhousem'r,6885,4,15,9,12,57,48,9,54
Clyde,6885,5,15,9,12,53,49,4,54
Elgin,6885,6,14,7,15,53,60,-7,49
Annan Athlet,6885,7,11,11,14,50,45,5,44
Berwick,6885,8,8,10,18,30,60,-30,34
Edinburgh Ci,6885,9,7,9,20,37,66,-29,30
Cowdenbeath,6885,10,5,10,21,27,57,-30,25
Montrose,6886,1,24,7,5,60,34,26,79
Peterhead,6886,2,24,4,8,79,39,40,76
Stirling,6886,3,17,6,13,63,53,10,57
Clyde,6886,4,15,9,12,52,48,4,54
Stenhousem'r,6886,5,15,8,13,57,49,8,53
Elgin,6886,6,14,6,16,53,61,-8,48
Annan Athlet,6886,7,12,11,13,49,41,8,47
Berwick,6886,8,8,10,18,29,59,-30,34
Edinburgh Ci,6886,9,7,9,20,37,62,-25,30
Cowdenbeath,6886,10,4,10,22,23,56,-33,22
Montrose,6887,1,23,8,5,60,35,25,77
Peterhead,6887,2,24,4,8,82,39,43,76
Stirling,6887,3,17,6,13,62,51,11,57
Clyde,6887,4,15,9,12,54,49,5,54
Stenhousem'r,6887,5,15,8,13,55,48,7,53
Elgin,6887,6,14,7,15,54,61,-7,49
Annan Athlet,6887,7,12,11,13,48,41,7,47
Berwick,6887,8,8,10,18,30,61,-31,34
Edinburgh Ci,6887,9,7,9,20,37,65,-28,30
Cowdenbeath,6887,10,4,10,22,23,55,-32,22
Peterhead,6888,1,24,4,8,81,39,42,76
Montrose,6888,2,23,7,6,60,37,23,76
Stirling,6888,3,17,6,13,63,53,10,57
Clyde,6888,4,15,9,12,55,48,7,54
Stenhousem'r,6888,5,15,8,13,57,49,8,53
Elgin,6888,6,15,6,15,56,61,-5,51
Annan Athlet,6888,7,11,12,13,47,41,6,45
Berwick,6888,8,8,10,18,29,62,-33,34
Edinburgh Ci,6888,9,7,9,20,37,64,-27,30
Cowdenbeath,6888,10,4,11,21,23,54,-31,23
Montrose,6889,1,24,7,5,61,34,27,79
Peterhead,6889,2,24,4,8,80,38,42,76
Stenhousem'r,6889,3,16,8,12,56,46,10,56
Stirling,6889,4,16,6,14,60,52,8,54
Clyde,6889,5,15,9,12,54,50,4,54
Elgin,6889,6,14,6,16,53,62,-9,48
Annan Athlet,6889,7,11,12,13,49,43,6,45
Berwick,6889,8,8,10,18,31,61,-30,34
Edinburgh Ci,6889,9,7,9,20,36,63,-27,30
Cowdenbeath,6889,10,4,11,21,25,56,-31,23
Montrose,6890,1,24,7,5,61,35,26,79
Peterhead,6890,2,24,4,8,81,39,42,76
Stirling,6890,3,17,6,13,61,51,10,57
Stenhousem'r,6890,4,15,8,13,55,47,8,53
Clyde,6890,5,14,10,12,52,49,3,52
Elgin,6890,6,14,6,16,54,62,-8,48
Annan Athlet,6890,7,11,12,13,49,43,6,45
Berwick,6890,8,8,11,17,30,59,-29,35
Edinburgh Ci,6890,9,7,9,20,37,64,-27,30
Cowdenbeath,6890,10,4,11,21,25,56,-31,23
Montrose,6891,1,24,7,5,62,35,27,79
Peterhead,6891,2,24,4,8,80,38,42,76
Stirling,6891,3,17,6,13,61,51,10,57
Clyde,6891,4,15,9,12,53,48,5,54
Stenhousem'r,6891,5,15,8,13,55,47,8,53
Elgin,6891,6,14,6,16,54,63,-9,48
Annan Athlet,6891,7,11,11,14,48,43,5,44
Berwick,6891,8,8,10,18,29,60,-31,34
Edinburgh Ci,6891,9,7,9,20,36,63,-27,30
Cowdenbeath,6891,10,5,10,21,25,55,-30,25
Montrose,6892,1,24,7,5,64,37,27,79
Peterhead,6892,2,24,4,8,81,39,42,76
Stirling,6892,3,16,7,13,61,52,9,55
Stenhousem'r,6892,4,15,9,12,56,47,9,54
Clyde,6892,5,15,9,12,53,48,5,54
Elgin,6892,6,14,6,16,56,65,-9,48
Annan Athlet,6892,7,11,12,13,48,42,6,45
Berwick,6892,8,8,10,18,29,60,-31,34
Edinburgh Ci,6892,9,7,9,20,37,64,-27,30
Cowdenbeath,6892,10,4,11,21,24,55,-31,23
Montrose,6893,1,23,8,5,60,35,25,77
Peterhead,6893,2,24,4,8,79,38,41,76
Stirling,6893,3,16,7,13,61,52,9,55
Stenhousem'r,6893,4,15,9,12,56,47,9,54
Clyde,6893,5,15,9,12,55,50,5,54
Elgin,6893,6,14,7,15,54,61,-7,49
Annan Athlet,6893,7,11,11,14,49,45,4,44
Berwick,6893,8,8,10,18,31,62,-31,34
Edinburgh Ci,6893,9,7,9,20,36,62,-26,30
Cowdenbeath,6893,10,5,10,21,27,56,-29,25
Montrose,6894,1,23,8,5,60,35,25,77
Peterhead,6894,2,24,4,8,80,39,41,76
Stirling,6894,3,17,6,13,65,51,14,57
Stenhousem'r,6894,4,15,8,13,55,51,4,53
Clyde,6894,5,14,9,13,52,51,1,51
Elgin,6894,6,14,7,15,54,61,-7,49
Annan Athlet,6894,7,11,11,14,49,44,5,44
Berwick,6894,8,9,10,17,32,59,-27,37
Edinburgh Ci,6894,9,7,9,20,37,63,-26,30
Cowdenbeath,6894,10,5,10,21,26,56,-30,25
Montrose,6895,1,24,7,5,62,35,27,79
Peterhead,6895,2,24,4,8,82,39,43,76
Stirling,6895,3,16,7,13,61,52,9,55
Stenhousem'r,6895,4,15,9,12,56,47,9,54
Clyde,6895,5,14,10,12,51,48,3,52
Elgin,6895,6,14,6,16,54,63,-9,48
Annan Athlet,6895,7,12,11,13,49,41,8,47
Berwick,6895,8,8,11,17,29,58,-29,35
Edinburgh Ci,6895,9,7,9,20,37,65,-28,30
Cowdenbeath,6895,10,4,10,22,23,56,-33,22
Montrose,6896,1,23,8,5,60,35,25,77
Peterhead,6896,2,24,4,8,79,39,40,76
Stirling,6896,3,17,6,13,64,52,12,57
Stenhousem'r,6896,4,15,8,13,56,50,6,53
Clyde,6896,5,14,9,13,52,51,1,51
Elgin,6896,6,14,7,15,54,61,-7,49
Annan Athlet,6896,7,11,12,13,48,42,6,45
Berwick,6896,8,9,10,17,32,59,-27,37
Edinburgh Ci,6896,9,7,9,20,37,62,-25,30
Cowdenbeath,6896,10,4,11,21,24,55,-31,23
Montrose,6897,1,24,7,5,62,34,28,79
Peterhead,6897,2,24,4,8,81,38,43,76
Stenhousem'r,6897,3,16,8,12,58,48,10,56
Stirling,6897,4,16,6,14,62,54,8,54
Clyde,6897,5,14,10,12,52,49,3,52
Elgin,6897,6,14,6,16,53,63,-10,48
Annan Athlet,6897,7,11,11,14,47,42,5,44
Berwick,6897,8,8,11,17,30,59,-29,35
Edinburgh Ci,6897,9,7,9,20,36,64,-28,30
Cowdenbeath,6897,10,5,10,21,24,54,-30,25
Montrose,6898,1,24,7,5,66,36,30,79
Peterhead,6898,2,23,5,8,79,40,39,74
Stirling,6898,3,16,7,13,62,53,9,55
Stenhousem'r,6898,4,15,9,12,57,48,9,54
Clyde,6898,5,14,9,13,51,52,-1,51
Elgin,6898,6,14,6,16,55,67,-12,48
Annan Athlet,6898,7,11,11,14,47,43,4,44
Berwick,6898,8,9,10,17,33,58,-25,37
Edinburgh Ci,6898,9,7,10,19,38,62,-24,31
Cowdenbeath,6898,10,5,10,21,25,54,-29,25
Peterhead,6899,1,24,4,8,80,38,42,76
Montrose,6899,2,23,7,6,59,36,23,76
Stirling,6899,3,16,7,13,61,52,9,55
Stenhousem'r,6899,4,15,9,12,56,47,9,54
Clyde,6899,5,14,9,13,52,53,-1,51
Elgin,6899,6,15,6,15,55,60,-5,51
Annan Athlet,6899,7,11,11,14,47,42,5,44
Berwick,6899,8,9,10,17,34,59,-25,37
Edinburgh Ci,6899,9,7,9,20,36,63,-27,30
Cowdenbeath,6899,10,5,10,21,24,54,-30,25
Montrose,6900,1,24,7,5,61,35,26,79
Peterhead,6900,2,24,4,8,82,38,44,76
Stirling,6900,3,17,6,13,62,51,11,57
Clyde,6900,4,15,9,12,52,48,4,54
Stenhousem'r,6900,5,15,8,13,55,48,7,53
Elgin,6900,6,14,6,16,54,62,-8,48
Annan Athlet,6900,7,12,11,13,48,41,7,47
Berwick,6900,8,8,10,18,29,59,-30,34
Edinburgh Ci,6900,9,7,9,20,36,65,-29,30
Cowdenbeath,6900,10,4,10,22,23,55,-32,22
Montrose,6901,1,23,7,6,60,36,24,76
Peterhead,6901,2,23,5,8,78,39,39,74
Stirling,6901,3,16,7,13,61,52,9,55
Stenhousem'r,6901,4,15,9,12,56,47,9,54
Clyde,6901,5,14,10,12,52,49,3,52
Elgin,6901,6,15,6,15,55,61,-6,51
Annan Athlet,6901,7,12,11,13,49,41,8,47
Berwick,6901,8,8,11,17,30,59,-29,35
Edinburgh Ci,6901,9,7,10,19,37,61,-24,31
Cowdenbeath,6901,10,4,10,22,23,56,-33,22
Montrose,6902,1,24,7,5,61,34,27,79
Peterhead,6902,2,24,4,8,79,38,41,76
Stirling,6902,3,17,6,13,62,51,11,57
Clyde,6902,4,15,9,12,52,48,4,54
Stenhousem'r,6902,5,15,8,13,55,48,7,53
Elgin,6902,6,14,6,16,53,62,-9,48
Annan Athlet,6902,7,11,12,13,47,41,6,45
Berwick,6902,8,8,10,18,29,59,-30,34
Edinburgh Ci,6902,9,7,9,20,36,62,-26,30
Cowdenbeath,6902,10,4,11,21,23,54,-31,23
Montrose,6903,1,24,7,5,61,34,27,79
Peterhead,6903,2,23,4,9,77,40,37,73
Stirling,6903,3,17,6,13,61,51,10,57
Clyde,6903,4,15,9,12,54,50,4,54
Stenhousem'r,6903,5,15,8,13,55,47,8,53
Elgin,6903,6,14,6,16,53,62,-9,48
Annan Athlet,6903,7,11,11,14,48,43,5,44
Berwick,6903,8,8,10,18,31,61,-30,34
Edinburgh Ci,6903,9,8,9,19,38,60,-22,33
Cowdenbeath,6903,10,5,10,21,25,55,-30,25
Montrose,6904,1,24,7,5,62,36,26,79
Peterhead,6904,2,23,5,8,78,39,39,74
Stirling,6904,3,16,7,13,62,53,9,55
Stenhousem'r,6904,4,15,9,12,57,48,9,54
Clyde,6904,5,14,10,12,51,48,3,52
Elgin,6904,6,14,6,16,55,63,-8,48
Annan Athlet,6904,7,12,11,13,51,42,9,47
Berwick,6904,8,8,11,17,29,58,-29,35
Edinburgh Ci,6904,9,7,10,19,37,61,-24,31
Cowdenbeath,6904,10,4,10,22,24,58,-34,22
Montrose,6905,1,24,7,5,61,35,26,79
Peterhead,6905,2,24,4,8,79,39,40,76
Stirling,6905,3,17,6,13,62,52,10,57
Clyde,6905,4,15,9,12,53,48,5,54
Stenhousem'r,6905,5,15,8,13,56,48,8,53
Elgin,6905,6,14,6,16,54,62,-8,48
Annan Athlet,6905,7,12,11,13,48,41,7,47
Berwick,6905,8,8,10,18,29,60,-31,34
Edinburgh Ci,6905,9,7,9,20,37,62,-25,30
Cowdenbeath,6905,10,4,10,22,23,55,-32,22
Peterhead,6906,1,24,4,8,80,38,42,76
Montrose,6906,2,23,7,6,60,37,23,76
Stenhousem'r,6906,3,16,8,12,56,46,10,56
Stirling,6906,4,16,6,14,60,52,8,54
Clyde,6906,5,14,10,12,52,49,3,52
Elgin,6906,6,15,6,15,56,61,-5,51
Annan Athlet,6906,7,12,11,13,48,41,7,47
Berwick,6906,8,8,11,17,30,59,-29,35
Edinburgh Ci,6906,9,7,9,20,36,63,-27,30
Cowdenbeath,6906,10,4,10,22,23,55,-32,22
Peterhead,6907,1,24,4,8,80,38,42,76
Montrose,6907,2,23,7,6,59,35,24,76
Stenhousem'r,6907,3,16,8,12,59,47,12,56
Stirling,6907,4,16,6,14,61,55,6,54
Clyde,6907,5,15,9,12,54,48,6,54
Elgin,6907,6,15,6,15,54,60,-6,51
Annan Athlet,6907,7,12,11,13,51,44,7,47
Berwick,6907,8,8,10,18,29,61,-32,34
Edinburgh Ci,6907,9,7,9,20,36,63,-27,30
Cowdenbeath,6907,10,4,10,22,26,58,-32,22
Montrose,6908,1,23,7,6,61,39,22,76
Peterhead,6908,2,23,4,9,78,41,37,73
Stirling,6908,3,17,6,13,61,51,10,57
Clyde,6908,4,15,9,12,52,48,4,54
Stenhousem'r,6908,5,15,8,13,55,47,8,53
Elgin,6908,6,15,6,15,58,62,-4,51
Annan Athlet,6908,7,11,12,13,47,41,6,45
Berwick,6908,8,8,10,18,29,59,-30,34
Edinburgh Ci,6908,9,8,9,19,39,61,-22,33
Cowdenbeath,6908,10,4,11,21,23,54,-31,23
Montrose,6909,1,23,8,5,60,35,25,77
Peterhead,6909,2,23,4,9,77,39,38,73
Stenhousem'r,6909,3,16,8,12,56,46,10,56
Stirling,6909,4,16,6,14,60,52,8,54
Clyde,6909,5,14,10,12,53,50,3,52
Elgin,6909,6,14,7,15,54,61,-7,49
Annan Athlet,6909,7,12,11,13,48,41,7,47
Berwick,6909,8,8,11,17,31,60,-29,35
Edinburgh Ci,6909,9,8,9,19,37,60,-23,33
Cowdenbeath,6909,10,4,10,22,23,55,-32,22
Montrose,6910,1,24,7,5,62,35,27,79
Peterhead,6910,2,24,4,8,81,39,42,76
Stenhousem'r,6910,3,16,8,12,56,46,10,56
Stirling,6910,4,16,6,14,60,52,8,54
Clyde,6910,5,15,9,12,55,49,6,54
Elgin,6910,6,14,6,16,54,63,-9,48
Annan Athlet,6910,7,11,12,13,47,41,6,45
Berwick,6910,8,8,10,18,30,62,-32,34
Edinburgh Ci,6910,9,7,9,20,37,64,-27,30
Cowdenbeath,6910,10,4,11,21,23,54,-31,23
Peterhead,6911,1,24,4,8,80,38,42,76
Montrose,6911,2,23,7,6,59,36,23,76
Stirling,6911,3,16,7,13,61,52,9,55
Stenhousem'r,6911,4,15,9,12,56,47,9,54
Clyde,6911,5,15,9,12,55,49,6,54
Elgin,6911,6,15,6,15,55,60,-5,51
Annan Athlet,6911,7,11,12,13,48,42,6,45
Berwick,6911,8,8,10,18,30,62,-32,34
Edinburgh Ci,6911,9,7,9,20,36,63,-27,30
Cowdenbeath,6911,10,4,11,21,24,55,-31,23
Peterhead,6912,1,24,4,8,84,38,46,76
Montrose,6912,2,23,7,6,60,36,24,76
Stirling,6912,3,16,7,13,62,53,9,55
Stenhousem'r,6912,4,15,9,12,57,48,9,54
Clyde,6912,5,15,9,12,52,48,4,54
Elgin,6912,6,15,6,15,55,61,-6,51
Annan Athlet,6912,7,11,11,14,47,42,5,44
Berwick,6912,8,8,10,18,29,59,-30,34
Edinburgh Ci,6912,9,7,9,20,36,67,-31,30
Cowdenbeath,6912,10,5,10,21,24,54,-30,25
Montrose,6913,1,24,7,5,60,34,26,79
Peterhead,6913,2,23,4,9,77,39,38,73
Stirling,6913,3,17,6,13,63,53,10,57
Clyde,6913,4,15,9,12,53,48,5,54
Stenhousem'r,6913,5,15,8,13,57,49,8,53
Elgin,6913,6,14,6,16,53,61,-8,48
Annan Athlet,6913,7,12,11,13,48,41,7,47
Berwick,6913,8,8,10,18,29,60,-31,34
Edinburgh Ci,6913,9,8,9,19,37,60,-23,33
Cowdenbeath,6913,10,4,10,22,23,55,-32,22
Peterhead,6914,1,24,4,8,82,38,44,76
Montrose,6914,2,23,7,6,60,37,23,76
Stirling,6914,3,16,7,13,62,53,9,55
Stenhousem'r,6914,4,15,9,12,57,48,9,54
Clyde,6914,5,15,9,12,53,49,4,54
Elgin,6914,6,15,6,15,56,61,-5,51
Annan Athlet,6914,7,12,11,13,48,41,7,47
Berwick,6914,8,8,10,18,30,60,-30,34
Edinburgh Ci,6914,9,7,9,20,36,65,-29,30
Cowdenbeath,6914,10,4,10,22,23,55,-32,22
Montrose,6915,1,24,7,5,61,34,27,79
Peterhead,6915,2,24,4,8,81,39,42,76
Stenhousem'r,6915,3,16,8,12,57,47,10,56
Stirling,6915,4,16,6,14,61,53,8,54
Clyde,6915,5,14,10,12,52,49,3,52
Elgin,6915,6,14,6,16,53,62,-9,48
Annan Athlet,6915,7,11,12,13,49,43,6,45
Berwick,6915,8,8,11,17,30,59,-29,35
Edinburgh Ci,6915,9,7,9,20,37,64,-27,30
Cowdenbeath,6915,10,4,11,21,25,56,-31,23
Montrose,6916,1,24,7,5,62,35,27,79
Peterhead,6916,2,24,4,8,80,40,40,76
Stenhousem'r,6916,3,16,8,12,57,47,10,56
Stirling,6916,4,16,6,14,61,53,8,54
Clyde,6916,5,15,9,12,53,49,4,54
Elgin,6916,6,14,6,16,54,63,-9,48
Annan Athlet,6916,7,11,12,13,48,42,6,45
Berwick,6916,8,8,10,18,30,60,-30,34
Edinburgh Ci,6916,9,7,9,20,38,63,-25,30
Cowdenbeath,6916,10,4,11,21,24,55,-31,23
Peterhead,6917,1,24,4,8,82,38,44,76
Montrose,6917,2,23,7,6,60,36,24,76
Stenhousem'r,6917,3,16,8,12,57,47,10,56
Stirling,6917,4,16,6,14,61,53,8,54
Clyde,6917,5,14,9,13,51,49,2,51
Elgin,6917,6,15,6,15,55,61,-6,51
Annan Athlet,6917,7,12,11,13,49,42,7,47
Berwick,6917,8,9,10,17,30,58,-28,37
Edinburgh Ci,6917,9,7,9,20,36,65,-29,30
Cowdenbeath,6917,10,4,10,22,24,56,-32,22
Montrose,6918,1,23,8,5,60,35,25,77
Peterhead,6918,2,24,4,8,80,38,42,76
Stirling,6918,3,17,6,13,62,51,11,57
Clyde,6918,4,15,9,12,54,48,6,54
Stenhousem'r,6918,5,15,8,13,55,48,7,53
Elgin,6918,6,14,7,15,54,61,-7,49
Annan Athlet,6918,7,12,11,13,49,42,7,47
Berwick,6918,8,8,10,18,29,61,-32,34
Edinburgh Ci,6918,9,7,9,20,36,63,-27,30
Cowdenbeath,6918,10,4,10,22,24,56,-32,22
Montrose,6919,1,23,7,6,59,35,24,76
Peterhead,6919,2,23,5,8,77,38,39,74
Stirling,6919,3,16,7,13,62,53,9,55
Stenhousem'r,6919,4,15,9,12,57,48,9,54
Clyde,6919,5,14,10,12,52,49,3,52
Elgin,6919,6,15,6,15,54,60,-6,51
Annan Athlet,6919,7,12,11,13,50,42,8,47
Berwick,6919,8,8,11,17,30,59,-29,35
Edinburgh Ci,6919,9,7,10,19,36,60,-24,31
Cowdenbeath,6919,10,4,10,22,24,57,-33,22
Montrose,6920,1,23,8,5,60,35,25,77
Peterhead,6920,2,24,4,8,80,39,41,76
Stirling,6920,3,17,6,13,63,52,11,57
Clyde,6920,4,15,9,12,52,48,4,54
Stenhousem'r,6920,5,15,8,13,56,49,7,53
Elgin,6920,6,14,7,15,54,61,-7,49
Annan Athlet,6920,7,12,11,13,48,41,7,47
Berwick,6920,8,8,10,18,29,59,-30,34
Edinburgh Ci,6920,9,7,9,20,37,63,-26,30
Cowdenbeath,6920,10,4,10,22,23,55,-32,22
Montrose,6921,1,24,7,5,62,36,26,79
Peterhead,6921,2,24,4,8,80,38,42,76
Stenhousem'r,6921,3,16,8,12,57,46,11,56
Stirling,6921,4,16,6,14,60,53,7,54
Clyde,6921,5,14,10,12,51,48,3,52
Elgin,6921,6,14,6,16,55,63,-8,48
Annan Athlet,6921,7,11,11,14,48,43,5,44
Berwick,6921,8,8,11,17,29,58,-29,35
Edinburgh Ci,6921,9,7,9,20,36,63,-27,30
Cowdenbeath,6921,10,5,10,21,25,55,-30,25
Montrose,6922,1,24,7,5,60,34,26,79
Peterhead,6922,2,24,4,8,80,38,42,76
Stirling,6922,3,16,7,13,61,52,9,55
Stenhousem'r,6922,4,15,9,12,56,47,9,54
Clyde,6922,5,14,9,13,53,51,2,51
Elgin,6922,6,14,6,16,53,61,-8,48
Annan Athlet,6922,7,12,11,13,50,42,8,47
Berwick,6922,8,9,10,17,32,60,-28,37
Edinburgh Ci,6922,9,7,9,20,36,63,-27,30
Cowdenbeath,6922,10,4,10,22,24,57,-33,22
Montrose,6923,1,24,7,5,62,35,27,79
Peterhead,6923,2,23,4,9,79,41,38,73
Stirling,6923,3,16,7,13,61,52,9,55
Stenhousem'r,6923,4,15,9,12,56,47,9,54
Clyde,6923,5,15,9,12,53,49,4,54
Elgin,6923,6,14,6,16,54,63,-9,48
Annan Athlet,6923,7,12,11,13,49,41,8,47
Berwick,6923,8,8,10,18,30,60,-30,34
Edinburgh Ci,6923,9,8,9,19,39,62,-23,33
Cowdenbeath,6923,10,4,10,22,23,56,-33,22
Montrose,6924,1,24,7,5,61,34,27,79
Peterhead,6924,2,24,4,8,83,38,45,76
Stirling,6924,3,17,6,13,63,52,11,57
Clyde,6924,4,15,9,12,53,48,5,54
Stenhousem'r,6924,5,15,8,13,56,49,7,53
Elgin,6924,6,14,6,16,53,62,-9,48
Annan Athlet,6924,7,11,11,14,49,44,5,44
Berwick,6924,8,8,10,18,29,60,-31,34
Edinburgh Ci,6924,9,7,9,20,36,66,-30,30
Cowdenbeath,6924,10,5,10,21,26,56,-30,25
Montrose,6925,1,24,7,5,61,34,27,79
Peterhead,6925,2,24,4,8,79,38,41,76
Stenhousem'r,6925,3,16,8,12,58,48,10,56
Stirling,6925,4,16,6,14,62,54,8,54
Clyde,6925,5,15,9,12,53,48,5,54
Elgin,6925,6,14,6,16,53,62,-9,48
Annan Athlet,6925,7,11,12,13,47,41,6,45
Berwick,6925,8,8,10,18,29,60,-31,34
Edinburgh Ci,6925,9,7,9,20,36,62,-26,30
Cowdenbeath,6925,10,4,11,21,23,54,-31,23
Montrose,6926,1,24,7,5,64,35,29,79
Peterhead,6926,2,23,4,9,79,42,37,73
Stirling,6926,3,16,7,13,61,52,9,55
Stenhousem'r,6926,4,15,9,12,56,47,9,54
Clyde,6926,5,15,9,12,55,48,7,54
Elgin,6926,6,14,6,16,54,65,-11,48
Annan Athlet,6926,7,11,12,13,48,42,6,45
Berwick,6926,8,8,10,18,29,62,-33,34
Edinburgh Ci,6926,9,8,9,19,40,62,-22,33
Cowdenbeath,6926,10,4,11,21,24,55,-31,23
Peterhead,6927,1,24,4,8,79,38,41,76
Montrose,6927,2,23,7,6,60,36,24,76
Stirling,6927,3,17,6,13,62,51,11,57
Stenhousem'r,6927,4,15,8,13,55,48,7,53
Clyde,6927,5,14,10,12,51,48,3,52
Elgin,6927,6,15,6,15,55,61,-6,51
Annan Athlet,6927,7,11,12,13,48,42,6,45
Berwick,6927,8,8,11,17,29,58,-29,35
Edinburgh Ci,6927,9,7,9,20,36,62,-26,30
Cowdenbeath,6927,10,4,11,21,24,55,-31,23
Montrose,6928,1,24,7,5,62,34,28,79
Peterhead,6928,2,24,4,8,80,39,41,76
Stirling,6928,3,16,7,13,62,53,9,55
Stenhousem'r,6928,4,15,9,12,57,48,9,54
Clyde,6928,5,14,9,13,53,51,2,51
Elgin,6928,6,14,6,16,53,63,-10,48
Annan Athlet,6928,7,11,12,13,48,42,6,45
Berwick,6928,8,9,10,17,32,60,-28,37
Edinburgh Ci,6928,9,7,9,20,37,63,-26,30
Cowdenbeath,6928,10,4,11,21,24,55,-31,23
Montrose,6929,1,24,7,5,63,34,29,79
Peterhead,6929,2,24,4,8,79,38,41,76
Stirling,6929,3,17,6,13,64,52,12,57
Clyde,6929,4,15,9,12,53,48,5,54
Stenhousem'r,6929,5,15,8,13,56,50,6,53
Elgin,6929,6,14,6,16,53,64,-11,48
Annan Athlet,6929,7,11,12,13,48,42,6,45
Berwick,6929,8,8,10,18,29,60,-31,34
Edinburgh Ci,6929,9,7,9,20,36,62,-26,30
Cowdenbeath,6929,10,4,11,21,24,55,-31,23
Montrose,6930,1,24,7,5,62,34,28,79
Peterhead,6930,2,24,4,8,81,39,42,76
Stirling,6930,3,17,6,13,63,52,11,57
Stenhousem'r,6930,4,15,8,13,56,49,7,53
Clyde,6930,5,14,9,13,51,49,2,51
Elgin,6930,6,14,6,16,53,63,-10,48
Annan Athlet,6930,7,11,12,13,48,42,6,45
Berwick,6930,8,9,10,17,30,58,-28,37
Edinburgh Ci,6930,9,7,9,20,37,64,-27,30
Cowdenbeath,6930,10,4,11,21,24,55,-31,23
Montrose,6931,1,24,7,5,61,35,26,79
Peterhead,6931,2,24,4,8,81,38,43,76
Stirling,6931,3,16,7,13,61,52,9,55
Stenhousem'r,6931,4,15,9,12,56,47,9,54
Clyde,6931,5,14,9,13,52,51,1,51
Elgin,6931,6,14,6,16,54,62,-8,48
Annan Athlet,6931,7,11,12,13,48,42,6,45
Berwick,6931,8,9,10,17,32,59,-27,37
Edinburgh Ci,6931,9,7,9,20,36,64,-28,30
Cowdenbeath,6931,10,4,11,21,24,55,-31,23
Montrose,6932,1,24,7,5,61,34,27,79
Peterhead,6932,2,24,4,8,80,40,40,76
Stirling,6932,3,17,6,13,62,52,10,57
Stenhousem'r,6932,4,15,8,13,56,48,8,53
Clyde,6932,5,14,10,12,52,49,3,52
Elgin,6932,6,14,6,16,53,62,-9,48
Annan Athlet,6932,7,12,11,13,50,42,8,47
Berwick,6932,8,8,11,17,30,59,-29,35
Edinburgh Ci,6932,9,7,9,20,38,63,-25,30
Cowdenbeath,6932,10,4,10,22,24,57,-33,22
Montrose,6933,1,24,7,5,61,35,26,79
Peterhead,6933,2,24,4,8,79,38,41,76
Stirling,6933,3,17,6,13,62,52,10,57
Stenhousem'r,6933,4,15,8,13,56,48,8,53
Clyde,6933,5,14,10,12,51,48,3,52
Elgin,6933,6,14,6,16,54,62,-8,48
Annan Athlet,6933,7,11,12,13,48,42,6,45
Berwick,6933,8,8,11,17,29,58,-29,35
Edinburgh Ci,6933,9,7,9,20,36,62,-26,30
Cowdenbeath,6933,10,4,11,21,24,55,-31,23
Peterhead,6934,1,24,4,8,81,38,43,76
Montrose,6934,2,23,7,6,59,36,23,76
Stirling,6934,3,17,6,13,62,52,10,57
Clyde,6934,4,15,9,12,55,48,7,54
Stenhousem'r,6934,5,15,8,13,56,48,8,53
Elgin,6934,6,15,6,15,55,60,-5,51
Annan Athlet,6934,7,11,12,13,48,42,6,45
Berwick,6934,8,8,10,18,29,62,-33,34
Edinburgh Ci,6934,9,7,9,20,36,64,-28,30
Cowdenbeath,6934,10,4,11,21,24,55,-31,23
Montrose,6935,1,24,7,5,61,35,26,79
Peterhead,6935,2,24,4,8,80,38,42,76
Stirling,6935,3,17,6,13,63,51,12,57
Clyde,6935,4,15,9,12,54,48,6,54
Stenhousem'r,6935,5,15,8,13,55,49,6,53
Elgin,6935,6,14,6,16,54,62,-8,48
Annan Athlet,6935,7,11,11,14,48,45,3,44
Berwick,6935,8,8,10,18,29,61,-32,34
Edinburgh Ci,6935,9,7,9,20,36,63,-27,30
Cowdenbeath,6935,10,5,10,21,27,55,-28,25
Montrose,6936,1,24,7,5,60,34,26,79
Peterhead,6936,2,24,4,8,81,38,43,76
Stenhousem'r,6936,3,16,8,12,57,46,11,56
Stirling,6936,4,16,6,14,60,53,7,54
Clyde,6936,5,15,9,12,53,49,4,54
Elgin,6936,6,14,6,16,53,61,-8,48
Annan Athlet,6936,7,11,11,14,48,45,3,44
Berwick,6936,8,8,10,18,30,60,-30,34
Edinburgh Ci,6936,9,7,9,20,36,64,-28,30
Cowdenbeath,6936,10,5,10,21,27,55,-28,25
Peterhead,6937,1,24,4,8,80,39,41,76
Montrose,6937,2,23,7,6,61,37,24,76
Stirling,6937,3,17,6,13,64,52,12,57
Stenhousem'r,6937,4,15,8,13,56,50,6,53
Clyde,6937,5,14,9,13,52,50,2,51
Elgin,6937,6,15,6,15,56,62,-6,51
Annan Athlet,6937,7,11,11,14,47,44,3,44
Berwick,6937,8,9,10,17,31,59,-28,37
Edinburgh Ci,6937,9,7,9,20,37,63,-26,30
Cowdenbeath,6937,10,5,10,21,26,54,-28,25
Montrose,6938,1,24,7,5,61,34,27,79
Peterhead,6938,2,24,4,8,82,38,44,76
Stirling,6938,3,17,6,13,61,51,10,57
Stenhousem'r,6938,4,15,8,13,55,47,8,53
Clyde,6938,5,14,9,13,51,49,2,51
Elgin,6938,6,14,6,16,53,62,-9,48
Annan Athlet,6938,7,11,12,13,48,42,6,45
Berwick,6938,8,9,10,17,30,58,-28,37
Edinburgh Ci,6938,9,7,9,20,36,65,-29,30
Cowdenbeath,6938,10,4,11,21,24,55,-31,23
Montrose,6939,1,24,7,5,62,34,28,79
Peterhead,6939,2,24,4,8,80,38,42,76
Stirling,6939,3,16,7,13,61,52,9,55
Stenhousem'r,6939,4,15,9,12,56,47,9,54
Clyde,6939,5,15,9,12,53,48,5,54
Elgin,6939,6,14,6,16,53,63,-10,48
Annan Athlet,6939,7,11,11,14,47,42,5,44
Berwick,6939,8,8,10,18,29,60,-31,34
Edinburgh Ci,6939,9,7,9,20,36,63,-27,30
Cowdenbeath,6939,10,5,10,21,24,54,-30,25
Peterhead,6940,1,24,4,8,79,39,40,76
Montrose,6940,2,23,7,6,59,38,21,76
Stirling,6940,3,17,6,13,62,51,11,57
Clyde,6940,4,15,9,12,56,48,8,54
Stenhousem'r,6940,5,15,8,13,55,48,7,53
Elgin,6940,6,15,6,15,57,60,-3,51
Annan Athlet,6940,7,11,12,13,47,41,6,45
Berwick,6940,8,8,10,18,29,63,-34,34
Edinburgh Ci,6940,9,7,9,20,37,62,-25,30
Cowdenbeath,6940,10,4,11,21,23,54,-31,23
Montrose,6941,1,24,7,5,62,35,27,79
Peterhead,6941,2,23,4,9,77,41,36,73
Stirling,6941,3,17,6,13,63,51,12,57
Stenhousem'r,6941,4,15,8,13,55,49,6,53
Clyde,6941,5,14,10,12,53,50,3,52
Elgin,6941,6,14,6,16,54,63,-9,48
Annan Athlet,6941,7,11,11,14,47,42,5,44
Berwick,6941,8,8,11,17,31,60,-29,35
Edinburgh Ci,6941,9,8,9,19,39,60,-21,33
Cowdenbeath,6941,10,5,10,21,24,54,-30,25
Montrose,6942,1,24,7,5,63,34,29,79
Peterhead,6942,2,24,4,8,79,38,41,76
Stirling,6942,3,17,6,13,61,51,10,57
Stenhousem'r,6942,4,15,8,13,55,47,8,53
Clyde,6942,5,14,10,12,51,48,3,52
Elgin,6942,6,14,6,16,53,64,-11,48
Annan Athlet,6942,7,12,11,13,49,41,8,47
Berwick,6942,8,8,11,17,29,58,-29,35
Edinburgh Ci,6942,9,7,9,20,36,62,-26,30
Cowdenbeath,6942,10,4,10,22,23,56,-33,22
Montrose,6943,1,24,7,5,61,34,27,79
Peterhead,6943,2,24,4,8,80,40,40,76
Stirling,6943,3,17,6,13,62,52,10,57
Clyde,6943,4,15,9,12,58,49,9,54
Stenhousem'r,6943,5,15,8,13,56,48,8,53
Elgin,6943,6,14,6,16,53,62,-9,48
Annan Athlet,6943,7,11,12,13,47,41,6,45
Berwick,6943,8,8,10,18,30,65,-35,34
Edinburgh Ci,6943,9,7,9,20,38,63,-25,30
Cowdenbeath,6943,10,4,11,21,23,54,-31,23
Peterhead,6944,1,24,4,8,83,39,44,76
Montrose,6944,2,23,7,6,60,36,24,76
Stirling,6944,3,16,7,13,62,53,9,55
Stenhousem'r,6944,4,15,9,12,57,48,9,54
Clyde,6944,5,14,10,12,52,49,3,52
Elgin,6944,6,15,6,15,55,61,-6,51
Annan Athlet,6944,7,11,12,13,49,43,6,45
Berwick,6944,8,8,11,17,30,59,-29,35
Edinburgh Ci,6944,9,7,9,20,37,66,-29,30
Cowdenbeath,6944,10,4,11,21,25,56,-31,23
Montrose,6945,1,24,7,5,61,34,27,79
Peterhead,6945,2,24,4,8,80,38,42,76
Stirling,6945,3,17,6,13,63,51,12,57
Clyde,6945,4,15,9,12,54,49,5,54
Stenhousem'r,6945,5,15,8,13,55,49,6,53
Elgin,6945,6,14,6,16,53,62,-9,48
Annan Athlet,6945,7,11,11,14,47,42,5,44
Berwick,6945,8,8,10,18,30,61,-31,34
Edinburgh Ci,6945,9,7,9,20,36,63,-27,30
Cowdenbeath,6945,10,5,10,21,24,54,-30,25
Montrose,6946,1,24,7,5,62,35,27,79
Peterhead,6946,2,24,4,8,81,39,42,76
Stirling,6946,3,17,6,13,64,51,13,57
Stenhousem'r,6946,4,15,8,13,55,50,5,53
Clyde,6946,5,14,10,12,52,49,3,52
Elgin,6946,6,14,6,16,54,63,-9,48
Annan Athlet,6946,7,12,11,13,50,42,8,47
Berwick,6946,8,8,11,17,30,59,-29,35
Edinburgh Ci,6946,9,7,9,20,37,64,-27,30
Cowdenbeath,6946,10,4,10,22,24,57,-33,22
Montrose,6947,1,23,8,5,59,34,25,77
Peterhead,6947,2,24,4,8,81,38,43,76
Stenhousem'r,6947,3,16,8,12,57,47,10,56
Stirling,6947,4,16,6,14,61,53,8,54
Clyde,6947,5,14,9,13,52,50,2,51
Elgin,6947,6,14,7,15,53,60,-7,49
Annan Athlet,6947,7,11,12,13,48,42,6,45
Berwick,6947,8,9,10,17,31,59,-28,37
Edinburgh Ci,6947,9,7,9,20,36,64,-28,30
Cowdenbeath,6947,10,4,11,21,24,55,-31,23
Montrose,6948,1,24,7,5,61,34,27,79
Peterhead,6948,2,24,4,8,84,40,44,76
Stirling,6948,3,17,6,13,63,51,12,57
Clyde,6948,4,15,9,12,53,49,4,54
Stenhousem'r,6948,5,15,8,13,55,49,6,53
Elgin,6948,6,14,6,16,53,62,-9,48
Annan Athlet,6948,7,11,11,14,48,43,5,44
Berwick,6948,8,8,10,18,30,60,-30,34
Edinburgh Ci,6948,9,7,9,20,38,67,-29,30
Cowdenbeath,6948,10,5,10,21,25,55,-30,25
Montrose,6949,1,24,7,5,63,34,29,79
Peterhead,6949,2,24,4,8,79,38,41,76
Stirling,6949,3,16,7,13,61,52,9,55
Stenhousem'r,6949,4,15,9,12,56,47,9,54
Clyde,6949,5,15,9,12,54,49,5,54
Elgin,6949,6,14,6,16,53,64,-11,48
Annan Athlet,6949,7,12,11,13,49,41,8,47
Berwick,6949,8,8,10,18,30,61,-31,34
Edinburgh Ci,6949,9,7,9,20,36,62,-26,30
Cowdenbeath,6949,10,4,10,22,23,56,-33,22
Montrose,6950,1,23,8,5,59,34,25,77
Peterhead,6950,2,23,4,9,78,41,37,73
Stenhousem'r,6950,3,16,8,12,57,47,10,56
Stirling,6950,4,16,6,14,61,53,8,54
Clyde,6950,5,15,9,12,52,48,4,54
Elgin,6950,6,14,7,15,53,60,-7,49
Annan Athlet,6950,7,11,12,13,47,41,6,45
Berwick,6950,8,8,10,18,29,59,-30,34
Edinburgh Ci,6950,9,8,9,19,39,61,-22,33
Cowdenbeath,6950,10,4,11,21,23,54,-31,23
Montrose,6951,1,24,7,5,60,34,26,79
Peterhead,6951,2,24,4,8,83,38,45,76
Stirling,6951,3,16,7,13,61,52,9,55
Stenhousem'r,6951,4,15,9,12,56,47,9,54
Clyde,6951,5,14,10,12,51,48,3,52
Elgin,6951,6,14,6,16,53,61,-8,48
Annan Athlet,6951,7,11,11,14,47,42,5,44
Berwick,6951,8,8,11,17,29,58,-29,35
Edinburgh Ci,6951,9,7,9,20,36,66,-30,30
Cowdenbeath,6951,10,5,10,21,24,54,-30,25
Montrose,6952,1,23,8,5,61,36,25,77
Peterhead,6952,2,23,5,8,80,41,39,74
Stirling,6952,3,17,6,13,64,52,12,57
Stenhousem'r,6952,4,15,8,13,56,50,6,53
Clyde,6952,5,14,10,12,51,48,3,52
Elgin,6952,6,14,7,15,55,62,-7,49
Annan Athlet,6952,7,11,12,13,47,41,6,45
Berwick,6952,8,8,11,17,29,58,-29,35
Edinburgh Ci,6952,9,7,10,19,39,63,-24,31
Cowdenbeath,6952,10,4,11,21,23,54,-31,23
Montrose,6953,1,23,8,5,60,35,25,77
Peterhead,6953,2,24,4,8,81,40,41,76
Stenhousem'r,6953,3,16,8,12,59,47,12,56
Clyde,6953,4,15,9,12,55,48,7,54
Stirling,6953,5,16,6,14,61,55,6,54
Elgin,6953,6,14,7,15,54,61,-7,49
Annan Athlet,6953,7,11,12,13,47,41,6,45
Berwick,6953,8,8,10,18,29,62,-33,34
Edinburgh Ci,6953,9,7,9,20,38,64,-26,30
Cowdenbeath,6953,10,4,11,21,23,54,-31,23
Montrose,6954,1,24,7,5,62,34,28,79
Peterhead,6954,2,24,4,8,80,39,41,76
Stirling,6954,3,16,7,13,62,53,9,55
Stenhousem'r,6954,4,15,9,12,57,48,9,54
Clyde,6954,5,15,9,12,55,50,5,54
Elgin,6954,6,14,6,16,53,63,-10,48
Annan Athlet,6954,7,12,11,13,49,41,8,47
Berwick,6954,8,8,10,18,31,62,-31,34
Edinburgh Ci,6954,9,7,9,20,37,63,-26,30
Cowdenbeath,6954,10,4,10,22,23,56,-33,22
Peterhead,6955,1,24,4,8,80,38,42,76
Montrose,6955,2,23,7,6,60,37,23,76
Stirling,6955,3,17,6,13,62,52,10,57
Clyde,6955,4,15,9,12,56,48,8,54
Stenhousem'r,6955,5,15,8,13,56,48,8,53
Elgin,6955,6,15,6,15,56,61,-5,51
Annan Athlet,6955,7,11,12,13,48,42,6,45
Berwick,6955,8,8,10,18,29,63,-34,34
Edinburgh Ci,6955,9,7,9,20,36,63,-27,30
Cowdenbeath,6955,10,4,11,21,24,55,-31,23
Peterhead,6956,1,24,4,8,80,39,41,76
Montrose,6956,2,23,7,6,60,36,24,76
Stirling,6956,3,17,6,13,61,51,10,57
Stenhousem'r,6956,4,15,8,13,55,47,8,53
Clyde,6956,5,14,9,13,52,50,2,51
Elgin,6956,6,15,6,15,55,61,-6,51
Annan Athlet,6956,7,11,11,14,47,44,3,44
Berwick,6956,8,9,10,17,31,59,-28,37
Edinburgh Ci,6956,9,7,9,20,37,63,-26,30
Cowdenbeath,6956,10,5,10,21,26,54,-28,25
Montrose,6957,1,24,7,5,61,34,27,79
Peterhead,6957,2,24,4,8,81,40,41,76
Stenhousem'r,6957,3,16,8,12,57,47,10,56
Stirling,6957,4,16,6,14,61,53,8,54
Clyde,6957,5,15,9,12,52,48,4,54
Elgin,6957,6,14,6,16,53,62,-9,48
Annan Athlet,6957,7,11,11,14,47,42,5,44
Berwick,6957,8,8,10,18,29,59,-30,34
Edinburgh Ci,6957,9,7,9,20,38,64,-26,30
Cowdenbeath,6957,10,5,10,21,24,54,-30,25
Montrose,6958,1,24,7,5,63,34,29,79
Peterhead,6958,2,24,4,8,83,39,44,76
Stirling,6958,3,17,6,13,63,52,11,57
Stenhousem'r,6958,4,15,8,13,56,49,7,53
Clyde,6958,5,14,10,12,51,48,3,52
Elgin,6958,6,14,6,16,53,64,-11,48
Annan Athlet,6958,7,11,12,13,47,41,6,45
Berwick,6958,8,8,11,17,29,58,-29,35
Edinburgh Ci,6958,9,7,9,20,37,66,-29,30
Cowdenbeath,6958,10,4,11,21,23,54,-31,23
Montrose,6959,1,23,8,5,61,36,25,77
Peterhead,6959,2,23,4,9,78,42,36,73
Stirling,6959,3,16,7,13,61,52,9,55
Stenhousem'r,6959,4,15,9,12,56,47,9,54
Clyde,6959,5,14,9,13,52,50,2,51
Elgin,6959,6,14,7,15,55,62,-7,49
Annan Athlet,6959,7,12,11,13,49,41,8,47
Berwick,6959,8,9,10,17,31,59,-28,37
Edinburgh Ci,6959,9,8,9,19,40,61,-21,33
Cowdenbeath,6959,10,4,10,22,23,56,-33,22
Montrose,6960,1,23,8,5,62,37,25,77
Peterhead,6960,2,24,4,8,84,38,46,76
Stirling,6960,3,17,6,13,63,51,12,57
Stenhousem'r,6960,4,15,8,13,55,49,6,53
Clyde,6960,5,14,9,13,52,50,2,51
Elgin,6960,6,14,7,15,56,63,-7,49
Annan Athlet,6960,7,11,11,14,48,43,5,44
Berwick,6960,8,9,10,17,31,59,-28,37
Edinburgh Ci,6960,9,7,9,20,36,67,-31,30
Cowdenbeath,6960,10,5,10,21,25,55,-30,25
Peterhead,6961,1,24,4,8,82,39,43,76
Montrose,6961,2,23,7,6,60,36,24,76
Stirling,6961,3,17,6,13,62,52,10,57
Clyde,6961,4,15,9,12,54,48,6,54
Stenhousem'r,6961,5,15,8,13,56,48,8,53
Elgin,6961,6,15,6,15,55,61,-6,51
Annan Athlet,6961,7,11,12,13,48,42,6,45
Berwick,6961,8,8,10,18,29,61,-32,34
Edinburgh Ci,6961,9,7,9,20,37,65,-28,30
Cowdenbeath,6961,10,4,11,21,24,55,-31,23
Montrose,6962,1,24,7,5,63,37,26,79
Peterhead,6962,2,24,4,8,81,38,43,76
Stenhousem'r,6962,3,16,8,12,57,47,10,56
Stirling,6962,4,16,6,14,61,53,8,54
Clyde,6962,5,14,9,13,52,50,2,51
Elgin,6962,6,14,6,16,56,64,-8,48
Annan Athlet,6962,7,11,11,14,48,43,5,44
Berwick,6962,8,9,10,17,31,59,-28,37
Edinburgh Ci,6962,9,7,9,20,36,64,-28,30
Cowdenbeath,6962,10,5,10,21,25,55,-30,25
Montrose,6963,1,24,7,5,62,35,27,79
Peterhead,6963,2,24,4,8,80,40,40,76
Stenhousem'r,6963,3,16,8,12,58,47,11,56
Stirling,6963,4,16,6,14,61,54,7,54
Clyde,6963,5,14,9,13,51,49,2,51
Elgin,6963,6,14,6,16,54,63,-9,48
Annan Athlet,6963,7,12,11,13,48,41,7,47
Berwick,6963,8,9,10,17,30,58,-28,37
Edinburgh Ci,6963,9,7,9,20,38,63,-25,30
Cowdenbeath,6963,10,4,10,22,23,55,-32,22
Montrose,6964,1,24,7,5,62,34,28,79
Peterhead,6964,2,24,4,8,81,38,43,76
Stirling,6964,3,16,7,13,61,52,9,55
Stenhousem'r,6964,4,15,9,12,56,47,9,54
Clyde,6964,5,15,9,12,52,48,4,54
Elgin,6964,6,14,6,16,53,63,-10,48
Annan Athlet,6964,7,11,11,14,47,42,5,44
Berwick,6964,8,8,10,18,29,59,-30,34
Edinburgh Ci,6964,9,7,9,20,36,64,-28,30
Cowdenbeath,6964,10,5,10,21,24,54,-30,25
Montrose,6965,1,24,7,5,62,34,28,79
Peterhead,6965,2,23,5,8,79,40,39,74
Stirling,6965,3,17,6,13,62,52,10,57
Clyde,6965,4,15,9,12,53,49,4,54
Stenhousem'r,6965,5,15,8,13,56,48,8,53
Elgin,6965,6,14,6,16,53,63,-10,48
Annan Athlet,6965,7,12,11,13,48,41,7,47
Berwick,6965,8,8,10,18,30,60,-30,34
Edinburgh Ci,6965,9,7,10,19,38,62,-24,31
Cowdenbeath,6965,10,4,10,22,23,55,-32,22
Montrose,6966,1,23,8,5,61,36,25,77
Peterhead,6966,2,24,4,8,80,38,42,76
Stirling,6966,3,17,6,13,61,51,10,57
Clyde,6966,4,15,9,12,54,50,4,54
Stenhousem'r,6966,5,15,8,13,55,47,8,53
Elgin,6966,6,14,7,15,55,62,-7,49
Annan Athlet,6966,7,11,12,13,48,42,6,45
Berwick,6966,8,8,10,18,31,61,-30,34
Edinburgh Ci,6966,9,7,9,20,36,63,-27,30
Cowdenbeath,6966,10,4,11,21,24,55,-31,23
Montrose,6967,1,24,7,5,61,34,27,79
Peterhead,6967,2,24,4,8,81,40,41,76
Stirling,6967,3,17,6,13,63,53,10,57
Stenhousem'r,6967,4,15,8,13,57,49,8,53
Clyde,6967,5,14,10,12,53,50,3,52
Elgin,6967,6,14,6,16,53,62,-9,48
Annan Athlet,6967,7,12,11,13,49,42,7,47
Berwick,6967,8,8,11,17,31,60,-29,35
Edinburgh Ci,6967,9,7,9,20,38,64,-26,30
Cowdenbeath,6967,10,4,10,22,24,56,-32,22
Montrose,6968,1,24,7,5,62,34,28,79
Peterhead,6968,2,24,4,8,80,40,40,76
Stirling,6968,3,17,6,13,66,53,13,57
Clyde,6968,4,15,9,12,53,49,4,54
Stenhousem'r,6968,5,15,8,13,57,52,5,53
Elgin,6968,6,14,6,16,53,63,-10,48
Annan Athlet,6968,7,12,11,13,49,42,7,47
Berwick,6968,8,8,10,18,30,60,-30,34
Edinburgh Ci,6968,9,7,9,20,38,63,-25,30
Cowdenbeath,6968,10,4,10,22,24,56,-32,22
Montrose,6969,1,24,7,5,62,35,27,79
Peterhead,6969,2,24,4,8,81,38,43,76
Stenhousem'r,6969,3,16,8,12,56,46,10,56
Stirling,6969,4,16,6,14,60,52,8,54
Clyde,6969,5,15,9,12,52,48,4,54
Elgin,6969,6,14,6,16,54,63,-9,48
Annan Athlet,6969,7,11,11,14,47,43,4,44
Berwick,6969,8,8,10,18,29,59,-30,34
Edinburgh Ci,6969,9,7,9,20,36,64,-28,30
Cowdenbeath,6969,10,5,10,21,25,54,-29,25
Montrose,6970,1,24,7,5,61,34,27,79
Peterhead,6970,2,24,4,8,81,39,42,76
Stirling,6970,3,17,6,13,62,51,11,57
Clyde,6970,4,15,9,12,55,49,6,54
Stenhousem'r,6970,5,15,8,13,55,48,7,53
Elgin,6970,6,14,6,16,53,62,-9,48
Annan Athlet,6970,7,12,11,13,51,42,9,47
Berwick,6970,8,8,10,18,30,62,-32,34
Edinburgh Ci,6970,9,7,9,20,37,64,-27,30
Cowdenbeath,6970,10,4,10,22,24,58,-34,22
Montrose,6971,1,23,8,5,62,37,25,77
Peterhead,6971,2,23,5,8,78,39,39,74
Stirling,6971,3,16,7,13,61,52,9,55
Stenhousem'r,6971,4,15,9,12,56,47,9,54
Clyde,6971,5,14,10,12,52,49,3,52
Elgin,6971,6,14,7,15,56,63,-7,49
Annan Athlet,6971,7,12,11,13,49,42,7,47
Berwick,6971,8,8,11,17,30,59,-29,35
Edinburgh Ci,6971,9,7,10,19,37,61,-24,31
Cowdenbeath,6971,10,4,10,22,24,56,-32,22
Montrose,6972,1,23,8,5,62,37,25,77
Peterhead,6972,2,24,4,8,79,39,40,76
Stirling,6972,3,16,7,13,61,52,9,55
Stenhousem'r,6972,4,15,9,12,56,47,9,54
Clyde,6972,5,15,9,12,55,49,6,54
Elgin,6972,6,14,7,15,56,63,-7,49
Annan Athlet,6972,7,12,11,13,49,41,8,47
Berwick,6972,8,8,10,18,30,62,-32,34
Edinburgh Ci,6972,9,7,9,20,37,62,-25,30
Cowdenbeath,6972,10,4,10,22,23,56,-33,22
Montrose,6973,1,24,7,5,60,34,26,79
Peterhead,6973,2,24,4,8,80,38,42,76
Stirling,6973,3,16,7,13,62,53,9,55
Stenhousem'r,6973,4,15,9,12,57,48,9,54
Clyde,6973,5,15,9,12,55,48,7,54
Elgin,6973,6,14,6,16,53,61,-8,48
Annan Athlet,6973,7,12,11,13,48,41,7,47
Berwick,6973,8,8,10,18,29,62,-33,34
Edinburgh Ci,6973,9,7,9,20,36,63,-27,30
Cowdenbeath,6973,10,4,10,22,23,55,-32,22
Montrose,6974,1,24,7,5,64,36,28,79
Peterhead,6974,2,24,4,8,81,40,41,76
Stenhousem'r,6974,3,16,8,12,58,47,11,56
Stirling,6974,4,16,6,14,61,54,7,54
Clyde,6974,5,15,9,12,55,51,4,54
Elgin,6974,6,14,6,16,55,65,-10,48
Annan Athlet,6974,7,11,12,13,48,42,6,45
Berwick,6974,8,8,10,18,32,62,-30,34
Edinburgh Ci,6974,9,7,9,20,38,64,-26,30
Cowdenbeath,6974,10,4,11,21,24,55,-31,23
Montrose,6975,1,24,7,5,61,35,26,79
Peterhead,6975,2,24,4,8,82,39,43,76
Stenhousem'r,6975,3,16,8,12,57,47,10,56
Stirling,6975,4,16,6,14,61,53,8,54
Clyde,6975,5,15,9,12,53,48,5,54
Elgin,6975,6,14,6,16,54,62,-8,48
Annan Athlet,6975,7,11,12,13,48,42,6,45
Berwick,6975,8,8,10,18,29,60,-31,34
Edinburgh Ci,6975,9,7,9,20,37,65,-28,30
Cowdenbeath,6975,10,4,11,21,24,55,-31,23
Montrose,6976,1,24,7,5,62,36,26,79
Peterhead,6976,2,24,4,8,81,38,43,76
Stirling,6976,3,17,6,13,62,51,11,57
Stenhousem'r,6976,4,15,8,13,55,48,7,53
Clyde,6976,5,14,10,12,51,48,3,52
Elgin,6976,6,14,6,16,55,63,-8,48
Annan Athlet,6976,7,11,11,14,47,42,5,44
Berwick,6976,8,8,11,17,29,58,-29,35
Edinburgh Ci,6976,9,7,9,20,36,64,-28,30
Cowdenbeath,6976,10,5,10,21,24,54,-30,25
Montrose,6977,1,24,7,5,63,34,29,79
Peterhead,6977,2,23,5,8,78,39,39,74
Stirling,6977,3,17,6,13,65,53,12,57
Clyde,6977,4,15,9,12,55,50,5,54
Stenhousem'r,6977,5,15,8,13,57,51,6,53
Elgin,6977,6,14,6,16,53,64,-11,48
Annan Athlet,6977,7,11,11,14,48,43,5,44
Berwick,6977,8,8,10,18,31,62,-31,34
Edinburgh Ci,6977,9,7,10,19,37,61,-24,31
Cowdenbeath,6977,10,5,10,21,25,55,-30,25
Montrose,6978,1,23,7,6,60,36,24,76
Peterhead,6978,2,23,5,8,78,39,39,74
Stirling,6978,3,16,7,13,62,53,9,55
Stenhousem'r,6978,4,15,9,12,57,48,9,54
Clyde,6978,5,15,9,12,53,48,5,54
Elgin,6978,6,15,6,15,55,61,-6,51
Annan Athlet,6978,7,12,11,13,52,42,10,47
Berwick,6978,8,8,10,18,29,60,-31,34
Edinburgh Ci,6978,9,7,10,19,37,61,-24,31
Cowdenbeath,6978,10,4,10,22,24,59,-35,22
Montrose,6979,1,23,8,5,61,36,25,77
Peterhead,6979,2,24,4,8,82,38,44,76
Stirling,6979,3,17,6,13,62,52,10,57
Clyde,6979,4,15,9,12,52,48,4,54
Stenhousem'r,6979,5,15,8,13,56,48,8,53
Elgin,6979,6,14,7,15,55,62,-7,49
Annan Athlet,6979,7,11,12,13,47,41,6,45
Berwick,6979,8,8,10,18,29,59,-30,34
Edinburgh Ci,6979,9,7,9,20,36,65,-29,30
Cowdenbeath,6979,10,4,11,21,23,54,-31,23
Montrose,6980,1,23,8,5,60,35,25,77
Peterhead,6980,2,24,4,8,79,38,41,76
Stirling,6980,3,17,6,13,62,52,10,57
Clyde,6980,4,15,9,12,53,48,5,54
Stenhousem'r,6980,5,15,8,13,56,48,8,53
Elgin,6980,6,14,7,15,54,61,-7,49
Annan Athlet,6980,7,11,11,14,48,43,5,44
Berwick,6980,8,8,10,18,29,60,-31,34
Edinburgh Ci,6980,9,7,9,20,36,62,-26,30
Cowdenbeath,6980,10,5,10,21,25,55,-30,25
Montrose,6981,1,24,7,5,61,35,26,79
Peterhead,6981,2,24,4,8,81,39,42,76
Stirling,6981,3,17,6,13,62,51,11,57
Clyde,6981,4,15,9,12,55,48,7,54
Stenhousem'r,6981,5,15,8,13,55,48,7,53
Elgin,6981,6,14,6,16,54,62,-8,48
Annan Athlet,6981,7,12,11,13,50,42,8,47
Berwick,6981,8,8,10,18,29,62,-33,34
Edinburgh Ci,6981,9,7,9,20,37,64,-27,30
Cowdenbeath,6981,10,4,10,22,24,57,-33,22
Montrose,6982,1,23,8,5,59,34,25,77
Peterhead,6982,2,23,5,8,78,39,39,74
Stirling,6982,3,16,7,13,63,54,9,55
Stenhousem'r,6982,4,15,9,12,58,49,9,54
Clyde,6982,5,14,9,13,52,51,1,51
Elgin,6982,6,14,7,15,53,60,-7,49
Annan Athlet,6982,7,11,12,13,47,41,6,45
Berwick,6982,8,9,10,17,32,59,-27,37
Edinburgh Ci,6982,9,7,10,19,37,61,-24,31
Cowdenbeath,6982,10,4,11,21,23,54,-31,23
Peterhead,6983,1,24,4,8,79,39,40,76
Montrose,6983,2,23,7,6,59,35,24,76
Stenhousem'r,6983,3,16,8,12,56,46,10,56
Stirling,6983,4,16,6,14,60,52,8,54
Clyde,6983,5,15,9,12,53,49,4,54
Elgin,6983,6,15,6,15,54,60,-6,51
Annan Athlet,6983,7,11,11,14,48,45,3,44
Berwick,6983,8,8,10,18,30,60,-30,34
Edinburgh Ci,6983,9,7,9,20,37,62,-25,30
Cowdenbeath,6983,10,5,10,21,27,55,-28,25
Montrose,6984,1,23,8,5,59,34,25,77
Peterhead,6984,2,24,4,8,78,38,40,76
Stenhousem'r,6984,3,16,8,12,57,47,10,56
Stirling,6984,4,16,6,14,61,53,8,54
Clyde,6984,5,15,9,12,54,48,6,54
Elgin,6984,6,14,7,15,53,60,-7,49
Annan Athlet,6984,7,11,12,13,48,42,6,45
Berwick,6984,8,8,10,18,29,61,-32,34
Edinburgh Ci,6984,9,7,9,20,36,61,-25,30
Cowdenbeath,6984,10,4,11,21,24,55,-31,23
Montrose,6985,1,24,7,5,63,37,26,79
Peterhead,6985,2,24,4,8,78,38,40,76
Stirling,6985,3,17,6,13,63,52,11,57
Clyde,6985,4,15,9,12,52,48,4,54
Stenhousem'r,6985,5,15,8,13,56,49,7,53
Elgin,6985,6,14,6,16,56,64,-8,48
Annan Athlet,6985,7,11,12,13,47,41,6,45
Berwick,6985,8,8,10,18,29,59,-30,34
Edinburgh Ci,6985,9,7,9,20,36,61,-25,30
Cowdenbeath,6985,10,4,11,21,23,54,-31,23
Montrose,6986,1,24,7,5,60,34,26,79
Peterhead,6986,2,23,4,9,79,42,37,73
Stirling,6986,3,16,7,13,62,53,9,55
Stenhousem'r,6986,4,15,9,12,57,48,9,54
Clyde,6986,5,14,10,12,53,50,3,52
Elgin,6986,6,14,6,16,53,61,-8,48
Annan Athlet,6986,7,11,12,13,48,42,6,45
Berwick,6986,8,8,11,17,31,60,-29,35
Edinburgh Ci,6986,9,8,9,19,40,62,-22,33
Cowdenbeath,6986,10,4,11,21,24,55,-31,23
Montrose,6987,1,23,7,6,59,36,23,76
Peterhead,6987,2,23,5,8,78,39,39,74
Stirling,6987,3,17,6,13,63,52,11,57
Clyde,6987,4,15,9,12,56,48,8,54
Stenhousem'r,6987,5,15,8,13,56,49,7,53
Elgin,6987,6,15,6,15,55,60,-5,51
Annan Athlet,6987,7,11,11,14,48,43,5,44
Berwick,6987,8,8,10,18,29,63,-34,34
Edinburgh Ci,6987,9,7,10,19,37,61,-24,31
Cowdenbeath,6987,10,5,10,21,25,55,-30,25
Montrose,6988,1,23,8,5,61,36,25,77
Peterhead,6988,2,24,4,8,84,38,46,76
Stirling,6988,3,16,7,13,61,52,9,55
Stenhousem'r,6988,4,15,9,12,56,47,9,54
Clyde,6988,5,15,9,12,52,48,4,54
Elgin,6988,6,14,7,15,55,62,-7,49
Annan Athlet,6988,7,12,11,13,48,41,7,47
Berwick,6988,8,8,10,18,29,59,-30,34
Edinburgh Ci,6988,9,7,9,20,36,67,-31,30
Cowdenbeath,6988,10,4,10,22,23,55,-32,22
Montrose,6989,1,24,7,5,63,35,28,79
Peterhead,6989,2,24,4,8,79,39,40,76
Stirling,6989,3,17,6,13,63,53,10,57
Clyde,6989,4,15,9,12,55,51,4,54
Stenhousem'r,6989,5,15,8,13,57,49,8,53
Elgin,6989,6,14,6,16,54,64,-10,48
Annan Athlet,6989,7,12,11,13,49,41,8,47
Berwick,6989,8,8,10,18,32,62,-30,34
Edinburgh Ci,6989,9,7,9,20,37,62,-25,30
Cowdenbeath,6989,10,4,10,22,23,56,-33,22
Montrose,6990,1,23,8,5,62,37,25,77
Peterhead,6990,2,24,4,8,81,38,43,76
Stenhousem'r,6990,3,16,8,12,57,47,10,56
Stirling,6990,4,16,6,14,61,53,8,54
Clyde,6990,5,15,9,12,52,48,4,54
Elgin,6990,6,14,7,15,56,63,-7,49
Annan Athlet,6990,7,12,11,13,48,41,7,47
Berwick,6990,8,8,10,18,29,59,-30,34
Edinburgh Ci,6990,9,7,9,20,36,64,-28,30
Cowdenbeath,6990,10,4,10,22,23,55,-32,22
Peterhead,6991,1,24,4,8,78,38,40,76
Montrose,6991,2,23,7,6,60,36,24,76
Stenhousem'r,6991,3,16,8,12,57,46,11,56
Stirling,6991,4,16,6,14,60,53,7,54
Clyde,6991,5,15,9,12,53,49,4,54
Elgin,6991,6,15,6,15,55,61,-6,51
Annan Athlet,6991,7,12,11,13,49,41,8,47
Berwick,6991,8,8,10,18,30,60,-30,34
Edinburgh Ci,6991,9,7,9,20,36,61,-25,30
Cowdenbeath,6991,10,4,10,22,23,56,-33,22
Montrose,6992,1,24,7,5,63,35,28,79
Peterhead,6992,2,24,4,8,81,38,43,76
Stirling,6992,3,17,6,13,61,51,10,57
Stenhousem'r,6992,4,15,8,13,55,47,8,53
Clyde,6992,5,14,9,13,51,49,2,51
Elgin,6992,6,14,6,16,54,64,-10,48
Annan Athlet,6992,7,11,11,14,47,42,5,44
Berwick,6992,8,9,10,17,30,58,-28,37
Edinburgh Ci,6992,9,7,9,20,36,64,-28,30
Cowdenbeath,6992,10,5,10,21,24,54,-30,25
Montrose,6993,1,24,7,5,60,34,26,79
Peterhead,6993,2,24,4,8,79,39,40,76
Stenhousem'r,6993,3,16,8,12,58,47,11,56
Stirling,6993,4,16,6,14,61,54,7,54
Clyde,6993,5,14,10,12,51,48,3,52
Elgin,6993,6,14,6,16,53,61,-8,48
Annan Athlet,6993,7,11,11,14,47,42,5,44
Berwick,6993,8,8,11,17,29,58,-29,35
Edinburgh Ci,6993,9,7,9,20,37,62,-25,30
Cowdenbeath,6993,10,5,10,21,24,54,-30,25
Montrose,6994,1,24,7,5,63,36,27,79
Peterhead,6994,2,23,5,8,79,40,39,74
Stirling,6994,3,16,7,13,61,52,9,55
Stenhousem'r,6994,4,15,9,12,56,47,9,54
Clyde,6994,5,14,10,12,53,50,3,52
Elgin,6994,6,14,6,16,55,64,-9,48
Annan Athlet,6994,7,12,11,13,52,41,11,47
Berwick,6994,8,8,11,17,31,60,-29,35
Edinburgh Ci,6994,9,7,10,19,38,62,-24,31
Cowdenbeath,6994,10,4,10,22,23,59,-36,22
Peterhead,6995,1,24,4,8,80,39,41,76
Montrose,6995,2,23,7,6,60,36,24,76
Stenhousem'r,6995,3,16,8,12,57,47,10,56
Stirling,6995,4,16,6,14,61,53,8,54
Clyde,6995,5,15,9,12,53,48,5,54
Elgin,6995,6,15,6,15,55,61,-6,51
Annan Athlet,6995,7,11,11,14,47,43,4,44
Berwick,6995,8,8,10,18,29,60,-31,34
Edinburgh Ci,6995,9,7,9,20,37,63,-26,30
Cowdenbeath,6995,10,5,10,21,25,54,-29,25
Montrose,6996,1,24,7,5,60,34,26,79
Peterhead,6996,2,24,4,8,80,39,41,76
Stenhousem'r,6996,3,16,8,12,58,47,11,56
Stirling,6996,4,16,6,14,61,54,7,54
Clyde,6996,5,15,9,12,55,49,6,54
Elgin,6996,6,14,6,16,53,61,-8,48
Annan Athlet,6996,7,11,12,13,49,43,6,45
Berwick,6996,8,8,10,18,30,62,-32,34
Edinburgh Ci,6996,9,7,9,20,37,63,-26,30
Cowdenbeath,6996,10,4,11,21,25,56,-31,23
Montrose,6997,1,24,7,5,62,35,27,79
Peterhead,6997,2,24,4,8,83,39,44,76
Stirling,6997,3,17,6,13,61,51,10,57
Stenhousem'r,6997,4,15,8,13,55,47,8,53
Clyde,6997,5,14,10,12,52,49,3,52
Elgin,6997,6,14,6,16,54,63,-9,48
Annan Athlet,6997,7,11,12,13,47,41,6,45
Berwick,6997,8,8,11,17,30,59,-29,35
Edinburgh Ci,6997,9,7,9,20,37,66,-29,30
Cowdenbeath,6997,10,4,11,21,23,54,-31,23
Montrose,6998,1,24,7,5,60,34,26,79
Peterhead,6998,2,24,4,8,81,38,43,76
Stirling,6998,3,17,6,13,62,52,10,57
Clyde,6998,4,15,9,12,54,48,6,54
Stenhousem'r,6998,5,15,8,13,56,48,8,53
Elgin,6998,6,14,6,16,53,61,-8,48
Annan Athlet,6998,7,12,11,13,49,42,7,47
Berwick,6998,8,8,10,18,29,61,-32,34
Edinburgh Ci,6998,9,7,9,20,36,64,-28,30
Cowdenbeath,6998,10,4,10,22,24,56,-32,22
Montrose,6999,1,24,7,5,61,35,26,79
Peterhead,6999,2,24,4,8,82,41,41,76
Stenhousem'r,6999,3,16,8,12,57,47,10,56
Stirling,6999,4,16,6,14,61,53,8,54
Clyde,6999,5,15,9,12,56,49,7,54
Elgin,6999,6,14,6,16,54,62,-8,48
Annan Athlet,6999,7,12,11,13,48,41,7,47
Berwick,6999,8,8,10,18,30,63,-33,34
Edinburgh Ci,6999,9,7,9,20,39,65,-26,30
Cowdenbeath,6999,10,4,10,22,23,55,-32,22
Montrose,7000,1,23,8,5,60,35,25,77
Peterhead,7000,2,24,4,8,80,38,42,76
Stenhousem'r,7000,3,16,8,12,57,47,10,56
Stirling,7000,4,16,6,14,61,53,8,54
Clyde,7000,5,15,9,12,55,49,6,54
Elgin,7000,6,14,7,15,54,61,-7,49
Annan Athlet,7000,7,11,11,14,49,44,5,44
Berwick,7000,8,8,10,18,30,62,-32,34
Edinburgh Ci,7000,9,7,9,20,36,63,-27,30
Cowdenbeath,7000,10,5,10,21,26,56,-30,25
Peterhead,7001,1,24,4,8,80,40,40,76
Montrose,7001,2,23,7,6,59,37,22,76
Stenhousem'r,7001,3,16,8,12,57,46,11,56
Stirling,7001,4,16,6,14,60,53,7,54
Clyde,7001,5,15,9,12,53,49,4,54
Elgin,7001,6,15,6,15,56,60,-4,51
Annan Athlet,7001,7,12,11,13,49,42,7,47
Berwick,7001,8,8,10,18,30,60,-30,34
Edinburgh Ci,7001,9,7,9,20,38,63,-25,30
Cowdenbeath,7001,10,4,10,22,24,56,-32,22
Montrose,7002,1,24,7,5,62,35,27,79
Peterhead,7002,2,24,4,8,80,38,42,76
Stirling,7002,3,17,6,13,62,51,11,57
Stenhousem'r,7002,4,15,8,13,55,48,7,53
Clyde,7002,5,14,10,12,53,50,3,52
Elgin,7002,6,14,6,16,54,63,-9,48
Annan Athlet,7002,7,11,11,14,48,43,5,44
Berwick,7002,8,8,11,17,31,60,-29,35
Edinburgh Ci,7002,9,7,9,20,36,63,-27,30
Cowdenbeath,7002,10,5,10,21,25,55,-30,25
Montrose,7003,1,24,7,5,61,35,26,79
Peterhead,7003,2,24,4,8,82,38,44,76
Stirling,7003,3,16,7,13,62,53,9,55
Stenhousem'r,7003,4,15,9,12,57,48,9,54
Clyde,7003,5,15,9,12,53,48,5,54
Elgin,7003,6,14,6,16,54,62,-8,48
Annan Athlet,7003,7,12,11,13,50,43,7,47
Berwick,7003,8,8,10,18,29,60,-31,34
Edinburgh Ci,7003,9,7,9,20,36,65,-29,30
Cowdenbeath,7003,10,4,10,22,25,57,-32,22
Montrose,7004,1,24,7,5,63,35,28,79
Peterhead,7004,2,24,4,8,80,39,41,76
Stirling,7004,3,17,6,13,62,52,10,57
Clyde,7004,4,15,9,12,56,50,6,54
Stenhousem'r,7004,5,15,8,13,56,48,8,53
Elgin,7004,6,14,6,16,54,64,-10,48
Annan Athlet,7004,7,12,11,13,49,42,7,47
Berwick,7004,8,8,10,18,31,63,-32,34
Edinburgh Ci,7004,9,7,9,20,37,63,-26,30
Cowdenbeath,7004,10,4,10,22,24,56,-32,22
Peterhead,7005,1,24,4,8,81,38,43,76
Montrose,7005,2,23,7,6,61,37,24,76
Stirling,7005,3,17,6,13,61,51,10,57
Stenhousem'r,7005,4,15,8,13,55,47,8,53
Clyde,7005,5,14,9,13,51,49,2,51
Elgin,7005,6,15,6,15,56,62,-6,51
Annan Athlet,7005,7,11,12,13,47,41,6,45
Berwick,7005,8,9,10,17,30,58,-28,37
Edinburgh Ci,7005,9,7,9,20,36,64,-28,30
Cowdenbeath,7005,10,4,11,21,23,54,-31,23
Montrose,7006,1,24,7,5,61,34,27,79
Peterhead,7006,2,24,4,8,81,39,42,76
Stirling,7006,3,17,6,13,63,52,11,57
Stenhousem'r,7006,4,15,8,13,56,49,7,53
Clyde,7006,5,14,10,12,53,50,3,52
Elgin,7006,6,14,6,16,53,62,-9,48
Annan Athlet,7006,7,12,11,13,50,42,8,47
Berwick,7006,8,8,11,17,31,60,-29,35
Edinburgh Ci,7006,9,7,9,20,37,64,-27,30
Cowdenbeath,7006,10,4,10,22,24,57,-33,22
Peterhead,7007,1,24,4,8,79,38,41,76
Montrose,7007,2,23,7,6,59,36,23,76
Stenhousem'r,7007,3,16,8,12,57,47,10,56
Stirling,7007,4,16,6,14,61,53,8,54
Clyde,7007,5,14,9,13,52,50,2,51
Elgin,7007,6,15,6,15,55,60,-5,51
Annan Athlet,7007,7,11,11,14,47,43,4,44
Berwick,7007,8,9,10,17,31,59,-28,37
Edinburgh Ci,7007,9,7,9,20,36,62,-26,30
Cowdenbeath,7007,10,5,10,21,25,54,-29,25
Montrose,7008,1,24,7,5,60,34,26,79
Peterhead,7008,2,23,4,9,78,40,38,73
Stenhousem'r,7008,3,16,8,12,56,46,10,56
Stirling,7008,4,16,6,14,60,52,8,54
Clyde,7008,5,14,9,13,52,50,2,51
Elgin,7008,6,14,6,16,53,61,-8,48
Annan Athlet,7008,7,12,11,13,49,41,8,47
Berwick,7008,8,9,10,17,31,59,-28,37
Edinburgh Ci,7008,9,8,9,19,38,61,-23,33
Cowdenbeath,7008,10,4,10,22,23,56,-33,22
Montrose,7009,1,24,7,5,61,34,27,79
Peterhead,7009,2,24,4,8,82,39,43,76
Stirling,7009,3,17,6,13,65,53,12,57
Clyde,7009,4,15,9,12,54,50,4,54
Stenhousem'r,7009,5,15,8,13,57,51,6,53
Elgin,7009,6,14,6,16,53,62,-9,48
Annan Athlet,7009,7,11,12,13,48,42,6,45
Berwick,7009,8,8,10,18,31,61,-30,34
Edinburgh Ci,7009,9,7,9,20,37,65,-28,30
Cowdenbeath,7009,10,4,11,21,24,55,-31,23
Montrose,7010,1,23,8,5,59,34,25,77
Peterhead,7010,2,24,4,8,79,39,40,76
Stirling,7010,3,17,6,13,64,52,12,57
Clyde,7010,4,15,9,12,53,49,4,54
Stenhousem'r,7010,5,15,8,13,56,50,6,53
Elgin,7010,6,14,7,15,53,60,-7,49
Annan Athlet,7010,7,11,11,14,47,42,5,44
Berwick,7010,8,8,10,18,30,60,-30,34
Edinburgh Ci,7010,9,7,9,20,37,62,-25,30
Cowdenbeath,7010,10,5,10,21,24,54,-30,25
Montrose,7011,1,23,7,6,60,36,24,76
Peterhead,7011,2,23,4,9,78,41,37,73
Stirling,7011,3,16,7,13,61,52,9,55
Stenhousem'r,7011,4,15,9,12,56,47,9,54
Clyde,7011,5,15,9,12,53,48,5,54
Elgin,7011,6,15,6,15,55,61,-6,51
Annan Athlet,7011,7,11,11,14,47,42,5,44
Berwick,7011,8,8,10,18,29,60,-31,34
Edinburgh Ci,7011,9,8,9,19,39,61,-22,33
Cowdenbeath,7011,10,5,10,21,24,54,-30,25
Montrose,7012,1,24,7,5,62,34,28,79
Peterhead,7012,2,24,4,8,79,38,41,76
Stenhousem'r,7012,3,16,8,12,57,47,10,56
Stirling,7012,4,16,6,14,61,53,8,54
Clyde,7012,5,14,10,12,53,50,3,52
Elgin,7012,6,14,6,16,53,63,-10,48
Annan Athlet,7012,7,12,11,13,49,42,7,47
Berwick,7012,8,8,11,17,31,60,-29,35
Edinburgh Ci,7012,9,7,9,20,36,62,-26,30
Cowdenbeath,7012,10,4,10,22,24,56,-32,22
Montrose,7013,1,23,7,6,59,35,24,76
Peterhead,7013,2,23,5,8,79,40,39,74
Stirling,7013,3,17,6,13,63,51,12,57
Clyde,7013,4,15,9,12,55,49,6,54
Stenhousem'r,7013,5,15,8,13,55,49,6,53
Elgin,7013,6,15,6,15,54,60,-6,51
Annan Athlet,7013,7,11,11,14,47,42,5,44
Berwick,7013,8,8,10,18,30,62,-32,34
Edinburgh Ci,7013,9,7,10,19,38,62,-24,31
Cowdenbeath,7013,10,5,10,21,24,54,-30,25
Montrose,7014,1,24,7,5,64,34,30,79
Peterhead,7014,2,23,5,8,81,42,39,74
Stirling,7014,3,17,6,13,64,51,13,57
Clyde,7014,4,15,9,12,54,49,5,54
Stenhousem'r,7014,5,15,8,13,55,50,5,53
Elgin,7014,6,14,6,16,53,65,-12,48
Annan Athlet,7014,7,11,12,13,47,41,6,45
Berwick,7014,8,8,10,18,30,61,-31,34
Edinburgh Ci,7014,9,7,10,19,40,64,-24,31
Cowdenbeath,7014,10,4,11,21,23,54,-31,23
Montrose,7015,1,24,7,5,61,35,26,79
Peterhead,7015,2,24,4,8,80,39,41,76
Stenhousem'r,7015,3,16,8,12,60,49,11,56
Stirling,7015,4,16,6,14,63,56,7,54
Clyde,7015,5,15,9,12,52,48,4,54
Elgin,7015,6,14,6,16,54,62,-8,48
Annan Athlet,7015,7,11,12,13,48,42,6,45
Berwick,7015,8,8,10,18,29,59,-30,34
Edinburgh Ci,7015,9,7,9,20,37,63,-26,30
Cowdenbeath,7015,10,4,11,21,24,55,-31,23
Montrose,7016,1,24,7,5,61,34,27,79
Peterhead,7016,2,23,4,9,77,39,38,73
Stirling,7016,3,17,6,13,63,51,12,57
Clyde,7016,4,15,9,12,54,50,4,54
Stenhousem'r,7016,5,15,8,13,55,49,6,53
Elgin,7016,6,14,6,16,53,62,-9,48
Annan Athlet,7016,7,11,12,13,48,42,6,45
Berwick,7016,8,8,10,18,31,61,-30,34
Edinburgh Ci,7016,9,8,9,19,37,60,-23,33
Cowdenbeath,7016,10,4,11,21,24,55,-31,23
Montrose,7017,1,23,8,5,59,34,25,77
Peterhead,7017,2,23,5,8,78,39,39,74
Stirling,7017,3,17,6,13,63,52,11,57
Clyde,7017,4,15,9,12,53,48,5,54
Stenhousem'r,7017,5,15,8,13,56,49,7,53
Elgin,7017,6,14,7,15,53,60,-7,49
Annan Athlet,7017,7,11,11,14,47,42,5,44
Berwick,7017,8,8,10,18,29,60,-31,34
Edinburgh Ci,7017,9,7,10,19,37,61,-24,31
Cowdenbeath,7017,10,5,10,21,24,54,-30,25
Peterhead,7018,1,24,4,8,81,39,42,76
Montrose,7018,2,23,7,6,60,37,23,76
Stirling,7018,3,16,7,13,61,52,9,55
Stenhousem'r,7018,4,15,9,12,56,47,9,54
Clyde,7018,5,15,9,12,53,49,4,54
Elgin,7018,6,15,6,15,56,61,-5,51
Annan Athlet,7018,7,11,11,14,48,43,5,44
Berwick,7018,8,8,10,18,30,60,-30,34
Edinburgh Ci,7018,9,7,9,20,37,64,-27,30
Cowdenbeath,7018,10,5,10,21,25,55,-30,25
Montrose,7019,1,23,8,5,59,34,25,77
Peterhead,7019,2,24,4,8,80,38,42,76
Stirling,7019,3,17,6,13,62,52,10,57
Clyde,7019,4,15,9,12,52,48,4,54
Stenhousem'r,7019,5,15,8,13,56,48,8,53
Elgin,7019,6,14,7,15,53,60,-7,49
Annan Athlet,7019,7,11,12,13,47,41,6,45
Berwick,7019,8,8,10,18,29,59,-30,34
Edinburgh Ci,7019,9,7,9,20,36,63,-27,30
Cowdenbeath,7019,10,4,11,21,23,54,-31,23
Montrose,7020,1,24,7,5,63,36,27,79
Peterhead,7020,2,24,4,8,81,39,42,76
Stenhousem'r,7020,3,16,8,12,56,46,10,56
Stirling,7020,4,16,6,14,60,52,8,54
Clyde,7020,5,14,10,12,52,49,3,52
Elgin,7020,6,14,6,16,55,64,-9,48
Annan Athlet,7020,7,11,12,13,48,42,6,45
Berwick,7020,8,8,11,17,30,59,-29,35
Edinburgh Ci,7020,9,7,9,20,37,64,-27,30
Cowdenbeath,7020,10,4,11,21,24,55,-31,23
Montrose,7021,1,23,8,5,60,35,25,77
Peterhead,7021,2,24,4,8,80,39,41,76
Stirling,7021,3,17,6,13,61,51,10,57
Clyde,7021,4,15,9,12,55,49,6,54
Stenhousem'r,7021,5,15,8,13,55,47,8,53
Elgin,7021,6,14,7,15,54,61,-7,49
Annan Athlet,7021,7,12,11,13,48,41,7,47
Berwick,7021,8,8,10,18,30,62,-32,34
Edinburgh Ci,7021,9,7,9,20,37,63,-26,30
Cowdenbeath,7021,10,4,10,22,23,55,-32,22
Peterhead,7022,1,24,4,8,81,38,43,76
Montrose,7022,2,23,7,6,60,36,24,76
Stirling,7022,3,17,6,13,63,51,12,57
Stenhousem'r,7022,4,15,8,13,55,49,6,53
Clyde,7022,5,14,9,13,52,50,2,51
Elgin,7022,6,15,6,15,55,61,-6,51
Annan Athlet,7022,7,11,11,14,48,43,5,44
Berwick,7022,8,9,10,17,31,59,-28,37
Edinburgh Ci,7022,9,7,9,20,36,64,-28,30
Cowdenbeath,7022,10,5,10,21,25,55,-30,25
Montrose,7023,1,23,8,5,60,35,25,77
Peterhead,7023,2,24,4,8,79,38,41,76
Stirling,7023,3,17,6,13,63,51,12,57
Stenhousem'r,7023,4,15,8,13,55,49,6,53
Clyde,7023,5,14,10,12,51,48,3,52
Elgin,7023,6,14,7,15,54,61,-7,49
Annan Athlet,7023,7,12,11,13,51,41,10,47
Berwick,7023,8,8,11,17,29,58,-29,35
Edinburgh Ci,7023,9,7,9,20,36,62,-26,30
Cowdenbeath,7023,10,4,10,22,23,58,-35,22
Peterhead,7024,1,24,4,8,81,38,43,76
Montrose,7024,2,23,7,6,60,36,24,76
Stenhousem'r,7024,3,16,8,12,56,46,10,56
Stirling,7024,4,16,6,14,60,52,8,54
Clyde,7024,5,14,9,13,51,50,1,51
Elgin,7024,6,15,6,15,55,61,-6,51
Annan Athlet,7024,7,11,11,14,47,42,5,44
Berwick,7024,8,9,10,17,31,58,-27,37
Edinburgh Ci,7024,9,7,9,20,36,64,-28,30
Cowdenbeath,7024,10,5,10,21,24,54,-30,25
Montrose,7025,1,24,7,5,61,34,27,79
Peterhead,7025,2,24,4,8,78,38,40,76
Stirling,7025,3,17,6,13,65,54,11,57
Stenhousem'r,7025,4,15,8,13,58,51,7,53
Clyde,7025,5,14,9,13,51,50,1,51
Elgin,7025,6,14,6,16,53,62,-9,48
Annan Athlet,7025,7,11,11,14,47,42,5,44
Berwick,7025,8,9,10,17,31,58,-27,37
Edinburgh Ci,7025,9,7,9,20,36,61,-25,30
Cowdenbeath,7025,10,5,10,21,24,54,-30,25
Montrose,7026,1,24,7,5,61,34,27,79
Peterhead,7026,2,24,4,8,81,39,42,76
Stenhousem'r,7026,3,16,8,12,56,46,10,56
Stirling,7026,4,16,6,14,60,52,8,54
Clyde,7026,5,14,10,12,52,49,3,52
Elgin,7026,6,14,6,16,53,62,-9,48
Annan Athlet,7026,7,11,11,14,47,43,4,44
Berwick,7026,8,8,11,17,30,59,-29,35
Edinburgh Ci,7026,9,7,9,20,37,64,-27,30
Cowdenbeath,7026,10,5,10,21,25,54,-29,25
Montrose,7027,1,24,7,5,61,34,27,79
Peterhead,7027,2,24,4,8,78,38,40,76
Stenhousem'r,7027,3,16,8,12,57,47,10,56
Stirling,7027,4,16,6,14,61,53,8,54
Clyde,7027,5,14,10,12,54,51,3,52
Elgin,7027,6,14,6,16,53,62,-9,48
Annan Athlet,7027,7,11,12,13,47,41,6,45
Berwick,7027,8,8,11,17,32,61,-29,35
Edinburgh Ci,7027,9,7,9,20,36,61,-25,30
Cowdenbeath,7027,10,4,11,21,23,54,-31,23
Montrose,7028,1,24,7,5,60,34,26,79
Peterhead,7028,2,24,4,8,80,38,42,76
Stirling,7028,3,17,6,13,64,53,11,57
Clyde,7028,4,15,9,12,55,50,5,54
Stenhousem'r,7028,5,15,8,13,57,50,7,53
Elgin,7028,6,14,6,16,53,61,-8,48
Annan Athlet,7028,7,11,12,13,47,41,6,45
Berwick,7028,8,8,10,18,31,62,-31,34
Edinburgh Ci,7028,9,7,9,20,36,63,-27,30
Cowdenbeath,7028,10,4,11,21,23,54,-31,23
Montrose,7029,1,23,8,5,60,35,25,77
Peterhead,7029,2,24,4,8,79,38,41,76
Stirling,7029,3,17,6,13,62,52,10,57
Clyde,7029,4,15,9,12,54,48,6,54
Stenhousem'r,7029,5,15,8,13,56,48,8,53
Elgin,7029,6,14,7,15,54,61,-7,49
Annan Athlet,7029,7,12,11,13,48,41,7,47
Berwick,7029,8,8,10,18,29,61,-32,34
Edinburgh Ci,7029,9,7,9,20,36,62,-26,30
Cowdenbeath,7029,10,4,10,22,23,55,-32,22
Peterhead,7030,1,24,4,8,83,39,44,76
Montrose,7030,2,23,7,6,59,35,24,76
Stenhousem'r,7030,3,16,8,12,57,46,11,56
Stirling,7030,4,16,6,14,60,53,7,54
Clyde,7030,5,14,10,12,54,51,3,52
Elgin,7030,6,15,6,15,54,60,-6,51
Annan Athlet,7030,7,11,12,13,50,44,6,45
Berwick,7030,8,8,11,17,32,61,-29,35
Edinburgh Ci,7030,9,7,9,20,37,66,-29,30
Cowdenbeath,7030,10,4,11,21,26,57,-31,23
Montrose,7031,1,24,7,5,61,34,27,79
Peterhead,7031,2,23,5,8,78,39,39,74
Stenhousem'r,7031,3,16,8,12,57,46,11,56
Stirling,7031,4,16,6,14,60,53,7,54
Clyde,7031,5,15,9,12,55,49,6,54
Elgin,7031,6,14,6,16,53,62,-9,48
Annan Athlet,7031,7,12,11,13,50,42,8,47
Berwick,7031,8,8,10,18,30,62,-32,34
Edinburgh Ci,7031,9,7,10,19,37,61,-24,31
Cowdenbeath,7031,10,4,10,22,24,57,-33,22
Montrose,7032,1,23,8,5,59,34,25,77
Peterhead,7032,2,24,4,8,79,38,41,76
Stenhousem'r,7032,3,16,8,12,57,47,10,56
Stirling,7032,4,16,6,14,61,53,8,54
Clyde,7032,5,15,9,12,56,49,7,54
Elgin,7032,6,14,7,15,53,60,-7,49
Annan Athlet,7032,7,11,12,13,48,42,6,45
Berwick,7032,8,8,10,18,30,63,-33,34
Edinburgh Ci,7032,9,7,9,20,36,62,-26,30
Cowdenbeath,7032,10,4,11,21,24,55,-31,23
Montrose,7033,1,23,8,5,62,37,25,77
Peterhead,7033,2,24,4,8,80,38,42,76
Stirling,7033,3,17,6,13,63,53,10,57
Stenhousem'r,7033,4,15,8,13,57,49,8,53
Clyde,7033,5,14,10,12,53,50,3,52
Elgin,7033,6,14,7,15,56,63,-7,49
Annan Athlet,7033,7,11,12,13,48,42,6,45
Berwick,7033,8,8,11,17,31,60,-29,35
Edinburgh Ci,7033,9,7,9,20,36,63,-27,30
Cowdenbeath,7033,10,4,11,21,24,55,-31,23
Montrose,7034,1,24,7,5,63,35,28,79
Peterhead,7034,2,24,4,8,79,38,41,76
Stenhousem'r,7034,3,16,8,12,57,46,11,56
Stirling,7034,4,16,6,14,60,53,7,54
Clyde,7034,5,15,9,12,53,48,5,54
Elgin,7034,6,14,6,16,54,64,-10,48
Annan Athlet,7034,7,11,11,14,47,44,3,44
Berwick,7034,8,8,10,18,29,60,-31,34
Edinburgh Ci,7034,9,7,9,20,36,62,-26,30
Cowdenbeath,7034,10,5,10,21,26,54,-28,25
Montrose,7035,1,24,7,5,63,34,29,79
Peterhead,7035,2,24,4,8,79,39,40,76
Stenhousem'r,7035,3,16,8,12,57,46,11,56
Stirling,7035,4,16,6,14,60,53,7,54
Clyde,7035,5,14,9,13,51,49,2,51
Elgin,7035,6,14,6,16,53,64,-11,48
Annan Athlet,7035,7,11,12,13,47,41,6,45
Berwick,7035,8,9,10,17,30,58,-28,37
Edinburgh Ci,7035,9,7,9,20,37,62,-25,30
Cowdenbeath,7035,10,4,11,21,23,54,-31,23
Montrose,7036,1,24,7,5,61,35,26,79
Peterhead,7036,2,24,4,8,81,39,42,76
Stenhousem'r,7036,3,16,8,12,57,46,11,56
Stirling,7036,4,16,6,14,60,53,7,54
Clyde,7036,5,14,9,13,54,52,2,51
Elgin,7036,6,14,6,16,54,62,-8,48
Annan Athlet,7036,7,12,11,13,50,41,9,47
Berwick,7036,8,9,10,17,33,61,-28,37
Edinburgh Ci,7036,9,7,9,20,37,64,-27,30
Cowdenbeath,7036,10,4,10,22,23,57,-34,22
Peterhead,7037,1,24,4,8,80,38,42,76
Montrose,7037,2,23,7,6,60,36,24,76
Stirling,7037,3,16,7,13,60,51,9,55
Stenhousem'r,7037,4,15,9,12,55,46,9,54
Clyde,7037,5,14,10,12,52,49,3,52
Elgin,7037,6,15,6,15,55,61,-6,51
Annan Athlet,7037,7,12,11,13,49,42,7,47
Berwick,7037,8,8,11,17,30,59,-29,35
Edinburgh Ci,7037,9,7,9,20,36,63,-27,30
Cowdenbeath,7037,10,4,10,22,24,56,-32,22
Montrose,7038,1,24,7,5,61,34,27,79
Peterhead,7038,2,24,4,8,79,38,41,76
Stirling,7038,3,17,6,13,63,51,12,57
Stenhousem'r,7038,4,15,8,13,55,49,6,53
Clyde,7038,5,14,10,12,53,50,3,52
Elgin,7038,6,14,6,16,53,62,-9,48
Annan Athlet,7038,7,11,11,14,48,44,4,44
Berwick,7038,8,8,11,17,31,60,-29,35
Edinburgh Ci,7038,9,7,9,20,36,62,-26,30
Cowdenbeath,7038,10,5,10,21,26,55,-29,25
Montrose,7039,1,24,7,5,61,35,26,79
Peterhead,7039,2,24,4,8,79,39,40,76
Stirling,7039,3,16,7,13,60,51,9,55
Stenhousem'r,7039,4,15,9,12,55,46,9,54
Clyde,7039,5,15,9,12,56,51,5,54
Elgin,7039,6,14,6,16,54,62,-8,48
Annan Athlet,7039,7,11,11,14,48,43,5,44
Berwick,7039,8,8,10,18,32,63,-31,34
Edinburgh Ci,7039,9,7,9,20,37,62,-25,30
Cowdenbeath,7039,10,5,10,21,25,55,-30,25
Montrose,7040,1,23,7,6,60,36,24,76
Peterhead,7040,2,23,4,9,79,42,37,73
Stirling,7040,3,16,7,13,62,53,9,55
Stenhousem'r,7040,4,15,9,12,57,48,9,54
Clyde,7040,5,15,9,12,54,49,5,54
Elgin,7040,6,15,6,15,55,61,-6,51
Annan Athlet,7040,7,11,11,14,47,42,5,44
Berwick,7040,8,8,10,18,30,61,-31,34
Edinburgh Ci,7040,9,8,9,19,40,62,-22,33
Cowdenbeath,7040,10,5,10,21,24,54,-30,25
Montrose,7041,1,24,7,5,62,35,27,79
Peterhead,7041,2,23,4,9,77,39,38,73
Stirling,7041,3,16,7,13,61,52,9,55
Stenhousem'r,7041,4,15,9,12,56,47,9,54
Clyde,7041,5,14,9,13,51,50,1,51
Elgin,7041,6,14,6,16,54,63,-9,48
Annan Athlet,7041,7,12,11,13,51,42,9,47
Berwick,7041,8,9,10,17,31,58,-27,37
Edinburgh Ci,7041,9,8,9,19,37,60,-23,33
Cowdenbeath,7041,10,4,10,22,24,58,-34,22
Montrose,7042,1,24,7,5,62,34,28,79
Peterhead,7042,2,24,4,8,82,38,44,76
Stenhousem'r,7042,3,16,8,12,56,46,10,56
Stirling,7042,4,16,6,14,60,52,8,54
Clyde,7042,5,14,10,12,53,50,3,52
Elgin,7042,6,14,6,16,53,63,-10,48
Annan Athlet,7042,7,11,11,14,47,42,5,44
Berwick,7042,8,8,11,17,31,60,-29,35
Edinburgh Ci,7042,9,7,9,20,36,65,-29,30
Cowdenbeath,7042,10,5,10,21,24,54,-30,25
Peterhead,7043,1,24,4,8,79,38,41,76
Montrose,7043,2,23,7,6,61,38,23,76
Stenhousem'r,7043,3,16,8,12,56,46,10,56
Stirling,7043,4,16,6,14,60,52,8,54
Clyde,7043,5,15,9,12,53,48,5,54
Elgin,7043,6,15,6,15,57,62,-5,51
Annan Athlet,7043,7,11,11,14,48,43,5,44
Berwick,7043,8,8,10,18,29,60,-31,34
Edinburgh Ci,7043,9,7,9,20,36,62,-26,30
Cowdenbeath,7043,10,5,10,21,25,55,-30,25
Montrose,7044,1,24,7,5,62,36,26,79
Peterhead,7044,2,24,4,8,79,38,41,76
Stirling,7044,3,17,6,13,63,51,12,57
Clyde,7044,4,15,9,12,53,49,4,54
Stenhousem'r,7044,5,15,8,13,55,49,6,53
Elgin,7044,6,14,6,16,55,63,-8,48
Annan Athlet,7044,7,11,11,14,48,43,5,44
Berwick,7044,8,8,10,18,30,60,-30,34
Edinburgh Ci,7044,9,7,9,20,36,62,-26,30
Cowdenbeath,7044,10,5,10,21,25,55,-30,25
Montrose,7045,1,24,7,5,62,35,27,79
Peterhead,7045,2,24,4,8,81,38,43,76
Stirling,7045,3,17,6,13,62,52,10,57
Stenhousem'r,7045,4,15,8,13,56,48,8,53
Clyde,7045,5,14,9,13,51,49,2,51
Elgin,7045,6,14,6,16,54,63,-9,48
Annan Athlet,7045,7,11,12,13,48,42,6,45
Berwick,7045,8,9,10,17,30,58,-28,37
Edinburgh Ci,7045,9,7,9,20,36,64,-28,30
Cowdenbeath,7045,10,4,11,21,24,55,-31,23
Montrose,7046,1,24,7,5,66,35,31,79
Peterhead,7046,2,24,4,8,80,40,40,76
Stenhousem'r,7046,3,16,8,12,56,46,10,56
Stirling,7046,4,16,6,14,60,52,8,54
Clyde,7046,5,14,10,12,52,49,3,52
Elgin,7046,6,14,6,16,54,67,-13,48
Annan Athlet,7046,7,11,12,13,48,42,6,45
Berwick,7046,8,8,11,17,30,59,-29,35
Edinburgh Ci,7046,9,7,9,20,38,63,-25,30
Cowdenbeath,7046,10,4,11,21,24,55,-31,23
Montrose,7047,1,24,7,5,62,36,26,79
Peterhead,7047,2,24,4,8,80,39,41,76
Stenhousem'r,7047,3,16,8,12,58,48,10,56
Stirling,7047,4,16,6,14,62,54,8,54
Clyde,7047,5,15,9,12,55,48,7,54
Elgin,7047,6,14,6,16,55,63,-8,48
Annan Athlet,7047,7,11,12,13,48,42,6,45
Berwick,7047,8,8,10,18,29,62,-33,34
Edinburgh Ci,7047,9,7,9,20,37,63,-26,30
Cowdenbeath,7047,10,4,11,21,24,55,-31,23
Montrose,7048,1,24,7,5,61,35,26,79
Peterhead,7048,2,23,4,9,78,40,38,73
Stirling,7048,3,17,6,13,63,52,11,57
Clyde,7048,4,15,9,12,53,49,4,54
Stenhousem'r,7048,5,15,8,13,56,49,7,53
Elgin,7048,6,14,6,16,54,62,-8,48
Annan Athlet,7048,7,11,11,14,48,44,4,44
Berwick,7048,8,8,10,18,30,60,-30,34
Edinburgh Ci,7048,9,8,9,19,38,61,-23,33
Cowdenbeath,7048,10,5,10,21,26,55,-29,25
Montrose,7049,1,24,7,5,63,34,29,79
Peterhead,7049,2,23,4,9,79,41,38,73
Stirling,7049,3,17,6,13,61,51,10,57
Clyde,7049,4,15,9,12,56,49,7,54
Stenhousem'r,7049,5,15,8,13,55,47,8,53
Elgin,7049,6,14,6,16,53,64,-11,48
Annan Athlet,7049,7,11,12,13,48,42,6,45
Berwick,7049,8,8,10,18,30,63,-33,34
Edinburgh Ci,7049,9,8,9,19,39,62,-23,33
Cowdenbeath,7049,10,4,11,21,24,55,-31,23
Montrose,7050,1,24,7,5,63,34,29,79
Peterhead,7050,2,23,5,8,79,40,39,74
Stirling,7050,3,17,6,13,63,52,11,57
Stenhousem'r,7050,4,15,8,13,56,49,7,53
Clyde,7050,5,14,10,12,52,49,3,52
Elgin,7050,6,14,6,16,53,64,-11,48
Annan Athlet,7050,7,12,11,13,49,41,8,47
Berwick,7050,8,8,11,17,30,59,-29,35
Edinburgh Ci,7050,9,7,10,19,38,62,-24,31
Cowdenbeath,7050,10,4,10,22,23,56,-33,22
Montrose,7051,1,24,7,5,64,35,29,79
Peterhead,7051,2,23,5,8,78,39,39,74
Stenhousem'r,7051,3,16,8,12,57,46,11,56
Stirling,7051,4,16,6,14,60,53,7,54
Clyde,7051,5,14,9,13,52,50,2,51
Elgin,7051,6,14,6,16,54,65,-11,48
Annan Athlet,7051,7,11,11,14,47,45,2,44
Berwick,7051,8,9,10,17,31,59,-28,37
Edinburgh Ci,7051,9,7,10,19,37,61,-24,31
Cowdenbeath,7051,10,5,10,21,27,54,-27,25
Montrose,7052,1,24,7,5,63,35,28,79
Peterhead,7052,2,24,4,8,83,38,45,76
Stirling,7052,3,16,7,13,63,54,9,55
Stenhousem'r,7052,4,15,9,12,58,49,9,54
Clyde,7052,5,14,10,12,51,48,3,52
Elgin,7052,6,14,6,16,54,64,-10,48
Annan Athlet,7052,7,12,11,13,51,42,9,47
Berwick,7052,8,8,11,17,29,58,-29,35
Edinburgh Ci,7052,9,7,9,20,36,66,-30,30
Cowdenbeath,7052,10,4,10,22,24,58,-34,22
Montrose,7053,1,24,7,5,62,35,27,79
Peterhead,7053,2,23,4,9,77,39,38,73
Stenhousem'r,7053,3,16,8,12,58,47,11,56
Stirling,7053,4,16,6,14,61,54,7,54
Clyde,7053,5,15,9,12,52,48,4,54
Elgin,7053,6,14,6,16,54,63,-9,48
Annan Athlet,7053,7,11,12,13,49,43,6,45
Berwick,7053,8,8,10,18,29,59,-30,34
Edinburgh Ci,7053,9,8,9,19,37,60,-23,33
Cowdenbeath,7053,10,4,11,21,25,56,-31,23
Montrose,7054,1,23,8,5,59,34,25,77
Peterhead,7054,2,24,4,8,79,39,40,76
Stenhousem'r,7054,3,16,8,12,56,46,10,56
Stirling,7054,4,16,6,14,60,52,8,54
Clyde,7054,5,15,9,12,54,49,5,54
Elgin,7054,6,14,7,15,53,60,-7,49
Annan Athlet,7054,7,12,11,13,49,42,7,47
Berwick,7054,8,8,10,18,30,61,-31,34
Edinburgh Ci,7054,9,7,9,20,37,62,-25,30
Cowdenbeath,7054,10,4,10,22,24,56,-32,22
Montrose,7055,1,24,7,5,61,35,26,79
Peterhead,7055,2,24,4,8,81,39,42,76
Stirling,7055,3,17,6,13,63,53,10,57
Clyde,7055,4,15,9,12,53,49,4,54
Stenhousem'r,7055,5,15,8,13,57,49,8,53
Elgin,7055,6,14,6,16,54,62,-8,48
Annan Athlet,7055,7,11,12,13,47,41,6,45
Berwick,7055,8,8,10,18,30,60,-30,34
Edinburgh Ci,7055,9,7,9,20,37,64,-27,30
Cowdenbeath,7055,10,4,11,21,23,54,-31,23
Montrose,7056,1,23,8,5,61,36,25,77
Peterhead,7056,2,24,4,8,78,38,40,76
Stirling,7056,3,17,6,13,63,51,12,57
Clyde,7056,4,15,9,12,54,50,4,54
Stenhousem'r,7056,5,15,8,13,55,49,6,53
Elgin,7056,6,14,7,15,55,62,-7,49
Annan Athlet,7056,7,12,11,13,48,41,7,47
Berwick,7056,8,8,10,18,31,61,-30,34
Edinburgh Ci,7056,9,7,9,20,36,61,-25,30
Cowdenbeath,7056,10,4,10,22,23,55,-32,22
Montrose,7057,1,24,7,5,60,34,26,79
Peterhead,7057,2,24,4,8,80,38,42,76
Stenhousem'r,7057,3,16,8,12,57,47,10,56
Stirling,7057,4,16,6,14,61,53,8,54
Clyde,7057,5,14,10,12,51,48,3,52
Elgin,7057,6,14,6,16,53,61,-8,48
Annan Athlet,7057,7,11,12,13,48,42,6,45
Berwick,7057,8,8,11,17,29,58,-29,35
Edinburgh Ci,7057,9,7,9,20,36,63,-27,30
Cowdenbeath,7057,10,4,11,21,24,55,-31,23
Montrose,7058,1,24,7,5,62,36,26,79
Peterhead,7058,2,24,4,8,81,38,43,76
Stenhousem'r,7058,3,16,8,12,56,46,10,56
Stirling,7058,4,16,6,14,60,52,8,54
Clyde,7058,5,15,9,12,53,48,5,54
Elgin,7058,6,14,6,16,55,63,-8,48
Annan Athlet,7058,7,11,12,13,47,41,6,45
Berwick,7058,8,8,10,18,29,60,-31,34
Edinburgh Ci,7058,9,7,9,20,36,64,-28,30
Cowdenbeath,7058,10,4,11,21,23,54,-31,23
Montrose,7059,1,24,7,5,62,34,28,79
Peterhead,7059,2,24,4,8,80,40,40,76
Stirling,7059,3,17,6,13,61,51,10,57
Clyde,7059,4,15,9,12,53,48,5,54
Stenhousem'r,7059,5,15,8,13,55,47,8,53
Elgin,7059,6,14,6,16,53,63,-10,48
Annan Athlet,7059,7,12,11,13,51,44,7,47
Berwick,7059,8,8,10,18,29,60,-31,34
Edinburgh Ci,7059,9,7,9,20,38,63,-25,30
Cowdenbeath,7059,10,4,10,22,26,58,-32,22
Montrose,7060,1,24,7,5,62,34,28,79
Peterhead,7060,2,24,4,8,78,38,40,76
Stirling,7060,3,17,6,13,63,52,11,57
Clyde,7060,4,15,9,12,53,48,5,54
Stenhousem'r,7060,5,15,8,13,56,49,7,53
Elgin,7060,6,14,6,16,53,63,-10,48
Annan Athlet,7060,7,11,11,14,48,43,5,44
Berwick,7060,8,8,10,18,29,60,-31,34
Edinburgh Ci,7060,9,7,9,20,36,61,-25,30
Cowdenbeath,7060,10,5,10,21,25,55,-30,25
Montrose,7061,1,23,8,5,61,36,25,77
Peterhead,7061,2,24,4,8,78,38,40,76
Stirling,7061,3,17,6,13,62,51,11,57
Stenhousem'r,7061,4,15,8,13,55,48,7,53
Clyde,7061,5,14,10,12,52,49,3,52
Elgin,7061,6,14,7,15,55,62,-7,49
Annan Athlet,7061,7,12,11,13,49,41,8,47
Berwick,7061,8,8,11,17,30,59,-29,35
Edinburgh Ci,7061,9,7,9,20,36,61,-25,30
Cowdenbeath,7061,10,4,10,22,23,56,-33,22
Montrose,7062,1,23,8,5,60,35,25,77
Peterhead,7062,2,24,4,8,81,38,43,76
Stirling,7062,3,17,6,13,62,51,11,57
Stenhousem'r,7062,4,15,8,13,55,48,7,53
Clyde,7062,5,14,9,13,53,51,2,51
Elgin,7062,6,14,7,15,54,61,-7,49
Annan Athlet,7062,7,12,11,13,50,43,7,47
Berwick,7062,8,9,10,17,32,60,-28,37
Edinburgh Ci,7062,9,7,9,20,36,64,-28,30
Cowdenbeath,7062,10,4,10,22,25,57,-32,22
Montrose,7063,1,24,7,5,60,34,26,79
Peterhead,7063,2,24,4,8,78,38,40,76
Stirling,7063,3,17,6,13,63,51,12,57
Stenhousem'r,7063,4,15,8,13,55,49,6,53
Clyde,7063,5,14,9,13,51,49,2,51
Elgin,7063,6,14,6,16,53,61,-8,48
Annan Athlet,7063,7,11,11,14,48,43,5,44
Berwick,7063,8,9,10,17,30,58,-28,37
Edinburgh Ci,7063,9,7,9,20,36,61,-25,30
Cowdenbeath,7063,10,5,10,21,25,55,-30,25
Montrose,7064,1,24,7,5,63,34,29,79
Peterhead,7064,2,24,4,8,79,38,41,76
Stirling,7064,3,17,6,13,61,51,10,57
Stenhousem'r,7064,4,15,8,13,55,47,8,53
Clyde,7064,5,14,9,13,52,50,2,51
Elgin,7064,6,14,6,16,53,64,-11,48
Annan Athlet,7064,7,12,11,13,53,41,12,47
Berwick,7064,8,9,10,17,31,59,-28,37
Edinburgh Ci,7064,9,7,9,20,36,62,-26,30
Cowdenbeath,7064,10,4,10,22,23,60,-37,22
Montrose,7065,1,24,7,5,61,34,27,79
Peterhead,7065,2,24,4,8,79,38,41,76
Stenhousem'r,7065,3,16,8,12,58,48,10,56
Stirling,7065,4,16,6,14,62,54,8,54
Clyde,7065,5,15,9,12,53,48,5,54
Elgin,7065,6,14,6,16,53,62,-9,48
Annan Athlet,7065,7,11,11,14,48,43,5,44
Berwick,7065,8,8,10,18,29,60,-31,34
Edinburgh Ci,7065,9,7,9,20,36,62,-26,30
Cowdenbeath,7065,10,5,10,21,25,55,-30,25
Montrose,7066,1,24,7,5,62,36,26,79
Peterhead,7066,2,24,4,8,79,38,41,76
Stenhousem'r,7066,3,16,8,12,57,47,10,56
Stirling,7066,4,16,6,14,61,53,8,54
Clyde,7066,5,14,10,12,52,49,3,52
Elgin,7066,6,14,6,16,55,63,-8,48
Annan Athlet,7066,7,11,11,14,47,43,4,44
Berwick,7066,8,8,11,17,30,59,-29,35
Edinburgh Ci,7066,9,7,9,20,36,62,-26,30
Cowdenbeath,7066,10,5,10,21,25,54,-29,25
Montrose,7067,1,23,8,5,61,36,25,77
Peterhead,7067,2,24,4,8,83,38,45,76
Stirling,7067,3,17,6,13,63,51,12,57
Clyde,7067,4,15,9,12,54,49,5,54
Stenhousem'r,7067,5,15,8,13,55,49,6,53
Elgin,7067,6,14,7,15,55,62,-7,49
Annan Athlet,7067,7,11,11,14,49,44,5,44
Berwick,7067,8,8,10,18,30,61,-31,34
Edinburgh Ci,7067,9,7,9,20,36,66,-30,30
Cowdenbeath,7067,10,5,10,21,26,56,-30,25
Montrose,7068,1,24,7,5,61,34,27,79
Peterhead,7068,2,23,5,8,79,40,39,74
Stirling,7068,3,16,7,13,60,51,9,55
Stenhousem'r,7068,4,15,9,12,55,46,9,54
Clyde,7068,5,15,9,12,54,48,6,54
Elgin,7068,6,14,6,16,53,62,-9,48
Annan Athlet,7068,7,11,11,14,49,44,5,44
Berwick,7068,8,8,10,18,29,61,-32,34
Edinburgh Ci,7068,9,7,10,19,38,62,-24,31
Cowdenbeath,7068,10,5,10,21,26,56,-30,25
Montrose,7069,1,23,8,5,60,35,25,77
Peterhead,7069,2,24,4,8,79,39,40,76
Stenhousem'r,7069,3,16,8,12,56,46,10,56
Stirling,7069,4,16,6,14,60,52,8,54
Clyde,7069,5,14,10,12,52,49,3,52
Elgin,7069,6,14,7,15,54,61,-7,49
Annan Athlet,7069,7,11,12,13,47,41,6,45
Berwick,7069,8,8,11,17,30,59,-29,35
Edinburgh Ci,7069,9,7,9,20,37,62,-25,30
Cowdenbeath,7069,10,4,11,21,23,54,-31,23
Montrose,7070,1,24,7,5,61,34,27,79
Peterhead,7070,2,23,5,8,78,39,39,74
Stenhousem'r,7070,3,16,8,12,56,46,10,56
Stirling,7070,4,16,6,14,60,52,8,54
Clyde,7070,5,15,9,12,52,48,4,54
Elgin,7070,6,14,6,16,53,62,-9,48
Annan Athlet,7070,7,11,12,13,47,41,6,45
Berwick,7070,8,8,10,18,29,59,-30,34
Edinburgh Ci,7070,9,7,10,19,37,61,-24,31
Cowdenbeath,7070,10,4,11,21,23,54,-31,23
Montrose,7071,1,24,7,5,61,35,26,79
Peterhead,7071,2,23,4,9,77,40,37,73
Stenhousem'r,7071,3,16,8,12,56,46,10,56
Stirling,7071,4,16,6,14,60,52,8,54
Clyde,7071,5,14,10,12,52,49,3,52
Elgin,7071,6,14,6,16,54,62,-8,48
Annan Athlet,7071,7,12,11,13,49,42,7,47
Berwick,7071,8,8,11,17,30,59,-29,35
Edinburgh Ci,7071,9,8,9,19,38,60,-22,33
Cowdenbeath,7071,10,4,10,22,24,56,-32,22
Peterhead,7072,1,24,4,8,81,41,40,76
Montrose,7072,2,23,7,6,59,35,24,76
Stirling,7072,3,17,6,13,61,51,10,57
Stenhousem'r,7072,4,15,8,13,55,47,8,53
Clyde,7072,5,14,10,12,52,49,3,52
Elgin,7072,6,15,6,15,54,60,-6,51
Annan Athlet,7072,7,12,11,13,49,42,7,47
Berwick,7072,8,8,11,17,30,59,-29,35
Edinburgh Ci,7072,9,7,9,20,39,64,-25,30
Cowdenbeath,7072,10,4,10,22,24,56,-32,22
Montrose,7073,1,24,7,5,61,35,26,79
Peterhead,7073,2,24,4,8,81,39,42,76
Stirling,7073,3,17,6,13,61,51,10,57
Clyde,7073,4,15,9,12,55,49,6,54
Stenhousem'r,7073,5,15,8,13,55,47,8,53
Elgin,7073,6,14,6,16,54,62,-8,48
Annan Athlet,7073,7,11,11,14,47,44,3,44
Berwick,7073,8,8,10,18,30,62,-32,34
Edinburgh Ci,7073,9,7,9,20,37,64,-27,30
Cowdenbeath,7073,10,5,10,21,26,54,-28,25
Montrose,7074,1,23,8,5,62,37,25,77
Peterhead,7074,2,24,4,8,82,38,44,76
Stenhousem'r,7074,3,16,8,12,57,47,10,56
Clyde,7074,4,15,9,12,57,48,9,54
Stirling,7074,5,16,6,14,61,53,8,54
Elgin,7074,6,14,7,15,56,63,-7,49
Annan Athlet,7074,7,12,11,13,49,41,8,47
Berwick,7074,8,8,10,18,29,64,-35,34
Edinburgh Ci,7074,9,7,9,20,36,65,-29,30
Cowdenbeath,7074,10,4,10,22,23,56,-33,22
Montrose,7075,1,24,7,5,61,35,26,79
Peterhead,7075,2,24,4,8,83,38,45,76
Stirling,7075,3,16,7,13,61,52,9,55
Stenhousem'r,7075,4,15,9,12,56,47,9,54
Clyde,7075,5,15,9,12,53,49,4,54
Elgin,7075,6,14,6,16,54,62,-8,48
Annan Athlet,7075,7,11,12,13,48,42,6,45
Berwick,7075,8,8,10,18,30,60,-30,34
Edinburgh Ci,7075,9,7,9,20,36,66,-30,30
Cowdenbeath,7075,10,4,11,21,24,55,-31,23
Montrose,7076,1,24,7,5,61,35,26,79
Peterhead,7076,2,24,4,8,79,39,40,76
Stirling,7076,3,16,7,13,60,51,9,55
Stenhousem'r,7076,4,15,9,12,55,46,9,54
Clyde,7076,5,14,10,12,52,49,3,52
Elgin,7076,6,14,6,16,54,62,-8,48
Annan Athlet,7076,7,11,11,14,47,42,5,44
Berwick,7076,8,8,11,17,30,59,-29,35
Edinburgh Ci,7076,9,7,9,20,37,62,-25,30
Cowdenbeath,7076,10,5,10,21,24,54,-30,25
Montrose,7077,1,24,7,5,62,34,28,79
Peterhead,7077,2,24,4,8,79,38,41,76
Stirling,7077,3,16,7,13,60,51,9,55
Stenhousem'r,7077,4,15,9,12,55,46,9,54
Clyde,7077,5,15,9,12,54,49,5,54
Elgin,7077,6,14,6,16,53,63,-10,48
Annan Athlet,7077,7,11,11,14,47,43,4,44
Berwick,7077,8,8,10,18,30,61,-31,34
Edinburgh Ci,7077,9,7,9,20,36,62,-26,30
Cowdenbeath,7077,10,5,10,21,25,54,-29,25
Montrose,7078,1,24,7,5,62,35,27,79
Peterhead,7078,2,24,4,8,79,39,40,76
Stirling,7078,3,17,6,13,62,51,11,57
Clyde,7078,4,15,9,12,54,48,6,54
Stenhousem'r,7078,5,15,8,13,55,48,7,53
Elgin,7078,6,14,6,16,54,63,-9,48
Annan Athlet,7078,7,12,11,13,49,42,7,47
Berwick,7078,8,8,10,18,29,61,-32,34
Edinburgh Ci,7078,9,7,9,20,37,62,-25,30
Cowdenbeath,7078,10,4,10,22,24,56,-32,22
Peterhead,7079,1,24,4,8,79,39,40,76
Montrose,7079,2,23,7,6,60,37,23,76
Stirling,7079,3,16,7,13,61,52,9,55
Stenhousem'r,7079,4,15,9,12,56,47,9,54
Clyde,7079,5,14,9,13,51,49,2,51
Elgin,7079,6,15,6,15,56,61,-5,51
Annan Athlet,7079,7,12,11,13,48,41,7,47
Berwick,7079,8,9,10,17,30,58,-28,37
Edinburgh Ci,7079,9,7,9,20,37,62,-25,30
Cowdenbeath,7079,10,4,10,22,23,55,-32,22
Peterhead,7080,1,24,4,8,80,39,41,76
Montrose,7080,2,23,7,6,59,35,24,76
Stirling,7080,3,17,6,13,61,51,10,57
Clyde,7080,4,15,9,12,52,48,4,54
Stenhousem'r,7080,5,15,8,13,55,47,8,53
Elgin,7080,6,15,6,15,54,60,-6,51
Annan Athlet,7080,7,11,12,13,47,41,6,45
Berwick,7080,8,8,10,18,29,59,-30,34
Edinburgh Ci,7080,9,7,9,20,37,63,-26,30
Cowdenbeath,7080,10,4,11,21,23,54,-31,23
Montrose,7081,1,24,7,5,62,35,27,79
Peterhead,7081,2,24,4,8,81,39,42,76
Stirling,7081,3,16,7,13,63,54,9,55
Stenhousem'r,7081,4,15,9,12,58,49,9,54
Clyde,7081,5,14,9,13,52,50,2,51
Elgin,7081,6,14,6,16,54,63,-9,48
Annan Athlet,7081,7,11,12,13,49,43,6,45
Berwick,7081,8,9,10,17,31,59,-28,37
Edinburgh Ci,7081,9,7,9,20,37,64,-27,30
Cowdenbeath,7081,10,4,11,21,25,56,-31,23
Peterhead,7082,1,24,4,8,79,39,40,76
Montrose,7082,2,23,7,6,61,37,24,76
Stirling,7082,3,16,7,13,62,53,9,55
Stenhousem'r,7082,4,15,9,12,57,48,9,54
Clyde,7082,5,15,9,12,56,48,8,54
Elgin,7082,6,15,6,15,56,62,-6,51
Annan Athlet,7082,7,12,11,13,49,42,7,47
Berwick,7082,8,8,10,18,29,63,-34,34
Edinburgh Ci,7082,9,7,9,20,37,62,-25,30
Cowdenbeath,7082,10,4,10,22,24,56,-32,22
Montrose,7083,1,24,7,5,62,35,27,79
Peterhead,7083,2,24,4,8,79,38,41,76
Stirling,7083,3,17,6,13,62,51,11,57
Clyde,7083,4,15,9,12,54,49,5,54
Stenhousem'r,7083,5,15,8,13,55,48,7,53
Elgin,7083,6,14,6,16,54,63,-9,48
Annan Athlet,7083,7,11,12,13,47,41,6,45
Berwick,7083,8,8,10,18,30,61,-31,34
Edinburgh Ci,7083,9,7,9,20,36,62,-26,30
Cowdenbeath,7083,10,4,11,21,23,54,-31,23
Montrose,7084,1,24,7,5,62,35,27,79
Peterhead,7084,2,24,4,8,80,39,41,76
Stirling,7084,3,17,6,13,63,51,12,57
Stenhousem'r,7084,4,15,8,13,55,49,6,53
Clyde,7084,5,14,10,12,51,48,3,52
Elgin,7084,6,14,6,16,54,63,-9,48
Annan Athlet,7084,7,11,11,14,48,44,4,44
Berwick,7084,8,8,11,17,29,58,-29,35
Edinburgh Ci,7084,9,7,9,20,37,63,-26,30
Cowdenbeath,7084,10,5,10,21,26,55,-29,25
Montrose,7085,1,24,7,5,60,34,26,79
Peterhead,7085,2,24,4,8,81,39,42,76
Stirling,7085,3,17,6,13,63,52,11,57
Stenhousem'r,7085,4,15,8,13,56,49,7,53
Clyde,7085,5,14,9,13,51,49,2,51
Elgin,7085,6,14,6,16,53,61,-8,48
Annan Athlet,7085,7,11,11,14,47,42,5,44
Berwick,7085,8,9,10,17,30,58,-28,37
Edinburgh Ci,7085,9,7,9,20,37,64,-27,30
Cowdenbeath,7085,10,5,10,21,24,54,-30,25
Montrose,7086,1,23,8,5,60,35,25,77
Peterhead,7086,2,24,4,8,80,38,42,76
Stirling,7086,3,17,6,13,61,51,10,57
Clyde,7086,4,15,9,12,54,48,6,54
Stenhousem'r,7086,5,15,8,13,55,47,8,53
Elgin,7086,6,14,7,15,54,61,-7,49
Annan Athlet,7086,7,12,11,13,50,41,9,47
Berwick,7086,8,8,10,18,29,61,-32,34
Edinburgh Ci,7086,9,7,9,20,36,63,-27,30
Cowdenbeath,7086,10,4,10,22,23,57,-34,22
Montrose,7087,1,24,7,5,62,34,28,79
Peterhead,7087,2,24,4,8,81,38,43,76
Stirling,7087,3,16,7,13,61,52,9,55
Stenhousem'r,7087,4,15,9,12,56,47,9,54
Clyde,7087,5,14,9,13,51,49,2,51
Elgin,7087,6,14,6,16,53,63,-10,48
Annan Athlet,7087,7,12,11,13,49,42,7,47
Berwick,7087,8,9,10,17,30,58,-28,37
Edinburgh Ci,7087,9,7,9,20,36,64,-28,30
Cowdenbeath,7087,10,4,10,22,24,56,-32,22
Montrose,7088,1,24,7,5,61,35,26,79
Peterhead,7088,2,24,4,8,79,38,41,76
Stirling,7088,3,17,6,13,63,52,11,57
Clyde,7088,4,15,9,12,54,49,5,54
Stenhousem'r,7088,5,15,8,13,56,49,7,53
Elgin,7088,6,14,6,16,54,62,-8,48
Annan Athlet,7088,7,12,11,13,48,41,7,47
Berwick,7088,8,8,10,18,30,61,-31,34
Edinburgh Ci,7088,9,7,9,20,36,62,-26,30
Cowdenbeath,7088,10,4,10,22,23,55,-32,22
Montrose,7089,1,23,7,6,59,36,23,76
Peterhead,7089,2,23,4,9,78,40,38,73
Stirling,7089,3,17,6,13,63,53,10,57
Clyde,7089,4,15,9,12,52,48,4,54
Stenhousem'r,7089,5,15,8,13,57,49,8,53
Elgin,7089,6,15,6,15,55,60,-5,51
Annan Athlet,7089,7,12,11,13,48,41,7,47
Berwick,7089,8,8,10,18,29,59,-30,34
Edinburgh Ci,7089,9,8,9,19,38,61,-23,33
Cowdenbeath,7089,10,4,10,22,23,55,-32,22
Montrose,7090,1,24,7,5,62,34,28,79
Peterhead,7090,2,24,4,8,82,39,43,76
Stirling,7090,3,17,6,13,61,51,10,57
Clyde,7090,4,15,9,12,53,49,4,54
Stenhousem'r,7090,5,15,8,13,55,47,8,53
Elgin,7090,6,14,6,16,53,63,-10,48
Annan Athlet,7090,7,11,12,13,49,43,6,45
Berwick,7090,8,8,10,18,30,60,-30,34
Edinburgh Ci,7090,9,7,9,20,37,65,-28,30
Cowdenbeath,7090,10,4,11,21,25,56,-31,23
Peterhead,7091,1,24,4,8,79,38,41,76
Montrose,7091,2,23,7,6,59,35,24,76
Stenhousem'r,7091,3,16,8,12,57,46,11,56
Stirling,7091,4,16,6,14,60,53,7,54
Clyde,7091,5,14,10,12,52,49,3,52
Elgin,7091,6,15,6,15,54,60,-6,51
Annan Athlet,7091,7,11,11,14,47,43,4,44
Berwick,7091,8,8,11,17,30,59,-29,35
Edinburgh Ci,7091,9,7,9,20,36,62,-26,30
Cowdenbeath,7091,10,5,10,21,25,54,-29,25
Montrose,7092,1,24,7,5,62,35,27,79
Peterhead,7092,2,24,4,8,78,38,40,76
Stirling,7092,3,17,6,13,63,52,11,57
Stenhousem'r,7092,4,15,8,13,56,49,7,53
Clyde,7092,5,14,9,13,52,50,2,51
Elgin,7092,6,14,6,16,54,63,-9,48
Annan Athlet,7092,7,12,11,13,49,42,7,47
Berwick,7092,8,9,10,17,31,59,-28,37
Edinburgh Ci,7092,9,7,9,20,36,61,-25,30
Cowdenbeath,7092,10,4,10,22,24,56,-32,22
Montrose,7093,1,24,7,5,61,34,27,79
Peterhead,7093,2,24,4,8,79,38,41,76
Stirling,7093,3,17,6,13,63,51,12,57
Stenhousem'r,7093,4,15,8,13,55,49,6,53
Clyde,7093,5,14,9,13,52,51,1,51
Elgin,7093,6,14,6,16,53,62,-9,48
Annan Athlet,7093,7,11,11,14,47,43,4,44
Berwick,7093,8,9,10,17,32,59,-27,37
Edinburgh Ci,7093,9,7,9,20,36,62,-26,30
Cowdenbeath,7093,10,5,10,21,25,54,-29,25
Montrose,7094,1,24,7,5,61,34,27,79
Peterhead,7094,2,24,4,8,80,39,41,76
Stirling,7094,3,16,7,13,61,52,9,55
Stenhousem'r,7094,4,15,9,12,56,47,9,54
Clyde,7094,5,15,9,12,54,49,5,54
Elgin,7094,6,14,6,16,53,62,-9,48
Annan Athlet,7094,7,11,11,14,48,43,5,44
Berwick,7094,8,8,10,18,30,61,-31,34
Edinburgh Ci,7094,9,7,9,20,37,63,-26,30
Cowdenbeath,7094,10,5,10,21,25,55,-30,25
Montrose,7095,1,24,7,5,62,36,26,79
Peterhead,7095,2,24,4,8,80,39,41,76
Stirling,7095,3,17,6,13,64,51,13,57
Stenhousem'r,7095,4,15,8,13,55,50,5,53
Clyde,7095,5,14,9,13,52,50,2,51
Elgin,7095,6,14,6,16,55,63,-8,48
Annan Athlet,7095,7,12,11,13,51,41,10,47
Berwick,7095,8,9,10,17,31,59,-28,37
Edinburgh Ci,7095,9,7,9,20,37,63,-26,30
Cowdenbeath,7095,10,4,10,22,23,58,-35,22
Peterhead,7096,1,24,4,8,81,38,43,76
Montrose,7096,2,23,7,6,60,36,24,76
Stirling,7096,3,17,6,13,66,53,13,57
Stenhousem'r,7096,4,15,8,13,57,52,5,53
Clyde,7096,5,14,10,12,51,48,3,52
Elgin,7096,6,15,6,15,55,61,-6,51
Annan Athlet,7096,7,12,11,13,50,42,8,47
Berwick,7096,8,8,11,17,29,58,-29,35
Edinburgh Ci,7096,9,7,9,20,36,64,-28,30
Cowdenbeath,7096,10,4,10,22,24,57,-33,22
Montrose,7097,1,24,7,5,62,35,27,79
Peterhead,7097,2,24,4,8,81,39,42,76
Stirling,7097,3,17,6,13,62,52,10,57
Stenhousem'r,7097,4,15,8,13,56,48,8,53
Clyde,7097,5,14,10,12,53,50,3,52
Elgin,7097,6,14,6,16,54,63,-9,48
Annan Athlet,7097,7,12,11,13,50,42,8,47
Berwick,7097,8,8,11,17,31,60,-29,35
Edinburgh Ci,7097,9,7,9,20,37,64,-27,30
Cowdenbeath,7097,10,4,10,22,24,57,-33,22
Montrose,7098,1,24,7,5,63,34,29,79
Peterhead,7098,2,24,4,8,80,40,40,76
Stirling,7098,3,17,6,13,62,51,11,57
Clyde,7098,4,15,9,12,52,48,4,54
Stenhousem'r,7098,5,15,8,13,55,48,7,53
Elgin,7098,6,14,6,16,53,64,-11,48
Annan Athlet,7098,7,11,12,13,48,42,6,45
Berwick,7098,8,8,10,18,29,59,-30,34
Edinburgh Ci,7098,9,7,9,20,38,63,-25,30
Cowdenbeath,7098,10,4,11,21,24,55,-31,23
Montrose,7099,1,23,8,5,61,36,25,77
Peterhead,7099,2,24,4,8,80,39,41,76
Stenhousem'r,7099,3,16,8,12,56,46,10,56
Stirling,7099,4,16,6,14,60,52,8,54
Clyde,7099,5,15,9,12,55,49,6,54
Elgin,7099,6,14,7,15,55,62,-7,49
Annan Athlet,7099,7,11,11,14,47,42,5,44
Berwick,7099,8,8,10,18,30,62,-32,34
Edinburgh Ci,7099,9,7,9,20,37,63,-26,30
Cowdenbeath,7099,10,5,10,21,24,54,-30,25
Montrose,7100,1,24,7,5,62,35,27,79
Peterhead,7100,2,23,4,9,78,41,37,73
Stenhousem'r,7100,3,16,8,12,59,47,12,56
Stirling,7100,4,16,6,14,61,55,6,54
Clyde,7100,5,14,9,13,52,50,2,51
Elgin,7100,6,14,6,16,54,63,-9,48
Annan Athlet,7100,7,12,11,13,48,41,7,47
Berwick,7100,8,9,10,17,31,59,-28,37
Edinburgh Ci,7100,9,8,9,19,39,61,-22,33
Cowdenbeath,7100,10,4,10,22,23,55,-32,22
Montrose,7101,1,23,8,5,60,35,25,77
Peterhead,7101,2,23,4,9,79,41,38,73
Stirling,7101,3,16,7,13,61,52,9,55
Stenhousem'r,7101,4,15,9,12,56,47,9,54
Clyde,7101,5,14,9,13,52,50,2,51
Elgin,7101,6,14,7,15,54,61,-7,49
Annan Athlet,7101,7,11,11,14,47,42,5,44
Berwick,7101,8,9,10,17,31,59,-28,37
Edinburgh Ci,7101,9,8,9,19,39,62,-23,33
Cowdenbeath,7101,10,5,10,21,24,54,-30,25
Montrose,7102,1,23,8,5,60,35,25,77
Peterhead,7102,2,24,4,8,81,38,43,76
Stirling,7102,3,16,7,13,61,52,9,55
Stenhousem'r,7102,4,15,9,12,56,47,9,54
Clyde,7102,5,15,9,12,53,48,5,54
Elgin,7102,6,14,7,15,54,61,-7,49
Annan Athlet,7102,7,11,12,13,49,43,6,45
Berwick,7102,8,8,10,18,29,60,-31,34
Edinburgh Ci,7102,9,7,9,20,36,64,-28,30
Cowdenbeath,7102,10,4,11,21,25,56,-31,23
Montrose,7103,1,24,7,5,61,35,26,79
Peterhead,7103,2,23,4,9,77,39,38,73
Stenhousem'r,7103,3,16,8,12,57,47,10,56
Stirling,7103,4,16,6,14,61,53,8,54
Clyde,7103,5,15,9,12,54,49,5,54
Elgin,7103,6,14,6,16,54,62,-8,48
Annan Athlet,7103,7,11,12,13,49,43,6,45
Berwick,7103,8,8,10,18,30,61,-31,34
Edinburgh Ci,7103,9,8,9,19,37,60,-23,33
Cowdenbeath,7103,10,4,11,21,25,56,-31,23
Montrose,7104,1,24,7,5,61,34,27,79
Peterhead,7104,2,23,5,8,79,40,39,74
Stirling,7104,3,17,6,13,62,51,11,57
Stenhousem'r,7104,4,15,8,13,55,48,7,53
Clyde,7104,5,14,10,12,52,49,3,52
Elgin,7104,6,14,6,16,53,62,-9,48
Annan Athlet,7104,7,11,12,13,47,41,6,45
Berwick,7104,8,8,11,17,30,59,-29,35
Edinburgh Ci,7104,9,7,10,19,38,62,-24,31
Cowdenbeath,7104,10,4,11,21,23,54,-31,23
Montrose,7105,1,23,8,5,60,35,25,77
Peterhead,7105,2,24,4,8,80,38,42,76
Stirling,7105,3,17,6,13,61,51,10,57
Clyde,7105,4,15,9,12,53,48,5,54
Stenhousem'r,7105,5,15,8,13,55,47,8,53
Elgin,7105,6,14,7,15,54,61,-7,49
Annan Athlet,7105,7,11,11,14,47,43,4,44
Berwick,7105,8,8,10,18,29,60,-31,34
Edinburgh Ci,7105,9,7,9,20,36,63,-27,30
Cowdenbeath,7105,10,5,10,21,25,54,-29,25
Peterhead,7106,1,24,4,8,79,39,40,76
Montrose,7106,2,23,7,6,61,38,23,76
Stenhousem'r,7106,3,16,8,12,57,47,10,56
Stirling,7106,4,16,6,14,61,53,8,54
Clyde,7106,5,15,9,12,52,48,4,54
Elgin,7106,6,15,6,15,57,62,-5,51
Annan Athlet,7106,7,11,11,14,48,43,5,44
Berwick,7106,8,8,10,18,29,59,-30,34
Edinburgh Ci,7106,9,7,9,20,37,62,-25,30
Cowdenbeath,7106,10,5,10,21,25,55,-30,25
Montrose,7107,1,24,7,5,61,34,27,79
Peterhead,7107,2,24,4,8,79,38,41,76
Stirling,7107,3,17,6,13,62,51,11,57
Stenhousem'r,7107,4,15,8,13,55,48,7,53
Clyde,7107,5,14,9,13,51,49,2,51
Elgin,7107,6,14,6,16,53,62,-9,48
Annan Athlet,7107,7,11,11,14,48,43,5,44
Berwick,7107,8,9,10,17,30,58,-28,37
Edinburgh Ci,7107,9,7,9,20,36,62,-26,30
Cowdenbeath,7107,10,5,10,21,25,55,-30,25
Peterhead,7108,1,24,4,8,78,38,40,76
Montrose,7108,2,23,7,6,59,35,24,76
Stirling,7108,3,17,6,13,63,52,11,57
Clyde,7108,4,15,9,12,53,48,5,54
Stenhousem'r,7108,5,15,8,13,56,49,7,53
Elgin,7108,6,15,6,15,54,60,-6,51
Annan Athlet,7108,7,12,11,13,50,41,9,47
Berwick,7108,8,8,10,18,29,60,-31,34
Edinburgh Ci,7108,9,7,9,20,36,61,-25,30
Cowdenbeath,7108,10,4,10,22,23,57,-34,22
Montrose,7109,1,24,7,5,64,34,30,79
Peterhead,7109,2,24,4,8,79,39,40,76
Stirling,7109,3,17,6,13,61,51,10,57
Clyde,7109,4,15,9,12,53,48,5,54
Stenhousem'r,7109,5,15,8,13,55,47,8,53
Elgin,7109,6,14,6,16,53,65,-12,48
Annan Athlet,7109,7,12,11,13,49,41,8,47
Berwick,7109,8,8,10,18,29,60,-31,34
Edinburgh Ci,7109,9,7,9,20,37,62,-25,30
Cowdenbeath,7109,10,4,10,22,23,56,-33,22
Montrose,7110,1,24,7,5,61,35,26,79
Peterhead,7110,2,24,4,8,80,39,41,76
Stirling,7110,3,16,7,13,61,52,9,55
Stenhousem'r,7110,4,15,9,12,56,47,9,54
Clyde,7110,5,14,9,13,52,51,1,51
Elgin,7110,6,14,6,16,54,62,-8,48
Annan Athlet,7110,7,11,12,13,47,41,6,45
Berwick,7110,8,9,10,17,32,59,-27,37
Edinburgh Ci,7110,9,7,9,20,37,63,-26,30
Cowdenbeath,7110,10,4,11,21,23,54,-31,23
Montrose,7111,1,24,7,5,66,35,31,79
Peterhead,7111,2,23,5,8,78,39,39,74
Stenhousem'r,7111,3,16,8,12,58,46,12,56
Stirling,7111,4,16,6,14,60,54,6,54
Clyde,7111,5,15,9,12,54,50,4,54
Elgin,7111,6,14,6,16,54,67,-13,48
Annan Athlet,7111,7,12,11,13,49,41,8,47
Berwick,7111,8,8,10,18,31,61,-30,34
Edinburgh Ci,7111,9,7,10,19,37,61,-24,31
Cowdenbeath,7111,10,4,10,22,23,56,-33,22
Montrose,7112,1,23,7,6,59,36,23,76
Peterhead,7112,2,23,5,8,78,39,39,74
Stirling,7112,3,17,6,13,61,51,10,57
Stenhousem'r,7112,4,15,8,13,55,47,8,53
Clyde,7112,5,14,10,12,52,49,3,52
Elgin,7112,6,15,6,15,55,60,-5,51
Annan Athlet,7112,7,11,11,14,49,44,5,44
Berwick,7112,8,8,11,17,30,59,-29,35
Edinburgh Ci,7112,9,7,10,19,37,61,-24,31
Cowdenbeath,7112,10,5,10,21,26,56,-30,25
Montrose,7113,1,24,7,5,62,35,27,79
Peterhead,7113,2,24,4,8,78,38,40,76
Stirling,7113,3,17,6,13,63,53,10,57
Stenhousem'r,7113,4,15,8,13,57,49,8,53
Clyde,7113,5,14,9,13,53,51,2,51
Elgin,7113,6,14,6,16,54,63,-9,48
Annan Athlet,7113,7,11,11,14,47,42,5,44
Berwick,7113,8,9,10,17,32,60,-28,37
Edinburgh Ci,7113,9,7,9,20,36,61,-25,30
Cowdenbeath,7113,10,5,10,21,24,54,-30,25
Montrose,7114,1,24,7,5,61,34,27,79
Peterhead,7114,2,24,4,8,81,39,42,76
Stirling,7114,3,17,6,13,63,51,12,57
Stenhousem'r,7114,4,15,8,13,55,49,6,53
Clyde,7114,5,14,10,12,51,48,3,52
Elgin,7114,6,14,6,16,53,62,-9,48
Annan Athlet,7114,7,12,11,13,48,41,7,47
Berwick,7114,8,8,11,17,29,58,-29,35
Edinburgh Ci,7114,9,7,9,20,37,64,-27,30
Cowdenbeath,7114,10,4,10,22,23,55,-32,22
Peterhead,7115,1,24,4,8,80,39,41,76
Montrose,7115,2,23,7,6,59,36,23,76
Stirling,7115,3,17,6,13,61,51,10,57
Clyde,7115,4,15,9,12,53,49,4,54
Stenhousem'r,7115,5,15,8,13,55,47,8,53
Elgin,7115,6,15,6,15,55,60,-5,51
Annan Athlet,7115,7,11,11,14,47,42,5,44
Berwick,7115,8,8,10,18,30,60,-30,34
Edinburgh Ci,7115,9,7,9,20,37,63,-26,30
Cowdenbeath,7115,10,5,10,21,24,54,-30,25
Montrose,7116,1,24,7,5,61,35,26,79
Peterhead,7116,2,23,5,8,78,39,39,74
Stirling,7116,3,17,6,13,61,51,10,57
Stenhousem'r,7116,4,15,8,13,55,47,8,53
Clyde,7116,5,14,10,12,52,49,3,52
Elgin,7116,6,14,6,16,54,62,-8,48
Annan Athlet,7116,7,11,12,13,48,42,6,45
Berwick,7116,8,8,11,17,30,59,-29,35
Edinburgh Ci,7116,9,7,10,19,37,61,-24,31
Cowdenbeath,7116,10,4,11,21,24,55,-31,23
Montrose,7117,1,23,8,5,59,34,25,77
Peterhead,7117,2,24,4,8,79,39,40,76
Stirling,7117,3,17,6,13,61,51,10,57
Stenhousem'r,7117,4,15,8,13,55,47,8,53
Clyde,7117,5,14,10,12,51,48,3,52
Elgin,7117,6,14,7,15,53,60,-7,49
Annan Athlet,7117,7,11,11,14,47,42,5,44
Berwick,7117,8,8,11,17,29,58,-29,35
Edinburgh Ci,7117,9,7,9,20,37,62,-25,30
Cowdenbeath,7117,10,5,10,21,24,54,-30,25
Montrose,7118,1,24,7,5,62,36,26,79
Peterhead,7118,2,24,4,8,78,38,40,76
Stirling,7118,3,17,6,13,63,51,12,57
Stenhousem'r,7118,4,15,8,13,55,49,6,53
Clyde,7118,5,14,9,13,51,50,1,51
Elgin,7118,6,14,6,16,55,63,-8,48
Annan Athlet,7118,7,11,11,14,48,44,4,44
Berwick,7118,8,9,10,17,31,58,-27,37
Edinburgh Ci,7118,9,7,9,20,36,61,-25,30
Cowdenbeath,7118,10,5,10,21,26,55,-29,25
Montrose,7119,1,24,7,5,61,34,27,79
Peterhead,7119,2,24,4,8,79,39,40,76
Stenhousem'r,7119,3,16,8,12,58,48,10,56
Stirling,7119,4,16,6,14,62,54,8,54
Clyde,7119,5,15,9,12,55,50,5,54
Elgin,7119,6,14,6,16,53,62,-9,48
Annan Athlet,7119,7,11,11,14,47,42,5,44
Berwick,7119,8,8,10,18,31,62,-31,34
Edinburgh Ci,7119,9,7,9,20,37,62,-25,30
Cowdenbeath,7119,10,5,10,21,24,54,-30,25
Montrose,7120,1,23,7,6,61,37,24,76
Peterhead,7120,2,23,5,8,77,38,39,74
Stirling,7120,3,17,6,13,62,52,10,57
Clyde,7120,4,15,9,12,52,48,4,54
Stenhousem'r,7120,5,15,8,13,56,48,8,53
Elgin,7120,6,15,6,15,56,62,-6,51
Annan Athlet,7120,7,11,11,14,47,42,5,44
Berwick,7120,8,8,10,18,29,59,-30,34
Edinburgh Ci,7120,9,7,10,19,36,60,-24,31
Cowdenbeath,7120,10,5,10,21,24,54,-30,25
Montrose,7121,1,24,7,5,61,34,27,79
Peterhead,7121,2,24,4,8,81,39,42,76
Stirling,7121,3,17,6,13,61,51,10,57
Stenhousem'r,7121,4,15,8,13,55,47,8,53
Clyde,7121,5,14,9,13,51,49,2,51
Elgin,7121,6,14,6,16,53,62,-9,48
Annan Athlet,7121,7,12,11,13,49,41,8,47
Berwick,7121,8,9,10,17,30,58,-28,37
Edinburgh Ci,7121,9,7,9,20,37,64,-27,30
Cowdenbeath,7121,10,4,10,22,23,56,-33,22
Montrose,7122,1,24,7,5,62,36,26,79
Peterhead,7122,2,23,5,8,79,40,39,74
Stirling,7122,3,16,7,13,61,52,9,55
Stenhousem'r,7122,4,15,9,12,56,47,9,54
Clyde,7122,5,15,9,12,53,49,4,54
Elgin,7122,6,14,6,16,55,63,-8,48
Annan Athlet,7122,7,11,12,13,47,41,6,45
Berwick,7122,8,8,10,18,30,60,-30,34
Edinburgh Ci,7122,9,7,10,19,38,62,-24,31
Cowdenbeath,7122,10,4,11,21,23,54,-31,23
Montrose,7123,1,24,7,5,63,34,29,79
Peterhead,7123,2,24,4,8,82,39,43,76
Stirling,7123,3,17,6,13,62,51,11,57
Clyde,7123,4,15,9,12,53,48,5,54
Stenhousem'r,7123,5,15,8,13,55,48,7,53
Elgin,7123,6,14,6,16,53,64,-11,48
Annan Athlet,7123,7,11,12,13,47,41,6,45
Berwick,7123,8,8,10,18,29,60,-31,34
Edinburgh Ci,7123,9,7,9,20,37,65,-28,30
Cowdenbeath,7123,10,4,11,21,23,54,-31,23
Montrose,7124,1,24,7,5,60,34,26,79
Peterhead,7124,2,24,4,8,79,39,40,76
Stirling,7124,3,17,6,13,62,51,11,57
Stenhousem'r,7124,4,15,8,13,55,48,7,53
Clyde,7124,5,14,9,13,52,50,2,51
Elgin,7124,6,14,6,16,53,61,-8,48
Annan Athlet,7124,7,12,11,13,50,41,9,47
Berwick,7124,8,9,10,17,31,59,-28,37
Edinburgh Ci,7124,9,7,9,20,37,62,-25,30
Cowdenbeath,7124,10,4,10,22,23,57,-34,22
Montrose,7125,1,24,7,5,60,34,26,79
Peterhead,7125,2,24,4,8,84,39,45,76
Stenhousem'r,7125,3,16,8,12,57,46,11,56
Stirling,7125,4,16,6,14,60,53,7,54
Clyde,7125,5,14,9,13,51,49,2,51
Elgin,7125,6,14,6,16,53,61,-8,48
Annan Athlet,7125,7,11,12,13,48,42,6,45
Berwick,7125,8,9,10,17,30,58,-28,37
Edinburgh Ci,7125,9,7,9,20,37,67,-30,30
Cowdenbeath,7125,10,4,11,21,24,55,-31,23
Montrose,7126,1,23,8,5,59,34,25,77
Peterhead,7126,2,23,5,8,78,39,39,74
Stirling,7126,3,16,7,13,60,51,9,55
Stenhousem'r,7126,4,15,9,12,55,46,9,54
Clyde,7126,5,15,9,12,54,48,6,54
Elgin,7126,6,14,7,15,53,60,-7,49
Annan Athlet,7126,7,12,11,13,50,42,8,47
Berwick,7126,8,8,10,18,29,61,-32,34
Edinburgh Ci,7126,9,7,10,19,37,61,-24,31
Cowdenbeath,7126,10,4,10,22,24,57,-33,22
Montrose,7127,1,24,7,5,62,35,27,79
Peterhead,7127,2,23,5,8,79,40,39,74
Stirling,7127,3,17,6,13,63,51,12,57
Stenhousem'r,7127,4,15,8,13,55,49,6,53
Clyde,7127,5,14,9,13,52,50,2,51
Elgin,7127,6,14,6,16,54,63,-9,48
Annan Athlet,7127,7,12,11,13,51,42,9,47
Berwick,7127,8,9,10,17,31,59,-28,37
Edinburgh Ci,7127,9,7,10,19,38,62,-24,31
Cowdenbeath,7127,10,4,10,22,24,58,-34,22
Montrose,7128,1,24,7,5,62,34,28,79
Peterhead,7128,2,24,4,8,78,38,40,76
Stirling,7128,3,16,7,13,61,52,9,55
Stenhousem'r,7128,4,15,9,12,56,47,9,54
Clyde,7128,5,15,9,12,53,49,4,54
Elgin,7128,6,14,6,16,53,63,-10,48
Annan Athlet,7128,7,11,11,14,48,44,4,44
Berwick,7128,8,8,10,18,30,60,-30,34
Edinburgh Ci,7128,9,7,9,20,36,61,-25,30
Cowdenbeath,7128,10,5,10,21,26,55,-29,25
Montrose,7129,1,24,7,5,60,34,26,79
Peterhead,7129,2,23,5,8,77,38,39,74
Stirling,7129,3,17,6,13,62,52,10,57
Clyde,7129,4,15,9,12,53,49,4,54
Stenhousem'r,7129,5,15,8,13,56,48,8,53
Elgin,7129,6,14,6,16,53,61,-8,48
Annan Athlet,7129,7,12,11,13,50,42,8,47
Berwick,7129,8,8,10,18,30,60,-30,34
Edinburgh Ci,7129,9,7,10,19,36,60,-24,31
Cowdenbeath,7129,10,4,10,22,24,57,-33,22
Montrose,7130,1,24,7,5,61,35,26,79
Peterhead,7130,2,24,4,8,82,38,44,76
Stirling,7130,3,16,7,13,60,51,9,55
Stenhousem'r,7130,4,15,9,12,55,46,9,54
Clyde,7130,5,14,10,12,53,50,3,52
Elgin,7130,6,14,6,16,54,62,-8,48
Annan Athlet,7130,7,11,12,13,48,42,6,45
Berwick,7130,8,8,11,17,31,60,-29,35
Edinburgh Ci,7130,9,7,9,20,36,65,-29,30
Cowdenbeath,7130,10,4,11,21,24,55,-31,23
Montrose,7131,1,23,8,5,60,35,25,77
Peterhead,7131,2,24,4,8,80,39,41,76
Stirling,7131,3,17,6,13,62,52,10,57
Clyde,7131,4,15,9,12,55,49,6,54
Stenhousem'r,7131,5,15,8,13,56,48,8,53
Elgin,7131,6,14,7,15,54,61,-7,49
Annan Athlet,7131,7,11,11,14,47,42,5,44
Berwick,7131,8,8,10,18,30,62,-32,34
Edinburgh Ci,7131,9,7,9,20,37,63,-26,30
Cowdenbeath,7131,10,5,10,21,24,54,-30,25
Montrose,7132,1,24,7,5,60,34,26,79
Peterhead,7132,2,24,4,8,78,38,40,76
Stirling,7132,3,16,7,13,61,52,9,55
Stenhousem'r,7132,4,15,9,12,56,47,9,54
Clyde,7132,5,15,9,12,54,49,5,54
Elgin,7132,6,14,6,16,53,61,-8,48
Annan Athlet,7132,7,12,11,13,49,42,7,47
Berwick,7132,8,8,10,18,30,61,-31,34
Edinburgh Ci,7132,9,7,9,20,36,61,-25,30
Cowdenbeath,7132,10,4,10,22,24,56,-32,22
Montrose,7133,1,23,8,5,61,36,25,77
Peterhead,7133,2,23,5,8,78,39,39,74
Stenhousem'r,7133,3,16,8,12,56,46,10,56
Stirling,7133,4,16,6,14,60,52,8,54
Clyde,7133,5,14,10,12,51,48,3,52
Elgin,7133,6,14,7,15,55,62,-7,49
Annan Athlet,7133,7,12,11,13,48,41,7,47
Berwick,7133,8,8,11,17,29,58,-29,35
Edinburgh Ci,7133,9,7,10,19,37,61,-24,31
Cowdenbeath,7133,10,4,10,22,23,55,-32,22
Montrose,7134,1,23,8,5,60,35,25,77
Peterhead,7134,2,24,4,8,80,39,41,76
Stirling,7134,3,17,6,13,64,54,10,57
Stenhousem'r,7134,4,15,8,13,58,50,8,53
Clyde,7134,5,14,9,13,51,49,2,51
Elgin,7134,6,14,7,15,54,61,-7,49
Annan Athlet,7134,7,11,12,13,48,42,6,45
Berwick,7134,8,9,10,17,30,58,-28,37
Edinburgh Ci,7134,9,7,9,20,37,63,-26,30
Cowdenbeath,7134,10,4,11,21,24,55,-31,23
Montrose,7135,1,24,7,5,62,35,27,79
Peterhead,7135,2,24,4,8,80,38,42,76
Stenhousem'r,7135,3,16,8,12,57,46,11,56
Stirling,7135,4,16,6,14,60,53,7,54
Clyde,7135,5,15,9,12,54,48,6,54
Elgin,7135,6,14,6,16,54,63,-9,48
Annan Athlet,7135,7,11,12,13,50,44,6,45
Berwick,7135,8,8,10,18,29,61,-32,34
Edinburgh Ci,7135,9,7,9,20,36,63,-27,30
Cowdenbeath,7135,10,4,11,21,26,57,-31,23
Montrose,7136,1,24,7,5,63,35,28,79
Peterhead,7136,2,24,4,8,78,38,40,76
Stirling,7136,3,17,6,13,61,51,10,57
Stenhousem'r,7136,4,15,8,13,55,47,8,53
Clyde,7136,5,14,9,13,51,49,2,51
Elgin,7136,6,14,6,16,54,64,-10,48
Annan Athlet,7136,7,12,11,13,48,41,7,47
Berwick,7136,8,9,10,17,30,58,-28,37
Edinburgh Ci,7136,9,7,9,20,36,61,-25,30
Cowdenbeath,7136,10,4,10,22,23,55,-32,22
Peterhead,7137,1,24,4,8,81,38,43,76
Montrose,7137,2,23,7,6,60,36,24,76
Stirling,7137,3,17,6,13,62,51,11,57
Stenhousem'r,7137,4,15,8,13,55,48,7,53
Clyde,7137,5,14,9,13,51,50,1,51
Elgin,7137,6,15,6,15,55,61,-6,51
Annan Athlet,7137,7,11,11,14,47,42,5,44
Berwick,7137,8,9,10,17,31,58,-27,37
Edinburgh Ci,7137,9,7,9,20,36,64,-28,30
Cowdenbeath,7137,10,5,10,21,24,54,-30,25
Montrose,7138,1,24,7,5,60,34,26,79
Peterhead,7138,2,24,4,8,78,38,40,76
Stirling,7138,3,16,7,13,63,54,9,55
Stenhousem'r,7138,4,15,9,12,58,49,9,54
Clyde,7138,5,14,10,12,52,49,3,52
Elgin,7138,6,14,6,16,53,61,-8,48
Annan Athlet,7138,7,11,12,13,47,41,6,45
Berwick,7138,8,8,11,17,30,59,-29,35
Edinburgh Ci,7138,9,7,9,20,36,61,-25,30
Cowdenbeath,7138,10,4,11,21,23,54,-31,23
Montrose,7139,1,24,7,5,60,34,26,79
Peterhead,7139,2,24,4,8,83,39,44,76
Stenhousem'r,7139,3,16,8,12,59,47,12,56
Stirling,7139,4,16,6,14,61,55,6,54
Clyde,7139,5,15,9,12,52,48,4,54
Elgin,7139,6,14,6,16,53,61,-8,48
Annan Athlet,7139,7,11,11,14,47,42,5,44
Berwick,7139,8,8,10,18,29,59,-30,34
Edinburgh Ci,7139,9,7,9,20,37,66,-29,30
Cowdenbeath,7139,10,5,10,21,24,54,-30,25
Montrose,7140,1,24,7,5,61,35,26,79
Peterhead,7140,2,24,4,8,82,38,44,76
Stenhousem'r,7140,3,16,8,12,57,47,10,56
Stirling,7140,4,16,6,14,61,53,8,54
Clyde,7140,5,14,10,12,51,48,3,52
Elgin,7140,6,14,6,16,54,62,-8,48
Annan Athlet,7140,7,12,11,13,48,41,7,47
Berwick,7140,8,8,11,17,29,58,-29,35
Edinburgh Ci,7140,9,7,9,20,36,65,-29,30
Cowdenbeath,7140,10,4,10,22,23,55,-32,22
Peterhead,7141,1,24,4,8,80,38,42,76
Montrose,7141,2,23,7,6,61,37,24,76
Stirling,7141,3,16,7,13,62,53,9,55
Stenhousem'r,7141,4,15,9,12,57,48,9,54
Clyde,7141,5,15,9,12,54,50,4,54
Elgin,7141,6,15,6,15,56,62,-6,51
Annan Athlet,7141,7,11,11,14,48,43,5,44
Berwick,7141,8,8,10,18,31,61,-30,34
Edinburgh Ci,7141,9,7,9,20,36,63,-27,30
Cowdenbeath,7141,10,5,10,21,25,55,-30,25
Montrose,7142,1,24,7,5,62,36,26,79
Peterhead,7142,2,24,4,8,80,40,40,76
Stirling,7142,3,16,7,13,64,55,9,55
Stenhousem'r,7142,4,15,9,12,59,50,9,54
Clyde,7142,5,15,9,12,52,48,4,54
Elgin,7142,6,14,6,16,55,63,-8,48
Annan Athlet,7142,7,12,11,13,50,42,8,47
Berwick,7142,8,8,10,18,29,59,-30,34
Edinburgh Ci,7142,9,7,9,20,38,63,-25,30
Cowdenbeath,7142,10,4,10,22,24,57,-33,22
Montrose,7143,1,23,7,6,60,36,24,76
Peterhead,7143,2,23,5,8,79,40,39,74
Stirling,7143,3,17,6,13,64,52,12,57
Clyde,7143,4,15,9,12,54,49,5,54
Stenhousem'r,7143,5,15,8,13,56,50,6,53
Elgin,7143,6,15,6,15,55,61,-6,51
Annan Athlet,7143,7,11,11,14,48,43,5,44
Berwick,7143,8,8,10,18,30,61,-31,34
Edinburgh Ci,7143,9,7,10,19,38,62,-24,31
Cowdenbeath,7143,10,5,10,21,25,55,-30,25
Montrose,7144,1,24,7,5,63,34,29,79
Peterhead,7144,2,23,4,9,78,40,38,73
Stirling,7144,3,17,6,13,63,52,11,57
Clyde,7144,4,15,9,12,53,48,5,54
Stenhousem'r,7144,5,15,8,13,56,49,7,53
Elgin,7144,6,14,6,16,53,64,-11,48
Annan Athlet,7144,7,12,11,13,48,41,7,47
Berwick,7144,8,8,10,18,29,60,-31,34
Edinburgh Ci,7144,9,8,9,19,38,61,-23,33
Cowdenbeath,7144,10,4,10,22,23,55,-32,22
Montrose,7145,1,24,7,5,64,35,29,79
Peterhead,7145,2,24,4,8,82,38,44,76
Stirling,7145,3,17,6,13,62,52,10,57
Clyde,7145,4,15,9,12,53,49,4,54
Stenhousem'r,7145,5,15,8,13,56,48,8,53
Elgin,7145,6,14,6,16,54,65,-11,48
Annan Athlet,7145,7,11,11,14,48,44,4,44
Berwick,7145,8,8,10,18,30,60,-30,34
Edinburgh Ci,7145,9,7,9,20,36,65,-29,30
Cowdenbeath,7145,10,5,10,21,26,55,-29,25
Peterhead,7146,1,24,4,8,80,39,41,76
Montrose,7146,2,23,7,6,60,37,23,76
Stirling,7146,3,16,7,13,61,52,9,55
Stenhousem'r,7146,4,15,9,12,56,47,9,54
Clyde,7146,5,14,9,13,51,49,2,51
Elgin,7146,6,15,6,15,56,61,-5,51
Annan Athlet,7146,7,11,11,14,49,46,3,44
Berwick,7146,8,9,10,17,30,58,-28,37
Edinburgh Ci,7146,9,7,9,20,37,63,-26,30
Cowdenbeath,7146,10,5,10,21,28,56,-28,25
Montrose,7147,1,24,7,5,65,38,27,79
Peterhead,7147,2,24,4,8,82,40,42,76
Stenhousem'r,7147,3,16,8,12,56,46,10,56
Stirling,7147,4,16,6,14,60,52,8,54
Clyde,7147,5,15,9,12,53,48,5,54
Elgin,7147,6,14,6,16,57,66,-9,48
Annan Athlet,7147,7,12,11,13,49,41,8,47
Berwick,7147,8,8,10,18,29,60,-31,34
Edinburgh Ci,7147,9,7,9,20,38,65,-27,30
Cowdenbeath,7147,10,4,10,22,23,56,-33,22
Montrose,7148,1,23,8,5,59,34,25,77
Peterhead,7148,2,24,4,8,81,39,42,76
Stenhousem'r,7148,3,16,8,12,57,46,11,56
Stirling,7148,4,16,6,14,60,53,7,54
Clyde,7148,5,14,9,13,51,49,2,51
Elgin,7148,6,14,7,15,53,60,-7,49
Annan Athlet,7148,7,12,11,13,50,42,8,47
Berwick,7148,8,9,10,17,30,58,-28,37
Edinburgh Ci,7148,9,7,9,20,37,64,-27,30
Cowdenbeath,7148,10,4,10,22,24,57,-33,22
Montrose,7149,1,24,7,5,62,34,28,79
Peterhead,7149,2,24,4,8,78,38,40,76
Stirling,7149,3,16,7,13,61,52,9,55
Stenhousem'r,7149,4,15,9,12,56,47,9,54
Clyde,7149,5,15,9,12,52,48,4,54
Elgin,7149,6,14,6,16,53,63,-10,48
Annan Athlet,7149,7,11,11,14,47,42,5,44
Berwick,7149,8,8,10,18,29,59,-30,34
Edinburgh Ci,7149,9,7,9,20,36,61,-25,30
Cowdenbeath,7149,10,5,10,21,24,54,-30,25
Peterhead,7150,1,24,4,8,80,38,42,76
Montrose,7150,2,23,7,6,61,37,24,76
Stenhousem'r,7150,3,16,8,12,59,47,12,56
Stirling,7150,4,16,6,14,61,55,6,54
Clyde,7150,5,14,10,12,52,49,3,52
Elgin,7150,6,15,6,15,56,62,-6,51
Annan Athlet,7150,7,11,11,14,47,42,5,44
Berwick,7150,8,8,11,17,30,59,-29,35
Edinburgh Ci,7150,9,7,9,20,36,63,-27,30
Cowdenbeath,7150,10,5,10,21,24,54,-30,25
Peterhead,7151,1,24,4,8,81,39,42,76
Montrose,7151,2,23,7,6,59,36,23,76
Stirling,7151,3,17,6,13,61,51,10,57
Clyde,7151,4,15,9,12,53,49,4,54
Stenhousem'r,7151,5,15,8,13,55,47,8,53
Elgin,7151,6,15,6,15,55,60,-5,51
Annan Athlet,7151,7,11,11,14,47,42,5,44
Berwick,7151,8,8,10,18,30,60,-30,34
Edinburgh Ci,7151,9,7,9,20,37,64,-27,30
Cowdenbeath,7151,10,5,10,21,24,54,-30,25
Peterhead,7152,1,24,4,8,82,41,41,76
Montrose,7152,2,23,7,6,59,37,22,76
Stirling,7152,3,17,6,13,61,51,10,57
Stenhousem'r,7152,4,15,8,13,55,47,8,53
Clyde,7152,5,14,9,13,51,49,2,51
Elgin,7152,6,15,6,15,56,60,-4,51
Annan Athlet,7152,7,12,11,13,50,42,8,47
Berwick,7152,8,9,10,17,30,58,-28,37
Edinburgh Ci,7152,9,7,9,20,39,65,-26,30
Cowdenbeath,7152,10,4,10,22,24,57,-33,22
Montrose,7153,1,24,7,5,62,35,27,79
Peterhead,7153,2,24,4,8,81,39,42,76
Stirling,7153,3,17,6,13,63,52,11,57
Clyde,7153,4,15,9,12,53,48,5,54
Stenhousem'r,7153,5,15,8,13,56,49,7,53
Elgin,7153,6,14,6,16,54,63,-9,48
Annan Athlet,7153,7,12,11,13,48,41,7,47
Berwick,7153,8,8,10,18,29,60,-31,34
Edinburgh Ci,7153,9,7,9,20,37,64,-27,30
Cowdenbeath,7153,10,4,10,22,23,55,-32,22
Montrose,7154,1,24,7,5,63,36,27,79
Peterhead,7154,2,24,4,8,83,39,44,76
Stenhousem'r,7154,3,16,8,12,57,46,11,56
Stirling,7154,4,16,6,14,60,53,7,54
Clyde,7154,5,15,9,12,54,49,5,54
Elgin,7154,6,14,6,16,55,64,-9,48
Annan Athlet,7154,7,11,12,13,48,42,6,45
Berwick,7154,8,8,10,18,30,61,-31,34
Edinburgh Ci,7154,9,7,9,20,37,66,-29,30
Cowdenbeath,7154,10,4,11,21,24,55,-31,23
Montrose,7155,1,24,7,5,62,35,27,79
Peterhead,7155,2,24,4,8,79,39,40,76
Stirling,7155,3,16,7,13,61,52,9,55
Stenhousem'r,7155,4,15,9,12,56,47,9,54
Clyde,7155,5,15,9,12,54,48,6,54
Elgin,7155,6,14,6,16,54,63,-9,48
Annan Athlet,7155,7,11,11,14,47,43,4,44
Berwick,7155,8,8,10,18,29,61,-32,34
Edinburgh Ci,7155,9,7,9,20,37,62,-25,30
Cowdenbeath,7155,10,5,10,21,25,54,-29,25
Montrose,7156,1,24,7,5,61,35,26,79
Peterhead,7156,2,23,5,8,78,39,39,74
Stirling,7156,3,17,6,13,65,52,13,57
Clyde,7156,4,15,9,12,55,49,6,54
Stenhousem'r,7156,5,15,8,13,56,51,5,53
Elgin,7156,6,14,6,16,54,62,-8,48
Annan Athlet,7156,7,11,12,13,47,41,6,45
Berwick,7156,8,8,10,18,30,62,-32,34
Edinburgh Ci,7156,9,7,10,19,37,61,-24,31
Cowdenbeath,7156,10,4,11,21,23,54,-31,23
Montrose,7157,1,24,7,5,61,34,27,79
Peterhead,7157,2,23,4,9,78,43,35,73
Stirling,7157,3,16,7,13,61,52,9,55
Stenhousem'r,7157,4,15,9,12,56,47,9,54
Clyde,7157,5,15,9,12,55,48,7,54
Elgin,7157,6,14,6,16,53,62,-9,48
Annan Athlet,7157,7,11,12,13,47,41,6,45
Berwick,7157,8,8,10,18,29,62,-33,34
Edinburgh Ci,7157,9,8,9,19,41,61,-20,33
Cowdenbeath,7157,10,4,11,21,23,54,-31,23
Montrose,7158,1,24,7,5,62,35,27,79
Peterhead,7158,2,24,4,8,80,38,42,76
Stirling,7158,3,16,7,13,62,53,9,55
Stenhousem'r,7158,4,15,9,12,57,48,9,54
Clyde,7158,5,14,10,12,52,49,3,52
Elgin,7158,6,14,6,16,54,63,-9,48
Annan Athlet,7158,7,11,12,13,48,42,6,45
Berwick,7158,8,8,11,17,30,59,-29,35
Edinburgh Ci,7158,9,7,9,20,36,63,-27,30
Cowdenbeath,7158,10,4,11,21,24,55,-31,23
Montrose,7159,1,24,7,5,61,34,27,79
Peterhead,7159,2,24,4,8,82,39,43,76
Stenhousem'r,7159,3,16,8,12,58,48,10,56
Stirling,7159,4,16,6,14,62,54,8,54
Clyde,7159,5,14,10,12,52,49,3,52
Elgin,7159,6,14,6,16,53,62,-9,48
Annan Athlet,7159,7,11,12,13,47,41,6,45
Berwick,7159,8,8,11,17,30,59,-29,35
Edinburgh Ci,7159,9,7,9,20,37,65,-28,30
Cowdenbeath,7159,10,4,11,21,23,54,-31,23
Montrose,7160,1,24,7,5,63,35,28,79
Peterhead,7160,2,24,4,8,79,39,40,76
Stirling,7160,3,17,6,13,64,52,12,57
Clyde,7160,4,15,9,12,54,49,5,54
Stenhousem'r,7160,5,15,8,13,56,50,6,53
Elgin,7160,6,14,6,16,54,64,-10,48
Annan Athlet,7160,7,12,11,13,49,41,8,47
Berwick,7160,8,8,10,18,30,61,-31,34
Edinburgh Ci,7160,9,7,9,20,37,62,-25,30
Cowdenbeath,7160,10,4,10,22,23,56,-33,22
Montrose,7161,1,24,7,5,63,34,29,79
Peterhead,7161,2,24,4,8,81,38,43,76
Stirling,7161,3,17,6,13,64,52,12,57
Clyde,7161,4,15,9,12,54,49,5,54
Stenhousem'r,7161,5,15,8,13,56,50,6,53
Elgin,7161,6,14,6,16,53,64,-11,48
Annan Athlet,7161,7,11,12,13,50,44,6,45
Berwick,7161,8,8,10,18,30,61,-31,34
Edinburgh Ci,7161,9,7,9,20,36,64,-28,30
Cowdenbeath,7161,10,4,11,21,26,57,-31,23
Montrose,7162,1,24,7,5,62,35,27,79
Peterhead,7162,2,24,4,8,79,39,40,76
Stirling,7162,3,17,6,13,61,51,10,57
Clyde,7162,4,15,9,12,53,49,4,54
Stenhousem'r,7162,5,15,8,13,55,47,8,53
Elgin,7162,6,14,6,16,54,63,-9,48
Annan Athlet,7162,7,12,11,13,48,41,7,47
Berwick,7162,8,8,10,18,30,60,-30,34
Edinburgh Ci,7162,9,7,9,20,37,62,-25,30
Cowdenbeath,7162,10,4,10,22,23,55,-32,22
Peterhead,7163,1,24,4,8,82,39,43,76
Montrose,7163,2,23,7,6,59,35,24,76
Stenhousem'r,7163,3,16,8,12,57,47,10,56
Stirling,7163,4,16,6,14,61,53,8,54
Clyde,7163,5,14,9,13,51,49,2,51
Elgin,7163,6,15,6,15,54,60,-6,51
Annan Athlet,7163,7,12,11,13,49,42,7,47
Berwick,7163,8,9,10,17,30,58,-28,37
Edinburgh Ci,7163,9,7,9,20,37,65,-28,30
Cowdenbeath,7163,10,4,10,22,24,56,-32,22
Montrose,7164,1,24,7,5,61,35,26,79
Peterhead,7164,2,24,4,8,82,38,44,76
Stirling,7164,3,16,7,13,61,52,9,55
Stenhousem'r,7164,4,15,9,12,56,47,9,54
Clyde,7164,5,15,9,12,55,50,5,54
Elgin,7164,6,14,6,16,54,62,-8,48
Annan Athlet,7164,7,11,12,13,48,42,6,45
Berwick,7164,8,8,10,18,31,62,-31,34
Edinburgh Ci,7164,9,7,9,20,36,65,-29,30
Cowdenbeath,7164,10,4,11,21,24,55,-31,23
Montrose,7165,1,23,7,6,59,35,24,76
Peterhead,7165,2,23,4,9,78,41,37,73
Stenhousem'r,7165,3,16,8,12,57,47,10,56
Stirling,7165,4,16,6,14,61,53,8,54
Clyde,7165,5,15,9,12,52,48,4,54
Elgin,7165,6,15,6,15,54,60,-6,51
Annan Athlet,7165,7,12,11,13,48,41,7,47
Berwick,7165,8,8,10,18,29,59,-30,34
Edinburgh Ci,7165,9,8,9,19,39,61,-22,33
Cowdenbeath,7165,10,4,10,22,23,55,-32,22
Montrose,7166,1,24,7,5,61,35,26,79
Peterhead,7166,2,24,4,8,83,39,44,76
Stirling,7166,3,17,6,13,62,51,11,57
Clyde,7166,4,15,9,12,53,48,5,54
Stenhousem'r,7166,5,15,8,13,55,48,7,53
Elgin,7166,6,14,6,16,54,62,-8,48
Annan Athlet,7166,7,12,11,13,48,41,7,47
Berwick,7166,8,8,10,18,29,60,-31,34
Edinburgh Ci,7166,9,7,9,20,37,66,-29,30
Cowdenbeath,7166,10,4,10,22,23,55,-32,22
Montrose,7167,1,24,7,5,62,34,28,79
Peterhead,7167,2,24,4,8,80,39,41,76
Stirling,7167,3,16,7,13,62,53,9,55
Stenhousem'r,7167,4,15,9,12,57,48,9,54
Clyde,7167,5,14,10,12,53,50,3,52
Elgin,7167,6,14,6,16,53,63,-10,48
Annan Athlet,7167,7,12,11,13,49,41,8,47
Berwick,7167,8,8,11,17,31,60,-29,35
Edinburgh Ci,7167,9,7,9,20,37,63,-26,30
Cowdenbeath,7167,10,4,10,22,23,56,-33,22
Montrose,7168,1,23,8,5,59,34,25,77
Peterhead,7168,2,24,4,8,80,39,41,76
Stirling,7168,3,16,7,13,60,51,9,55
Stenhousem'r,7168,4,15,9,12,55,46,9,54
Clyde,7168,5,15,9,12,56,49,7,54
Elgin,7168,6,14,7,15,53,60,-7,49
Annan Athlet,7168,7,12,11,13,49,42,7,47
Berwick,7168,8,8,10,18,30,63,-33,34
Edinburgh Ci,7168,9,7,9,20,37,63,-26,30
Cowdenbeath,7168,10,4,10,22,24,56,-32,22
Montrose,7169,1,23,8,5,59,34,25,77
Peterhead,7169,2,23,5,8,79,40,39,74
Stirling,7169,3,16,7,13,60,51,9,55
Stenhousem'r,7169,4,15,9,12,55,46,9,54
Clyde,7169,5,14,9,13,53,51,2,51
Elgin,7169,6,14,7,15,53,60,-7,49
Annan Athlet,7169,7,11,11,14,47,44,3,44
Berwick,7169,8,9,10,17,32,60,-28,37
Edinburgh Ci,7169,9,7,10,19,38,62,-24,31
Cowdenbeath,7169,10,5,10,21,26,54,-28,25
Montrose,7170,1,24,7,5,64,35,29,79
Peterhead,7170,2,24,4,8,79,39,40,76
Stirling,7170,3,17,6,13,62,51,11,57
Clyde,7170,4,15,9,12,56,48,8,54
Stenhousem'r,7170,5,15,8,13,55,48,7,53
Elgin,7170,6,14,6,16,54,65,-11,48
Annan Athlet,7170,7,11,12,13,47,41,6,45
Berwick,7170,8,8,10,18,29,63,-34,34
Edinburgh Ci,7170,9,7,9,20,37,62,-25,30
Cowdenbeath,7170,10,4,11,21,23,54,-31,23
Montrose,7171,1,24,7,5,63,34,29,79
Peterhead,7171,2,24,4,8,80,40,40,76
Stirling,7171,3,17,6,13,62,52,10,57
Stenhousem'r,7171,4,15,8,13,56,48,8,53
Clyde,7171,5,14,9,13,52,50,2,51
Elgin,7171,6,14,6,16,53,64,-11,48
Annan Athlet,7171,7,11,11,14,48,44,4,44
Berwick,7171,8,9,10,17,31,59,-28,37
Edinburgh Ci,7171,9,7,9,20,38,63,-25,30
Cowdenbeath,7171,10,5,10,21,26,55,-29,25
Peterhead,7172,1,24,4,8,79,38,41,76
Montrose,7172,2,23,7,6,62,38,24,76
Stenhousem'r,7172,3,16,8,12,57,47,10,56
Stirling,7172,4,16,6,14,61,53,8,54
Clyde,7172,5,15,9,12,53,48,5,54
Elgin,7172,6,15,6,15,57,63,-6,51
Annan Athlet,7172,7,11,12,13,48,42,6,45
Berwick,7172,8,8,10,18,29,60,-31,34
Edinburgh Ci,7172,9,7,9,20,36,62,-26,30
Cowdenbeath,7172,10,4,11,21,24,55,-31,23
Peterhead,7173,1,24,4,8,81,39,42,76
Montrose,7173,2,23,7,6,60,36,24,76
Stirling,7173,3,17,6,13,63,52,11,57
Stenhousem'r,7173,4,15,8,13,56,49,7,53
Clyde,7173,5,14,9,13,52,50,2,51
Elgin,7173,6,15,6,15,55,61,-6,51
Annan Athlet,7173,7,11,11,14,47,43,4,44
Berwick,7173,8,9,10,17,31,59,-28,37
Edinburgh Ci,7173,9,7,9,20,37,64,-27,30
Cowdenbeath,7173,10,5,10,21,25,54,-29,25
Montrose,7174,1,24,7,5,62,35,27,79
Peterhead,7174,2,23,4,9,79,43,36,73
Stenhousem'r,7174,3,16,8,12,59,48,11,56
Stirling,7174,4,16,6,14,62,55,7,54
Clyde,7174,5,14,10,12,54,51,3,52
Elgin,7174,6,14,6,16,54,63,-9,48
Annan Athlet,7174,7,12,11,13,49,41,8,47
Berwick,7174,8,8,11,17,32,61,-29,35
Edinburgh Ci,7174,9,8,9,19,41,62,-21,33
Cowdenbeath,7174,10,4,10,22,23,56,-33,22
Montrose,7175,1,24,7,5,64,35,29,79
Peterhead,7175,2,24,4,8,82,38,44,76
Stenhousem'r,7175,3,16,8,12,56,46,10,56
Stirling,7175,4,16,6,14,60,52,8,54
Clyde,7175,5,14,10,12,52,49,3,52
Elgin,7175,6,14,6,16,54,65,-11,48
Annan Athlet,7175,7,12,11,13,49,41,8,47
Berwick,7175,8,8,11,17,30,59,-29,35
Edinburgh Ci,7175,9,7,9,20,36,65,-29,30
Cowdenbeath,7175,10,4,10,22,23,56,-33,22
Montrose,7176,1,24,7,5,60,34,26,79
Peterhead,7176,2,24,4,8,80,38,42,76
Stirling,7176,3,16,7,13,60,51,9,55
Stenhousem'r,7176,4,15,9,12,55,46,9,54
Clyde,7176,5,14,10,12,52,49,3,52
Elgin,7176,6,14,6,16,53,61,-8,48
Annan Athlet,7176,7,12,11,13,49,42,7,47
Berwick,7176,8,8,11,17,30,59,-29,35
Edinburgh Ci,7176,9,7,9,20,36,63,-27,30
Cowdenbeath,7176,10,4,10,22,24,56,-32,22
Montrose,7177,1,24,7,5,63,35,28,79
Peterhead,7177,2,24,4,8,79,38,41,76
Stirling,7177,3,16,7,13,60,51,9,55
Stenhousem'r,7177,4,15,9,12,55,46,9,54
Clyde,7177,5,15,9,12,53,48,5,54
Elgin,7177,6,14,6,16,54,64,-10,48
Annan Athlet,7177,7,11,12,13,47,41,6,45
Berwick,7177,8,8,10,18,29,60,-31,34
Edinburgh Ci,7177,9,7,9,20,36,62,-26,30
Cowdenbeath,7177,10,4,11,21,23,54,-31,23
Montrose,7178,1,23,7,6,59,35,24,76
Peterhead,7178,2,23,5,8,77,38,39,74
Stirling,7178,3,16,7,13,62,53,9,55
Stenhousem'r,7178,4,15,9,12,57,48,9,54
Clyde,7178,5,14,9,13,52,50,2,51
Elgin,7178,6,15,6,15,54,60,-6,51
Annan Athlet,7178,7,11,12,13,48,42,6,45
Berwick,7178,8,9,10,17,31,59,-28,37
Edinburgh Ci,7178,9,7,10,19,36,60,-24,31
Cowdenbeath,7178,10,4,11,21,24,55,-31,23
Montrose,7179,1,24,7,5,60,34,26,79
Peterhead,7179,2,23,4,9,77,40,37,73
Stirling,7179,3,16,7,13,60,51,9,55
Stenhousem'r,7179,4,15,9,12,55,46,9,54
Clyde,7179,5,15,9,12,53,48,5,54
Elgin,7179,6,14,6,16,53,61,-8,48
Annan Athlet,7179,7,11,11,14,47,43,4,44
Berwick,7179,8,8,10,18,29,60,-31,34
Edinburgh Ci,7179,9,8,9,19,38,60,-22,33
Cowdenbeath,7179,10,5,10,21,25,54,-29,25
Peterhead,7180,1,24,4,8,81,38,43,76
Montrose,7180,2,23,7,6,59,35,24,76
Stenhousem'r,7180,3,16,8,12,56,46,10,56
Stirling,7180,4,16,6,14,60,52,8,54
Clyde,7180,5,14,9,13,51,49,2,51
Elgin,7180,6,15,6,15,54,60,-6,51
Annan Athlet,7180,7,11,11,14,47,43,4,44
Berwick,7180,8,9,10,17,30,58,-28,37
Edinburgh Ci,7180,9,7,9,20,36,64,-28,30
Cowdenbeath,7180,10,5,10,21,25,54,-29,25
Montrose,7181,1,23,8,5,61,36,25,77
Peterhead,7181,2,24,4,8,84,38,46,76
Stirling,7181,3,16,7,13,61,52,9,55
Stenhousem'r,7181,4,15,9,12,56,47,9,54
Clyde,7181,5,15,9,12,53,49,4,54
Elgin,7181,6,14,7,15,55,62,-7,49
Annan Athlet,7181,7,11,12,13,48,42,6,45
Berwick,7181,8,8,10,18,30,60,-30,34
Edinburgh Ci,7181,9,7,9,20,36,67,-31,30
Cowdenbeath,7181,10,4,11,21,24,55,-31,23
Montrose,7182,1,24,7,5,60,34,26,79
Peterhead,7182,2,24,4,8,82,39,43,76
Stirling,7182,3,17,6,13,64,52,12,57
Clyde,7182,4,15,9,12,55,48,7,54
Stenhousem'r,7182,5,15,8,13,56,50,6,53
Elgin,7182,6,14,6,16,53,61,-8,48
Annan Athlet,7182,7,12,11,13,49,42,7,47
Berwick,7182,8,8,10,18,29,62,-33,34
Edinburgh Ci,7182,9,7,9,20,37,65,-28,30
Cowdenbeath,7182,10,4,10,22,24,56,-32,22
Montrose,7183,1,23,8,5,60,35,25,77
Peterhead,7183,2,24,4,8,81,38,43,76
Stirling,7183,3,17,6,13,63,52,11,57
Stenhousem'r,7183,4,15,8,13,56,49,7,53
Clyde,7183,5,14,9,13,53,51,2,51
Elgin,7183,6,14,7,15,54,61,-7,49
Annan Athlet,7183,7,12,11,13,50,41,9,47
Berwick,7183,8,9,10,17,32,60,-28,37
Edinburgh Ci,7183,9,7,9,20,36,64,-28,30
Cowdenbeath,7183,10,4,10,22,23,57,-34,22
Peterhead,7184,1,24,4,8,81,40,41,76
Montrose,7184,2,23,7,6,60,38,22,76
Stenhousem'r,7184,3,16,8,12,58,47,11,56
Stirling,7184,4,16,6,14,61,54,7,54
Clyde,7184,5,15,9,12,54,50,4,54
Elgin,7184,6,15,6,15,57,61,-4,51
Annan Athlet,7184,7,12,11,13,49,41,8,47
Berwick,7184,8,8,10,18,31,61,-30,34
Edinburgh Ci,7184,9,7,9,20,38,64,-26,30
Cowdenbeath,7184,10,4,10,22,23,56,-33,22
Montrose,7185,1,24,7,5,62,35,27,79
Peterhead,7185,2,24,4,8,84,40,44,76
Stirling,7185,3,16,7,13,61,52,9,55
Stenhousem'r,7185,4,15,9,12,56,47,9,54
Clyde,7185,5,15,9,12,53,49,4,54
Elgin,7185,6,14,6,16,54,63,-9,48
Annan Athlet,7185,7,12,11,13,49,42,7,47
Berwick,7185,8,8,10,18,30,60,-30,34
Edinburgh Ci,7185,9,7,9,20,38,67,-29,30
Cowdenbeath,7185,10,4,10,22,24,56,-32,22
Montrose,7186,1,23,8,5,60,35,25,77
Peterhead,7186,2,24,4,8,80,38,42,76
Stirling,7186,3,16,7,13,61,52,9,55
Stenhousem'r,7186,4,15,9,12,56,47,9,54
Clyde,7186,5,15,9,12,53,48,5,54
Elgin,7186,6,14,7,15,54,61,-7,49
Annan Athlet,7186,7,12,11,13,49,41,8,47
Berwick,7186,8,8,10,18,29,60,-31,34
Edinburgh Ci,7186,9,7,9,20,36,63,-27,30
Cowdenbeath,7186,10,4,10,22,23,56,-33,22
Montrose,7187,1,23,7,6,59,37,22,76
Peterhead,7187,2,23,5,8,77,38,39,74
Stirling,7187,3,17,6,13,64,52,12,57
Clyde,7187,4,15,9,12,56,51,5,54
Stenhousem'r,7187,5,15,8,13,56,50,6,53
Elgin,7187,6,15,6,15,56,60,-4,51
Annan Athlet,7187,7,12,11,13,51,43,8,47
Berwick,7187,8,8,10,18,32,63,-31,34
Edinburgh Ci,7187,9,7,10,19,36,60,-24,31
Cowdenbeath,7187,10,4,10,22,25,58,-33,22
Montrose,7188,1,24,7,5,60,34,26,79
Peterhead,7188,2,24,4,8,81,38,43,76
Stirling,7188,3,17,6,13,63,52,11,57
Clyde,7188,4,15,9,12,54,49,5,54
Stenhousem'r,7188,5,15,8,13,56,49,7,53
Elgin,7188,6,14,6,16,53,61,-8,48
Annan Athlet,7188,7,12,11,13,48,41,7,47
Berwick,7188,8,8,10,18,30,61,-31,34
Edinburgh Ci,7188,9,7,9,20,36,64,-28,30
Cowdenbeath,7188,10,4,10,22,23,55,-32,22
Peterhead,7189,1,24,4,8,82,38,44,76
Montrose,7189,2,23,7,6,60,36,24,76
Stirling,7189,3,17,6,13,64,52,12,57
Stenhousem'r,7189,4,15,8,13,56,50,6,53
Clyde,7189,5,14,9,13,53,51,2,51
Elgin,7189,6,15,6,15,55,61,-6,51
Annan Athlet,7189,7,11,12,13,47,41,6,45
Berwick,7189,8,9,10,17,32,60,-28,37
Edinburgh Ci,7189,9,7,9,20,36,65,-29,30
Cowdenbeath,7189,10,4,11,21,23,54,-31,23
Montrose,7190,1,23,8,5,62,37,25,77
Peterhead,7190,2,24,4,8,79,39,40,76
Stirling,7190,3,16,7,13,61,52,9,55
Stenhousem'r,7190,4,15,9,12,56,47,9,54
Clyde,7190,5,15,9,12,53,48,5,54
Elgin,7190,6,14,7,15,56,63,-7,49
Annan Athlet,7190,7,12,11,13,48,41,7,47
Berwick,7190,8,8,10,18,29,60,-31,34
Edinburgh Ci,7190,9,7,9,20,37,62,-25,30
Cowdenbeath,7190,10,4,10,22,23,55,-32,22
Montrose,7191,1,23,8,5,60,35,25,77
Peterhead,7191,2,24,4,8,81,38,43,76
Stirling,7191,3,16,7,13,61,52,9,55
Stenhousem'r,7191,4,15,9,12,56,47,9,54
Clyde,7191,5,15,9,12,53,48,5,54
Elgin,7191,6,14,7,15,54,61,-7,49
Annan Athlet,7191,7,11,11,14,48,44,4,44
Berwick,7191,8,8,10,18,29,60,-31,34
Edinburgh Ci,7191,9,7,9,20,36,64,-28,30
Cowdenbeath,7191,10,5,10,21,26,55,-29,25
Montrose,7192,1,24,7,5,62,35,27,79
Peterhead,7192,2,24,4,8,80,38,42,76
Stirling,7192,3,17,6,13,62,52,10,57
Stenhousem'r,7192,4,15,8,13,56,48,8,53
Clyde,7192,5,14,10,12,52,49,3,52
Elgin,7192,6,14,6,16,54,63,-9,48
Annan Athlet,7192,7,11,11,14,47,42,5,44
Berwick,7192,8,8,11,17,30,59,-29,35
Edinburgh Ci,7192,9,7,9,20,36,63,-27,30
Cowdenbeath,7192,10,5,10,21,24,54,-30,25
Montrose,7193,1,24,7,5,60,34,26,79
Peterhead,7193,2,23,5,8,77,38,39,74
Stirling,7193,3,16,7,13,60,51,9,55
Stenhousem'r,7193,4,15,9,12,55,46,9,54
Clyde,7193,5,15,9,12,52,48,4,54
Elgin,7193,6,14,6,16,53,61,-8,48
Annan Athlet,7193,7,11,12,13,47,41,6,45
Berwick,7193,8,8,10,18,29,59,-30,34
Edinburgh Ci,7193,9,7,10,19,36,60,-24,31
Cowdenbeath,7193,10,4,11,21,23,54,-31,23
Montrose,7194,1,24,7,5,61,35,26,79
Peterhead,7194,2,24,4,8,81,38,43,76
Stirling,7194,3,16,7,13,61,52,9,55
Stenhousem'r,7194,4,15,9,12,56,47,9,54
Clyde,7194,5,15,9,12,58,50,8,54
Elgin,7194,6,14,6,16,54,62,-8,48
Annan Athlet,7194,7,11,11,14,48,43,5,44
Berwick,7194,8,8,10,18,31,65,-34,34
Edinburgh Ci,7194,9,7,9,20,36,64,-28,30
Cowdenbeath,7194,10,5,10,21,25,55,-30,25
Peterhead,7195,1,24,4,8,79,39,40,76
Montrose,7195,2,23,7,6,59,35,24,76
Stirling,7195,3,17,6,13,61,51,10,57
Clyde,7195,4,15,9,12,55,48,7,54
Stenhousem'r,7195,5,15,8,13,55,47,8,53
Elgin,7195,6,15,6,15,54,60,-6,51
Annan Athlet,7195,7,12,11,13,49,41,8,47
Berwick,7195,8,8,10,18,29,62,-33,34
Edinburgh Ci,7195,9,7,9,20,37,62,-25,30
Cowdenbeath,7195,10,4,10,22,23,56,-33,22
Montrose,7196,1,24,7,5,60,34,26,79
Peterhead,7196,2,24,4,8,78,38,40,76
Stenhousem'r,7196,3,16,8,12,58,46,12,56
Stirling,7196,4,16,6,14,60,54,6,54
Clyde,7196,5,14,9,13,52,50,2,51
Elgin,7196,6,14,6,16,53,61,-8,48
Annan Athlet,7196,7,11,12,13,47,41,6,45
Berwick,7196,8,9,10,17,31,59,-28,37
Edinburgh Ci,7196,9,7,9,20,36,61,-25,30
Cowdenbeath,7196,10,4,11,21,23,54,-31,23
Montrose,7197,1,24,7,5,61,35,26,79
Peterhead,7197,2,24,4,8,81,40,41,76
Stirling,7197,3,17,6,13,62,51,11,57
Clyde,7197,4,15,9,12,53,49,4,54
Stenhousem'r,7197,5,15,8,13,55,48,7,53
Elgin,7197,6,14,6,16,54,62,-8,48
Annan Athlet,7197,7,11,12,13,47,41,6,45
Berwick,7197,8,8,10,18,30,60,-30,34
Edinburgh Ci,7197,9,7,9,20,38,64,-26,30
Cowdenbeath,7197,10,4,11,21,23,54,-31,23
Montrose,7198,1,23,8,5,62,37,25,77
Peterhead,7198,2,24,4,8,78,38,40,76
Stirling,7198,3,17,6,13,63,53,10,57
Stenhousem'r,7198,4,15,8,13,57,49,8,53
Clyde,7198,5,14,9,13,51,49,2,51
Elgin,7198,6,14,7,15,56,63,-7,49
Annan Athlet,7198,7,11,12,13,48,42,6,45
Berwick,7198,8,9,10,17,30,58,-28,37
Edinburgh Ci,7198,9,7,9,20,36,61,-25,30
Cowdenbeath,7198,10,4,11,21,24,55,-31,23
Montrose,7199,1,23,8,5,60,35,25,77
Peterhead,7199,2,24,4,8,80,39,41,76
Stenhousem'r,7199,3,16,8,12,57,47,10,56
Stirling,7199,4,16,6,14,61,53,8,54
Clyde,7199,5,14,10,12,53,50,3,52
Elgin,7199,6,14,7,15,54,61,-7,49
Annan Athlet,7199,7,12,11,13,50,42,8,47
Berwick,7199,8,8,11,17,31,60,-29,35
Edinburgh Ci,7199,9,7,9,20,37,63,-26,30
Cowdenbeath,7199,10,4,10,22,24,57,-33,22
Montrose,7200,1,24,7,5,62,35,27,79
Peterhead,7200,2,24,4,8,79,39,40,76
Stirling,7200,3,16,7,13,61,52,9,55
Stenhousem'r,7200,4,15,9,12,56,47,9,54
Clyde,7200,5,14,10,12,52,49,3,52
Elgin,7200,6,14,6,16,54,63,-9,48
Annan Athlet,7200,7,11,11,14,48,43,5,44
Berwick,7200,8,8,11,17,30,59,-29,35
Edinburgh Ci,7200,9,7,9,20,37,62,-25,30
Cowdenbeath,7200,10,5,10,21,25,55,-30,25
Peterhead,7201,1,24,4,8,79,38,41,76
Montrose,7201,2,23,7,6,60,36,24,76
Stenhousem'r,7201,3,16,8,12,57,47,10,56
Stirling,7201,4,16,6,14,61,53,8,54
Clyde,7201,5,15,9,12,52,48,4,54
Elgin,7201,6,15,6,15,55,61,-6,51
Annan Athlet,7201,7,11,11,14,47,43,4,44
Berwick,7201,8,8,10,18,29,59,-30,34
Edinburgh Ci,7201,9,7,9,20,36,62,-26,30
Cowdenbeath,7201,10,5,10,21,25,54,-29,25
Montrose,7202,1,23,7,6,61,37,24,76
Peterhead,7202,2,23,4,9,80,42,38,73
Stirling,7202,3,17,6,13,64,53,11,57
Stenhousem'r,7202,4,15,8,13,57,50,7,53
Clyde,7202,5,14,9,13,51,51,0,51
Elgin,7202,6,15,6,15,56,62,-6,51
Annan Athlet,7202,7,11,12,13,48,42,6,45
Berwick,7202,8,9,10,17,32,58,-26,37
Edinburgh Ci,7202,9,8,9,19,40,63,-23,33
Cowdenbeath,7202,10,4,11,21,24,55,-31,23
Montrose,7203,1,24,7,5,62,36,26,79
Peterhead,7203,2,24,4,8,79,38,41,76
Stenhousem'r,7203,3,16,8,12,58,46,12,56
Stirling,7203,4,16,6,14,60,54,6,54
Clyde,7203,5,14,10,12,51,48,3,52
Elgin,7203,6,14,6,16,55,63,-8,48
Annan Athlet,7203,7,11,11,14,49,44,5,44
Berwick,7203,8,8,11,17,29,58,-29,35
Edinburgh Ci,7203,9,7,9,20,36,62,-26,30
Cowdenbeath,7203,10,5,10,21,26,56,-30,25
Peterhead,7204,1,24,4,8,78,38,40,76
Montrose,7204,2,23,7,6,59,35,24,76
Stirling,7204,3,16,7,13,62,53,9,55
Stenhousem'r,7204,4,15,9,12,57,48,9,54
Clyde,7204,5,15,9,12,53,49,4,54
Elgin,7204,6,15,6,15,54,60,-6,51
Annan Athlet,7204,7,11,11,14,47,43,4,44
Berwick,7204,8,8,10,18,30,60,-30,34
Edinburgh Ci,7204,9,7,9,20,36,61,-25,30
Cowdenbeath,7204,10,5,10,21,25,54,-29,25
Montrose,7205,1,24,7,5,61,34,27,79
Peterhead,7205,2,23,5,8,79,40,39,74
Stirling,7205,3,17,6,13,63,52,11,57
Stenhousem'r,7205,4,15,8,13,56,49,7,53
Clyde,7205,5,14,10,12,52,49,3,52
Elgin,7205,6,14,6,16,53,62,-9,48
Annan Athlet,7205,7,11,12,13,47,41,6,45
Berwick,7205,8,8,11,17,30,59,-29,35
Edinburgh Ci,7205,9,7,10,19,38,62,-24,31
Cowdenbeath,7205,10,4,11,21,23,54,-31,23
Montrose,7206,1,23,8,5,61,36,25,77
Peterhead,7206,2,23,5,8,79,40,39,74
Stirling,7206,3,17,6,13,63,53,10,57
Stenhousem'r,7206,4,15,8,13,57,49,8,53
Clyde,7206,5,14,10,12,53,50,3,52
Elgin,7206,6,14,7,15,55,62,-7,49
Annan Athlet,7206,7,12,11,13,48,41,7,47
Berwick,7206,8,8,11,17,31,60,-29,35
Edinburgh Ci,7206,9,7,10,19,38,62,-24,31
Cowdenbeath,7206,10,4,10,22,23,55,-32,22
Montrose,7207,1,24,7,5,62,36,26,79
Peterhead,7207,2,24,4,8,80,40,40,76
Stenhousem'r,7207,3,16,8,12,57,47,10,56
Stirling,7207,4,16,6,14,61,53,8,54
Clyde,7207,5,15,9,12,54,50,4,54
Elgin,7207,6,14,6,16,55,63,-8,48
Annan Athlet,7207,7,12,11,13,48,41,7,47
Berwick,7207,8,8,10,18,31,61,-30,34
Edinburgh Ci,7207,9,7,9,20,38,63,-25,30
Cowdenbeath,7207,10,4,10,22,23,55,-32,22
Montrose,7208,1,24,7,5,61,35,26,79
Peterhead,7208,2,24,4,8,79,38,41,76
Stirling,7208,3,17,6,13,63,53,10,57
Stenhousem'r,7208,4,15,8,13,57,49,8,53
Clyde,7208,5,14,9,13,51,50,1,51
Elgin,7208,6,14,6,16,54,62,-8,48
Annan Athlet,7208,7,11,12,13,48,42,6,45
Berwick,7208,8,9,10,17,31,58,-27,37
Edinburgh Ci,7208,9,7,9,20,36,62,-26,30
Cowdenbeath,7208,10,4,11,21,24,55,-31,23
Montrose,7209,1,23,8,5,60,35,25,77
Peterhead,7209,2,24,4,8,80,39,41,76
Stirling,7209,3,17,6,13,65,51,14,57
Clyde,7209,4,15,9,12,52,48,4,54
Stenhousem'r,7209,5,15,8,13,55,51,4,53
Elgin,7209,6,14,7,15,54,61,-7,49
Annan Athlet,7209,7,12,11,13,48,41,7,47
Berwick,7209,8,8,10,18,29,59,-30,34
Edinburgh Ci,7209,9,7,9,20,37,63,-26,30
Cowdenbeath,7209,10,4,10,22,23,55,-32,22
Montrose,7210,1,23,8,5,60,35,25,77
Peterhead,7210,2,24,4,8,81,38,43,76
Stirling,7210,3,17,6,13,64,51,13,57
Clyde,7210,4,15,9,12,53,48,5,54
Stenhousem'r,7210,5,15,8,13,55,50,5,53
Elgin,7210,6,14,7,15,54,61,-7,49
Annan Athlet,7210,7,11,11,14,47,43,4,44
Berwick,7210,8,8,10,18,29,60,-31,34
Edinburgh Ci,7210,9,7,9,20,36,64,-28,30
Cowdenbeath,7210,10,5,10,21,25,54,-29,25
Montrose,7211,1,24,7,5,60,34,26,79
Peterhead,7211,2,23,5,8,79,40,39,74
Stenhousem'r,7211,3,16,8,12,57,47,10,56
Stirling,7211,4,16,6,14,61,53,8,54
Clyde,7211,5,15,9,12,53,49,4,54
Elgin,7211,6,14,6,16,53,61,-8,48
Annan Athlet,7211,7,11,11,14,48,43,5,44
Berwick,7211,8,8,10,18,30,60,-30,34
Edinburgh Ci,7211,9,7,10,19,38,62,-24,31
Cowdenbeath,7211,10,5,10,21,25,55,-30,25
Montrose,7212,1,24,7,5,62,35,27,79
Peterhead,7212,2,24,4,8,81,38,43,76
Stirling,7212,3,17,6,13,63,53,10,57
Stenhousem'r,7212,4,15,8,13,57,49,8,53
Clyde,7212,5,14,10,12,54,51,3,52
Elgin,7212,6,14,6,16,54,63,-9,48
Annan Athlet,7212,7,11,11,14,47,42,5,44
Berwick,7212,8,8,11,17,32,61,-29,35
Edinburgh Ci,7212,9,7,9,20,36,64,-28,30
Cowdenbeath,7212,10,5,10,21,24,54,-30,25
Montrose,7213,1,24,7,5,61,35,26,79
Peterhead,7213,2,24,4,8,80,38,42,76
Stirling,7213,3,17,6,13,64,52,12,57
Clyde,7213,4,15,9,12,54,48,6,54
Stenhousem'r,7213,5,15,8,13,56,50,6,53
Elgin,7213,6,14,6,16,54,62,-8,48
Annan Athlet,7213,7,11,11,14,48,43,5,44
Berwick,7213,8,8,10,18,29,61,-32,34
Edinburgh Ci,7213,9,7,9,20,36,63,-27,30
Cowdenbeath,7213,10,5,10,21,25,55,-30,25
Peterhead,7214,1,24,4,8,80,38,42,76
Montrose,7214,2,23,7,6,61,37,24,76
Stirling,7214,3,17,6,13,62,52,10,57
Stenhousem'r,7214,4,15,8,13,56,48,8,53
Clyde,7214,5,14,9,13,52,50,2,51
Elgin,7214,6,15,6,15,56,62,-6,51
Annan Athlet,7214,7,12,11,13,49,42,7,47
Berwick,7214,8,9,10,17,31,59,-28,37
Edinburgh Ci,7214,9,7,9,20,36,63,-27,30
Cowdenbeath,7214,10,4,10,22,24,56,-32,22
Peterhead,7215,1,24,4,8,80,40,40,76
Montrose,7215,2,23,7,6,59,35,24,76
Stirling,7215,3,16,7,13,61,52,9,55
Stenhousem'r,7215,4,15,9,12,56,47,9,54
Clyde,7215,5,15,9,12,52,48,4,54
Elgin,7215,6,15,6,15,54,60,-6,51
Annan Athlet,7215,7,11,12,13,48,42,6,45
Berwick,7215,8,8,10,18,29,59,-30,34
Edinburgh Ci,7215,9,7,9,20,38,63,-25,30
Cowdenbeath,7215,10,4,11,21,24,55,-31,23
Montrose,7216,1,24,7,5,60,34,26,79
Peterhead,7216,2,24,4,8,80,39,41,76
Stirling,7216,3,17,6,13,62,52,10,57
Clyde,7216,4,15,9,12,57,48,9,54
Stenhousem'r,7216,5,15,8,13,56,48,8,53
Elgin,7216,6,14,6,16,53,61,-8,48
Annan Athlet,7216,7,11,12,13,47,41,6,45
Berwick,7216,8,8,10,18,29,64,-35,34
Edinburgh Ci,7216,9,7,9,20,37,63,-26,30
Cowdenbeath,7216,10,4,11,21,23,54,-31,23
Montrose,7217,1,23,8,5,60,35,25,77
Peterhead,7217,2,24,4,8,83,40,43,76
Stenhousem'r,7217,3,16,8,12,56,46,10,56
Stirling,7217,4,16,6,14,60,52,8,54
Clyde,7217,5,15,9,12,53,48,5,54
Elgin,7217,6,14,7,15,54,61,-7,49
Annan Athlet,7217,7,12,11,13,49,42,7,47
Berwick,7217,8,8,10,18,29,60,-31,34
Edinburgh Ci,7217,9,7,9,20,38,66,-28,30
Cowdenbeath,7217,10,4,10,22,24,56,-32,22
Peterhead,7218,1,24,4,8,81,40,41,76
Montrose,7218,2,23,7,6,60,38,22,76
Stenhousem'r,7218,3,16,8,12,58,48,10,56
Stirling,7218,4,16,6,14,62,54,8,54
Clyde,7218,5,15,9,12,53,49,4,54
Elgin,7218,6,15,6,15,57,61,-4,51
Annan Athlet,7218,7,12,11,13,48,41,7,47
Berwick,7218,8,8,10,18,30,60,-30,34
Edinburgh Ci,7218,9,7,9,20,38,64,-26,30
Cowdenbeath,7218,10,4,10,22,23,55,-32,22
Montrose,7219,1,24,7,5,61,35,26,79
Peterhead,7219,2,24,4,8,79,38,41,76
Stenhousem'r,7219,3,16,8,12,57,47,10,56
Stirling,7219,4,16,6,14,61,53,8,54
Clyde,7219,5,14,9,13,52,50,2,51
Elgin,7219,6,14,6,16,54,62,-8,48
Annan Athlet,7219,7,11,12,13,48,42,6,45
Berwick,7219,8,9,10,17,31,59,-28,37
Edinburgh Ci,7219,9,7,9,20,36,62,-26,30
Cowdenbeath,7219,10,4,11,21,24,55,-31,23
Montrose,7220,1,24,7,5,61,34,27,79
Peterhead,7220,2,24,4,8,82,40,42,76
Stenhousem'r,7220,3,16,8,12,56,46,10,56
Stirling,7220,4,16,6,14,60,52,8,54
Clyde,7220,5,14,10,12,52,49,3,52
Elgin,7220,6,14,6,16,53,62,-9,48
Annan Athlet,7220,7,12,11,13,49,41,8,47
Berwick,7220,8,8,11,17,30,59,-29,35
Edinburgh Ci,7220,9,7,9,20,38,65,-27,30
Cowdenbeath,7220,10,4,10,22,23,56,-33,22
Montrose,7221,1,23,8,5,59,34,25,77
Peterhead,7221,2,24,4,8,79,38,41,76
Stirling,7221,3,17,6,13,61,51,10,57
Stenhousem'r,7221,4,15,8,13,55,47,8,53
Clyde,7221,5,14,10,12,52,49,3,52
Elgin,7221,6,14,7,15,53,60,-7,49
Annan Athlet,7221,7,12,11,13,49,41,8,47
Berwick,7221,8,8,11,17,30,59,-29,35
Edinburgh Ci,7221,9,7,9,20,36,62,-26,30
Cowdenbeath,7221,10,4,10,22,23,56,-33,22
Peterhead,7222,1,24,4,8,80,40,40,76
Montrose,7222,2,23,7,6,60,36,24,76
Stirling,7222,3,16,7,13,61,52,9,55
Stenhousem'r,7222,4,15,9,12,56,47,9,54
Clyde,7222,5,15,9,12,55,50,5,54
Elgin,7222,6,15,6,15,55,61,-6,51
Annan Athlet,7222,7,11,12,13,48,42,6,45
Berwick,7222,8,8,10,18,31,62,-31,34
Edinburgh Ci,7222,9,7,9,20,38,63,-25,30
Cowdenbeath,7222,10,4,11,21,24,55,-31,23
Montrose,7223,1,24,7,5,62,36,26,79
Peterhead,7223,2,24,4,8,80,38,42,76
Stenhousem'r,7223,3,16,8,12,58,47,11,56
Stirling,7223,4,16,6,14,61,54,7,54
Clyde,7223,5,15,9,12,52,48,4,54
Elgin,7223,6,14,6,16,55,63,-8,48
Annan Athlet,7223,7,11,11,14,47,42,5,44
Berwick,7223,8,8,10,18,29,59,-30,34
Edinburgh Ci,7223,9,7,9,20,36,63,-27,30
Cowdenbeath,7223,10,5,10,21,24,54,-30,25
Montrose,7224,1,23,7,6,59,39,20,76
Peterhead,7224,2,23,5,8,79,40,39,74
Stirling,7224,3,16,7,13,62,53,9,55
Stenhousem'r,7224,4,15,9,12,57,48,9,54
Clyde,7224,5,15,9,12,53,48,5,54
Elgin,7224,6,15,6,15,58,60,-2,51
Annan Athlet,7224,7,12,11,13,49,42,7,47
Berwick,7224,8,8,10,18,29,60,-31,34
Edinburgh Ci,7224,9,7,10,19,38,62,-24,31
Cowdenbeath,7224,10,4,10,22,24,56,-32,22
Montrose,7225,1,23,8,5,60,35,25,77
Peterhead,7225,2,23,5,8,77,38,39,74
Stirling,7225,3,17,6,13,62,51,11,57
Clyde,7225,4,15,9,12,53,48,5,54
Stenhousem'r,7225,5,15,8,13,55,48,7,53
Elgin,7225,6,14,7,15,54,61,-7,49
Annan Athlet,7225,7,12,11,13,48,41,7,47
Berwick,7225,8,8,10,18,29,60,-31,34
Edinburgh Ci,7225,9,7,10,19,36,60,-24,31
Cowdenbeath,7225,10,4,10,22,23,55,-32,22
Montrose,7226,1,24,7,5,65,35,30,79
Peterhead,7226,2,24,4,8,79,38,41,76
Stirling,7226,3,17,6,13,62,51,11,57
Stenhousem'r,7226,4,15,8,13,55,48,7,53
Clyde,7226,5,14,9,13,52,50,2,51
Elgin,7226,6,14,6,16,54,66,-12,48
Annan Athlet,7226,7,12,11,13,49,42,7,47
Berwick,7226,8,9,10,17,31,59,-28,37
Edinburgh Ci,7226,9,7,9,20,36,62,-26,30
Cowdenbeath,7226,10,4,10,22,24,56,-32,22
Montrose,7227,1,23,7,6,60,36,24,76
Peterhead,7227,2,23,4,9,77,39,38,73
Stirling,7227,3,16,7,13,62,53,9,55
Stenhousem'r,7227,4,15,9,12,57,48,9,54
Clyde,7227,5,15,9,12,56,49,7,54
Elgin,7227,6,15,6,15,55,61,-6,51
Annan Athlet,7227,7,11,11,14,47,42,5,44
Berwick,7227,8,8,10,18,30,63,-33,34
Edinburgh Ci,7227,9,8,9,19,37,60,-23,33
Cowdenbeath,7227,10,5,10,21,24,54,-30,25
Montrose,7228,1,24,7,5,62,36,26,79
Peterhead,7228,2,24,4,8,80,38,42,76
Stenhousem'r,7228,3,16,8,12,58,47,11,56
Stirling,7228,4,16,6,14,61,54,7,54
Clyde,7228,5,14,9,13,51,49,2,51
Elgin,7228,6,14,6,16,55,63,-8,48
Annan Athlet,7228,7,11,11,14,47,43,4,44
Berwick,7228,8,9,10,17,30,58,-28,37
Edinburgh Ci,7228,9,7,9,20,36,63,-27,30
Cowdenbeath,7228,10,5,10,21,25,54,-29,25
Peterhead,7229,1,24,4,8,81,38,43,76
Montrose,7229,2,23,7,6,60,36,24,76
Stirling,7229,3,17,6,13,62,51,11,57
Stenhousem'r,7229,4,15,8,13,55,48,7,53
Clyde,7229,5,14,9,13,52,50,2,51
Elgin,7229,6,15,6,15,55,61,-6,51
Annan Athlet,7229,7,11,11,14,48,43,5,44
Berwick,7229,8,9,10,17,31,59,-28,37
Edinburgh Ci,7229,9,7,9,20,36,64,-28,30
Cowdenbeath,7229,10,5,10,21,25,55,-30,25
Montrose,7230,1,24,7,5,63,34,29,79
Peterhead,7230,2,23,5,8,79,40,39,74
Stenhousem'r,7230,3,16,8,12,57,47,10,56
Stirling,7230,4,16,6,14,61,53,8,54
Clyde,7230,5,15,9,12,53,49,4,54
Elgin,7230,6,14,6,16,53,64,-11,48
Annan Athlet,7230,7,12,11,13,48,41,7,47
Berwick,7230,8,8,10,18,30,60,-30,34
Edinburgh Ci,7230,9,7,10,19,38,62,-24,31
Cowdenbeath,7230,10,4,10,22,23,55,-32,22
Montrose,7231,1,23,8,5,61,36,25,77
Peterhead,7231,2,23,5,8,78,39,39,74
Stirling,7231,3,16,7,13,61,52,9,55
Stenhousem'r,7231,4,15,9,12,56,47,9,54
Clyde,7231,5,15,9,12,54,49,5,54
Elgin,7231,6,14,7,15,55,62,-7,49
Annan Athlet,7231,7,11,11,14,47,44,3,44
Berwick,7231,8,8,10,18,30,61,-31,34
Edinburgh Ci,7231,9,7,10,19,37,61,-24,31
Cowdenbeath,7231,10,5,10,21,26,54,-28,25
Montrose,7232,1,24,7,5,62,35,27,79
Peterhead,7232,2,23,5,8,77,38,39,74
Stenhousem'r,7232,3,16,8,12,59,47,12,56
Stirling,7232,4,16,6,14,61,55,6,54
Clyde,7232,5,15,9,12,54,50,4,54
Elgin,7232,6,14,6,16,54,63,-9,48
Annan Athlet,7232,7,11,12,13,47,41,6,45
Berwick,7232,8,8,10,18,31,61,-30,34
Edinburgh Ci,7232,9,7,10,19,36,60,-24,31
Cowdenbeath,7232,10,4,11,21,23,54,-31,23
Montrose,7233,1,24,7,5,60,34,26,79
Peterhead,7233,2,23,5,8,80,41,39,74
Stirling,7233,3,17,6,13,63,52,11,57
Stenhousem'r,7233,4,15,8,13,56,49,7,53
Clyde,7233,5,14,10,12,53,50,3,52
Elgin,7233,6,14,6,16,53,61,-8,48
Annan Athlet,7233,7,11,12,13,48,42,6,45
Berwick,7233,8,8,11,17,31,60,-29,35
Edinburgh Ci,7233,9,7,10,19,39,63,-24,31
Cowdenbeath,7233,10,4,11,21,24,55,-31,23
Montrose,7234,1,23,8,5,62,37,25,77
Peterhead,7234,2,24,4,8,81,39,42,76
Stirling,7234,3,17,6,13,64,53,11,57
Stenhousem'r,7234,4,15,8,13,57,50,7,53
Clyde,7234,5,14,10,12,52,49,3,52
Elgin,7234,6,14,7,15,56,63,-7,49
Annan Athlet,7234,7,11,12,13,48,42,6,45
Berwick,7234,8,8,11,17,30,59,-29,35
Edinburgh Ci,7234,9,7,9,20,37,64,-27,30
Cowdenbeath,7234,10,4,11,21,24,55,-31,23
Montrose,7235,1,23,7,6,59,35,24,76
Peterhead,7235,2,23,4,9,78,40,38,73
Stirling,7235,3,17,6,13,62,51,11,57
Clyde,7235,4,15,9,12,53,48,5,54
Stenhousem'r,7235,5,15,8,13,55,48,7,53
Elgin,7235,6,15,6,15,54,60,-6,51
Annan Athlet,7235,7,11,11,14,47,44,3,44
Berwick,7235,8,8,10,18,29,60,-31,34
Edinburgh Ci,7235,9,8,9,19,38,61,-23,33
Cowdenbeath,7235,10,5,10,21,26,54,-28,25
Montrose,7236,1,24,7,5,62,34,28,79
Peterhead,7236,2,23,5,8,78,39,39,74
Stirling,7236,3,17,6,13,62,51,11,57
Stenhousem'r,7236,4,15,8,13,55,48,7,53
Clyde,7236,5,14,10,12,52,49,3,52
Elgin,7236,6,14,6,16,53,63,-10,48
Annan Athlet,7236,7,11,11,14,47,42,5,44
Berwick,7236,8,8,11,17,30,59,-29,35
Edinburgh Ci,7236,9,7,10,19,37,61,-24,31
Cowdenbeath,7236,10,5,10,21,24,54,-30,25
Montrose,7237,1,23,8,5,59,34,25,77
Peterhead,7237,2,24,4,8,81,40,41,76
Stirling,7237,3,17,6,13,63,52,11,57
Stenhousem'r,7237,4,15,8,13,56,49,7,53
Clyde,7237,5,14,9,13,51,49,2,51
Elgin,7237,6,14,7,15,53,60,-7,49
Annan Athlet,7237,7,12,11,13,49,42,7,47
Berwick,7237,8,9,10,17,30,58,-28,37
Edinburgh Ci,7237,9,7,9,20,38,64,-26,30
Cowdenbeath,7237,10,4,10,22,24,56,-32,22
Montrose,7238,1,24,7,5,61,34,27,79
Peterhead,7238,2,24,4,8,79,38,41,76
Stirling,7238,3,16,7,13,61,52,9,55
Stenhousem'r,7238,4,15,9,12,56,47,9,54
Clyde,7238,5,15,9,12,53,48,5,54
Elgin,7238,6,14,6,16,53,62,-9,48
Annan Athlet,7238,7,11,11,14,47,43,4,44
Berwick,7238,8,8,10,18,29,60,-31,34
Edinburgh Ci,7238,9,7,9,20,36,62,-26,30
Cowdenbeath,7238,10,5,10,21,25,54,-29,25
Montrose,7239,1,23,8,5,60,35,25,77
Peterhead,7239,2,23,5,8,79,40,39,74
Stirling,7239,3,17,6,13,64,51,13,57
Stenhousem'r,7239,4,15,8,13,55,50,5,53
Clyde,7239,5,14,10,12,54,51,3,52
Elgin,7239,6,14,7,15,54,61,-7,49
Annan Athlet,7239,7,11,11,14,47,43,4,44
Berwick,7239,8,8,11,17,32,61,-29,35
Edinburgh Ci,7239,9,7,10,19,38,62,-24,31
Cowdenbeath,7239,10,5,10,21,25,54,-29,25
Montrose,7240,1,24,7,5,60,34,26,79
Peterhead,7240,2,24,4,8,79,38,41,76
Stirling,7240,3,16,7,13,61,52,9,55
Stenhousem'r,7240,4,15,9,12,56,47,9,54
Clyde,7240,5,15,9,12,53,48,5,54
Elgin,7240,6,14,6,16,53,61,-8,48
Annan Athlet,7240,7,12,11,13,48,41,7,47
Berwick,7240,8,8,10,18,29,60,-31,34
Edinburgh Ci,7240,9,7,9,20,36,62,-26,30
Cowdenbeath,7240,10,4,10,22,23,55,-32,22
Peterhead,7241,1,24,4,8,82,40,42,76
Montrose,7241,2,23,7,6,60,36,24,76
Stirling,7241,3,17,6,13,64,52,12,57
Clyde,7241,4,15,9,12,53,49,4,54
Stenhousem'r,7241,5,15,8,13,56,50,6,53
Elgin,7241,6,15,6,15,55,61,-6,51
Annan Athlet,7241,7,12,11,13,52,41,11,47
Berwick,7241,8,8,10,18,30,60,-30,34
Edinburgh Ci,7241,9,7,9,20,38,65,-27,30
Cowdenbeath,7241,10,4,10,22,23,59,-36,22
Peterhead,7242,1,24,4,8,81,39,42,76
Montrose,7242,2,23,7,6,60,36,24,76
Stirling,7242,3,17,6,13,66,51,15,57
Clyde,7242,4,15,9,12,54,49,5,54
Stenhousem'r,7242,5,15,8,13,55,52,3,53
Elgin,7242,6,15,6,15,55,61,-6,51
Annan Athlet,7242,7,11,12,13,48,42,6,45
Berwick,7242,8,8,10,18,30,61,-31,34
Edinburgh Ci,7242,9,7,9,20,37,64,-27,30
Cowdenbeath,7242,10,4,11,21,24,55,-31,23
Montrose,7243,1,24,7,5,61,34,27,79
Peterhead,7243,2,24,4,8,79,38,41,76
Stirling,7243,3,16,7,13,64,55,9,55
Stenhousem'r,7243,4,15,9,12,59,50,9,54
Clyde,7243,5,15,9,12,54,48,6,54
Elgin,7243,6,14,6,16,53,62,-9,48
Annan Athlet,7243,7,11,12,13,49,43,6,45
Berwick,7243,8,8,10,18,29,61,-32,34
Edinburgh Ci,7243,9,7,9,20,36,62,-26,30
Cowdenbeath,7243,10,4,11,21,25,56,-31,23
Peterhead,7244,1,24,4,8,79,39,40,76
Montrose,7244,2,23,7,6,60,36,24,76
Stenhousem'r,7244,3,16,8,12,57,46,11,56
Stirling,7244,4,16,6,14,60,53,7,54
Clyde,7244,5,15,9,12,54,48,6,54
Elgin,7244,6,15,6,15,55,61,-6,51
Annan Athlet,7244,7,12,11,13,50,41,9,47
Berwick,7244,8,8,10,18,29,61,-32,34
Edinburgh Ci,7244,9,7,9,20,37,62,-25,30
Cowdenbeath,7244,10,4,10,22,23,57,-34,22
Montrose,7245,1,23,7,6,60,37,23,76
Peterhead,7245,2,23,5,8,78,39,39,74
Stirling,7245,3,17,6,13,61,51,10,57
Clyde,7245,4,15,9,12,53,48,5,54
Stenhousem'r,7245,5,15,8,13,55,47,8,53
Elgin,7245,6,15,6,15,56,61,-5,51
Annan Athlet,7245,7,11,12,13,47,41,6,45
Berwick,7245,8,8,10,18,29,60,-31,34
Edinburgh Ci,7245,9,7,10,19,37,61,-24,31
Cowdenbeath,7245,10,4,11,21,23,54,-31,23
Montrose,7246,1,24,7,5,63,34,29,79
Peterhead,7246,2,24,4,8,80,39,41,76
Stirling,7246,3,16,7,13,61,52,9,55
Stenhousem'r,7246,4,15,9,12,56,47,9,54
Clyde,7246,5,15,9,12,55,50,5,54
Elgin,7246,6,14,6,16,53,64,-11,48
Annan Athlet,7246,7,12,11,13,48,41,7,47
Berwick,7246,8,8,10,18,31,62,-31,34
Edinburgh Ci,7246,9,7,9,20,37,63,-26,30
Cowdenbeath,7246,10,4,10,22,23,55,-32,22
Montrose,7247,1,23,8,5,60,35,25,77
Peterhead,7247,2,24,4,8,85,38,47,76
Stenhousem'r,7247,3,16,8,12,56,46,10,56
Stirling,7247,4,16,6,14,60,52,8,54
Clyde,7247,5,14,9,13,51,50,1,51
Elgin,7247,6,14,7,15,54,61,-7,49
Annan Athlet,7247,7,12,11,13,49,42,7,47
Berwick,7247,8,9,10,17,31,58,-27,37
Edinburgh Ci,7247,9,7,9,20,36,68,-32,30
Cowdenbeath,7247,10,4,10,22,24,56,-32,22
Montrose,7248,1,24,7,5,62,36,26,79
Peterhead,7248,2,23,5,8,80,41,39,74
Stirling,7248,3,17,6,13,62,51,11,57
Stenhousem'r,7248,4,15,8,13,55,48,7,53
Clyde,7248,5,14,10,12,53,50,3,52
Elgin,7248,6,14,6,16,55,63,-8,48
Annan Athlet,7248,7,11,12,13,48,42,6,45
Berwick,7248,8,8,11,17,31,60,-29,35
Edinburgh Ci,7248,9,7,10,19,39,63,-24,31
Cowdenbeath,7248,10,4,11,21,24,55,-31,23
Montrose,7249,1,24,7,5,62,35,27,79
Peterhead,7249,2,23,5,8,79,40,39,74
Stenhousem'r,7249,3,16,8,12,57,47,10,56
Stirling,7249,4,16,6,14,61,53,8,54
Clyde,7249,5,15,9,12,53,49,4,54
Elgin,7249,6,14,6,16,54,63,-9,48
Annan Athlet,7249,7,11,11,14,47,43,4,44
Berwick,7249,8,8,10,18,30,60,-30,34
Edinburgh Ci,7249,9,7,10,19,38,62,-24,31
Cowdenbeath,7249,10,5,10,21,25,54,-29,25
Montrose,7250,1,23,7,6,59,37,22,76
Peterhead,7250,2,23,4,9,79,41,38,73
Stenhousem'r,7250,3,16,8,12,56,46,10,56
Stirling,7250,4,16,6,14,60,52,8,54
Clyde,7250,5,14,10,12,52,49,3,52
Elgin,7250,6,15,6,15,56,60,-4,51
Annan Athlet,7250,7,12,11,13,49,41,8,47
Berwick,7250,8,8,11,17,30,59,-29,35
Edinburgh Ci,7250,9,8,9,19,39,62,-23,33
Cowdenbeath,7250,10,4,10,22,23,56,-33,22
Montrose,7251,1,24,7,5,62,35,27,79
Peterhead,7251,2,24,4,8,79,38,41,76
Stirling,7251,3,17,6,13,62,51,11,57
Clyde,7251,4,15,9,12,52,48,4,54
Stenhousem'r,7251,5,15,8,13,55,48,7,53
Elgin,7251,6,14,6,16,54,63,-9,48
Annan Athlet,7251,7,12,11,13,50,42,8,47
Berwick,7251,8,8,10,18,29,59,-30,34
Edinburgh Ci,7251,9,7,9,20,36,62,-26,30
Cowdenbeath,7251,10,4,10,22,24,57,-33,22
Montrose,7252,1,23,8,5,60,35,25,77
Peterhead,7252,2,23,5,8,77,38,39,74
Stirling,7252,3,16,7,13,60,51,9,55
Stenhousem'r,7252,4,15,9,12,55,46,9,54
Clyde,7252,5,15,9,12,55,49,6,54
Elgin,7252,6,14,7,15,54,61,-7,49
Annan Athlet,7252,7,11,12,13,47,41,6,45
Berwick,7252,8,8,10,18,30,62,-32,34
Edinburgh Ci,7252,9,7,10,19,36,60,-24,31
Cowdenbeath,7252,10,4,11,21,23,54,-31,23
Montrose,7253,1,24,7,5,62,36,26,79
Peterhead,7253,2,23,5,8,78,39,39,74
Stirling,7253,3,17,6,13,64,53,11,57
Clyde,7253,4,15,9,12,53,49,4,54
Stenhousem'r,7253,5,15,8,13,57,50,7,53
Elgin,7253,6,14,6,16,55,63,-8,48
Annan Athlet,7253,7,12,11,13,51,43,8,47
Berwick,7253,8,8,10,18,30,60,-30,34
Edinburgh Ci,7253,9,7,10,19,37,61,-24,31
Cowdenbeath,7253,10,4,10,22,25,58,-33,22
Montrose,7254,1,24,7,5,62,36,26,79
Peterhead,7254,2,24,4,8,81,40,41,76
Stenhousem'r,7254,3,16,8,12,60,46,14,56
Stirling,7254,4,16,6,14,60,56,4,54
Clyde,7254,5,14,10,12,53,50,3,52
Elgin,7254,6,14,6,16,55,63,-8,48
Annan Athlet,7254,7,11,12,13,49,43,6,45
Berwick,7254,8,8,11,17,31,60,-29,35
Edinburgh Ci,7254,9,7,9,20,38,64,-26,30
Cowdenbeath,7254,10,4,11,21,25,56,-31,23
Montrose,7255,1,24,7,5,60,34,26,79
Peterhead,7255,2,23,5,8,79,40,39,74
Stirling,7255,3,17,6,13,63,51,12,57
Stenhousem'r,7255,4,15,8,13,55,49,6,53
Clyde,7255,5,14,9,13,51,50,1,51
Elgin,7255,6,14,6,16,53,61,-8,48
Annan Athlet,7255,7,11,11,14,48,43,5,44
Berwick,7255,8,9,10,17,31,58,-27,37
Edinburgh Ci,7255,9,7,10,19,38,62,-24,31
Cowdenbeath,7255,10,5,10,21,25,55,-30,25
Montrose,7256,1,23,8,5,61,36,25,77
Peterhead,7256,2,24,4,8,78,38,40,76
Stenhousem'r,7256,3,16,8,12,57,47,10,56
Stirling,7256,4,16,6,14,61,53,8,54
Clyde,7256,5,14,10,12,52,49,3,52
Elgin,7256,6,14,7,15,55,62,-7,49
Annan Athlet,7256,7,12,11,13,49,41,8,47
Berwick,7256,8,8,11,17,30,59,-29,35
Edinburgh Ci,7256,9,7,9,20,36,61,-25,30
Cowdenbeath,7256,10,4,10,22,23,56,-33,22
Peterhead,7257,1,24,4,8,82,38,44,76
Montrose,7257,2,23,7,6,59,37,22,76
Stenhousem'r,7257,3,16,8,12,56,46,10,56
Stirling,7257,4,16,6,14,60,52,8,54
Clyde,7257,5,14,10,12,51,48,3,52
Elgin,7257,6,15,6,15,56,60,-4,51
Annan Athlet,7257,7,12,11,13,48,41,7,47
Berwick,7257,8,8,11,17,29,58,-29,35
Edinburgh Ci,7257,9,7,9,20,36,65,-29,30
Cowdenbeath,7257,10,4,10,22,23,55,-32,22
Peterhead,7258,1,24,4,8,80,39,41,76
Montrose,7258,2,23,7,6,59,36,23,76
Stirling,7258,3,16,7,13,61,52,9,55
Stenhousem'r,7258,4,15,9,12,56,47,9,54
Clyde,7258,5,14,9,13,52,50,2,51
Elgin,7258,6,15,6,15,55,60,-5,51
Annan Athlet,7258,7,11,11,14,47,42,5,44
Berwick,7258,8,9,10,17,31,59,-28,37
Edinburgh Ci,7258,9,7,9,20,37,63,-26,30
Cowdenbeath,7258,10,5,10,21,24,54,-30,25
Montrose,7259,1,24,7,5,62,35,27,79
Peterhead,7259,2,23,5,8,78,39,39,74
Stirling,7259,3,16,7,13,61,52,9,55
Stenhousem'r,7259,4,15,9,12,56,47,9,54
Clyde,7259,5,15,9,12,54,50,4,54
Elgin,7259,6,14,6,16,54,63,-9,48
Annan Athlet,7259,7,11,12,13,48,42,6,45
Berwick,7259,8,8,10,18,31,61,-30,34
Edinburgh Ci,7259,9,7,10,19,37,61,-24,31
Cowdenbeath,7259,10,4,11,21,24,55,-31,23
Montrose,7260,1,24,7,5,60,34,26,79
Peterhead,7260,2,24,4,8,83,38,45,76
Stirling,7260,3,17,6,13,62,51,11,57
Clyde,7260,4,15,9,12,53,48,5,54
Stenhousem'r,7260,5,15,8,13,55,48,7,53
Elgin,7260,6,14,6,16,53,61,-8,48
Annan Athlet,7260,7,12,11,13,50,42,8,47
Berwick,7260,8,8,10,18,29,60,-31,34
Edinburgh Ci,7260,9,7,9,20,36,66,-30,30
Cowdenbeath,7260,10,4,10,22,24,57,-33,22
Montrose,7261,1,24,7,5,60,34,26,79
Peterhead,7261,2,23,4,9,78,40,38,73
Stenhousem'r,7261,3,16,8,12,57,47,10,56
Stirling,7261,4,16,6,14,61,53,8,54
Clyde,7261,5,15,9,12,53,48,5,54
Elgin,7261,6,14,6,16,53,61,-8,48
Annan Athlet,7261,7,11,11,14,47,42,5,44
Berwick,7261,8,8,10,18,29,60,-31,34
Edinburgh Ci,7261,9,8,9,19,38,61,-23,33
Cowdenbeath,7261,10,5,10,21,24,54,-30,25
Montrose,7262,1,24,7,5,62,34,28,79
Peterhead,7262,2,24,4,8,80,38,42,76
Stirling,7262,3,16,7,13,63,54,9,55
Stenhousem'r,7262,4,15,9,12,58,49,9,54
Clyde,7262,5,15,9,12,52,48,4,54
Elgin,7262,6,14,6,16,53,63,-10,48
Annan Athlet,7262,7,11,11,14,47,43,4,44
Berwick,7262,8,8,10,18,29,59,-30,34
Edinburgh Ci,7262,9,7,9,20,36,63,-27,30
Cowdenbeath,7262,10,5,10,21,25,54,-29,25
Montrose,7263,1,24,7,5,63,34,29,79
Peterhead,7263,2,23,5,8,80,41,39,74
Stirling,7263,3,17,6,13,61,51,10,57
Clyde,7263,4,15,9,12,53,48,5,54
Stenhousem'r,7263,5,15,8,13,55,47,8,53
Elgin,7263,6,14,6,16,53,64,-11,48
Annan Athlet,7263,7,12,11,13,52,42,10,47
Berwick,7263,8,8,10,18,29,60,-31,34
Edinburgh Ci,7263,9,7,10,19,39,63,-24,31
Cowdenbeath,7263,10,4,10,22,24,59,-35,22
Montrose,7264,1,24,7,5,60,34,26,79
Peterhead,7264,2,24,4,8,82,39,43,76
Stirling,7264,3,17,6,13,61,51,10,57
Clyde,7264,4,15,9,12,56,49,7,54
Stenhousem'r,7264,5,15,8,13,55,47,8,53
Elgin,7264,6,14,6,16,53,61,-8,48
Annan Athlet,7264,7,11,11,14,47,42,5,44
Berwick,7264,8,8,10,18,30,63,-33,34
Edinburgh Ci,7264,9,7,9,20,37,65,-28,30
Cowdenbeath,7264,10,5,10,21,24,54,-30,25
Peterhead,7265,1,24,4,8,80,38,42,76
Montrose,7265,2,23,7,6,60,37,23,76
Stirling,7265,3,17,6,13,61,51,10,57
Stenhousem'r,7265,4,15,8,13,55,47,8,53
Clyde,7265,5,14,10,12,52,49,3,52
Elgin,7265,6,15,6,15,56,61,-5,51
Annan Athlet,7265,7,11,11,14,47,45,2,44
Berwick,7265,8,8,11,17,30,59,-29,35
Edinburgh Ci,7265,9,7,9,20,36,63,-27,30
Cowdenbeath,7265,10,5,10,21,27,54,-27,25
Montrose,7266,1,24,7,5,60,34,26,79
Peterhead,7266,2,24,4,8,78,38,40,76
Stirling,7266,3,17,6,13,62,52,10,57
Clyde,7266,4,15,9,12,55,49,6,54
Stenhousem'r,7266,5,15,8,13,56,48,8,53
Elgin,7266,6,14,6,16,53,61,-8,48
Annan Athlet,7266,7,12,11,13,50,41,9,47
Berwick,7266,8,8,10,18,30,62,-32,34
Edinburgh Ci,7266,9,7,9,20,36,61,-25,30
Cowdenbeath,7266,10,4,10,22,23,57,-34,22
Peterhead,7267,1,24,4,8,82,38,44,76
Montrose,7267,2,23,7,6,59,35,24,76
Stirling,7267,3,17,6,13,62,52,10,57
Clyde,7267,4,15,9,12,53,49,4,54
Stenhousem'r,7267,5,15,8,13,56,48,8,53
Elgin,7267,6,15,6,15,54,60,-6,51
Annan Athlet,7267,7,12,11,13,48,41,7,47
Berwick,7267,8,8,10,18,30,60,-30,34
Edinburgh Ci,7267,9,7,9,20,36,65,-29,30
Cowdenbeath,7267,10,4,10,22,23,55,-32,22
Montrose,7268,1,24,7,5,64,36,28,79
Peterhead,7268,2,23,5,8,77,38,39,74
Stirling,7268,3,17,6,13,63,51,12,57
Stenhousem'r,7268,4,15,8,13,55,49,6,53
Clyde,7268,5,14,9,13,51,50,1,51
Elgin,7268,6,14,6,16,55,65,-10,48
Annan Athlet,7268,7,11,11,14,47,43,4,44
Berwick,7268,8,9,10,17,31,58,-27,37
Edinburgh Ci,7268,9,7,10,19,36,60,-24,31
Cowdenbeath,7268,10,5,10,21,25,54,-29,25
Montrose,7269,1,24,7,5,61,34,27,79
Peterhead,7269,2,24,4,8,80,38,42,76
Stenhousem'r,7269,3,16,8,12,56,46,10,56
Stirling,7269,4,16,6,14,60,52,8,54
Clyde,7269,5,14,9,13,52,50,2,51
Elgin,7269,6,14,6,16,53,62,-9,48
Annan Athlet,7269,7,12,11,13,48,41,7,47
Berwick,7269,8,9,10,17,31,59,-28,37
Edinburgh Ci,7269,9,7,9,20,36,63,-27,30
Cowdenbeath,7269,10,4,10,22,23,55,-32,22
Montrose,7270,1,24,7,5,64,36,28,79
Peterhead,7270,2,24,4,8,80,39,41,76
Stirling,7270,3,17,6,13,65,52,13,57
Clyde,7270,4,15,9,12,52,48,4,54
Stenhousem'r,7270,5,15,8,13,56,51,5,53
Elgin,7270,6,14,6,16,55,65,-10,48
Annan Athlet,7270,7,12,11,13,48,41,7,47
Berwick,7270,8,8,10,18,29,59,-30,34
Edinburgh Ci,7270,9,7,9,20,37,63,-26,30
Cowdenbeath,7270,10,4,10,22,23,55,-32,22
Montrose,7271,1,24,7,5,60,34,26,79
Peterhead,7271,2,24,4,8,79,39,40,76
Stenhousem'r,7271,3,16,8,12,57,47,10,56
Stirling,7271,4,16,6,14,61,53,8,54
Clyde,7271,5,15,9,12,55,48,7,54
Elgin,7271,6,14,6,16,53,61,-8,48
Annan Athlet,7271,7,12,11,13,49,42,7,47
Berwick,7271,8,8,10,18,29,62,-33,34
Edinburgh Ci,7271,9,7,9,20,37,62,-25,30
Cowdenbeath,7271,10,4,10,22,24,56,-32,22
Montrose,7272,1,24,7,5,60,34,26,79
Peterhead,7272,2,24,4,8,82,39,43,76
Stirling,7272,3,16,7,13,60,51,9,55
Stenhousem'r,7272,4,15,9,12,55,46,9,54
Clyde,7272,5,14,10,12,53,50,3,52
Elgin,7272,6,14,6,16,53,61,-8,48
Annan Athlet,7272,7,11,12,13,49,43,6,45
Berwick,7272,8,8,11,17,31,60,-29,35
Edinburgh Ci,7272,9,7,9,20,37,65,-28,30
Cowdenbeath,7272,10,4,11,21,25,56,-31,23
Montrose,7273,1,24,7,5,60,34,26,79
Peterhead,7273,2,24,4,8,80,39,41,76
Stirling,7273,3,17,6,13,63,52,11,57
Clyde,7273,4,15,9,12,53,48,5,54
Stenhousem'r,7273,5,15,8,13,56,49,7,53
Elgin,7273,6,14,6,16,53,61,-8,48
Annan Athlet,7273,7,12,11,13,51,42,9,47
Berwick,7273,8,8,10,18,29,60,-31,34
Edinburgh Ci,7273,9,7,9,20,37,63,-26,30
Cowdenbeath,7273,10,4,10,22,24,58,-34,22
Montrose,7274,1,23,8,5,61,36,25,77
Peterhead,7274,2,23,5,8,78,39,39,74
Stirling,7274,3,17,6,13,63,53,10,57
Stenhousem'r,7274,4,15,8,13,57,49,8,53
Clyde,7274,5,14,9,13,51,49,2,51
Elgin,7274,6,14,7,15,55,62,-7,49
Annan Athlet,7274,7,12,11,13,49,41,8,47
Berwick,7274,8,9,10,17,30,58,-28,37
Edinburgh Ci,7274,9,7,10,19,37,61,-24,31
Cowdenbeath,7274,10,4,10,22,23,56,-33,22
Peterhead,7275,1,24,4,8,81,38,43,76
Montrose,7275,2,23,7,6,59,35,24,76
Stirling,7275,3,17,6,13,63,51,12,57
Clyde,7275,4,15,9,12,53,49,4,54
Stenhousem'r,7275,5,15,8,13,55,49,6,53
Elgin,7275,6,15,6,15,54,60,-6,51
Annan Athlet,7275,7,11,12,13,47,41,6,45
Berwick,7275,8,8,10,18,30,60,-30,34
Edinburgh Ci,7275,9,7,9,20,36,64,-28,30
Cowdenbeath,7275,10,4,11,21,23,54,-31,23
Peterhead,7276,1,24,4,8,79,38,41,76
Montrose,7276,2,23,7,6,59,35,24,76
Stirling,7276,3,17,6,13,64,52,12,57
Stenhousem'r,7276,4,15,8,13,56,50,6,53
Clyde,7276,5,14,9,13,51,50,1,51
Elgin,7276,6,15,6,15,54,60,-6,51
Annan Athlet,7276,7,11,11,14,48,43,5,44
Berwick,7276,8,9,10,17,31,58,-27,37
Edinburgh Ci,7276,9,7,9,20,36,62,-26,30
Cowdenbeath,7276,10,5,10,21,25,55,-30,25
Montrose,7277,1,23,8,5,61,36,25,77
Peterhead,7277,2,24,4,8,80,38,42,76
Stenhousem'r,7277,3,16,8,12,57,46,11,56
Stirling,7277,4,16,6,14,60,53,7,54
Clyde,7277,5,14,10,12,52,49,3,52
Elgin,7277,6,14,7,15,55,62,-7,49
Annan Athlet,7277,7,11,11,14,47,42,5,44
Berwick,7277,8,8,11,17,30,59,-29,35
Edinburgh Ci,7277,9,7,9,20,36,63,-27,30
Cowdenbeath,7277,10,5,10,21,24,54,-30,25
Montrose,7278,1,24,7,5,61,34,27,79
Peterhead,7278,2,24,4,8,79,39,40,76
Stenhousem'r,7278,3,16,8,12,57,46,11,56
Stirling,7278,4,16,6,14,60,53,7,54
Clyde,7278,5,15,9,12,53,48,5,54
Elgin,7278,6,14,6,16,53,62,-9,48
Annan Athlet,7278,7,12,11,13,50,43,7,47
Berwick,7278,8,8,10,18,29,60,-31,34
Edinburgh Ci,7278,9,7,9,20,37,62,-25,30
Cowdenbeath,7278,10,4,10,22,25,57,-32,22
Montrose,7279,1,24,7,5,63,34,29,79
Peterhead,7279,2,24,4,8,80,38,42,76
Stenhousem'r,7279,3,16,8,12,59,48,11,56
Stirling,7279,4,16,6,14,62,55,7,54
Clyde,7279,5,15,9,12,54,50,4,54
Elgin,7279,6,14,6,16,53,64,-11,48
Annan Athlet,7279,7,12,11,13,50,41,9,47
Berwick,7279,8,8,10,18,31,61,-30,34
Edinburgh Ci,7279,9,7,9,20,36,63,-27,30
Cowdenbeath,7279,10,4,10,22,23,57,-34,22
Montrose,7280,1,24,7,5,62,35,27,79
Peterhead,7280,2,24,4,8,83,39,44,76
Stirling,7280,3,16,7,13,61,52,9,55
Stenhousem'r,7280,4,15,9,12,56,47,9,54
Clyde,7280,5,15,9,12,54,48,6,54
Elgin,7280,6,14,6,16,54,63,-9,48
Annan Athlet,7280,7,11,11,14,47,45,2,44
Berwick,7280,8,8,10,18,29,61,-32,34
Edinburgh Ci,7280,9,7,9,20,37,66,-29,30
Cowdenbeath,7280,10,5,10,21,27,54,-27,25
Montrose,7281,1,23,8,5,61,36,25,77
Peterhead,7281,2,23,4,9,78,40,38,73
Stirling,7281,3,16,7,13,60,51,9,55
Stenhousem'r,7281,4,15,9,12,55,46,9,54
Clyde,7281,5,15,9,12,54,49,5,54
Elgin,7281,6,14,7,15,55,62,-7,49
Annan Athlet,7281,7,11,12,13,48,42,6,45
Berwick,7281,8,8,10,18,30,61,-31,34
Edinburgh Ci,7281,9,8,9,19,38,61,-23,33
Cowdenbeath,7281,10,4,11,21,24,55,-31,23
Montrose,7282,1,23,8,5,60,35,25,77
Peterhead,7282,2,24,4,8,80,38,42,76
Stenhousem'r,7282,3,16,8,12,58,47,11,56
Stirling,7282,4,16,6,14,61,54,7,54
Clyde,7282,5,14,10,12,52,49,3,52
Elgin,7282,6,14,7,15,54,61,-7,49
Annan Athlet,7282,7,12,11,13,49,42,7,47
Berwick,7282,8,8,11,17,30,59,-29,35
Edinburgh Ci,7282,9,7,9,20,36,63,-27,30
Cowdenbeath,7282,10,4,10,22,24,56,-32,22
Montrose,7283,1,24,7,5,62,34,28,79
Peterhead,7283,2,24,4,8,79,38,41,76
Stirling,7283,3,16,7,13,62,53,9,55
Stenhousem'r,7283,4,15,9,12,57,48,9,54
Clyde,7283,5,15,9,12,54,49,5,54
Elgin,7283,6,14,6,16,53,63,-10,48
Annan Athlet,7283,7,12,11,13,48,41,7,47
Berwick,7283,8,8,10,18,30,61,-31,34
Edinburgh Ci,7283,9,7,9,20,36,62,-26,30
Cowdenbeath,7283,10,4,10,22,23,55,-32,22
Montrose,7284,1,24,7,5,63,36,27,79
Peterhead,7284,2,24,4,8,79,39,40,76
Stirling,7284,3,16,7,13,61,52,9,55
Stenhousem'r,7284,4,15,9,12,56,47,9,54
Clyde,7284,5,14,10,12,52,49,3,52
Elgin,7284,6,14,6,16,55,64,-9,48
Annan Athlet,7284,7,11,11,14,48,43,5,44
Berwick,7284,8,8,11,17,30,59,-29,35
Edinburgh Ci,7284,9,7,9,20,37,62,-25,30
Cowdenbeath,7284,10,5,10,21,25,55,-30,25
Montrose,7285,1,23,7,6,59,36,23,76
Peterhead,7285,2,23,5,8,80,41,39,74
Stirling,7285,3,17,6,13,62,51,11,57
Clyde,7285,4,15,9,12,56,49,7,54
Stenhousem'r,7285,5,15,8,13,55,48,7,53
Elgin,7285,6,15,6,15,55,60,-5,51
Annan Athlet,7285,7,11,11,14,47,43,4,44
Berwick,7285,8,8,10,18,30,63,-33,34
Edinburgh Ci,7285,9,7,10,19,39,63,-24,31
Cowdenbeath,7285,10,5,10,21,25,54,-29,25
Montrose,7286,1,23,8,5,59,34,25,77
Peterhead,7286,2,24,4,8,80,39,41,76
Stenhousem'r,7286,3,16,8,12,58,47,11,56
Stirling,7286,4,16,6,14,61,54,7,54
Clyde,7286,5,15,9,12,54,48,6,54
Elgin,7286,6,14,7,15,53,60,-7,49
Annan Athlet,7286,7,12,11,13,48,41,7,47
Berwick,7286,8,8,10,18,29,61,-32,34
Edinburgh Ci,7286,9,7,9,20,37,63,-26,30
Cowdenbeath,7286,10,4,10,22,23,55,-32,22
Montrose,7287,1,24,7,5,62,34,28,79
Peterhead,7287,2,24,4,8,78,38,40,76
Stenhousem'r,7287,3,16,8,12,57,46,11,56
Stirling,7287,4,16,6,14,60,53,7,54
Clyde,7287,5,15,9,12,54,49,5,54
Elgin,7287,6,14,6,16,53,63,-10,48
Annan Athlet,7287,7,12,11,13,49,42,7,47
Berwick,7287,8,8,10,18,30,61,-31,34
Edinburgh Ci,7287,9,7,9,20,36,61,-25,30
Cowdenbeath,7287,10,4,10,22,24,56,-32,22
Peterhead,7288,1,24,4,8,79,39,40,76
Montrose,7288,2,23,7,6,59,35,24,76
Stirling,7288,3,16,7,13,61,52,9,55
Stenhousem'r,7288,4,15,9,12,56,47,9,54
Clyde,7288,5,14,9,13,51,49,2,51
Elgin,7288,6,15,6,15,54,60,-6,51
Annan Athlet,7288,7,11,12,13,48,42,6,45
Berwick,7288,8,9,10,17,30,58,-28,37
Edinburgh Ci,7288,9,7,9,20,37,62,-25,30
Cowdenbeath,7288,10,4,11,21,24,55,-31,23
Montrose,7289,1,24,7,5,62,35,27,79
Peterhead,7289,2,24,4,8,81,38,43,76
Stirling,7289,3,17,6,13,63,51,12,57
Stenhousem'r,7289,4,15,8,13,55,49,6,53
Clyde,7289,5,14,10,12,52,49,3,52
Elgin,7289,6,14,6,16,54,63,-9,48
Annan Athlet,7289,7,11,12,13,48,42,6,45
Berwick,7289,8,8,11,17,30,59,-29,35
Edinburgh Ci,7289,9,7,9,20,36,64,-28,30
Cowdenbeath,7289,10,4,11,21,24,55,-31,23
Montrose,7290,1,24,7,5,62,34,28,79
Peterhead,7290,2,24,4,8,79,38,41,76
Stirling,7290,3,16,7,13,61,52,9,55
Stenhousem'r,7290,4,15,9,12,56,47,9,54
Clyde,7290,5,15,9,12,53,48,5,54
Elgin,7290,6,14,6,16,53,63,-10,48
Annan Athlet,7290,7,12,11,13,51,41,10,47
Berwick,7290,8,8,10,18,29,60,-31,34
Edinburgh Ci,7290,9,7,9,20,36,62,-26,30
Cowdenbeath,7290,10,4,10,22,23,58,-35,22
Montrose,7291,1,24,7,5,64,34,30,79
Peterhead,7291,2,23,4,9,78,40,38,73
Stenhousem'r,7291,3,16,8,12,59,48,11,56
Stirling,7291,4,16,6,14,62,55,7,54
Clyde,7291,5,14,10,12,52,49,3,52
Elgin,7291,6,14,6,16,53,65,-12,48
Annan Athlet,7291,7,11,12,13,49,43,6,45
Berwick,7291,8,8,11,17,30,59,-29,35
Edinburgh Ci,7291,9,8,9,19,38,61,-23,33
Cowdenbeath,7291,10,4,11,21,25,56,-31,23
Montrose,7292,1,23,8,5,60,35,25,77
Peterhead,7292,2,24,4,8,79,39,40,76
Stirling,7292,3,17,6,13,62,51,11,57
Clyde,7292,4,15,9,12,54,48,6,54
Stenhousem'r,7292,5,15,8,13,55,48,7,53
Elgin,7292,6,14,7,15,54,61,-7,49
Annan Athlet,7292,7,11,11,14,48,43,5,44
Berwick,7292,8,8,10,18,29,61,-32,34
Edinburgh Ci,7292,9,7,9,20,37,62,-25,30
Cowdenbeath,7292,10,5,10,21,25,55,-30,25
Montrose,7293,1,24,7,5,62,36,26,79
Peterhead,7293,2,24,4,8,80,38,42,76
Stirling,7293,3,17,6,13,61,51,10,57
Clyde,7293,4,15,9,12,55,49,6,54
Stenhousem'r,7293,5,15,8,13,55,47,8,53
Elgin,7293,6,14,6,16,55,63,-8,48
Annan Athlet,7293,7,11,11,14,48,43,5,44
Berwick,7293,8,8,10,18,30,62,-32,34
Edinburgh Ci,7293,9,7,9,20,36,63,-27,30
Cowdenbeath,7293,10,5,10,21,25,55,-30,25
Montrose,7294,1,24,7,5,62,34,28,79
Peterhead,7294,2,23,5,8,78,39,39,74
Stirling,7294,3,17,6,13,62,51,11,57
Clyde,7294,4,15,9,12,53,48,5,54
Stenhousem'r,7294,5,15,8,13,55,48,7,53
Elgin,7294,6,14,6,16,53,63,-10,48
Annan Athlet,7294,7,11,11,14,47,43,4,44
Berwick,7294,8,8,10,18,29,60,-31,34
Edinburgh Ci,7294,9,7,10,19,37,61,-24,31
Cowdenbeath,7294,10,5,10,21,25,54,-29,25
Montrose,7295,1,23,8,5,61,36,25,77
Peterhead,7295,2,24,4,8,80,39,41,76
Stenhousem'r,7295,3,16,8,12,58,47,11,56
Stirling,7295,4,16,6,14,61,54,7,54
Clyde,7295,5,15,9,12,52,48,4,54
Elgin,7295,6,14,7,15,55,62,-7,49
Annan Athlet,7295,7,12,11,13,48,41,7,47
Berwick,7295,8,8,10,18,29,59,-30,34
Edinburgh Ci,7295,9,7,9,20,37,63,-26,30
Cowdenbeath,7295,10,4,10,22,23,55,-32,22
Montrose,7296,1,24,7,5,62,34,28,79
Peterhead,7296,2,24,4,8,82,38,44,76
Stenhousem'r,7296,3,16,8,12,58,47,11,56
Stirling,7296,4,16,6,14,61,54,7,54
Clyde,7296,5,14,10,12,52,49,3,52
Elgin,7296,6,14,6,16,53,63,-10,48
Annan Athlet,7296,7,11,11,14,48,43,5,44
Berwick,7296,8,8,11,17,30,59,-29,35
Edinburgh Ci,7296,9,7,9,20,36,65,-29,30
Cowdenbeath,7296,10,5,10,21,25,55,-30,25
Montrose,7297,1,24,7,5,60,34,26,79
Peterhead,7297,2,24,4,8,79,39,40,76
Stirling,7297,3,16,7,13,61,52,9,55
Stenhousem'r,7297,4,15,9,12,56,47,9,54
Clyde,7297,5,15,9,12,54,49,5,54
Elgin,7297,6,14,6,16,53,61,-8,48
Annan Athlet,7297,7,12,11,13,49,41,8,47
Berwick,7297,8,8,10,18,30,61,-31,34
Edinburgh Ci,7297,9,7,9,20,37,62,-25,30
Cowdenbeath,7297,10,4,10,22,23,56,-33,22
Montrose,7298,1,24,7,5,61,35,26,79
Peterhead,7298,2,24,4,8,79,39,40,76
Stirling,7298,3,17,6,13,63,52,11,57
Stenhousem'r,7298,4,15,8,13,56,49,7,53
Clyde,7298,5,14,10,12,51,48,3,52
Elgin,7298,6,14,6,16,54,62,-8,48
Annan Athlet,7298,7,12,11,13,50,41,9,47
Berwick,7298,8,8,11,17,29,58,-29,35
Edinburgh Ci,7298,9,7,9,20,37,62,-25,30
Cowdenbeath,7298,10,4,10,22,23,57,-34,22
Montrose,7299,1,23,8,5,61,36,25,77
Peterhead,7299,2,24,4,8,79,39,40,76
Stenhousem'r,7299,3,16,8,12,56,46,10,56
Stirling,7299,4,16,6,14,60,52,8,54
Clyde,7299,5,14,9,13,52,51,1,51
Elgin,7299,6,14,7,15,55,62,-7,49
Annan Athlet,7299,7,12,11,13,49,42,7,47
Berwick,7299,8,9,10,17,32,59,-27,37
Edinburgh Ci,7299,9,7,9,20,37,62,-25,30
Cowdenbeath,7299,10,4,10,22,24,56,-32,22
Montrose,7300,1,23,8,5,61,36,25,77
Peterhead,7300,2,24,4,8,81,39,42,76
Stenhousem'r,7300,3,16,8,12,57,47,10,56
Stirling,7300,4,16,6,14,61,53,8,54
Clyde,7300,5,14,9,13,51,50,1,51
Elgin,7300,6,14,7,15,55,62,-7,49
Annan Athlet,7300,7,11,11,14,48,43,5,44
Berwick,7300,8,9,10,17,31,58,-27,37
Edinburgh Ci,7300,9,7,9,20,37,64,-27,30
Cowdenbeath,7300,10,5,10,21,25,55,-30,25
Montrose,7301,1,24,7,5,65,35,30,79
Peterhead,7301,2,24,4,8,80,39,41,76
Stirling,7301,3,17,6,13,63,52,11,57
Clyde,7301,4,15,9,12,52,48,4,54
Stenhousem'r,7301,5,15,8,13,56,49,7,53
Elgin,7301,6,14,6,16,54,66,-12,48
Annan Athlet,7301,7,11,12,13,47,41,6,45
Berwick,7301,8,8,10,18,29,59,-30,34
Edinburgh Ci,7301,9,7,9,20,37,63,-26,30
Cowdenbeath,7301,10,4,11,21,23,54,-31,23
Montrose,7302,1,24,7,5,61,35,26,79
Peterhead,7302,2,24,4,8,80,39,41,76
Stenhousem'r,7302,3,16,8,12,57,47,10,56
Stirling,7302,4,16,6,14,61,53,8,54
Clyde,7302,5,15,9,12,55,50,5,54
Elgin,7302,6,14,6,16,54,62,-8,48
Annan Athlet,7302,7,12,11,13,51,43,8,47
Berwick,7302,8,8,10,18,31,62,-31,34
Edinburgh Ci,7302,9,7,9,20,37,63,-26,30
Cowdenbeath,7302,10,4,10,22,25,58,-33,22
Montrose,7303,1,24,7,5,61,35,26,79
Peterhead,7303,2,24,4,8,80,39,41,76
Stirling,7303,3,17,6,13,61,51,10,57
Stenhousem'r,7303,4,15,8,13,55,47,8,53
Clyde,7303,5,14,10,12,52,49,3,52
Elgin,7303,6,14,6,16,54,62,-8,48
Annan Athlet,7303,7,11,12,13,47,41,6,45
Berwick,7303,8,8,11,17,30,59,-29,35
Edinburgh Ci,7303,9,7,9,20,37,63,-26,30
Cowdenbeath,7303,10,4,11,21,23,54,-31,23
Montrose,7304,1,23,8,5,60,35,25,77
Peterhead,7304,2,24,4,8,81,39,42,76
Stirling,7304,3,17,6,13,62,51,11,57
Stenhousem'r,7304,4,15,8,13,55,48,7,53
Clyde,7304,5,14,10,12,52,49,3,52
Elgin,7304,6,14,7,15,54,61,-7,49
Annan Athlet,7304,7,12,11,13,48,41,7,47
Berwick,7304,8,8,11,17,30,59,-29,35
Edinburgh Ci,7304,9,7,9,20,37,64,-27,30
Cowdenbeath,7304,10,4,10,22,23,55,-32,22
Montrose,7305,1,24,7,5,63,35,28,79
Peterhead,7305,2,24,4,8,79,38,41,76
Stenhousem'r,7305,3,16,8,12,56,46,10,56
Stirling,7305,4,16,6,14,60,52,8,54
Clyde,7305,5,14,10,12,52,49,3,52
Elgin,7305,6,14,6,16,54,64,-10,48
Annan Athlet,7305,7,11,12,13,48,42,6,45
Berwick,7305,8,8,11,17,30,59,-29,35
Edinburgh Ci,7305,9,7,9,20,36,62,-26,30
Cowdenbeath,7305,10,4,11,21,24,55,-31,23
Montrose,7306,1,24,7,5,65,35,30,79
Peterhead,7306,2,23,4,9,78,40,38,73
Stirling,7306,3,17,6,13,62,51,11,57
Clyde,7306,4,15,9,12,53,48,5,54
Stenhousem'r,7306,5,15,8,13,55,48,7,53
Elgin,7306,6,14,6,16,54,66,-12,48
Annan Athlet,7306,7,12,11,13,49,41,8,47
Berwick,7306,8,8,10,18,29,60,-31,34
Edinburgh Ci,7306,9,8,9,19,38,61,-23,33
Cowdenbeath,7306,10,4,10,22,23,56,-33,22
Montrose,7307,1,24,7,5,61,35,26,79
Peterhead,7307,2,24,4,8,81,40,41,76
Stirling,7307,3,17,6,13,62,52,10,57
Clyde,7307,4,15,9,12,52,48,4,54
Stenhousem'r,7307,5,15,8,13,56,48,8,53
Elgin,7307,6,14,6,16,54,62,-8,48
Annan Athlet,7307,7,12,11,13,48,41,7,47
Berwick,7307,8,8,10,18,29,59,-30,34
Edinburgh Ci,7307,9,7,9,20,38,64,-26,30
Cowdenbeath,7307,10,4,10,22,23,55,-32,22
Montrose,7308,1,24,7,5,63,36,27,79
Peterhead,7308,2,24,4,8,78,38,40,76
Stirling,7308,3,17,6,13,64,52,12,57
Stenhousem'r,7308,4,15,8,13,56,50,6,53
Clyde,7308,5,14,9,13,53,51,2,51
Elgin,7308,6,14,6,16,55,64,-9,48
Annan Athlet,7308,7,11,11,14,47,42,5,44
Berwick,7308,8,9,10,17,32,60,-28,37
Edinburgh Ci,7308,9,7,9,20,36,61,-25,30
Cowdenbeath,7308,10,5,10,21,24,54,-30,25
Montrose,7309,1,24,7,5,61,34,27,79
Peterhead,7309,2,23,5,8,79,40,39,74
Stirling,7309,3,16,7,13,61,52,9,55
Stenhousem'r,7309,4,15,9,12,56,47,9,54
Clyde,7309,5,15,9,12,54,49,5,54
Elgin,7309,6,14,6,16,53,62,-9,48
Annan Athlet,7309,7,11,12,13,48,42,6,45
Berwick,7309,8,8,10,18,30,61,-31,34
Edinburgh Ci,7309,9,7,10,19,38,62,-24,31
Cowdenbeath,7309,10,4,11,21,24,55,-31,23
Montrose,7310,1,24,7,5,61,34,27,79
Peterhead,7310,2,24,4,8,82,38,44,76
Stenhousem'r,7310,3,16,8,12,57,47,10,56
Stirling,7310,4,16,6,14,61,53,8,54
Clyde,7310,5,14,9,13,51,49,2,51
Elgin,7310,6,14,6,16,53,62,-9,48
Annan Athlet,7310,7,11,11,14,47,42,5,44
Berwick,7310,8,9,10,17,30,58,-28,37
Edinburgh Ci,7310,9,7,9,20,36,65,-29,30
Cowdenbeath,7310,10,5,10,21,24,54,-30,25
Montrose,7311,1,23,8,5,60,35,25,77
Peterhead,7311,2,24,4,8,82,38,44,76
Stirling,7311,3,17,6,13,62,52,10,57
Clyde,7311,4,15,9,12,52,48,4,54
Stenhousem'r,7311,5,15,8,13,56,48,8,53
Elgin,7311,6,14,7,15,54,61,-7,49
Annan Athlet,7311,7,11,12,13,47,41,6,45
Berwick,7311,8,8,10,18,29,59,-30,34
Edinburgh Ci,7311,9,7,9,20,36,65,-29,30
Cowdenbeath,7311,10,4,11,21,23,54,-31,23
Montrose,7312,1,23,8,5,60,35,25,77
Peterhead,7312,2,23,5,8,78,39,39,74
Stenhousem'r,7312,3,16,8,12,58,47,11,56
Stirling,7312,4,16,6,14,61,54,7,54
Clyde,7312,5,15,9,12,53,48,5,54
Elgin,7312,6,14,7,15,54,61,-7,49
Annan Athlet,7312,7,11,12,13,48,42,6,45
Berwick,7312,8,8,10,18,29,60,-31,34
Edinburgh Ci,7312,9,7,10,19,37,61,-24,31
Cowdenbeath,7312,10,4,11,21,24,55,-31,23
Montrose,7313,1,23,8,5,60,35,25,77
Peterhead,7313,2,24,4,8,80,38,42,76
Stirling,7313,3,17,6,13,62,52,10,57
Clyde,7313,4,15,9,12,53,48,5,54
Stenhousem'r,7313,5,15,8,13,56,48,8,53
Elgin,7313,6,14,7,15,54,61,-7,49
Annan Athlet,7313,7,12,11,13,49,41,8,47
Berwick,7313,8,8,10,18,29,60,-31,34
Edinburgh Ci,7313,9,7,9,20,36,63,-27,30
Cowdenbeath,7313,10,4,10,22,23,56,-33,22
Montrose,7314,1,24,7,5,62,35,27,79
Peterhead,7314,2,24,4,8,79,38,41,76
Stirling,7314,3,17,6,13,63,52,11,57
Stenhousem'r,7314,4,15,8,13,56,49,7,53
Clyde,7314,5,14,10,12,51,48,3,52
Elgin,7314,6,14,6,16,54,63,-9,48
Annan Athlet,7314,7,11,12,13,48,42,6,45
Berwick,7314,8,8,11,17,29,58,-29,35
Edinburgh Ci,7314,9,7,9,20,36,62,-26,30
Cowdenbeath,7314,10,4,11,21,24,55,-31,23
Montrose,7315,1,24,7,5,61,34,27,79
Peterhead,7315,2,23,4,9,77,39,38,73
Stenhousem'r,7315,3,16,8,12,60,49,11,56
Stirling,7315,4,16,6,14,63,56,7,54
Clyde,7315,5,14,9,13,52,51,1,51
Elgin,7315,6,14,6,16,53,62,-9,48
Annan Athlet,7315,7,12,11,13,48,41,7,47
Berwick,7315,8,9,10,17,32,59,-27,37
Edinburgh Ci,7315,9,8,9,19,37,60,-23,33
Cowdenbeath,7315,10,4,10,22,23,55,-32,22
Montrose,7316,1,24,7,5,60,34,26,79
Peterhead,7316,2,24,4,8,82,38,44,76
Stirling,7316,3,17,6,13,63,52,11,57
Clyde,7316,4,15,9,12,53,49,4,54
Stenhousem'r,7316,5,15,8,13,56,49,7,53
Elgin,7316,6,14,6,16,53,61,-8,48
Annan Athlet,7316,7,11,11,14,47,45,2,44
Berwick,7316,8,8,10,18,30,60,-30,34
Edinburgh Ci,7316,9,7,9,20,36,65,-29,30
Cowdenbeath,7316,10,5,10,21,27,54,-27,25
Montrose,7317,1,24,7,5,60,34,26,79
Peterhead,7317,2,24,4,8,81,38,43,76
Stirling,7317,3,17,6,13,63,52,11,57
Stenhousem'r,7317,4,15,8,13,56,49,7,53
Clyde,7317,5,14,10,12,52,49,3,52
Elgin,7317,6,14,6,16,53,61,-8,48
Annan Athlet,7317,7,12,11,13,49,41,8,47
Berwick,7317,8,8,11,17,30,59,-29,35
Edinburgh Ci,7317,9,7,9,20,36,64,-28,30
Cowdenbeath,7317,10,4,10,22,23,56,-33,22
Montrose,7318,1,24,7,5,62,36,26,79
Peterhead,7318,2,24,4,8,81,38,43,76
Stirling,7318,3,17,6,13,62,51,11,57
Clyde,7318,4,15,9,12,54,48,6,54
Stenhousem'r,7318,5,15,8,13,55,48,7,53
Elgin,7318,6,14,6,16,55,63,-8,48
Annan Athlet,7318,7,12,11,13,50,41,9,47
Berwick,7318,8,8,10,18,29,61,-32,34
Edinburgh Ci,7318,9,7,9,20,36,64,-28,30
Cowdenbeath,7318,10,4,10,22,23,57,-34,22
Peterhead,7319,1,24,4,8,80,39,41,76
Montrose,7319,2,23,7,6,60,36,24,76
Stenhousem'r,7319,3,16,8,12,57,47,10,56
Stirling,7319,4,16,6,14,61,53,8,54
Clyde,7319,5,15,9,12,54,49,5,54
Elgin,7319,6,15,6,15,55,61,-6,51
Annan Athlet,7319,7,11,12,13,47,41,6,45
Berwick,7319,8,8,10,18,30,61,-31,34
Edinburgh Ci,7319,9,7,9,20,37,63,-26,30
Cowdenbeath,7319,10,4,11,21,23,54,-31,23
Montrose,7320,1,24,7,5,60,34,26,79
Peterhead,7320,2,24,4,8,80,38,42,76
Stirling,7320,3,16,7,13,61,52,9,55
Stenhousem'r,7320,4,15,9,12,56,47,9,54
Clyde,7320,5,14,9,13,51,49,2,51
Elgin,7320,6,14,6,16,53,61,-8,48
Annan Athlet,7320,7,11,12,13,49,43,6,45
Berwick,7320,8,9,10,17,30,58,-28,37
Edinburgh Ci,7320,9,7,9,20,36,63,-27,30
Cowdenbeath,7320,10,4,11,21,25,56,-31,23
Montrose,7321,1,23,8,5,60,35,25,77
Peterhead,7321,2,24,4,8,81,39,42,76
Stirling,7321,3,16,7,13,61,52,9,55
Stenhousem'r,7321,4,15,9,12,56,47,9,54
Clyde,7321,5,15,9,12,54,48,6,54
Elgin,7321,6,14,7,15,54,61,-7,49
Annan Athlet,7321,7,11,12,13,47,41,6,45
Berwick,7321,8,8,10,18,29,61,-32,34
Edinburgh Ci,7321,9,7,9,20,37,64,-27,30
Cowdenbeath,7321,10,4,11,21,23,54,-31,23
Montrose,7322,1,23,7,6,61,37,24,76
Peterhead,7322,2,23,5,8,78,39,39,74
Stirling,7322,3,16,7,13,61,52,9,55
Stenhousem'r,7322,4,15,9,12,56,47,9,54
Clyde,7322,5,15,9,12,53,49,4,54
Elgin,7322,6,15,6,15,56,62,-6,51
Annan Athlet,7322,7,11,12,13,48,42,6,45
Berwick,7322,8,8,10,18,30,60,-30,34
Edinburgh Ci,7322,9,7,10,19,37,61,-24,31
Cowdenbeath,7322,10,4,11,21,24,55,-31,23
Montrose,7323,1,23,8,5,60,35,25,77
Peterhead,7323,2,24,4,8,79,39,40,76
Stirling,7323,3,17,6,13,63,52,11,57
Clyde,7323,4,15,9,12,52,48,4,54
Stenhousem'r,7323,5,15,8,13,56,49,7,53
Elgin,7323,6,14,7,15,54,61,-7,49
Annan Athlet,7323,7,11,12,13,47,41,6,45
Berwick,7323,8,8,10,18,29,59,-30,34
Edinburgh Ci,7323,9,7,9,20,37,62,-25,30
Cowdenbeath,7323,10,4,11,21,23,54,-31,23
Montrose,7324,1,24,7,5,61,34,27,79
Peterhead,7324,2,24,4,8,79,39,40,76
Stirling,7324,3,16,7,13,61,52,9,55
Stenhousem'r,7324,4,15,9,12,56,47,9,54
Clyde,7324,5,14,10,12,53,50,3,52
Elgin,7324,6,14,6,16,53,62,-9,48
Annan Athlet,7324,7,11,12,13,48,42,6,45
Berwick,7324,8,8,11,17,31,60,-29,35
Edinburgh Ci,7324,9,7,9,20,37,62,-25,30
Cowdenbeath,7324,10,4,11,21,24,55,-31,23
Montrose,7325,1,24,7,5,61,34,27,79
Peterhead,7325,2,23,5,8,79,40,39,74
Stirling,7325,3,16,7,13,63,54,9,55
Stenhousem'r,7325,4,15,9,12,58,49,9,54
Clyde,7325,5,14,10,12,54,51,3,52
Elgin,7325,6,14,6,16,53,62,-9,48
Annan Athlet,7325,7,12,11,13,49,41,8,47
Berwick,7325,8,8,11,17,32,61,-29,35
Edinburgh Ci,7325,9,7,10,19,38,62,-24,31
Cowdenbeath,7325,10,4,10,22,23,56,-33,22
Montrose,7326,1,24,7,5,61,34,27,79
Peterhead,7326,2,24,4,8,80,39,41,76
Stenhousem'r,7326,3,16,8,12,57,47,10,56
Stirling,7326,4,16,6,14,61,53,8,54
Clyde,7326,5,15,9,12,52,48,4,54
Elgin,7326,6,14,6,16,53,62,-9,48
Annan Athlet,7326,7,12,11,13,48,41,7,47
Berwick,7326,8,8,10,18,29,59,-30,34
Edinburgh Ci,7326,9,7,9,20,37,63,-26,30
Cowdenbeath,7326,10,4,10,22,23,55,-32,22
Montrose,7327,1,24,7,5,62,36,26,79
Peterhead,7327,2,24,4,8,80,40,40,76
Stirling,7327,3,16,7,13,61,52,9,55
Stenhousem'r,7327,4,15,9,12,56,47,9,54
Clyde,7327,5,14,9,13,52,50,2,51
Elgin,7327,6,14,6,16,55,63,-8,48
Annan Athlet,7327,7,12,11,13,48,41,7,47
Berwick,7327,8,9,10,17,31,59,-28,37
Edinburgh Ci,7327,9,7,9,20,38,63,-25,30
Cowdenbeath,7327,10,4,10,22,23,55,-32,22
Montrose,7328,1,24,7,5,62,34,28,79
Peterhead,7328,2,24,4,8,79,38,41,76
Stirling,7328,3,17,6,13,62,52,10,57
Clyde,7328,4,15,9,12,54,50,4,54
Stenhousem'r,7328,5,15,8,13,56,48,8,53
Elgin,7328,6,14,6,16,53,63,-10,48
Annan Athlet,7328,7,12,11,13,49,42,7,47
Berwick,7328,8,8,10,18,31,61,-30,34
Edinburgh Ci,7328,9,7,9,20,36,62,-26,30
Cowdenbeath,7328,10,4,10,22,24,56,-32,22
Montrose,7329,1,24,7,5,62,36,26,79
Peterhead,7329,2,24,4,8,82,38,44,76
Stenhousem'r,7329,3,16,8,12,58,46,12,56
Stirling,7329,4,16,6,14,60,54,6,54
Clyde,7329,5,14,9,13,51,49,2,51
Elgin,7329,6,14,6,16,55,63,-8,48
Annan Athlet,7329,7,11,12,13,49,43,6,45
Berwick,7329,8,9,10,17,30,58,-28,37
Edinburgh Ci,7329,9,7,9,20,36,65,-29,30
Cowdenbeath,7329,10,4,11,21,25,56,-31,23
Montrose,7330,1,23,7,6,59,36,23,76
Peterhead,7330,2,23,5,8,77,38,39,74
Stirling,7330,3,16,7,13,61,52,9,55
Stenhousem'r,7330,4,15,9,12,56,47,9,54
Clyde,7330,5,15,9,12,55,49,6,54
Elgin,7330,6,15,6,15,55,60,-5,51
Annan Athlet,7330,7,11,12,13,48,42,6,45
Berwick,7330,8,8,10,18,30,62,-32,34
Edinburgh Ci,7330,9,7,10,19,36,60,-24,31
Cowdenbeath,7330,10,4,11,21,24,55,-31,23
Montrose,7331,1,24,7,5,62,35,27,79
Peterhead,7331,2,24,4,8,78,38,40,76
Stirling,7331,3,17,6,13,61,51,10,57
Clyde,7331,4,15,9,12,53,48,5,54
Stenhousem'r,7331,5,15,8,13,55,47,8,53
Elgin,7331,6,14,6,16,54,63,-9,48
Annan Athlet,7331,7,12,11,13,48,41,7,47
Berwick,7331,8,8,10,18,29,60,-31,34
Edinburgh Ci,7331,9,7,9,20,36,61,-25,30
Cowdenbeath,7331,10,4,10,22,23,55,-32,22
Montrose,7332,1,23,7,6,60,36,24,76
Peterhead,7332,2,23,5,8,78,39,39,74
Stenhousem'r,7332,3,16,8,12,57,47,10,56
Stirling,7332,4,16,6,14,61,53,8,54
Clyde,7332,5,15,9,12,53,49,4,54
Elgin,7332,6,15,6,15,55,61,-6,51
Annan Athlet,7332,7,12,11,13,50,41,9,47
Berwick,7332,8,8,10,18,30,60,-30,34
Edinburgh Ci,7332,9,7,10,19,37,61,-24,31
Cowdenbeath,7332,10,4,10,22,23,57,-34,22
Montrose,7333,1,24,7,5,60,34,26,79
Peterhead,7333,2,24,4,8,79,39,40,76
Stirling,7333,3,17,6,13,64,52,12,57
Clyde,7333,4,15,9,12,54,48,6,54
Stenhousem'r,7333,5,15,8,13,56,50,6,53
Elgin,7333,6,14,6,16,53,61,-8,48
Annan Athlet,7333,7,11,11,14,47,42,5,44
Berwick,7333,8,8,10,18,29,61,-32,34
Edinburgh Ci,7333,9,7,9,20,37,62,-25,30
Cowdenbeath,7333,10,5,10,21,24,54,-30,25
Montrose,7334,1,24,7,5,63,35,28,79
Peterhead,7334,2,24,4,8,81,40,41,76
Stirling,7334,3,16,7,13,61,52,9,55
Stenhousem'r,7334,4,15,9,12,56,47,9,54
Clyde,7334,5,14,9,13,52,50,2,51
Elgin,7334,6,14,6,16,54,64,-10,48
Annan Athlet,7334,7,11,11,14,47,42,5,44
Berwick,7334,8,9,10,17,31,59,-28,37
Edinburgh Ci,7334,9,7,9,20,38,64,-26,30
Cowdenbeath,7334,10,5,10,21,24,54,-30,25
Montrose,7335,1,24,7,5,61,35,26,79
Peterhead,7335,2,23,5,8,77,38,39,74
Stirling,7335,3,17,6,13,64,52,12,57
Stenhousem'r,7335,4,15,8,13,56,50,6,53
Clyde,7335,5,14,9,13,51,50,1,51
Elgin,7335,6,14,6,16,54,62,-8,48
Annan Athlet,7335,7,12,11,13,48,41,7,47
Berwick,7335,8,9,10,17,31,58,-27,37
Edinburgh Ci,7335,9,7,10,19,36,60,-24,31
Cowdenbeath,7335,10,4,10,22,23,55,-32,22
Montrose,7336,1,24,7,5,63,34,29,79
Peterhead,7336,2,24,4,8,79,38,41,76
Stenhousem'r,7336,3,16,8,12,60,47,13,56
Stirling,7336,4,16,6,14,61,56,5,54
Clyde,7336,5,15,9,12,52,48,4,54
Elgin,7336,6,14,6,16,53,64,-11,48
Annan Athlet,7336,7,11,11,14,47,42,5,44
Berwick,7336,8,8,10,18,29,59,-30,34
Edinburgh Ci,7336,9,7,9,20,36,62,-26,30
Cowdenbeath,7336,10,5,10,21,24,54,-30,25
Montrose,7337,1,23,8,5,60,35,25,77
Peterhead,7337,2,23,5,8,77,38,39,74
Stirling,7337,3,17,6,13,65,52,13,57
Stenhousem'r,7337,4,15,8,13,56,51,5,53
Clyde,7337,5,14,10,12,53,50,3,52
Elgin,7337,6,14,7,15,54,61,-7,49
Annan Athlet,7337,7,11,11,14,47,44,3,44
Berwick,7337,8,8,11,17,31,60,-29,35
Edinburgh Ci,7337,9,7,10,19,36,60,-24,31
Cowdenbeath,7337,10,5,10,21,26,54,-28,25
Montrose,7338,1,24,7,5,60,34,26,79
Peterhead,7338,2,24,4,8,80,38,42,76
Stirling,7338,3,17,6,13,62,51,11,57
Stenhousem'r,7338,4,15,8,13,55,48,7,53
Clyde,7338,5,14,9,13,52,52,0,51
Elgin,7338,6,14,6,16,53,61,-8,48
Annan Athlet,7338,7,11,11,14,47,45,2,44
Berwick,7338,8,9,10,17,33,59,-26,37
Edinburgh Ci,7338,9,7,9,20,36,63,-27,30
Cowdenbeath,7338,10,5,10,21,27,54,-27,25
Montrose,7339,1,24,7,5,61,34,27,79
Peterhead,7339,2,24,4,8,79,39,40,76
Stenhousem'r,7339,3,16,8,12,58,47,11,56
Stirling,7339,4,16,6,14,61,54,7,54
Clyde,7339,5,14,9,13,52,52,0,51
Elgin,7339,6,14,6,16,53,62,-9,48
Annan Athlet,7339,7,11,11,14,48,43,5,44
Berwick,7339,8,9,10,17,33,59,-26,37
Edinburgh Ci,7339,9,7,9,20,37,62,-25,30
Cowdenbeath,7339,10,5,10,21,25,55,-30,25
Montrose,7340,1,23,7,6,59,35,24,76
Peterhead,7340,2,23,5,8,79,40,39,74
Stirling,7340,3,17,6,13,63,52,11,57
Stenhousem'r,7340,4,15,8,13,56,49,7,53
Clyde,7340,5,14,9,13,52,50,2,51
Elgin,7340,6,15,6,15,54,60,-6,51
Annan Athlet,7340,7,12,11,13,48,41,7,47
Berwick,7340,8,9,10,17,31,59,-28,37
Edinburgh Ci,7340,9,7,10,19,38,62,-24,31
Cowdenbeath,7340,10,4,10,22,23,55,-32,22
Peterhead,7341,1,24,4,8,82,41,41,76
Montrose,7341,2,23,7,6,60,36,24,76
Stirling,7341,3,17,6,13,63,53,10,57
Clyde,7341,4,15,9,12,53,48,5,54
Stenhousem'r,7341,5,15,8,13,57,49,8,53
Elgin,7341,6,15,6,15,55,61,-6,51
Annan Athlet,7341,7,11,11,14,48,43,5,44
Berwick,7341,8,8,10,18,29,60,-31,34
Edinburgh Ci,7341,9,7,9,20,39,65,-26,30
Cowdenbeath,7341,10,5,10,21,25,55,-30,25
Montrose,7342,1,23,7,6,59,37,22,76
Peterhead,7342,2,23,5,8,78,39,39,74
Stirling,7342,3,16,7,13,61,52,9,55
Stenhousem'r,7342,4,15,9,12,56,47,9,54
Clyde,7342,5,15,9,12,52,48,4,54
Elgin,7342,6,15,6,15,56,60,-4,51
Annan Athlet,7342,7,11,11,14,49,45,4,44
Berwick,7342,8,8,10,18,29,59,-30,34
Edinburgh Ci,7342,9,7,10,19,37,61,-24,31
Cowdenbeath,7342,10,5,10,21,27,56,-29,25
Montrose,7343,1,24,7,5,63,34,29,79
Peterhead,7343,2,24,4,8,79,38,41,76
Stirling,7343,3,17,6,13,64,52,12,57
Stenhousem'r,7343,4,15,8,13,56,50,6,53
Clyde,7343,5,14,10,12,53,50,3,52
Elgin,7343,6,14,6,16,53,64,-11,48
Annan Athlet,7343,7,11,12,13,47,41,6,45
Berwick,7343,8,8,11,17,31,60,-29,35
Edinburgh Ci,7343,9,7,9,20,36,62,-26,30
Cowdenbeath,7343,10,4,11,21,23,54,-31,23
Montrose,7344,1,24,7,5,64,34,30,79
Peterhead,7344,2,24,4,8,78,38,40,76
Stenhousem'r,7344,3,16,8,12,57,46,11,56
Stirling,7344,4,16,6,14,60,53,7,54
Clyde,7344,5,15,9,12,53,49,4,54
Elgin,7344,6,14,6,16,53,65,-12,48
Annan Athlet,7344,7,11,12,13,47,41,6,45
Berwick,7344,8,8,10,18,30,60,-30,34
Edinburgh Ci,7344,9,7,9,20,36,61,-25,30
Cowdenbeath,7344,10,4,11,21,23,54,-31,23
Montrose,7345,1,24,7,5,60,34,26,79
Peterhead,7345,2,24,4,8,79,39,40,76
Stenhousem'r,7345,3,16,8,12,57,47,10,56
Stirling,7345,4,16,6,14,61,53,8,54
Clyde,7345,5,14,10,12,53,50,3,52
Elgin,7345,6,14,6,16,53,61,-8,48
Annan Athlet,7345,7,11,11,14,48,43,5,44
Berwick,7345,8,8,11,17,31,60,-29,35
Edinburgh Ci,7345,9,7,9,20,37,62,-25,30
Cowdenbeath,7345,10,5,10,21,25,55,-30,25
Montrose,7346,1,24,7,5,61,34,27,79
Peterhead,7346,2,23,4,9,77,39,38,73
Stirling,7346,3,16,7,13,61,52,9,55
Stenhousem'r,7346,4,15,9,12,56,47,9,54
Clyde,7346,5,15,9,12,54,48,6,54
Elgin,7346,6,14,6,16,53,62,-9,48
Annan Athlet,7346,7,11,12,13,48,42,6,45
Berwick,7346,8,8,10,18,29,61,-32,34
Edinburgh Ci,7346,9,8,9,19,37,60,-23,33
Cowdenbeath,7346,10,4,11,21,24,55,-31,23
Montrose,7347,1,24,7,5,63,35,28,79
Peterhead,7347,2,24,4,8,78,38,40,76
Stenhousem'r,7347,3,16,8,12,56,46,10,56
Stirling,7347,4,16,6,14,60,52,8,54
Clyde,7347,5,14,9,13,53,52,1,51
Elgin,7347,6,14,6,16,54,64,-10,48
Annan Athlet,7347,7,12,11,13,50,42,8,47
Berwick,7347,8,9,10,17,33,60,-27,37
Edinburgh Ci,7347,9,7,9,20,36,61,-25,30
Cowdenbeath,7347,10,4,10,22,24,57,-33,22
Peterhead,7348,1,24,4,8,78,38,40,76
Montrose,7348,2,23,7,6,60,37,23,76
Stenhousem'r,7348,3,16,8,12,56,46,10,56
Stirling,7348,4,16,6,14,60,52,8,54
Clyde,7348,5,15,9,12,54,49,5,54
Elgin,7348,6,15,6,15,56,61,-5,51
Annan Athlet,7348,7,11,12,13,48,42,6,45
Berwick,7348,8,8,10,18,30,61,-31,34
Edinburgh Ci,7348,9,7,9,20,36,61,-25,30
Cowdenbeath,7348,10,4,11,21,24,55,-31,23
Montrose,7349,1,24,7,5,62,35,27,79
Peterhead,7349,2,23,5,8,78,39,39,74
Stenhousem'r,7349,3,16,8,12,56,46,10,56
Stirling,7349,4,16,6,14,60,52,8,54
Clyde,7349,5,14,10,12,53,50,3,52
Elgin,7349,6,14,6,16,54,63,-9,48
Annan Athlet,7349,7,12,11,13,49,41,8,47
Berwick,7349,8,8,11,17,31,60,-29,35
Edinburgh Ci,7349,9,7,10,19,37,61,-24,31
Cowdenbeath,7349,10,4,10,22,23,56,-33,22
Montrose,7350,1,23,8,5,59,34,25,77
Peterhead,7350,2,24,4,8,80,39,41,76
Stirling,7350,3,16,7,13,60,51,9,55
Stenhousem'r,7350,4,15,9,12,55,46,9,54
Clyde,7350,5,14,10,12,52,49,3,52
Elgin,7350,6,14,7,15,53,60,-7,49
Annan Athlet,7350,7,12,11,13,49,41,8,47
Berwick,7350,8,8,11,17,30,59,-29,35
Edinburgh Ci,7350,9,7,9,20,37,63,-26,30
Cowdenbeath,7350,10,4,10,22,23,56,-33,22
Montrose,7351,1,24,7,5,63,36,27,79
Peterhead,7351,2,24,4,8,79,38,41,76
Stirling,7351,3,17,6,13,64,52,12,57
Stenhousem'r,7351,4,15,8,13,56,50,6,53
Clyde,7351,5,14,9,13,51,50,1,51
Elgin,7351,6,14,6,16,55,64,-9,48
Annan Athlet,7351,7,11,11,14,47,42,5,44
Berwick,7351,8,9,10,17,31,58,-27,37
Edinburgh Ci,7351,9,7,9,20,36,62,-26,30
Cowdenbeath,7351,10,5,10,21,24,54,-30,25
Montrose,7352,1,23,8,5,60,35,25,77
Peterhead,7352,2,24,4,8,79,39,40,76
Stirling,7352,3,17,6,13,63,52,11,57
Clyde,7352,4,15,9,12,53,49,4,54
Stenhousem'r,7352,5,15,8,13,56,49,7,53
Elgin,7352,6,14,7,15,54,61,-7,49
Annan Athlet,7352,7,12,11,13,50,42,8,47
Berwick,7352,8,8,10,18,30,60,-30,34
Edinburgh Ci,7352,9,7,9,20,37,62,-25,30
Cowdenbeath,7352,10,4,10,22,24,57,-33,22
Montrose,7353,1,24,7,5,60,34,26,79
Peterhead,7353,2,24,4,8,81,38,43,76
Stirling,7353,3,17,6,13,62,51,11,57
Stenhousem'r,7353,4,15,8,13,55,48,7,53
Clyde,7353,5,14,10,12,51,48,3,52
Elgin,7353,6,14,6,16,53,61,-8,48
Annan Athlet,7353,7,11,11,14,48,43,5,44
Berwick,7353,8,8,11,17,29,58,-29,35
Edinburgh Ci,7353,9,7,9,20,36,64,-28,30
Cowdenbeath,7353,10,5,10,21,25,55,-30,25
Peterhead,7354,1,24,4,8,79,38,41,76
Montrose,7354,2,23,7,6,60,36,24,76
Stirling,7354,3,17,6,13,64,51,13,57
Clyde,7354,4,15,9,12,53,49,4,54
Stenhousem'r,7354,5,15,8,13,55,50,5,53
Elgin,7354,6,15,6,15,55,61,-6,51
Annan Athlet,7354,7,12,11,13,50,42,8,47
Berwick,7354,8,8,10,18,30,60,-30,34
Edinburgh Ci,7354,9,7,9,20,36,62,-26,30
Cowdenbeath,7354,10,4,10,22,24,57,-33,22
Montrose,7355,1,24,7,5,64,34,30,79
Peterhead,7355,2,24,4,8,81,38,43,76
Stirling,7355,3,17,6,13,63,52,11,57
Stenhousem'r,7355,4,15,8,13,56,49,7,53
Clyde,7355,5,14,10,12,54,51,3,52
Elgin,7355,6,14,6,16,53,65,-12,48
Annan Athlet,7355,7,11,11,14,47,42,5,44
Berwick,7355,8,8,11,17,32,61,-29,35
Edinburgh Ci,7355,9,7,9,20,36,64,-28,30
Cowdenbeath,7355,10,5,10,21,24,54,-30,25
Montrose,7356,1,24,7,5,61,35,26,79
Peterhead,7356,2,23,5,8,78,39,39,74
Stirling,7356,3,16,7,13,61,52,9,55
Stenhousem'r,7356,4,15,9,12,56,47,9,54
Clyde,7356,5,14,10,12,53,50,3,52
Elgin,7356,6,14,6,16,54,62,-8,48
Annan Athlet,7356,7,11,11,14,47,42,5,44
Berwick,7356,8,8,11,17,31,60,-29,35
Edinburgh Ci,7356,9,7,10,19,37,61,-24,31
Cowdenbeath,7356,10,5,10,21,24,54,-30,25
Peterhead,7357,1,24,4,8,81,39,42,76
Montrose,7357,2,23,7,6,60,37,23,76
Stirling,7357,3,17,6,13,62,52,10,57
Clyde,7357,4,15,9,12,57,48,9,54
Stenhousem'r,7357,5,15,8,13,56,48,8,53
Elgin,7357,6,15,6,15,56,61,-5,51
Annan Athlet,7357,7,11,12,13,47,41,6,45
Berwick,7357,8,8,10,18,29,64,-35,34
Edinburgh Ci,7357,9,7,9,20,37,64,-27,30
Cowdenbeath,7357,10,4,11,21,23,54,-31,23
Montrose,7358,1,23,7,6,60,36,24,76
Peterhead,7358,2,23,5,8,80,41,39,74
Stenhousem'r,7358,3,16,8,12,58,47,11,56
Stirling,7358,4,16,6,14,61,54,7,54
Clyde,7358,5,14,9,13,52,50,2,51
Elgin,7358,6,15,6,15,55,61,-6,51
Annan Athlet,7358,7,12,11,13,49,42,7,47
Berwick,7358,8,9,10,17,31,59,-28,37
Edinburgh Ci,7358,9,7,10,19,39,63,-24,31
Cowdenbeath,7358,10,4,10,22,24,56,-32,22
Montrose,7359,1,24,7,5,64,35,29,79
Peterhead,7359,2,24,4,8,79,39,40,76
Stirling,7359,3,17,6,13,63,52,11,57
Stenhousem'r,7359,4,15,8,13,56,49,7,53
Clyde,7359,5,14,9,13,52,50,2,51
Elgin,7359,6,14,6,16,54,65,-11,48
Annan Athlet,7359,7,11,11,14,47,42,5,44
Berwick,7359,8,9,10,17,31,59,-28,37
Edinburgh Ci,7359,9,7,9,20,37,62,-25,30
Cowdenbeath,7359,10,5,10,21,24,54,-30,25
Peterhead,7360,1,24,4,8,81,39,42,76
Montrose,7360,2,23,7,6,61,37,24,76
Stenhousem'r,7360,3,16,8,12,59,49,10,56
Stirling,7360,4,16,6,14,63,55,8,54
Clyde,7360,5,15,9,12,52,48,4,54
Elgin,7360,6,15,6,15,56,62,-6,51
Annan Athlet,7360,7,12,11,13,48,41,7,47
Berwick,7360,8,8,10,18,29,59,-30,34
Edinburgh Ci,7360,9,7,9,20,37,64,-27,30
Cowdenbeath,7360,10,4,10,22,23,55,-32,22
Montrose,7361,1,24,7,5,60,34,26,79
Peterhead,7361,2,23,5,8,77,38,39,74
Stenhousem'r,7361,3,16,8,12,59,46,13,56
Stirling,7361,4,16,6,14,60,55,5,54
Clyde,7361,5,15,9,12,52,48,4,54
Elgin,7361,6,14,6,16,53,61,-8,48
Annan Athlet,7361,7,11,11,14,47,42,5,44
Berwick,7361,8,8,10,18,29,59,-30,34
Edinburgh Ci,7361,9,7,10,19,36,60,-24,31
Cowdenbeath,7361,10,5,10,21,24,54,-30,25
Montrose,7362,1,24,7,5,62,34,28,79
Peterhead,7362,2,23,5,8,78,39,39,74
Stirling,7362,3,16,7,13,63,54,9,55
Stenhousem'r,7362,4,15,9,12,58,49,9,54
Clyde,7362,5,15,9,12,53,48,5,54
Elgin,7362,6,14,6,16,53,63,-10,48
Annan Athlet,7362,7,11,11,14,47,43,4,44
Berwick,7362,8,8,10,18,29,60,-31,34
Edinburgh Ci,7362,9,7,10,19,37,61,-24,31
Cowdenbeath,7362,10,5,10,21,25,54,-29,25
Montrose,7363,1,24,7,5,62,35,27,79
Peterhead,7363,2,24,4,8,79,38,41,76
Stirling,7363,3,17,6,13,62,51,11,57
Clyde,7363,4,15,9,12,54,49,5,54
Stenhousem'r,7363,5,15,8,13,55,48,7,53
Elgin,7363,6,14,6,16,54,63,-9,48
Annan Athlet,7363,7,12,11,13,49,41,8,47
Berwick,7363,8,8,10,18,30,61,-31,34
Edinburgh Ci,7363,9,7,9,20,36,62,-26,30
Cowdenbeath,7363,10,4,10,22,23,56,-33,22
Montrose,7364,1,24,7,5,63,37,26,79
Peterhead,7364,2,24,4,8,80,40,40,76
Stenhousem'r,7364,3,16,8,12,56,46,10,56
Stirling,7364,4,16,6,14,60,52,8,54
Clyde,7364,5,15,9,12,55,49,6,54
Elgin,7364,6,14,6,16,56,64,-8,48
Annan Athlet,7364,7,11,12,13,49,43,6,45
Berwick,7364,8,8,10,18,30,62,-32,34
Edinburgh Ci,7364,9,7,9,20,38,63,-25,30
Cowdenbeath,7364,10,4,11,21,25,56,-31,23
Montrose,7365,1,24,7,5,62,34,28,79
Peterhead,7365,2,23,5,8,79,40,39,74
Stirling,7365,3,17,6,13,62,51,11,57
Clyde,7365,4,15,9,12,53,49,4,54
Stenhousem'r,7365,5,15,8,13,55,48,7,53
Elgin,7365,6,14,6,16,53,63,-10,48
Annan Athlet,7365,7,11,12,13,48,42,6,45
Berwick,7365,8,8,10,18,30,60,-30,34
Edinburgh Ci,7365,9,7,10,19,38,62,-24,31
Cowdenbeath,7365,10,4,11,21,24,55,-31,23
Montrose,7366,1,24,7,5,60,34,26,79
Peterhead,7366,2,24,4,8,79,38,41,76
Stirling,7366,3,16,7,13,61,52,9,55
Stenhousem'r,7366,4,15,9,12,56,47,9,54
Clyde,7366,5,15,9,12,53,48,5,54
Elgin,7366,6,14,6,16,53,61,-8,48
Annan Athlet,7366,7,11,12,13,47,41,6,45
Berwick,7366,8,8,10,18,29,60,-31,34
Edinburgh Ci,7366,9,7,9,20,36,62,-26,30
Cowdenbeath,7366,10,4,11,21,23,54,-31,23
Montrose,7367,1,24,7,5,62,34,28,79
Peterhead,7367,2,24,4,8,80,38,42,76
Stenhousem'r,7367,3,16,8,12,58,48,10,56
Stirling,7367,4,16,6,14,62,54,8,54
Clyde,7367,5,15,9,12,53,49,4,54
Elgin,7367,6,14,6,16,53,63,-10,48
Annan Athlet,7367,7,12,11,13,48,41,7,47
Berwick,7367,8,8,10,18,30,60,-30,34
Edinburgh Ci,7367,9,7,9,20,36,63,-27,30
Cowdenbeath,7367,10,4,10,22,23,55,-32,22
Montrose,7368,1,24,7,5,62,36,26,79
Peterhead,7368,2,24,4,8,83,38,45,76
Stenhousem'r,7368,3,16,8,12,58,46,12,56
Stirling,7368,4,16,6,14,60,54,6,54
Clyde,7368,5,14,10,12,52,49,3,52
Elgin,7368,6,14,6,16,55,63,-8,48
Annan Athlet,7368,7,11,12,13,47,41,6,45
Berwick,7368,8,8,11,17,30,59,-29,35
Edinburgh Ci,7368,9,7,9,20,36,66,-30,30
Cowdenbeath,7368,10,4,11,21,23,54,-31,23
Montrose,7369,1,23,7,6,59,35,24,76
Peterhead,7369,2,23,4,9,77,39,38,73
Stirling,7369,3,17,6,13,62,51,11,57
Clyde,7369,4,15,9,12,53,48,5,54
Stenhousem'r,7369,5,15,8,13,55,48,7,53
Elgin,7369,6,15,6,15,54,60,-6,51
Annan Athlet,7369,7,11,11,14,47,42,5,44
Berwick,7369,8,8,10,18,29,60,-31,34
Edinburgh Ci,7369,9,8,9,19,37,60,-23,33
Cowdenbeath,7369,10,5,10,21,24,54,-30,25
Montrose,7370,1,23,8,5,61,36,25,77
Peterhead,7370,2,24,4,8,83,41,42,76
Stenhousem'r,7370,3,16,8,12,59,47,12,56
Stirling,7370,4,16,6,14,61,55,6,54
Clyde,7370,5,15,9,12,52,48,4,54
Elgin,7370,6,14,7,15,55,62,-7,49
Annan Athlet,7370,7,12,11,13,50,41,9,47
Berwick,7370,8,8,10,18,29,59,-30,34
Edinburgh Ci,7370,9,7,9,20,39,66,-27,30
Cowdenbeath,7370,10,4,10,22,23,57,-34,22
Montrose,7371,1,24,7,5,62,34,28,79
Peterhead,7371,2,24,4,8,81,38,43,76
Stirling,7371,3,16,7,13,61,52,9,55
Stenhousem'r,7371,4,15,9,12,56,47,9,54
Clyde,7371,5,14,9,13,51,52,-1,51
Elgin,7371,6,14,6,16,53,63,-10,48
Annan Athlet,7371,7,12,11,13,50,42,8,47
Berwick,7371,8,9,10,17,33,58,-25,37
Edinburgh Ci,7371,9,7,9,20,36,64,-28,30
Cowdenbeath,7371,10,4,10,22,24,57,-33,22
Montrose,7372,1,24,7,5,62,35,27,79
Peterhead,7372,2,24,4,8,78,38,40,76
Stirling,7372,3,17,6,13,62,51,11,57
Stenhousem'r,7372,4,15,8,13,55,48,7,53
Clyde,7372,5,14,10,12,51,48,3,52
Elgin,7372,6,14,6,16,54,63,-9,48
Annan Athlet,7372,7,12,11,13,51,41,10,47
Berwick,7372,8,8,11,17,29,58,-29,35
Edinburgh Ci,7372,9,7,9,20,36,61,-25,30
Cowdenbeath,7372,10,4,10,22,23,58,-35,22
Montrose,7373,1,24,7,5,60,34,26,79
Peterhead,7373,2,24,4,8,82,38,44,76
Stirling,7373,3,16,7,13,61,52,9,55
Stenhousem'r,7373,4,15,9,12,56,47,9,54
Clyde,7373,5,15,9,12,54,48,6,54
Elgin,7373,6,14,6,16,53,61,-8,48
Annan Athlet,7373,7,11,12,13,49,43,6,45
Berwick,7373,8,8,10,18,29,61,-32,34
Edinburgh Ci,7373,9,7,9,20,36,65,-29,30
Cowdenbeath,7373,10,4,11,21,25,56,-31,23
Montrose,7374,1,24,7,5,62,36,26,79
Peterhead,7374,2,24,4,8,81,38,43,76
Stirling,7374,3,16,7,13,63,54,9,55
Stenhousem'r,7374,4,15,9,12,58,49,9,54
Clyde,7374,5,14,10,12,53,50,3,52
Elgin,7374,6,14,6,16,55,63,-8,48
Annan Athlet,7374,7,12,11,13,48,41,7,47
Berwick,7374,8,8,11,17,31,60,-29,35
Edinburgh Ci,7374,9,7,9,20,36,64,-28,30
Cowdenbeath,7374,10,4,10,22,23,55,-32,22
Montrose,7375,1,23,8,5,60,35,25,77
Peterhead,7375,2,24,4,8,80,40,40,76
Stirling,7375,3,17,6,13,63,51,12,57
Clyde,7375,4,15,9,12,54,50,4,54
Stenhousem'r,7375,5,15,8,13,55,49,6,53
Elgin,7375,6,14,7,15,54,61,-7,49
Annan Athlet,7375,7,11,12,13,48,42,6,45
Berwick,7375,8,8,10,18,31,61,-30,34
Edinburgh Ci,7375,9,7,9,20,38,63,-25,30
Cowdenbeath,7375,10,4,11,21,24,55,-31,23
Montrose,7376,1,24,7,5,61,34,27,79
Peterhead,7376,2,24,4,8,81,38,43,76
Stirling,7376,3,16,7,13,61,52,9,55
Stenhousem'r,7376,4,15,9,12,56,47,9,54
Clyde,7376,5,15,9,12,53,48,5,54
Elgin,7376,6,14,6,16,53,62,-9,48
Annan Athlet,7376,7,11,12,13,47,41,6,45
Berwick,7376,8,8,10,18,29,60,-31,34
Edinburgh Ci,7376,9,7,9,20,36,64,-28,30
Cowdenbeath,7376,10,4,11,21,23,54,-31,23
Montrose,7377,1,24,7,5,60,34,26,79
Peterhead,7377,2,24,4,8,79,39,40,76
Stirling,7377,3,17,6,13,62,52,10,57
Clyde,7377,4,15,9,12,54,49,5,54
Stenhousem'r,7377,5,15,8,13,56,48,8,53
Elgin,7377,6,14,6,16,53,61,-8,48
Annan Athlet,7377,7,12,11,13,50,42,8,47
Berwick,7377,8,8,10,18,30,61,-31,34
Edinburgh Ci,7377,9,7,9,20,37,62,-25,30
Cowdenbeath,7377,10,4,10,22,24,57,-33,22
Montrose,7378,1,23,8,5,59,34,25,77
Peterhead,7378,2,24,4,8,79,39,40,76
Stirling,7378,3,17,6,13,61,51,10,57
Stenhousem'r,7378,4,15,8,13,55,47,8,53
Clyde,7378,5,14,10,12,52,49,3,52
Elgin,7378,6,14,7,15,53,60,-7,49
Annan Athlet,7378,7,12,11,13,48,41,7,47
Berwick,7378,8,8,11,17,30,59,-29,35
Edinburgh Ci,7378,9,7,9,20,37,62,-25,30
Cowdenbeath,7378,10,4,10,22,23,55,-32,22
Montrose,7379,1,24,7,5,62,34,28,79
Peterhead,7379,2,23,4,9,77,40,37,73
Stirling,7379,3,17,6,13,63,52,11,57
Stenhousem'r,7379,4,15,8,13,56,49,7,53
Clyde,7379,5,14,9,13,52,50,2,51
Elgin,7379,6,14,6,16,53,63,-10,48
Annan Athlet,7379,7,12,11,13,50,42,8,47
Berwick,7379,8,9,10,17,31,59,-28,37
Edinburgh Ci,7379,9,8,9,19,38,60,-22,33
Cowdenbeath,7379,10,4,10,22,24,57,-33,22
Montrose,7380,1,23,8,5,60,35,25,77
Peterhead,7380,2,24,4,8,79,39,40,76
Stirling,7380,3,17,6,13,63,53,10,57
Clyde,7380,4,15,9,12,53,49,4,54
Stenhousem'r,7380,5,15,8,13,57,49,8,53
Elgin,7380,6,14,7,15,54,61,-7,49
Annan Athlet,7380,7,11,11,14,48,44,4,44
Berwick,7380,8,8,10,18,30,60,-30,34
Edinburgh Ci,7380,9,7,9,20,37,62,-25,30
Cowdenbeath,7380,10,5,10,21,26,55,-29,25
Montrose,7381,1,24,7,5,61,35,26,79
Peterhead,7381,2,24,4,8,80,38,42,76
Stenhousem'r,7381,3,16,8,12,57,46,11,56
Stirling,7381,4,16,6,14,60,53,7,54
Clyde,7381,5,14,9,13,52,50,2,51
Elgin,7381,6,14,6,16,54,62,-8,48
Annan Athlet,7381,7,12,11,13,50,41,9,47
Berwick,7381,8,9,10,17,31,59,-28,37
Edinburgh Ci,7381,9,7,9,20,36,63,-27,30
Cowdenbeath,7381,10,4,10,22,23,57,-34,22
Montrose,7382,1,24,7,5,62,34,28,79
Peterhead,7382,2,24,4,8,82,38,44,76
Stirling,7382,3,17,6,13,62,52,10,57
Clyde,7382,4,15,9,12,53,48,5,54
Stenhousem'r,7382,5,15,8,13,56,48,8,53
Elgin,7382,6,14,6,16,53,63,-10,48
Annan Athlet,7382,7,11,12,13,47,41,6,45
Berwick,7382,8,8,10,18,29,60,-31,34
Edinburgh Ci,7382,9,7,9,20,36,65,-29,30
Cowdenbeath,7382,10,4,11,21,23,54,-31,23
Montrose,7383,1,24,7,5,63,36,27,79
Peterhead,7383,2,24,4,8,79,38,41,76
Stirling,7383,3,17,6,13,66,51,15,57
Clyde,7383,4,15,9,12,53,49,4,54
Stenhousem'r,7383,5,15,8,13,55,52,3,53
Elgin,7383,6,14,6,16,55,64,-9,48
Annan Athlet,7383,7,11,11,14,48,43,5,44
Berwick,7383,8,8,10,18,30,60,-30,34
Edinburgh Ci,7383,9,7,9,20,36,62,-26,30
Cowdenbeath,7383,10,5,10,21,25,55,-30,25
Montrose,7384,1,24,7,5,62,34,28,79
Peterhead,7384,2,23,5,8,78,39,39,74
Stenhousem'r,7384,3,16,8,12,58,48,10,56
Stirling,7384,4,16,6,14,62,54,8,54
Clyde,7384,5,14,10,12,51,48,3,52
Elgin,7384,6,14,6,16,53,63,-10,48
Annan Athlet,7384,7,11,11,14,47,42,5,44
Berwick,7384,8,8,11,17,29,58,-29,35
Edinburgh Ci,7384,9,7,10,19,37,61,-24,31
Cowdenbeath,7384,10,5,10,21,24,54,-30,25
Montrose,7385,1,24,7,5,61,34,27,79
Peterhead,7385,2,23,4,9,79,41,38,73
Stirling,7385,3,17,6,13,67,53,14,57
Stenhousem'r,7385,4,15,8,13,57,53,4,53
Clyde,7385,5,14,10,12,53,50,3,52
Elgin,7385,6,14,6,16,53,62,-9,48
Annan Athlet,7385,7,11,12,13,47,41,6,45
Berwick,7385,8,8,11,17,31,60,-29,35
Edinburgh Ci,7385,9,8,9,19,39,62,-23,33
Cowdenbeath,7385,10,4,11,21,23,54,-31,23
Montrose,7386,1,24,7,5,63,35,28,79
Peterhead,7386,2,24,4,8,79,39,40,76
Stirling,7386,3,16,7,13,63,54,9,55
Stenhousem'r,7386,4,15,9,12,58,49,9,54
Clyde,7386,5,14,10,12,54,51,3,52
Elgin,7386,6,14,6,16,54,64,-10,48
Annan Athlet,7386,7,12,11,13,49,42,7,47
Berwick,7386,8,8,11,17,32,61,-29,35
Edinburgh Ci,7386,9,7,9,20,37,62,-25,30
Cowdenbeath,7386,10,4,10,22,24,56,-32,22
Montrose,7387,1,24,7,5,61,34,27,79
Peterhead,7387,2,24,4,8,79,38,41,76
Stirling,7387,3,16,7,13,61,52,9,55
Stenhousem'r,7387,4,15,9,12,56,47,9,54
Clyde,7387,5,15,9,12,53,49,4,54
Elgin,7387,6,14,6,16,53,62,-9,48
Annan Athlet,7387,7,11,11,14,47,43,4,44
Berwick,7387,8,8,10,18,30,60,-30,34
Edinburgh Ci,7387,9,7,9,20,36,62,-26,30
Cowdenbeath,7387,10,5,10,21,25,54,-29,25
Montrose,7388,1,23,8,5,61,36,25,77
Peterhead,7388,2,24,4,8,78,38,40,76
Stirling,7388,3,16,7,13,60,51,9,55
Stenhousem'r,7388,4,15,9,12,55,46,9,54
Clyde,7388,5,14,9,13,51,49,2,51
Elgin,7388,6,14,7,15,55,62,-7,49
Annan Athlet,7388,7,12,11,13,48,41,7,47
Berwick,7388,8,9,10,17,30,58,-28,37
Edinburgh Ci,7388,9,7,9,20,36,61,-25,30
Cowdenbeath,7388,10,4,10,22,23,55,-32,22
Montrose,7389,1,24,7,5,63,36,27,79
Peterhead,7389,2,24,4,8,79,39,40,76
Stenhousem'r,7389,3,16,8,12,59,48,11,56
Stirling,7389,4,16,6,14,62,55,7,54
Clyde,7389,5,15,9,12,52,48,4,54
Elgin,7389,6,14,6,16,55,64,-9,48
Annan Athlet,7389,7,12,11,13,48,41,7,47
Berwick,7389,8,8,10,18,29,59,-30,34
Edinburgh Ci,7389,9,7,9,20,37,62,-25,30
Cowdenbeath,7389,10,4,10,22,23,55,-32,22
Montrose,7390,1,24,7,5,60,34,26,79
Peterhead,7390,2,24,4,8,79,39,40,76
Stirling,7390,3,17,6,13,62,51,11,57
Clyde,7390,4,15,9,12,54,49,5,54
Stenhousem'r,7390,5,15,8,13,55,48,7,53
Elgin,7390,6,14,6,16,53,61,-8,48
Annan Athlet,7390,7,11,11,14,48,43,5,44
Berwick,7390,8,8,10,18,30,61,-31,34
Edinburgh Ci,7390,9,7,9,20,37,62,-25,30
Cowdenbeath,7390,10,5,10,21,25,55,-30,25
Montrose,7391,1,24,7,5,63,34,29,79
Peterhead,7391,2,23,5,8,78,39,39,74
Stenhousem'r,7391,3,16,8,12,57,47,10,56
Stirling,7391,4,16,6,14,61,53,8,54
Clyde,7391,5,15,9,12,56,48,8,54
Elgin,7391,6,14,6,16,53,64,-11,48
Annan Athlet,7391,7,11,12,13,49,43,6,45
Berwick,7391,8,8,10,18,29,63,-34,34
Edinburgh Ci,7391,9,7,10,19,37,61,-24,31
Cowdenbeath,7391,10,4,11,21,25,56,-31,23
Montrose,7392,1,24,7,5,60,34,26,79
Peterhead,7392,2,24,4,8,79,38,41,76
Stenhousem'r,7392,3,16,8,12,58,47,11,56
Stirling,7392,4,16,6,14,61,54,7,54
Clyde,7392,5,15,9,12,52,48,4,54
Elgin,7392,6,14,6,16,53,61,-8,48
Annan Athlet,7392,7,12,11,13,49,42,7,47
Berwick,7392,8,8,10,18,29,59,-30,34
Edinburgh Ci,7392,9,7,9,20,36,62,-26,30
Cowdenbeath,7392,10,4,10,22,24,56,-32,22
Montrose,7393,1,24,7,5,61,35,26,79
Peterhead,7393,2,23,5,8,79,40,39,74
Stirling,7393,3,16,7,13,62,53,9,55
Stenhousem'r,7393,4,15,9,12,57,48,9,54
Clyde,7393,5,15,9,12,53,48,5,54
Elgin,7393,6,14,6,16,54,62,-8,48
Annan Athlet,7393,7,12,11,13,49,41,8,47
Berwick,7393,8,8,10,18,29,60,-31,34
Edinburgh Ci,7393,9,7,10,19,38,62,-24,31
Cowdenbeath,7393,10,4,10,22,23,56,-33,22
Montrose,7394,1,24,7,5,62,35,27,79
Peterhead,7394,2,24,4,8,84,38,46,76
Stirling,7394,3,16,7,13,63,54,9,55
Stenhousem'r,7394,4,15,9,12,58,49,9,54
Clyde,7394,5,15,9,12,54,49,5,54
Elgin,7394,6,14,6,16,54,63,-9,48
Annan Athlet,7394,7,12,11,13,49,42,7,47
Berwick,7394,8,8,10,18,30,61,-31,34
Edinburgh Ci,7394,9,7,9,20,36,67,-31,30
Cowdenbeath,7394,10,4,10,22,24,56,-32,22
Montrose,7395,1,24,7,5,61,35,26,79
Peterhead,7395,2,24,4,8,79,38,41,76
Stenhousem'r,7395,3,16,8,12,58,46,12,56
Stirling,7395,4,16,6,14,60,54,6,54
Clyde,7395,5,15,9,12,53,49,4,54
Elgin,7395,6,14,6,16,54,62,-8,48
Annan Athlet,7395,7,11,11,14,48,43,5,44
Berwick,7395,8,8,10,18,30,60,-30,34
Edinburgh Ci,7395,9,7,9,20,36,62,-26,30
Cowdenbeath,7395,10,5,10,21,25,55,-30,25
Montrose,7396,1,24,7,5,63,36,27,79
Peterhead,7396,2,24,4,8,81,41,40,76
Stirling,7396,3,17,6,13,63,52,11,57
Stenhousem'r,7396,4,15,8,13,56,49,7,53
Clyde,7396,5,14,9,13,51,51,0,51
Elgin,7396,6,14,6,16,55,64,-9,48
Annan Athlet,7396,7,11,12,13,47,41,6,45
Berwick,7396,8,9,10,17,32,58,-26,37
Edinburgh Ci,7396,9,7,9,20,39,64,-25,30
Cowdenbeath,7396,10,4,11,21,23,54,-31,23
Montrose,7397,1,23,7,6,59,35,24,76
Peterhead,7397,2,23,5,8,77,38,39,74
Stirling,7397,3,17,6,13,63,53,10,57
Clyde,7397,4,15,9,12,52,48,4,54
Stenhousem'r,7397,5,15,8,13,57,49,8,53
Elgin,7397,6,15,6,15,54,60,-6,51
Annan Athlet,7397,7,11,11,14,47,43,4,44
Berwick,7397,8,8,10,18,29,59,-30,34
Edinburgh Ci,7397,9,7,10,19,36,60,-24,31
Cowdenbeath,7397,10,5,10,21,25,54,-29,25
Peterhead,7398,1,24,4,8,78,38,40,76
Montrose,7398,2,23,7,6,59,35,24,76
Stirling,7398,3,16,7,13,61,52,9,55
Stenhousem'r,7398,4,15,9,12,56,47,9,54
Clyde,7398,5,14,9,13,52,50,2,51
Elgin,7398,6,15,6,15,54,60,-6,51
Annan Athlet,7398,7,11,12,13,47,41,6,45
Berwick,7398,8,9,10,17,31,59,-28,37
Edinburgh Ci,7398,9,7,9,20,36,61,-25,30
Cowdenbeath,7398,10,4,11,21,23,54,-31,23
Montrose,7399,1,24,7,5,61,34,27,79
Peterhead,7399,2,24,4,8,79,38,41,76
Stenhousem'r,7399,3,16,8,12,56,46,10,56
Stirling,7399,4,16,6,14,60,52,8,54
Clyde,7399,5,14,10,12,53,50,3,52
Elgin,7399,6,14,6,16,53,62,-9,48
Annan Athlet,7399,7,11,11,14,48,43,5,44
Berwick,7399,8,8,11,17,31,60,-29,35
Edinburgh Ci,7399,9,7,9,20,36,62,-26,30
Cowdenbeath,7399,10,5,10,21,25,55,-30,25
Montrose,7400,1,24,7,5,65,36,29,79
Peterhead,7400,2,24,4,8,80,38,42,76
Stirling,7400,3,17,6,13,61,51,10,57
Stenhousem'r,7400,4,15,8,13,55,47,8,53
Clyde,7400,5,14,9,13,51,49,2,51
Elgin,7400,6,14,6,16,55,66,-11,48
Annan Athlet,7400,7,11,12,13,47,41,6,45
Berwick,7400,8,9,10,17,30,58,-28,37
Edinburgh Ci,7400,9,7,9,20,36,63,-27,30
Cowdenbeath,7400,10,4,11,21,23,54,-31,23
Montrose,7401,1,23,8,5,60,35,25,77
Peterhead,7401,2,24,4,8,79,39,40,76
Stenhousem'r,7401,3,16,8,12,57,47,10,56
Stirling,7401,4,16,6,14,61,53,8,54
Clyde,7401,5,14,10,12,52,49,3,52
Elgin,7401,6,14,7,15,54,61,-7,49
Annan Athlet,7401,7,11,12,13,48,42,6,45
Berwick,7401,8,8,11,17,30,59,-29,35
Edinburgh Ci,7401,9,7,9,20,37,62,-25,30
Cowdenbeath,7401,10,4,11,21,24,55,-31,23
Montrose,7402,1,24,7,5,61,34,27,79
Peterhead,7402,2,24,4,8,80,39,41,76
Stenhousem'r,7402,3,16,8,12,56,46,10,56
Stirling,7402,4,16,6,14,60,52,8,54
Clyde,7402,5,15,9,12,53,49,4,54
Elgin,7402,6,14,6,16,53,62,-9,48
Annan Athlet,7402,7,12,11,13,49,42,7,47
Berwick,7402,8,8,10,18,30,60,-30,34
Edinburgh Ci,7402,9,7,9,20,37,63,-26,30
Cowdenbeath,7402,10,4,10,22,24,56,-32,22
Montrose,7403,1,24,7,5,62,34,28,79
Peterhead,7403,2,24,4,8,79,39,40,76
Stenhousem'r,7403,3,16,8,12,57,47,10,56
Stirling,7403,4,16,6,14,61,53,8,54
Clyde,7403,5,15,9,12,54,49,5,54
Elgin,7403,6,14,6,16,53,63,-10,48
Annan Athlet,7403,7,12,11,13,49,42,7,47
Berwick,7403,8,8,10,18,30,61,-31,34
Edinburgh Ci,7403,9,7,9,20,37,62,-25,30
Cowdenbeath,7403,10,4,10,22,24,56,-32,22
Montrose,7404,1,24,7,5,61,35,26,79
Peterhead,7404,2,24,4,8,81,39,42,76
Stirling,7404,3,17,6,13,62,52,10,57
Clyde,7404,4,15,9,12,53,48,5,54
Stenhousem'r,7404,5,15,8,13,56,48,8,53
Elgin,7404,6,14,6,16,54,62,-8,48
Annan Athlet,7404,7,11,12,13,48,42,6,45
Berwick,7404,8,8,10,18,29,60,-31,34
Edinburgh Ci,7404,9,7,9,20,37,64,-27,30
Cowdenbeath,7404,10,4,11,21,24,55,-31,23
Montrose,7405,1,24,7,5,61,34,27,79
Peterhead,7405,2,24,4,8,80,38,42,76
Stirling,7405,3,17,6,13,62,51,11,57
Stenhousem'r,7405,4,15,8,13,55,48,7,53
Clyde,7405,5,14,10,12,51,48,3,52
Elgin,7405,6,14,6,16,53,62,-9,48
Annan Athlet,7405,7,12,11,13,50,43,7,47
Berwick,7405,8,8,11,17,29,58,-29,35
Edinburgh Ci,7405,9,7,9,20,36,63,-27,30
Cowdenbeath,7405,10,4,10,22,25,57,-32,22
Peterhead,7406,1,24,4,8,82,39,43,76
Montrose,7406,2,23,7,6,60,37,23,76
Stirling,7406,3,16,7,13,62,53,9,55
Stenhousem'r,7406,4,15,9,12,57,48,9,54
Clyde,7406,5,15,9,12,54,48,6,54
Elgin,7406,6,15,6,15,56,61,-5,51
Annan Athlet,7406,7,11,12,13,48,42,6,45
Berwick,7406,8,8,10,18,29,61,-32,34
Edinburgh Ci,7406,9,7,9,20,37,65,-28,30
Cowdenbeath,7406,10,4,11,21,24,55,-31,23
Montrose,7407,1,24,7,5,64,36,28,79
Peterhead,7407,2,24,4,8,78,38,40,76
Stirling,7407,3,17,6,13,62,51,11,57
Stenhousem'r,7407,4,15,8,13,55,48,7,53
Clyde,7407,5,14,10,12,51,48,3,52
Elgin,7407,6,14,6,16,55,65,-10,48
Annan Athlet,7407,7,11,11,14,47,42,5,44
Berwick,7407,8,8,11,17,29,58,-29,35
Edinburgh Ci,7407,9,7,9,20,36,61,-25,30
Cowdenbeath,7407,10,5,10,21,24,54,-30,25
Montrose,7408,1,24,7,5,61,34,27,79
Peterhead,7408,2,24,4,8,80,38,42,76
Stirling,7408,3,17,6,13,67,52,15,57
Clyde,7408,4,15,9,12,55,50,5,54
Stenhousem'r,7408,5,15,8,13,56,53,3,53
Elgin,7408,6,14,6,16,53,62,-9,48
Annan Athlet,7408,7,11,12,13,47,41,6,45
Berwick,7408,8,8,10,18,31,62,-31,34
Edinburgh Ci,7408,9,7,9,20,36,63,-27,30
Cowdenbeath,7408,10,4,11,21,23,54,-31,23
Montrose,7409,1,23,8,5,60,35,25,77
Peterhead,7409,2,24,4,8,82,38,44,76
Stirling,7409,3,17,6,13,64,53,11,57
Clyde,7409,4,15,9,12,54,48,6,54
Stenhousem'r,7409,5,15,8,13,57,50,7,53
Elgin,7409,6,14,7,15,54,61,-7,49
Annan Athlet,7409,7,12,11,13,51,42,9,47
Berwick,7409,8,8,10,18,29,61,-32,34
Edinburgh Ci,7409,9,7,9,20,36,65,-29,30
Cowdenbeath,7409,10,4,10,22,24,58,-34,22
Montrose,7410,1,23,8,5,60,35,25,77
Peterhead,7410,2,23,4,9,77,39,38,73
Stirling,7410,3,17,6,13,61,51,10,57
Clyde,7410,4,15,9,12,57,48,9,54
Stenhousem'r,7410,5,15,8,13,55,47,8,53
Elgin,7410,6,14,7,15,54,61,-7,49
Annan Athlet,7410,7,11,11,14,47,43,4,44
Berwick,7410,8,8,10,18,29,64,-35,34
Edinburgh Ci,7410,9,8,9,19,37,60,-23,33
Cowdenbeath,7410,10,5,10,21,25,54,-29,25
Montrose,7411,1,23,8,5,61,36,25,77
Peterhead,7411,2,23,5,8,79,40,39,74
Stirling,7411,3,17,6,13,64,52,12,57
Clyde,7411,4,15,9,12,56,48,8,54
Stenhousem'r,7411,5,15,8,13,56,50,6,53
Elgin,7411,6,14,7,15,55,62,-7,49
Annan Athlet,7411,7,12,11,13,48,41,7,47
Berwick,7411,8,8,10,18,29,63,-34,34
Edinburgh Ci,7411,9,7,10,19,38,62,-24,31
Cowdenbeath,7411,10,4,10,22,23,55,-32,22
Montrose,7412,1,24,7,5,60,34,26,79
Peterhead,7412,2,24,4,8,81,38,43,76
Stirling,7412,3,16,7,13,61,52,9,55
Stenhousem'r,7412,4,15,9,12,56,47,9,54
Clyde,7412,5,14,10,12,54,51,3,52
Elgin,7412,6,14,6,16,53,61,-8,48
Annan Athlet,7412,7,11,12,13,48,42,6,45
Berwick,7412,8,8,11,17,32,61,-29,35
Edinburgh Ci,7412,9,7,9,20,36,64,-28,30
Cowdenbeath,7412,10,4,11,21,24,55,-31,23
Montrose,7413,1,23,8,5,60,35,25,77
Peterhead,7413,2,24,4,8,79,39,40,76
Stenhousem'r,7413,3,16,8,12,56,46,10,56
Stirling,7413,4,16,6,14,60,52,8,54
Clyde,7413,5,14,9,13,54,52,2,51
Elgin,7413,6,14,7,15,54,61,-7,49
Annan Athlet,7413,7,11,11,14,48,43,5,44
Berwick,7413,8,9,10,17,33,61,-28,37
Edinburgh Ci,7413,9,7,9,20,37,62,-25,30
Cowdenbeath,7413,10,5,10,21,25,55,-30,25
Peterhead,7414,1,24,4,8,80,38,42,76
Montrose,7414,2,23,7,6,61,39,22,76
Stenhousem'r,7414,3,16,8,12,59,47,12,56
Stirling,7414,4,16,6,14,61,55,6,54
Clyde,7414,5,15,9,12,52,48,4,54
Elgin,7414,6,15,6,15,58,62,-4,51
Annan Athlet,7414,7,11,11,14,47,42,5,44
Berwick,7414,8,8,10,18,29,59,-30,34
Edinburgh Ci,7414,9,7,9,20,36,63,-27,30
Cowdenbeath,7414,10,5,10,21,24,54,-30,25
Montrose,7415,1,24,7,5,62,34,28,79
Peterhead,7415,2,24,4,8,81,38,43,76
Stenhousem'r,7415,3,16,8,12,57,46,11,56
Stirling,7415,4,16,6,14,60,53,7,54
Clyde,7415,5,15,9,12,54,50,4,54
Elgin,7415,6,14,6,16,53,63,-10,48
Annan Athlet,7415,7,11,11,14,47,42,5,44
Berwick,7415,8,8,10,18,31,61,-30,34
Edinburgh Ci,7415,9,7,9,20,36,64,-28,30
Cowdenbeath,7415,10,5,10,21,24,54,-30,25
Montrose,7416,1,24,7,5,64,35,29,79
Peterhead,7416,2,24,4,8,80,39,41,76
Stirling,7416,3,17,6,13,62,51,11,57
Stenhousem'r,7416,4,15,8,13,55,48,7,53
Clyde,7416,5,14,9,13,52,50,2,51
Elgin,7416,6,14,6,16,54,65,-11,48
Annan Athlet,7416,7,11,12,13,47,41,6,45
Berwick,7416,8,9,10,17,31,59,-28,37
Edinburgh Ci,7416,9,7,9,20,37,63,-26,30
Cowdenbeath,7416,10,4,11,21,23,54,-31,23
Montrose,7417,1,24,7,5,60,34,26,79
Peterhead,7417,2,23,5,8,78,39,39,74
Stirling,7417,3,17,6,13,64,51,13,57
Clyde,7417,4,15,9,12,53,48,5,54
Stenhousem'r,7417,5,15,8,13,55,50,5,53
Elgin,7417,6,14,6,16,53,61,-8,48
Annan Athlet,7417,7,12,11,13,50,41,9,47
Berwick,7417,8,8,10,18,29,60,-31,34
Edinburgh Ci,7417,9,7,10,19,37,61,-24,31
Cowdenbeath,7417,10,4,10,22,23,57,-34,22
Montrose,7418,1,23,7,6,61,37,24,76
Peterhead,7418,2,23,5,8,78,39,39,74
Stirling,7418,3,17,6,13,64,52,12,57
Clyde,7418,4,15,9,12,53,48,5,54
Stenhousem'r,7418,5,15,8,13,56,50,6,53
Elgin,7418,6,15,6,15,56,62,-6,51
Annan Athlet,7418,7,12,11,13,50,42,8,47
Berwick,7418,8,8,10,18,29,60,-31,34
Edinburgh Ci,7418,9,7,10,19,37,61,-24,31
Cowdenbeath,7418,10,4,10,22,24,57,-33,22
Montrose,7419,1,24,7,5,63,34,29,79
Peterhead,7419,2,24,4,8,79,38,41,76
Stirling,7419,3,16,7,13,61,52,9,55
Stenhousem'r,7419,4,15,9,12,56,47,9,54
Clyde,7419,5,14,10,12,51,48,3,52
Elgin,7419,6,14,6,16,53,64,-11,48
Annan Athlet,7419,7,11,12,13,48,42,6,45
Berwick,7419,8,8,11,17,29,58,-29,35
Edinburgh Ci,7419,9,7,9,20,36,62,-26,30
Cowdenbeath,7419,10,4,11,21,24,55,-31,23
Montrose,7420,1,24,7,5,66,34,32,79
Peterhead,7420,2,24,4,8,79,39,40,76
Stenhousem'r,7420,3,16,8,12,57,47,10,56
Stirling,7420,4,16,6,14,61,53,8,54
Clyde,7420,5,15,9,12,52,48,4,54
Elgin,7420,6,14,6,16,53,67,-14,48
Annan Athlet,7420,7,11,11,14,49,44,5,44
Berwick,7420,8,8,10,18,29,59,-30,34
Edinburgh Ci,7420,9,7,9,20,37,62,-25,30
Cowdenbeath,7420,10,5,10,21,26,56,-30,25
Montrose,7421,1,23,7,6,59,35,24,76
Peterhead,7421,2,23,5,8,79,40,39,74
Stenhousem'r,7421,3,16,8,12,56,46,10,56
Stirling,7421,4,16,6,14,60,52,8,54
Clyde,7421,5,15,9,12,52,48,4,54
Elgin,7421,6,15,6,15,54,60,-6,51
Annan Athlet,7421,7,11,12,13,48,42,6,45
Berwick,7421,8,8,10,18,29,59,-30,34
Edinburgh Ci,7421,9,7,10,19,38,62,-24,31
Cowdenbeath,7421,10,4,11,21,24,55,-31,23
Peterhead,7422,1,24,4,8,79,38,41,76
Montrose,7422,2,23,7,6,62,39,23,76
Stirling,7422,3,17,6,13,61,51,10,57
Stenhousem'r,7422,4,15,8,13,55,47,8,53
Clyde,7422,5,14,9,13,52,50,2,51
Elgin,7422,6,15,6,15,58,63,-5,51
Annan Athlet,7422,7,11,11,14,48,44,4,44
Berwick,7422,8,9,10,17,31,59,-28,37
Edinburgh Ci,7422,9,7,9,20,36,62,-26,30
Cowdenbeath,7422,10,5,10,21,26,55,-29,25
Montrose,7423,1,24,7,5,63,36,27,79
Peterhead,7423,2,24,4,8,78,38,40,76
Stirling,7423,3,17,6,13,61,51,10,57
Clyde,7423,4,15,9,12,55,49,6,54
Stenhousem'r,7423,5,15,8,13,55,47,8,53
Elgin,7423,6,14,6,16,55,64,-9,48
Annan Athlet,7423,7,11,12,13,49,43,6,45
Berwick,7423,8,8,10,18,30,62,-32,34
Edinburgh Ci,7423,9,7,9,20,36,61,-25,30
Cowdenbeath,7423,10,4,11,21,25,56,-31,23
Montrose,7424,1,24,7,5,61,35,26,79
Peterhead,7424,2,24,4,8,81,39,42,76
Stirling,7424,3,17,6,13,62,51,11,57
Clyde,7424,4,15,9,12,52,48,4,54
Stenhousem'r,7424,5,15,8,13,55,48,7,53
Elgin,7424,6,14,6,16,54,62,-8,48
Annan Athlet,7424,7,11,12,13,47,41,6,45
Berwick,7424,8,8,10,18,29,59,-30,34
Edinburgh Ci,7424,9,7,9,20,37,64,-27,30
Cowdenbeath,7424,10,4,11,21,23,54,-31,23
Montrose,7425,1,23,8,5,59,34,25,77
Peterhead,7425,2,24,4,8,79,39,40,76
Stirling,7425,3,17,6,13,62,52,10,57
Stenhousem'r,7425,4,15,8,13,56,48,8,53
Clyde,7425,5,14,10,12,53,50,3,52
Elgin,7425,6,14,7,15,53,60,-7,49
Annan Athlet,7425,7,12,11,13,49,42,7,47
Berwick,7425,8,8,11,17,31,60,-29,35
Edinburgh Ci,7425,9,7,9,20,37,62,-25,30
Cowdenbeath,7425,10,4,10,22,24,56,-32,22
Montrose,7426,1,23,8,5,60,35,25,77
Peterhead,7426,2,23,5,8,79,40,39,74
Stirling,7426,3,17,6,13,63,53,10,57
Clyde,7426,4,15,9,12,54,50,4,54
Stenhousem'r,7426,5,15,8,13,57,49,8,53
Elgin,7426,6,14,7,15,54,61,-7,49
Annan Athlet,7426,7,12,11,13,48,41,7,47
Berwick,7426,8,8,10,18,31,61,-30,34
Edinburgh Ci,7426,9,7,10,19,38,62,-24,31
Cowdenbeath,7426,10,4,10,22,23,55,-32,22
Montrose,7427,1,24,7,5,61,34,27,79
Peterhead,7427,2,23,5,8,79,40,39,74
Stirling,7427,3,17,6,13,62,52,10,57
Clyde,7427,4,15,9,12,53,48,5,54
Stenhousem'r,7427,5,15,8,13,56,48,8,53
Elgin,7427,6,14,6,16,53,62,-9,48
Annan Athlet,7427,7,12,11,13,50,42,8,47
Berwick,7427,8,8,10,18,29,60,-31,34
Edinburgh Ci,7427,9,7,10,19,38,62,-24,31
Cowdenbeath,7427,10,4,10,22,24,57,-33,22
Montrose,7428,1,23,8,5,60,35,25,77
Peterhead,7428,2,23,5,8,80,41,39,74
Stenhousem'r,7428,3,16,8,12,56,46,10,56
Stirling,7428,4,16,6,14,60,52,8,54
Clyde,7428,5,14,9,13,52,50,2,51
Elgin,7428,6,14,7,15,54,61,-7,49
Annan Athlet,7428,7,11,11,14,47,44,3,44
Berwick,7428,8,9,10,17,31,59,-28,37
Edinburgh Ci,7428,9,7,10,19,39,63,-24,31
Cowdenbeath,7428,10,5,10,21,26,54,-28,25
Montrose,7429,1,24,7,5,60,34,26,79
Peterhead,7429,2,24,4,8,79,38,41,76
Stenhousem'r,7429,3,16,8,12,58,48,10,56
Stirling,7429,4,16,6,14,62,54,8,54
Clyde,7429,5,15,9,12,54,49,5,54
Elgin,7429,6,14,6,16,53,61,-8,48
Annan Athlet,7429,7,11,12,13,48,42,6,45
Berwick,7429,8,8,10,18,30,61,-31,34
Edinburgh Ci,7429,9,7,9,20,36,62,-26,30
Cowdenbeath,7429,10,4,11,21,24,55,-31,23
Peterhead,7430,1,24,4,8,78,38,40,76
Montrose,7430,2,23,7,6,59,35,24,76
Stenhousem'r,7430,3,16,8,12,57,47,10,56
Stirling,7430,4,16,6,14,61,53,8,54
Clyde,7430,5,14,10,12,52,49,3,52
Elgin,7430,6,15,6,15,54,60,-6,51
Annan Athlet,7430,7,11,11,14,47,42,5,44
Berwick,7430,8,8,11,17,30,59,-29,35
Edinburgh Ci,7430,9,7,9,20,36,61,-25,30
Cowdenbeath,7430,10,5,10,21,24,54,-30,25
Montrose,7431,1,23,8,5,60,35,25,77
Peterhead,7431,2,24,4,8,81,39,42,76
Stenhousem'r,7431,3,16,8,12,56,46,10,56
Stirling,7431,4,16,6,14,60,52,8,54
Clyde,7431,5,15,9,12,54,50,4,54
Elgin,7431,6,14,7,15,54,61,-7,49
Annan Athlet,7431,7,11,11,14,47,42,5,44
Berwick,7431,8,8,10,18,31,61,-30,34
Edinburgh Ci,7431,9,7,9,20,37,64,-27,30
Cowdenbeath,7431,10,5,10,21,24,54,-30,25
Montrose,7432,1,24,7,5,62,36,26,79
Peterhead,7432,2,24,4,8,83,38,45,76
Stirling,7432,3,16,7,13,63,54,9,55
Stenhousem'r,7432,4,15,9,12,58,49,9,54
Clyde,7432,5,14,10,12,53,50,3,52
Elgin,7432,6,14,6,16,55,63,-8,48
Annan Athlet,7432,7,12,11,13,49,42,7,47
Berwick,7432,8,8,11,17,31,60,-29,35
Edinburgh Ci,7432,9,7,9,20,36,66,-30,30
Cowdenbeath,7432,10,4,10,22,24,56,-32,22
Montrose,7433,1,24,7,5,63,36,27,79
Peterhead,7433,2,24,4,8,80,38,42,76
Stenhousem'r,7433,3,16,8,12,56,46,10,56
Stirling,7433,4,16,6,14,60,52,8,54
Clyde,7433,5,14,10,12,52,49,3,52
Elgin,7433,6,14,6,16,55,64,-9,48
Annan Athlet,7433,7,12,11,13,50,43,7,47
Berwick,7433,8,8,11,17,30,59,-29,35
Edinburgh Ci,7433,9,7,9,20,36,63,-27,30
Cowdenbeath,7433,10,4,10,22,25,57,-32,22
Montrose,7434,1,24,7,5,62,36,26,79
Peterhead,7434,2,24,4,8,79,39,40,76
Stenhousem'r,7434,3,16,8,12,60,46,14,56
Stirling,7434,4,16,6,14,60,56,4,54
Clyde,7434,5,15,9,12,52,48,4,54
Elgin,7434,6,14,6,16,55,63,-8,48
Annan Athlet,7434,7,11,11,14,48,43,5,44
Berwick,7434,8,8,10,18,29,59,-30,34
Edinburgh Ci,7434,9,7,9,20,37,62,-25,30
Cowdenbeath,7434,10,5,10,21,25,55,-30,25
Montrose,7435,1,23,7,6,59,35,24,76
Peterhead,7435,2,23,5,8,77,38,39,74
Stirling,7435,3,17,6,13,64,52,12,57
Stenhousem'r,7435,4,15,8,13,56,50,6,53
Clyde,7435,5,14,9,13,53,51,2,51
Elgin,7435,6,15,6,15,54,60,-6,51
Annan Athlet,7435,7,11,11,14,47,43,4,44
Berwick,7435,8,9,10,17,32,60,-28,37
Edinburgh Ci,7435,9,7,10,19,36,60,-24,31
Cowdenbeath,7435,10,5,10,21,25,54,-29,25
Montrose,7436,1,24,7,5,62,35,27,79
Peterhead,7436,2,24,4,8,80,39,41,76
Stenhousem'r,7436,3,16,8,12,58,47,11,56
Stirling,7436,4,16,6,14,61,54,7,54
Clyde,7436,5,15,9,12,54,48,6,54
Elgin,7436,6,14,6,16,54,63,-9,48
Annan Athlet,7436,7,11,11,14,48,43,5,44
Berwick,7436,8,8,10,18,29,61,-32,34
Edinburgh Ci,7436,9,7,9,20,37,63,-26,30
Cowdenbeath,7436,10,5,10,21,25,55,-30,25
Montrose,7437,1,24,7,5,63,35,28,79
Peterhead,7437,2,24,4,8,83,38,45,76
Stirling,7437,3,17,6,13,63,51,12,57
Stenhousem'r,7437,4,15,8,13,55,49,6,53
Clyde,7437,5,14,9,13,51,52,-1,51
Elgin,7437,6,14,6,16,54,64,-10,48
Annan Athlet,7437,7,12,11,13,50,41,9,47
Berwick,7437,8,9,10,17,33,58,-25,37
Edinburgh Ci,7437,9,7,9,20,36,66,-30,30
Cowdenbeath,7437,10,4,10,22,23,57,-34,22
Peterhead,7438,1,24,4,8,82,39,43,76
Montrose,7438,2,23,7,6,59,35,24,76
Stirling,7438,3,16,7,13,61,52,9,55
Stenhousem'r,7438,4,15,9,12,56,47,9,54
Clyde,7438,5,14,10,12,51,48,3,52
Elgin,7438,6,15,6,15,54,60,-6,51
Annan Athlet,7438,7,11,12,13,48,42,6,45
Berwick,7438,8,8,11,17,29,58,-29,35
Edinburgh Ci,7438,9,7,9,20,37,65,-28,30
Cowdenbeath,7438,10,4,11,21,24,55,-31,23
Montrose,7439,1,24,7,5,62,34,28,79
Peterhead,7439,2,24,4,8,81,38,43,76
Stirling,7439,3,17,6,13,63,51,12,57
Stenhousem'r,7439,4,15,8,13,55,49,6,53
Clyde,7439,5,14,9,13,52,50,2,51
Elgin,7439,6,14,6,16,53,63,-10,48
Annan Athlet,7439,7,12,11,13,48,41,7,47
Berwick,7439,8,9,10,17,31,59,-28,37
Edinburgh Ci,7439,9,7,9,20,36,64,-28,30
Cowdenbeath,7439,10,4,10,22,23,55,-32,22
Montrose,7440,1,24,7,5,64,34,30,79
Peterhead,7440,2,24,4,8,79,39,40,76
Stirling,7440,3,16,7,13,61,52,9,55
Stenhousem'r,7440,4,15,9,12,56,47,9,54
Clyde,7440,5,15,9,12,54,50,4,54
Elgin,7440,6,14,6,16,53,65,-12,48
Annan Athlet,7440,7,11,12,13,48,42,6,45
Berwick,7440,8,8,10,18,31,61,-30,34
Edinburgh Ci,7440,9,7,9,20,37,62,-25,30
Cowdenbeath,7440,10,4,11,21,24,55,-31,23
Montrose,7441,1,24,7,5,62,35,27,79
Peterhead,7441,2,24,4,8,80,38,42,76
Stenhousem'r,7441,3,16,8,12,58,48,10,56
Stirling,7441,4,16,6,14,62,54,8,54
Clyde,7441,5,14,10,12,52,49,3,52
Elgin,7441,6,14,6,16,54,63,-9,48
Annan Athlet,7441,7,12,11,13,49,42,7,47
Berwick,7441,8,8,11,17,30,59,-29,35
Edinburgh Ci,7441,9,7,9,20,36,63,-27,30
Cowdenbeath,7441,10,4,10,22,24,56,-32,22
Montrose,7442,1,23,8,5,61,36,25,77
Peterhead,7442,2,24,4,8,80,38,42,76
Stirling,7442,3,17,6,13,63,51,12,57
Stenhousem'r,7442,4,15,8,13,55,49,6,53
Clyde,7442,5,14,9,13,52,51,1,51
Elgin,7442,6,14,7,15,55,62,-7,49
Annan Athlet,7442,7,11,11,14,48,43,5,44
Berwick,7442,8,9,10,17,32,59,-27,37
Edinburgh Ci,7442,9,7,9,20,36,63,-27,30
Cowdenbeath,7442,10,5,10,21,25,55,-30,25
Montrose,7443,1,23,8,5,61,36,25,77
Peterhead,7443,2,23,5,8,79,40,39,74
Stirling,7443,3,16,7,13,60,51,9,55
Stenhousem'r,7443,4,15,9,12,55,46,9,54
Clyde,7443,5,15,9,12,54,48,6,54
Elgin,7443,6,14,7,15,55,62,-7,49
Annan Athlet,7443,7,11,11,14,47,43,4,44
Berwick,7443,8,8,10,18,29,61,-32,34
Edinburgh Ci,7443,9,7,10,19,38,62,-24,31
Cowdenbeath,7443,10,5,10,21,25,54,-29,25
Montrose,7444,1,23,8,5,62,37,25,77
Peterhead,7444,2,24,4,8,80,39,41,76
Stirling,7444,3,17,6,13,66,51,15,57
Clyde,7444,4,15,9,12,53,49,4,54
Stenhousem'r,7444,5,15,8,13,55,52,3,53
Elgin,7444,6,14,7,15,56,63,-7,49
Annan Athlet,7444,7,11,11,14,47,42,5,44
Berwick,7444,8,8,10,18,30,60,-30,34
Edinburgh Ci,7444,9,7,9,20,37,63,-26,30
Cowdenbeath,7444,10,5,10,21,24,54,-30,25
Peterhead,7445,1,24,4,8,79,39,40,76
Montrose,7445,2,23,7,6,59,35,24,76
Stirling,7445,3,17,6,13,64,52,12,57
Stenhousem'r,7445,4,15,8,13,56,50,6,53
Clyde,7445,5,14,10,12,51,48,3,52
Elgin,7445,6,15,6,15,54,60,-6,51
Annan Athlet,7445,7,11,12,13,48,42,6,45
Berwick,7445,8,8,11,17,29,58,-29,35
Edinburgh Ci,7445,9,7,9,20,37,62,-25,30
Cowdenbeath,7445,10,4,11,21,24,55,-31,23
Montrose,7446,1,24,7,5,61,35,26,79
Peterhead,7446,2,24,4,8,79,39,40,76
Stirling,7446,3,17,6,13,63,52,11,57
Stenhousem'r,7446,4,15,8,13,56,49,7,53
Clyde,7446,5,14,9,13,53,51,2,51
Elgin,7446,6,14,6,16,54,62,-8,48
Annan Athlet,7446,7,11,12,13,49,43,6,45
Berwick,7446,8,9,10,17,32,60,-28,37
Edinburgh Ci,7446,9,7,9,20,37,62,-25,30
Cowdenbeath,7446,10,4,11,21,25,56,-31,23
Montrose,7447,1,24,7,5,62,35,27,79
Peterhead,7447,2,24,4,8,80,39,41,76
Stenhousem'r,7447,3,16,8,12,57,47,10,56
Stirling,7447,4,16,6,14,61,53,8,54
Clyde,7447,5,15,9,12,53,49,4,54
Elgin,7447,6,14,6,16,54,63,-9,48
Annan Athlet,7447,7,11,12,13,48,42,6,45
Berwick,7447,8,8,10,18,30,60,-30,34
Edinburgh Ci,7447,9,7,9,20,37,63,-26,30
Cowdenbeath,7447,10,4,11,21,24,55,-31,23
Montrose,7448,1,23,7,6,59,35,24,76
Peterhead,7448,2,23,5,8,78,39,39,74
Stirling,7448,3,17,6,13,63,53,10,57
Stenhousem'r,7448,4,15,8,13,57,49,8,53
Clyde,7448,5,14,10,12,51,48,3,52
Elgin,7448,6,15,6,15,54,60,-6,51
Annan Athlet,7448,7,11,11,14,47,42,5,44
Berwick,7448,8,8,11,17,29,58,-29,35
Edinburgh Ci,7448,9,7,10,19,37,61,-24,31
Cowdenbeath,7448,10,5,10,21,24,54,-30,25
Peterhead,7449,1,24,4,8,80,38,42,76
Montrose,7449,2,23,7,6,59,36,23,76
Stirling,7449,3,17,6,13,63,52,11,57
Clyde,7449,4,15,9,12,53,48,5,54
Stenhousem'r,7449,5,15,8,13,56,49,7,53
Elgin,7449,6,15,6,15,55,60,-5,51
Annan Athlet,7449,7,12,11,13,48,41,7,47
Berwick,7449,8,8,10,18,29,60,-31,34
Edinburgh Ci,7449,9,7,9,20,36,63,-27,30
Cowdenbeath,7449,10,4,10,22,23,55,-32,22
Peterhead,7450,1,24,4,8,78,38,40,76
Montrose,7450,2,23,7,6,59,35,24,76
Stenhousem'r,7450,3,16,8,12,57,46,11,56
Stirling,7450,4,16,6,14,60,53,7,54
Clyde,7450,5,14,9,13,52,50,2,51
Elgin,7450,6,15,6,15,54,60,-6,51
Annan Athlet,7450,7,12,11,13,48,41,7,47
Berwick,7450,8,9,10,17,31,59,-28,37
Edinburgh Ci,7450,9,7,9,20,36,61,-25,30
Cowdenbeath,7450,10,4,10,22,23,55,-32,22
Montrose,7451,1,23,8,5,60,35,25,77
Peterhead,7451,2,24,4,8,83,40,43,76
Stirling,7451,3,17,6,13,62,51,11,57
Stenhousem'r,7451,4,15,8,13,55,48,7,53
Clyde,7451,5,14,10,12,52,49,3,52
Elgin,7451,6,14,7,15,54,61,-7,49
Annan Athlet,7451,7,11,11,14,47,42,5,44
Berwick,7451,8,8,11,17,30,59,-29,35
Edinburgh Ci,7451,9,7,9,20,38,66,-28,30
Cowdenbeath,7451,10,5,10,21,24,54,-30,25
Montrose,7452,1,24,7,5,60,34,26,79
Peterhead,7452,2,24,4,8,79,39,40,76
Stenhousem'r,7452,3,16,8,12,59,49,10,56
Stirling,7452,4,16,6,14,63,55,8,54
Clyde,7452,5,14,10,12,51,48,3,52
Elgin,7452,6,14,6,16,53,61,-8,48
Annan Athlet,7452,7,11,11,14,48,43,5,44
Berwick,7452,8,8,11,17,29,58,-29,35
Edinburgh Ci,7452,9,7,9,20,37,62,-25,30
Cowdenbeath,7452,10,5,10,21,25,55,-30,25
Montrose,7453,1,23,8,5,60,35,25,77
Peterhead,7453,2,24,4,8,82,38,44,76
Stirling,7453,3,16,7,13,61,52,9,55
Stenhousem'r,7453,4,15,9,12,56,47,9,54
Clyde,7453,5,14,9,13,51,51,0,51
Elgin,7453,6,14,7,15,54,61,-7,49
Annan Athlet,7453,7,12,11,13,48,41,7,47
Berwick,7453,8,9,10,17,32,58,-26,37
Edinburgh Ci,7453,9,7,9,20,36,65,-29,30
Cowdenbeath,7453,10,4,10,22,23,55,-32,22
Montrose,7454,1,24,7,5,63,35,28,79
Peterhead,7454,2,23,5,8,78,39,39,74
Stenhousem'r,7454,3,16,8,12,58,47,11,56
Stirling,7454,4,16,6,14,61,54,7,54
Clyde,7454,5,14,10,12,53,50,3,52
Elgin,7454,6,14,6,16,54,64,-10,48
Annan Athlet,7454,7,12,11,13,49,41,8,47
Berwick,7454,8,8,11,17,31,60,-29,35
Edinburgh Ci,7454,9,7,10,19,37,61,-24,31
Cowdenbeath,7454,10,4,10,22,23,56,-33,22
Peterhead,7455,1,24,4,8,80,38,42,76
Montrose,7455,2,23,7,6,59,35,24,76
Stirling,7455,3,17,6,13,64,51,13,57
Clyde,7455,4,15,9,12,53,48,5,54
Stenhousem'r,7455,5,15,8,13,55,50,5,53
Elgin,7455,6,15,6,15,54,60,-6,51
Annan Athlet,7455,7,11,12,13,47,41,6,45
Berwick,7455,8,8,10,18,29,60,-31,34
Edinburgh Ci,7455,9,7,9,20,36,63,-27,30
Cowdenbeath,7455,10,4,11,21,23,54,-31,23
Peterhead,7456,1,24,4,8,83,38,45,76
Montrose,7456,2,23,7,6,59,35,24,76
Stirling,7456,3,17,6,13,63,53,10,57
Stenhousem'r,7456,4,15,8,13,57,49,8,53
Clyde,7456,5,14,10,12,52,49,3,52
Elgin,7456,6,15,6,15,54,60,-6,51
Annan Athlet,7456,7,11,12,13,48,42,6,45
Berwick,7456,8,8,11,17,30,59,-29,35
Edinburgh Ci,7456,9,7,9,20,36,66,-30,30
Cowdenbeath,7456,10,4,11,21,24,55,-31,23
Montrose,7457,1,24,7,5,62,36,26,79
Peterhead,7457,2,23,5,8,79,40,39,74
Stenhousem'r,7457,3,16,8,12,57,47,10,56
Stirling,7457,4,16,6,14,61,53,8,54
Clyde,7457,5,15,9,12,53,49,4,54
Elgin,7457,6,14,6,16,55,63,-8,48
Annan Athlet,7457,7,12,11,13,49,42,7,47
Berwick,7457,8,8,10,18,30,60,-30,34
Edinburgh Ci,7457,9,7,10,19,38,62,-24,31
Cowdenbeath,7457,10,4,10,22,24,56,-32,22
Montrose,7458,1,24,7,5,62,35,27,79
Peterhead,7458,2,24,4,8,79,38,41,76
Stirling,7458,3,17,6,13,63,53,10,57
Clyde,7458,4,15,9,12,55,50,5,54
Stenhousem'r,7458,5,15,8,13,57,49,8,53
Elgin,7458,6,14,6,16,54,63,-9,48
Annan Athlet,7458,7,12,11,13,48,41,7,47
Berwick,7458,8,8,10,18,31,62,-31,34
Edinburgh Ci,7458,9,7,9,20,36,62,-26,30
Cowdenbeath,7458,10,4,10,22,23,55,-32,22
Montrose,7459,1,24,7,5,63,34,29,79
Peterhead,7459,2,24,4,8,78,38,40,76
Stenhousem'r,7459,3,16,8,12,58,48,10,56
Stirling,7459,4,16,6,14,62,54,8,54
Clyde,7459,5,15,9,12,53,49,4,54
Elgin,7459,6,14,6,16,53,64,-11,48
Annan Athlet,7459,7,12,11,13,49,42,7,47
Berwick,7459,8,8,10,18,30,60,-30,34
Edinburgh Ci,7459,9,7,9,20,36,61,-25,30
Cowdenbeath,7459,10,4,10,22,24,56,-32,22
Montrose,7460,1,24,7,5,62,35,27,79
Peterhead,7460,2,23,5,8,78,39,39,74
Stirling,7460,3,17,6,13,63,52,11,57
Stenhousem'r,7460,4,15,8,13,56,49,7,53
Clyde,7460,5,14,9,13,51,49,2,51
Elgin,7460,6,14,6,16,54,63,-9,48
Annan Athlet,7460,7,11,12,13,48,42,6,45
Berwick,7460,8,9,10,17,30,58,-28,37
Edinburgh Ci,7460,9,7,10,19,37,61,-24,31
Cowdenbeath,7460,10,4,11,21,24,55,-31,23
Montrose,7461,1,24,7,5,61,34,27,79
Peterhead,7461,2,24,4,8,80,38,42,76
Stirling,7461,3,17,6,13,64,52,12,57
Clyde,7461,4,15,9,12,53,49,4,54
Stenhousem'r,7461,5,15,8,13,56,50,6,53
Elgin,7461,6,14,6,16,53,62,-9,48
Annan Athlet,7461,7,11,11,14,47,43,4,44
Berwick,7461,8,8,10,18,30,60,-30,34
Edinburgh Ci,7461,9,7,9,20,36,63,-27,30
Cowdenbeath,7461,10,5,10,21,25,54,-29,25
Montrose,7462,1,24,7,5,65,34,31,79
Peterhead,7462,2,24,4,8,80,38,42,76
Stirling,7462,3,16,7,13,61,52,9,55
Stenhousem'r,7462,4,15,9,12,56,47,9,54
Clyde,7462,5,15,9,12,53,49,4,54
Elgin,7462,6,14,6,16,53,66,-13,48
Annan Athlet,7462,7,12,11,13,48,41,7,47
Berwick,7462,8,8,10,18,30,60,-30,34
Edinburgh Ci,7462,9,7,9,20,36,63,-27,30
Cowdenbeath,7462,10,4,10,22,23,55,-32,22
Montrose,7463,1,24,7,5,61,35,26,79
Peterhead,7463,2,24,4,8,81,38,43,76
Stirling,7463,3,17,6,13,63,51,12,57
Stenhousem'r,7463,4,15,8,13,55,49,6,53
Clyde,7463,5,14,10,12,52,49,3,52
Elgin,7463,6,14,6,16,54,62,-8,48
Annan Athlet,7463,7,12,11,13,48,41,7,47
Berwick,7463,8,8,11,17,30,59,-29,35
Edinburgh Ci,7463,9,7,9,20,36,64,-28,30
Cowdenbeath,7463,10,4,10,22,23,55,-32,22
Peterhead,7464,1,24,4,8,81,39,42,76
Montrose,7464,2,23,7,6,59,35,24,76
Stenhousem'r,7464,3,16,8,12,57,47,10,56
Stirling,7464,4,16,6,14,61,53,8,54
Clyde,7464,5,14,10,12,53,50,3,52
Elgin,7464,6,15,6,15,54,60,-6,51
Annan Athlet,7464,7,11,11,14,49,44,5,44
Berwick,7464,8,8,11,17,31,60,-29,35
Edinburgh Ci,7464,9,7,9,20,37,64,-27,30
Cowdenbeath,7464,10,5,10,21,26,56,-30,25
Peterhead,7465,1,24,4,8,82,40,42,76
Montrose,7465,2,23,7,6,59,36,23,76
Stirling,7465,3,16,7,13,62,53,9,55
Stenhousem'r,7465,4,15,9,12,57,48,9,54
Clyde,7465,5,15,9,12,54,49,5,54
Elgin,7465,6,15,6,15,55,60,-5,51
Annan Athlet,7465,7,12,11,13,48,41,7,47
Berwick,7465,8,8,10,18,30,61,-31,34
Edinburgh Ci,7465,9,7,9,20,38,65,-27,30
Cowdenbeath,7465,10,4,10,22,23,55,-32,22
Montrose,7466,1,23,8,5,61,36,25,77
Peterhead,7466,2,24,4,8,79,38,41,76
Stirling,7466,3,16,7,13,60,51,9,55
Stenhousem'r,7466,4,15,9,12,55,46,9,54
Clyde,7466,5,15,9,12,54,50,4,54
Elgin,7466,6,14,7,15,55,62,-7,49
Annan Athlet,7466,7,11,12,13,48,42,6,45
Berwick,7466,8,8,10,18,31,61,-30,34
Edinburgh Ci,7466,9,7,9,20,36,62,-26,30
Cowdenbeath,7466,10,4,11,21,24,55,-31,23
Montrose,7467,1,24,7,5,61,35,26,79
Peterhead,7467,2,24,4,8,79,39,40,76
Stirling,7467,3,16,7,13,61,52,9,55
Stenhousem'r,7467,4,15,9,12,56,47,9,54
Clyde,7467,5,14,10,12,52,49,3,52
Elgin,7467,6,14,6,16,54,62,-8,48
Annan Athlet,7467,7,11,12,13,49,43,6,45
Berwick,7467,8,8,11,17,30,59,-29,35
Edinburgh Ci,7467,9,7,9,20,37,62,-25,30
Cowdenbeath,7467,10,4,11,21,25,56,-31,23
Peterhead,7468,1,24,4,8,81,38,43,76
Montrose,7468,2,23,7,6,59,35,24,76
Stirling,7468,3,16,7,13,62,53,9,55
Stenhousem'r,7468,4,15,9,12,57,48,9,54
Clyde,7468,5,14,10,12,52,49,3,52
Elgin,7468,6,15,6,15,54,60,-6,51
Annan Athlet,7468,7,12,11,13,50,42,8,47
Berwick,7468,8,8,11,17,30,59,-29,35
Edinburgh Ci,7468,9,7,9,20,36,64,-28,30
Cowdenbeath,7468,10,4,10,22,24,57,-33,22
Peterhead,7469,1,24,4,8,81,38,43,76
Montrose,7469,2,23,7,6,59,35,24,76
Stenhousem'r,7469,3,16,8,12,59,47,12,56
Stirling,7469,4,16,6,14,61,55,6,54
Clyde,7469,5,14,10,12,53,50,3,52
Elgin,7469,6,15,6,15,54,60,-6,51
Annan Athlet,7469,7,11,11,14,47,42,5,44
Berwick,7469,8,8,11,17,31,60,-29,35
Edinburgh Ci,7469,9,7,9,20,36,64,-28,30
Cowdenbeath,7469,10,5,10,21,24,54,-30,25
Montrose,7470,1,24,7,5,62,34,28,79
Peterhead,7470,2,24,4,8,80,38,42,76
Stirling,7470,3,17,6,13,62,52,10,57
Clyde,7470,4,15,9,12,54,48,6,54
Stenhousem'r,7470,5,15,8,13,56,48,8,53
Elgin,7470,6,14,6,16,53,63,-10,48
Annan Athlet,7470,7,12,11,13,49,41,8,47
Berwick,7470,8,8,10,18,29,61,-32,34
Edinburgh Ci,7470,9,7,9,20,36,63,-27,30
Cowdenbeath,7470,10,4,10,22,23,56,-33,22
Montrose,7471,1,24,7,5,61,34,27,79
Peterhead,7471,2,23,5,8,79,40,39,74
Stirling,7471,3,16,7,13,61,52,9,55
Stenhousem'r,7471,4,15,9,12,56,47,9,54
Clyde,7471,5,14,10,12,51,48,3,52
Elgin,7471,6,14,6,16,53,62,-9,48
Annan Athlet,7471,7,11,12,13,48,42,6,45
Berwick,7471,8,8,11,17,29,58,-29,35
Edinburgh Ci,7471,9,7,10,19,38,62,-24,31
Cowdenbeath,7471,10,4,11,21,24,55,-31,23
Montrose,7472,1,24,7,5,62,35,27,79
Peterhead,7472,2,24,4,8,79,38,41,76
Stirling,7472,3,17,6,13,63,53,10,57
Clyde,7472,4,15,9,12,55,49,6,54
Stenhousem'r,7472,5,15,8,13,57,49,8,53
Elgin,7472,6,14,6,16,54,63,-9,48
Annan Athlet,7472,7,12,11,13,49,41,8,47
Berwick,7472,8,8,10,18,30,62,-32,34
Edinburgh Ci,7472,9,7,9,20,36,62,-26,30
Cowdenbeath,7472,10,4,10,22,23,56,-33,22
Montrose,7473,1,24,7,5,62,36,26,79
Peterhead,7473,2,24,4,8,81,39,42,76
Stirling,7473,3,16,7,13,61,52,9,55
Stenhousem'r,7473,4,15,9,12,56,47,9,54
Clyde,7473,5,14,10,12,52,49,3,52
Elgin,7473,6,14,6,16,55,63,-8,48
Annan Athlet,7473,7,11,11,14,47,42,5,44
Berwick,7473,8,8,11,17,30,59,-29,35
Edinburgh Ci,7473,9,7,9,20,37,64,-27,30
Cowdenbeath,7473,10,5,10,21,24,54,-30,25
Montrose,7474,1,24,7,5,63,35,28,79
Peterhead,7474,2,24,4,8,84,39,45,76
Stirling,7474,3,17,6,13,63,52,11,57
Clyde,7474,4,15,9,12,53,48,5,54
Stenhousem'r,7474,5,15,8,13,56,49,7,53
Elgin,7474,6,14,6,16,54,64,-10,48
Annan Athlet,7474,7,12,11,13,49,41,8,47
Berwick,7474,8,8,10,18,29,60,-31,34
Edinburgh Ci,7474,9,7,9,20,37,67,-30,30
Cowdenbeath,7474,10,4,10,22,23,56,-33,22
Montrose,7475,1,24,7,5,62,35,27,79
Peterhead,7475,2,24,4,8,81,39,42,76
Stirling,7475,3,16,7,13,61,52,9,55
Stenhousem'r,7475,4,15,9,12,56,47,9,54
Clyde,7475,5,14,9,13,52,51,1,51
Elgin,7475,6,14,6,16,54,63,-9,48
Annan Athlet,7475,7,12,11,13,50,41,9,47
Berwick,7475,8,9,10,17,32,59,-27,37
Edinburgh Ci,7475,9,7,9,20,37,64,-27,30
Cowdenbeath,7475,10,4,10,22,23,57,-34,22
Montrose,7476,1,24,7,5,62,34,28,79
Peterhead,7476,2,23,4,9,78,40,38,73
Stenhousem'r,7476,3,16,8,12,58,46,12,56
Stirling,7476,4,16,6,14,60,54,6,54
Clyde,7476,5,15,9,12,53,49,4,54
Elgin,7476,6,14,6,16,53,63,-10,48
Annan Athlet,7476,7,12,11,13,48,41,7,47
Berwick,7476,8,8,10,18,30,60,-30,34
Edinburgh Ci,7476,9,8,9,19,38,61,-23,33
Cowdenbeath,7476,10,4,10,22,23,55,-32,22
Peterhead,7477,1,24,4,8,79,39,40,76
Montrose,7477,2,23,7,6,59,35,24,76
Stirling,7477,3,17,6,13,64,51,13,57
Stenhousem'r,7477,4,15,8,13,55,50,5,53
Clyde,7477,5,14,9,13,51,49,2,51
Elgin,7477,6,15,6,15,54,60,-6,51
Annan Athlet,7477,7,12,11,13,48,41,7,47
Berwick,7477,8,9,10,17,30,58,-28,37
Edinburgh Ci,7477,9,7,9,20,37,62,-25,30
Cowdenbeath,7477,10,4,10,22,23,55,-32,22
Montrose,7478,1,24,7,5,62,34,28,79
Peterhead,7478,2,24,4,8,82,38,44,76
Stenhousem'r,7478,3,16,8,12,56,46,10,56
Stirling,7478,4,16,6,14,60,52,8,54
Clyde,7478,5,14,9,13,52,50,2,51
Elgin,7478,6,14,6,16,53,63,-10,48
Annan Athlet,7478,7,11,11,14,47,42,5,44
Berwick,7478,8,9,10,17,31,59,-28,37
Edinburgh Ci,7478,9,7,9,20,36,65,-29,30
Cowdenbeath,7478,10,5,10,21,24,54,-30,25
Peterhead,7479,1,24,4,8,80,40,40,76
Montrose,7479,2,23,7,6,60,37,23,76
Stirling,7479,3,16,7,13,61,52,9,55
Stenhousem'r,7479,4,15,9,12,56,47,9,54
Clyde,7479,5,14,10,12,52,49,3,52
Elgin,7479,6,15,6,15,56,61,-5,51
Annan Athlet,7479,7,11,12,13,47,41,6,45
Berwick,7479,8,8,11,17,30,59,-29,35
Edinburgh Ci,7479,9,7,9,20,38,63,-25,30
Cowdenbeath,7479,10,4,11,21,23,54,-31,23
Montrose,7480,1,24,7,5,62,35,27,79
Peterhead,7480,2,24,4,8,79,39,40,76
Stirling,7480,3,16,7,13,63,54,9,55
Stenhousem'r,7480,4,15,9,12,58,49,9,54
Clyde,7480,5,14,9,13,51,49,2,51
Elgin,7480,6,14,6,16,54,63,-9,48
Annan Athlet,7480,7,12,11,13,49,41,8,47
Berwick,7480,8,9,10,17,30,58,-28,37
Edinburgh Ci,7480,9,7,9,20,37,62,-25,30
Cowdenbeath,7480,10,4,10,22,23,56,-33,22
Montrose,7481,1,24,7,5,62,35,27,79
Peterhead,7481,2,23,4,9,77,39,38,73
Stirling,7481,3,17,6,13,62,52,10,57
Stenhousem'r,7481,4,15,8,13,56,48,8,53
Clyde,7481,5,14,10,12,52,49,3,52
Elgin,7481,6,14,6,16,54,63,-9,48
Annan Athlet,7481,7,12,11,13,51,41,10,47
Berwick,7481,8,8,11,17,30,59,-29,35
Edinburgh Ci,7481,9,8,9,19,37,60,-23,33
Cowdenbeath,7481,10,4,10,22,23,58,-35,22
Montrose,7482,1,23,8,5,59,34,25,77
Peterhead,7482,2,24,4,8,80,38,42,76
Stirling,7482,3,17,6,13,61,51,10,57
Clyde,7482,4,15,9,12,55,48,7,54
Stenhousem'r,7482,5,15,8,13,55,47,8,53
Elgin,7482,6,14,7,15,53,60,-7,49
Annan Athlet,7482,7,11,12,13,49,43,6,45
Berwick,7482,8,8,10,18,29,62,-33,34
Edinburgh Ci,7482,9,7,9,20,36,63,-27,30
Cowdenbeath,7482,10,4,11,21,25,56,-31,23
Montrose,7483,1,23,8,5,60,35,25,77
Peterhead,7483,2,24,4,8,80,38,42,76
Stirling,7483,3,17,6,13,62,52,10,57
Clyde,7483,4,15,9,12,52,48,4,54
Stenhousem'r,7483,5,15,8,13,56,48,8,53
Elgin,7483,6,14,7,15,54,61,-7,49
Annan Athlet,7483,7,11,11,14,48,43,5,44
Berwick,7483,8,8,10,18,29,59,-30,34
Edinburgh Ci,7483,9,7,9,20,36,63,-27,30
Cowdenbeath,7483,10,5,10,21,25,55,-30,25
Montrose,7484,1,24,7,5,61,35,26,79
Peterhead,7484,2,24,4,8,80,38,42,76
Stirling,7484,3,16,7,13,61,52,9,55
Stenhousem'r,7484,4,15,9,12,56,47,9,54
Clyde,7484,5,14,10,12,52,49,3,52
Elgin,7484,6,14,6,16,54,62,-8,48
Annan Athlet,7484,7,11,12,13,47,41,6,45
Berwick,7484,8,8,11,17,30,59,-29,35
Edinburgh Ci,7484,9,7,9,20,36,63,-27,30
Cowdenbeath,7484,10,4,11,21,23,54,-31,23
Montrose,7485,1,23,8,5,59,34,25,77
Peterhead,7485,2,24,4,8,80,39,41,76
Stirling,7485,3,16,7,13,63,54,9,55
Stenhousem'r,7485,4,15,9,12,58,49,9,54
Clyde,7485,5,14,9,13,52,50,2,51
Elgin,7485,6,14,7,15,53,60,-7,49
Annan Athlet,7485,7,11,11,14,47,42,5,44
Berwick,7485,8,9,10,17,31,59,-28,37
Edinburgh Ci,7485,9,7,9,20,37,63,-26,30
Cowdenbeath,7485,10,5,10,21,24,54,-30,25
Peterhead,7486,1,24,4,8,81,38,43,76
Montrose,7486,2,23,7,6,59,35,24,76
Stenhousem'r,7486,3,16,8,12,57,46,11,56
Stirling,7486,4,16,6,14,60,53,7,54
Clyde,7486,5,14,9,13,51,50,1,51
Elgin,7486,6,15,6,15,54,60,-6,51
Annan Athlet,7486,7,12,11,13,51,43,8,47
Berwick,7486,8,9,10,17,31,58,-27,37
Edinburgh Ci,7486,9,7,9,20,36,64,-28,30
Cowdenbeath,7486,10,4,10,22,25,58,-33,22
Montrose,7487,1,23,8,5,60,35,25,77
Peterhead,7487,2,24,4,8,79,38,41,76
Stirling,7487,3,16,7,13,60,51,9,55
Stenhousem'r,7487,4,15,9,12,55,46,9,54
Clyde,7487,5,15,9,12,53,49,4,54
Elgin,7487,6,14,7,15,54,61,-7,49
Annan Athlet,7487,7,11,11,14,47,42,5,44
Berwick,7487,8,8,10,18,30,60,-30,34
Edinburgh Ci,7487,9,7,9,20,36,62,-26,30
Cowdenbeath,7487,10,5,10,21,24,54,-30,25
Montrose,7488,1,23,8,5,61,36,25,77
Peterhead,7488,2,24,4,8,82,38,44,76
Stirling,7488,3,16,7,13,61,52,9,55
Stenhousem'r,7488,4,15,9,12,56,47,9,54
Clyde,7488,5,15,9,12,55,50,5,54
Elgin,7488,6,14,7,15,55,62,-7,49
Annan Athlet,7488,7,12,11,13,49,41,8,47
Berwick,7488,8,8,10,18,31,62,-31,34
Edinburgh Ci,7488,9,7,9,20,36,65,-29,30
Cowdenbeath,7488,10,4,10,22,23,56,-33,22
Montrose,7489,1,24,7,5,61,35,26,79
Peterhead,7489,2,23,4,9,77,39,38,73
Stirling,7489,3,17,6,13,66,52,14,57
Stenhousem'r,7489,4,15,8,13,56,52,4,53
Clyde,7489,5,14,10,12,52,49,3,52
Elgin,7489,6,14,6,16,54,62,-8,48
Annan Athlet,7489,7,11,11,14,48,43,5,44
Berwick,7489,8,8,11,17,30,59,-29,35
Edinburgh Ci,7489,9,8,9,19,37,60,-23,33
Cowdenbeath,7489,10,5,10,21,25,55,-30,25
Montrose,7490,1,24,7,5,60,34,26,79
Peterhead,7490,2,24,4,8,82,39,43,76
Stirling,7490,3,16,7,13,61,52,9,55
Stenhousem'r,7490,4,15,9,12,56,47,9,54
Clyde,7490,5,15,9,12,54,49,5,54
Elgin,7490,6,14,6,16,53,61,-8,48
Annan Athlet,7490,7,11,12,13,48,42,6,45
Berwick,7490,8,8,10,18,30,61,-31,34
Edinburgh Ci,7490,9,7,9,20,37,65,-28,30
Cowdenbeath,7490,10,4,11,21,24,55,-31,23
Montrose,7491,1,23,8,5,62,37,25,77
Peterhead,7491,2,24,4,8,81,38,43,76
Stirling,7491,3,16,7,13,61,52,9,55
Stenhousem'r,7491,4,15,9,12,56,47,9,54
Clyde,7491,5,15,9,12,53,48,5,54
Elgin,7491,6,14,7,15,56,63,-7,49
Annan Athlet,7491,7,12,11,13,48,41,7,47
Berwick,7491,8,8,10,18,29,60,-31,34
Edinburgh Ci,7491,9,7,9,20,36,64,-28,30
Cowdenbeath,7491,10,4,10,22,23,55,-32,22
Montrose,7492,1,23,8,5,62,37,25,77
Peterhead,7492,2,24,4,8,80,40,40,76
Stirling,7492,3,17,6,13,63,51,12,57
Clyde,7492,4,15,9,12,53,49,4,54
Stenhousem'r,7492,5,15,8,13,55,49,6,53
Elgin,7492,6,14,7,15,56,63,-7,49
Annan Athlet,7492,7,11,11,14,47,44,3,44
Berwick,7492,8,8,10,18,30,60,-30,34
Edinburgh Ci,7492,9,7,9,20,38,63,-25,30
Cowdenbeath,7492,10,5,10,21,26,54,-28,25
Montrose,7493,1,23,8,5,61,36,25,77
Peterhead,7493,2,24,4,8,80,39,41,76
Stenhousem'r,7493,3,16,8,12,59,48,11,56
Stirling,7493,4,16,6,14,62,55,7,54
Clyde,7493,5,15,9,12,52,48,4,54
Elgin,7493,6,14,7,15,55,62,-7,49
Annan Athlet,7493,7,12,11,13,49,41,8,47
Berwick,7493,8,8,10,18,29,59,-30,34
Edinburgh Ci,7493,9,7,9,20,37,63,-26,30
Cowdenbeath,7493,10,4,10,22,23,56,-33,22
Montrose,7494,1,24,7,5,62,35,27,79
Peterhead,7494,2,24,4,8,79,39,40,76
Stirling,7494,3,17,6,13,61,51,10,57
Clyde,7494,4,15,9,12,53,48,5,54
Stenhousem'r,7494,5,15,8,13,55,47,8,53
Elgin,7494,6,14,6,16,54,63,-9,48
Annan Athlet,7494,7,11,12,13,47,41,6,45
Berwick,7494,8,8,10,18,29,60,-31,34
Edinburgh Ci,7494,9,7,9,20,37,62,-25,30
Cowdenbeath,7494,10,4,11,21,23,54,-31,23
Montrose,7495,1,24,7,5,61,34,27,79
Peterhead,7495,2,24,4,8,79,38,41,76
Stenhousem'r,7495,3,16,8,12,56,46,10,56
Stirling,7495,4,16,6,14,60,52,8,54
Clyde,7495,5,15,9,12,53,49,4,54
Elgin,7495,6,14,6,16,53,62,-9,48
Annan Athlet,7495,7,12,11,13,49,41,8,47
Berwick,7495,8,8,10,18,30,60,-30,34
Edinburgh Ci,7495,9,7,9,20,36,62,-26,30
Cowdenbeath,7495,10,4,10,22,23,56,-33,22
Montrose,7496,1,23,8,5,60,35,25,77
Peterhead,7496,2,24,4,8,82,39,43,76
Stenhousem'r,7496,3,16,8,12,56,46,10,56
Stirling,7496,4,16,6,14,60,52,8,54
Clyde,7496,5,14,9,13,51,50,1,51
Elgin,7496,6,14,7,15,54,61,-7,49
Annan Athlet,7496,7,11,12,13,47,41,6,45
Berwick,7496,8,9,10,17,31,58,-27,37
Edinburgh Ci,7496,9,7,9,20,37,65,-28,30
Cowdenbeath,7496,10,4,11,21,23,54,-31,23
Montrose,7497,1,23,7,6,59,35,24,76
Peterhead,7497,2,23,4,9,78,41,37,73
Stirling,7497,3,17,6,13,62,52,10,57
Stenhousem'r,7497,4,15,8,13,56,48,8,53
Clyde,7497,5,14,10,12,52,49,3,52
Elgin,7497,6,15,6,15,54,60,-6,51
Annan Athlet,7497,7,11,11,14,47,42,5,44
Berwick,7497,8,8,11,17,30,59,-29,35
Edinburgh Ci,7497,9,8,9,19,39,61,-22,33
Cowdenbeath,7497,10,5,10,21,24,54,-30,25
Montrose,7498,1,24,7,5,62,36,26,79
Peterhead,7498,2,23,5,8,78,39,39,74
Stirling,7498,3,16,7,13,60,51,9,55
Stenhousem'r,7498,4,15,9,12,55,46,9,54
Clyde,7498,5,15,9,12,55,49,6,54
Elgin,7498,6,14,6,16,55,63,-8,48
Annan Athlet,7498,7,12,11,13,50,43,7,47
Berwick,7498,8,8,10,18,30,62,-32,34
Edinburgh Ci,7498,9,7,10,19,37,61,-24,31
Cowdenbeath,7498,10,4,10,22,25,57,-32,22
Peterhead,7499,1,24,4,8,81,38,43,76
Montrose,7499,2,23,7,6,61,38,23,76
Stirling,7499,3,16,7,13,61,52,9,55
Stenhousem'r,7499,4,15,9,12,56,47,9,54
Clyde,7499,5,14,10,12,54,51,3,52
Elgin,7499,6,15,6,15,57,62,-5,51
Annan Athlet,7499,7,12,11,13,48,41,7,47
Berwick,7499,8,8,11,17,32,61,-29,35
Edinburgh Ci,7499,9,7,9,20,36,64,-28,30
Cowdenbeath,7499,10,4,10,22,23,55,-32,22
Peterhead,7500,1,24,4,8,80,40,40,76
Montrose,7500,2,23,7,6,60,36,24,76
Stirling,7500,3,17,6,13,63,53,10,57
Clyde,7500,4,15,9,12,52,48,4,54
Stenhousem'r,7500,5,15,8,13,57,49,8,53
Elgin,7500,6,15,6,15,55,61,-6,51
Annan Athlet,7500,7,11,12,13,49,43,6,45
Berwick,7500,8,8,10,18,29,59,-30,34
Edinburgh Ci,7500,9,7,9,20,38,63,-25,30
Cowdenbeath,7500,10,4,11,21,25,56,-31,23
Peterhead,7501,1,24,4,8,86,38,48,76
Montrose,7501,2,23,7,6,60,36,24,76
Stirling,7501,3,17,6,13,61,51,10,57
Stenhousem'r,7501,4,15,8,13,55,47,8,53
Clyde,7501,5,14,10,12,51,48,3,52
Elgin,7501,6,15,6,15,55,61,-6,51
Annan Athlet,7501,7,12,11,13,49,41,8,47
Berwick,7501,8,8,11,17,29,58,-29,35
Edinburgh Ci,7501,9,7,9,20,36,69,-33,30
Cowdenbeath,7501,10,4,10,22,23,56,-33,22
Montrose,7502,1,24,7,5,64,34,30,79
Peterhead,7502,2,24,4,8,82,38,44,76
Stirling,7502,3,16,7,13,62,53,9,55
Stenhousem'r,7502,4,15,9,12,57,48,9,54
Clyde,7502,5,15,9,12,55,49,6,54
Elgin,7502,6,14,6,16,53,65,-12,48
Annan Athlet,7502,7,12,11,13,50,43,7,47
Berwick,7502,8,8,10,18,30,62,-32,34
Edinburgh Ci,7502,9,7,9,20,36,65,-29,30
Cowdenbeath,7502,10,4,10,22,25,57,-32,22
Montrose,7503,1,23,8,5,60,35,25,77
Peterhead,7503,2,24,4,8,80,38,42,76
Stenhousem'r,7503,3,16,8,12,58,46,12,56
Stirling,7503,4,16,6,14,60,54,6,54
Clyde,7503,5,14,10,12,51,48,3,52
Elgin,7503,6,14,7,15,54,61,-7,49
Annan Athlet,7503,7,12,11,13,49,42,7,47
Berwick,7503,8,8,11,17,29,58,-29,35
Edinburgh Ci,7503,9,7,9,20,36,63,-27,30
Cowdenbeath,7503,10,4,10,22,24,56,-32,22
Montrose,7504,1,23,7,6,61,38,23,76
Peterhead,7504,2,23,4,9,78,40,38,73
Stenhousem'r,7504,3,16,8,12,56,46,10,56
Stirling,7504,4,16,6,14,60,52,8,54
Clyde,7504,5,15,9,12,54,48,6,54
Elgin,7504,6,15,6,15,57,62,-5,51
Annan Athlet,7504,7,11,12,13,48,42,6,45
Berwick,7504,8,8,10,18,29,61,-32,34
Edinburgh Ci,7504,9,8,9,19,38,61,-23,33
Cowdenbeath,7504,10,4,11,21,24,55,-31,23
Montrose,7505,1,24,7,5,61,34,27,79
Peterhead,7505,2,24,4,8,81,38,43,76
Stirling,7505,3,17,6,13,63,52,11,57
Clyde,7505,4,15,9,12,54,49,5,54
Stenhousem'r,7505,5,15,8,13,56,49,7,53
Elgin,7505,6,14,6,16,53,62,-9,48
Annan Athlet,7505,7,11,12,13,47,41,6,45
Berwick,7505,8,8,10,18,30,61,-31,34
Edinburgh Ci,7505,9,7,9,20,36,64,-28,30
Cowdenbeath,7505,10,4,11,21,23,54,-31,23
Peterhead,7506,1,24,4,8,80,40,40,76
Montrose,7506,2,23,7,6,60,36,24,76
Stirling,7506,3,16,7,13,63,54,9,55
Stenhousem'r,7506,4,15,9,12,58,49,9,54
Clyde,7506,5,14,10,12,53,50,3,52
Elgin,7506,6,15,6,15,55,61,-6,51
Annan Athlet,7506,7,11,12,13,48,42,6,45
Berwick,7506,8,8,11,17,31,60,-29,35
Edinburgh Ci,7506,9,7,9,20,38,63,-25,30
Cowdenbeath,7506,10,4,11,21,24,55,-31,23
Montrose,7507,1,24,7,5,63,36,27,79
Peterhead,7507,2,24,4,8,79,38,41,76
Stirling,7507,3,16,7,13,61,52,9,55
Stenhousem'r,7507,4,15,9,12,56,47,9,54
Clyde,7507,5,15,9,12,52,48,4,54
Elgin,7507,6,14,6,16,55,64,-9,48
Annan Athlet,7507,7,12,11,13,49,41,8,47
Berwick,7507,8,8,10,18,29,59,-30,34
Edinburgh Ci,7507,9,7,9,20,36,62,-26,30
Cowdenbeath,7507,10,4,10,22,23,56,-33,22
Montrose,7508,1,24,7,5,62,36,26,79
Peterhead,7508,2,24,4,8,83,38,45,76
Stenhousem'r,7508,3,16,8,12,56,46,10,56
Stirling,7508,4,16,6,14,60,52,8,54
Clyde,7508,5,15,9,12,55,48,7,54
Elgin,7508,6,14,6,16,55,63,-8,48
Annan Athlet,7508,7,11,11,14,47,42,5,44
Berwick,7508,8,8,10,18,29,62,-33,34
Edinburgh Ci,7508,9,7,9,20,36,66,-30,30
Cowdenbeath,7508,10,5,10,21,24,54,-30,25
Montrose,7509,1,24,7,5,61,35,26,79
Peterhead,7509,2,24,4,8,81,38,43,76
Stenhousem'r,7509,3,16,8,12,58,47,11,56
Stirling,7509,4,16,6,14,61,54,7,54
Clyde,7509,5,15,9,12,52,48,4,54
Elgin,7509,6,14,6,16,54,62,-8,48
Annan Athlet,7509,7,11,12,13,48,42,6,45
Berwick,7509,8,8,10,18,29,59,-30,34
Edinburgh Ci,7509,9,7,9,20,36,64,-28,30
Cowdenbeath,7509,10,4,11,21,24,55,-31,23
Montrose,7510,1,23,8,5,61,36,25,77
Peterhead,7510,2,24,4,8,78,38,40,76
Stenhousem'r,7510,3,16,8,12,57,47,10,56
Stirling,7510,4,16,6,14,61,53,8,54
Clyde,7510,5,15,9,12,54,48,6,54
Elgin,7510,6,14,7,15,55,62,-7,49
Annan Athlet,7510,7,11,11,14,48,43,5,44
Berwick,7510,8,8,10,18,29,61,-32,34
Edinburgh Ci,7510,9,7,9,20,36,61,-25,30
Cowdenbeath,7510,10,5,10,21,25,55,-30,25
Montrose,7511,1,23,7,6,60,36,24,76
Peterhead,7511,2,23,4,9,77,39,38,73
Stenhousem'r,7511,3,16,8,12,58,46,12,56
Stirling,7511,4,16,6,14,60,54,6,54
Clyde,7511,5,15,9,12,53,49,4,54
Elgin,7511,6,15,6,15,55,61,-6,51
Annan Athlet,7511,7,11,11,14,49,44,5,44
Berwick,7511,8,8,10,18,30,60,-30,34
Edinburgh Ci,7511,9,8,9,19,37,60,-23,33
Cowdenbeath,7511,10,5,10,21,26,56,-30,25
Peterhead,7512,1,24,4,8,81,38,43,76
Montrose,7512,2,23,7,6,59,35,24,76
Stenhousem'r,7512,3,16,8,12,56,46,10,56
Stirling,7512,4,16,6,14,60,52,8,54
Clyde,7512,5,14,9,13,53,52,1,51
Elgin,7512,6,15,6,15,54,60,-6,51
Annan Athlet,7512,7,11,12,13,47,41,6,45
Berwick,7512,8,9,10,17,33,60,-27,37
Edinburgh Ci,7512,9,7,9,20,36,64,-28,30
Cowdenbeath,7512,10,4,11,21,23,54,-31,23
Montrose,7513,1,24,7,5,60,34,26,79
Peterhead,7513,2,24,4,8,80,40,40,76
Stirling,7513,3,17,6,13,63,52,11,57
Stenhousem'r,7513,4,15,8,13,56,49,7,53
Clyde,7513,5,14,9,13,51,49,2,51
Elgin,7513,6,14,6,16,53,61,-8,48
Annan Athlet,7513,7,12,11,13,50,43,7,47
Berwick,7513,8,9,10,17,30,58,-28,37
Edinburgh Ci,7513,9,7,9,20,38,63,-25,30
Cowdenbeath,7513,10,4,10,22,25,57,-32,22
Montrose,7514,1,24,7,5,62,34,28,79
Peterhead,7514,2,24,4,8,78,38,40,76
Stirling,7514,3,17,6,13,62,52,10,57
Stenhousem'r,7514,4,15,8,13,56,48,8,53
Clyde,7514,5,14,9,13,51,49,2,51
Elgin,7514,6,14,6,16,53,63,-10,48
Annan Athlet,7514,7,11,11,14,49,45,4,44
Berwick,7514,8,9,10,17,30,58,-28,37
Edinburgh Ci,7514,9,7,9,20,36,61,-25,30
Cowdenbeath,7514,10,5,10,21,27,56,-29,25
Montrose,7515,1,23,8,5,60,35,25,77
Peterhead,7515,2,24,4,8,79,38,41,76
Stirling,7515,3,16,7,13,61,52,9,55
Stenhousem'r,7515,4,15,9,12,56,47,9,54
Clyde,7515,5,15,9,12,53,48,5,54
Elgin,7515,6,14,7,15,54,61,-7,49
Annan Athlet,7515,7,11,12,13,48,42,6,45
Berwick,7515,8,8,10,18,29,60,-31,34
Edinburgh Ci,7515,9,7,9,20,36,62,-26,30
Cowdenbeath,7515,10,4,11,21,24,55,-31,23
Montrose,7516,1,24,7,5,61,35,26,79
Peterhead,7516,2,24,4,8,81,38,43,76
Stenhousem'r,7516,3,16,8,12,56,46,10,56
Stirling,7516,4,16,6,14,60,52,8,54
Clyde,7516,5,14,10,12,52,49,3,52
Elgin,7516,6,14,6,16,54,62,-8,48
Annan Athlet,7516,7,12,11,13,49,41,8,47
Berwick,7516,8,8,11,17,30,59,-29,35
Edinburgh Ci,7516,9,7,9,20,36,64,-28,30
Cowdenbeath,7516,10,4,10,22,23,56,-33,22
Montrose,7517,1,23,8,5,61,36,25,77
Peterhead,7517,2,24,4,8,79,39,40,76
Stirling,7517,3,17,6,13,61,51,10,57
Clyde,7517,4,15,9,12,53,48,5,54
Stenhousem'r,7517,5,15,8,13,55,47,8,53
Elgin,7517,6,14,7,15,55,62,-7,49
Annan Athlet,7517,7,11,12,13,47,41,6,45
Berwick,7517,8,8,10,18,29,60,-31,34
Edinburgh Ci,7517,9,7,9,20,37,62,-25,30
Cowdenbeath,7517,10,4,11,21,23,54,-31,23
Montrose,7518,1,23,8,5,61,36,25,77
Peterhead,7518,2,24,4,8,81,38,43,76
Stirling,7518,3,17,6,13,62,52,10,57
Clyde,7518,4,15,9,12,57,48,9,54
Stenhousem'r,7518,5,15,8,13,56,48,8,53
Elgin,7518,6,14,7,15,55,62,-7,49
Annan Athlet,7518,7,11,12,13,50,44,6,45
Berwick,7518,8,8,10,18,29,64,-35,34
Edinburgh Ci,7518,9,7,9,20,36,64,-28,30
Cowdenbeath,7518,10,4,11,21,26,57,-31,23
Montrose,7519,1,23,8,5,59,34,25,77
Peterhead,7519,2,24,4,8,78,38,40,76
Stirling,7519,3,17,6,13,61,51,10,57
Stenhousem'r,7519,4,15,8,13,55,47,8,53
Clyde,7519,5,14,9,13,51,49,2,51
Elgin,7519,6,14,7,15,53,60,-7,49
Annan Athlet,7519,7,11,12,13,47,41,6,45
Berwick,7519,8,9,10,17,30,58,-28,37
Edinburgh Ci,7519,9,7,9,20,36,61,-25,30
Cowdenbeath,7519,10,4,11,21,23,54,-31,23
Montrose,7520,1,24,7,5,60,34,26,79
Peterhead,7520,2,23,4,9,78,40,38,73
Stirling,7520,3,17,6,13,62,51,11,57
Stenhousem'r,7520,4,15,8,13,55,48,7,53
Clyde,7520,5,14,10,12,53,50,3,52
Elgin,7520,6,14,6,16,53,61,-8,48
Annan Athlet,7520,7,11,12,13,47,41,6,45
Berwick,7520,8,8,11,17,31,60,-29,35
Edinburgh Ci,7520,9,8,9,19,38,61,-23,33
Cowdenbeath,7520,10,4,11,21,23,54,-31,23
Peterhead,7521,1,24,4,8,81,39,42,76
Montrose,7521,2,23,7,6,59,35,24,76
Stirling,7521,3,17,6,13,64,51,13,57
Clyde,7521,4,15,9,12,54,48,6,54
Stenhousem'r,7521,5,15,8,13,55,50,5,53
Elgin,7521,6,15,6,15,54,60,-6,51
Annan Athlet,7521,7,11,11,14,48,43,5,44
Berwick,7521,8,8,10,18,29,61,-32,34
Edinburgh Ci,7521,9,7,9,20,37,64,-27,30
Cowdenbeath,7521,10,5,10,21,25,55,-30,25
Montrose,7522,1,23,8,5,60,35,25,77
Peterhead,7522,2,23,4,9,79,43,36,73
Stirling,7522,3,16,7,13,63,54,9,55
Stenhousem'r,7522,4,15,9,12,58,49,9,54
Clyde,7522,5,14,9,13,51,50,1,51
Elgin,7522,6,14,7,15,54,61,-7,49
Annan Athlet,7522,7,11,12,13,48,42,6,45
Berwick,7522,8,9,10,17,31,58,-27,37
Edinburgh Ci,7522,9,8,9,19,41,62,-21,33
Cowdenbeath,7522,10,4,11,21,24,55,-31,23
Montrose,7523,1,23,8,5,59,34,25,77
Peterhead,7523,2,24,4,8,81,39,42,76
Stirling,7523,3,17,6,13,63,53,10,57
Stenhousem'r,7523,4,15,8,13,57,49,8,53
Clyde,7523,5,14,9,13,52,50,2,51
Elgin,7523,6,14,7,15,53,60,-7,49
Annan Athlet,7523,7,11,11,14,47,42,5,44
Berwick,7523,8,9,10,17,31,59,-28,37
Edinburgh Ci,7523,9,7,9,20,37,64,-27,30
Cowdenbeath,7523,10,5,10,21,24,54,-30,25
Montrose,7524,1,24,7,5,61,35,26,79
Peterhead,7524,2,23,4,9,77,40,37,73
Stirling,7524,3,17,6,13,62,52,10,57
Clyde,7524,4,15,9,12,57,49,8,54
Stenhousem'r,7524,5,15,8,13,56,48,8,53
Elgin,7524,6,14,6,16,54,62,-8,48
Annan Athlet,7524,7,11,11,14,47,42,5,44
Berwick,7524,8,8,10,18,30,64,-34,34
Edinburgh Ci,7524,9,8,9,19,38,60,-22,33
Cowdenbeath,7524,10,5,10,21,24,54,-30,25
Montrose,7525,1,24,7,5,62,34,28,79
Peterhead,7525,2,24,4,8,81,39,42,76
Stirling,7525,3,16,7,13,61,52,9,55
Stenhousem'r,7525,4,15,9,12,56,47,9,54
Clyde,7525,5,14,10,12,52,49,3,52
Elgin,7525,6,14,6,16,53,63,-10,48
Annan Athlet,7525,7,11,12,13,47,41,6,45
Berwick,7525,8,8,11,17,30,59,-29,35
Edinburgh Ci,7525,9,7,9,20,37,64,-27,30
Cowdenbeath,7525,10,4,11,21,23,54,-31,23
Montrose,7526,1,24,7,5,62,36,26,79
Peterhead,7526,2,24,4,8,81,39,42,76
Stirling,7526,3,17,6,13,64,51,13,57
Stenhousem'r,7526,4,15,8,13,55,50,5,53
Clyde,7526,5,14,9,13,51,52,-1,51
Elgin,7526,6,14,6,16,55,63,-8,48
Annan Athlet,7526,7,11,11,14,47,43,4,44
Berwick,7526,8,9,10,17,33,58,-25,37
Edinburgh Ci,7526,9,7,9,20,37,64,-27,30
Cowdenbeath,7526,10,5,10,21,25,54,-29,25
Montrose,7527,1,24,7,5,61,34,27,79
Peterhead,7527,2,23,5,8,80,41,39,74
Stenhousem'r,7527,3,16,8,12,58,48,10,56
Stirling,7527,4,16,6,14,62,54,8,54
Clyde,7527,5,15,9,12,53,49,4,54
Elgin,7527,6,14,6,16,53,62,-9,48
Annan Athlet,7527,7,12,11,13,49,42,7,47
Berwick,7527,8,8,10,18,30,60,-30,34
Edinburgh Ci,7527,9,7,10,19,39,63,-24,31
Cowdenbeath,7527,10,4,10,22,24,56,-32,22
Montrose,7528,1,24,7,5,63,34,29,79
Peterhead,7528,2,24,4,8,79,39,40,76
Stirling,7528,3,17,6,13,63,51,12,57
Stenhousem'r,7528,4,15,8,13,55,49,6,53
Clyde,7528,5,14,9,13,53,51,2,51
Elgin,7528,6,14,6,16,53,64,-11,48
Annan Athlet,7528,7,11,11,14,48,44,4,44
Berwick,7528,8,9,10,17,32,60,-28,37
Edinburgh Ci,7528,9,7,9,20,37,62,-25,30
Cowdenbeath,7528,10,5,10,21,26,55,-29,25
Montrose,7529,1,23,7,6,59,35,24,76
Peterhead,7529,2,23,5,8,78,39,39,74
Stirling,7529,3,17,6,13,63,51,12,57
Clyde,7529,4,15,9,12,54,49,5,54
Stenhousem'r,7529,5,15,8,13,55,49,6,53
Elgin,7529,6,15,6,15,54,60,-6,51
Annan Athlet,7529,7,12,11,13,49,41,8,47
Berwick,7529,8,8,10,18,30,61,-31,34
Edinburgh Ci,7529,9,7,10,19,37,61,-24,31
Cowdenbeath,7529,10,4,10,22,23,56,-33,22
Montrose,7530,1,23,7,6,59,36,23,76
Peterhead,7530,2,23,5,8,78,39,39,74
Stenhousem'r,7530,3,16,8,12,57,47,10,56
Stirling,7530,4,16,6,14,61,53,8,54
Clyde,7530,5,15,9,12,56,50,6,54
Elgin,7530,6,15,6,15,55,60,-5,51
Annan Athlet,7530,7,11,11,14,47,44,3,44
Berwick,7530,8,8,10,18,31,63,-32,34
Edinburgh Ci,7530,9,7,10,19,37,61,-24,31
Cowdenbeath,7530,10,5,10,21,26,54,-28,25
Peterhead,7531,1,24,4,8,78,38,40,76
Montrose,7531,2,23,7,6,59,35,24,76
Stenhousem'r,7531,3,16,8,12,59,48,11,56
Stirling,7531,4,16,6,14,62,55,7,54
Clyde,7531,5,15,9,12,54,48,6,54
Elgin,7531,6,15,6,15,54,60,-6,51
Annan Athlet,7531,7,12,11,13,49,41,8,47
Berwick,7531,8,8,10,18,29,61,-32,34
Edinburgh Ci,7531,9,7,9,20,36,61,-25,30
Cowdenbeath,7531,10,4,10,22,23,56,-33,22
Montrose,7532,1,24,7,5,63,34,29,79
Peterhead,7532,2,24,4,8,83,39,44,76
Stirling,7532,3,17,6,13,63,52,11,57
Clyde,7532,4,15,9,12,54,50,4,54
Stenhousem'r,7532,5,15,8,13,56,49,7,53
Elgin,7532,6,14,6,16,53,64,-11,48
Annan Athlet,7532,7,11,11,14,47,42,5,44
Berwick,7532,8,8,10,18,31,61,-30,34
Edinburgh Ci,7532,9,7,9,20,37,66,-29,30
Cowdenbeath,7532,10,5,10,21,24,54,-30,25
Montrose,7533,1,23,8,5,61,36,25,77
Peterhead,7533,2,24,4,8,79,38,41,76
Stenhousem'r,7533,3,16,8,12,60,48,12,56
Stirling,7533,4,16,6,14,62,56,6,54
Clyde,7533,5,15,9,12,53,48,5,54
Elgin,7533,6,14,7,15,55,62,-7,49
Annan Athlet,7533,7,11,11,14,47,43,4,44
Berwick,7533,8,8,10,18,29,60,-31,34
Edinburgh Ci,7533,9,7,9,20,36,62,-26,30
Cowdenbeath,7533,10,5,10,21,25,54,-29,25
Montrose,7534,1,24,7,5,61,34,27,79
Peterhead,7534,2,23,5,8,79,40,39,74
Stirling,7534,3,17,6,13,62,51,11,57
Clyde,7534,4,15,9,12,54,50,4,54
Stenhousem'r,7534,5,15,8,13,55,48,7,53
Elgin,7534,6,14,6,16,53,62,-9,48
Annan Athlet,7534,7,12,11,13,48,41,7,47
Berwick,7534,8,8,10,18,31,61,-30,34
Edinburgh Ci,7534,9,7,10,19,38,62,-24,31
Cowdenbeath,7534,10,4,10,22,23,55,-32,22
Montrose,7535,1,24,7,5,62,34,28,79
Peterhead,7535,2,23,4,9,77,41,36,73
Stenhousem'r,7535,3,16,8,12,58,48,10,56
Stirling,7535,4,16,6,14,62,54,8,54
Clyde,7535,5,15,9,12,53,48,5,54
Elgin,7535,6,14,6,16,53,63,-10,48
Annan Athlet,7535,7,11,12,13,47,41,6,45
Berwick,7535,8,8,10,18,29,60,-31,34
Edinburgh Ci,7535,9,8,9,19,39,60,-21,33
Cowdenbeath,7535,10,4,11,21,23,54,-31,23
Montrose,7536,1,23,8,5,61,36,25,77
Peterhead,7536,2,23,5,8,79,40,39,74
Stirling,7536,3,16,7,13,61,52,9,55
Stenhousem'r,7536,4,15,9,12,56,47,9,54
Clyde,7536,5,15,9,12,55,48,7,54
Elgin,7536,6,14,7,15,55,62,-7,49
Annan Athlet,7536,7,12,11,13,49,42,7,47
Berwick,7536,8,8,10,18,29,62,-33,34
Edinburgh Ci,7536,9,7,10,19,38,62,-24,31
Cowdenbeath,7536,10,4,10,22,24,56,-32,22
Montrose,7537,1,24,7,5,62,35,27,79
Peterhead,7537,2,24,4,8,80,38,42,76
Stirling,7537,3,16,7,13,62,53,9,55
Stenhousem'r,7537,4,15,9,12,57,48,9,54
Clyde,7537,5,15,9,12,55,48,7,54
Elgin,7537,6,14,6,16,54,63,-9,48
Annan Athlet,7537,7,12,11,13,49,42,7,47
Berwick,7537,8,8,10,18,29,62,-33,34
Edinburgh Ci,7537,9,7,9,20,36,63,-27,30
Cowdenbeath,7537,10,4,10,22,24,56,-32,22
Montrose,7538,1,23,7,6,60,36,24,76
Peterhead,7538,2,23,5,8,78,39,39,74
Stenhousem'r,7538,3,16,8,12,58,47,11,56
Stirling,7538,4,16,6,14,61,54,7,54
Clyde,7538,5,14,9,13,51,51,0,51
Elgin,7538,6,15,6,15,55,61,-6,51
Annan Athlet,7538,7,11,11,14,47,42,5,44
Berwick,7538,8,9,10,17,32,58,-26,37
Edinburgh Ci,7538,9,7,10,19,37,61,-24,31
Cowdenbeath,7538,10,5,10,21,24,54,-30,25
Montrose,7539,1,23,8,5,60,35,25,77
Peterhead,7539,2,24,4,8,82,40,42,76
Stenhousem'r,7539,3,16,8,12,59,48,11,56
Stirling,7539,4,16,6,14,62,55,7,54
Clyde,7539,5,15,9,12,52,48,4,54
Elgin,7539,6,14,7,15,54,61,-7,49
Annan Athlet,7539,7,11,12,13,48,42,6,45
Berwick,7539,8,8,10,18,29,59,-30,34
Edinburgh Ci,7539,9,7,9,20,38,65,-27,30
Cowdenbeath,7539,10,4,11,21,24,55,-31,23
Montrose,7540,1,23,8,5,59,34,25,77
Peterhead,7540,2,24,4,8,80,38,42,76
Stenhousem'r,7540,3,16,8,12,56,46,10,56
Stirling,7540,4,16,6,14,60,52,8,54
Clyde,7540,5,14,9,13,52,50,2,51
Elgin,7540,6,14,7,15,53,60,-7,49
Annan Athlet,7540,7,12,11,13,49,42,7,47
Berwick,7540,8,9,10,17,31,59,-28,37
Edinburgh Ci,7540,9,7,9,20,36,63,-27,30
Cowdenbeath,7540,10,4,10,22,24,56,-32,22
Montrose,7541,1,24,7,5,60,34,26,79
Peterhead,7541,2,23,5,8,79,40,39,74
Stenhousem'r,7541,3,16,8,12,57,47,10,56
Stirling,7541,4,16,6,14,61,53,8,54
Clyde,7541,5,15,9,12,53,49,4,54
Elgin,7541,6,14,6,16,53,61,-8,48
Annan Athlet,7541,7,11,11,14,47,43,4,44
Berwick,7541,8,8,10,18,30,60,-30,34
Edinburgh Ci,7541,9,7,10,19,38,62,-24,31
Cowdenbeath,7541,10,5,10,21,25,54,-29,25
Montrose,7542,1,23,8,5,61,36,25,77
Peterhead,7542,2,24,4,8,78,38,40,76
Stirling,7542,3,16,7,13,61,52,9,55
Stenhousem'r,7542,4,15,9,12,56,47,9,54
Clyde,7542,5,15,9,12,52,48,4,54
Elgin,7542,6,14,7,15,55,62,-7,49
Annan Athlet,7542,7,11,11,14,47,42,5,44
Berwick,7542,8,8,10,18,29,59,-30,34
Edinburgh Ci,7542,9,7,9,20,36,61,-25,30
Cowdenbeath,7542,10,5,10,21,24,54,-30,25
Peterhead,7543,1,24,4,8,80,39,41,76
Montrose,7543,2,23,7,6,60,36,24,76
Stenhousem'r,7543,3,16,8,12,58,46,12,56
Stirling,7543,4,16,6,14,60,54,6,54
Clyde,7543,5,15,9,12,53,49,4,54
Elgin,7543,6,15,6,15,55,61,-6,51
Annan Athlet,7543,7,11,12,13,48,42,6,45
Berwick,7543,8,8,10,18,30,60,-30,34
Edinburgh Ci,7543,9,7,9,20,37,63,-26,30
Cowdenbeath,7543,10,4,11,21,24,55,-31,23
Montrose,7544,1,23,8,5,60,35,25,77
Peterhead,7544,2,24,4,8,80,39,41,76
Stirling,7544,3,17,6,13,63,51,12,57
Clyde,7544,4,15,9,12,53,48,5,54
Stenhousem'r,7544,5,15,8,13,55,49,6,53
Elgin,7544,6,14,7,15,54,61,-7,49
Annan Athlet,7544,7,12,11,13,48,41,7,47
Berwick,7544,8,8,10,18,29,60,-31,34
Edinburgh Ci,7544,9,7,9,20,37,63,-26,30
Cowdenbeath,7544,10,4,10,22,23,55,-32,22
Montrose,7545,1,23,8,5,60,35,25,77
Peterhead,7545,2,24,4,8,82,38,44,76
Stirling,7545,3,17,6,13,64,54,10,57
Clyde,7545,4,15,9,12,55,49,6,54
Stenhousem'r,7545,5,15,8,13,58,50,8,53
Elgin,7545,6,14,7,15,54,61,-7,49
Annan Athlet,7545,7,11,11,14,47,42,5,44
Berwick,7545,8,8,10,18,30,62,-32,34
Edinburgh Ci,7545,9,7,9,20,36,65,-29,30
Cowdenbeath,7545,10,5,10,21,24,54,-30,25
Montrose,7546,1,23,8,5,61,36,25,77
Peterhead,7546,2,23,4,9,77,41,36,73
Stirling,7546,3,17,6,13,62,51,11,57
Clyde,7546,4,15,9,12,54,49,5,54
Stenhousem'r,7546,5,15,8,13,55,48,7,53
Elgin,7546,6,14,7,15,55,62,-7,49
Annan Athlet,7546,7,11,12,13,47,41,6,45
Berwick,7546,8,8,10,18,30,61,-31,34
Edinburgh Ci,7546,9,8,9,19,39,60,-21,33
Cowdenbeath,7546,10,4,11,21,23,54,-31,23
Peterhead,7547,1,24,4,8,79,39,40,76
Montrose,7547,2,23,7,6,59,35,24,76
Stenhousem'r,7547,3,16,8,12,56,46,10,56
Stirling,7547,4,16,6,14,60,52,8,54
Clyde,7547,5,15,9,12,54,50,4,54
Elgin,7547,6,15,6,15,54,60,-6,51
Annan Athlet,7547,7,12,11,13,48,41,7,47
Berwick,7547,8,8,10,18,31,61,-30,34
Edinburgh Ci,7547,9,7,9,20,37,62,-25,30
Cowdenbeath,7547,10,4,10,22,23,55,-32,22
Montrose,7548,1,24,7,5,61,35,26,79
Peterhead,7548,2,24,4,8,80,40,40,76
Stirling,7548,3,16,7,13,62,53,9,55
Stenhousem'r,7548,4,15,9,12,57,48,9,54
Clyde,7548,5,15,9,12,52,48,4,54
Elgin,7548,6,14,6,16,54,62,-8,48
Annan Athlet,7548,7,12,11,13,51,42,9,47
Berwick,7548,8,8,10,18,29,59,-30,34
Edinburgh Ci,7548,9,7,9,20,38,63,-25,30
Cowdenbeath,7548,10,4,10,22,24,58,-34,22
Montrose,7549,1,24,7,5,63,36,27,79
Peterhead,7549,2,24,4,8,80,39,41,76
Stirling,7549,3,17,6,13,63,51,12,57
Stenhousem'r,7549,4,15,8,13,55,49,6,53
Clyde,7549,5,14,10,12,54,51,3,52
Elgin,7549,6,14,6,16,55,64,-9,48
Annan Athlet,7549,7,11,11,14,47,43,4,44
Berwick,7549,8,8,11,17,32,61,-29,35
Edinburgh Ci,7549,9,7,9,20,37,63,-26,30
Cowdenbeath,7549,10,5,10,21,25,54,-29,25
Montrose,7550,1,24,7,5,62,35,27,79
Peterhead,7550,2,24,4,8,80,40,40,76
Stirling,7550,3,17,6,13,65,53,12,57
Clyde,7550,4,15,9,12,52,48,4,54
Stenhousem'r,7550,5,15,8,13,57,51,6,53
Elgin,7550,6,14,6,16,54,63,-9,48
Annan Athlet,7550,7,11,12,13,47,41,6,45
Berwick,7550,8,8,10,18,29,59,-30,34
Edinburgh Ci,7550,9,7,9,20,38,63,-25,30
Cowdenbeath,7550,10,4,11,21,23,54,-31,23
Montrose,7551,1,23,8,5,59,34,25,77
Peterhead,7551,2,23,5,8,78,39,39,74
Stirling,7551,3,16,7,13,61,52,9,55
Stenhousem'r,7551,4,15,9,12,56,47,9,54
Clyde,7551,5,14,10,12,51,48,3,52
Elgin,7551,6,14,7,15,53,60,-7,49
Annan Athlet,7551,7,11,12,13,48,42,6,45
Berwick,7551,8,8,11,17,29,58,-29,35
Edinburgh Ci,7551,9,7,10,19,37,61,-24,31
Cowdenbeath,7551,10,4,11,21,24,55,-31,23
Montrose,7552,1,23,8,5,59,34,25,77
Peterhead,7552,2,24,4,8,78,38,40,76
Stirling,7552,3,17,6,13,63,52,11,57
Clyde,7552,4,15,9,12,54,49,5,54
Stenhousem'r,7552,5,15,8,13,56,49,7,53
Elgin,7552,6,14,7,15,53,60,-7,49
Annan Athlet,7552,7,11,11,14,48,44,4,44
Berwick,7552,8,8,10,18,30,61,-31,34
Edinburgh Ci,7552,9,7,9,20,36,61,-25,30
Cowdenbeath,7552,10,5,10,21,26,55,-29,25
Montrose,7553,1,23,8,5,59,34,25,77
Peterhead,7553,2,24,4,8,80,38,42,76
Stirling,7553,3,17,6,13,64,54,10,57
Clyde,7553,4,15,9,12,54,48,6,54
Stenhousem'r,7553,5,15,8,13,58,50,8,53
Elgin,7553,6,14,7,15,53,60,-7,49
Annan Athlet,7553,7,11,11,14,48,43,5,44
Berwick,7553,8,8,10,18,29,61,-32,34
Edinburgh Ci,7553,9,7,9,20,36,63,-27,30
Cowdenbeath,7553,10,5,10,21,25,55,-30,25
Montrose,7554,1,23,8,5,60,35,25,77
Peterhead,7554,2,23,5,8,78,39,39,74
Stirling,7554,3,17,6,13,62,52,10,57
Clyde,7554,4,15,9,12,53,48,5,54
Stenhousem'r,7554,5,15,8,13,56,48,8,53
Elgin,7554,6,14,7,15,54,61,-7,49
Annan Athlet,7554,7,12,11,13,48,41,7,47
Berwick,7554,8,8,10,18,29,60,-31,34
Edinburgh Ci,7554,9,7,10,19,37,61,-24,31
Cowdenbeath,7554,10,4,10,22,23,55,-32,22
Montrose,7555,1,24,7,5,60,34,26,79
Peterhead,7555,2,23,5,8,78,39,39,74
Stenhousem'r,7555,3,16,8,12,58,48,10,56
Stirling,7555,4,16,6,14,62,54,8,54
Clyde,7555,5,15,9,12,53,49,4,54
Elgin,7555,6,14,6,16,53,61,-8,48
Annan Athlet,7555,7,11,11,14,47,42,5,44
Berwick,7555,8,8,10,18,30,60,-30,34
Edinburgh Ci,7555,9,7,10,19,37,61,-24,31
Cowdenbeath,7555,10,5,10,21,24,54,-30,25
Montrose,7556,1,24,7,5,63,34,29,79
Peterhead,7556,2,24,4,8,82,39,43,76
Stenhousem'r,7556,3,16,8,12,57,47,10,56
Stirling,7556,4,16,6,14,61,53,8,54
Clyde,7556,5,14,9,13,51,49,2,51
Elgin,7556,6,14,6,16,53,64,-11,48
Annan Athlet,7556,7,11,12,13,47,41,6,45
Berwick,7556,8,9,10,17,30,58,-28,37
Edinburgh Ci,7556,9,7,9,20,37,65,-28,30
Cowdenbeath,7556,10,4,11,21,23,54,-31,23
Montrose,7557,1,24,7,5,62,34,28,79
Peterhead,7557,2,24,4,8,79,39,40,76
Stirling,7557,3,16,7,13,62,53,9,55
Stenhousem'r,7557,4,15,9,12,57,48,9,54
Clyde,7557,5,14,10,12,53,50,3,52
Elgin,7557,6,14,6,16,53,63,-10,48
Annan Athlet,7557,7,11,12,13,47,41,6,45
Berwick,7557,8,8,11,17,31,60,-29,35
Edinburgh Ci,7557,9,7,9,20,37,62,-25,30
Cowdenbeath,7557,10,4,11,21,23,54,-31,23
Montrose,7558,1,24,7,5,62,35,27,79
Peterhead,7558,2,24,4,8,81,38,43,76
Stenhousem'r,7558,3,16,8,12,56,46,10,56
Stirling,7558,4,16,6,14,60,52,8,54
Clyde,7558,5,14,9,13,52,50,2,51
Elgin,7558,6,14,6,16,54,63,-9,48
Annan Athlet,7558,7,11,12,13,48,42,6,45
Berwick,7558,8,9,10,17,31,59,-28,37
Edinburgh Ci,7558,9,7,9,20,36,64,-28,30
Cowdenbeath,7558,10,4,11,21,24,55,-31,23
Montrose,7559,1,24,7,5,61,35,26,79
Peterhead,7559,2,24,4,8,79,38,41,76
Stirling,7559,3,16,7,13,62,53,9,55
Stenhousem'r,7559,4,15,9,12,57,48,9,54
Clyde,7559,5,15,9,12,53,49,4,54
Elgin,7559,6,14,6,16,54,62,-8,48
Annan Athlet,7559,7,12,11,13,49,41,8,47
Berwick,7559,8,8,10,18,30,60,-30,34
Edinburgh Ci,7559,9,7,9,20,36,62,-26,30
Cowdenbeath,7559,10,4,10,22,23,56,-33,22
Montrose,7560,1,24,7,5,61,34,27,79
Peterhead,7560,2,24,4,8,80,39,41,76
Stirling,7560,3,17,6,13,63,52,11,57
Clyde,7560,4,15,9,12,54,48,6,54
Stenhousem'r,7560,5,15,8,13,56,49,7,53
Elgin,7560,6,14,6,16,53,62,-9,48
Annan Athlet,7560,7,11,12,13,48,42,6,45
Berwick,7560,8,8,10,18,29,61,-32,34
Edinburgh Ci,7560,9,7,9,20,37,63,-26,30
Cowdenbeath,7560,10,4,11,21,24,55,-31,23
Montrose,7561,1,23,8,5,61,36,25,77
Peterhead,7561,2,24,4,8,78,38,40,76
Stirling,7561,3,17,6,13,62,52,10,57
Stenhousem'r,7561,4,15,8,13,56,48,8,53
Clyde,7561,5,14,10,12,52,49,3,52
Elgin,7561,6,14,7,15,55,62,-7,49
Annan Athlet,7561,7,11,12,13,48,42,6,45
Berwick,7561,8,8,11,17,30,59,-29,35
Edinburgh Ci,7561,9,7,9,20,36,61,-25,30
Cowdenbeath,7561,10,4,11,21,24,55,-31,23
Montrose,7562,1,23,8,5,61,36,25,77
Peterhead,7562,2,24,4,8,79,38,41,76
Stirling,7562,3,17,6,13,62,51,11,57
Clyde,7562,4,15,9,12,53,48,5,54
Stenhousem'r,7562,5,15,8,13,55,48,7,53
Elgin,7562,6,14,7,15,55,62,-7,49
Annan Athlet,7562,7,12,11,13,48,41,7,47
Berwick,7562,8,8,10,18,29,60,-31,34
Edinburgh Ci,7562,9,7,9,20,36,62,-26,30
Cowdenbeath,7562,10,4,10,22,23,55,-32,22
Montrose,7563,1,23,8,5,60,35,25,77
Peterhead,7563,2,24,4,8,80,39,41,76
Stenhousem'r,7563,3,16,8,12,57,47,10,56
Stirling,7563,4,16,6,14,61,53,8,54
Clyde,7563,5,14,9,13,51,50,1,51
Elgin,7563,6,14,7,15,54,61,-7,49
Annan Athlet,7563,7,11,12,13,48,42,6,45
Berwick,7563,8,9,10,17,31,58,-27,37
Edinburgh Ci,7563,9,7,9,20,37,63,-26,30
Cowdenbeath,7563,10,4,11,21,24,55,-31,23
Peterhead,7564,1,24,4,8,83,39,44,76
Montrose,7564,2,23,7,6,60,37,23,76
Stenhousem'r,7564,3,16,8,12,56,46,10,56
Stirling,7564,4,16,6,14,60,52,8,54
Clyde,7564,5,14,10,12,51,48,3,52
Elgin,7564,6,15,6,15,56,61,-5,51
Annan Athlet,7564,7,11,11,14,47,42,5,44
Berwick,7564,8,8,11,17,29,58,-29,35
Edinburgh Ci,7564,9,7,9,20,37,66,-29,30
Cowdenbeath,7564,10,5,10,21,24,54,-30,25
Montrose,7565,1,23,8,5,59,34,25,77
Peterhead,7565,2,23,5,8,77,38,39,74
Stirling,7565,3,17,6,13,66,53,13,57
Stenhousem'r,7565,4,15,8,13,57,52,5,53
Clyde,7565,5,14,10,12,54,51,3,52
Elgin,7565,6,14,7,15,53,60,-7,49
Annan Athlet,7565,7,11,11,14,47,42,5,44
Berwick,7565,8,8,11,17,32,61,-29,35
Edinburgh Ci,7565,9,7,10,19,36,60,-24,31
Cowdenbeath,7565,10,5,10,21,24,54,-30,25
Montrose,7566,1,24,7,5,61,34,27,79
Peterhead,7566,2,24,4,8,78,38,40,76
Stirling,7566,3,16,7,13,61,52,9,55
Stenhousem'r,7566,4,15,9,12,56,47,9,54
Clyde,7566,5,15,9,12,52,48,4,54
Elgin,7566,6,14,6,16,53,62,-9,48
Annan Athlet,7566,7,11,11,14,49,44,5,44
Berwick,7566,8,8,10,18,29,59,-30,34
Edinburgh Ci,7566,9,7,9,20,36,61,-25,30
Cowdenbeath,7566,10,5,10,21,26,56,-30,25
Montrose,7567,1,24,7,5,61,35,26,79
Peterhead,7567,2,24,4,8,78,38,40,76
Stenhousem'r,7567,3,16,8,12,56,46,10,56
Stirling,7567,4,16,6,14,60,52,8,54
Clyde,7567,5,15,9,12,52,48,4,54
Elgin,7567,6,14,6,16,54,62,-8,48
Annan Athlet,7567,7,12,11,13,48,41,7,47
Berwick,7567,8,8,10,18,29,59,-30,34
Edinburgh Ci,7567,9,7,9,20,36,61,-25,30
Cowdenbeath,7567,10,4,10,22,23,55,-32,22
Montrose,7568,1,24,7,5,61,35,26,79
Peterhead,7568,2,24,4,8,85,38,47,76
Stirling,7568,3,17,6,13,62,52,10,57
Clyde,7568,4,15,9,12,52,48,4,54
Stenhousem'r,7568,5,15,8,13,56,48,8,53
Elgin,7568,6,14,6,16,54,62,-8,48
Annan Athlet,7568,7,11,11,14,48,43,5,44
Berwick,7568,8,8,10,18,29,59,-30,34
Edinburgh Ci,7568,9,7,9,20,36,68,-32,30
Cowdenbeath,7568,10,5,10,21,25,55,-30,25
Montrose,7569,1,24,7,5,65,35,30,79
Peterhead,7569,2,24,4,8,79,38,41,76
Stirling,7569,3,17,6,13,63,53,10,57
Clyde,7569,4,15,9,12,52,48,4,54
Stenhousem'r,7569,5,15,8,13,57,49,8,53
Elgin,7569,6,14,6,16,54,66,-12,48
Annan Athlet,7569,7,12,11,13,49,41,8,47
Berwick,7569,8,8,10,18,29,59,-30,34
Edinburgh Ci,7569,9,7,9,20,36,62,-26,30
Cowdenbeath,7569,10,4,10,22,23,56,-33,22
Montrose,7570,1,24,7,5,61,35,26,79
Peterhead,7570,2,23,4,9,77,42,35,73
Stirling,7570,3,17,6,13,63,52,11,57
Stenhousem'r,7570,4,15,8,13,56,49,7,53
Clyde,7570,5,14,9,13,53,51,2,51
Elgin,7570,6,14,6,16,54,62,-8,48
Annan Athlet,7570,7,12,11,13,48,41,7,47
Berwick,7570,8,9,10,17,32,60,-28,37
Edinburgh Ci,7570,9,8,9,19,40,60,-20,33
Cowdenbeath,7570,10,4,10,22,23,55,-32,22
Montrose,7571,1,23,8,5,60,35,25,77
Peterhead,7571,2,24,4,8,78,38,40,76
Stirling,7571,3,17,6,13,62,51,11,57
Clyde,7571,4,15,9,12,55,48,7,54
Stenhousem'r,7571,5,15,8,13,55,48,7,53
Elgin,7571,6,14,7,15,54,61,-7,49
Annan Athlet,7571,7,11,12,13,47,41,6,45
Berwick,7571,8,8,10,18,29,62,-33,34
Edinburgh Ci,7571,9,7,9,20,36,61,-25,30
Cowdenbeath,7571,10,4,11,21,23,54,-31,23
Montrose,7572,1,24,7,5,62,36,26,79
Peterhead,7572,2,24,4,8,80,39,41,76
Stirling,7572,3,17,6,13,63,53,10,57
Stenhousem'r,7572,4,15,8,13,57,49,8,53
Clyde,7572,5,14,9,13,52,50,2,51
Elgin,7572,6,14,6,16,55,63,-8,48
Annan Athlet,7572,7,11,12,13,49,43,6,45
Berwick,7572,8,9,10,17,31,59,-28,37
Edinburgh Ci,7572,9,7,9,20,37,63,-26,30
Cowdenbeath,7572,10,4,11,21,25,56,-31,23
Montrose,7573,1,23,8,5,60,35,25,77
Peterhead,7573,2,23,5,8,77,38,39,74
Stenhousem'r,7573,3,16,8,12,57,47,10,56
Stirling,7573,4,16,6,14,61,53,8,54
Clyde,7573,5,15,9,12,52,48,4,54
Elgin,7573,6,14,7,15,54,61,-7,49
Annan Athlet,7573,7,11,11,14,47,42,5,44
Berwick,7573,8,8,10,18,29,59,-30,34
Edinburgh Ci,7573,9,7,10,19,36,60,-24,31
Cowdenbeath,7573,10,5,10,21,24,54,-30,25
Montrose,7574,1,24,7,5,60,34,26,79
Peterhead,7574,2,24,4,8,81,40,41,76
Stirling,7574,3,17,6,13,64,51,13,57
Stenhousem'r,7574,4,15,8,13,55,50,5,53
Clyde,7574,5,14,10,12,52,49,3,52
Elgin,7574,6,14,6,16,53,61,-8,48
Annan Athlet,7574,7,12,11,13,51,42,9,47
Berwick,7574,8,8,11,17,30,59,-29,35
Edinburgh Ci,7574,9,7,9,20,38,64,-26,30
Cowdenbeath,7574,10,4,10,22,24,58,-34,22
Peterhead,7575,1,24,4,8,82,39,43,76
Montrose,7575,2,23,7,6,60,36,24,76
Stenhousem'r,7575,3,16,8,12,57,47,10,56
Stirling,7575,4,16,6,14,61,53,8,54
Clyde,7575,5,15,9,12,52,48,4,54
Elgin,7575,6,15,6,15,55,61,-6,51
Annan Athlet,7575,7,12,11,13,48,41,7,47
Berwick,7575,8,8,10,18,29,59,-30,34
Edinburgh Ci,7575,9,7,9,20,37,65,-28,30
Cowdenbeath,7575,10,4,10,22,23,55,-32,22
Montrose,7576,1,24,7,5,62,34,28,79
Peterhead,7576,2,23,5,8,78,39,39,74
Stenhousem'r,7576,3,16,8,12,58,48,10,56
Stirling,7576,4,16,6,14,62,54,8,54
Clyde,7576,5,14,9,13,52,50,2,51
Elgin,7576,6,14,6,16,53,63,-10,48
Annan Athlet,7576,7,11,11,14,47,42,5,44
Berwick,7576,8,9,10,17,31,59,-28,37
Edinburgh Ci,7576,9,7,10,19,37,61,-24,31
Cowdenbeath,7576,10,5,10,21,24,54,-30,25
Montrose,7577,1,24,7,5,60,34,26,79
Peterhead,7577,2,24,4,8,78,38,40,76
Stenhousem'r,7577,3,16,8,12,57,47,10,56
Stirling,7577,4,16,6,14,61,53,8,54
Clyde,7577,5,15,9,12,55,49,6,54
Elgin,7577,6,14,6,16,53,61,-8,48
Annan Athlet,7577,7,12,11,13,49,41,8,47
Berwick,7577,8,8,10,18,30,62,-32,34
Edinburgh Ci,7577,9,7,9,20,36,61,-25,30
Cowdenbeath,7577,10,4,10,22,23,56,-33,22
Montrose,7578,1,24,7,5,63,35,28,79
Peterhead,7578,2,24,4,8,79,38,41,76
Stirling,7578,3,17,6,13,62,52,10,57
Clyde,7578,4,15,9,12,52,48,4,54
Stenhousem'r,7578,5,15,8,13,56,48,8,53
Elgin,7578,6,14,6,16,54,64,-10,48
Annan Athlet,7578,7,12,11,13,48,41,7,47
Berwick,7578,8,8,10,18,29,59,-30,34
Edinburgh Ci,7578,9,7,9,20,36,62,-26,30
Cowdenbeath,7578,10,4,10,22,23,55,-32,22
Montrose,7579,1,24,7,5,62,36,26,79
Peterhead,7579,2,24,4,8,79,39,40,76
Stirling,7579,3,17,6,13,63,51,12,57
Clyde,7579,4,15,9,12,53,49,4,54
Stenhousem'r,7579,5,15,8,13,55,49,6,53
Elgin,7579,6,14,6,16,55,63,-8,48
Annan Athlet,7579,7,12,11,13,51,43,8,47
Berwick,7579,8,8,10,18,30,60,-30,34
Edinburgh Ci,7579,9,7,9,20,37,62,-25,30
Cowdenbeath,7579,10,4,10,22,25,58,-33,22
Montrose,7580,1,24,7,5,61,35,26,79
Peterhead,7580,2,23,4,9,79,41,38,73
Stirling,7580,3,17,6,13,62,51,11,57
Clyde,7580,4,15,9,12,54,48,6,54
Stenhousem'r,7580,5,15,8,13,55,48,7,53
Elgin,7580,6,14,6,16,54,62,-8,48
Annan Athlet,7580,7,11,12,13,48,42,6,45
Berwick,7580,8,8,10,18,29,61,-32,34
Edinburgh Ci,7580,9,8,9,19,39,62,-23,33
Cowdenbeath,7580,10,4,11,21,24,55,-31,23
Montrose,7581,1,24,7,5,63,37,26,79
Peterhead,7581,2,24,4,8,79,39,40,76
Stirling,7581,3,16,7,13,60,51,9,55
Stenhousem'r,7581,4,15,9,12,55,46,9,54
Clyde,7581,5,15,9,12,53,48,5,54
Elgin,7581,6,14,6,16,56,64,-8,48
Annan Athlet,7581,7,11,12,13,48,42,6,45
Berwick,7581,8,8,10,18,29,60,-31,34
Edinburgh Ci,7581,9,7,9,20,37,62,-25,30
Cowdenbeath,7581,10,4,11,21,24,55,-31,23
Montrose,7582,1,24,7,5,61,35,26,79
Peterhead,7582,2,23,5,8,79,40,39,74
Stirling,7582,3,17,6,13,67,51,16,57
Clyde,7582,4,15,9,12,53,48,5,54
Stenhousem'r,7582,5,15,8,13,55,53,2,53
Elgin,7582,6,14,6,16,54,62,-8,48
Annan Athlet,7582,7,11,11,14,48,43,5,44
Berwick,7582,8,8,10,18,29,60,-31,34
Edinburgh Ci,7582,9,7,10,19,38,62,-24,31
Cowdenbeath,7582,10,5,10,21,25,55,-30,25
Montrose,7583,1,24,7,5,61,34,27,79
Peterhead,7583,2,24,4,8,81,38,43,76
Stirling,7583,3,17,6,13,61,51,10,57
Stenhousem'r,7583,4,15,8,13,55,47,8,53
Clyde,7583,5,14,10,12,52,49,3,52
Elgin,7583,6,14,6,16,53,62,-9,48
Annan Athlet,7583,7,11,11,14,47,43,4,44
Berwick,7583,8,8,11,17,30,59,-29,35
Edinburgh Ci,7583,9,7,9,20,36,64,-28,30
Cowdenbeath,7583,10,5,10,21,25,54,-29,25
Montrose,7584,1,24,7,5,63,34,29,79
Peterhead,7584,2,24,4,8,78,38,40,76
Stirling,7584,3,16,7,13,61,52,9,55
Stenhousem'r,7584,4,15,9,12,56,47,9,54
Clyde,7584,5,15,9,12,53,49,4,54
Elgin,7584,6,14,6,16,53,64,-11,48
Annan Athlet,7584,7,11,11,14,47,44,3,44
Berwick,7584,8,8,10,18,30,60,-30,34
Edinburgh Ci,7584,9,7,9,20,36,61,-25,30
Cowdenbeath,7584,10,5,10,21,26,54,-28,25
Montrose,7585,1,24,7,5,62,35,27,79
Peterhead,7585,2,24,4,8,81,39,42,76
Stirling,7585,3,16,7,13,62,53,9,55
Stenhousem'r,7585,4,15,9,12,57,48,9,54
Clyde,7585,5,14,9,13,52,51,1,51
Elgin,7585,6,14,6,16,54,63,-9,48
Annan Athlet,7585,7,12,11,13,50,43,7,47
Berwick,7585,8,9,10,17,32,59,-27,37
Edinburgh Ci,7585,9,7,9,20,37,64,-27,30
Cowdenbeath,7585,10,4,10,22,25,57,-32,22
Peterhead,7586,1,24,4,8,82,38,44,76
Montrose,7586,2,23,7,6,60,36,24,76
Stirling,7586,3,16,7,13,61,52,9,55
Stenhousem'r,7586,4,15,9,12,56,47,9,54
Clyde,7586,5,15,9,12,53,49,4,54
Elgin,7586,6,15,6,15,55,61,-6,51
Annan Athlet,7586,7,12,11,13,51,41,10,47
Berwick,7586,8,8,10,18,30,60,-30,34
Edinburgh Ci,7586,9,7,9,20,36,65,-29,30
Cowdenbeath,7586,10,4,10,22,23,58,-35,22
Peterhead,7587,1,24,4,8,82,39,43,76
Montrose,7587,2,23,7,6,59,35,24,76
Stirling,7587,3,16,7,13,62,53,9,55
Stenhousem'r,7587,4,15,9,12,57,48,9,54
Clyde,7587,5,15,9,12,54,49,5,54
Elgin,7587,6,15,6,15,54,60,-6,51
Annan Athlet,7587,7,11,11,14,47,42,5,44
Berwick,7587,8,8,10,18,30,61,-31,34
Edinburgh Ci,7587,9,7,9,20,37,65,-28,30
Cowdenbeath,7587,10,5,10,21,24,54,-30,25
Montrose,7588,1,24,7,5,63,35,28,79
Peterhead,7588,2,24,4,8,80,38,42,76
Stenhousem'r,7588,3,16,8,12,56,46,10,56
Stirling,7588,4,16,6,14,60,52,8,54
Clyde,7588,5,15,9,12,53,48,5,54
Elgin,7588,6,14,6,16,54,64,-10,48
Annan Athlet,7588,7,12,11,13,51,42,9,47
Berwick,7588,8,8,10,18,29,60,-31,34
Edinburgh Ci,7588,9,7,9,20,36,63,-27,30
Cowdenbeath,7588,10,4,10,22,24,58,-34,22
Montrose,7589,1,24,7,5,64,34,30,79
Peterhead,7589,2,23,5,8,77,38,39,74
Stirling,7589,3,16,7,13,61,52,9,55
Stenhousem'r,7589,4,15,9,12,56,47,9,54
Clyde,7589,5,14,9,13,51,49,2,51
Elgin,7589,6,14,6,16,53,65,-12,48
Annan Athlet,7589,7,12,11,13,49,42,7,47
Berwick,7589,8,9,10,17,30,58,-28,37
Edinburgh Ci,7589,9,7,10,19,36,60,-24,31
Cowdenbeath,7589,10,4,10,22,24,56,-32,22
Peterhead,7590,1,24,4,8,79,39,40,76
Montrose,7590,2,23,7,6,60,36,24,76
Stirling,7590,3,17,6,13,62,51,11,57
Clyde,7590,4,15,9,12,54,48,6,54
Stenhousem'r,7590,5,15,8,13,55,48,7,53
Elgin,7590,6,15,6,15,55,61,-6,51
Annan Athlet,7590,7,11,12,13,48,42,6,45
Berwick,7590,8,8,10,18,29,61,-32,34
Edinburgh Ci,7590,9,7,9,20,37,62,-25,30
Cowdenbeath,7590,10,4,11,21,24,55,-31,23
Montrose,7591,1,24,7,5,60,34,26,79
Peterhead,7591,2,24,4,8,80,38,42,76
Stenhousem'r,7591,3,16,8,12,59,47,12,56
Stirling,7591,4,16,6,14,61,55,6,54
Clyde,7591,5,14,10,12,51,48,3,52
Elgin,7591,6,14,6,16,53,61,-8,48
Annan Athlet,7591,7,11,12,13,48,42,6,45
Berwick,7591,8,8,11,17,29,58,-29,35
Edinburgh Ci,7591,9,7,9,20,36,63,-27,30
Cowdenbeath,7591,10,4,11,21,24,55,-31,23
Montrose,7592,1,23,8,5,59,34,25,77
Peterhead,7592,2,23,4,9,79,41,38,73
Stirling,7592,3,17,6,13,63,53,10,57
Stenhousem'r,7592,4,15,8,13,57,49,8,53
Clyde,7592,5,14,10,12,52,49,3,52
Elgin,7592,6,14,7,15,53,60,-7,49
Annan Athlet,7592,7,11,12,13,48,42,6,45
Berwick,7592,8,8,11,17,30,59,-29,35
Edinburgh Ci,7592,9,8,9,19,39,62,-23,33
Cowdenbeath,7592,10,4,11,21,24,55,-31,23
Peterhead,7593,1,24,4,8,78,38,40,76
Montrose,7593,2,23,7,6,59,36,23,76
Stirling,7593,3,16,7,13,61,52,9,55
Stenhousem'r,7593,4,15,9,12,56,47,9,54
Clyde,7593,5,14,9,13,53,51,2,51
Elgin,7593,6,15,6,15,55,60,-5,51
Annan Athlet,7593,7,11,11,14,47,43,4,44
Berwick,7593,8,9,10,17,32,60,-28,37
Edinburgh Ci,7593,9,7,9,20,36,61,-25,30
Cowdenbeath,7593,10,5,10,21,25,54,-29,25
Montrose,7594,1,23,7,6,59,35,24,76
Peterhead,7594,2,23,4,9,77,39,38,73
Stirling,7594,3,17,6,13,61,51,10,57
Clyde,7594,4,15,9,12,52,48,4,54
Stenhousem'r,7594,5,15,8,13,55,47,8,53
Elgin,7594,6,15,6,15,54,60,-6,51
Annan Athlet,7594,7,11,11,14,47,42,5,44
Berwick,7594,8,8,10,18,29,59,-30,34
Edinburgh Ci,7594,9,8,9,19,37,60,-23,33
Cowdenbeath,7594,10,5,10,21,24,54,-30,25
Montrose,7595,1,24,7,5,64,35,29,79
Peterhead,7595,2,24,4,8,79,38,41,76
Stirling,7595,3,17,6,13,61,51,10,57
Stenhousem'r,7595,4,15,8,13,55,47,8,53
Clyde,7595,5,14,10,12,52,49,3,52
Elgin,7595,6,14,6,16,54,65,-11,48
Annan Athlet,7595,7,12,11,13,48,41,7,47
Berwick,7595,8,8,11,17,30,59,-29,35
Edinburgh Ci,7595,9,7,9,20,36,62,-26,30
Cowdenbeath,7595,10,4,10,22,23,55,-32,22
Montrose,7596,1,24,7,5,61,34,27,79
Peterhead,7596,2,24,4,8,82,39,43,76
Stirling,7596,3,17,6,13,63,52,11,57
Stenhousem'r,7596,4,15,8,13,56,49,7,53
Clyde,7596,5,14,9,13,52,50,2,51
Elgin,7596,6,14,6,16,53,62,-9,48
Annan Athlet,7596,7,11,12,13,48,42,6,45
Berwick,7596,8,9,10,17,31,59,-28,37
Edinburgh Ci,7596,9,7,9,20,37,65,-28,30
Cowdenbeath,7596,10,4,11,21,24,55,-31,23
Montrose,7597,1,24,7,5,61,35,26,79
Peterhead,7597,2,24,4,8,80,38,42,76
Stirling,7597,3,16,7,13,61,52,9,55
Stenhousem'r,7597,4,15,9,12,56,47,9,54
Clyde,7597,5,15,9,12,53,49,4,54
Elgin,7597,6,14,6,16,54,62,-8,48
Annan Athlet,7597,7,12,11,13,48,41,7,47
Berwick,7597,8,8,10,18,30,60,-30,34
Edinburgh Ci,7597,9,7,9,20,36,63,-27,30
Cowdenbeath,7597,10,4,10,22,23,55,-32,22
Montrose,7598,1,24,7,5,62,34,28,79
Peterhead,7598,2,24,4,8,78,38,40,76
Stirling,7598,3,16,7,13,63,54,9,55
Stenhousem'r,7598,4,15,9,12,58,49,9,54
Clyde,7598,5,15,9,12,52,48,4,54
Elgin,7598,6,14,6,16,53,63,-10,48
Annan Athlet,7598,7,11,11,14,47,42,5,44
Berwick,7598,8,8,10,18,29,59,-30,34
Edinburgh Ci,7598,9,7,9,20,36,61,-25,30
Cowdenbeath,7598,10,5,10,21,24,54,-30,25
Montrose,7599,1,24,7,5,60,34,26,79
Peterhead,7599,2,23,5,8,77,38,39,74
Stenhousem'r,7599,3,16,8,12,58,47,11,56
Stirling,7599,4,16,6,14,61,54,7,54
Clyde,7599,5,14,10,12,51,48,3,52
Elgin,7599,6,14,6,16,53,61,-8,48
Annan Athlet,7599,7,11,12,13,48,42,6,45
Berwick,7599,8,8,11,17,29,58,-29,35
Edinburgh Ci,7599,9,7,10,19,36,60,-24,31
Cowdenbeath,7599,10,4,11,21,24,55,-31,23
Montrose,7600,1,24,7,5,62,35,27,79
Peterhead,7600,2,23,4,9,77,40,37,73
Stirling,7600,3,16,7,13,61,52,9,55
Stenhousem'r,7600,4,15,9,12,56,47,9,54
Clyde,7600,5,15,9,12,53,48,5,54
Elgin,7600,6,14,6,16,54,63,-9,48
Annan Athlet,7600,7,12,11,13,48,41,7,47
Berwick,7600,8,8,10,18,29,60,-31,34
Edinburgh Ci,7600,9,8,9,19,38,60,-22,33
Cowdenbeath,7600,10,4,10,22,23,55,-32,22
Montrose,7601,1,24,7,5,62,34,28,79
Peterhead,7601,2,24,4,8,81,39,42,76
Stenhousem'r,7601,3,16,8,12,57,47,10,56
Stirling,7601,4,16,6,14,61,53,8,54
Clyde,7601,5,14,10,12,52,49,3,52
Elgin,7601,6,14,6,16,53,63,-10,48
Annan Athlet,7601,7,11,12,13,49,43,6,45
Berwick,7601,8,8,11,17,30,59,-29,35
Edinburgh Ci,7601,9,7,9,20,37,64,-27,30
Cowdenbeath,7601,10,4,11,21,25,56,-31,23
Montrose,7602,1,24,7,5,61,35,26,79
Peterhead,7602,2,24,4,8,81,38,43,76
Stirling,7602,3,17,6,13,62,51,11,57
Stenhousem'r,7602,4,15,8,13,55,48,7,53
Clyde,7602,5,14,9,13,52,50,2,51
Elgin,7602,6,14,6,16,54,62,-8,48
Annan Athlet,7602,7,12,11,13,49,41,8,47
Berwick,7602,8,9,10,17,31,59,-28,37
Edinburgh Ci,7602,9,7,9,20,36,64,-28,30
Cowdenbeath,7602,10,4,10,22,23,56,-33,22
Montrose,7603,1,23,8,5,60,35,25,77
Peterhead,7603,2,23,5,8,79,40,39,74
Stirling,7603,3,17,6,13,64,51,13,57
Clyde,7603,4,15,9,12,53,48,5,54
Stenhousem'r,7603,5,15,8,13,55,50,5,53
Elgin,7603,6,14,7,15,54,61,-7,49
Annan Athlet,7603,7,11,12,13,48,42,6,45
Berwick,7603,8,8,10,18,29,60,-31,34
Edinburgh Ci,7603,9,7,10,19,38,62,-24,31
Cowdenbeath,7603,10,4,11,21,24,55,-31,23
Montrose,7604,1,24,7,5,64,34,30,79
Peterhead,7604,2,23,4,9,77,40,37,73
Stirling,7604,3,16,7,13,60,51,9,55
Stenhousem'r,7604,4,15,9,12,55,46,9,54
Clyde,7604,5,15,9,12,54,49,5,54
Elgin,7604,6,14,6,16,53,65,-12,48
Annan Athlet,7604,7,11,12,13,47,41,6,45
Berwick,7604,8,8,10,18,30,61,-31,34
Edinburgh Ci,7604,9,8,9,19,38,60,-22,33
Cowdenbeath,7604,10,4,11,21,23,54,-31,23
Montrose,7605,1,24,7,5,62,34,28,79
Peterhead,7605,2,24,4,8,82,39,43,76
Stirling,7605,3,17,6,13,62,51,11,57
Clyde,7605,4,15,9,12,52,48,4,54
Stenhousem'r,7605,5,15,8,13,55,48,7,53
Elgin,7605,6,14,6,16,53,63,-10,48
Annan Athlet,7605,7,11,11,14,47,43,4,44
Berwick,7605,8,8,10,18,29,59,-30,34
Edinburgh Ci,7605,9,7,9,20,37,65,-28,30
Cowdenbeath,7605,10,5,10,21,25,54,-29,25
Montrose,7606,1,24,7,5,61,35,26,79
Peterhead,7606,2,24,4,8,81,39,42,76
Stirling,7606,3,17,6,13,62,52,10,57
Clyde,7606,4,15,9,12,54,49,5,54
Stenhousem'r,7606,5,15,8,13,56,48,8,53
Elgin,7606,6,14,6,16,54,62,-8,48
Annan Athlet,7606,7,11,12,13,47,41,6,45
Berwick,7606,8,8,10,18,30,61,-31,34
Edinburgh Ci,7606,9,7,9,20,37,64,-27,30
Cowdenbeath,7606,10,4,11,21,23,54,-31,23
Montrose,7607,1,24,7,5,62,34,28,79
Peterhead,7607,2,24,4,8,79,38,41,76
Stirling,7607,3,17,6,13,61,51,10,57
Stenhousem'r,7607,4,15,8,13,55,47,8,53
Clyde,7607,5,14,9,13,52,50,2,51
Elgin,7607,6,14,6,16,53,63,-10,48
Annan Athlet,7607,7,11,11,14,47,43,4,44
Berwick,7607,8,9,10,17,31,59,-28,37
Edinburgh Ci,7607,9,7,9,20,36,62,-26,30
Cowdenbeath,7607,10,5,10,21,25,54,-29,25
Montrose,7608,1,24,7,5,62,35,27,79
Peterhead,7608,2,24,4,8,82,38,44,76
Stirling,7608,3,17,6,13,63,53,10,57
Clyde,7608,4,15,9,12,53,49,4,54
Stenhousem'r,7608,5,15,8,13,57,49,8,53
Elgin,7608,6,14,6,16,54,63,-9,48
Annan Athlet,7608,7,12,11,13,48,41,7,47
Berwick,7608,8,8,10,18,30,60,-30,34
Edinburgh Ci,7608,9,7,9,20,36,65,-29,30
Cowdenbeath,7608,10,4,10,22,23,55,-32,22
Montrose,7609,1,23,8,5,60,35,25,77
Peterhead,7609,2,24,4,8,80,40,40,76
Stirling,7609,3,17,6,13,64,54,10,57
Clyde,7609,4,15,9,12,53,49,4,54
Stenhousem'r,7609,5,15,8,13,58,50,8,53
Elgin,7609,6,14,7,15,54,61,-7,49
Annan Athlet,7609,7,11,12,13,48,42,6,45
Berwick,7609,8,8,10,18,30,60,-30,34
Edinburgh Ci,7609,9,7,9,20,38,63,-25,30
Cowdenbeath,7609,10,4,11,21,24,55,-31,23
Montrose,7610,1,24,7,5,64,35,29,79
Peterhead,7610,2,24,4,8,79,39,40,76
Stirling,7610,3,16,7,13,61,52,9,55
Stenhousem'r,7610,4,15,9,12,56,47,9,54
Clyde,7610,5,14,9,13,51,52,-1,51
Elgin,7610,6,14,6,16,54,65,-11,48
Annan Athlet,7610,7,12,11,13,49,42,7,47
Berwick,7610,8,9,10,17,33,58,-25,37
Edinburgh Ci,7610,9,7,9,20,37,62,-25,30
Cowdenbeath,7610,10,4,10,22,24,56,-32,22
Montrose,7611,1,24,7,5,63,35,28,79
Peterhead,7611,2,24,4,8,80,39,41,76
Stirling,7611,3,17,6,13,63,51,12,57
Clyde,7611,4,15,9,12,55,49,6,54
Stenhousem'r,7611,5,15,8,13,55,49,6,53
Elgin,7611,6,14,6,16,54,64,-10,48
Annan Athlet,7611,7,12,11,13,49,42,7,47
Berwick,7611,8,8,10,18,30,62,-32,34
Edinburgh Ci,7611,9,7,9,20,37,63,-26,30
Cowdenbeath,7611,10,4,10,22,24,56,-32,22
Montrose,7612,1,24,7,5,62,35,27,79
Peterhead,7612,2,24,4,8,78,38,40,76
Stenhousem'r,7612,3,16,8,12,58,47,11,56
Stirling,7612,4,16,6,14,61,54,7,54
Clyde,7612,5,15,9,12,53,48,5,54
Elgin,7612,6,14,6,16,54,63,-9,48
Annan Athlet,7612,7,12,11,13,49,42,7,47
Berwick,7612,8,8,10,18,29,60,-31,34
Edinburgh Ci,7612,9,7,9,20,36,61,-25,30
Cowdenbeath,7612,10,4,10,22,24,56,-32,22
Montrose,7613,1,24,7,5,62,34,28,79
Peterhead,7613,2,24,4,8,79,38,41,76
Stirling,7613,3,17,6,13,63,53,10,57
Clyde,7613,4,15,9,12,52,48,4,54
Stenhousem'r,7613,5,15,8,13,57,49,8,53
Elgin,7613,6,14,6,16,53,63,-10,48
Annan Athlet,7613,7,11,11,14,47,43,4,44
Berwick,7613,8,8,10,18,29,59,-30,34
Edinburgh Ci,7613,9,7,9,20,36,62,-26,30
Cowdenbeath,7613,10,5,10,21,25,54,-29,25
Montrose,7614,1,23,8,5,62,37,25,77
Peterhead,7614,2,24,4,8,78,38,40,76
Stenhousem'r,7614,3,16,8,12,57,46,11,56
Stirling,7614,4,16,6,14,60,53,7,54
Clyde,7614,5,14,10,12,52,49,3,52
Elgin,7614,6,14,7,15,56,63,-7,49
Annan Athlet,7614,7,11,12,13,48,42,6,45
Berwick,7614,8,8,11,17,30,59,-29,35
Edinburgh Ci,7614,9,7,9,20,36,61,-25,30
Cowdenbeath,7614,10,4,11,21,24,55,-31,23
Montrose,7615,1,23,8,5,61,36,25,77
Peterhead,7615,2,24,4,8,80,39,41,76
Stirling,7615,3,16,7,13,60,51,9,55
Stenhousem'r,7615,4,15,9,12,55,46,9,54
Clyde,7615,5,14,9,13,51,50,1,51
Elgin,7615,6,14,7,15,55,62,-7,49
Annan Athlet,7615,7,11,12,13,49,43,6,45
Berwick,7615,8,9,10,17,31,58,-27,37
Edinburgh Ci,7615,9,7,9,20,37,63,-26,30
Cowdenbeath,7615,10,4,11,21,25,56,-31,23
Montrose,7616,1,24,7,5,60,34,26,79
Peterhead,7616,2,23,4,9,79,43,36,73
Stirling,7616,3,17,6,13,62,51,11,57
Stenhousem'r,7616,4,15,8,13,55,48,7,53
Clyde,7616,5,14,10,12,53,50,3,52
Elgin,7616,6,14,6,16,53,61,-8,48
Annan Athlet,7616,7,12,11,13,49,42,7,47
Berwick,7616,8,8,11,17,31,60,-29,35
Edinburgh Ci,7616,9,8,9,19,41,62,-21,33
Cowdenbeath,7616,10,4,10,22,24,56,-32,22
Montrose,7617,1,24,7,5,65,34,31,79
Peterhead,7617,2,24,4,8,79,38,41,76
Stirling,7617,3,16,7,13,61,52,9,55
Stenhousem'r,7617,4,15,9,12,56,47,9,54
Clyde,7617,5,15,9,12,54,50,4,54
Elgin,7617,6,14,6,16,53,66,-13,48
Annan Athlet,7617,7,11,11,14,48,44,4,44
Berwick,7617,8,8,10,18,31,61,-30,34
Edinburgh Ci,7617,9,7,9,20,36,62,-26,30
Cowdenbeath,7617,10,5,10,21,26,55,-29,25
Montrose,7618,1,23,8,5,60,35,25,77
Peterhead,7618,2,24,4,8,81,41,40,76
Stirling,7618,3,16,7,13,61,52,9,55
Stenhousem'r,7618,4,15,9,12,56,47,9,54
Clyde,7618,5,14,9,13,52,50,2,51
Elgin,7618,6,14,7,15,54,61,-7,49
Annan Athlet,7618,7,12,11,13,48,41,7,47
Berwick,7618,8,9,10,17,31,59,-28,37
Edinburgh Ci,7618,9,7,9,20,39,64,-25,30
Cowdenbeath,7618,10,4,10,22,23,55,-32,22
Montrose,7619,1,24,7,5,62,34,28,79
Peterhead,7619,2,23,4,9,78,41,37,73
Stirling,7619,3,17,6,13,63,52,11,57
Stenhousem'r,7619,4,15,8,13,56,49,7,53
Clyde,7619,5,14,10,12,51,48,3,52
Elgin,7619,6,14,6,16,53,63,-10,48
Annan Athlet,7619,7,12,11,13,51,43,8,47
Berwick,7619,8,8,11,17,29,58,-29,35
Edinburgh Ci,7619,9,8,9,19,39,61,-22,33
Cowdenbeath,7619,10,4,10,22,25,58,-33,22
Montrose,7620,1,23,8,5,59,34,25,77
Peterhead,7620,2,24,4,8,79,38,41,76
Stenhousem'r,7620,3,16,8,12,57,46,11,56
Stirling,7620,4,16,6,14,60,53,7,54
Clyde,7620,5,15,9,12,55,48,7,54
Elgin,7620,6,14,7,15,53,60,-7,49
Annan Athlet,7620,7,12,11,13,50,41,9,47
Berwick,7620,8,8,10,18,29,62,-33,34
Edinburgh Ci,7620,9,7,9,20,36,62,-26,30
Cowdenbeath,7620,10,4,10,22,23,57,-34,22
Montrose,7621,1,24,7,5,62,34,28,79
Peterhead,7621,2,24,4,8,79,39,40,76
Stirling,7621,3,17,6,13,62,51,11,57
Stenhousem'r,7621,4,15,8,13,55,48,7,53
Clyde,7621,5,14,9,13,52,51,1,51
Elgin,7621,6,14,6,16,53,63,-10,48
Annan Athlet,7621,7,11,12,13,47,41,6,45
Berwick,7621,8,9,10,17,32,59,-27,37
Edinburgh Ci,7621,9,7,9,20,37,62,-25,30
Cowdenbeath,7621,10,4,11,21,23,54,-31,23
Montrose,7622,1,24,7,5,60,34,26,79
Peterhead,7622,2,24,4,8,79,38,41,76
Stirling,7622,3,17,6,13,62,51,11,57
Stenhousem'r,7622,4,15,8,13,55,48,7,53
Clyde,7622,5,14,9,13,53,52,1,51
Elgin,7622,6,14,6,16,53,61,-8,48
Annan Athlet,7622,7,12,11,13,49,41,8,47
Berwick,7622,8,9,10,17,33,60,-27,37
Edinburgh Ci,7622,9,7,9,20,36,62,-26,30
Cowdenbeath,7622,10,4,10,22,23,56,-33,22
Montrose,7623,1,23,8,5,60,35,25,77
Peterhead,7623,2,24,4,8,79,38,41,76
Stenhousem'r,7623,3,16,8,12,58,48,10,56
Stirling,7623,4,16,6,14,62,54,8,54
Clyde,7623,5,14,9,13,52,52,0,51
Elgin,7623,6,14,7,15,54,61,-7,49
Annan Athlet,7623,7,12,11,13,48,41,7,47
Berwick,7623,8,9,10,17,33,59,-26,37
Edinburgh Ci,7623,9,7,9,20,36,62,-26,30
Cowdenbeath,7623,10,4,10,22,23,55,-32,22
Montrose,7624,1,24,7,5,61,34,27,79
Peterhead,7624,2,24,4,8,79,38,41,76
Stirling,7624,3,17,6,13,64,53,11,57
Stenhousem'r,7624,4,15,8,13,57,50,7,53
Clyde,7624,5,14,10,12,52,49,3,52
Elgin,7624,6,14,6,16,53,62,-9,48
Annan Athlet,7624,7,11,12,13,48,42,6,45
Berwick,7624,8,8,11,17,30,59,-29,35
Edinburgh Ci,7624,9,7,9,20,36,62,-26,30
Cowdenbeath,7624,10,4,11,21,24,55,-31,23
Montrose,7625,1,24,7,5,60,34,26,79
Peterhead,7625,2,24,4,8,80,38,42,76
Stenhousem'r,7625,3,16,8,12,57,46,11,56
Stirling,7625,4,16,6,14,60,53,7,54
Clyde,7625,5,14,10,12,51,48,3,52
Elgin,7625,6,14,6,16,53,61,-8,48
Annan Athlet,7625,7,12,11,13,49,42,7,47
Berwick,7625,8,8,11,17,29,58,-29,35
Edinburgh Ci,7625,9,7,9,20,36,63,-27,30
Cowdenbeath,7625,10,4,10,22,24,56,-32,22
Peterhead,7626,1,24,4,8,83,41,42,76
Montrose,7626,2,23,7,6,59,35,24,76
Stirling,7626,3,17,6,13,63,53,10,57
Clyde,7626,4,15,9,12,56,49,7,54
Stenhousem'r,7626,5,15,8,13,57,49,8,53
Elgin,7626,6,15,6,15,54,60,-6,51
Annan Athlet,7626,7,12,11,13,48,41,7,47
Berwick,7626,8,8,10,18,30,63,-33,34
Edinburgh Ci,7626,9,7,9,20,39,66,-27,30
Cowdenbeath,7626,10,4,10,22,23,55,-32,22
Montrose,7627,1,24,7,5,63,35,28,79
Peterhead,7627,2,23,5,8,78,39,39,74
Stirling,7627,3,17,6,13,64,51,13,57
Stenhousem'r,7627,4,15,8,13,55,50,5,53
Clyde,7627,5,14,10,12,52,49,3,52
Elgin,7627,6,14,6,16,54,64,-10,48
Annan Athlet,7627,7,12,11,13,48,41,7,47
Berwick,7627,8,8,11,17,30,59,-29,35
Edinburgh Ci,7627,9,7,10,19,37,61,-24,31
Cowdenbeath,7627,10,4,10,22,23,55,-32,22
Montrose,7628,1,23,7,6,60,36,24,76
Peterhead,7628,2,23,5,8,78,39,39,74
Stirling,7628,3,16,7,13,60,51,9,55
Stenhousem'r,7628,4,15,9,12,55,46,9,54
Clyde,7628,5,15,9,12,55,48,7,54
Elgin,7628,6,15,6,15,55,61,-6,51
Annan Athlet,7628,7,11,12,13,49,43,6,45
Berwick,7628,8,8,10,18,29,62,-33,34
Edinburgh Ci,7628,9,7,10,19,37,61,-24,31
Cowdenbeath,7628,10,4,11,21,25,56,-31,23
Montrose,7629,1,24,7,5,61,34,27,79
Peterhead,7629,2,23,4,9,77,40,37,73
Stenhousem'r,7629,3,16,8,12,58,47,11,56
Clyde,7629,4,15,9,12,56,48,8,54
Stirling,7629,5,16,6,14,61,54,7,54
Elgin,7629,6,14,6,16,53,62,-9,48
Annan Athlet,7629,7,11,11,14,47,44,3,44
Berwick,7629,8,8,10,18,29,63,-34,34
Edinburgh Ci,7629,9,8,9,19,38,60,-22,33
Cowdenbeath,7629,10,5,10,21,26,54,-28,25
Montrose,7630,1,23,8,5,61,36,25,77
Peterhead,7630,2,23,5,8,78,39,39,74
Stenhousem'r,7630,3,16,8,12,57,46,11,56
Stirling,7630,4,16,6,14,60,53,7,54
Clyde,7630,5,15,9,12,54,48,6,54
Elgin,7630,6,14,7,15,55,62,-7,49
Annan Athlet,7630,7,12,11,13,52,43,9,47
Berwick,7630,8,8,10,18,29,61,-32,34
Edinburgh Ci,7630,9,7,10,19,37,61,-24,31
Cowdenbeath,7630,10,4,10,22,25,59,-34,22
Montrose,7631,1,24,7,5,61,35,26,79
Peterhead,7631,2,24,4,8,78,38,40,76
Stirling,7631,3,16,7,13,61,52,9,55
Stenhousem'r,7631,4,15,9,12,56,47,9,54
Clyde,7631,5,15,9,12,56,48,8,54
Elgin,7631,6,14,6,16,54,62,-8,48
Annan Athlet,7631,7,12,11,13,50,43,7,47
Berwick,7631,8,8,10,18,29,63,-34,34
Edinburgh Ci,7631,9,7,9,20,36,61,-25,30
Cowdenbeath,7631,10,4,10,22,25,57,-32,22
Montrose,7632,1,24,7,5,61,35,26,79
Peterhead,7632,2,24,4,8,80,38,42,76
Stirling,7632,3,16,7,13,60,51,9,55
Stenhousem'r,7632,4,15,9,12,55,46,9,54
Clyde,7632,5,15,9,12,56,48,8,54
Elgin,7632,6,14,6,16,54,62,-8,48
Annan Athlet,7632,7,11,12,13,47,41,6,45
Berwick,7632,8,8,10,18,29,63,-34,34
Edinburgh Ci,7632,9,7,9,20,36,63,-27,30
Cowdenbeath,7632,10,4,11,21,23,54,-31,23
Peterhead,7633,1,24,4,8,79,39,40,76
Montrose,7633,2,23,7,6,61,37,24,76
Stirling,7633,3,17,6,13,63,51,12,57
Clyde,7633,4,15,9,12,53,49,4,54
Stenhousem'r,7633,5,15,8,13,55,49,6,53
Elgin,7633,6,15,6,15,56,62,-6,51
Annan Athlet,7633,7,11,11,14,47,42,5,44
Berwick,7633,8,8,10,18,30,60,-30,34
Edinburgh Ci,7633,9,7,9,20,37,62,-25,30
Cowdenbeath,7633,10,5,10,21,24,54,-30,25
Peterhead,7634,1,24,4,8,81,38,43,76
Montrose,7634,2,23,7,6,60,37,23,76
Stirling,7634,3,17,6,13,63,53,10,57
Clyde,7634,4,15,9,12,54,48,6,54
Stenhousem'r,7634,5,15,8,13,57,49,8,53
Elgin,7634,6,15,6,15,56,61,-5,51
Annan Athlet,7634,7,11,12,13,48,42,6,45
Berwick,7634,8,8,10,18,29,61,-32,34
Edinburgh Ci,7634,9,7,9,20,36,64,-28,30
Cowdenbeath,7634,10,4,11,21,24,55,-31,23
Montrose,7635,1,24,7,5,62,35,27,79
Peterhead,7635,2,24,4,8,80,39,41,76
Stenhousem'r,7635,3,16,8,12,57,46,11,56
Stirling,7635,4,16,6,14,60,53,7,54
Clyde,7635,5,15,9,12,56,49,7,54
Elgin,7635,6,14,6,16,54,63,-9,48
Annan Athlet,7635,7,12,11,13,49,42,7,47
Berwick,7635,8,8,10,18,30,63,-33,34
Edinburgh Ci,7635,9,7,9,20,37,63,-26,30
Cowdenbeath,7635,10,4,10,22,24,56,-32,22
Montrose,7636,1,23,7,6,61,37,24,76
Peterhead,7636,2,23,5,8,79,40,39,74
Stenhousem'r,7636,3,16,8,12,56,46,10,56
Stirling,7636,4,16,6,14,60,52,8,54
Clyde,7636,5,15,9,12,53,48,5,54
Elgin,7636,6,15,6,15,56,62,-6,51
Annan Athlet,7636,7,12,11,13,50,41,9,47
Berwick,7636,8,8,10,18,29,60,-31,34
Edinburgh Ci,7636,9,7,10,19,38,62,-24,31
Cowdenbeath,7636,10,4,10,22,23,57,-34,22
Montrose,7637,1,24,7,5,61,34,27,79
Peterhead,7637,2,24,4,8,80,40,40,76
Stirling,7637,3,17,6,13,62,51,11,57
Stenhousem'r,7637,4,15,8,13,55,48,7,53
Clyde,7637,5,14,9,13,51,50,1,51
Elgin,7637,6,14,6,16,53,62,-9,48
Annan Athlet,7637,7,11,11,14,48,43,5,44
Berwick,7637,8,9,10,17,31,58,-27,37
Edinburgh Ci,7637,9,7,9,20,38,63,-25,30
Cowdenbeath,7637,10,5,10,21,25,55,-30,25
Montrose,7638,1,23,8,5,61,36,25,77
Peterhead,7638,2,24,4,8,79,38,41,76
Stirling,7638,3,16,7,13,60,51,9,55
Stenhousem'r,7638,4,15,9,12,55,46,9,54
Clyde,7638,5,15,9,12,52,48,4,54
Elgin,7638,6,14,7,15,55,62,-7,49
Annan Athlet,7638,7,11,12,13,47,41,6,45
Berwick,7638,8,8,10,18,29,59,-30,34
Edinburgh Ci,7638,9,7,9,20,36,62,-26,30
Cowdenbeath,7638,10,4,11,21,23,54,-31,23
Montrose,7639,1,24,7,5,61,35,26,79
Peterhead,7639,2,23,5,8,79,40,39,74
Stirling,7639,3,16,7,13,61,52,9,55
Stenhousem'r,7639,4,15,9,12,56,47,9,54
Clyde,7639,5,15,9,12,53,48,5,54
Elgin,7639,6,14,6,16,54,62,-8,48
Annan Athlet,7639,7,12,11,13,50,42,8,47
Berwick,7639,8,8,10,18,29,60,-31,34
Edinburgh Ci,7639,9,7,10,19,38,62,-24,31
Cowdenbeath,7639,10,4,10,22,24,57,-33,22
Montrose,7640,1,23,8,5,60,35,25,77
Peterhead,7640,2,23,4,9,77,39,38,73
Stenhousem'r,7640,3,16,8,12,58,46,12,56
Stirling,7640,4,16,6,14,60,54,6,54
Clyde,7640,5,15,9,12,53,48,5,54
Elgin,7640,6,14,7,15,54,61,-7,49
Annan Athlet,7640,7,11,11,14,48,45,3,44
Berwick,7640,8,8,10,18,29,60,-31,34
Edinburgh Ci,7640,9,8,9,19,37,60,-23,33
Cowdenbeath,7640,10,5,10,21,27,55,-28,25
Peterhead,7641,1,24,4,8,82,38,44,76
Montrose,7641,2,23,7,6,59,36,23,76
Stirling,7641,3,17,6,13,64,53,11,57
Clyde,7641,4,15,9,12,53,49,4,54
Stenhousem'r,7641,5,15,8,13,57,50,7,53
Elgin,7641,6,15,6,15,55,60,-5,51
Annan Athlet,7641,7,11,11,14,47,42,5,44
Berwick,7641,8,8,10,18,30,60,-30,34
Edinburgh Ci,7641,9,7,9,20,36,65,-29,30
Cowdenbeath,7641,10,5,10,21,24,54,-30,25
Montrose,7642,1,23,8,5,59,34,25,77
Peterhead,7642,2,24,4,8,80,39,41,76
Stirling,7642,3,17,6,13,64,52,12,57
Clyde,7642,4,15,9,12,55,48,7,54
Stenhousem'r,7642,5,15,8,13,56,50,6,53
Elgin,7642,6,14,7,15,53,60,-7,49
Annan Athlet,7642,7,11,11,14,47,43,4,44
Berwick,7642,8,8,10,18,29,62,-33,34
Edinburgh Ci,7642,9,7,9,20,37,63,-26,30
Cowdenbeath,7642,10,5,10,21,25,54,-29,25
Montrose,7643,1,24,7,5,62,36,26,79
Peterhead,7643,2,24,4,8,84,38,46,76
Stenhousem'r,7643,3,16,8,12,60,49,11,56
Stirling,7643,4,16,6,14,63,56,7,54
Clyde,7643,5,15,9,12,52,48,4,54
Elgin,7643,6,14,6,16,55,63,-8,48
Annan Athlet,7643,7,12,11,13,49,41,8,47
Berwick,7643,8,8,10,18,29,59,-30,34
Edinburgh Ci,7643,9,7,9,20,36,67,-31,30
Cowdenbeath,7643,10,4,10,22,23,56,-33,22
Montrose,7644,1,24,7,5,64,36,28,79
Peterhead,7644,2,23,5,8,78,39,39,74
Stirling,7644,3,16,7,13,62,53,9,55
Stenhousem'r,7644,4,15,9,12,57,48,9,54
Clyde,7644,5,14,9,13,51,49,2,51
Elgin,7644,6,14,6,16,55,65,-10,48
Annan Athlet,7644,7,11,12,13,47,41,6,45
Berwick,7644,8,9,10,17,30,58,-28,37
Edinburgh Ci,7644,9,7,10,19,37,61,-24,31
Cowdenbeath,7644,10,4,11,21,23,54,-31,23
Montrose,7645,1,23,8,5,59,34,25,77
Peterhead,7645,2,24,4,8,80,40,40,76
Stirling,7645,3,17,6,13,63,52,11,57
Stenhousem'r,7645,4,15,8,13,56,49,7,53
Clyde,7645,5,14,10,12,54,51,3,52
Elgin,7645,6,14,7,15,53,60,-7,49
Annan Athlet,7645,7,11,11,14,48,43,5,44
Berwick,7645,8,8,11,17,32,61,-29,35
Edinburgh Ci,7645,9,7,9,20,38,63,-25,30
Cowdenbeath,7645,10,5,10,21,25,55,-30,25
Montrose,7646,1,24,7,5,62,35,27,79
Peterhead,7646,2,24,4,8,82,38,44,76
Stirling,7646,3,17,6,13,64,51,13,57
Stenhousem'r,7646,4,15,8,13,55,50,5,53
Clyde,7646,5,14,10,12,51,48,3,52
Elgin,7646,6,14,6,16,54,63,-9,48
Annan Athlet,7646,7,11,11,14,47,42,5,44
Berwick,7646,8,8,11,17,29,58,-29,35
Edinburgh Ci,7646,9,7,9,20,36,65,-29,30
Cowdenbeath,7646,10,5,10,21,24,54,-30,25
Montrose,7647,1,24,7,5,61,34,27,79
Peterhead,7647,2,24,4,8,79,39,40,76
Stirling,7647,3,17,6,13,61,51,10,57
Stenhousem'r,7647,4,15,8,13,55,47,8,53
Clyde,7647,5,14,10,12,51,48,3,52
Elgin,7647,6,14,6,16,53,62,-9,48
Annan Athlet,7647,7,12,11,13,49,42,7,47
Berwick,7647,8,8,11,17,29,58,-29,35
Edinburgh Ci,7647,9,7,9,20,37,62,-25,30
Cowdenbeath,7647,10,4,10,22,24,56,-32,22
Montrose,7648,1,24,7,5,61,34,27,79
Peterhead,7648,2,24,4,8,80,39,41,76
Stenhousem'r,7648,3,16,8,12,58,47,11,56
Stirling,7648,4,16,6,14,61,54,7,54
Clyde,7648,5,14,10,12,53,50,3,52
Elgin,7648,6,14,6,16,53,62,-9,48
Annan Athlet,7648,7,11,11,14,48,43,5,44
Berwick,7648,8,8,11,17,31,60,-29,35
Edinburgh Ci,7648,9,7,9,20,37,63,-26,30
Cowdenbeath,7648,10,5,10,21,25,55,-30,25
Peterhead,7649,1,24,4,8,80,38,42,76
Montrose,7649,2,23,7,6,59,36,23,76
Stirling,7649,3,17,6,13,65,53,12,57
Stenhousem'r,7649,4,15,8,13,57,51,6,53
Clyde,7649,5,14,10,12,51,48,3,52
Elgin,7649,6,15,6,15,55,60,-5,51
Annan Athlet,7649,7,12,11,13,50,42,8,47
Berwick,7649,8,8,11,17,29,58,-29,35
Edinburgh Ci,7649,9,7,9,20,36,63,-27,30
Cowdenbeath,7649,10,4,10,22,24,57,-33,22
Montrose,7650,1,24,7,5,62,36,26,79
Peterhead,7650,2,24,4,8,79,39,40,76
Stirling,7650,3,16,7,13,61,52,9,55
Stenhousem'r,7650,4,15,9,12,56,47,9,54
Clyde,7650,5,14,9,13,52,51,1,51
Elgin,7650,6,14,6,16,55,63,-8,48
Annan Athlet,7650,7,11,12,13,48,42,6,45
Berwick,7650,8,9,10,17,32,59,-27,37
Edinburgh Ci,7650,9,7,9,20,37,62,-25,30
Cowdenbeath,7650,10,4,11,21,24,55,-31,23
Montrose,7651,1,24,7,5,61,34,27,79
Peterhead,7651,2,24,4,8,80,39,41,76
Stirling,7651,3,16,7,13,62,53,9,55
Stenhousem'r,7651,4,15,9,12,57,48,9,54
Clyde,7651,5,15,9,12,54,48,6,54
Elgin,7651,6,14,6,16,53,62,-9,48
Annan Athlet,7651,7,11,11,14,47,42,5,44
Berwick,7651,8,8,10,18,29,61,-32,34
Edinburgh Ci,7651,9,7,9,20,37,63,-26,30
Cowdenbeath,7651,10,5,10,21,24,54,-30,25
Montrose,7652,1,24,7,5,61,34,27,79
Peterhead,7652,2,24,4,8,80,39,41,76
Stenhousem'r,7652,3,16,8,12,56,46,10,56
Stirling,7652,4,16,6,14,60,52,8,54
Clyde,7652,5,15,9,12,53,48,5,54
Elgin,7652,6,14,6,16,53,62,-9,48
Annan Athlet,7652,7,11,11,14,47,43,4,44
Berwick,7652,8,8,10,18,29,60,-31,34
Edinburgh Ci,7652,9,7,9,20,37,63,-26,30
Cowdenbeath,7652,10,5,10,21,25,54,-29,25
Montrose,7653,1,24,7,5,61,35,26,79
Peterhead,7653,2,24,4,8,80,40,40,76
Stirling,7653,3,17,6,13,62,51,11,57
Stenhousem'r,7653,4,15,8,13,55,48,7,53
Clyde,7653,5,14,10,12,52,49,3,52
Elgin,7653,6,14,6,16,54,62,-8,48
Annan Athlet,7653,7,12,11,13,48,41,7,47
Berwick,7653,8,8,11,17,30,59,-29,35
Edinburgh Ci,7653,9,7,9,20,38,63,-25,30
Cowdenbeath,7653,10,4,10,22,23,55,-32,22
Montrose,7654,1,24,7,5,61,35,26,79
Peterhead,7654,2,24,4,8,81,38,43,76
Stirling,7654,3,16,7,13,61,52,9,55
Stenhousem'r,7654,4,15,9,12,56,47,9,54
Clyde,7654,5,14,9,13,53,51,2,51
Elgin,7654,6,14,6,16,54,62,-8,48
Annan Athlet,7654,7,11,11,14,47,44,3,44
Berwick,7654,8,9,10,17,32,60,-28,37
Edinburgh Ci,7654,9,7,9,20,36,64,-28,30
Cowdenbeath,7654,10,5,10,21,26,54,-28,25
Montrose,7655,1,23,8,5,61,36,25,77
Peterhead,7655,2,24,4,8,80,39,41,76
Stirling,7655,3,17,6,13,61,51,10,57
Stenhousem'r,7655,4,15,8,13,55,47,8,53
Clyde,7655,5,14,10,12,52,49,3,52
Elgin,7655,6,14,7,15,55,62,-7,49
Annan Athlet,7655,7,12,11,13,48,41,7,47
Berwick,7655,8,8,11,17,30,59,-29,35
Edinburgh Ci,7655,9,7,9,20,37,63,-26,30
Cowdenbeath,7655,10,4,10,22,23,55,-32,22
Peterhead,7656,1,24,4,8,79,38,41,76
Montrose,7656,2,23,7,6,60,37,23,76
Stirling,7656,3,17,6,13,63,51,12,57
Clyde,7656,4,15,9,12,52,48,4,54
Stenhousem'r,7656,5,15,8,13,55,49,6,53
Elgin,7656,6,15,6,15,56,61,-5,51
Annan Athlet,7656,7,11,12,13,47,41,6,45
Berwick,7656,8,8,10,18,29,59,-30,34
Edinburgh Ci,7656,9,7,9,20,36,62,-26,30
Cowdenbeath,7656,10,4,11,21,23,54,-31,23
Montrose,7657,1,24,7,5,61,34,27,79
Peterhead,7657,2,24,4,8,80,38,42,76
Stenhousem'r,7657,3,16,8,12,57,46,11,56
Stirling,7657,4,16,6,14,60,53,7,54
Clyde,7657,5,15,9,12,53,49,4,54
Elgin,7657,6,14,6,16,53,62,-9,48
Annan Athlet,7657,7,12,11,13,52,44,8,47
Berwick,7657,8,8,10,18,30,60,-30,34
Edinburgh Ci,7657,9,7,9,20,36,63,-27,30
Cowdenbeath,7657,10,4,10,22,26,59,-33,22
Montrose,7658,1,24,7,5,61,35,26,79
Peterhead,7658,2,23,5,8,78,39,39,74
Stirling,7658,3,17,6,13,62,51,11,57
Clyde,7658,4,15,9,12,53,49,4,54
Stenhousem'r,7658,5,15,8,13,55,48,7,53
Elgin,7658,6,14,6,16,54,62,-8,48
Annan Athlet,7658,7,12,11,13,48,41,7,47
Berwick,7658,8,8,10,18,30,60,-30,34
Edinburgh Ci,7658,9,7,10,19,37,61,-24,31
Cowdenbeath,7658,10,4,10,22,23,55,-32,22
Montrose,7659,1,24,7,5,64,35,29,79
Peterhead,7659,2,24,4,8,80,38,42,76
Stenhousem'r,7659,3,16,8,12,56,46,10,56
Stirling,7659,4,16,6,14,60,52,8,54
Clyde,7659,5,15,9,12,53,48,5,54
Elgin,7659,6,14,6,16,54,65,-11,48
Annan Athlet,7659,7,11,11,14,50,45,5,44
Berwick,7659,8,8,10,18,29,60,-31,34
Edinburgh Ci,7659,9,7,9,20,36,63,-27,30
Cowdenbeath,7659,10,5,10,21,27,57,-30,25
Montrose,7660,1,24,7,5,61,35,26,79
Peterhead,7660,2,24,4,8,79,39,40,76
Stirling,7660,3,16,7,13,63,54,9,55
Stenhousem'r,7660,4,15,9,12,58,49,9,54
Clyde,7660,5,15,9,12,53,48,5,54
Elgin,7660,6,14,6,16,54,62,-8,48
Annan Athlet,7660,7,12,11,13,49,42,7,47
Berwick,7660,8,8,10,18,29,60,-31,34
Edinburgh Ci,7660,9,7,9,20,37,62,-25,30
Cowdenbeath,7660,10,4,10,22,24,56,-32,22
Peterhead,7661,1,24,4,8,80,38,42,76
Montrose,7661,2,23,7,6,59,36,23,76
Stirling,7661,3,17,6,13,61,51,10,57
Clyde,7661,4,15,9,12,54,49,5,54
Stenhousem'r,7661,5,15,8,13,55,47,8,53
Elgin,7661,6,15,6,15,55,60,-5,51
Annan Athlet,7661,7,11,11,14,47,42,5,44
Berwick,7661,8,8,10,18,30,61,-31,34
Edinburgh Ci,7661,9,7,9,20,36,63,-27,30
Cowdenbeath,7661,10,5,10,21,24,54,-30,25
Montrose,7662,1,24,7,5,62,35,27,79
Peterhead,7662,2,24,4,8,79,38,41,76
Stirling,7662,3,17,6,13,64,52,12,57
Clyde,7662,4,15,9,12,54,48,6,54
Stenhousem'r,7662,5,15,8,13,56,50,6,53
Elgin,7662,6,14,6,16,54,63,-9,48
Annan Athlet,7662,7,11,11,14,48,43,5,44
Berwick,7662,8,8,10,18,29,61,-32,34
Edinburgh Ci,7662,9,7,9,20,36,62,-26,30
Cowdenbeath,7662,10,5,10,21,25,55,-30,25
Montrose,7663,1,24,7,5,60,34,26,79
Peterhead,7663,2,24,4,8,78,38,40,76
Stenhousem'r,7663,3,16,8,12,59,49,10,56
Stirling,7663,4,16,6,14,63,55,8,54
Clyde,7663,5,15,9,12,53,49,4,54
Elgin,7663,6,14,6,16,53,61,-8,48
Annan Athlet,7663,7,11,11,14,47,43,4,44
Berwick,7663,8,8,10,18,30,60,-30,34
Edinburgh Ci,7663,9,7,9,20,36,61,-25,30
Cowdenbeath,7663,10,5,10,21,25,54,-29,25
Montrose,7664,1,24,7,5,61,34,27,79
Peterhead,7664,2,24,4,8,82,38,44,76
Stirling,7664,3,17,6,13,62,51,11,57
Stenhousem'r,7664,4,15,8,13,55,48,7,53
Clyde,7664,5,14,9,13,52,50,2,51
Elgin,7664,6,14,6,16,53,62,-9,48
Annan Athlet,7664,7,11,12,13,48,42,6,45
Berwick,7664,8,9,10,17,31,59,-28,37
Edinburgh Ci,7664,9,7,9,20,36,65,-29,30
Cowdenbeath,7664,10,4,11,21,24,55,-31,23
Montrose,7665,1,24,7,5,63,35,28,79
Peterhead,7665,2,24,4,8,78,38,40,76
Stirling,7665,3,17,6,13,62,52,10,57
Stenhousem'r,7665,4,15,8,13,56,48,8,53
Clyde,7665,5,14,9,13,52,50,2,51
Elgin,7665,6,14,6,16,54,64,-10,48
Annan Athlet,7665,7,11,11,14,47,42,5,44
Berwick,7665,8,9,10,17,31,59,-28,37
Edinburgh Ci,7665,9,7,9,20,36,61,-25,30
Cowdenbeath,7665,10,5,10,21,24,54,-30,25
Montrose,7666,1,23,7,6,61,38,23,76
Peterhead,7666,2,23,5,8,77,38,39,74
Stirling,7666,3,16,7,13,61,52,9,55
Stenhousem'r,7666,4,15,9,12,56,47,9,54
Clyde,7666,5,15,9,12,55,49,6,54
Elgin,7666,6,15,6,15,57,62,-5,51
Annan Athlet,7666,7,11,12,13,48,42,6,45
Berwick,7666,8,8,10,18,30,62,-32,34
Edinburgh Ci,7666,9,7,10,19,36,60,-24,31
Cowdenbeath,7666,10,4,11,21,24,55,-31,23
Montrose,7667,1,23,8,5,60,35,25,77
Peterhead,7667,2,24,4,8,80,38,42,76
Stirling,7667,3,17,6,13,63,52,11,57
Stenhousem'r,7667,4,15,8,13,56,49,7,53
Clyde,7667,5,14,9,13,51,49,2,51
Elgin,7667,6,14,7,15,54,61,-7,49
Annan Athlet,7667,7,11,11,14,48,43,5,44
Berwick,7667,8,9,10,17,30,58,-28,37
Edinburgh Ci,7667,9,7,9,20,36,63,-27,30
Cowdenbeath,7667,10,5,10,21,25,55,-30,25
Montrose,7668,1,23,7,6,60,36,24,76
Peterhead,7668,2,23,5,8,79,40,39,74
Stenhousem'r,7668,3,16,8,12,58,46,12,56
Stirling,7668,4,16,6,14,60,54,6,54
Clyde,7668,5,14,9,13,51,49,2,51
Elgin,7668,6,15,6,15,55,61,-6,51
Annan Athlet,7668,7,12,11,13,48,41,7,47
Berwick,7668,8,9,10,17,30,58,-28,37
Edinburgh Ci,7668,9,7,10,19,38,62,-24,31
Cowdenbeath,7668,10,4,10,22,23,55,-32,22
Peterhead,7669,1,24,4,8,79,38,41,76
Montrose,7669,2,23,7,6,59,35,24,76
Stirling,7669,3,17,6,13,62,51,11,57
Stenhousem'r,7669,4,15,8,13,55,48,7,53
Clyde,7669,5,14,9,13,51,49,2,51
Elgin,7669,6,15,6,15,54,60,-6,51
Annan Athlet,7669,7,11,11,14,48,44,4,44
Berwick,7669,8,9,10,17,30,58,-28,37
Edinburgh Ci,7669,9,7,9,20,36,62,-26,30
Cowdenbeath,7669,10,5,10,21,26,55,-29,25
Montrose,7670,1,24,7,5,63,34,29,79
Peterhead,7670,2,24,4,8,79,38,41,76
Stenhousem'r,7670,3,16,8,12,57,47,10,56
Stirling,7670,4,16,6,14,61,53,8,54
Clyde,7670,5,15,9,12,53,48,5,54
Elgin,7670,6,14,6,16,53,64,-11,48
Annan Athlet,7670,7,11,11,14,47,43,4,44
Berwick,7670,8,8,10,18,29,60,-31,34
Edinburgh Ci,7670,9,7,9,20,36,62,-26,30
Cowdenbeath,7670,10,5,10,21,25,54,-29,25
Montrose,7671,1,23,8,5,59,34,25,77
Peterhead,7671,2,24,4,8,78,38,40,76
Stirling,7671,3,16,7,13,61,52,9,55
Stenhousem'r,7671,4,15,9,12,56,47,9,54
Clyde,7671,5,15,9,12,53,49,4,54
Elgin,7671,6,14,7,15,53,60,-7,49
Annan Athlet,7671,7,11,11,14,47,42,5,44
Berwick,7671,8,8,10,18,30,60,-30,34
Edinburgh Ci,7671,9,7,9,20,36,61,-25,30
Cowdenbeath,7671,10,5,10,21,24,54,-30,25
Montrose,7672,1,24,7,5,61,35,26,79
Peterhead,7672,2,23,5,8,78,39,39,74
Stenhousem'r,7672,3,16,8,12,56,46,10,56
Stirling,7672,4,16,6,14,60,52,8,54
Clyde,7672,5,14,10,12,53,50,3,52
Elgin,7672,6,14,6,16,54,62,-8,48
Annan Athlet,7672,7,12,11,13,50,42,8,47
Berwick,7672,8,8,11,17,31,60,-29,35
Edinburgh Ci,7672,9,7,10,19,37,61,-24,31
Cowdenbeath,7672,10,4,10,22,24,57,-33,22
Montrose,7673,1,24,7,5,62,34,28,79
Peterhead,7673,2,24,4,8,79,39,40,76
Stirling,7673,3,17,6,13,63,52,11,57
Clyde,7673,4,15,9,12,52,48,4,54
Stenhousem'r,7673,5,15,8,13,56,49,7,53
Elgin,7673,6,14,6,16,53,63,-10,48
Annan Athlet,7673,7,12,11,13,50,43,7,47
Berwick,7673,8,8,10,18,29,59,-30,34
Edinburgh Ci,7673,9,7,9,20,37,62,-25,30
Cowdenbeath,7673,10,4,10,22,25,57,-32,22
Montrose,7674,1,24,7,5,61,35,26,79
Peterhead,7674,2,24,4,8,78,38,40,76
Stenhousem'r,7674,3,16,8,12,57,47,10,56
Stirling,7674,4,16,6,14,61,53,8,54
Clyde,7674,5,14,10,12,52,49,3,52
Elgin,7674,6,14,6,16,54,62,-8,48
Annan Athlet,7674,7,11,11,14,47,43,4,44
Berwick,7674,8,8,11,17,30,59,-29,35
Edinburgh Ci,7674,9,7,9,20,36,61,-25,30
Cowdenbeath,7674,10,5,10,21,25,54,-29,25
Montrose,7675,1,24,7,5,62,34,28,79
Peterhead,7675,2,24,4,8,78,38,40,76
Stirling,7675,3,16,7,13,60,51,9,55
Stenhousem'r,7675,4,15,9,12,55,46,9,54
Clyde,7675,5,14,9,13,51,49,2,51
Elgin,7675,6,14,6,16,53,63,-10,48
Annan Athlet,7675,7,11,11,14,47,42,5,44
Berwick,7675,8,9,10,17,30,58,-28,37
Edinburgh Ci,7675,9,7,9,20,36,61,-25,30
Cowdenbeath,7675,10,5,10,21,24,54,-30,25
Montrose,7676,1,24,7,5,63,34,29,79
Peterhead,7676,2,24,4,8,81,40,41,76
Stenhousem'r,7676,3,16,8,12,57,47,10,56
Stirling,7676,4,16,6,14,61,53,8,54
Clyde,7676,5,15,9,12,52,48,4,54
Elgin,7676,6,14,6,16,53,64,-11,48
Annan Athlet,7676,7,11,12,13,48,42,6,45
Berwick,7676,8,8,10,18,29,59,-30,34
Edinburgh Ci,7676,9,7,9,20,38,64,-26,30
Cowdenbeath,7676,10,4,11,21,24,55,-31,23
Peterhead,7677,1,24,4,8,81,40,41,76
Montrose,7677,2,23,7,6,60,36,24,76
Stirling,7677,3,17,6,13,61,51,10,57
Stenhousem'r,7677,4,15,8,13,55,47,8,53
Clyde,7677,5,14,10,12,51,48,3,52
Elgin,7677,6,15,6,15,55,61,-6,51
Annan Athlet,7677,7,11,11,14,48,43,5,44
Berwick,7677,8,8,11,17,29,58,-29,35
Edinburgh Ci,7677,9,7,9,20,38,64,-26,30
Cowdenbeath,7677,10,5,10,21,25,55,-30,25
Montrose,7678,1,23,7,6,60,37,23,76
Peterhead,7678,2,23,4,9,77,39,38,73
Stirling,7678,3,17,6,13,65,53,12,57
Stenhousem'r,7678,4,15,8,13,57,51,6,53
Clyde,7678,5,14,10,12,52,49,3,52
Elgin,7678,6,15,6,15,56,61,-5,51
Annan Athlet,7678,7,11,11,14,47,42,5,44
Berwick,7678,8,8,11,17,30,59,-29,35
Edinburgh Ci,7678,9,8,9,19,37,60,-23,33
Cowdenbeath,7678,10,5,10,21,24,54,-30,25
Montrose,7679,1,24,7,5,61,34,27,79
Peterhead,7679,2,23,4,9,78,40,38,73
Stirling,7679,3,17,6,13,63,52,11,57
Clyde,7679,4,15,9,12,54,48,6,54
Stenhousem'r,7679,5,15,8,13,56,49,7,53
Elgin,7679,6,14,6,16,53,62,-9,48
Annan Athlet,7679,7,11,11,14,47,42,5,44
Berwick,7679,8,8,10,18,29,61,-32,34
Edinburgh Ci,7679,9,8,9,19,38,61,-23,33
Cowdenbeath,7679,10,5,10,21,24,54,-30,25
Montrose,7680,1,24,7,5,65,35,30,79
Peterhead,7680,2,24,4,8,79,39,40,76
Stenhousem'r,7680,3,16,8,12,56,46,10,56
Stirling,7680,4,16,6,14,60,52,8,54
Clyde,7680,5,15,9,12,52,48,4,54
Elgin,7680,6,14,6,16,54,66,-12,48
Annan Athlet,7680,7,11,11,14,48,43,5,44
Berwick,7680,8,8,10,18,29,59,-30,34
Edinburgh Ci,7680,9,7,9,20,37,62,-25,30
Cowdenbeath,7680,10,5,10,21,25,55,-30,25
Montrose,7681,1,24,7,5,63,35,28,79
Peterhead,7681,2,24,4,8,81,38,43,76
Stirling,7681,3,17,6,13,61,51,10,57
Clyde,7681,4,15,9,12,57,48,9,54
Stenhousem'r,7681,5,15,8,13,55,47,8,53
Elgin,7681,6,14,6,16,54,64,-10,48
Annan Athlet,7681,7,11,11,14,48,43,5,44
Berwick,7681,8,8,10,18,29,64,-35,34
Edinburgh Ci,7681,9,7,9,20,36,64,-28,30
Cowdenbeath,7681,10,5,10,21,25,55,-30,25
Montrose,7682,1,24,7,5,61,34,27,79
Peterhead,7682,2,24,4,8,79,38,41,76
Stirling,7682,3,17,6,13,62,52,10,57
Clyde,7682,4,15,9,12,54,49,5,54
Stenhousem'r,7682,5,15,8,13,56,48,8,53
Elgin,7682,6,14,6,16,53,62,-9,48
Annan Athlet,7682,7,11,12,13,48,42,6,45
Berwick,7682,8,8,10,18,30,61,-31,34
Edinburgh Ci,7682,9,7,9,20,36,62,-26,30
Cowdenbeath,7682,10,4,11,21,24,55,-31,23
Montrose,7683,1,23,8,5,60,35,25,77
Peterhead,7683,2,24,4,8,80,39,41,76
Stirling,7683,3,17,6,13,64,52,12,57
Stenhousem'r,7683,4,15,8,13,56,50,6,53
Clyde,7683,5,14,10,12,52,49,3,52
Elgin,7683,6,14,7,15,54,61,-7,49
Annan Athlet,7683,7,12,11,13,50,41,9,47
Berwick,7683,8,8,11,17,30,59,-29,35
Edinburgh Ci,7683,9,7,9,20,37,63,-26,30
Cowdenbeath,7683,10,4,10,22,23,57,-34,22
Montrose,7684,1,23,8,5,60,35,25,77
Peterhead,7684,2,24,4,8,79,38,41,76
Stirling,7684,3,17,6,13,64,51,13,57
Clyde,7684,4,15,9,12,53,49,4,54
Stenhousem'r,7684,5,15,8,13,55,50,5,53
Elgin,7684,6,14,7,15,54,61,-7,49
Annan Athlet,7684,7,12,11,13,49,42,7,47
Berwick,7684,8,8,10,18,30,60,-30,34
Edinburgh Ci,7684,9,7,9,20,36,62,-26,30
Cowdenbeath,7684,10,4,10,22,24,56,-32,22
Montrose,7685,1,24,7,5,62,36,26,79
Peterhead,7685,2,24,4,8,80,39,41,76
Stirling,7685,3,17,6,13,63,53,10,57
Clyde,7685,4,15,9,12,52,48,4,54
Stenhousem'r,7685,5,15,8,13,57,49,8,53
Elgin,7685,6,14,6,16,55,63,-8,48
Annan Athlet,7685,7,11,11,14,48,44,4,44
Berwick,7685,8,8,10,18,29,59,-30,34
Edinburgh Ci,7685,9,7,9,20,37,63,-26,30
Cowdenbeath,7685,10,5,10,21,26,55,-29,25
Montrose,7686,1,24,7,5,60,34,26,79
Peterhead,7686,2,24,4,8,81,38,43,76
Stirling,7686,3,17,6,13,66,52,14,57
Clyde,7686,4,15,9,12,53,49,4,54
Stenhousem'r,7686,5,15,8,13,56,52,4,53
Elgin,7686,6,14,6,16,53,61,-8,48
Annan Athlet,7686,7,12,11,13,49,41,8,47
Berwick,7686,8,8,10,18,30,60,-30,34
Edinburgh Ci,7686,9,7,9,20,36,64,-28,30
Cowdenbeath,7686,10,4,10,22,23,56,-33,22
Montrose,7687,1,24,7,5,63,34,29,79
Peterhead,7687,2,24,4,8,80,38,42,76
Stirling,7687,3,17,6,13,62,52,10,57
Stenhousem'r,7687,4,15,8,13,56,48,8,53
Clyde,7687,5,14,10,12,51,48,3,52
Elgin,7687,6,14,6,16,53,64,-11,48
Annan Athlet,7687,7,11,11,14,48,44,4,44
Berwick,7687,8,8,11,17,29,58,-29,35
Edinburgh Ci,7687,9,7,9,20,36,63,-27,30
Cowdenbeath,7687,10,5,10,21,26,55,-29,25
Montrose,7688,1,23,7,6,59,35,24,76
Peterhead,7688,2,23,4,9,78,41,37,73
Stirling,7688,3,16,7,13,61,52,9,55
Stenhousem'r,7688,4,15,9,12,56,47,9,54
Clyde,7688,5,14,9,13,51,50,1,51
Elgin,7688,6,15,6,15,54,60,-6,51
Annan Athlet,7688,7,12,11,13,48,41,7,47
Berwick,7688,8,9,10,17,31,58,-27,37
Edinburgh Ci,7688,9,8,9,19,39,61,-22,33
Cowdenbeath,7688,10,4,10,22,23,55,-32,22
Montrose,7689,1,24,7,5,61,34,27,79
Peterhead,7689,2,24,4,8,80,39,41,76
Stirling,7689,3,16,7,13,62,53,9,55
Stenhousem'r,7689,4,15,9,12,57,48,9,54
Clyde,7689,5,15,9,12,54,49,5,54
Elgin,7689,6,14,6,16,53,62,-9,48
Annan Athlet,7689,7,12,11,13,49,41,8,47
Berwick,7689,8,8,10,18,30,61,-31,34
Edinburgh Ci,7689,9,7,9,20,37,63,-26,30
Cowdenbeath,7689,10,4,10,22,23,56,-33,22
Montrose,7690,1,23,7,6,59,37,22,76
Peterhead,7690,2,23,5,8,78,39,39,74
Stenhousem'r,7690,3,16,8,12,58,46,12,56
Stirling,7690,4,16,6,14,60,54,6,54
Clyde,7690,5,15,9,12,54,48,6,54
Elgin,7690,6,15,6,15,56,60,-4,51
Annan Athlet,7690,7,11,12,13,48,42,6,45
Berwick,7690,8,8,10,18,29,61,-32,34
Edinburgh Ci,7690,9,7,10,19,37,61,-24,31
Cowdenbeath,7690,10,4,11,21,24,55,-31,23
Montrose,7691,1,24,7,5,62,36,26,79
Peterhead,7691,2,24,4,8,80,39,41,76
Stirling,7691,3,17,6,13,62,52,10,57
Clyde,7691,4,15,9,12,52,48,4,54
Stenhousem'r,7691,5,15,8,13,56,48,8,53
Elgin,7691,6,14,6,16,55,63,-8,48
Annan Athlet,7691,7,11,12,13,48,42,6,45
Berwick,7691,8,8,10,18,29,59,-30,34
Edinburgh Ci,7691,9,7,9,20,37,63,-26,30
Cowdenbeath,7691,10,4,11,21,24,55,-31,23
Montrose,7692,1,24,7,5,65,37,28,79
Peterhead,7692,2,24,4,8,78,38,40,76
Stirling,7692,3,17,6,13,61,51,10,57
Clyde,7692,4,15,9,12,54,48,6,54
Stenhousem'r,7692,5,15,8,13,55,47,8,53
Elgin,7692,6,14,6,16,56,66,-10,48
Annan Athlet,7692,7,12,11,13,49,41,8,47
Berwick,7692,8,8,10,18,29,61,-32,34
Edinburgh Ci,7692,9,7,9,20,36,61,-25,30
Cowdenbeath,7692,10,4,10,22,23,56,-33,22
Montrose,7693,1,23,8,5,60,35,25,77
Peterhead,7693,2,24,4,8,79,38,41,76
Stenhousem'r,7693,3,16,8,12,57,47,10,56
Stirling,7693,4,16,6,14,61,53,8,54
Clyde,7693,5,15,9,12,56,51,5,54
Elgin,7693,6,14,7,15,54,61,-7,49
Annan Athlet,7693,7,11,12,13,48,42,6,45
Berwick,7693,8,8,10,18,32,63,-31,34
Edinburgh Ci,7693,9,7,9,20,36,62,-26,30
Cowdenbeath,7693,10,4,11,21,24,55,-31,23
Montrose,7694,1,24,7,5,62,34,28,79
Peterhead,7694,2,24,4,8,80,40,40,76
Stirling,7694,3,16,7,13,60,51,9,55
Stenhousem'r,7694,4,15,9,12,55,46,9,54
Clyde,7694,5,15,9,12,54,48,6,54
Elgin,7694,6,14,6,16,53,63,-10,48
Annan Athlet,7694,7,12,11,13,50,41,9,47
Berwick,7694,8,8,10,18,29,61,-32,34
Edinburgh Ci,7694,9,7,9,20,38,63,-25,30
Cowdenbeath,7694,10,4,10,22,23,57,-34,22
Peterhead,7695,1,24,4,8,81,38,43,76
Montrose,7695,2,23,7,6,61,39,22,76
Stenhousem'r,7695,3,16,8,12,56,46,10,56
Stirling,7695,4,16,6,14,60,52,8,54
Clyde,7695,5,14,9,13,51,51,0,51
Elgin,7695,6,15,6,15,58,62,-4,51
Annan Athlet,7695,7,11,11,14,48,44,4,44
Berwick,7695,8,9,10,17,32,58,-26,37
Edinburgh Ci,7695,9,7,9,20,36,64,-28,30
Cowdenbeath,7695,10,5,10,21,26,55,-29,25
Montrose,7696,1,24,7,5,60,34,26,79
Peterhead,7696,2,23,4,9,78,40,38,73
Stirling,7696,3,16,7,13,61,52,9,55
Stenhousem'r,7696,4,15,9,12,56,47,9,54
Clyde,7696,5,14,10,12,51,48,3,52
Elgin,7696,6,14,6,16,53,61,-8,48
Annan Athlet,7696,7,11,11,14,48,44,4,44
Berwick,7696,8,8,11,17,29,58,-29,35
Edinburgh Ci,7696,9,8,9,19,38,61,-23,33
Cowdenbeath,7696,10,5,10,21,26,55,-29,25
Montrose,7697,1,24,7,5,62,36,26,79
Peterhead,7697,2,24,4,8,79,38,41,76
Stirling,7697,3,17,6,13,62,52,10,57
Clyde,7697,4,15,9,12,54,48,6,54
Stenhousem'r,7697,5,15,8,13,56,48,8,53
Elgin,7697,6,14,6,16,55,63,-8,48
Annan Athlet,7697,7,11,11,14,48,43,5,44
Berwick,7697,8,8,10,18,29,61,-32,34
Edinburgh Ci,7697,9,7,9,20,36,62,-26,30
Cowdenbeath,7697,10,5,10,21,25,55,-30,25
Montrose,7698,1,24,7,5,63,37,26,79
Peterhead,7698,2,24,4,8,82,39,43,76
Stirling,7698,3,16,7,13,61,52,9,55
Stenhousem'r,7698,4,15,9,12,56,47,9,54
Clyde,7698,5,15,9,12,54,48,6,54
Elgin,7698,6,14,6,16,56,64,-8,48
Annan Athlet,7698,7,11,11,14,49,44,5,44
Berwick,7698,8,8,10,18,29,61,-32,34
Edinburgh Ci,7698,9,7,9,20,37,65,-28,30
Cowdenbeath,7698,10,5,10,21,26,56,-30,25
Montrose,7699,1,24,7,5,61,35,26,79
Peterhead,7699,2,24,4,8,81,39,42,76
Stenhousem'r,7699,3,16,8,12,57,47,10,56
Stirling,7699,4,16,6,14,61,53,8,54
Clyde,7699,5,15,9,12,52,48,4,54
Elgin,7699,6,14,6,16,54,62,-8,48
Annan Athlet,7699,7,12,11,13,49,42,7,47
Berwick,7699,8,8,10,18,29,59,-30,34
Edinburgh Ci,7699,9,7,9,20,37,64,-27,30
Cowdenbeath,7699,10,4,10,22,24,56,-32,22
Peterhead,7700,1,24,4,8,80,39,41,76
Montrose,7700,2,23,7,6,59,35,24,76
Stenhousem'r,7700,3,16,8,12,57,46,11,56
Stirling,7700,4,16,6,14,60,53,7,54
Clyde,7700,5,15,9,12,55,48,7,54
Elgin,7700,6,15,6,15,54,60,-6,51
Annan Athlet,7700,7,11,11,14,48,43,5,44
Berwick,7700,8,8,10,18,29,62,-33,34
Edinburgh Ci,7700,9,7,9,20,37,63,-26,30
Cowdenbeath,7700,10,5,10,21,25,55,-30,25
Montrose,7701,1,23,8,5,59,34,25,77
Peterhead,7701,2,24,4,8,81,38,43,76
Stirling,7701,3,17,6,13,62,51,11,57
Stenhousem'r,7701,4,15,8,13,55,48,7,53
Clyde,7701,5,14,9,13,51,49,2,51
Elgin,7701,6,14,7,15,53,60,-7,49
Annan Athlet,7701,7,11,11,14,48,44,4,44
Berwick,7701,8,9,10,17,30,58,-28,37
Edinburgh Ci,7701,9,7,9,20,36,64,-28,30
Cowdenbeath,7701,10,5,10,21,26,55,-29,25
Montrose,7702,1,23,8,5,59,34,25,77
Peterhead,7702,2,24,4,8,79,39,40,76
Stirling,7702,3,16,7,13,61,52,9,55
Stenhousem'r,7702,4,15,9,12,56,47,9,54
Clyde,7702,5,14,10,12,53,50,3,52
Elgin,7702,6,14,7,15,53,60,-7,49
Annan Athlet,7702,7,12,11,13,49,41,8,47
Berwick,7702,8,8,11,17,31,60,-29,35
Edinburgh Ci,7702,9,7,9,20,37,62,-25,30
Cowdenbeath,7702,10,4,10,22,23,56,-33,22
Peterhead,7703,1,24,4,8,80,39,41,76
Montrose,7703,2,23,7,6,60,37,23,76
Stirling,7703,3,17,6,13,62,51,11,57
Stenhousem'r,7703,4,15,8,13,55,48,7,53
Clyde,7703,5,14,9,13,51,49,2,51
Elgin,7703,6,15,6,15,56,61,-5,51
Annan Athlet,7703,7,12,11,13,50,42,8,47
Berwick,7703,8,9,10,17,30,58,-28,37
Edinburgh Ci,7703,9,7,9,20,37,63,-26,30
Cowdenbeath,7703,10,4,10,22,24,57,-33,22
Peterhead,7704,1,24,4,8,80,39,41,76
Montrose,7704,2,23,7,6,61,37,24,76
Stirling,7704,3,16,7,13,61,52,9,55
Stenhousem'r,7704,4,15,9,12,56,47,9,54
Clyde,7704,5,14,10,12,51,48,3,52
Elgin,7704,6,15,6,15,56,62,-6,51
Annan Athlet,7704,7,12,11,13,49,41,8,47
Berwick,7704,8,8,11,17,29,58,-29,35
Edinburgh Ci,7704,9,7,9,20,37,63,-26,30
Cowdenbeath,7704,10,4,10,22,23,56,-33,22
Montrose,7705,1,24,7,5,63,34,29,79
Peterhead,7705,2,24,4,8,80,39,41,76
Stirling,7705,3,17,6,13,63,52,11,57
Stenhousem'r,7705,4,15,8,13,56,49,7,53
Clyde,7705,5,14,9,13,52,50,2,51
Elgin,7705,6,14,6,16,53,64,-11,48
Annan Athlet,7705,7,11,11,14,47,42,5,44
Berwick,7705,8,9,10,17,31,59,-28,37
Edinburgh Ci,7705,9,7,9,20,37,63,-26,30
Cowdenbeath,7705,10,5,10,21,24,54,-30,25
Montrose,7706,1,24,7,5,61,35,26,79
Peterhead,7706,2,24,4,8,82,40,42,76
Stirling,7706,3,17,6,13,65,54,11,57
Clyde,7706,4,15,9,12,56,48,8,54
Stenhousem'r,7706,5,15,8,13,58,51,7,53
Elgin,7706,6,14,6,16,54,62,-8,48
Annan Athlet,7706,7,11,11,14,50,46,4,44
Berwick,7706,8,8,10,18,29,63,-34,34
Edinburgh Ci,7706,9,7,9,20,38,65,-27,30
Cowdenbeath,7706,10,5,10,21,28,57,-29,25
Peterhead,7707,1,24,4,8,82,39,43,76
Montrose,7707,2,23,7,6,60,37,23,76
Stirling,7707,3,16,7,13,60,51,9,55
Stenhousem'r,7707,4,15,9,12,55,46,9,54
Clyde,7707,5,15,9,12,53,49,4,54
Elgin,7707,6,15,6,15,56,61,-5,51
Annan Athlet,7707,7,11,12,13,49,43,6,45
Berwick,7707,8,8,10,18,30,60,-30,34
Edinburgh Ci,7707,9,7,9,20,37,65,-28,30
Cowdenbeath,7707,10,4,11,21,25,56,-31,23
Montrose,7708,1,24,7,5,62,35,27,79
Peterhead,7708,2,24,4,8,81,39,42,76
Stirling,7708,3,17,6,13,63,51,12,57
Stenhousem'r,7708,4,15,8,13,55,49,6,53
Clyde,7708,5,14,10,12,52,49,3,52
Elgin,7708,6,14,6,16,54,63,-9,48
Annan Athlet,7708,7,11,12,13,48,42,6,45
Berwick,7708,8,8,11,17,30,59,-29,35
Edinburgh Ci,7708,9,7,9,20,37,64,-27,30
Cowdenbeath,7708,10,4,11,21,24,55,-31,23
Montrose,7709,1,24,7,5,63,35,28,79
Peterhead,7709,2,24,4,8,83,39,44,76
Stirling,7709,3,16,7,13,62,53,9,55
Stenhousem'r,7709,4,15,9,12,57,48,9,54
Clyde,7709,5,15,9,12,53,48,5,54
Elgin,7709,6,14,6,16,54,64,-10,48
Annan Athlet,7709,7,11,12,13,48,42,6,45
Berwick,7709,8,8,10,18,29,60,-31,34
Edinburgh Ci,7709,9,7,9,20,37,66,-29,30
Cowdenbeath,7709,10,4,11,21,24,55,-31,23
Montrose,7710,1,24,7,5,61,34,27,79
Peterhead,7710,2,24,4,8,78,38,40,76
Stirling,7710,3,17,6,13,61,51,10,57
Clyde,7710,4,15,9,12,52,48,4,54
Stenhousem'r,7710,5,15,8,13,55,47,8,53
Elgin,7710,6,14,6,16,53,62,-9,48
Annan Athlet,7710,7,11,11,14,48,43,5,44
Berwick,7710,8,8,10,18,29,59,-30,34
Edinburgh Ci,7710,9,7,9,20,36,61,-25,30
Cowdenbeath,7710,10,5,10,21,25,55,-30,25
Montrose,7711,1,23,8,5,59,34,25,77
Peterhead,7711,2,24,4,8,78,38,40,76
Stirling,7711,3,17,6,13,65,52,13,57
Stenhousem'r,7711,4,15,8,13,56,51,5,53
Clyde,7711,5,14,10,12,52,49,3,52
Elgin,7711,6,14,7,15,53,60,-7,49
Annan Athlet,7711,7,11,12,13,48,42,6,45
Berwick,7711,8,8,11,17,30,59,-29,35
Edinburgh Ci,7711,9,7,9,20,36,61,-25,30
Cowdenbeath,7711,10,4,11,21,24,55,-31,23
Montrose,7712,1,24,7,5,62,35,27,79
Peterhead,7712,2,24,4,8,82,38,44,76
Stirling,7712,3,17,6,13,63,52,11,57
Clyde,7712,4,15,9,12,53,48,5,54
Stenhousem'r,7712,5,15,8,13,56,49,7,53
Elgin,7712,6,14,6,16,54,63,-9,48
Annan Athlet,7712,7,11,11,14,48,43,5,44
Berwick,7712,8,8,10,18,29,60,-31,34
Edinburgh Ci,7712,9,7,9,20,36,65,-29,30
Cowdenbeath,7712,10,5,10,21,25,55,-30,25
Montrose,7713,1,24,7,5,64,34,30,79
Peterhead,7713,2,24,4,8,79,39,40,76
Stirling,7713,3,16,7,13,61,52,9,55
Stenhousem'r,7713,4,15,9,12,56,47,9,54
Clyde,7713,5,15,9,12,55,49,6,54
Elgin,7713,6,14,6,16,53,65,-12,48
Annan Athlet,7713,7,11,11,14,47,44,3,44
Berwick,7713,8,8,10,18,30,62,-32,34
Edinburgh Ci,7713,9,7,9,20,37,62,-25,30
Cowdenbeath,7713,10,5,10,21,26,54,-28,25
Peterhead,7714,1,24,4,8,80,39,41,76
Montrose,7714,2,23,7,6,60,36,24,76
Stenhousem'r,7714,3,16,8,12,57,47,10,56
Stirling,7714,4,16,6,14,61,53,8,54
Clyde,7714,5,15,9,12,53,48,5,54
Elgin,7714,6,15,6,15,55,61,-6,51
Annan Athlet,7714,7,11,12,13,47,41,6,45
Berwick,7714,8,8,10,18,29,60,-31,34
Edinburgh Ci,7714,9,7,9,20,37,63,-26,30
Cowdenbeath,7714,10,4,11,21,23,54,-31,23
Montrose,7715,1,24,7,5,65,34,31,79
Peterhead,7715,2,24,4,8,78,38,40,76
Stirling,7715,3,17,6,13,63,53,10,57
Stenhousem'r,7715,4,15,8,13,57,49,8,53
Clyde,7715,5,14,9,13,51,50,1,51
Elgin,7715,6,14,6,16,53,66,-13,48
Annan Athlet,7715,7,12,11,13,49,42,7,47
Berwick,7715,8,9,10,17,31,58,-27,37
Edinburgh Ci,7715,9,7,9,20,36,61,-25,30
Cowdenbeath,7715,10,4,10,22,24,56,-32,22
Montrose,7716,1,24,7,5,62,34,28,79
Peterhead,7716,2,24,4,8,79,38,41,76
Stirling,7716,3,17,6,13,62,52,10,57
Clyde,7716,4,15,9,12,55,50,5,54
Stenhousem'r,7716,5,15,8,13,56,48,8,53
Elgin,7716,6,14,6,16,53,63,-10,48
Annan Athlet,7716,7,11,11,14,48,44,4,44
Berwick,7716,8,8,10,18,31,62,-31,34
Edinburgh Ci,7716,9,7,9,20,36,62,-26,30
Cowdenbeath,7716,10,5,10,21,26,55,-29,25
Peterhead,7717,1,24,4,8,80,38,42,76
Montrose,7717,2,23,7,6,59,35,24,76
Stirling,7717,3,17,6,13,64,53,11,57
Clyde,7717,4,15,9,12,56,49,7,54
Stenhousem'r,7717,5,15,8,13,57,50,7,53
Elgin,7717,6,15,6,15,54,60,-6,51
Annan Athlet,7717,7,11,11,14,48,44,4,44
Berwick,7717,8,8,10,18,30,63,-33,34
Edinburgh Ci,7717,9,7,9,20,36,63,-27,30
Cowdenbeath,7717,10,5,10,21,26,55,-29,25
Montrose,7718,1,24,7,5,62,34,28,79
Peterhead,7718,2,24,4,8,81,38,43,76
Stirling,7718,3,17,6,13,63,51,12,57
Clyde,7718,4,15,9,12,54,50,4,54
Stenhousem'r,7718,5,15,8,13,55,49,6,53
Elgin,7718,6,14,6,16,53,63,-10,48
Annan Athlet,7718,7,11,11,14,47,42,5,44
Berwick,7718,8,8,10,18,31,61,-30,34
Edinburgh Ci,7718,9,7,9,20,36,64,-28,30
Cowdenbeath,7718,10,5,10,21,24,54,-30,25
Montrose,7719,1,24,7,5,61,35,26,79
Peterhead,7719,2,24,4,8,79,38,41,76
Stenhousem'r,7719,3,16,8,12,56,46,10,56
Stirling,7719,4,16,6,14,60,52,8,54
Clyde,7719,5,14,10,12,51,48,3,52
Elgin,7719,6,14,6,16,54,62,-8,48
Annan Athlet,7719,7,11,11,14,48,43,5,44
Berwick,7719,8,8,11,17,29,58,-29,35
Edinburgh Ci,7719,9,7,9,20,36,62,-26,30
Cowdenbeath,7719,10,5,10,21,25,55,-30,25
Peterhead,7720,1,24,4,8,81,39,42,76
Montrose,7720,2,23,7,6,59,35,24,76
Stirling,7720,3,17,6,13,63,53,10,57
Stenhousem'r,7720,4,15,8,13,57,49,8,53
Clyde,7720,5,14,10,12,52,49,3,52
Elgin,7720,6,15,6,15,54,60,-6,51
Annan Athlet,7720,7,12,11,13,48,41,7,47
Berwick,7720,8,8,11,17,30,59,-29,35
Edinburgh Ci,7720,9,7,9,20,37,64,-27,30
Cowdenbeath,7720,10,4,10,22,23,55,-32,22
Montrose,7721,1,23,8,5,59,34,25,77
Peterhead,7721,2,23,4,9,80,42,38,73
Stirling,7721,3,17,6,13,64,51,13,57
Stenhousem'r,7721,4,15,8,13,55,50,5,53
Clyde,7721,5,14,10,12,52,49,3,52
Elgin,7721,6,14,7,15,53,60,-7,49
Annan Athlet,7721,7,11,11,14,47,42,5,44
Berwick,7721,8,8,11,17,30,59,-29,35
Edinburgh Ci,7721,9,8,9,19,40,63,-23,33
Cowdenbeath,7721,10,5,10,21,24,54,-30,25
Montrose,7722,1,24,7,5,62,34,28,79
Peterhead,7722,2,23,5,8,78,39,39,74
Stirling,7722,3,16,7,13,60,51,9,55
Stenhousem'r,7722,4,15,9,12,55,46,9,54
Clyde,7722,5,14,9,13,51,49,2,51
Elgin,7722,6,14,6,16,53,63,-10,48
Annan Athlet,7722,7,12,11,13,50,43,7,47
Berwick,7722,8,9,10,17,30,58,-28,37
Edinburgh Ci,7722,9,7,10,19,37,61,-24,31
Cowdenbeath,7722,10,4,10,22,25,57,-32,22
Peterhead,7723,1,24,4,8,78,38,40,76
Montrose,7723,2,23,7,6,60,36,24,76
Stenhousem'r,7723,3,16,8,12,56,46,10,56
Stirling,7723,4,16,6,14,60,52,8,54
Clyde,7723,5,15,9,12,53,49,4,54
Elgin,7723,6,15,6,15,55,61,-6,51
Annan Athlet,7723,7,11,12,13,47,41,6,45
Berwick,7723,8,8,10,18,30,60,-30,34
Edinburgh Ci,7723,9,7,9,20,36,61,-25,30
Cowdenbeath,7723,10,4,11,21,23,54,-31,23
Montrose,7724,1,23,7,6,59,35,24,76
Peterhead,7724,2,23,4,9,77,41,36,73
Stirling,7724,3,17,6,13,64,51,13,57
Clyde,7724,4,15,9,12,52,48,4,54
Stenhousem'r,7724,5,15,8,13,55,50,5,53
Elgin,7724,6,15,6,15,54,60,-6,51
Annan Athlet,7724,7,12,11,13,48,41,7,47
Berwick,7724,8,8,10,18,29,59,-30,34
Edinburgh Ci,7724,9,8,9,19,39,60,-21,33
Cowdenbeath,7724,10,4,10,22,23,55,-32,22
Peterhead,7725,1,24,4,8,80,39,41,76
Montrose,7725,2,23,7,6,60,37,23,76
Stenhousem'r,7725,3,16,8,12,60,48,12,56
Stirling,7725,4,16,6,14,62,56,6,54
Clyde,7725,5,14,9,13,52,50,2,51
Elgin,7725,6,15,6,15,56,61,-5,51
Annan Athlet,7725,7,12,11,13,48,41,7,47
Berwick,7725,8,9,10,17,31,59,-28,37
Edinburgh Ci,7725,9,7,9,20,37,63,-26,30
Cowdenbeath,7725,10,4,10,22,23,55,-32,22
Montrose,7726,1,24,7,5,60,34,26,79
Peterhead,7726,2,23,5,8,77,38,39,74
Stirling,7726,3,16,7,13,62,53,9,55
Stenhousem'r,7726,4,15,9,12,57,48,9,54
Clyde,7726,5,15,9,12,53,48,5,54
Elgin,7726,6,14,6,16,53,61,-8,48
Annan Athlet,7726,7,11,12,13,47,41,6,45
Berwick,7726,8,8,10,18,29,60,-31,34
Edinburgh Ci,7726,9,7,10,19,36,60,-24,31
Cowdenbeath,7726,10,4,11,21,23,54,-31,23
Peterhead,7727,1,24,4,8,78,38,40,76
Montrose,7727,2,23,7,6,60,37,23,76
Stirling,7727,3,16,7,13,62,53,9,55
Stenhousem'r,7727,4,15,9,12,57,48,9,54
Clyde,7727,5,14,10,12,52,49,3,52
Elgin,7727,6,15,6,15,56,61,-5,51
Annan Athlet,7727,7,11,12,13,47,41,6,45
Berwick,7727,8,8,11,17,30,59,-29,35
Edinburgh Ci,7727,9,7,9,20,36,61,-25,30
Cowdenbeath,7727,10,4,11,21,23,54,-31,23
Peterhead,7728,1,24,4,8,82,39,43,76
Montrose,7728,2,23,7,6,59,35,24,76
Stirling,7728,3,16,7,13,63,54,9,55
Stenhousem'r,7728,4,15,9,12,58,49,9,54
Clyde,7728,5,15,9,12,53,49,4,54
Elgin,7728,6,15,6,15,54,60,-6,51
Annan Athlet,7728,7,12,11,13,49,41,8,47
Berwick,7728,8,8,10,18,30,60,-30,34
Edinburgh Ci,7728,9,7,9,20,37,65,-28,30
Cowdenbeath,7728,10,4,10,22,23,56,-33,22
Montrose,7729,1,23,8,5,61,36,25,77
Peterhead,7729,2,24,4,8,79,39,40,76
Stenhousem'r,7729,3,16,8,12,57,46,11,56
Stirling,7729,4,16,6,14,60,53,7,54
Clyde,7729,5,15,9,12,53,49,4,54
Elgin,7729,6,14,7,15,55,62,-7,49
Annan Athlet,7729,7,11,11,14,47,42,5,44
Berwick,7729,8,8,10,18,30,60,-30,34
Edinburgh Ci,7729,9,7,9,20,37,62,-25,30
Cowdenbeath,7729,10,5,10,21,24,54,-30,25
Montrose,7730,1,24,7,5,62,35,27,79
Peterhead,7730,2,24,4,8,79,38,41,76
Stirling,7730,3,17,6,13,63,51,12,57
Stenhousem'r,7730,4,15,8,13,55,49,6,53
Clyde,7730,5,14,9,13,51,50,1,51
Elgin,7730,6,14,6,16,54,63,-9,48
Annan Athlet,7730,7,12,11,13,49,42,7,47
Berwick,7730,8,9,10,17,31,58,-27,37
Edinburgh Ci,7730,9,7,9,20,36,62,-26,30
Cowdenbeath,7730,10,4,10,22,24,56,-32,22
Montrose,7731,1,24,7,5,61,34,27,79
Peterhead,7731,2,24,4,8,78,38,40,76
Stenhousem'r,7731,3,16,8,12,56,46,10,56
Stirling,7731,4,16,6,14,60,52,8,54
Clyde,7731,5,15,9,12,53,49,4,54
Elgin,7731,6,14,6,16,53,62,-9,48
Annan Athlet,7731,7,11,11,14,51,46,5,44
Berwick,7731,8,8,10,18,30,60,-30,34
Edinburgh Ci,7731,9,7,9,20,36,61,-25,30
Cowdenbeath,7731,10,5,10,21,28,58,-30,25
Montrose,7732,1,24,7,5,60,34,26,79
Peterhead,7732,2,24,4,8,79,38,41,76
Stirling,7732,3,17,6,13,63,51,12,57
Clyde,7732,4,15,9,12,53,49,4,54
Stenhousem'r,7732,5,15,8,13,55,49,6,53
Elgin,7732,6,14,6,16,53,61,-8,48
Annan Athlet,7732,7,11,11,14,47,43,4,44
Berwick,7732,8,8,10,18,30,60,-30,34
Edinburgh Ci,7732,9,7,9,20,36,62,-26,30
Cowdenbeath,7732,10,5,10,21,25,54,-29,25
Peterhead,7733,1,24,4,8,80,39,41,76
Montrose,7733,2,23,7,6,59,35,24,76
Stirling,7733,3,17,6,13,61,51,10,57
Clyde,7733,4,15,9,12,52,48,4,54
Stenhousem'r,7733,5,15,8,13,55,47,8,53
Elgin,7733,6,15,6,15,54,60,-6,51
Annan Athlet,7733,7,11,11,14,48,44,4,44
Berwick,7733,8,8,10,18,29,59,-30,34
Edinburgh Ci,7733,9,7,9,20,37,63,-26,30
Cowdenbeath,7733,10,5,10,21,26,55,-29,25
Montrose,7734,1,24,7,5,62,35,27,79
Peterhead,7734,2,24,4,8,81,39,42,76
Stirling,7734,3,16,7,13,60,51,9,55
Stenhousem'r,7734,4,15,9,12,55,46,9,54
Clyde,7734,5,15,9,12,53,49,4,54
Elgin,7734,6,14,6,16,54,63,-9,48
Annan Athlet,7734,7,12,11,13,49,41,8,47
Berwick,7734,8,8,10,18,30,60,-30,34
Edinburgh Ci,7734,9,7,9,20,37,64,-27,30
Cowdenbeath,7734,10,4,10,22,23,56,-33,22
Montrose,7735,1,24,7,5,61,35,26,79
Peterhead,7735,2,24,4,8,81,38,43,76
Stenhousem'r,7735,3,16,8,12,56,46,10,56
Stirling,7735,4,16,6,14,60,52,8,54
Clyde,7735,5,15,9,12,53,49,4,54
Elgin,7735,6,14,6,16,54,62,-8,48
Annan Athlet,7735,7,12,11,13,48,41,7,47
Berwick,7735,8,8,10,18,30,60,-30,34
Edinburgh Ci,7735,9,7,9,20,36,64,-28,30
Cowdenbeath,7735,10,4,10,22,23,55,-32,22
Montrose,7736,1,23,8,5,59,34,25,77
Peterhead,7736,2,24,4,8,79,39,40,76
Stenhousem'r,7736,3,16,8,12,58,47,11,56
Stirling,7736,4,16,6,14,61,54,7,54
Clyde,7736,5,15,9,12,52,48,4,54
Elgin,7736,6,14,7,15,53,60,-7,49
Annan Athlet,7736,7,11,12,13,48,42,6,45
Berwick,7736,8,8,10,18,29,59,-30,34
Edinburgh Ci,7736,9,7,9,20,37,62,-25,30
Cowdenbeath,7736,10,4,11,21,24,55,-31,23
Montrose,7737,1,24,7,5,61,35,26,79
Peterhead,7737,2,24,4,8,81,38,43,76
Stirling,7737,3,17,6,13,61,51,10,57
Stenhousem'r,7737,4,15,8,13,55,47,8,53
Clyde,7737,5,14,10,12,52,49,3,52
Elgin,7737,6,14,6,16,54,62,-8,48
Annan Athlet,7737,7,12,11,13,49,41,8,47
Berwick,7737,8,8,11,17,30,59,-29,35
Edinburgh Ci,7737,9,7,9,20,36,64,-28,30
Cowdenbeath,7737,10,4,10,22,23,56,-33,22
Montrose,7738,1,23,8,5,60,35,25,77
Peterhead,7738,2,23,5,8,78,39,39,74
Stirling,7738,3,17,6,13,63,52,11,57
Clyde,7738,4,15,9,12,52,48,4,54
Stenhousem'r,7738,5,15,8,13,56,49,7,53
Elgin,7738,6,14,7,15,54,61,-7,49
Annan Athlet,7738,7,12,11,13,51,42,9,47
Berwick,7738,8,8,10,18,29,59,-30,34
Edinburgh Ci,7738,9,7,10,19,37,61,-24,31
Cowdenbeath,7738,10,4,10,22,24,58,-34,22
Montrose,7739,1,23,8,5,61,36,25,77
Peterhead,7739,2,24,4,8,81,38,43,76
Stirling,7739,3,17,6,13,62,51,11,57
Clyde,7739,4,15,9,12,53,48,5,54
Stenhousem'r,7739,5,15,8,13,55,48,7,53
Elgin,7739,6,14,7,15,55,62,-7,49
Annan Athlet,7739,7,11,11,14,47,43,4,44
Berwick,7739,8,8,10,18,29,60,-31,34
Edinburgh Ci,7739,9,7,9,20,36,64,-28,30
Cowdenbeath,7739,10,5,10,21,25,54,-29,25
Montrose,7740,1,23,8,5,60,35,25,77
Peterhead,7740,2,23,5,8,78,39,39,74
Stirling,7740,3,17,6,13,62,51,11,57
Clyde,7740,4,15,9,12,53,48,5,54
Stenhousem'r,7740,5,15,8,13,55,48,7,53
Elgin,7740,6,14,7,15,54,61,-7,49
Annan Athlet,7740,7,12,11,13,48,41,7,47
Berwick,7740,8,8,10,18,29,60,-31,34
Edinburgh Ci,7740,9,7,10,19,37,61,-24,31
Cowdenbeath,7740,10,4,10,22,23,55,-32,22
Montrose,7741,1,24,7,5,64,35,29,79
Peterhead,7741,2,24,4,8,78,38,40,76
Stirling,7741,3,17,6,13,64,53,11,57
Stenhousem'r,7741,4,15,8,13,57,50,7,53
Clyde,7741,5,14,9,13,51,49,2,51
Elgin,7741,6,14,6,16,54,65,-11,48
Annan Athlet,7741,7,11,12,13,48,42,6,45
Berwick,7741,8,9,10,17,30,58,-28,37
Edinburgh Ci,7741,9,7,9,20,36,61,-25,30
Cowdenbeath,7741,10,4,11,21,24,55,-31,23
Peterhead,7742,1,24,4,8,82,40,42,76
Montrose,7742,2,23,7,6,59,35,24,76
Stirling,7742,3,17,6,13,62,51,11,57
Clyde,7742,4,15,9,12,53,48,5,54
Stenhousem'r,7742,5,15,8,13,55,48,7,53
Elgin,7742,6,15,6,15,54,60,-6,51
Annan Athlet,7742,7,11,11,14,47,44,3,44
Berwick,7742,8,8,10,18,29,60,-31,34
Edinburgh Ci,7742,9,7,9,20,38,65,-27,30
Cowdenbeath,7742,10,5,10,21,26,54,-28,25
Peterhead,7743,1,24,4,8,81,38,43,76
Montrose,7743,2,23,7,6,60,38,22,76
Stirling,7743,3,17,6,13,62,52,10,57
Clyde,7743,4,15,9,12,55,49,6,54
Stenhousem'r,7743,5,15,8,13,56,48,8,53
Elgin,7743,6,15,6,15,57,61,-4,51
Annan Athlet,7743,7,11,12,13,48,42,6,45
Berwick,7743,8,8,10,18,30,62,-32,34
Edinburgh Ci,7743,9,7,9,20,36,64,-28,30
Cowdenbeath,7743,10,4,11,21,24,55,-31,23
Peterhead,7744,1,24,4,8,80,39,41,76
Montrose,7744,2,23,7,6,60,37,23,76
Stirling,7744,3,17,6,13,61,51,10,57
Clyde,7744,4,15,9,12,54,49,5,54
Stenhousem'r,7744,5,15,8,13,55,47,8,53
Elgin,7744,6,15,6,15,56,61,-5,51
Annan Athlet,7744,7,12,11,13,49,41,8,47
Berwick,7744,8,8,10,18,30,61,-31,34
Edinburgh Ci,7744,9,7,9,20,37,63,-26,30
Cowdenbeath,7744,10,4,10,22,23,56,-33,22
Montrose,7745,1,24,7,5,63,34,29,79
Peterhead,7745,2,24,4,8,81,38,43,76
Stirling,7745,3,17,6,13,62,52,10,57
Clyde,7745,4,15,9,12,55,48,7,54
Stenhousem'r,7745,5,15,8,13,56,48,8,53
Elgin,7745,6,14,6,16,53,64,-11,48
Annan Athlet,7745,7,11,12,13,48,42,6,45
Berwick,7745,8,8,10,18,29,62,-33,34
Edinburgh Ci,7745,9,7,9,20,36,64,-28,30
Cowdenbeath,7745,10,4,11,21,24,55,-31,23
Montrose,7746,1,24,7,5,60,34,26,79
Peterhead,7746,2,23,5,8,78,39,39,74
Stirling,7746,3,17,6,13,63,53,10,57
Clyde,7746,4,15,9,12,55,48,7,54
Stenhousem'r,7746,5,15,8,13,57,49,8,53
Elgin,7746,6,14,6,16,53,61,-8,48
Annan Athlet,7746,7,11,11,14,47,42,5,44
Berwick,7746,8,8,10,18,29,62,-33,34
Edinburgh Ci,7746,9,7,10,19,37,61,-24,31
Cowdenbeath,7746,10,5,10,21,24,54,-30,25
Peterhead,7747,1,24,4,8,82,40,42,76
Montrose,7747,2,23,7,6,59,36,23,76
Stirling,7747,3,17,6,13,61,51,10,57
Clyde,7747,4,15,9,12,52,48,4,54
Stenhousem'r,7747,5,15,8,13,55,47,8,53
Elgin,7747,6,15,6,15,55,60,-5,51
Annan Athlet,7747,7,11,11,14,48,43,5,44
Berwick,7747,8,8,10,18,29,59,-30,34
Edinburgh Ci,7747,9,7,9,20,38,65,-27,30
Cowdenbeath,7747,10,5,10,21,25,55,-30,25
Montrose,7748,1,24,7,5,64,34,30,79
Peterhead,7748,2,24,4,8,78,38,40,76
Stirling,7748,3,17,6,13,63,51,12,57
Clyde,7748,4,15,9,12,54,49,5,54
Stenhousem'r,7748,5,15,8,13,55,49,6,53
Elgin,7748,6,14,6,16,53,65,-12,48
Annan Athlet,7748,7,12,11,13,49,41,8,47
Berwick,7748,8,8,10,18,30,61,-31,34
Edinburgh Ci,7748,9,7,9,20,36,61,-25,30
Cowdenbeath,7748,10,4,10,22,23,56,-33,22
Montrose,7749,1,24,7,5,61,35,26,79
Peterhead,7749,2,23,4,9,79,41,38,73
Stirling,7749,3,16,7,13,60,51,9,55
Stenhousem'r,7749,4,15,9,12,55,46,9,54
Clyde,7749,5,14,9,13,52,51,1,51
Elgin,7749,6,14,6,16,54,62,-8,48
Annan Athlet,7749,7,11,12,13,47,41,6,45
Berwick,7749,8,9,10,17,32,59,-27,37
Edinburgh Ci,7749,9,8,9,19,39,62,-23,33
Cowdenbeath,7749,10,4,11,21,23,54,-31,23
Montrose,7750,1,24,7,5,61,35,26,79
Peterhead,7750,2,24,4,8,80,40,40,76
Stirling,7750,3,17,6,13,62,51,11,57
Stenhousem'r,7750,4,15,8,13,55,48,7,53
Clyde,7750,5,14,10,12,52,49,3,52
Elgin,7750,6,14,6,16,54,62,-8,48
Annan Athlet,7750,7,11,11,14,47,42,5,44
Berwick,7750,8,8,11,17,30,59,-29,35
Edinburgh Ci,7750,9,7,9,20,38,63,-25,30
Cowdenbeath,7750,10,5,10,21,24,54,-30,25
Montrose,7751,1,24,7,5,61,35,26,79
Peterhead,7751,2,24,4,8,79,38,41,76
Stirling,7751,3,16,7,13,61,52,9,55
Stenhousem'r,7751,4,15,9,12,56,47,9,54
Clyde,7751,5,15,9,12,54,48,6,54
Elgin,7751,6,14,6,16,54,62,-8,48
Annan Athlet,7751,7,12,11,13,48,41,7,47
Berwick,7751,8,8,10,18,29,61,-32,34
Edinburgh Ci,7751,9,7,9,20,36,62,-26,30
Cowdenbeath,7751,10,4,10,22,23,55,-32,22
Montrose,7752,1,24,7,5,64,36,28,79
Peterhead,7752,2,24,4,8,82,40,42,76
Stirling,7752,3,17,6,13,62,52,10,57
Stenhousem'r,7752,4,15,8,13,56,48,8,53
Clyde,7752,5,14,10,12,52,49,3,52
Elgin,7752,6,14,6,16,55,65,-10,48
Annan Athlet,7752,7,12,11,13,51,41,10,47
Berwick,7752,8,8,11,17,30,59,-29,35
Edinburgh Ci,7752,9,7,9,20,38,65,-27,30
Cowdenbeath,7752,10,4,10,22,23,58,-35,22
Montrose,7753,1,23,8,5,59,34,25,77
Peterhead,7753,2,24,4,8,78,38,40,76
Stirling,7753,3,17,6,13,65,51,14,57
Clyde,7753,4,15,9,12,54,50,4,54
Stenhousem'r,7753,5,15,8,13,55,51,4,53
Elgin,7753,6,14,7,15,53,60,-7,49
Annan Athlet,7753,7,11,11,14,47,43,4,44
Berwick,7753,8,8,10,18,31,61,-30,34
Edinburgh Ci,7753,9,7,9,20,36,61,-25,30
Cowdenbeath,7753,10,5,10,21,25,54,-29,25
Montrose,7754,1,24,7,5,60,34,26,79
Peterhead,7754,2,24,4,8,81,38,43,76
Stirling,7754,3,16,7,13,61,52,9,55
Stenhousem'r,7754,4,15,9,12,56,47,9,54
Clyde,7754,5,14,9,13,51,51,0,51
Elgin,7754,6,14,6,16,53,61,-8,48
Annan Athlet,7754,7,12,11,13,48,41,7,47
Berwick,7754,8,9,10,17,32,58,-26,37
Edinburgh Ci,7754,9,7,9,20,36,64,-28,30
Cowdenbeath,7754,10,4,10,22,23,55,-32,22
Montrose,7755,1,24,7,5,65,35,30,79
Peterhead,7755,2,24,4,8,79,38,41,76
Stenhousem'r,7755,3,16,8,12,57,47,10,56
Stirling,7755,4,16,6,14,61,53,8,54
Clyde,7755,5,15,9,12,53,48,5,54
Elgin,7755,6,14,6,16,54,66,-12,48
Annan Athlet,7755,7,11,11,14,47,43,4,44
Berwick,7755,8,8,10,18,29,60,-31,34
Edinburgh Ci,7755,9,7,9,20,36,62,-26,30
Cowdenbeath,7755,10,5,10,21,25,54,-29,25
Peterhead,7756,1,24,4,8,80,39,41,76
Montrose,7756,2,23,7,6,60,36,24,76
Stirling,7756,3,17,6,13,65,51,14,57
Clyde,7756,4,15,9,12,54,50,4,54
Stenhousem'r,7756,5,15,8,13,55,51,4,53
Elgin,7756,6,15,6,15,55,61,-6,51
Annan Athlet,7756,7,11,11,14,49,44,5,44
Berwick,7756,8,8,10,18,31,61,-30,34
Edinburgh Ci,7756,9,7,9,20,37,63,-26,30
Cowdenbeath,7756,10,5,10,21,26,56,-30,25
Montrose,7757,1,24,7,5,60,34,26,79
Peterhead,7757,2,24,4,8,79,38,41,76
Stirling,7757,3,16,7,13,60,51,9,55
Stenhousem'r,7757,4,15,9,12,55,46,9,54
Clyde,7757,5,14,10,12,51,48,3,52
Elgin,7757,6,14,6,16,53,61,-8,48
Annan Athlet,7757,7,12,11,13,49,41,8,47
Berwick,7757,8,8,11,17,29,58,-29,35
Edinburgh Ci,7757,9,7,9,20,36,62,-26,30
Cowdenbeath,7757,10,4,10,22,23,56,-33,22
Montrose,7758,1,24,7,5,60,34,26,79
Peterhead,7758,2,23,5,8,79,40,39,74
Stenhousem'r,7758,3,16,8,12,57,47,10,56
Stirling,7758,4,16,6,14,61,53,8,54
Clyde,7758,5,14,10,12,53,50,3,52
Elgin,7758,6,14,6,16,53,61,-8,48
Annan Athlet,7758,7,11,12,13,48,42,6,45
Berwick,7758,8,8,11,17,31,60,-29,35
Edinburgh Ci,7758,9,7,10,19,38,62,-24,31
Cowdenbeath,7758,10,4,11,21,24,55,-31,23
Montrose,7759,1,23,8,5,60,35,25,77
Peterhead,7759,2,24,4,8,79,38,41,76
Stenhousem'r,7759,3,16,8,12,58,47,11,56
Stirling,7759,4,16,6,14,61,54,7,54
Clyde,7759,5,14,10,12,53,50,3,52
Elgin,7759,6,14,7,15,54,61,-7,49
Annan Athlet,7759,7,12,11,13,49,41,8,47
Berwick,7759,8,8,11,17,31,60,-29,35
Edinburgh Ci,7759,9,7,9,20,36,62,-26,30
Cowdenbeath,7759,10,4,10,22,23,56,-33,22
Montrose,7760,1,23,8,5,61,36,25,77
Peterhead,7760,2,23,5,8,78,39,39,74
Stirling,7760,3,17,6,13,67,52,15,57
Stenhousem'r,7760,4,15,8,13,56,53,3,53
Clyde,7760,5,14,10,12,52,49,3,52
Elgin,7760,6,14,7,15,55,62,-7,49
Annan Athlet,7760,7,11,12,13,48,42,6,45
Berwick,7760,8,8,11,17,30,59,-29,35
Edinburgh Ci,7760,9,7,10,19,37,61,-24,31
Cowdenbeath,7760,10,4,11,21,24,55,-31,23
Montrose,7761,1,24,7,5,60,34,26,79
Peterhead,7761,2,24,4,8,80,40,40,76
Stenhousem'r,7761,3,16,8,12,56,46,10,56
Stirling,7761,4,16,6,14,60,52,8,54
Clyde,7761,5,14,9,13,51,49,2,51
Elgin,7761,6,14,6,16,53,61,-8,48
Annan Athlet,7761,7,12,11,13,50,42,8,47
Berwick,7761,8,9,10,17,30,58,-28,37
Edinburgh Ci,7761,9,7,9,20,38,63,-25,30
Cowdenbeath,7761,10,4,10,22,24,57,-33,22
Montrose,7762,1,24,7,5,63,34,29,79
Peterhead,7762,2,23,4,9,78,41,37,73
Stenhousem'r,7762,3,16,8,12,58,47,11,56
Stirling,7762,4,16,6,14,61,54,7,54
Clyde,7762,5,15,9,12,56,49,7,54
Elgin,7762,6,14,6,16,53,64,-11,48
Annan Athlet,7762,7,12,11,13,48,41,7,47
Berwick,7762,8,8,10,18,30,63,-33,34
Edinburgh Ci,7762,9,8,9,19,39,61,-22,33
Cowdenbeath,7762,10,4,10,22,23,55,-32,22
Montrose,7763,1,24,7,5,61,35,26,79
Peterhead,7763,2,24,4,8,79,39,40,76
Stirling,7763,3,16,7,13,62,53,9,55
Stenhousem'r,7763,4,15,9,12,57,48,9,54
Clyde,7763,5,14,9,13,52,50,2,51
Elgin,7763,6,14,6,16,54,62,-8,48
Annan Athlet,7763,7,11,11,14,49,44,5,44
Berwick,7763,8,9,10,17,31,59,-28,37
Edinburgh Ci,7763,9,7,9,20,37,62,-25,30
Cowdenbeath,7763,10,5,10,21,26,56,-30,25
Montrose,7764,1,24,7,5,61,34,27,79
Peterhead,7764,2,24,4,8,82,38,44,76
Stenhousem'r,7764,3,16,8,12,56,46,10,56
Stirling,7764,4,16,6,14,60,52,8,54
Clyde,7764,5,15,9,12,52,48,4,54
Elgin,7764,6,14,6,16,53,62,-9,48
Annan Athlet,7764,7,11,12,13,47,41,6,45
Berwick,7764,8,8,10,18,29,59,-30,34
Edinburgh Ci,7764,9,7,9,20,36,65,-29,30
Cowdenbeath,7764,10,4,11,21,23,54,-31,23
Peterhead,7765,1,24,4,8,81,39,42,76
Montrose,7765,2,23,7,6,59,35,24,76
Stenhousem'r,7765,3,16,8,12,57,47,10,56
Stirling,7765,4,16,6,14,61,53,8,54
Clyde,7765,5,14,10,12,51,48,3,52
Elgin,7765,6,15,6,15,54,60,-6,51
Annan Athlet,7765,7,11,11,14,48,43,5,44
Berwick,7765,8,8,11,17,29,58,-29,35
Edinburgh Ci,7765,9,7,9,20,37,64,-27,30
Cowdenbeath,7765,10,5,10,21,25,55,-30,25
Montrose,7766,1,24,7,5,61,34,27,79
Peterhead,7766,2,24,4,8,84,38,46,76
Stirling,7766,3,16,7,13,60,51,9,55
Stenhousem'r,7766,4,15,9,12,55,46,9,54
Clyde,7766,5,15,9,12,55,49,6,54
Elgin,7766,6,14,6,16,53,62,-9,48
Annan Athlet,7766,7,11,11,14,47,44,3,44
Berwick,7766,8,8,10,18,30,62,-32,34
Edinburgh Ci,7766,9,7,9,20,36,67,-31,30
Cowdenbeath,7766,10,5,10,21,26,54,-28,25
Montrose,7767,1,24,7,5,61,35,26,79
Peterhead,7767,2,23,4,9,77,39,38,73
Stenhousem'r,7767,3,16,8,12,58,48,10,56
Stirling,7767,4,16,6,14,62,54,8,54
Clyde,7767,5,14,10,12,52,49,3,52
Elgin,7767,6,14,6,16,54,62,-8,48
Annan Athlet,7767,7,11,11,14,48,43,5,44
Berwick,7767,8,8,11,17,30,59,-29,35
Edinburgh Ci,7767,9,8,9,19,37,60,-23,33
Cowdenbeath,7767,10,5,10,21,25,55,-30,25
Montrose,7768,1,24,7,5,63,35,28,79
Peterhead,7768,2,24,4,8,82,38,44,76
Stirling,7768,3,16,7,13,61,52,9,55
Stenhousem'r,7768,4,15,9,12,56,47,9,54
Clyde,7768,5,15,9,12,55,49,6,54
Elgin,7768,6,14,6,16,54,64,-10,48
Annan Athlet,7768,7,12,11,13,49,42,7,47
Berwick,7768,8,8,10,18,30,62,-32,34
Edinburgh Ci,7768,9,7,9,20,36,65,-29,30
Cowdenbeath,7768,10,4,10,22,24,56,-32,22
Montrose,7769,1,24,7,5,62,36,26,79
Peterhead,7769,2,24,4,8,79,38,41,76
Stirling,7769,3,17,6,13,61,51,10,57
Stenhousem'r,7769,4,15,8,13,55,47,8,53
Clyde,7769,5,14,10,12,52,49,3,52
Elgin,7769,6,14,6,16,55,63,-8,48
Annan Athlet,7769,7,11,12,13,49,43,6,45
Berwick,7769,8,8,11,17,30,59,-29,35
Edinburgh Ci,7769,9,7,9,20,36,62,-26,30
Cowdenbeath,7769,10,4,11,21,25,56,-31,23
Montrose,7770,1,24,7,5,61,34,27,79
Peterhead,7770,2,23,5,8,77,38,39,74
Stirling,7770,3,16,7,13,61,52,9,55
Stenhousem'r,7770,4,15,9,12,56,47,9,54
Clyde,7770,5,15,9,12,54,48,6,54
Elgin,7770,6,14,6,16,53,62,-9,48
Annan Athlet,7770,7,11,12,13,47,41,6,45
Berwick,7770,8,8,10,18,29,61,-32,34
Edinburgh Ci,7770,9,7,10,19,36,60,-24,31
Cowdenbeath,7770,10,4,11,21,23,54,-31,23
Montrose,7771,1,24,7,5,62,35,27,79
Peterhead,7771,2,24,4,8,82,38,44,76
Stirling,7771,3,17,6,13,62,52,10,57
Stenhousem'r,7771,4,15,8,13,56,48,8,53
Clyde,7771,5,14,9,13,51,50,1,51
Elgin,7771,6,14,6,16,54,63,-9,48
Annan Athlet,7771,7,11,11,14,48,43,5,44
Berwick,7771,8,9,10,17,31,58,-27,37
Edinburgh Ci,7771,9,7,9,20,36,65,-29,30
Cowdenbeath,7771,10,5,10,21,25,55,-30,25
Montrose,7772,1,24,7,5,62,36,26,79
Peterhead,7772,2,23,4,9,77,40,37,73
Stirling,7772,3,17,6,13,63,51,12,57
Stenhousem'r,7772,4,15,8,13,55,49,6,53
Clyde,7772,5,14,10,12,52,49,3,52
Elgin,7772,6,14,6,16,55,63,-8,48
Annan Athlet,7772,7,12,11,13,50,41,9,47
Berwick,7772,8,8,11,17,30,59,-29,35
Edinburgh Ci,7772,9,8,9,19,38,60,-22,33
Cowdenbeath,7772,10,4,10,22,23,57,-34,22
Montrose,7773,1,24,7,5,62,36,26,79
Peterhead,7773,2,24,4,8,78,38,40,76
Stirling,7773,3,17,6,13,61,51,10,57
Clyde,7773,4,15,9,12,52,48,4,54
Stenhousem'r,7773,5,15,8,13,55,47,8,53
Elgin,7773,6,14,6,16,55,63,-8,48
Annan Athlet,7773,7,11,11,14,48,43,5,44
Berwick,7773,8,8,10,18,29,59,-30,34
Edinburgh Ci,7773,9,7,9,20,36,61,-25,30
Cowdenbeath,7773,10,5,10,21,25,55,-30,25
Montrose,7774,1,24,7,5,62,35,27,79
Peterhead,7774,2,24,4,8,79,38,41,76
Stirling,7774,3,16,7,13,62,53,9,55
Stenhousem'r,7774,4,15,9,12,57,48,9,54
Clyde,7774,5,14,10,12,53,50,3,52
Elgin,7774,6,14,6,16,54,63,-9,48
Annan Athlet,7774,7,12,11,13,48,41,7,47
Berwick,7774,8,8,11,17,31,60,-29,35
Edinburgh Ci,7774,9,7,9,20,36,62,-26,30
Cowdenbeath,7774,10,4,10,22,23,55,-32,22
Montrose,7775,1,23,8,5,59,34,25,77
Peterhead,7775,2,24,4,8,79,39,40,76
Stenhousem'r,7775,3,16,8,12,58,47,11,56
Stirling,7775,4,16,6,14,61,54,7,54
Clyde,7775,5,15,9,12,53,49,4,54
Elgin,7775,6,14,7,15,53,60,-7,49
Annan Athlet,7775,7,12,11,13,50,41,9,47
Berwick,7775,8,8,10,18,30,60,-30,34
Edinburgh Ci,7775,9,7,9,20,37,62,-25,30
Cowdenbeath,7775,10,4,10,22,23,57,-34,22
Montrose,7776,1,24,7,5,61,35,26,79
Peterhead,7776,2,23,4,9,78,40,38,73
Stenhousem'r,7776,3,16,8,12,57,47,10,56
Stirling,7776,4,16,6,14,61,53,8,54
Clyde,7776,5,15,9,12,55,48,7,54
Elgin,7776,6,14,6,16,54,62,-8,48
Annan Athlet,7776,7,11,11,14,47,42,5,44
Berwick,7776,8,8,10,18,29,62,-33,34
Edinburgh Ci,7776,9,8,9,19,38,61,-23,33
Cowdenbeath,7776,10,5,10,21,24,54,-30,25
Montrose,7777,1,24,7,5,60,34,26,79
Peterhead,7777,2,24,4,8,79,39,40,76
Stirling,7777,3,16,7,13,61,52,9,55
Stenhousem'r,7777,4,15,9,12,56,47,9,54
Clyde,7777,5,14,9,13,53,51,2,51
Elgin,7777,6,14,6,16,53,61,-8,48
Annan Athlet,7777,7,11,12,13,49,43,6,45
Berwick,7777,8,9,10,17,32,60,-28,37
Edinburgh Ci,7777,9,7,9,20,37,62,-25,30
Cowdenbeath,7777,10,4,11,21,25,56,-31,23
Montrose,7778,1,24,7,5,65,36,29,79
Peterhead,7778,2,24,4,8,81,38,43,76
Stirling,7778,3,17,6,13,63,51,12,57
Clyde,7778,4,15,9,12,52,48,4,54
Stenhousem'r,7778,5,15,8,13,55,49,6,53
Elgin,7778,6,14,6,16,55,66,-11,48
Annan Athlet,7778,7,11,12,13,48,42,6,45
Berwick,7778,8,8,10,18,29,59,-30,34
Edinburgh Ci,7778,9,7,9,20,36,64,-28,30
Cowdenbeath,7778,10,4,11,21,24,55,-31,23
Montrose,7779,1,24,7,5,61,35,26,79
Peterhead,7779,2,24,4,8,79,38,41,76
Stirling,7779,3,17,6,13,61,51,10,57
Stenhousem'r,7779,4,15,8,13,55,47,8,53
Clyde,7779,5,14,9,13,52,50,2,51
Elgin,7779,6,14,6,16,54,62,-8,48
Annan Athlet,7779,7,12,11,13,50,42,8,47
Berwick,7779,8,9,10,17,31,59,-28,37
Edinburgh Ci,7779,9,7,9,20,36,62,-26,30
Cowdenbeath,7779,10,4,10,22,24,57,-33,22
Montrose,7780,1,23,8,5,60,35,25,77
Peterhead,7780,2,23,5,8,79,40,39,74
Stirling,7780,3,17,6,13,62,52,10,57
Clyde,7780,4,15,9,12,52,48,4,54
Stenhousem'r,7780,5,15,8,13,56,48,8,53
Elgin,7780,6,14,7,15,54,61,-7,49
Annan Athlet,7780,7,11,12,13,50,44,6,45
Berwick,7780,8,8,10,18,29,59,-30,34
Edinburgh Ci,7780,9,7,10,19,38,62,-24,31
Cowdenbeath,7780,10,4,11,21,26,57,-31,23
Montrose,7781,1,24,7,5,61,35,26,79
Peterhead,7781,2,24,4,8,78,38,40,76
Stirling,7781,3,16,7,13,61,52,9,55
Stenhousem'r,7781,4,15,9,12,56,47,9,54
Clyde,7781,5,15,9,12,55,48,7,54
Elgin,7781,6,14,6,16,54,62,-8,48
Annan Athlet,7781,7,12,11,13,49,42,7,47
Berwick,7781,8,8,10,18,29,62,-33,34
Edinburgh Ci,7781,9,7,9,20,36,61,-25,30
Cowdenbeath,7781,10,4,10,22,24,56,-32,22
Peterhead,7782,1,24,4,8,79,38,41,76
Montrose,7782,2,23,7,6,59,35,24,76
Stirling,7782,3,17,6,13,61,51,10,57
Stenhousem'r,7782,4,15,8,13,55,47,8,53
Clyde,7782,5,14,9,13,52,50,2,51
Elgin,7782,6,15,6,15,54,60,-6,51
Annan Athlet,7782,7,11,11,14,47,42,5,44
Berwick,7782,8,9,10,17,31,59,-28,37
Edinburgh Ci,7782,9,7,9,20,36,62,-26,30
Cowdenbeath,7782,10,5,10,21,24,54,-30,25
Montrose,7783,1,24,7,5,60,34,26,79
Peterhead,7783,2,24,4,8,80,39,41,76
Stenhousem'r,7783,3,16,8,12,58,47,11,56
Stirling,7783,4,16,6,14,61,54,7,54
Clyde,7783,5,15,9,12,53,48,5,54
Elgin,7783,6,14,6,16,53,61,-8,48
Annan Athlet,7783,7,11,11,14,47,42,5,44
Berwick,7783,8,8,10,18,29,60,-31,34
Edinburgh Ci,7783,9,7,9,20,37,63,-26,30
Cowdenbeath,7783,10,5,10,21,24,54,-30,25
Peterhead,7784,1,24,4,8,78,38,40,76
Montrose,7784,2,23,7,6,59,35,24,76
Stirling,7784,3,17,6,13,65,53,12,57
Clyde,7784,4,15,9,12,52,48,4,54
Stenhousem'r,7784,5,15,8,13,57,51,6,53
Elgin,7784,6,15,6,15,54,60,-6,51
Annan Athlet,7784,7,12,11,13,50,43,7,47
Berwick,7784,8,8,10,18,29,59,-30,34
Edinburgh Ci,7784,9,7,9,20,36,61,-25,30
Cowdenbeath,7784,10,4,10,22,25,57,-32,22
Montrose,7785,1,24,7,5,62,34,28,79
Peterhead,7785,2,24,4,8,82,38,44,76
Stirling,7785,3,17,6,13,62,52,10,57
Stenhousem'r,7785,4,15,8,13,56,48,8,53
Clyde,7785,5,14,10,12,51,48,3,52
Elgin,7785,6,14,6,16,53,63,-10,48
Annan Athlet,7785,7,11,11,14,48,43,5,44
Berwick,7785,8,8,11,17,29,58,-29,35
Edinburgh Ci,7785,9,7,9,20,36,65,-29,30
Cowdenbeath,7785,10,5,10,21,25,55,-30,25
Peterhead,7786,1,24,4,8,82,40,42,76
Montrose,7786,2,23,7,6,59,36,23,76
Stirling,7786,3,17,6,13,64,51,13,57
Clyde,7786,4,15,9,12,53,49,4,54
Stenhousem'r,7786,5,15,8,13,55,50,5,53
Elgin,7786,6,15,6,15,55,60,-5,51
Annan Athlet,7786,7,11,12,13,47,41,6,45
Berwick,7786,8,8,10,18,30,60,-30,34
Edinburgh Ci,7786,9,7,9,20,38,65,-27,30
Cowdenbeath,7786,10,4,11,21,23,54,-31,23
Montrose,7787,1,23,8,5,61,36,25,77
Peterhead,7787,2,23,4,9,78,40,38,73
Stirling,7787,3,17,6,13,61,51,10,57
Stenhousem'r,7787,4,15,8,13,55,47,8,53
Clyde,7787,5,14,10,12,53,50,3,52
Elgin,7787,6,14,7,15,55,62,-7,49
Annan Athlet,7787,7,11,11,14,47,44,3,44
Berwick,7787,8,8,11,17,31,60,-29,35
Edinburgh Ci,7787,9,8,9,19,38,61,-23,33
Cowdenbeath,7787,10,5,10,21,26,54,-28,25
Montrose,7788,1,23,8,5,60,35,25,77
Peterhead,7788,2,24,4,8,79,39,40,76
Stirling,7788,3,17,6,13,63,53,10,57
Clyde,7788,4,15,9,12,55,50,5,54
Stenhousem'r,7788,5,15,8,13,57,49,8,53
Elgin,7788,6,14,7,15,54,61,-7,49
Annan Athlet,7788,7,11,12,13,47,41,6,45
Berwick,7788,8,8,10,18,31,62,-31,34
Edinburgh Ci,7788,9,7,9,20,37,62,-25,30
Cowdenbeath,7788,10,4,11,21,23,54,-31,23
Montrose,7789,1,24,7,5,61,35,26,79
Peterhead,7789,2,24,4,8,80,39,41,76
Stenhousem'r,7789,3,16,8,12,57,46,11,56
Stirling,7789,4,16,6,14,60,53,7,54
Clyde,7789,5,15,9,12,54,49,5,54
Elgin,7789,6,14,6,16,54,62,-8,48
Annan Athlet,7789,7,11,11,14,47,44,3,44
Berwick,7789,8,8,10,18,30,61,-31,34
Edinburgh Ci,7789,9,7,9,20,37,63,-26,30
Cowdenbeath,7789,10,5,10,21,26,54,-28,25
Montrose,7790,1,24,7,5,63,35,28,79
Peterhead,7790,2,23,5,8,78,39,39,74
Stirling,7790,3,17,6,13,63,53,10,57
Stenhousem'r,7790,4,15,8,13,57,49,8,53
Clyde,7790,5,14,9,13,53,51,2,51
Elgin,7790,6,14,6,16,54,64,-10,48
Annan Athlet,7790,7,12,11,13,48,41,7,47
Berwick,7790,8,9,10,17,32,60,-28,37
Edinburgh Ci,7790,9,7,10,19,37,61,-24,31
Cowdenbeath,7790,10,4,10,22,23,55,-32,22
Montrose,7791,1,24,7,5,63,34,29,79
Peterhead,7791,2,24,4,8,81,38,43,76
Stirling,7791,3,16,7,13,62,53,9,55
Stenhousem'r,7791,4,15,9,12,57,48,9,54
Clyde,7791,5,15,9,12,53,48,5,54
Elgin,7791,6,14,6,16,53,64,-11,48
Annan Athlet,7791,7,11,12,13,47,41,6,45
Berwick,7791,8,8,10,18,29,60,-31,34
Edinburgh Ci,7791,9,7,9,20,36,64,-28,30
Cowdenbeath,7791,10,4,11,21,23,54,-31,23
Peterhead,7792,1,24,4,8,78,38,40,76
Montrose,7792,2,23,7,6,60,36,24,76
Stirling,7792,3,16,7,13,61,52,9,55
Stenhousem'r,7792,4,15,9,12,56,47,9,54
Clyde,7792,5,15,9,12,56,49,7,54
Elgin,7792,6,15,6,15,55,61,-6,51
Annan Athlet,7792,7,11,12,13,48,42,6,45
Berwick,7792,8,8,10,18,30,63,-33,34
Edinburgh Ci,7792,9,7,9,20,36,61,-25,30
Cowdenbeath,7792,10,4,11,21,24,55,-31,23
Montrose,7793,1,24,7,5,60,34,26,79
Peterhead,7793,2,23,4,9,78,40,38,73
Stirling,7793,3,17,6,13,62,51,11,57
Stenhousem'r,7793,4,15,8,13,55,48,7,53
Clyde,7793,5,14,10,12,52,49,3,52
Elgin,7793,6,14,6,16,53,61,-8,48
Annan Athlet,7793,7,11,12,13,48,42,6,45
Berwick,7793,8,8,11,17,30,59,-29,35
Edinburgh Ci,7793,9,8,9,19,38,61,-23,33
Cowdenbeath,7793,10,4,11,21,24,55,-31,23
Montrose,7794,1,24,7,5,61,34,27,79
Peterhead,7794,2,23,5,8,79,40,39,74
Stirling,7794,3,16,7,13,64,55,9,55
Stenhousem'r,7794,4,15,9,12,59,50,9,54
Clyde,7794,5,15,9,12,55,48,7,54
Elgin,7794,6,14,6,16,53,62,-9,48
Annan Athlet,7794,7,12,11,13,48,41,7,47
Berwick,7794,8,8,10,18,29,62,-33,34
Edinburgh Ci,7794,9,7,10,19,38,62,-24,31
Cowdenbeath,7794,10,4,10,22,23,55,-32,22
Montrose,7795,1,24,7,5,62,35,27,79
Peterhead,7795,2,23,5,8,78,39,39,74
Stirling,7795,3,17,6,13,61,51,10,57
Stenhousem'r,7795,4,15,8,13,55,47,8,53
Clyde,7795,5,14,10,12,52,49,3,52
Elgin,7795,6,14,6,16,54,63,-9,48
Annan Athlet,7795,7,11,11,14,48,43,5,44
Berwick,7795,8,8,11,17,30,59,-29,35
Edinburgh Ci,7795,9,7,10,19,37,61,-24,31
Cowdenbeath,7795,10,5,10,21,25,55,-30,25
Montrose,7796,1,24,7,5,63,34,29,79
Peterhead,7796,2,23,4,9,77,39,38,73
Stirling,7796,3,17,6,13,62,52,10,57
Clyde,7796,4,15,9,12,54,49,5,54
Stenhousem'r,7796,5,15,8,13,56,48,8,53
Elgin,7796,6,14,6,16,53,64,-11,48
Annan Athlet,7796,7,11,11,14,47,42,5,44
Berwick,7796,8,8,10,18,30,61,-31,34
Edinburgh Ci,7796,9,8,9,19,37,60,-23,33
Cowdenbeath,7796,10,5,10,21,24,54,-30,25
Montrose,7797,1,24,7,5,61,34,27,79
Peterhead,7797,2,23,4,9,78,42,36,73
Stirling,7797,3,17,6,13,61,51,10,57
Stenhousem'r,7797,4,15,8,13,55,47,8,53
Clyde,7797,5,14,10,12,51,48,3,52
Elgin,7797,6,14,6,16,53,62,-9,48
Annan Athlet,7797,7,12,11,13,49,42,7,47
Berwick,7797,8,8,11,17,29,58,-29,35
Edinburgh Ci,7797,9,8,9,19,40,61,-21,33
Cowdenbeath,7797,10,4,10,22,24,56,-32,22
Montrose,7798,1,24,7,5,61,34,27,79
Peterhead,7798,2,24,4,8,78,38,40,76
Stirling,7798,3,16,7,13,62,53,9,55
Stenhousem'r,7798,4,15,9,12,57,48,9,54
Clyde,7798,5,15,9,12,54,48,6,54
Elgin,7798,6,14,6,16,53,62,-9,48
Annan Athlet,7798,7,12,11,13,49,42,7,47
Berwick,7798,8,8,10,18,29,61,-32,34
Edinburgh Ci,7798,9,7,9,20,36,61,-25,30
Cowdenbeath,7798,10,4,10,22,24,56,-32,22
Montrose,7799,1,23,8,5,61,36,25,77
Peterhead,7799,2,23,4,9,77,39,38,73
Stirling,7799,3,16,7,13,61,52,9,55
Stenhousem'r,7799,4,15,9,12,56,47,9,54
Clyde,7799,5,15,9,12,53,48,5,54
Elgin,7799,6,14,7,15,55,62,-7,49
Annan Athlet,7799,7,12,11,13,48,41,7,47
Berwick,7799,8,8,10,18,29,60,-31,34
Edinburgh Ci,7799,9,8,9,19,37,60,-23,33
Cowdenbeath,7799,10,4,10,22,23,55,-32,22
Montrose,7800,1,24,7,5,62,34,28,79
Peterhead,7800,2,23,4,9,78,40,38,73
Stirling,7800,3,17,6,13,62,51,11,57
Clyde,7800,4,15,9,12,54,50,4,54
Stenhousem'r,7800,5,15,8,13,55,48,7,53
Elgin,7800,6,14,6,16,53,63,-10,48
Annan Athlet,7800,7,11,12,13,47,41,6,45
Berwick,7800,8,8,10,18,31,61,-30,34
Edinburgh Ci,7800,9,8,9,19,38,61,-23,33
Cowdenbeath,7800,10,4,11,21,23,54,-31,23
Montrose,7801,1,24,7,5,61,35,26,79
Peterhead,7801,2,24,4,8,78,38,40,76
Stenhousem'r,7801,3,16,8,12,59,46,13,56
Stirling,7801,4,16,6,14,60,55,5,54
Clyde,7801,5,14,9,13,53,51,2,51
Elgin,7801,6,14,6,16,54,62,-8,48
Annan Athlet,7801,7,11,11,14,47,43,4,44
Berwick,7801,8,9,10,17,32,60,-28,37
Edinburgh Ci,7801,9,7,9,20,36,61,-25,30
Cowdenbeath,7801,10,5,10,21,25,54,-29,25
Montrose,7802,1,24,7,5,62,35,27,79
Peterhead,7802,2,24,4,8,80,38,42,76
Stirling,7802,3,16,7,13,61,52,9,55
Stenhousem'r,7802,4,15,9,12,56,47,9,54
Clyde,7802,5,15,9,12,53,48,5,54
Elgin,7802,6,14,6,16,54,63,-9,48
Annan Athlet,7802,7,11,11,14,47,42,5,44
Berwick,7802,8,8,10,18,29,60,-31,34
Edinburgh Ci,7802,9,7,9,20,36,63,-27,30
Cowdenbeath,7802,10,5,10,21,24,54,-30,25
Peterhead,7803,1,24,4,8,79,39,40,76
Montrose,7803,2,23,7,6,60,37,23,76
Stirling,7803,3,17,6,13,63,52,11,57
Clyde,7803,4,15,9,12,53,48,5,54
Stenhousem'r,7803,5,15,8,13,56,49,7,53
Elgin,7803,6,15,6,15,56,61,-5,51
Annan Athlet,7803,7,12,11,13,49,42,7,47
Berwick,7803,8,8,10,18,29,60,-31,34
Edinburgh Ci,7803,9,7,9,20,37,62,-25,30
Cowdenbeath,7803,10,4,10,22,24,56,-32,22
Montrose,7804,1,24,7,5,61,34,27,79
Peterhead,7804,2,24,4,8,78,38,40,76
Stirling,7804,3,16,7,13,61,52,9,55
Stenhousem'r,7804,4,15,9,12,56,47,9,54
Clyde,7804,5,15,9,12,54,48,6,54
Elgin,7804,6,14,6,16,53,62,-9,48
Annan Athlet,7804,7,11,12,13,47,41,6,45
Berwick,7804,8,8,10,18,29,61,-32,34
Edinburgh Ci,7804,9,7,9,20,36,61,-25,30
Cowdenbeath,7804,10,4,11,21,23,54,-31,23
Peterhead,7805,1,24,4,8,79,38,41,76
Montrose,7805,2,23,7,6,59,35,24,76
Stenhousem'r,7805,3,16,8,12,56,46,10,56
Stirling,7805,4,16,6,14,60,52,8,54
Clyde,7805,5,15,9,12,54,48,6,54
Elgin,7805,6,15,6,15,54,60,-6,51
Annan Athlet,7805,7,11,11,14,47,42,5,44
Berwick,7805,8,8,10,18,29,61,-32,34
Edinburgh Ci,7805,9,7,9,20,36,62,-26,30
Cowdenbeath,7805,10,5,10,21,24,54,-30,25
Montrose,7806,1,24,7,5,64,36,28,79
Peterhead,7806,2,23,4,9,77,41,36,73
Stirling,7806,3,17,6,13,62,52,10,57
Stenhousem'r,7806,4,15,8,13,56,48,8,53
Clyde,7806,5,14,9,13,53,51,2,51
Elgin,7806,6,14,6,16,55,65,-10,48
Annan Athlet,7806,7,12,11,13,50,43,7,47
Berwick,7806,8,9,10,17,32,60,-28,37
Edinburgh Ci,7806,9,8,9,19,39,60,-21,33
Cowdenbeath,7806,10,4,10,22,25,57,-32,22
Montrose,7807,1,23,8,5,60,35,25,77
Peterhead,7807,2,24,4,8,82,38,44,76
Stirling,7807,3,17,6,13,63,52,11,57
Clyde,7807,4,15,9,12,56,48,8,54
Stenhousem'r,7807,5,15,8,13,56,49,7,53
Elgin,7807,6,14,7,15,54,61,-7,49
Annan Athlet,7807,7,11,11,14,49,44,5,44
Berwick,7807,8,8,10,18,29,63,-34,34
Edinburgh Ci,7807,9,7,9,20,36,65,-29,30
Cowdenbeath,7807,10,5,10,21,26,56,-30,25
Montrose,7808,1,24,7,5,61,35,26,79
Peterhead,7808,2,23,4,9,78,40,38,73
Stirling,7808,3,17,6,13,64,53,11,57
Clyde,7808,4,15,9,12,53,48,5,54
Stenhousem'r,7808,5,15,8,13,57,50,7,53
Elgin,7808,6,14,6,16,54,62,-8,48
Annan Athlet,7808,7,11,12,13,48,42,6,45
Berwick,7808,8,8,10,18,29,60,-31,34
Edinburgh Ci,7808,9,8,9,19,38,61,-23,33
Cowdenbeath,7808,10,4,11,21,24,55,-31,23
Montrose,7809,1,23,8,5,60,35,25,77
Peterhead,7809,2,23,5,8,78,39,39,74
Stirling,7809,3,17,6,13,62,51,11,57
Stenhousem'r,7809,4,15,8,13,55,48,7,53
Clyde,7809,5,14,9,13,52,50,2,51
Elgin,7809,6,14,7,15,54,61,-7,49
Annan Athlet,7809,7,11,12,13,47,41,6,45
Berwick,7809,8,9,10,17,31,59,-28,37
Edinburgh Ci,7809,9,7,10,19,37,61,-24,31
Cowdenbeath,7809,10,4,11,21,23,54,-31,23
Montrose,7810,1,24,7,5,64,34,30,79
Peterhead,7810,2,24,4,8,79,38,41,76
Stirling,7810,3,17,6,13,63,52,11,57
Clyde,7810,4,15,9,12,53,49,4,54
Stenhousem'r,7810,5,15,8,13,56,49,7,53
Elgin,7810,6,14,6,16,53,65,-12,48
Annan Athlet,7810,7,11,11,14,48,44,4,44
Berwick,7810,8,8,10,18,30,60,-30,34
Edinburgh Ci,7810,9,7,9,20,36,62,-26,30
Cowdenbeath,7810,10,5,10,21,26,55,-29,25
Montrose,7811,1,24,7,5,63,36,27,79
Peterhead,7811,2,24,4,8,79,39,40,76
Stirling,7811,3,17,6,13,65,53,12,57
Stenhousem'r,7811,4,15,8,13,57,51,6,53
Clyde,7811,5,14,10,12,53,50,3,52
Elgin,7811,6,14,6,16,55,64,-9,48
Annan Athlet,7811,7,11,11,14,47,43,4,44
Berwick,7811,8,8,11,17,31,60,-29,35
Edinburgh Ci,7811,9,7,9,20,37,62,-25,30
Cowdenbeath,7811,10,5,10,21,25,54,-29,25
Montrose,7812,1,24,7,5,66,37,29,79
Peterhead,7812,2,24,4,8,78,38,40,76
Stirling,7812,3,16,7,13,64,55,9,55
Stenhousem'r,7812,4,15,9,12,59,50,9,54
Clyde,7812,5,15,9,12,54,49,5,54
Elgin,7812,6,14,6,16,56,67,-11,48
Annan Athlet,7812,7,11,11,14,48,44,4,44
Berwick,7812,8,8,10,18,30,61,-31,34
Edinburgh Ci,7812,9,7,9,20,36,61,-25,30
Cowdenbeath,7812,10,5,10,21,26,55,-29,25
Montrose,7813,1,24,7,5,63,37,26,79
Peterhead,7813,2,24,4,8,78,38,40,76
Stirling,7813,3,17,6,13,63,53,10,57
Clyde,7813,4,15,9,12,52,48,4,54
Stenhousem'r,7813,5,15,8,13,57,49,8,53
Elgin,7813,6,14,6,16,56,64,-8,48
Annan Athlet,7813,7,11,11,14,48,45,3,44
Berwick,7813,8,8,10,18,29,59,-30,34
Edinburgh Ci,7813,9,7,9,20,36,61,-25,30
Cowdenbeath,7813,10,5,10,21,27,55,-28,25
Montrose,7814,1,24,7,5,61,35,26,79
Peterhead,7814,2,24,4,8,80,38,42,76
Stenhousem'r,7814,3,16,8,12,58,47,11,56
Stirling,7814,4,16,6,14,61,54,7,54
Clyde,7814,5,15,9,12,56,50,6,54
Elgin,7814,6,14,6,16,54,62,-8,48
Annan Athlet,7814,7,12,11,13,49,42,7,47
Berwick,7814,8,8,10,18,31,63,-32,34
Edinburgh Ci,7814,9,7,9,20,36,63,-27,30
Cowdenbeath,7814,10,4,10,22,24,56,-32,22
Montrose,7815,1,23,7,6,59,35,24,76
Peterhead,7815,2,23,5,8,78,39,39,74
Stirling,7815,3,17,6,13,63,51,12,57
Stenhousem'r,7815,4,15,8,13,55,49,6,53
Clyde,7815,5,14,9,13,52,50,2,51
Elgin,7815,6,15,6,15,54,60,-6,51
Annan Athlet,7815,7,11,11,14,47,42,5,44
Berwick,7815,8,9,10,17,31,59,-28,37
Edinburgh Ci,7815,9,7,10,19,37,61,-24,31
Cowdenbeath,7815,10,5,10,21,24,54,-30,25
Montrose,7816,1,24,7,5,61,34,27,79
Peterhead,7816,2,24,4,8,80,38,42,76
Stirling,7816,3,17,6,13,62,51,11,57
Clyde,7816,4,15,9,12,53,48,5,54
Stenhousem'r,7816,5,15,8,13,55,48,7,53
Elgin,7816,6,14,6,16,53,62,-9,48
Annan Athlet,7816,7,11,11,14,47,45,2,44
Berwick,7816,8,8,10,18,29,60,-31,34
Edinburgh Ci,7816,9,7,9,20,36,63,-27,30
Cowdenbeath,7816,10,5,10,21,27,54,-27,25
Montrose,7817,1,24,7,5,61,34,27,79
Peterhead,7817,2,24,4,8,79,39,40,76
Stirling,7817,3,17,6,13,63,53,10,57
Stenhousem'r,7817,4,15,8,13,57,49,8,53
Clyde,7817,5,14,10,12,52,49,3,52
Elgin,7817,6,14,6,16,53,62,-9,48
Annan Athlet,7817,7,11,12,13,48,42,6,45
Berwick,7817,8,8,11,17,30,59,-29,35
Edinburgh Ci,7817,9,7,9,20,37,62,-25,30
Cowdenbeath,7817,10,4,11,21,24,55,-31,23
Montrose,7818,1,24,7,5,63,36,27,79
Peterhead,7818,2,23,4,9,79,41,38,73
Stirling,7818,3,17,6,13,64,54,10,57
Clyde,7818,4,15,9,12,53,49,4,54
Stenhousem'r,7818,5,15,8,13,58,50,8,53
Elgin,7818,6,14,6,16,55,64,-9,48
Annan Athlet,7818,7,12,11,13,50,42,8,47
Berwick,7818,8,8,10,18,30,60,-30,34
Edinburgh Ci,7818,9,8,9,19,39,62,-23,33
Cowdenbeath,7818,10,4,10,22,24,57,-33,22
Peterhead,7819,1,24,4,8,84,39,45,76
Montrose,7819,2,23,7,6,59,37,22,76
Stenhousem'r,7819,3,16,8,12,56,46,10,56
Stirling,7819,4,16,6,14,60,52,8,54
Clyde,7819,5,14,9,13,52,50,2,51
Elgin,7819,6,15,6,15,56,60,-4,51
Annan Athlet,7819,7,12,11,13,49,41,8,47
Berwick,7819,8,9,10,17,31,59,-28,37
Edinburgh Ci,7819,9,7,9,20,37,67,-30,30
Cowdenbeath,7819,10,4,10,22,23,56,-33,22
Peterhead,7820,1,24,4,8,79,39,40,76
Montrose,7820,2,23,7,6,59,35,24,76
Stenhousem'r,7820,3,16,8,12,57,47,10,56
Stirling,7820,4,16,6,14,61,53,8,54
Clyde,7820,5,15,9,12,53,48,5,54
Elgin,7820,6,15,6,15,54,60,-6,51
Annan Athlet,7820,7,11,11,14,49,44,5,44
Berwick,7820,8,8,10,18,29,60,-31,34
Edinburgh Ci,7820,9,7,9,20,37,62,-25,30
Cowdenbeath,7820,10,5,10,21,26,56,-30,25
Montrose,7821,1,24,7,5,64,34,30,79
Peterhead,7821,2,24,4,8,81,39,42,76
Stirling,7821,3,17,6,13,63,51,12,57
Clyde,7821,4,15,9,12,57,49,8,54
Stenhousem'r,7821,5,15,8,13,55,49,6,53
Elgin,7821,6,14,6,16,53,65,-12,48
Annan Athlet,7821,7,12,11,13,50,41,9,47
Berwick,7821,8,8,10,18,30,64,-34,34
Edinburgh Ci,7821,9,7,9,20,37,64,-27,30
Cowdenbeath,7821,10,4,10,22,23,57,-34,22
Montrose,7822,1,24,7,5,62,35,27,79
Peterhead,7822,2,24,4,8,79,39,40,76
Stirling,7822,3,17,6,13,62,51,11,57
Clyde,7822,4,15,9,12,53,49,4,54
Stenhousem'r,7822,5,15,8,13,55,48,7,53
Elgin,7822,6,14,6,16,54,63,-9,48
Annan Athlet,7822,7,12,11,13,50,43,7,47
Berwick,7822,8,8,10,18,30,60,-30,34
Edinburgh Ci,7822,9,7,9,20,37,62,-25,30
Cowdenbeath,7822,10,4,10,22,25,57,-32,22
Montrose,7823,1,24,7,5,61,34,27,79
Peterhead,7823,2,24,4,8,80,39,41,76
Stirling,7823,3,17,6,13,63,52,11,57
Clyde,7823,4,15,9,12,54,50,4,54
Stenhousem'r,7823,5,15,8,13,56,49,7,53
Elgin,7823,6,14,6,16,53,62,-9,48
Annan Athlet,7823,7,12,11,13,50,43,7,47
Berwick,7823,8,8,10,18,31,61,-30,34
Edinburgh Ci,7823,9,7,9,20,37,63,-26,30
Cowdenbeath,7823,10,4,10,22,25,57,-32,22
Montrose,7824,1,23,7,6,61,38,23,76
Peterhead,7824,2,23,5,8,79,40,39,74
Stenhousem'r,7824,3,16,8,12,57,47,10,56
Stirling,7824,4,16,6,14,61,53,8,54
Clyde,7824,5,14,9,13,52,50,2,51
Elgin,7824,6,15,6,15,57,62,-5,51
Annan Athlet,7824,7,12,11,13,51,42,9,47
Berwick,7824,8,9,10,17,31,59,-28,37
Edinburgh Ci,7824,9,7,10,19,38,62,-24,31
Cowdenbeath,7824,10,4,10,22,24,58,-34,22
Montrose,7825,1,24,7,5,61,35,26,79
Peterhead,7825,2,24,4,8,79,38,41,76
Stenhousem'r,7825,3,16,8,12,58,48,10,56
Stirling,7825,4,16,6,14,62,54,8,54
Clyde,7825,5,14,9,13,53,51,2,51
Elgin,7825,6,14,6,16,54,62,-8,48
Annan Athlet,7825,7,11,11,14,48,43,5,44
Berwick,7825,8,9,10,17,32,60,-28,37
Edinburgh Ci,7825,9,7,9,20,36,62,-26,30
Cowdenbeath,7825,10,5,10,21,25,55,-30,25
Montrose,7826,1,23,8,5,62,37,25,77
Peterhead,7826,2,24,4,8,81,39,42,76
Stirling,7826,3,17,6,13,62,52,10,57
Clyde,7826,4,15,9,12,53,48,5,54
Stenhousem'r,7826,5,15,8,13,56,48,8,53
Elgin,7826,6,14,7,15,56,63,-7,49
Annan Athlet,7826,7,12,11,13,49,41,8,47
Berwick,7826,8,8,10,18,29,60,-31,34
Edinburgh Ci,7826,9,7,9,20,37,64,-27,30
Cowdenbeath,7826,10,4,10,22,23,56,-33,22
Montrose,7827,1,23,8,5,60,35,25,77
Peterhead,7827,2,23,4,9,77,39,38,73
Stenhousem'r,7827,3,16,8,12,58,48,10,56
Stirling,7827,4,16,6,14,62,54,8,54
Clyde,7827,5,15,9,12,56,48,8,54
Elgin,7827,6,14,7,15,54,61,-7,49
Annan Athlet,7827,7,11,11,14,47,42,5,44
Berwick,7827,8,8,10,18,29,63,-34,34
Edinburgh Ci,7827,9,8,9,19,37,60,-23,33
Cowdenbeath,7827,10,5,10,21,24,54,-30,25
Montrose,7828,1,24,7,5,61,34,27,79
Peterhead,7828,2,24,4,8,80,38,42,76
Stirling,7828,3,17,6,13,62,52,10,57
Clyde,7828,4,15,9,12,54,49,5,54
Stenhousem'r,7828,5,15,8,13,56,48,8,53
Elgin,7828,6,14,6,16,53,62,-9,48
Annan Athlet,7828,7,11,12,13,48,42,6,45
Berwick,7828,8,8,10,18,30,61,-31,34
Edinburgh Ci,7828,9,7,9,20,36,63,-27,30
Cowdenbeath,7828,10,4,11,21,24,55,-31,23
Montrose,7829,1,24,7,5,61,34,27,79
Peterhead,7829,2,24,4,8,81,38,43,76
Stirling,7829,3,17,6,13,62,52,10,57
Stenhousem'r,7829,4,15,8,13,56,48,8,53
Clyde,7829,5,14,9,13,51,49,2,51
Elgin,7829,6,14,6,16,53,62,-9,48
Annan Athlet,7829,7,12,11,13,50,41,9,47
Berwick,7829,8,9,10,17,30,58,-28,37
Edinburgh Ci,7829,9,7,9,20,36,64,-28,30
Cowdenbeath,7829,10,4,10,22,23,57,-34,22
Montrose,7830,1,24,7,5,60,34,26,79
Peterhead,7830,2,24,4,8,79,38,41,76
Stirling,7830,3,17,6,13,63,51,12,57
Stenhousem'r,7830,4,15,8,13,55,49,6,53
Clyde,7830,5,14,9,13,53,51,2,51
Elgin,7830,6,14,6,16,53,61,-8,48
Annan Athlet,7830,7,12,11,13,49,41,8,47
Berwick,7830,8,9,10,17,32,60,-28,37
Edinburgh Ci,7830,9,7,9,20,36,62,-26,30
Cowdenbeath,7830,10,4,10,22,23,56,-33,22
Montrose,7831,1,23,8,5,59,34,25,77
Peterhead,7831,2,24,4,8,82,39,43,76
Stenhousem'r,7831,3,16,8,12,56,46,10,56
Stirling,7831,4,16,6,14,60,52,8,54
Clyde,7831,5,15,9,12,52,48,4,54
Elgin,7831,6,14,7,15,53,60,-7,49
Annan Athlet,7831,7,11,12,13,47,41,6,45
Berwick,7831,8,8,10,18,29,59,-30,34
Edinburgh Ci,7831,9,7,9,20,37,65,-28,30
Cowdenbeath,7831,10,4,11,21,23,54,-31,23
Montrose,7832,1,24,7,5,62,35,27,79
Peterhead,7832,2,24,4,8,80,39,41,76
Stenhousem'r,7832,3,16,8,12,57,47,10,56
Stirling,7832,4,16,6,14,61,53,8,54
Clyde,7832,5,15,9,12,55,48,7,54
Elgin,7832,6,14,6,16,54,63,-9,48
Annan Athlet,7832,7,11,12,13,47,41,6,45
Berwick,7832,8,8,10,18,29,62,-33,34
Edinburgh Ci,7832,9,7,9,20,37,63,-26,30
Cowdenbeath,7832,10,4,11,21,23,54,-31,23
Montrose,7833,1,23,8,5,60,35,25,77
Peterhead,7833,2,24,4,8,79,39,40,76
Stirling,7833,3,17,6,13,65,53,12,57
Stenhousem'r,7833,4,15,8,13,57,51,6,53
Clyde,7833,5,14,10,12,51,48,3,52
Elgin,7833,6,14,7,15,54,61,-7,49
Annan Athlet,7833,7,11,12,13,48,42,6,45
Berwick,7833,8,8,11,17,29,58,-29,35
Edinburgh Ci,7833,9,7,9,20,37,62,-25,30
Cowdenbeath,7833,10,4,11,21,24,55,-31,23
Montrose,7834,1,24,7,5,62,35,27,79
Peterhead,7834,2,23,4,9,77,39,38,73
Stirling,7834,3,16,7,13,62,53,9,55
Stenhousem'r,7834,4,15,9,12,57,48,9,54
Clyde,7834,5,14,10,12,53,50,3,52
Elgin,7834,6,14,6,16,54,63,-9,48
Annan Athlet,7834,7,11,12,13,48,42,6,45
Berwick,7834,8,8,11,17,31,60,-29,35
Edinburgh Ci,7834,9,8,9,19,37,60,-23,33
Cowdenbeath,7834,10,4,11,21,24,55,-31,23
Peterhead,7835,1,24,4,8,81,39,42,76
Montrose,7835,2,23,7,6,59,36,23,76
Stirling,7835,3,17,6,13,63,51,12,57
Stenhousem'r,7835,4,15,8,13,55,49,6,53
Clyde,7835,5,14,10,12,51,48,3,52
Elgin,7835,6,15,6,15,55,60,-5,51
Annan Athlet,7835,7,12,11,13,49,42,7,47
Berwick,7835,8,8,11,17,29,58,-29,35
Edinburgh Ci,7835,9,7,9,20,37,64,-27,30
Cowdenbeath,7835,10,4,10,22,24,56,-32,22
Montrose,7836,1,24,7,5,61,34,27,79
Peterhead,7836,2,24,4,8,79,38,41,76
Stirling,7836,3,17,6,13,61,51,10,57
Stenhousem'r,7836,4,15,8,13,55,47,8,53
Clyde,7836,5,14,10,12,53,50,3,52
Elgin,7836,6,14,6,16,53,62,-9,48
Annan Athlet,7836,7,12,11,13,48,41,7,47
Berwick,7836,8,8,11,17,31,60,-29,35
Edinburgh Ci,7836,9,7,9,20,36,62,-26,30
Cowdenbeath,7836,10,4,10,22,23,55,-32,22
Montrose,7837,1,24,7,5,61,35,26,79
Peterhead,7837,2,24,4,8,83,38,45,76
Stenhousem'r,7837,3,16,8,12,56,46,10,56
Stirling,7837,4,16,6,14,60,52,8,54
Clyde,7837,5,14,10,12,52,49,3,52
Elgin,7837,6,14,6,16,54,62,-8,48
Annan Athlet,7837,7,11,11,14,47,42,5,44
Berwick,7837,8,8,11,17,30,59,-29,35
Edinburgh Ci,7837,9,7,9,20,36,66,-30,30
Cowdenbeath,7837,10,5,10,21,24,54,-30,25
Montrose,7838,1,23,8,5,60,35,25,77
Peterhead,7838,2,24,4,8,80,38,42,76
Stirling,7838,3,17,6,13,62,51,11,57
Stenhousem'r,7838,4,15,8,13,55,48,7,53
Clyde,7838,5,14,9,13,52,50,2,51
Elgin,7838,6,14,7,15,54,61,-7,49
Annan Athlet,7838,7,11,11,14,47,42,5,44
Berwick,7838,8,9,10,17,31,59,-28,37
Edinburgh Ci,7838,9,7,9,20,36,63,-27,30
Cowdenbeath,7838,10,5,10,21,24,54,-30,25
Montrose,7839,1,24,7,5,63,34,29,79
Peterhead,7839,2,24,4,8,79,39,40,76
Stirling,7839,3,17,6,13,63,52,11,57
Clyde,7839,4,15,9,12,53,48,5,54
Stenhousem'r,7839,5,15,8,13,56,49,7,53
Elgin,7839,6,14,6,16,53,64,-11,48
Annan Athlet,7839,7,11,12,13,48,42,6,45
Berwick,7839,8,8,10,18,29,60,-31,34
Edinburgh Ci,7839,9,7,9,20,37,62,-25,30
Cowdenbeath,7839,10,4,11,21,24,55,-31,23
Montrose,7840,1,23,8,5,60,35,25,77
Peterhead,7840,2,24,4,8,81,38,43,76
Stirling,7840,3,16,7,13,60,51,9,55
Stenhousem'r,7840,4,15,9,12,55,46,9,54
Clyde,7840,5,14,9,13,51,49,2,51
Elgin,7840,6,14,7,15,54,61,-7,49
Annan Athlet,7840,7,12,11,13,48,41,7,47
Berwick,7840,8,9,10,17,30,58,-28,37
Edinburgh Ci,7840,9,7,9,20,36,64,-28,30
Cowdenbeath,7840,10,4,10,22,23,55,-32,22
Montrose,7841,1,24,7,5,62,35,27,79
Peterhead,7841,2,24,4,8,79,38,41,76
Stirling,7841,3,17,6,13,63,53,10,57
Stenhousem'r,7841,4,15,8,13,57,49,8,53
Clyde,7841,5,14,9,13,51,49,2,51
Elgin,7841,6,14,6,16,54,63,-9,48
Annan Athlet,7841,7,11,11,14,47,43,4,44
Berwick,7841,8,9,10,17,30,58,-28,37
Edinburgh Ci,7841,9,7,9,20,36,62,-26,30
Cowdenbeath,7841,10,5,10,21,25,54,-29,25
Peterhead,7842,1,24,4,8,81,38,43,76
Montrose,7842,2,23,7,6,60,37,23,76
Stirling,7842,3,16,7,13,64,55,9,55
Stenhousem'r,7842,4,15,9,12,59,50,9,54
Clyde,7842,5,15,9,12,54,49,5,54
Elgin,7842,6,15,6,15,56,61,-5,51
Annan Athlet,7842,7,11,11,14,47,42,5,44
Berwick,7842,8,8,10,18,30,61,-31,34
Edinburgh Ci,7842,9,7,9,20,36,64,-28,30
Cowdenbeath,7842,10,5,10,21,24,54,-30,25
Montrose,7843,1,24,7,5,60,34,26,79
Peterhead,7843,2,23,4,9,78,40,38,73
Stirling,7843,3,16,7,13,62,53,9,55
Stenhousem'r,7843,4,15,9,12,57,48,9,54
Clyde,7843,5,14,9,13,51,51,0,51
Elgin,7843,6,14,6,16,53,61,-8,48
Annan Athlet,7843,7,11,11,14,48,43,5,44
Berwick,7843,8,9,10,17,32,58,-26,37
Edinburgh Ci,7843,9,8,9,19,38,61,-23,33
Cowdenbeath,7843,10,5,10,21,25,55,-30,25
Montrose,7844,1,24,7,5,61,35,26,79
Peterhead,7844,2,24,4,8,81,38,43,76
Stirling,7844,3,16,7,13,61,52,9,55
Stenhousem'r,7844,4,15,9,12,56,47,9,54
Clyde,7844,5,15,9,12,54,49,5,54
Elgin,7844,6,14,6,16,54,62,-8,48
Annan Athlet,7844,7,11,11,14,47,42,5,44
Berwick,7844,8,8,10,18,30,61,-31,34
Edinburgh Ci,7844,9,7,9,20,36,64,-28,30
Cowdenbeath,7844,10,5,10,21,24,54,-30,25
Montrose,7845,1,24,7,5,60,34,26,79
Peterhead,7845,2,24,4,8,79,39,40,76
Stirling,7845,3,17,6,13,62,52,10,57
Clyde,7845,4,15,9,12,54,48,6,54
Stenhousem'r,7845,5,15,8,13,56,48,8,53
Elgin,7845,6,14,6,16,53,61,-8,48
Annan Athlet,7845,7,12,11,13,48,41,7,47
Berwick,7845,8,8,10,18,29,61,-32,34
Edinburgh Ci,7845,9,7,9,20,37,62,-25,30
Cowdenbeath,7845,10,4,10,22,23,55,-32,22
Montrose,7846,1,23,8,5,60,35,25,77
Peterhead,7846,2,24,4,8,79,39,40,76
Stirling,7846,3,17,6,13,61,51,10,57
Stenhousem'r,7846,4,15,8,13,55,47,8,53
Clyde,7846,5,14,9,13,51,49,2,51
Elgin,7846,6,14,7,15,54,61,-7,49
Annan Athlet,7846,7,12,11,13,49,42,7,47
Berwick,7846,8,9,10,17,30,58,-28,37
Edinburgh Ci,7846,9,7,9,20,37,62,-25,30
Cowdenbeath,7846,10,4,10,22,24,56,-32,22
Montrose,7847,1,24,7,5,63,34,29,79
Peterhead,7847,2,24,4,8,81,39,42,76
Stenhousem'r,7847,3,16,8,12,57,47,10,56
Stirling,7847,4,16,6,14,61,53,8,54
Clyde,7847,5,14,9,13,52,50,2,51
Elgin,7847,6,14,6,16,53,64,-11,48
Annan Athlet,7847,7,12,11,13,48,41,7,47
Berwick,7847,8,9,10,17,31,59,-28,37
Edinburgh Ci,7847,9,7,9,20,37,64,-27,30
Cowdenbeath,7847,10,4,10,22,23,55,-32,22
Montrose,7848,1,24,7,5,60,34,26,79
Peterhead,7848,2,24,4,8,80,39,41,76
Stirling,7848,3,16,7,13,61,52,9,55
Stenhousem'r,7848,4,15,9,12,56,47,9,54
Clyde,7848,5,14,10,12,52,49,3,52
Elgin,7848,6,14,6,16,53,61,-8,48
Annan Athlet,7848,7,11,12,13,49,43,6,45
Berwick,7848,8,8,11,17,30,59,-29,35
Edinburgh Ci,7848,9,7,9,20,37,63,-26,30
Cowdenbeath,7848,10,4,11,21,25,56,-31,23
Montrose,7849,1,23,8,5,60,35,25,77
Peterhead,7849,2,24,4,8,80,39,41,76
Stirling,7849,3,16,7,13,61,52,9,55
Stenhousem'r,7849,4,15,9,12,56,47,9,54
Clyde,7849,5,15,9,12,56,50,6,54
Elgin,7849,6,14,7,15,54,61,-7,49
Annan Athlet,7849,7,11,12,13,47,41,6,45
Berwick,7849,8,8,10,18,31,63,-32,34
Edinburgh Ci,7849,9,7,9,20,37,63,-26,30
Cowdenbeath,7849,10,4,11,21,23,54,-31,23
Peterhead,7850,1,24,4,8,81,38,43,76
Montrose,7850,2,23,7,6,60,36,24,76
Stenhousem'r,7850,3,16,8,12,56,46,10,56
Stirling,7850,4,16,6,14,60,52,8,54
Clyde,7850,5,15,9,12,53,48,5,54
Elgin,7850,6,15,6,15,55,61,-6,51
Annan Athlet,7850,7,12,11,13,49,42,7,47
Berwick,7850,8,8,10,18,29,60,-31,34
Edinburgh Ci,7850,9,7,9,20,36,64,-28,30
Cowdenbeath,7850,10,4,10,22,24,56,-32,22
Montrose,7851,1,23,8,5,61,36,25,77
Peterhead,7851,2,24,4,8,78,38,40,76
Stirling,7851,3,16,7,13,63,54,9,55
Stenhousem'r,7851,4,15,9,12,58,49,9,54
Clyde,7851,5,14,10,12,53,50,3,52
Elgin,7851,6,14,7,15,55,62,-7,49
Annan Athlet,7851,7,12,11,13,49,42,7,47
Berwick,7851,8,8,11,17,31,60,-29,35
Edinburgh Ci,7851,9,7,9,20,36,61,-25,30
Cowdenbeath,7851,10,4,10,22,24,56,-32,22
Montrose,7852,1,24,7,5,62,34,28,79
Peterhead,7852,2,24,4,8,79,39,40,76
Stirling,7852,3,17,6,13,63,51,12,57
Clyde,7852,4,15,9,12,55,49,6,54
Stenhousem'r,7852,5,15,8,13,55,49,6,53
Elgin,7852,6,14,6,16,53,63,-10,48
Annan Athlet,7852,7,12,11,13,49,41,8,47
Berwick,7852,8,8,10,18,30,62,-32,34
Edinburgh Ci,7852,9,7,9,20,37,62,-25,30
Cowdenbeath,7852,10,4,10,22,23,56,-33,22
Montrose,7853,1,23,8,5,60,35,25,77
Peterhead,7853,2,24,4,8,79,39,40,76
Stenhousem'r,7853,3,16,8,12,59,47,12,56
Stirling,7853,4,16,6,14,61,55,6,54
Clyde,7853,5,14,10,12,52,49,3,52
Elgin,7853,6,14,7,15,54,61,-7,49
Annan Athlet,7853,7,11,11,14,47,42,5,44
Berwick,7853,8,8,11,17,30,59,-29,35
Edinburgh Ci,7853,9,7,9,20,37,62,-25,30
Cowdenbeath,7853,10,5,10,21,24,54,-30,25
Montrose,7854,1,24,7,5,60,34,26,79
Peterhead,7854,2,23,4,9,77,39,38,73
Stirling,7854,3,17,6,13,65,52,13,57
Stenhousem'r,7854,4,15,8,13,56,51,5,53
Clyde,7854,5,14,10,12,51,48,3,52
Elgin,7854,6,14,6,16,53,61,-8,48
Annan Athlet,7854,7,12,11,13,49,42,7,47
Berwick,7854,8,8,11,17,29,58,-29,35
Edinburgh Ci,7854,9,8,9,19,37,60,-23,33
Cowdenbeath,7854,10,4,10,22,24,56,-32,22
Montrose,7855,1,24,7,5,62,34,28,79
Peterhead,7855,2,24,4,8,80,38,42,76
Stenhousem'r,7855,3,16,8,12,56,46,10,56
Stirling,7855,4,16,6,14,60,52,8,54
Clyde,7855,5,15,9,12,54,48,6,54
Elgin,7855,6,14,6,16,53,63,-10,48
Annan Athlet,7855,7,11,12,13,49,43,6,45
Berwick,7855,8,8,10,18,29,61,-32,34
Edinburgh Ci,7855,9,7,9,20,36,63,-27,30
Cowdenbeath,7855,10,4,11,21,25,56,-31,23
Montrose,7856,1,24,7,5,61,35,26,79
Peterhead,7856,2,24,4,8,81,41,40,76
Stenhousem'r,7856,3,16,8,12,57,47,10,56
Stirling,7856,4,16,6,14,61,53,8,54
Clyde,7856,5,15,9,12,53,49,4,54
Elgin,7856,6,14,6,16,54,62,-8,48
Annan Athlet,7856,7,12,11,13,50,42,8,47
Berwick,7856,8,8,10,18,30,60,-30,34
Edinburgh Ci,7856,9,7,9,20,39,64,-25,30
Cowdenbeath,7856,10,4,10,22,24,57,-33,22
Montrose,7857,1,24,7,5,64,34,30,79
Peterhead,7857,2,24,4,8,80,38,42,76
Stenhousem'r,7857,3,16,8,12,56,46,10,56
Stirling,7857,4,16,6,14,60,52,8,54
Clyde,7857,5,15,9,12,53,48,5,54
Elgin,7857,6,14,6,16,53,65,-12,48
Annan Athlet,7857,7,11,12,13,48,42,6,45
Berwick,7857,8,8,10,18,29,60,-31,34
Edinburgh Ci,7857,9,7,9,20,36,63,-27,30
Cowdenbeath,7857,10,4,11,21,24,55,-31,23
Montrose,7858,1,24,7,5,62,34,28,79
Peterhead,7858,2,23,4,9,77,40,37,73
Stenhousem'r,7858,3,16,8,12,57,47,10,56
Stirling,7858,4,16,6,14,61,53,8,54
Clyde,7858,5,15,9,12,54,49,5,54
Elgin,7858,6,14,6,16,53,63,-10,48
Annan Athlet,7858,7,11,11,14,47,42,5,44
Berwick,7858,8,8,10,18,30,61,-31,34
Edinburgh Ci,7858,9,8,9,19,38,60,-22,33
Cowdenbeath,7858,10,5,10,21,24,54,-30,25
Montrose,7859,1,23,8,5,59,34,25,77
Peterhead,7859,2,23,5,8,79,40,39,74
Stenhousem'r,7859,3,16,8,12,57,47,10,56
Stirling,7859,4,16,6,14,61,53,8,54
Clyde,7859,5,14,9,13,52,50,2,51
Elgin,7859,6,14,7,15,53,60,-7,49
Annan Athlet,7859,7,11,11,14,47,42,5,44
Berwick,7859,8,9,10,17,31,59,-28,37
Edinburgh Ci,7859,9,7,10,19,38,62,-24,31
Cowdenbeath,7859,10,5,10,21,24,54,-30,25
Montrose,7860,1,24,7,5,63,34,29,79
Peterhead,7860,2,24,4,8,79,39,40,76
Stirling,7860,3,17,6,13,63,51,12,57
Stenhousem'r,7860,4,15,8,13,55,49,6,53
Clyde,7860,5,14,10,12,51,48,3,52
Elgin,7860,6,14,6,16,53,64,-11,48
Annan Athlet,7860,7,12,11,13,50,41,9,47
Berwick,7860,8,8,11,17,29,58,-29,35
Edinburgh Ci,7860,9,7,9,20,37,62,-25,30
Cowdenbeath,7860,10,4,10,22,23,57,-34,22
Peterhead,7861,1,24,4,8,80,40,40,76
Montrose,7861,2,23,7,6,59,35,24,76
Stenhousem'r,7861,3,16,8,12,59,47,12,56
Stirling,7861,4,16,6,14,61,55,6,54
Clyde,7861,5,14,9,13,51,49,2,51
Elgin,7861,6,15,6,15,54,60,-6,51
Annan Athlet,7861,7,12,11,13,48,41,7,47
Berwick,7861,8,9,10,17,30,58,-28,37
Edinburgh Ci,7861,9,7,9,20,38,63,-25,30
Cowdenbeath,7861,10,4,10,22,23,55,-32,22
Montrose,7862,1,24,7,5,62,35,27,79
Peterhead,7862,2,23,4,9,78,40,38,73
Stirling,7862,3,17,6,13,62,51,11,57
Clyde,7862,4,15,9,12,52,48,4,54
Stenhousem'r,7862,5,15,8,13,55,48,7,53
Elgin,7862,6,14,6,16,54,63,-9,48
Annan Athlet,7862,7,12,11,13,48,41,7,47
Berwick,7862,8,8,10,18,29,59,-30,34
Edinburgh Ci,7862,9,8,9,19,38,61,-23,33
Cowdenbeath,7862,10,4,10,22,23,55,-32,22
Peterhead,7863,1,24,4,8,79,38,41,76
Montrose,7863,2,23,7,6,60,36,24,76
Stirling,7863,3,17,6,13,62,51,11,57
Stenhousem'r,7863,4,15,8,13,55,48,7,53
Clyde,7863,5,14,10,12,51,48,3,52
Elgin,7863,6,15,6,15,55,61,-6,51
Annan Athlet,7863,7,11,12,13,48,42,6,45
Berwick,7863,8,8,11,17,29,58,-29,35
Edinburgh Ci,7863,9,7,9,20,36,62,-26,30
Cowdenbeath,7863,10,4,11,21,24,55,-31,23
Montrose,7864,1,23,8,5,60,35,25,77
Peterhead,7864,2,24,4,8,80,38,42,76
Stirling,7864,3,17,6,13,61,51,10,57
Clyde,7864,4,15,9,12,55,50,5,54
Stenhousem'r,7864,5,15,8,13,55,47,8,53
Elgin,7864,6,14,7,15,54,61,-7,49
Annan Athlet,7864,7,11,12,13,48,42,6,45
Berwick,7864,8,8,10,18,31,62,-31,34
Edinburgh Ci,7864,9,7,9,20,36,63,-27,30
Cowdenbeath,7864,10,4,11,21,24,55,-31,23
Montrose,7865,1,24,7,5,62,34,28,79
Peterhead,7865,2,24,4,8,78,38,40,76
Stirling,7865,3,17,6,13,64,51,13,57
Stenhousem'r,7865,4,15,8,13,55,50,5,53
Clyde,7865,5,14,9,13,51,49,2,51
Elgin,7865,6,14,6,16,53,63,-10,48
Annan Athlet,7865,7,11,11,14,48,43,5,44
Berwick,7865,8,9,10,17,30,58,-28,37
Edinburgh Ci,7865,9,7,9,20,36,61,-25,30
Cowdenbeath,7865,10,5,10,21,25,55,-30,25
Montrose,7866,1,24,7,5,62,34,28,79
Peterhead,7866,2,24,4,8,83,40,43,76
Stirling,7866,3,16,7,13,60,51,9,55
Stenhousem'r,7866,4,15,9,12,55,46,9,54
Clyde,7866,5,15,9,12,52,48,4,54
Elgin,7866,6,14,6,16,53,63,-10,48
Annan Athlet,7866,7,12,11,13,48,41,7,47
Berwick,7866,8,8,10,18,29,59,-30,34
Edinburgh Ci,7866,9,7,9,20,38,66,-28,30
Cowdenbeath,7866,10,4,10,22,23,55,-32,22
Montrose,7867,1,23,8,5,60,35,25,77
Peterhead,7867,2,24,4,8,78,38,40,76
Stirling,7867,3,17,6,13,62,52,10,57
Stenhousem'r,7867,4,15,8,13,56,48,8,53
Clyde,7867,5,14,10,12,52,49,3,52
Elgin,7867,6,14,7,15,54,61,-7,49
Annan Athlet,7867,7,11,11,14,47,42,5,44
Berwick,7867,8,8,11,17,30,59,-29,35
Edinburgh Ci,7867,9,7,9,20,36,61,-25,30
Cowdenbeath,7867,10,5,10,21,24,54,-30,25
Peterhead,7868,1,24,4,8,81,38,43,76
Montrose,7868,2,23,7,6,62,40,22,76
Stirling,7868,3,17,6,13,63,52,11,57
Stenhousem'r,7868,4,15,8,13,56,49,7,53
Clyde,7868,5,14,10,12,53,50,3,52
Elgin,7868,6,15,6,15,59,63,-4,51
Annan Athlet,7868,7,11,11,14,47,44,3,44
Berwick,7868,8,8,11,17,31,60,-29,35
Edinburgh Ci,7868,9,7,9,20,36,64,-28,30
Cowdenbeath,7868,10,5,10,21,26,54,-28,25
Montrose,7869,1,24,7,5,62,36,26,79
Peterhead,7869,2,24,4,8,79,38,41,76
Stirling,7869,3,17,6,13,62,51,11,57
Clyde,7869,4,15,9,12,53,49,4,54
Stenhousem'r,7869,5,15,8,13,55,48,7,53
Elgin,7869,6,14,6,16,55,63,-8,48
Annan Athlet,7869,7,11,12,13,47,41,6,45
Berwick,7869,8,8,10,18,30,60,-30,34
Edinburgh Ci,7869,9,7,9,20,36,62,-26,30
Cowdenbeath,7869,10,4,11,21,23,54,-31,23
Montrose,7870,1,24,7,5,62,34,28,79
Peterhead,7870,2,24,4,8,81,38,43,76
Stirling,7870,3,16,7,13,62,53,9,55
Stenhousem'r,7870,4,15,9,12,57,48,9,54
Clyde,7870,5,15,9,12,52,48,4,54
Elgin,7870,6,14,6,16,53,63,-10,48
Annan Athlet,7870,7,11,11,14,48,43,5,44
Berwick,7870,8,8,10,18,29,59,-30,34
Edinburgh Ci,7870,9,7,9,20,36,64,-28,30
Cowdenbeath,7870,10,5,10,21,25,55,-30,25
Peterhead,7871,1,24,4,8,81,38,43,76
Montrose,7871,2,23,7,6,60,36,24,76
Stirling,7871,3,16,7,13,61,52,9,55
Stenhousem'r,7871,4,15,9,12,56,47,9,54
Clyde,7871,5,15,9,12,53,48,5,54
Elgin,7871,6,15,6,15,55,61,-6,51
Annan Athlet,7871,7,11,11,14,48,43,5,44
Berwick,7871,8,8,10,18,29,60,-31,34
Edinburgh Ci,7871,9,7,9,20,36,64,-28,30
Cowdenbeath,7871,10,5,10,21,25,55,-30,25
Montrose,7872,1,24,7,5,62,36,26,79
Peterhead,7872,2,23,5,8,79,40,39,74
Stenhousem'r,7872,3,16,8,12,56,46,10,56
Stirling,7872,4,16,6,14,60,52,8,54
Clyde,7872,5,14,9,13,53,51,2,51
Elgin,7872,6,14,6,16,55,63,-8,48
Annan Athlet,7872,7,12,11,13,49,41,8,47
Berwick,7872,8,9,10,17,32,60,-28,37
Edinburgh Ci,7872,9,7,10,19,38,62,-24,31
Cowdenbeath,7872,10,4,10,22,23,56,-33,22
Montrose,7873,1,24,7,5,65,35,30,79
Peterhead,7873,2,24,4,8,81,39,42,76
Stirling,7873,3,16,7,13,62,53,9,55
Stenhousem'r,7873,4,15,9,12,57,48,9,54
Clyde,7873,5,14,10,12,53,50,3,52
Elgin,7873,6,14,6,16,54,66,-12,48
Annan Athlet,7873,7,11,12,13,49,43,6,45
Berwick,7873,8,8,11,17,31,60,-29,35
Edinburgh Ci,7873,9,7,9,20,37,64,-27,30
Cowdenbeath,7873,10,4,11,21,25,56,-31,23
Peterhead,7874,1,24,4,8,78,38,40,76
Montrose,7874,2,23,7,6,60,37,23,76
Stirling,7874,3,16,7,13,61,52,9,55
Stenhousem'r,7874,4,15,9,12,56,47,9,54
Clyde,7874,5,15,9,12,53,49,4,54
Elgin,7874,6,15,6,15,56,61,-5,51
Annan Athlet,7874,7,11,11,14,47,43,4,44
Berwick,7874,8,8,10,18,30,60,-30,34
Edinburgh Ci,7874,9,7,9,20,36,61,-25,30
Cowdenbeath,7874,10,5,10,21,25,54,-29,25
Montrose,7875,1,24,7,5,61,34,27,79
Peterhead,7875,2,24,4,8,82,40,42,76
Stirling,7875,3,17,6,13,62,51,11,57
Clyde,7875,4,15,9,12,53,49,4,54
Stenhousem'r,7875,5,15,8,13,55,48,7,53
Elgin,7875,6,14,6,16,53,62,-9,48
Annan Athlet,7875,7,12,11,13,48,41,7,47
Berwick,7875,8,8,10,18,30,60,-30,34
Edinburgh Ci,7875,9,7,9,20,38,65,-27,30
Cowdenbeath,7875,10,4,10,22,23,55,-32,22
Montrose,7876,1,24,7,5,60,34,26,79
Peterhead,7876,2,24,4,8,80,39,41,76
Stirling,7876,3,17,6,13,62,51,11,57
Clyde,7876,4,15,9,12,54,48,6,54
Stenhousem'r,7876,5,15,8,13,55,48,7,53
Elgin,7876,6,14,6,16,53,61,-8,48
Annan Athlet,7876,7,11,11,14,48,43,5,44
Berwick,7876,8,8,10,18,29,61,-32,34
Edinburgh Ci,7876,9,7,9,20,37,63,-26,30
Cowdenbeath,7876,10,5,10,21,25,55,-30,25
Montrose,7877,1,24,7,5,62,36,26,79
Peterhead,7877,2,24,4,8,79,39,40,76
Stirling,7877,3,17,6,13,63,53,10,57
Clyde,7877,4,15,9,12,52,48,4,54
Stenhousem'r,7877,5,15,8,13,57,49,8,53
Elgin,7877,6,14,6,16,55,63,-8,48
Annan Athlet,7877,7,11,12,13,47,41,6,45
Berwick,7877,8,8,10,18,29,59,-30,34
Edinburgh Ci,7877,9,7,9,20,37,62,-25,30
Cowdenbeath,7877,10,4,11,21,23,54,-31,23
Montrose,7878,1,24,7,5,62,36,26,79
Peterhead,7878,2,24,4,8,82,38,44,76
Stirling,7878,3,17,6,13,64,52,12,57
Clyde,7878,4,15,9,12,54,50,4,54
Stenhousem'r,7878,5,15,8,13,56,50,6,53
Elgin,7878,6,14,6,16,55,63,-8,48
Annan Athlet,7878,7,12,11,13,49,41,8,47
Berwick,7878,8,8,10,18,31,61,-30,34
Edinburgh Ci,7878,9,7,9,20,36,65,-29,30
Cowdenbeath,7878,10,4,10,22,23,56,-33,22
Peterhead,7879,1,24,4,8,80,40,40,76
Montrose,7879,2,23,7,6,59,37,22,76
Stirling,7879,3,17,6,13,63,51,12,57
Clyde,7879,4,15,9,12,53,49,4,54
Stenhousem'r,7879,5,15,8,13,55,49,6,53
Elgin,7879,6,15,6,15,56,60,-4,51
Annan Athlet,7879,7,12,11,13,49,42,7,47
Berwick,7879,8,8,10,18,30,60,-30,34
Edinburgh Ci,7879,9,7,9,20,38,63,-25,30
Cowdenbeath,7879,10,4,10,22,24,56,-32,22
Montrose,7880,1,24,7,5,62,36,26,79
Peterhead,7880,2,23,5,8,78,39,39,74
Stenhousem'r,7880,3,16,8,12,58,48,10,56
Stirling,7880,4,16,6,14,62,54,8,54
Clyde,7880,5,15,9,12,52,48,4,54
Elgin,7880,6,14,6,16,55,63,-8,48
Annan Athlet,7880,7,11,11,14,47,44,3,44
Berwick,7880,8,8,10,18,29,59,-30,34
Edinburgh Ci,7880,9,7,10,19,37,61,-24,31
Cowdenbeath,7880,10,5,10,21,26,54,-28,25
Montrose,7881,1,23,8,5,60,35,25,77
Peterhead,7881,2,24,4,8,80,38,42,76
Stenhousem'r,7881,3,16,8,12,58,48,10,56
Stirling,7881,4,16,6,14,62,54,8,54
Clyde,7881,5,14,9,13,51,49,2,51
Elgin,7881,6,14,7,15,54,61,-7,49
Annan Athlet,7881,7,11,12,13,49,43,6,45
Berwick,7881,8,9,10,17,30,58,-28,37
Edinburgh Ci,7881,9,7,9,20,36,63,-27,30
Cowdenbeath,7881,10,4,11,21,25,56,-31,23
Peterhead,7882,1,24,4,8,80,38,42,76
Montrose,7882,2,23,7,6,59,35,24,76
Stirling,7882,3,16,7,13,62,53,9,55
Stenhousem'r,7882,4,15,9,12,57,48,9,54
Clyde,7882,5,15,9,12,55,48,7,54
Elgin,7882,6,15,6,15,54,60,-6,51
Annan Athlet,7882,7,11,11,14,47,42,5,44
Berwick,7882,8,8,10,18,29,62,-33,34
Edinburgh Ci,7882,9,7,9,20,36,63,-27,30
Cowdenbeath,7882,10,5,10,21,24,54,-30,25
Montrose,7883,1,24,7,5,61,35,26,79
Peterhead,7883,2,24,4,8,78,38,40,76
Stirling,7883,3,16,7,13,61,52,9,55
Stenhousem'r,7883,4,15,9,12,56,47,9,54
Clyde,7883,5,15,9,12,53,48,5,54
Elgin,7883,6,14,6,16,54,62,-8,48
Annan Athlet,7883,7,12,11,13,48,41,7,47
Berwick,7883,8,8,10,18,29,60,-31,34
Edinburgh Ci,7883,9,7,9,20,36,61,-25,30
Cowdenbeath,7883,10,4,10,22,23,55,-32,22
Montrose,7884,1,23,7,6,59,37,22,76
Peterhead,7884,2,23,4,9,78,40,38,73
Stirling,7884,3,17,6,13,65,51,14,57
Stenhousem'r,7884,4,15,8,13,55,51,4,53
Clyde,7884,5,14,10,12,51,48,3,52
Elgin,7884,6,15,6,15,56,60,-4,51
Annan Athlet,7884,7,11,11,14,47,42,5,44
Berwick,7884,8,8,11,17,29,58,-29,35
Edinburgh Ci,7884,9,8,9,19,38,61,-23,33
Cowdenbeath,7884,10,5,10,21,24,54,-30,25
Montrose,7885,1,24,7,5,64,35,29,79
Peterhead,7885,2,24,4,8,78,38,40,76
Stirling,7885,3,17,6,13,65,55,10,57
Stenhousem'r,7885,4,15,8,13,59,51,8,53
Clyde,7885,5,14,9,13,51,49,2,51
Elgin,7885,6,14,6,16,54,65,-11,48
Annan Athlet,7885,7,11,11,14,47,42,5,44
Berwick,7885,8,9,10,17,30,58,-28,37
Edinburgh Ci,7885,9,7,9,20,36,61,-25,30
Cowdenbeath,7885,10,5,10,21,24,54,-30,25
Peterhead,7886,1,24,4,8,79,38,41,76
Montrose,7886,2,23,7,6,59,35,24,76
Stenhousem'r,7886,3,16,8,12,58,46,12,56
Stirling,7886,4,16,6,14,60,54,6,54
Clyde,7886,5,14,10,12,53,50,3,52
Elgin,7886,6,15,6,15,54,60,-6,51
Annan Athlet,7886,7,12,11,13,48,41,7,47
Berwick,7886,8,8,11,17,31,60,-29,35
Edinburgh Ci,7886,9,7,9,20,36,62,-26,30
Cowdenbeath,7886,10,4,10,22,23,55,-32,22
Peterhead,7887,1,24,4,8,78,38,40,76
Montrose,7887,2,23,7,6,59,36,23,76
Stirling,7887,3,17,6,13,62,52,10,57
Stenhousem'r,7887,4,15,8,13,56,48,8,53
Clyde,7887,5,14,10,12,52,49,3,52
Elgin,7887,6,15,6,15,55,60,-5,51
Annan Athlet,7887,7,11,12,13,49,43,6,45
Berwick,7887,8,8,11,17,30,59,-29,35
Edinburgh Ci,7887,9,7,9,20,36,61,-25,30
Cowdenbeath,7887,10,4,11,21,25,56,-31,23
Montrose,7888,1,23,8,5,61,36,25,77
Peterhead,7888,2,24,4,8,82,39,43,76
Stenhousem'r,7888,3,16,8,12,57,47,10,56
Stirling,7888,4,16,6,14,61,53,8,54
Clyde,7888,5,15,9,12,56,49,7,54
Elgin,7888,6,14,7,15,55,62,-7,49
Annan Athlet,7888,7,11,12,13,47,41,6,45
Berwick,7888,8,8,10,18,30,63,-33,34
Edinburgh Ci,7888,9,7,9,20,37,65,-28,30
Cowdenbeath,7888,10,4,11,21,23,54,-31,23
Montrose,7889,1,23,8,5,61,36,25,77
Peterhead,7889,2,24,4,8,79,39,40,76
Stenhousem'r,7889,3,16,8,12,60,49,11,56
Stirling,7889,4,16,6,14,63,56,7,54
Clyde,7889,5,15,9,12,52,48,4,54
Elgin,7889,6,14,7,15,55,62,-7,49
Annan Athlet,7889,7,12,11,13,50,43,7,47
Berwick,7889,8,8,10,18,29,59,-30,34
Edinburgh Ci,7889,9,7,9,20,37,62,-25,30
Cowdenbeath,7889,10,4,10,22,25,57,-32,22
Montrose,7890,1,24,7,5,64,36,28,79
Peterhead,7890,2,24,4,8,80,39,41,76
Stirling,7890,3,16,7,13,61,52,9,55
Stenhousem'r,7890,4,15,9,12,56,47,9,54
Clyde,7890,5,14,9,13,51,49,2,51
Elgin,7890,6,14,6,16,55,65,-10,48
Annan Athlet,7890,7,11,11,14,47,44,3,44
Berwick,7890,8,9,10,17,30,58,-28,37
Edinburgh Ci,7890,9,7,9,20,37,63,-26,30
Cowdenbeath,7890,10,5,10,21,26,54,-28,25
Montrose,7891,1,24,7,5,62,36,26,79
Peterhead,7891,2,24,4,8,83,38,45,76
Stirling,7891,3,16,7,13,62,53,9,55
Stenhousem'r,7891,4,15,9,12,57,48,9,54
Clyde,7891,5,14,9,13,52,50,2,51
Elgin,7891,6,14,6,16,55,63,-8,48
Annan Athlet,7891,7,11,12,13,49,43,6,45
Berwick,7891,8,9,10,17,31,59,-28,37
Edinburgh Ci,7891,9,7,9,20,36,66,-30,30
Cowdenbeath,7891,10,4,11,21,25,56,-31,23
Montrose,7892,1,24,7,5,62,35,27,79
Peterhead,7892,2,24,4,8,81,40,41,76
Stirling,7892,3,16,7,13,60,51,9,55
Stenhousem'r,7892,4,15,9,12,55,46,9,54
Clyde,7892,5,14,9,13,51,51,0,51
Elgin,7892,6,14,6,16,54,63,-9,48
Annan Athlet,7892,7,11,11,14,47,43,4,44
Berwick,7892,8,9,10,17,32,58,-26,37
Edinburgh Ci,7892,9,7,9,20,38,64,-26,30
Cowdenbeath,7892,10,5,10,21,25,54,-29,25
Montrose,7893,1,23,8,5,61,36,25,77
Peterhead,7893,2,24,4,8,80,39,41,76
Stirling,7893,3,16,7,13,61,52,9,55
Stenhousem'r,7893,4,15,9,12,56,47,9,54
Clyde,7893,5,15,9,12,55,48,7,54
Elgin,7893,6,14,7,15,55,62,-7,49
Annan Athlet,7893,7,12,11,13,49,42,7,47
Berwick,7893,8,8,10,18,29,62,-33,34
Edinburgh Ci,7893,9,7,9,20,37,63,-26,30
Cowdenbeath,7893,10,4,10,22,24,56,-32,22
Montrose,7894,1,24,7,5,61,34,27,79
Peterhead,7894,2,23,4,9,78,41,37,73
Stenhousem'r,7894,3,16,8,12,59,48,11,56
Stirling,7894,4,16,6,14,62,55,7,54
Clyde,7894,5,14,9,13,52,52,0,51
Elgin,7894,6,14,6,16,53,62,-9,48
Annan Athlet,7894,7,11,11,14,48,43,5,44
Berwick,7894,8,9,10,17,33,59,-26,37
Edinburgh Ci,7894,9,8,9,19,39,61,-22,33
Cowdenbeath,7894,10,5,10,21,25,55,-30,25
Montrose,7895,1,24,7,5,61,35,26,79
Peterhead,7895,2,24,4,8,83,40,43,76
Stirling,7895,3,17,6,13,62,52,10,57
Clyde,7895,4,15,9,12,56,49,7,54
Stenhousem'r,7895,5,15,8,13,56,48,8,53
Elgin,7895,6,14,6,16,54,62,-8,48
Annan Athlet,7895,7,12,11,13,49,41,8,47
Berwick,7895,8,8,10,18,30,63,-33,34
Edinburgh Ci,7895,9,7,9,20,38,66,-28,30
Cowdenbeath,7895,10,4,10,22,23,56,-33,22
Peterhead,7896,1,24,4,8,80,40,40,76
Montrose,7896,2,23,7,6,59,35,24,76
Stenhousem'r,7896,3,16,8,12,57,47,10,56
Stirling,7896,4,16,6,14,61,53,8,54
Clyde,7896,5,15,9,12,54,49,5,54
Elgin,7896,6,15,6,15,54,60,-6,51
Annan Athlet,7896,7,12,11,13,49,41,8,47
Berwick,7896,8,8,10,18,30,61,-31,34
Edinburgh Ci,7896,9,7,9,20,38,63,-25,30
Cowdenbeath,7896,10,4,10,22,23,56,-33,22
Montrose,7897,1,23,8,5,61,36,25,77
Peterhead,7897,2,24,4,8,79,39,40,76
Stenhousem'r,7897,3,16,8,12,57,47,10,56
Stirling,7897,4,16,6,14,61,53,8,54
Clyde,7897,5,15,9,12,52,48,4,54
Elgin,7897,6,14,7,15,55,62,-7,49
Annan Athlet,7897,7,12,11,13,49,42,7,47
Berwick,7897,8,8,10,18,29,59,-30,34
Edinburgh Ci,7897,9,7,9,20,37,62,-25,30
Cowdenbeath,7897,10,4,10,22,24,56,-32,22
Montrose,7898,1,23,8,5,60,35,25,77
Peterhead,7898,2,24,4,8,81,41,40,76
Stirling,7898,3,17,6,13,62,51,11,57
Clyde,7898,4,15,9,12,53,48,5,54
Stenhousem'r,7898,5,15,8,13,55,48,7,53
Elgin,7898,6,14,7,15,54,61,-7,49
Annan Athlet,7898,7,11,11,14,47,42,5,44
Berwick,7898,8,8,10,18,29,60,-31,34
Edinburgh Ci,7898,9,7,9,20,39,64,-25,30
Cowdenbeath,7898,10,5,10,21,24,54,-30,25
Peterhead,7899,1,24,4,8,80,38,42,76
Montrose,7899,2,23,7,6,60,36,24,76
Stenhousem'r,7899,3,16,8,12,59,48,11,56
Stirling,7899,4,16,6,14,62,55,7,54
Clyde,7899,5,15,9,12,54,48,6,54
Elgin,7899,6,15,6,15,55,61,-6,51
Annan Athlet,7899,7,12,11,13,49,41,8,47
Berwick,7899,8,8,10,18,29,61,-32,34
Edinburgh Ci,7899,9,7,9,20,36,63,-27,30
Cowdenbeath,7899,10,4,10,22,23,56,-33,22
Montrose,7900,1,23,8,5,60,35,25,77
Peterhead,7900,2,24,4,8,80,40,40,76
Stirling,7900,3,17,6,13,63,53,10,57
Stenhousem'r,7900,4,15,8,13,57,49,8,53
Clyde,7900,5,14,10,12,51,48,3,52
Elgin,7900,6,14,7,15,54,61,-7,49
Annan Athlet,7900,7,11,12,13,47,41,6,45
Berwick,7900,8,8,11,17,29,58,-29,35
Edinburgh Ci,7900,9,7,9,20,38,63,-25,30
Cowdenbeath,7900,10,4,11,21,23,54,-31,23
Montrose,7901,1,24,7,5,62,34,28,79
Peterhead,7901,2,24,4,8,81,39,42,76
Stirling,7901,3,17,6,13,63,51,12,57
Clyde,7901,4,15,9,12,54,50,4,54
Stenhousem'r,7901,5,15,8,13,55,49,6,53
Elgin,7901,6,14,6,16,53,63,-10,48
Annan Athlet,7901,7,12,11,13,48,41,7,47
Berwick,7901,8,8,10,18,31,61,-30,34
Edinburgh Ci,7901,9,7,9,20,37,64,-27,30
Cowdenbeath,7901,10,4,10,22,23,55,-32,22
Montrose,7902,1,24,7,5,61,35,26,79
Peterhead,7902,2,24,4,8,78,38,40,76
Stenhousem'r,7902,3,16,8,12,58,46,12,56
Stirling,7902,4,16,6,14,60,54,6,54
Clyde,7902,5,15,9,12,53,48,5,54
Elgin,7902,6,14,6,16,54,62,-8,48
Annan Athlet,7902,7,12,11,13,48,41,7,47
Berwick,7902,8,8,10,18,29,60,-31,34
Edinburgh Ci,7902,9,7,9,20,36,61,-25,30
Cowdenbeath,7902,10,4,10,22,23,55,-32,22
Montrose,7903,1,24,7,5,62,35,27,79
Peterhead,7903,2,24,4,8,78,38,40,76
Stirling,7903,3,17,6,13,61,51,10,57
Clyde,7903,4,15,9,12,54,50,4,54
Stenhousem'r,7903,5,15,8,13,55,47,8,53
Elgin,7903,6,14,6,16,54,63,-9,48
Annan Athlet,7903,7,11,12,13,47,41,6,45
Berwick,7903,8,8,10,18,31,61,-30,34
Edinburgh Ci,7903,9,7,9,20,36,61,-25,30
Cowdenbeath,7903,10,4,11,21,23,54,-31,23
Montrose,7904,1,24,7,5,62,36,26,79
Peterhead,7904,2,24,4,8,85,39,46,76
Stirling,7904,3,17,6,13,62,52,10,57
Stenhousem'r,7904,4,15,8,13,56,48,8,53
Clyde,7904,5,14,9,13,51,51,0,51
Elgin,7904,6,14,6,16,55,63,-8,48
Annan Athlet,7904,7,12,11,13,49,42,7,47
Berwick,7904,8,9,10,17,32,58,-26,37
Edinburgh Ci,7904,9,7,9,20,37,68,-31,30
Cowdenbeath,7904,10,4,10,22,24,56,-32,22
Montrose,7905,1,23,7,6,59,36,23,76
Peterhead,7905,2,23,5,8,77,38,39,74
Stirling,7905,3,16,7,13,61,52,9,55
Stenhousem'r,7905,4,15,9,12,56,47,9,54
Clyde,7905,5,15,9,12,53,48,5,54
Elgin,7905,6,15,6,15,55,60,-5,51
Annan Athlet,7905,7,11,11,14,48,43,5,44
Berwick,7905,8,8,10,18,29,60,-31,34
Edinburgh Ci,7905,9,7,10,19,36,60,-24,31
Cowdenbeath,7905,10,5,10,21,25,55,-30,25
Peterhead,7906,1,24,4,8,79,39,40,76
Montrose,7906,2,23,7,6,61,39,22,76
Stirling,7906,3,17,6,13,63,52,11,57
Clyde,7906,4,15,9,12,54,49,5,54
Stenhousem'r,7906,5,15,8,13,56,49,7,53
Elgin,7906,6,15,6,15,58,62,-4,51
Annan Athlet,7906,7,11,11,14,47,42,5,44
Berwick,7906,8,8,10,18,30,61,-31,34
Edinburgh Ci,7906,9,7,9,20,37,62,-25,30
Cowdenbeath,7906,10,5,10,21,24,54,-30,25
Montrose,7907,1,24,7,5,62,34,28,79
Peterhead,7907,2,24,4,8,82,38,44,76
Stirling,7907,3,16,7,13,61,52,9,55
Stenhousem'r,7907,4,15,9,12,56,47,9,54
Clyde,7907,5,14,10,12,53,50,3,52
Elgin,7907,6,14,6,16,53,63,-10,48
Annan Athlet,7907,7,12,11,13,49,42,7,47
Berwick,7907,8,8,11,17,31,60,-29,35
Edinburgh Ci,7907,9,7,9,20,36,65,-29,30
Cowdenbeath,7907,10,4,10,22,24,56,-32,22
Montrose,7908,1,23,8,5,60,35,25,77
Peterhead,7908,2,24,4,8,82,42,40,76
Stenhousem'r,7908,3,16,8,12,58,46,12,56
Stirling,7908,4,16,6,14,60,54,6,54
Clyde,7908,5,14,9,13,51,49,2,51
Elgin,7908,6,14,7,15,54,61,-7,49
Annan Athlet,7908,7,11,11,14,47,45,2,44
Berwick,7908,8,9,10,17,30,58,-28,37
Edinburgh Ci,7908,9,7,9,20,40,65,-25,30
Cowdenbeath,7908,10,5,10,21,27,54,-27,25
Montrose,7909,1,24,7,5,62,34,28,79
Peterhead,7909,2,24,4,8,80,39,41,76
Stenhousem'r,7909,3,16,8,12,57,47,10,56
Stirling,7909,4,16,6,14,61,53,8,54
Clyde,7909,5,15,9,12,53,49,4,54
Elgin,7909,6,14,6,16,53,63,-10,48
Annan Athlet,7909,7,11,12,13,48,42,6,45
Berwick,7909,8,8,10,18,30,60,-30,34
Edinburgh Ci,7909,9,7,9,20,37,63,-26,30
Cowdenbeath,7909,10,4,11,21,24,55,-31,23
Peterhead,7910,1,24,4,8,79,39,40,76
Montrose,7910,2,23,7,6,60,36,24,76
Stenhousem'r,7910,3,16,8,12,58,48,10,56
Stirling,7910,4,16,6,14,62,54,8,54
Clyde,7910,5,15,9,12,52,48,4,54
Elgin,7910,6,15,6,15,55,61,-6,51
Annan Athlet,7910,7,12,11,13,48,41,7,47
Berwick,7910,8,8,10,18,29,59,-30,34
Edinburgh Ci,7910,9,7,9,20,37,62,-25,30
Cowdenbeath,7910,10,4,10,22,23,55,-32,22
Montrose,7911,1,24,7,5,62,36,26,79
Peterhead,7911,2,24,4,8,80,39,41,76
Stirling,7911,3,17,6,13,62,51,11,57
Clyde,7911,4,15,9,12,53,48,5,54
Stenhousem'r,7911,5,15,8,13,55,48,7,53
Elgin,7911,6,14,6,16,55,63,-8,48
Annan Athlet,7911,7,11,12,13,49,43,6,45
Berwick,7911,8,8,10,18,29,60,-31,34
Edinburgh Ci,7911,9,7,9,20,37,63,-26,30
Cowdenbeath,7911,10,4,11,21,25,56,-31,23
Peterhead,7912,1,24,4,8,80,39,41,76
Montrose,7912,2,23,7,6,59,38,21,76
Stirling,7912,3,16,7,13,61,52,9,55
Stenhousem'r,7912,4,15,9,12,56,47,9,54
Clyde,7912,5,15,9,12,53,49,4,54
Elgin,7912,6,15,6,15,57,60,-3,51
Annan Athlet,7912,7,12,11,13,50,43,7,47
Berwick,7912,8,8,10,18,30,60,-30,34
Edinburgh Ci,7912,9,7,9,20,37,63,-26,30
Cowdenbeath,7912,10,4,10,22,25,57,-32,22
Montrose,7913,1,24,7,5,61,34,27,79
Peterhead,7913,2,24,4,8,79,38,41,76
Stenhousem'r,7913,3,16,8,12,60,47,13,56
Stirling,7913,4,16,6,14,61,56,5,54
Clyde,7913,5,14,9,13,51,49,2,51
Elgin,7913,6,14,6,16,53,62,-9,48
Annan Athlet,7913,7,11,11,14,48,43,5,44
Berwick,7913,8,9,10,17,30,58,-28,37
Edinburgh Ci,7913,9,7,9,20,36,62,-26,30
Cowdenbeath,7913,10,5,10,21,25,55,-30,25
Montrose,7914,1,24,7,5,62,36,26,79
Peterhead,7914,2,24,4,8,81,39,42,76
Stirling,7914,3,16,7,13,61,52,9,55
Stenhousem'r,7914,4,15,9,12,56,47,9,54
Clyde,7914,5,15,9,12,52,48,4,54
Elgin,7914,6,14,6,16,55,63,-8,48
Annan Athlet,7914,7,11,12,13,47,41,6,45
Berwick,7914,8,8,10,18,29,59,-30,34
Edinburgh Ci,7914,9,7,9,20,37,64,-27,30
Cowdenbeath,7914,10,4,11,21,23,54,-31,23
Montrose,7915,1,24,7,5,63,34,29,79
Peterhead,7915,2,23,5,8,79,40,39,74
Stirling,7915,3,17,6,13,62,52,10,57
Clyde,7915,4,15,9,12,54,50,4,54
Stenhousem'r,7915,5,15,8,13,56,48,8,53
Elgin,7915,6,14,6,16,53,64,-11,48
Annan Athlet,7915,7,11,11,14,48,43,5,44
Berwick,7915,8,8,10,18,31,61,-30,34
Edinburgh Ci,7915,9,7,10,19,38,62,-24,31
Cowdenbeath,7915,10,5,10,21,25,55,-30,25
Montrose,7916,1,23,8,5,60,35,25,77
Peterhead,7916,2,24,4,8,80,38,42,76
Stirling,7916,3,16,7,13,60,51,9,55
Stenhousem'r,7916,4,15,9,12,55,46,9,54
Clyde,7916,5,15,9,12,55,49,6,54
Elgin,7916,6,14,7,15,54,61,-7,49
Annan Athlet,7916,7,12,11,13,48,41,7,47
Berwick,7916,8,8,10,18,30,62,-32,34
Edinburgh Ci,7916,9,7,9,20,36,63,-27,30
Cowdenbeath,7916,10,4,10,22,23,55,-32,22
Montrose,7917,1,24,7,5,60,34,26,79
Peterhead,7917,2,24,4,8,80,38,42,76
Stenhousem'r,7917,3,16,8,12,56,46,10,56
Stirling,7917,4,16,6,14,60,52,8,54
Clyde,7917,5,14,10,12,53,50,3,52
Elgin,7917,6,14,6,16,53,61,-8,48
Annan Athlet,7917,7,11,11,14,48,43,5,44
Berwick,7917,8,8,11,17,31,60,-29,35
Edinburgh Ci,7917,9,7,9,20,36,63,-27,30
Cowdenbeath,7917,10,5,10,21,25,55,-30,25
Peterhead,7918,1,24,4,8,81,39,42,76
Montrose,7918,2,23,7,6,60,36,24,76
Stenhousem'r,7918,3,16,8,12,57,47,10,56
Stirling,7918,4,16,6,14,61,53,8,54
Clyde,7918,5,15,9,12,54,50,4,54
Elgin,7918,6,15,6,15,55,61,-6,51
Annan Athlet,7918,7,12,11,13,48,41,7,47
Berwick,7918,8,8,10,18,31,61,-30,34
Edinburgh Ci,7918,9,7,9,20,37,64,-27,30
Cowdenbeath,7918,10,4,10,22,23,55,-32,22
Montrose,7919,1,24,7,5,61,35,26,79
Peterhead,7919,2,24,4,8,79,38,41,76
Stirling,7919,3,17,6,13,68,52,16,57
Clyde,7919,4,15,9,12,53,48,5,54
Stenhousem'r,7919,5,15,8,13,56,54,2,53
Elgin,7919,6,14,6,16,54,62,-8,48
Annan Athlet,7919,7,11,11,14,47,43,4,44
Berwick,7919,8,8,10,18,29,60,-31,34
Edinburgh Ci,7919,9,7,9,20,36,62,-26,30
Cowdenbeath,7919,10,5,10,21,25,54,-29,25
Peterhead,7920,1,24,4,8,78,38,40,76
Montrose,7920,2,23,7,6,60,36,24,76
Stirling,7920,3,17,6,13,64,52,12,57
Stenhousem'r,7920,4,15,8,13,56,50,6,53
Clyde,7920,5,14,9,13,51,49,2,51
Elgin,7920,6,15,6,15,55,61,-6,51
Annan Athlet,7920,7,11,12,13,48,42,6,45
Berwick,7920,8,9,10,17,30,58,-28,37
Edinburgh Ci,7920,9,7,9,20,36,61,-25,30
Cowdenbeath,7920,10,4,11,21,24,55,-31,23
Montrose,7921,1,24,7,5,61,34,27,79
Peterhead,7921,2,23,4,9,80,42,38,73
Stirling,7921,3,17,6,13,63,52,11,57
Clyde,7921,4,15,9,12,52,48,4,54
Stenhousem'r,7921,5,15,8,13,56,49,7,53
Elgin,7921,6,14,6,16,53,62,-9,48
Annan Athlet,7921,7,11,11,14,48,43,5,44
Berwick,7921,8,8,10,18,29,59,-30,34
Edinburgh Ci,7921,9,8,9,19,40,63,-23,33
Cowdenbeath,7921,10,5,10,21,25,55,-30,25
Montrose,7922,1,24,7,5,62,35,27,79
Peterhead,7922,2,24,4,8,79,38,41,76
Stirling,7922,3,17,6,13,64,54,10,57
Clyde,7922,4,15,9,12,53,48,5,54
Stenhousem'r,7922,5,15,8,13,58,50,8,53
Elgin,7922,6,14,6,16,54,63,-9,48
Annan Athlet,7922,7,11,11,14,49,44,5,44
Berwick,7922,8,8,10,18,29,60,-31,34
Edinburgh Ci,7922,9,7,9,20,36,62,-26,30
Cowdenbeath,7922,10,5,10,21,26,56,-30,25
Montrose,7923,1,24,7,5,61,34,27,79
Peterhead,7923,2,24,4,8,82,40,42,76
Stirling,7923,3,17,6,13,61,51,10,57
Clyde,7923,4,15,9,12,53,49,4,54
Stenhousem'r,7923,5,15,8,13,55,47,8,53
Elgin,7923,6,14,6,16,53,62,-9,48
Annan Athlet,7923,7,11,11,14,47,42,5,44
Berwick,7923,8,8,10,18,30,60,-30,34
Edinburgh Ci,7923,9,7,9,20,38,65,-27,30
Cowdenbeath,7923,10,5,10,21,24,54,-30,25
Montrose,7924,1,24,7,5,61,35,26,79
Peterhead,7924,2,24,4,8,82,41,41,76
Stirling,7924,3,17,6,13,63,53,10,57
Stenhousem'r,7924,4,15,8,13,57,49,8,53
Clyde,7924,5,14,9,13,51,51,0,51
Elgin,7924,6,14,6,16,54,62,-8,48
Annan Athlet,7924,7,11,11,14,48,43,5,44
Berwick,7924,8,9,10,17,32,58,-26,37
Edinburgh Ci,7924,9,7,9,20,39,65,-26,30
Cowdenbeath,7924,10,5,10,21,25,55,-30,25
Montrose,7925,1,23,8,5,62,37,25,77
Peterhead,7925,2,23,5,8,80,41,39,74
Stirling,7925,3,17,6,13,63,52,11,57
Stenhousem'r,7925,4,15,8,13,56,49,7,53
Clyde,7925,5,14,9,13,53,52,1,51
Elgin,7925,6,14,7,15,56,63,-7,49
Annan Athlet,7925,7,11,12,13,47,41,6,45
Berwick,7925,8,9,10,17,33,60,-27,37
Edinburgh Ci,7925,9,7,10,19,39,63,-24,31
Cowdenbeath,7925,10,4,11,21,23,54,-31,23
Montrose,7926,1,24,7,5,63,35,28,79
Peterhead,7926,2,24,4,8,79,39,40,76
Stirling,7926,3,17,6,13,64,51,13,57
Clyde,7926,4,15,9,12,58,48,10,54
Stenhousem'r,7926,5,15,8,13,55,50,5,53
Elgin,7926,6,14,6,16,54,64,-10,48
Annan Athlet,7926,7,11,12,13,47,41,6,45
Berwick,7926,8,8,10,18,29,65,-36,34
Edinburgh Ci,7926,9,7,9,20,37,62,-25,30
Cowdenbeath,7926,10,4,11,21,23,54,-31,23
Montrose,7927,1,24,7,5,61,34,27,79
Peterhead,7927,2,24,4,8,79,38,41,76
Stenhousem'r,7927,3,16,8,12,57,47,10,56
Stirling,7927,4,16,6,14,61,53,8,54
Clyde,7927,5,14,9,13,51,49,2,51
Elgin,7927,6,14,6,16,53,62,-9,48
Annan Athlet,7927,7,12,11,13,49,42,7,47
Berwick,7927,8,9,10,17,30,58,-28,37
Edinburgh Ci,7927,9,7,9,20,36,62,-26,30
Cowdenbeath,7927,10,4,10,22,24,56,-32,22
Montrose,7928,1,24,7,5,61,34,27,79
Peterhead,7928,2,23,4,9,77,40,37,73
Stenhousem'r,7928,3,16,8,12,57,46,11,56
Stirling,7928,4,16,6,14,60,53,7,54
Clyde,7928,5,15,9,12,53,49,4,54
Elgin,7928,6,14,6,16,53,62,-9,48
Annan Athlet,7928,7,11,11,14,48,43,5,44
Berwick,7928,8,8,10,18,30,60,-30,34
Edinburgh Ci,7928,9,8,9,19,38,60,-22,33
Cowdenbeath,7928,10,5,10,21,25,55,-30,25
Montrose,7929,1,24,7,5,63,35,28,79
Peterhead,7929,2,24,4,8,78,38,40,76
Stirling,7929,3,17,6,13,64,52,12,57
Stenhousem'r,7929,4,15,8,13,56,50,6,53
Clyde,7929,5,14,9,13,53,51,2,51
Elgin,7929,6,14,6,16,54,64,-10,48
Annan Athlet,7929,7,11,11,14,48,43,5,44
Berwick,7929,8,9,10,17,32,60,-28,37
Edinburgh Ci,7929,9,7,9,20,36,61,-25,30
Cowdenbeath,7929,10,5,10,21,25,55,-30,25
Peterhead,7930,1,24,4,8,79,39,40,76
Montrose,7930,2,23,7,6,60,38,22,76
Stirling,7930,3,16,7,13,62,53,9,55
Stenhousem'r,7930,4,15,9,12,57,48,9,54
Clyde,7930,5,14,10,12,53,50,3,52
Elgin,7930,6,15,6,15,57,61,-4,51
Annan Athlet,7930,7,11,12,13,47,41,6,45
Berwick,7930,8,8,11,17,31,60,-29,35
Edinburgh Ci,7930,9,7,9,20,37,62,-25,30
Cowdenbeath,7930,10,4,11,21,23,54,-31,23
Montrose,7931,1,24,7,5,61,34,27,79
Peterhead,7931,2,23,4,9,78,40,38,73
Stenhousem'r,7931,3,16,8,12,57,47,10,56
Stirling,7931,4,16,6,14,61,53,8,54
Clyde,7931,5,15,9,12,52,48,4,54
Elgin,7931,6,14,6,16,53,62,-9,48
Annan Athlet,7931,7,11,12,13,49,43,6,45
Berwick,7931,8,8,10,18,29,59,-30,34
Edinburgh Ci,7931,9,8,9,19,38,61,-23,33
Cowdenbeath,7931,10,4,11,21,25,56,-31,23
Montrose,7932,1,24,7,5,62,36,26,79
Peterhead,7932,2,23,4,9,77,39,38,73
Stenhousem'r,7932,3,16,8,12,57,46,11,56
Stirling,7932,4,16,6,14,60,53,7,54
Clyde,7932,5,15,9,12,55,50,5,54
Elgin,7932,6,14,6,16,55,63,-8,48
Annan Athlet,7932,7,11,11,14,47,42,5,44
Berwick,7932,8,8,10,18,31,62,-31,34
Edinburgh Ci,7932,9,8,9,19,37,60,-23,33
Cowdenbeath,7932,10,5,10,21,24,54,-30,25
Montrose,7933,1,23,7,6,60,36,24,76
Peterhead,7933,2,23,4,9,79,41,38,73
Stirling,7933,3,17,6,13,61,51,10,57
Stenhousem'r,7933,4,15,8,13,55,47,8,53
Clyde,7933,5,14,10,12,52,49,3,52
Elgin,7933,6,15,6,15,55,61,-6,51
Annan Athlet,7933,7,11,11,14,47,43,4,44
Berwick,7933,8,8,11,17,30,59,-29,35
Edinburgh Ci,7933,9,8,9,19,39,62,-23,33
Cowdenbeath,7933,10,5,10,21,25,54,-29,25
Montrose,7934,1,24,7,5,64,34,30,79
Peterhead,7934,2,24,4,8,82,38,44,76
Stirling,7934,3,17,6,13,65,51,14,57
Clyde,7934,4,15,9,12,54,49,5,54
Stenhousem'r,7934,5,15,8,13,55,51,4,53
Elgin,7934,6,14,6,16,53,65,-12,48
Annan Athlet,7934,7,12,11,13,49,42,7,47
Berwick,7934,8,8,10,18,30,61,-31,34
Edinburgh Ci,7934,9,7,9,20,36,65,-29,30
Cowdenbeath,7934,10,4,10,22,24,56,-32,22
Peterhead,7935,1,24,4,8,79,39,40,76
Montrose,7935,2,23,7,6,60,36,24,76
Stirling,7935,3,17,6,13,62,51,11,57
Clyde,7935,4,15,9,12,52,48,4,54
Stenhousem'r,7935,5,15,8,13,55,48,7,53
Elgin,7935,6,15,6,15,55,61,-6,51
Annan Athlet,7935,7,12,11,13,49,41,8,47
Berwick,7935,8,8,10,18,29,59,-30,34
Edinburgh Ci,7935,9,7,9,20,37,62,-25,30
Cowdenbeath,7935,10,4,10,22,23,56,-33,22
Montrose,7936,1,24,7,5,62,34,28,79
Peterhead,7936,2,24,4,8,80,38,42,76
Stenhousem'r,7936,3,16,8,12,58,47,11,56
Stirling,7936,4,16,6,14,61,54,7,54
Clyde,7936,5,14,9,13,51,49,2,51
Elgin,7936,6,14,6,16,53,63,-10,48
Annan Athlet,7936,7,11,11,14,47,42,5,44
Berwick,7936,8,9,10,17,30,58,-28,37
Edinburgh Ci,7936,9,7,9,20,36,63,-27,30
Cowdenbeath,7936,10,5,10,21,24,54,-30,25
Montrose,7937,1,24,7,5,62,35,27,79
Peterhead,7937,2,24,4,8,80,39,41,76
Stenhousem'r,7937,3,16,8,12,63,47,16,56
Clyde,7937,4,15,9,12,54,49,5,54
Stirling,7937,5,16,6,14,61,59,2,54
Elgin,7937,6,14,6,16,54,63,-9,48
Annan Athlet,7937,7,11,11,14,47,42,5,44
Berwick,7937,8,8,10,18,30,61,-31,34
Edinburgh Ci,7937,9,7,9,20,37,63,-26,30
Cowdenbeath,7937,10,5,10,21,24,54,-30,25
Montrose,7938,1,23,8,5,61,36,25,77
Peterhead,7938,2,24,4,8,79,38,41,76
Stirling,7938,3,17,6,13,63,51,12,57
Clyde,7938,4,15,9,12,53,49,4,54
Stenhousem'r,7938,5,15,8,13,55,49,6,53
Elgin,7938,6,14,7,15,55,62,-7,49
Annan Athlet,7938,7,11,11,14,48,43,5,44
Berwick,7938,8,8,10,18,30,60,-30,34
Edinburgh Ci,7938,9,7,9,20,36,62,-26,30
Cowdenbeath,7938,10,5,10,21,25,55,-30,25
Montrose,7939,1,24,7,5,63,35,28,79
Peterhead,7939,2,23,5,8,77,38,39,74
Stenhousem'r,7939,3,16,8,12,59,46,13,56
Stirling,7939,4,16,6,14,60,55,5,54
Clyde,7939,5,15,9,12,52,48,4,54
Elgin,7939,6,14,6,16,54,64,-10,48
Annan Athlet,7939,7,11,11,14,48,44,4,44
Berwick,7939,8,8,10,18,29,59,-30,34
Edinburgh Ci,7939,9,7,10,19,36,60,-24,31
Cowdenbeath,7939,10,5,10,21,26,55,-29,25
Montrose,7940,1,24,7,5,60,34,26,79
Peterhead,7940,2,24,4,8,80,39,41,76
Stirling,7940,3,17,6,13,63,53,10,57
Stenhousem'r,7940,4,15,8,13,57,49,8,53
Clyde,7940,5,14,10,12,52,49,3,52
Elgin,7940,6,14,6,16,53,61,-8,48
Annan Athlet,7940,7,12,11,13,50,41,9,47
Berwick,7940,8,8,11,17,30,59,-29,35
Edinburgh Ci,7940,9,7,9,20,37,63,-26,30
Cowdenbeath,7940,10,4,10,22,23,57,-34,22
Montrose,7941,1,24,7,5,61,35,26,79
Peterhead,7941,2,23,5,8,78,39,39,74
Stenhousem'r,7941,3,16,8,12,56,46,10,56
Stirling,7941,4,16,6,14,60,52,8,54
Clyde,7941,5,15,9,12,54,49,5,54
Elgin,7941,6,14,6,16,54,62,-8,48
Annan Athlet,7941,7,11,11,14,47,43,4,44
Berwick,7941,8,8,10,18,30,61,-31,34
Edinburgh Ci,7941,9,7,10,19,37,61,-24,31
Cowdenbeath,7941,10,5,10,21,25,54,-29,25
Montrose,7942,1,23,8,5,59,34,25,77
Peterhead,7942,2,24,4,8,79,38,41,76
Stirling,7942,3,17,6,13,61,51,10,57
Clyde,7942,4,15,9,12,56,50,6,54
Stenhousem'r,7942,5,15,8,13,55,47,8,53
Elgin,7942,6,14,7,15,53,60,-7,49
Annan Athlet,7942,7,12,11,13,48,41,7,47
Berwick,7942,8,8,10,18,31,63,-32,34
Edinburgh Ci,7942,9,7,9,20,36,62,-26,30
Cowdenbeath,7942,10,4,10,22,23,55,-32,22
Montrose,7943,1,24,7,5,61,35,26,79
Peterhead,7943,2,23,5,8,77,38,39,74
Stirling,7943,3,17,6,13,61,51,10,57
Clyde,7943,4,15,9,12,54,48,6,54
Stenhousem'r,7943,5,15,8,13,55,47,8,53
Elgin,7943,6,14,6,16,54,62,-8,48
Annan Athlet,7943,7,11,12,13,47,41,6,45
Berwick,7943,8,8,10,18,29,61,-32,34
Edinburgh Ci,7943,9,7,10,19,36,60,-24,31
Cowdenbeath,7943,10,4,11,21,23,54,-31,23
Montrose,7944,1,24,7,5,61,35,26,79
Peterhead,7944,2,23,5,8,79,40,39,74
Stenhousem'r,7944,3,16,8,12,56,46,10,56
Stirling,7944,4,16,6,14,60,52,8,54
Clyde,7944,5,14,10,12,54,51,3,52
Elgin,7944,6,14,6,16,54,62,-8,48
Annan Athlet,7944,7,12,11,13,49,42,7,47
Berwick,7944,8,8,11,17,32,61,-29,35
Edinburgh Ci,7944,9,7,10,19,38,62,-24,31
Cowdenbeath,7944,10,4,10,22,24,56,-32,22
Montrose,7945,1,24,7,5,61,35,26,79
Peterhead,7945,2,23,5,8,78,39,39,74
Stirling,7945,3,16,7,13,62,53,9,55
Stenhousem'r,7945,4,15,9,12,57,48,9,54
Clyde,7945,5,14,10,12,52,49,3,52
Elgin,7945,6,14,6,16,54,62,-8,48
Annan Athlet,7945,7,12,11,13,50,43,7,47
Berwick,7945,8,8,11,17,30,59,-29,35
Edinburgh Ci,7945,9,7,10,19,37,61,-24,31
Cowdenbeath,7945,10,4,10,22,25,57,-32,22
Montrose,7946,1,23,7,6,59,35,24,76
Peterhead,7946,2,23,5,8,78,39,39,74
Stirling,7946,3,17,6,13,66,51,15,57
Stenhousem'r,7946,4,15,8,13,55,52,3,53
Clyde,7946,5,14,10,12,52,49,3,52
Elgin,7946,6,15,6,15,54,60,-6,51
Annan Athlet,7946,7,11,11,14,48,43,5,44
Berwick,7946,8,8,11,17,30,59,-29,35
Edinburgh Ci,7946,9,7,10,19,37,61,-24,31
Cowdenbeath,7946,10,5,10,21,25,55,-30,25
Montrose,7947,1,24,7,5,62,34,28,79
Peterhead,7947,2,24,4,8,81,38,43,76
Stirling,7947,3,16,7,13,61,52,9,55
Stenhousem'r,7947,4,15,9,12,56,47,9,54
Clyde,7947,5,14,10,12,52,49,3,52
Elgin,7947,6,14,6,16,53,63,-10,48
Annan Athlet,7947,7,11,12,13,48,42,6,45
Berwick,7947,8,8,11,17,30,59,-29,35
Edinburgh Ci,7947,9,7,9,20,36,64,-28,30
Cowdenbeath,7947,10,4,11,21,24,55,-31,23
Montrose,7948,1,24,7,5,61,34,27,79
Peterhead,7948,2,24,4,8,80,38,42,76
Stirling,7948,3,16,7,13,61,52,9,55
Stenhousem'r,7948,4,15,9,12,56,47,9,54
Clyde,7948,5,14,10,12,52,49,3,52
Elgin,7948,6,14,6,16,53,62,-9,48
Annan Athlet,7948,7,11,11,14,48,43,5,44
Berwick,7948,8,8,11,17,30,59,-29,35
Edinburgh Ci,7948,9,7,9,20,36,63,-27,30
Cowdenbeath,7948,10,5,10,21,25,55,-30,25
Montrose,7949,1,24,7,5,61,34,27,79
Peterhead,7949,2,23,5,8,78,39,39,74
Stirling,7949,3,17,6,13,63,51,12,57
Clyde,7949,4,15,9,12,52,48,4,54
Stenhousem'r,7949,5,15,8,13,55,49,6,53
Elgin,7949,6,14,6,16,53,62,-9,48
Annan Athlet,7949,7,11,11,14,48,44,4,44
Berwick,7949,8,8,10,18,29,59,-30,34
Edinburgh Ci,7949,9,7,10,19,37,61,-24,31
Cowdenbeath,7949,10,5,10,21,26,55,-29,25
Montrose,7950,1,23,8,5,60,35,25,77
Peterhead,7950,2,23,4,9,77,39,38,73
Stirling,7950,3,17,6,13,61,51,10,57
Clyde,7950,4,15,9,12,54,49,5,54
Stenhousem'r,7950,5,15,8,13,55,47,8,53
Elgin,7950,6,14,7,15,54,61,-7,49
Annan Athlet,7950,7,12,11,13,48,41,7,47
Berwick,7950,8,8,10,18,30,61,-31,34
Edinburgh Ci,7950,9,8,9,19,37,60,-23,33
Cowdenbeath,7950,10,4,10,22,23,55,-32,22
Montrose,7951,1,24,7,5,61,34,27,79
Peterhead,7951,2,24,4,8,80,39,41,76
Stirling,7951,3,17,6,13,63,52,11,57
Clyde,7951,4,15,9,12,54,49,5,54
Stenhousem'r,7951,5,15,8,13,56,49,7,53
Elgin,7951,6,14,6,16,53,62,-9,48
Annan Athlet,7951,7,12,11,13,50,42,8,47
Berwick,7951,8,8,10,18,30,61,-31,34
Edinburgh Ci,7951,9,7,9,20,37,63,-26,30
Cowdenbeath,7951,10,4,10,22,24,57,-33,22
Montrose,7952,1,24,7,5,62,34,28,79
Peterhead,7952,2,24,4,8,79,38,41,76
Stirling,7952,3,16,7,13,61,52,9,55
Stenhousem'r,7952,4,15,9,12,56,47,9,54
Clyde,7952,5,15,9,12,53,48,5,54
Elgin,7952,6,14,6,16,53,63,-10,48
Annan Athlet,7952,7,11,11,14,48,43,5,44
Berwick,7952,8,8,10,18,29,60,-31,34
Edinburgh Ci,7952,9,7,9,20,36,62,-26,30
Cowdenbeath,7952,10,5,10,21,25,55,-30,25
Montrose,7953,1,23,8,5,60,35,25,77
Peterhead,7953,2,24,4,8,79,39,40,76
Stirling,7953,3,16,7,13,60,51,9,55
Stenhousem'r,7953,4,15,9,12,55,46,9,54
Clyde,7953,5,15,9,12,54,50,4,54
Elgin,7953,6,14,7,15,54,61,-7,49
Annan Athlet,7953,7,11,11,14,47,45,2,44
Berwick,7953,8,8,10,18,31,61,-30,34
Edinburgh Ci,7953,9,7,9,20,37,62,-25,30
Cowdenbeath,7953,10,5,10,21,27,54,-27,25
Peterhead,7954,1,24,4,8,78,38,40,76
Montrose,7954,2,23,7,6,60,37,23,76
Stirling,7954,3,17,6,13,61,51,10,57
Stenhousem'r,7954,4,15,8,13,55,47,8,53
Clyde,7954,5,14,10,12,53,50,3,52
Elgin,7954,6,15,6,15,56,61,-5,51
Annan Athlet,7954,7,11,11,14,47,42,5,44
Berwick,7954,8,8,11,17,31,60,-29,35
Edinburgh Ci,7954,9,7,9,20,36,61,-25,30
Cowdenbeath,7954,10,5,10,21,24,54,-30,25
Montrose,7955,1,24,7,5,61,34,27,79
Peterhead,7955,2,24,4,8,82,38,44,76
Stirling,7955,3,17,6,13,62,52,10,57
Clyde,7955,4,15,9,12,55,50,5,54
Stenhousem'r,7955,5,15,8,13,56,48,8,53
Elgin,7955,6,14,6,16,53,62,-9,48
Annan Athlet,7955,7,11,11,14,47,42,5,44
Berwick,7955,8,8,10,18,31,62,-31,34
Edinburgh Ci,7955,9,7,9,20,36,65,-29,30
Cowdenbeath,7955,10,5,10,21,24,54,-30,25
Peterhead,7956,1,24,4,8,78,38,40,76
Montrose,7956,2,23,7,6,59,35,24,76
Stirling,7956,3,17,6,13,65,53,12,57
Clyde,7956,4,15,9,12,52,48,4,54
Stenhousem'r,7956,5,15,8,13,57,51,6,53
Elgin,7956,6,15,6,15,54,60,-6,51
Annan Athlet,7956,7,12,11,13,49,42,7,47
Berwick,7956,8,8,10,18,29,59,-30,34
Edinburgh Ci,7956,9,7,9,20,36,61,-25,30
Cowdenbeath,7956,10,4,10,22,24,56,-32,22
Montrose,7957,1,23,7,6,60,36,24,76
Peterhead,7957,2,23,4,9,79,41,38,73
Stenhousem'r,7957,3,16,8,12,57,47,10,56
Stirling,7957,4,16,6,14,61,53,8,54
Clyde,7957,5,15,9,12,54,48,6,54
Elgin,7957,6,15,6,15,55,61,-6,51
Annan Athlet,7957,7,11,11,14,47,43,4,44
Berwick,7957,8,8,10,18,29,61,-32,34
Edinburgh Ci,7957,9,8,9,19,39,62,-23,33
Cowdenbeath,7957,10,5,10,21,25,54,-29,25
Montrose,7958,1,23,7,6,59,35,24,76
Peterhead,7958,2,23,4,9,80,42,38,73
Stirling,7958,3,17,6,13,62,52,10,57
Stenhousem'r,7958,4,15,8,13,56,48,8,53
Clyde,7958,5,14,9,13,52,51,1,51
Elgin,7958,6,15,6,15,54,60,-6,51
Annan Athlet,7958,7,11,11,14,47,42,5,44
Berwick,7958,8,9,10,17,32,59,-27,37
Edinburgh Ci,7958,9,8,9,19,40,63,-23,33
Cowdenbeath,7958,10,5,10,21,24,54,-30,25
Montrose,7959,1,24,7,5,61,35,26,79
Peterhead,7959,2,24,4,8,79,38,41,76
Stirling,7959,3,16,7,13,62,53,9,55
Stenhousem'r,7959,4,15,9,12,57,48,9,54
Clyde,7959,5,15,9,12,53,49,4,54
Elgin,7959,6,14,6,16,54,62,-8,48
Annan Athlet,7959,7,12,11,13,50,41,9,47
Berwick,7959,8,8,10,18,30,60,-30,34
Edinburgh Ci,7959,9,7,9,20,36,62,-26,30
Cowdenbeath,7959,10,4,10,22,23,57,-34,22
Montrose,7960,1,23,8,5,60,35,25,77
Peterhead,7960,2,24,4,8,80,39,41,76
Stirling,7960,3,17,6,13,64,53,11,57
Clyde,7960,4,15,9,12,52,48,4,54
Stenhousem'r,7960,5,15,8,13,57,50,7,53
Elgin,7960,6,14,7,15,54,61,-7,49
Annan Athlet,7960,7,11,11,14,48,43,5,44
Berwick,7960,8,8,10,18,29,59,-30,34
Edinburgh Ci,7960,9,7,9,20,37,63,-26,30
Cowdenbeath,7960,10,5,10,21,25,55,-30,25
Montrose,7961,1,24,7,5,62,35,27,79
Peterhead,7961,2,24,4,8,82,40,42,76
Stirling,7961,3,17,6,13,64,51,13,57
Stenhousem'r,7961,4,15,8,13,55,50,5,53
Clyde,7961,5,14,10,12,52,49,3,52
Elgin,7961,6,14,6,16,54,63,-9,48
Annan Athlet,7961,7,11,12,13,49,43,6,45
Berwick,7961,8,8,11,17,30,59,-29,35
Edinburgh Ci,7961,9,7,9,20,38,65,-27,30
Cowdenbeath,7961,10,4,11,21,25,56,-31,23
Montrose,7962,1,24,7,5,61,34,27,79
Peterhead,7962,2,23,4,9,77,40,37,73
Stenhousem'r,7962,3,16,8,12,57,46,11,56
Stirling,7962,4,16,6,14,60,53,7,54
Clyde,7962,5,14,9,13,51,50,1,51
Elgin,7962,6,14,6,16,53,62,-9,48
Annan Athlet,7962,7,12,11,13,52,43,9,47
Berwick,7962,8,9,10,17,31,58,-27,37
Edinburgh Ci,7962,9,8,9,19,38,60,-22,33
Cowdenbeath,7962,10,4,10,22,25,59,-34,22
Montrose,7963,1,24,7,5,63,35,28,79
Peterhead,7963,2,24,4,8,85,38,47,76
Stirling,7963,3,17,6,13,62,52,10,57
Stenhousem'r,7963,4,15,8,13,56,48,8,53
Clyde,7963,5,14,10,12,52,49,3,52
Elgin,7963,6,14,6,16,54,64,-10,48
Annan Athlet,7963,7,11,12,13,48,42,6,45
Berwick,7963,8,8,11,17,30,59,-29,35
Edinburgh Ci,7963,9,7,9,20,36,68,-32,30
Cowdenbeath,7963,10,4,11,21,24,55,-31,23
Montrose,7964,1,23,7,6,60,36,24,76
Peterhead,7964,2,23,4,9,78,40,38,73
Stenhousem'r,7964,3,16,8,12,58,48,10,56
Stirling,7964,4,16,6,14,62,54,8,54
Clyde,7964,5,14,10,12,51,48,3,52
Elgin,7964,6,15,6,15,55,61,-6,51
Annan Athlet,7964,7,11,12,13,48,42,6,45
Berwick,7964,8,8,11,17,29,58,-29,35
Edinburgh Ci,7964,9,8,9,19,38,61,-23,33
Cowdenbeath,7964,10,4,11,21,24,55,-31,23
Montrose,7965,1,24,7,5,63,36,27,79
Peterhead,7965,2,24,4,8,80,38,42,76
Stenhousem'r,7965,3,16,8,12,58,48,10,56
Stirling,7965,4,16,6,14,62,54,8,54
Clyde,7965,5,15,9,12,55,50,5,54
Elgin,7965,6,14,6,16,55,64,-9,48
Annan Athlet,7965,7,11,11,14,47,42,5,44
Berwick,7965,8,8,10,18,31,62,-31,34
Edinburgh Ci,7965,9,7,9,20,36,63,-27,30
Cowdenbeath,7965,10,5,10,21,24,54,-30,25
Montrose,7966,1,23,7,6,59,35,24,76
Peterhead,7966,2,23,5,8,77,38,39,74
Stirling,7966,3,17,6,13,63,52,11,57
Clyde,7966,4,15,9,12,55,50,5,54
Stenhousem'r,7966,5,15,8,13,56,49,7,53
Elgin,7966,6,15,6,15,54,60,-6,51
Annan Athlet,7966,7,11,11,14,48,43,5,44
Berwick,7966,8,8,10,18,31,62,-31,34
Edinburgh Ci,7966,9,7,10,19,36,60,-24,31
Cowdenbeath,7966,10,5,10,21,25,55,-30,25
Peterhead,7967,1,24,4,8,78,38,40,76
Montrose,7967,2,23,7,6,60,36,24,76
Stenhousem'r,7967,3,16,8,12,59,49,10,56
Stirling,7967,4,16,6,14,63,55,8,54
Clyde,7967,5,15,9,12,55,48,7,54
Elgin,7967,6,15,6,15,55,61,-6,51
Annan Athlet,7967,7,12,11,13,49,42,7,47
Berwick,7967,8,8,10,18,29,62,-33,34
Edinburgh Ci,7967,9,7,9,20,36,61,-25,30
Cowdenbeath,7967,10,4,10,22,24,56,-32,22
Peterhead,7968,1,24,4,8,79,39,40,76
Montrose,7968,2,23,7,6,60,36,24,76
Stirling,7968,3,17,6,13,63,52,11,57
Clyde,7968,4,15,9,12,53,49,4,54
Stenhousem'r,7968,5,15,8,13,56,49,7,53
Elgin,7968,6,15,6,15,55,61,-6,51
Annan Athlet,7968,7,11,11,14,48,43,5,44
Berwick,7968,8,8,10,18,30,60,-30,34
Edinburgh Ci,7968,9,7,9,20,37,62,-25,30
Cowdenbeath,7968,10,5,10,21,25,55,-30,25
Montrose,7969,1,24,7,5,61,35,26,79
Peterhead,7969,2,24,4,8,81,40,41,76
Stirling,7969,3,17,6,13,63,52,11,57
Clyde,7969,4,15,9,12,55,51,4,54
Stenhousem'r,7969,5,15,8,13,56,49,7,53
Elgin,7969,6,14,6,16,54,62,-8,48
Annan Athlet,7969,7,11,11,14,49,44,5,44
Berwick,7969,8,8,10,18,32,62,-30,34
Edinburgh Ci,7969,9,7,9,20,38,64,-26,30
Cowdenbeath,7969,10,5,10,21,26,56,-30,25
Montrose,7970,1,23,8,5,59,34,25,77
Peterhead,7970,2,24,4,8,79,39,40,76
Stenhousem'r,7970,3,16,8,12,58,48,10,56
Stirling,7970,4,16,6,14,62,54,8,54
Clyde,7970,5,15,9,12,53,49,4,54
Elgin,7970,6,14,7,15,53,60,-7,49
Annan Athlet,7970,7,11,11,14,47,43,4,44
Berwick,7970,8,8,10,18,30,60,-30,34
Edinburgh Ci,7970,9,7,9,20,37,62,-25,30
Cowdenbeath,7970,10,5,10,21,25,54,-29,25
Montrose,7971,1,24,7,5,62,34,28,79
Peterhead,7971,2,23,5,8,78,39,39,74
Stirling,7971,3,17,6,13,62,52,10,57
Stenhousem'r,7971,4,15,8,13,56,48,8,53
Clyde,7971,5,14,10,12,51,48,3,52
Elgin,7971,6,14,6,16,53,63,-10,48
Annan Athlet,7971,7,12,11,13,48,41,7,47
Berwick,7971,8,8,11,17,29,58,-29,35
Edinburgh Ci,7971,9,7,10,19,37,61,-24,31
Cowdenbeath,7971,10,4,10,22,23,55,-32,22
Montrose,7972,1,24,7,5,63,35,28,79
Peterhead,7972,2,23,5,8,79,40,39,74
Stirling,7972,3,17,6,13,65,51,14,57
Clyde,7972,4,15,9,12,55,49,6,54
Stenhousem'r,7972,5,15,8,13,55,51,4,53
Elgin,7972,6,14,6,16,54,64,-10,48
Annan Athlet,7972,7,11,12,13,47,41,6,45
Berwick,7972,8,8,10,18,30,62,-32,34
Edinburgh Ci,7972,9,7,10,19,38,62,-24,31
Cowdenbeath,7972,10,4,11,21,23,54,-31,23
Montrose,7973,1,24,7,5,64,36,28,79
Peterhead,7973,2,23,5,8,79,40,39,74
Stirling,7973,3,17,6,13,63,51,12,57
Clyde,7973,4,15,9,12,52,48,4,54
Stenhousem'r,7973,5,15,8,13,55,49,6,53
Elgin,7973,6,14,6,16,55,65,-10,48
Annan Athlet,7973,7,12,11,13,48,41,7,47
Berwick,7973,8,8,10,18,29,59,-30,34
Edinburgh Ci,7973,9,7,10,19,38,62,-24,31
Cowdenbeath,7973,10,4,10,22,23,55,-32,22
Montrose,7974,1,24,7,5,61,35,26,79
Peterhead,7974,2,24,4,8,79,38,41,76
Stirling,7974,3,16,7,13,61,52,9,55
Stenhousem'r,7974,4,15,9,12,56,47,9,54
Clyde,7974,5,14,10,12,53,50,3,52
Elgin,7974,6,14,6,16,54,62,-8,48
Annan Athlet,7974,7,11,11,14,49,44,5,44
Berwick,7974,8,8,11,17,31,60,-29,35
Edinburgh Ci,7974,9,7,9,20,36,62,-26,30
Cowdenbeath,7974,10,5,10,21,26,56,-30,25
Montrose,7975,1,24,7,5,60,34,26,79
Peterhead,7975,2,24,4,8,79,38,41,76
Stenhousem'r,7975,3,16,8,12,58,47,11,56
Stirling,7975,4,16,6,14,61,54,7,54
Clyde,7975,5,14,10,12,53,50,3,52
Elgin,7975,6,14,6,16,53,61,-8,48
Annan Athlet,7975,7,12,11,13,49,42,7,47
Berwick,7975,8,8,11,17,31,60,-29,35
Edinburgh Ci,7975,9,7,9,20,36,62,-26,30
Cowdenbeath,7975,10,4,10,22,24,56,-32,22
Montrose,7976,1,24,7,5,60,34,26,79
Peterhead,7976,2,24,4,8,78,38,40,76
Stirling,7976,3,17,6,13,62,51,11,57
Clyde,7976,4,15,9,12,53,49,4,54
Stenhousem'r,7976,5,15,8,13,55,48,7,53
Elgin,7976,6,14,6,16,53,61,-8,48
Annan Athlet,7976,7,11,12,13,48,42,6,45
Berwick,7976,8,8,10,18,30,60,-30,34
Edinburgh Ci,7976,9,7,9,20,36,61,-25,30
Cowdenbeath,7976,10,4,11,21,24,55,-31,23
Peterhead,7977,1,24,4,8,78,38,40,76
Montrose,7977,2,23,7,6,59,37,22,76
Stirling,7977,3,16,7,13,61,52,9,55
Stenhousem'r,7977,4,15,9,12,56,47,9,54
Clyde,7977,5,14,10,12,54,51,3,52
Elgin,7977,6,15,6,15,56,60,-4,51
Annan Athlet,7977,7,12,11,13,49,42,7,47
Berwick,7977,8,8,11,17,32,61,-29,35
Edinburgh Ci,7977,9,7,9,20,36,61,-25,30
Cowdenbeath,7977,10,4,10,22,24,56,-32,22
Montrose,7978,1,24,7,5,60,34,26,79
Peterhead,7978,2,24,4,8,80,40,40,76
Stirling,7978,3,17,6,13,64,53,11,57
Stenhousem'r,7978,4,15,8,13,57,50,7,53
Clyde,7978,5,14,10,12,54,51,3,52
Elgin,7978,6,14,6,16,53,61,-8,48
Annan Athlet,7978,7,11,11,14,49,44,5,44
Berwick,7978,8,8,11,17,32,61,-29,35
Edinburgh Ci,7978,9,7,9,20,38,63,-25,30
Cowdenbeath,7978,10,5,10,21,26,56,-30,25
Montrose,7979,1,23,8,5,59,34,25,77
Peterhead,7979,2,23,4,9,79,41,38,73
Stirling,7979,3,17,6,13,63,52,11,57
Stenhousem'r,7979,4,15,8,13,56,49,7,53
Clyde,7979,5,14,10,12,53,50,3,52
Elgin,7979,6,14,7,15,53,60,-7,49
Annan Athlet,7979,7,11,12,13,48,42,6,45
Berwick,7979,8,8,11,17,31,60,-29,35
Edinburgh Ci,7979,9,8,9,19,39,62,-23,33
Cowdenbeath,7979,10,4,11,21,24,55,-31,23
Montrose,7980,1,23,8,5,62,37,25,77
Peterhead,7980,2,24,4,8,82,38,44,76
Stirling,7980,3,17,6,13,68,53,15,57
Clyde,7980,4,15,9,12,54,48,6,54
Stenhousem'r,7980,5,15,8,13,57,54,3,53
Elgin,7980,6,14,7,15,56,63,-7,49
Annan Athlet,7980,7,12,11,13,48,41,7,47
Berwick,7980,8,8,10,18,29,61,-32,34
Edinburgh Ci,7980,9,7,9,20,36,65,-29,30
Cowdenbeath,7980,10,4,10,22,23,55,-32,22
Montrose,7981,1,24,7,5,60,34,26,79
Peterhead,7981,2,24,4,8,79,39,40,76
Stirling,7981,3,17,6,13,62,52,10,57
Clyde,7981,4,15,9,12,56,50,6,54
Stenhousem'r,7981,5,15,8,13,56,48,8,53
Elgin,7981,6,14,6,16,53,61,-8,48
Annan Athlet,7981,7,12,11,13,49,42,7,47
Berwick,7981,8,8,10,18,31,63,-32,34
Edinburgh Ci,7981,9,7,9,20,37,62,-25,30
Cowdenbeath,7981,10,4,10,22,24,56,-32,22
Montrose,7982,1,23,7,6,60,36,24,76
Peterhead,7982,2,23,4,9,79,44,35,73
Stirling,7982,3,17,6,13,63,53,10,57
Clyde,7982,4,15,9,12,53,49,4,54
Stenhousem'r,7982,5,15,8,13,57,49,8,53
Elgin,7982,6,15,6,15,55,61,-6,51
Annan Athlet,7982,7,11,11,14,48,44,4,44
Berwick,7982,8,8,10,18,30,60,-30,34
Edinburgh Ci,7982,9,8,9,19,42,62,-20,33
Cowdenbeath,7982,10,5,10,21,26,55,-29,25
Montrose,7983,1,24,7,5,60,34,26,79
Peterhead,7983,2,24,4,8,79,39,40,76
Stenhousem'r,7983,3,16,8,12,58,48,10,56
Stirling,7983,4,16,6,14,62,54,8,54
Clyde,7983,5,14,10,12,53,50,3,52
Elgin,7983,6,14,6,16,53,61,-8,48
Annan Athlet,7983,7,12,11,13,48,41,7,47
Berwick,7983,8,8,11,17,31,60,-29,35
Edinburgh Ci,7983,9,7,9,20,37,62,-25,30
Cowdenbeath,7983,10,4,10,22,23,55,-32,22
Montrose,7984,1,24,7,5,61,34,27,79
Peterhead,7984,2,24,4,8,78,38,40,76
Stirling,7984,3,16,7,13,62,53,9,55
Stenhousem'r,7984,4,15,9,12,57,48,9,54
Clyde,7984,5,15,9,12,54,49,5,54
Elgin,7984,6,14,6,16,53,62,-9,48
Annan Athlet,7984,7,11,12,13,47,41,6,45
Berwick,7984,8,8,10,18,30,61,-31,34
Edinburgh Ci,7984,9,7,9,20,36,61,-25,30
Cowdenbeath,7984,10,4,11,21,23,54,-31,23
Montrose,7985,1,23,8,5,60,35,25,77
Peterhead,7985,2,24,4,8,79,39,40,76
Stenhousem'r,7985,3,16,8,12,57,47,10,56
Stirling,7985,4,16,6,14,61,53,8,54
Clyde,7985,5,14,10,12,52,49,3,52
Elgin,7985,6,14,7,15,54,61,-7,49
Annan Athlet,7985,7,12,11,13,51,42,9,47
Berwick,7985,8,8,11,17,30,59,-29,35
Edinburgh Ci,7985,9,7,9,20,37,62,-25,30
Cowdenbeath,7985,10,4,10,22,24,58,-34,22
Montrose,7986,1,23,8,5,63,38,25,77
Peterhead,7986,2,24,4,8,79,38,41,76
Stirling,7986,3,17,6,13,62,52,10,57
Stenhousem'r,7986,4,15,8,13,56,48,8,53
Clyde,7986,5,14,10,12,52,49,3,52
Elgin,7986,6,14,7,15,57,64,-7,49
Annan Athlet,7986,7,11,12,13,47,41,6,45
Berwick,7986,8,8,11,17,30,59,-29,35
Edinburgh Ci,7986,9,7,9,20,36,62,-26,30
Cowdenbeath,7986,10,4,11,21,23,54,-31,23
Montrose,7987,1,23,8,5,61,36,25,77
Peterhead,7987,2,24,4,8,82,39,43,76
Stirling,7987,3,17,6,13,63,53,10,57
Clyde,7987,4,15,9,12,55,48,7,54
Stenhousem'r,7987,5,15,8,13,57,49,8,53
Elgin,7987,6,14,7,15,55,62,-7,49
Annan Athlet,7987,7,11,11,14,47,42,5,44
Berwick,7987,8,8,10,18,29,62,-33,34
Edinburgh Ci,7987,9,7,9,20,37,65,-28,30
Cowdenbeath,7987,10,5,10,21,24,54,-30,25
Montrose,7988,1,24,7,5,60,34,26,79
Peterhead,7988,2,24,4,8,79,39,40,76
Stirling,7988,3,16,7,13,61,52,9,55
Stenhousem'r,7988,4,15,9,12,56,47,9,54
Clyde,7988,5,14,10,12,52,49,3,52
Elgin,7988,6,14,6,16,53,61,-8,48
Annan Athlet,7988,7,11,12,13,48,42,6,45
Berwick,7988,8,8,11,17,30,59,-29,35
Edinburgh Ci,7988,9,7,9,20,37,62,-25,30
Cowdenbeath,7988,10,4,11,21,24,55,-31,23
Montrose,7989,1,24,7,5,60,34,26,79
Peterhead,7989,2,23,4,9,79,41,38,73
Stenhousem'r,7989,3,16,8,12,58,47,11,56
Stirling,7989,4,16,6,14,61,54,7,54
Clyde,7989,5,15,9,12,52,48,4,54
Elgin,7989,6,14,6,16,53,61,-8,48
Annan Athlet,7989,7,11,12,13,50,44,6,45
Berwick,7989,8,8,10,18,29,59,-30,34
Edinburgh Ci,7989,9,8,9,19,39,62,-23,33
Cowdenbeath,7989,10,4,11,21,26,57,-31,23
Montrose,7990,1,23,8,5,61,36,25,77
Peterhead,7990,2,24,4,8,79,38,41,76
Stenhousem'r,7990,3,16,8,12,58,46,12,56
Stirling,7990,4,16,6,14,60,54,6,54
Clyde,7990,5,15,9,12,53,48,5,54
Elgin,7990,6,14,7,15,55,62,-7,49
Annan Athlet,7990,7,12,11,13,50,42,8,47
Berwick,7990,8,8,10,18,29,60,-31,34
Edinburgh Ci,7990,9,7,9,20,36,62,-26,30
Cowdenbeath,7990,10,4,10,22,24,57,-33,22
Montrose,7991,1,24,7,5,61,34,27,79
Peterhead,7991,2,24,4,8,78,38,40,76
Stirling,7991,3,17,6,13,63,51,12,57
Clyde,7991,4,15,9,12,53,49,4,54
Stenhousem'r,7991,5,15,8,13,55,49,6,53
Elgin,7991,6,14,6,16,53,62,-9,48
Annan Athlet,7991,7,11,12,13,47,41,6,45
Berwick,7991,8,8,10,18,30,60,-30,34
Edinburgh Ci,7991,9,7,9,20,36,61,-25,30
Cowdenbeath,7991,10,4,11,21,23,54,-31,23
Montrose,7992,1,24,7,5,63,35,28,79
Peterhead,7992,2,24,4,8,81,39,42,76
Stirling,7992,3,17,6,13,63,51,12,57
Clyde,7992,4,15,9,12,54,49,5,54
Stenhousem'r,7992,5,15,8,13,55,49,6,53
Elgin,7992,6,14,6,16,54,64,-10,48
Annan Athlet,7992,7,11,12,13,48,42,6,45
Berwick,7992,8,8,10,18,30,61,-31,34
Edinburgh Ci,7992,9,7,9,20,37,64,-27,30
Cowdenbeath,7992,10,4,11,21,24,55,-31,23
Montrose,7993,1,23,8,5,60,35,25,77
Peterhead,7993,2,24,4,8,81,38,43,76
Stenhousem'r,7993,3,16,8,12,57,47,10,56
Stirling,7993,4,16,6,14,61,53,8,54
Clyde,7993,5,15,9,12,52,48,4,54
Elgin,7993,6,14,7,15,54,61,-7,49
Annan Athlet,7993,7,11,12,13,48,42,6,45
Berwick,7993,8,8,10,18,29,59,-30,34
Edinburgh Ci,7993,9,7,9,20,36,64,-28,30
Cowdenbeath,7993,10,4,11,21,24,55,-31,23
Montrose,7994,1,24,7,5,61,35,26,79
Peterhead,7994,2,24,4,8,80,39,41,76
Stirling,7994,3,16,7,13,61,52,9,55
Stenhousem'r,7994,4,15,9,12,56,47,9,54
Clyde,7994,5,15,9,12,54,48,6,54
Elgin,7994,6,14,6,16,54,62,-8,48
Annan Athlet,7994,7,11,11,14,48,45,3,44
Berwick,7994,8,8,10,18,29,61,-32,34
Edinburgh Ci,7994,9,7,9,20,37,63,-26,30
Cowdenbeath,7994,10,5,10,21,27,55,-28,25
Montrose,7995,1,24,7,5,62,35,27,79
Peterhead,7995,2,23,4,9,78,41,37,73
Stenhousem'r,7995,3,16,8,12,57,46,11,56
Stirling,7995,4,16,6,14,60,53,7,54
Clyde,7995,5,14,9,13,51,49,2,51
Elgin,7995,6,14,6,16,54,63,-9,48
Annan Athlet,7995,7,11,12,13,47,41,6,45
Berwick,7995,8,9,10,17,30,58,-28,37
Edinburgh Ci,7995,9,8,9,19,39,61,-22,33
Cowdenbeath,7995,10,4,11,21,23,54,-31,23
Montrose,7996,1,24,7,5,60,34,26,79
Peterhead,7996,2,23,5,8,77,38,39,74
Stirling,7996,3,16,7,13,61,52,9,55
Stenhousem'r,7996,4,15,9,12,56,47,9,54
Clyde,7996,5,15,9,12,53,48,5,54
Elgin,7996,6,14,6,16,53,61,-8,48
Annan Athlet,7996,7,11,11,14,47,45,2,44
Berwick,7996,8,8,10,18,29,60,-31,34
Edinburgh Ci,7996,9,7,10,19,36,60,-24,31
Cowdenbeath,7996,10,5,10,21,27,54,-27,25
Montrose,7997,1,24,7,5,64,36,28,79
Peterhead,7997,2,24,4,8,80,38,42,76
Stirling,7997,3,17,6,13,62,51,11,57
Clyde,7997,4,15,9,12,53,49,4,54
Stenhousem'r,7997,5,15,8,13,55,48,7,53
Elgin,7997,6,14,6,16,55,65,-10,48
Annan Athlet,7997,7,11,12,13,48,42,6,45
Berwick,7997,8,8,10,18,30,60,-30,34
Edinburgh Ci,7997,9,7,9,20,36,63,-27,30
Cowdenbeath,7997,10,4,11,21,24,55,-31,23
Montrose,7998,1,24,7,5,61,35,26,79
Peterhead,7998,2,24,4,8,80,39,41,76
Stirling,7998,3,17,6,13,62,52,10,57
Clyde,7998,4,15,9,12,52,48,4,54
Stenhousem'r,7998,5,15,8,13,56,48,8,53
Elgin,7998,6,14,6,16,54,62,-8,48
Annan Athlet,7998,7,11,12,13,48,42,6,45
Berwick,7998,8,8,10,18,29,59,-30,34
Edinburgh Ci,7998,9,7,9,20,37,63,-26,30
Cowdenbeath,7998,10,4,11,21,24,55,-31,23
Montrose,7999,1,24,7,5,62,35,27,79
Peterhead,7999,2,24,4,8,79,39,40,76
Stirling,7999,3,16,7,13,61,52,9,55
Stenhousem'r,7999,4,15,9,12,56,47,9,54
Clyde,7999,5,14,10,12,51,48,3,52
Elgin,7999,6,14,6,16,54,63,-9,48
Annan Athlet,7999,7,11,11,14,47,42,5,44
Berwick,7999,8,8,11,17,29,58,-29,35
Edinburgh Ci,7999,9,7,9,20,37,62,-25,30
Cowdenbeath,7999,10,5,10,21,24,54,-30,25
Montrose,8000,1,24,7,5,62,36,26,79
Peterhead,8000,2,24,4,8,81,38,43,76
Stenhousem'r,8000,3,16,8,12,56,46,10,56
Stirling,8000,4,16,6,14,60,52,8,54
Clyde,8000,5,15,9,12,54,49,5,54
Elgin,8000,6,14,6,16,55,63,-8,48
Annan Athlet,8000,7,11,12,13,49,43,6,45
Berwick,8000,8,8,10,18,30,61,-31,34
Edinburgh Ci,8000,9,7,9,20,36,64,-28,30
Cowdenbeath,8000,10,4,11,21,25,56,-31,23
Montrose,8001,1,24,7,5,60,34,26,79
Peterhead,8001,2,24,4,8,79,38,41,76
Stenhousem'r,8001,3,16,8,12,56,46,10,56
Stirling,8001,4,16,6,14,60,52,8,54
Clyde,8001,5,15,9,12,52,48,4,54
Elgin,8001,6,14,6,16,53,61,-8,48
Annan Athlet,8001,7,11,12,13,47,41,6,45
Berwick,8001,8,8,10,18,29,59,-30,34
Edinburgh Ci,8001,9,7,9,20,36,62,-26,30
Cowdenbeath,8001,10,4,11,21,23,54,-31,23
Montrose,8002,1,23,8,5,61,36,25,77
Peterhead,8002,2,23,5,8,78,39,39,74
Stenhousem'r,8002,3,16,8,12,58,47,11,56
Stirling,8002,4,16,6,14,61,54,7,54
Clyde,8002,5,15,9,12,53,48,5,54
Elgin,8002,6,14,7,15,55,62,-7,49
Annan Athlet,8002,7,11,12,13,48,42,6,45
Berwick,8002,8,8,10,18,29,60,-31,34
Edinburgh Ci,8002,9,7,10,19,37,61,-24,31
Cowdenbeath,8002,10,4,11,21,24,55,-31,23
Montrose,8003,1,23,7,6,61,37,24,76
Peterhead,8003,2,23,4,9,77,39,38,73
Stenhousem'r,8003,3,16,8,12,59,46,13,56
Clyde,8003,4,15,9,12,56,48,8,54
Stirling,8003,5,16,6,14,60,55,5,54
Elgin,8003,6,15,6,15,56,62,-6,51
Annan Athlet,8003,7,11,11,14,47,42,5,44
Berwick,8003,8,8,10,18,29,63,-34,34
Edinburgh Ci,8003,9,8,9,19,37,60,-23,33
Cowdenbeath,8003,10,5,10,21,24,54,-30,25
Montrose,8004,1,24,7,5,65,35,30,79
Peterhead,8004,2,24,4,8,79,38,41,76
Stenhousem'r,8004,3,16,8,12,60,48,12,56
Stirling,8004,4,16,6,14,62,56,6,54
Clyde,8004,5,15,9,12,55,49,6,54
Elgin,8004,6,14,6,16,54,66,-12,48
Annan Athlet,8004,7,11,11,14,47,42,5,44
Berwick,8004,8,8,10,18,30,62,-32,34
Edinburgh Ci,8004,9,7,9,20,36,62,-26,30
Cowdenbeath,8004,10,5,10,21,24,54,-30,25
Montrose,8005,1,23,7,6,59,36,23,76
Peterhead,8005,2,23,5,8,78,39,39,74
Stenhousem'r,8005,3,16,8,12,59,48,11,56
Clyde,8005,4,15,9,12,57,48,9,54
Stirling,8005,5,16,6,14,62,55,7,54
Elgin,8005,6,15,6,15,55,60,-5,51
Annan Athlet,8005,7,11,12,13,48,42,6,45
Berwick,8005,8,8,10,18,29,64,-35,34
Edinburgh Ci,8005,9,7,10,19,37,61,-24,31
Cowdenbeath,8005,10,4,11,21,24,55,-31,23
Montrose,8006,1,23,8,5,61,36,25,77
Peterhead,8006,2,24,4,8,78,38,40,76
Stirling,8006,3,17,6,13,63,52,11,57
Stenhousem'r,8006,4,15,8,13,56,49,7,53
Clyde,8006,5,14,9,13,52,51,1,51
Elgin,8006,6,14,7,15,55,62,-7,49
Annan Athlet,8006,7,12,11,13,49,41,8,47
Berwick,8006,8,9,10,17,32,59,-27,37
Edinburgh Ci,8006,9,7,9,20,36,61,-25,30
Cowdenbeath,8006,10,4,10,22,23,56,-33,22
Peterhead,8007,1,24,4,8,81,38,43,76
Montrose,8007,2,23,7,6,59,37,22,76
Stirling,8007,3,17,6,13,61,51,10,57
Stenhousem'r,8007,4,15,8,13,55,47,8,53
Clyde,8007,5,14,9,13,51,50,1,51
Elgin,8007,6,15,6,15,56,60,-4,51
Annan Athlet,8007,7,11,12,13,48,42,6,45
Berwick,8007,8,9,10,17,31,58,-27,37
Edinburgh Ci,8007,9,7,9,20,36,64,-28,30
Cowdenbeath,8007,10,4,11,21,24,55,-31,23
Montrose,8008,1,23,8,5,61,36,25,77
Peterhead,8008,2,24,4,8,79,38,41,76
Stenhousem'r,8008,3,16,8,12,57,46,11,56
Stirling,8008,4,16,6,14,60,53,7,54
Clyde,8008,5,14,10,12,53,50,3,52
Elgin,8008,6,14,7,15,55,62,-7,49
Annan Athlet,8008,7,12,11,13,50,42,8,47
Berwick,8008,8,8,11,17,31,60,-29,35
Edinburgh Ci,8008,9,7,9,20,36,62,-26,30
Cowdenbeath,8008,10,4,10,22,24,57,-33,22
Montrose,8009,1,24,7,5,63,34,29,79
Peterhead,8009,2,23,4,9,78,40,38,73
Stirling,8009,3,17,6,13,63,53,10,57
Clyde,8009,4,15,9,12,53,48,5,54
Stenhousem'r,8009,5,15,8,13,57,49,8,53
Elgin,8009,6,14,6,16,53,64,-11,48
Annan Athlet,8009,7,12,11,13,49,41,8,47
Berwick,8009,8,8,10,18,29,60,-31,34
Edinburgh Ci,8009,9,8,9,19,38,61,-23,33
Cowdenbeath,8009,10,4,10,22,23,56,-33,22
Montrose,8010,1,24,7,5,64,34,30,79
Peterhead,8010,2,24,4,8,80,40,40,76
Stirling,8010,3,17,6,13,61,51,10,57
Clyde,8010,4,15,9,12,52,48,4,54
Stenhousem'r,8010,5,15,8,13,55,47,8,53
Elgin,8010,6,14,6,16,53,65,-12,48
Annan Athlet,8010,7,12,11,13,49,42,7,47
Berwick,8010,8,8,10,18,29,59,-30,34
Edinburgh Ci,8010,9,7,9,20,38,63,-25,30
Cowdenbeath,8010,10,4,10,22,24,56,-32,22
Peterhead,8011,1,24,4,8,80,38,42,76
Montrose,8011,2,23,7,6,59,35,24,76
Stirling,8011,3,16,7,13,61,52,9,55
Stenhousem'r,8011,4,15,9,12,56,47,9,54
Clyde,8011,5,14,9,13,51,51,0,51
Elgin,8011,6,15,6,15,54,60,-6,51
Annan Athlet,8011,7,12,11,13,49,42,7,47
Berwick,8011,8,9,10,17,32,58,-26,37
Edinburgh Ci,8011,9,7,9,20,36,63,-27,30
Cowdenbeath,8011,10,4,10,22,24,56,-32,22
Montrose,8012,1,24,7,5,60,34,26,79
Peterhead,8012,2,24,4,8,79,38,41,76
Stirling,8012,3,17,6,13,64,51,13,57
Clyde,8012,4,15,9,12,53,48,5,54
Stenhousem'r,8012,5,15,8,13,55,50,5,53
Elgin,8012,6,14,6,16,53,61,-8,48
Annan Athlet,8012,7,12,11,13,49,42,7,47
Berwick,8012,8,8,10,18,29,60,-31,34
Edinburgh Ci,8012,9,7,9,20,36,62,-26,30
Cowdenbeath,8012,10,4,10,22,24,56,-32,22
Montrose,8013,1,23,8,5,60,35,25,77
Peterhead,8013,2,24,4,8,82,38,44,76
Stirling,8013,3,17,6,13,66,52,14,57
Stenhousem'r,8013,4,15,8,13,56,52,4,53
Clyde,8013,5,14,10,12,53,50,3,52
Elgin,8013,6,14,7,15,54,61,-7,49
Annan Athlet,8013,7,11,12,13,48,42,6,45
Berwick,8013,8,8,11,17,31,60,-29,35
Edinburgh Ci,8013,9,7,9,20,36,65,-29,30
Cowdenbeath,8013,10,4,11,21,24,55,-31,23
Peterhead,8014,1,24,4,8,82,38,44,76
Montrose,8014,2,23,7,6,60,36,24,76
Stenhousem'r,8014,3,16,8,12,57,47,10,56
Stirling,8014,4,16,6,14,61,53,8,54
Clyde,8014,5,15,9,12,52,48,4,54
Elgin,8014,6,15,6,15,55,61,-6,51
Annan Athlet,8014,7,11,12,13,48,42,6,45
Berwick,8014,8,8,10,18,29,59,-30,34
Edinburgh Ci,8014,9,7,9,20,36,65,-29,30
Cowdenbeath,8014,10,4,11,21,24,55,-31,23
Montrose,8015,1,24,7,5,65,35,30,79
Peterhead,8015,2,24,4,8,80,40,40,76
Stirling,8015,3,17,6,13,63,53,10,57
Clyde,8015,4,15,9,12,52,48,4,54
Stenhousem'r,8015,5,15,8,13,57,49,8,53
Elgin,8015,6,14,6,16,54,66,-12,48
Annan Athlet,8015,7,12,11,13,50,41,9,47
Berwick,8015,8,8,10,18,29,59,-30,34
Edinburgh Ci,8015,9,7,9,20,38,63,-25,30
Cowdenbeath,8015,10,4,10,22,23,57,-34,22
Peterhead,8016,1,24,4,8,78,38,40,76
Montrose,8016,2,23,7,6,59,35,24,76
Stirling,8016,3,17,6,13,62,51,11,57
Stenhousem'r,8016,4,15,8,13,55,48,7,53
Clyde,8016,5,14,10,12,52,49,3,52
Elgin,8016,6,15,6,15,54,60,-6,51
Annan Athlet,8016,7,12,11,13,49,42,7,47
Berwick,8016,8,8,11,17,30,59,-29,35
Edinburgh Ci,8016,9,7,9,20,36,61,-25,30
Cowdenbeath,8016,10,4,10,22,24,56,-32,22
Montrose,8017,1,24,7,5,61,35,26,79
Peterhead,8017,2,24,4,8,81,41,40,76
Stirling,8017,3,17,6,13,61,51,10,57
Clyde,8017,4,15,9,12,53,48,5,54
Stenhousem'r,8017,5,15,8,13,55,47,8,53
Elgin,8017,6,14,6,16,54,62,-8,48
Annan Athlet,8017,7,12,11,13,48,41,7,47
Berwick,8017,8,8,10,18,29,60,-31,34
Edinburgh Ci,8017,9,7,9,20,39,64,-25,30
Cowdenbeath,8017,10,4,10,22,23,55,-32,22
Montrose,8018,1,24,7,5,60,34,26,79
Peterhead,8018,2,23,4,9,78,40,38,73
Stirling,8018,3,17,6,13,61,51,10,57
Clyde,8018,4,15,9,12,54,49,5,54
Stenhousem'r,8018,5,15,8,13,55,47,8,53
Elgin,8018,6,14,6,16,53,61,-8,48
Annan Athlet,8018,7,11,12,13,48,42,6,45
Berwick,8018,8,8,10,18,30,61,-31,34
Edinburgh Ci,8018,9,8,9,19,38,61,-23,33
Cowdenbeath,8018,10,4,11,21,24,55,-31,23
Peterhead,8019,1,24,4,8,82,38,44,76
Montrose,8019,2,23,7,6,61,37,24,76
Stirling,8019,3,16,7,13,63,54,9,55
Stenhousem'r,8019,4,15,9,12,58,49,9,54
Clyde,8019,5,14,10,12,51,48,3,52
Elgin,8019,6,15,6,15,56,62,-6,51
Annan Athlet,8019,7,12,11,13,49,42,7,47
Berwick,8019,8,8,11,17,29,58,-29,35
Edinburgh Ci,8019,9,7,9,20,36,65,-29,30
Cowdenbeath,8019,10,4,10,22,24,56,-32,22
Montrose,8020,1,23,8,5,62,37,25,77
Peterhead,8020,2,24,4,8,81,38,43,76
Stirling,8020,3,17,6,13,63,52,11,57
Clyde,8020,4,15,9,12,54,48,6,54
Stenhousem'r,8020,5,15,8,13,56,49,7,53
Elgin,8020,6,14,7,15,56,63,-7,49
Annan Athlet,8020,7,11,12,13,48,42,6,45
Berwick,8020,8,8,10,18,29,61,-32,34
Edinburgh Ci,8020,9,7,9,20,36,64,-28,30
Cowdenbeath,8020,10,4,11,21,24,55,-31,23
Montrose,8021,1,24,7,5,62,34,28,79
Peterhead,8021,2,24,4,8,79,39,40,76
Stirling,8021,3,16,7,13,61,52,9,55
Stenhousem'r,8021,4,15,9,12,56,47,9,54
Clyde,8021,5,15,9,12,53,48,5,54
Elgin,8021,6,14,6,16,53,63,-10,48
Annan Athlet,8021,7,11,12,13,48,42,6,45
Berwick,8021,8,8,10,18,29,60,-31,34
Edinburgh Ci,8021,9,7,9,20,37,62,-25,30
Cowdenbeath,8021,10,4,11,21,24,55,-31,23
Peterhead,8022,1,24,4,8,78,38,40,76
Montrose,8022,2,23,7,6,59,35,24,76
Stirling,8022,3,17,6,13,63,51,12,57
Stenhousem'r,8022,4,15,8,13,55,49,6,53
Clyde,8022,5,14,10,12,53,50,3,52
Elgin,8022,6,15,6,15,54,60,-6,51
Annan Athlet,8022,7,11,11,14,47,42,5,44
Berwick,8022,8,8,11,17,31,60,-29,35
Edinburgh Ci,8022,9,7,9,20,36,61,-25,30
Cowdenbeath,8022,10,5,10,21,24,54,-30,25
Montrose,8023,1,23,8,5,61,36,25,77
Peterhead,8023,2,24,4,8,83,39,44,76
Stenhousem'r,8023,3,16,8,12,57,47,10,56
Stirling,8023,4,16,6,14,61,53,8,54
Clyde,8023,5,14,10,12,53,50,3,52
Elgin,8023,6,14,7,15,55,62,-7,49
Annan Athlet,8023,7,11,11,14,47,43,4,44
Berwick,8023,8,8,11,17,31,60,-29,35
Edinburgh Ci,8023,9,7,9,20,37,66,-29,30
Cowdenbeath,8023,10,5,10,21,25,54,-29,25
Montrose,8024,1,24,7,5,62,36,26,79
Peterhead,8024,2,23,4,9,78,41,37,73
Stirling,8024,3,17,6,13,65,51,14,57
Stenhousem'r,8024,4,15,8,13,55,51,4,53
Clyde,8024,5,14,10,12,51,48,3,52
Elgin,8024,6,14,6,16,55,63,-8,48
Annan Athlet,8024,7,11,12,13,47,41,6,45
Berwick,8024,8,8,11,17,29,58,-29,35
Edinburgh Ci,8024,9,8,9,19,39,61,-22,33
Cowdenbeath,8024,10,4,11,21,23,54,-31,23
Montrose,8025,1,24,7,5,61,34,27,79
Peterhead,8025,2,24,4,8,81,39,42,76
Stirling,8025,3,17,6,13,64,51,13,57
Clyde,8025,4,15,9,12,55,49,6,54
Stenhousem'r,8025,5,15,8,13,55,50,5,53
Elgin,8025,6,14,6,16,53,62,-9,48
Annan Athlet,8025,7,11,12,13,48,42,6,45
Berwick,8025,8,8,10,18,30,62,-32,34
Edinburgh Ci,8025,9,7,9,20,37,64,-27,30
Cowdenbeath,8025,10,4,11,21,24,55,-31,23
Montrose,8026,1,23,8,5,62,37,25,77
Peterhead,8026,2,23,5,8,77,38,39,74
Stirling,8026,3,16,7,13,62,53,9,55
Stenhousem'r,8026,4,15,9,12,57,48,9,54
Clyde,8026,5,15,9,12,53,48,5,54
Elgin,8026,6,14,7,15,56,63,-7,49
Annan Athlet,8026,7,11,12,13,47,41,6,45
Berwick,8026,8,8,10,18,29,60,-31,34
Edinburgh Ci,8026,9,7,10,19,36,60,-24,31
Cowdenbeath,8026,10,4,11,21,23,54,-31,23
Montrose,8027,1,24,7,5,62,35,27,79
Peterhead,8027,2,23,5,8,78,39,39,74
Stirling,8027,3,17,6,13,66,53,13,57
Clyde,8027,4,15,9,12,53,48,5,54
Stenhousem'r,8027,5,15,8,13,57,52,5,53
Elgin,8027,6,14,6,16,54,63,-9,48
Annan Athlet,8027,7,11,12,13,47,41,6,45
Berwick,8027,8,8,10,18,29,60,-31,34
Edinburgh Ci,8027,9,7,10,19,37,61,-24,31
Cowdenbeath,8027,10,4,11,21,23,54,-31,23
Montrose,8028,1,23,8,5,60,35,25,77
Peterhead,8028,2,24,4,8,80,38,42,76
Stirling,8028,3,16,7,13,62,53,9,55
Stenhousem'r,8028,4,15,9,12,57,48,9,54
Clyde,8028,5,15,9,12,52,48,4,54
Elgin,8028,6,14,7,15,54,61,-7,49
Annan Athlet,8028,7,12,11,13,49,41,8,47
Berwick,8028,8,8,10,18,29,59,-30,34
Edinburgh Ci,8028,9,7,9,20,36,63,-27,30
Cowdenbeath,8028,10,4,10,22,23,56,-33,22
Montrose,8029,1,24,7,5,61,34,27,79
Peterhead,8029,2,23,4,9,77,39,38,73
Stirling,8029,3,17,6,13,64,53,11,57
Clyde,8029,4,15,9,12,52,48,4,54
Stenhousem'r,8029,5,15,8,13,57,50,7,53
Elgin,8029,6,14,6,16,53,62,-9,48
Annan Athlet,8029,7,11,12,13,47,41,6,45
Berwick,8029,8,8,10,18,29,59,-30,34
Edinburgh Ci,8029,9,8,9,19,37,60,-23,33
Cowdenbeath,8029,10,4,11,21,23,54,-31,23
Montrose,8030,1,24,7,5,61,34,27,79
Peterhead,8030,2,24,4,8,79,38,41,76
Stenhousem'r,8030,3,16,8,12,59,49,10,56
Stirling,8030,4,16,6,14,63,55,8,54
Clyde,8030,5,15,9,12,53,48,5,54
Elgin,8030,6,14,6,16,53,62,-9,48
Annan Athlet,8030,7,11,11,14,48,43,5,44
Berwick,8030,8,8,10,18,29,60,-31,34
Edinburgh Ci,8030,9,7,9,20,36,62,-26,30
Cowdenbeath,8030,10,5,10,21,25,55,-30,25
Montrose,8031,1,24,7,5,62,35,27,79
Peterhead,8031,2,24,4,8,80,38,42,76
Stenhousem'r,8031,3,16,8,12,56,46,10,56
Stirling,8031,4,16,6,14,60,52,8,54
Clyde,8031,5,15,9,12,55,49,6,54
Elgin,8031,6,14,6,16,54,63,-9,48
Annan Athlet,8031,7,11,12,13,48,42,6,45
Berwick,8031,8,8,10,18,30,62,-32,34
Edinburgh Ci,8031,9,7,9,20,36,63,-27,30
Cowdenbeath,8031,10,4,11,21,24,55,-31,23
Montrose,8032,1,24,7,5,60,34,26,79
Peterhead,8032,2,24,4,8,80,39,41,76
Stirling,8032,3,17,6,13,63,53,10,57
Stenhousem'r,8032,4,15,8,13,57,49,8,53
Clyde,8032,5,14,9,13,52,50,2,51
Elgin,8032,6,14,6,16,53,61,-8,48
Annan Athlet,8032,7,12,11,13,48,41,7,47
Berwick,8032,8,9,10,17,31,59,-28,37
Edinburgh Ci,8032,9,7,9,20,37,63,-26,30
Cowdenbeath,8032,10,4,10,22,23,55,-32,22
Montrose,8033,1,24,7,5,63,34,29,79
Peterhead,8033,2,24,4,8,81,39,42,76
Stenhousem'r,8033,3,16,8,12,56,46,10,56
Stirling,8033,4,16,6,14,60,52,8,54
Clyde,8033,5,14,9,13,51,49,2,51
Elgin,8033,6,14,6,16,53,64,-11,48
Annan Athlet,8033,7,11,12,13,50,44,6,45
Berwick,8033,8,9,10,17,30,58,-28,37
Edinburgh Ci,8033,9,7,9,20,37,64,-27,30
Cowdenbeath,8033,10,4,11,21,26,57,-31,23
Montrose,8034,1,24,7,5,62,34,28,79
Peterhead,8034,2,24,4,8,78,38,40,76
Stenhousem'r,8034,3,16,8,12,59,47,12,56
Clyde,8034,4,15,9,12,55,48,7,54
Stirling,8034,5,16,6,14,61,55,6,54
Elgin,8034,6,14,6,16,53,63,-10,48
Annan Athlet,8034,7,11,11,14,47,43,4,44
Berwick,8034,8,8,10,18,29,62,-33,34
Edinburgh Ci,8034,9,7,9,20,36,61,-25,30
Cowdenbeath,8034,10,5,10,21,25,54,-29,25
Montrose,8035,1,23,8,5,60,35,25,77
Peterhead,8035,2,24,4,8,78,38,40,76
Stirling,8035,3,17,6,13,61,51,10,57
Clyde,8035,4,15,9,12,53,48,5,54
Stenhousem'r,8035,5,15,8,13,55,47,8,53
Elgin,8035,6,14,7,15,54,61,-7,49
Annan Athlet,8035,7,12,11,13,49,41,8,47
Berwick,8035,8,8,10,18,29,60,-31,34
Edinburgh Ci,8035,9,7,9,20,36,61,-25,30
Cowdenbeath,8035,10,4,10,22,23,56,-33,22
Montrose,8036,1,24,7,5,62,36,26,79
Peterhead,8036,2,24,4,8,80,38,42,76
Stirling,8036,3,16,7,13,61,52,9,55
Stenhousem'r,8036,4,15,9,12,56,47,9,54
Clyde,8036,5,15,9,12,52,48,4,54
Elgin,8036,6,14,6,16,55,63,-8,48
Annan Athlet,8036,7,11,12,13,47,41,6,45
Berwick,8036,8,8,10,18,29,59,-30,34
Edinburgh Ci,8036,9,7,9,20,36,63,-27,30
Cowdenbeath,8036,10,4,11,21,23,54,-31,23
Montrose,8037,1,24,7,5,61,34,27,79
Peterhead,8037,2,24,4,8,79,38,41,76
Stirling,8037,3,17,6,13,64,53,11,57
Stenhousem'r,8037,4,15,8,13,57,50,7,53
Clyde,8037,5,14,10,12,51,48,3,52
Elgin,8037,6,14,6,16,53,62,-9,48
Annan Athlet,8037,7,12,11,13,49,42,7,47
Berwick,8037,8,8,11,17,29,58,-29,35
Edinburgh Ci,8037,9,7,9,20,36,62,-26,30
Cowdenbeath,8037,10,4,10,22,24,56,-32,22
Peterhead,8038,1,24,4,8,79,38,41,76
Montrose,8038,2,23,7,6,60,37,23,76
Stirling,8038,3,16,7,13,63,54,9,55
Stenhousem'r,8038,4,15,9,12,58,49,9,54
Clyde,8038,5,15,9,12,53,48,5,54
Elgin,8038,6,15,6,15,56,61,-5,51
Annan Athlet,8038,7,11,11,14,48,43,5,44
Berwick,8038,8,8,10,18,29,60,-31,34
Edinburgh Ci,8038,9,7,9,20,36,62,-26,30
Cowdenbeath,8038,10,5,10,21,25,55,-30,25
Montrose,8039,1,23,8,5,59,34,25,77
Peterhead,8039,2,24,4,8,81,38,43,76
Stirling,8039,3,17,6,13,63,53,10,57
Clyde,8039,4,15,9,12,53,48,5,54
Stenhousem'r,8039,5,15,8,13,57,49,8,53
Elgin,8039,6,14,7,15,53,60,-7,49
Annan Athlet,8039,7,11,11,14,47,42,5,44
Berwick,8039,8,8,10,18,29,60,-31,34
Edinburgh Ci,8039,9,7,9,20,36,64,-28,30
Cowdenbeath,8039,10,5,10,21,24,54,-30,25
Montrose,8040,1,24,7,5,62,34,28,79
Peterhead,8040,2,24,4,8,83,38,45,76
Stirling,8040,3,17,6,13,62,51,11,57
Clyde,8040,4,15,9,12,56,49,7,54
Stenhousem'r,8040,5,15,8,13,55,48,7,53
Elgin,8040,6,14,6,16,53,63,-10,48
Annan Athlet,8040,7,11,12,13,47,41,6,45
Berwick,8040,8,8,10,18,30,63,-33,34
Edinburgh Ci,8040,9,7,9,20,36,66,-30,30
Cowdenbeath,8040,10,4,11,21,23,54,-31,23
Montrose,8041,1,24,7,5,62,34,28,79
Peterhead,8041,2,24,4,8,80,39,41,76
Stirling,8041,3,17,6,13,64,51,13,57
Clyde,8041,4,15,9,12,53,48,5,54
Stenhousem'r,8041,5,15,8,13,55,50,5,53
Elgin,8041,6,14,6,16,53,63,-10,48
Annan Athlet,8041,7,11,12,13,48,42,6,45
Berwick,8041,8,8,10,18,29,60,-31,34
Edinburgh Ci,8041,9,7,9,20,37,63,-26,30
Cowdenbeath,8041,10,4,11,21,24,55,-31,23
Montrose,8042,1,24,7,5,60,34,26,79
Peterhead,8042,2,24,4,8,81,39,42,76
Stenhousem'r,8042,3,16,8,12,58,47,11,56
Stirling,8042,4,16,6,14,61,54,7,54
Clyde,8042,5,14,9,13,51,50,1,51
Elgin,8042,6,14,6,16,53,61,-8,48
Annan Athlet,8042,7,11,12,13,49,43,6,45
Berwick,8042,8,9,10,17,31,58,-27,37
Edinburgh Ci,8042,9,7,9,20,37,64,-27,30
Cowdenbeath,8042,10,4,11,21,25,56,-31,23
Montrose,8043,1,24,7,5,60,34,26,79
Peterhead,8043,2,24,4,8,80,38,42,76
Stirling,8043,3,17,6,13,63,52,11,57
Stenhousem'r,8043,4,15,8,13,56,49,7,53
Clyde,8043,5,14,9,13,52,51,1,51
Elgin,8043,6,14,6,16,53,61,-8,48
Annan Athlet,8043,7,12,11,13,49,41,8,47
Berwick,8043,8,9,10,17,32,59,-27,37
Edinburgh Ci,8043,9,7,9,20,36,63,-27,30
Cowdenbeath,8043,10,4,10,22,23,56,-33,22
Montrose,8044,1,23,8,5,59,34,25,77
Peterhead,8044,2,24,4,8,81,40,41,76
Stirling,8044,3,16,7,13,61,52,9,55
Stenhousem'r,8044,4,15,9,12,56,47,9,54
Clyde,8044,5,15,9,12,53,48,5,54
Elgin,8044,6,14,7,15,53,60,-7,49
Annan Athlet,8044,7,11,12,13,48,42,6,45
Berwick,8044,8,8,10,18,29,60,-31,34
Edinburgh Ci,8044,9,7,9,20,38,64,-26,30
Cowdenbeath,8044,10,4,11,21,24,55,-31,23
Montrose,8045,1,23,8,5,60,35,25,77
Peterhead,8045,2,24,4,8,81,39,42,76
Stirling,8045,3,17,6,13,63,53,10,57
Clyde,8045,4,15,9,12,53,49,4,54
Stenhousem'r,8045,5,15,8,13,57,49,8,53
Elgin,8045,6,14,7,15,54,61,-7,49
Annan Athlet,8045,7,11,11,14,47,42,5,44
Berwick,8045,8,8,10,18,30,60,-30,34
Edinburgh Ci,8045,9,7,9,20,37,64,-27,30
Cowdenbeath,8045,10,5,10,21,24,54,-30,25
Montrose,8046,1,24,7,5,62,35,27,79
Peterhead,8046,2,24,4,8,80,38,42,76
Stirling,8046,3,16,7,13,62,53,9,55
Stenhousem'r,8046,4,15,9,12,57,48,9,54
Clyde,8046,5,15,9,12,53,48,5,54
Elgin,8046,6,14,6,16,54,63,-9,48
Annan Athlet,8046,7,11,12,13,49,43,6,45
Berwick,8046,8,8,10,18,29,60,-31,34
Edinburgh Ci,8046,9,7,9,20,36,63,-27,30
Cowdenbeath,8046,10,4,11,21,25,56,-31,23
Montrose,8047,1,24,7,5,61,35,26,79
Peterhead,8047,2,24,4,8,79,39,40,76
Stenhousem'r,8047,3,16,8,12,57,47,10,56
Stirling,8047,4,16,6,14,61,53,8,54
Clyde,8047,5,15,9,12,52,48,4,54
Elgin,8047,6,14,6,16,54,62,-8,48
Annan Athlet,8047,7,11,12,13,47,41,6,45
Berwick,8047,8,8,10,18,29,59,-30,34
Edinburgh Ci,8047,9,7,9,20,37,62,-25,30
Cowdenbeath,8047,10,4,11,21,23,54,-31,23
Montrose,8048,1,24,7,5,63,36,27,79
Peterhead,8048,2,24,4,8,81,38,43,76
Stirling,8048,3,17,6,13,63,52,11,57
Clyde,8048,4,15,9,12,54,48,6,54
Stenhousem'r,8048,5,15,8,13,56,49,7,53
Elgin,8048,6,14,6,16,55,64,-9,48
Annan Athlet,8048,7,12,11,13,51,41,10,47
Berwick,8048,8,8,10,18,29,61,-32,34
Edinburgh Ci,8048,9,7,9,20,36,64,-28,30
Cowdenbeath,8048,10,4,10,22,23,58,-35,22
Peterhead,8049,1,24,4,8,80,39,41,76
Montrose,8049,2,23,7,6,59,35,24,76
Stirling,8049,3,17,6,13,64,52,12,57
Stenhousem'r,8049,4,15,8,13,56,50,6,53
Clyde,8049,5,14,10,12,52,49,3,52
Elgin,8049,6,15,6,15,54,60,-6,51
Annan Athlet,8049,7,11,11,14,48,43,5,44
Berwick,8049,8,8,11,17,30,59,-29,35
Edinburgh Ci,8049,9,7,9,20,37,63,-26,30
Cowdenbeath,8049,10,5,10,21,25,55,-30,25
Montrose,8050,1,24,7,5,62,36,26,79
Peterhead,8050,2,24,4,8,81,40,41,76
Stirling,8050,3,17,6,13,65,52,13,57
Stenhousem'r,8050,4,15,8,13,56,51,5,53
Clyde,8050,5,14,10,12,52,49,3,52
Elgin,8050,6,14,6,16,55,63,-8,48
Annan Athlet,8050,7,12,11,13,48,41,7,47
Berwick,8050,8,8,11,17,30,59,-29,35
Edinburgh Ci,8050,9,7,9,20,38,64,-26,30
Cowdenbeath,8050,10,4,10,22,23,55,-32,22
Montrose,8051,1,23,7,6,61,37,24,76
Peterhead,8051,2,23,5,8,78,39,39,74
Stirling,8051,3,17,6,13,64,51,13,57
Stenhousem'r,8051,4,15,8,13,55,50,5,53
Clyde,8051,5,14,9,13,51,49,2,51
Elgin,8051,6,15,6,15,56,62,-6,51
Annan Athlet,8051,7,11,12,13,47,41,6,45
Berwick,8051,8,9,10,17,30,58,-28,37
Edinburgh Ci,8051,9,7,10,19,37,61,-24,31
Cowdenbeath,8051,10,4,11,21,23,54,-31,23
Montrose,8052,1,24,7,5,61,34,27,79
Peterhead,8052,2,24,4,8,79,39,40,76
Stenhousem'r,8052,3,16,8,12,56,46,10,56
Stirling,8052,4,16,6,14,60,52,8,54
Clyde,8052,5,15,9,12,54,50,4,54
Elgin,8052,6,14,6,16,53,62,-9,48
Annan Athlet,8052,7,12,11,13,49,42,7,47
Berwick,8052,8,8,10,18,31,61,-30,34
Edinburgh Ci,8052,9,7,9,20,37,62,-25,30
Cowdenbeath,8052,10,4,10,22,24,56,-32,22
Montrose,8053,1,23,8,5,60,35,25,77
Peterhead,8053,2,24,4,8,80,39,41,76
Stirling,8053,3,16,7,13,61,52,9,55
Stenhousem'r,8053,4,15,9,12,56,47,9,54
Clyde,8053,5,15,9,12,53,49,4,54
Elgin,8053,6,14,7,15,54,61,-7,49
Annan Athlet,8053,7,12,11,13,48,41,7,47
Berwick,8053,8,8,10,18,30,60,-30,34
Edinburgh Ci,8053,9,7,9,20,37,63,-26,30
Cowdenbeath,8053,10,4,10,22,23,55,-32,22
Peterhead,8054,1,24,4,8,79,39,40,76
Montrose,8054,2,23,7,6,59,35,24,76
Stirling,8054,3,17,6,13,65,51,14,57
Stenhousem'r,8054,4,15,8,13,55,51,4,53
Clyde,8054,5,14,9,13,53,51,2,51
Elgin,8054,6,15,6,15,54,60,-6,51
Annan Athlet,8054,7,12,11,13,48,41,7,47
Berwick,8054,8,9,10,17,32,60,-28,37
Edinburgh Ci,8054,9,7,9,20,37,62,-25,30
Cowdenbeath,8054,10,4,10,22,23,55,-32,22
Montrose,8055,1,23,8,5,59,34,25,77
Peterhead,8055,2,24,4,8,79,39,40,76
Stirling,8055,3,17,6,13,62,52,10,57
Clyde,8055,4,15,9,12,57,49,8,54
Stenhousem'r,8055,5,15,8,13,56,48,8,53
Elgin,8055,6,14,7,15,53,60,-7,49
Annan Athlet,8055,7,11,12,13,48,42,6,45
Berwick,8055,8,8,10,18,30,64,-34,34
Edinburgh Ci,8055,9,7,9,20,37,62,-25,30
Cowdenbeath,8055,10,4,11,21,24,55,-31,23
Montrose,8056,1,24,7,5,60,34,26,79
Peterhead,8056,2,23,5,8,78,39,39,74
Stirling,8056,3,16,7,13,61,52,9,55
Stenhousem'r,8056,4,15,9,12,56,47,9,54
Clyde,8056,5,15,9,12,52,48,4,54
Elgin,8056,6,14,6,16,53,61,-8,48
Annan Athlet,8056,7,11,11,14,47,42,5,44
Berwick,8056,8,8,10,18,29,59,-30,34
Edinburgh Ci,8056,9,7,10,19,37,61,-24,31
Cowdenbeath,8056,10,5,10,21,24,54,-30,25
Peterhead,8057,1,24,4,8,79,38,41,76
Montrose,8057,2,23,7,6,60,36,24,76
Stirling,8057,3,17,6,13,61,51,10,57
Clyde,8057,4,15,9,12,53,48,5,54
Stenhousem'r,8057,5,15,8,13,55,47,8,53
Elgin,8057,6,15,6,15,55,61,-6,51
Annan Athlet,8057,7,11,11,14,48,43,5,44
Berwick,8057,8,8,10,18,29,60,-31,34
Edinburgh Ci,8057,9,7,9,20,36,62,-26,30
Cowdenbeath,8057,10,5,10,21,25,55,-30,25
Montrose,8058,1,24,7,5,60,34,26,79
Peterhead,8058,2,24,4,8,85,39,46,76
Stirling,8058,3,16,7,13,61,52,9,55
Stenhousem'r,8058,4,15,9,12,56,47,9,54
Clyde,8058,5,15,9,12,53,49,4,54
Elgin,8058,6,14,6,16,53,61,-8,48
Annan Athlet,8058,7,11,12,13,48,42,6,45
Berwick,8058,8,8,10,18,30,60,-30,34
Edinburgh Ci,8058,9,7,9,20,37,68,-31,30
Cowdenbeath,8058,10,4,11,21,24,55,-31,23
Montrose,8059,1,24,7,5,63,35,28,79
Peterhead,8059,2,23,5,8,77,38,39,74
Stirling,8059,3,16,7,13,60,51,9,55
Stenhousem'r,8059,4,15,9,12,55,46,9,54
Clyde,8059,5,14,10,12,52,49,3,52
Elgin,8059,6,14,6,16,54,64,-10,48
Annan Athlet,8059,7,12,11,13,50,43,7,47
Berwick,8059,8,8,11,17,30,59,-29,35
Edinburgh Ci,8059,9,7,10,19,36,60,-24,31
Cowdenbeath,8059,10,4,10,22,25,57,-32,22
Peterhead,8060,1,24,4,8,79,38,41,76
Montrose,8060,2,23,7,6,60,38,22,76
Stenhousem'r,8060,3,16,8,12,56,46,10,56
Stirling,8060,4,16,6,14,60,52,8,54
Clyde,8060,5,15,9,12,54,48,6,54
Elgin,8060,6,15,6,15,57,61,-4,51
Annan Athlet,8060,7,12,11,13,50,42,8,47
Berwick,8060,8,8,10,18,29,61,-32,34
Edinburgh Ci,8060,9,7,9,20,36,62,-26,30
Cowdenbeath,8060,10,4,10,22,24,57,-33,22
Montrose,8061,1,24,7,5,63,36,27,79
Peterhead,8061,2,24,4,8,81,39,42,76
Stirling,8061,3,16,7,13,60,51,9,55
Stenhousem'r,8061,4,15,9,12,55,46,9,54
Clyde,8061,5,15,9,12,53,49,4,54
Elgin,8061,6,14,6,16,55,64,-9,48
Annan Athlet,8061,7,11,11,14,47,44,3,44
Berwick,8061,8,8,10,18,30,60,-30,34
Edinburgh Ci,8061,9,7,9,20,37,64,-27,30
Cowdenbeath,8061,10,5,10,21,26,54,-28,25
Montrose,8062,1,24,7,5,62,35,27,79
Peterhead,8062,2,23,5,8,77,38,39,74
Stirling,8062,3,16,7,13,60,51,9,55
Stenhousem'r,8062,4,15,9,12,55,46,9,54
Clyde,8062,5,15,9,12,52,48,4,54
Elgin,8062,6,14,6,16,54,63,-9,48
Annan Athlet,8062,7,12,11,13,48,41,7,47
Berwick,8062,8,8,10,18,29,59,-30,34
Edinburgh Ci,8062,9,7,10,19,36,60,-24,31
Cowdenbeath,8062,10,4,10,22,23,55,-32,22
Montrose,8063,1,24,7,5,61,35,26,79
Peterhead,8063,2,24,4,8,82,38,44,76
Stenhousem'r,8063,3,16,8,12,57,47,10,56
Stirling,8063,4,16,6,14,61,53,8,54
Clyde,8063,5,15,9,12,53,49,4,54
Elgin,8063,6,14,6,16,54,62,-8,48
Annan Athlet,8063,7,11,11,14,47,43,4,44
Berwick,8063,8,8,10,18,30,60,-30,34
Edinburgh Ci,8063,9,7,9,20,36,65,-29,30
Cowdenbeath,8063,10,5,10,21,25,54,-29,25
Montrose,8064,1,23,7,6,59,38,21,76
Peterhead,8064,2,23,5,8,78,39,39,74
Stirling,8064,3,17,6,13,63,52,11,57
Clyde,8064,4,15,9,12,53,48,5,54
Stenhousem'r,8064,5,15,8,13,56,49,7,53
Elgin,8064,6,15,6,15,57,60,-3,51
Annan Athlet,8064,7,11,11,14,47,44,3,44
Berwick,8064,8,8,10,18,29,60,-31,34
Edinburgh Ci,8064,9,7,10,19,37,61,-24,31
Cowdenbeath,8064,10,5,10,21,26,54,-28,25
Montrose,8065,1,24,7,5,61,35,26,79
Peterhead,8065,2,24,4,8,81,39,42,76
Stirling,8065,3,16,7,13,60,51,9,55
Stenhousem'r,8065,4,15,9,12,55,46,9,54
Clyde,8065,5,15,9,12,53,49,4,54
Elgin,8065,6,14,6,16,54,62,-8,48
Annan Athlet,8065,7,11,12,13,48,42,6,45
Berwick,8065,8,8,10,18,30,60,-30,34
Edinburgh Ci,8065,9,7,9,20,37,64,-27,30
Cowdenbeath,8065,10,4,11,21,24,55,-31,23
Montrose,8066,1,23,8,5,60,35,25,77
Peterhead,8066,2,24,4,8,79,38,41,76
Stirling,8066,3,17,6,13,64,53,11,57
Clyde,8066,4,15,9,12,55,48,7,54
Stenhousem'r,8066,5,15,8,13,57,50,7,53
Elgin,8066,6,14,7,15,54,61,-7,49
Annan Athlet,8066,7,11,11,14,47,43,4,44
Berwick,8066,8,8,10,18,29,62,-33,34
Edinburgh Ci,8066,9,7,9,20,36,62,-26,30
Cowdenbeath,8066,10,5,10,21,25,54,-29,25
Montrose,8067,1,24,7,5,61,34,27,79
Peterhead,8067,2,24,4,8,81,38,43,76
Stirling,8067,3,17,6,13,62,51,11,57
Clyde,8067,4,15,9,12,54,50,4,54
Stenhousem'r,8067,5,15,8,13,55,48,7,53
Elgin,8067,6,14,6,16,53,62,-9,48
Annan Athlet,8067,7,11,11,14,47,42,5,44
Berwick,8067,8,8,10,18,31,61,-30,34
Edinburgh Ci,8067,9,7,9,20,36,64,-28,30
Cowdenbeath,8067,10,5,10,21,24,54,-30,25
Peterhead,8068,1,24,4,8,79,39,40,76
Montrose,8068,2,23,7,6,59,35,24,76
Stirling,8068,3,17,6,13,63,53,10,57
Stenhousem'r,8068,4,15,8,13,57,49,8,53
Clyde,8068,5,14,10,12,52,49,3,52
Elgin,8068,6,15,6,15,54,60,-6,51
Annan Athlet,8068,7,12,11,13,48,41,7,47
Berwick,8068,8,8,11,17,30,59,-29,35
Edinburgh Ci,8068,9,7,9,20,37,62,-25,30
Cowdenbeath,8068,10,4,10,22,23,55,-32,22
Montrose,8069,1,23,8,5,59,34,25,77
Peterhead,8069,2,23,4,9,79,41,38,73
Stirling,8069,3,17,6,13,62,52,10,57
Stenhousem'r,8069,4,15,8,13,56,48,8,53
Clyde,8069,5,14,10,12,52,49,3,52
Elgin,8069,6,14,7,15,53,60,-7,49
Annan Athlet,8069,7,11,11,14,48,43,5,44
Berwick,8069,8,8,11,17,30,59,-29,35
Edinburgh Ci,8069,9,8,9,19,39,62,-23,33
Cowdenbeath,8069,10,5,10,21,25,55,-30,25
Montrose,8070,1,24,7,5,62,34,28,79
Peterhead,8070,2,24,4,8,83,39,44,76
Stenhousem'r,8070,3,16,8,12,57,47,10,56
Stirling,8070,4,16,6,14,61,53,8,54
Clyde,8070,5,15,9,12,53,49,4,54
Elgin,8070,6,14,6,16,53,63,-10,48
Annan Athlet,8070,7,11,11,14,47,42,5,44
Berwick,8070,8,8,10,18,30,60,-30,34
Edinburgh Ci,8070,9,7,9,20,37,66,-29,30
Cowdenbeath,8070,10,5,10,21,24,54,-30,25
Montrose,8071,1,24,7,5,62,35,27,79
Peterhead,8071,2,24,4,8,78,38,40,76
Stirling,8071,3,16,7,13,61,52,9,55
Stenhousem'r,8071,4,15,9,12,56,47,9,54
Clyde,8071,5,14,10,12,53,50,3,52
Elgin,8071,6,14,6,16,54,63,-9,48
Annan Athlet,8071,7,11,11,14,47,42,5,44
Berwick,8071,8,8,11,17,31,60,-29,35
Edinburgh Ci,8071,9,7,9,20,36,61,-25,30
Cowdenbeath,8071,10,5,10,21,24,54,-30,25
Montrose,8072,1,23,8,5,60,35,25,77
Peterhead,8072,2,24,4,8,81,39,42,76
Stirling,8072,3,17,6,13,62,52,10,57
Stenhousem'r,8072,4,15,8,13,56,48,8,53
Clyde,8072,5,14,9,13,52,50,2,51
Elgin,8072,6,14,7,15,54,61,-7,49
Annan Athlet,8072,7,12,11,13,48,41,7,47
Berwick,8072,8,9,10,17,31,59,-28,37
Edinburgh Ci,8072,9,7,9,20,37,64,-27,30
Cowdenbeath,8072,10,4,10,22,23,55,-32,22
Montrose,8073,1,24,7,5,63,34,29,79
Peterhead,8073,2,24,4,8,80,39,41,76
Stirling,8073,3,17,6,13,62,51,11,57
Stenhousem'r,8073,4,15,8,13,55,48,7,53
Clyde,8073,5,14,10,12,52,49,3,52
Elgin,8073,6,14,6,16,53,64,-11,48
Annan Athlet,8073,7,12,11,13,49,42,7,47
Berwick,8073,8,8,11,17,30,59,-29,35
Edinburgh Ci,8073,9,7,9,20,37,63,-26,30
Cowdenbeath,8073,10,4,10,22,24,56,-32,22
Montrose,8074,1,24,7,5,61,35,26,79
Peterhead,8074,2,24,4,8,79,39,40,76
Stirling,8074,3,16,7,13,61,52,9,55
Stenhousem'r,8074,4,15,9,12,56,47,9,54
Clyde,8074,5,15,9,12,53,48,5,54
Elgin,8074,6,14,6,16,54,62,-8,48
Annan Athlet,8074,7,12,11,13,49,41,8,47
Berwick,8074,8,8,10,18,29,60,-31,34
Edinburgh Ci,8074,9,7,9,20,37,62,-25,30
Cowdenbeath,8074,10,4,10,22,23,56,-33,22
Montrose,8075,1,23,8,5,61,36,25,77
Peterhead,8075,2,24,4,8,80,38,42,76
Stirling,8075,3,16,7,13,62,53,9,55
Stenhousem'r,8075,4,15,9,12,57,48,9,54
Clyde,8075,5,14,10,12,52,49,3,52
Elgin,8075,6,14,7,15,55,62,-7,49
Annan Athlet,8075,7,11,12,13,47,41,6,45
Berwick,8075,8,8,11,17,30,59,-29,35
Edinburgh Ci,8075,9,7,9,20,36,63,-27,30
Cowdenbeath,8075,10,4,11,21,23,54,-31,23
Montrose,8076,1,24,7,5,61,34,27,79
Peterhead,8076,2,23,5,8,79,40,39,74
Stirling,8076,3,16,7,13,61,52,9,55
Stenhousem'r,8076,4,15,9,12,56,47,9,54
Clyde,8076,5,14,10,12,51,48,3,52
Elgin,8076,6,14,6,16,53,62,-9,48
Annan Athlet,8076,7,12,11,13,48,41,7,47
Berwick,8076,8,8,11,17,29,58,-29,35
Edinburgh Ci,8076,9,7,10,19,38,62,-24,31
Cowdenbeath,8076,10,4,10,22,23,55,-32,22
Montrose,8077,1,24,7,5,61,35,26,79
Peterhead,8077,2,24,4,8,82,38,44,76
Stenhousem'r,8077,3,16,8,12,57,47,10,56
Stirling,8077,4,16,6,14,61,53,8,54
Clyde,8077,5,15,9,12,52,48,4,54
Elgin,8077,6,14,6,16,54,62,-8,48
Annan Athlet,8077,7,12,11,13,50,42,8,47
Berwick,8077,8,8,10,18,29,59,-30,34
Edinburgh Ci,8077,9,7,9,20,36,65,-29,30
Cowdenbeath,8077,10,4,10,22,24,57,-33,22
Montrose,8078,1,24,7,5,62,34,28,79
Peterhead,8078,2,24,4,8,80,39,41,76
Stirling,8078,3,17,6,13,64,51,13,57
Clyde,8078,4,15,9,12,52,48,4,54
Stenhousem'r,8078,5,15,8,13,55,50,5,53
Elgin,8078,6,14,6,16,53,63,-10,48
Annan Athlet,8078,7,11,12,13,47,41,6,45
Berwick,8078,8,8,10,18,29,59,-30,34
Edinburgh Ci,8078,9,7,9,20,37,63,-26,30
Cowdenbeath,8078,10,4,11,21,23,54,-31,23
Montrose,8079,1,24,7,5,61,35,26,79
Peterhead,8079,2,23,5,8,78,39,39,74
Stenhousem'r,8079,3,16,8,12,59,47,12,56
Stirling,8079,4,16,6,14,61,55,6,54
Clyde,8079,5,14,10,12,53,50,3,52
Elgin,8079,6,14,6,16,54,62,-8,48
Annan Athlet,8079,7,11,11,14,48,43,5,44
Berwick,8079,8,8,11,17,31,60,-29,35
Edinburgh Ci,8079,9,7,10,19,37,61,-24,31
Cowdenbeath,8079,10,5,10,21,25,55,-30,25
Montrose,8080,1,24,7,5,63,34,29,79
Peterhead,8080,2,24,4,8,78,38,40,76
Stirling,8080,3,17,6,13,63,51,12,57
Stenhousem'r,8080,4,15,8,13,55,49,6,53
Clyde,8080,5,14,9,13,51,49,2,51
Elgin,8080,6,14,6,16,53,64,-11,48
Annan Athlet,8080,7,11,11,14,47,43,4,44
Berwick,8080,8,9,10,17,30,58,-28,37
Edinburgh Ci,8080,9,7,9,20,36,61,-25,30
Cowdenbeath,8080,10,5,10,21,25,54,-29,25
Peterhead,8081,1,24,4,8,79,38,41,76
Montrose,8081,2,23,7,6,59,35,24,76
Stirling,8081,3,16,7,13,60,51,9,55
Stenhousem'r,8081,4,15,9,12,55,46,9,54
Clyde,8081,5,15,9,12,53,49,4,54
Elgin,8081,6,15,6,15,54,60,-6,51
Annan Athlet,8081,7,12,11,13,49,41,8,47
Berwick,8081,8,8,10,18,30,60,-30,34
Edinburgh Ci,8081,9,7,9,20,36,62,-26,30
Cowdenbeath,8081,10,4,10,22,23,56,-33,22
Peterhead,8082,1,24,4,8,80,38,42,76
Montrose,8082,2,23,7,6,60,39,21,76
Stirling,8082,3,17,6,13,66,53,13,57
Stenhousem'r,8082,4,15,8,13,57,52,5,53
Clyde,8082,5,14,9,13,52,50,2,51
Elgin,8082,6,15,6,15,58,61,-3,51
Annan Athlet,8082,7,11,12,13,47,41,6,45
Berwick,8082,8,9,10,17,31,59,-28,37
Edinburgh Ci,8082,9,7,9,20,36,63,-27,30
Cowdenbeath,8082,10,4,11,21,23,54,-31,23
Montrose,8083,1,24,7,5,61,35,26,79
Peterhead,8083,2,24,4,8,81,39,42,76
Stirling,8083,3,16,7,13,62,53,9,55
Stenhousem'r,8083,4,15,9,12,57,48,9,54
Clyde,8083,5,14,10,12,52,49,3,52
Elgin,8083,6,14,6,16,54,62,-8,48
Annan Athlet,8083,7,12,11,13,50,41,9,47
Berwick,8083,8,8,11,17,30,59,-29,35
Edinburgh Ci,8083,9,7,9,20,37,64,-27,30
Cowdenbeath,8083,10,4,10,22,23,57,-34,22
Montrose,8084,1,23,7,6,60,36,24,76
Peterhead,8084,2,23,5,8,79,40,39,74
Stirling,8084,3,16,7,13,61,52,9,55
Stenhousem'r,8084,4,15,9,12,56,47,9,54
Clyde,8084,5,14,9,13,52,50,2,51
Elgin,8084,6,15,6,15,55,61,-6,51
Annan Athlet,8084,7,11,11,14,47,42,5,44
Berwick,8084,8,9,10,17,31,59,-28,37
Edinburgh Ci,8084,9,7,10,19,38,62,-24,31
Cowdenbeath,8084,10,5,10,21,24,54,-30,25
Montrose,8085,1,23,8,5,60,35,25,77
Peterhead,8085,2,24,4,8,79,38,41,76
Stirling,8085,3,17,6,13,63,53,10,57
Stenhousem'r,8085,4,15,8,13,57,49,8,53
Clyde,8085,5,14,10,12,52,49,3,52
Elgin,8085,6,14,7,15,54,61,-7,49
Annan Athlet,8085,7,11,11,14,47,45,2,44
Berwick,8085,8,8,11,17,30,59,-29,35
Edinburgh Ci,8085,9,7,9,20,36,62,-26,30
Cowdenbeath,8085,10,5,10,21,27,54,-27,25
Montrose,8086,1,23,7,6,59,35,24,76
Peterhead,8086,2,23,4,9,77,40,37,73
Stirling,8086,3,16,7,13,61,52,9,55
Stenhousem'r,8086,4,15,9,12,56,47,9,54
Clyde,8086,5,15,9,12,54,48,6,54
Elgin,8086,6,15,6,15,54,60,-6,51
Annan Athlet,8086,7,11,11,14,47,42,5,44
Berwick,8086,8,8,10,18,29,61,-32,34
Edinburgh Ci,8086,9,8,9,19,38,60,-22,33
Cowdenbeath,8086,10,5,10,21,24,54,-30,25
Montrose,8087,1,24,7,5,60,34,26,79
Peterhead,8087,2,24,4,8,78,38,40,76
Stirling,8087,3,17,6,13,63,52,11,57
Clyde,8087,4,15,9,12,53,49,4,54
Stenhousem'r,8087,5,15,8,13,56,49,7,53
Elgin,8087,6,14,6,16,53,61,-8,48
Annan Athlet,8087,7,12,11,13,48,41,7,47
Berwick,8087,8,8,10,18,30,60,-30,34
Edinburgh Ci,8087,9,7,9,20,36,61,-25,30
Cowdenbeath,8087,10,4,10,22,23,55,-32,22
Montrose,8088,1,24,7,5,60,34,26,79
Peterhead,8088,2,24,4,8,80,40,40,76
Stirling,8088,3,16,7,13,61,52,9,55
Stenhousem'r,8088,4,15,9,12,56,47,9,54
Clyde,8088,5,15,9,12,52,48,4,54
Elgin,8088,6,14,6,16,53,61,-8,48
Annan Athlet,8088,7,12,11,13,48,41,7,47
Berwick,8088,8,8,10,18,29,59,-30,34
Edinburgh Ci,8088,9,7,9,20,38,63,-25,30
Cowdenbeath,8088,10,4,10,22,23,55,-32,22
Peterhead,8089,1,24,4,8,81,38,43,76
Montrose,8089,2,23,7,6,59,35,24,76
Stirling,8089,3,17,6,13,63,53,10,57
Clyde,8089,4,15,9,12,53,48,5,54
Stenhousem'r,8089,5,15,8,13,57,49,8,53
Elgin,8089,6,15,6,15,54,60,-6,51
Annan Athlet,8089,7,12,11,13,49,42,7,47
Berwick,8089,8,8,10,18,29,60,-31,34
Edinburgh Ci,8089,9,7,9,20,36,64,-28,30
Cowdenbeath,8089,10,4,10,22,24,56,-32,22
Peterhead,8090,1,24,4,8,80,40,40,76
Montrose,8090,2,23,7,6,62,39,23,76
Stirling,8090,3,17,6,13,61,51,10,57
Clyde,8090,4,15,9,12,53,48,5,54
Stenhousem'r,8090,5,15,8,13,55,47,8,53
Elgin,8090,6,15,6,15,58,63,-5,51
Annan Athlet,8090,7,12,11,13,48,41,7,47
Berwick,8090,8,8,10,18,29,60,-31,34
Edinburgh Ci,8090,9,7,9,20,38,63,-25,30
Cowdenbeath,8090,10,4,10,22,23,55,-32,22
Montrose,8091,1,24,7,5,63,36,27,79
Peterhead,8091,2,24,4,8,79,38,41,76
Stenhousem'r,8091,3,16,8,12,56,46,10,56
Stirling,8091,4,16,6,14,60,52,8,54
Clyde,8091,5,15,9,12,55,49,6,54
Elgin,8091,6,14,6,16,55,64,-9,48
Annan Athlet,8091,7,11,11,14,47,43,4,44
Berwick,8091,8,8,10,18,30,62,-32,34
Edinburgh Ci,8091,9,7,9,20,36,62,-26,30
Cowdenbeath,8091,10,5,10,21,25,54,-29,25
Montrose,8092,1,24,7,5,62,36,26,79
Peterhead,8092,2,23,5,8,78,39,39,74
Stirling,8092,3,16,7,13,62,53,9,55
Stenhousem'r,8092,4,15,9,12,57,48,9,54
Clyde,8092,5,14,9,13,52,50,2,51
Elgin,8092,6,14,6,16,55,63,-8,48
Annan Athlet,8092,7,12,11,13,49,41,8,47
Berwick,8092,8,9,10,17,31,59,-28,37
Edinburgh Ci,8092,9,7,10,19,37,61,-24,31
Cowdenbeath,8092,10,4,10,22,23,56,-33,22
Montrose,8093,1,24,7,5,60,34,26,79
Peterhead,8093,2,24,4,8,80,39,41,76
Stirling,8093,3,17,6,13,62,51,11,57
Clyde,8093,4,15,9,12,53,49,4,54
Stenhousem'r,8093,5,15,8,13,55,48,7,53
Elgin,8093,6,14,6,16,53,61,-8,48
Annan Athlet,8093,7,11,11,14,47,42,5,44
Berwick,8093,8,8,10,18,30,60,-30,34
Edinburgh Ci,8093,9,7,9,20,37,63,-26,30
Cowdenbeath,8093,10,5,10,21,24,54,-30,25
Montrose,8094,1,23,8,5,59,34,25,77
Peterhead,8094,2,24,4,8,80,39,41,76
Stirling,8094,3,16,7,13,63,54,9,55
Stenhousem'r,8094,4,15,9,12,58,49,9,54
Clyde,8094,5,15,9,12,52,48,4,54
Elgin,8094,6,14,7,15,53,60,-7,49
Annan Athlet,8094,7,11,11,14,47,42,5,44
Berwick,8094,8,8,10,18,29,59,-30,34
Edinburgh Ci,8094,9,7,9,20,37,63,-26,30
Cowdenbeath,8094,10,5,10,21,24,54,-30,25
Montrose,8095,1,23,8,5,60,35,25,77
Peterhead,8095,2,24,4,8,79,39,40,76
Stenhousem'r,8095,3,16,8,12,58,48,10,56
Stirling,8095,4,16,6,14,62,54,8,54
Clyde,8095,5,15,9,12,53,48,5,54
Elgin,8095,6,14,7,15,54,61,-7,49
Annan Athlet,8095,7,11,11,14,47,42,5,44
Berwick,8095,8,8,10,18,29,60,-31,34
Edinburgh Ci,8095,9,7,9,20,37,62,-25,30
Cowdenbeath,8095,10,5,10,21,24,54,-30,25
Montrose,8096,1,23,8,5,60,35,25,77
Peterhead,8096,2,24,4,8,80,38,42,76
Stenhousem'r,8096,3,16,8,12,57,47,10,56
Stirling,8096,4,16,6,14,61,53,8,54
Clyde,8096,5,15,9,12,53,48,5,54
Elgin,8096,6,14,7,15,54,61,-7,49
Annan Athlet,8096,7,11,12,13,47,41,6,45
Berwick,8096,8,8,10,18,29,60,-31,34
Edinburgh Ci,8096,9,7,9,20,36,63,-27,30
Cowdenbeath,8096,10,4,11,21,23,54,-31,23
Peterhead,8097,1,24,4,8,79,38,41,76
Montrose,8097,2,23,7,6,60,37,23,76
Stenhousem'r,8097,3,16,8,12,59,49,10,56
Stirling,8097,4,16,6,14,63,55,8,54
Clyde,8097,5,15,9,12,53,49,4,54
Elgin,8097,6,15,6,15,56,61,-5,51
Annan Athlet,8097,7,11,12,13,49,43,6,45
Berwick,8097,8,8,10,18,30,60,-30,34
Edinburgh Ci,8097,9,7,9,20,36,62,-26,30
Cowdenbeath,8097,10,4,11,21,25,56,-31,23
Montrose,8098,1,24,7,5,63,36,27,79
Peterhead,8098,2,24,4,8,81,40,41,76
Stirling,8098,3,17,6,13,61,51,10,57
Clyde,8098,4,15,9,12,52,48,4,54
Stenhousem'r,8098,5,15,8,13,55,47,8,53
Elgin,8098,6,14,6,16,55,64,-9,48
Annan Athlet,8098,7,11,11,14,47,43,4,44
Berwick,8098,8,8,10,18,29,59,-30,34
Edinburgh Ci,8098,9,7,9,20,38,64,-26,30
Cowdenbeath,8098,10,5,10,21,25,54,-29,25
Montrose,8099,1,24,7,5,63,35,28,79
Peterhead,8099,2,23,4,9,78,41,37,73
Stirling,8099,3,17,6,13,61,51,10,57
Clyde,8099,4,15,9,12,56,49,7,54
Stenhousem'r,8099,5,15,8,13,55,47,8,53
Elgin,8099,6,14,6,16,54,64,-10,48
Annan Athlet,8099,7,11,12,13,47,41,6,45
Berwick,8099,8,8,10,18,30,63,-33,34
Edinburgh Ci,8099,9,8,9,19,39,61,-22,33
Cowdenbeath,8099,10,4,11,21,23,54,-31,23
Montrose,8100,1,23,8,5,59,34,25,77
Peterhead,8100,2,23,5,8,78,39,39,74
Stirling,8100,3,17,6,13,62,51,11,57
Clyde,8100,4,15,9,12,54,48,6,54
Stenhousem'r,8100,5,15,8,13,55,48,7,53
Elgin,8100,6,14,7,15,53,60,-7,49
Annan Athlet,8100,7,12,11,13,49,41,8,47
Berwick,8100,8,8,10,18,29,61,-32,34
Edinburgh Ci,8100,9,7,10,19,37,61,-24,31
Cowdenbeath,8100,10,4,10,22,23,56,-33,22
Montrose,8101,1,24,7,5,61,34,27,79
Peterhead,8101,2,24,4,8,81,38,43,76
Stenhousem'r,8101,3,16,8,12,56,46,10,56
Stirling,8101,4,16,6,14,60,52,8,54
Clyde,8101,5,15,9,12,54,48,6,54
Elgin,8101,6,14,6,16,53,62,-9,48
Annan Athlet,8101,7,12,11,13,51,42,9,47
Berwick,8101,8,8,10,18,29,61,-32,34
Edinburgh Ci,8101,9,7,9,20,36,64,-28,30
Cowdenbeath,8101,10,4,10,22,24,58,-34,22
Montrose,8102,1,23,8,5,59,34,25,77
Peterhead,8102,2,24,4,8,80,38,42,76
Stirling,8102,3,17,6,13,62,51,11,57
Stenhousem'r,8102,4,15,8,13,55,48,7,53
Clyde,8102,5,14,9,13,51,50,1,51
Elgin,8102,6,14,7,15,53,60,-7,49
Annan Athlet,8102,7,12,11,13,48,41,7,47
Berwick,8102,8,9,10,17,31,58,-27,37
Edinburgh Ci,8102,9,7,9,20,36,63,-27,30
Cowdenbeath,8102,10,4,10,22,23,55,-32,22
Montrose,8103,1,23,8,5,61,36,25,77
Peterhead,8103,2,24,4,8,79,39,40,76
Stirling,8103,3,17,6,13,64,51,13,57
Clyde,8103,4,15,9,12,53,49,4,54
Stenhousem'r,8103,5,15,8,13,55,50,5,53
Elgin,8103,6,14,7,15,55,62,-7,49
Annan Athlet,8103,7,11,12,13,47,41,6,45
Berwick,8103,8,8,10,18,30,60,-30,34
Edinburgh Ci,8103,9,7,9,20,37,62,-25,30
Cowdenbeath,8103,10,4,11,21,23,54,-31,23
Montrose,8104,1,24,7,5,65,35,30,79
Peterhead,8104,2,24,4,8,80,39,41,76
Stenhousem'r,8104,3,16,8,12,59,48,11,56
Stirling,8104,4,16,6,14,62,55,7,54
Clyde,8104,5,15,9,12,52,48,4,54
Elgin,8104,6,14,6,16,54,66,-12,48
Annan Athlet,8104,7,12,11,13,50,41,9,47
Berwick,8104,8,8,10,18,29,59,-30,34
Edinburgh Ci,8104,9,7,9,20,37,63,-26,30
Cowdenbeath,8104,10,4,10,22,23,57,-34,22
Peterhead,8105,1,24,4,8,80,39,41,76
Montrose,8105,2,23,7,6,60,36,24,76
Stirling,8105,3,17,6,13,63,52,11,57
Clyde,8105,4,15,9,12,53,48,5,54
Stenhousem'r,8105,5,15,8,13,56,49,7,53
Elgin,8105,6,15,6,15,55,61,-6,51
Annan Athlet,8105,7,12,11,13,48,41,7,47
Berwick,8105,8,8,10,18,29,60,-31,34
Edinburgh Ci,8105,9,7,9,20,37,63,-26,30
Cowdenbeath,8105,10,4,10,22,23,55,-32,22
Montrose,8106,1,24,7,5,62,34,28,79
Peterhead,8106,2,24,4,8,79,39,40,76
Stirling,8106,3,17,6,13,61,51,10,57
Clyde,8106,4,15,9,12,54,49,5,54
Stenhousem'r,8106,5,15,8,13,55,47,8,53
Elgin,8106,6,14,6,16,53,63,-10,48
Annan Athlet,8106,7,11,12,13,48,42,6,45
Berwick,8106,8,8,10,18,30,61,-31,34
Edinburgh Ci,8106,9,7,9,20,37,62,-25,30
Cowdenbeath,8106,10,4,11,21,24,55,-31,23
Peterhead,8107,1,24,4,8,79,38,41,76
Montrose,8107,2,23,7,6,60,36,24,76
Stirling,8107,3,16,7,13,63,54,9,55
Stenhousem'r,8107,4,15,9,12,58,49,9,54
Clyde,8107,5,14,10,12,51,48,3,52
Elgin,8107,6,15,6,15,55,61,-6,51
Annan Athlet,8107,7,11,12,13,47,41,6,45
Berwick,8107,8,8,11,17,29,58,-29,35
Edinburgh Ci,8107,9,7,9,20,36,62,-26,30
Cowdenbeath,8107,10,4,11,21,23,54,-31,23
Peterhead,8108,1,24,4,8,79,38,41,76
Montrose,8108,2,23,7,6,59,37,22,76
Stirling,8108,3,17,6,13,64,53,11,57
Stenhousem'r,8108,4,15,8,13,57,50,7,53
Clyde,8108,5,14,10,12,52,49,3,52
Elgin,8108,6,15,6,15,56,60,-4,51
Annan Athlet,8108,7,12,11,13,49,41,8,47
Berwick,8108,8,8,11,17,30,59,-29,35
Edinburgh Ci,8108,9,7,9,20,36,62,-26,30
Cowdenbeath,8108,10,4,10,22,23,56,-33,22
Montrose,8109,1,24,7,5,60,34,26,79
Peterhead,8109,2,24,4,8,81,41,40,76
Stirling,8109,3,17,6,13,61,51,10,57
Stenhousem'r,8109,4,15,8,13,55,47,8,53
Clyde,8109,5,14,10,12,53,50,3,52
Elgin,8109,6,14,6,16,53,61,-8,48
Annan Athlet,8109,7,12,11,13,50,42,8,47
Berwick,8109,8,8,11,17,31,60,-29,35
Edinburgh Ci,8109,9,7,9,20,39,64,-25,30
Cowdenbeath,8109,10,4,10,22,24,57,-33,22
Montrose,8110,1,24,7,5,61,34,27,79
Peterhead,8110,2,24,4,8,82,39,43,76
Stirling,8110,3,17,6,13,63,51,12,57
Clyde,8110,4,15,9,12,53,48,5,54
Stenhousem'r,8110,5,15,8,13,55,49,6,53
Elgin,8110,6,14,6,16,53,62,-9,48
Annan Athlet,8110,7,12,11,13,50,43,7,47
Berwick,8110,8,8,10,18,29,60,-31,34
Edinburgh Ci,8110,9,7,9,20,37,65,-28,30
Cowdenbeath,8110,10,4,10,22,25,57,-32,22
Montrose,8111,1,24,7,5,61,35,26,79
Peterhead,8111,2,24,4,8,81,38,43,76
Stirling,8111,3,16,7,13,61,52,9,55
Stenhousem'r,8111,4,15,9,12,56,47,9,54
Clyde,8111,5,15,9,12,53,48,5,54
Elgin,8111,6,14,6,16,54,62,-8,48
Annan Athlet,8111,7,11,11,14,47,43,4,44
Berwick,8111,8,8,10,18,29,60,-31,34
Edinburgh Ci,8111,9,7,9,20,36,64,-28,30
Cowdenbeath,8111,10,5,10,21,25,54,-29,25
Montrose,8112,1,24,7,5,62,36,26,79
Peterhead,8112,2,23,4,9,78,40,38,73
Stirling,8112,3,16,7,13,60,51,9,55
Stenhousem'r,8112,4,15,9,12,55,46,9,54
Clyde,8112,5,15,9,12,54,49,5,54
Elgin,8112,6,14,6,16,55,63,-8,48
Annan Athlet,8112,7,11,11,14,48,43,5,44
Berwick,8112,8,8,10,18,30,61,-31,34
Edinburgh Ci,8112,9,8,9,19,38,61,-23,33
Cowdenbeath,8112,10,5,10,21,25,55,-30,25
Montrose,8113,1,24,7,5,64,38,26,79
Peterhead,8113,2,24,4,8,83,39,44,76
Stirling,8113,3,16,7,13,60,51,9,55
Stenhousem'r,8113,4,15,9,12,55,46,9,54
Clyde,8113,5,15,9,12,56,52,4,54
Elgin,8113,6,14,6,16,57,65,-8,48
Annan Athlet,8113,7,11,11,14,47,44,3,44
Berwick,8113,8,8,10,18,33,63,-30,34
Edinburgh Ci,8113,9,7,9,20,37,66,-29,30
Cowdenbeath,8113,10,5,10,21,26,54,-28,25
Montrose,8114,1,24,7,5,61,35,26,79
Peterhead,8114,2,23,5,8,78,39,39,74
Stirling,8114,3,17,6,13,64,51,13,57
Clyde,8114,4,15,9,12,56,48,8,54
Stenhousem'r,8114,5,15,8,13,55,50,5,53
Elgin,8114,6,14,6,16,54,62,-8,48
Annan Athlet,8114,7,12,11,13,49,42,7,47
Berwick,8114,8,8,10,18,29,63,-34,34
Edinburgh Ci,8114,9,7,10,19,37,61,-24,31
Cowdenbeath,8114,10,4,10,22,24,56,-32,22
Montrose,8115,1,24,7,5,62,34,28,79
Peterhead,8115,2,24,4,8,80,39,41,76
Stenhousem'r,8115,3,16,8,12,57,47,10,56
Stirling,8115,4,16,6,14,61,53,8,54
Clyde,8115,5,15,9,12,55,48,7,54
Elgin,8115,6,14,6,16,53,63,-10,48
Annan Athlet,8115,7,12,11,13,49,42,7,47
Berwick,8115,8,8,10,18,29,62,-33,34
Edinburgh Ci,8115,9,7,9,20,37,63,-26,30
Cowdenbeath,8115,10,4,10,22,24,56,-32,22
Montrose,8116,1,24,7,5,62,36,26,79
Peterhead,8116,2,24,4,8,81,40,41,76
Stirling,8116,3,17,6,13,65,52,13,57
Stenhousem'r,8116,4,15,8,13,56,51,5,53
Clyde,8116,5,14,9,13,53,51,2,51
Elgin,8116,6,14,6,16,55,63,-8,48
Annan Athlet,8116,7,12,11,13,50,43,7,47
Berwick,8116,8,9,10,17,32,60,-28,37
Edinburgh Ci,8116,9,7,9,20,38,64,-26,30
Cowdenbeath,8116,10,4,10,22,25,57,-32,22
Montrose,8117,1,23,8,5,60,35,25,77
Peterhead,8117,2,24,4,8,81,39,42,76
Stirling,8117,3,17,6,13,64,51,13,57
Clyde,8117,4,15,9,12,53,49,4,54
Stenhousem'r,8117,5,15,8,13,55,50,5,53
Elgin,8117,6,14,7,15,54,61,-7,49
Annan Athlet,8117,7,11,11,14,47,42,5,44
Berwick,8117,8,8,10,18,30,60,-30,34
Edinburgh Ci,8117,9,7,9,20,37,64,-27,30
Cowdenbeath,8117,10,5,10,21,24,54,-30,25
Montrose,8118,1,23,8,5,61,36,25,77
Peterhead,8118,2,24,4,8,81,39,42,76
Stirling,8118,3,17,6,13,64,51,13,57
Clyde,8118,4,15,9,12,54,49,5,54
Stenhousem'r,8118,5,15,8,13,55,50,5,53
Elgin,8118,6,14,7,15,55,62,-7,49
Annan Athlet,8118,7,12,11,13,51,41,10,47
Berwick,8118,8,8,10,18,30,61,-31,34
Edinburgh Ci,8118,9,7,9,20,37,64,-27,30
Cowdenbeath,8118,10,4,10,22,23,58,-35,22
Montrose,8119,1,23,8,5,60,35,25,77
Peterhead,8119,2,24,4,8,81,39,42,76
Stirling,8119,3,17,6,13,65,53,12,57
Clyde,8119,4,15,9,12,54,48,6,54
Stenhousem'r,8119,5,15,8,13,57,51,6,53
Elgin,8119,6,14,7,15,54,61,-7,49
Annan Athlet,8119,7,12,11,13,50,43,7,47
Berwick,8119,8,8,10,18,29,61,-32,34
Edinburgh Ci,8119,9,7,9,20,37,64,-27,30
Cowdenbeath,8119,10,4,10,22,25,57,-32,22
Montrose,8120,1,23,8,5,59,34,25,77
Peterhead,8120,2,24,4,8,80,38,42,76
Stirling,8120,3,17,6,13,61,51,10,57
Stenhousem'r,8120,4,15,8,13,55,47,8,53
Clyde,8120,5,14,10,12,52,49,3,52
Elgin,8120,6,14,7,15,53,60,-7,49
Annan Athlet,8120,7,12,11,13,50,41,9,47
Berwick,8120,8,8,11,17,30,59,-29,35
Edinburgh Ci,8120,9,7,9,20,36,63,-27,30
Cowdenbeath,8120,10,4,10,22,23,57,-34,22
Peterhead,8121,1,24,4,8,80,38,42,76
Montrose,8121,2,23,7,6,59,35,24,76
Stenhousem'r,8121,3,16,8,12,56,46,10,56
Stirling,8121,4,16,6,14,60,52,8,54
Clyde,8121,5,14,10,12,52,49,3,52
Elgin,8121,6,15,6,15,54,60,-6,51
Annan Athlet,8121,7,11,11,14,48,43,5,44
Berwick,8121,8,8,11,17,30,59,-29,35
Edinburgh Ci,8121,9,7,9,20,36,63,-27,30
Cowdenbeath,8121,10,5,10,21,25,55,-30,25
Montrose,8122,1,24,7,5,61,34,27,79
Peterhead,8122,2,23,5,8,78,39,39,74
Stenhousem'r,8122,3,16,8,12,56,46,10,56
Stirling,8122,4,16,6,14,60,52,8,54
Clyde,8122,5,15,9,12,52,48,4,54
Elgin,8122,6,14,6,16,53,62,-9,48
Annan Athlet,8122,7,11,12,13,47,41,6,45
Berwick,8122,8,8,10,18,29,59,-30,34
Edinburgh Ci,8122,9,7,10,19,37,61,-24,31
Cowdenbeath,8122,10,4,11,21,23,54,-31,23
Montrose,8123,1,24,7,5,61,34,27,79
Peterhead,8123,2,23,4,9,79,41,38,73
Stirling,8123,3,17,6,13,64,51,13,57
Clyde,8123,4,15,9,12,52,48,4,54
Stenhousem'r,8123,5,15,8,13,55,50,5,53
Elgin,8123,6,14,6,16,53,62,-9,48
Annan Athlet,8123,7,11,12,13,47,41,6,45
Berwick,8123,8,8,10,18,29,59,-30,34
Edinburgh Ci,8123,9,8,9,19,39,62,-23,33
Cowdenbeath,8123,10,4,11,21,23,54,-31,23
Peterhead,8124,1,24,4,8,81,39,42,76
Montrose,8124,2,23,7,6,60,36,24,76
Stirling,8124,3,17,6,13,62,52,10,57
Stenhousem'r,8124,4,15,8,13,56,48,8,53
Clyde,8124,5,14,10,12,52,49,3,52
Elgin,8124,6,15,6,15,55,61,-6,51
Annan Athlet,8124,7,12,11,13,51,42,9,47
Berwick,8124,8,8,11,17,30,59,-29,35
Edinburgh Ci,8124,9,7,9,20,37,64,-27,30
Cowdenbeath,8124,10,4,10,22,24,58,-34,22
Montrose,8125,1,23,8,5,59,34,25,77
Peterhead,8125,2,24,4,8,83,40,43,76
Stenhousem'r,8125,3,16,8,12,56,46,10,56
Stirling,8125,4,16,6,14,60,52,8,54
Clyde,8125,5,14,9,13,52,50,2,51
Elgin,8125,6,14,7,15,53,60,-7,49
Annan Athlet,8125,7,11,12,13,47,41,6,45
Berwick,8125,8,9,10,17,31,59,-28,37
Edinburgh Ci,8125,9,7,9,20,38,66,-28,30
Cowdenbeath,8125,10,4,11,21,23,54,-31,23
Montrose,8126,1,24,7,5,63,34,29,79
Peterhead,8126,2,23,5,8,78,39,39,74
Stirling,8126,3,17,6,13,63,51,12,57
Clyde,8126,4,15,9,12,53,48,5,54
Stenhousem'r,8126,5,15,8,13,55,49,6,53
Elgin,8126,6,14,6,16,53,64,-11,48
Annan Athlet,8126,7,11,12,13,48,42,6,45
Berwick,8126,8,8,10,18,29,60,-31,34
Edinburgh Ci,8126,9,7,10,19,37,61,-24,31
Cowdenbeath,8126,10,4,11,21,24,55,-31,23
Montrose,8127,1,24,7,5,60,34,26,79
Peterhead,8127,2,24,4,8,79,38,41,76
Stenhousem'r,8127,3,16,8,12,56,46,10,56
Stirling,8127,4,16,6,14,60,52,8,54
Clyde,8127,5,15,9,12,53,49,4,54
Elgin,8127,6,14,6,16,53,61,-8,48
Annan Athlet,8127,7,12,11,13,48,41,7,47
Berwick,8127,8,8,10,18,30,60,-30,34
Edinburgh Ci,8127,9,7,9,20,36,62,-26,30
Cowdenbeath,8127,10,4,10,22,23,55,-32,22
Peterhead,8128,1,24,4,8,79,38,41,76
Montrose,8128,2,23,7,6,59,35,24,76
Stenhousem'r,8128,3,16,8,12,57,47,10,56
Stirling,8128,4,16,6,14,61,53,8,54
Clyde,8128,5,14,10,12,53,50,3,52
Elgin,8128,6,15,6,15,54,60,-6,51
Annan Athlet,8128,7,12,11,13,48,41,7,47
Berwick,8128,8,8,11,17,31,60,-29,35
Edinburgh Ci,8128,9,7,9,20,36,62,-26,30
Cowdenbeath,8128,10,4,10,22,23,55,-32,22
Montrose,8129,1,23,8,5,61,36,25,77
Peterhead,8129,2,23,4,9,78,40,38,73
Stirling,8129,3,17,6,13,64,53,11,57
Stenhousem'r,8129,4,15,8,13,57,50,7,53
Clyde,8129,5,14,10,12,51,48,3,52
Elgin,8129,6,14,7,15,55,62,-7,49
Annan Athlet,8129,7,11,12,13,48,42,6,45
Berwick,8129,8,8,11,17,29,58,-29,35
Edinburgh Ci,8129,9,8,9,19,38,61,-23,33
Cowdenbeath,8129,10,4,11,21,24,55,-31,23
Montrose,8130,1,24,7,5,60,34,26,79
Peterhead,8130,2,24,4,8,81,40,41,76
Stirling,8130,3,17,6,13,62,51,11,57
Clyde,8130,4,15,9,12,56,49,7,54
Stenhousem'r,8130,5,15,8,13,55,48,7,53
Elgin,8130,6,14,6,16,53,61,-8,48
Annan Athlet,8130,7,11,12,13,49,43,6,45
Berwick,8130,8,8,10,18,30,63,-33,34
Edinburgh Ci,8130,9,7,9,20,38,64,-26,30
Cowdenbeath,8130,10,4,11,21,25,56,-31,23
Peterhead,8131,1,24,4,8,80,38,42,76
Montrose,8131,2,23,7,6,60,36,24,76
Stirling,8131,3,16,7,13,61,52,9,55
Stenhousem'r,8131,4,15,9,12,56,47,9,54
Clyde,8131,5,14,10,12,51,48,3,52
Elgin,8131,6,15,6,15,55,61,-6,51
Annan Athlet,8131,7,11,12,13,47,41,6,45
Berwick,8131,8,8,11,17,29,58,-29,35
Edinburgh Ci,8131,9,7,9,20,36,63,-27,30
Cowdenbeath,8131,10,4,11,21,23,54,-31,23
Montrose,8132,1,24,7,5,60,34,26,79
Peterhead,8132,2,24,4,8,80,38,42,76
Stirling,8132,3,16,7,13,62,53,9,55
Stenhousem'r,8132,4,15,9,12,57,48,9,54
Clyde,8132,5,15,9,12,54,49,5,54
Elgin,8132,6,14,6,16,53,61,-8,48
Annan Athlet,8132,7,12,11,13,48,41,7,47
Berwick,8132,8,8,10,18,30,61,-31,34
Edinburgh Ci,8132,9,7,9,20,36,63,-27,30
Cowdenbeath,8132,10,4,10,22,23,55,-32,22
Montrose,8133,1,24,7,5,62,36,26,79
Peterhead,8133,2,24,4,8,80,38,42,76
Stenhousem'r,8133,3,16,8,12,59,47,12,56
Stirling,8133,4,16,6,14,61,55,6,54
Clyde,8133,5,14,10,12,52,49,3,52
Elgin,8133,6,14,6,16,55,63,-8,48
Annan Athlet,8133,7,11,12,13,48,42,6,45
Berwick,8133,8,8,11,17,30,59,-29,35
Edinburgh Ci,8133,9,7,9,20,36,63,-27,30
Cowdenbeath,8133,10,4,11,21,24,55,-31,23
Montrose,8134,1,24,7,5,61,34,27,79
Peterhead,8134,2,24,4,8,80,38,42,76
Stenhousem'r,8134,3,16,8,12,59,49,10,56
Stirling,8134,4,16,6,14,63,55,8,54
Clyde,8134,5,15,9,12,52,48,4,54
Elgin,8134,6,14,6,16,53,62,-9,48
Annan Athlet,8134,7,11,11,14,47,42,5,44
Berwick,8134,8,8,10,18,29,59,-30,34
Edinburgh Ci,8134,9,7,9,20,36,63,-27,30
Cowdenbeath,8134,10,5,10,21,24,54,-30,25
Montrose,8135,1,24,7,5,61,35,26,79
Peterhead,8135,2,24,4,8,78,38,40,76
Stirling,8135,3,17,6,13,63,51,12,57
Stenhousem'r,8135,4,15,8,13,55,49,6,53
Clyde,8135,5,14,9,13,52,50,2,51
Elgin,8135,6,14,6,16,54,62,-8,48
Annan Athlet,8135,7,11,11,14,47,42,5,44
Berwick,8135,8,9,10,17,31,59,-28,37
Edinburgh Ci,8135,9,7,9,20,36,61,-25,30
Cowdenbeath,8135,10,5,10,21,24,54,-30,25
Montrose,8136,1,24,7,5,60,34,26,79
Peterhead,8136,2,24,4,8,80,39,41,76
Stirling,8136,3,16,7,13,61,52,9,55
Stenhousem'r,8136,4,15,9,12,56,47,9,54
Clyde,8136,5,14,9,13,51,51,0,51
Elgin,8136,6,14,6,16,53,61,-8,48
Annan Athlet,8136,7,11,12,13,47,41,6,45
Berwick,8136,8,9,10,17,32,58,-26,37
Edinburgh Ci,8136,9,7,9,20,37,63,-26,30
Cowdenbeath,8136,10,4,11,21,23,54,-31,23
Montrose,8137,1,24,7,5,61,34,27,79
Peterhead,8137,2,24,4,8,81,38,43,76
Stirling,8137,3,17,6,13,62,52,10,57
Clyde,8137,4,15,9,12,54,48,6,54
Stenhousem'r,8137,5,15,8,13,56,48,8,53
Elgin,8137,6,14,6,16,53,62,-9,48
Annan Athlet,8137,7,11,12,13,49,43,6,45
Berwick,8137,8,8,10,18,29,61,-32,34
Edinburgh Ci,8137,9,7,9,20,36,64,-28,30
Cowdenbeath,8137,10,4,11,21,25,56,-31,23
Montrose,8138,1,23,7,6,60,37,23,76
Peterhead,8138,2,23,4,9,77,39,38,73
Stenhousem'r,8138,3,16,8,12,57,46,11,56
Clyde,8138,4,15,9,12,56,48,8,54
Stirling,8138,5,16,6,14,60,53,7,54
Elgin,8138,6,15,6,15,56,61,-5,51
Annan Athlet,8138,7,12,11,13,49,41,8,47
Berwick,8138,8,8,10,18,29,63,-34,34
Edinburgh Ci,8138,9,8,9,19,37,60,-23,33
Cowdenbeath,8138,10,4,10,22,23,56,-33,22
Montrose,8139,1,24,7,5,64,37,27,79
Peterhead,8139,2,24,4,8,82,40,42,76
Stirling,8139,3,16,7,13,60,51,9,55
Stenhousem'r,8139,4,15,9,12,55,46,9,54
Clyde,8139,5,15,9,12,55,49,6,54
Elgin,8139,6,14,6,16,56,65,-9,48
Annan Athlet,8139,7,11,12,13,47,41,6,45
Berwick,8139,8,8,10,18,30,62,-32,34
Edinburgh Ci,8139,9,7,9,20,38,65,-27,30
Cowdenbeath,8139,10,4,11,21,23,54,-31,23
Montrose,8140,1,24,7,5,62,35,27,79
Peterhead,8140,2,23,4,9,80,42,38,73
Stirling,8140,3,16,7,13,61,52,9,55
Stenhousem'r,8140,4,15,9,12,56,47,9,54
Clyde,8140,5,14,10,12,52,49,3,52
Elgin,8140,6,14,6,16,54,63,-9,48
Annan Athlet,8140,7,12,11,13,50,42,8,47
Berwick,8140,8,8,11,17,30,59,-29,35
Edinburgh Ci,8140,9,8,9,19,40,63,-23,33
Cowdenbeath,8140,10,4,10,22,24,57,-33,22
Montrose,8141,1,24,7,5,64,34,30,79
Peterhead,8141,2,24,4,8,81,39,42,76
Stirling,8141,3,17,6,13,64,54,10,57
Stenhousem'r,8141,4,15,8,13,58,50,8,53
Clyde,8141,5,14,10,12,51,48,3,52
Elgin,8141,6,14,6,16,53,65,-12,48
Annan Athlet,8141,7,11,11,14,48,44,4,44
Berwick,8141,8,8,11,17,29,58,-29,35
Edinburgh Ci,8141,9,7,9,20,37,64,-27,30
Cowdenbeath,8141,10,5,10,21,26,55,-29,25
Peterhead,8142,1,24,4,8,80,38,42,76
Montrose,8142,2,23,7,6,59,35,24,76
Stirling,8142,3,16,7,13,62,53,9,55
Stenhousem'r,8142,4,15,9,12,57,48,9,54
Clyde,8142,5,15,9,12,53,49,4,54
Elgin,8142,6,15,6,15,54,60,-6,51
Annan Athlet,8142,7,12,11,13,48,41,7,47
Berwick,8142,8,8,10,18,30,60,-30,34
Edinburgh Ci,8142,9,7,9,20,36,63,-27,30
Cowdenbeath,8142,10,4,10,22,23,55,-32,22
Peterhead,8143,1,24,4,8,80,38,42,76
Montrose,8143,2,23,7,6,59,35,24,76
Stirling,8143,3,16,7,13,62,53,9,55
Stenhousem'r,8143,4,15,9,12,57,48,9,54
Clyde,8143,5,14,10,12,51,48,3,52
Elgin,8143,6,15,6,15,54,60,-6,51
Annan Athlet,8143,7,12,11,13,49,41,8,47
Berwick,8143,8,8,11,17,29,58,-29,35
Edinburgh Ci,8143,9,7,9,20,36,63,-27,30
Cowdenbeath,8143,10,4,10,22,23,56,-33,22
Montrose,8144,1,23,8,5,61,36,25,77
Peterhead,8144,2,24,4,8,80,39,41,76
Stirling,8144,3,17,6,13,63,52,11,57
Stenhousem'r,8144,4,15,8,13,56,49,7,53
Clyde,8144,5,14,10,12,52,49,3,52
Elgin,8144,6,14,7,15,55,62,-7,49
Annan Athlet,8144,7,11,11,14,49,44,5,44
Berwick,8144,8,8,11,17,30,59,-29,35
Edinburgh Ci,8144,9,7,9,20,37,63,-26,30
Cowdenbeath,8144,10,5,10,21,26,56,-30,25
Montrose,8145,1,24,7,5,61,35,26,79
Peterhead,8145,2,24,4,8,79,38,41,76
Stenhousem'r,8145,3,16,8,12,57,47,10,56
Stirling,8145,4,16,6,14,61,53,8,54
Clyde,8145,5,15,9,12,54,48,6,54
Elgin,8145,6,14,6,16,54,62,-8,48
Annan Athlet,8145,7,12,11,13,51,42,9,47
Berwick,8145,8,8,10,18,29,61,-32,34
Edinburgh Ci,8145,9,7,9,20,36,62,-26,30
Cowdenbeath,8145,10,4,10,22,24,58,-34,22
Montrose,8146,1,23,7,6,60,36,24,76
Peterhead,8146,2,23,4,9,78,40,38,73
Stirling,8146,3,17,6,13,61,51,10,57
Stenhousem'r,8146,4,15,8,13,55,47,8,53
Clyde,8146,5,14,9,13,51,50,1,51
Elgin,8146,6,15,6,15,55,61,-6,51
Annan Athlet,8146,7,12,11,13,50,41,9,47
Berwick,8146,8,9,10,17,31,58,-27,37
Edinburgh Ci,8146,9,8,9,19,38,61,-23,33
Cowdenbeath,8146,10,4,10,22,23,57,-34,22
Montrose,8147,1,23,8,5,60,35,25,77
Peterhead,8147,2,23,4,9,77,41,36,73
Stirling,8147,3,17,6,13,61,51,10,57
Clyde,8147,4,15,9,12,57,49,8,54
Stenhousem'r,8147,5,15,8,13,55,47,8,53
Elgin,8147,6,14,7,15,54,61,-7,49
Annan Athlet,8147,7,12,11,13,48,41,7,47
Berwick,8147,8,8,10,18,30,64,-34,34
Edinburgh Ci,8147,9,8,9,19,39,60,-21,33
Cowdenbeath,8147,10,4,10,22,23,55,-32,22
Montrose,8148,1,23,7,6,59,36,23,76
Peterhead,8148,2,23,5,8,78,39,39,74
Stenhousem'r,8148,3,16,8,12,57,47,10,56
Stirling,8148,4,16,6,14,61,53,8,54
Clyde,8148,5,14,9,13,52,50,2,51
Elgin,8148,6,15,6,15,55,60,-5,51
Annan Athlet,8148,7,11,11,14,48,44,4,44
Berwick,8148,8,9,10,17,31,59,-28,37
Edinburgh Ci,8148,9,7,10,19,37,61,-24,31
Cowdenbeath,8148,10,5,10,21,26,55,-29,25
Montrose,8149,1,24,7,5,60,34,26,79
Peterhead,8149,2,24,4,8,78,38,40,76
Stenhousem'r,8149,3,16,8,12,59,46,13,56
Stirling,8149,4,16,6,14,60,55,5,54
Clyde,8149,5,14,9,13,52,50,2,51
Elgin,8149,6,14,6,16,53,61,-8,48
Annan Athlet,8149,7,12,11,13,49,41,8,47
Berwick,8149,8,9,10,17,31,59,-28,37
Edinburgh Ci,8149,9,7,9,20,36,61,-25,30
Cowdenbeath,8149,10,4,10,22,23,56,-33,22
Peterhead,8150,1,24,4,8,80,38,42,76
Montrose,8150,2,23,7,6,59,36,23,76
Stenhousem'r,8150,3,16,8,12,56,46,10,56
Stirling,8150,4,16,6,14,60,52,8,54
Clyde,8150,5,14,9,13,51,50,1,51
Elgin,8150,6,15,6,15,55,60,-5,51
Annan Athlet,8150,7,12,11,13,52,42,10,47
Berwick,8150,8,9,10,17,31,58,-27,37
Edinburgh Ci,8150,9,7,9,20,36,63,-27,30
Cowdenbeath,8150,10,4,10,22,24,59,-35,22
Peterhead,8151,1,24,4,8,82,40,42,76
Montrose,8151,2,23,7,6,60,36,24,76
Stirling,8151,3,17,6,13,62,52,10,57
Clyde,8151,4,15,9,12,53,48,5,54
Stenhousem'r,8151,5,15,8,13,56,48,8,53
Elgin,8151,6,15,6,15,55,61,-6,51
Annan Athlet,8151,7,11,11,14,47,42,5,44
Berwick,8151,8,8,10,18,29,60,-31,34
Edinburgh Ci,8151,9,7,9,20,38,65,-27,30
Cowdenbeath,8151,10,5,10,21,24,54,-30,25
Montrose,8152,1,24,7,5,64,36,28,79
Peterhead,8152,2,23,5,8,77,38,39,74
Stenhousem'r,8152,3,16,8,12,56,46,10,56
Stirling,8152,4,16,6,14,60,52,8,54
Clyde,8152,5,14,10,12,54,51,3,52
Elgin,8152,6,14,6,16,55,65,-10,48
Annan Athlet,8152,7,11,11,14,47,42,5,44
Berwick,8152,8,8,11,17,32,61,-29,35
Edinburgh Ci,8152,9,7,10,19,36,60,-24,31
Cowdenbeath,8152,10,5,10,21,24,54,-30,25
Montrose,8153,1,24,7,5,64,34,30,79
Peterhead,8153,2,24,4,8,80,39,41,76
Stirling,8153,3,17,6,13,62,51,11,57
Clyde,8153,4,15,9,12,53,48,5,54
Stenhousem'r,8153,5,15,8,13,55,48,7,53
Elgin,8153,6,14,6,16,53,65,-12,48
Annan Athlet,8153,7,11,12,13,47,41,6,45
Berwick,8153,8,8,10,18,29,60,-31,34
Edinburgh Ci,8153,9,7,9,20,37,63,-26,30
Cowdenbeath,8153,10,4,11,21,23,54,-31,23
Peterhead,8154,1,24,4,8,78,38,40,76
Montrose,8154,2,23,7,6,59,36,23,76
Stirling,8154,3,16,7,13,61,52,9,55
Stenhousem'r,8154,4,15,9,12,56,47,9,54
Clyde,8154,5,14,10,12,52,49,3,52
Elgin,8154,6,15,6,15,55,60,-5,51
Annan Athlet,8154,7,12,11,13,48,41,7,47
Berwick,8154,8,8,11,17,30,59,-29,35
Edinburgh Ci,8154,9,7,9,20,36,61,-25,30
Cowdenbeath,8154,10,4,10,22,23,55,-32,22
Peterhead,8155,1,24,4,8,79,38,41,76
Montrose,8155,2,23,7,6,59,37,22,76
Stirling,8155,3,16,7,13,61,52,9,55
Stenhousem'r,8155,4,15,9,12,56,47,9,54
Clyde,8155,5,15,9,12,55,48,7,54
Elgin,8155,6,15,6,15,56,60,-4,51
Annan Athlet,8155,7,12,11,13,50,42,8,47
Berwick,8155,8,8,10,18,29,62,-33,34
Edinburgh Ci,8155,9,7,9,20,36,62,-26,30
Cowdenbeath,8155,10,4,10,22,24,57,-33,22
Montrose,8156,1,24,7,5,63,35,28,79
Peterhead,8156,2,23,5,8,77,38,39,74
Stenhousem'r,8156,3,16,8,12,56,46,10,56
Stirling,8156,4,16,6,14,60,52,8,54
Clyde,8156,5,14,9,13,51,51,0,51
Elgin,8156,6,14,6,16,54,64,-10,48
Annan Athlet,8156,7,12,11,13,51,42,9,47
Berwick,8156,8,9,10,17,32,58,-26,37
Edinburgh Ci,8156,9,7,10,19,36,60,-24,31
Cowdenbeath,8156,10,4,10,22,24,58,-34,22
Montrose,8157,1,24,7,5,61,35,26,79
Peterhead,8157,2,24,4,8,83,39,44,76
Stirling,8157,3,17,6,13,65,54,11,57
Clyde,8157,4,15,9,12,56,49,7,54
Stenhousem'r,8157,5,15,8,13,58,51,7,53
Elgin,8157,6,14,6,16,54,62,-8,48
Annan Athlet,8157,7,11,11,14,48,45,3,44
Berwick,8157,8,8,10,18,30,63,-33,34
Edinburgh Ci,8157,9,7,9,20,37,66,-29,30
Cowdenbeath,8157,10,5,10,21,27,55,-28,25
Montrose,8158,1,24,7,5,61,34,27,79
Peterhead,8158,2,24,4,8,79,38,41,76
Stirling,8158,3,17,6,13,62,52,10,57
Stenhousem'r,8158,4,15,8,13,56,48,8,53
Clyde,8158,5,14,10,12,53,50,3,52
Elgin,8158,6,14,6,16,53,62,-9,48
Annan Athlet,8158,7,11,11,14,47,42,5,44
Berwick,8158,8,8,11,17,31,60,-29,35
Edinburgh Ci,8158,9,7,9,20,36,62,-26,30
Cowdenbeath,8158,10,5,10,21,24,54,-30,25
Montrose,8159,1,23,8,5,61,36,25,77
Peterhead,8159,2,24,4,8,79,39,40,76
Stirling,8159,3,17,6,13,63,51,12,57
Clyde,8159,4,15,9,12,57,50,7,54
Stenhousem'r,8159,5,15,8,13,55,49,6,53
Elgin,8159,6,14,7,15,55,62,-7,49
Annan Athlet,8159,7,11,12,13,48,42,6,45
Berwick,8159,8,8,10,18,31,64,-33,34
Edinburgh Ci,8159,9,7,9,20,37,62,-25,30
Cowdenbeath,8159,10,4,11,21,24,55,-31,23
Montrose,8160,1,24,7,5,61,34,27,79
Peterhead,8160,2,23,5,8,78,39,39,74
Stenhousem'r,8160,3,16,8,12,56,46,10,56
Stirling,8160,4,16,6,14,60,52,8,54
Clyde,8160,5,14,10,12,51,48,3,52
Elgin,8160,6,14,6,16,53,62,-9,48
Annan Athlet,8160,7,12,11,13,48,41,7,47
Berwick,8160,8,8,11,17,29,58,-29,35
Edinburgh Ci,8160,9,7,10,19,37,61,-24,31
Cowdenbeath,8160,10,4,10,22,23,55,-32,22
Montrose,8161,1,24,7,5,60,34,26,79
Peterhead,8161,2,24,4,8,80,39,41,76
Stirling,8161,3,17,6,13,62,51,11,57
Stenhousem'r,8161,4,15,8,13,55,48,7,53
Clyde,8161,5,14,10,12,51,48,3,52
Elgin,8161,6,14,6,16,53,61,-8,48
Annan Athlet,8161,7,11,12,13,47,41,6,45
Berwick,8161,8,8,11,17,29,58,-29,35
Edinburgh Ci,8161,9,7,9,20,37,63,-26,30
Cowdenbeath,8161,10,4,11,21,23,54,-31,23
Montrose,8162,1,23,8,5,62,37,25,77
Peterhead,8162,2,24,4,8,79,39,40,76
Stirling,8162,3,17,6,13,61,51,10,57
Stenhousem'r,8162,4,15,8,13,55,47,8,53
Clyde,8162,5,14,9,13,51,50,1,51
Elgin,8162,6,14,7,15,56,63,-7,49
Annan Athlet,8162,7,11,11,14,48,44,4,44
Berwick,8162,8,9,10,17,31,58,-27,37
Edinburgh Ci,8162,9,7,9,20,37,62,-25,30
Cowdenbeath,8162,10,5,10,21,26,55,-29,25
Montrose,8163,1,24,7,5,61,34,27,79
Peterhead,8163,2,24,4,8,79,38,41,76
Stirling,8163,3,17,6,13,61,51,10,57
Stenhousem'r,8163,4,15,8,13,55,47,8,53
Clyde,8163,5,14,10,12,52,49,3,52
Elgin,8163,6,14,6,16,53,62,-9,48
Annan Athlet,8163,7,11,11,14,47,43,4,44
Berwick,8163,8,8,11,17,30,59,-29,35
Edinburgh Ci,8163,9,7,9,20,36,62,-26,30
Cowdenbeath,8163,10,5,10,21,25,54,-29,25
Montrose,8164,1,24,7,5,60,34,26,79
Peterhead,8164,2,24,4,8,82,39,43,76
Stenhousem'r,8164,3,16,8,12,57,47,10,56
Stirling,8164,4,16,6,14,61,53,8,54
Clyde,8164,5,14,10,12,51,48,3,52
Elgin,8164,6,14,6,16,53,61,-8,48
Annan Athlet,8164,7,11,11,14,47,43,4,44
Berwick,8164,8,8,11,17,29,58,-29,35
Edinburgh Ci,8164,9,7,9,20,37,65,-28,30
Cowdenbeath,8164,10,5,10,21,25,54,-29,25
Montrose,8165,1,24,7,5,61,34,27,79
Peterhead,8165,2,24,4,8,81,39,42,76
Stenhousem'r,8165,3,16,8,12,56,46,10,56
Stirling,8165,4,16,6,14,60,52,8,54
Clyde,8165,5,15,9,12,55,49,6,54
Elgin,8165,6,14,6,16,53,62,-9,48
Annan Athlet,8165,7,11,12,13,47,41,6,45
Berwick,8165,8,8,10,18,30,62,-32,34
Edinburgh Ci,8165,9,7,9,20,37,64,-27,30
Cowdenbeath,8165,10,4,11,21,23,54,-31,23
Montrose,8166,1,24,7,5,61,35,26,79
Peterhead,8166,2,23,4,9,78,40,38,73
Stenhousem'r,8166,3,16,8,12,57,47,10,56
Stirling,8166,4,16,6,14,61,53,8,54
Clyde,8166,5,15,9,12,53,48,5,54
Elgin,8166,6,14,6,16,54,62,-8,48
Annan Athlet,8166,7,11,11,14,48,45,3,44
Berwick,8166,8,8,10,18,29,60,-31,34
Edinburgh Ci,8166,9,8,9,19,38,61,-23,33
Cowdenbeath,8166,10,5,10,21,27,55,-28,25
Montrose,8167,1,24,7,5,61,34,27,79
Peterhead,8167,2,23,4,9,77,41,36,73
Stirling,8167,3,17,6,13,62,52,10,57
Stenhousem'r,8167,4,15,8,13,56,48,8,53
Clyde,8167,5,14,9,13,53,51,2,51
Elgin,8167,6,14,6,16,53,62,-9,48
Annan Athlet,8167,7,11,12,13,48,42,6,45
Berwick,8167,8,9,10,17,32,60,-28,37
Edinburgh Ci,8167,9,8,9,19,39,60,-21,33
Cowdenbeath,8167,10,4,11,21,24,55,-31,23
Montrose,8168,1,24,7,5,62,35,27,79
Peterhead,8168,2,24,4,8,80,39,41,76
Stirling,8168,3,16,7,13,60,51,9,55
Stenhousem'r,8168,4,15,9,12,55,46,9,54
Clyde,8168,5,15,9,12,52,48,4,54
Elgin,8168,6,14,6,16,54,63,-9,48
Annan Athlet,8168,7,12,11,13,51,41,10,47
Berwick,8168,8,8,10,18,29,59,-30,34
Edinburgh Ci,8168,9,7,9,20,37,63,-26,30
Cowdenbeath,8168,10,4,10,22,23,58,-35,22
Montrose,8169,1,23,8,5,60,35,25,77
Peterhead,8169,2,24,4,8,80,38,42,76
Stenhousem'r,8169,3,16,8,12,56,46,10,56
Stirling,8169,4,16,6,14,60,52,8,54
Clyde,8169,5,15,9,12,55,50,5,54
Elgin,8169,6,14,7,15,54,61,-7,49
Annan Athlet,8169,7,11,12,13,47,41,6,45
Berwick,8169,8,8,10,18,31,62,-31,34
Edinburgh Ci,8169,9,7,9,20,36,63,-27,30
Cowdenbeath,8169,10,4,11,21,23,54,-31,23
Montrose,8170,1,24,7,5,61,34,27,79
Peterhead,8170,2,23,4,9,78,40,38,73
Stirling,8170,3,17,6,13,62,51,11,57
Stenhousem'r,8170,4,15,8,13,55,48,7,53
Clyde,8170,5,14,10,12,53,50,3,52
Elgin,8170,6,14,6,16,53,62,-9,48
Annan Athlet,8170,7,12,11,13,48,41,7,47
Berwick,8170,8,8,11,17,31,60,-29,35
Edinburgh Ci,8170,9,8,9,19,38,61,-23,33
Cowdenbeath,8170,10,4,10,22,23,55,-32,22
Montrose,8171,1,24,7,5,62,36,26,79
Peterhead,8171,2,24,4,8,80,38,42,76
Stenhousem'r,8171,3,16,8,12,57,47,10,56
Stirling,8171,4,16,6,14,61,53,8,54
Clyde,8171,5,14,9,13,51,50,1,51
Elgin,8171,6,14,6,16,55,63,-8,48
Annan Athlet,8171,7,12,11,13,50,42,8,47
Berwick,8171,8,9,10,17,31,58,-27,37
Edinburgh Ci,8171,9,7,9,20,36,63,-27,30
Cowdenbeath,8171,10,4,10,22,24,57,-33,22
Peterhead,8172,1,24,4,8,85,39,46,76
Montrose,8172,2,23,7,6,59,36,23,76
Stenhousem'r,8172,3,16,8,12,56,46,10,56
Stirling,8172,4,16,6,14,60,52,8,54
Clyde,8172,5,15,9,12,54,49,5,54
Elgin,8172,6,15,6,15,55,60,-5,51
Annan Athlet,8172,7,12,11,13,51,42,9,47
Berwick,8172,8,8,10,18,30,61,-31,34
Edinburgh Ci,8172,9,7,9,20,37,68,-31,30
Cowdenbeath,8172,10,4,10,22,24,58,-34,22
Montrose,8173,1,23,8,5,60,35,25,77
Peterhead,8173,2,24,4,8,79,38,41,76
Stirling,8173,3,17,6,13,62,52,10,57
Stenhousem'r,8173,4,15,8,13,56,48,8,53
Clyde,8173,5,14,9,13,51,50,1,51
Elgin,8173,6,14,7,15,54,61,-7,49
Annan Athlet,8173,7,12,11,13,52,41,11,47
Berwick,8173,8,9,10,17,31,58,-27,37
Edinburgh Ci,8173,9,7,9,20,36,62,-26,30
Cowdenbeath,8173,10,4,10,22,23,59,-36,22
Montrose,8174,1,24,7,5,63,34,29,79
Peterhead,8174,2,24,4,8,80,40,40,76
Stenhousem'r,8174,3,16,8,12,57,47,10,56
Stirling,8174,4,16,6,14,61,53,8,54
Clyde,8174,5,14,10,12,51,48,3,52
Elgin,8174,6,14,6,16,53,64,-11,48
Annan Athlet,8174,7,12,11,13,49,41,8,47
Berwick,8174,8,8,11,17,29,58,-29,35
Edinburgh Ci,8174,9,7,9,20,38,63,-25,30
Cowdenbeath,8174,10,4,10,22,23,56,-33,22
Montrose,8175,1,23,8,5,60,35,25,77
Peterhead,8175,2,24,4,8,79,39,40,76
Stirling,8175,3,16,7,13,62,53,9,55
Stenhousem'r,8175,4,15,9,12,57,48,9,54
Clyde,8175,5,15,9,12,53,49,4,54
Elgin,8175,6,14,7,15,54,61,-7,49
Annan Athlet,8175,7,12,11,13,49,42,7,47
Berwick,8175,8,8,10,18,30,60,-30,34
Edinburgh Ci,8175,9,7,9,20,37,62,-25,30
Cowdenbeath,8175,10,4,10,22,24,56,-32,22
Montrose,8176,1,24,7,5,63,34,29,79
Peterhead,8176,2,24,4,8,81,38,43,76
Stirling,8176,3,17,6,13,64,53,11,57
Clyde,8176,4,15,9,12,53,48,5,54
Stenhousem'r,8176,5,15,8,13,57,50,7,53
Elgin,8176,6,14,6,16,53,64,-11,48
Annan Athlet,8176,7,12,11,13,48,41,7,47
Berwick,8176,8,8,10,18,29,60,-31,34
Edinburgh Ci,8176,9,7,9,20,36,64,-28,30
Cowdenbeath,8176,10,4,10,22,23,55,-32,22
Montrose,8177,1,23,7,6,59,35,24,76
Peterhead,8177,2,23,5,8,80,41,39,74
Stirling,8177,3,16,7,13,62,53,9,55
Stenhousem'r,8177,4,15,9,12,57,48,9,54
Clyde,8177,5,15,9,12,55,48,7,54
Elgin,8177,6,15,6,15,54,60,-6,51
Annan Athlet,8177,7,11,12,13,48,42,6,45
Berwick,8177,8,8,10,18,29,62,-33,34
Edinburgh Ci,8177,9,7,10,19,39,63,-24,31
Cowdenbeath,8177,10,4,11,21,24,55,-31,23
Montrose,8178,1,24,7,5,63,35,28,79
Peterhead,8178,2,24,4,8,80,38,42,76
Stenhousem'r,8178,3,16,8,12,57,47,10,56
Stirling,8178,4,16,6,14,61,53,8,54
Clyde,8178,5,14,10,12,51,48,3,52
Elgin,8178,6,14,6,16,54,64,-10,48
Annan Athlet,8178,7,11,11,14,47,42,5,44
Berwick,8178,8,8,11,17,29,58,-29,35
Edinburgh Ci,8178,9,7,9,20,36,63,-27,30
Cowdenbeath,8178,10,5,10,21,24,54,-30,25
Montrose,8179,1,23,8,5,59,34,25,77
Peterhead,8179,2,24,4,8,80,38,42,76
Stirling,8179,3,17,6,13,64,52,12,57
Clyde,8179,4,15,9,12,53,48,5,54
Stenhousem'r,8179,5,15,8,13,56,50,6,53
Elgin,8179,6,14,7,15,53,60,-7,49
Annan Athlet,8179,7,11,12,13,47,41,6,45
Berwick,8179,8,8,10,18,29,60,-31,34
Edinburgh Ci,8179,9,7,9,20,36,63,-27,30
Cowdenbeath,8179,10,4,11,21,23,54,-31,23
Montrose,8180,1,24,7,5,64,34,30,79
Peterhead,8180,2,24,4,8,79,38,41,76
Stirling,8180,3,16,7,13,61,52,9,55
Stenhousem'r,8180,4,15,9,12,56,47,9,54
Clyde,8180,5,15,9,12,55,48,7,54
Elgin,8180,6,14,6,16,53,65,-12,48
Annan Athlet,8180,7,11,12,13,47,41,6,45
Berwick,8180,8,8,10,18,29,62,-33,34
Edinburgh Ci,8180,9,7,9,20,36,62,-26,30
Cowdenbeath,8180,10,4,11,21,23,54,-31,23
Montrose,8181,1,24,7,5,60,34,26,79
Peterhead,8181,2,24,4,8,79,38,41,76
Stirling,8181,3,17,6,13,62,51,11,57
Stenhousem'r,8181,4,15,8,13,55,48,7,53
Clyde,8181,5,14,10,12,52,49,3,52
Elgin,8181,6,14,6,16,53,61,-8,48
Annan Athlet,8181,7,12,11,13,51,41,10,47
Berwick,8181,8,8,11,17,30,59,-29,35
Edinburgh Ci,8181,9,7,9,20,36,62,-26,30
Cowdenbeath,8181,10,4,10,22,23,58,-35,22
Montrose,8182,1,24,7,5,61,34,27,79
Peterhead,8182,2,24,4,8,79,39,40,76
Stirling,8182,3,16,7,13,61,52,9,55
Stenhousem'r,8182,4,15,9,12,56,47,9,54
Clyde,8182,5,14,10,12,51,48,3,52
Elgin,8182,6,14,6,16,53,62,-9,48
Annan Athlet,8182,7,11,12,13,48,42,6,45
Berwick,8182,8,8,11,17,29,58,-29,35
Edinburgh Ci,8182,9,7,9,20,37,62,-25,30
Cowdenbeath,8182,10,4,11,21,24,55,-31,23
Montrose,8183,1,24,7,5,60,34,26,79
Peterhead,8183,2,24,4,8,83,39,44,76
Stirling,8183,3,17,6,13,63,53,10,57
Stenhousem'r,8183,4,15,8,13,57,49,8,53
Clyde,8183,5,14,9,13,52,52,0,51
Elgin,8183,6,14,6,16,53,61,-8,48
Annan Athlet,8183,7,12,11,13,48,41,7,47
Berwick,8183,8,9,10,17,33,59,-26,37
Edinburgh Ci,8183,9,7,9,20,37,66,-29,30
Cowdenbeath,8183,10,4,10,22,23,55,-32,22
Peterhead,8184,1,24,4,8,83,38,45,76
Montrose,8184,2,23,7,6,59,36,23,76
Stenhousem'r,8184,3,16,8,12,56,46,10,56
Stirling,8184,4,16,6,14,60,52,8,54
Clyde,8184,5,15,9,12,54,48,6,54
Elgin,8184,6,15,6,15,55,60,-5,51
Annan Athlet,8184,7,11,11,14,47,42,5,44
Berwick,8184,8,8,10,18,29,61,-32,34
Edinburgh Ci,8184,9,7,9,20,36,66,-30,30
Cowdenbeath,8184,10,5,10,21,24,54,-30,25
Montrose,8185,1,23,8,5,59,34,25,77
Peterhead,8185,2,23,5,8,78,39,39,74
Stirling,8185,3,16,7,13,61,52,9,55
Stenhousem'r,8185,4,15,9,12,56,47,9,54
Clyde,8185,5,15,9,12,55,48,7,54
Elgin,8185,6,14,7,15,53,60,-7,49
Annan Athlet,8185,7,12,11,13,49,42,7,47
Berwick,8185,8,8,10,18,29,62,-33,34
Edinburgh Ci,8185,9,7,10,19,37,61,-24,31
Cowdenbeath,8185,10,4,10,22,24,56,-32,22
Montrose,8186,1,23,8,5,61,36,25,77
Peterhead,8186,2,24,4,8,82,38,44,76
Stirling,8186,3,16,7,13,62,53,9,55
Stenhousem'r,8186,4,15,9,12,57,48,9,54
Clyde,8186,5,15,9,12,53,49,4,54
Elgin,8186,6,14,7,15,55,62,-7,49
Annan Athlet,8186,7,11,11,14,47,42,5,44
Berwick,8186,8,8,10,18,30,60,-30,34
Edinburgh Ci,8186,9,7,9,20,36,65,-29,30
Cowdenbeath,8186,10,5,10,21,24,54,-30,25
Montrose,8187,1,23,8,5,60,35,25,77
Peterhead,8187,2,23,5,8,78,39,39,74
Stirling,8187,3,17,6,13,64,51,13,57
Clyde,8187,4,15,9,12,56,50,6,54
Stenhousem'r,8187,5,15,8,13,55,50,5,53
Elgin,8187,6,14,7,15,54,61,-7,49
Annan Athlet,8187,7,11,12,13,48,42,6,45
Berwick,8187,8,8,10,18,31,63,-32,34
Edinburgh Ci,8187,9,7,10,19,37,61,-24,31
Cowdenbeath,8187,10,4,11,21,24,55,-31,23
Montrose,8188,1,24,7,5,63,34,29,79
Peterhead,8188,2,23,5,8,77,38,39,74
Stenhousem'r,8188,3,16,8,12,57,47,10,56
Stirling,8188,4,16,6,14,61,53,8,54
Clyde,8188,5,14,10,12,51,48,3,52
Elgin,8188,6,14,6,16,53,64,-11,48
Annan Athlet,8188,7,12,11,13,50,43,7,47
Berwick,8188,8,8,11,17,29,58,-29,35
Edinburgh Ci,8188,9,7,10,19,36,60,-24,31
Cowdenbeath,8188,10,4,10,22,25,57,-32,22
Montrose,8189,1,24,7,5,61,34,27,79
Peterhead,8189,2,24,4,8,79,38,41,76
Stirling,8189,3,17,6,13,62,52,10,57
Stenhousem'r,8189,4,15,8,13,56,48,8,53
Clyde,8189,5,14,10,12,53,50,3,52
Elgin,8189,6,14,6,16,53,62,-9,48
Annan Athlet,8189,7,12,11,13,48,41,7,47
Berwick,8189,8,8,11,17,31,60,-29,35
Edinburgh Ci,8189,9,7,9,20,36,62,-26,30
Cowdenbeath,8189,10,4,10,22,23,55,-32,22
Montrose,8190,1,24,7,5,61,35,26,79
Peterhead,8190,2,24,4,8,80,40,40,76
Stenhousem'r,8190,3,16,8,12,58,47,11,56
Stirling,8190,4,16,6,14,61,54,7,54
Clyde,8190,5,15,9,12,54,49,5,54
Elgin,8190,6,14,6,16,54,62,-8,48
Annan Athlet,8190,7,12,11,13,49,42,7,47
Berwick,8190,8,8,10,18,30,61,-31,34
Edinburgh Ci,8190,9,7,9,20,38,63,-25,30
Cowdenbeath,8190,10,4,10,22,24,56,-32,22
Peterhead,8191,1,24,4,8,82,38,44,76
Montrose,8191,2,23,7,6,59,35,24,76
Stenhousem'r,8191,3,16,8,12,57,46,11,56
Stirling,8191,4,16,6,14,60,53,7,54
Clyde,8191,5,15,9,12,53,49,4,54
Elgin,8191,6,15,6,15,54,60,-6,51
Annan Athlet,8191,7,11,11,14,49,44,5,44
Berwick,8191,8,8,10,18,30,60,-30,34
Edinburgh Ci,8191,9,7,9,20,36,65,-29,30
Cowdenbeath,8191,10,5,10,21,26,56,-30,25
Montrose,8192,1,24,7,5,62,34,28,79
Peterhead,8192,2,24,4,8,79,38,41,76
Stirling,8192,3,17,6,13,64,52,12,57
Stenhousem'r,8192,4,15,8,13,56,50,6,53
Clyde,8192,5,14,10,12,52,49,3,52
Elgin,8192,6,14,6,16,53,63,-10,48
Annan Athlet,8192,7,11,11,14,48,44,4,44
Berwick,8192,8,8,11,17,30,59,-29,35
Edinburgh Ci,8192,9,7,9,20,36,62,-26,30
Cowdenbeath,8192,10,5,10,21,26,55,-29,25
Montrose,8193,1,23,8,5,59,34,25,77
Peterhead,8193,2,24,4,8,79,39,40,76
Stenhousem'r,8193,3,16,8,12,59,46,13,56
Stirling,8193,4,16,6,14,60,55,5,54
Clyde,8193,5,14,10,12,51,48,3,52
Elgin,8193,6,14,7,15,53,60,-7,49
Annan Athlet,8193,7,12,11,13,48,41,7,47
Berwick,8193,8,8,11,17,29,58,-29,35
Edinburgh Ci,8193,9,7,9,20,37,62,-25,30
Cowdenbeath,8193,10,4,10,22,23,55,-32,22
Montrose,8194,1,24,7,5,63,35,28,79
Peterhead,8194,2,24,4,8,81,40,41,76
Stirling,8194,3,17,6,13,62,51,11,57
Clyde,8194,4,15,9,12,54,48,6,54
Stenhousem'r,8194,5,15,8,13,55,48,7,53
Elgin,8194,6,14,6,16,54,64,-10,48
Annan Athlet,8194,7,12,11,13,48,41,7,47
Berwick,8194,8,8,10,18,29,61,-32,34
Edinburgh Ci,8194,9,7,9,20,38,64,-26,30
Cowdenbeath,8194,10,4,10,22,23,55,-32,22
Montrose,8195,1,24,7,5,61,35,26,79
Peterhead,8195,2,24,4,8,81,39,42,76
Stirling,8195,3,17,6,13,64,51,13,57
Clyde,8195,4,15,9,12,53,48,5,54
Stenhousem'r,8195,5,15,8,13,55,50,5,53
Elgin,8195,6,14,6,16,54,62,-8,48
Annan Athlet,8195,7,12,11,13,49,41,8,47
Berwick,8195,8,8,10,18,29,60,-31,34
Edinburgh Ci,8195,9,7,9,20,37,64,-27,30
Cowdenbeath,8195,10,4,10,22,23,56,-33,22
Montrose,8196,1,24,7,5,63,35,28,79
Peterhead,8196,2,24,4,8,82,38,44,76
Stirling,8196,3,17,6,13,61,51,10,57
Clyde,8196,4,15,9,12,53,48,5,54
Stenhousem'r,8196,5,15,8,13,55,47,8,53
Elgin,8196,6,14,6,16,54,64,-10,48
Annan Athlet,8196,7,12,11,13,51,43,8,47
Berwick,8196,8,8,10,18,29,60,-31,34
Edinburgh Ci,8196,9,7,9,20,36,65,-29,30
Cowdenbeath,8196,10,4,10,22,25,58,-33,22
Montrose,8197,1,23,8,5,60,35,25,77
Peterhead,8197,2,24,4,8,79,38,41,76
Stirling,8197,3,17,6,13,63,53,10,57
Clyde,8197,4,15,9,12,53,48,5,54
Stenhousem'r,8197,5,15,8,13,57,49,8,53
Elgin,8197,6,14,7,15,54,61,-7,49
Annan Athlet,8197,7,11,12,13,48,42,6,45
Berwick,8197,8,8,10,18,29,60,-31,34
Edinburgh Ci,8197,9,7,9,20,36,62,-26,30
Cowdenbeath,8197,10,4,11,21,24,55,-31,23
Montrose,8198,1,24,7,5,64,34,30,79
Peterhead,8198,2,23,5,8,78,39,39,74
Stenhousem'r,8198,3,16,8,12,57,47,10,56
Stirling,8198,4,16,6,14,61,53,8,54
Clyde,8198,5,15,9,12,54,50,4,54
Elgin,8198,6,14,6,16,53,65,-12,48
Annan Athlet,8198,7,12,11,13,51,42,9,47
Berwick,8198,8,8,10,18,31,61,-30,34
Edinburgh Ci,8198,9,7,10,19,37,61,-24,31
Cowdenbeath,8198,10,4,10,22,24,58,-34,22
Montrose,8199,1,24,7,5,60,34,26,79
Peterhead,8199,2,24,4,8,80,39,41,76
Stirling,8199,3,16,7,13,60,51,9,55
Stenhousem'r,8199,4,15,9,12,55,46,9,54
Clyde,8199,5,14,9,13,52,50,2,51
Elgin,8199,6,14,6,16,53,61,-8,48
Annan Athlet,8199,7,12,11,13,49,41,8,47
Berwick,8199,8,9,10,17,31,59,-28,37
Edinburgh Ci,8199,9,7,9,20,37,63,-26,30
Cowdenbeath,8199,10,4,10,22,23,56,-33,22
Montrose,8200,1,24,7,5,61,34,27,79
Peterhead,8200,2,24,4,8,82,38,44,76
Stenhousem'r,8200,3,16,8,12,58,48,10,56
Stirling,8200,4,16,6,14,62,54,8,54
Clyde,8200,5,15,9,12,53,48,5,54
Elgin,8200,6,14,6,16,53,62,-9,48
Annan Athlet,8200,7,11,12,13,47,41,6,45
Berwick,8200,8,8,10,18,29,60,-31,34
Edinburgh Ci,8200,9,7,9,20,36,65,-29,30
Cowdenbeath,8200,10,4,11,21,23,54,-31,23
Montrose,8201,1,23,8,5,60,35,25,77
Peterhead,8201,2,24,4,8,80,39,41,76
Stirling,8201,3,17,6,13,62,52,10,57
Stenhousem'r,8201,4,15,8,13,56,48,8,53
Clyde,8201,5,14,10,12,52,49,3,52
Elgin,8201,6,14,7,15,54,61,-7,49
Annan Athlet,8201,7,11,12,13,47,41,6,45
Berwick,8201,8,8,11,17,30,59,-29,35
Edinburgh Ci,8201,9,7,9,20,37,63,-26,30
Cowdenbeath,8201,10,4,11,21,23,54,-31,23
Montrose,8202,1,24,7,5,63,35,28,79
Peterhead,8202,2,23,5,8,77,38,39,74
Stirling,8202,3,17,6,13,61,51,10,57
Stenhousem'r,8202,4,15,8,13,55,47,8,53
Clyde,8202,5,14,9,13,52,52,0,51
Elgin,8202,6,14,6,16,54,64,-10,48
Annan Athlet,8202,7,12,11,13,50,41,9,47
Berwick,8202,8,9,10,17,33,59,-26,37
Edinburgh Ci,8202,9,7,10,19,36,60,-24,31
Cowdenbeath,8202,10,4,10,22,23,57,-34,22
Montrose,8203,1,23,8,5,60,35,25,77
Peterhead,8203,2,24,4,8,78,38,40,76
Stirling,8203,3,17,6,13,61,51,10,57
Clyde,8203,4,15,9,12,52,48,4,54
Stenhousem'r,8203,5,15,8,13,55,47,8,53
Elgin,8203,6,14,7,15,54,61,-7,49
Annan Athlet,8203,7,11,11,14,47,42,5,44
Berwick,8203,8,8,10,18,29,59,-30,34
Edinburgh Ci,8203,9,7,9,20,36,61,-25,30
Cowdenbeath,8203,10,5,10,21,24,54,-30,25
Montrose,8204,1,24,7,5,63,34,29,79
Peterhead,8204,2,24,4,8,80,39,41,76
Stirling,8204,3,17,6,13,63,51,12,57
Clyde,8204,4,15,9,12,54,48,6,54
Stenhousem'r,8204,5,15,8,13,55,49,6,53
Elgin,8204,6,14,6,16,53,64,-11,48
Annan Athlet,8204,7,12,11,13,49,42,7,47
Berwick,8204,8,8,10,18,29,61,-32,34
Edinburgh Ci,8204,9,7,9,20,37,63,-26,30
Cowdenbeath,8204,10,4,10,22,24,56,-32,22
Montrose,8205,1,24,7,5,62,35,27,79
Peterhead,8205,2,24,4,8,80,39,41,76
Stirling,8205,3,17,6,13,63,53,10,57
Clyde,8205,4,15,9,12,52,48,4,54
Stenhousem'r,8205,5,15,8,13,57,49,8,53
Elgin,8205,6,14,6,16,54,63,-9,48
Annan Athlet,8205,7,12,11,13,50,41,9,47
Berwick,8205,8,8,10,18,29,59,-30,34
Edinburgh Ci,8205,9,7,9,20,37,63,-26,30
Cowdenbeath,8205,10,4,10,22,23,57,-34,22
Montrose,8206,1,24,7,5,61,35,26,79
Peterhead,8206,2,24,4,8,81,38,43,76
Stirling,8206,3,17,6,13,63,51,12,57
Stenhousem'r,8206,4,15,8,13,55,49,6,53
Clyde,8206,5,14,10,12,53,50,3,52
Elgin,8206,6,14,6,16,54,62,-8,48
Annan Athlet,8206,7,12,11,13,48,41,7,47
Berwick,8206,8,8,11,17,31,60,-29,35
Edinburgh Ci,8206,9,7,9,20,36,64,-28,30
Cowdenbeath,8206,10,4,10,22,23,55,-32,22
Montrose,8207,1,24,7,5,60,34,26,79
Peterhead,8207,2,24,4,8,79,39,40,76
Stenhousem'r,8207,3,16,8,12,57,47,10,56
Stirling,8207,4,16,6,14,61,53,8,54
Clyde,8207,5,14,10,12,53,50,3,52
Elgin,8207,6,14,6,16,53,61,-8,48
Annan Athlet,8207,7,12,11,13,49,42,7,47
Berwick,8207,8,8,11,17,31,60,-29,35
Edinburgh Ci,8207,9,7,9,20,37,62,-25,30
Cowdenbeath,8207,10,4,10,22,24,56,-32,22
Montrose,8208,1,24,7,5,64,34,30,79
Peterhead,8208,2,24,4,8,80,39,41,76
Stirling,8208,3,17,6,13,64,52,12,57
Stenhousem'r,8208,4,15,8,13,56,50,6,53
Clyde,8208,5,14,9,13,54,52,2,51
Elgin,8208,6,14,6,16,53,65,-12,48
Annan Athlet,8208,7,12,11,13,48,41,7,47
Berwick,8208,8,9,10,17,33,61,-28,37
Edinburgh Ci,8208,9,7,9,20,37,63,-26,30
Cowdenbeath,8208,10,4,10,22,23,55,-32,22
Montrose,8209,1,23,8,5,61,36,25,77
Peterhead,8209,2,24,4,8,78,38,40,76
Stirling,8209,3,16,7,13,60,51,9,55
Stenhousem'r,8209,4,15,9,12,55,46,9,54
Clyde,8209,5,15,9,12,56,49,7,54
Elgin,8209,6,14,7,15,55,62,-7,49
Annan Athlet,8209,7,11,11,14,48,43,5,44
Berwick,8209,8,8,10,18,30,63,-33,34
Edinburgh Ci,8209,9,7,9,20,36,61,-25,30
Cowdenbeath,8209,10,5,10,21,25,55,-30,25
Montrose,8210,1,24,7,5,62,34,28,79
Peterhead,8210,2,24,4,8,79,38,41,76
Stirling,8210,3,17,6,13,63,53,10,57
Clyde,8210,4,15,9,12,54,48,6,54
Stenhousem'r,8210,5,15,8,13,57,49,8,53
Elgin,8210,6,14,6,16,53,63,-10,48
Annan Athlet,8210,7,11,11,14,49,44,5,44
Berwick,8210,8,8,10,18,29,61,-32,34
Edinburgh Ci,8210,9,7,9,20,36,62,-26,30
Cowdenbeath,8210,10,5,10,21,26,56,-30,25
Montrose,8211,1,24,7,5,62,34,28,79
Peterhead,8211,2,24,4,8,79,38,41,76
Stirling,8211,3,16,7,13,61,52,9,55
Stenhousem'r,8211,4,15,9,12,56,47,9,54
Clyde,8211,5,14,9,13,51,49,2,51
Elgin,8211,6,14,6,16,53,63,-10,48
Annan Athlet,8211,7,12,11,13,48,41,7,47
Berwick,8211,8,9,10,17,30,58,-28,37
Edinburgh Ci,8211,9,7,9,20,36,62,-26,30
Cowdenbeath,8211,10,4,10,22,23,55,-32,22
Montrose,8212,1,24,7,5,63,34,29,79
Peterhead,8212,2,24,4,8,79,38,41,76
Stirling,8212,3,17,6,13,63,52,11,57
Clyde,8212,4,15,9,12,54,49,5,54
Stenhousem'r,8212,5,15,8,13,56,49,7,53
Elgin,8212,6,14,6,16,53,64,-11,48
Annan Athlet,8212,7,12,11,13,49,42,7,47
Berwick,8212,8,8,10,18,30,61,-31,34
Edinburgh Ci,8212,9,7,9,20,36,62,-26,30
Cowdenbeath,8212,10,4,10,22,24,56,-32,22
Peterhead,8213,1,24,4,8,79,38,41,76
Montrose,8213,2,23,7,6,60,37,23,76
Stirling,8213,3,16,7,13,60,51,9,55
Stenhousem'r,8213,4,15,9,12,55,46,9,54
Clyde,8213,5,14,9,13,52,50,2,51
Elgin,8213,6,15,6,15,56,61,-5,51
Annan Athlet,8213,7,12,11,13,48,41,7,47
Berwick,8213,8,9,10,17,31,59,-28,37
Edinburgh Ci,8213,9,7,9,20,36,62,-26,30
Cowdenbeath,8213,10,4,10,22,23,55,-32,22
Montrose,8214,1,24,7,5,62,34,28,79
Peterhead,8214,2,24,4,8,80,38,42,76
Stirling,8214,3,17,6,13,63,52,11,57
Clyde,8214,4,15,9,12,52,48,4,54
Stenhousem'r,8214,5,15,8,13,56,49,7,53
Elgin,8214,6,14,6,16,53,63,-10,48
Annan Athlet,8214,7,11,12,13,48,42,6,45
Berwick,8214,8,8,10,18,29,59,-30,34
Edinburgh Ci,8214,9,7,9,20,36,63,-27,30
Cowdenbeath,8214,10,4,11,21,24,55,-31,23
Montrose,8215,1,24,7,5,61,34,27,79
Peterhead,8215,2,23,4,9,77,39,38,73
Stirling,8215,3,17,6,13,63,52,11,57
Stenhousem'r,8215,4,15,8,13,56,49,7,53
Clyde,8215,5,14,10,12,52,49,3,52
Elgin,8215,6,14,6,16,53,62,-9,48
Annan Athlet,8215,7,12,11,13,48,41,7,47
Berwick,8215,8,8,11,17,30,59,-29,35
Edinburgh Ci,8215,9,8,9,19,37,60,-23,33
Cowdenbeath,8215,10,4,10,22,23,55,-32,22
Montrose,8216,1,23,8,5,61,36,25,77
Peterhead,8216,2,23,4,9,78,40,38,73
Stirling,8216,3,16,7,13,63,54,9,55
Stenhousem'r,8216,4,15,9,12,58,49,9,54
Clyde,8216,5,14,10,12,53,50,3,52
Elgin,8216,6,14,7,15,55,62,-7,49
Annan Athlet,8216,7,12,11,13,50,42,8,47
Berwick,8216,8,8,11,17,31,60,-29,35
Edinburgh Ci,8216,9,8,9,19,38,61,-23,33
Cowdenbeath,8216,10,4,10,22,24,57,-33,22
Peterhead,8217,1,24,4,8,80,38,42,76
Montrose,8217,2,23,7,6,60,36,24,76
Stirling,8217,3,16,7,13,61,52,9,55
Stenhousem'r,8217,4,15,9,12,56,47,9,54
Clyde,8217,5,15,9,12,53,48,5,54
Elgin,8217,6,15,6,15,55,61,-6,51
Annan Athlet,8217,7,12,11,13,50,41,9,47
Berwick,8217,8,8,10,18,29,60,-31,34
Edinburgh Ci,8217,9,7,9,20,36,63,-27,30
Cowdenbeath,8217,10,4,10,22,23,57,-34,22
Montrose,8218,1,23,8,5,60,35,25,77
Peterhead,8218,2,23,5,8,78,39,39,74
Stirling,8218,3,17,6,13,62,52,10,57
Stenhousem'r,8218,4,15,8,13,56,48,8,53
Clyde,8218,5,14,10,12,53,50,3,52
Elgin,8218,6,14,7,15,54,61,-7,49
Annan Athlet,8218,7,11,12,13,47,41,6,45
Berwick,8218,8,8,11,17,31,60,-29,35
Edinburgh Ci,8218,9,7,10,19,37,61,-24,31
Cowdenbeath,8218,10,4,11,21,23,54,-31,23
Montrose,8219,1,24,7,5,65,35,30,79
Peterhead,8219,2,24,4,8,79,39,40,76
Stirling,8219,3,17,6,13,65,53,12,57
Clyde,8219,4,15,9,12,55,48,7,54
Stenhousem'r,8219,5,15,8,13,57,51,6,53
Elgin,8219,6,14,6,16,54,66,-12,48
Annan Athlet,8219,7,12,11,13,50,43,7,47
Berwick,8219,8,8,10,18,29,62,-33,34
Edinburgh Ci,8219,9,7,9,20,37,62,-25,30
Cowdenbeath,8219,10,4,10,22,25,57,-32,22
Montrose,8220,1,23,8,5,60,35,25,77
Peterhead,8220,2,24,4,8,82,38,44,76
Stenhousem'r,8220,3,16,8,12,56,46,10,56
Stirling,8220,4,16,6,14,60,52,8,54
Clyde,8220,5,15,9,12,52,48,4,54
Elgin,8220,6,14,7,15,54,61,-7,49
Annan Athlet,8220,7,12,11,13,48,41,7,47
Berwick,8220,8,8,10,18,29,59,-30,34
Edinburgh Ci,8220,9,7,9,20,36,65,-29,30
Cowdenbeath,8220,10,4,10,22,23,55,-32,22
Peterhead,8221,1,24,4,8,78,38,40,76
Montrose,8221,2,23,7,6,61,37,24,76
Stirling,8221,3,17,6,13,63,51,12,57
Clyde,8221,4,15,9,12,55,49,6,54
Stenhousem'r,8221,5,15,8,13,55,49,6,53
Elgin,8221,6,15,6,15,56,62,-6,51
Annan Athlet,8221,7,11,12,13,48,42,6,45
Berwick,8221,8,8,10,18,30,62,-32,34
Edinburgh Ci,8221,9,7,9,20,36,61,-25,30
Cowdenbeath,8221,10,4,11,21,24,55,-31,23
Peterhead,8222,1,24,4,8,82,40,42,76
Montrose,8222,2,23,7,6,59,36,23,76
Stenhousem'r,8222,3,16,8,12,56,46,10,56
Stirling,8222,4,16,6,14,60,52,8,54
Clyde,8222,5,15,9,12,53,49,4,54
Elgin,8222,6,15,6,15,55,60,-5,51
Annan Athlet,8222,7,11,11,14,47,43,4,44
Berwick,8222,8,8,10,18,30,60,-30,34
Edinburgh Ci,8222,9,7,9,20,38,65,-27,30
Cowdenbeath,8222,10,5,10,21,25,54,-29,25
Montrose,8223,1,24,7,5,61,35,26,79
Peterhead,8223,2,24,4,8,81,40,41,76
Stirling,8223,3,17,6,13,62,51,11,57
Stenhousem'r,8223,4,15,8,13,55,48,7,53
Clyde,8223,5,14,10,12,52,49,3,52
Elgin,8223,6,14,6,16,54,62,-8,48
Annan Athlet,8223,7,12,11,13,49,41,8,47
Berwick,8223,8,8,11,17,30,59,-29,35
Edinburgh Ci,8223,9,7,9,20,38,64,-26,30
Cowdenbeath,8223,10,4,10,22,23,56,-33,22
Montrose,8224,1,24,7,5,61,35,26,79
Peterhead,8224,2,24,4,8,79,38,41,76
Stirling,8224,3,16,7,13,62,53,9,55
Stenhousem'r,8224,4,15,9,12,57,48,9,54
Clyde,8224,5,14,10,12,52,49,3,52
Elgin,8224,6,14,6,16,54,62,-8,48
Annan Athlet,8224,7,11,11,14,47,42,5,44
Berwick,8224,8,8,11,17,30,59,-29,35
Edinburgh Ci,8224,9,7,9,20,36,62,-26,30
Cowdenbeath,8224,10,5,10,21,24,54,-30,25
Montrose,8225,1,24,7,5,62,34,28,79
Peterhead,8225,2,24,4,8,79,39,40,76
Stenhousem'r,8225,3,16,8,12,61,48,13,56
Stirling,8225,4,16,6,14,62,57,5,54
Clyde,8225,5,14,9,13,51,49,2,51
Elgin,8225,6,14,6,16,53,63,-10,48
Annan Athlet,8225,7,11,12,13,47,41,6,45
Berwick,8225,8,9,10,17,30,58,-28,37
Edinburgh Ci,8225,9,7,9,20,37,62,-25,30
Cowdenbeath,8225,10,4,11,21,23,54,-31,23
Montrose,8226,1,24,7,5,62,34,28,79
Peterhead,8226,2,24,4,8,83,38,45,76
Stenhousem'r,8226,3,16,8,12,57,46,11,56
Stirling,8226,4,16,6,14,60,53,7,54
Clyde,8226,5,15,9,12,54,48,6,54
Elgin,8226,6,14,6,16,53,63,-10,48
Annan Athlet,8226,7,12,11,13,48,41,7,47
Berwick,8226,8,8,10,18,29,61,-32,34
Edinburgh Ci,8226,9,7,9,20,36,66,-30,30
Cowdenbeath,8226,10,4,10,22,23,55,-32,22
Montrose,8227,1,24,7,5,62,35,27,79
Peterhead,8227,2,23,4,9,78,40,38,73
Stenhousem'r,8227,3,16,8,12,58,48,10,56
Stirling,8227,4,16,6,14,62,54,8,54
Clyde,8227,5,15,9,12,52,48,4,54
Elgin,8227,6,14,6,16,54,63,-9,48
Annan Athlet,8227,7,11,12,13,48,42,6,45
Berwick,8227,8,8,10,18,29,59,-30,34
Edinburgh Ci,8227,9,8,9,19,38,61,-23,33
Cowdenbeath,8227,10,4,11,21,24,55,-31,23
Montrose,8228,1,23,8,5,62,37,25,77
Peterhead,8228,2,24,4,8,79,38,41,76
Stirling,8228,3,16,7,13,61,52,9,55
Stenhousem'r,8228,4,15,9,12,56,47,9,54
Clyde,8228,5,14,10,12,53,50,3,52
Elgin,8228,6,14,7,15,56,63,-7,49
Annan Athlet,8228,7,11,11,14,47,42,5,44
Berwick,8228,8,8,11,17,31,60,-29,35
Edinburgh Ci,8228,9,7,9,20,36,62,-26,30
Cowdenbeath,8228,10,5,10,21,24,54,-30,25
Montrose,8229,1,23,8,5,59,34,25,77
Peterhead,8229,2,24,4,8,80,39,41,76
Stirling,8229,3,17,6,13,66,54,12,57
Stenhousem'r,8229,4,15,8,13,58,52,6,53
Clyde,8229,5,14,10,12,53,50,3,52
Elgin,8229,6,14,7,15,53,60,-7,49
Annan Athlet,8229,7,11,11,14,47,42,5,44
Berwick,8229,8,8,11,17,31,60,-29,35
Edinburgh Ci,8229,9,7,9,20,37,63,-26,30
Cowdenbeath,8229,10,5,10,21,24,54,-30,25
Montrose,8230,1,23,8,5,60,35,25,77
Peterhead,8230,2,24,4,8,78,38,40,76
Stirling,8230,3,17,6,13,62,52,10,57
Clyde,8230,4,15,9,12,54,49,5,54
Stenhousem'r,8230,5,15,8,13,56,48,8,53
Elgin,8230,6,14,7,15,54,61,-7,49
Annan Athlet,8230,7,11,12,13,47,41,6,45
Berwick,8230,8,8,10,18,30,61,-31,34
Edinburgh Ci,8230,9,7,9,20,36,61,-25,30
Cowdenbeath,8230,10,4,11,21,23,54,-31,23
Montrose,8231,1,23,8,5,61,36,25,77
Peterhead,8231,2,24,4,8,82,38,44,76
Stirling,8231,3,17,6,13,62,52,10,57
Stenhousem'r,8231,4,15,8,13,56,48,8,53
Clyde,8231,5,14,10,12,53,50,3,52
Elgin,8231,6,14,7,15,55,62,-7,49
Annan Athlet,8231,7,12,11,13,48,41,7,47
Berwick,8231,8,8,11,17,31,60,-29,35
Edinburgh Ci,8231,9,7,9,20,36,65,-29,30
Cowdenbeath,8231,10,4,10,22,23,55,-32,22
Montrose,8232,1,23,7,6,59,35,24,76
Peterhead,8232,2,23,5,8,80,41,39,74
Stirling,8232,3,17,6,13,62,52,10,57
Clyde,8232,4,15,9,12,53,48,5,54
Stenhousem'r,8232,5,15,8,13,56,48,8,53
Elgin,8232,6,15,6,15,54,60,-6,51
Annan Athlet,8232,7,12,11,13,50,41,9,47
Berwick,8232,8,8,10,18,29,60,-31,34
Edinburgh Ci,8232,9,7,10,19,39,63,-24,31
Cowdenbeath,8232,10,4,10,22,23,57,-34,22
Montrose,8233,1,24,7,5,61,35,26,79
Peterhead,8233,2,24,4,8,80,38,42,76
Stirling,8233,3,16,7,13,64,55,9,55
Stenhousem'r,8233,4,15,9,12,59,50,9,54
Clyde,8233,5,14,10,12,51,48,3,52
Elgin,8233,6,14,6,16,54,62,-8,48
Annan Athlet,8233,7,11,11,14,47,42,5,44
Berwick,8233,8,8,11,17,29,58,-29,35
Edinburgh Ci,8233,9,7,9,20,36,63,-27,30
Cowdenbeath,8233,10,5,10,21,24,54,-30,25
Peterhead,8234,1,24,4,8,80,38,42,76
Montrose,8234,2,23,7,6,60,39,21,76
Stirling,8234,3,16,7,13,62,53,9,55
Stenhousem'r,8234,4,15,9,12,57,48,9,54
Clyde,8234,5,15,9,12,55,49,6,54
Elgin,8234,6,15,6,15,58,61,-3,51
Annan Athlet,8234,7,11,11,14,47,45,2,44
Berwick,8234,8,8,10,18,30,62,-32,34
Edinburgh Ci,8234,9,7,9,20,36,63,-27,30
Cowdenbeath,8234,10,5,10,21,27,54,-27,25
Montrose,8235,1,24,7,5,60,34,26,79
Peterhead,8235,2,23,5,8,77,38,39,74
Stirling,8235,3,17,6,13,64,52,12,57
Clyde,8235,4,15,9,12,53,49,4,54
Stenhousem'r,8235,5,15,8,13,56,50,6,53
Elgin,8235,6,14,6,16,53,61,-8,48
Annan Athlet,8235,7,12,11,13,51,41,10,47
Berwick,8235,8,8,10,18,30,60,-30,34
Edinburgh Ci,8235,9,7,10,19,36,60,-24,31
Cowdenbeath,8235,10,4,10,22,23,58,-35,22
Montrose,8236,1,23,8,5,62,37,25,77
Peterhead,8236,2,24,4,8,80,39,41,76
Stenhousem'r,8236,3,16,8,12,58,48,10,56
Stirling,8236,4,16,6,14,62,54,8,54
Clyde,8236,5,15,9,12,53,48,5,54
Elgin,8236,6,14,7,15,56,63,-7,49
Annan Athlet,8236,7,11,11,14,47,42,5,44
Berwick,8236,8,8,10,18,29,60,-31,34
Edinburgh Ci,8236,9,7,9,20,37,63,-26,30
Cowdenbeath,8236,10,5,10,21,24,54,-30,25
Montrose,8237,1,24,7,5,61,34,27,79
Peterhead,8237,2,24,4,8,79,38,41,76
Stirling,8237,3,17,6,13,62,52,10,57
Stenhousem'r,8237,4,15,8,13,56,48,8,53
Clyde,8237,5,14,9,13,52,52,0,51
Elgin,8237,6,14,6,16,53,62,-9,48
Annan Athlet,8237,7,11,12,13,50,44,6,45
Berwick,8237,8,9,10,17,33,59,-26,37
Edinburgh Ci,8237,9,7,9,20,36,62,-26,30
Cowdenbeath,8237,10,4,11,21,26,57,-31,23
Montrose,8238,1,23,8,5,60,35,25,77
Peterhead,8238,2,24,4,8,79,38,41,76
Stirling,8238,3,16,7,13,61,52,9,55
Stenhousem'r,8238,4,15,9,12,56,47,9,54
Clyde,8238,5,15,9,12,54,48,6,54
Elgin,8238,6,14,7,15,54,61,-7,49
Annan Athlet,8238,7,11,12,13,47,41,6,45
Berwick,8238,8,8,10,18,29,61,-32,34
Edinburgh Ci,8238,9,7,9,20,36,62,-26,30
Cowdenbeath,8238,10,4,11,21,23,54,-31,23
Peterhead,8239,1,24,4,8,80,38,42,76
Montrose,8239,2,23,7,6,59,36,23,76
Stirling,8239,3,16,7,13,61,52,9,55
Stenhousem'r,8239,4,15,9,12,56,47,9,54
Clyde,8239,5,14,9,13,51,49,2,51
Elgin,8239,6,15,6,15,55,60,-5,51
Annan Athlet,8239,7,11,12,13,47,41,6,45
Berwick,8239,8,9,10,17,30,58,-28,37
Edinburgh Ci,8239,9,7,9,20,36,63,-27,30
Cowdenbeath,8239,10,4,11,21,23,54,-31,23
Montrose,8240,1,24,7,5,61,35,26,79
Peterhead,8240,2,24,4,8,82,40,42,76
Stirling,8240,3,17,6,13,63,53,10,57
Clyde,8240,4,15,9,12,52,48,4,54
Stenhousem'r,8240,5,15,8,13,57,49,8,53
Elgin,8240,6,14,6,16,54,62,-8,48
Annan Athlet,8240,7,11,11,14,47,42,5,44
Berwick,8240,8,8,10,18,29,59,-30,34
Edinburgh Ci,8240,9,7,9,20,38,65,-27,30
Cowdenbeath,8240,10,5,10,21,24,54,-30,25
Montrose,8241,1,24,7,5,62,35,27,79
Peterhead,8241,2,24,4,8,81,38,43,76
Stenhousem'r,8241,3,16,8,12,58,47,11,56
Stirling,8241,4,16,6,14,61,54,7,54
Clyde,8241,5,15,9,12,53,48,5,54
Elgin,8241,6,14,6,16,54,63,-9,48
Annan Athlet,8241,7,11,11,14,47,42,5,44
Berwick,8241,8,8,10,18,29,60,-31,34
Edinburgh Ci,8241,9,7,9,20,36,64,-28,30
Cowdenbeath,8241,10,5,10,21,24,54,-30,25
Montrose,8242,1,24,7,5,61,35,26,79
Peterhead,8242,2,24,4,8,78,38,40,76
Stirling,8242,3,17,6,13,62,52,10,57
Clyde,8242,4,15,9,12,55,48,7,54
Stenhousem'r,8242,5,15,8,13,56,48,8,53
Elgin,8242,6,14,6,16,54,62,-8,48
Annan Athlet,8242,7,12,11,13,49,41,8,47
Berwick,8242,8,8,10,18,29,62,-33,34
Edinburgh Ci,8242,9,7,9,20,36,61,-25,30
Cowdenbeath,8242,10,4,10,22,23,56,-33,22
Montrose,8243,1,24,7,5,61,34,27,79
Peterhead,8243,2,24,4,8,81,38,43,76
Stirling,8243,3,17,6,13,62,52,10,57
Clyde,8243,4,15,9,12,52,48,4,54
Stenhousem'r,8243,5,15,8,13,56,48,8,53
Elgin,8243,6,14,6,16,53,62,-9,48
Annan Athlet,8243,7,12,11,13,49,42,7,47
Berwick,8243,8,8,10,18,29,59,-30,34
Edinburgh Ci,8243,9,7,9,20,36,64,-28,30
Cowdenbeath,8243,10,4,10,22,24,56,-32,22
Montrose,8244,1,24,7,5,60,34,26,79
Peterhead,8244,2,24,4,8,78,38,40,76
Stenhousem'r,8244,3,16,8,12,58,48,10,56
Stirling,8244,4,16,6,14,62,54,8,54
Clyde,8244,5,15,9,12,53,48,5,54
Elgin,8244,6,14,6,16,53,61,-8,48
Annan Athlet,8244,7,11,11,14,47,45,2,44
Berwick,8244,8,8,10,18,29,60,-31,34
Edinburgh Ci,8244,9,7,9,20,36,61,-25,30
Cowdenbeath,8244,10,5,10,21,27,54,-27,25
Montrose,8245,1,24,7,5,61,35,26,79
Peterhead,8245,2,23,5,8,79,40,39,74
Stirling,8245,3,17,6,13,64,52,12,57
Clyde,8245,4,15,9,12,53,49,4,54
Stenhousem'r,8245,5,15,8,13,56,50,6,53
Elgin,8245,6,14,6,16,54,62,-8,48
Annan Athlet,8245,7,11,11,14,47,42,5,44
Berwick,8245,8,8,10,18,30,60,-30,34
Edinburgh Ci,8245,9,7,10,19,38,62,-24,31
Cowdenbeath,8245,10,5,10,21,24,54,-30,25
Montrose,8246,1,23,8,5,59,34,25,77
Peterhead,8246,2,24,4,8,78,38,40,76
Stirling,8246,3,17,6,13,63,52,11,57
Clyde,8246,4,15,9,12,54,49,5,54
Stenhousem'r,8246,5,15,8,13,56,49,7,53
Elgin,8246,6,14,7,15,53,60,-7,49
Annan Athlet,8246,7,12,11,13,49,42,7,47
Berwick,8246,8,8,10,18,30,61,-31,34
Edinburgh Ci,8246,9,7,9,20,36,61,-25,30
Cowdenbeath,8246,10,4,10,22,24,56,-32,22
Peterhead,8247,1,24,4,8,81,39,42,76
Montrose,8247,2,23,7,6,60,36,24,76
Stirling,8247,3,17,6,13,65,55,10,57
Stenhousem'r,8247,4,15,8,13,59,51,8,53
Clyde,8247,5,14,10,12,52,49,3,52
Elgin,8247,6,15,6,15,55,61,-6,51
Annan Athlet,8247,7,11,11,14,47,43,4,44
Berwick,8247,8,8,11,17,30,59,-29,35
Edinburgh Ci,8247,9,7,9,20,37,64,-27,30
Cowdenbeath,8247,10,5,10,21,25,54,-29,25
Montrose,8248,1,23,8,5,59,34,25,77
Peterhead,8248,2,24,4,8,82,41,41,76
Stirling,8248,3,16,7,13,62,53,9,55
Stenhousem'r,8248,4,15,9,12,57,48,9,54
Clyde,8248,5,14,10,12,52,49,3,52
Elgin,8248,6,14,7,15,53,60,-7,49
Annan Athlet,8248,7,11,11,14,47,42,5,44
Berwick,8248,8,8,11,17,30,59,-29,35
Edinburgh Ci,8248,9,7,9,20,39,65,-26,30
Cowdenbeath,8248,10,5,10,21,24,54,-30,25
Montrose,8249,1,24,7,5,63,35,28,79
Peterhead,8249,2,24,4,8,80,39,41,76
Stirling,8249,3,16,7,13,60,51,9,55
Stenhousem'r,8249,4,15,9,12,55,46,9,54
Clyde,8249,5,15,9,12,53,49,4,54
Elgin,8249,6,14,6,16,54,64,-10,48
Annan Athlet,8249,7,11,12,13,48,42,6,45
Berwick,8249,8,8,10,18,30,60,-30,34
Edinburgh Ci,8249,9,7,9,20,37,63,-26,30
Cowdenbeath,8249,10,4,11,21,24,55,-31,23
Peterhead,8250,1,24,4,8,81,39,42,76
Montrose,8250,2,23,7,6,61,38,23,76
Stirling,8250,3,16,7,13,62,53,9,55
Stenhousem'r,8250,4,15,9,12,57,48,9,54
Clyde,8250,5,15,9,12,54,49,5,54
Elgin,8250,6,15,6,15,57,62,-5,51
Annan Athlet,8250,7,12,11,13,48,41,7,47
Berwick,8250,8,8,10,18,30,61,-31,34
Edinburgh Ci,8250,9,7,9,20,37,64,-27,30
Cowdenbeath,8250,10,4,10,22,23,55,-32,22
Montrose,8251,1,23,8,5,61,36,25,77
Peterhead,8251,2,23,5,8,77,38,39,74
Stenhousem'r,8251,3,16,8,12,58,48,10,56
Stirling,8251,4,16,6,14,62,54,8,54
Clyde,8251,5,15,9,12,56,49,7,54
Elgin,8251,6,14,7,15,55,62,-7,49
Annan Athlet,8251,7,11,12,13,47,41,6,45
Berwick,8251,8,8,10,18,30,63,-33,34
Edinburgh Ci,8251,9,7,10,19,36,60,-24,31
Cowdenbeath,8251,10,4,11,21,23,54,-31,23
Montrose,8252,1,24,7,5,65,37,28,79
Peterhead,8252,2,24,4,8,79,39,40,76
Stenhousem'r,8252,3,16,8,12,59,47,12,56
Stirling,8252,4,16,6,14,61,55,6,54
Clyde,8252,5,15,9,12,54,48,6,54
Elgin,8252,6,14,6,16,56,66,-10,48
Annan Athlet,8252,7,11,12,13,48,42,6,45
Berwick,8252,8,8,10,18,29,61,-32,34
Edinburgh Ci,8252,9,7,9,20,37,62,-25,30
Cowdenbeath,8252,10,4,11,21,24,55,-31,23
Montrose,8253,1,24,7,5,62,35,27,79
Peterhead,8253,2,24,4,8,81,38,43,76
Stirling,8253,3,17,6,13,62,52,10,57
Clyde,8253,4,15,9,12,55,48,7,54
Stenhousem'r,8253,5,15,8,13,56,48,8,53
Elgin,8253,6,14,6,16,54,63,-9,48
Annan Athlet,8253,7,11,11,14,47,45,2,44
Berwick,8253,8,8,10,18,29,62,-33,34
Edinburgh Ci,8253,9,7,9,20,36,64,-28,30
Cowdenbeath,8253,10,5,10,21,27,54,-27,25
Montrose,8254,1,24,7,5,62,34,28,79
Peterhead,8254,2,24,4,8,82,41,41,76
Stirling,8254,3,17,6,13,61,51,10,57
Clyde,8254,4,15,9,12,53,49,4,54
Stenhousem'r,8254,5,15,8,13,55,47,8,53
Elgin,8254,6,14,6,16,53,63,-10,48
Annan Athlet,8254,7,11,11,14,47,42,5,44
Berwick,8254,8,8,10,18,30,60,-30,34
Edinburgh Ci,8254,9,7,9,20,39,65,-26,30
Cowdenbeath,8254,10,5,10,21,24,54,-30,25
Montrose,8255,1,24,7,5,62,34,28,79
Peterhead,8255,2,24,4,8,80,39,41,76
Stirling,8255,3,17,6,13,61,51,10,57
Clyde,8255,4,15,9,12,56,49,7,54
Stenhousem'r,8255,5,15,8,13,55,47,8,53
Elgin,8255,6,14,6,16,53,63,-10,48
Annan Athlet,8255,7,11,12,13,48,42,6,45
Berwick,8255,8,8,10,18,30,63,-33,34
Edinburgh Ci,8255,9,7,9,20,37,63,-26,30
Cowdenbeath,8255,10,4,11,21,24,55,-31,23
Montrose,8256,1,24,7,5,61,34,27,79
Peterhead,8256,2,24,4,8,83,39,44,76
Stirling,8256,3,16,7,13,61,52,9,55
Stenhousem'r,8256,4,15,9,12,56,47,9,54
Clyde,8256,5,15,9,12,53,48,5,54
Elgin,8256,6,14,6,16,53,62,-9,48
Annan Athlet,8256,7,11,11,14,48,44,4,44
Berwick,8256,8,8,10,18,29,60,-31,34
Edinburgh Ci,8256,9,7,9,20,37,66,-29,30
Cowdenbeath,8256,10,5,10,21,26,55,-29,25
Montrose,8257,1,24,7,5,61,35,26,79
Peterhead,8257,2,24,4,8,80,39,41,76
Stirling,8257,3,16,7,13,62,53,9,55
Stenhousem'r,8257,4,15,9,12,57,48,9,54
Clyde,8257,5,14,10,12,52,49,3,52
Elgin,8257,6,14,6,16,54,62,-8,48
Annan Athlet,8257,7,11,11,14,47,42,5,44
Berwick,8257,8,8,11,17,30,59,-29,35
Edinburgh Ci,8257,9,7,9,20,37,63,-26,30
Cowdenbeath,8257,10,5,10,21,24,54,-30,25
Montrose,8258,1,24,7,5,62,36,26,79
Peterhead,8258,2,24,4,8,80,40,40,76
Stirling,8258,3,17,6,13,62,52,10,57
Stenhousem'r,8258,4,15,8,13,56,48,8,53
Clyde,8258,5,14,9,13,51,49,2,51
Elgin,8258,6,14,6,16,55,63,-8,48
Annan Athlet,8258,7,11,12,13,48,42,6,45
Berwick,8258,8,9,10,17,30,58,-28,37
Edinburgh Ci,8258,9,7,9,20,38,63,-25,30
Cowdenbeath,8258,10,4,11,21,24,55,-31,23
Montrose,8259,1,24,7,5,62,34,28,79
Peterhead,8259,2,23,4,9,79,41,38,73
Stirling,8259,3,16,7,13,62,53,9,55
Stenhousem'r,8259,4,15,9,12,57,48,9,54
Clyde,8259,5,14,9,13,52,51,1,51
Elgin,8259,6,14,6,16,53,63,-10,48
Annan Athlet,8259,7,11,11,14,47,43,4,44
Berwick,8259,8,9,10,17,32,59,-27,37
Edinburgh Ci,8259,9,8,9,19,39,62,-23,33
Cowdenbeath,8259,10,5,10,21,25,54,-29,25
Peterhead,8260,1,24,4,8,80,38,42,76
Montrose,8260,2,23,7,6,59,36,23,76
Stirling,8260,3,17,6,13,64,54,10,57
Clyde,8260,4,15,9,12,53,48,5,54
Stenhousem'r,8260,5,15,8,13,58,50,8,53
Elgin,8260,6,15,6,15,55,60,-5,51
Annan Athlet,8260,7,12,11,13,48,41,7,47
Berwick,8260,8,8,10,18,29,60,-31,34
Edinburgh Ci,8260,9,7,9,20,36,63,-27,30
Cowdenbeath,8260,10,4,10,22,23,55,-32,22
Montrose,8261,1,24,7,5,63,35,28,79
Peterhead,8261,2,24,4,8,79,39,40,76
Stirling,8261,3,16,7,13,60,51,9,55
Stenhousem'r,8261,4,15,9,12,55,46,9,54
Clyde,8261,5,14,9,13,51,50,1,51
Elgin,8261,6,14,6,16,54,64,-10,48
Annan Athlet,8261,7,12,11,13,49,42,7,47
Berwick,8261,8,9,10,17,31,58,-27,37
Edinburgh Ci,8261,9,7,9,20,37,62,-25,30
Cowdenbeath,8261,10,4,10,22,24,56,-32,22
Montrose,8262,1,24,7,5,65,38,27,79
Peterhead,8262,2,24,4,8,81,38,43,76
Stenhousem'r,8262,3,16,8,12,58,48,10,56
Stirling,8262,4,16,6,14,62,54,8,54
Clyde,8262,5,15,9,12,55,48,7,54
Elgin,8262,6,14,6,16,57,66,-9,48
Annan Athlet,8262,7,11,12,13,48,42,6,45
Berwick,8262,8,8,10,18,29,62,-33,34
Edinburgh Ci,8262,9,7,9,20,36,64,-28,30
Cowdenbeath,8262,10,4,11,21,24,55,-31,23
Montrose,8263,1,23,8,5,60,35,25,77
Peterhead,8263,2,24,4,8,79,38,41,76
Stirling,8263,3,16,7,13,62,53,9,55
Stenhousem'r,8263,4,15,9,12,57,48,9,54
Clyde,8263,5,14,10,12,51,48,3,52
Elgin,8263,6,14,7,15,54,61,-7,49
Annan Athlet,8263,7,11,12,13,48,42,6,45
Berwick,8263,8,8,11,17,29,58,-29,35
Edinburgh Ci,8263,9,7,9,20,36,62,-26,30
Cowdenbeath,8263,10,4,11,21,24,55,-31,23
Montrose,8264,1,24,7,5,61,34,27,79
Peterhead,8264,2,24,4,8,81,38,43,76
Stirling,8264,3,17,6,13,62,52,10,57
Clyde,8264,4,15,9,12,53,48,5,54
Stenhousem'r,8264,5,15,8,13,56,48,8,53
Elgin,8264,6,14,6,16,53,62,-9,48
Annan Athlet,8264,7,11,11,14,47,44,3,44
Berwick,8264,8,8,10,18,29,60,-31,34
Edinburgh Ci,8264,9,7,9,20,36,64,-28,30
Cowdenbeath,8264,10,5,10,21,26,54,-28,25
Montrose,8265,1,24,7,5,63,35,28,79
Peterhead,8265,2,23,4,9,79,41,38,73
Stirling,8265,3,16,7,13,62,53,9,55
Stenhousem'r,8265,4,15,9,12,57,48,9,54
Clyde,8265,5,14,10,12,52,49,3,52
Elgin,8265,6,14,6,16,54,64,-10,48
Annan Athlet,8265,7,11,12,13,47,41,6,45
Berwick,8265,8,8,11,17,30,59,-29,35
Edinburgh Ci,8265,9,8,9,19,39,62,-23,33
Cowdenbeath,8265,10,4,11,21,23,54,-31,23
Montrose,8266,1,24,7,5,64,34,30,79
Peterhead,8266,2,24,4,8,81,40,41,76
Stirling,8266,3,17,6,13,61,51,10,57
Clyde,8266,4,15,9,12,52,48,4,54
Stenhousem'r,8266,5,15,8,13,55,47,8,53
Elgin,8266,6,14,6,16,53,65,-12,48
Annan Athlet,8266,7,12,11,13,48,41,7,47
Berwick,8266,8,8,10,18,29,59,-30,34
Edinburgh Ci,8266,9,7,9,20,38,64,-26,30
Cowdenbeath,8266,10,4,10,22,23,55,-32,22
Montrose,8267,1,24,7,5,63,34,29,79
Peterhead,8267,2,24,4,8,78,38,40,76
Stenhousem'r,8267,3,16,8,12,57,47,10,56
Stirling,8267,4,16,6,14,61,53,8,54
Clyde,8267,5,15,9,12,52,48,4,54
Elgin,8267,6,14,6,16,53,64,-11,48
Annan Athlet,8267,7,11,12,13,47,41,6,45
Berwick,8267,8,8,10,18,29,59,-30,34
Edinburgh Ci,8267,9,7,9,20,36,61,-25,30
Cowdenbeath,8267,10,4,11,21,23,54,-31,23
Montrose,8268,1,24,7,5,61,35,26,79
Peterhead,8268,2,24,4,8,79,39,40,76
Stirling,8268,3,17,6,13,62,51,11,57
Clyde,8268,4,15,9,12,53,48,5,54
Stenhousem'r,8268,5,15,8,13,55,48,7,53
Elgin,8268,6,14,6,16,54,62,-8,48
Annan Athlet,8268,7,11,11,14,47,42,5,44
Berwick,8268,8,8,10,18,29,60,-31,34
Edinburgh Ci,8268,9,7,9,20,37,62,-25,30
Cowdenbeath,8268,10,5,10,21,24,54,-30,25
Montrose,8269,1,24,7,5,60,34,26,79
Peterhead,8269,2,23,4,9,77,39,38,73
Stirling,8269,3,16,7,13,61,52,9,55
Stenhousem'r,8269,4,15,9,12,56,47,9,54
Clyde,8269,5,14,10,12,52,49,3,52
Elgin,8269,6,14,6,16,53,61,-8,48
Annan Athlet,8269,7,12,11,13,48,41,7,47
Berwick,8269,8,8,11,17,30,59,-29,35
Edinburgh Ci,8269,9,8,9,19,37,60,-23,33
Cowdenbeath,8269,10,4,10,22,23,55,-32,22
Peterhead,8270,1,24,4,8,80,39,41,76
Montrose,8270,2,23,7,6,60,37,23,76
Stirling,8270,3,17,6,13,63,51,12,57
Stenhousem'r,8270,4,15,8,13,55,49,6,53
Clyde,8270,5,14,9,13,51,50,1,51
Elgin,8270,6,15,6,15,56,61,-5,51
Annan Athlet,8270,7,12,11,13,49,41,8,47
Berwick,8270,8,9,10,17,31,58,-27,37
Edinburgh Ci,8270,9,7,9,20,37,63,-26,30
Cowdenbeath,8270,10,4,10,22,23,56,-33,22
Montrose,8271,1,23,7,6,61,37,24,76
Peterhead,8271,2,23,5,8,78,39,39,74
Stirling,8271,3,17,6,13,63,51,12,57
Clyde,8271,4,15,9,12,57,51,6,54
Stenhousem'r,8271,5,15,8,13,55,49,6,53
Elgin,8271,6,15,6,15,56,62,-6,51
Annan Athlet,8271,7,12,11,13,50,41,9,47
Berwick,8271,8,8,10,18,32,64,-32,34
Edinburgh Ci,8271,9,7,10,19,37,61,-24,31
Cowdenbeath,8271,10,4,10,22,23,57,-34,22
Montrose,8272,1,24,7,5,61,34,27,79
Peterhead,8272,2,24,4,8,78,38,40,76
Stenhousem'r,8272,3,16,8,12,58,47,11,56
Stirling,8272,4,16,6,14,61,54,7,54
Clyde,8272,5,15,9,12,55,48,7,54
Elgin,8272,6,14,6,16,53,62,-9,48
Annan Athlet,8272,7,11,11,14,47,43,4,44
Berwick,8272,8,8,10,18,29,62,-33,34
Edinburgh Ci,8272,9,7,9,20,36,61,-25,30
Cowdenbeath,8272,10,5,10,21,25,54,-29,25
Peterhead,8273,1,24,4,8,81,41,40,76
Montrose,8273,2,23,7,6,59,35,24,76
Stirling,8273,3,17,6,13,64,52,12,57
Stenhousem'r,8273,4,15,8,13,56,50,6,53
Clyde,8273,5,14,9,13,52,50,2,51
Elgin,8273,6,15,6,15,54,60,-6,51
Annan Athlet,8273,7,11,11,14,48,45,3,44
Berwick,8273,8,9,10,17,31,59,-28,37
Edinburgh Ci,8273,9,7,9,20,39,64,-25,30
Cowdenbeath,8273,10,5,10,21,27,55,-28,25
Montrose,8274,1,23,8,5,60,35,25,77
Peterhead,8274,2,23,5,8,78,39,39,74
Stirling,8274,3,17,6,13,61,51,10,57
Clyde,8274,4,15,9,12,53,48,5,54
Stenhousem'r,8274,5,15,8,13,55,47,8,53
Elgin,8274,6,14,7,15,54,61,-7,49
Annan Athlet,8274,7,11,11,14,48,43,5,44
Berwick,8274,8,8,10,18,29,60,-31,34
Edinburgh Ci,8274,9,7,10,19,37,61,-24,31
Cowdenbeath,8274,10,5,10,21,25,55,-30,25
Montrose,8275,1,24,7,5,63,35,28,79
Peterhead,8275,2,24,4,8,79,39,40,76
Stirling,8275,3,16,7,13,63,54,9,55
Stenhousem'r,8275,4,15,9,12,58,49,9,54
Clyde,8275,5,14,9,13,53,51,2,51
Elgin,8275,6,14,6,16,54,64,-10,48
Annan Athlet,8275,7,11,11,14,47,42,5,44
Berwick,8275,8,9,10,17,32,60,-28,37
Edinburgh Ci,8275,9,7,9,20,37,62,-25,30
Cowdenbeath,8275,10,5,10,21,24,54,-30,25
Montrose,8276,1,24,7,5,63,35,28,79
Peterhead,8276,2,24,4,8,79,39,40,76
Stirling,8276,3,17,6,13,61,51,10,57
Clyde,8276,4,15,9,12,54,48,6,54
Stenhousem'r,8276,5,15,8,13,55,47,8,53
Elgin,8276,6,14,6,16,54,64,-10,48
Annan Athlet,8276,7,11,12,13,49,43,6,45
Berwick,8276,8,8,10,18,29,61,-32,34
Edinburgh Ci,8276,9,7,9,20,37,62,-25,30
Cowdenbeath,8276,10,4,11,21,25,56,-31,23
Montrose,8277,1,24,7,5,61,35,26,79
Peterhead,8277,2,24,4,8,82,38,44,76
Stirling,8277,3,17,6,13,63,53,10,57
Clyde,8277,4,15,9,12,53,49,4,54
Stenhousem'r,8277,5,15,8,13,57,49,8,53
Elgin,8277,6,14,6,16,54,62,-8,48
Annan Athlet,8277,7,12,11,13,49,41,8,47
Berwick,8277,8,8,10,18,30,60,-30,34
Edinburgh Ci,8277,9,7,9,20,36,65,-29,30
Cowdenbeath,8277,10,4,10,22,23,56,-33,22
Montrose,8278,1,23,8,5,59,34,25,77
Peterhead,8278,2,24,4,8,80,40,40,76
Stirling,8278,3,17,6,13,61,51,10,57
Stenhousem'r,8278,4,15,8,13,55,47,8,53
Clyde,8278,5,14,10,12,51,48,3,52
Elgin,8278,6,14,7,15,53,60,-7,49
Annan Athlet,8278,7,11,11,14,47,42,5,44
Berwick,8278,8,8,11,17,29,58,-29,35
Edinburgh Ci,8278,9,7,9,20,38,63,-25,30
Cowdenbeath,8278,10,5,10,21,24,54,-30,25
Montrose,8279,1,24,7,5,63,36,27,79
Peterhead,8279,2,24,4,8,83,38,45,76
Stirling,8279,3,16,7,13,60,51,9,55
Stenhousem'r,8279,4,15,9,12,55,46,9,54
Clyde,8279,5,15,9,12,54,49,5,54
Elgin,8279,6,14,6,16,55,64,-9,48
Annan Athlet,8279,7,11,12,13,47,41,6,45
Berwick,8279,8,8,10,18,30,61,-31,34
Edinburgh Ci,8279,9,7,9,20,36,66,-30,30
Cowdenbeath,8279,10,4,11,21,23,54,-31,23
Montrose,8280,1,24,7,5,61,34,27,79
Peterhead,8280,2,24,4,8,80,38,42,76
Stirling,8280,3,16,7,13,61,52,9,55
Stenhousem'r,8280,4,15,9,12,56,47,9,54
Clyde,8280,5,14,10,12,53,50,3,52
Elgin,8280,6,14,6,16,53,62,-9,48
Annan Athlet,8280,7,12,11,13,50,41,9,47
Berwick,8280,8,8,11,17,31,60,-29,35
Edinburgh Ci,8280,9,7,9,20,36,63,-27,30
Cowdenbeath,8280,10,4,10,22,23,57,-34,22
Montrose,8281,1,24,7,5,62,34,28,79
Peterhead,8281,2,23,4,9,77,40,37,73
Stirling,8281,3,16,7,13,60,51,9,55
Stenhousem'r,8281,4,15,9,12,55,46,9,54
Clyde,8281,5,15,9,12,53,48,5,54
Elgin,8281,6,14,6,16,53,63,-10,48
Annan Athlet,8281,7,12,11,13,48,41,7,47
Berwick,8281,8,8,10,18,29,60,-31,34
Edinburgh Ci,8281,9,8,9,19,38,60,-22,33
Cowdenbeath,8281,10,4,10,22,23,55,-32,22
Montrose,8282,1,23,7,6,59,35,24,76
Peterhead,8282,2,23,5,8,79,40,39,74
Stirling,8282,3,16,7,13,62,53,9,55
Stenhousem'r,8282,4,15,9,12,57,48,9,54
Clyde,8282,5,14,9,13,51,49,2,51
Elgin,8282,6,15,6,15,54,60,-6,51
Annan Athlet,8282,7,12,11,13,48,41,7,47
Berwick,8282,8,9,10,17,30,58,-28,37
Edinburgh Ci,8282,9,7,10,19,38,62,-24,31
Cowdenbeath,8282,10,4,10,22,23,55,-32,22
Montrose,8283,1,23,8,5,60,35,25,77
Peterhead,8283,2,23,4,9,78,40,38,73
Stirling,8283,3,17,6,13,62,52,10,57
Clyde,8283,4,15,9,12,55,51,4,54
Stenhousem'r,8283,5,15,8,13,56,48,8,53
Elgin,8283,6,14,7,15,54,61,-7,49
Annan Athlet,8283,7,11,11,14,47,43,4,44
Berwick,8283,8,8,10,18,32,62,-30,34
Edinburgh Ci,8283,9,8,9,19,38,61,-23,33
Cowdenbeath,8283,10,5,10,21,25,54,-29,25
Montrose,8284,1,24,7,5,60,34,26,79
Peterhead,8284,2,23,5,8,78,39,39,74
Stirling,8284,3,16,7,13,62,53,9,55
Stenhousem'r,8284,4,15,9,12,57,48,9,54
Clyde,8284,5,15,9,12,53,48,5,54
Elgin,8284,6,14,6,16,53,61,-8,48
Annan Athlet,8284,7,12,11,13,48,41,7,47
Berwick,8284,8,8,10,18,29,60,-31,34
Edinburgh Ci,8284,9,7,10,19,37,61,-24,31
Cowdenbeath,8284,10,4,10,22,23,55,-32,22
Montrose,8285,1,24,7,5,61,35,26,79
Peterhead,8285,2,23,5,8,78,39,39,74
Stirling,8285,3,16,7,13,61,52,9,55
Stenhousem'r,8285,4,15,9,12,56,47,9,54
Clyde,8285,5,15,9,12,52,48,4,54
Elgin,8285,6,14,6,16,54,62,-8,48
Annan Athlet,8285,7,11,12,13,49,43,6,45
Berwick,8285,8,8,10,18,29,59,-30,34
Edinburgh Ci,8285,9,7,10,19,37,61,-24,31
Cowdenbeath,8285,10,4,11,21,25,56,-31,23
Montrose,8286,1,24,7,5,61,35,26,79
Peterhead,8286,2,24,4,8,82,38,44,76
Stirling,8286,3,16,7,13,61,52,9,55
Stenhousem'r,8286,4,15,9,12,56,47,9,54
Clyde,8286,5,15,9,12,52,48,4,54
Elgin,8286,6,14,6,16,54,62,-8,48
Annan Athlet,8286,7,12,11,13,49,42,7,47
Berwick,8286,8,8,10,18,29,59,-30,34
Edinburgh Ci,8286,9,7,9,20,36,65,-29,30
Cowdenbeath,8286,10,4,10,22,24,56,-32,22
Peterhead,8287,1,24,4,8,81,39,42,76
Montrose,8287,2,23,7,6,60,36,24,76
Stirling,8287,3,17,6,13,62,52,10,57
Stenhousem'r,8287,4,15,8,13,56,48,8,53
Clyde,8287,5,14,10,12,54,51,3,52
Elgin,8287,6,15,6,15,55,61,-6,51
Annan Athlet,8287,7,12,11,13,48,41,7,47
Berwick,8287,8,8,11,17,32,61,-29,35
Edinburgh Ci,8287,9,7,9,20,37,64,-27,30
Cowdenbeath,8287,10,4,10,22,23,55,-32,22
Montrose,8288,1,23,7,6,59,35,24,76
Peterhead,8288,2,23,5,8,78,39,39,74
Stirling,8288,3,16,7,13,60,51,9,55
Stenhousem'r,8288,4,15,9,12,55,46,9,54
Clyde,8288,5,15,9,12,54,48,6,54
Elgin,8288,6,15,6,15,54,60,-6,51
Annan Athlet,8288,7,11,11,14,47,42,5,44
Berwick,8288,8,8,10,18,29,61,-32,34
Edinburgh Ci,8288,9,7,10,19,37,61,-24,31
Cowdenbeath,8288,10,5,10,21,24,54,-30,25
Montrose,8289,1,23,8,5,60,35,25,77
Peterhead,8289,2,24,4,8,81,39,42,76
Stenhousem'r,8289,3,16,8,12,57,47,10,56
Stirling,8289,4,16,6,14,61,53,8,54
Clyde,8289,5,15,9,12,54,49,5,54
Elgin,8289,6,14,7,15,54,61,-7,49
Annan Athlet,8289,7,11,11,14,47,42,5,44
Berwick,8289,8,8,10,18,30,61,-31,34
Edinburgh Ci,8289,9,7,9,20,37,64,-27,30
Cowdenbeath,8289,10,5,10,21,24,54,-30,25
Montrose,8290,1,24,7,5,62,34,28,79
Peterhead,8290,2,23,5,8,81,42,39,74
Stirling,8290,3,16,7,13,61,52,9,55
Stenhousem'r,8290,4,15,9,12,56,47,9,54
Clyde,8290,5,15,9,12,52,48,4,54
Elgin,8290,6,14,6,16,53,63,-10,48
Annan Athlet,8290,7,11,11,14,47,42,5,44
Berwick,8290,8,8,10,18,29,59,-30,34
Edinburgh Ci,8290,9,7,10,19,40,64,-24,31
Cowdenbeath,8290,10,5,10,21,24,54,-30,25
Montrose,8291,1,23,7,6,59,36,23,76
Peterhead,8291,2,23,5,8,78,39,39,74
Stenhousem'r,8291,3,16,8,12,56,46,10,56
Stirling,8291,4,16,6,14,60,52,8,54
Clyde,8291,5,15,9,12,52,48,4,54
Elgin,8291,6,15,6,15,55,60,-5,51
Annan Athlet,8291,7,12,11,13,49,41,8,47
Berwick,8291,8,8,10,18,29,59,-30,34
Edinburgh Ci,8291,9,7,10,19,37,61,-24,31
Cowdenbeath,8291,10,4,10,22,23,56,-33,22
Montrose,8292,1,23,8,5,60,35,25,77
Peterhead,8292,2,23,4,9,78,41,37,73
Stenhousem'r,8292,3,16,8,12,56,46,10,56
Stirling,8292,4,16,6,14,60,52,8,54
Clyde,8292,5,15,9,12,54,50,4,54
Elgin,8292,6,14,7,15,54,61,-7,49
Annan Athlet,8292,7,11,12,13,47,41,6,45
Berwick,8292,8,8,10,18,31,61,-30,34
Edinburgh Ci,8292,9,8,9,19,39,61,-22,33
Cowdenbeath,8292,10,4,11,21,23,54,-31,23
Montrose,8293,1,24,7,5,61,35,26,79
Peterhead,8293,2,24,4,8,79,39,40,76
Stenhousem'r,8293,3,16,8,12,57,46,11,56
Stirling,8293,4,16,6,14,60,53,7,54
Clyde,8293,5,15,9,12,55,51,4,54
Elgin,8293,6,14,6,16,54,62,-8,48
Annan Athlet,8293,7,12,11,13,50,41,9,47
Berwick,8293,8,8,10,18,32,62,-30,34
Edinburgh Ci,8293,9,7,9,20,37,62,-25,30
Cowdenbeath,8293,10,4,10,22,23,57,-34,22
Montrose,8294,1,24,7,5,61,35,26,79
Peterhead,8294,2,23,5,8,80,41,39,74
Stenhousem'r,8294,3,16,8,12,57,46,11,56
Stirling,8294,4,16,6,14,60,53,7,54
Clyde,8294,5,14,10,12,52,49,3,52
Elgin,8294,6,14,6,16,54,62,-8,48
Annan Athlet,8294,7,11,11,14,47,42,5,44
Berwick,8294,8,8,11,17,30,59,-29,35
Edinburgh Ci,8294,9,7,10,19,39,63,-24,31
Cowdenbeath,8294,10,5,10,21,24,54,-30,25
Montrose,8295,1,24,7,5,61,34,27,79
Peterhead,8295,2,24,4,8,79,38,41,76
Stirling,8295,3,17,6,13,62,51,11,57
Stenhousem'r,8295,4,15,8,13,55,48,7,53
Clyde,8295,5,14,9,13,51,50,1,51
Elgin,8295,6,14,6,16,53,62,-9,48
Annan Athlet,8295,7,11,11,14,48,43,5,44
Berwick,8295,8,9,10,17,31,58,-27,37
Edinburgh Ci,8295,9,7,9,20,36,62,-26,30
Cowdenbeath,8295,10,5,10,21,25,55,-30,25
Montrose,8296,1,24,7,5,65,36,29,79
Peterhead,8296,2,24,4,8,80,38,42,76
Stenhousem'r,8296,3,16,8,12,58,46,12,56
Stirling,8296,4,16,6,14,60,54,6,54
Clyde,8296,5,15,9,12,55,49,6,54
Elgin,8296,6,14,6,16,55,66,-11,48
Annan Athlet,8296,7,11,11,14,47,42,5,44
Berwick,8296,8,8,10,18,30,62,-32,34
Edinburgh Ci,8296,9,7,9,20,36,63,-27,30
Cowdenbeath,8296,10,5,10,21,24,54,-30,25
Montrose,8297,1,23,8,5,59,34,25,77
Peterhead,8297,2,24,4,8,80,38,42,76
Stirling,8297,3,17,6,13,63,53,10,57
Clyde,8297,4,15,9,12,52,48,4,54
Stenhousem'r,8297,5,15,8,13,57,49,8,53
Elgin,8297,6,14,7,15,53,60,-7,49
Annan Athlet,8297,7,11,12,13,47,41,6,45
Berwick,8297,8,8,10,18,29,59,-30,34
Edinburgh Ci,8297,9,7,9,20,36,63,-27,30
Cowdenbeath,8297,10,4,11,21,23,54,-31,23
Montrose,8298,1,23,8,5,61,36,25,77
Peterhead,8298,2,24,4,8,80,40,40,76
Stirling,8298,3,16,7,13,63,54,9,55
Stenhousem'r,8298,4,15,9,12,58,49,9,54
Clyde,8298,5,14,10,12,51,48,3,52
Elgin,8298,6,14,7,15,55,62,-7,49
Annan Athlet,8298,7,11,11,14,47,43,4,44
Berwick,8298,8,8,11,17,29,58,-29,35
Edinburgh Ci,8298,9,7,9,20,38,63,-25,30
Cowdenbeath,8298,10,5,10,21,25,54,-29,25
Montrose,8299,1,24,7,5,61,34,27,79
Peterhead,8299,2,24,4,8,79,38,41,76
Stirling,8299,3,17,6,13,61,51,10,57
Stenhousem'r,8299,4,15,8,13,55,47,8,53
Clyde,8299,5,14,9,13,51,51,0,51
Elgin,8299,6,14,6,16,53,62,-9,48
Annan Athlet,8299,7,11,12,13,47,41,6,45
Berwick,8299,8,9,10,17,32,58,-26,37
Edinburgh Ci,8299,9,7,9,20,36,62,-26,30
Cowdenbeath,8299,10,4,11,21,23,54,-31,23
Montrose,8300,1,23,8,5,60,35,25,77
Peterhead,8300,2,24,4,8,80,38,42,76
Stenhousem'r,8300,3,16,8,12,58,47,11,56
Stirling,8300,4,16,6,14,61,54,7,54
Clyde,8300,5,14,10,12,52,49,3,52
Elgin,8300,6,14,7,15,54,61,-7,49
Annan Athlet,8300,7,11,12,13,49,43,6,45
Berwick,8300,8,8,11,17,30,59,-29,35
Edinburgh Ci,8300,9,7,9,20,36,63,-27,30
Cowdenbeath,8300,10,4,11,21,25,56,-31,23
Montrose,8301,1,24,7,5,61,34,27,79
Peterhead,8301,2,24,4,8,82,38,44,76
Stenhousem'r,8301,3,16,8,12,57,46,11,56
Stirling,8301,4,16,6,14,60,53,7,54
Clyde,8301,5,15,9,12,53,48,5,54
Elgin,8301,6,14,6,16,53,62,-9,48
Annan Athlet,8301,7,11,11,14,47,42,5,44
Berwick,8301,8,8,10,18,29,60,-31,34
Edinburgh Ci,8301,9,7,9,20,36,65,-29,30
Cowdenbeath,8301,10,5,10,21,24,54,-30,25
Montrose,8302,1,24,7,5,62,36,26,79
Peterhead,8302,2,24,4,8,83,38,45,76
Stirling,8302,3,16,7,13,61,52,9,55
Stenhousem'r,8302,4,15,9,12,56,47,9,54
Clyde,8302,5,14,9,13,52,50,2,51
Elgin,8302,6,14,6,16,55,63,-8,48
Annan Athlet,8302,7,11,12,13,49,43,6,45
Berwick,8302,8,9,10,17,31,59,-28,37
Edinburgh Ci,8302,9,7,9,20,36,66,-30,30
Cowdenbeath,8302,10,4,11,21,25,56,-31,23
Montrose,8303,1,24,7,5,61,34,27,79
Peterhead,8303,2,23,5,8,78,39,39,74
Stirling,8303,3,17,6,13,62,52,10,57
Clyde,8303,4,15,9,12,55,50,5,54
Stenhousem'r,8303,5,15,8,13,56,48,8,53
Elgin,8303,6,14,6,16,53,62,-9,48
Annan Athlet,8303,7,11,12,13,49,43,6,45
Berwick,8303,8,8,10,18,31,62,-31,34
Edinburgh Ci,8303,9,7,10,19,37,61,-24,31
Cowdenbeath,8303,10,4,11,21,25,56,-31,23
Montrose,8304,1,24,7,5,63,35,28,79
Peterhead,8304,2,24,4,8,81,38,43,76
Stenhousem'r,8304,3,16,8,12,59,46,13,56
Clyde,8304,4,15,9,12,55,49,6,54
Stirling,8304,5,16,6,14,60,55,5,54
Elgin,8304,6,14,6,16,54,64,-10,48
Annan Athlet,8304,7,11,12,13,47,41,6,45
Berwick,8304,8,8,10,18,30,62,-32,34
Edinburgh Ci,8304,9,7,9,20,36,64,-28,30
Cowdenbeath,8304,10,4,11,21,23,54,-31,23
Montrose,8305,1,24,7,5,61,35,26,79
Peterhead,8305,2,23,4,9,79,41,38,73
Stirling,8305,3,16,7,13,62,53,9,55
Stenhousem'r,8305,4,15,9,12,57,48,9,54
Clyde,8305,5,15,9,12,53,49,4,54
Elgin,8305,6,14,6,16,54,62,-8,48
Annan Athlet,8305,7,12,11,13,50,42,8,47
Berwick,8305,8,8,10,18,30,60,-30,34
Edinburgh Ci,8305,9,8,9,19,39,62,-23,33
Cowdenbeath,8305,10,4,10,22,24,57,-33,22
Montrose,8306,1,23,8,5,62,37,25,77
Peterhead,8306,2,24,4,8,80,38,42,76
Stirling,8306,3,16,7,13,62,53,9,55
Stenhousem'r,8306,4,15,9,12,57,48,9,54
Clyde,8306,5,15,9,12,52,48,4,54
Elgin,8306,6,14,7,15,56,63,-7,49
Annan Athlet,8306,7,12,11,13,49,41,8,47
Berwick,8306,8,8,10,18,29,59,-30,34
Edinburgh Ci,8306,9,7,9,20,36,63,-27,30
Cowdenbeath,8306,10,4,10,22,23,56,-33,22
Montrose,8307,1,24,7,5,62,34,28,79
Peterhead,8307,2,24,4,8,80,40,40,76
Stenhousem'r,8307,3,16,8,12,57,47,10,56
Stirling,8307,4,16,6,14,61,53,8,54
Clyde,8307,5,15,9,12,52,48,4,54
Elgin,8307,6,14,6,16,53,63,-10,48
Annan Athlet,8307,7,11,11,14,48,45,3,44
Berwick,8307,8,8,10,18,29,59,-30,34
Edinburgh Ci,8307,9,7,9,20,38,63,-25,30
Cowdenbeath,8307,10,5,10,21,27,55,-28,25
Montrose,8308,1,24,7,5,62,34,28,79
Peterhead,8308,2,24,4,8,79,39,40,76
Stirling,8308,3,17,6,13,62,52,10,57
Clyde,8308,4,15,9,12,53,49,4,54
Stenhousem'r,8308,5,15,8,13,56,48,8,53
Elgin,8308,6,14,6,16,53,63,-10,48
Annan Athlet,8308,7,11,11,14,48,44,4,44
Berwick,8308,8,8,10,18,30,60,-30,34
Edinburgh Ci,8308,9,7,9,20,37,62,-25,30
Cowdenbeath,8308,10,5,10,21,26,55,-29,25
Montrose,8309,1,23,8,5,60,35,25,77
Peterhead,8309,2,23,5,8,80,41,39,74
Stirling,8309,3,17,6,13,64,52,12,57
Clyde,8309,4,15,9,12,56,49,7,54
Stenhousem'r,8309,5,15,8,13,56,50,6,53
Elgin,8309,6,14,7,15,54,61,-7,49
Annan Athlet,8309,7,11,11,14,47,43,4,44
Berwick,8309,8,8,10,18,30,63,-33,34
Edinburgh Ci,8309,9,7,10,19,39,63,-24,31
Cowdenbeath,8309,10,5,10,21,25,54,-29,25
Montrose,8310,1,23,8,5,60,35,25,77
Peterhead,8310,2,24,4,8,80,39,41,76
Stirling,8310,3,16,7,13,62,53,9,55
Stenhousem'r,8310,4,15,9,12,57,48,9,54
Clyde,8310,5,15,9,12,56,48,8,54
Elgin,8310,6,14,7,15,54,61,-7,49
Annan Athlet,8310,7,11,11,14,48,43,5,44
Berwick,8310,8,8,10,18,29,63,-34,34
Edinburgh Ci,8310,9,7,9,20,37,63,-26,30
Cowdenbeath,8310,10,5,10,21,25,55,-30,25
Montrose,8311,1,24,7,5,63,35,28,79
Peterhead,8311,2,24,4,8,79,38,41,76
Stenhousem'r,8311,3,16,8,12,57,47,10,56
Stirling,8311,4,16,6,14,61,53,8,54
Clyde,8311,5,15,9,12,55,50,5,54
Elgin,8311,6,14,6,16,54,64,-10,48
Annan Athlet,8311,7,11,11,14,47,43,4,44
Berwick,8311,8,8,10,18,31,62,-31,34
Edinburgh Ci,8311,9,7,9,20,36,62,-26,30
Cowdenbeath,8311,10,5,10,21,25,54,-29,25
Montrose,8312,1,24,7,5,61,34,27,79
Peterhead,8312,2,24,4,8,79,39,40,76
Stenhousem'r,8312,3,16,8,12,57,46,11,56
Stirling,8312,4,16,6,14,60,53,7,54
Clyde,8312,5,14,9,13,51,49,2,51
Elgin,8312,6,14,6,16,53,62,-9,48
Annan Athlet,8312,7,12,11,13,48,41,7,47
Berwick,8312,8,9,10,17,30,58,-28,37
Edinburgh Ci,8312,9,7,9,20,37,62,-25,30
Cowdenbeath,8312,10,4,10,22,23,55,-32,22
Montrose,8313,1,24,7,5,60,34,26,79
Peterhead,8313,2,24,4,8,80,39,41,76
Stirling,8313,3,17,6,13,63,51,12,57
Clyde,8313,4,15,9,12,53,48,5,54
Stenhousem'r,8313,5,15,8,13,55,49,6,53
Elgin,8313,6,14,6,16,53,61,-8,48
Annan Athlet,8313,7,11,12,13,48,42,6,45
Berwick,8313,8,8,10,18,29,60,-31,34
Edinburgh Ci,8313,9,7,9,20,37,63,-26,30
Cowdenbeath,8313,10,4,11,21,24,55,-31,23
Montrose,8314,1,24,7,5,60,34,26,79
Peterhead,8314,2,24,4,8,81,38,43,76
Stirling,8314,3,16,7,13,61,52,9,55
Stenhousem'r,8314,4,15,9,12,56,47,9,54
Clyde,8314,5,14,9,13,51,51,0,51
Elgin,8314,6,14,6,16,53,61,-8,48
Annan Athlet,8314,7,11,12,13,47,41,6,45
Berwick,8314,8,9,10,17,32,58,-26,37
Edinburgh Ci,8314,9,7,9,20,36,64,-28,30
Cowdenbeath,8314,10,4,11,21,23,54,-31,23
Montrose,8315,1,24,7,5,61,35,26,79
Peterhead,8315,2,23,4,9,77,41,36,73
Stenhousem'r,8315,3,16,8,12,59,49,10,56
Stirling,8315,4,16,6,14,63,55,8,54
Clyde,8315,5,15,9,12,54,49,5,54
Elgin,8315,6,14,6,16,54,62,-8,48
Annan Athlet,8315,7,11,12,13,47,41,6,45
Berwick,8315,8,8,10,18,30,61,-31,34
Edinburgh Ci,8315,9,8,9,19,39,60,-21,33
Cowdenbeath,8315,10,4,11,21,23,54,-31,23
Montrose,8316,1,24,7,5,61,35,26,79
Peterhead,8316,2,24,4,8,79,39,40,76
Stirling,8316,3,17,6,13,62,52,10,57
Clyde,8316,4,15,9,12,54,48,6,54
Stenhousem'r,8316,5,15,8,13,56,48,8,53
Elgin,8316,6,14,6,16,54,62,-8,48
Annan Athlet,8316,7,11,12,13,49,43,6,45
Berwick,8316,8,8,10,18,29,61,-32,34
Edinburgh Ci,8316,9,7,9,20,37,62,-25,30
Cowdenbeath,8316,10,4,11,21,25,56,-31,23
Montrose,8317,1,24,7,5,61,35,26,79
Peterhead,8317,2,24,4,8,81,40,41,76
Stirling,8317,3,17,6,13,63,52,11,57
Clyde,8317,4,15,9,12,54,49,5,54
Stenhousem'r,8317,5,15,8,13,56,49,7,53
Elgin,8317,6,14,6,16,54,62,-8,48
Annan Athlet,8317,7,12,11,13,48,41,7,47
Berwick,8317,8,8,10,18,30,61,-31,34
Edinburgh Ci,8317,9,7,9,20,38,64,-26,30
Cowdenbeath,8317,10,4,10,22,23,55,-32,22
Peterhead,8318,1,24,4,8,82,38,44,76
Montrose,8318,2,23,7,6,60,37,23,76
Stenhousem'r,8318,3,16,8,12,56,46,10,56
Stirling,8318,4,16,6,14,60,52,8,54
Clyde,8318,5,15,9,12,54,50,4,54
Elgin,8318,6,15,6,15,56,61,-5,51
Annan Athlet,8318,7,11,12,13,47,41,6,45
Berwick,8318,8,8,10,18,31,61,-30,34
Edinburgh Ci,8318,9,7,9,20,36,65,-29,30
Cowdenbeath,8318,10,4,11,21,23,54,-31,23
Peterhead,8319,1,24,4,8,79,38,41,76
Montrose,8319,2,23,7,6,60,36,24,76
Stirling,8319,3,17,6,13,61,51,10,57
Clyde,8319,4,15,9,12,54,49,5,54
Stenhousem'r,8319,5,15,8,13,55,47,8,53
Elgin,8319,6,15,6,15,55,61,-6,51
Annan Athlet,8319,7,12,11,13,49,42,7,47
Berwick,8319,8,8,10,18,30,61,-31,34
Edinburgh Ci,8319,9,7,9,20,36,62,-26,30
Cowdenbeath,8319,10,4,10,22,24,56,-32,22
Montrose,8320,1,24,7,5,63,34,29,79
Peterhead,8320,2,23,5,8,79,40,39,74
Stirling,8320,3,17,6,13,62,51,11,57
Stenhousem'r,8320,4,15,8,13,55,48,7,53
Clyde,8320,5,14,9,13,54,53,1,51
Elgin,8320,6,14,6,16,53,64,-11,48
Annan Athlet,8320,7,11,11,14,47,42,5,44
Berwick,8320,8,9,10,17,34,61,-27,37
Edinburgh Ci,8320,9,7,10,19,38,62,-24,31
Cowdenbeath,8320,10,5,10,21,24,54,-30,25
Montrose,8321,1,24,7,5,60,34,26,79
Peterhead,8321,2,24,4,8,79,39,40,76
Stirling,8321,3,17,6,13,63,53,10,57
Clyde,8321,4,15,9,12,54,50,4,54
Stenhousem'r,8321,5,15,8,13,57,49,8,53
Elgin,8321,6,14,6,16,53,61,-8,48
Annan Athlet,8321,7,11,11,14,48,43,5,44
Berwick,8321,8,8,10,18,31,61,-30,34
Edinburgh Ci,8321,9,7,9,20,37,62,-25,30
Cowdenbeath,8321,10,5,10,21,25,55,-30,25
Montrose,8322,1,23,8,5,59,34,25,77
Peterhead,8322,2,23,4,9,78,40,38,73
Stenhousem'r,8322,3,16,8,12,57,47,10,56
Stirling,8322,4,16,6,14,61,53,8,54
Clyde,8322,5,14,9,13,52,50,2,51
Elgin,8322,6,14,7,15,53,60,-7,49
Annan Athlet,8322,7,12,11,13,48,41,7,47
Berwick,8322,8,9,10,17,31,59,-28,37
Edinburgh Ci,8322,9,8,9,19,38,61,-23,33
Cowdenbeath,8322,10,4,10,22,23,55,-32,22
Montrose,8323,1,24,7,5,64,35,29,79
Peterhead,8323,2,24,4,8,81,38,43,76
Stirling,8323,3,16,7,13,62,53,9,55
Stenhousem'r,8323,4,15,9,12,57,48,9,54
Clyde,8323,5,15,9,12,53,49,4,54
Elgin,8323,6,14,6,16,54,65,-11,48
Annan Athlet,8323,7,11,11,14,47,42,5,44
Berwick,8323,8,8,10,18,30,60,-30,34
Edinburgh Ci,8323,9,7,9,20,36,64,-28,30
Cowdenbeath,8323,10,5,10,21,24,54,-30,25
Montrose,8324,1,24,7,5,61,34,27,79
Peterhead,8324,2,24,4,8,81,39,42,76
Stenhousem'r,8324,3,16,8,12,57,46,11,56
Stirling,8324,4,16,6,14,60,53,7,54
Clyde,8324,5,15,9,12,53,48,5,54
Elgin,8324,6,14,6,16,53,62,-9,48
Annan Athlet,8324,7,11,11,14,47,45,2,44
Berwick,8324,8,8,10,18,29,60,-31,34
Edinburgh Ci,8324,9,7,9,20,37,64,-27,30
Cowdenbeath,8324,10,5,10,21,27,54,-27,25
Montrose,8325,1,23,8,5,60,35,25,77
Peterhead,8325,2,24,4,8,79,39,40,76
Stenhousem'r,8325,3,16,8,12,57,47,10,56
Stirling,8325,4,16,6,14,61,53,8,54
Clyde,8325,5,15,9,12,53,48,5,54
Elgin,8325,6,14,7,15,54,61,-7,49
Annan Athlet,8325,7,11,11,14,48,43,5,44
Berwick,8325,8,8,10,18,29,60,-31,34
Edinburgh Ci,8325,9,7,9,20,37,62,-25,30
Cowdenbeath,8325,10,5,10,21,25,55,-30,25
Montrose,8326,1,24,7,5,62,35,27,79
Peterhead,8326,2,24,4,8,81,39,42,76
Stenhousem'r,8326,3,16,8,12,59,48,11,56
Stirling,8326,4,16,6,14,62,55,7,54
Clyde,8326,5,15,9,12,55,49,6,54
Elgin,8326,6,14,6,16,54,63,-9,48
Annan Athlet,8326,7,12,11,13,51,42,9,47
Berwick,8326,8,8,10,18,30,62,-32,34
Edinburgh Ci,8326,9,7,9,20,37,64,-27,30
Cowdenbeath,8326,10,4,10,22,24,58,-34,22
Peterhead,8327,1,24,4,8,79,39,40,76
Montrose,8327,2,23,7,6,61,37,24,76
Stirling,8327,3,17,6,13,63,51,12,57
Clyde,8327,4,15,9,12,54,49,5,54
Stenhousem'r,8327,5,15,8,13,55,49,6,53
Elgin,8327,6,15,6,15,56,62,-6,51
Annan Athlet,8327,7,11,11,14,47,42,5,44
Berwick,8327,8,8,10,18,30,61,-31,34
Edinburgh Ci,8327,9,7,9,20,37,62,-25,30
Cowdenbeath,8327,10,5,10,21,24,54,-30,25
Peterhead,8328,1,24,4,8,79,39,40,76
Montrose,8328,2,23,7,6,60,37,23,76
Stirling,8328,3,17,6,13,61,51,10,57
Stenhousem'r,8328,4,15,8,13,55,47,8,53
Clyde,8328,5,14,9,13,52,50,2,51
Elgin,8328,6,15,6,15,56,61,-5,51
Annan Athlet,8328,7,12,11,13,49,41,8,47
Berwick,8328,8,9,10,17,31,59,-28,37
Edinburgh Ci,8328,9,7,9,20,37,62,-25,30
Cowdenbeath,8328,10,4,10,22,23,56,-33,22
Montrose,8329,1,24,7,5,62,34,28,79
Peterhead,8329,2,24,4,8,79,38,41,76
Stirling,8329,3,17,6,13,61,51,10,57
Clyde,8329,4,15,9,12,57,48,9,54
Stenhousem'r,8329,5,15,8,13,55,47,8,53
Elgin,8329,6,14,6,16,53,63,-10,48
Annan Athlet,8329,7,12,11,13,49,41,8,47
Berwick,8329,8,8,10,18,29,64,-35,34
Edinburgh Ci,8329,9,7,9,20,36,62,-26,30
Cowdenbeath,8329,10,4,10,22,23,56,-33,22
Montrose,8330,1,24,7,5,63,35,28,79
Peterhead,8330,2,24,4,8,82,39,43,76
Stenhousem'r,8330,3,16,8,12,58,47,11,56
Stirling,8330,4,16,6,14,61,54,7,54
Clyde,8330,5,15,9,12,53,48,5,54
Elgin,8330,6,14,6,16,54,64,-10,48
Annan Athlet,8330,7,11,12,13,48,42,6,45
Berwick,8330,8,8,10,18,29,60,-31,34
Edinburgh Ci,8330,9,7,9,20,37,65,-28,30
Cowdenbeath,8330,10,4,11,21,24,55,-31,23
Peterhead,8331,1,24,4,8,81,40,41,76
Montrose,8331,2,23,7,6,59,35,24,76
Stenhousem'r,8331,3,16,8,12,57,47,10,56
Stirling,8331,4,16,6,14,61,53,8,54
Clyde,8331,5,14,9,13,51,49,2,51
Elgin,8331,6,15,6,15,54,60,-6,51
Annan Athlet,8331,7,11,12,13,47,41,6,45
Berwick,8331,8,9,10,17,30,58,-28,37
Edinburgh Ci,8331,9,7,9,20,38,64,-26,30
Cowdenbeath,8331,10,4,11,21,23,54,-31,23
Montrose,8332,1,23,8,5,60,35,25,77
Peterhead,8332,2,24,4,8,80,38,42,76
Stirling,8332,3,16,7,13,62,53,9,55
Stenhousem'r,8332,4,15,9,12,57,48,9,54
Clyde,8332,5,14,10,12,52,49,3,52
Elgin,8332,6,14,7,15,54,61,-7,49
Annan Athlet,8332,7,12,11,13,49,41,8,47
Berwick,8332,8,8,11,17,30,59,-29,35
Edinburgh Ci,8332,9,7,9,20,36,63,-27,30
Cowdenbeath,8332,10,4,10,22,23,56,-33,22
Peterhead,8333,1,24,4,8,82,38,44,76
Montrose,8333,2,23,7,6,60,37,23,76
Stirling,8333,3,16,7,13,61,52,9,55
Stenhousem'r,8333,4,15,9,12,56,47,9,54
Clyde,8333,5,15,9,12,53,49,4,54
Elgin,8333,6,15,6,15,56,61,-5,51
Annan Athlet,8333,7,12,11,13,50,42,8,47
Berwick,8333,8,8,10,18,30,60,-30,34
Edinburgh Ci,8333,9,7,9,20,36,65,-29,30
Cowdenbeath,8333,10,4,10,22,24,57,-33,22
Montrose,8334,1,23,8,5,61,36,25,77
Peterhead,8334,2,24,4,8,79,39,40,76
Stenhousem'r,8334,3,16,8,12,56,46,10,56
Stirling,8334,4,16,6,14,60,52,8,54
Clyde,8334,5,14,10,12,52,49,3,52
Elgin,8334,6,14,7,15,55,62,-7,49
Annan Athlet,8334,7,12,11,13,50,42,8,47
Berwick,8334,8,8,11,17,30,59,-29,35
Edinburgh Ci,8334,9,7,9,20,37,62,-25,30
Cowdenbeath,8334,10,4,10,22,24,57,-33,22
Peterhead,8335,1,24,4,8,81,39,42,76
Montrose,8335,2,23,7,6,59,35,24,76
Stirling,8335,3,16,7,13,61,52,9,55
Stenhousem'r,8335,4,15,9,12,56,47,9,54
Clyde,8335,5,14,10,12,52,49,3,52
Elgin,8335,6,15,6,15,54,60,-6,51
Annan Athlet,8335,7,12,11,13,51,42,9,47
Berwick,8335,8,8,11,17,30,59,-29,35
Edinburgh Ci,8335,9,7,9,20,37,64,-27,30
Cowdenbeath,8335,10,4,10,22,24,58,-34,22
Montrose,8336,1,24,7,5,63,36,27,79
Peterhead,8336,2,24,4,8,79,39,40,76
Stirling,8336,3,16,7,13,62,53,9,55
Stenhousem'r,8336,4,15,9,12,57,48,9,54
Clyde,8336,5,15,9,12,52,48,4,54
Elgin,8336,6,14,6,16,55,64,-9,48
Annan Athlet,8336,7,11,12,13,49,43,6,45
Berwick,8336,8,8,10,18,29,59,-30,34
Edinburgh Ci,8336,9,7,9,20,37,62,-25,30
Cowdenbeath,8336,10,4,11,21,25,56,-31,23
Montrose,8337,1,23,8,5,62,37,25,77
Peterhead,8337,2,24,4,8,78,38,40,76
Stirling,8337,3,16,7,13,62,53,9,55
Stenhousem'r,8337,4,15,9,12,57,48,9,54
Clyde,8337,5,15,9,12,55,49,6,54
Elgin,8337,6,14,7,15,56,63,-7,49
Annan Athlet,8337,7,12,11,13,49,41,8,47
Berwick,8337,8,8,10,18,30,62,-32,34
Edinburgh Ci,8337,9,7,9,20,36,61,-25,30
Cowdenbeath,8337,10,4,10,22,23,56,-33,22
Montrose,8338,1,24,7,5,61,34,27,79
Peterhead,8338,2,24,4,8,80,39,41,76
Stirling,8338,3,17,6,13,63,51,12,57
Clyde,8338,4,15,9,12,53,49,4,54
Stenhousem'r,8338,5,15,8,13,55,49,6,53
Elgin,8338,6,14,6,16,53,62,-9,48
Annan Athlet,8338,7,12,11,13,48,41,7,47
Berwick,8338,8,8,10,18,30,60,-30,34
Edinburgh Ci,8338,9,7,9,20,37,63,-26,30
Cowdenbeath,8338,10,4,10,22,23,55,-32,22
Montrose,8339,1,24,7,5,62,34,28,79
Peterhead,8339,2,23,4,9,78,40,38,73
Stirling,8339,3,17,6,13,61,51,10,57
Clyde,8339,4,15,9,12,52,48,4,54
Stenhousem'r,8339,5,15,8,13,55,47,8,53
Elgin,8339,6,14,6,16,53,63,-10,48
Annan Athlet,8339,7,12,11,13,50,41,9,47
Berwick,8339,8,8,10,18,29,59,-30,34
Edinburgh Ci,8339,9,8,9,19,38,61,-23,33
Cowdenbeath,8339,10,4,10,22,23,57,-34,22
Montrose,8340,1,24,7,5,62,36,26,79
Peterhead,8340,2,24,4,8,81,38,43,76
Stirling,8340,3,16,7,13,61,52,9,55
Stenhousem'r,8340,4,15,9,12,56,47,9,54
Clyde,8340,5,15,9,12,54,48,6,54
Elgin,8340,6,14,6,16,55,63,-8,48
Annan Athlet,8340,7,11,11,14,47,43,4,44
Berwick,8340,8,8,10,18,29,61,-32,34
Edinburgh Ci,8340,9,7,9,20,36,64,-28,30
Cowdenbeath,8340,10,5,10,21,25,54,-29,25
Montrose,8341,1,24,7,5,61,35,26,79
Peterhead,8341,2,24,4,8,82,38,44,76
Stenhousem'r,8341,3,16,8,12,59,47,12,56
Clyde,8341,4,15,9,12,55,48,7,54
Stirling,8341,5,16,6,14,61,55,6,54
Elgin,8341,6,14,6,16,54,62,-8,48
Annan Athlet,8341,7,12,11,13,49,42,7,47
Berwick,8341,8,8,10,18,29,62,-33,34
Edinburgh Ci,8341,9,7,9,20,36,65,-29,30
Cowdenbeath,8341,10,4,10,22,24,56,-32,22
Peterhead,8342,1,24,4,8,80,39,41,76
Montrose,8342,2,23,7,6,60,36,24,76
Stirling,8342,3,17,6,13,64,54,10,57
Clyde,8342,4,15,9,12,52,48,4,54
Stenhousem'r,8342,5,15,8,13,58,50,8,53
Elgin,8342,6,15,6,15,55,61,-6,51
Annan Athlet,8342,7,12,11,13,48,41,7,47
Berwick,8342,8,8,10,18,29,59,-30,34
Edinburgh Ci,8342,9,7,9,20,37,63,-26,30
Cowdenbeath,8342,10,4,10,22,23,55,-32,22
Montrose,8343,1,24,7,5,62,36,26,79
Peterhead,8343,2,24,4,8,79,39,40,76
Stenhousem'r,8343,3,16,8,12,59,47,12,56
Stirling,8343,4,16,6,14,61,55,6,54
Clyde,8343,5,14,10,12,52,49,3,52
Elgin,8343,6,14,6,16,55,63,-8,48
Annan Athlet,8343,7,11,12,13,47,41,6,45
Berwick,8343,8,8,11,17,30,59,-29,35
Edinburgh Ci,8343,9,7,9,20,37,62,-25,30
Cowdenbeath,8343,10,4,11,21,23,54,-31,23
Montrose,8344,1,24,7,5,60,34,26,79
Peterhead,8344,2,24,4,8,80,38,42,76
Stirling,8344,3,17,6,13,62,51,11,57
Stenhousem'r,8344,4,15,8,13,55,48,7,53
Clyde,8344,5,14,10,12,52,49,3,52
Elgin,8344,6,14,6,16,53,61,-8,48
Annan Athlet,8344,7,11,12,13,47,41,6,45
Berwick,8344,8,8,11,17,30,59,-29,35
Edinburgh Ci,8344,9,7,9,20,36,63,-27,30
Cowdenbeath,8344,10,4,11,21,23,54,-31,23
Peterhead,8345,1,24,4,8,80,38,42,76
Montrose,8345,2,23,7,6,60,36,24,76
Stenhousem'r,8345,3,16,8,12,56,46,10,56
Stirling,8345,4,16,6,14,60,52,8,54
Clyde,8345,5,14,10,12,53,50,3,52
Elgin,8345,6,15,6,15,55,61,-6,51
Annan Athlet,8345,7,11,11,14,47,42,5,44
Berwick,8345,8,8,11,17,31,60,-29,35
Edinburgh Ci,8345,9,7,9,20,36,63,-27,30
Cowdenbeath,8345,10,5,10,21,24,54,-30,25
Montrose,8346,1,24,7,5,64,34,30,79
Peterhead,8346,2,23,5,8,78,39,39,74
Stenhousem'r,8346,3,16,8,12,56,46,10,56
Stirling,8346,4,16,6,14,60,52,8,54
Clyde,8346,5,14,9,13,52,51,1,51
Elgin,8346,6,14,6,16,53,65,-12,48
Annan Athlet,8346,7,11,12,13,48,42,6,45
Berwick,8346,8,9,10,17,32,59,-27,37
Edinburgh Ci,8346,9,7,10,19,37,61,-24,31
Cowdenbeath,8346,10,4,11,21,24,55,-31,23
Montrose,8347,1,24,7,5,61,34,27,79
Peterhead,8347,2,24,4,8,79,38,41,76
Stirling,8347,3,17,6,13,61,51,10,57
Clyde,8347,4,15,9,12,53,49,4,54
Stenhousem'r,8347,5,15,8,13,55,47,8,53
Elgin,8347,6,14,6,16,53,62,-9,48
Annan Athlet,8347,7,12,11,13,49,42,7,47
Berwick,8347,8,8,10,18,30,60,-30,34
Edinburgh Ci,8347,9,7,9,20,36,62,-26,30
Cowdenbeath,8347,10,4,10,22,24,56,-32,22
Montrose,8348,1,24,7,5,63,34,29,79
Peterhead,8348,2,24,4,8,79,39,40,76
Stirling,8348,3,17,6,13,63,52,11,57
Stenhousem'r,8348,4,15,8,13,56,49,7,53
Clyde,8348,5,14,9,13,52,50,2,51
Elgin,8348,6,14,6,16,53,64,-11,48
Annan Athlet,8348,7,11,11,14,48,44,4,44
Berwick,8348,8,9,10,17,31,59,-28,37
Edinburgh Ci,8348,9,7,9,20,37,62,-25,30
Cowdenbeath,8348,10,5,10,21,26,55,-29,25
Montrose,8349,1,23,8,5,60,35,25,77
Peterhead,8349,2,24,4,8,80,39,41,76
Stenhousem'r,8349,3,16,8,12,59,47,12,56
Clyde,8349,4,15,9,12,55,48,7,54
Stirling,8349,5,16,6,14,61,55,6,54
Elgin,8349,6,14,7,15,54,61,-7,49
Annan Athlet,8349,7,12,11,13,48,41,7,47
Berwick,8349,8,8,10,18,29,62,-33,34
Edinburgh Ci,8349,9,7,9,20,37,63,-26,30
Cowdenbeath,8349,10,4,10,22,23,55,-32,22
Montrose,8350,1,24,7,5,62,34,28,79
Peterhead,8350,2,24,4,8,79,38,41,76
Stirling,8350,3,17,6,13,62,52,10,57
Clyde,8350,4,15,9,12,53,49,4,54
Stenhousem'r,8350,5,15,8,13,56,48,8,53
Elgin,8350,6,14,6,16,53,63,-10,48
Annan Athlet,8350,7,12,11,13,48,41,7,47
Berwick,8350,8,8,10,18,30,60,-30,34
Edinburgh Ci,8350,9,7,9,20,36,62,-26,30
Cowdenbeath,8350,10,4,10,22,23,55,-32,22
Montrose,8351,1,24,7,5,61,35,26,79
Peterhead,8351,2,24,4,8,80,38,42,76
Stirling,8351,3,16,7,13,61,52,9,55
Stenhousem'r,8351,4,15,9,12,56,47,9,54
Clyde,8351,5,15,9,12,53,49,4,54
Elgin,8351,6,14,6,16,54,62,-8,48
Annan Athlet,8351,7,12,11,13,50,41,9,47
Berwick,8351,8,8,10,18,30,60,-30,34
Edinburgh Ci,8351,9,7,9,20,36,63,-27,30
Cowdenbeath,8351,10,4,10,22,23,57,-34,22
Montrose,8352,1,24,7,5,63,35,28,79
Peterhead,8352,2,24,4,8,79,39,40,76
Stirling,8352,3,17,6,13,63,52,11,57
Stenhousem'r,8352,4,15,8,13,56,49,7,53
Clyde,8352,5,14,10,12,52,49,3,52
Elgin,8352,6,14,6,16,54,64,-10,48
Annan Athlet,8352,7,11,11,14,47,43,4,44
Berwick,8352,8,8,11,17,30,59,-29,35
Edinburgh Ci,8352,9,7,9,20,37,62,-25,30
Cowdenbeath,8352,10,5,10,21,25,54,-29,25
Montrose,8353,1,24,7,5,61,35,26,79
Peterhead,8353,2,24,4,8,79,39,40,76
Stenhousem'r,8353,3,16,8,12,57,47,10,56
Stirling,8353,4,16,6,14,61,53,8,54
Clyde,8353,5,14,9,13,51,49,2,51
Elgin,8353,6,14,6,16,54,62,-8,48
Annan Athlet,8353,7,12,11,13,49,41,8,47
Berwick,8353,8,9,10,17,30,58,-28,37
Edinburgh Ci,8353,9,7,9,20,37,62,-25,30
Cowdenbeath,8353,10,4,10,22,23,56,-33,22
Montrose,8354,1,23,8,5,59,34,25,77
Peterhead,8354,2,24,4,8,80,38,42,76
Stirling,8354,3,16,7,13,63,54,9,55
Stenhousem'r,8354,4,15,9,12,58,49,9,54
Clyde,8354,5,14,9,13,51,49,2,51
Elgin,8354,6,14,7,15,53,60,-7,49
Annan Athlet,8354,7,11,12,13,47,41,6,45
Berwick,8354,8,9,10,17,30,58,-28,37
Edinburgh Ci,8354,9,7,9,20,36,63,-27,30
Cowdenbeath,8354,10,4,11,21,23,54,-31,23
Peterhead,8355,1,24,4,8,81,39,42,76
Montrose,8355,2,23,7,6,59,35,24,76
Stenhousem'r,8355,3,16,8,12,57,46,11,56
Stirling,8355,4,16,6,14,60,53,7,54
Clyde,8355,5,15,9,12,53,49,4,54
Elgin,8355,6,15,6,15,54,60,-6,51
Annan Athlet,8355,7,11,12,13,48,42,6,45
Berwick,8355,8,8,10,18,30,60,-30,34
Edinburgh Ci,8355,9,7,9,20,37,64,-27,30
Cowdenbeath,8355,10,4,11,21,24,55,-31,23
Montrose,8356,1,23,8,5,60,35,25,77
Peterhead,8356,2,24,4,8,79,38,41,76
Stenhousem'r,8356,3,16,8,12,56,46,10,56
Stirling,8356,4,16,6,14,60,52,8,54
Clyde,8356,5,15,9,12,55,50,5,54
Elgin,8356,6,14,7,15,54,61,-7,49
Annan Athlet,8356,7,12,11,13,49,42,7,47
Berwick,8356,8,8,10,18,31,62,-31,34
Edinburgh Ci,8356,9,7,9,20,36,62,-26,30
Cowdenbeath,8356,10,4,10,22,24,56,-32,22
Montrose,8357,1,24,7,5,66,36,30,79
Peterhead,8357,2,24,4,8,80,40,40,76
Stenhousem'r,8357,3,16,8,12,57,47,10,56
Stirling,8357,4,16,6,14,61,53,8,54
Clyde,8357,5,14,9,13,51,51,0,51
Elgin,8357,6,14,6,16,55,67,-12,48
Annan Athlet,8357,7,11,11,14,47,43,4,44
Berwick,8357,8,9,10,17,32,58,-26,37
Edinburgh Ci,8357,9,7,9,20,38,63,-25,30
Cowdenbeath,8357,10,5,10,21,25,54,-29,25
Montrose,8358,1,23,8,5,60,35,25,77
Peterhead,8358,2,23,5,8,79,40,39,74
Stirling,8358,3,16,7,13,62,53,9,55
Stenhousem'r,8358,4,15,9,12,57,48,9,54
Clyde,8358,5,15,9,12,53,48,5,54
Elgin,8358,6,14,7,15,54,61,-7,49
Annan Athlet,8358,7,11,12,13,48,42,6,45
Berwick,8358,8,8,10,18,29,60,-31,34
Edinburgh Ci,8358,9,7,10,19,38,62,-24,31
Cowdenbeath,8358,10,4,11,21,24,55,-31,23
Montrose,8359,1,24,7,5,62,34,28,79
Peterhead,8359,2,24,4,8,80,38,42,76
Stenhousem'r,8359,3,16,8,12,58,47,11,56
Stirling,8359,4,16,6,14,61,54,7,54
Clyde,8359,5,15,9,12,53,48,5,54
Elgin,8359,6,14,6,16,53,63,-10,48
Annan Athlet,8359,7,11,11,14,47,42,5,44
Berwick,8359,8,8,10,18,29,60,-31,34
Edinburgh Ci,8359,9,7,9,20,36,63,-27,30
Cowdenbeath,8359,10,5,10,21,24,54,-30,25
Montrose,8360,1,23,8,5,60,35,25,77
Peterhead,8360,2,24,4,8,78,38,40,76
Stirling,8360,3,17,6,13,64,54,10,57
Stenhousem'r,8360,4,15,8,13,58,50,8,53
Clyde,8360,5,14,10,12,52,49,3,52
Elgin,8360,6,14,7,15,54,61,-7,49
Annan Athlet,8360,7,12,11,13,49,41,8,47
Berwick,8360,8,8,11,17,30,59,-29,35
Edinburgh Ci,8360,9,7,9,20,36,61,-25,30
Cowdenbeath,8360,10,4,10,22,23,56,-33,22
Montrose,8361,1,24,7,5,61,35,26,79
Peterhead,8361,2,24,4,8,80,38,42,76
Stenhousem'r,8361,3,16,8,12,60,49,11,56
Stirling,8361,4,16,6,14,63,56,7,54
Clyde,8361,5,15,9,12,54,49,5,54
Elgin,8361,6,14,6,16,54,62,-8,48
Annan Athlet,8361,7,12,11,13,49,42,7,47
Berwick,8361,8,8,10,18,30,61,-31,34
Edinburgh Ci,8361,9,7,9,20,36,63,-27,30
Cowdenbeath,8361,10,4,10,22,24,56,-32,22
Montrose,8362,1,24,7,5,64,34,30,79
Peterhead,8362,2,24,4,8,78,38,40,76
Stirling,8362,3,16,7,13,60,51,9,55
Stenhousem'r,8362,4,15,9,12,55,46,9,54
Clyde,8362,5,14,9,13,51,49,2,51
Elgin,8362,6,14,6,16,53,65,-12,48
Annan Athlet,8362,7,12,11,13,50,43,7,47
Berwick,8362,8,9,10,17,30,58,-28,37
Edinburgh Ci,8362,9,7,9,20,36,61,-25,30
Cowdenbeath,8362,10,4,10,22,25,57,-32,22
Montrose,8363,1,24,7,5,62,35,27,79
Peterhead,8363,2,23,5,8,79,40,39,74
Stirling,8363,3,16,7,13,61,52,9,55
Stenhousem'r,8363,4,15,9,12,56,47,9,54
Clyde,8363,5,14,10,12,54,51,3,52
Elgin,8363,6,14,6,16,54,63,-9,48
Annan Athlet,8363,7,12,11,13,49,42,7,47
Berwick,8363,8,8,11,17,32,61,-29,35
Edinburgh Ci,8363,9,7,10,19,38,62,-24,31
Cowdenbeath,8363,10,4,10,22,24,56,-32,22
Montrose,8364,1,24,7,5,62,34,28,79
Peterhead,8364,2,24,4,8,79,39,40,76
Stirling,8364,3,16,7,13,61,52,9,55
Stenhousem'r,8364,4,15,9,12,56,47,9,54
Clyde,8364,5,14,9,13,51,50,1,51
Elgin,8364,6,14,6,16,53,63,-10,48
Annan Athlet,8364,7,12,11,13,49,41,8,47
Berwick,8364,8,9,10,17,31,58,-27,37
Edinburgh Ci,8364,9,7,9,20,37,62,-25,30
Cowdenbeath,8364,10,4,10,22,23,56,-33,22
Montrose,8365,1,23,8,5,61,36,25,77
Peterhead,8365,2,24,4,8,79,38,41,76
Stirling,8365,3,17,6,13,63,51,12,57
Stenhousem'r,8365,4,15,8,13,55,49,6,53
Clyde,8365,5,14,10,12,51,48,3,52
Elgin,8365,6,14,7,15,55,62,-7,49
Annan Athlet,8365,7,11,12,13,48,42,6,45
Berwick,8365,8,8,11,17,29,58,-29,35
Edinburgh Ci,8365,9,7,9,20,36,62,-26,30
Cowdenbeath,8365,10,4,11,21,24,55,-31,23
Montrose,8366,1,24,7,5,61,35,26,79
Peterhead,8366,2,24,4,8,81,39,42,76
Stirling,8366,3,17,6,13,61,51,10,57
Clyde,8366,4,15,9,12,53,48,5,54
Stenhousem'r,8366,5,15,8,13,55,47,8,53
Elgin,8366,6,14,6,16,54,62,-8,48
Annan Athlet,8366,7,11,11,14,47,42,5,44
Berwick,8366,8,8,10,18,29,60,-31,34
Edinburgh Ci,8366,9,7,9,20,37,64,-27,30
Cowdenbeath,8366,10,5,10,21,24,54,-30,25
Montrose,8367,1,23,8,5,59,34,25,77
Peterhead,8367,2,23,5,8,77,38,39,74
Stirling,8367,3,17,6,13,66,52,14,57
Clyde,8367,4,15,9,12,53,49,4,54
Stenhousem'r,8367,5,15,8,13,56,52,4,53
Elgin,8367,6,14,7,15,53,60,-7,49
Annan Athlet,8367,7,12,11,13,49,42,7,47
Berwick,8367,8,8,10,18,30,60,-30,34
Edinburgh Ci,8367,9,7,10,19,36,60,-24,31
Cowdenbeath,8367,10,4,10,22,24,56,-32,22
Montrose,8368,1,23,8,5,60,35,25,77
Peterhead,8368,2,24,4,8,80,38,42,76
Stirling,8368,3,16,7,13,61,52,9,55
Stenhousem'r,8368,4,15,9,12,56,47,9,54
Clyde,8368,5,15,9,12,55,48,7,54
Elgin,8368,6,14,7,15,54,61,-7,49
Annan Athlet,8368,7,12,11,13,49,42,7,47
Berwick,8368,8,8,10,18,29,62,-33,34
Edinburgh Ci,8368,9,7,9,20,36,63,-27,30
Cowdenbeath,8368,10,4,10,22,24,56,-32,22
Montrose,8369,1,23,8,5,59,34,25,77
Peterhead,8369,2,24,4,8,80,38,42,76
Stenhousem'r,8369,3,16,8,12,57,47,10,56
Stirling,8369,4,16,6,14,61,53,8,54
Clyde,8369,5,15,9,12,52,48,4,54
Elgin,8369,6,14,7,15,53,60,-7,49
Annan Athlet,8369,7,11,11,14,47,43,4,44
Berwick,8369,8,8,10,18,29,59,-30,34
Edinburgh Ci,8369,9,7,9,20,36,63,-27,30
Cowdenbeath,8369,10,5,10,21,25,54,-29,25
Montrose,8370,1,23,7,6,60,37,23,76
Peterhead,8370,2,23,4,9,79,42,37,73
Stirling,8370,3,17,6,13,61,51,10,57
Stenhousem'r,8370,4,15,8,13,55,47,8,53
Clyde,8370,5,14,9,13,51,49,2,51
Elgin,8370,6,15,6,15,56,61,-5,51
Annan Athlet,8370,7,11,11,14,47,43,4,44
Berwick,8370,8,9,10,17,30,58,-28,37
Edinburgh Ci,8370,9,8,9,19,40,62,-22,33
Cowdenbeath,8370,10,5,10,21,25,54,-29,25
Montrose,8371,1,23,8,5,60,35,25,77
Peterhead,8371,2,24,4,8,79,39,40,76
Stirling,8371,3,17,6,13,63,52,11,57
Clyde,8371,4,15,9,12,52,48,4,54
Stenhousem'r,8371,5,15,8,13,56,49,7,53
Elgin,8371,6,14,7,15,54,61,-7,49
Annan Athlet,8371,7,12,11,13,52,42,10,47
Berwick,8371,8,8,10,18,29,59,-30,34
Edinburgh Ci,8371,9,7,9,20,37,62,-25,30
Cowdenbeath,8371,10,4,10,22,24,59,-35,22
Montrose,8372,1,24,7,5,60,34,26,79
Peterhead,8372,2,24,4,8,79,38,41,76
Stirling,8372,3,17,6,13,64,51,13,57
Stenhousem'r,8372,4,15,8,13,55,50,5,53
Clyde,8372,5,14,9,13,53,51,2,51
Elgin,8372,6,14,6,16,53,61,-8,48
Annan Athlet,8372,7,11,11,14,48,44,4,44
Berwick,8372,8,9,10,17,32,60,-28,37
Edinburgh Ci,8372,9,7,9,20,36,62,-26,30
Cowdenbeath,8372,10,5,10,21,26,55,-29,25
Montrose,8373,1,24,7,5,63,35,28,79
Peterhead,8373,2,24,4,8,79,38,41,76
Stirling,8373,3,17,6,13,62,51,11,57
Clyde,8373,4,15,9,12,54,48,6,54
Stenhousem'r,8373,5,15,8,13,55,48,7,53
Elgin,8373,6,14,6,16,54,64,-10,48
Annan Athlet,8373,7,12,11,13,48,41,7,47
Berwick,8373,8,8,10,18,29,61,-32,34
Edinburgh Ci,8373,9,7,9,20,36,62,-26,30
Cowdenbeath,8373,10,4,10,22,23,55,-32,22
Montrose,8374,1,24,7,5,61,35,26,79
Peterhead,8374,2,24,4,8,79,39,40,76
Stirling,8374,3,17,6,13,63,53,10,57
Stenhousem'r,8374,4,15,8,13,57,49,8,53
Clyde,8374,5,14,9,13,53,51,2,51
Elgin,8374,6,14,6,16,54,62,-8,48
Annan Athlet,8374,7,12,11,13,48,41,7,47
Berwick,8374,8,9,10,17,32,60,-28,37
Edinburgh Ci,8374,9,7,9,20,37,62,-25,30
Cowdenbeath,8374,10,4,10,22,23,55,-32,22
Montrose,8375,1,24,7,5,60,34,26,79
Peterhead,8375,2,24,4,8,79,39,40,76
Stirling,8375,3,16,7,13,62,53,9,55
Stenhousem'r,8375,4,15,9,12,57,48,9,54
Clyde,8375,5,14,9,13,51,49,2,51
Elgin,8375,6,14,6,16,53,61,-8,48
Annan Athlet,8375,7,12,11,13,48,41,7,47
Berwick,8375,8,9,10,17,30,58,-28,37
Edinburgh Ci,8375,9,7,9,20,37,62,-25,30
Cowdenbeath,8375,10,4,10,22,23,55,-32,22
Peterhead,8376,1,24,4,8,82,40,42,76
Montrose,8376,2,23,7,6,59,36,23,76
Stirling,8376,3,16,7,13,62,53,9,55
Stenhousem'r,8376,4,15,9,12,57,48,9,54
Clyde,8376,5,15,9,12,55,48,7,54
Elgin,8376,6,15,6,15,55,60,-5,51
Annan Athlet,8376,7,11,12,13,48,42,6,45
Berwick,8376,8,8,10,18,29,62,-33,34
Edinburgh Ci,8376,9,7,9,20,38,65,-27,30
Cowdenbeath,8376,10,4,11,21,24,55,-31,23
Montrose,8377,1,24,7,5,63,35,28,79
Peterhead,8377,2,23,5,8,78,39,39,74
Stirling,8377,3,17,6,13,65,55,10,57
Stenhousem'r,8377,4,15,8,13,59,51,8,53
Clyde,8377,5,14,10,12,52,49,3,52
Elgin,8377,6,14,6,16,54,64,-10,48
Annan Athlet,8377,7,12,11,13,49,41,8,47
Berwick,8377,8,8,11,17,30,59,-29,35
Edinburgh Ci,8377,9,7,10,19,37,61,-24,31
Cowdenbeath,8377,10,4,10,22,23,56,-33,22
Montrose,8378,1,24,7,5,61,34,27,79
Peterhead,8378,2,24,4,8,81,41,40,76
Stenhousem'r,8378,3,16,8,12,57,47,10,56
Stirling,8378,4,16,6,14,61,53,8,54
Clyde,8378,5,14,9,13,51,49,2,51
Elgin,8378,6,14,6,16,53,62,-9,48
Annan Athlet,8378,7,12,11,13,49,42,7,47
Berwick,8378,8,9,10,17,30,58,-28,37
Edinburgh Ci,8378,9,7,9,20,39,64,-25,30
Cowdenbeath,8378,10,4,10,22,24,56,-32,22
Montrose,8379,1,24,7,5,63,34,29,79
Peterhead,8379,2,24,4,8,81,41,40,76
Stirling,8379,3,16,7,13,61,52,9,55
Stenhousem'r,8379,4,15,9,12,56,47,9,54
Clyde,8379,5,14,10,12,53,50,3,52
Elgin,8379,6,14,6,16,53,64,-11,48
Annan Athlet,8379,7,11,12,13,47,41,6,45
Berwick,8379,8,8,11,17,31,60,-29,35
Edinburgh Ci,8379,9,7,9,20,39,64,-25,30
Cowdenbeath,8379,10,4,11,21,23,54,-31,23
Montrose,8380,1,23,8,5,63,38,25,77
Peterhead,8380,2,24,4,8,79,39,40,76
Stirling,8380,3,16,7,13,63,54,9,55
Stenhousem'r,8380,4,15,9,12,58,49,9,54
Clyde,8380,5,15,9,12,54,48,6,54
Elgin,8380,6,14,7,15,57,64,-7,49
Annan Athlet,8380,7,11,12,13,47,41,6,45
Berwick,8380,8,8,10,18,29,61,-32,34
Edinburgh Ci,8380,9,7,9,20,37,62,-25,30
Cowdenbeath,8380,10,4,11,21,23,54,-31,23
Montrose,8381,1,24,7,5,62,36,26,79
Peterhead,8381,2,24,4,8,79,39,40,76
Stenhousem'r,8381,3,16,8,12,57,47,10,56
Stirling,8381,4,16,6,14,61,53,8,54
Clyde,8381,5,15,9,12,53,48,5,54
Elgin,8381,6,14,6,16,55,63,-8,48
Annan Athlet,8381,7,11,11,14,47,42,5,44
Berwick,8381,8,8,10,18,29,60,-31,34
Edinburgh Ci,8381,9,7,9,20,37,62,-25,30
Cowdenbeath,8381,10,5,10,21,24,54,-30,25
Montrose,8382,1,24,7,5,63,34,29,79
Peterhead,8382,2,24,4,8,80,39,41,76
Stenhousem'r,8382,3,16,8,12,57,46,11,56
Stirling,8382,4,16,6,14,60,53,7,54
Clyde,8382,5,14,10,12,52,49,3,52
Elgin,8382,6,14,6,16,53,64,-11,48
Annan Athlet,8382,7,11,12,13,48,42,6,45
Berwick,8382,8,8,11,17,30,59,-29,35
Edinburgh Ci,8382,9,7,9,20,37,63,-26,30
Cowdenbeath,8382,10,4,11,21,24,55,-31,23
Montrose,8383,1,24,7,5,61,35,26,79
Peterhead,8383,2,24,4,8,81,39,42,76
Stirling,8383,3,16,7,13,60,51,9,55
Stenhousem'r,8383,4,15,9,12,55,46,9,54
Clyde,8383,5,14,9,13,52,50,2,51
Elgin,8383,6,14,6,16,54,62,-8,48
Annan Athlet,8383,7,12,11,13,49,41,8,47
Berwick,8383,8,9,10,17,31,59,-28,37
Edinburgh Ci,8383,9,7,9,20,37,64,-27,30
Cowdenbeath,8383,10,4,10,22,23,56,-33,22
Montrose,8384,1,23,8,5,61,36,25,77
Peterhead,8384,2,23,4,9,78,41,37,73
Stirling,8384,3,17,6,13,63,52,11,57
Stenhousem'r,8384,4,15,8,13,56,49,7,53
Clyde,8384,5,14,10,12,54,51,3,52
Elgin,8384,6,14,7,15,55,62,-7,49
Annan Athlet,8384,7,12,11,13,48,41,7,47
Berwick,8384,8,8,11,17,32,61,-29,35
Edinburgh Ci,8384,9,8,9,19,39,61,-22,33
Cowdenbeath,8384,10,4,10,22,23,55,-32,22
Montrose,8385,1,24,7,5,63,34,29,79
Peterhead,8385,2,24,4,8,82,39,43,76
Stenhousem'r,8385,3,16,8,12,56,46,10,56
Stirling,8385,4,16,6,14,60,52,8,54
Clyde,8385,5,15,9,12,54,50,4,54
Elgin,8385,6,14,6,16,53,64,-11,48
Annan Athlet,8385,7,12,11,13,48,41,7,47
Berwick,8385,8,8,10,18,31,61,-30,34
Edinburgh Ci,8385,9,7,9,20,37,65,-28,30
Cowdenbeath,8385,10,4,10,22,23,55,-32,22
Montrose,8386,1,24,7,5,62,34,28,79
Peterhead,8386,2,24,4,8,81,38,43,76
Stirling,8386,3,17,6,13,62,51,11,57
Stenhousem'r,8386,4,15,8,13,55,48,7,53
Clyde,8386,5,14,9,13,51,49,2,51
Elgin,8386,6,14,6,16,53,63,-10,48
Annan Athlet,8386,7,11,11,14,47,42,5,44
Berwick,8386,8,9,10,17,30,58,-28,37
Edinburgh Ci,8386,9,7,9,20,36,64,-28,30
Cowdenbeath,8386,10,5,10,21,24,54,-30,25
Montrose,8387,1,24,7,5,65,34,31,79
Peterhead,8387,2,24,4,8,81,39,42,76
Stenhousem'r,8387,3,16,8,12,59,47,12,56
Stirling,8387,4,16,6,14,61,55,6,54
Clyde,8387,5,15,9,12,54,50,4,54
Elgin,8387,6,14,6,16,53,66,-13,48
Annan Athlet,8387,7,12,11,13,48,41,7,47
Berwick,8387,8,8,10,18,31,61,-30,34
Edinburgh Ci,8387,9,7,9,20,37,64,-27,30
Cowdenbeath,8387,10,4,10,22,23,55,-32,22
Montrose,8388,1,23,8,5,60,35,25,77
Peterhead,8388,2,24,4,8,79,38,41,76
Stirling,8388,3,17,6,13,62,52,10,57
Stenhousem'r,8388,4,15,8,13,56,48,8,53
Clyde,8388,5,14,10,12,52,49,3,52
Elgin,8388,6,14,7,15,54,61,-7,49
Annan Athlet,8388,7,12,11,13,51,42,9,47
Berwick,8388,8,8,11,17,30,59,-29,35
Edinburgh Ci,8388,9,7,9,20,36,62,-26,30
Cowdenbeath,8388,10,4,10,22,24,58,-34,22
Montrose,8389,1,24,7,5,67,35,32,79
Peterhead,8389,2,23,5,8,78,39,39,74
Stirling,8389,3,17,6,13,61,51,10,57
Stenhousem'r,8389,4,15,8,13,55,47,8,53
Clyde,8389,5,14,9,13,52,52,0,51
Elgin,8389,6,14,6,16,54,68,-14,48
Annan Athlet,8389,7,11,11,14,47,42,5,44
Berwick,8389,8,9,10,17,33,59,-26,37
Edinburgh Ci,8389,9,7,10,19,37,61,-24,31
Cowdenbeath,8389,10,5,10,21,24,54,-30,25
Peterhead,8390,1,24,4,8,78,38,40,76
Montrose,8390,2,23,7,6,60,36,24,76
Stenhousem'r,8390,3,16,8,12,56,46,10,56
Stirling,8390,4,16,6,14,60,52,8,54
Clyde,8390,5,15,9,12,55,51,4,54
Elgin,8390,6,15,6,15,55,61,-6,51
Annan Athlet,8390,7,12,11,13,49,42,7,47
Berwick,8390,8,8,10,18,32,62,-30,34
Edinburgh Ci,8390,9,7,9,20,36,61,-25,30
Cowdenbeath,8390,10,4,10,22,24,56,-32,22
Montrose,8391,1,23,8,5,60,35,25,77
Peterhead,8391,2,24,4,8,81,39,42,76
Stenhousem'r,8391,3,16,8,12,58,46,12,56
Stirling,8391,4,16,6,14,60,54,6,54
Clyde,8391,5,14,10,12,51,48,3,52
Elgin,8391,6,14,7,15,54,61,-7,49
Annan Athlet,8391,7,12,11,13,49,42,7,47
Berwick,8391,8,8,11,17,29,58,-29,35
Edinburgh Ci,8391,9,7,9,20,37,64,-27,30
Cowdenbeath,8391,10,4,10,22,24,56,-32,22
Montrose,8392,1,23,7,6,59,36,23,76
Peterhead,8392,2,23,5,8,78,39,39,74
Stirling,8392,3,17,6,13,64,52,12,57
Stenhousem'r,8392,4,15,8,13,56,50,6,53
Clyde,8392,5,14,10,12,53,50,3,52
Elgin,8392,6,15,6,15,55,60,-5,51
Annan Athlet,8392,7,12,11,13,49,42,7,47
Berwick,8392,8,8,11,17,31,60,-29,35
Edinburgh Ci,8392,9,7,10,19,37,61,-24,31
Cowdenbeath,8392,10,4,10,22,24,56,-32,22
Montrose,8393,1,23,8,5,60,35,25,77
Peterhead,8393,2,24,4,8,81,39,42,76
Stirling,8393,3,17,6,13,64,51,13,57
Clyde,8393,4,15,9,12,55,49,6,54
Stenhousem'r,8393,5,15,8,13,55,50,5,53
Elgin,8393,6,14,7,15,54,61,-7,49
Annan Athlet,8393,7,11,12,13,47,41,6,45
Berwick,8393,8,8,10,18,30,62,-32,34
Edinburgh Ci,8393,9,7,9,20,37,64,-27,30
Cowdenbeath,8393,10,4,11,21,23,54,-31,23
Peterhead,8394,1,24,4,8,79,38,41,76
Montrose,8394,2,23,7,6,60,37,23,76
Stirling,8394,3,16,7,13,62,53,9,55
Stenhousem'r,8394,4,15,9,12,57,48,9,54
Clyde,8394,5,15,9,12,53,49,4,54
Elgin,8394,6,15,6,15,56,61,-5,51
Annan Athlet,8394,7,11,11,14,48,43,5,44
Berwick,8394,8,8,10,18,30,60,-30,34
Edinburgh Ci,8394,9,7,9,20,36,62,-26,30
Cowdenbeath,8394,10,5,10,21,25,55,-30,25
Peterhead,8395,1,24,4,8,79,38,41,76
Montrose,8395,2,23,7,6,59,35,24,76
Stirling,8395,3,17,6,13,64,51,13,57
Clyde,8395,4,15,9,12,52,48,4,54
Stenhousem'r,8395,5,15,8,13,55,50,5,53
Elgin,8395,6,15,6,15,54,60,-6,51
Annan Athlet,8395,7,12,11,13,49,42,7,47
Berwick,8395,8,8,10,18,29,59,-30,34
Edinburgh Ci,8395,9,7,9,20,36,62,-26,30
Cowdenbeath,8395,10,4,10,22,24,56,-32,22
Montrose,8396,1,24,7,5,64,34,30,79
Peterhead,8396,2,24,4,8,79,39,40,76
Stirling,8396,3,16,7,13,62,53,9,55
Stenhousem'r,8396,4,15,9,12,57,48,9,54
Clyde,8396,5,15,9,12,52,48,4,54
Elgin,8396,6,14,6,16,53,65,-12,48
Annan Athlet,8396,7,11,12,13,48,42,6,45
Berwick,8396,8,8,10,18,29,59,-30,34
Edinburgh Ci,8396,9,7,9,20,37,62,-25,30
Cowdenbeath,8396,10,4,11,21,24,55,-31,23
Montrose,8397,1,24,7,5,63,36,27,79
Peterhead,8397,2,23,5,8,77,38,39,74
Stirling,8397,3,17,6,13,62,52,10,57
Clyde,8397,4,15,9,12,53,49,4,54
Stenhousem'r,8397,5,15,8,13,56,48,8,53
Elgin,8397,6,14,6,16,55,64,-9,48
Annan Athlet,8397,7,12,11,13,48,41,7,47
Berwick,8397,8,8,10,18,30,60,-30,34
Edinburgh Ci,8397,9,7,10,19,36,60,-24,31
Cowdenbeath,8397,10,4,10,22,23,55,-32,22
Montrose,8398,1,23,8,5,59,34,25,77
Peterhead,8398,2,24,4,8,79,38,41,76
Stirling,8398,3,17,6,13,61,51,10,57
Clyde,8398,4,15,9,12,54,48,6,54
Stenhousem'r,8398,5,15,8,13,55,47,8,53
Elgin,8398,6,14,7,15,53,60,-7,49
Annan Athlet,8398,7,11,11,14,49,44,5,44
Berwick,8398,8,8,10,18,29,61,-32,34
Edinburgh Ci,8398,9,7,9,20,36,62,-26,30
Cowdenbeath,8398,10,5,10,21,26,56,-30,25
Montrose,8399,1,23,8,5,61,36,25,77
Peterhead,8399,2,24,4,8,81,38,43,76
Stirling,8399,3,17,6,13,61,51,10,57
Clyde,8399,4,15,9,12,52,48,4,54
Stenhousem'r,8399,5,15,8,13,55,47,8,53
Elgin,8399,6,14,7,15,55,62,-7,49
Annan Athlet,8399,7,11,12,13,48,42,6,45
Berwick,8399,8,8,10,18,29,59,-30,34
Edinburgh Ci,8399,9,7,9,20,36,64,-28,30
Cowdenbeath,8399,10,4,11,21,24,55,-31,23
Montrose,8400,1,24,7,5,63,34,29,79
Peterhead,8400,2,24,4,8,80,38,42,76
Stenhousem'r,8400,3,16,8,12,58,48,10,56
Stirling,8400,4,16,6,14,62,54,8,54
Clyde,8400,5,14,9,13,53,52,1,51
Elgin,8400,6,14,6,16,53,64,-11,48
Annan Athlet,8400,7,11,12,13,48,42,6,45
Berwick,8400,8,9,10,17,33,60,-27,37
Edinburgh Ci,8400,9,7,9,20,36,63,-27,30
Cowdenbeath,8400,10,4,11,21,24,55,-31,23
Montrose,8401,1,24,7,5,61,35,26,79
Peterhead,8401,2,23,4,9,77,39,38,73
Stirling,8401,3,16,7,13,61,52,9,55
Stenhousem'r,8401,4,15,9,12,56,47,9,54
Clyde,8401,5,14,9,13,53,54,-1,51
Elgin,8401,6,14,6,16,54,62,-8,48
Annan Athlet,8401,7,11,12,13,48,42,6,45
Berwick,8401,8,9,10,17,35,60,-25,37
Edinburgh Ci,8401,9,8,9,19,37,60,-23,33
Cowdenbeath,8401,10,4,11,21,24,55,-31,23
Montrose,8402,1,23,8,5,60,35,25,77
Peterhead,8402,2,23,5,8,78,39,39,74
Stirling,8402,3,17,6,13,64,51,13,57
Clyde,8402,4,15,9,12,54,49,5,54
Stenhousem'r,8402,5,15,8,13,55,50,5,53
Elgin,8402,6,14,7,15,54,61,-7,49
Annan Athlet,8402,7,12,11,13,49,42,7,47
Berwick,8402,8,8,10,18,30,61,-31,34
Edinburgh Ci,8402,9,7,10,19,37,61,-24,31
Cowdenbeath,8402,10,4,10,22,24,56,-32,22
Montrose,8403,1,23,8,5,60,35,25,77
Peterhead,8403,2,24,4,8,78,38,40,76
Stirling,8403,3,16,7,13,61,52,9,55
Stenhousem'r,8403,4,15,9,12,56,47,9,54
Clyde,8403,5,14,10,12,51,48,3,52
Elgin,8403,6,14,7,15,54,61,-7,49
Annan Athlet,8403,7,11,12,13,47,41,6,45
Berwick,8403,8,8,11,17,29,58,-29,35
Edinburgh Ci,8403,9,7,9,20,36,61,-25,30
Cowdenbeath,8403,10,4,11,21,23,54,-31,23
Montrose,8404,1,24,7,5,62,35,27,79
Peterhead,8404,2,23,5,8,79,40,39,74
Stirling,8404,3,16,7,13,61,52,9,55
Stenhousem'r,8404,4,15,9,12,56,47,9,54
Clyde,8404,5,15,9,12,53,48,5,54
Elgin,8404,6,14,6,16,54,63,-9,48
Annan Athlet,8404,7,11,12,13,48,42,6,45
Berwick,8404,8,8,10,18,29,60,-31,34
Edinburgh Ci,8404,9,7,10,19,38,62,-24,31
Cowdenbeath,8404,10,4,11,21,24,55,-31,23
Montrose,8405,1,23,8,5,60,35,25,77
Peterhead,8405,2,24,4,8,79,39,40,76
Stirling,8405,3,17,6,13,63,52,11,57
Clyde,8405,4,15,9,12,53,48,5,54
Stenhousem'r,8405,5,15,8,13,56,49,7,53
Elgin,8405,6,14,7,15,54,61,-7,49
Annan Athlet,8405,7,11,11,14,47,43,4,44
Berwick,8405,8,8,10,18,29,60,-31,34
Edinburgh Ci,8405,9,7,9,20,37,62,-25,30
Cowdenbeath,8405,10,5,10,21,25,54,-29,25
Montrose,8406,1,24,7,5,62,34,28,79
Peterhead,8406,2,24,4,8,79,38,41,76
Stenhousem'r,8406,3,16,8,12,57,46,11,56
Stirling,8406,4,16,6,14,60,53,7,54
Clyde,8406,5,14,9,13,51,49,2,51
Elgin,8406,6,14,6,16,53,63,-10,48
Annan Athlet,8406,7,12,11,13,48,41,7,47
Berwick,8406,8,9,10,17,30,58,-28,37
Edinburgh Ci,8406,9,7,9,20,36,62,-26,30
Cowdenbeath,8406,10,4,10,22,23,55,-32,22
Montrose,8407,1,24,7,5,63,35,28,79
Peterhead,8407,2,24,4,8,79,38,41,76
Stirling,8407,3,17,6,13,62,51,11,57
Clyde,8407,4,15,9,12,52,48,4,54
Stenhousem'r,8407,5,15,8,13,55,48,7,53
Elgin,8407,6,14,6,16,54,64,-10,48
Annan Athlet,8407,7,12,11,13,49,42,7,47
Berwick,8407,8,8,10,18,29,59,-30,34
Edinburgh Ci,8407,9,7,9,20,36,62,-26,30
Cowdenbeath,8407,10,4,10,22,24,56,-32,22
Montrose,8408,1,24,7,5,61,34,27,79
Peterhead,8408,2,24,4,8,82,39,43,76
Stirling,8408,3,17,6,13,64,52,12,57
Clyde,8408,4,15,9,12,53,49,4,54
Stenhousem'r,8408,5,15,8,13,56,50,6,53
Elgin,8408,6,14,6,16,53,62,-9,48
Annan Athlet,8408,7,12,11,13,49,41,8,47
Berwick,8408,8,8,10,18,30,60,-30,34
Edinburgh Ci,8408,9,7,9,20,37,65,-28,30
Cowdenbeath,8408,10,4,10,22,23,56,-33,22
Montrose,8409,1,24,7,5,63,34,29,79
Peterhead,8409,2,24,4,8,80,40,40,76
Stenhousem'r,8409,3,16,8,12,57,47,10,56
Stirling,8409,4,16,6,14,61,53,8,54
Clyde,8409,5,14,9,13,51,49,2,51
Elgin,8409,6,14,6,16,53,64,-11,48
Annan Athlet,8409,7,11,12,13,48,42,6,45
Berwick,8409,8,9,10,17,30,58,-28,37
Edinburgh Ci,8409,9,7,9,20,38,63,-25,30
Cowdenbeath,8409,10,4,11,21,24,55,-31,23
Montrose,8410,1,24,7,5,61,35,26,79
Peterhead,8410,2,24,4,8,82,39,43,76
Stirling,8410,3,16,7,13,61,52,9,55
Stenhousem'r,8410,4,15,9,12,56,47,9,54
Clyde,8410,5,15,9,12,54,49,5,54
Elgin,8410,6,14,6,16,54,62,-8,48
Annan Athlet,8410,7,11,12,13,49,43,6,45
Berwick,8410,8,8,10,18,30,61,-31,34
Edinburgh Ci,8410,9,7,9,20,37,65,-28,30
Cowdenbeath,8410,10,4,11,21,25,56,-31,23
Peterhead,8411,1,24,4,8,79,39,40,76
Montrose,8411,2,23,7,6,60,36,24,76
Stirling,8411,3,17,6,13,64,53,11,57
Clyde,8411,4,15,9,12,55,48,7,54
Stenhousem'r,8411,5,15,8,13,57,50,7,53
Elgin,8411,6,15,6,15,55,61,-6,51
Annan Athlet,8411,7,11,12,13,48,42,6,45
Berwick,8411,8,8,10,18,29,62,-33,34
Edinburgh Ci,8411,9,7,9,20,37,62,-25,30
Cowdenbeath,8411,10,4,11,21,24,55,-31,23
Montrose,8412,1,23,7,6,59,35,24,76
Peterhead,8412,2,23,5,8,81,42,39,74
Stirling,8412,3,17,6,13,65,51,14,57
Clyde,8412,4,15,9,12,53,48,5,54
Stenhousem'r,8412,5,15,8,13,55,51,4,53
Elgin,8412,6,15,6,15,54,60,-6,51
Annan Athlet,8412,7,12,11,13,50,43,7,47
Berwick,8412,8,8,10,18,29,60,-31,34
Edinburgh Ci,8412,9,7,10,19,40,64,-24,31
Cowdenbeath,8412,10,4,10,22,25,57,-32,22
Montrose,8413,1,23,8,5,61,36,25,77
Peterhead,8413,2,24,4,8,78,38,40,76
Stenhousem'r,8413,3,16,8,12,56,46,10,56
Stirling,8413,4,16,6,14,60,52,8,54
Clyde,8413,5,15,9,12,55,49,6,54
Elgin,8413,6,14,7,15,55,62,-7,49
Annan Athlet,8413,7,11,12,13,47,41,6,45
Berwick,8413,8,8,10,18,30,62,-32,34
Edinburgh Ci,8413,9,7,9,20,36,61,-25,30
Cowdenbeath,8413,10,4,11,21,23,54,-31,23
Montrose,8414,1,24,7,5,62,35,27,79
Peterhead,8414,2,23,4,9,78,40,38,73
Stirling,8414,3,17,6,13,62,52,10,57
Stenhousem'r,8414,4,15,8,13,56,48,8,53
Clyde,8414,5,14,10,12,51,48,3,52
Elgin,8414,6,14,6,16,54,63,-9,48
Annan Athlet,8414,7,12,11,13,48,41,7,47
Berwick,8414,8,8,11,17,29,58,-29,35
Edinburgh Ci,8414,9,8,9,19,38,61,-23,33
Cowdenbeath,8414,10,4,10,22,23,55,-32,22
Peterhead,8415,1,24,4,8,79,39,40,76
Montrose,8415,2,23,7,6,61,37,24,76
Stirling,8415,3,16,7,13,61,52,9,55
Stenhousem'r,8415,4,15,9,12,56,47,9,54
Clyde,8415,5,14,9,13,51,51,0,51
Elgin,8415,6,15,6,15,56,62,-6,51
Annan Athlet,8415,7,11,12,13,47,41,6,45
Berwick,8415,8,9,10,17,32,58,-26,37
Edinburgh Ci,8415,9,7,9,20,37,62,-25,30
Cowdenbeath,8415,10,4,11,21,23,54,-31,23
Montrose,8416,1,23,8,5,60,35,25,77
Peterhead,8416,2,24,4,8,83,38,45,76
Stenhousem'r,8416,3,16,8,12,57,47,10,56
Stirling,8416,4,16,6,14,61,53,8,54
Clyde,8416,5,15,9,12,57,50,7,54
Elgin,8416,6,14,7,15,54,61,-7,49
Annan Athlet,8416,7,12,11,13,49,41,8,47
Berwick,8416,8,8,10,18,31,64,-33,34
Edinburgh Ci,8416,9,7,9,20,36,66,-30,30
Cowdenbeath,8416,10,4,10,22,23,56,-33,22
Montrose,8417,1,24,7,5,61,34,27,79
Peterhead,8417,2,24,4,8,81,39,42,76
Stirling,8417,3,17,6,13,62,51,11,57
Stenhousem'r,8417,4,15,8,13,55,48,7,53
Clyde,8417,5,14,10,12,52,49,3,52
Elgin,8417,6,14,6,16,53,62,-9,48
Annan Athlet,8417,7,11,12,13,48,42,6,45
Berwick,8417,8,8,11,17,30,59,-29,35
Edinburgh Ci,8417,9,7,9,20,37,64,-27,30
Cowdenbeath,8417,10,4,11,21,24,55,-31,23
Peterhead,8418,1,24,4,8,84,38,46,76
Montrose,8418,2,23,7,6,59,35,24,76
Stirling,8418,3,17,6,13,62,51,11,57
Clyde,8418,4,15,9,12,52,48,4,54
Stenhousem'r,8418,5,15,8,13,55,48,7,53
Elgin,8418,6,15,6,15,54,60,-6,51
Annan Athlet,8418,7,11,11,14,48,43,5,44
Berwick,8418,8,8,10,18,29,59,-30,34
Edinburgh Ci,8418,9,7,9,20,36,67,-31,30
Cowdenbeath,8418,10,5,10,21,25,55,-30,25
Montrose,8419,1,24,7,5,62,35,27,79
Peterhead,8419,2,24,4,8,80,38,42,76
Stirling,8419,3,17,6,13,63,53,10,57
Clyde,8419,4,15,9,12,53,49,4,54
Stenhousem'r,8419,5,15,8,13,57,49,8,53
Elgin,8419,6,14,6,16,54,63,-9,48
Annan Athlet,8419,7,11,12,13,47,41,6,45
Berwick,8419,8,8,10,18,30,60,-30,34
Edinburgh Ci,8419,9,7,9,20,36,63,-27,30
Cowdenbeath,8419,10,4,11,21,23,54,-31,23
Montrose,8420,1,24,7,5,61,35,26,79
Peterhead,8420,2,24,4,8,82,40,42,76
Stirling,8420,3,17,6,13,61,51,10,57
Stenhousem'r,8420,4,15,8,13,55,47,8,53
Clyde,8420,5,14,9,13,51,49,2,51
Elgin,8420,6,14,6,16,54,62,-8,48
Annan Athlet,8420,7,12,11,13,48,41,7,47
Berwick,8420,8,9,10,17,30,58,-28,37
Edinburgh Ci,8420,9,7,9,20,38,65,-27,30
Cowdenbeath,8420,10,4,10,22,23,55,-32,22
Peterhead,8421,1,24,4,8,79,39,40,76
Montrose,8421,2,23,7,6,59,35,24,76
Stenhousem'r,8421,3,16,8,12,58,47,11,56
Stirling,8421,4,16,6,14,61,54,7,54
Clyde,8421,5,14,9,13,52,50,2,51
Elgin,8421,6,15,6,15,54,60,-6,51
Annan Athlet,8421,7,12,11,13,52,41,11,47
Berwick,8421,8,9,10,17,31,59,-28,37
Edinburgh Ci,8421,9,7,9,20,37,62,-25,30
Cowdenbeath,8421,10,4,10,22,23,59,-36,22
Montrose,8422,1,24,7,5,61,35,26,79
Peterhead,8422,2,24,4,8,81,38,43,76
Stirling,8422,3,17,6,13,62,52,10,57
Clyde,8422,4,15,9,12,52,48,4,54
Stenhousem'r,8422,5,15,8,13,56,48,8,53
Elgin,8422,6,14,6,16,54,62,-8,48
Annan Athlet,8422,7,11,11,14,47,42,5,44
Berwick,8422,8,8,10,18,29,59,-30,34
Edinburgh Ci,8422,9,7,9,20,36,64,-28,30
Cowdenbeath,8422,10,5,10,21,24,54,-30,25
Montrose,8423,1,24,7,5,64,34,30,79
Peterhead,8423,2,24,4,8,82,41,41,76
Stirling,8423,3,17,6,13,63,53,10,57
Clyde,8423,4,15,9,12,54,50,4,54
Stenhousem'r,8423,5,15,8,13,57,49,8,53
Elgin,8423,6,14,6,16,53,65,-12,48
Annan Athlet,8423,7,11,12,13,48,42,6,45
Berwick,8423,8,8,10,18,31,61,-30,34
Edinburgh Ci,8423,9,7,9,20,39,65,-26,30
Cowdenbeath,8423,10,4,11,21,24,55,-31,23
Montrose,8424,1,24,7,5,61,34,27,79
Peterhead,8424,2,24,4,8,80,39,41,76
Stirling,8424,3,16,7,13,63,54,9,55
Stenhousem'r,8424,4,15,9,12,58,49,9,54
Clyde,8424,5,15,9,12,53,49,4,54
Elgin,8424,6,14,6,16,53,62,-9,48
Annan Athlet,8424,7,12,11,13,49,42,7,47
Berwick,8424,8,8,10,18,30,60,-30,34
Edinburgh Ci,8424,9,7,9,20,37,63,-26,30
Cowdenbeath,8424,10,4,10,22,24,56,-32,22
Peterhead,8425,1,24,4,8,81,39,42,76
Montrose,8425,2,23,7,6,59,36,23,76
Stenhousem'r,8425,3,16,8,12,57,46,11,56
Stirling,8425,4,16,6,14,60,53,7,54
Clyde,8425,5,14,9,13,52,52,0,51
Elgin,8425,6,15,6,15,55,60,-5,51
Annan Athlet,8425,7,12,11,13,48,41,7,47
Berwick,8425,8,9,10,17,33,59,-26,37
Edinburgh Ci,8425,9,7,9,20,37,64,-27,30
Cowdenbeath,8425,10,4,10,22,23,55,-32,22
Montrose,8426,1,24,7,5,61,35,26,79
Peterhead,8426,2,24,4,8,80,40,40,76
Stirling,8426,3,17,6,13,61,51,10,57
Clyde,8426,4,15,9,12,53,49,4,54
Stenhousem'r,8426,5,15,8,13,55,47,8,53
Elgin,8426,6,14,6,16,54,62,-8,48
Annan Athlet,8426,7,12,11,13,49,41,8,47
Berwick,8426,8,8,10,18,30,60,-30,34
Edinburgh Ci,8426,9,7,9,20,38,63,-25,30
Cowdenbeath,8426,10,4,10,22,23,56,-33,22
Montrose,8427,1,24,7,5,61,34,27,79
Peterhead,8427,2,24,4,8,79,38,41,76
Stenhousem'r,8427,3,16,8,12,56,46,10,56
Stirling,8427,4,16,6,14,60,52,8,54
Clyde,8427,5,15,9,12,52,48,4,54
Elgin,8427,6,14,6,16,53,62,-9,48
Annan Athlet,8427,7,12,11,13,50,41,9,47
Berwick,8427,8,8,10,18,29,59,-30,34
Edinburgh Ci,8427,9,7,9,20,36,62,-26,30
Cowdenbeath,8427,10,4,10,22,23,57,-34,22
Montrose,8428,1,24,7,5,61,35,26,79
Peterhead,8428,2,24,4,8,79,38,41,76
Stenhousem'r,8428,3,16,8,12,57,47,10,56
Stirling,8428,4,16,6,14,61,53,8,54
Clyde,8428,5,14,10,12,53,50,3,52
Elgin,8428,6,14,6,16,54,62,-8,48
Annan Athlet,8428,7,11,11,14,47,43,4,44
Berwick,8428,8,8,11,17,31,60,-29,35
Edinburgh Ci,8428,9,7,9,20,36,62,-26,30
Cowdenbeath,8428,10,5,10,21,25,54,-29,25
Montrose,8429,1,23,8,5,61,36,25,77
Peterhead,8429,2,24,4,8,80,38,42,76
Stirling,8429,3,17,6,13,62,52,10,57
Stenhousem'r,8429,4,15,8,13,56,48,8,53
Clyde,8429,5,14,10,12,53,50,3,52
Elgin,8429,6,14,7,15,55,62,-7,49
Annan Athlet,8429,7,11,11,14,48,43,5,44
Berwick,8429,8,8,11,17,31,60,-29,35
Edinburgh Ci,8429,9,7,9,20,36,63,-27,30
Cowdenbeath,8429,10,5,10,21,25,55,-30,25
Montrose,8430,1,24,7,5,62,35,27,79
Peterhead,8430,2,24,4,8,84,38,46,76
Stirling,8430,3,17,6,13,61,51,10,57
Stenhousem'r,8430,4,15,8,13,55,47,8,53
Clyde,8430,5,14,10,12,51,48,3,52
Elgin,8430,6,14,6,16,54,63,-9,48
Annan Athlet,8430,7,11,11,14,48,44,4,44
Berwick,8430,8,8,11,17,29,58,-29,35
Edinburgh Ci,8430,9,7,9,20,36,67,-31,30
Cowdenbeath,8430,10,5,10,21,26,55,-29,25
Montrose,8431,1,23,8,5,60,35,25,77
Peterhead,8431,2,24,4,8,81,39,42,76
Stirling,8431,3,16,7,13,60,51,9,55
Stenhousem'r,8431,4,15,9,12,55,46,9,54
Clyde,8431,5,15,9,12,53,48,5,54
Elgin,8431,6,14,7,15,54,61,-7,49
Annan Athlet,8431,7,11,11,14,47,43,4,44
Berwick,8431,8,8,10,18,29,60,-31,34
Edinburgh Ci,8431,9,7,9,20,37,64,-27,30
Cowdenbeath,8431,10,5,10,21,25,54,-29,25
Montrose,8432,1,24,7,5,60,34,26,79
Peterhead,8432,2,24,4,8,82,38,44,76
Stenhousem'r,8432,3,16,8,12,59,46,13,56
Stirling,8432,4,16,6,14,60,55,5,54
Clyde,8432,5,15,9,12,53,48,5,54
Elgin,8432,6,14,6,16,53,61,-8,48
Annan Athlet,8432,7,12,11,13,48,41,7,47
Berwick,8432,8,8,10,18,29,60,-31,34
Edinburgh Ci,8432,9,7,9,20,36,65,-29,30
Cowdenbeath,8432,10,4,10,22,23,55,-32,22
Montrose,8433,1,24,7,5,60,34,26,79
Peterhead,8433,2,24,4,8,84,39,45,76
Stirling,8433,3,17,6,13,63,53,10,57
Clyde,8433,4,15,9,12,53,48,5,54
Stenhousem'r,8433,5,15,8,13,57,49,8,53
Elgin,8433,6,14,6,16,53,61,-8,48
Annan Athlet,8433,7,12,11,13,49,41,8,47
Berwick,8433,8,8,10,18,29,60,-31,34
Edinburgh Ci,8433,9,7,9,20,37,67,-30,30
Cowdenbeath,8433,10,4,10,22,23,56,-33,22
Montrose,8434,1,24,7,5,63,34,29,79
Peterhead,8434,2,24,4,8,81,41,40,76
Stenhousem'r,8434,3,16,8,12,59,47,12,56
Stirling,8434,4,16,6,14,61,55,6,54
Clyde,8434,5,14,9,13,52,51,1,51
Elgin,8434,6,14,6,16,53,64,-11,48
Annan Athlet,8434,7,11,11,14,47,43,4,44
Berwick,8434,8,9,10,17,32,59,-27,37
Edinburgh Ci,8434,9,7,9,20,39,64,-25,30
Cowdenbeath,8434,10,5,10,21,25,54,-29,25
Montrose,8435,1,23,8,5,60,35,25,77
Peterhead,8435,2,24,4,8,79,38,41,76
Stenhousem'r,8435,3,16,8,12,57,47,10,56
Stirling,8435,4,16,6,14,61,53,8,54
Clyde,8435,5,14,10,12,51,48,3,52
Elgin,8435,6,14,7,15,54,61,-7,49
Annan Athlet,8435,7,11,12,13,47,41,6,45
Berwick,8435,8,8,11,17,29,58,-29,35
Edinburgh Ci,8435,9,7,9,20,36,62,-26,30
Cowdenbeath,8435,10,4,11,21,23,54,-31,23
Montrose,8436,1,24,7,5,62,35,27,79
Peterhead,8436,2,24,4,8,85,39,46,76
Stirling,8436,3,17,6,13,61,51,10,57
Stenhousem'r,8436,4,15,8,13,55,47,8,53
Clyde,8436,5,14,9,13,52,50,2,51
Elgin,8436,6,14,6,16,54,63,-9,48
Annan Athlet,8436,7,12,11,13,50,43,7,47
Berwick,8436,8,9,10,17,31,59,-28,37
Edinburgh Ci,8436,9,7,9,20,37,68,-31,30
Cowdenbeath,8436,10,4,10,22,25,57,-32,22
Montrose,8437,1,23,8,5,59,34,25,77
Peterhead,8437,2,23,4,9,77,39,38,73
Stirling,8437,3,17,6,13,61,51,10,57
Clyde,8437,4,15,9,12,54,49,5,54
Stenhousem'r,8437,5,15,8,13,55,47,8,53
Elgin,8437,6,14,7,15,53,60,-7,49
Annan Athlet,8437,7,12,11,13,50,41,9,47
Berwick,8437,8,8,10,18,30,61,-31,34
Edinburgh Ci,8437,9,8,9,19,37,60,-23,33
Cowdenbeath,8437,10,4,10,22,23,57,-34,22
Montrose,8438,1,24,7,5,62,34,28,79
Peterhead,8438,2,24,4,8,78,38,40,76
Stirling,8438,3,17,6,13,63,53,10,57
Clyde,8438,4,15,9,12,54,48,6,54
Stenhousem'r,8438,5,15,8,13,57,49,8,53
Elgin,8438,6,14,6,16,53,63,-10,48
Annan Athlet,8438,7,11,12,13,50,44,6,45
Berwick,8438,8,8,10,18,29,61,-32,34
Edinburgh Ci,8438,9,7,9,20,36,61,-25,30
Cowdenbeath,8438,10,4,11,21,26,57,-31,23
Montrose,8439,1,23,8,5,61,36,25,77
Peterhead,8439,2,23,5,8,79,40,39,74
Stirling,8439,3,17,6,13,62,52,10,57
Stenhousem'r,8439,4,15,8,13,56,48,8,53
Clyde,8439,5,14,10,12,52,49,3,52
Elgin,8439,6,14,7,15,55,62,-7,49
Annan Athlet,8439,7,11,12,13,48,42,6,45
Berwick,8439,8,8,11,17,30,59,-29,35
Edinburgh Ci,8439,9,7,10,19,38,62,-24,31
Cowdenbeath,8439,10,4,11,21,24,55,-31,23
Peterhead,8440,1,24,4,8,79,39,40,76
Montrose,8440,2,23,7,6,60,36,24,76
Stirling,8440,3,17,6,13,63,51,12,57
Clyde,8440,4,15,9,12,55,50,5,54
Stenhousem'r,8440,5,15,8,13,55,49,6,53
Elgin,8440,6,15,6,15,55,61,-6,51
Annan Athlet,8440,7,12,11,13,49,41,8,47
Berwick,8440,8,8,10,18,31,62,-31,34
Edinburgh Ci,8440,9,7,9,20,37,62,-25,30
Cowdenbeath,8440,10,4,10,22,23,56,-33,22
Montrose,8441,1,24,7,5,62,35,27,79
Peterhead,8441,2,23,4,9,77,39,38,73
Stirling,8441,3,17,6,13,61,51,10,57
Clyde,8441,4,15,9,12,52,48,4,54
Stenhousem'r,8441,5,15,8,13,55,47,8,53
Elgin,8441,6,14,6,16,54,63,-9,48
Annan Athlet,8441,7,12,11,13,49,42,7,47
Berwick,8441,8,8,10,18,29,59,-30,34
Edinburgh Ci,8441,9,8,9,19,37,60,-23,33
Cowdenbeath,8441,10,4,10,22,24,56,-32,22
Montrose,8442,1,23,8,5,60,35,25,77
Peterhead,8442,2,24,4,8,80,38,42,76
Stirling,8442,3,16,7,13,62,53,9,55
Stenhousem'r,8442,4,15,9,12,57,48,9,54
Clyde,8442,5,14,9,13,52,51,1,51
Elgin,8442,6,14,7,15,54,61,-7,49
Annan Athlet,8442,7,12,11,13,48,41,7,47
Berwick,8442,8,9,10,17,32,59,-27,37
Edinburgh Ci,8442,9,7,9,20,36,63,-27,30
Cowdenbeath,8442,10,4,10,22,23,55,-32,22
Montrose,8443,1,24,7,5,60,34,26,79
Peterhead,8443,2,24,4,8,82,38,44,76
Stirling,8443,3,17,6,13,61,51,10,57
Clyde,8443,4,15,9,12,53,49,4,54
Stenhousem'r,8443,5,15,8,13,55,47,8,53
Elgin,8443,6,14,6,16,53,61,-8,48
Annan Athlet,8443,7,11,11,14,47,42,5,44
Berwick,8443,8,8,10,18,30,60,-30,34
Edinburgh Ci,8443,9,7,9,20,36,65,-29,30
Cowdenbeath,8443,10,5,10,21,24,54,-30,25
Montrose,8444,1,24,7,5,63,35,28,79
Peterhead,8444,2,24,4,8,79,38,41,76
Stirling,8444,3,17,6,13,64,52,12,57
Clyde,8444,4,15,9,12,53,48,5,54
Stenhousem'r,8444,5,15,8,13,56,50,6,53
Elgin,8444,6,14,6,16,54,64,-10,48
Annan Athlet,8444,7,12,11,13,49,42,7,47
Berwick,8444,8,8,10,18,29,60,-31,34
Edinburgh Ci,8444,9,7,9,20,36,62,-26,30
Cowdenbeath,8444,10,4,10,22,24,56,-32,22
Montrose,8445,1,24,7,5,60,34,26,79
Peterhead,8445,2,24,4,8,80,39,41,76
Stirling,8445,3,16,7,13,60,51,9,55
Stenhousem'r,8445,4,15,9,12,55,46,9,54
Clyde,8445,5,15,9,12,53,48,5,54
Elgin,8445,6,14,6,16,53,61,-8,48
Annan Athlet,8445,7,11,12,13,48,42,6,45
Berwick,8445,8,8,10,18,29,60,-31,34
Edinburgh Ci,8445,9,7,9,20,37,63,-26,30
Cowdenbeath,8445,10,4,11,21,24,55,-31,23
Montrose,8446,1,24,7,5,62,35,27,79
Peterhead,8446,2,24,4,8,80,38,42,76
Stenhousem'r,8446,3,16,8,12,56,46,10,56
Stirling,8446,4,16,6,14,60,52,8,54
Clyde,8446,5,15,9,12,53,48,5,54
Elgin,8446,6,14,6,16,54,63,-9,48
Annan Athlet,8446,7,12,11,13,50,42,8,47
Berwick,8446,8,8,10,18,29,60,-31,34
Edinburgh Ci,8446,9,7,9,20,36,63,-27,30
Cowdenbeath,8446,10,4,10,22,24,57,-33,22
Montrose,8447,1,23,8,5,62,37,25,77
Peterhead,8447,2,24,4,8,80,38,42,76
Stirling,8447,3,16,7,13,60,51,9,55
Stenhousem'r,8447,4,15,9,12,55,46,9,54
Clyde,8447,5,14,10,12,52,49,3,52
Elgin,8447,6,14,7,15,56,63,-7,49
Annan Athlet,8447,7,12,11,13,49,41,8,47
Berwick,8447,8,8,11,17,30,59,-29,35
Edinburgh Ci,8447,9,7,9,20,36,63,-27,30
Cowdenbeath,8447,10,4,10,22,23,56,-33,22
Peterhead,8448,1,24,4,8,81,40,41,76
Montrose,8448,2,23,7,6,59,35,24,76
Stirling,8448,3,17,6,13,62,52,10,57
Clyde,8448,4,15,9,12,53,49,4,54
Stenhousem'r,8448,5,15,8,13,56,48,8,53
Elgin,8448,6,15,6,15,54,60,-6,51
Annan Athlet,8448,7,12,11,13,49,41,8,47
Berwick,8448,8,8,10,18,30,60,-30,34
Edinburgh Ci,8448,9,7,9,20,38,64,-26,30
Cowdenbeath,8448,10,4,10,22,23,56,-33,22
Montrose,8449,1,23,8,5,59,34,25,77
Peterhead,8449,2,24,4,8,81,39,42,76
Stenhousem'r,8449,3,16,8,12,58,47,11,56
Stirling,8449,4,16,6,14,61,54,7,54
Clyde,8449,5,14,9,13,51,50,1,51
Elgin,8449,6,14,7,15,53,60,-7,49
Annan Athlet,8449,7,11,11,14,47,42,5,44
Berwick,8449,8,9,10,17,31,58,-27,37
Edinburgh Ci,8449,9,7,9,20,37,64,-27,30
Cowdenbeath,8449,10,5,10,21,24,54,-30,25
Montrose,8450,1,24,7,5,63,35,28,79
Peterhead,8450,2,23,4,9,78,40,38,73
Stirling,8450,3,16,7,13,61,52,9,55
Stenhousem'r,8450,4,15,9,12,56,47,9,54
Clyde,8450,5,15,9,12,53,49,4,54
Elgin,8450,6,14,6,16,54,64,-10,48
Annan Athlet,8450,7,11,12,13,49,43,6,45
Berwick,8450,8,8,10,18,30,60,-30,34
Edinburgh Ci,8450,9,8,9,19,38,61,-23,33
Cowdenbeath,8450,10,4,11,21,25,56,-31,23
Montrose,8451,1,24,7,5,61,35,26,79
Peterhead,8451,2,24,4,8,84,38,46,76
Stirling,8451,3,17,6,13,63,51,12,57
Clyde,8451,4,15,9,12,52,48,4,54
Stenhousem'r,8451,5,15,8,13,55,49,6,53
Elgin,8451,6,14,6,16,54,62,-8,48
Annan Athlet,8451,7,11,12,13,47,41,6,45
Berwick,8451,8,8,10,18,29,59,-30,34
Edinburgh Ci,8451,9,7,9,20,36,67,-31,30
Cowdenbeath,8451,10,4,11,21,23,54,-31,23
Montrose,8452,1,24,7,5,62,35,27,79
Peterhead,8452,2,24,4,8,80,39,41,76
Stirling,8452,3,16,7,13,61,52,9,55
Stenhousem'r,8452,4,15,9,12,56,47,9,54
Clyde,8452,5,15,9,12,56,49,7,54
Elgin,8452,6,14,6,16,54,63,-9,48
Annan Athlet,8452,7,12,11,13,49,42,7,47
Berwick,8452,8,8,10,18,30,63,-33,34
Edinburgh Ci,8452,9,7,9,20,37,63,-26,30
Cowdenbeath,8452,10,4,10,22,24,56,-32,22
Montrose,8453,1,24,7,5,64,35,29,79
Peterhead,8453,2,23,4,9,79,41,38,73
Stirling,8453,3,17,6,13,65,52,13,57
Stenhousem'r,8453,4,15,8,13,56,51,5,53
Clyde,8453,5,14,9,13,51,49,2,51
Elgin,8453,6,14,6,16,54,65,-11,48
Annan Athlet,8453,7,11,11,14,48,44,4,44
Berwick,8453,8,9,10,17,30,58,-28,37
Edinburgh Ci,8453,9,8,9,19,39,62,-23,33
Cowdenbeath,8453,10,5,10,21,26,55,-29,25
Montrose,8454,1,24,7,5,61,34,27,79
Peterhead,8454,2,24,4,8,80,39,41,76
Stenhousem'r,8454,3,16,8,12,58,48,10,56
Stirling,8454,4,16,6,14,62,54,8,54
Clyde,8454,5,15,9,12,55,50,5,54
Elgin,8454,6,14,6,16,53,62,-9,48
Annan Athlet,8454,7,11,12,13,47,41,6,45
Berwick,8454,8,8,10,18,31,62,-31,34
Edinburgh Ci,8454,9,7,9,20,37,63,-26,30
Cowdenbeath,8454,10,4,11,21,23,54,-31,23
Montrose,8455,1,24,7,5,62,35,27,79
Peterhead,8455,2,24,4,8,84,38,46,76
Stirling,8455,3,16,7,13,61,52,9,55
Stenhousem'r,8455,4,15,9,12,56,47,9,54
Clyde,8455,5,15,9,12,55,49,6,54
Elgin,8455,6,14,6,16,54,63,-9,48
Annan Athlet,8455,7,12,11,13,50,42,8,47
Berwick,8455,8,8,10,18,30,62,-32,34
Edinburgh Ci,8455,9,7,9,20,36,67,-31,30
Cowdenbeath,8455,10,4,10,22,24,57,-33,22
Montrose,8456,1,24,7,5,63,36,27,79
Peterhead,8456,2,24,4,8,78,38,40,76
Stenhousem'r,8456,3,16,8,12,56,46,10,56
Stirling,8456,4,16,6,14,60,52,8,54
Clyde,8456,5,15,9,12,54,48,6,54
Elgin,8456,6,14,6,16,55,64,-9,48
Annan Athlet,8456,7,12,11,13,52,44,8,47
Berwick,8456,8,8,10,18,29,61,-32,34
Edinburgh Ci,8456,9,7,9,20,36,61,-25,30
Cowdenbeath,8456,10,4,10,22,26,59,-33,22
Montrose,8457,1,23,8,5,60,35,25,77
Peterhead,8457,2,24,4,8,79,38,41,76
Stirling,8457,3,17,6,13,65,54,11,57
Clyde,8457,4,15,9,12,54,48,6,54
Stenhousem'r,8457,5,15,8,13,58,51,7,53
Elgin,8457,6,14,7,15,54,61,-7,49
Annan Athlet,8457,7,11,12,13,47,41,6,45
Berwick,8457,8,8,10,18,29,61,-32,34
Edinburgh Ci,8457,9,7,9,20,36,62,-26,30
Cowdenbeath,8457,10,4,11,21,23,54,-31,23
Montrose,8458,1,23,8,5,59,34,25,77
Peterhead,8458,2,24,4,8,78,38,40,76
Stirling,8458,3,17,6,13,64,52,12,57
Clyde,8458,4,15,9,12,55,48,7,54
Stenhousem'r,8458,5,15,8,13,56,50,6,53
Elgin,8458,6,14,7,15,53,60,-7,49
Annan Athlet,8458,7,11,11,14,47,43,4,44
Berwick,8458,8,8,10,18,29,62,-33,34
Edinburgh Ci,8458,9,7,9,20,36,61,-25,30
Cowdenbeath,8458,10,5,10,21,25,54,-29,25
Montrose,8459,1,23,8,5,61,36,25,77
Peterhead,8459,2,24,4,8,80,38,42,76
Stenhousem'r,8459,3,16,8,12,58,46,12,56
Stirling,8459,4,16,6,14,60,54,6,54
Clyde,8459,5,14,9,13,52,50,2,51
Elgin,8459,6,14,7,15,55,62,-7,49
Annan Athlet,8459,7,12,11,13,48,41,7,47
Berwick,8459,8,9,10,17,31,59,-28,37
Edinburgh Ci,8459,9,7,9,20,36,63,-27,30
Cowdenbeath,8459,10,4,10,22,23,55,-32,22
Montrose,8460,1,23,8,5,61,36,25,77
Peterhead,8460,2,23,5,8,78,39,39,74
Stenhousem'r,8460,3,16,8,12,57,46,11,56
Stirling,8460,4,16,6,14,60,53,7,54
Clyde,8460,5,14,10,12,51,48,3,52
Elgin,8460,6,14,7,15,55,62,-7,49
Annan Athlet,8460,7,12,11,13,52,41,11,47
Berwick,8460,8,8,11,17,29,58,-29,35
Edinburgh Ci,8460,9,7,10,19,37,61,-24,31
Cowdenbeath,8460,10,4,10,22,23,59,-36,22
Peterhead,8461,1,24,4,8,79,38,41,76
Montrose,8461,2,23,7,6,59,37,22,76
Stirling,8461,3,16,7,13,62,53,9,55
Stenhousem'r,8461,4,15,9,12,57,48,9,54
Clyde,8461,5,15,9,12,53,49,4,54
Elgin,8461,6,15,6,15,56,60,-4,51
Annan Athlet,8461,7,11,11,14,47,42,5,44
Berwick,8461,8,8,10,18,30,60,-30,34
Edinburgh Ci,8461,9,7,9,20,36,62,-26,30
Cowdenbeath,8461,10,5,10,21,24,54,-30,25
Montrose,8462,1,24,7,5,63,35,28,79
Peterhead,8462,2,24,4,8,81,41,40,76
Stirling,8462,3,17,6,13,62,52,10,57
Clyde,8462,4,15,9,12,53,49,4,54
Stenhousem'r,8462,5,15,8,13,56,48,8,53
Elgin,8462,6,14,6,16,54,64,-10,48
Annan Athlet,8462,7,11,12,13,47,41,6,45
Berwick,8462,8,8,10,18,30,60,-30,34
Edinburgh Ci,8462,9,7,9,20,39,64,-25,30
Cowdenbeath,8462,10,4,11,21,23,54,-31,23
Montrose,8463,1,24,7,5,63,34,29,79
Peterhead,8463,2,24,4,8,78,38,40,76
Stirling,8463,3,17,6,13,61,51,10,57
Stenhousem'r,8463,4,15,8,13,55,47,8,53
Clyde,8463,5,14,9,13,52,50,2,51
Elgin,8463,6,14,6,16,53,64,-11,48
Annan Athlet,8463,7,12,11,13,48,41,7,47
Berwick,8463,8,9,10,17,31,59,-28,37
Edinburgh Ci,8463,9,7,9,20,36,61,-25,30
Cowdenbeath,8463,10,4,10,22,23,55,-32,22
Montrose,8464,1,24,7,5,60,34,26,79
Peterhead,8464,2,24,4,8,80,38,42,76
Stenhousem'r,8464,3,16,8,12,56,46,10,56
Stirling,8464,4,16,6,14,60,52,8,54
Clyde,8464,5,15,9,12,53,49,4,54
Elgin,8464,6,14,6,16,53,61,-8,48
Annan Athlet,8464,7,11,11,14,47,42,5,44
Berwick,8464,8,8,10,18,30,60,-30,34
Edinburgh Ci,8464,9,7,9,20,36,63,-27,30
Cowdenbeath,8464,10,5,10,21,24,54,-30,25
Montrose,8465,1,24,7,5,61,35,26,79
Peterhead,8465,2,24,4,8,79,38,41,76
Stirling,8465,3,16,7,13,61,52,9,55
Stenhousem'r,8465,4,15,9,12,56,47,9,54
Clyde,8465,5,14,10,12,52,49,3,52
Elgin,8465,6,14,6,16,54,62,-8,48
Annan Athlet,8465,7,11,12,13,47,41,6,45
Berwick,8465,8,8,11,17,30,59,-29,35
Edinburgh Ci,8465,9,7,9,20,36,62,-26,30
Cowdenbeath,8465,10,4,11,21,23,54,-31,23
Peterhead,8466,1,24,4,8,82,38,44,76
Montrose,8466,2,23,7,6,59,36,23,76
Stirling,8466,3,17,6,13,66,51,15,57
Stenhousem'r,8466,4,15,8,13,55,52,3,53
Clyde,8466,5,14,10,12,52,49,3,52
Elgin,8466,6,15,6,15,55,60,-5,51
Annan Athlet,8466,7,12,11,13,50,42,8,47
Berwick,8466,8,8,11,17,30,59,-29,35
Edinburgh Ci,8466,9,7,9,20,36,65,-29,30
Cowdenbeath,8466,10,4,10,22,24,57,-33,22
Montrose,8467,1,24,7,5,61,35,26,79
Peterhead,8467,2,24,4,8,78,38,40,76
Stirling,8467,3,17,6,13,66,51,15,57
Stenhousem'r,8467,4,15,8,13,55,52,3,53
Clyde,8467,5,14,10,12,51,48,3,52
Elgin,8467,6,14,6,16,54,62,-8,48
Annan Athlet,8467,7,12,11,13,51,43,8,47
Berwick,8467,8,8,11,17,29,58,-29,35
Edinburgh Ci,8467,9,7,9,20,36,61,-25,30
Cowdenbeath,8467,10,4,10,22,25,58,-33,22
Montrose,8468,1,24,7,5,60,34,26,79
Peterhead,8468,2,23,5,8,78,39,39,74
Stirling,8468,3,17,6,13,62,51,11,57
Stenhousem'r,8468,4,15,8,13,55,48,7,53
Clyde,8468,5,14,10,12,51,48,3,52
Elgin,8468,6,14,6,16,53,61,-8,48
Annan Athlet,8468,7,11,12,13,49,43,6,45
Berwick,8468,8,8,11,17,29,58,-29,35
Edinburgh Ci,8468,9,7,10,19,37,61,-24,31
Cowdenbeath,8468,10,4,11,21,25,56,-31,23
Montrose,8469,1,23,8,5,59,34,25,77
Peterhead,8469,2,24,4,8,80,38,42,76
Stenhousem'r,8469,3,16,8,12,59,49,10,56
Stirling,8469,4,16,6,14,63,55,8,54
Clyde,8469,5,15,9,12,55,48,7,54
Elgin,8469,6,14,7,15,53,60,-7,49
Annan Athlet,8469,7,11,12,13,47,41,6,45
Berwick,8469,8,8,10,18,29,62,-33,34
Edinburgh Ci,8469,9,7,9,20,36,63,-27,30
Cowdenbeath,8469,10,4,11,21,23,54,-31,23
Montrose,8470,1,24,7,5,63,34,29,79
Peterhead,8470,2,24,4,8,80,40,40,76
Stenhousem'r,8470,3,16,8,12,58,46,12,56
Stirling,8470,4,16,6,14,60,54,6,54
Clyde,8470,5,15,9,12,53,49,4,54
Elgin,8470,6,14,6,16,53,64,-11,48
Annan Athlet,8470,7,11,11,14,47,43,4,44
Berwick,8470,8,8,10,18,30,60,-30,34
Edinburgh Ci,8470,9,7,9,20,38,63,-25,30
Cowdenbeath,8470,10,5,10,21,25,54,-29,25
Montrose,8471,1,23,8,5,61,36,25,77
Peterhead,8471,2,24,4,8,80,38,42,76
Stirling,8471,3,16,7,13,62,53,9,55
Stenhousem'r,8471,4,15,9,12,57,48,9,54
Clyde,8471,5,14,9,13,51,49,2,51
Elgin,8471,6,14,7,15,55,62,-7,49
Annan Athlet,8471,7,11,11,14,48,43,5,44
Berwick,8471,8,9,10,17,30,58,-28,37
Edinburgh Ci,8471,9,7,9,20,36,63,-27,30
Cowdenbeath,8471,10,5,10,21,25,55,-30,25
Montrose,8472,1,24,7,5,61,35,26,79
Peterhead,8472,2,24,4,8,81,39,42,76
Stirling,8472,3,17,6,13,62,52,10,57
Stenhousem'r,8472,4,15,8,13,56,48,8,53
Clyde,8472,5,14,10,12,53,50,3,52
Elgin,8472,6,14,6,16,54,62,-8,48
Annan Athlet,8472,7,12,11,13,50,41,9,47
Berwick,8472,8,8,11,17,31,60,-29,35
Edinburgh Ci,8472,9,7,9,20,37,64,-27,30
Cowdenbeath,8472,10,4,10,22,23,57,-34,22
Montrose,8473,1,24,7,5,61,34,27,79
Peterhead,8473,2,24,4,8,79,39,40,76
Stirling,8473,3,17,6,13,62,52,10,57
Stenhousem'r,8473,4,15,8,13,56,48,8,53
Clyde,8473,5,14,10,12,52,49,3,52
Elgin,8473,6,14,6,16,53,62,-9,48
Annan Athlet,8473,7,11,11,14,47,42,5,44
Berwick,8473,8,8,11,17,30,59,-29,35
Edinburgh Ci,8473,9,7,9,20,37,62,-25,30
Cowdenbeath,8473,10,5,10,21,24,54,-30,25
Montrose,8474,1,24,7,5,60,34,26,79
Peterhead,8474,2,23,4,9,78,40,38,73
Stirling,8474,3,16,7,13,62,53,9,55
Stenhousem'r,8474,4,15,9,12,57,48,9,54
Clyde,8474,5,14,10,12,52,49,3,52
Elgin,8474,6,14,6,16,53,61,-8,48
Annan Athlet,8474,7,12,11,13,50,41,9,47
Berwick,8474,8,8,11,17,30,59,-29,35
Edinburgh Ci,8474,9,8,9,19,38,61,-23,33
Cowdenbeath,8474,10,4,10,22,23,57,-34,22
Peterhead,8475,1,24,4,8,80,38,42,76
Montrose,8475,2,23,7,6,60,38,22,76
Stirling,8475,3,17,6,13,63,51,12,57
Clyde,8475,4,15,9,12,55,49,6,54
Stenhousem'r,8475,5,15,8,13,55,49,6,53
Elgin,8475,6,15,6,15,57,61,-4,51
Annan Athlet,8475,7,11,12,13,49,43,6,45
Berwick,8475,8,8,10,18,30,62,-32,34
Edinburgh Ci,8475,9,7,9,20,36,63,-27,30
Cowdenbeath,8475,10,4,11,21,25,56,-31,23
Montrose,8476,1,24,7,5,64,35,29,79
Peterhead,8476,2,23,4,9,78,40,38,73
Stirling,8476,3,16,7,13,61,52,9,55
Stenhousem'r,8476,4,15,9,12,56,47,9,54
Clyde,8476,5,14,9,13,51,49,2,51
Elgin,8476,6,14,6,16,54,65,-11,48
Annan Athlet,8476,7,12,11,13,48,41,7,47
Berwick,8476,8,9,10,17,30,58,-28,37
Edinburgh Ci,8476,9,8,9,19,38,61,-23,33
Cowdenbeath,8476,10,4,10,22,23,55,-32,22
Montrose,8477,1,24,7,5,61,34,27,79
Peterhead,8477,2,24,4,8,78,38,40,76
Stirling,8477,3,16,7,13,60,51,9,55
Stenhousem'r,8477,4,15,9,12,55,46,9,54
Clyde,8477,5,15,9,12,53,49,4,54
Elgin,8477,6,14,6,16,53,62,-9,48
Annan Athlet,8477,7,11,12,13,48,42,6,45
Berwick,8477,8,8,10,18,30,60,-30,34
Edinburgh Ci,8477,9,7,9,20,36,61,-25,30
Cowdenbeath,8477,10,4,11,21,24,55,-31,23
Montrose,8478,1,24,7,5,62,35,27,79
Peterhead,8478,2,23,4,9,78,42,36,73
Stirling,8478,3,16,7,13,61,52,9,55
Stenhousem'r,8478,4,15,9,12,56,47,9,54
Clyde,8478,5,15,9,12,52,48,4,54
Elgin,8478,6,14,6,16,54,63,-9,48
Annan Athlet,8478,7,11,11,14,48,44,4,44
Berwick,8478,8,8,10,18,29,59,-30,34
Edinburgh Ci,8478,9,8,9,19,40,61,-21,33
Cowdenbeath,8478,10,5,10,21,26,55,-29,25
Peterhead,8479,1,24,4,8,82,39,43,76
Montrose,8479,2,23,7,6,59,36,23,76
Stirling,8479,3,16,7,13,60,51,9,55
Stenhousem'r,8479,4,15,9,12,55,46,9,54
Clyde,8479,5,15,9,12,53,48,5,54
Elgin,8479,6,15,6,15,55,60,-5,51
Annan Athlet,8479,7,11,12,13,47,41,6,45
Berwick,8479,8,8,10,18,29,60,-31,34
Edinburgh Ci,8479,9,7,9,20,37,65,-28,30
Cowdenbeath,8479,10,4,11,21,23,54,-31,23
Montrose,8480,1,24,7,5,63,34,29,79
Peterhead,8480,2,23,4,9,78,40,38,73
Stenhousem'r,8480,3,16,8,12,57,47,10,56
Stirling,8480,4,16,6,14,61,53,8,54
Clyde,8480,5,15,9,12,55,50,5,54
Elgin,8480,6,14,6,16,53,64,-11,48
Annan Athlet,8480,7,12,11,13,49,41,8,47
Berwick,8480,8,8,10,18,31,62,-31,34
Edinburgh Ci,8480,9,8,9,19,38,61,-23,33
Cowdenbeath,8480,10,4,10,22,23,56,-33,22
Peterhead,8481,1,24,4,8,79,39,40,76
Montrose,8481,2,23,7,6,61,37,24,76
Stenhousem'r,8481,3,16,8,12,57,47,10,56
Stirling,8481,4,16,6,14,61,53,8,54
Clyde,8481,5,15,9,12,53,49,4,54
Elgin,8481,6,15,6,15,56,62,-6,51
Annan Athlet,8481,7,11,12,13,49,43,6,45
Berwick,8481,8,8,10,18,30,60,-30,34
Edinburgh Ci,8481,9,7,9,20,37,62,-25,30
Cowdenbeath,8481,10,4,11,21,25,56,-31,23
Montrose,8482,1,24,7,5,63,34,29,79
Peterhead,8482,2,24,4,8,80,39,41,76
Stirling,8482,3,17,6,13,62,52,10,57
Clyde,8482,4,15,9,12,53,49,4,54
Stenhousem'r,8482,5,15,8,13,56,48,8,53
Elgin,8482,6,14,6,16,53,64,-11,48
Annan Athlet,8482,7,11,12,13,48,42,6,45
Berwick,8482,8,8,10,18,30,60,-30,34
Edinburgh Ci,8482,9,7,9,20,37,63,-26,30
Cowdenbeath,8482,10,4,11,21,24,55,-31,23
Montrose,8483,1,24,7,5,62,35,27,79
Peterhead,8483,2,24,4,8,78,38,40,76
Stirling,8483,3,17,6,13,62,52,10,57
Clyde,8483,4,15,9,12,54,48,6,54
Stenhousem'r,8483,5,15,8,13,56,48,8,53
Elgin,8483,6,14,6,16,54,63,-9,48
Annan Athlet,8483,7,11,12,13,48,42,6,45
Berwick,8483,8,8,10,18,29,61,-32,34
Edinburgh Ci,8483,9,7,9,20,36,61,-25,30
Cowdenbeath,8483,10,4,11,21,24,55,-31,23
Montrose,8484,1,24,7,5,61,34,27,79
Peterhead,8484,2,24,4,8,80,39,41,76
Stenhousem'r,8484,3,16,8,12,57,47,10,56
Stirling,8484,4,16,6,14,61,53,8,54
Clyde,8484,5,15,9,12,54,49,5,54
Elgin,8484,6,14,6,16,53,62,-9,48
Annan Athlet,8484,7,11,12,13,48,42,6,45
Berwick,8484,8,8,10,18,30,61,-31,34
Edinburgh Ci,8484,9,7,9,20,37,63,-26,30
Cowdenbeath,8484,10,4,11,21,24,55,-31,23
Montrose,8485,1,23,7,6,59,35,24,76
Peterhead,8485,2,23,5,8,79,40,39,74
Stenhousem'r,8485,3,16,8,12,56,46,10,56
Stirling,8485,4,16,6,14,60,52,8,54
Clyde,8485,5,15,9,12,52,48,4,54
Elgin,8485,6,15,6,15,54,60,-6,51
Annan Athlet,8485,7,11,12,13,48,42,6,45
Berwick,8485,8,8,10,18,29,59,-30,34
Edinburgh Ci,8485,9,7,10,19,38,62,-24,31
Cowdenbeath,8485,10,4,11,21,24,55,-31,23
Montrose,8486,1,24,7,5,62,35,27,79
Peterhead,8486,2,24,4,8,82,38,44,76
Stenhousem'r,8486,3,16,8,12,59,48,11,56
Stirling,8486,4,16,6,14,62,55,7,54
Clyde,8486,5,15,9,12,52,48,4,54
Elgin,8486,6,14,6,16,54,63,-9,48
Annan Athlet,8486,7,11,11,14,49,44,5,44
Berwick,8486,8,8,10,18,29,59,-30,34
Edinburgh Ci,8486,9,7,9,20,36,65,-29,30
Cowdenbeath,8486,10,5,10,21,26,56,-30,25
Peterhead,8487,1,24,4,8,79,38,41,76
Montrose,8487,2,23,7,6,59,35,24,76
Stenhousem'r,8487,3,16,8,12,58,47,11,56
Stirling,8487,4,16,6,14,61,54,7,54
Clyde,8487,5,14,9,13,52,50,2,51
Elgin,8487,6,15,6,15,54,60,-6,51
Annan Athlet,8487,7,11,11,14,47,42,5,44
Berwick,8487,8,9,10,17,31,59,-28,37
Edinburgh Ci,8487,9,7,9,20,36,62,-26,30
Cowdenbeath,8487,10,5,10,21,24,54,-30,25
Peterhead,8488,1,24,4,8,79,39,40,76
Montrose,8488,2,23,7,6,60,36,24,76
Stirling,8488,3,16,7,13,62,53,9,55
Stenhousem'r,8488,4,15,9,12,57,48,9,54
Clyde,8488,5,15,9,12,53,49,4,54
Elgin,8488,6,15,6,15,55,61,-6,51
Annan Athlet,8488,7,11,12,13,48,42,6,45
Berwick,8488,8,8,10,18,30,60,-30,34
Edinburgh Ci,8488,9,7,9,20,37,62,-25,30
Cowdenbeath,8488,10,4,11,21,24,55,-31,23
Montrose,8489,1,24,7,5,62,34,28,79
Peterhead,8489,2,24,4,8,80,38,42,76
Stenhousem'r,8489,3,16,8,12,57,47,10,56
Stirling,8489,4,16,6,14,61,53,8,54
Clyde,8489,5,14,10,12,52,49,3,52
Elgin,8489,6,14,6,16,53,63,-10,48
Annan Athlet,8489,7,11,12,13,48,42,6,45
Berwick,8489,8,8,11,17,30,59,-29,35
Edinburgh Ci,8489,9,7,9,20,36,63,-27,30
Cowdenbeath,8489,10,4,11,21,24,55,-31,23
Montrose,8490,1,24,7,5,61,34,27,79
Peterhead,8490,2,23,5,8,78,39,39,74
Stenhousem'r,8490,3,16,8,12,57,46,11,56
Stirling,8490,4,16,6,14,60,53,7,54
Clyde,8490,5,15,9,12,55,49,6,54
Elgin,8490,6,14,6,16,53,62,-9,48
Annan Athlet,8490,7,11,11,14,48,43,5,44
Berwick,8490,8,8,10,18,30,62,-32,34
Edinburgh Ci,8490,9,7,10,19,37,61,-24,31
Cowdenbeath,8490,10,5,10,21,25,55,-30,25
Peterhead,8491,1,24,4,8,81,41,40,76
Montrose,8491,2,23,7,6,61,37,24,76
Stirling,8491,3,17,6,13,65,53,12,57
Clyde,8491,4,15,9,12,54,48,6,54
Stenhousem'r,8491,5,15,8,13,57,51,6,53
Elgin,8491,6,15,6,15,56,62,-6,51
Annan Athlet,8491,7,12,11,13,49,42,7,47
Berwick,8491,8,8,10,18,29,61,-32,34
Edinburgh Ci,8491,9,7,9,20,39,64,-25,30
Cowdenbeath,8491,10,4,10,22,24,56,-32,22
Montrose,8492,1,24,7,5,64,34,30,79
Peterhead,8492,2,24,4,8,80,39,41,76
Stenhousem'r,8492,3,16,8,12,56,46,10,56
Stirling,8492,4,16,6,14,60,52,8,54
Clyde,8492,5,15,9,12,54,49,5,54
Elgin,8492,6,14,6,16,53,65,-12,48
Annan Athlet,8492,7,12,11,13,49,41,8,47
Berwick,8492,8,8,10,18,30,61,-31,34
Edinburgh Ci,8492,9,7,9,20,37,63,-26,30
Cowdenbeath,8492,10,4,10,22,23,56,-33,22
Montrose,8493,1,24,7,5,62,36,26,79
Peterhead,8493,2,24,4,8,79,38,41,76
Stirling,8493,3,17,6,13,61,51,10,57
Clyde,8493,4,15,9,12,53,49,4,54
Stenhousem'r,8493,5,15,8,13,55,47,8,53
Elgin,8493,6,14,6,16,55,63,-8,48
Annan Athlet,8493,7,11,11,14,47,43,4,44
Berwick,8493,8,8,10,18,30,60,-30,34
Edinburgh Ci,8493,9,7,9,20,36,62,-26,30
Cowdenbeath,8493,10,5,10,21,25,54,-29,25
Montrose,8494,1,24,7,5,63,35,28,79
Peterhead,8494,2,24,4,8,79,39,40,76
Stenhousem'r,8494,3,16,8,12,57,46,11,56
Stirling,8494,4,16,6,14,60,53,7,54
Clyde,8494,5,14,9,13,53,51,2,51
Elgin,8494,6,14,6,16,54,64,-10,48
Annan Athlet,8494,7,12,11,13,49,42,7,47
Berwick,8494,8,9,10,17,32,60,-28,37
Edinburgh Ci,8494,9,7,9,20,37,62,-25,30
Cowdenbeath,8494,10,4,10,22,24,56,-32,22
Montrose,8495,1,24,7,5,62,36,26,79
Peterhead,8495,2,24,4,8,79,38,41,76
Stirling,8495,3,17,6,13,63,52,11,57
Clyde,8495,4,15,9,12,55,50,5,54
Stenhousem'r,8495,5,15,8,13,56,49,7,53
Elgin,8495,6,14,6,16,55,63,-8,48
Annan Athlet,8495,7,11,12,13,48,42,6,45
Berwick,8495,8,8,10,18,31,62,-31,34
Edinburgh Ci,8495,9,7,9,20,36,62,-26,30
Cowdenbeath,8495,10,4,11,21,24,55,-31,23
Montrose,8496,1,24,7,5,60,34,26,79
Peterhead,8496,2,23,5,8,79,40,39,74
Stirling,8496,3,17,6,13,63,52,11,57
Clyde,8496,4,15,9,12,54,49,5,54
Stenhousem'r,8496,5,15,8,13,56,49,7,53
Elgin,8496,6,14,6,16,53,61,-8,48
Annan Athlet,8496,7,12,11,13,50,43,7,47
Berwick,8496,8,8,10,18,30,61,-31,34
Edinburgh Ci,8496,9,7,10,19,38,62,-24,31
Cowdenbeath,8496,10,4,10,22,25,57,-32,22
Montrose,8497,1,23,8,5,62,37,25,77
Peterhead,8497,2,24,4,8,81,39,42,76
Stirling,8497,3,17,6,13,64,53,11,57
Clyde,8497,4,15,9,12,53,48,5,54
Stenhousem'r,8497,5,15,8,13,57,50,7,53
Elgin,8497,6,14,7,15,56,63,-7,49
Annan Athlet,8497,7,11,11,14,48,44,4,44
Berwick,8497,8,8,10,18,29,60,-31,34
Edinburgh Ci,8497,9,7,9,20,37,64,-27,30
Cowdenbeath,8497,10,5,10,21,26,55,-29,25
Montrose,8498,1,24,7,5,61,35,26,79
Peterhead,8498,2,23,4,9,78,40,38,73
Stirling,8498,3,17,6,13,65,54,11,57
Stenhousem'r,8498,4,15,8,13,58,51,7,53
Clyde,8498,5,14,10,12,53,50,3,52
Elgin,8498,6,14,6,16,54,62,-8,48
Annan Athlet,8498,7,12,11,13,49,42,7,47
Berwick,8498,8,8,11,17,31,60,-29,35
Edinburgh Ci,8498,9,8,9,19,38,61,-23,33
Cowdenbeath,8498,10,4,10,22,24,56,-32,22
Montrose,8499,1,23,8,5,59,34,25,77
Peterhead,8499,2,24,4,8,79,39,40,76
Stirling,8499,3,16,7,13,61,52,9,55
Stenhousem'r,8499,4,15,9,12,56,47,9,54
Clyde,8499,5,15,9,12,53,49,4,54
Elgin,8499,6,14,7,15,53,60,-7,49
Annan Athlet,8499,7,12,11,13,48,41,7,47
Berwick,8499,8,8,10,18,30,60,-30,34
Edinburgh Ci,8499,9,7,9,20,37,62,-25,30
Cowdenbeath,8499,10,4,10,22,23,55,-32,22
Montrose,8500,1,24,7,5,61,35,26,79
Peterhead,8500,2,23,5,8,78,39,39,74
Stirling,8500,3,17,6,13,63,52,11,57
Clyde,8500,4,15,9,12,52,48,4,54
Stenhousem'r,8500,5,15,8,13,56,49,7,53
Elgin,8500,6,14,6,16,54,62,-8,48
Annan Athlet,8500,7,11,11,14,47,42,5,44
Berwick,8500,8,8,10,18,29,59,-30,34
Edinburgh Ci,8500,9,7,10,19,37,61,-24,31
Cowdenbeath,8500,10,5,10,21,24,54,-30,25
Montrose,8501,1,23,7,6,62,38,24,76
Peterhead,8501,2,23,5,8,78,39,39,74
Stirling,8501,3,17,6,13,62,51,11,57
Clyde,8501,4,15,9,12,52,48,4,54
Stenhousem'r,8501,5,15,8,13,55,48,7,53
Elgin,8501,6,15,6,15,57,63,-6,51
Annan Athlet,8501,7,11,12,13,48,42,6,45
Berwick,8501,8,8,10,18,29,59,-30,34
Edinburgh Ci,8501,9,7,10,19,37,61,-24,31
Cowdenbeath,8501,10,4,11,21,24,55,-31,23
Peterhead,8502,1,24,4,8,79,38,41,76
Montrose,8502,2,23,7,6,60,36,24,76
Stirling,8502,3,17,6,13,65,52,13,57
Clyde,8502,4,15,9,12,52,48,4,54
Stenhousem'r,8502,5,15,8,13,56,51,5,53
Elgin,8502,6,15,6,15,55,61,-6,51
Annan Athlet,8502,7,12,11,13,51,44,7,47
Berwick,8502,8,8,10,18,29,59,-30,34
Edinburgh Ci,8502,9,7,9,20,36,62,-26,30
Cowdenbeath,8502,10,4,10,22,26,58,-32,22
Montrose,8503,1,24,7,5,61,34,27,79
Peterhead,8503,2,23,4,9,77,39,38,73
Stenhousem'r,8503,3,16,8,12,57,46,11,56
Stirling,8503,4,16,6,14,60,53,7,54
Clyde,8503,5,15,9,12,54,48,6,54
Elgin,8503,6,14,6,16,53,62,-9,48
Annan Athlet,8503,7,12,11,13,48,41,7,47
Berwick,8503,8,8,10,18,29,61,-32,34
Edinburgh Ci,8503,9,8,9,19,37,60,-23,33
Cowdenbeath,8503,10,4,10,22,23,55,-32,22
Peterhead,8504,1,24,4,8,82,38,44,76
Montrose,8504,2,23,7,6,59,36,23,76
Stirling,8504,3,17,6,13,62,52,10,57
Stenhousem'r,8504,4,15,8,13,56,48,8,53
Clyde,8504,5,14,9,13,51,49,2,51
Elgin,8504,6,15,6,15,55,60,-5,51
Annan Athlet,8504,7,12,11,13,48,41,7,47
Berwick,8504,8,9,10,17,30,58,-28,37
Edinburgh Ci,8504,9,7,9,20,36,65,-29,30
Cowdenbeath,8504,10,4,10,22,23,55,-32,22
Peterhead,8505,1,24,4,8,81,41,40,76
Montrose,8505,2,23,7,6,59,35,24,76
Stenhousem'r,8505,3,16,8,12,58,47,11,56
Stirling,8505,4,16,6,14,61,54,7,54
Clyde,8505,5,15,9,12,53,48,5,54
Elgin,8505,6,15,6,15,54,60,-6,51
Annan Athlet,8505,7,11,12,13,48,42,6,45
Berwick,8505,8,8,10,18,29,60,-31,34
Edinburgh Ci,8505,9,7,9,20,39,64,-25,30
Cowdenbeath,8505,10,4,11,21,24,55,-31,23
Montrose,8506,1,24,7,5,61,35,26,79
Peterhead,8506,2,23,5,8,78,39,39,74
Stirling,8506,3,17,6,13,64,51,13,57
Clyde,8506,4,15,9,12,53,48,5,54
Stenhousem'r,8506,5,15,8,13,55,50,5,53
Elgin,8506,6,14,6,16,54,62,-8,48
Annan Athlet,8506,7,11,11,14,48,44,4,44
Berwick,8506,8,8,10,18,29,60,-31,34
Edinburgh Ci,8506,9,7,10,19,37,61,-24,31
Cowdenbeath,8506,10,5,10,21,26,55,-29,25
Montrose,8507,1,24,7,5,60,34,26,79
Peterhead,8507,2,24,4,8,81,38,43,76
Stenhousem'r,8507,3,16,8,12,60,47,13,56
Stirling,8507,4,16,6,14,61,56,5,54
Clyde,8507,5,14,10,12,52,49,3,52
Elgin,8507,6,14,6,16,53,61,-8,48
Annan Athlet,8507,7,11,12,13,48,42,6,45
Berwick,8507,8,8,11,17,30,59,-29,35
Edinburgh Ci,8507,9,7,9,20,36,64,-28,30
Cowdenbeath,8507,10,4,11,21,24,55,-31,23
Montrose,8508,1,24,7,5,62,35,27,79
Peterhead,8508,2,24,4,8,80,38,42,76
Stenhousem'r,8508,3,16,8,12,58,46,12,56
Stirling,8508,4,16,6,14,60,54,6,54
Clyde,8508,5,14,10,12,51,48,3,52
Elgin,8508,6,14,6,16,54,63,-9,48
Annan Athlet,8508,7,12,11,13,50,41,9,47
Berwick,8508,8,8,11,17,29,58,-29,35
Edinburgh Ci,8508,9,7,9,20,36,63,-27,30
Cowdenbeath,8508,10,4,10,22,23,57,-34,22
Peterhead,8509,1,24,4,8,81,39,42,76
Montrose,8509,2,23,7,6,61,37,24,76
Stirling,8509,3,16,7,13,61,52,9,55
Stenhousem'r,8509,4,15,9,12,56,47,9,54
Clyde,8509,5,15,9,12,53,48,5,54
Elgin,8509,6,15,6,15,56,62,-6,51
Annan Athlet,8509,7,11,12,13,48,42,6,45
Berwick,8509,8,8,10,18,29,60,-31,34
Edinburgh Ci,8509,9,7,9,20,37,64,-27,30
Cowdenbeath,8509,10,4,11,21,24,55,-31,23
Montrose,8510,1,23,8,5,59,34,25,77
Peterhead,8510,2,24,4,8,82,38,44,76
Stirling,8510,3,17,6,13,64,52,12,57
Clyde,8510,4,15,9,12,54,49,5,54
Stenhousem'r,8510,5,15,8,13,56,50,6,53
Elgin,8510,6,14,7,15,53,60,-7,49
Annan Athlet,8510,7,11,12,13,48,42,6,45
Berwick,8510,8,8,10,18,30,61,-31,34
Edinburgh Ci,8510,9,7,9,20,36,65,-29,30
Cowdenbeath,8510,10,4,11,21,24,55,-31,23
Montrose,8511,1,24,7,5,61,34,27,79
Peterhead,8511,2,24,4,8,80,38,42,76
Stenhousem'r,8511,3,16,8,12,58,46,12,56
Stirling,8511,4,16,6,14,60,54,6,54
Clyde,8511,5,15,9,12,54,48,6,54
Elgin,8511,6,14,6,16,53,62,-9,48
Annan Athlet,8511,7,11,11,14,48,43,5,44
Berwick,8511,8,8,10,18,29,61,-32,34
Edinburgh Ci,8511,9,7,9,20,36,63,-27,30
Cowdenbeath,8511,10,5,10,21,25,55,-30,25
Montrose,8512,1,23,8,5,59,34,25,77
Peterhead,8512,2,23,4,9,77,39,38,73
Stenhousem'r,8512,3,16,8,12,56,46,10,56
Stirling,8512,4,16,6,14,60,52,8,54
Clyde,8512,5,14,10,12,54,51,3,52
Elgin,8512,6,14,7,15,53,60,-7,49
Annan Athlet,8512,7,12,11,13,50,42,8,47
Berwick,8512,8,8,11,17,32,61,-29,35
Edinburgh Ci,8512,9,8,9,19,37,60,-23,33
Cowdenbeath,8512,10,4,10,22,24,57,-33,22
Montrose,8513,1,24,7,5,60,34,26,79
Peterhead,8513,2,24,4,8,80,39,41,76
Stirling,8513,3,17,6,13,63,52,11,57
Stenhousem'r,8513,4,15,8,13,56,49,7,53
Clyde,8513,5,14,10,12,51,48,3,52
Elgin,8513,6,14,6,16,53,61,-8,48
Annan Athlet,8513,7,11,12,13,48,42,6,45
Berwick,8513,8,8,11,17,29,58,-29,35
Edinburgh Ci,8513,9,7,9,20,37,63,-26,30
Cowdenbeath,8513,10,4,11,21,24,55,-31,23
Montrose,8514,1,23,8,5,60,35,25,77
Peterhead,8514,2,24,4,8,82,38,44,76
Stirling,8514,3,17,6,13,61,51,10,57
Stenhousem'r,8514,4,15,8,13,55,47,8,53
Clyde,8514,5,14,10,12,51,48,3,52
Elgin,8514,6,14,7,15,54,61,-7,49
Annan Athlet,8514,7,12,11,13,48,41,7,47
Berwick,8514,8,8,11,17,29,58,-29,35
Edinburgh Ci,8514,9,7,9,20,36,65,-29,30
Cowdenbeath,8514,10,4,10,22,23,55,-32,22
Montrose,8515,1,23,8,5,59,34,25,77
Peterhead,8515,2,24,4,8,82,38,44,76
Stenhousem'r,8515,3,16,8,12,56,46,10,56
Stirling,8515,4,16,6,14,60,52,8,54
Clyde,8515,5,14,9,13,52,51,1,51
Elgin,8515,6,14,7,15,53,60,-7,49
Annan Athlet,8515,7,12,11,13,48,41,7,47
Berwick,8515,8,9,10,17,32,59,-27,37
Edinburgh Ci,8515,9,7,9,20,36,65,-29,30
Cowdenbeath,8515,10,4,10,22,23,55,-32,22
Montrose,8516,1,24,7,5,62,35,27,79
Peterhead,8516,2,24,4,8,82,39,43,76
Stirling,8516,3,17,6,13,62,52,10,57
Clyde,8516,4,15,9,12,54,48,6,54
Stenhousem'r,8516,5,15,8,13,56,48,8,53
Elgin,8516,6,14,6,16,54,63,-9,48
Annan Athlet,8516,7,12,11,13,49,41,8,47
Berwick,8516,8,8,10,18,29,61,-32,34
Edinburgh Ci,8516,9,7,9,20,37,65,-28,30
Cowdenbeath,8516,10,4,10,22,23,56,-33,22
Montrose,8517,1,24,7,5,62,35,27,79
Peterhead,8517,2,24,4,8,81,38,43,76
Stenhousem'r,8517,3,16,8,12,57,47,10,56
Stirling,8517,4,16,6,14,61,53,8,54
Clyde,8517,5,15,9,12,54,48,6,54
Elgin,8517,6,14,6,16,54,63,-9,48
Annan Athlet,8517,7,12,11,13,49,42,7,47
Berwick,8517,8,8,10,18,29,61,-32,34
Edinburgh Ci,8517,9,7,9,20,36,64,-28,30
Cowdenbeath,8517,10,4,10,22,24,56,-32,22
Montrose,8518,1,24,7,5,61,34,27,79
Peterhead,8518,2,23,5,8,78,39,39,74
Stirling,8518,3,16,7,13,60,51,9,55
Stenhousem'r,8518,4,15,9,12,55,46,9,54
Clyde,8518,5,15,9,12,55,50,5,54
Elgin,8518,6,14,6,16,53,62,-9,48
Annan Athlet,8518,7,12,11,13,51,41,10,47
Berwick,8518,8,8,10,18,31,62,-31,34
Edinburgh Ci,8518,9,7,10,19,37,61,-24,31
Cowdenbeath,8518,10,4,10,22,23,58,-35,22
Montrose,8519,1,24,7,5,60,34,26,79
Peterhead,8519,2,23,4,9,78,42,36,73
Stirling,8519,3,17,6,13,64,52,12,57
Stenhousem'r,8519,4,15,8,13,56,50,6,53
Clyde,8519,5,14,10,12,51,48,3,52
Elgin,8519,6,14,6,16,53,61,-8,48
Annan Athlet,8519,7,11,12,13,49,43,6,45
Berwick,8519,8,8,11,17,29,58,-29,35
Edinburgh Ci,8519,9,8,9,19,40,61,-21,33
Cowdenbeath,8519,10,4,11,21,25,56,-31,23
Montrose,8520,1,24,7,5,63,35,28,79
Peterhead,8520,2,24,4,8,83,39,44,76
Stirling,8520,3,17,6,13,62,51,11,57
Stenhousem'r,8520,4,15,8,13,55,48,7,53
Clyde,8520,5,14,10,12,52,49,3,52
Elgin,8520,6,14,6,16,54,64,-10,48
Annan Athlet,8520,7,11,12,13,48,42,6,45
Berwick,8520,8,8,11,17,30,59,-29,35
Edinburgh Ci,8520,9,7,9,20,37,66,-29,30
Cowdenbeath,8520,10,4,11,21,24,55,-31,23
Peterhead,8521,1,24,4,8,81,41,40,76
Montrose,8521,2,23,7,6,61,37,24,76
Stenhousem'r,8521,3,16,8,12,59,46,13,56
Clyde,8521,4,15,9,12,55,49,6,54
Stirling,8521,5,16,6,14,60,55,5,54
Elgin,8521,6,15,6,15,56,62,-6,51
Annan Athlet,8521,7,11,11,14,47,43,4,44
Berwick,8521,8,8,10,18,30,62,-32,34
Edinburgh Ci,8521,9,7,9,20,39,64,-25,30
Cowdenbeath,8521,10,5,10,21,25,54,-29,25
Montrose,8522,1,24,7,5,63,35,28,79
Peterhead,8522,2,24,4,8,80,39,41,76
Stenhousem'r,8522,3,16,8,12,60,47,13,56
Stirling,8522,4,16,6,14,61,56,5,54
Clyde,8522,5,14,10,12,52,49,3,52
Elgin,8522,6,14,6,16,54,64,-10,48
Annan Athlet,8522,7,11,11,14,47,43,4,44
Berwick,8522,8,8,11,17,30,59,-29,35
Edinburgh Ci,8522,9,7,9,20,37,63,-26,30
Cowdenbeath,8522,10,5,10,21,25,54,-29,25
Montrose,8523,1,24,7,5,60,34,26,79
Peterhead,8523,2,23,5,8,78,39,39,74
Stirling,8523,3,16,7,13,62,53,9,55
Stenhousem'r,8523,4,15,9,12,57,48,9,54
Clyde,8523,5,15,9,12,55,49,6,54
Elgin,8523,6,14,6,16,53,61,-8,48
Annan Athlet,8523,7,11,11,14,49,45,4,44
Berwick,8523,8,8,10,18,30,62,-32,34
Edinburgh Ci,8523,9,7,10,19,37,61,-24,31
Cowdenbeath,8523,10,5,10,21,27,56,-29,25
Montrose,8524,1,23,8,5,60,35,25,77
Peterhead,8524,2,24,4,8,79,39,40,76
Stirling,8524,3,17,6,13,62,52,10,57
Clyde,8524,4,15,9,12,54,49,5,54
Stenhousem'r,8524,5,15,8,13,56,48,8,53
Elgin,8524,6,14,7,15,54,61,-7,49
Annan Athlet,8524,7,11,11,14,47,43,4,44
Berwick,8524,8,8,10,18,30,61,-31,34
Edinburgh Ci,8524,9,7,9,20,37,62,-25,30
Cowdenbeath,8524,10,5,10,21,25,54,-29,25
Montrose,8525,1,23,8,5,60,35,25,77
Peterhead,8525,2,24,4,8,80,39,41,76
Stirling,8525,3,16,7,13,62,53,9,55
Stenhousem'r,8525,4,15,9,12,57,48,9,54
Clyde,8525,5,14,9,13,52,50,2,51
Elgin,8525,6,14,7,15,54,61,-7,49
Annan Athlet,8525,7,12,11,13,50,41,9,47
Berwick,8525,8,9,10,17,31,59,-28,37
Edinburgh Ci,8525,9,7,9,20,37,63,-26,30
Cowdenbeath,8525,10,4,10,22,23,57,-34,22
Montrose,8526,1,23,8,5,62,37,25,77
Peterhead,8526,2,23,4,9,79,41,38,73
Stirling,8526,3,17,6,13,61,51,10,57
Stenhousem'r,8526,4,15,8,13,55,47,8,53
Clyde,8526,5,14,10,12,52,49,3,52
Elgin,8526,6,14,7,15,56,63,-7,49
Annan Athlet,8526,7,12,11,13,50,41,9,47
Berwick,8526,8,8,11,17,30,59,-29,35
Edinburgh Ci,8526,9,8,9,19,39,62,-23,33
Cowdenbeath,8526,10,4,10,22,23,57,-34,22
Montrose,8527,1,23,8,5,61,36,25,77
Peterhead,8527,2,24,4,8,81,40,41,76
Stirling,8527,3,16,7,13,61,52,9,55
Stenhousem'r,8527,4,15,9,12,56,47,9,54
Clyde,8527,5,15,9,12,53,48,5,54
Elgin,8527,6,14,7,15,55,62,-7,49
Annan Athlet,8527,7,11,12,13,48,42,6,45
Berwick,8527,8,8,10,18,29,60,-31,34
Edinburgh Ci,8527,9,7,9,20,38,64,-26,30
Cowdenbeath,8527,10,4,11,21,24,55,-31,23
Montrose,8528,1,23,8,5,61,36,25,77
Peterhead,8528,2,24,4,8,81,41,40,76
Stenhousem'r,8528,3,16,8,12,58,48,10,56
Stirling,8528,4,16,6,14,62,54,8,54
Clyde,8528,5,15,9,12,55,48,7,54
Elgin,8528,6,14,7,15,55,62,-7,49
Annan Athlet,8528,7,11,11,14,47,44,3,44
Berwick,8528,8,8,10,18,29,62,-33,34
Edinburgh Ci,8528,9,7,9,20,39,64,-25,30
Cowdenbeath,8528,10,5,10,21,26,54,-28,25
Montrose,8529,1,24,7,5,60,34,26,79
Peterhead,8529,2,24,4,8,80,38,42,76
Stirling,8529,3,17,6,13,61,51,10,57
Clyde,8529,4,15,9,12,55,49,6,54
Stenhousem'r,8529,5,15,8,13,55,47,8,53
Elgin,8529,6,14,6,16,53,61,-8,48
Annan Athlet,8529,7,11,11,14,48,46,2,44
Berwick,8529,8,8,10,18,30,62,-32,34
Edinburgh Ci,8529,9,7,9,20,36,63,-27,30
Cowdenbeath,8529,10,5,10,21,28,55,-27,25
Montrose,8530,1,23,8,5,60,35,25,77
Peterhead,8530,2,24,4,8,82,38,44,76
Stirling,8530,3,17,6,13,63,52,11,57
Clyde,8530,4,15,9,12,54,50,4,54
Stenhousem'r,8530,5,15,8,13,56,49,7,53
Elgin,8530,6,14,7,15,54,61,-7,49
Annan Athlet,8530,7,12,11,13,49,41,8,47
Berwick,8530,8,8,10,18,31,61,-30,34
Edinburgh Ci,8530,9,7,9,20,36,65,-29,30
Cowdenbeath,8530,10,4,10,22,23,56,-33,22
Peterhead,8531,1,24,4,8,81,38,43,76
Montrose,8531,2,23,7,6,59,35,24,76
Stenhousem'r,8531,3,16,8,12,60,47,13,56
Stirling,8531,4,16,6,14,61,56,5,54
Clyde,8531,5,15,9,12,53,49,4,54
Elgin,8531,6,15,6,15,54,60,-6,51
Annan Athlet,8531,7,12,11,13,50,43,7,47
Berwick,8531,8,8,10,18,30,60,-30,34
Edinburgh Ci,8531,9,7,9,20,36,64,-28,30
Cowdenbeath,8531,10,4,10,22,25,57,-32,22
Montrose,8532,1,24,7,5,62,36,26,79
Peterhead,8532,2,23,5,8,77,38,39,74
Stirling,8532,3,17,6,13,64,51,13,57
Stenhousem'r,8532,4,15,8,13,55,50,5,53
Clyde,8532,5,14,10,12,53,50,3,52
Elgin,8532,6,14,6,16,55,63,-8,48
Annan Athlet,8532,7,11,11,14,47,43,4,44
Berwick,8532,8,8,11,17,31,60,-29,35
Edinburgh Ci,8532,9,7,10,19,36,60,-24,31
Cowdenbeath,8532,10,5,10,21,25,54,-29,25
Montrose,8533,1,23,8,5,62,37,25,77
Peterhead,8533,2,24,4,8,81,38,43,76
Stirling,8533,3,17,6,13,62,51,11,57
Stenhousem'r,8533,4,15,8,13,55,48,7,53
Clyde,8533,5,14,9,13,52,50,2,51
Elgin,8533,6,14,7,15,56,63,-7,49
Annan Athlet,8533,7,11,12,13,48,42,6,45
Berwick,8533,8,9,10,17,31,59,-28,37
Edinburgh Ci,8533,9,7,9,20,36,64,-28,30
Cowdenbeath,8533,10,4,11,21,24,55,-31,23
Montrose,8534,1,24,7,5,62,34,28,79
Peterhead,8534,2,24,4,8,82,38,44,76
Stirling,8534,3,16,7,13,63,54,9,55
Stenhousem'r,8534,4,15,9,12,58,49,9,54
Clyde,8534,5,14,9,13,51,49,2,51
Elgin,8534,6,14,6,16,53,63,-10,48
Annan Athlet,8534,7,11,11,14,47,42,5,44
Berwick,8534,8,9,10,17,30,58,-28,37
Edinburgh Ci,8534,9,7,9,20,36,65,-29,30
Cowdenbeath,8534,10,5,10,21,24,54,-30,25
Montrose,8535,1,24,7,5,63,34,29,79
Peterhead,8535,2,24,4,8,79,39,40,76
Stenhousem'r,8535,3,16,8,12,57,47,10,56
Stirling,8535,4,16,6,14,61,53,8,54
Clyde,8535,5,15,9,12,54,49,5,54
Elgin,8535,6,14,6,16,53,64,-11,48
Annan Athlet,8535,7,12,11,13,48,41,7,47
Berwick,8535,8,8,10,18,30,61,-31,34
Edinburgh Ci,8535,9,7,9,20,37,62,-25,30
Cowdenbeath,8535,10,4,10,22,23,55,-32,22
Montrose,8536,1,24,7,5,63,34,29,79
Peterhead,8536,2,23,5,8,78,39,39,74
Stirling,8536,3,17,6,13,63,51,12,57
Clyde,8536,4,15,9,12,52,48,4,54
Stenhousem'r,8536,5,15,8,13,55,49,6,53
Elgin,8536,6,14,6,16,53,64,-11,48
Annan Athlet,8536,7,11,12,13,48,42,6,45
Berwick,8536,8,8,10,18,29,59,-30,34
Edinburgh Ci,8536,9,7,10,19,37,61,-24,31
Cowdenbeath,8536,10,4,11,21,24,55,-31,23
Montrose,8537,1,24,7,5,62,36,26,79
Peterhead,8537,2,23,4,9,78,41,37,73
Stenhousem'r,8537,3,16,8,12,56,46,10,56
Stirling,8537,4,16,6,14,60,52,8,54
Clyde,8537,5,14,9,13,52,50,2,51
Elgin,8537,6,14,6,16,55,63,-8,48
Annan Athlet,8537,7,11,11,14,49,44,5,44
Berwick,8537,8,9,10,17,31,59,-28,37
Edinburgh Ci,8537,9,8,9,19,39,61,-22,33
Cowdenbeath,8537,10,5,10,21,26,56,-30,25
Montrose,8538,1,24,7,5,64,34,30,79
Peterhead,8538,2,24,4,8,80,38,42,76
Stirling,8538,3,17,6,13,62,52,10,57
Clyde,8538,4,15,9,12,54,48,6,54
Stenhousem'r,8538,5,15,8,13,56,48,8,53
Elgin,8538,6,14,6,16,53,65,-12,48
Annan Athlet,8538,7,11,12,13,47,41,6,45
Berwick,8538,8,8,10,18,29,61,-32,34
Edinburgh Ci,8538,9,7,9,20,36,63,-27,30
Cowdenbeath,8538,10,4,11,21,23,54,-31,23
Montrose,8539,1,24,7,5,63,35,28,79
Peterhead,8539,2,24,4,8,83,39,44,76
Stirling,8539,3,17,6,13,62,52,10,57
Stenhousem'r,8539,4,15,8,13,56,48,8,53
Clyde,8539,5,14,9,13,52,51,1,51
Elgin,8539,6,14,6,16,54,64,-10,48
Annan Athlet,8539,7,12,11,13,49,42,7,47
Berwick,8539,8,9,10,17,32,59,-27,37
Edinburgh Ci,8539,9,7,9,20,37,66,-29,30
Cowdenbeath,8539,10,4,10,22,24,56,-32,22
Montrose,8540,1,23,8,5,60,35,25,77
Peterhead,8540,2,24,4,8,79,39,40,76
Stirling,8540,3,17,6,13,63,51,12,57
Clyde,8540,4,15,9,12,55,48,7,54
Stenhousem'r,8540,5,15,8,13,55,49,6,53
Elgin,8540,6,14,7,15,54,61,-7,49
Annan Athlet,8540,7,11,12,13,47,41,6,45
Berwick,8540,8,8,10,18,29,62,-33,34
Edinburgh Ci,8540,9,7,9,20,37,62,-25,30
Cowdenbeath,8540,10,4,11,21,23,54,-31,23
Montrose,8541,1,24,7,5,61,35,26,79
Peterhead,8541,2,24,4,8,78,38,40,76
Stirling,8541,3,16,7,13,62,53,9,55
Stenhousem'r,8541,4,15,9,12,57,48,9,54
Clyde,8541,5,14,10,12,52,49,3,52
Elgin,8541,6,14,6,16,54,62,-8,48
Annan Athlet,8541,7,11,12,13,47,41,6,45
Berwick,8541,8,8,11,17,30,59,-29,35
Edinburgh Ci,8541,9,7,9,20,36,61,-25,30
Cowdenbeath,8541,10,4,11,21,23,54,-31,23
Montrose,8542,1,24,7,5,61,34,27,79
Peterhead,8542,2,23,4,9,77,39,38,73
Stirling,8542,3,16,7,13,60,51,9,55
Stenhousem'r,8542,4,15,9,12,55,46,9,54
Clyde,8542,5,15,9,12,56,49,7,54
Elgin,8542,6,14,6,16,53,62,-9,48
Annan Athlet,8542,7,11,11,14,47,42,5,44
Berwick,8542,8,8,10,18,30,63,-33,34
Edinburgh Ci,8542,9,8,9,19,37,60,-23,33
Cowdenbeath,8542,10,5,10,21,24,54,-30,25
Montrose,8543,1,24,7,5,61,35,26,79
Peterhead,8543,2,24,4,8,79,38,41,76
Stirling,8543,3,16,7,13,63,54,9,55
Stenhousem'r,8543,4,15,9,12,58,49,9,54
Clyde,8543,5,14,10,12,52,49,3,52
Elgin,8543,6,14,6,16,54,62,-8,48
Annan Athlet,8543,7,11,11,14,47,42,5,44
Berwick,8543,8,8,11,17,30,59,-29,35
Edinburgh Ci,8543,9,7,9,20,36,62,-26,30
Cowdenbeath,8543,10,5,10,21,24,54,-30,25
Montrose,8544,1,24,7,5,61,35,26,79
Peterhead,8544,2,24,4,8,80,38,42,76
Stirling,8544,3,17,6,13,61,51,10,57
Clyde,8544,4,15,9,12,52,48,4,54
Stenhousem'r,8544,5,15,8,13,55,47,8,53
Elgin,8544,6,14,6,16,54,62,-8,48
Annan Athlet,8544,7,12,11,13,49,42,7,47
Berwick,8544,8,8,10,18,29,59,-30,34
Edinburgh Ci,8544,9,7,9,20,36,63,-27,30
Cowdenbeath,8544,10,4,10,22,24,56,-32,22
Montrose,8545,1,24,7,5,62,34,28,79
Peterhead,8545,2,24,4,8,79,39,40,76
Stirling,8545,3,17,6,13,62,52,10,57
Clyde,8545,4,15,9,12,56,49,7,54
Stenhousem'r,8545,5,15,8,13,56,48,8,53
Elgin,8545,6,14,6,16,53,63,-10,48
Annan Athlet,8545,7,11,11,14,47,42,5,44
Berwick,8545,8,8,10,18,30,63,-33,34
Edinburgh Ci,8545,9,7,9,20,37,62,-25,30
Cowdenbeath,8545,10,5,10,21,24,54,-30,25
Montrose,8546,1,24,7,5,62,34,28,79
Peterhead,8546,2,24,4,8,83,38,45,76
Stirling,8546,3,17,6,13,62,51,11,57
Clyde,8546,4,15,9,12,52,48,4,54
Stenhousem'r,8546,5,15,8,13,55,48,7,53
Elgin,8546,6,14,6,16,53,63,-10,48
Annan Athlet,8546,7,12,11,13,48,41,7,47
Berwick,8546,8,8,10,18,29,59,-30,34
Edinburgh Ci,8546,9,7,9,20,36,66,-30,30
Cowdenbeath,8546,10,4,10,22,23,55,-32,22
Peterhead,8547,1,24,4,8,79,39,40,76
Montrose,8547,2,23,7,6,59,38,21,76
Stirling,8547,3,17,6,13,61,51,10,57
Stenhousem'r,8547,4,15,8,13,55,47,8,53
Clyde,8547,5,14,9,13,52,50,2,51
Elgin,8547,6,15,6,15,57,60,-3,51
Annan Athlet,8547,7,11,12,13,49,43,6,45
Berwick,8547,8,9,10,17,31,59,-28,37
Edinburgh Ci,8547,9,7,9,20,37,62,-25,30
Cowdenbeath,8547,10,4,11,21,25,56,-31,23
Montrose,8548,1,23,8,5,60,35,25,77
Peterhead,8548,2,23,5,8,78,39,39,74
Stirling,8548,3,16,7,13,60,51,9,55
Stenhousem'r,8548,4,15,9,12,55,46,9,54
Clyde,8548,5,15,9,12,53,49,4,54
Elgin,8548,6,14,7,15,54,61,-7,49
Annan Athlet,8548,7,11,11,14,48,44,4,44
Berwick,8548,8,8,10,18,30,60,-30,34
Edinburgh Ci,8548,9,7,10,19,37,61,-24,31
Cowdenbeath,8548,10,5,10,21,26,55,-29,25
Montrose,8549,1,23,8,5,60,35,25,77
Peterhead,8549,2,24,4,8,79,38,41,76
Stirling,8549,3,17,6,13,61,51,10,57
Clyde,8549,4,15,9,12,54,48,6,54
Stenhousem'r,8549,5,15,8,13,55,47,8,53
Elgin,8549,6,14,7,15,54,61,-7,49
Annan Athlet,8549,7,12,11,13,50,42,8,47
Berwick,8549,8,8,10,18,29,61,-32,34
Edinburgh Ci,8549,9,7,9,20,36,62,-26,30
Cowdenbeath,8549,10,4,10,22,24,57,-33,22
Montrose,8550,1,24,7,5,61,35,26,79
Peterhead,8550,2,24,4,8,79,38,41,76
Stenhousem'r,8550,3,16,8,12,57,47,10,56
Stirling,8550,4,16,6,14,61,53,8,54
Clyde,8550,5,15,9,12,54,48,6,54
Elgin,8550,6,14,6,16,54,62,-8,48
Annan Athlet,8550,7,12,11,13,48,41,7,47
Berwick,8550,8,8,10,18,29,61,-32,34
Edinburgh Ci,8550,9,7,9,20,36,62,-26,30
Cowdenbeath,8550,10,4,10,22,23,55,-32,22
Montrose,8551,1,24,7,5,61,34,27,79
Peterhead,8551,2,24,4,8,80,40,40,76
Stenhousem'r,8551,3,16,8,12,58,47,11,56
Stirling,8551,4,16,6,14,61,54,7,54
Clyde,8551,5,14,9,13,52,51,1,51
Elgin,8551,6,14,6,16,53,62,-9,48
Annan Athlet,8551,7,12,11,13,50,42,8,47
Berwick,8551,8,9,10,17,32,59,-27,37
Edinburgh Ci,8551,9,7,9,20,38,63,-25,30
Cowdenbeath,8551,10,4,10,22,24,57,-33,22
Montrose,8552,1,24,7,5,62,35,27,79
Peterhead,8552,2,24,4,8,80,38,42,76
Stirling,8552,3,17,6,13,65,54,11,57
Clyde,8552,4,15,9,12,53,49,4,54
Stenhousem'r,8552,5,15,8,13,58,51,7,53
Elgin,8552,6,14,6,16,54,63,-9,48
Annan Athlet,8552,7,11,12,13,48,42,6,45
Berwick,8552,8,8,10,18,30,60,-30,34
Edinburgh Ci,8552,9,7,9,20,36,63,-27,30
Cowdenbeath,8552,10,4,11,21,24,55,-31,23
Montrose,8553,1,24,7,5,61,35,26,79
Peterhead,8553,2,24,4,8,78,38,40,76
Stenhousem'r,8553,3,16,8,12,57,47,10,56
Stirling,8553,4,16,6,14,61,53,8,54
Clyde,8553,5,15,9,12,52,48,4,54
Elgin,8553,6,14,6,16,54,62,-8,48
Annan Athlet,8553,7,11,12,13,47,41,6,45
Berwick,8553,8,8,10,18,29,59,-30,34
Edinburgh Ci,8553,9,7,9,20,36,61,-25,30
Cowdenbeath,8553,10,4,11,21,23,54,-31,23
Montrose,8554,1,24,7,5,63,35,28,79
Peterhead,8554,2,24,4,8,79,38,41,76
Stenhousem'r,8554,3,16,8,12,57,47,10,56
Stirling,8554,4,16,6,14,61,53,8,54
Clyde,8554,5,14,10,12,53,50,3,52
Elgin,8554,6,14,6,16,54,64,-10,48
Annan Athlet,8554,7,11,12,13,48,42,6,45
Berwick,8554,8,8,11,17,31,60,-29,35
Edinburgh Ci,8554,9,7,9,20,36,62,-26,30
Cowdenbeath,8554,10,4,11,21,24,55,-31,23
Montrose,8555,1,24,7,5,61,35,26,79
Peterhead,8555,2,24,4,8,82,40,42,76
Stirling,8555,3,17,6,13,62,52,10,57
Clyde,8555,4,15,9,12,52,48,4,54
Stenhousem'r,8555,5,15,8,13,56,48,8,53
Elgin,8555,6,14,6,16,54,62,-8,48
Annan Athlet,8555,7,11,12,13,48,42,6,45
Berwick,8555,8,8,10,18,29,59,-30,34
Edinburgh Ci,8555,9,7,9,20,38,65,-27,30
Cowdenbeath,8555,10,4,11,21,24,55,-31,23
Montrose,8556,1,24,7,5,63,34,29,79
Peterhead,8556,2,23,5,8,78,39,39,74
Stirling,8556,3,17,6,13,63,51,12,57
Clyde,8556,4,15,9,12,53,49,4,54
Stenhousem'r,8556,5,15,8,13,55,49,6,53
Elgin,8556,6,14,6,16,53,64,-11,48
Annan Athlet,8556,7,12,11,13,48,41,7,47
Berwick,8556,8,8,10,18,30,60,-30,34
Edinburgh Ci,8556,9,7,10,19,37,61,-24,31
Cowdenbeath,8556,10,4,10,22,23,55,-32,22
Montrose,8557,1,23,7,6,59,35,24,76
Peterhead,8557,2,23,5,8,77,38,39,74
Stenhousem'r,8557,3,16,8,12,57,47,10,56
Stirling,8557,4,16,6,14,61,53,8,54
Clyde,8557,5,15,9,12,52,48,4,54
Elgin,8557,6,15,6,15,54,60,-6,51
Annan Athlet,8557,7,11,11,14,48,43,5,44
Berwick,8557,8,8,10,18,29,59,-30,34
Edinburgh Ci,8557,9,7,10,19,36,60,-24,31
Cowdenbeath,8557,10,5,10,21,25,55,-30,25
Peterhead,8558,1,24,4,8,80,38,42,76
Montrose,8558,2,23,7,6,60,36,24,76
Stirling,8558,3,17,6,13,61,51,10,57
Clyde,8558,4,15,9,12,55,48,7,54
Stenhousem'r,8558,5,15,8,13,55,47,8,53
Elgin,8558,6,15,6,15,55,61,-6,51
Annan Athlet,8558,7,11,11,14,47,42,5,44
Berwick,8558,8,8,10,18,29,62,-33,34
Edinburgh Ci,8558,9,7,9,20,36,63,-27,30
Cowdenbeath,8558,10,5,10,21,24,54,-30,25
Montrose,8559,1,24,7,5,66,35,31,79
Peterhead,8559,2,24,4,8,81,38,43,76
Stirling,8559,3,17,6,13,62,52,10,57
Stenhousem'r,8559,4,15,8,13,56,48,8,53
Clyde,8559,5,14,10,12,51,48,3,52
Elgin,8559,6,14,6,16,54,67,-13,48
Annan Athlet,8559,7,11,12,13,48,42,6,45
Berwick,8559,8,8,11,17,29,58,-29,35
Edinburgh Ci,8559,9,7,9,20,36,64,-28,30
Cowdenbeath,8559,10,4,11,21,24,55,-31,23
Montrose,8560,1,24,7,5,62,34,28,79
Peterhead,8560,2,24,4,8,79,39,40,76
Stenhousem'r,8560,3,16,8,12,59,49,10,56
Stirling,8560,4,16,6,14,63,55,8,54
Clyde,8560,5,15,9,12,53,49,4,54
Elgin,8560,6,14,6,16,53,63,-10,48
Annan Athlet,8560,7,11,11,14,47,42,5,44
Berwick,8560,8,8,10,18,30,60,-30,34
Edinburgh Ci,8560,9,7,9,20,37,62,-25,30
Cowdenbeath,8560,10,5,10,21,24,54,-30,25
Peterhead,8561,1,24,4,8,81,38,43,76
Montrose,8561,2,23,7,6,60,39,21,76
Stirling,8561,3,16,7,13,61,52,9,55
Stenhousem'r,8561,4,15,9,12,56,47,9,54
Clyde,8561,5,15,9,12,53,48,5,54
Elgin,8561,6,15,6,15,58,61,-3,51
Annan Athlet,8561,7,12,11,13,48,41,7,47
Berwick,8561,8,8,10,18,29,60,-31,34
Edinburgh Ci,8561,9,7,9,20,36,64,-28,30
Cowdenbeath,8561,10,4,10,22,23,55,-32,22
Montrose,8562,1,23,8,5,61,36,25,77
Peterhead,8562,2,23,4,9,77,39,38,73
Stirling,8562,3,16,7,13,61,52,9,55
Stenhousem'r,8562,4,15,9,12,56,47,9,54
Clyde,8562,5,14,10,12,52,49,3,52
Elgin,8562,6,14,7,15,55,62,-7,49
Annan Athlet,8562,7,11,11,14,47,42,5,44
Berwick,8562,8,8,11,17,30,59,-29,35
Edinburgh Ci,8562,9,8,9,19,37,60,-23,33
Cowdenbeath,8562,10,5,10,21,24,54,-30,25
Montrose,8563,1,24,7,5,60,34,26,79
Peterhead,8563,2,24,4,8,80,39,41,76
Stenhousem'r,8563,3,16,8,12,58,48,10,56
Stirling,8563,4,16,6,14,62,54,8,54
Clyde,8563,5,14,10,12,53,50,3,52
Elgin,8563,6,14,6,16,53,61,-8,48
Annan Athlet,8563,7,11,11,14,48,43,5,44
Berwick,8563,8,8,11,17,31,60,-29,35
Edinburgh Ci,8563,9,7,9,20,37,63,-26,30
Cowdenbeath,8563,10,5,10,21,25,55,-30,25
Montrose,8564,1,24,7,5,62,35,27,79
Peterhead,8564,2,24,4,8,78,38,40,76
Stirling,8564,3,17,6,13,63,52,11,57
Clyde,8564,4,15,9,12,52,48,4,54
Stenhousem'r,8564,5,15,8,13,56,49,7,53
Elgin,8564,6,14,6,16,54,63,-9,48
Annan Athlet,8564,7,12,11,13,49,41,8,47
Berwick,8564,8,8,10,18,29,59,-30,34
Edinburgh Ci,8564,9,7,9,20,36,61,-25,30
Cowdenbeath,8564,10,4,10,22,23,56,-33,22
Montrose,8565,1,24,7,5,60,34,26,79
Peterhead,8565,2,24,4,8,78,38,40,76
Stirling,8565,3,17,6,13,61,51,10,57
Clyde,8565,4,15,9,12,53,49,4,54
Stenhousem'r,8565,5,15,8,13,55,47,8,53
Elgin,8565,6,14,6,16,53,61,-8,48
Annan Athlet,8565,7,12,11,13,49,42,7,47
Berwick,8565,8,8,10,18,30,60,-30,34
Edinburgh Ci,8565,9,7,9,20,36,61,-25,30
Cowdenbeath,8565,10,4,10,22,24,56,-32,22
Montrose,8566,1,24,7,5,62,34,28,79
Peterhead,8566,2,23,4,9,79,43,36,73
Stirling,8566,3,17,6,13,64,52,12,57
Stenhousem'r,8566,4,15,8,13,56,50,6,53
Clyde,8566,5,14,10,12,52,49,3,52
Elgin,8566,6,14,6,16,53,63,-10,48
Annan Athlet,8566,7,11,12,13,47,41,6,45
Berwick,8566,8,8,11,17,30,59,-29,35
Edinburgh Ci,8566,9,8,9,19,41,62,-21,33
Cowdenbeath,8566,10,4,11,21,23,54,-31,23
Montrose,8567,1,24,7,5,62,34,28,79
Peterhead,8567,2,24,4,8,83,39,44,76
Stirling,8567,3,17,6,13,63,53,10,57
Stenhousem'r,8567,4,15,8,13,57,49,8,53
Clyde,8567,5,14,10,12,52,49,3,52
Elgin,8567,6,14,6,16,53,63,-10,48
Annan Athlet,8567,7,11,12,13,49,43,6,45
Berwick,8567,8,8,11,17,30,59,-29,35
Edinburgh Ci,8567,9,7,9,20,37,66,-29,30
Cowdenbeath,8567,10,4,11,21,25,56,-31,23
Montrose,8568,1,24,7,5,63,36,27,79
Peterhead,8568,2,23,5,8,78,39,39,74
Stirling,8568,3,16,7,13,61,52,9,55
Stenhousem'r,8568,4,15,9,12,56,47,9,54
Clyde,8568,5,14,9,13,51,50,1,51
Elgin,8568,6,14,6,16,55,64,-9,48
Annan Athlet,8568,7,11,12,13,47,41,6,45
Berwick,8568,8,9,10,17,31,58,-27,37
Edinburgh Ci,8568,9,7,10,19,37,61,-24,31
Cowdenbeath,8568,10,4,11,21,23,54,-31,23
Montrose,8569,1,23,8,5,59,34,25,77
Peterhead,8569,2,24,4,8,79,38,41,76
Stenhousem'r,8569,3,16,8,12,57,46,11,56
Stirling,8569,4,16,6,14,60,53,7,54
Clyde,8569,5,14,10,12,52,49,3,52
Elgin,8569,6,14,7,15,53,60,-7,49
Annan Athlet,8569,7,12,11,13,49,41,8,47
Berwick,8569,8,8,11,17,30,59,-29,35
Edinburgh Ci,8569,9,7,9,20,36,62,-26,30
Cowdenbeath,8569,10,4,10,22,23,56,-33,22
Montrose,8570,1,24,7,5,61,34,27,79
Peterhead,8570,2,24,4,8,80,39,41,76
Stirling,8570,3,16,7,13,61,52,9,55
Stenhousem'r,8570,4,15,9,12,56,47,9,54
Clyde,8570,5,15,9,12,52,48,4,54
Elgin,8570,6,14,6,16,53,62,-9,48
Annan Athlet,8570,7,11,11,14,47,42,5,44
Berwick,8570,8,8,10,18,29,59,-30,34
Edinburgh Ci,8570,9,7,9,20,37,63,-26,30
Cowdenbeath,8570,10,5,10,21,24,54,-30,25
Montrose,8571,1,24,7,5,61,34,27,79
Peterhead,8571,2,24,4,8,80,38,42,76
Stirling,8571,3,17,6,13,62,52,10,57
Stenhousem'r,8571,4,15,8,13,56,48,8,53
Clyde,8571,5,14,10,12,54,51,3,52
Elgin,8571,6,14,6,16,53,62,-9,48
Annan Athlet,8571,7,11,12,13,48,42,6,45
Berwick,8571,8,8,11,17,32,61,-29,35
Edinburgh Ci,8571,9,7,9,20,36,63,-27,30
Cowdenbeath,8571,10,4,11,21,24,55,-31,23
Montrose,8572,1,23,8,5,59,34,25,77
Peterhead,8572,2,23,4,9,77,39,38,73
Stirling,8572,3,17,6,13,64,53,11,57
Stenhousem'r,8572,4,15,8,13,57,50,7,53
Clyde,8572,5,14,9,13,52,51,1,51
Elgin,8572,6,14,7,15,53,60,-7,49
Annan Athlet,8572,7,11,11,14,47,42,5,44
Berwick,8572,8,9,10,17,32,59,-27,37
Edinburgh Ci,8572,9,8,9,19,37,60,-23,33
Cowdenbeath,8572,10,5,10,21,24,54,-30,25
Montrose,8573,1,23,8,5,61,36,25,77
Peterhead,8573,2,24,4,8,81,41,40,76
Stirling,8573,3,17,6,13,63,52,11,57
Clyde,8573,4,15,9,12,53,48,5,54
Stenhousem'r,8573,5,15,8,13,56,49,7,53
Elgin,8573,6,14,7,15,55,62,-7,49
Annan Athlet,8573,7,11,11,14,48,43,5,44
Berwick,8573,8,8,10,18,29,60,-31,34
Edinburgh Ci,8573,9,7,9,20,39,64,-25,30
Cowdenbeath,8573,10,5,10,21,25,55,-30,25
Montrose,8574,1,23,8,5,59,34,25,77
Peterhead,8574,2,24,4,8,82,39,43,76
Stirling,8574,3,16,7,13,60,51,9,55
Stenhousem'r,8574,4,15,9,12,55,46,9,54
Clyde,8574,5,14,9,13,51,50,1,51
Elgin,8574,6,14,7,15,53,60,-7,49
Annan Athlet,8574,7,11,12,13,47,41,6,45
Berwick,8574,8,9,10,17,31,58,-27,37
Edinburgh Ci,8574,9,7,9,20,37,65,-28,30
Cowdenbeath,8574,10,4,11,21,23,54,-31,23
Montrose,8575,1,24,7,5,60,34,26,79
Peterhead,8575,2,23,5,8,79,40,39,74
Stirling,8575,3,16,7,13,62,53,9,55
Stenhousem'r,8575,4,15,9,12,57,48,9,54
Clyde,8575,5,15,9,12,54,49,5,54
Elgin,8575,6,14,6,16,53,61,-8,48
Annan Athlet,8575,7,11,11,14,47,42,5,44
Berwick,8575,8,8,10,18,30,61,-31,34
Edinburgh Ci,8575,9,7,10,19,38,62,-24,31
Cowdenbeath,8575,10,5,10,21,24,54,-30,25
Montrose,8576,1,24,7,5,63,35,28,79
Peterhead,8576,2,24,4,8,82,39,43,76
Stirling,8576,3,17,6,13,63,52,11,57
Stenhousem'r,8576,4,15,8,13,56,49,7,53
Clyde,8576,5,14,10,12,53,50,3,52
Elgin,8576,6,14,6,16,54,64,-10,48
Annan Athlet,8576,7,12,11,13,49,41,8,47
Berwick,8576,8,8,11,17,31,60,-29,35
Edinburgh Ci,8576,9,7,9,20,37,65,-28,30
Cowdenbeath,8576,10,4,10,22,23,56,-33,22
Montrose,8577,1,24,7,5,64,36,28,79
Peterhead,8577,2,23,4,9,79,42,37,73
Stirling,8577,3,17,6,13,62,51,11,57
Clyde,8577,4,15,9,12,54,48,6,54
Stenhousem'r,8577,5,15,8,13,55,48,7,53
Elgin,8577,6,14,6,16,55,65,-10,48
Annan Athlet,8577,7,11,12,13,50,44,6,45
Berwick,8577,8,8,10,18,29,61,-32,34
Edinburgh Ci,8577,9,8,9,19,40,62,-22,33
Cowdenbeath,8577,10,4,11,21,26,57,-31,23
Montrose,8578,1,24,7,5,61,35,26,79
Peterhead,8578,2,24,4,8,82,40,42,76
Stirling,8578,3,16,7,13,62,53,9,55
Stenhousem'r,8578,4,15,9,12,57,48,9,54
Clyde,8578,5,15,9,12,53,49,4,54
Elgin,8578,6,14,6,16,54,62,-8,48
Annan Athlet,8578,7,11,11,14,47,42,5,44
Berwick,8578,8,8,10,18,30,60,-30,34
Edinburgh Ci,8578,9,7,9,20,38,65,-27,30
Cowdenbeath,8578,10,5,10,21,24,54,-30,25
Montrose,8579,1,24,7,5,62,35,27,79
Peterhead,8579,2,24,4,8,79,38,41,76
Stirling,8579,3,16,7,13,63,54,9,55
Stenhousem'r,8579,4,15,9,12,58,49,9,54
Clyde,8579,5,15,9,12,54,49,5,54
Elgin,8579,6,14,6,16,54,63,-9,48
Annan Athlet,8579,7,11,12,13,47,41,6,45
Berwick,8579,8,8,10,18,30,61,-31,34
Edinburgh Ci,8579,9,7,9,20,36,62,-26,30
Cowdenbeath,8579,10,4,11,21,23,54,-31,23
Montrose,8580,1,24,7,5,60,34,26,79
Peterhead,8580,2,24,4,8,81,39,42,76
Stirling,8580,3,17,6,13,61,51,10,57
Stenhousem'r,8580,4,15,8,13,55,47,8,53
Clyde,8580,5,14,10,12,52,49,3,52
Elgin,8580,6,14,6,16,53,61,-8,48
Annan Athlet,8580,7,11,11,14,47,42,5,44
Berwick,8580,8,8,11,17,30,59,-29,35
Edinburgh Ci,8580,9,7,9,20,37,64,-27,30
Cowdenbeath,8580,10,5,10,21,24,54,-30,25
Peterhead,8581,1,24,4,8,78,38,40,76
Montrose,8581,2,23,7,6,59,37,22,76
Stirling,8581,3,17,6,13,64,52,12,57
Stenhousem'r,8581,4,15,8,13,56,50,6,53
Clyde,8581,5,14,10,12,52,49,3,52
Elgin,8581,6,15,6,15,56,60,-4,51
Annan Athlet,8581,7,12,11,13,50,42,8,47
Berwick,8581,8,8,11,17,30,59,-29,35
Edinburgh Ci,8581,9,7,9,20,36,61,-25,30
Cowdenbeath,8581,10,4,10,22,24,57,-33,22
Montrose,8582,1,23,7,6,59,36,23,76
Peterhead,8582,2,23,4,9,77,39,38,73
Stirling,8582,3,17,6,13,62,52,10,57
Stenhousem'r,8582,4,15,8,13,56,48,8,53
Clyde,8582,5,14,10,12,52,49,3,52
Elgin,8582,6,15,6,15,55,60,-5,51
Annan Athlet,8582,7,12,11,13,49,42,7,47
Berwick,8582,8,8,11,17,30,59,-29,35
Edinburgh Ci,8582,9,8,9,19,37,60,-23,33
Cowdenbeath,8582,10,4,10,22,24,56,-32,22
Montrose,8583,1,24,7,5,62,36,26,79
Peterhead,8583,2,24,4,8,81,38,43,76
Stenhousem'r,8583,3,16,8,12,57,47,10,56
Stirling,8583,4,16,6,14,61,53,8,54
Clyde,8583,5,15,9,12,54,50,4,54
Elgin,8583,6,14,6,16,55,63,-8,48
Annan Athlet,8583,7,12,11,13,51,41,10,47
Berwick,8583,8,8,10,18,31,61,-30,34
Edinburgh Ci,8583,9,7,9,20,36,64,-28,30
Cowdenbeath,8583,10,4,10,22,23,58,-35,22
Montrose,8584,1,23,8,5,60,35,25,77
Peterhead,8584,2,24,4,8,81,40,41,76
Stirling,8584,3,17,6,13,62,52,10,57
Clyde,8584,4,15,9,12,54,49,5,54
Stenhousem'r,8584,5,15,8,13,56,48,8,53
Elgin,8584,6,14,7,15,54,61,-7,49
Annan Athlet,8584,7,12,11,13,49,41,8,47
Berwick,8584,8,8,10,18,30,61,-31,34
Edinburgh Ci,8584,9,7,9,20,38,64,-26,30
Cowdenbeath,8584,10,4,10,22,23,56,-33,22
Montrose,8585,1,23,7,6,60,37,23,76
Peterhead,8585,2,23,4,9,78,40,38,73
Stirling,8585,3,17,6,13,63,52,11,57
Clyde,8585,4,15,9,12,52,48,4,54
Stenhousem'r,8585,5,15,8,13,56,49,7,53
Elgin,8585,6,15,6,15,56,61,-5,51
Annan Athlet,8585,7,12,11,13,48,41,7,47
Berwick,8585,8,8,10,18,29,59,-30,34
Edinburgh Ci,8585,9,8,9,19,38,61,-23,33
Cowdenbeath,8585,10,4,10,22,23,55,-32,22
Montrose,8586,1,24,7,5,63,34,29,79
Peterhead,8586,2,24,4,8,80,39,41,76
Stirling,8586,3,17,6,13,63,52,11,57
Clyde,8586,4,15,9,12,53,48,5,54
Stenhousem'r,8586,5,15,8,13,56,49,7,53
Elgin,8586,6,14,6,16,53,64,-11,48
Annan Athlet,8586,7,12,11,13,48,41,7,47
Berwick,8586,8,8,10,18,29,60,-31,34
Edinburgh Ci,8586,9,7,9,20,37,63,-26,30
Cowdenbeath,8586,10,4,10,22,23,55,-32,22
Montrose,8587,1,24,7,5,62,35,27,79
Peterhead,8587,2,24,4,8,78,38,40,76
Stenhousem'r,8587,3,16,8,12,58,48,10,56
Stirling,8587,4,16,6,14,62,54,8,54
Clyde,8587,5,15,9,12,53,48,5,54
Elgin,8587,6,14,6,16,54,63,-9,48
Annan Athlet,8587,7,11,12,13,48,42,6,45
Berwick,8587,8,8,10,18,29,60,-31,34
Edinburgh Ci,8587,9,7,9,20,36,61,-25,30
Cowdenbeath,8587,10,4,11,21,24,55,-31,23
Montrose,8588,1,23,8,5,60,35,25,77
Peterhead,8588,2,24,4,8,81,39,42,76
Stirling,8588,3,17,6,13,64,51,13,57
Clyde,8588,4,15,9,12,52,48,4,54
Stenhousem'r,8588,5,15,8,13,55,50,5,53
Elgin,8588,6,14,7,15,54,61,-7,49
Annan Athlet,8588,7,11,11,14,47,42,5,44
Berwick,8588,8,8,10,18,29,59,-30,34
Edinburgh Ci,8588,9,7,9,20,37,64,-27,30
Cowdenbeath,8588,10,5,10,21,24,54,-30,25
Montrose,8589,1,24,7,5,62,34,28,79
Peterhead,8589,2,23,5,8,78,39,39,74
Stirling,8589,3,16,7,13,61,52,9,55
Stenhousem'r,8589,4,15,9,12,56,47,9,54
Clyde,8589,5,14,10,12,52,49,3,52
Elgin,8589,6,14,6,16,53,63,-10,48
Annan Athlet,8589,7,12,11,13,51,43,8,47
Berwick,8589,8,8,11,17,30,59,-29,35
Edinburgh Ci,8589,9,7,10,19,37,61,-24,31
Cowdenbeath,8589,10,4,10,22,25,58,-33,22
Montrose,8590,1,24,7,5,62,34,28,79
Peterhead,8590,2,24,4,8,78,38,40,76
Stirling,8590,3,17,6,13,63,53,10,57
Clyde,8590,4,15,9,12,52,48,4,54
Stenhousem'r,8590,5,15,8,13,57,49,8,53
Elgin,8590,6,14,6,16,53,63,-10,48
Annan Athlet,8590,7,11,11,14,47,43,4,44
Berwick,8590,8,8,10,18,29,59,-30,34
Edinburgh Ci,8590,9,7,9,20,36,61,-25,30
Cowdenbeath,8590,10,5,10,21,25,54,-29,25
Montrose,8591,1,24,7,5,62,34,28,79
Peterhead,8591,2,23,5,8,80,41,39,74
Stirling,8591,3,16,7,13,61,52,9,55
Stenhousem'r,8591,4,15,9,12,56,47,9,54
Clyde,8591,5,15,9,12,55,49,6,54
Elgin,8591,6,14,6,16,53,63,-10,48
Annan Athlet,8591,7,11,11,14,48,45,3,44
Berwick,8591,8,8,10,18,30,62,-32,34
Edinburgh Ci,8591,9,7,10,19,39,63,-24,31
Cowdenbeath,8591,10,5,10,21,27,55,-28,25
Montrose,8592,1,23,8,5,59,34,25,77
Peterhead,8592,2,23,5,8,79,40,39,74
Stenhousem'r,8592,3,16,8,12,57,47,10,56
Stirling,8592,4,16,6,14,61,53,8,54
Clyde,8592,5,15,9,12,56,48,8,54
Elgin,8592,6,14,7,15,53,60,-7,49
Annan Athlet,8592,7,12,11,13,50,41,9,47
Berwick,8592,8,8,10,18,29,63,-34,34
Edinburgh Ci,8592,9,7,10,19,38,62,-24,31
Cowdenbeath,8592,10,4,10,22,23,57,-34,22
Montrose,8593,1,23,8,5,60,35,25,77
Peterhead,8593,2,24,4,8,78,38,40,76
Stirling,8593,3,17,6,13,63,53,10,57
Stenhousem'r,8593,4,15,8,13,57,49,8,53
Clyde,8593,5,14,10,12,51,48,3,52
Elgin,8593,6,14,7,15,54,61,-7,49
Annan Athlet,8593,7,11,12,13,47,41,6,45
Berwick,8593,8,8,11,17,29,58,-29,35
Edinburgh Ci,8593,9,7,9,20,36,61,-25,30
Cowdenbeath,8593,10,4,11,21,23,54,-31,23
Montrose,8594,1,24,7,5,61,35,26,79
Peterhead,8594,2,23,4,9,77,39,38,73
Stirling,8594,3,17,6,13,64,54,10,57
Clyde,8594,4,15,9,12,55,49,6,54
Stenhousem'r,8594,5,15,8,13,58,50,8,53
Elgin,8594,6,14,6,16,54,62,-8,48
Annan Athlet,8594,7,12,11,13,48,41,7,47
Berwick,8594,8,8,10,18,30,62,-32,34
Edinburgh Ci,8594,9,8,9,19,37,60,-23,33
Cowdenbeath,8594,10,4,10,22,23,55,-32,22
Montrose,8595,1,23,8,5,59,34,25,77
Peterhead,8595,2,24,4,8,79,38,41,76
Stenhousem'r,8595,3,16,8,12,60,48,12,56
Stirling,8595,4,16,6,14,62,56,6,54
Clyde,8595,5,14,9,13,52,50,2,51
Elgin,8595,6,14,7,15,53,60,-7,49
Annan Athlet,8595,7,11,11,14,47,42,5,44
Berwick,8595,8,9,10,17,31,59,-28,37
Edinburgh Ci,8595,9,7,9,20,36,62,-26,30
Cowdenbeath,8595,10,5,10,21,24,54,-30,25
Montrose,8596,1,24,7,5,60,34,26,79
Peterhead,8596,2,24,4,8,81,38,43,76
Stirling,8596,3,17,6,13,63,52,11,57
Clyde,8596,4,15,9,12,52,48,4,54
Stenhousem'r,8596,5,15,8,13,56,49,7,53
Elgin,8596,6,14,6,16,53,61,-8,48
Annan Athlet,8596,7,12,11,13,48,41,7,47
Berwick,8596,8,8,10,18,29,59,-30,34
Edinburgh Ci,8596,9,7,9,20,36,64,-28,30
Cowdenbeath,8596,10,4,10,22,23,55,-32,22
Montrose,8597,1,24,7,5,62,34,28,79
Peterhead,8597,2,23,4,9,78,40,38,73
Stirling,8597,3,17,6,13,61,51,10,57
Clyde,8597,4,15,9,12,53,49,4,54
Stenhousem'r,8597,5,15,8,13,55,47,8,53
Elgin,8597,6,14,6,16,53,63,-10,48
Annan Athlet,8597,7,11,12,13,48,42,6,45
Berwick,8597,8,8,10,18,30,60,-30,34
Edinburgh Ci,8597,9,8,9,19,38,61,-23,33
Cowdenbeath,8597,10,4,11,21,24,55,-31,23
Montrose,8598,1,23,8,5,59,34,25,77
Peterhead,8598,2,24,4,8,84,39,45,76
Stenhousem'r,8598,3,16,8,12,57,47,10,56
Stirling,8598,4,16,6,14,61,53,8,54
Clyde,8598,5,14,9,13,52,50,2,51
Elgin,8598,6,14,7,15,53,60,-7,49
Annan Athlet,8598,7,11,11,14,47,42,5,44
Berwick,8598,8,9,10,17,31,59,-28,37
Edinburgh Ci,8598,9,7,9,20,37,67,-30,30
Cowdenbeath,8598,10,5,10,21,24,54,-30,25
Montrose,8599,1,24,7,5,61,34,27,79
Peterhead,8599,2,24,4,8,79,39,40,76
Stirling,8599,3,16,7,13,61,52,9,55
Stenhousem'r,8599,4,15,9,12,56,47,9,54
Clyde,8599,5,15,9,12,53,48,5,54
Elgin,8599,6,14,6,16,53,62,-9,48
Annan Athlet,8599,7,11,11,14,48,44,4,44
Berwick,8599,8,8,10,18,29,60,-31,34
Edinburgh Ci,8599,9,7,9,20,37,62,-25,30
Cowdenbeath,8599,10,5,10,21,26,55,-29,25
Montrose,8600,1,24,7,5,60,34,26,79
Peterhead,8600,2,24,4,8,83,38,45,76
Stenhousem'r,8600,3,16,8,12,59,47,12,56
Stirling,8600,4,16,6,14,61,55,6,54
Clyde,8600,5,15,9,12,54,48,6,54
Elgin,8600,6,14,6,16,53,61,-8,48
Annan Athlet,8600,7,12,11,13,48,41,7,47
Berwick,8600,8,8,10,18,29,61,-32,34
Edinburgh Ci,8600,9,7,9,20,36,66,-30,30
Cowdenbeath,8600,10,4,10,22,23,55,-32,22
Montrose,8601,1,24,7,5,62,34,28,79
Peterhead,8601,2,23,5,8,78,39,39,74
Stirling,8601,3,16,7,13,62,53,9,55
Stenhousem'r,8601,4,15,9,12,57,48,9,54
Clyde,8601,5,15,9,12,53,48,5,54
Elgin,8601,6,14,6,16,53,63,-10,48
Annan Athlet,8601,7,11,11,14,47,43,4,44
Berwick,8601,8,8,10,18,29,60,-31,34
Edinburgh Ci,8601,9,7,10,19,37,61,-24,31
Cowdenbeath,8601,10,5,10,21,25,54,-29,25
Montrose,8602,1,24,7,5,61,34,27,79
Peterhead,8602,2,24,4,8,78,38,40,76
Stirling,8602,3,17,6,13,62,51,11,57
Stenhousem'r,8602,4,15,8,13,55,48,7,53
Clyde,8602,5,14,9,13,51,49,2,51
Elgin,8602,6,14,6,16,53,62,-9,48
Annan Athlet,8602,7,11,12,13,49,43,6,45
Berwick,8602,8,9,10,17,30,58,-28,37
Edinburgh Ci,8602,9,7,9,20,36,61,-25,30
Cowdenbeath,8602,10,4,11,21,25,56,-31,23
Montrose,8603,1,24,7,5,60,34,26,79
Peterhead,8603,2,24,4,8,80,39,41,76
Stirling,8603,3,17,6,13,62,51,11,57
Clyde,8603,4,15,9,12,55,49,6,54
Stenhousem'r,8603,5,15,8,13,55,48,7,53
Elgin,8603,6,14,6,16,53,61,-8,48
Annan Athlet,8603,7,11,12,13,48,42,6,45
Berwick,8603,8,8,10,18,30,62,-32,34
Edinburgh Ci,8603,9,7,9,20,37,63,-26,30
Cowdenbeath,8603,10,4,11,21,24,55,-31,23
Montrose,8604,1,24,7,5,62,35,27,79
Peterhead,8604,2,23,4,9,77,39,38,73
Stenhousem'r,8604,3,16,8,12,56,46,10,56
Stirling,8604,4,16,6,14,60,52,8,54
Clyde,8604,5,15,9,12,52,48,4,54
Elgin,8604,6,14,6,16,54,63,-9,48
Annan Athlet,8604,7,12,11,13,49,42,7,47
Berwick,8604,8,8,10,18,29,59,-30,34
Edinburgh Ci,8604,9,8,9,19,37,60,-23,33
Cowdenbeath,8604,10,4,10,22,24,56,-32,22
Peterhead,8605,1,24,4,8,83,39,44,76
Montrose,8605,2,23,7,6,60,38,22,76
Stirling,8605,3,17,6,13,64,54,10,57
Clyde,8605,4,15,9,12,54,50,4,54
Stenhousem'r,8605,5,15,8,13,58,50,8,53
Elgin,8605,6,15,6,15,57,61,-4,51
Annan Athlet,8605,7,11,12,13,48,42,6,45
Berwick,8605,8,8,10,18,31,61,-30,34
Edinburgh Ci,8605,9,7,9,20,37,66,-29,30
Cowdenbeath,8605,10,4,11,21,24,55,-31,23
Montrose,8606,1,23,8,5,60,35,25,77
Peterhead,8606,2,24,4,8,78,38,40,76
Stirling,8606,3,16,7,13,62,53,9,55
Stenhousem'r,8606,4,15,9,12,57,48,9,54
Clyde,8606,5,15,9,12,55,49,6,54
Elgin,8606,6,14,7,15,54,61,-7,49
Annan Athlet,8606,7,12,11,13,50,42,8,47
Berwick,8606,8,8,10,18,30,62,-32,34
Edinburgh Ci,8606,9,7,9,20,36,61,-25,30
Cowdenbeath,8606,10,4,10,22,24,57,-33,22
Montrose,8607,1,24,7,5,61,35,26,79
Peterhead,8607,2,24,4,8,79,38,41,76
Stirling,8607,3,17,6,13,62,51,11,57
Stenhousem'r,8607,4,15,8,13,55,48,7,53
Clyde,8607,5,14,9,13,54,52,2,51
Elgin,8607,6,14,6,16,54,62,-8,48
Annan Athlet,8607,7,12,11,13,50,42,8,47
Berwick,8607,8,9,10,17,33,61,-28,37
Edinburgh Ci,8607,9,7,9,20,36,62,-26,30
Cowdenbeath,8607,10,4,10,22,24,57,-33,22
Montrose,8608,1,23,7,6,59,35,24,76
Peterhead,8608,2,23,4,9,78,41,37,73
Stirling,8608,3,17,6,13,61,51,10,57
Clyde,8608,4,15,9,12,52,48,4,54
Stenhousem'r,8608,5,15,8,13,55,47,8,53
Elgin,8608,6,15,6,15,54,60,-6,51
Annan Athlet,8608,7,12,11,13,49,41,8,47
Berwick,8608,8,8,10,18,29,59,-30,34
Edinburgh Ci,8608,9,8,9,19,39,61,-22,33
Cowdenbeath,8608,10,4,10,22,23,56,-33,22
Montrose,8609,1,24,7,5,61,35,26,79
Peterhead,8609,2,24,4,8,78,38,40,76
Stenhousem'r,8609,3,16,8,12,56,46,10,56
Stirling,8609,4,16,6,14,60,52,8,54
Clyde,8609,5,14,10,12,52,49,3,52
Elgin,8609,6,14,6,16,54,62,-8,48
Annan Athlet,8609,7,11,12,13,47,41,6,45
Berwick,8609,8,8,11,17,30,59,-29,35
Edinburgh Ci,8609,9,7,9,20,36,61,-25,30
Cowdenbeath,8609,10,4,11,21,23,54,-31,23
Montrose,8610,1,23,8,5,60,35,25,77
Peterhead,8610,2,24,4,8,80,39,41,76
Stenhousem'r,8610,3,16,8,12,56,46,10,56
Stirling,8610,4,16,6,14,60,52,8,54
Clyde,8610,5,15,9,12,52,48,4,54
Elgin,8610,6,14,7,15,54,61,-7,49
Annan Athlet,8610,7,11,12,13,47,41,6,45
Berwick,8610,8,8,10,18,29,59,-30,34
Edinburgh Ci,8610,9,7,9,20,37,63,-26,30
Cowdenbeath,8610,10,4,11,21,23,54,-31,23
Peterhead,8611,1,24,4,8,80,38,42,76
Montrose,8611,2,23,7,6,60,36,24,76
Stenhousem'r,8611,3,16,8,12,57,46,11,56
Stirling,8611,4,16,6,14,60,53,7,54
Clyde,8611,5,15,9,12,54,49,5,54
Elgin,8611,6,15,6,15,55,61,-6,51
Annan Athlet,8611,7,11,12,13,50,44,6,45
Berwick,8611,8,8,10,18,30,61,-31,34
Edinburgh Ci,8611,9,7,9,20,36,63,-27,30
Cowdenbeath,8611,10,4,11,21,26,57,-31,23
Montrose,8612,1,24,7,5,62,36,26,79
Peterhead,8612,2,23,4,9,78,40,38,73
Stirling,8612,3,17,6,13,66,52,14,57
Clyde,8612,4,15,9,12,54,48,6,54
Stenhousem'r,8612,5,15,8,13,56,52,4,53
Elgin,8612,6,14,6,16,55,63,-8,48
Annan Athlet,8612,7,11,12,13,47,41,6,45
Berwick,8612,8,8,10,18,29,61,-32,34
Edinburgh Ci,8612,9,8,9,19,38,61,-23,33
Cowdenbeath,8612,10,4,11,21,23,54,-31,23
Montrose,8613,1,24,7,5,62,36,26,79
Peterhead,8613,2,24,4,8,80,39,41,76
Stirling,8613,3,17,6,13,61,51,10,57
Clyde,8613,4,15,9,12,53,48,5,54
Stenhousem'r,8613,5,15,8,13,55,47,8,53
Elgin,8613,6,14,6,16,55,63,-8,48
Annan Athlet,8613,7,11,11,14,48,43,5,44
Berwick,8613,8,8,10,18,29,60,-31,34
Edinburgh Ci,8613,9,7,9,20,37,63,-26,30
Cowdenbeath,8613,10,5,10,21,25,55,-30,25
Montrose,8614,1,24,7,5,61,34,27,79
Peterhead,8614,2,24,4,8,79,38,41,76
Stirling,8614,3,16,7,13,62,53,9,55
Stenhousem'r,8614,4,15,9,12,57,48,9,54
Clyde,8614,5,14,10,12,51,48,3,52
Elgin,8614,6,14,6,16,53,62,-9,48
Annan Athlet,8614,7,11,12,13,49,43,6,45
Berwick,8614,8,8,11,17,29,58,-29,35
Edinburgh Ci,8614,9,7,9,20,36,62,-26,30
Cowdenbeath,8614,10,4,11,21,25,56,-31,23
Montrose,8615,1,24,7,5,63,35,28,79
Peterhead,8615,2,24,4,8,79,39,40,76
Stenhousem'r,8615,3,16,8,12,56,46,10,56
Stirling,8615,4,16,6,14,60,52,8,54
Clyde,8615,5,15,9,12,52,48,4,54
Elgin,8615,6,14,6,16,54,64,-10,48
Annan Athlet,8615,7,11,12,13,48,42,6,45
Berwick,8615,8,8,10,18,29,59,-30,34
Edinburgh Ci,8615,9,7,9,20,37,62,-25,30
Cowdenbeath,8615,10,4,11,21,24,55,-31,23
Montrose,8616,1,24,7,5,65,35,30,79
Peterhead,8616,2,24,4,8,81,38,43,76
Stirling,8616,3,17,6,13,64,53,11,57
Stenhousem'r,8616,4,15,8,13,57,50,7,53
Clyde,8616,5,14,9,13,53,51,2,51
Elgin,8616,6,14,6,16,54,66,-12,48
Annan Athlet,8616,7,12,11,13,50,43,7,47
Berwick,8616,8,9,10,17,32,60,-28,37
Edinburgh Ci,8616,9,7,9,20,36,64,-28,30
Cowdenbeath,8616,10,4,10,22,25,57,-32,22
Montrose,8617,1,24,7,5,64,34,30,79
Peterhead,8617,2,24,4,8,78,38,40,76
Stirling,8617,3,17,6,13,62,52,10,57
Clyde,8617,4,15,9,12,52,48,4,54
Stenhousem'r,8617,5,15,8,13,56,48,8,53
Elgin,8617,6,14,6,16,53,65,-12,48
Annan Athlet,8617,7,12,11,13,49,41,8,47
Berwick,8617,8,8,10,18,29,59,-30,34
Edinburgh Ci,8617,9,7,9,20,36,61,-25,30
Cowdenbeath,8617,10,4,10,22,23,56,-33,22
Montrose,8618,1,24,7,5,60,34,26,79
Peterhead,8618,2,24,4,8,78,38,40,76
Stirling,8618,3,17,6,13,64,51,13,57
Clyde,8618,4,15,9,12,53,48,5,54
Stenhousem'r,8618,5,15,8,13,55,50,5,53
Elgin,8618,6,14,6,16,53,61,-8,48
Annan Athlet,8618,7,11,11,14,47,44,3,44
Berwick,8618,8,8,10,18,29,60,-31,34
Edinburgh Ci,8618,9,7,9,20,36,61,-25,30
Cowdenbeath,8618,10,5,10,21,26,54,-28,25
Montrose,8619,1,24,7,5,62,34,28,79
Peterhead,8619,2,24,4,8,80,38,42,76
Stenhousem'r,8619,3,16,8,12,58,48,10,56
Stirling,8619,4,16,6,14,62,54,8,54
Clyde,8619,5,14,10,12,52,49,3,52
Elgin,8619,6,14,6,16,53,63,-10,48
Annan Athlet,8619,7,11,11,14,47,42,5,44
Berwick,8619,8,8,11,17,30,59,-29,35
Edinburgh Ci,8619,9,7,9,20,36,63,-27,30
Cowdenbeath,8619,10,5,10,21,24,54,-30,25
Montrose,8620,1,24,7,5,63,36,27,79
Peterhead,8620,2,24,4,8,78,38,40,76
Stirling,8620,3,16,7,13,61,52,9,55
Stenhousem'r,8620,4,15,9,12,56,47,9,54
Clyde,8620,5,15,9,12,54,48,6,54
Elgin,8620,6,14,6,16,55,64,-9,48
Annan Athlet,8620,7,12,11,13,49,42,7,47
Berwick,8620,8,8,10,18,29,61,-32,34
Edinburgh Ci,8620,9,7,9,20,36,61,-25,30
Cowdenbeath,8620,10,4,10,22,24,56,-32,22
Montrose,8621,1,24,7,5,63,35,28,79
Peterhead,8621,2,24,4,8,80,38,42,76
Stenhousem'r,8621,3,16,8,12,57,46,11,56
Stirling,8621,4,16,6,14,60,53,7,54
Clyde,8621,5,15,9,12,54,49,5,54
Elgin,8621,6,14,6,16,54,64,-10,48
Annan Athlet,8621,7,12,11,13,49,42,7,47
Berwick,8621,8,8,10,18,30,61,-31,34
Edinburgh Ci,8621,9,7,9,20,36,63,-27,30
Cowdenbeath,8621,10,4,10,22,24,56,-32,22
Montrose,8622,1,24,7,5,63,34,29,79
Peterhead,8622,2,24,4,8,82,38,44,76
Stirling,8622,3,16,7,13,62,53,9,55
Stenhousem'r,8622,4,15,9,12,57,48,9,54
Clyde,8622,5,15,9,12,53,48,5,54
Elgin,8622,6,14,6,16,53,64,-11,48
Annan Athlet,8622,7,12,11,13,49,41,8,47
Berwick,8622,8,8,10,18,29,60,-31,34
Edinburgh Ci,8622,9,7,9,20,36,65,-29,30
Cowdenbeath,8622,10,4,10,22,23,56,-33,22
Montrose,8623,1,24,7,5,61,34,27,79
Peterhead,8623,2,23,5,8,78,39,39,74
Stirling,8623,3,17,6,13,62,52,10,57
Clyde,8623,4,15,9,12,54,49,5,54
Stenhousem'r,8623,5,15,8,13,56,48,8,53
Elgin,8623,6,14,6,16,53,62,-9,48
Annan Athlet,8623,7,12,11,13,48,41,7,47
Berwick,8623,8,8,10,18,30,61,-31,34
Edinburgh Ci,8623,9,7,10,19,37,61,-24,31
Cowdenbeath,8623,10,4,10,22,23,55,-32,22
Montrose,8624,1,23,8,5,59,34,25,77
Peterhead,8624,2,24,4,8,78,38,40,76
Stirling,8624,3,16,7,13,61,52,9,55
Stenhousem'r,8624,4,15,9,12,56,47,9,54
Clyde,8624,5,15,9,12,52,48,4,54
Elgin,8624,6,14,7,15,53,60,-7,49
Annan Athlet,8624,7,11,11,14,49,44,5,44
Berwick,8624,8,8,10,18,29,59,-30,34
Edinburgh Ci,8624,9,7,9,20,36,61,-25,30
Cowdenbeath,8624,10,5,10,21,26,56,-30,25
Montrose,8625,1,24,7,5,61,35,26,79
Peterhead,8625,2,24,4,8,79,38,41,76
Stenhousem'r,8625,3,16,8,12,57,47,10,56
Stirling,8625,4,16,6,14,61,53,8,54
Clyde,8625,5,15,9,12,52,48,4,54
Elgin,8625,6,14,6,16,54,62,-8,48
Annan Athlet,8625,7,12,11,13,51,43,8,47
Berwick,8625,8,8,10,18,29,59,-30,34
Edinburgh Ci,8625,9,7,9,20,36,62,-26,30
Cowdenbeath,8625,10,4,10,22,25,58,-33,22
Peterhead,8626,1,24,4,8,80,40,40,76
Montrose,8626,2,23,7,6,60,36,24,76
Stenhousem'r,8626,3,16,8,12,57,46,11,56
Stirling,8626,4,16,6,14,60,53,7,54
Clyde,8626,5,14,10,12,52,49,3,52
Elgin,8626,6,15,6,15,55,61,-6,51
Annan Athlet,8626,7,12,11,13,48,41,7,47
Berwick,8626,8,8,11,17,30,59,-29,35
Edinburgh Ci,8626,9,7,9,20,38,63,-25,30
Cowdenbeath,8626,10,4,10,22,23,55,-32,22
Peterhead,8627,1,24,4,8,78,38,40,76
Montrose,8627,2,23,7,6,59,35,24,76
Stirling,8627,3,17,6,13,62,52,10,57
Stenhousem'r,8627,4,15,8,13,56,48,8,53
Clyde,8627,5,14,10,12,51,48,3,52
Elgin,8627,6,15,6,15,54,60,-6,51
Annan Athlet,8627,7,11,12,13,50,44,6,45
Berwick,8627,8,8,11,17,29,58,-29,35
Edinburgh Ci,8627,9,7,9,20,36,61,-25,30
Cowdenbeath,8627,10,4,11,21,26,57,-31,23
Montrose,8628,1,23,8,5,60,35,25,77
Peterhead,8628,2,23,5,8,78,39,39,74
Stenhousem'r,8628,3,16,8,12,58,48,10,56
Stirling,8628,4,16,6,14,62,54,8,54
Clyde,8628,5,14,10,12,52,49,3,52
Elgin,8628,6,14,7,15,54,61,-7,49
Annan Athlet,8628,7,11,11,14,48,43,5,44
Berwick,8628,8,8,11,17,30,59,-29,35
Edinburgh Ci,8628,9,7,10,19,37,61,-24,31
Cowdenbeath,8628,10,5,10,21,25,55,-30,25
Montrose,8629,1,24,7,5,62,35,27,79
Peterhead,8629,2,24,4,8,81,39,42,76
Stirling,8629,3,17,6,13,65,51,14,57
Clyde,8629,4,15,9,12,53,48,5,54
Stenhousem'r,8629,5,15,8,13,55,51,4,53
Elgin,8629,6,14,6,16,54,63,-9,48
Annan Athlet,8629,7,11,11,14,47,44,3,44
Berwick,8629,8,8,10,18,29,60,-31,34
Edinburgh Ci,8629,9,7,9,20,37,64,-27,30
Cowdenbeath,8629,10,5,10,21,26,54,-28,25
Montrose,8630,1,24,7,5,60,34,26,79
Peterhead,8630,2,24,4,8,79,39,40,76
Stenhousem'r,8630,3,16,8,12,56,46,10,56
Stirling,8630,4,16,6,14,60,52,8,54
Clyde,8630,5,15,9,12,52,48,4,54
Elgin,8630,6,14,6,16,53,61,-8,48
Annan Athlet,8630,7,11,12,13,48,42,6,45
Berwick,8630,8,8,10,18,29,59,-30,34
Edinburgh Ci,8630,9,7,9,20,37,62,-25,30
Cowdenbeath,8630,10,4,11,21,24,55,-31,23
Montrose,8631,1,24,7,5,61,34,27,79
Peterhead,8631,2,23,4,9,77,39,38,73
Stirling,8631,3,16,7,13,62,53,9,55
Stenhousem'r,8631,4,15,9,12,57,48,9,54
Clyde,8631,5,14,10,12,51,48,3,52
Elgin,8631,6,14,6,16,53,62,-9,48
Annan Athlet,8631,7,12,11,13,48,41,7,47
Berwick,8631,8,8,11,17,29,58,-29,35
Edinburgh Ci,8631,9,8,9,19,37,60,-23,33
Cowdenbeath,8631,10,4,10,22,23,55,-32,22
Montrose,8632,1,24,7,5,60,34,26,79
Peterhead,8632,2,24,4,8,78,38,40,76
Stirling,8632,3,17,6,13,62,52,10,57
Clyde,8632,4,15,9,12,55,51,4,54
Stenhousem'r,8632,5,15,8,13,56,48,8,53
Elgin,8632,6,14,6,16,53,61,-8,48
Annan Athlet,8632,7,11,12,13,47,41,6,45
Berwick,8632,8,8,10,18,32,62,-30,34
Edinburgh Ci,8632,9,7,9,20,36,61,-25,30
Cowdenbeath,8632,10,4,11,21,23,54,-31,23
Montrose,8633,1,24,7,5,61,35,26,79
Peterhead,8633,2,24,4,8,78,38,40,76
Stirling,8633,3,16,7,13,62,53,9,55
Stenhousem'r,8633,4,15,9,12,57,48,9,54
Clyde,8633,5,14,10,12,52,49,3,52
Elgin,8633,6,14,6,16,54,62,-8,48
Annan Athlet,8633,7,12,11,13,48,41,7,47
Berwick,8633,8,8,11,17,30,59,-29,35
Edinburgh Ci,8633,9,7,9,20,36,61,-25,30
Cowdenbeath,8633,10,4,10,22,23,55,-32,22
Montrose,8634,1,24,7,5,61,35,26,79
Peterhead,8634,2,23,5,8,77,38,39,74
Stirling,8634,3,17,6,13,64,51,13,57
Clyde,8634,4,15,9,12,57,48,9,54
Stenhousem'r,8634,5,15,8,13,55,50,5,53
Elgin,8634,6,14,6,16,54,62,-8,48
Annan Athlet,8634,7,12,11,13,48,41,7,47
Berwick,8634,8,8,10,18,29,64,-35,34
Edinburgh Ci,8634,9,7,10,19,36,60,-24,31
Cowdenbeath,8634,10,4,10,22,23,55,-32,22
Montrose,8635,1,23,8,5,60,35,25,77
Peterhead,8635,2,24,4,8,80,38,42,76
Stenhousem'r,8635,3,16,8,12,59,48,11,56
Stirling,8635,4,16,6,14,62,55,7,54
Clyde,8635,5,15,9,12,52,48,4,54
Elgin,8635,6,14,7,15,54,61,-7,49
Annan Athlet,8635,7,12,11,13,50,41,9,47
Berwick,8635,8,8,10,18,29,59,-30,34
Edinburgh Ci,8635,9,7,9,20,36,63,-27,30
Cowdenbeath,8635,10,4,10,22,23,57,-34,22
Montrose,8636,1,24,7,5,60,34,26,79
Peterhead,8636,2,24,4,8,81,39,42,76
Stirling,8636,3,17,6,13,62,52,10,57
Stenhousem'r,8636,4,15,8,13,56,48,8,53
Clyde,8636,5,14,10,12,52,49,3,52
Elgin,8636,6,14,6,16,53,61,-8,48
Annan Athlet,8636,7,11,11,14,47,42,5,44
Berwick,8636,8,8,11,17,30,59,-29,35
Edinburgh Ci,8636,9,7,9,20,37,64,-27,30
Cowdenbeath,8636,10,5,10,21,24,54,-30,25
Montrose,8637,1,23,8,5,59,34,25,77
Peterhead,8637,2,24,4,8,79,38,41,76
Stenhousem'r,8637,3,16,8,12,58,47,11,56
Stirling,8637,4,16,6,14,61,54,7,54
Clyde,8637,5,15,9,12,53,48,5,54
Elgin,8637,6,14,7,15,53,60,-7,49
Annan Athlet,8637,7,12,11,13,49,41,8,47
Berwick,8637,8,8,10,18,29,60,-31,34
Edinburgh Ci,8637,9,7,9,20,36,62,-26,30
Cowdenbeath,8637,10,4,10,22,23,56,-33,22
Montrose,8638,1,23,7,6,60,36,24,76
Peterhead,8638,2,23,4,9,78,42,36,73
Stirling,8638,3,17,6,13,63,51,12,57
Stenhousem'r,8638,4,15,8,13,55,49,6,53
Clyde,8638,5,14,10,12,52,49,3,52
Elgin,8638,6,15,6,15,55,61,-6,51
Annan Athlet,8638,7,11,11,14,48,43,5,44
Berwick,8638,8,8,11,17,30,59,-29,35
Edinburgh Ci,8638,9,8,9,19,40,61,-21,33
Cowdenbeath,8638,10,5,10,21,25,55,-30,25
Montrose,8639,1,23,8,5,60,35,25,77
Peterhead,8639,2,23,5,8,78,39,39,74
Stirling,8639,3,17,6,13,63,51,12,57
Clyde,8639,4,15,9,12,53,48,5,54
Stenhousem'r,8639,5,15,8,13,55,49,6,53
Elgin,8639,6,14,7,15,54,61,-7,49
Annan Athlet,8639,7,12,11,13,49,41,8,47
Berwick,8639,8,8,10,18,29,60,-31,34
Edinburgh Ci,8639,9,7,10,19,37,61,-24,31
Cowdenbeath,8639,10,4,10,22,23,56,-33,22
Peterhead,8640,1,24,4,8,80,40,40,76
Montrose,8640,2,23,7,6,60,36,24,76
Stenhousem'r,8640,3,16,8,12,57,47,10,56
Stirling,8640,4,16,6,14,61,53,8,54
Clyde,8640,5,15,9,12,53,49,4,54
Elgin,8640,6,15,6,15,55,61,-6,51
Annan Athlet,8640,7,11,12,13,48,42,6,45
Berwick,8640,8,8,10,18,30,60,-30,34
Edinburgh Ci,8640,9,7,9,20,38,63,-25,30
Cowdenbeath,8640,10,4,11,21,24,55,-31,23
Montrose,8641,1,24,7,5,62,36,26,79
Peterhead,8641,2,24,4,8,80,39,41,76
Stirling,8641,3,16,7,13,62,53,9,55
Stenhousem'r,8641,4,15,9,12,57,48,9,54
Clyde,8641,5,15,9,12,54,48,6,54
Elgin,8641,6,14,6,16,55,63,-8,48
Annan Athlet,8641,7,11,12,13,48,42,6,45
Berwick,8641,8,8,10,18,29,61,-32,34
Edinburgh Ci,8641,9,7,9,20,37,63,-26,30
Cowdenbeath,8641,10,4,11,21,24,55,-31,23
Montrose,8642,1,23,8,5,61,36,25,77
Peterhead,8642,2,23,5,8,78,39,39,74
Stirling,8642,3,16,7,13,62,53,9,55
Stenhousem'r,8642,4,15,9,12,57,48,9,54
Clyde,8642,5,14,10,12,51,48,3,52
Elgin,8642,6,14,7,15,55,62,-7,49
Annan Athlet,8642,7,12,11,13,50,41,9,47
Berwick,8642,8,8,11,17,29,58,-29,35
Edinburgh Ci,8642,9,7,10,19,37,61,-24,31
Cowdenbeath,8642,10,4,10,22,23,57,-34,22
Montrose,8643,1,24,7,5,60,34,26,79
Peterhead,8643,2,23,4,9,78,40,38,73
Stirling,8643,3,16,7,13,63,54,9,55
Stenhousem'r,8643,4,15,9,12,58,49,9,54
Clyde,8643,5,15,9,12,53,49,4,54
Elgin,8643,6,14,6,16,53,61,-8,48
Annan Athlet,8643,7,12,11,13,48,41,7,47
Berwick,8643,8,8,10,18,30,60,-30,34
Edinburgh Ci,8643,9,8,9,19,38,61,-23,33
Cowdenbeath,8643,10,4,10,22,23,55,-32,22
Montrose,8644,1,23,8,5,60,35,25,77
Peterhead,8644,2,24,4,8,79,38,41,76
Stirling,8644,3,16,7,13,61,52,9,55
Stenhousem'r,8644,4,15,9,12,56,47,9,54
Clyde,8644,5,15,9,12,52,48,4,54
Elgin,8644,6,14,7,15,54,61,-7,49
Annan Athlet,8644,7,11,12,13,48,42,6,45
Berwick,8644,8,8,10,18,29,59,-30,34
Edinburgh Ci,8644,9,7,9,20,36,62,-26,30
Cowdenbeath,8644,10,4,11,21,24,55,-31,23
Montrose,8645,1,24,7,5,63,34,29,79
Peterhead,8645,2,24,4,8,79,39,40,76
Stirling,8645,3,17,6,13,61,51,10,57
Clyde,8645,4,15,9,12,54,48,6,54
Stenhousem'r,8645,5,15,8,13,55,47,8,53
Elgin,8645,6,14,6,16,53,64,-11,48
Annan Athlet,8645,7,11,12,13,48,42,6,45
Berwick,8645,8,8,10,18,29,61,-32,34
Edinburgh Ci,8645,9,7,9,20,37,62,-25,30
Cowdenbeath,8645,10,4,11,21,24,55,-31,23
Peterhead,8646,1,24,4,8,81,40,41,76
Montrose,8646,2,23,7,6,60,36,24,76
Stenhousem'r,8646,3,16,8,12,56,46,10,56
Stirling,8646,4,16,6,14,60,52,8,54
Clyde,8646,5,14,10,12,51,48,3,52
Elgin,8646,6,15,6,15,55,61,-6,51
Annan Athlet,8646,7,11,12,13,48,42,6,45
Berwick,8646,8,8,11,17,29,58,-29,35
Edinburgh Ci,8646,9,7,9,20,38,64,-26,30
Cowdenbeath,8646,10,4,11,21,24,55,-31,23
Montrose,8647,1,24,7,5,61,35,26,79
Peterhead,8647,2,24,4,8,79,38,41,76
Stirling,8647,3,17,6,13,63,52,11,57
Clyde,8647,4,15,9,12,54,48,6,54
Stenhousem'r,8647,5,15,8,13,56,49,7,53
Elgin,8647,6,14,6,16,54,62,-8,48
Annan Athlet,8647,7,12,11,13,51,41,10,47
Berwick,8647,8,8,10,18,29,61,-32,34
Edinburgh Ci,8647,9,7,9,20,36,62,-26,30
Cowdenbeath,8647,10,4,10,22,23,58,-35,22
Peterhead,8648,1,24,4,8,81,38,43,76
Montrose,8648,2,23,7,6,59,36,23,76
Stirling,8648,3,17,6,13,61,51,10,57
Stenhousem'r,8648,4,15,8,13,55,47,8,53
Clyde,8648,5,14,9,13,52,50,2,51
Elgin,8648,6,15,6,15,55,60,-5,51
Annan Athlet,8648,7,12,11,13,49,41,8,47
Berwick,8648,8,9,10,17,31,59,-28,37
Edinburgh Ci,8648,9,7,9,20,36,64,-28,30
Cowdenbeath,8648,10,4,10,22,23,56,-33,22
Peterhead,8649,1,24,4,8,79,39,40,76
Montrose,8649,2,23,7,6,59,38,21,76
Stirling,8649,3,16,7,13,61,52,9,55
Stenhousem'r,8649,4,15,9,12,56,47,9,54
Clyde,8649,5,15,9,12,53,49,4,54
Elgin,8649,6,15,6,15,57,60,-3,51
Annan Athlet,8649,7,12,11,13,48,41,7,47
Berwick,8649,8,8,10,18,30,60,-30,34
Edinburgh Ci,8649,9,7,9,20,37,62,-25,30
Cowdenbeath,8649,10,4,10,22,23,55,-32,22
Montrose,8650,1,23,8,5,62,37,25,77
Peterhead,8650,2,24,4,8,81,38,43,76
Stirling,8650,3,17,6,13,63,53,10,57
Stenhousem'r,8650,4,15,8,13,57,49,8,53
Clyde,8650,5,14,10,12,52,49,3,52
Elgin,8650,6,14,7,15,56,63,-7,49
Annan Athlet,8650,7,12,11,13,49,42,7,47
Berwick,8650,8,8,11,17,30,59,-29,35
Edinburgh Ci,8650,9,7,9,20,36,64,-28,30
Cowdenbeath,8650,10,4,10,22,24,56,-32,22
Montrose,8651,1,24,7,5,64,34,30,79
Peterhead,8651,2,24,4,8,79,39,40,76
Stirling,8651,3,17,6,13,61,51,10,57
Clyde,8651,4,15,9,12,54,48,6,54
Stenhousem'r,8651,5,15,8,13,55,47,8,53
Elgin,8651,6,14,6,16,53,65,-12,48
Annan Athlet,8651,7,11,11,14,48,43,5,44
Berwick,8651,8,8,10,18,29,61,-32,34
Edinburgh Ci,8651,9,7,9,20,37,62,-25,30
Cowdenbeath,8651,10,5,10,21,25,55,-30,25
Montrose,8652,1,24,7,5,62,35,27,79
Peterhead,8652,2,24,4,8,78,38,40,76
Stenhousem'r,8652,3,16,8,12,57,46,11,56
Stirling,8652,4,16,6,14,60,53,7,54
Clyde,8652,5,15,9,12,53,49,4,54
Elgin,8652,6,14,6,16,54,63,-9,48
Annan Athlet,8652,7,11,12,13,49,43,6,45
Berwick,8652,8,8,10,18,30,60,-30,34
Edinburgh Ci,8652,9,7,9,20,36,61,-25,30
Cowdenbeath,8652,10,4,11,21,25,56,-31,23
Montrose,8653,1,24,7,5,61,35,26,79
Peterhead,8653,2,24,4,8,83,40,43,76
Stenhousem'r,8653,3,16,8,12,57,47,10,56
Stirling,8653,4,16,6,14,61,53,8,54
Clyde,8653,5,14,9,13,51,50,1,51
Elgin,8653,6,14,6,16,54,62,-8,48
Annan Athlet,8653,7,11,12,13,47,41,6,45
Berwick,8653,8,9,10,17,31,58,-27,37
Edinburgh Ci,8653,9,7,9,20,38,66,-28,30
Cowdenbeath,8653,10,4,11,21,23,54,-31,23
Montrose,8654,1,24,7,5,61,35,26,79
Peterhead,8654,2,24,4,8,80,40,40,76
Stirling,8654,3,17,6,13,63,53,10,57
Stenhousem'r,8654,4,15,8,13,57,49,8,53
Clyde,8654,5,14,9,13,52,50,2,51
Elgin,8654,6,14,6,16,54,62,-8,48
Annan Athlet,8654,7,11,11,14,47,43,4,44
Berwick,8654,8,9,10,17,31,59,-28,37
Edinburgh Ci,8654,9,7,9,20,38,63,-25,30
Cowdenbeath,8654,10,5,10,21,25,54,-29,25
Montrose,8655,1,23,8,5,61,36,25,77
Peterhead,8655,2,24,4,8,82,40,42,76
Stirling,8655,3,17,6,13,63,53,10,57
Stenhousem'r,8655,4,15,8,13,57,49,8,53
Clyde,8655,5,14,10,12,52,49,3,52
Elgin,8655,6,14,7,15,55,62,-7,49
Annan Athlet,8655,7,12,11,13,50,41,9,47
Berwick,8655,8,8,11,17,30,59,-29,35
Edinburgh Ci,8655,9,7,9,20,38,65,-27,30
Cowdenbeath,8655,10,4,10,22,23,57,-34,22
Montrose,8656,1,23,8,5,62,37,25,77
Peterhead,8656,2,24,4,8,80,38,42,76
Stirling,8656,3,16,7,13,60,51,9,55
Stenhousem'r,8656,4,15,9,12,55,46,9,54
Clyde,8656,5,14,10,12,53,50,3,52
Elgin,8656,6,14,7,15,56,63,-7,49
Annan Athlet,8656,7,11,12,13,48,42,6,45
Berwick,8656,8,8,11,17,31,60,-29,35
Edinburgh Ci,8656,9,7,9,20,36,63,-27,30
Cowdenbeath,8656,10,4,11,21,24,55,-31,23
Montrose,8657,1,24,7,5,61,35,26,79
Peterhead,8657,2,24,4,8,78,38,40,76
Stenhousem'r,8657,3,16,8,12,60,47,13,56
Clyde,8657,4,15,9,12,57,49,8,54
Stirling,8657,5,16,6,14,61,56,5,54
Elgin,8657,6,14,6,16,54,62,-8,48
Annan Athlet,8657,7,11,11,14,47,42,5,44
Berwick,8657,8,8,10,18,30,64,-34,34
Edinburgh Ci,8657,9,7,9,20,36,61,-25,30
Cowdenbeath,8657,10,5,10,21,24,54,-30,25
Montrose,8658,1,24,7,5,65,35,30,79
Peterhead,8658,2,24,4,8,78,38,40,76
Stenhousem'r,8658,3,16,8,12,57,46,11,56
Stirling,8658,4,16,6,14,60,53,7,54
Clyde,8658,5,15,9,12,54,49,5,54
Elgin,8658,6,14,6,16,54,66,-12,48
Annan Athlet,8658,7,11,12,13,47,41,6,45
Berwick,8658,8,8,10,18,30,61,-31,34
Edinburgh Ci,8658,9,7,9,20,36,61,-25,30
Cowdenbeath,8658,10,4,11,21,23,54,-31,23
Montrose,8659,1,24,7,5,63,36,27,79
Peterhead,8659,2,24,4,8,79,38,41,76
Stirling,8659,3,17,6,13,62,52,10,57
Clyde,8659,4,15,9,12,55,48,7,54
Stenhousem'r,8659,5,15,8,13,56,48,8,53
Elgin,8659,6,14,6,16,55,64,-9,48
Annan Athlet,8659,7,11,12,13,47,41,6,45
Berwick,8659,8,8,10,18,29,62,-33,34
Edinburgh Ci,8659,9,7,9,20,36,62,-26,30
Cowdenbeath,8659,10,4,11,21,23,54,-31,23
Montrose,8660,1,23,7,6,61,37,24,76
Peterhead,8660,2,23,4,9,79,41,38,73
Stirling,8660,3,16,7,13,60,51,9,55
Stenhousem'r,8660,4,15,9,12,55,46,9,54
Clyde,8660,5,14,10,12,52,49,3,52
Elgin,8660,6,15,6,15,56,62,-6,51
Annan Athlet,8660,7,11,11,14,47,42,5,44
Berwick,8660,8,8,11,17,30,59,-29,35
Edinburgh Ci,8660,9,8,9,19,39,62,-23,33
Cowdenbeath,8660,10,5,10,21,24,54,-30,25
Montrose,8661,1,24,7,5,61,34,27,79
Peterhead,8661,2,23,5,8,78,39,39,74
Stirling,8661,3,17,6,13,61,51,10,57
Clyde,8661,4,15,9,12,53,49,4,54
Stenhousem'r,8661,5,15,8,13,55,47,8,53
Elgin,8661,6,14,6,16,53,62,-9,48
Annan Athlet,8661,7,11,11,14,47,43,4,44
Berwick,8661,8,8,10,18,30,60,-30,34
Edinburgh Ci,8661,9,7,10,19,37,61,-24,31
Cowdenbeath,8661,10,5,10,21,25,54,-29,25
Montrose,8662,1,23,8,5,61,36,25,77
Peterhead,8662,2,24,4,8,80,39,41,76
Stirling,8662,3,17,6,13,61,51,10,57
Clyde,8662,4,15,9,12,55,49,6,54
Stenhousem'r,8662,5,15,8,13,55,47,8,53
Elgin,8662,6,14,7,15,55,62,-7,49
Annan Athlet,8662,7,11,11,14,48,43,5,44
Berwick,8662,8,8,10,18,30,62,-32,34
Edinburgh Ci,8662,9,7,9,20,37,63,-26,30
Cowdenbeath,8662,10,5,10,21,25,55,-30,25
Peterhead,8663,1,24,4,8,80,38,42,76
Montrose,8663,2,23,7,6,61,37,24,76
Stirling,8663,3,17,6,13,61,51,10,57
Clyde,8663,4,15,9,12,54,48,6,54
Stenhousem'r,8663,5,15,8,13,55,47,8,53
Elgin,8663,6,15,6,15,56,62,-6,51
Annan Athlet,8663,7,12,11,13,49,42,7,47
Berwick,8663,8,8,10,18,29,61,-32,34
Edinburgh Ci,8663,9,7,9,20,36,63,-27,30
Cowdenbeath,8663,10,4,10,22,24,56,-32,22
Montrose,8664,1,23,8,5,60,35,25,77
Peterhead,8664,2,24,4,8,80,40,40,76
Stirling,8664,3,16,7,13,60,51,9,55
Stenhousem'r,8664,4,15,9,12,55,46,9,54
Clyde,8664,5,14,10,12,51,48,3,52
Elgin,8664,6,14,7,15,54,61,-7,49
Annan Athlet,8664,7,11,12,13,48,42,6,45
Berwick,8664,8,8,11,17,29,58,-29,35
Edinburgh Ci,8664,9,7,9,20,38,63,-25,30
Cowdenbeath,8664,10,4,11,21,24,55,-31,23
Montrose,8665,1,24,7,5,64,34,30,79
Peterhead,8665,2,24,4,8,80,38,42,76
Stenhousem'r,8665,3,16,8,12,57,46,11,56
Stirling,8665,4,16,6,14,60,53,7,54
Clyde,8665,5,14,9,13,51,50,1,51
Elgin,8665,6,14,6,16,53,65,-12,48
Annan Athlet,8665,7,11,12,13,47,41,6,45
Berwick,8665,8,9,10,17,31,58,-27,37
Edinburgh Ci,8665,9,7,9,20,36,63,-27,30
Cowdenbeath,8665,10,4,11,21,23,54,-31,23
Montrose,8666,1,24,7,5,61,35,26,79
Peterhead,8666,2,24,4,8,78,38,40,76
Stirling,8666,3,17,6,13,62,51,11,57
Clyde,8666,4,15,9,12,53,49,4,54
Stenhousem'r,8666,5,15,8,13,55,48,7,53
Elgin,8666,6,14,6,16,54,62,-8,48
Annan Athlet,8666,7,12,11,13,48,41,7,47
Berwick,8666,8,8,10,18,30,60,-30,34
Edinburgh Ci,8666,9,7,9,20,36,61,-25,30
Cowdenbeath,8666,10,4,10,22,23,55,-32,22
Peterhead,8667,1,24,4,8,80,39,41,76
Montrose,8667,2,23,7,6,60,38,22,76
Stenhousem'r,8667,3,16,8,12,58,47,11,56
Stirling,8667,4,16,6,14,61,54,7,54
Clyde,8667,5,15,9,12,54,50,4,54
Elgin,8667,6,15,6,15,57,61,-4,51
Annan Athlet,8667,7,11,11,14,47,45,2,44
Berwick,8667,8,8,10,18,31,61,-30,34
Edinburgh Ci,8667,9,7,9,20,37,63,-26,30
Cowdenbeath,8667,10,5,10,21,27,54,-27,25
Montrose,8668,1,24,7,5,63,35,28,79
Peterhead,8668,2,24,4,8,81,38,43,76
Stirling,8668,3,17,6,13,63,53,10,57
Clyde,8668,4,15,9,12,53,48,5,54
Stenhousem'r,8668,5,15,8,13,57,49,8,53
Elgin,8668,6,14,6,16,54,64,-10,48
Annan Athlet,8668,7,11,12,13,48,42,6,45
Berwick,8668,8,8,10,18,29,60,-31,34
Edinburgh Ci,8668,9,7,9,20,36,64,-28,30
Cowdenbeath,8668,10,4,11,21,24,55,-31,23
Montrose,8669,1,24,7,5,61,35,26,79
Peterhead,8669,2,23,5,8,79,40,39,74
Stenhousem'r,8669,3,16,8,12,58,47,11,56
Stirling,8669,4,16,6,14,61,54,7,54
Clyde,8669,5,15,9,12,54,48,6,54
Elgin,8669,6,14,6,16,54,62,-8,48
Annan Athlet,8669,7,12,11,13,48,41,7,47
Berwick,8669,8,8,10,18,29,61,-32,34
Edinburgh Ci,8669,9,7,10,19,38,62,-24,31
Cowdenbeath,8669,10,4,10,22,23,55,-32,22
Montrose,8670,1,24,7,5,61,35,26,79
Peterhead,8670,2,24,4,8,82,39,43,76
Stirling,8670,3,17,6,13,63,52,11,57
Clyde,8670,4,15,9,12,53,48,5,54
Stenhousem'r,8670,5,15,8,13,56,49,7,53
Elgin,8670,6,14,6,16,54,62,-8,48
Annan Athlet,8670,7,12,11,13,49,41,8,47
Berwick,8670,8,8,10,18,29,60,-31,34
Edinburgh Ci,8670,9,7,9,20,37,65,-28,30
Cowdenbeath,8670,10,4,10,22,23,56,-33,22
Montrose,8671,1,24,7,5,61,35,26,79
Peterhead,8671,2,24,4,8,79,39,40,76
Stirling,8671,3,16,7,13,62,53,9,55
Stenhousem'r,8671,4,15,9,12,57,48,9,54
Clyde,8671,5,15,9,12,52,48,4,54
Elgin,8671,6,14,6,16,54,62,-8,48
Annan Athlet,8671,7,12,11,13,49,41,8,47
Berwick,8671,8,8,10,18,29,59,-30,34
Edinburgh Ci,8671,9,7,9,20,37,62,-25,30
Cowdenbeath,8671,10,4,10,22,23,56,-33,22
Montrose,8672,1,24,7,5,62,36,26,79
Peterhead,8672,2,24,4,8,81,38,43,76
Stirling,8672,3,17,6,13,63,53,10,57
Clyde,8672,4,15,9,12,52,48,4,54
Stenhousem'r,8672,5,15,8,13,57,49,8,53
Elgin,8672,6,14,6,16,55,63,-8,48
Annan Athlet,8672,7,12,11,13,50,43,7,47
Berwick,8672,8,8,10,18,29,59,-30,34
Edinburgh Ci,8672,9,7,9,20,36,64,-28,30
Cowdenbeath,8672,10,4,10,22,25,57,-32,22
Peterhead,8673,1,24,4,8,81,40,41,76
Montrose,8673,2,23,7,6,60,36,24,76
Stenhousem'r,8673,3,16,8,12,56,46,10,56
Stirling,8673,4,16,6,14,60,52,8,54
Clyde,8673,5,15,9,12,54,48,6,54
Elgin,8673,6,15,6,15,55,61,-6,51
Annan Athlet,8673,7,12,11,13,49,41,8,47
Berwick,8673,8,8,10,18,29,61,-32,34
Edinburgh Ci,8673,9,7,9,20,38,64,-26,30
Cowdenbeath,8673,10,4,10,22,23,56,-33,22
Montrose,8674,1,23,8,5,59,34,25,77
Peterhead,8674,2,24,4,8,79,39,40,76
Stirling,8674,3,17,6,13,64,53,11,57
Stenhousem'r,8674,4,15,8,13,57,50,7,53
Clyde,8674,5,14,9,13,51,49,2,51
Elgin,8674,6,14,7,15,53,60,-7,49
Annan Athlet,8674,7,11,12,13,49,43,6,45
Berwick,8674,8,9,10,17,30,58,-28,37
Edinburgh Ci,8674,9,7,9,20,37,62,-25,30
Cowdenbeath,8674,10,4,11,21,25,56,-31,23
Montrose,8675,1,24,7,5,61,34,27,79
Peterhead,8675,2,24,4,8,81,38,43,76
Stenhousem'r,8675,3,16,8,12,57,47,10,56
Stirling,8675,4,16,6,14,61,53,8,54
Clyde,8675,5,15,9,12,55,49,6,54
Elgin,8675,6,14,6,16,53,62,-9,48
Annan Athlet,8675,7,12,11,13,50,41,9,47
Berwick,8675,8,8,10,18,30,62,-32,34
Edinburgh Ci,8675,9,7,9,20,36,64,-28,30
Cowdenbeath,8675,10,4,10,22,23,57,-34,22
Montrose,8676,1,24,7,5,62,34,28,79
Peterhead,8676,2,24,4,8,81,39,42,76
Stenhousem'r,8676,3,16,8,12,57,47,10,56
Stirling,8676,4,16,6,14,61,53,8,54
Clyde,8676,5,15,9,12,55,50,5,54
Elgin,8676,6,14,6,16,53,63,-10,48
Annan Athlet,8676,7,12,11,13,50,41,9,47
Berwick,8676,8,8,10,18,31,62,-31,34
Edinburgh Ci,8676,9,7,9,20,37,64,-27,30
Cowdenbeath,8676,10,4,10,22,23,57,-34,22
Montrose,8677,1,24,7,5,62,36,26,79
Peterhead,8677,2,24,4,8,84,39,45,76
Stirling,8677,3,17,6,13,66,52,14,57
Stenhousem'r,8677,4,15,8,13,56,52,4,53
Clyde,8677,5,14,9,13,52,51,1,51
Elgin,8677,6,14,6,16,55,63,-8,48
Annan Athlet,8677,7,12,11,13,49,41,8,47
Berwick,8677,8,9,10,17,32,59,-27,37
Edinburgh Ci,8677,9,7,9,20,37,67,-30,30
Cowdenbeath,8677,10,4,10,22,23,56,-33,22
Montrose,8678,1,23,7,6,59,35,24,76
Peterhead,8678,2,23,5,8,78,39,39,74
Stirling,8678,3,17,6,13,64,53,11,57
Clyde,8678,4,15,9,12,53,48,5,54
Stenhousem'r,8678,5,15,8,13,57,50,7,53
Elgin,8678,6,15,6,15,54,60,-6,51
Annan Athlet,8678,7,11,11,14,47,43,4,44
Berwick,8678,8,8,10,18,29,60,-31,34
Edinburgh Ci,8678,9,7,10,19,37,61,-24,31
Cowdenbeath,8678,10,5,10,21,25,54,-29,25
Montrose,8679,1,24,7,5,64,35,29,79
Peterhead,8679,2,24,4,8,79,38,41,76
Stirling,8679,3,16,7,13,60,51,9,55
Stenhousem'r,8679,4,15,9,12,55,46,9,54
Clyde,8679,5,15,9,12,54,49,5,54
Elgin,8679,6,14,6,16,54,65,-11,48
Annan Athlet,8679,7,11,12,13,48,42,6,45
Berwick,8679,8,8,10,18,30,61,-31,34
Edinburgh Ci,8679,9,7,9,20,36,62,-26,30
Cowdenbeath,8679,10,4,11,21,24,55,-31,23
Montrose,8680,1,24,7,5,61,35,26,79
Peterhead,8680,2,23,5,8,79,40,39,74
Stirling,8680,3,17,6,13,61,51,10,57
Stenhousem'r,8680,4,15,8,13,55,47,8,53
Clyde,8680,5,14,9,13,51,49,2,51
Elgin,8680,6,14,6,16,54,62,-8,48
Annan Athlet,8680,7,11,11,14,48,44,4,44
Berwick,8680,8,9,10,17,30,58,-28,37
Edinburgh Ci,8680,9,7,10,19,38,62,-24,31
Cowdenbeath,8680,10,5,10,21,26,55,-29,25
Montrose,8681,1,24,7,5,61,34,27,79
Peterhead,8681,2,23,4,9,77,39,38,73
Stirling,8681,3,17,6,13,63,52,11,57
Clyde,8681,4,15,9,12,55,48,7,54
Stenhousem'r,8681,5,15,8,13,56,49,7,53
Elgin,8681,6,14,6,16,53,62,-9,48
Annan Athlet,8681,7,11,12,13,48,42,6,45
Berwick,8681,8,8,10,18,29,62,-33,34
Edinburgh Ci,8681,9,8,9,19,37,60,-23,33
Cowdenbeath,8681,10,4,11,21,24,55,-31,23
Montrose,8682,1,24,7,5,62,35,27,79
Peterhead,8682,2,24,4,8,80,38,42,76
Stenhousem'r,8682,3,16,8,12,58,47,11,56
Stirling,8682,4,16,6,14,61,54,7,54
Clyde,8682,5,15,9,12,54,48,6,54
Elgin,8682,6,14,6,16,54,63,-9,48
Annan Athlet,8682,7,11,12,13,50,44,6,45
Berwick,8682,8,8,10,18,29,61,-32,34
Edinburgh Ci,8682,9,7,9,20,36,63,-27,30
Cowdenbeath,8682,10,4,11,21,26,57,-31,23
Peterhead,8683,1,24,4,8,80,38,42,76
Montrose,8683,2,23,7,6,59,35,24,76
Stirling,8683,3,16,7,13,62,53,9,55
Stenhousem'r,8683,4,15,9,12,57,48,9,54
Clyde,8683,5,14,9,13,52,50,2,51
Elgin,8683,6,15,6,15,54,60,-6,51
Annan Athlet,8683,7,12,11,13,48,41,7,47
Berwick,8683,8,9,10,17,31,59,-28,37
Edinburgh Ci,8683,9,7,9,20,36,63,-27,30
Cowdenbeath,8683,10,4,10,22,23,55,-32,22
Montrose,8684,1,24,7,5,64,35,29,79
Peterhead,8684,2,24,4,8,80,38,42,76
Stenhousem'r,8684,3,16,8,12,59,48,11,56
Stirling,8684,4,16,6,14,62,55,7,54
Clyde,8684,5,15,9,12,53,49,4,54
Elgin,8684,6,14,6,16,54,65,-11,48
Annan Athlet,8684,7,11,12,13,49,43,6,45
Berwick,8684,8,8,10,18,30,60,-30,34
Edinburgh Ci,8684,9,7,9,20,36,63,-27,30
Cowdenbeath,8684,10,4,11,21,25,56,-31,23
Montrose,8685,1,23,8,5,59,34,25,77
Peterhead,8685,2,23,5,8,81,42,39,74
Stirling,8685,3,16,7,13,60,51,9,55
Stenhousem'r,8685,4,15,9,12,55,46,9,54
Clyde,8685,5,14,9,13,52,51,1,51
Elgin,8685,6,14,7,15,53,60,-7,49
Annan Athlet,8685,7,12,11,13,50,42,8,47
Berwick,8685,8,9,10,17,32,59,-27,37
Edinburgh Ci,8685,9,7,10,19,40,64,-24,31
Cowdenbeath,8685,10,4,10,22,24,57,-33,22
Montrose,8686,1,24,7,5,61,34,27,79
Peterhead,8686,2,23,5,8,79,40,39,74
Stirling,8686,3,17,6,13,61,51,10,57
Stenhousem'r,8686,4,15,8,13,55,47,8,53
Clyde,8686,5,14,10,12,52,49,3,52
Elgin,8686,6,14,6,16,53,62,-9,48
Annan Athlet,8686,7,11,11,14,47,42,5,44
Berwick,8686,8,8,11,17,30,59,-29,35
Edinburgh Ci,8686,9,7,10,19,38,62,-24,31
Cowdenbeath,8686,10,5,10,21,24,54,-30,25
Montrose,8687,1,24,7,5,60,34,26,79
Peterhead,8687,2,23,4,9,77,44,33,73
Stirling,8687,3,17,6,13,61,51,10,57
Clyde,8687,4,15,9,12,53,48,5,54
Stenhousem'r,8687,5,15,8,13,55,47,8,53
Elgin,8687,6,14,6,16,53,61,-8,48
Annan Athlet,8687,7,12,11,13,50,43,7,47
Berwick,8687,8,8,10,18,29,60,-31,34
Edinburgh Ci,8687,9,8,9,19,42,60,-18,33
Cowdenbeath,8687,10,4,10,22,25,57,-32,22
Montrose,8688,1,24,7,5,61,34,27,79
Peterhead,8688,2,24,4,8,80,38,42,76
Stirling,8688,3,17,6,13,63,51,12,57
Clyde,8688,4,15,9,12,54,48,6,54
Stenhousem'r,8688,5,15,8,13,55,49,6,53
Elgin,8688,6,14,6,16,53,62,-9,48
Annan Athlet,8688,7,11,11,14,48,43,5,44
Berwick,8688,8,8,10,18,29,61,-32,34
Edinburgh Ci,8688,9,7,9,20,36,63,-27,30
Cowdenbeath,8688,10,5,10,21,25,55,-30,25
Peterhead,8689,1,24,4,8,81,39,42,76
Montrose,8689,2,23,7,6,59,35,24,76
Stirling,8689,3,16,7,13,64,55,9,55
Stenhousem'r,8689,4,15,9,12,59,50,9,54
Clyde,8689,5,15,9,12,52,48,4,54
Elgin,8689,6,15,6,15,54,60,-6,51
Annan Athlet,8689,7,11,11,14,47,45,2,44
Berwick,8689,8,8,10,18,29,59,-30,34
Edinburgh Ci,8689,9,7,9,20,37,64,-27,30
Cowdenbeath,8689,10,5,10,21,27,54,-27,25
Peterhead,8690,1,24,4,8,78,38,40,76
Montrose,8690,2,23,7,6,60,36,24,76
Stirling,8690,3,17,6,13,62,51,11,57
Stenhousem'r,8690,4,15,8,13,55,48,7,53
Clyde,8690,5,14,10,12,52,49,3,52
Elgin,8690,6,15,6,15,55,61,-6,51
Annan Athlet,8690,7,11,11,14,47,42,5,44
Berwick,8690,8,8,11,17,30,59,-29,35
Edinburgh Ci,8690,9,7,9,20,36,61,-25,30
Cowdenbeath,8690,10,5,10,21,24,54,-30,25
Montrose,8691,1,23,8,5,61,36,25,77
Peterhead,8691,2,23,4,9,78,40,38,73
Stirling,8691,3,17,6,13,63,53,10,57
Stenhousem'r,8691,4,15,8,13,57,49,8,53
Clyde,8691,5,14,10,12,53,50,3,52
Elgin,8691,6,14,7,15,55,62,-7,49
Annan Athlet,8691,7,11,11,14,48,44,4,44
Berwick,8691,8,8,11,17,31,60,-29,35
Edinburgh Ci,8691,9,8,9,19,38,61,-23,33
Cowdenbeath,8691,10,5,10,21,26,55,-29,25
Montrose,8692,1,24,7,5,63,35,28,79
Peterhead,8692,2,24,4,8,80,39,41,76
Stirling,8692,3,17,6,13,63,53,10,57
Clyde,8692,4,15,9,12,54,49,5,54
Stenhousem'r,8692,5,15,8,13,57,49,8,53
Elgin,8692,6,14,6,16,54,64,-10,48
Annan Athlet,8692,7,12,11,13,50,43,7,47
Berwick,8692,8,8,10,18,30,61,-31,34
Edinburgh Ci,8692,9,7,9,20,37,63,-26,30
Cowdenbeath,8692,10,4,10,22,25,57,-32,22
Peterhead,8693,1,24,4,8,80,40,40,76
Montrose,8693,2,23,7,6,61,37,24,76
Stirling,8693,3,17,6,13,62,51,11,57
Stenhousem'r,8693,4,15,8,13,55,48,7,53
Clyde,8693,5,14,9,13,52,50,2,51
Elgin,8693,6,15,6,15,56,62,-6,51
Annan Athlet,8693,7,11,11,14,47,43,4,44
Berwick,8693,8,9,10,17,31,59,-28,37
Edinburgh Ci,8693,9,7,9,20,38,63,-25,30
Cowdenbeath,8693,10,5,10,21,25,54,-29,25
Montrose,8694,1,24,7,5,60,34,26,79
Peterhead,8694,2,23,5,8,77,38,39,74
Stirling,8694,3,17,6,13,63,52,11,57
Clyde,8694,4,15,9,12,53,48,5,54
Stenhousem'r,8694,5,15,8,13,56,49,7,53
Elgin,8694,6,14,6,16,53,61,-8,48
Annan Athlet,8694,7,12,11,13,50,43,7,47
Berwick,8694,8,8,10,18,29,60,-31,34
Edinburgh Ci,8694,9,7,10,19,36,60,-24,31
Cowdenbeath,8694,10,4,10,22,25,57,-32,22
Montrose,8695,1,24,7,5,64,34,30,79
Peterhead,8695,2,24,4,8,80,38,42,76
Stenhousem'r,8695,3,16,8,12,56,46,10,56
Stirling,8695,4,16,6,14,60,52,8,54
Clyde,8695,5,14,10,12,52,49,3,52
Elgin,8695,6,14,6,16,53,65,-12,48
Annan Athlet,8695,7,12,11,13,49,41,8,47
Berwick,8695,8,8,11,17,30,59,-29,35
Edinburgh Ci,8695,9,7,9,20,36,63,-27,30
Cowdenbeath,8695,10,4,10,22,23,56,-33,22
Montrose,8696,1,24,7,5,63,35,28,79
Peterhead,8696,2,24,4,8,78,38,40,76
Stenhousem'r,8696,3,16,8,12,57,46,11,56
Stirling,8696,4,16,6,14,60,53,7,54
Clyde,8696,5,15,9,12,54,49,5,54
Elgin,8696,6,14,6,16,54,64,-10,48
Annan Athlet,8696,7,11,11,14,47,42,5,44
Berwick,8696,8,8,10,18,30,61,-31,34
Edinburgh Ci,8696,9,7,9,20,36,61,-25,30
Cowdenbeath,8696,10,5,10,21,24,54,-30,25
Montrose,8697,1,24,7,5,62,35,27,79
Peterhead,8697,2,24,4,8,83,39,44,76
Stirling,8697,3,17,6,13,63,51,12,57
Stenhousem'r,8697,4,15,8,13,55,49,6,53
Clyde,8697,5,14,10,12,52,49,3,52
Elgin,8697,6,14,6,16,54,63,-9,48
Annan Athlet,8697,7,11,12,13,48,42,6,45
Berwick,8697,8,8,11,17,30,59,-29,35
Edinburgh Ci,8697,9,7,9,20,37,66,-29,30
Cowdenbeath,8697,10,4,11,21,24,55,-31,23
Peterhead,8698,1,24,4,8,80,40,40,76
Montrose,8698,2,23,7,6,60,36,24,76
Stirling,8698,3,17,6,13,61,51,10,57
Clyde,8698,4,15,9,12,54,48,6,54
Stenhousem'r,8698,5,15,8,13,55,47,8,53
Elgin,8698,6,15,6,15,55,61,-6,51
Annan Athlet,8698,7,12,11,13,51,43,8,47
Berwick,8698,8,8,10,18,29,61,-32,34
Edinburgh Ci,8698,9,7,9,20,38,63,-25,30
Cowdenbeath,8698,10,4,10,22,25,58,-33,22
Montrose,8699,1,24,7,5,62,35,27,79
Peterhead,8699,2,24,4,8,80,39,41,76
Stirling,8699,3,16,7,13,63,54,9,55
Stenhousem'r,8699,4,15,9,12,58,49,9,54
Clyde,8699,5,15,9,12,53,48,5,54
Elgin,8699,6,14,6,16,54,63,-9,48
Annan Athlet,8699,7,12,11,13,49,42,7,47
Berwick,8699,8,8,10,18,29,60,-31,34
Edinburgh Ci,8699,9,7,9,20,37,63,-26,30
Cowdenbeath,8699,10,4,10,22,24,56,-32,22
Montrose,8700,1,24,7,5,62,34,28,79
Peterhead,8700,2,24,4,8,81,38,43,76
Stirling,8700,3,17,6,13,63,52,11,57
Clyde,8700,4,15,9,12,54,49,5,54
Stenhousem'r,8700,5,15,8,13,56,49,7,53
Elgin,8700,6,14,6,16,53,63,-10,48
Annan Athlet,8700,7,11,12,13,47,41,6,45
Berwick,8700,8,8,10,18,30,61,-31,34
Edinburgh Ci,8700,9,7,9,20,36,64,-28,30
Cowdenbeath,8700,10,4,11,21,23,54,-31,23
Montrose,8701,1,24,7,5,61,35,26,79
Peterhead,8701,2,24,4,8,79,38,41,76
Stirling,8701,3,17,6,13,62,52,10,57
Clyde,8701,4,15,9,12,53,48,5,54
Stenhousem'r,8701,5,15,8,13,56,48,8,53
Elgin,8701,6,14,6,16,54,62,-8,48
Annan Athlet,8701,7,11,12,13,48,42,6,45
Berwick,8701,8,8,10,18,29,60,-31,34
Edinburgh Ci,8701,9,7,9,20,36,62,-26,30
Cowdenbeath,8701,10,4,11,21,24,55,-31,23
Montrose,8702,1,24,7,5,61,34,27,79
Peterhead,8702,2,24,4,8,80,38,42,76
Stenhousem'r,8702,3,16,8,12,57,47,10,56
Stirling,8702,4,16,6,14,61,53,8,54
Clyde,8702,5,15,9,12,55,51,4,54
Elgin,8702,6,14,6,16,53,62,-9,48
Annan Athlet,8702,7,12,11,13,48,41,7,47
Berwick,8702,8,8,10,18,32,62,-30,34
Edinburgh Ci,8702,9,7,9,20,36,63,-27,30
Cowdenbeath,8702,10,4,10,22,23,55,-32,22
Montrose,8703,1,23,7,6,60,37,23,76
Peterhead,8703,2,23,4,9,78,40,38,73
Stirling,8703,3,17,6,13,62,52,10,57
Stenhousem'r,8703,4,15,8,13,56,48,8,53
Clyde,8703,5,14,10,12,52,49,3,52
Elgin,8703,6,15,6,15,56,61,-5,51
Annan Athlet,8703,7,11,12,13,48,42,6,45
Berwick,8703,8,8,11,17,30,59,-29,35
Edinburgh Ci,8703,9,8,9,19,38,61,-23,33
Cowdenbeath,8703,10,4,11,21,24,55,-31,23
Montrose,8704,1,24,7,5,62,35,27,79
Peterhead,8704,2,24,4,8,78,38,40,76
Stirling,8704,3,17,6,13,62,52,10,57
Clyde,8704,4,15,9,12,52,48,4,54
Stenhousem'r,8704,5,15,8,13,56,48,8,53
Elgin,8704,6,14,6,16,54,63,-9,48
Annan Athlet,8704,7,12,11,13,48,41,7,47
Berwick,8704,8,8,10,18,29,59,-30,34
Edinburgh Ci,8704,9,7,9,20,36,61,-25,30
Cowdenbeath,8704,10,4,10,22,23,55,-32,22
Montrose,8705,1,23,8,5,59,34,25,77
Peterhead,8705,2,24,4,8,80,39,41,76
Stirling,8705,3,17,6,13,62,52,10,57
Stenhousem'r,8705,4,15,8,13,56,48,8,53
Clyde,8705,5,14,10,12,51,48,3,52
Elgin,8705,6,14,7,15,53,60,-7,49
Annan Athlet,8705,7,11,11,14,47,42,5,44
Berwick,8705,8,8,11,17,29,58,-29,35
Edinburgh Ci,8705,9,7,9,20,37,63,-26,30
Cowdenbeath,8705,10,5,10,21,24,54,-30,25
Montrose,8706,1,23,8,5,62,37,25,77
Peterhead,8706,2,24,4,8,82,39,43,76
Stirling,8706,3,16,7,13,61,52,9,55
Stenhousem'r,8706,4,15,9,12,56,47,9,54
Clyde,8706,5,14,9,13,51,50,1,51
Elgin,8706,6,14,7,15,56,63,-7,49
Annan Athlet,8706,7,12,11,13,48,41,7,47
Berwick,8706,8,9,10,17,31,58,-27,37
Edinburgh Ci,8706,9,7,9,20,37,65,-28,30
Cowdenbeath,8706,10,4,10,22,23,55,-32,22
Peterhead,8707,1,24,4,8,81,38,43,76
Montrose,8707,2,23,7,6,60,38,22,76
Stirling,8707,3,16,7,13,63,54,9,55
Stenhousem'r,8707,4,15,9,12,58,49,9,54
Clyde,8707,5,14,9,13,51,49,2,51
Elgin,8707,6,15,6,15,57,61,-4,51
Annan Athlet,8707,7,11,12,13,47,41,6,45
Berwick,8707,8,9,10,17,30,58,-28,37
Edinburgh Ci,8707,9,7,9,20,36,64,-28,30
Cowdenbeath,8707,10,4,11,21,23,54,-31,23
Montrose,8708,1,23,8,5,60,35,25,77
Peterhead,8708,2,24,4,8,79,38,41,76
Stenhousem'r,8708,3,16,8,12,58,47,11,56
Stirling,8708,4,16,6,14,61,54,7,54
Clyde,8708,5,15,9,12,55,49,6,54
Elgin,8708,6,14,7,15,54,61,-7,49
Annan Athlet,8708,7,11,12,13,48,42,6,45
Berwick,8708,8,8,10,18,30,62,-32,34
Edinburgh Ci,8708,9,7,9,20,36,62,-26,30
Cowdenbeath,8708,10,4,11,21,24,55,-31,23
Montrose,8709,1,24,7,5,61,35,26,79
Peterhead,8709,2,24,4,8,80,39,41,76
Stirling,8709,3,17,6,13,62,51,11,57
Stenhousem'r,8709,4,15,8,13,55,48,7,53
Clyde,8709,5,14,9,13,51,49,2,51
Elgin,8709,6,14,6,16,54,62,-8,48
Annan Athlet,8709,7,11,11,14,47,42,5,44
Berwick,8709,8,9,10,17,30,58,-28,37
Edinburgh Ci,8709,9,7,9,20,37,63,-26,30
Cowdenbeath,8709,10,5,10,21,24,54,-30,25
Montrose,8710,1,23,8,5,60,35,25,77
Peterhead,8710,2,24,4,8,79,39,40,76
Stenhousem'r,8710,3,16,8,12,57,46,11,56
Stirling,8710,4,16,6,14,60,53,7,54
Clyde,8710,5,15,9,12,53,48,5,54
Elgin,8710,6,14,7,15,54,61,-7,49
Annan Athlet,8710,7,12,11,13,50,42,8,47
Berwick,8710,8,8,10,18,29,60,-31,34
Edinburgh Ci,8710,9,7,9,20,37,62,-25,30
Cowdenbeath,8710,10,4,10,22,24,57,-33,22
Montrose,8711,1,24,7,5,61,35,26,79
Peterhead,8711,2,24,4,8,78,38,40,76
Stirling,8711,3,16,7,13,61,52,9,55
Stenhousem'r,8711,4,15,9,12,56,47,9,54
Clyde,8711,5,15,9,12,54,49,5,54
Elgin,8711,6,14,6,16,54,62,-8,48
Annan Athlet,8711,7,11,11,14,47,42,5,44
Berwick,8711,8,8,10,18,30,61,-31,34
Edinburgh Ci,8711,9,7,9,20,36,61,-25,30
Cowdenbeath,8711,10,5,10,21,24,54,-30,25
Montrose,8712,1,24,7,5,66,34,32,79
Peterhead,8712,2,24,4,8,80,38,42,76
Stirling,8712,3,17,6,13,63,53,10,57
Stenhousem'r,8712,4,15,8,13,57,49,8,53
Clyde,8712,5,14,10,12,52,49,3,52
Elgin,8712,6,14,6,16,53,67,-14,48
Annan Athlet,8712,7,11,12,13,48,42,6,45
Berwick,8712,8,8,11,17,30,59,-29,35
Edinburgh Ci,8712,9,7,9,20,36,63,-27,30
Cowdenbeath,8712,10,4,11,21,24,55,-31,23
Montrose,8713,1,23,8,5,59,34,25,77
Peterhead,8713,2,24,4,8,79,38,41,76
Stirling,8713,3,17,6,13,64,51,13,57
Clyde,8713,4,15,9,12,55,48,7,54
Stenhousem'r,8713,5,15,8,13,55,50,5,53
Elgin,8713,6,14,7,15,53,60,-7,49
Annan Athlet,8713,7,11,11,14,48,43,5,44
Berwick,8713,8,8,10,18,29,62,-33,34
Edinburgh Ci,8713,9,7,9,20,36,62,-26,30
Cowdenbeath,8713,10,5,10,21,25,55,-30,25
Montrose,8714,1,24,7,5,61,34,27,79
Peterhead,8714,2,24,4,8,80,39,41,76
Stirling,8714,3,17,6,13,63,51,12,57
Clyde,8714,4,15,9,12,55,49,6,54
Stenhousem'r,8714,5,15,8,13,55,49,6,53
Elgin,8714,6,14,6,16,53,62,-9,48
Annan Athlet,8714,7,11,12,13,49,43,6,45
Berwick,8714,8,8,10,18,30,62,-32,34
Edinburgh Ci,8714,9,7,9,20,37,63,-26,30
Cowdenbeath,8714,10,4,11,21,25,56,-31,23
Montrose,8715,1,24,7,5,62,34,28,79
Peterhead,8715,2,23,5,8,79,40,39,74
Stirling,8715,3,16,7,13,60,51,9,55
Stenhousem'r,8715,4,15,9,12,55,46,9,54
Clyde,8715,5,15,9,12,52,48,4,54
Elgin,8715,6,14,6,16,53,63,-10,48
Annan Athlet,8715,7,12,11,13,48,41,7,47
Berwick,8715,8,8,10,18,29,59,-30,34
Edinburgh Ci,8715,9,7,10,19,38,62,-24,31
Cowdenbeath,8715,10,4,10,22,23,55,-32,22
Montrose,8716,1,23,8,5,60,35,25,77
Peterhead,8716,2,24,4,8,82,39,43,76
Stenhousem'r,8716,3,16,8,12,58,48,10,56
Stirling,8716,4,16,6,14,62,54,8,54
Clyde,8716,5,15,9,12,54,48,6,54
Elgin,8716,6,14,7,15,54,61,-7,49
Annan Athlet,8716,7,11,12,13,47,41,6,45
Berwick,8716,8,8,10,18,29,61,-32,34
Edinburgh Ci,8716,9,7,9,20,37,65,-28,30
Cowdenbeath,8716,10,4,11,21,23,54,-31,23
Peterhead,8717,1,24,4,8,79,38,41,76
Montrose,8717,2,23,7,6,59,36,23,76
Stenhousem'r,8717,3,16,8,12,56,46,10,56
Stirling,8717,4,16,6,14,60,52,8,54
Clyde,8717,5,14,9,13,52,50,2,51
Elgin,8717,6,15,6,15,55,60,-5,51
Annan Athlet,8717,7,12,11,13,48,41,7,47
Berwick,8717,8,9,10,17,31,59,-28,37
Edinburgh Ci,8717,9,7,9,20,36,62,-26,30
Cowdenbeath,8717,10,4,10,22,23,55,-32,22
Montrose,8718,1,24,7,5,61,35,26,79
Peterhead,8718,2,23,5,8,78,39,39,74
Stenhousem'r,8718,3,16,8,12,57,46,11,56
Stirling,8718,4,16,6,14,60,53,7,54
Clyde,8718,5,15,9,12,54,49,5,54
Elgin,8718,6,14,6,16,54,62,-8,48
Annan Athlet,8718,7,12,11,13,49,42,7,47
Berwick,8718,8,8,10,18,30,61,-31,34
Edinburgh Ci,8718,9,7,10,19,37,61,-24,31
Cowdenbeath,8718,10,4,10,22,24,56,-32,22
Montrose,8719,1,24,7,5,60,34,26,79
Peterhead,8719,2,24,4,8,82,39,43,76
Stirling,8719,3,16,7,13,61,52,9,55
Stenhousem'r,8719,4,15,9,12,56,47,9,54
Clyde,8719,5,14,9,13,51,49,2,51
Elgin,8719,6,14,6,16,53,61,-8,48
Annan Athlet,8719,7,12,11,13,48,41,7,47
Berwick,8719,8,9,10,17,30,58,-28,37
Edinburgh Ci,8719,9,7,9,20,37,65,-28,30
Cowdenbeath,8719,10,4,10,22,23,55,-32,22
Peterhead,8720,1,24,4,8,83,38,45,76
Montrose,8720,2,23,7,6,59,36,23,76
Stirling,8720,3,17,6,13,65,53,12,57
Stenhousem'r,8720,4,15,8,13,57,51,6,53
Clyde,8720,5,14,10,12,52,49,3,52
Elgin,8720,6,15,6,15,55,60,-5,51
Annan Athlet,8720,7,12,11,13,52,42,10,47
Berwick,8720,8,8,11,17,30,59,-29,35
Edinburgh Ci,8720,9,7,9,20,36,66,-30,30
Cowdenbeath,8720,10,4,10,22,24,59,-35,22
Peterhead,8721,1,24,4,8,79,39,40,76
Montrose,8721,2,23,7,6,59,36,23,76
Stirling,8721,3,17,6,13,63,52,11,57
Clyde,8721,4,15,9,12,53,49,4,54
Stenhousem'r,8721,5,15,8,13,56,49,7,53
Elgin,8721,6,15,6,15,55,60,-5,51
Annan Athlet,8721,7,11,11,14,48,43,5,44
Berwick,8721,8,8,10,18,30,60,-30,34
Edinburgh Ci,8721,9,7,9,20,37,62,-25,30
Cowdenbeath,8721,10,5,10,21,25,55,-30,25
Montrose,8722,1,24,7,5,60,34,26,79
Peterhead,8722,2,23,4,9,77,40,37,73
Stirling,8722,3,16,7,13,61,52,9,55
Stenhousem'r,8722,4,15,9,12,56,47,9,54
Clyde,8722,5,14,9,13,51,49,2,51
Elgin,8722,6,14,6,16,53,61,-8,48
Annan Athlet,8722,7,11,11,14,47,42,5,44
Berwick,8722,8,9,10,17,30,58,-28,37
Edinburgh Ci,8722,9,8,9,19,38,60,-22,33
Cowdenbeath,8722,10,5,10,21,24,54,-30,25
Montrose,8723,1,24,7,5,63,36,27,79
Peterhead,8723,2,24,4,8,80,39,41,76
Stenhousem'r,8723,3,16,8,12,57,47,10,56
Stirling,8723,4,16,6,14,61,53,8,54
Clyde,8723,5,15,9,12,52,48,4,54
Elgin,8723,6,14,6,16,55,64,-9,48
Annan Athlet,8723,7,12,11,13,49,41,8,47
Berwick,8723,8,8,10,18,29,59,-30,34
Edinburgh Ci,8723,9,7,9,20,37,63,-26,30
Cowdenbeath,8723,10,4,10,22,23,56,-33,22
Montrose,8724,1,24,7,5,62,36,26,79
Peterhead,8724,2,24,4,8,80,38,42,76
Stirling,8724,3,17,6,13,62,52,10,57
Stenhousem'r,8724,4,15,8,13,56,48,8,53
Clyde,8724,5,14,9,13,53,51,2,51
Elgin,8724,6,14,6,16,55,63,-8,48
Annan Athlet,8724,7,12,11,13,49,42,7,47
Berwick,8724,8,9,10,17,32,60,-28,37
Edinburgh Ci,8724,9,7,9,20,36,63,-27,30
Cowdenbeath,8724,10,4,10,22,24,56,-32,22
Montrose,8725,1,24,7,5,64,34,30,79
Peterhead,8725,2,24,4,8,78,38,40,76
Stirling,8725,3,17,6,13,61,51,10,57
Stenhousem'r,8725,4,15,8,13,55,47,8,53
Clyde,8725,5,14,9,13,53,51,2,51
Elgin,8725,6,14,6,16,53,65,-12,48
Annan Athlet,8725,7,11,11,14,47,42,5,44
Berwick,8725,8,9,10,17,32,60,-28,37
Edinburgh Ci,8725,9,7,9,20,36,61,-25,30
Cowdenbeath,8725,10,5,10,21,24,54,-30,25
Montrose,8726,1,24,7,5,63,35,28,79
Peterhead,8726,2,24,4,8,81,39,42,76
Stirling,8726,3,17,6,13,62,51,11,57
Clyde,8726,4,15,9,12,58,48,10,54
Stenhousem'r,8726,5,15,8,13,55,48,7,53
Elgin,8726,6,14,6,16,54,64,-10,48
Annan Athlet,8726,7,12,11,13,50,41,9,47
Berwick,8726,8,8,10,18,29,65,-36,34
Edinburgh Ci,8726,9,7,9,20,37,64,-27,30
Cowdenbeath,8726,10,4,10,22,23,57,-34,22
Montrose,8727,1,24,7,5,62,34,28,79
Peterhead,8727,2,24,4,8,82,38,44,76
Stirling,8727,3,17,6,13,61,51,10,57
Clyde,8727,4,15,9,12,55,48,7,54
Stenhousem'r,8727,5,15,8,13,55,47,8,53
Elgin,8727,6,14,6,16,53,63,-10,48
Annan Athlet,8727,7,11,11,14,47,42,5,44
Berwick,8727,8,8,10,18,29,62,-33,34
Edinburgh Ci,8727,9,7,9,20,36,65,-29,30
Cowdenbeath,8727,10,5,10,21,24,54,-30,25
Montrose,8728,1,24,7,5,63,37,26,79
Peterhead,8728,2,23,4,9,77,39,38,73
Stenhousem'r,8728,3,16,8,12,57,47,10,56
Stirling,8728,4,16,6,14,61,53,8,54
Clyde,8728,5,15,9,12,53,49,4,54
Elgin,8728,6,14,6,16,56,64,-8,48
Annan Athlet,8728,7,11,12,13,48,42,6,45
Berwick,8728,8,8,10,18,30,60,-30,34
Edinburgh Ci,8728,9,8,9,19,37,60,-23,33
Cowdenbeath,8728,10,4,11,21,24,55,-31,23
Montrose,8729,1,24,7,5,63,35,28,79
Peterhead,8729,2,23,5,8,77,38,39,74
Stirling,8729,3,16,7,13,62,53,9,55
Stenhousem'r,8729,4,15,9,12,57,48,9,54
Clyde,8729,5,15,9,12,54,49,5,54
Elgin,8729,6,14,6,16,54,64,-10,48
Annan Athlet,8729,7,11,11,14,48,43,5,44
Berwick,8729,8,8,10,18,30,61,-31,34
Edinburgh Ci,8729,9,7,10,19,36,60,-24,31
Cowdenbeath,8729,10,5,10,21,25,55,-30,25
Montrose,8730,1,24,7,5,61,35,26,79
Peterhead,8730,2,24,4,8,81,39,42,76
Stirling,8730,3,17,6,13,62,52,10,57
Clyde,8730,4,15,9,12,52,48,4,54
Stenhousem'r,8730,5,15,8,13,56,48,8,53
Elgin,8730,6,14,6,16,54,62,-8,48
Annan Athlet,8730,7,12,11,13,48,41,7,47
Berwick,8730,8,8,10,18,29,59,-30,34
Edinburgh Ci,8730,9,7,9,20,37,64,-27,30
Cowdenbeath,8730,10,4,10,22,23,55,-32,22
Montrose,8731,1,24,7,5,63,37,26,79
Peterhead,8731,2,24,4,8,81,38,43,76
Stirling,8731,3,17,6,13,63,51,12,57
Clyde,8731,4,15,9,12,54,50,4,54
Stenhousem'r,8731,5,15,8,13,55,49,6,53
Elgin,8731,6,14,6,16,56,64,-8,48
Annan Athlet,8731,7,12,11,13,50,42,8,47
Berwick,8731,8,8,10,18,31,61,-30,34
Edinburgh Ci,8731,9,7,9,20,36,64,-28,30
Cowdenbeath,8731,10,4,10,22,24,57,-33,22
Montrose,8732,1,23,8,5,60,35,25,77
Peterhead,8732,2,24,4,8,78,38,40,76
Stirling,8732,3,16,7,13,61,52,9,55
Stenhousem'r,8732,4,15,9,12,56,47,9,54
Clyde,8732,5,15,9,12,53,49,4,54
Elgin,8732,6,14,7,15,54,61,-7,49
Annan Athlet,8732,7,11,11,14,47,43,4,44
Berwick,8732,8,8,10,18,30,60,-30,34
Edinburgh Ci,8732,9,7,9,20,36,61,-25,30
Cowdenbeath,8732,10,5,10,21,25,54,-29,25
Montrose,8733,1,24,7,5,62,36,26,79
Peterhead,8733,2,24,4,8,79,39,40,76
Stirling,8733,3,16,7,13,61,52,9,55
Stenhousem'r,8733,4,15,9,12,56,47,9,54
Clyde,8733,5,14,9,13,51,50,1,51
Elgin,8733,6,14,6,16,55,63,-8,48
Annan Athlet,8733,7,12,11,13,50,43,7,47
Berwick,8733,8,9,10,17,31,58,-27,37
Edinburgh Ci,8733,9,7,9,20,37,62,-25,30
Cowdenbeath,8733,10,4,10,22,25,57,-32,22
Peterhead,8734,1,24,4,8,83,39,44,76
Montrose,8734,2,23,7,6,59,35,24,76
Stirling,8734,3,17,6,13,65,51,14,57
Clyde,8734,4,15,9,12,53,48,5,54
Stenhousem'r,8734,5,15,8,13,55,51,4,53
Elgin,8734,6,15,6,15,54,60,-6,51
Annan Athlet,8734,7,11,12,13,48,42,6,45
Berwick,8734,8,8,10,18,29,60,-31,34
Edinburgh Ci,8734,9,7,9,20,37,66,-29,30
Cowdenbeath,8734,10,4,11,21,24,55,-31,23
Montrose,8735,1,24,7,5,61,35,26,79
Peterhead,8735,2,23,4,9,79,41,38,73
Stirling,8735,3,17,6,13,62,52,10,57
Stenhousem'r,8735,4,15,8,13,56,48,8,53
Clyde,8735,5,14,10,12,53,50,3,52
Elgin,8735,6,14,6,16,54,62,-8,48
Annan Athlet,8735,7,11,11,14,48,43,5,44
Berwick,8735,8,8,11,17,31,60,-29,35
Edinburgh Ci,8735,9,8,9,19,39,62,-23,33
Cowdenbeath,8735,10,5,10,21,25,55,-30,25
Montrose,8736,1,24,7,5,62,35,27,79
Peterhead,8736,2,24,4,8,79,38,41,76
Stenhousem'r,8736,3,16,8,12,57,46,11,56
Stirling,8736,4,16,6,14,60,53,7,54
Clyde,8736,5,15,9,12,53,48,5,54
Elgin,8736,6,14,6,16,54,63,-9,48
Annan Athlet,8736,7,11,11,14,47,42,5,44
Berwick,8736,8,8,10,18,29,60,-31,34
Edinburgh Ci,8736,9,7,9,20,36,62,-26,30
Cowdenbeath,8736,10,5,10,21,24,54,-30,25
Montrose,8737,1,24,7,5,62,34,28,79
Peterhead,8737,2,23,4,9,77,39,38,73
Stirling,8737,3,17,6,13,63,51,12,57
Clyde,8737,4,15,9,12,53,48,5,54
Stenhousem'r,8737,5,15,8,13,55,49,6,53
Elgin,8737,6,14,6,16,53,63,-10,48
Annan Athlet,8737,7,11,11,14,48,43,5,44
Berwick,8737,8,8,10,18,29,60,-31,34
Edinburgh Ci,8737,9,8,9,19,37,60,-23,33
Cowdenbeath,8737,10,5,10,21,25,55,-30,25
Montrose,8738,1,24,7,5,61,34,27,79
Peterhead,8738,2,23,5,8,79,40,39,74
Stirling,8738,3,17,6,13,62,51,11,57
Stenhousem'r,8738,4,15,8,13,55,48,7,53
Clyde,8738,5,14,9,13,51,49,2,51
Elgin,8738,6,14,6,16,53,62,-9,48
Annan Athlet,8738,7,11,12,13,48,42,6,45
Berwick,8738,8,9,10,17,30,58,-28,37
Edinburgh Ci,8738,9,7,10,19,38,62,-24,31
Cowdenbeath,8738,10,4,11,21,24,55,-31,23
Montrose,8739,1,23,8,5,62,37,25,77
Peterhead,8739,2,24,4,8,79,39,40,76
Stirling,8739,3,17,6,13,63,53,10,57
Clyde,8739,4,15,9,12,54,48,6,54
Stenhousem'r,8739,5,15,8,13,57,49,8,53
Elgin,8739,6,14,7,15,56,63,-7,49
Annan Athlet,8739,7,11,11,14,47,43,4,44
Berwick,8739,8,8,10,18,29,61,-32,34
Edinburgh Ci,8739,9,7,9,20,37,62,-25,30
Cowdenbeath,8739,10,5,10,21,25,54,-29,25
Montrose,8740,1,24,7,5,60,34,26,79
Peterhead,8740,2,24,4,8,81,38,43,76
Stirling,8740,3,17,6,13,61,51,10,57
Clyde,8740,4,15,9,12,54,50,4,54
Stenhousem'r,8740,5,15,8,13,55,47,8,53
Elgin,8740,6,14,6,16,53,61,-8,48
Annan Athlet,8740,7,12,11,13,48,41,7,47
Berwick,8740,8,8,10,18,31,61,-30,34
Edinburgh Ci,8740,9,7,9,20,36,64,-28,30
Cowdenbeath,8740,10,4,10,22,23,55,-32,22
Peterhead,8741,1,24,4,8,79,38,41,76
Montrose,8741,2,23,7,6,61,37,24,76
Stenhousem'r,8741,3,16,8,12,58,48,10,56
Stirling,8741,4,16,6,14,62,54,8,54
Clyde,8741,5,14,10,12,53,50,3,52
Elgin,8741,6,15,6,15,56,62,-6,51
Annan Athlet,8741,7,12,11,13,49,41,8,47
Berwick,8741,8,8,11,17,31,60,-29,35
Edinburgh Ci,8741,9,7,9,20,36,62,-26,30
Cowdenbeath,8741,10,4,10,22,23,56,-33,22
Montrose,8742,1,23,8,5,59,34,25,77
Peterhead,8742,2,23,5,8,79,40,39,74
Stirling,8742,3,16,7,13,62,53,9,55
Stenhousem'r,8742,4,15,9,12,57,48,9,54
Clyde,8742,5,14,9,13,51,49,2,51
Elgin,8742,6,14,7,15,53,60,-7,49
Annan Athlet,8742,7,12,11,13,50,42,8,47
Berwick,8742,8,9,10,17,30,58,-28,37
Edinburgh Ci,8742,9,7,10,19,38,62,-24,31
Cowdenbeath,8742,10,4,10,22,24,57,-33,22
Montrose,8743,1,23,8,5,60,35,25,77
Peterhead,8743,2,24,4,8,80,38,42,76
Stenhousem'r,8743,3,16,8,12,58,47,11,56
Stirling,8743,4,16,6,14,61,54,7,54
Clyde,8743,5,15,9,12,53,48,5,54
Elgin,8743,6,14,7,15,54,61,-7,49
Annan Athlet,8743,7,12,11,13,49,41,8,47
Berwick,8743,8,8,10,18,29,60,-31,34
Edinburgh Ci,8743,9,7,9,20,36,63,-27,30
Cowdenbeath,8743,10,4,10,22,23,56,-33,22
Montrose,8744,1,24,7,5,61,35,26,79
Peterhead,8744,2,23,5,8,78,39,39,74
Stenhousem'r,8744,3,16,8,12,57,47,10,56
Stirling,8744,4,16,6,14,61,53,8,54
Clyde,8744,5,15,9,12,54,49,5,54
Elgin,8744,6,14,6,16,54,62,-8,48
Annan Athlet,8744,7,12,11,13,50,41,9,47
Berwick,8744,8,8,10,18,30,61,-31,34
Edinburgh Ci,8744,9,7,10,19,37,61,-24,31
Cowdenbeath,8744,10,4,10,22,23,57,-34,22
Montrose,8745,1,24,7,5,61,34,27,79
Peterhead,8745,2,23,5,8,80,41,39,74
Stirling,8745,3,17,6,13,63,53,10,57
Clyde,8745,4,15,9,12,53,48,5,54
Stenhousem'r,8745,5,15,8,13,57,49,8,53
Elgin,8745,6,14,6,16,53,62,-9,48
Annan Athlet,8745,7,12,11,13,49,41,8,47
Berwick,8745,8,8,10,18,29,60,-31,34
Edinburgh Ci,8745,9,7,10,19,39,63,-24,31
Cowdenbeath,8745,10,4,10,22,23,56,-33,22
Montrose,8746,1,24,7,5,63,34,29,79
Peterhead,8746,2,23,4,9,78,42,36,73
Stirling,8746,3,16,7,13,63,54,9,55
Stenhousem'r,8746,4,15,9,12,58,49,9,54
Clyde,8746,5,14,10,12,52,49,3,52
Elgin,8746,6,14,6,16,53,64,-11,48
Annan Athlet,8746,7,12,11,13,48,41,7,47
Berwick,8746,8,8,11,17,30,59,-29,35
Edinburgh Ci,8746,9,8,9,19,40,61,-21,33
Cowdenbeath,8746,10,4,10,22,23,55,-32,22
Montrose,8747,1,23,8,5,60,35,25,77
Peterhead,8747,2,24,4,8,80,39,41,76
Stirling,8747,3,17,6,13,62,51,11,57
Clyde,8747,4,15,9,12,56,49,7,54
Stenhousem'r,8747,5,15,8,13,55,48,7,53
Elgin,8747,6,14,7,15,54,61,-7,49
Annan Athlet,8747,7,12,11,13,50,42,8,47
Berwick,8747,8,8,10,18,30,63,-33,34
Edinburgh Ci,8747,9,7,9,20,37,63,-26,30
Cowdenbeath,8747,10,4,10,22,24,57,-33,22
Montrose,8748,1,24,7,5,60,34,26,79
Peterhead,8748,2,24,4,8,80,39,41,76
Stirling,8748,3,17,6,13,63,51,12,57
Stenhousem'r,8748,4,15,8,13,55,49,6,53
Clyde,8748,5,14,10,12,52,49,3,52
Elgin,8748,6,14,6,16,53,61,-8,48
Annan Athlet,8748,7,12,11,13,48,41,7,47
Berwick,8748,8,8,11,17,30,59,-29,35
Edinburgh Ci,8748,9,7,9,20,37,63,-26,30
Cowdenbeath,8748,10,4,10,22,23,55,-32,22
Montrose,8749,1,24,7,5,61,34,27,79
Peterhead,8749,2,24,4,8,80,38,42,76
Stenhousem'r,8749,3,16,8,12,57,47,10,56
Stirling,8749,4,16,6,14,61,53,8,54
Clyde,8749,5,15,9,12,53,48,5,54
Elgin,8749,6,14,6,16,53,62,-9,48
Annan Athlet,8749,7,11,11,14,48,44,4,44
Berwick,8749,8,8,10,18,29,60,-31,34
Edinburgh Ci,8749,9,7,9,20,36,63,-27,30
Cowdenbeath,8749,10,5,10,21,26,55,-29,25
Montrose,8750,1,24,7,5,62,35,27,79
Peterhead,8750,2,24,4,8,80,38,42,76
Stenhousem'r,8750,3,16,8,12,60,48,12,56
Stirling,8750,4,16,6,14,62,56,6,54
Clyde,8750,5,15,9,12,54,49,5,54
Elgin,8750,6,14,6,16,54,63,-9,48
Annan Athlet,8750,7,11,11,14,47,42,5,44
Berwick,8750,8,8,10,18,30,61,-31,34
Edinburgh Ci,8750,9,7,9,20,36,63,-27,30
Cowdenbeath,8750,10,5,10,21,24,54,-30,25
Montrose,8751,1,24,7,5,61,35,26,79
Peterhead,8751,2,24,4,8,80,39,41,76
Stirling,8751,3,17,6,13,63,52,11,57
Stenhousem'r,8751,4,15,8,13,56,49,7,53
Clyde,8751,5,14,9,13,53,51,2,51
Elgin,8751,6,14,6,16,54,62,-8,48
Annan Athlet,8751,7,12,11,13,49,41,8,47
Berwick,8751,8,9,10,17,32,60,-28,37
Edinburgh Ci,8751,9,7,9,20,37,63,-26,30
Cowdenbeath,8751,10,4,10,22,23,56,-33,22
Peterhead,8752,1,24,4,8,79,38,41,76
Montrose,8752,2,23,7,6,59,35,24,76
Stirling,8752,3,17,6,13,64,53,11,57
Stenhousem'r,8752,4,15,8,13,57,50,7,53
Clyde,8752,5,14,10,12,52,49,3,52
Elgin,8752,6,15,6,15,54,60,-6,51
Annan Athlet,8752,7,11,12,13,47,41,6,45
Berwick,8752,8,8,11,17,30,59,-29,35
Edinburgh Ci,8752,9,7,9,20,36,62,-26,30
Cowdenbeath,8752,10,4,11,21,23,54,-31,23
Montrose,8753,1,23,8,5,60,35,25,77
Peterhead,8753,2,24,4,8,79,39,40,76
Stirling,8753,3,17,6,13,65,53,12,57
Stenhousem'r,8753,4,15,8,13,57,51,6,53
Clyde,8753,5,14,10,12,52,49,3,52
Elgin,8753,6,14,7,15,54,61,-7,49
Annan Athlet,8753,7,11,11,14,47,43,4,44
Berwick,8753,8,8,11,17,30,59,-29,35
Edinburgh Ci,8753,9,7,9,20,37,62,-25,30
Cowdenbeath,8753,10,5,10,21,25,54,-29,25
Montrose,8754,1,23,8,5,60,35,25,77
Peterhead,8754,2,24,4,8,82,38,44,76
Stirling,8754,3,17,6,13,64,52,12,57
Stenhousem'r,8754,4,15,8,13,56,50,6,53
Clyde,8754,5,14,10,12,51,48,3,52
Elgin,8754,6,14,7,15,54,61,-7,49
Annan Athlet,8754,7,11,11,14,47,42,5,44
Berwick,8754,8,8,11,17,29,58,-29,35
Edinburgh Ci,8754,9,7,9,20,36,65,-29,30
Cowdenbeath,8754,10,5,10,21,24,54,-30,25
Montrose,8755,1,23,8,5,61,36,25,77
Peterhead,8755,2,24,4,8,78,38,40,76
Stirling,8755,3,17,6,13,63,53,10,57
Clyde,8755,4,15,9,12,53,49,4,54
Stenhousem'r,8755,5,15,8,13,57,49,8,53
Elgin,8755,6,14,7,15,55,62,-7,49
Annan Athlet,8755,7,11,12,13,47,41,6,45
Berwick,8755,8,8,10,18,30,60,-30,34
Edinburgh Ci,8755,9,7,9,20,36,61,-25,30
Cowdenbeath,8755,10,4,11,21,23,54,-31,23
Peterhead,8756,1,24,4,8,78,38,40,76
Montrose,8756,2,23,7,6,61,38,23,76
Stirling,8756,3,16,7,13,61,52,9,55
Stenhousem'r,8756,4,15,9,12,56,47,9,54
Clyde,8756,5,14,9,13,52,50,2,51
Elgin,8756,6,15,6,15,57,62,-5,51
Annan Athlet,8756,7,11,12,13,48,42,6,45
Berwick,8756,8,9,10,17,31,59,-28,37
Edinburgh Ci,8756,9,7,9,20,36,61,-25,30
Cowdenbeath,8756,10,4,11,21,24,55,-31,23
Montrose,8757,1,24,7,5,62,35,27,79
Peterhead,8757,2,24,4,8,79,38,41,76
Stirling,8757,3,17,6,13,62,52,10,57
Clyde,8757,4,15,9,12,57,48,9,54
Stenhousem'r,8757,5,15,8,13,56,48,8,53
Elgin,8757,6,14,6,16,54,63,-9,48
Annan Athlet,8757,7,11,12,13,49,43,6,45
Berwick,8757,8,8,10,18,29,64,-35,34
Edinburgh Ci,8757,9,7,9,20,36,62,-26,30
Cowdenbeath,8757,10,4,11,21,25,56,-31,23
Montrose,8758,1,24,7,5,61,34,27,79
Peterhead,8758,2,24,4,8,80,40,40,76
Stirling,8758,3,17,6,13,62,51,11,57
Stenhousem'r,8758,4,15,8,13,55,48,7,53
Clyde,8758,5,14,9,13,52,50,2,51
Elgin,8758,6,14,6,16,53,62,-9,48
Annan Athlet,8758,7,12,11,13,50,41,9,47
Berwick,8758,8,9,10,17,31,59,-28,37
Edinburgh Ci,8758,9,7,9,20,38,63,-25,30
Cowdenbeath,8758,10,4,10,22,23,57,-34,22
Montrose,8759,1,24,7,5,63,37,26,79
Peterhead,8759,2,24,4,8,81,38,43,76
Stirling,8759,3,16,7,13,62,53,9,55
Stenhousem'r,8759,4,15,9,12,57,48,9,54
Clyde,8759,5,15,9,12,54,50,4,54
Elgin,8759,6,14,6,16,56,64,-8,48
Annan Athlet,8759,7,11,12,13,47,41,6,45
Berwick,8759,8,8,10,18,31,61,-30,34
Edinburgh Ci,8759,9,7,9,20,36,64,-28,30
Cowdenbeath,8759,10,4,11,21,23,54,-31,23
Montrose,8760,1,23,7,6,59,36,23,76
Peterhead,8760,2,23,4,9,78,40,38,73
Stirling,8760,3,17,6,13,64,51,13,57
Stenhousem'r,8760,4,15,8,13,55,50,5,53
Clyde,8760,5,14,10,12,52,49,3,52
Elgin,8760,6,15,6,15,55,60,-5,51
Annan Athlet,8760,7,12,11,13,48,41,7,47
Berwick,8760,8,8,11,17,30,59,-29,35
Edinburgh Ci,8760,9,8,9,19,38,61,-23,33
Cowdenbeath,8760,10,4,10,22,23,55,-32,22
Montrose,8761,1,23,7,6,61,37,24,76
Peterhead,8761,2,23,4,9,78,40,38,73
Stirling,8761,3,17,6,13,63,53,10,57
Stenhousem'r,8761,4,15,8,13,57,49,8,53
Clyde,8761,5,14,9,13,52,51,1,51
Elgin,8761,6,15,6,15,56,62,-6,51
Annan Athlet,8761,7,11,11,14,47,42,5,44
Berwick,8761,8,9,10,17,32,59,-27,37
Edinburgh Ci,8761,9,8,9,19,38,61,-23,33
Cowdenbeath,8761,10,5,10,21,24,54,-30,25
Montrose,8762,1,24,7,5,61,35,26,79
Peterhead,8762,2,24,4,8,80,40,40,76
Stirling,8762,3,16,7,13,62,53,9,55
Stenhousem'r,8762,4,15,9,12,57,48,9,54
Clyde,8762,5,15,9,12,52,48,4,54
Elgin,8762,6,14,6,16,54,62,-8,48
Annan Athlet,8762,7,11,11,14,47,42,5,44
Berwick,8762,8,8,10,18,29,59,-30,34
Edinburgh Ci,8762,9,7,9,20,38,63,-25,30
Cowdenbeath,8762,10,5,10,21,24,54,-30,25
Montrose,8763,1,24,7,5,63,36,27,79
Peterhead,8763,2,23,5,8,78,39,39,74
Stirling,8763,3,16,7,13,62,53,9,55
Stenhousem'r,8763,4,15,9,12,57,48,9,54
Clyde,8763,5,14,10,12,52,49,3,52
Elgin,8763,6,14,6,16,55,64,-9,48
Annan Athlet,8763,7,11,11,14,47,42,5,44
Berwick,8763,8,8,11,17,30,59,-29,35
Edinburgh Ci,8763,9,7,10,19,37,61,-24,31
Cowdenbeath,8763,10,5,10,21,24,54,-30,25
Montrose,8764,1,23,8,5,61,36,25,77
Peterhead,8764,2,23,5,8,79,40,39,74
Stirling,8764,3,17,6,13,62,52,10,57
Stenhousem'r,8764,4,15,8,13,56,48,8,53
Clyde,8764,5,14,10,12,52,49,3,52
Elgin,8764,6,14,7,15,55,62,-7,49
Annan Athlet,8764,7,12,11,13,50,41,9,47
Berwick,8764,8,8,11,17,30,59,-29,35
Edinburgh Ci,8764,9,7,10,19,38,62,-24,31
Cowdenbeath,8764,10,4,10,22,23,57,-34,22
Montrose,8765,1,23,8,5,62,37,25,77
Peterhead,8765,2,23,5,8,80,41,39,74
Stirling,8765,3,17,6,13,64,51,13,57
Clyde,8765,4,15,9,12,54,49,5,54
Stenhousem'r,8765,5,15,8,13,55,50,5,53
Elgin,8765,6,14,7,15,56,63,-7,49
Annan Athlet,8765,7,11,11,14,47,42,5,44
Berwick,8765,8,8,10,18,30,61,-31,34
Edinburgh Ci,8765,9,7,10,19,39,63,-24,31
Cowdenbeath,8765,10,5,10,21,24,54,-30,25
Montrose,8766,1,24,7,5,60,34,26,79
Peterhead,8766,2,24,4,8,80,38,42,76
Stirling,8766,3,17,6,13,62,52,10,57
Clyde,8766,4,15,9,12,54,49,5,54
Stenhousem'r,8766,5,15,8,13,56,48,8,53
Elgin,8766,6,14,6,16,53,61,-8,48
Annan Athlet,8766,7,12,11,13,49,42,7,47
Berwick,8766,8,8,10,18,30,61,-31,34
Edinburgh Ci,8766,9,7,9,20,36,63,-27,30
Cowdenbeath,8766,10,4,10,22,24,56,-32,22
Montrose,8767,1,24,7,5,61,34,27,79
Peterhead,8767,2,24,4,8,80,38,42,76
Stirling,8767,3,17,6,13,61,51,10,57
Clyde,8767,4,15,9,12,53,49,4,54
Stenhousem'r,8767,5,15,8,13,55,47,8,53
Elgin,8767,6,14,6,16,53,62,-9,48
Annan Athlet,8767,7,11,12,13,48,42,6,45
Berwick,8767,8,8,10,18,30,60,-30,34
Edinburgh Ci,8767,9,7,9,20,36,63,-27,30
Cowdenbeath,8767,10,4,11,21,24,55,-31,23
Montrose,8768,1,24,7,5,61,34,27,79
Peterhead,8768,2,23,5,8,79,40,39,74
Stirling,8768,3,16,7,13,61,52,9,55
Stenhousem'r,8768,4,15,9,12,56,47,9,54
Clyde,8768,5,15,9,12,53,49,4,54
Elgin,8768,6,14,6,16,53,62,-9,48
Annan Athlet,8768,7,12,11,13,50,42,8,47
Berwick,8768,8,8,10,18,30,60,-30,34
Edinburgh Ci,8768,9,7,10,19,38,62,-24,31
Cowdenbeath,8768,10,4,10,22,24,57,-33,22
Montrose,8769,1,24,7,5,61,35,26,79
Peterhead,8769,2,24,4,8,78,38,40,76
Stirling,8769,3,17,6,13,63,52,11,57
Clyde,8769,4,15,9,12,52,48,4,54
Stenhousem'r,8769,5,15,8,13,56,49,7,53
Elgin,8769,6,14,6,16,54,62,-8,48
Annan Athlet,8769,7,11,11,14,47,44,3,44
Berwick,8769,8,8,10,18,29,59,-30,34
Edinburgh Ci,8769,9,7,9,20,36,61,-25,30
Cowdenbeath,8769,10,5,10,21,26,54,-28,25
Montrose,8770,1,24,7,5,61,35,26,79
Peterhead,8770,2,24,4,8,79,38,41,76
Stirling,8770,3,16,7,13,61,52,9,55
Stenhousem'r,8770,4,15,9,12,56,47,9,54
Clyde,8770,5,15,9,12,54,49,5,54
Elgin,8770,6,14,6,16,54,62,-8,48
Annan Athlet,8770,7,12,11,13,49,42,7,47
Berwick,8770,8,8,10,18,30,61,-31,34
Edinburgh Ci,8770,9,7,9,20,36,62,-26,30
Cowdenbeath,8770,10,4,10,22,24,56,-32,22
Peterhead,8771,1,24,4,8,81,40,41,76
Montrose,8771,2,23,7,6,59,37,22,76
Stirling,8771,3,17,6,13,63,52,11,57
Clyde,8771,4,15,9,12,54,48,6,54
Stenhousem'r,8771,5,15,8,13,56,49,7,53
Elgin,8771,6,15,6,15,56,60,-4,51
Annan Athlet,8771,7,12,11,13,50,41,9,47
Berwick,8771,8,8,10,18,29,61,-32,34
Edinburgh Ci,8771,9,7,9,20,38,64,-26,30
Cowdenbeath,8771,10,4,10,22,23,57,-34,22
Montrose,8772,1,24,7,5,60,34,26,79
Peterhead,8772,2,23,5,8,78,39,39,74
Stirling,8772,3,16,7,13,61,52,9,55
Stenhousem'r,8772,4,15,9,12,56,47,9,54
Clyde,8772,5,14,10,12,52,49,3,52
Elgin,8772,6,14,6,16,53,61,-8,48
Annan Athlet,8772,7,12,11,13,48,41,7,47
Berwick,8772,8,8,11,17,30,59,-29,35
Edinburgh Ci,8772,9,7,10,19,37,61,-24,31
Cowdenbeath,8772,10,4,10,22,23,55,-32,22
Montrose,8773,1,23,8,5,59,34,25,77
Peterhead,8773,2,24,4,8,78,38,40,76
Stenhousem'r,8773,3,16,8,12,59,46,13,56
Stirling,8773,4,16,6,14,60,55,5,54
Clyde,8773,5,14,9,13,52,50,2,51
Elgin,8773,6,14,7,15,53,60,-7,49
Annan Athlet,8773,7,11,12,13,47,41,6,45
Berwick,8773,8,9,10,17,31,59,-28,37
Edinburgh Ci,8773,9,7,9,20,36,61,-25,30
Cowdenbeath,8773,10,4,11,21,23,54,-31,23
Montrose,8774,1,24,7,5,61,35,26,79
Peterhead,8774,2,24,4,8,79,39,40,76
Stenhousem'r,8774,3,16,8,12,58,47,11,56
Stirling,8774,4,16,6,14,61,54,7,54
Clyde,8774,5,15,9,12,54,49,5,54
Elgin,8774,6,14,6,16,54,62,-8,48
Annan Athlet,8774,7,11,12,13,49,43,6,45
Berwick,8774,8,8,10,18,30,61,-31,34
Edinburgh Ci,8774,9,7,9,20,37,62,-25,30
Cowdenbeath,8774,10,4,11,21,25,56,-31,23
Montrose,8775,1,24,7,5,61,35,26,79
Peterhead,8775,2,24,4,8,80,38,42,76
Stenhousem'r,8775,3,16,8,12,58,48,10,56
Stirling,8775,4,16,6,14,62,54,8,54
Clyde,8775,5,15,9,12,53,49,4,54
Elgin,8775,6,14,6,16,54,62,-8,48
Annan Athlet,8775,7,12,11,13,51,41,10,47
Berwick,8775,8,8,10,18,30,60,-30,34
Edinburgh Ci,8775,9,7,9,20,36,63,-27,30
Cowdenbeath,8775,10,4,10,22,23,58,-35,22
Montrose,8776,1,24,7,5,62,34,28,79
Peterhead,8776,2,24,4,8,83,41,42,76
Stirling,8776,3,16,7,13,62,53,9,55
Stenhousem'r,8776,4,15,9,12,57,48,9,54
Clyde,8776,5,15,9,12,53,49,4,54
Elgin,8776,6,14,6,16,53,63,-10,48
Annan Athlet,8776,7,11,12,13,47,41,6,45
Berwick,8776,8,8,10,18,30,60,-30,34
Edinburgh Ci,8776,9,7,9,20,39,66,-27,30
Cowdenbeath,8776,10,4,11,21,23,54,-31,23
Peterhead,8777,1,24,4,8,83,39,44,76
Montrose,8777,2,23,7,6,59,36,23,76
Stenhousem'r,8777,3,16,8,12,59,48,11,56
Stirling,8777,4,16,6,14,62,55,7,54
Clyde,8777,5,14,10,12,51,48,3,52
Elgin,8777,6,15,6,15,55,60,-5,51
Annan Athlet,8777,7,11,11,14,49,44,5,44
Berwick,8777,8,8,11,17,29,58,-29,35
Edinburgh Ci,8777,9,7,9,20,37,66,-29,30
Cowdenbeath,8777,10,5,10,21,26,56,-30,25
Montrose,8778,1,23,8,5,60,35,25,77
Peterhead,8778,2,24,4,8,80,38,42,76
Stirling,8778,3,16,7,13,62,53,9,55
Stenhousem'r,8778,4,15,9,12,57,48,9,54
Clyde,8778,5,15,9,12,55,49,6,54
Elgin,8778,6,14,7,15,54,61,-7,49
Annan Athlet,8778,7,11,11,14,47,42,5,44
Berwick,8778,8,8,10,18,30,62,-32,34
Edinburgh Ci,8778,9,7,9,20,36,63,-27,30
Cowdenbeath,8778,10,5,10,21,24,54,-30,25
Montrose,8779,1,23,7,6,60,36,24,76
Peterhead,8779,2,23,5,8,78,39,39,74
Stirling,8779,3,17,6,13,64,51,13,57
Clyde,8779,4,15,9,12,53,49,4,54
Stenhousem'r,8779,5,15,8,13,55,50,5,53
Elgin,8779,6,15,6,15,55,61,-6,51
Annan Athlet,8779,7,12,11,13,50,42,8,47
Berwick,8779,8,8,10,18,30,60,-30,34
Edinburgh Ci,8779,9,7,10,19,37,61,-24,31
Cowdenbeath,8779,10,4,10,22,24,57,-33,22
Montrose,8780,1,23,8,5,62,37,25,77
Peterhead,8780,2,24,4,8,80,38,42,76
Stenhousem'r,8780,3,16,8,12,59,47,12,56
Stirling,8780,4,16,6,14,61,55,6,54
Clyde,8780,5,14,10,12,51,48,3,52
Elgin,8780,6,14,7,15,56,63,-7,49
Annan Athlet,8780,7,11,11,14,47,44,3,44
Berwick,8780,8,8,11,17,29,58,-29,35
Edinburgh Ci,8780,9,7,9,20,36,63,-27,30
Cowdenbeath,8780,10,5,10,21,26,54,-28,25
Montrose,8781,1,24,7,5,61,35,26,79
Peterhead,8781,2,24,4,8,81,39,42,76
Stenhousem'r,8781,3,16,8,12,57,46,11,56
Stirling,8781,4,16,6,14,60,53,7,54
Clyde,8781,5,15,9,12,54,48,6,54
Elgin,8781,6,14,6,16,54,62,-8,48
Annan Athlet,8781,7,11,12,13,47,41,6,45
Berwick,8781,8,8,10,18,29,61,-32,34
Edinburgh Ci,8781,9,7,9,20,37,64,-27,30
Cowdenbeath,8781,10,4,11,21,23,54,-31,23
Montrose,8782,1,24,7,5,63,35,28,79
Peterhead,8782,2,24,4,8,81,40,41,76
Stirling,8782,3,17,6,13,62,52,10,57
Clyde,8782,4,15,9,12,55,48,7,54
Stenhousem'r,8782,5,15,8,13,56,48,8,53
Elgin,8782,6,14,6,16,54,64,-10,48
Annan Athlet,8782,7,11,12,13,48,42,6,45
Berwick,8782,8,8,10,18,29,62,-33,34
Edinburgh Ci,8782,9,7,9,20,38,64,-26,30
Cowdenbeath,8782,10,4,11,21,24,55,-31,23
Montrose,8783,1,24,7,5,61,34,27,79
Peterhead,8783,2,24,4,8,80,39,41,76
Stirling,8783,3,17,6,13,67,53,14,57
Stenhousem'r,8783,4,15,8,13,57,53,4,53
Clyde,8783,5,14,9,13,53,51,2,51
Elgin,8783,6,14,6,16,53,62,-9,48
Annan Athlet,8783,7,11,11,14,49,45,4,44
Berwick,8783,8,9,10,17,32,60,-28,37
Edinburgh Ci,8783,9,7,9,20,37,63,-26,30
Cowdenbeath,8783,10,5,10,21,27,56,-29,25
Peterhead,8784,1,24,4,8,78,38,40,76
Montrose,8784,2,23,7,6,59,35,24,76
Stenhousem'r,8784,3,16,8,12,56,46,10,56
Stirling,8784,4,16,6,14,60,52,8,54
Clyde,8784,5,15,9,12,54,48,6,54
Elgin,8784,6,15,6,15,54,60,-6,51
Annan Athlet,8784,7,11,11,14,47,42,5,44
Berwick,8784,8,8,10,18,29,61,-32,34
Edinburgh Ci,8784,9,7,9,20,36,61,-25,30
Cowdenbeath,8784,10,5,10,21,24,54,-30,25
Montrose,8785,1,23,8,5,60,35,25,77
Peterhead,8785,2,23,5,8,77,38,39,74
Stirling,8785,3,17,6,13,63,52,11,57
Clyde,8785,4,15,9,12,54,48,6,54
Stenhousem'r,8785,5,15,8,13,56,49,7,53
Elgin,8785,6,14,7,15,54,61,-7,49
Annan Athlet,8785,7,11,11,14,47,43,4,44
Berwick,8785,8,8,10,18,29,61,-32,34
Edinburgh Ci,8785,9,7,10,19,36,60,-24,31
Cowdenbeath,8785,10,5,10,21,25,54,-29,25
Peterhead,8786,1,24,4,8,78,38,40,76
Montrose,8786,2,23,7,6,59,36,23,76
Stirling,8786,3,17,6,13,62,51,11,57
Stenhousem'r,8786,4,15,8,13,55,48,7,53
Clyde,8786,5,14,10,12,51,48,3,52
Elgin,8786,6,15,6,15,55,60,-5,51
Annan Athlet,8786,7,11,12,13,47,41,6,45
Berwick,8786,8,8,11,17,29,58,-29,35
Edinburgh Ci,8786,9,7,9,20,36,61,-25,30
Cowdenbeath,8786,10,4,11,21,23,54,-31,23
Montrose,8787,1,24,7,5,62,36,26,79
Peterhead,8787,2,24,4,8,80,39,41,76
Stirling,8787,3,17,6,13,61,51,10,57
Clyde,8787,4,15,9,12,54,49,5,54
Stenhousem'r,8787,5,15,8,13,55,47,8,53
Elgin,8787,6,14,6,16,55,63,-8,48
Annan Athlet,8787,7,11,12,13,48,42,6,45
Berwick,8787,8,8,10,18,30,61,-31,34
Edinburgh Ci,8787,9,7,9,20,37,63,-26,30
Cowdenbeath,8787,10,4,11,21,24,55,-31,23
Montrose,8788,1,24,7,5,62,35,27,79
Peterhead,8788,2,23,5,8,80,41,39,74
Stirling,8788,3,16,7,13,60,51,9,55
Stenhousem'r,8788,4,15,9,12,55,46,9,54
Clyde,8788,5,14,9,13,51,50,1,51
Elgin,8788,6,14,6,16,54,63,-9,48
Annan Athlet,8788,7,11,11,14,47,42,5,44
Berwick,8788,8,9,10,17,31,58,-27,37
Edinburgh Ci,8788,9,7,10,19,39,63,-24,31
Cowdenbeath,8788,10,5,10,21,24,54,-30,25
Montrose,8789,1,24,7,5,65,35,30,79
Peterhead,8789,2,24,4,8,80,40,40,76
Stirling,8789,3,16,7,13,62,53,9,55
Stenhousem'r,8789,4,15,9,12,57,48,9,54
Clyde,8789,5,15,9,12,54,49,5,54
Elgin,8789,6,14,6,16,54,66,-12,48
Annan Athlet,8789,7,12,11,13,48,41,7,47
Berwick,8789,8,8,10,18,30,61,-31,34
Edinburgh Ci,8789,9,7,9,20,38,63,-25,30
Cowdenbeath,8789,10,4,10,22,23,55,-32,22
Montrose,8790,1,23,8,5,60,35,25,77
Peterhead,8790,2,24,4,8,80,38,42,76
Stirling,8790,3,17,6,13,62,51,11,57
Stenhousem'r,8790,4,15,8,13,55,48,7,53
Clyde,8790,5,14,10,12,53,50,3,52
Elgin,8790,6,14,7,15,54,61,-7,49
Annan Athlet,8790,7,11,11,14,48,44,4,44
Berwick,8790,8,8,11,17,31,60,-29,35
Edinburgh Ci,8790,9,7,9,20,36,63,-27,30
Cowdenbeath,8790,10,5,10,21,26,55,-29,25
Montrose,8791,1,24,7,5,62,35,27,79
Peterhead,8791,2,24,4,8,78,38,40,76
Stenhousem'r,8791,3,16,8,12,58,48,10,56
Stirling,8791,4,16,6,14,62,54,8,54
Clyde,8791,5,14,10,12,53,50,3,52
Elgin,8791,6,14,6,16,54,63,-9,48
Annan Athlet,8791,7,12,11,13,48,41,7,47
Berwick,8791,8,8,11,17,31,60,-29,35
Edinburgh Ci,8791,9,7,9,20,36,61,-25,30
Cowdenbeath,8791,10,4,10,22,23,55,-32,22
Montrose,8792,1,24,7,5,60,34,26,79
Peterhead,8792,2,23,5,8,78,39,39,74
Stenhousem'r,8792,3,16,8,12,56,46,10,56
Stirling,8792,4,16,6,14,60,52,8,54
Clyde,8792,5,14,10,12,52,49,3,52
Elgin,8792,6,14,6,16,53,61,-8,48
Annan Athlet,8792,7,11,12,13,48,42,6,45
Berwick,8792,8,8,11,17,30,59,-29,35
Edinburgh Ci,8792,9,7,10,19,37,61,-24,31
Cowdenbeath,8792,10,4,11,21,24,55,-31,23
Peterhead,8793,1,24,4,8,79,39,40,76
Montrose,8793,2,23,7,6,59,36,23,76
Stenhousem'r,8793,3,16,8,12,57,46,11,56
Stirling,8793,4,16,6,14,60,53,7,54
Clyde,8793,5,14,10,12,51,48,3,52
Elgin,8793,6,15,6,15,55,60,-5,51
Annan Athlet,8793,7,11,11,14,47,43,4,44
Berwick,8793,8,8,11,17,29,58,-29,35
Edinburgh Ci,8793,9,7,9,20,37,62,-25,30
Cowdenbeath,8793,10,5,10,21,25,54,-29,25
Montrose,8794,1,24,7,5,61,35,26,79
Peterhead,8794,2,24,4,8,78,38,40,76
Stirling,8794,3,17,6,13,63,51,12,57
Clyde,8794,4,15,9,12,55,50,5,54
Stenhousem'r,8794,5,15,8,13,55,49,6,53
Elgin,8794,6,14,6,16,54,62,-8,48
Annan Athlet,8794,7,11,11,14,48,43,5,44
Berwick,8794,8,8,10,18,31,62,-31,34
Edinburgh Ci,8794,9,7,9,20,36,61,-25,30
Cowdenbeath,8794,10,5,10,21,25,55,-30,25
Montrose,8795,1,24,7,5,62,34,28,79
Peterhead,8795,2,23,5,8,79,40,39,74
Stirling,8795,3,16,7,13,60,51,9,55
Stenhousem'r,8795,4,15,9,12,55,46,9,54
Clyde,8795,5,15,9,12,52,48,4,54
Elgin,8795,6,14,6,16,53,63,-10,48
Annan Athlet,8795,7,11,11,14,47,42,5,44
Berwick,8795,8,8,10,18,29,59,-30,34
Edinburgh Ci,8795,9,7,10,19,38,62,-24,31
Cowdenbeath,8795,10,5,10,21,24,54,-30,25
Montrose,8796,1,24,7,5,63,34,29,79
Peterhead,8796,2,24,4,8,81,39,42,76
Stirling,8796,3,17,6,13,62,51,11,57
Clyde,8796,4,15,9,12,53,49,4,54
Stenhousem'r,8796,5,15,8,13,55,48,7,53
Elgin,8796,6,14,6,16,53,64,-11,48
Annan Athlet,8796,7,11,12,13,48,42,6,45
Berwick,8796,8,8,10,18,30,60,-30,34
Edinburgh Ci,8796,9,7,9,20,37,64,-27,30
Cowdenbeath,8796,10,4,11,21,24,55,-31,23
Montrose,8797,1,24,7,5,62,36,26,79
Peterhead,8797,2,24,4,8,83,38,45,76
Stirling,8797,3,17,6,13,62,51,11,57
Clyde,8797,4,15,9,12,55,48,7,54
Stenhousem'r,8797,5,15,8,13,55,48,7,53
Elgin,8797,6,14,6,16,55,63,-8,48
Annan Athlet,8797,7,11,12,13,48,42,6,45
Berwick,8797,8,8,10,18,29,62,-33,34
Edinburgh Ci,8797,9,7,9,20,36,66,-30,30
Cowdenbeath,8797,10,4,11,21,24,55,-31,23
Montrose,8798,1,24,7,5,62,36,26,79
Peterhead,8798,2,24,4,8,79,39,40,76
Stirling,8798,3,16,7,13,62,53,9,55
Stenhousem'r,8798,4,15,9,12,57,48,9,54
Clyde,8798,5,15,9,12,55,48,7,54
Elgin,8798,6,14,6,16,55,63,-8,48
Annan Athlet,8798,7,11,11,14,47,42,5,44
Berwick,8798,8,8,10,18,29,62,-33,34
Edinburgh Ci,8798,9,7,9,20,37,62,-25,30
Cowdenbeath,8798,10,5,10,21,24,54,-30,25
Montrose,8799,1,24,7,5,61,35,26,79
Peterhead,8799,2,24,4,8,83,38,45,76
Stirling,8799,3,17,6,13,63,51,12,57
Clyde,8799,4,15,9,12,52,48,4,54
Stenhousem'r,8799,5,15,8,13,55,49,6,53
Elgin,8799,6,14,6,16,54,62,-8,48
Annan Athlet,8799,7,11,11,14,48,43,5,44
Berwick,8799,8,8,10,18,29,59,-30,34
Edinburgh Ci,8799,9,7,9,20,36,66,-30,30
Cowdenbeath,8799,10,5,10,21,25,55,-30,25
Montrose,8800,1,24,7,5,61,35,26,79
Peterhead,8800,2,24,4,8,82,39,43,76
Stirling,8800,3,17,6,13,63,52,11,57
Stenhousem'r,8800,4,15,8,13,56,49,7,53
Clyde,8800,5,14,9,13,52,50,2,51
Elgin,8800,6,14,6,16,54,62,-8,48
Annan Athlet,8800,7,12,11,13,48,41,7,47
Berwick,8800,8,9,10,17,31,59,-28,37
Edinburgh Ci,8800,9,7,9,20,37,65,-28,30
Cowdenbeath,8800,10,4,10,22,23,55,-32,22
Montrose,8801,1,24,7,5,60,34,26,79
Peterhead,8801,2,24,4,8,80,39,41,76
Stirling,8801,3,17,6,13,64,51,13,57
Stenhousem'r,8801,4,15,8,13,55,50,5,53
Clyde,8801,5,14,10,12,51,48,3,52
Elgin,8801,6,14,6,16,53,61,-8,48
Annan Athlet,8801,7,11,12,13,47,41,6,45
Berwick,8801,8,8,11,17,29,58,-29,35
Edinburgh Ci,8801,9,7,9,20,37,63,-26,30
Cowdenbeath,8801,10,4,11,21,23,54,-31,23
Montrose,8802,1,24,7,5,61,35,26,79
Peterhead,8802,2,23,5,8,79,40,39,74
Stirling,8802,3,17,6,13,63,52,11,57
Stenhousem'r,8802,4,15,8,13,56,49,7,53
Clyde,8802,5,14,9,13,51,49,2,51
Elgin,8802,6,14,6,16,54,62,-8,48
Annan Athlet,8802,7,11,11,14,47,42,5,44
Berwick,8802,8,9,10,17,30,58,-28,37
Edinburgh Ci,8802,9,7,10,19,38,62,-24,31
Cowdenbeath,8802,10,5,10,21,24,54,-30,25
Montrose,8803,1,24,7,5,62,35,27,79
Peterhead,8803,2,24,4,8,78,38,40,76
Stirling,8803,3,16,7,13,60,51,9,55
Stenhousem'r,8803,4,15,9,12,55,46,9,54
Clyde,8803,5,15,9,12,57,50,7,54
Elgin,8803,6,14,6,16,54,63,-9,48
Annan Athlet,8803,7,11,12,13,48,42,6,45
Berwick,8803,8,8,10,18,31,64,-33,34
Edinburgh Ci,8803,9,7,9,20,36,61,-25,30
Cowdenbeath,8803,10,4,11,21,24,55,-31,23
Montrose,8804,1,24,7,5,64,34,30,79
Peterhead,8804,2,24,4,8,79,38,41,76
Stirling,8804,3,17,6,13,62,52,10,57
Clyde,8804,4,15,9,12,54,50,4,54
Stenhousem'r,8804,5,15,8,13,56,48,8,53
Elgin,8804,6,14,6,16,53,65,-12,48
Annan Athlet,8804,7,12,11,13,50,41,9,47
Berwick,8804,8,8,10,18,31,61,-30,34
Edinburgh Ci,8804,9,7,9,20,36,62,-26,30
Cowdenbeath,8804,10,4,10,22,23,57,-34,22
Peterhead,8805,1,24,4,8,81,39,42,76
Montrose,8805,2,23,7,6,61,37,24,76
Stenhousem'r,8805,3,16,8,12,58,47,11,56
Stirling,8805,4,16,6,14,61,54,7,54
Clyde,8805,5,14,9,13,53,51,2,51
Elgin,8805,6,15,6,15,56,62,-6,51
Annan Athlet,8805,7,11,11,14,47,45,2,44
Berwick,8805,8,9,10,17,32,60,-28,37
Edinburgh Ci,8805,9,7,9,20,37,64,-27,30
Cowdenbeath,8805,10,5,10,21,27,54,-27,25
Montrose,8806,1,24,7,5,63,35,28,79
Peterhead,8806,2,24,4,8,79,38,41,76
Stirling,8806,3,16,7,13,61,52,9,55
Stenhousem'r,8806,4,15,9,12,56,47,9,54
Clyde,8806,5,14,10,12,53,50,3,52
Elgin,8806,6,14,6,16,54,64,-10,48
Annan Athlet,8806,7,12,11,13,49,41,8,47
Berwick,8806,8,8,11,17,31,60,-29,35
Edinburgh Ci,8806,9,7,9,20,36,62,-26,30
Cowdenbeath,8806,10,4,10,22,23,56,-33,22
Montrose,8807,1,24,7,5,60,34,26,79
Peterhead,8807,2,24,4,8,80,39,41,76
Stenhousem'r,8807,3,16,8,12,56,46,10,56
Stirling,8807,4,16,6,14,60,52,8,54
Clyde,8807,5,14,9,13,51,50,1,51
Elgin,8807,6,14,6,16,53,61,-8,48
Annan Athlet,8807,7,11,11,14,48,43,5,44
Berwick,8807,8,9,10,17,31,58,-27,37
Edinburgh Ci,8807,9,7,9,20,37,63,-26,30
Cowdenbeath,8807,10,5,10,21,25,55,-30,25
Montrose,8808,1,23,8,5,60,35,25,77
Peterhead,8808,2,24,4,8,82,39,43,76
Stirling,8808,3,17,6,13,66,55,11,57
Stenhousem'r,8808,4,15,8,13,59,52,7,53
Clyde,8808,5,14,10,12,53,50,3,52
Elgin,8808,6,14,7,15,54,61,-7,49
Annan Athlet,8808,7,11,12,13,48,42,6,45
Berwick,8808,8,8,11,17,31,60,-29,35
Edinburgh Ci,8808,9,7,9,20,37,65,-28,30
Cowdenbeath,8808,10,4,11,21,24,55,-31,23
Peterhead,8809,1,24,4,8,81,38,43,76
Montrose,8809,2,23,7,6,61,37,24,76
Stirling,8809,3,16,7,13,61,52,9,55
Stenhousem'r,8809,4,15,9,12,56,47,9,54
Clyde,8809,5,15,9,12,53,49,4,54
Elgin,8809,6,15,6,15,56,62,-6,51
Annan Athlet,8809,7,12,11,13,49,42,7,47
Berwick,8809,8,8,10,18,30,60,-30,34
Edinburgh Ci,8809,9,7,9,20,36,64,-28,30
Cowdenbeath,8809,10,4,10,22,24,56,-32,22
Montrose,8810,1,23,7,6,60,37,23,76
Peterhead,8810,2,23,4,9,78,40,38,73
Stirling,8810,3,17,6,13,62,51,11,57
Stenhousem'r,8810,4,15,8,13,55,48,7,53
Clyde,8810,5,14,9,13,51,51,0,51
Elgin,8810,6,15,6,15,56,61,-5,51
Annan Athlet,8810,7,11,12,13,47,41,6,45
Berwick,8810,8,9,10,17,32,58,-26,37
Edinburgh Ci,8810,9,8,9,19,38,61,-23,33
Cowdenbeath,8810,10,4,11,21,23,54,-31,23
Montrose,8811,1,23,8,5,61,36,25,77
Peterhead,8811,2,24,4,8,79,39,40,76
Stirling,8811,3,16,7,13,63,54,9,55
Stenhousem'r,8811,4,15,9,12,58,49,9,54
Clyde,8811,5,14,9,13,51,50,1,51
Elgin,8811,6,14,7,15,55,62,-7,49
Annan Athlet,8811,7,11,11,14,47,43,4,44
Berwick,8811,8,9,10,17,31,58,-27,37
Edinburgh Ci,8811,9,7,9,20,37,62,-25,30
Cowdenbeath,8811,10,5,10,21,25,54,-29,25
Montrose,8812,1,24,7,5,61,34,27,79
Peterhead,8812,2,24,4,8,80,39,41,76
Stirling,8812,3,16,7,13,60,51,9,55
Stenhousem'r,8812,4,15,9,12,55,46,9,54
Clyde,8812,5,15,9,12,52,48,4,54
Elgin,8812,6,14,6,16,53,62,-9,48
Annan Athlet,8812,7,12,11,13,48,41,7,47
Berwick,8812,8,8,10,18,29,59,-30,34
Edinburgh Ci,8812,9,7,9,20,37,63,-26,30
Cowdenbeath,8812,10,4,10,22,23,55,-32,22
Montrose,8813,1,23,8,5,60,35,25,77
Peterhead,8813,2,24,4,8,79,39,40,76
Stirling,8813,3,17,6,13,62,52,10,57
Clyde,8813,4,15,9,12,52,48,4,54
Stenhousem'r,8813,5,15,8,13,56,48,8,53
Elgin,8813,6,14,7,15,54,61,-7,49
Annan Athlet,8813,7,12,11,13,49,41,8,47
Berwick,8813,8,8,10,18,29,59,-30,34
Edinburgh Ci,8813,9,7,9,20,37,62,-25,30
Cowdenbeath,8813,10,4,10,22,23,56,-33,22
Montrose,8814,1,24,7,5,63,36,27,79
Peterhead,8814,2,24,4,8,79,39,40,76
Stirling,8814,3,16,7,13,61,52,9,55
Stenhousem'r,8814,4,15,9,12,56,47,9,54
Clyde,8814,5,14,10,12,51,48,3,52
Elgin,8814,6,14,6,16,55,64,-9,48
Annan Athlet,8814,7,11,11,14,47,43,4,44
Berwick,8814,8,8,11,17,29,58,-29,35
Edinburgh Ci,8814,9,7,9,20,37,62,-25,30
Cowdenbeath,8814,10,5,10,21,25,54,-29,25
Montrose,8815,1,24,7,5,60,34,26,79
Peterhead,8815,2,24,4,8,81,38,43,76
Stirling,8815,3,17,6,13,66,52,14,57
Clyde,8815,4,15,9,12,52,48,4,54
Stenhousem'r,8815,5,15,8,13,56,52,4,53
Elgin,8815,6,14,6,16,53,61,-8,48
Annan Athlet,8815,7,11,11,14,47,45,2,44
Berwick,8815,8,8,10,18,29,59,-30,34
Edinburgh Ci,8815,9,7,9,20,36,64,-28,30
Cowdenbeath,8815,10,5,10,21,27,54,-27,25
Peterhead,8816,1,24,4,8,79,38,41,76
Montrose,8816,2,23,7,6,59,38,21,76
Stenhousem'r,8816,3,16,8,12,58,47,11,56
Stirling,8816,4,16,6,14,61,54,7,54
Clyde,8816,5,14,9,13,51,51,0,51
Elgin,8816,6,15,6,15,57,60,-3,51
Annan Athlet,8816,7,12,11,13,49,42,7,47
Berwick,8816,8,9,10,17,32,58,-26,37
Edinburgh Ci,8816,9,7,9,20,36,62,-26,30
Cowdenbeath,8816,10,4,10,22,24,56,-32,22
Montrose,8817,1,23,8,5,60,35,25,77
Peterhead,8817,2,24,4,8,81,39,42,76
Stirling,8817,3,17,6,13,63,52,11,57
Stenhousem'r,8817,4,15,8,13,56,49,7,53
Clyde,8817,5,14,10,12,54,51,3,52
Elgin,8817,6,14,7,15,54,61,-7,49
Annan Athlet,8817,7,12,11,13,50,41,9,47
Berwick,8817,8,8,11,17,32,61,-29,35
Edinburgh Ci,8817,9,7,9,20,37,64,-27,30
Cowdenbeath,8817,10,4,10,22,23,57,-34,22
Montrose,8818,1,24,7,5,64,34,30,79
Peterhead,8818,2,23,5,8,79,40,39,74
Stenhousem'r,8818,3,16,8,12,56,46,10,56
Stirling,8818,4,16,6,14,60,52,8,54
Clyde,8818,5,15,9,12,53,49,4,54
Elgin,8818,6,14,6,16,53,65,-12,48
Annan Athlet,8818,7,12,11,13,50,41,9,47
Berwick,8818,8,8,10,18,30,60,-30,34
Edinburgh Ci,8818,9,7,10,19,38,62,-24,31
Cowdenbeath,8818,10,4,10,22,23,57,-34,22
Montrose,8819,1,24,7,5,60,34,26,79
Peterhead,8819,2,24,4,8,81,39,42,76
Stenhousem'r,8819,3,16,8,12,57,47,10,56
Stirling,8819,4,16,6,14,61,53,8,54
Clyde,8819,5,14,10,12,51,48,3,52
Elgin,8819,6,14,6,16,53,61,-8,48
Annan Athlet,8819,7,12,11,13,49,41,8,47
Berwick,8819,8,8,11,17,29,58,-29,35
Edinburgh Ci,8819,9,7,9,20,37,64,-27,30
Cowdenbeath,8819,10,4,10,22,23,56,-33,22
Montrose,8820,1,24,7,5,60,34,26,79
Peterhead,8820,2,24,4,8,80,39,41,76
Stenhousem'r,8820,3,16,8,12,57,47,10,56
Stirling,8820,4,16,6,14,61,53,8,54
Clyde,8820,5,14,9,13,51,50,1,51
Elgin,8820,6,14,6,16,53,61,-8,48
Annan Athlet,8820,7,11,11,14,47,43,4,44
Berwick,8820,8,9,10,17,31,58,-27,37
Edinburgh Ci,8820,9,7,9,20,37,63,-26,30
Cowdenbeath,8820,10,5,10,21,25,54,-29,25
Peterhead,8821,1,24,4,8,81,38,43,76
Montrose,8821,2,23,7,6,59,35,24,76
Stirling,8821,3,16,7,13,61,52,9,55
Stenhousem'r,8821,4,15,9,12,56,47,9,54
Clyde,8821,5,15,9,12,56,50,6,54
Elgin,8821,6,15,6,15,54,60,-6,51
Annan Athlet,8821,7,11,12,13,47,41,6,45
Berwick,8821,8,8,10,18,31,63,-32,34
Edinburgh Ci,8821,9,7,9,20,36,64,-28,30
Cowdenbeath,8821,10,4,11,21,23,54,-31,23
Montrose,8822,1,24,7,5,62,36,26,79
Peterhead,8822,2,24,4,8,80,39,41,76
Stirling,8822,3,17,6,13,62,51,11,57
Clyde,8822,4,15,9,12,53,48,5,54
Stenhousem'r,8822,5,15,8,13,55,48,7,53
Elgin,8822,6,14,6,16,55,63,-8,48
Annan Athlet,8822,7,11,12,13,47,41,6,45
Berwick,8822,8,8,10,18,29,60,-31,34
Edinburgh Ci,8822,9,7,9,20,37,63,-26,30
Cowdenbeath,8822,10,4,11,21,23,54,-31,23
Montrose,8823,1,24,7,5,61,35,26,79
Peterhead,8823,2,24,4,8,82,38,44,76
Stirling,8823,3,16,7,13,61,52,9,55
Stenhousem'r,8823,4,15,9,12,56,47,9,54
Clyde,8823,5,14,9,13,51,50,1,51
Elgin,8823,6,14,6,16,54,62,-8,48
Annan Athlet,8823,7,11,11,14,47,42,5,44
Berwick,8823,8,9,10,17,31,58,-27,37
Edinburgh Ci,8823,9,7,9,20,36,65,-29,30
Cowdenbeath,8823,10,5,10,21,24,54,-30,25
Montrose,8824,1,24,7,5,60,34,26,79
Peterhead,8824,2,24,4,8,78,38,40,76
Stirling,8824,3,16,7,13,60,51,9,55
Stenhousem'r,8824,4,15,9,12,55,46,9,54
Clyde,8824,5,15,9,12,54,48,6,54
Elgin,8824,6,14,6,16,53,61,-8,48
Annan Athlet,8824,7,11,11,14,47,43,4,44
Berwick,8824,8,8,10,18,29,61,-32,34
Edinburgh Ci,8824,9,7,9,20,36,61,-25,30
Cowdenbeath,8824,10,5,10,21,25,54,-29,25
Montrose,8825,1,24,7,5,63,37,26,79
Peterhead,8825,2,24,4,8,80,38,42,76
Stirling,8825,3,16,7,13,61,52,9,55
Stenhousem'r,8825,4,15,9,12,56,47,9,54
Clyde,8825,5,15,9,12,52,48,4,54
Elgin,8825,6,14,6,16,56,64,-8,48
Annan Athlet,8825,7,11,11,14,48,43,5,44
Berwick,8825,8,8,10,18,29,59,-30,34
Edinburgh Ci,8825,9,7,9,20,36,63,-27,30
Cowdenbeath,8825,10,5,10,21,25,55,-30,25
Montrose,8826,1,23,8,5,61,36,25,77
Peterhead,8826,2,23,4,9,77,39,38,73
Stirling,8826,3,17,6,13,62,52,10,57
Clyde,8826,4,15,9,12,52,48,4,54
Stenhousem'r,8826,5,15,8,13,56,48,8,53
Elgin,8826,6,14,7,15,55,62,-7,49
Annan Athlet,8826,7,11,11,14,47,42,5,44
Berwick,8826,8,8,10,18,29,59,-30,34
Edinburgh Ci,8826,9,8,9,19,37,60,-23,33
Cowdenbeath,8826,10,5,10,21,24,54,-30,25
Montrose,8827,1,24,7,5,60,34,26,79
Peterhead,8827,2,23,5,8,77,38,39,74
Stenhousem'r,8827,3,16,8,12,57,47,10,56
Stirling,8827,4,16,6,14,61,53,8,54
Clyde,8827,5,15,9,12,53,49,4,54
Elgin,8827,6,14,6,16,53,61,-8,48
Annan Athlet,8827,7,11,12,13,48,42,6,45
Berwick,8827,8,8,10,18,30,60,-30,34
Edinburgh Ci,8827,9,7,10,19,36,60,-24,31
Cowdenbeath,8827,10,4,11,21,24,55,-31,23
Montrose,8828,1,24,7,5,63,34,29,79
Peterhead,8828,2,24,4,8,81,39,42,76
Stirling,8828,3,17,6,13,66,53,13,57
Clyde,8828,4,15,9,12,53,48,5,54
Stenhousem'r,8828,5,15,8,13,57,52,5,53
Elgin,8828,6,14,6,16,53,64,-11,48
Annan Athlet,8828,7,12,11,13,50,41,9,47
Berwick,8828,8,8,10,18,29,60,-31,34
Edinburgh Ci,8828,9,7,9,20,37,64,-27,30
Cowdenbeath,8828,10,4,10,22,23,57,-34,22
Montrose,8829,1,24,7,5,64,34,30,79
Peterhead,8829,2,24,4,8,80,39,41,76
Stirling,8829,3,16,7,13,61,52,9,55
Stenhousem'r,8829,4,15,9,12,56,47,9,54
Clyde,8829,5,14,10,12,53,50,3,52
Elgin,8829,6,14,6,16,53,65,-12,48
Annan Athlet,8829,7,12,11,13,50,41,9,47
Berwick,8829,8,8,11,17,31,60,-29,35
Edinburgh Ci,8829,9,7,9,20,37,63,-26,30
Cowdenbeath,8829,10,4,10,22,23,57,-34,22
Montrose,8830,1,23,8,5,61,36,25,77
Peterhead,8830,2,24,4,8,80,39,41,76
Stirling,8830,3,17,6,13,62,51,11,57
Stenhousem'r,8830,4,15,8,13,55,48,7,53
Clyde,8830,5,14,10,12,52,49,3,52
Elgin,8830,6,14,7,15,55,62,-7,49
Annan Athlet,8830,7,11,11,14,47,42,5,44
Berwick,8830,8,8,11,17,30,59,-29,35
Edinburgh Ci,8830,9,7,9,20,37,63,-26,30
Cowdenbeath,8830,10,5,10,21,24,54,-30,25
Montrose,8831,1,24,7,5,62,35,27,79
Peterhead,8831,2,24,4,8,80,39,41,76
Stirling,8831,3,17,6,13,62,52,10,57
Stenhousem'r,8831,4,15,8,13,56,48,8,53
Clyde,8831,5,14,9,13,51,51,0,51
Elgin,8831,6,14,6,16,54,63,-9,48
Annan Athlet,8831,7,11,11,14,49,44,5,44
Berwick,8831,8,9,10,17,32,58,-26,37
Edinburgh Ci,8831,9,7,9,20,37,63,-26,30
Cowdenbeath,8831,10,5,10,21,26,56,-30,25
Peterhead,8832,1,24,4,8,79,38,41,76
Montrose,8832,2,23,7,6,62,38,24,76
Stirling,8832,3,16,7,13,61,52,9,55
Stenhousem'r,8832,4,15,9,12,56,47,9,54
Clyde,8832,5,15,9,12,53,49,4,54
Elgin,8832,6,15,6,15,57,63,-6,51
Annan Athlet,8832,7,12,11,13,48,41,7,47
Berwick,8832,8,8,10,18,30,60,-30,34
Edinburgh Ci,8832,9,7,9,20,36,62,-26,30
Cowdenbeath,8832,10,4,10,22,23,55,-32,22
Peterhead,8833,1,24,4,8,80,39,41,76
Montrose,8833,2,23,7,6,60,36,24,76
Stirling,8833,3,16,7,13,60,51,9,55
Stenhousem'r,8833,4,15,9,12,55,46,9,54
Clyde,8833,5,15,9,12,56,48,8,54
Elgin,8833,6,15,6,15,55,61,-6,51
Annan Athlet,8833,7,11,12,13,47,41,6,45
Berwick,8833,8,8,10,18,29,63,-34,34
Edinburgh Ci,8833,9,7,9,20,37,63,-26,30
Cowdenbeath,8833,10,4,11,21,23,54,-31,23
Montrose,8834,1,24,7,5,61,35,26,79
Peterhead,8834,2,23,4,9,79,42,37,73
Stirling,8834,3,16,7,13,60,51,9,55
Stenhousem'r,8834,4,15,9,12,55,46,9,54
Clyde,8834,5,15,9,12,54,49,5,54
Elgin,8834,6,14,6,16,54,62,-8,48
Annan Athlet,8834,7,11,11,14,47,44,3,44
Berwick,8834,8,8,10,18,30,61,-31,34
Edinburgh Ci,8834,9,8,9,19,40,62,-22,33
Cowdenbeath,8834,10,5,10,21,26,54,-28,25
Montrose,8835,1,23,8,5,60,35,25,77
Peterhead,8835,2,24,4,8,81,38,43,76
Stirling,8835,3,16,7,13,62,53,9,55
Stenhousem'r,8835,4,15,9,12,57,48,9,54
Clyde,8835,5,15,9,12,54,50,4,54
Elgin,8835,6,14,7,15,54,61,-7,49
Annan Athlet,8835,7,11,12,13,47,41,6,45
Berwick,8835,8,8,10,18,31,61,-30,34
Edinburgh Ci,8835,9,7,9,20,36,64,-28,30
Cowdenbeath,8835,10,4,11,21,23,54,-31,23
Montrose,8836,1,24,7,5,62,35,27,79
Peterhead,8836,2,23,5,8,77,38,39,74
Stenhousem'r,8836,3,16,8,12,56,46,10,56
Stirling,8836,4,16,6,14,60,52,8,54
Clyde,8836,5,14,9,13,51,49,2,51
Elgin,8836,6,14,6,16,54,63,-9,48
Annan Athlet,8836,7,11,12,13,50,44,6,45
Berwick,8836,8,9,10,17,30,58,-28,37
Edinburgh Ci,8836,9,7,10,19,36,60,-24,31
Cowdenbeath,8836,10,4,11,21,26,57,-31,23
Montrose,8837,1,24,7,5,60,34,26,79
Peterhead,8837,2,24,4,8,79,38,41,76
Stirling,8837,3,17,6,13,61,51,10,57
Clyde,8837,4,15,9,12,54,50,4,54
Stenhousem'r,8837,5,15,8,13,55,47,8,53
Elgin,8837,6,14,6,16,53,61,-8,48
Annan Athlet,8837,7,11,11,14,47,42,5,44
Berwick,8837,8,8,10,18,31,61,-30,34
Edinburgh Ci,8837,9,7,9,20,36,62,-26,30
Cowdenbeath,8837,10,5,10,21,24,54,-30,25
Montrose,8838,1,24,7,5,64,36,28,79
Peterhead,8838,2,24,4,8,81,40,41,76
Stenhousem'r,8838,3,16,8,12,58,46,12,56
Stirling,8838,4,16,6,14,60,54,6,54
Clyde,8838,5,14,9,13,51,49,2,51
Elgin,8838,6,14,6,16,55,65,-10,48
Annan Athlet,8838,7,12,11,13,48,41,7,47
Berwick,8838,8,9,10,17,30,58,-28,37
Edinburgh Ci,8838,9,7,9,20,38,64,-26,30
Cowdenbeath,8838,10,4,10,22,23,55,-32,22
Peterhead,8839,1,24,4,8,81,39,42,76
Montrose,8839,2,23,7,6,61,37,24,76
Stenhousem'r,8839,3,16,8,12,57,46,11,56
Stirling,8839,4,16,6,14,60,53,7,54
Clyde,8839,5,15,9,12,52,48,4,54
Elgin,8839,6,15,6,15,56,62,-6,51
Annan Athlet,8839,7,12,11,13,48,41,7,47
Berwick,8839,8,8,10,18,29,59,-30,34
Edinburgh Ci,8839,9,7,9,20,37,64,-27,30
Cowdenbeath,8839,10,4,10,22,23,55,-32,22
Montrose,8840,1,23,8,5,60,35,25,77
Peterhead,8840,2,24,4,8,80,38,42,76
Stenhousem'r,8840,3,16,8,12,57,47,10,56
Stirling,8840,4,16,6,14,61,53,8,54
Clyde,8840,5,15,9,12,53,48,5,54
Elgin,8840,6,14,7,15,54,61,-7,49
Annan Athlet,8840,7,12,11,13,49,42,7,47
Berwick,8840,8,8,10,18,29,60,-31,34
Edinburgh Ci,8840,9,7,9,20,36,63,-27,30
Cowdenbeath,8840,10,4,10,22,24,56,-32,22
Montrose,8841,1,23,8,5,59,34,25,77
Peterhead,8841,2,24,4,8,82,39,43,76
Stenhousem'r,8841,3,16,8,12,57,47,10,56
Stirling,8841,4,16,6,14,61,53,8,54
Clyde,8841,5,14,10,12,52,49,3,52
Elgin,8841,6,14,7,15,53,60,-7,49
Annan Athlet,8841,7,11,11,14,47,43,4,44
Berwick,8841,8,8,11,17,30,59,-29,35
Edinburgh Ci,8841,9,7,9,20,37,65,-28,30
Cowdenbeath,8841,10,5,10,21,25,54,-29,25
Peterhead,8842,1,24,4,8,80,38,42,76
Montrose,8842,2,23,7,6,59,35,24,76
Stirling,8842,3,16,7,13,60,51,9,55
Stenhousem'r,8842,4,15,9,12,55,46,9,54
Clyde,8842,5,15,9,12,54,49,5,54
Elgin,8842,6,15,6,15,54,60,-6,51
Annan Athlet,8842,7,12,11,13,49,42,7,47
Berwick,8842,8,8,10,18,30,61,-31,34
Edinburgh Ci,8842,9,7,9,20,36,63,-27,30
Cowdenbeath,8842,10,4,10,22,24,56,-32,22
Montrose,8843,1,23,8,5,60,35,25,77
Peterhead,8843,2,23,5,8,77,38,39,74
Stenhousem'r,8843,3,16,8,12,56,46,10,56
Stirling,8843,4,16,6,14,60,52,8,54
Clyde,8843,5,14,9,13,51,51,0,51
Elgin,8843,6,14,7,15,54,61,-7,49
Annan Athlet,8843,7,12,11,13,50,41,9,47
Berwick,8843,8,9,10,17,32,58,-26,37
Edinburgh Ci,8843,9,7,10,19,36,60,-24,31
Cowdenbeath,8843,10,4,10,22,23,57,-34,22
Peterhead,8844,1,24,4,8,80,38,42,76
Montrose,8844,2,23,7,6,59,35,24,76
Stirling,8844,3,16,7,13,62,53,9,55
Stenhousem'r,8844,4,15,9,12,57,48,9,54
Clyde,8844,5,15,9,12,53,49,4,54
Elgin,8844,6,15,6,15,54,60,-6,51
Annan Athlet,8844,7,12,11,13,51,42,9,47
Berwick,8844,8,8,10,18,30,60,-30,34
Edinburgh Ci,8844,9,7,9,20,36,63,-27,30
Cowdenbeath,8844,10,4,10,22,24,58,-34,22
Montrose,8845,1,24,7,5,63,35,28,79
Peterhead,8845,2,23,5,8,80,41,39,74
Stenhousem'r,8845,3,16,8,12,59,47,12,56
Stirling,8845,4,16,6,14,61,55,6,54
Clyde,8845,5,15,9,12,52,48,4,54
Elgin,8845,6,14,6,16,54,64,-10,48
Annan Athlet,8845,7,11,12,13,47,41,6,45
Berwick,8845,8,8,10,18,29,59,-30,34
Edinburgh Ci,8845,9,7,10,19,39,63,-24,31
Cowdenbeath,8845,10,4,11,21,23,54,-31,23
Montrose,8846,1,23,8,5,60,35,25,77
Peterhead,8846,2,24,4,8,80,38,42,76
Stenhousem'r,8846,3,16,8,12,58,47,11,56
Stirling,8846,4,16,6,14,61,54,7,54
Clyde,8846,5,15,9,12,54,48,6,54
Elgin,8846,6,14,7,15,54,61,-7,49
Annan Athlet,8846,7,12,11,13,49,42,7,47
Berwick,8846,8,8,10,18,29,61,-32,34
Edinburgh Ci,8846,9,7,9,20,36,63,-27,30
Cowdenbeath,8846,10,4,10,22,24,56,-32,22
Montrose,8847,1,23,8,5,59,34,25,77
Peterhead,8847,2,24,4,8,79,38,41,76
Stenhousem'r,8847,3,16,8,12,58,47,11,56
Stirling,8847,4,16,6,14,61,54,7,54
Clyde,8847,5,15,9,12,53,48,5,54
Elgin,8847,6,14,7,15,53,60,-7,49
Annan Athlet,8847,7,11,11,14,47,43,4,44
Berwick,8847,8,8,10,18,29,60,-31,34
Edinburgh Ci,8847,9,7,9,20,36,62,-26,30
Cowdenbeath,8847,10,5,10,21,25,54,-29,25
Peterhead,8848,1,24,4,8,83,39,44,76
Montrose,8848,2,23,7,6,59,36,23,76
Stirling,8848,3,17,6,13,63,52,11,57
Clyde,8848,4,15,9,12,54,49,5,54
Stenhousem'r,8848,5,15,8,13,56,49,7,53
Elgin,8848,6,15,6,15,55,60,-5,51
Annan Athlet,8848,7,11,12,13,47,41,6,45
Berwick,8848,8,8,10,18,30,61,-31,34
Edinburgh Ci,8848,9,7,9,20,37,66,-29,30
Cowdenbeath,8848,10,4,11,21,23,54,-31,23
Montrose,8849,1,24,7,5,61,35,26,79
Peterhead,8849,2,24,4,8,80,40,40,76
Stenhousem'r,8849,3,16,8,12,56,46,10,56
Stirling,8849,4,16,6,14,60,52,8,54
Clyde,8849,5,15,9,12,52,48,4,54
Elgin,8849,6,14,6,16,54,62,-8,48
Annan Athlet,8849,7,12,11,13,49,41,8,47
Berwick,8849,8,8,10,18,29,59,-30,34
Edinburgh Ci,8849,9,7,9,20,38,63,-25,30
Cowdenbeath,8849,10,4,10,22,23,56,-33,22
Montrose,8850,1,23,8,5,60,35,25,77
Peterhead,8850,2,23,5,8,79,40,39,74
Stirling,8850,3,16,7,13,62,53,9,55
Stenhousem'r,8850,4,15,9,12,57,48,9,54
Clyde,8850,5,15,9,12,56,50,6,54
Elgin,8850,6,14,7,15,54,61,-7,49
Annan Athlet,8850,7,12,11,13,49,41,8,47
Berwick,8850,8,8,10,18,31,63,-32,34
Edinburgh Ci,8850,9,7,10,19,38,62,-24,31
Cowdenbeath,8850,10,4,10,22,23,56,-33,22
Montrose,8851,1,24,7,5,62,36,26,79
Peterhead,8851,2,23,4,9,78,40,38,73
Stirling,8851,3,16,7,13,61,52,9,55
Stenhousem'r,8851,4,15,9,12,56,47,9,54
Clyde,8851,5,15,9,12,53,48,5,54
Elgin,8851,6,14,6,16,55,63,-8,48
Annan Athlet,8851,7,11,12,13,47,41,6,45
Berwick,8851,8,8,10,18,29,60,-31,34
Edinburgh Ci,8851,9,8,9,19,38,61,-23,33
Cowdenbeath,8851,10,4,11,21,23,54,-31,23
Montrose,8852,1,23,8,5,59,34,25,77
Peterhead,8852,2,24,4,8,78,38,40,76
Stirling,8852,3,17,6,13,62,52,10,57
Clyde,8852,4,15,9,12,54,48,6,54
Stenhousem'r,8852,5,15,8,13,56,48,8,53
Elgin,8852,6,14,7,15,53,60,-7,49
Annan Athlet,8852,7,11,11,14,47,43,4,44
Berwick,8852,8,8,10,18,29,61,-32,34
Edinburgh Ci,8852,9,7,9,20,36,61,-25,30
Cowdenbeath,8852,10,5,10,21,25,54,-29,25
Montrose,8853,1,24,7,5,60,34,26,79
Peterhead,8853,2,24,4,8,80,38,42,76
Stirling,8853,3,17,6,13,63,51,12,57
Clyde,8853,4,15,9,12,53,48,5,54
Stenhousem'r,8853,5,15,8,13,55,49,6,53
Elgin,8853,6,14,6,16,53,61,-8,48
Annan Athlet,8853,7,11,11,14,47,43,4,44
Berwick,8853,8,8,10,18,29,60,-31,34
Edinburgh Ci,8853,9,7,9,20,36,63,-27,30
Cowdenbeath,8853,10,5,10,21,25,54,-29,25
Montrose,8854,1,23,8,5,60,35,25,77
Peterhead,8854,2,24,4,8,80,38,42,76
Stirling,8854,3,17,6,13,63,51,12,57
Stenhousem'r,8854,4,15,8,13,55,49,6,53
Clyde,8854,5,14,9,13,52,50,2,51
Elgin,8854,6,14,7,15,54,61,-7,49
Annan Athlet,8854,7,11,11,14,47,42,5,44
Berwick,8854,8,9,10,17,31,59,-28,37
Edinburgh Ci,8854,9,7,9,20,36,63,-27,30
Cowdenbeath,8854,10,5,10,21,24,54,-30,25
Montrose,8855,1,23,8,5,59,34,25,77
Peterhead,8855,2,24,4,8,79,39,40,76
Stirling,8855,3,17,6,13,62,52,10,57
Stenhousem'r,8855,4,15,8,13,56,48,8,53
Clyde,8855,5,14,10,12,51,48,3,52
Elgin,8855,6,14,7,15,53,60,-7,49
Annan Athlet,8855,7,12,11,13,50,41,9,47
Berwick,8855,8,8,11,17,29,58,-29,35
Edinburgh Ci,8855,9,7,9,20,37,62,-25,30
Cowdenbeath,8855,10,4,10,22,23,57,-34,22
Montrose,8856,1,24,7,5,60,34,26,79
Peterhead,8856,2,24,4,8,83,38,45,76
Stirling,8856,3,16,7,13,61,52,9,55
Stenhousem'r,8856,4,15,9,12,56,47,9,54
Clyde,8856,5,14,10,12,52,49,3,52
Elgin,8856,6,14,6,16,53,61,-8,48
Annan Athlet,8856,7,12,11,13,50,43,7,47
Berwick,8856,8,8,11,17,30,59,-29,35
Edinburgh Ci,8856,9,7,9,20,36,66,-30,30
Cowdenbeath,8856,10,4,10,22,25,57,-32,22
Montrose,8857,1,23,8,5,61,36,25,77
Peterhead,8857,2,24,4,8,82,40,42,76
Stenhousem'r,8857,3,16,8,12,57,46,11,56
Stirling,8857,4,16,6,14,60,53,7,54
Clyde,8857,5,15,9,12,53,48,5,54
Elgin,8857,6,14,7,15,55,62,-7,49
Annan Athlet,8857,7,11,12,13,47,41,6,45
Berwick,8857,8,8,10,18,29,60,-31,34
Edinburgh Ci,8857,9,7,9,20,38,65,-27,30
Cowdenbeath,8857,10,4,11,21,23,54,-31,23
Montrose,8858,1,23,7,6,60,36,24,76
Peterhead,8858,2,23,5,8,79,40,39,74
Stirling,8858,3,17,6,13,61,51,10,57
Clyde,8858,4,15,9,12,56,48,8,54
Stenhousem'r,8858,5,15,8,13,55,47,8,53
Elgin,8858,6,15,6,15,55,61,-6,51
Annan Athlet,8858,7,11,11,14,48,45,3,44
Berwick,8858,8,8,10,18,29,63,-34,34
Edinburgh Ci,8858,9,7,10,19,38,62,-24,31
Cowdenbeath,8858,10,5,10,21,27,55,-28,25
Peterhead,8859,1,24,4,8,80,39,41,76
Montrose,8859,2,23,7,6,62,38,24,76
Stirling,8859,3,17,6,13,61,51,10,57
Clyde,8859,4,15,9,12,53,49,4,54
Stenhousem'r,8859,5,15,8,13,55,47,8,53
Elgin,8859,6,15,6,15,57,63,-6,51
Annan Athlet,8859,7,11,12,13,47,41,6,45
Berwick,8859,8,8,10,18,30,60,-30,34
Edinburgh Ci,8859,9,7,9,20,37,63,-26,30
Cowdenbeath,8859,10,4,11,21,23,54,-31,23
Montrose,8860,1,23,7,6,60,37,23,76
Peterhead,8860,2,23,5,8,78,39,39,74
Stirling,8860,3,17,6,13,63,51,12,57
Stenhousem'r,8860,4,15,8,13,55,49,6,53
Clyde,8860,5,14,10,12,51,48,3,52
Elgin,8860,6,15,6,15,56,61,-5,51
Annan Athlet,8860,7,11,11,14,47,44,3,44
Berwick,8860,8,8,11,17,29,58,-29,35
Edinburgh Ci,8860,9,7,10,19,37,61,-24,31
Cowdenbeath,8860,10,5,10,21,26,54,-28,25
Montrose,8861,1,23,8,5,60,35,25,77
Peterhead,8861,2,24,4,8,80,38,42,76
Stirling,8861,3,17,6,13,62,51,11,57
Clyde,8861,4,15,9,12,52,48,4,54
Stenhousem'r,8861,5,15,8,13,55,48,7,53
Elgin,8861,6,14,7,15,54,61,-7,49
Annan Athlet,8861,7,11,12,13,49,43,6,45
Berwick,8861,8,8,10,18,29,59,-30,34
Edinburgh Ci,8861,9,7,9,20,36,63,-27,30
Cowdenbeath,8861,10,4,11,21,25,56,-31,23
Montrose,8862,1,24,7,5,62,35,27,79
Peterhead,8862,2,24,4,8,85,39,46,76
Stirling,8862,3,16,7,13,62,53,9,55
Stenhousem'r,8862,4,15,9,12,57,48,9,54
Clyde,8862,5,14,10,12,53,50,3,52
Elgin,8862,6,14,6,16,54,63,-9,48
Annan Athlet,8862,7,11,12,13,47,41,6,45
Berwick,8862,8,8,11,17,31,60,-29,35
Edinburgh Ci,8862,9,7,9,20,37,68,-31,30
Cowdenbeath,8862,10,4,11,21,23,54,-31,23
Montrose,8863,1,24,7,5,63,34,29,79
Peterhead,8863,2,23,5,8,79,40,39,74
Stirling,8863,3,17,6,13,62,52,10,57
Clyde,8863,4,15,9,12,52,48,4,54
Stenhousem'r,8863,5,15,8,13,56,48,8,53
Elgin,8863,6,14,6,16,53,64,-11,48
Annan Athlet,8863,7,11,12,13,47,41,6,45
Berwick,8863,8,8,10,18,29,59,-30,34
Edinburgh Ci,8863,9,7,10,19,38,62,-24,31
Cowdenbeath,8863,10,4,11,21,23,54,-31,23
Montrose,8864,1,23,8,5,62,37,25,77
Peterhead,8864,2,24,4,8,79,38,41,76
Stenhousem'r,8864,3,16,8,12,56,46,10,56
Stirling,8864,4,16,6,14,60,52,8,54
Clyde,8864,5,14,9,13,52,50,2,51
Elgin,8864,6,14,7,15,56,63,-7,49
Annan Athlet,8864,7,12,11,13,50,42,8,47
Berwick,8864,8,9,10,17,31,59,-28,37
Edinburgh Ci,8864,9,7,9,20,36,62,-26,30
Cowdenbeath,8864,10,4,10,22,24,57,-33,22
Montrose,8865,1,24,7,5,60,34,26,79
Peterhead,8865,2,23,5,8,78,39,39,74
Stirling,8865,3,17,6,13,62,52,10,57
Stenhousem'r,8865,4,15,8,13,56,48,8,53
Clyde,8865,5,14,10,12,52,49,3,52
Elgin,8865,6,14,6,16,53,61,-8,48
Annan Athlet,8865,7,11,12,13,47,41,6,45
Berwick,8865,8,8,11,17,30,59,-29,35
Edinburgh Ci,8865,9,7,10,19,37,61,-24,31
Cowdenbeath,8865,10,4,11,21,23,54,-31,23
Montrose,8866,1,24,7,5,63,36,27,79
Peterhead,8866,2,23,4,9,77,39,38,73
Stirling,8866,3,17,6,13,62,51,11,57
Stenhousem'r,8866,4,15,8,13,55,48,7,53
Clyde,8866,5,14,9,13,51,49,2,51
Elgin,8866,6,14,6,16,55,64,-9,48
Annan Athlet,8866,7,11,12,13,48,42,6,45
Berwick,8866,8,9,10,17,30,58,-28,37
Edinburgh Ci,8866,9,8,9,19,37,60,-23,33
Cowdenbeath,8866,10,4,11,21,24,55,-31,23
Montrose,8867,1,24,7,5,62,34,28,79
Peterhead,8867,2,24,4,8,80,39,41,76
Stenhousem'r,8867,3,16,8,12,58,48,10,56
Stirling,8867,4,16,6,14,62,54,8,54
Clyde,8867,5,15,9,12,53,49,4,54
Elgin,8867,6,14,6,16,53,63,-10,48
Annan Athlet,8867,7,11,11,14,48,43,5,44
Berwick,8867,8,8,10,18,30,60,-30,34
Edinburgh Ci,8867,9,7,9,20,37,63,-26,30
Cowdenbeath,8867,10,5,10,21,25,55,-30,25
Montrose,8868,1,23,8,5,59,34,25,77
Peterhead,8868,2,23,4,9,77,40,37,73
Stirling,8868,3,17,6,13,61,51,10,57
Stenhousem'r,8868,4,15,8,13,55,47,8,53
Clyde,8868,5,14,10,12,51,48,3,52
Elgin,8868,6,14,7,15,53,60,-7,49
Annan Athlet,8868,7,12,11,13,50,42,8,47
Berwick,8868,8,8,11,17,29,58,-29,35
Edinburgh Ci,8868,9,8,9,19,38,60,-22,33
Cowdenbeath,8868,10,4,10,22,24,57,-33,22
Montrose,8869,1,24,7,5,61,35,26,79
Peterhead,8869,2,24,4,8,82,39,43,76
Stirling,8869,3,17,6,13,64,51,13,57
Clyde,8869,4,15,9,12,54,49,5,54
Stenhousem'r,8869,5,15,8,13,55,50,5,53
Elgin,8869,6,14,6,16,54,62,-8,48
Annan Athlet,8869,7,11,11,14,47,43,4,44
Berwick,8869,8,8,10,18,30,61,-31,34
Edinburgh Ci,8869,9,7,9,20,37,65,-28,30
Cowdenbeath,8869,10,5,10,21,25,54,-29,25
Montrose,8870,1,24,7,5,64,34,30,79
Peterhead,8870,2,24,4,8,81,38,43,76
Stirling,8870,3,17,6,13,63,52,11,57
Clyde,8870,4,15,9,12,52,48,4,54
Stenhousem'r,8870,5,15,8,13,56,49,7,53
Elgin,8870,6,14,6,16,53,65,-12,48
Annan Athlet,8870,7,12,11,13,48,41,7,47
Berwick,8870,8,8,10,18,29,59,-30,34
Edinburgh Ci,8870,9,7,9,20,36,64,-28,30
Cowdenbeath,8870,10,4,10,22,23,55,-32,22
Montrose,8871,1,24,7,5,62,34,28,79
Peterhead,8871,2,23,4,9,77,39,38,73
Stirling,8871,3,16,7,13,62,53,9,55
Stenhousem'r,8871,4,15,9,12,57,48,9,54
Clyde,8871,5,14,9,13,51,50,1,51
Elgin,8871,6,14,6,16,53,63,-10,48
Annan Athlet,8871,7,11,11,14,47,43,4,44
Berwick,8871,8,9,10,17,31,58,-27,37
Edinburgh Ci,8871,9,8,9,19,37,60,-23,33
Cowdenbeath,8871,10,5,10,21,25,54,-29,25
Montrose,8872,1,24,7,5,62,34,28,79
Peterhead,8872,2,24,4,8,82,39,43,76
Stirling,8872,3,17,6,13,63,51,12,57
Clyde,8872,4,15,9,12,55,48,7,54
Stenhousem'r,8872,5,15,8,13,55,49,6,53
Elgin,8872,6,14,6,16,53,63,-10,48
Annan Athlet,8872,7,11,12,13,48,42,6,45
Berwick,8872,8,8,10,18,29,62,-33,34
Edinburgh Ci,8872,9,7,9,20,37,65,-28,30
Cowdenbeath,8872,10,4,11,21,24,55,-31,23
Peterhead,8873,1,24,4,8,84,40,44,76
Montrose,8873,2,23,7,6,60,36,24,76
Stirling,8873,3,17,6,13,61,51,10,57
Clyde,8873,4,15,9,12,56,50,6,54
Stenhousem'r,8873,5,15,8,13,55,47,8,53
Elgin,8873,6,15,6,15,55,61,-6,51
Annan Athlet,8873,7,11,12,13,49,43,6,45
Berwick,8873,8,8,10,18,31,63,-32,34
Edinburgh Ci,8873,9,7,9,20,38,67,-29,30
Cowdenbeath,8873,10,4,11,21,25,56,-31,23
Montrose,8874,1,24,7,5,62,35,27,79
Peterhead,8874,2,24,4,8,81,40,41,76
Stenhousem'r,8874,3,16,8,12,58,46,12,56
Stirling,8874,4,16,6,14,60,54,6,54
Clyde,8874,5,15,9,12,53,49,4,54
Elgin,8874,6,14,6,16,54,63,-9,48
Annan Athlet,8874,7,11,11,14,47,42,5,44
Berwick,8874,8,8,10,18,30,60,-30,34
Edinburgh Ci,8874,9,7,9,20,38,64,-26,30
Cowdenbeath,8874,10,5,10,21,24,54,-30,25
Montrose,8875,1,24,7,5,61,35,26,79
Peterhead,8875,2,24,4,8,79,39,40,76
Stirling,8875,3,17,6,13,63,52,11,57
Clyde,8875,4,15,9,12,54,50,4,54
Stenhousem'r,8875,5,15,8,13,56,49,7,53
Elgin,8875,6,14,6,16,54,62,-8,48
Annan Athlet,8875,7,12,11,13,48,41,7,47
Berwick,8875,8,8,10,18,31,61,-30,34
Edinburgh Ci,8875,9,7,9,20,37,62,-25,30
Cowdenbeath,8875,10,4,10,22,23,55,-32,22
Montrose,8876,1,23,8,5,60,35,25,77
Peterhead,8876,2,24,4,8,79,38,41,76
Stirling,8876,3,16,7,13,60,51,9,55
Stenhousem'r,8876,4,15,9,12,55,46,9,54
Clyde,8876,5,15,9,12,53,49,4,54
Elgin,8876,6,14,7,15,54,61,-7,49
Annan Athlet,8876,7,11,12,13,47,41,6,45
Berwick,8876,8,8,10,18,30,60,-30,34
Edinburgh Ci,8876,9,7,9,20,36,62,-26,30
Cowdenbeath,8876,10,4,11,21,23,54,-31,23
Peterhead,8877,1,24,4,8,80,40,40,76
Montrose,8877,2,23,7,6,59,35,24,76
Stirling,8877,3,17,6,13,64,52,12,57
Stenhousem'r,8877,4,15,8,13,56,50,6,53
Clyde,8877,5,14,10,12,52,49,3,52
Elgin,8877,6,15,6,15,54,60,-6,51
Annan Athlet,8877,7,11,12,13,48,42,6,45
Berwick,8877,8,8,11,17,30,59,-29,35
Edinburgh Ci,8877,9,7,9,20,38,63,-25,30
Cowdenbeath,8877,10,4,11,21,24,55,-31,23
Peterhead,8878,1,24,4,8,81,39,42,76
Montrose,8878,2,23,7,6,59,35,24,76
Stirling,8878,3,16,7,13,62,53,9,55
Stenhousem'r,8878,4,15,9,12,57,48,9,54
Clyde,8878,5,14,9,13,53,51,2,51
Elgin,8878,6,15,6,15,54,60,-6,51
Annan Athlet,8878,7,11,11,14,47,43,4,44
Berwick,8878,8,9,10,17,32,60,-28,37
Edinburgh Ci,8878,9,7,9,20,37,64,-27,30
Cowdenbeath,8878,10,5,10,21,25,54,-29,25
Montrose,8879,1,24,7,5,63,34,29,79
Peterhead,8879,2,24,4,8,80,38,42,76
Stirling,8879,3,16,7,13,62,53,9,55
Stenhousem'r,8879,4,15,9,12,57,48,9,54
Clyde,8879,5,14,9,13,51,49,2,51
Elgin,8879,6,14,6,16,53,64,-11,48
Annan Athlet,8879,7,12,11,13,49,42,7,47
Berwick,8879,8,9,10,17,30,58,-28,37
Edinburgh Ci,8879,9,7,9,20,36,63,-27,30
Cowdenbeath,8879,10,4,10,22,24,56,-32,22
Montrose,8880,1,23,7,6,60,36,24,76
Peterhead,8880,2,23,4,9,77,40,37,73
Stirling,8880,3,17,6,13,64,52,12,57
Stenhousem'r,8880,4,15,8,13,56,50,6,53
Clyde,8880,5,14,9,13,51,52,-1,51
Elgin,8880,6,15,6,15,55,61,-6,51
Annan Athlet,8880,7,11,12,13,48,42,6,45
Berwick,8880,8,9,10,17,33,58,-25,37
Edinburgh Ci,8880,9,8,9,19,38,60,-22,33
Cowdenbeath,8880,10,4,11,21,24,55,-31,23
Montrose,8881,1,23,8,5,61,36,25,77
Peterhead,8881,2,24,4,8,80,39,41,76
Stirling,8881,3,17,6,13,64,51,13,57
Stenhousem'r,8881,4,15,8,13,55,50,5,53
Clyde,8881,5,14,9,13,51,49,2,51
Elgin,8881,6,14,7,15,55,62,-7,49
Annan Athlet,8881,7,11,11,14,47,42,5,44
Berwick,8881,8,9,10,17,30,58,-28,37
Edinburgh Ci,8881,9,7,9,20,37,63,-26,30
Cowdenbeath,8881,10,5,10,21,24,54,-30,25
Montrose,8882,1,23,8,5,60,35,25,77
Peterhead,8882,2,24,4,8,79,38,41,76
Stenhousem'r,8882,3,16,8,12,60,48,12,56
Stirling,8882,4,16,6,14,62,56,6,54
Clyde,8882,5,15,9,12,54,49,5,54
Elgin,8882,6,14,7,15,54,61,-7,49
Annan Athlet,8882,7,11,11,14,49,44,5,44
Berwick,8882,8,8,10,18,30,61,-31,34
Edinburgh Ci,8882,9,7,9,20,36,62,-26,30
Cowdenbeath,8882,10,5,10,21,26,56,-30,25
Montrose,8883,1,23,8,5,60,35,25,77
Peterhead,8883,2,24,4,8,81,41,40,76
Stenhousem'r,8883,3,16,8,12,57,46,11,56
Stirling,8883,4,16,6,14,60,53,7,54
Clyde,8883,5,14,10,12,52,49,3,52
Elgin,8883,6,14,7,15,54,61,-7,49
Annan Athlet,8883,7,11,11,14,47,42,5,44
Berwick,8883,8,8,11,17,30,59,-29,35
Edinburgh Ci,8883,9,7,9,20,39,64,-25,30
Cowdenbeath,8883,10,5,10,21,24,54,-30,25
Montrose,8884,1,23,7,6,59,35,24,76
Peterhead,8884,2,23,5,8,80,41,39,74
Stirling,8884,3,17,6,13,61,51,10,57
Clyde,8884,4,15,9,12,54,49,5,54
Stenhousem'r,8884,5,15,8,13,55,47,8,53
Elgin,8884,6,15,6,15,54,60,-6,51
Annan Athlet,8884,7,11,12,13,48,42,6,45
Berwick,8884,8,8,10,18,30,61,-31,34
Edinburgh Ci,8884,9,7,10,19,39,63,-24,31
Cowdenbeath,8884,10,4,11,21,24,55,-31,23
Peterhead,8885,1,24,4,8,80,38,42,76
Montrose,8885,2,23,7,6,60,36,24,76
Stirling,8885,3,16,7,13,60,51,9,55
Stenhousem'r,8885,4,15,9,12,55,46,9,54
Clyde,8885,5,14,10,12,52,49,3,52
Elgin,8885,6,15,6,15,55,61,-6,51
Annan Athlet,8885,7,11,12,13,48,42,6,45
Berwick,8885,8,8,11,17,30,59,-29,35
Edinburgh Ci,8885,9,7,9,20,36,63,-27,30
Cowdenbeath,8885,10,4,11,21,24,55,-31,23
Montrose,8886,1,24,7,5,62,35,27,79
Peterhead,8886,2,24,4,8,79,38,41,76
Stirling,8886,3,17,6,13,67,52,15,57
Clyde,8886,4,15,9,12,55,48,7,54
Stenhousem'r,8886,5,15,8,13,56,53,3,53
Elgin,8886,6,14,6,16,54,63,-9,48
Annan Athlet,8886,7,11,12,13,47,41,6,45
Berwick,8886,8,8,10,18,29,62,-33,34
Edinburgh Ci,8886,9,7,9,20,36,62,-26,30
Cowdenbeath,8886,10,4,11,21,23,54,-31,23
Montrose,8887,1,23,8,5,61,36,25,77
Peterhead,8887,2,23,5,8,77,38,39,74
Stirling,8887,3,16,7,13,60,51,9,55
Stenhousem'r,8887,4,15,9,12,55,46,9,54
Clyde,8887,5,14,10,12,52,49,3,52
Elgin,8887,6,14,7,15,55,62,-7,49
Annan Athlet,8887,7,11,11,14,48,43,5,44
Berwick,8887,8,8,11,17,30,59,-29,35
Edinburgh Ci,8887,9,7,10,19,36,60,-24,31
Cowdenbeath,8887,10,5,10,21,25,55,-30,25
Montrose,8888,1,24,7,5,60,34,26,79
Peterhead,8888,2,23,5,8,78,39,39,74
Stirling,8888,3,16,7,13,62,53,9,55
Stenhousem'r,8888,4,15,9,12,57,48,9,54
Clyde,8888,5,15,9,12,53,48,5,54
Elgin,8888,6,14,6,16,53,61,-8,48
Annan Athlet,8888,7,11,11,14,49,44,5,44
Berwick,8888,8,8,10,18,29,60,-31,34
Edinburgh Ci,8888,9,7,10,19,37,61,-24,31
Cowdenbeath,8888,10,5,10,21,26,56,-30,25
Montrose,8889,1,24,7,5,62,34,28,79
Peterhead,8889,2,23,5,8,79,40,39,74
Stirling,8889,3,17,6,13,65,52,13,57
Clyde,8889,4,15,9,12,52,48,4,54
Stenhousem'r,8889,5,15,8,13,56,51,5,53
Elgin,8889,6,14,6,16,53,63,-10,48
Annan Athlet,8889,7,12,11,13,51,42,9,47
Berwick,8889,8,8,10,18,29,59,-30,34
Edinburgh Ci,8889,9,7,10,19,38,62,-24,31
Cowdenbeath,8889,10,4,10,22,24,58,-34,22
Montrose,8890,1,24,7,5,60,34,26,79
Peterhead,8890,2,24,4,8,79,39,40,76
Stirling,8890,3,16,7,13,60,51,9,55
Stenhousem'r,8890,4,15,9,12,55,46,9,54
Clyde,8890,5,15,9,12,52,48,4,54
Elgin,8890,6,14,6,16,53,61,-8,48
Annan Athlet,8890,7,12,11,13,49,41,8,47
Berwick,8890,8,8,10,18,29,59,-30,34
Edinburgh Ci,8890,9,7,9,20,37,62,-25,30
Cowdenbeath,8890,10,4,10,22,23,56,-33,22
Montrose,8891,1,23,8,5,61,36,25,77
Peterhead,8891,2,24,4,8,80,40,40,76
Stirling,8891,3,17,6,13,61,51,10,57
Stenhousem'r,8891,4,15,8,13,55,47,8,53
Clyde,8891,5,14,9,13,51,51,0,51
Elgin,8891,6,14,7,15,55,62,-7,49
Annan Athlet,8891,7,12,11,13,49,41,8,47
Berwick,8891,8,9,10,17,32,58,-26,37
Edinburgh Ci,8891,9,7,9,20,38,63,-25,30
Cowdenbeath,8891,10,4,10,22,23,56,-33,22
Montrose,8892,1,24,7,5,62,34,28,79
Peterhead,8892,2,24,4,8,80,38,42,76
Stirling,8892,3,17,6,13,65,52,13,57
Clyde,8892,4,15,9,12,53,49,4,54
Stenhousem'r,8892,5,15,8,13,56,51,5,53
Elgin,8892,6,14,6,16,53,63,-10,48
Annan Athlet,8892,7,11,12,13,47,41,6,45
Berwick,8892,8,8,10,18,30,60,-30,34
Edinburgh Ci,8892,9,7,9,20,36,63,-27,30
Cowdenbeath,8892,10,4,11,21,23,54,-31,23
Montrose,8893,1,23,8,5,62,37,25,77
Peterhead,8893,2,24,4,8,82,39,43,76
Stirling,8893,3,16,7,13,63,54,9,55
Stenhousem'r,8893,4,15,9,12,58,49,9,54
Clyde,8893,5,15,9,12,55,48,7,54
Elgin,8893,6,14,7,15,56,63,-7,49
Annan Athlet,8893,7,12,11,13,48,41,7,47
Berwick,8893,8,8,10,18,29,62,-33,34
Edinburgh Ci,8893,9,7,9,20,37,65,-28,30
Cowdenbeath,8893,10,4,10,22,23,55,-32,22
Montrose,8894,1,23,8,5,61,36,25,77
Peterhead,8894,2,24,4,8,80,40,40,76
Stenhousem'r,8894,3,16,8,12,56,46,10,56
Stirling,8894,4,16,6,14,60,52,8,54
Clyde,8894,5,15,9,12,52,48,4,54
Elgin,8894,6,14,7,15,55,62,-7,49
Annan Athlet,8894,7,12,11,13,51,42,9,47
Berwick,8894,8,8,10,18,29,59,-30,34
Edinburgh Ci,8894,9,7,9,20,38,63,-25,30
Cowdenbeath,8894,10,4,10,22,24,58,-34,22
Montrose,8895,1,24,7,5,62,35,27,79
Peterhead,8895,2,23,4,9,77,39,38,73
Stenhousem'r,8895,3,16,8,12,57,47,10,56
Stirling,8895,4,16,6,14,61,53,8,54
Clyde,8895,5,15,9,12,53,49,4,54
Elgin,8895,6,14,6,16,54,63,-9,48
Annan Athlet,8895,7,11,12,13,48,42,6,45
Berwick,8895,8,8,10,18,30,60,-30,34
Edinburgh Ci,8895,9,8,9,19,37,60,-23,33
Cowdenbeath,8895,10,4,11,21,24,55,-31,23
Montrose,8896,1,23,8,5,61,36,25,77
Peterhead,8896,2,24,4,8,82,38,44,76
Stirling,8896,3,16,7,13,61,52,9,55
Stenhousem'r,8896,4,15,9,12,56,47,9,54
Clyde,8896,5,14,10,12,52,49,3,52
Elgin,8896,6,14,7,15,55,62,-7,49
Annan Athlet,8896,7,12,11,13,50,43,7,47
Berwick,8896,8,8,11,17,30,59,-29,35
Edinburgh Ci,8896,9,7,9,20,36,65,-29,30
Cowdenbeath,8896,10,4,10,22,25,57,-32,22
Montrose,8897,1,24,7,5,63,35,28,79
Peterhead,8897,2,24,4,8,83,39,44,76
Stirling,8897,3,17,6,13,62,51,11,57
Clyde,8897,4,15,9,12,53,48,5,54
Stenhousem'r,8897,5,15,8,13,55,48,7,53
Elgin,8897,6,14,6,16,54,64,-10,48
Annan Athlet,8897,7,12,11,13,49,41,8,47
Berwick,8897,8,8,10,18,29,60,-31,34
Edinburgh Ci,8897,9,7,9,20,37,66,-29,30
Cowdenbeath,8897,10,4,10,22,23,56,-33,22
Montrose,8898,1,24,7,5,62,35,27,79
Peterhead,8898,2,24,4,8,82,38,44,76
Stirling,8898,3,17,6,13,63,53,10,57
Clyde,8898,4,15,9,12,53,48,5,54
Stenhousem'r,8898,5,15,8,13,57,49,8,53
Elgin,8898,6,14,6,16,54,63,-9,48
Annan Athlet,8898,7,12,11,13,49,41,8,47
Berwick,8898,8,8,10,18,29,60,-31,34
Edinburgh Ci,8898,9,7,9,20,36,65,-29,30
Cowdenbeath,8898,10,4,10,22,23,56,-33,22
Montrose,8899,1,24,7,5,61,34,27,79
Peterhead,8899,2,24,4,8,78,38,40,76
Stirling,8899,3,16,7,13,62,53,9,55
Stenhousem'r,8899,4,15,9,12,57,48,9,54
Clyde,8899,5,15,9,12,52,48,4,54
Elgin,8899,6,14,6,16,53,62,-9,48
Annan Athlet,8899,7,12,11,13,49,41,8,47
Berwick,8899,8,8,10,18,29,59,-30,34
Edinburgh Ci,8899,9,7,9,20,36,61,-25,30
Cowdenbeath,8899,10,4,10,22,23,56,-33,22
Montrose,8900,1,24,7,5,61,35,26,79
Peterhead,8900,2,23,4,9,77,39,38,73
Stirling,8900,3,17,6,13,62,52,10,57
Stenhousem'r,8900,4,15,8,13,56,48,8,53
Clyde,8900,5,14,10,12,53,50,3,52
Elgin,8900,6,14,6,16,54,62,-8,48
Annan Athlet,8900,7,11,12,13,48,42,6,45
Berwick,8900,8,8,11,17,31,60,-29,35
Edinburgh Ci,8900,9,8,9,19,37,60,-23,33
Cowdenbeath,8900,10,4,11,21,24,55,-31,23
Montrose,8901,1,24,7,5,63,34,29,79
Peterhead,8901,2,24,4,8,80,38,42,76
Stirling,8901,3,16,7,13,60,51,9,55
Stenhousem'r,8901,4,15,9,12,55,46,9,54
Clyde,8901,5,15,9,12,52,48,4,54
Elgin,8901,6,14,6,16,53,64,-11,48
Annan Athlet,8901,7,12,11,13,48,41,7,47
Berwick,8901,8,8,10,18,29,59,-30,34
Edinburgh Ci,8901,9,7,9,20,36,63,-27,30
Cowdenbeath,8901,10,4,10,22,23,55,-32,22
Montrose,8902,1,24,7,5,61,35,26,79
Peterhead,8902,2,23,5,8,79,40,39,74
Stenhousem'r,8902,3,16,8,12,59,47,12,56
Stirling,8902,4,16,6,14,61,55,6,54
Clyde,8902,5,15,9,12,54,48,6,54
Elgin,8902,6,14,6,16,54,62,-8,48
Annan Athlet,8902,7,11,12,13,47,41,6,45
Berwick,8902,8,8,10,18,29,61,-32,34
Edinburgh Ci,8902,9,7,10,19,38,62,-24,31
Cowdenbeath,8902,10,4,11,21,23,54,-31,23
Montrose,8903,1,24,7,5,62,36,26,79
Peterhead,8903,2,24,4,8,81,38,43,76
Stirling,8903,3,17,6,13,62,52,10,57
Clyde,8903,4,15,9,12,54,49,5,54
Stenhousem'r,8903,5,15,8,13,56,48,8,53
Elgin,8903,6,14,6,16,55,63,-8,48
Annan Athlet,8903,7,11,12,13,47,41,6,45
Berwick,8903,8,8,10,18,30,61,-31,34
Edinburgh Ci,8903,9,7,9,20,36,64,-28,30
Cowdenbeath,8903,10,4,11,21,23,54,-31,23
Montrose,8904,1,23,8,5,59,34,25,77
Peterhead,8904,2,23,5,8,78,39,39,74
Stirling,8904,3,17,6,13,64,51,13,57
Clyde,8904,4,15,9,12,52,48,4,54
Stenhousem'r,8904,5,15,8,13,55,50,5,53
Elgin,8904,6,14,7,15,53,60,-7,49
Annan Athlet,8904,7,11,11,14,47,43,4,44
Berwick,8904,8,8,10,18,29,59,-30,34
Edinburgh Ci,8904,9,7,10,19,37,61,-24,31
Cowdenbeath,8904,10,5,10,21,25,54,-29,25
Montrose,8905,1,23,7,6,59,36,23,76
Peterhead,8905,2,23,5,8,80,41,39,74
Stenhousem'r,8905,3,16,8,12,56,46,10,56
Stirling,8905,4,16,6,14,60,52,8,54
Clyde,8905,5,15,9,12,54,49,5,54
Elgin,8905,6,15,6,15,55,60,-5,51
Annan Athlet,8905,7,12,11,13,49,41,8,47
Berwick,8905,8,8,10,18,30,61,-31,34
Edinburgh Ci,8905,9,7,10,19,39,63,-24,31
Cowdenbeath,8905,10,4,10,22,23,56,-33,22
Montrose,8906,1,24,7,5,63,34,29,79
Peterhead,8906,2,24,4,8,80,38,42,76
Stirling,8906,3,17,6,13,66,51,15,57
Stenhousem'r,8906,4,15,8,13,55,52,3,53
Clyde,8906,5,14,9,13,51,49,2,51
Elgin,8906,6,14,6,16,53,64,-11,48
Annan Athlet,8906,7,11,12,13,48,42,6,45
Berwick,8906,8,9,10,17,30,58,-28,37
Edinburgh Ci,8906,9,7,9,20,36,63,-27,30
Cowdenbeath,8906,10,4,11,21,24,55,-31,23
Montrose,8907,1,23,8,5,59,34,25,77
Peterhead,8907,2,23,5,8,77,38,39,74
Stenhousem'r,8907,3,16,8,12,56,46,10,56
Stirling,8907,4,16,6,14,60,52,8,54
Clyde,8907,5,14,10,12,53,50,3,52
Elgin,8907,6,14,7,15,53,60,-7,49
Annan Athlet,8907,7,12,11,13,48,41,7,47
Berwick,8907,8,8,11,17,31,60,-29,35
Edinburgh Ci,8907,9,7,10,19,36,60,-24,31
Cowdenbeath,8907,10,4,10,22,23,55,-32,22
Montrose,8908,1,23,8,5,60,35,25,77
Peterhead,8908,2,24,4,8,81,39,42,76
Stirling,8908,3,17,6,13,63,52,11,57
Clyde,8908,4,15,9,12,53,49,4,54
Stenhousem'r,8908,5,15,8,13,56,49,7,53
Elgin,8908,6,14,7,15,54,61,-7,49
Annan Athlet,8908,7,12,11,13,49,41,8,47
Berwick,8908,8,8,10,18,30,60,-30,34
Edinburgh Ci,8908,9,7,9,20,37,64,-27,30
Cowdenbeath,8908,10,4,10,22,23,56,-33,22
Montrose,8909,1,24,7,5,60,34,26,79
Peterhead,8909,2,23,4,9,77,40,37,73
Stirling,8909,3,17,6,13,64,54,10,57
Clyde,8909,4,15,9,12,54,48,6,54
Stenhousem'r,8909,5,15,8,13,58,50,8,53
Elgin,8909,6,14,6,16,53,61,-8,48
Annan Athlet,8909,7,12,11,13,49,42,7,47
Berwick,8909,8,8,10,18,29,61,-32,34
Edinburgh Ci,8909,9,8,9,19,38,60,-22,33
Cowdenbeath,8909,10,4,10,22,24,56,-32,22
Montrose,8910,1,24,7,5,64,34,30,79
Peterhead,8910,2,24,4,8,81,38,43,76
Stenhousem'r,8910,3,16,8,12,58,46,12,56
Stirling,8910,4,16,6,14,60,54,6,54
Clyde,8910,5,15,9,12,54,49,5,54
Elgin,8910,6,14,6,16,53,65,-12,48
Annan Athlet,8910,7,12,11,13,48,41,7,47
Berwick,8910,8,8,10,18,30,61,-31,34
Edinburgh Ci,8910,9,7,9,20,36,64,-28,30
Cowdenbeath,8910,10,4,10,22,23,55,-32,22
Montrose,8911,1,24,7,5,61,35,26,79
Peterhead,8911,2,24,4,8,78,38,40,76
Stenhousem'r,8911,3,16,8,12,57,47,10,56
Stirling,8911,4,16,6,14,61,53,8,54
Clyde,8911,5,15,9,12,54,50,4,54
Elgin,8911,6,14,6,16,54,62,-8,48
Annan Athlet,8911,7,11,12,13,48,42,6,45
Berwick,8911,8,8,10,18,31,61,-30,34
Edinburgh Ci,8911,9,7,9,20,36,61,-25,30
Cowdenbeath,8911,10,4,11,21,24,55,-31,23
Montrose,8912,1,23,8,5,60,35,25,77
Peterhead,8912,2,24,4,8,81,39,42,76
Stirling,8912,3,17,6,13,62,52,10,57
Stenhousem'r,8912,4,15,8,13,56,48,8,53
Clyde,8912,5,14,9,13,51,50,1,51
Elgin,8912,6,14,7,15,54,61,-7,49
Annan Athlet,8912,7,12,11,13,49,41,8,47
Berwick,8912,8,9,10,17,31,58,-27,37
Edinburgh Ci,8912,9,7,9,20,37,64,-27,30
Cowdenbeath,8912,10,4,10,22,23,56,-33,22
Montrose,8913,1,23,8,5,61,36,25,77
Peterhead,8913,2,24,4,8,80,40,40,76
Stenhousem'r,8913,3,16,8,12,56,46,10,56
Stirling,8913,4,16,6,14,60,52,8,54
Clyde,8913,5,14,10,12,52,49,3,52
Elgin,8913,6,14,7,15,55,62,-7,49
Annan Athlet,8913,7,12,11,13,50,42,8,47
Berwick,8913,8,8,11,17,30,59,-29,35
Edinburgh Ci,8913,9,7,9,20,38,63,-25,30
Cowdenbeath,8913,10,4,10,22,24,57,-33,22
Montrose,8914,1,24,7,5,61,35,26,79
Peterhead,8914,2,24,4,8,78,38,40,76
Stirling,8914,3,16,7,13,61,52,9,55
Stenhousem'r,8914,4,15,9,12,56,47,9,54
Clyde,8914,5,14,9,13,53,51,2,51
Elgin,8914,6,14,6,16,54,62,-8,48
Annan Athlet,8914,7,11,11,14,47,43,4,44
Berwick,8914,8,9,10,17,32,60,-28,37
Edinburgh Ci,8914,9,7,9,20,36,61,-25,30
Cowdenbeath,8914,10,5,10,21,25,54,-29,25
Montrose,8915,1,24,7,5,62,35,27,79
Peterhead,8915,2,23,5,8,79,40,39,74
Stenhousem'r,8915,3,16,8,12,57,47,10,56
Stirling,8915,4,16,6,14,61,53,8,54
Clyde,8915,5,15,9,12,52,48,4,54
Elgin,8915,6,14,6,16,54,63,-9,48
Annan Athlet,8915,7,11,11,14,47,42,5,44
Berwick,8915,8,8,10,18,29,59,-30,34
Edinburgh Ci,8915,9,7,10,19,38,62,-24,31
Cowdenbeath,8915,10,5,10,21,24,54,-30,25
Montrose,8916,1,24,7,5,62,35,27,79
Peterhead,8916,2,24,4,8,81,40,41,76
Stenhousem'r,8916,3,16,8,12,58,48,10,56
Stirling,8916,4,16,6,14,62,54,8,54
Clyde,8916,5,15,9,12,53,48,5,54
Elgin,8916,6,14,6,16,54,63,-9,48
Annan Athlet,8916,7,12,11,13,50,41,9,47
Berwick,8916,8,8,10,18,29,60,-31,34
Edinburgh Ci,8916,9,7,9,20,38,64,-26,30
Cowdenbeath,8916,10,4,10,22,23,57,-34,22
Montrose,8917,1,23,8,5,59,34,25,77
Peterhead,8917,2,24,4,8,80,39,41,76
Stirling,8917,3,16,7,13,62,53,9,55
Stenhousem'r,8917,4,15,9,12,57,48,9,54
Clyde,8917,5,15,9,12,55,50,5,54
Elgin,8917,6,14,7,15,53,60,-7,49
Annan Athlet,8917,7,11,11,14,47,43,4,44
Berwick,8917,8,8,10,18,31,62,-31,34
Edinburgh Ci,8917,9,7,9,20,37,63,-26,30
Cowdenbeath,8917,10,5,10,21,25,54,-29,25
Peterhead,8918,1,24,4,8,80,38,42,76
Montrose,8918,2,23,7,6,59,37,22,76
Stirling,8918,3,17,6,13,63,52,11,57
Stenhousem'r,8918,4,15,8,13,56,49,7,53
Clyde,8918,5,14,10,12,52,49,3,52
Elgin,8918,6,15,6,15,56,60,-4,51
Annan Athlet,8918,7,11,11,14,48,43,5,44
Berwick,8918,8,8,11,17,30,59,-29,35
Edinburgh Ci,8918,9,7,9,20,36,63,-27,30
Cowdenbeath,8918,10,5,10,21,25,55,-30,25
Montrose,8919,1,23,8,5,59,34,25,77
Peterhead,8919,2,23,5,8,78,39,39,74
Stirling,8919,3,16,7,13,61,52,9,55
Stenhousem'r,8919,4,15,9,12,56,47,9,54
Clyde,8919,5,14,9,13,51,49,2,51
Elgin,8919,6,14,7,15,53,60,-7,49
Annan Athlet,8919,7,11,12,13,48,42,6,45
Berwick,8919,8,9,10,17,30,58,-28,37
Edinburgh Ci,8919,9,7,10,19,37,61,-24,31
Cowdenbeath,8919,10,4,11,21,24,55,-31,23
Montrose,8920,1,23,8,5,60,35,25,77
Peterhead,8920,2,24,4,8,80,38,42,76
Stirling,8920,3,17,6,13,61,51,10,57
Stenhousem'r,8920,4,15,8,13,55,47,8,53
Clyde,8920,5,14,9,13,51,49,2,51
Elgin,8920,6,14,7,15,54,61,-7,49
Annan Athlet,8920,7,11,11,14,48,44,4,44
Berwick,8920,8,9,10,17,30,58,-28,37
Edinburgh Ci,8920,9,7,9,20,36,63,-27,30
Cowdenbeath,8920,10,5,10,21,26,55,-29,25
Montrose,8921,1,24,7,5,62,34,28,79
Peterhead,8921,2,24,4,8,80,38,42,76
Stenhousem'r,8921,3,16,8,12,56,46,10,56
Stirling,8921,4,16,6,14,60,52,8,54
Clyde,8921,5,15,9,12,52,48,4,54
Elgin,8921,6,14,6,16,53,63,-10,48
Annan Athlet,8921,7,12,11,13,49,42,7,47
Berwick,8921,8,8,10,18,29,59,-30,34
Edinburgh Ci,8921,9,7,9,20,36,63,-27,30
Cowdenbeath,8921,10,4,10,22,24,56,-32,22
Peterhead,8922,1,24,4,8,81,38,43,76
Montrose,8922,2,23,7,6,59,35,24,76
Stirling,8922,3,17,6,13,63,53,10,57
Clyde,8922,4,15,9,12,54,48,6,54
Stenhousem'r,8922,5,15,8,13,57,49,8,53
Elgin,8922,6,15,6,15,54,60,-6,51
Annan Athlet,8922,7,11,12,13,47,41,6,45
Berwick,8922,8,8,10,18,29,61,-32,34
Edinburgh Ci,8922,9,7,9,20,36,64,-28,30
Cowdenbeath,8922,10,4,11,21,23,54,-31,23
Montrose,8923,1,24,7,5,61,35,26,79
Peterhead,8923,2,24,4,8,80,39,41,76
Stenhousem'r,8923,3,16,8,12,57,47,10,56
Stirling,8923,4,16,6,14,61,53,8,54
Clyde,8923,5,14,9,13,51,50,1,51
Elgin,8923,6,14,6,16,54,62,-8,48
Annan Athlet,8923,7,11,12,13,50,44,6,45
Berwick,8923,8,9,10,17,31,58,-27,37
Edinburgh Ci,8923,9,7,9,20,37,63,-26,30
Cowdenbeath,8923,10,4,11,21,26,57,-31,23
Peterhead,8924,1,24,4,8,79,38,41,76
Montrose,8924,2,23,7,6,60,37,23,76
Stirling,8924,3,17,6,13,62,51,11,57
Clyde,8924,4,15,9,12,53,49,4,54
Stenhousem'r,8924,5,15,8,13,55,48,7,53
Elgin,8924,6,15,6,15,56,61,-5,51
Annan Athlet,8924,7,12,11,13,48,41,7,47
Berwick,8924,8,8,10,18,30,60,-30,34
Edinburgh Ci,8924,9,7,9,20,36,62,-26,30
Cowdenbeath,8924,10,4,10,22,23,55,-32,22
Montrose,8925,1,24,7,5,62,34,28,79
Peterhead,8925,2,23,4,9,77,39,38,73
Stirling,8925,3,16,7,13,61,52,9,55
Stenhousem'r,8925,4,15,9,12,56,47,9,54
Clyde,8925,5,15,9,12,53,48,5,54
Elgin,8925,6,14,6,16,53,63,-10,48
Annan Athlet,8925,7,12,11,13,48,41,7,47
Berwick,8925,8,8,10,18,29,60,-31,34
Edinburgh Ci,8925,9,8,9,19,37,60,-23,33
Cowdenbeath,8925,10,4,10,22,23,55,-32,22
Montrose,8926,1,24,7,5,60,34,26,79
Peterhead,8926,2,24,4,8,80,40,40,76
Stirling,8926,3,17,6,13,64,52,12,57
Stenhousem'r,8926,4,15,8,13,56,50,6,53
Clyde,8926,5,14,9,13,51,49,2,51
Elgin,8926,6,14,6,16,53,61,-8,48
Annan Athlet,8926,7,12,11,13,48,41,7,47
Berwick,8926,8,9,10,17,30,58,-28,37
Edinburgh Ci,8926,9,7,9,20,38,63,-25,30
Cowdenbeath,8926,10,4,10,22,23,55,-32,22
Montrose,8927,1,24,7,5,61,35,26,79
Peterhead,8927,2,24,4,8,80,40,40,76
Stirling,8927,3,17,6,13,63,53,10,57
Clyde,8927,4,15,9,12,52,48,4,54
Stenhousem'r,8927,5,15,8,13,57,49,8,53
Elgin,8927,6,14,6,16,54,62,-8,48
Annan Athlet,8927,7,11,11,14,47,44,3,44
Berwick,8927,8,8,10,18,29,59,-30,34
Edinburgh Ci,8927,9,7,9,20,38,63,-25,30
Cowdenbeath,8927,10,5,10,21,26,54,-28,25
Montrose,8928,1,24,7,5,63,36,27,79
Peterhead,8928,2,24,4,8,81,39,42,76
Stirling,8928,3,17,6,13,64,52,12,57
Clyde,8928,4,15,9,12,54,49,5,54
Stenhousem'r,8928,5,15,8,13,56,50,6,53
Elgin,8928,6,14,6,16,55,64,-9,48
Annan Athlet,8928,7,11,12,13,47,41,6,45
Berwick,8928,8,8,10,18,30,61,-31,34
Edinburgh Ci,8928,9,7,9,20,37,64,-27,30
Cowdenbeath,8928,10,4,11,21,23,54,-31,23
Peterhead,8929,1,24,4,8,85,41,44,76
Montrose,8929,2,23,7,6,59,36,23,76
Stirling,8929,3,16,7,13,60,51,9,55
Stenhousem'r,8929,4,15,9,12,55,46,9,54
Clyde,8929,5,15,9,12,53,48,5,54
Elgin,8929,6,15,6,15,55,60,-5,51
Annan Athlet,8929,7,12,11,13,48,41,7,47
Berwick,8929,8,8,10,18,29,60,-31,34
Edinburgh Ci,8929,9,7,9,20,39,68,-29,30
Cowdenbeath,8929,10,4,10,22,23,55,-32,22
Montrose,8930,1,23,8,5,62,37,25,77
Peterhead,8930,2,24,4,8,81,40,41,76
Stirling,8930,3,17,6,13,62,52,10,57
Clyde,8930,4,15,9,12,54,48,6,54
Stenhousem'r,8930,5,15,8,13,56,48,8,53
Elgin,8930,6,14,7,15,56,63,-7,49
Annan Athlet,8930,7,11,11,14,47,44,3,44
Berwick,8930,8,8,10,18,29,61,-32,34
Edinburgh Ci,8930,9,7,9,20,38,64,-26,30
Cowdenbeath,8930,10,5,10,21,26,54,-28,25
Montrose,8931,1,24,7,5,61,35,26,79
Peterhead,8931,2,24,4,8,78,38,40,76
Stenhousem'r,8931,3,16,8,12,56,46,10,56
Stirling,8931,4,16,6,14,60,52,8,54
Clyde,8931,5,14,9,13,52,51,1,51
Elgin,8931,6,14,6,16,54,62,-8,48
Annan Athlet,8931,7,12,11,13,48,41,7,47
Berwick,8931,8,9,10,17,32,59,-27,37
Edinburgh Ci,8931,9,7,9,20,36,61,-25,30
Cowdenbeath,8931,10,4,10,22,23,55,-32,22
Montrose,8932,1,24,7,5,61,35,26,79
Peterhead,8932,2,24,4,8,79,38,41,76
Stirling,8932,3,16,7,13,61,52,9,55
Stenhousem'r,8932,4,15,9,12,56,47,9,54
Clyde,8932,5,15,9,12,55,49,6,54
Elgin,8932,6,14,6,16,54,62,-8,48
Annan Athlet,8932,7,11,11,14,48,44,4,44
Berwick,8932,8,8,10,18,30,62,-32,34
Edinburgh Ci,8932,9,7,9,20,36,62,-26,30
Cowdenbeath,8932,10,5,10,21,26,55,-29,25
Montrose,8933,1,24,7,5,64,36,28,79
Peterhead,8933,2,24,4,8,79,39,40,76
Stirling,8933,3,17,6,13,63,52,11,57
Clyde,8933,4,15,9,12,53,49,4,54
Stenhousem'r,8933,5,15,8,13,56,49,7,53
Elgin,8933,6,14,6,16,55,65,-10,48
Annan Athlet,8933,7,11,12,13,48,42,6,45
Berwick,8933,8,8,10,18,30,60,-30,34
Edinburgh Ci,8933,9,7,9,20,37,62,-25,30
Cowdenbeath,8933,10,4,11,21,24,55,-31,23
Montrose,8934,1,23,8,5,59,34,25,77
Peterhead,8934,2,23,5,8,79,40,39,74
Stirling,8934,3,17,6,13,62,52,10,57
Stenhousem'r,8934,4,15,8,13,56,48,8,53
Clyde,8934,5,14,10,12,52,49,3,52
Elgin,8934,6,14,7,15,53,60,-7,49
Annan Athlet,8934,7,12,11,13,49,41,8,47
Berwick,8934,8,8,11,17,30,59,-29,35
Edinburgh Ci,8934,9,7,10,19,38,62,-24,31
Cowdenbeath,8934,10,4,10,22,23,56,-33,22
Montrose,8935,1,24,7,5,62,36,26,79
Peterhead,8935,2,24,4,8,79,39,40,76
Stirling,8935,3,16,7,13,60,51,9,55
Stenhousem'r,8935,4,15,9,12,55,46,9,54
Clyde,8935,5,14,10,12,53,50,3,52
Elgin,8935,6,14,6,16,55,63,-8,48
Annan Athlet,8935,7,12,11,13,51,43,8,47
Berwick,8935,8,8,11,17,31,60,-29,35
Edinburgh Ci,8935,9,7,9,20,37,62,-25,30
Cowdenbeath,8935,10,4,10,22,25,58,-33,22
Montrose,8936,1,23,8,5,60,35,25,77
Peterhead,8936,2,24,4,8,82,39,43,76
Stirling,8936,3,17,6,13,62,51,11,57
Clyde,8936,4,15,9,12,54,48,6,54
Stenhousem'r,8936,5,15,8,13,55,48,7,53
Elgin,8936,6,14,7,15,54,61,-7,49
Annan Athlet,8936,7,11,12,13,48,42,6,45
Berwick,8936,8,8,10,18,29,61,-32,34
Edinburgh Ci,8936,9,7,9,20,37,65,-28,30
Cowdenbeath,8936,10,4,11,21,24,55,-31,23
Peterhead,8937,1,24,4,8,80,38,42,76
Montrose,8937,2,23,7,6,60,36,24,76
Stenhousem'r,8937,3,16,8,12,56,46,10,56
Stirling,8937,4,16,6,14,60,52,8,54
Clyde,8937,5,15,9,12,54,48,6,54
Elgin,8937,6,15,6,15,55,61,-6,51
Annan Athlet,8937,7,11,12,13,47,41,6,45
Berwick,8937,8,8,10,18,29,61,-32,34
Edinburgh Ci,8937,9,7,9,20,36,63,-27,30
Cowdenbeath,8937,10,4,11,21,23,54,-31,23
Montrose,8938,1,23,8,5,60,35,25,77
Peterhead,8938,2,24,4,8,82,40,42,76
Stirling,8938,3,17,6,13,64,51,13,57
Clyde,8938,4,15,9,12,54,49,5,54
Stenhousem'r,8938,5,15,8,13,55,50,5,53
Elgin,8938,6,14,7,15,54,61,-7,49
Annan Athlet,8938,7,11,11,14,47,44,3,44
Berwick,8938,8,8,10,18,30,61,-31,34
Edinburgh Ci,8938,9,7,9,20,38,65,-27,30
Cowdenbeath,8938,10,5,10,21,26,54,-28,25
Montrose,8939,1,24,7,5,62,34,28,79
Peterhead,8939,2,24,4,8,80,40,40,76
Stenhousem'r,8939,3,16,8,12,58,46,12,56
Stirling,8939,4,16,6,14,60,54,6,54
Clyde,8939,5,15,9,12,54,48,6,54
Elgin,8939,6,14,6,16,53,63,-10,48
Annan Athlet,8939,7,11,11,14,47,42,5,44
Berwick,8939,8,8,10,18,29,61,-32,34
Edinburgh Ci,8939,9,7,9,20,38,63,-25,30
Cowdenbeath,8939,10,5,10,21,24,54,-30,25
Peterhead,8940,1,24,4,8,79,38,41,76
Montrose,8940,2,23,7,6,60,36,24,76
Stirling,8940,3,17,6,13,62,52,10,57
Stenhousem'r,8940,4,15,8,13,56,48,8,53
Clyde,8940,5,14,10,12,52,49,3,52
Elgin,8940,6,15,6,15,55,61,-6,51
Annan Athlet,8940,7,12,11,13,49,42,7,47
Berwick,8940,8,8,11,17,30,59,-29,35
Edinburgh Ci,8940,9,7,9,20,36,62,-26,30
Cowdenbeath,8940,10,4,10,22,24,56,-32,22
Montrose,8941,1,23,7,6,61,37,24,76
Peterhead,8941,2,23,5,8,80,41,39,74
Stirling,8941,3,17,6,13,64,52,12,57
Clyde,8941,4,15,9,12,52,48,4,54
Stenhousem'r,8941,5,15,8,13,56,50,6,53
Elgin,8941,6,15,6,15,56,62,-6,51
Annan Athlet,8941,7,11,12,13,48,42,6,45
Berwick,8941,8,8,10,18,29,59,-30,34
Edinburgh Ci,8941,9,7,10,19,39,63,-24,31
Cowdenbeath,8941,10,4,11,21,24,55,-31,23
Montrose,8942,1,24,7,5,60,34,26,79
Peterhead,8942,2,24,4,8,78,38,40,76
Stirling,8942,3,16,7,13,61,52,9,55
Stenhousem'r,8942,4,15,9,12,56,47,9,54
Clyde,8942,5,14,9,13,51,49,2,51
Elgin,8942,6,14,6,16,53,61,-8,48
Annan Athlet,8942,7,11,11,14,47,42,5,44
Berwick,8942,8,9,10,17,30,58,-28,37
Edinburgh Ci,8942,9,7,9,20,36,61,-25,30
Cowdenbeath,8942,10,5,10,21,24,54,-30,25
Montrose,8943,1,24,7,5,64,37,27,79
Peterhead,8943,2,24,4,8,83,39,44,76
Stirling,8943,3,16,7,13,61,52,9,55
Stenhousem'r,8943,4,15,9,12,56,47,9,54
Clyde,8943,5,14,10,12,53,50,3,52
Elgin,8943,6,14,6,16,56,65,-9,48
Annan Athlet,8943,7,11,12,13,48,42,6,45
Berwick,8943,8,8,11,17,31,60,-29,35
Edinburgh Ci,8943,9,7,9,20,37,66,-29,30
Cowdenbeath,8943,10,4,11,21,24,55,-31,23
Montrose,8944,1,23,8,5,60,35,25,77
Peterhead,8944,2,24,4,8,81,39,42,76
Stirling,8944,3,17,6,13,62,52,10,57
Stenhousem'r,8944,4,15,8,13,56,48,8,53
Clyde,8944,5,14,9,13,52,50,2,51
Elgin,8944,6,14,7,15,54,61,-7,49
Annan Athlet,8944,7,11,11,14,47,42,5,44
Berwick,8944,8,9,10,17,31,59,-28,37
Edinburgh Ci,8944,9,7,9,20,37,64,-27,30
Cowdenbeath,8944,10,5,10,21,24,54,-30,25
Montrose,8945,1,23,8,5,60,35,25,77
Peterhead,8945,2,24,4,8,80,39,41,76
Stirling,8945,3,16,7,13,62,53,9,55
Stenhousem'r,8945,4,15,9,12,57,48,9,54
Clyde,8945,5,14,10,12,51,48,3,52
Elgin,8945,6,14,7,15,54,61,-7,49
Annan Athlet,8945,7,11,12,13,47,41,6,45
Berwick,8945,8,8,11,17,29,58,-29,35
Edinburgh Ci,8945,9,7,9,20,37,63,-26,30
Cowdenbeath,8945,10,4,11,21,23,54,-31,23
Montrose,8946,1,24,7,5,60,34,26,79
Peterhead,8946,2,24,4,8,80,39,41,76
Stenhousem'r,8946,3,16,8,12,57,47,10,56
Stirling,8946,4,16,6,14,61,53,8,54
Clyde,8946,5,15,9,12,52,48,4,54
Elgin,8946,6,14,6,16,53,61,-8,48
Annan Athlet,8946,7,11,12,13,47,41,6,45
Berwick,8946,8,8,10,18,29,59,-30,34
Edinburgh Ci,8946,9,7,9,20,37,63,-26,30
Cowdenbeath,8946,10,4,11,21,23,54,-31,23
Montrose,8947,1,23,7,6,60,36,24,76
Peterhead,8947,2,23,4,9,78,40,38,73
Stirling,8947,3,17,6,13,63,51,12,57
Stenhousem'r,8947,4,15,8,13,55,49,6,53
Clyde,8947,5,14,10,12,52,49,3,52
Elgin,8947,6,15,6,15,55,61,-6,51
Annan Athlet,8947,7,11,12,13,48,42,6,45
Berwick,8947,8,8,11,17,30,59,-29,35
Edinburgh Ci,8947,9,8,9,19,38,61,-23,33
Cowdenbeath,8947,10,4,11,21,24,55,-31,23
Montrose,8948,1,24,7,5,63,34,29,79
Peterhead,8948,2,23,4,9,78,40,38,73
Stirling,8948,3,17,6,13,61,51,10,57
Stenhousem'r,8948,4,15,8,13,55,47,8,53
Clyde,8948,5,14,10,12,51,48,3,52
Elgin,8948,6,14,6,16,53,64,-11,48
Annan Athlet,8948,7,11,11,14,47,42,5,44
Berwick,8948,8,8,11,17,29,58,-29,35
Edinburgh Ci,8948,9,8,9,19,38,61,-23,33
Cowdenbeath,8948,10,5,10,21,24,54,-30,25
Montrose,8949,1,24,7,5,61,35,26,79
Peterhead,8949,2,24,4,8,78,38,40,76
Stenhousem'r,8949,3,16,8,12,58,48,10,56
Stirling,8949,4,16,6,14,62,54,8,54
Clyde,8949,5,15,9,12,53,49,4,54
Elgin,8949,6,14,6,16,54,62,-8,48
Annan Athlet,8949,7,11,12,13,47,41,6,45
Berwick,8949,8,8,10,18,30,60,-30,34
Edinburgh Ci,8949,9,7,9,20,36,61,-25,30
Cowdenbeath,8949,10,4,11,21,23,54,-31,23
Montrose,8950,1,24,7,5,60,34,26,79
Peterhead,8950,2,24,4,8,82,41,41,76
Stirling,8950,3,16,7,13,62,53,9,55
Stenhousem'r,8950,4,15,9,12,57,48,9,54
Clyde,8950,5,14,9,13,51,50,1,51
Elgin,8950,6,14,6,16,53,61,-8,48
Annan Athlet,8950,7,12,11,13,49,41,8,47
Berwick,8950,8,9,10,17,31,58,-27,37
Edinburgh Ci,8950,9,7,9,20,39,65,-26,30
Cowdenbeath,8950,10,4,10,22,23,56,-33,22
Montrose,8951,1,23,8,5,60,35,25,77
Peterhead,8951,2,24,4,8,80,40,40,76
Stenhousem'r,8951,3,16,8,12,57,47,10,56
Stirling,8951,4,16,6,14,61,53,8,54
Clyde,8951,5,15,9,12,52,48,4,54
Elgin,8951,6,14,7,15,54,61,-7,49
Annan Athlet,8951,7,12,11,13,49,41,8,47
Berwick,8951,8,8,10,18,29,59,-30,34
Edinburgh Ci,8951,9,7,9,20,38,63,-25,30
Cowdenbeath,8951,10,4,10,22,23,56,-33,22
Montrose,8952,1,23,8,5,60,35,25,77
Peterhead,8952,2,24,4,8,79,38,41,76
Stirling,8952,3,17,6,13,64,53,11,57
Clyde,8952,4,15,9,12,52,48,4,54
Stenhousem'r,8952,5,15,8,13,57,50,7,53
Elgin,8952,6,14,7,15,54,61,-7,49
Annan Athlet,8952,7,12,11,13,48,41,7,47
Berwick,8952,8,8,10,18,29,59,-30,34
Edinburgh Ci,8952,9,7,9,20,36,62,-26,30
Cowdenbeath,8952,10,4,10,22,23,55,-32,22
Montrose,8953,1,24,7,5,62,34,28,79
Peterhead,8953,2,24,4,8,80,39,41,76
Stirling,8953,3,16,7,13,62,53,9,55
Stenhousem'r,8953,4,15,9,12,57,48,9,54
Clyde,8953,5,14,9,13,53,51,2,51
Elgin,8953,6,14,6,16,53,63,-10,48
Annan Athlet,8953,7,11,11,14,47,43,4,44
Berwick,8953,8,9,10,17,32,60,-28,37
Edinburgh Ci,8953,9,7,9,20,37,63,-26,30
Cowdenbeath,8953,10,5,10,21,25,54,-29,25
Montrose,8954,1,23,7,6,60,39,21,76
Peterhead,8954,2,23,5,8,79,40,39,74
Stenhousem'r,8954,3,16,8,12,57,46,11,56
Clyde,8954,4,15,9,12,57,49,8,54
Stirling,8954,5,16,6,14,60,53,7,54
Elgin,8954,6,15,6,15,58,61,-3,51
Annan Athlet,8954,7,11,11,14,47,42,5,44
Berwick,8954,8,8,10,18,30,64,-34,34
Edinburgh Ci,8954,9,7,10,19,38,62,-24,31
Cowdenbeath,8954,10,5,10,21,24,54,-30,25
Montrose,8955,1,24,7,5,63,34,29,79
Peterhead,8955,2,24,4,8,79,38,41,76
Stirling,8955,3,16,7,13,61,52,9,55
Stenhousem'r,8955,4,15,9,12,56,47,9,54
Clyde,8955,5,15,9,12,53,49,4,54
Elgin,8955,6,14,6,16,53,64,-11,48
Annan Athlet,8955,7,11,12,13,47,41,6,45
Berwick,8955,8,8,10,18,30,60,-30,34
Edinburgh Ci,8955,9,7,9,20,36,62,-26,30
Cowdenbeath,8955,10,4,11,21,23,54,-31,23
Montrose,8956,1,24,7,5,60,34,26,79
Peterhead,8956,2,24,4,8,80,39,41,76
Stirling,8956,3,17,6,13,64,51,13,57
Stenhousem'r,8956,4,15,8,13,55,50,5,53
Clyde,8956,5,14,10,12,52,49,3,52
Elgin,8956,6,14,6,16,53,61,-8,48
Annan Athlet,8956,7,11,11,14,47,43,4,44
Berwick,8956,8,8,11,17,30,59,-29,35
Edinburgh Ci,8956,9,7,9,20,37,63,-26,30
Cowdenbeath,8956,10,5,10,21,25,54,-29,25
Montrose,8957,1,24,7,5,62,35,27,79
Peterhead,8957,2,23,4,9,78,40,38,73
Stenhousem'r,8957,3,16,8,12,57,47,10,56
Stirling,8957,4,16,6,14,61,53,8,54
Clyde,8957,5,15,9,12,54,49,5,54
Elgin,8957,6,14,6,16,54,63,-9,48
Annan Athlet,8957,7,12,11,13,48,41,7,47
Berwick,8957,8,8,10,18,30,61,-31,34
Edinburgh Ci,8957,9,8,9,19,38,61,-23,33
Cowdenbeath,8957,10,4,10,22,23,55,-32,22
Peterhead,8958,1,24,4,8,82,40,42,76
Montrose,8958,2,23,7,6,59,35,24,76
Stirling,8958,3,17,6,13,63,51,12,57
Stenhousem'r,8958,4,15,8,13,55,49,6,53
Clyde,8958,5,14,10,12,53,50,3,52
Elgin,8958,6,15,6,15,54,60,-6,51
Annan Athlet,8958,7,11,12,13,48,42,6,45
Berwick,8958,8,8,11,17,31,60,-29,35
Edinburgh Ci,8958,9,7,9,20,38,65,-27,30
Cowdenbeath,8958,10,4,11,21,24,55,-31,23
Peterhead,8959,1,24,4,8,81,38,43,76
Montrose,8959,2,23,7,6,60,37,23,76
Stirling,8959,3,17,6,13,61,51,10,57
Clyde,8959,4,15,9,12,54,48,6,54
Stenhousem'r,8959,5,15,8,13,55,47,8,53
Elgin,8959,6,15,6,15,56,61,-5,51
Annan Athlet,8959,7,12,11,13,49,42,7,47
Berwick,8959,8,8,10,18,29,61,-32,34
Edinburgh Ci,8959,9,7,9,20,36,64,-28,30
Cowdenbeath,8959,10,4,10,22,24,56,-32,22
Peterhead,8960,1,24,4,8,79,38,41,76
Montrose,8960,2,23,7,6,61,37,24,76
Stirling,8960,3,17,6,13,63,52,11,57
Clyde,8960,4,15,9,12,53,49,4,54
Stenhousem'r,8960,5,15,8,13,56,49,7,53
Elgin,8960,6,15,6,15,56,62,-6,51
Annan Athlet,8960,7,11,11,14,49,44,5,44
Berwick,8960,8,8,10,18,30,60,-30,34
Edinburgh Ci,8960,9,7,9,20,36,62,-26,30
Cowdenbeath,8960,10,5,10,21,26,56,-30,25
Montrose,8961,1,24,7,5,62,34,28,79
Peterhead,8961,2,24,4,8,82,38,44,76
Stirling,8961,3,17,6,13,62,51,11,57
Stenhousem'r,8961,4,15,8,13,55,48,7,53
Clyde,8961,5,14,9,13,51,50,1,51
Elgin,8961,6,14,6,16,53,63,-10,48
Annan Athlet,8961,7,12,11,13,50,41,9,47
Berwick,8961,8,9,10,17,31,58,-27,37
Edinburgh Ci,8961,9,7,9,20,36,65,-29,30
Cowdenbeath,8961,10,4,10,22,23,57,-34,22
Montrose,8962,1,23,8,5,61,36,25,77
Peterhead,8962,2,24,4,8,80,38,42,76
Stirling,8962,3,16,7,13,62,53,9,55
Stenhousem'r,8962,4,15,9,12,57,48,9,54
Clyde,8962,5,14,9,13,51,51,0,51
Elgin,8962,6,14,7,15,55,62,-7,49
Annan Athlet,8962,7,12,11,13,49,41,8,47
Berwick,8962,8,9,10,17,32,58,-26,37
Edinburgh Ci,8962,9,7,9,20,36,63,-27,30
Cowdenbeath,8962,10,4,10,22,23,56,-33,22
Peterhead,8963,1,24,4,8,81,38,43,76
Montrose,8963,2,23,7,6,60,36,24,76
Stenhousem'r,8963,3,16,8,12,60,49,11,56
Stirling,8963,4,16,6,14,63,56,7,54
Clyde,8963,5,14,10,12,52,49,3,52
Elgin,8963,6,15,6,15,55,61,-6,51
Annan Athlet,8963,7,11,11,14,47,44,3,44
Berwick,8963,8,8,11,17,30,59,-29,35
Edinburgh Ci,8963,9,7,9,20,36,64,-28,30
Cowdenbeath,8963,10,5,10,21,26,54,-28,25
Montrose,8964,1,24,7,5,62,36,26,79
Peterhead,8964,2,23,5,8,78,39,39,74
Stirling,8964,3,17,6,13,63,51,12,57
Stenhousem'r,8964,4,15,8,13,55,49,6,53
Clyde,8964,5,14,10,12,51,48,3,52
Elgin,8964,6,14,6,16,55,63,-8,48
Annan Athlet,8964,7,11,12,13,47,41,6,45
Berwick,8964,8,8,11,17,29,58,-29,35
Edinburgh Ci,8964,9,7,10,19,37,61,-24,31
Cowdenbeath,8964,10,4,11,21,23,54,-31,23
Peterhead,8965,1,24,4,8,79,38,41,76
Montrose,8965,2,23,7,6,59,37,22,76
Stirling,8965,3,16,7,13,61,52,9,55
Stenhousem'r,8965,4,15,9,12,56,47,9,54
Clyde,8965,5,14,9,13,53,51,2,51
Elgin,8965,6,15,6,15,56,60,-4,51
Annan Athlet,8965,7,11,12,13,47,41,6,45
Berwick,8965,8,9,10,17,32,60,-28,37
Edinburgh Ci,8965,9,7,9,20,36,62,-26,30
Cowdenbeath,8965,10,4,11,21,23,54,-31,23
Montrose,8966,1,24,7,5,62,35,27,79
Peterhead,8966,2,24,4,8,80,39,41,76
Stirling,8966,3,17,6,13,62,52,10,57
Clyde,8966,4,15,9,12,53,49,4,54
Stenhousem'r,8966,5,15,8,13,56,48,8,53
Elgin,8966,6,14,6,16,54,63,-9,48
Annan Athlet,8966,7,12,11,13,50,41,9,47
Berwick,8966,8,8,10,18,30,60,-30,34
Edinburgh Ci,8966,9,7,9,20,37,63,-26,30
Cowdenbeath,8966,10,4,10,22,23,57,-34,22
Montrose,8967,1,24,7,5,61,35,26,79
Peterhead,8967,2,23,5,8,77,38,39,74
Stirling,8967,3,17,6,13,61,51,10,57
Clyde,8967,4,15,9,12,54,48,6,54
Stenhousem'r,8967,5,15,8,13,55,47,8,53
Elgin,8967,6,14,6,16,54,62,-8,48
Annan Athlet,8967,7,11,12,13,48,42,6,45
Berwick,8967,8,8,10,18,29,61,-32,34
Edinburgh Ci,8967,9,7,10,19,36,60,-24,31
Cowdenbeath,8967,10,4,11,21,24,55,-31,23
Montrose,8968,1,23,7,6,61,37,24,76
Peterhead,8968,2,23,4,9,78,41,37,73
Stenhousem'r,8968,3,16,8,12,56,46,10,56
Stirling,8968,4,16,6,14,60,52,8,54
Clyde,8968,5,15,9,12,53,48,5,54
Elgin,8968,6,15,6,15,56,62,-6,51
Annan Athlet,8968,7,12,11,13,51,42,9,47
Berwick,8968,8,8,10,18,29,60,-31,34
Edinburgh Ci,8968,9,8,9,19,39,61,-22,33
Cowdenbeath,8968,10,4,10,22,24,58,-34,22
Montrose,8969,1,23,8,5,60,35,25,77
Peterhead,8969,2,24,4,8,82,39,43,76
Stirling,8969,3,17,6,13,64,54,10,57
Stenhousem'r,8969,4,15,8,13,58,50,8,53
Clyde,8969,5,14,10,12,53,50,3,52
Elgin,8969,6,14,7,15,54,61,-7,49
Annan Athlet,8969,7,11,11,14,47,43,4,44
Berwick,8969,8,8,11,17,31,60,-29,35
Edinburgh Ci,8969,9,7,9,20,37,65,-28,30
Cowdenbeath,8969,10,5,10,21,25,54,-29,25
Montrose,8970,1,24,7,5,60,34,26,79
Peterhead,8970,2,23,4,9,78,40,38,73
Stirling,8970,3,17,6,13,64,53,11,57
Stenhousem'r,8970,4,15,8,13,57,50,7,53
Clyde,8970,5,14,9,13,51,49,2,51
Elgin,8970,6,14,6,16,53,61,-8,48
Annan Athlet,8970,7,12,11,13,49,42,7,47
Berwick,8970,8,9,10,17,30,58,-28,37
Edinburgh Ci,8970,9,8,9,19,38,61,-23,33
Cowdenbeath,8970,10,4,10,22,24,56,-32,22
Peterhead,8971,1,24,4,8,81,38,43,76
Montrose,8971,2,23,7,6,60,36,24,76
Stenhousem'r,8971,3,16,8,12,58,48,10,56
Stirling,8971,4,16,6,14,62,54,8,54
Clyde,8971,5,15,9,12,53,48,5,54
Elgin,8971,6,15,6,15,55,61,-6,51
Annan Athlet,8971,7,11,12,13,47,41,6,45
Berwick,8971,8,8,10,18,29,60,-31,34
Edinburgh Ci,8971,9,7,9,20,36,64,-28,30
Cowdenbeath,8971,10,4,11,21,23,54,-31,23
Montrose,8972,1,24,7,5,61,34,27,79
Peterhead,8972,2,23,5,8,77,38,39,74
Stirling,8972,3,17,6,13,62,52,10,57
Stenhousem'r,8972,4,15,8,13,56,48,8,53
Clyde,8972,5,14,10,12,53,50,3,52
Elgin,8972,6,14,6,16,53,62,-9,48
Annan Athlet,8972,7,12,11,13,49,42,7,47
Berwick,8972,8,8,11,17,31,60,-29,35
Edinburgh Ci,8972,9,7,10,19,36,60,-24,31
Cowdenbeath,8972,10,4,10,22,24,56,-32,22
Montrose,8973,1,24,7,5,60,34,26,79
Peterhead,8973,2,24,4,8,82,39,43,76
Stirling,8973,3,17,6,13,62,51,11,57
Stenhousem'r,8973,4,15,8,13,55,48,7,53
Clyde,8973,5,14,9,13,51,49,2,51
Elgin,8973,6,14,6,16,53,61,-8,48
Annan Athlet,8973,7,11,11,14,48,46,2,44
Berwick,8973,8,9,10,17,30,58,-28,37
Edinburgh Ci,8973,9,7,9,20,37,65,-28,30
Cowdenbeath,8973,10,5,10,21,28,55,-27,25
Montrose,8974,1,24,7,5,60,34,26,79
Peterhead,8974,2,24,4,8,79,39,40,76
Stirling,8974,3,16,7,13,62,53,9,55
Stenhousem'r,8974,4,15,9,12,57,48,9,54
Clyde,8974,5,15,9,12,54,48,6,54
Elgin,8974,6,14,6,16,53,61,-8,48
Annan Athlet,8974,7,11,11,14,47,42,5,44
Berwick,8974,8,8,10,18,29,61,-32,34
Edinburgh Ci,8974,9,7,9,20,37,62,-25,30
Cowdenbeath,8974,10,5,10,21,24,54,-30,25
Montrose,8975,1,23,8,5,62,37,25,77
Peterhead,8975,2,23,5,8,78,39,39,74
Stirling,8975,3,16,7,13,61,52,9,55
Stenhousem'r,8975,4,15,9,12,56,47,9,54
Clyde,8975,5,15,9,12,52,48,4,54
Elgin,8975,6,14,7,15,56,63,-7,49
Annan Athlet,8975,7,12,11,13,48,41,7,47
Berwick,8975,8,8,10,18,29,59,-30,34
Edinburgh Ci,8975,9,7,10,19,37,61,-24,31
Cowdenbeath,8975,10,4,10,22,23,55,-32,22
Montrose,8976,1,24,7,5,62,35,27,79
Peterhead,8976,2,24,4,8,80,38,42,76
Stirling,8976,3,17,6,13,61,51,10,57
Stenhousem'r,8976,4,15,8,13,55,47,8,53
Clyde,8976,5,14,10,12,52,49,3,52
Elgin,8976,6,14,6,16,54,63,-9,48
Annan Athlet,8976,7,12,11,13,48,41,7,47
Berwick,8976,8,8,11,17,30,59,-29,35
Edinburgh Ci,8976,9,7,9,20,36,63,-27,30
Cowdenbeath,8976,10,4,10,22,23,55,-32,22
Montrose,8977,1,23,8,5,59,34,25,77
Peterhead,8977,2,24,4,8,79,38,41,76
Stirling,8977,3,17,6,13,61,51,10,57
Clyde,8977,4,15,9,12,54,48,6,54
Stenhousem'r,8977,5,15,8,13,55,47,8,53
Elgin,8977,6,14,7,15,53,60,-7,49
Annan Athlet,8977,7,11,11,14,47,42,5,44
Berwick,8977,8,8,10,18,29,61,-32,34
Edinburgh Ci,8977,9,7,9,20,36,62,-26,30
Cowdenbeath,8977,10,5,10,21,24,54,-30,25
Montrose,8978,1,24,7,5,61,35,26,79
Peterhead,8978,2,24,4,8,81,41,40,76
Stirling,8978,3,16,7,13,62,53,9,55
Stenhousem'r,8978,4,15,9,12,57,48,9,54
Clyde,8978,5,15,9,12,52,48,4,54
Elgin,8978,6,14,6,16,54,62,-8,48
Annan Athlet,8978,7,11,11,14,48,43,5,44
Berwick,8978,8,8,10,18,29,59,-30,34
Edinburgh Ci,8978,9,7,9,20,39,64,-25,30
Cowdenbeath,8978,10,5,10,21,25,55,-30,25
Montrose,8979,1,23,8,5,61,36,25,77
Peterhead,8979,2,24,4,8,81,38,43,76
Stirling,8979,3,16,7,13,62,53,9,55
Stenhousem'r,8979,4,15,9,12,57,48,9,54
Clyde,8979,5,15,9,12,54,50,4,54
Elgin,8979,6,14,7,15,55,62,-7,49
Annan Athlet,8979,7,11,11,14,47,42,5,44
Berwick,8979,8,8,10,18,31,61,-30,34
Edinburgh Ci,8979,9,7,9,20,36,64,-28,30
Cowdenbeath,8979,10,5,10,21,24,54,-30,25
Montrose,8980,1,24,7,5,63,34,29,79
Peterhead,8980,2,23,4,9,77,39,38,73
Stirling,8980,3,17,6,13,62,51,11,57
Stenhousem'r,8980,4,15,8,13,55,48,7,53
Clyde,8980,5,14,10,12,54,51,3,52
Elgin,8980,6,14,6,16,53,64,-11,48
Annan Athlet,8980,7,12,11,13,49,42,7,47
Berwick,8980,8,8,11,17,32,61,-29,35
Edinburgh Ci,8980,9,8,9,19,37,60,-23,33
Cowdenbeath,8980,10,4,10,22,24,56,-32,22
Montrose,8981,1,23,8,5,60,35,25,77
Peterhead,8981,2,23,5,8,78,39,39,74
Stirling,8981,3,17,6,13,63,51,12,57
Clyde,8981,4,15,9,12,54,48,6,54
Stenhousem'r,8981,5,15,8,13,55,49,6,53
Elgin,8981,6,14,7,15,54,61,-7,49
Annan Athlet,8981,7,11,12,13,47,41,6,45
Berwick,8981,8,8,10,18,29,61,-32,34
Edinburgh Ci,8981,9,7,10,19,37,61,-24,31
Cowdenbeath,8981,10,4,11,21,23,54,-31,23
Montrose,8982,1,24,7,5,62,35,27,79
Peterhead,8982,2,23,4,9,78,40,38,73
Stirling,8982,3,16,7,13,60,51,9,55
Stenhousem'r,8982,4,15,9,12,55,46,9,54
Clyde,8982,5,14,9,13,51,49,2,51
Elgin,8982,6,14,6,16,54,63,-9,48
Annan Athlet,8982,7,11,11,14,48,43,5,44
Berwick,8982,8,9,10,17,30,58,-28,37
Edinburgh Ci,8982,9,8,9,19,38,61,-23,33
Cowdenbeath,8982,10,5,10,21,25,55,-30,25
Montrose,8983,1,23,8,5,60,35,25,77
Peterhead,8983,2,24,4,8,79,38,41,76
Stirling,8983,3,17,6,13,62,52,10,57
Stenhousem'r,8983,4,15,8,13,56,48,8,53
Clyde,8983,5,14,10,12,51,48,3,52
Elgin,8983,6,14,7,15,54,61,-7,49
Annan Athlet,8983,7,11,11,14,48,43,5,44
Berwick,8983,8,8,11,17,29,58,-29,35
Edinburgh Ci,8983,9,7,9,20,36,62,-26,30
Cowdenbeath,8983,10,5,10,21,25,55,-30,25
Montrose,8984,1,24,7,5,63,34,29,79
Peterhead,8984,2,24,4,8,81,40,41,76
Stirling,8984,3,17,6,13,65,52,13,57
Clyde,8984,4,15,9,12,54,48,6,54
Stenhousem'r,8984,5,15,8,13,56,51,5,53
Elgin,8984,6,14,6,16,53,64,-11,48
Annan Athlet,8984,7,12,11,13,51,43,8,47
Berwick,8984,8,8,10,18,29,61,-32,34
Edinburgh Ci,8984,9,7,9,20,38,64,-26,30
Cowdenbeath,8984,10,4,10,22,25,58,-33,22
Peterhead,8985,1,24,4,8,78,38,40,76
Montrose,8985,2,23,7,6,59,35,24,76
Stenhousem'r,8985,3,16,8,12,57,47,10,56
Stirling,8985,4,16,6,14,61,53,8,54
Clyde,8985,5,14,10,12,52,49,3,52
Elgin,8985,6,15,6,15,54,60,-6,51
Annan Athlet,8985,7,12,11,13,49,42,7,47
Berwick,8985,8,8,11,17,30,59,-29,35
Edinburgh Ci,8985,9,7,9,20,36,61,-25,30
Cowdenbeath,8985,10,4,10,22,24,56,-32,22
Montrose,8986,1,23,7,6,59,35,24,76
Peterhead,8986,2,23,4,9,77,41,36,73
Stirling,8986,3,17,6,13,64,53,11,57
Stenhousem'r,8986,4,15,8,13,57,50,7,53
Clyde,8986,5,14,9,13,51,49,2,51
Elgin,8986,6,15,6,15,54,60,-6,51
Annan Athlet,8986,7,11,12,13,48,42,6,45
Berwick,8986,8,9,10,17,30,58,-28,37
Edinburgh Ci,8986,9,8,9,19,39,60,-21,33
Cowdenbeath,8986,10,4,11,21,24,55,-31,23
Montrose,8987,1,24,7,5,64,36,28,79
Peterhead,8987,2,24,4,8,78,38,40,76
Stirling,8987,3,16,7,13,60,51,9,55
Stenhousem'r,8987,4,15,9,12,55,46,9,54
Clyde,8987,5,14,10,12,52,49,3,52
Elgin,8987,6,14,6,16,55,65,-10,48
Annan Athlet,8987,7,11,11,14,47,42,5,44
Berwick,8987,8,8,11,17,30,59,-29,35
Edinburgh Ci,8987,9,7,9,20,36,61,-25,30
Cowdenbeath,8987,10,5,10,21,24,54,-30,25
Peterhead,8988,1,24,4,8,82,39,43,76
Montrose,8988,2,23,7,6,59,35,24,76
Stirling,8988,3,17,6,13,62,51,11,57
Stenhousem'r,8988,4,15,8,13,55,48,7,53
Clyde,8988,5,14,9,13,51,49,2,51
Elgin,8988,6,15,6,15,54,60,-6,51
Annan Athlet,8988,7,11,12,13,47,41,6,45
Berwick,8988,8,9,10,17,30,58,-28,37
Edinburgh Ci,8988,9,7,9,20,37,65,-28,30
Cowdenbeath,8988,10,4,11,21,23,54,-31,23
Montrose,8989,1,24,7,5,61,35,26,79
Peterhead,8989,2,23,5,8,78,39,39,74
Stenhousem'r,8989,3,16,8,12,57,46,11,56
Stirling,8989,4,16,6,14,60,53,7,54
Clyde,8989,5,15,9,12,55,48,7,54
Elgin,8989,6,14,6,16,54,62,-8,48
Annan Athlet,8989,7,11,12,13,48,42,6,45
Berwick,8989,8,8,10,18,29,62,-33,34
Edinburgh Ci,8989,9,7,10,19,37,61,-24,31
Cowdenbeath,8989,10,4,11,21,24,55,-31,23
Montrose,8990,1,24,7,5,64,35,29,79
Peterhead,8990,2,24,4,8,82,38,44,76
Stenhousem'r,8990,3,16,8,12,59,47,12,56
Stirling,8990,4,16,6,14,61,55,6,54
Clyde,8990,5,14,10,12,51,48,3,52
Elgin,8990,6,14,6,16,54,65,-11,48
Annan Athlet,8990,7,11,11,14,47,43,4,44
Berwick,8990,8,8,11,17,29,58,-29,35
Edinburgh Ci,8990,9,7,9,20,36,65,-29,30
Cowdenbeath,8990,10,5,10,21,25,54,-29,25
Montrose,8991,1,23,8,5,60,35,25,77
Peterhead,8991,2,24,4,8,78,38,40,76
Stirling,8991,3,17,6,13,61,51,10,57
Stenhousem'r,8991,4,15,8,13,55,47,8,53
Clyde,8991,5,14,9,13,51,50,1,51
Elgin,8991,6,14,7,15,54,61,-7,49
Annan Athlet,8991,7,11,12,13,49,43,6,45
Berwick,8991,8,9,10,17,31,58,-27,37
Edinburgh Ci,8991,9,7,9,20,36,61,-25,30
Cowdenbeath,8991,10,4,11,21,25,56,-31,23
Montrose,8992,1,24,7,5,63,34,29,79
Peterhead,8992,2,24,4,8,79,38,41,76
Stirling,8992,3,16,7,13,62,53,9,55
Stenhousem'r,8992,4,15,9,12,57,48,9,54
Clyde,8992,5,15,9,12,53,49,4,54
Elgin,8992,6,14,6,16,53,64,-11,48
Annan Athlet,8992,7,11,12,13,49,43,6,45
Berwick,8992,8,8,10,18,30,60,-30,34
Edinburgh Ci,8992,9,7,9,20,36,62,-26,30
Cowdenbeath,8992,10,4,11,21,25,56,-31,23
Montrose,8993,1,24,7,5,61,34,27,79
Peterhead,8993,2,24,4,8,80,39,41,76
Stirling,8993,3,16,7,13,60,51,9,55
Stenhousem'r,8993,4,15,9,12,55,46,9,54
Clyde,8993,5,14,10,12,52,49,3,52
Elgin,8993,6,14,6,16,53,62,-9,48
Annan Athlet,8993,7,12,11,13,49,42,7,47
Berwick,8993,8,8,11,17,30,59,-29,35
Edinburgh Ci,8993,9,7,9,20,37,63,-26,30
Cowdenbeath,8993,10,4,10,22,24,56,-32,22
Montrose,8994,1,24,7,5,60,34,26,79
Peterhead,8994,2,24,4,8,79,39,40,76
Stirling,8994,3,17,6,13,62,51,11,57
Clyde,8994,4,15,9,12,55,49,6,54
Stenhousem'r,8994,5,15,8,13,55,48,7,53
Elgin,8994,6,14,6,16,53,61,-8,48
Annan Athlet,8994,7,11,11,14,49,44,5,44
Berwick,8994,8,8,10,18,30,62,-32,34
Edinburgh Ci,8994,9,7,9,20,37,62,-25,30
Cowdenbeath,8994,10,5,10,21,26,56,-30,25
Peterhead,8995,1,24,4,8,79,39,40,76
Montrose,8995,2,23,7,6,60,36,24,76
Stenhousem'r,8995,3,16,8,12,56,46,10,56
Stirling,8995,4,16,6,14,60,52,8,54
Clyde,8995,5,15,9,12,52,48,4,54
Elgin,8995,6,15,6,15,55,61,-6,51
Annan Athlet,8995,7,11,12,13,47,41,6,45
Berwick,8995,8,8,10,18,29,59,-30,34
Edinburgh Ci,8995,9,7,9,20,37,62,-25,30
Cowdenbeath,8995,10,4,11,21,23,54,-31,23
Peterhead,8996,1,24,4,8,81,41,40,76
Montrose,8996,2,23,7,6,60,36,24,76
Stirling,8996,3,17,6,13,62,51,11,57
Clyde,8996,4,15,9,12,54,49,5,54
Stenhousem'r,8996,5,15,8,13,55,48,7,53
Elgin,8996,6,15,6,15,55,61,-6,51
Annan Athlet,8996,7,12,11,13,48,41,7,47
Berwick,8996,8,8,10,18,30,61,-31,34
Edinburgh Ci,8996,9,7,9,20,39,64,-25,30
Cowdenbeath,8996,10,4,10,22,23,55,-32,22
Montrose,8997,1,23,8,5,60,35,25,77
Peterhead,8997,2,24,4,8,79,38,41,76
Stirling,8997,3,17,6,13,62,52,10,57
Clyde,8997,4,15,9,12,55,48,7,54
Stenhousem'r,8997,5,15,8,13,56,48,8,53
Elgin,8997,6,14,7,15,54,61,-7,49
Annan Athlet,8997,7,12,11,13,49,41,8,47
Berwick,8997,8,8,10,18,29,62,-33,34
Edinburgh Ci,8997,9,7,9,20,36,62,-26,30
Cowdenbeath,8997,10,4,10,22,23,56,-33,22
Montrose,8998,1,23,8,5,60,35,25,77
Peterhead,8998,2,24,4,8,80,40,40,76
Stirling,8998,3,17,6,13,62,52,10,57
Clyde,8998,4,15,9,12,55,49,6,54
Stenhousem'r,8998,5,15,8,13,56,48,8,53
Elgin,8998,6,14,7,15,54,61,-7,49
Annan Athlet,8998,7,11,12,13,47,41,6,45
Berwick,8998,8,8,10,18,30,62,-32,34
Edinburgh Ci,8998,9,7,9,20,38,63,-25,30
Cowdenbeath,8998,10,4,11,21,23,54,-31,23
Montrose,8999,1,24,7,5,61,35,26,79
Peterhead,8999,2,23,5,8,78,39,39,74
Stirling,8999,3,17,6,13,62,52,10,57
Stenhousem'r,8999,4,15,8,13,56,48,8,53
Clyde,8999,5,14,10,12,52,49,3,52
Elgin,8999,6,14,6,16,54,62,-8,48
Annan Athlet,8999,7,12,11,13,50,43,7,47
Berwick,8999,8,8,11,17,30,59,-29,35
Edinburgh Ci,8999,9,7,10,19,37,61,-24,31
Cowdenbeath,8999,10,4,10,22,25,57,-32,22
Montrose,9000,1,23,8,5,59,34,25,77
Peterhead,9000,2,24,4,8,80,39,41,76
Stenhousem'r,9000,3,16,8,12,58,46,12,56
Stirling,9000,4,16,6,14,60,54,6,54
Clyde,9000,5,15,9,12,54,48,6,54
Elgin,9000,6,14,7,15,53,60,-7,49
Annan Athlet,9000,7,11,12,13,48,42,6,45
Berwick,9000,8,8,10,18,29,61,-32,34
Edinburgh Ci,9000,9,7,9,20,37,63,-26,30
Cowdenbeath,9000,10,4,11,21,24,55,-31,23
Montrose,9001,1,24,7,5,62,36,26,79
Peterhead,9001,2,24,4,8,83,39,44,76
Stirling,9001,3,17,6,13,63,53,10,57
Stenhousem'r,9001,4,15,8,13,57,49,8,53
Clyde,9001,5,14,10,12,52,49,3,52
Elgin,9001,6,14,6,16,55,63,-8,48
Annan Athlet,9001,7,11,12,13,47,41,6,45
Berwick,9001,8,8,11,17,30,59,-29,35
Edinburgh Ci,9001,9,7,9,20,37,66,-29,30
Cowdenbeath,9001,10,4,11,21,23,54,-31,23
Montrose,9002,1,24,7,5,60,34,26,79
Peterhead,9002,2,24,4,8,78,38,40,76
Stirling,9002,3,16,7,13,61,52,9,55
Stenhousem'r,9002,4,15,9,12,56,47,9,54
Clyde,9002,5,15,9,12,53,48,5,54
Elgin,9002,6,14,6,16,53,61,-8,48
Annan Athlet,9002,7,11,11,14,47,42,5,44
Berwick,9002,8,8,10,18,29,60,-31,34
Edinburgh Ci,9002,9,7,9,20,36,61,-25,30
Cowdenbeath,9002,10,5,10,21,24,54,-30,25
Peterhead,9003,1,24,4,8,81,39,42,76
Montrose,9003,2,23,7,6,61,39,22,76
Stirling,9003,3,16,7,13,61,52,9,55
Stenhousem'r,9003,4,15,9,12,56,47,9,54
Clyde,9003,5,14,10,12,52,49,3,52
Elgin,9003,6,15,6,15,58,62,-4,51
Annan Athlet,9003,7,11,12,13,47,41,6,45
Berwick,9003,8,8,11,17,30,59,-29,35
Edinburgh Ci,9003,9,7,9,20,37,64,-27,30
Cowdenbeath,9003,10,4,11,21,23,54,-31,23
Montrose,9004,1,23,8,5,60,35,25,77
Peterhead,9004,2,23,5,8,79,40,39,74
Stenhousem'r,9004,3,16,8,12,57,46,11,56
Stirling,9004,4,16,6,14,60,53,7,54
Clyde,9004,5,15,9,12,54,48,6,54
Elgin,9004,6,14,7,15,54,61,-7,49
Annan Athlet,9004,7,11,11,14,47,42,5,44
Berwick,9004,8,8,10,18,29,61,-32,34
Edinburgh Ci,9004,9,7,10,19,38,62,-24,31
Cowdenbeath,9004,10,5,10,21,24,54,-30,25
Montrose,9005,1,24,7,5,63,35,28,79
Peterhead,9005,2,24,4,8,80,38,42,76
Stenhousem'r,9005,3,16,8,12,58,47,11,56
Stirling,9005,4,16,6,14,61,54,7,54
Clyde,9005,5,15,9,12,52,48,4,54
Elgin,9005,6,14,6,16,54,64,-10,48
Annan Athlet,9005,7,11,12,13,49,43,6,45
Berwick,9005,8,8,10,18,29,59,-30,34
Edinburgh Ci,9005,9,7,9,20,36,63,-27,30
Cowdenbeath,9005,10,4,11,21,25,56,-31,23
Montrose,9006,1,23,8,5,59,34,25,77
Peterhead,9006,2,23,5,8,78,39,39,74
Stirling,9006,3,17,6,13,63,52,11,57
Stenhousem'r,9006,4,15,8,13,56,49,7,53
Clyde,9006,5,14,9,13,51,52,-1,51
Elgin,9006,6,14,7,15,53,60,-7,49
Annan Athlet,9006,7,11,12,13,49,43,6,45
Berwick,9006,8,9,10,17,33,58,-25,37
Edinburgh Ci,9006,9,7,10,19,37,61,-24,31
Cowdenbeath,9006,10,4,11,21,25,56,-31,23
Montrose,9007,1,24,7,5,62,35,27,79
Peterhead,9007,2,24,4,8,79,38,41,76
Stenhousem'r,9007,3,16,8,12,56,46,10,56
Stirling,9007,4,16,6,14,60,52,8,54
Clyde,9007,5,14,10,12,52,49,3,52
Elgin,9007,6,14,6,16,54,63,-9,48
Annan Athlet,9007,7,12,11,13,48,41,7,47
Berwick,9007,8,8,11,17,30,59,-29,35
Edinburgh Ci,9007,9,7,9,20,36,62,-26,30
Cowdenbeath,9007,10,4,10,22,23,55,-32,22
Montrose,9008,1,23,7,6,61,37,24,76
Peterhead,9008,2,23,5,8,79,40,39,74
Stenhousem'r,9008,3,16,8,12,56,46,10,56
Stirling,9008,4,16,6,14,60,52,8,54
Clyde,9008,5,14,9,13,52,50,2,51
Elgin,9008,6,15,6,15,56,62,-6,51
Annan Athlet,9008,7,11,11,14,47,42,5,44
Berwick,9008,8,9,10,17,31,59,-28,37
Edinburgh Ci,9008,9,7,10,19,38,62,-24,31
Cowdenbeath,9008,10,5,10,21,24,54,-30,25
Montrose,9009,1,24,7,5,61,35,26,79
Peterhead,9009,2,24,4,8,79,39,40,76
Stenhousem'r,9009,3,16,8,12,57,46,11,56
Stirling,9009,4,16,6,14,60,53,7,54
Clyde,9009,5,14,10,12,51,48,3,52
Elgin,9009,6,14,6,16,54,62,-8,48
Annan Athlet,9009,7,12,11,13,48,41,7,47
Berwick,9009,8,8,11,17,29,58,-29,35
Edinburgh Ci,9009,9,7,9,20,37,62,-25,30
Cowdenbeath,9009,10,4,10,22,23,55,-32,22
Montrose,9010,1,24,7,5,62,36,26,79
Peterhead,9010,2,24,4,8,81,38,43,76
Stenhousem'r,9010,3,16,8,12,56,46,10,56
Stirling,9010,4,16,6,14,60,52,8,54
Clyde,9010,5,15,9,12,52,48,4,54
Elgin,9010,6,14,6,16,55,63,-8,48
Annan Athlet,9010,7,12,11,13,50,41,9,47
Berwick,9010,8,8,10,18,29,59,-30,34
Edinburgh Ci,9010,9,7,9,20,36,64,-28,30
Cowdenbeath,9010,10,4,10,22,23,57,-34,22
Montrose,9011,1,23,8,5,59,34,25,77
Peterhead,9011,2,24,4,8,81,40,41,76
Stirling,9011,3,17,6,13,61,51,10,57
Stenhousem'r,9011,4,15,8,13,55,47,8,53
Clyde,9011,5,14,10,12,52,49,3,52
Elgin,9011,6,14,7,15,53,60,-7,49
Annan Athlet,9011,7,12,11,13,48,41,7,47
Berwick,9011,8,8,11,17,30,59,-29,35
Edinburgh Ci,9011,9,7,9,20,38,64,-26,30
Cowdenbeath,9011,10,4,10,22,23,55,-32,22
Montrose,9012,1,24,7,5,62,35,27,79
Peterhead,9012,2,24,4,8,78,38,40,76
Stirling,9012,3,17,6,13,63,51,12,57
Clyde,9012,4,15,9,12,53,48,5,54
Stenhousem'r,9012,5,15,8,13,55,49,6,53
Elgin,9012,6,14,6,16,54,63,-9,48
Annan Athlet,9012,7,12,11,13,48,41,7,47
Berwick,9012,8,8,10,18,29,60,-31,34
Edinburgh Ci,9012,9,7,9,20,36,61,-25,30
Cowdenbeath,9012,10,4,10,22,23,55,-32,22
Montrose,9013,1,23,8,5,61,36,25,77
Peterhead,9013,2,24,4,8,81,38,43,76
Stenhousem'r,9013,3,16,8,12,57,46,11,56
Stirling,9013,4,16,6,14,60,53,7,54
Clyde,9013,5,15,9,12,53,49,4,54
Elgin,9013,6,14,7,15,55,62,-7,49
Annan Athlet,9013,7,11,12,13,48,42,6,45
Berwick,9013,8,8,10,18,30,60,-30,34
Edinburgh Ci,9013,9,7,9,20,36,64,-28,30
Cowdenbeath,9013,10,4,11,21,24,55,-31,23
Montrose,9014,1,23,7,6,59,35,24,76
Peterhead,9014,2,23,5,8,78,39,39,74
Stirling,9014,3,17,6,13,63,52,11,57
Clyde,9014,4,15,9,12,54,49,5,54
Stenhousem'r,9014,5,15,8,13,56,49,7,53
Elgin,9014,6,15,6,15,54,60,-6,51
Annan Athlet,9014,7,12,11,13,48,41,7,47
Berwick,9014,8,8,10,18,30,61,-31,34
Edinburgh Ci,9014,9,7,10,19,37,61,-24,31
Cowdenbeath,9014,10,4,10,22,23,55,-32,22
Peterhead,9015,1,24,4,8,81,38,43,76
Montrose,9015,2,23,7,6,60,36,24,76
Stirling,9015,3,17,6,13,67,53,14,57
Clyde,9015,4,15,9,12,55,48,7,54
Stenhousem'r,9015,5,15,8,13,57,53,4,53
Elgin,9015,6,15,6,15,55,61,-6,51
Annan Athlet,9015,7,11,11,14,48,43,5,44
Berwick,9015,8,8,10,18,29,62,-33,34
Edinburgh Ci,9015,9,7,9,20,36,64,-28,30
Cowdenbeath,9015,10,5,10,21,25,55,-30,25
Montrose,9016,1,23,7,6,60,39,21,76
Peterhead,9016,2,23,5,8,79,40,39,74
Stenhousem'r,9016,3,16,8,12,59,48,11,56
Stirling,9016,4,16,6,14,62,55,7,54
Clyde,9016,5,15,9,12,53,48,5,54
Elgin,9016,6,15,6,15,58,61,-3,51
Annan Athlet,9016,7,11,11,14,47,44,3,44
Berwick,9016,8,8,10,18,29,60,-31,34
Edinburgh Ci,9016,9,7,10,19,38,62,-24,31
Cowdenbeath,9016,10,5,10,21,26,54,-28,25
Montrose,9017,1,24,7,5,61,35,26,79
Peterhead,9017,2,24,4,8,79,39,40,76
Stirling,9017,3,17,6,13,62,51,11,57
Stenhousem'r,9017,4,15,8,13,55,48,7,53
Clyde,9017,5,14,9,13,52,51,1,51
Elgin,9017,6,14,6,16,54,62,-8,48
Annan Athlet,9017,7,11,11,14,47,43,4,44
Berwick,9017,8,9,10,17,32,59,-27,37
Edinburgh Ci,9017,9,7,9,20,37,62,-25,30
Cowdenbeath,9017,10,5,10,21,25,54,-29,25
Montrose,9018,1,24,7,5,60,34,26,79
Peterhead,9018,2,23,4,9,77,39,38,73
Stirling,9018,3,17,6,13,61,51,10,57
Clyde,9018,4,15,9,12,54,49,5,54
Stenhousem'r,9018,5,15,8,13,55,47,8,53
Elgin,9018,6,14,6,16,53,61,-8,48
Annan Athlet,9018,7,11,11,14,47,42,5,44
Berwick,9018,8,8,10,18,30,61,-31,34
Edinburgh Ci,9018,9,8,9,19,37,60,-23,33
Cowdenbeath,9018,10,5,10,21,24,54,-30,25
Montrose,9019,1,23,7,6,60,36,24,76
Peterhead,9019,2,23,4,9,77,39,38,73
Stirling,9019,3,16,7,13,60,51,9,55
Stenhousem'r,9019,4,15,9,12,55,46,9,54
Clyde,9019,5,14,10,12,51,48,3,52
Elgin,9019,6,15,6,15,55,61,-6,51
Annan Athlet,9019,7,12,11,13,49,42,7,47
Berwick,9019,8,8,11,17,29,58,-29,35
Edinburgh Ci,9019,9,8,9,19,37,60,-23,33
Cowdenbeath,9019,10,4,10,22,24,56,-32,22
Peterhead,9020,1,24,4,8,80,38,42,76
Montrose,9020,2,23,7,6,60,36,24,76
Stirling,9020,3,16,7,13,62,53,9,55
Stenhousem'r,9020,4,15,9,12,57,48,9,54
Clyde,9020,5,14,9,13,54,52,2,51
Elgin,9020,6,15,6,15,55,61,-6,51
Annan Athlet,9020,7,11,11,14,47,43,4,44
Berwick,9020,8,9,10,17,33,61,-28,37
Edinburgh Ci,9020,9,7,9,20,36,63,-27,30
Cowdenbeath,9020,10,5,10,21,25,54,-29,25
Montrose,9021,1,24,7,5,60,34,26,79
Peterhead,9021,2,24,4,8,79,38,41,76
Stirling,9021,3,16,7,13,62,53,9,55
Stenhousem'r,9021,4,15,9,12,57,48,9,54
Clyde,9021,5,15,9,12,54,50,4,54
Elgin,9021,6,14,6,16,53,61,-8,48
Annan Athlet,9021,7,12,11,13,48,41,7,47
Berwick,9021,8,8,10,18,31,61,-30,34
Edinburgh Ci,9021,9,7,9,20,36,62,-26,30
Cowdenbeath,9021,10,4,10,22,23,55,-32,22
Montrose,9022,1,24,7,5,61,35,26,79
Peterhead,9022,2,24,4,8,81,38,43,76
Stirling,9022,3,17,6,13,62,51,11,57
Clyde,9022,4,15,9,12,52,48,4,54
Stenhousem'r,9022,5,15,8,13,55,48,7,53
Elgin,9022,6,14,6,16,54,62,-8,48
Annan Athlet,9022,7,11,11,14,48,45,3,44
Berwick,9022,8,8,10,18,29,59,-30,34
Edinburgh Ci,9022,9,7,9,20,36,64,-28,30
Cowdenbeath,9022,10,5,10,21,27,55,-28,25
Montrose,9023,1,24,7,5,62,35,27,79
Peterhead,9023,2,23,5,8,77,38,39,74
Stirling,9023,3,17,6,13,61,51,10,57
Clyde,9023,4,15,9,12,54,49,5,54
Stenhousem'r,9023,5,15,8,13,55,47,8,53
Elgin,9023,6,14,6,16,54,63,-9,48
Annan Athlet,9023,7,11,12,13,47,41,6,45
Berwick,9023,8,8,10,18,30,61,-31,34
Edinburgh Ci,9023,9,7,10,19,36,60,-24,31
Cowdenbeath,9023,10,4,11,21,23,54,-31,23
Peterhead,9024,1,24,4,8,81,40,41,76
Montrose,9024,2,23,7,6,60,36,24,76
Stirling,9024,3,16,7,13,62,53,9,55
Stenhousem'r,9024,4,15,9,12,57,48,9,54
Clyde,9024,5,15,9,12,55,49,6,54
Elgin,9024,6,15,6,15,55,61,-6,51
Annan Athlet,9024,7,12,11,13,48,41,7,47
Berwick,9024,8,8,10,18,30,62,-32,34
Edinburgh Ci,9024,9,7,9,20,38,64,-26,30
Cowdenbeath,9024,10,4,10,22,23,55,-32,22
Montrose,9025,1,24,7,5,60,34,26,79
Peterhead,9025,2,24,4,8,82,38,44,76
Stirling,9025,3,17,6,13,63,51,12,57
Clyde,9025,4,15,9,12,52,48,4,54
Stenhousem'r,9025,5,15,8,13,55,49,6,53
Elgin,9025,6,14,6,16,53,61,-8,48
Annan Athlet,9025,7,12,11,13,48,41,7,47
Berwick,9025,8,8,10,18,29,59,-30,34
Edinburgh Ci,9025,9,7,9,20,36,65,-29,30
Cowdenbeath,9025,10,4,10,22,23,55,-32,22
Montrose,9026,1,24,7,5,63,37,26,79
Peterhead,9026,2,23,4,9,78,40,38,73
Stirling,9026,3,17,6,13,63,53,10,57
Stenhousem'r,9026,4,15,8,13,57,49,8,53
Clyde,9026,5,14,10,12,52,49,3,52
Elgin,9026,6,14,6,16,56,64,-8,48
Annan Athlet,9026,7,12,11,13,49,42,7,47
Berwick,9026,8,8,11,17,30,59,-29,35
Edinburgh Ci,9026,9,8,9,19,38,61,-23,33
Cowdenbeath,9026,10,4,10,22,24,56,-32,22
Montrose,9027,1,24,7,5,61,35,26,79
Peterhead,9027,2,24,4,8,79,38,41,76
Stirling,9027,3,16,7,13,62,53,9,55
Stenhousem'r,9027,4,15,9,12,57,48,9,54
Clyde,9027,5,15,9,12,53,48,5,54
Elgin,9027,6,14,6,16,54,62,-8,48
Annan Athlet,9027,7,11,12,13,48,42,6,45
Berwick,9027,8,8,10,18,29,60,-31,34
Edinburgh Ci,9027,9,7,9,20,36,62,-26,30
Cowdenbeath,9027,10,4,11,21,24,55,-31,23
Montrose,9028,1,24,7,5,62,35,27,79
Peterhead,9028,2,24,4,8,80,40,40,76
Stenhousem'r,9028,3,16,8,12,57,47,10,56
Stirling,9028,4,16,6,14,61,53,8,54
Clyde,9028,5,14,10,12,53,50,3,52
Elgin,9028,6,14,6,16,54,63,-9,48
Annan Athlet,9028,7,11,12,13,47,41,6,45
Berwick,9028,8,8,11,17,31,60,-29,35
Edinburgh Ci,9028,9,7,9,20,38,63,-25,30
Cowdenbeath,9028,10,4,11,21,23,54,-31,23
Montrose,9029,1,24,7,5,62,35,27,79
Peterhead,9029,2,24,4,8,82,39,43,76
Stenhousem'r,9029,3,16,8,12,58,48,10,56
Stirling,9029,4,16,6,14,62,54,8,54
Clyde,9029,5,14,9,13,52,50,2,51
Elgin,9029,6,14,6,16,54,63,-9,48
Annan Athlet,9029,7,11,12,13,47,41,6,45
Berwick,9029,8,9,10,17,31,59,-28,37
Edinburgh Ci,9029,9,7,9,20,37,65,-28,30
Cowdenbeath,9029,10,4,11,21,23,54,-31,23
Montrose,9030,1,24,7,5,61,34,27,79
Peterhead,9030,2,23,5,8,79,40,39,74
Stirling,9030,3,17,6,13,65,51,14,57
Stenhousem'r,9030,4,15,8,13,55,51,4,53
Clyde,9030,5,14,9,13,51,50,1,51
Elgin,9030,6,14,6,16,53,62,-9,48
Annan Athlet,9030,7,12,11,13,48,41,7,47
Berwick,9030,8,9,10,17,31,58,-27,37
Edinburgh Ci,9030,9,7,10,19,38,62,-24,31
Cowdenbeath,9030,10,4,10,22,23,55,-32,22
Montrose,9031,1,24,7,5,61,35,26,79
Peterhead,9031,2,24,4,8,81,39,42,76
Stirling,9031,3,17,6,13,61,51,10,57
Clyde,9031,4,15,9,12,56,48,8,54
Stenhousem'r,9031,5,15,8,13,55,47,8,53
Elgin,9031,6,14,6,16,54,62,-8,48
Annan Athlet,9031,7,11,12,13,48,42,6,45
Berwick,9031,8,8,10,18,29,63,-34,34
Edinburgh Ci,9031,9,7,9,20,37,64,-27,30
Cowdenbeath,9031,10,4,11,21,24,55,-31,23
Montrose,9032,1,23,8,5,60,35,25,77
Peterhead,9032,2,24,4,8,81,38,43,76
Stirling,9032,3,17,6,13,62,52,10,57
Clyde,9032,4,15,9,12,53,49,4,54
Stenhousem'r,9032,5,15,8,13,56,48,8,53
Elgin,9032,6,14,7,15,54,61,-7,49
Annan Athlet,9032,7,12,11,13,48,41,7,47
Berwick,9032,8,8,10,18,30,60,-30,34
Edinburgh Ci,9032,9,7,9,20,36,64,-28,30
Cowdenbeath,9032,10,4,10,22,23,55,-32,22
Montrose,9033,1,23,7,6,59,35,24,76
Peterhead,9033,2,23,5,8,78,39,39,74
Stenhousem'r,9033,3,16,8,12,56,46,10,56
Stirling,9033,4,16,6,14,60,52,8,54
Clyde,9033,5,14,9,13,51,50,1,51
Elgin,9033,6,15,6,15,54,60,-6,51
Annan Athlet,9033,7,12,11,13,48,41,7,47
Berwick,9033,8,9,10,17,31,58,-27,37
Edinburgh Ci,9033,9,7,10,19,37,61,-24,31
Cowdenbeath,9033,10,4,10,22,23,55,-32,22
Montrose,9034,1,24,7,5,61,35,26,79
Peterhead,9034,2,24,4,8,79,39,40,76
Stirling,9034,3,17,6,13,61,51,10,57
Clyde,9034,4,15,9,12,52,48,4,54
Stenhousem'r,9034,5,15,8,13,55,47,8,53
Elgin,9034,6,14,6,16,54,62,-8,48
Annan Athlet,9034,7,11,12,13,47,41,6,45
Berwick,9034,8,8,10,18,29,59,-30,34
Edinburgh Ci,9034,9,7,9,20,37,62,-25,30
Cowdenbeath,9034,10,4,11,21,23,54,-31,23
Peterhead,9035,1,24,4,8,78,38,40,76
Montrose,9035,2,23,7,6,59,36,23,76
Stirling,9035,3,17,6,13,61,51,10,57
Clyde,9035,4,15,9,12,54,50,4,54
Stenhousem'r,9035,5,15,8,13,55,47,8,53
Elgin,9035,6,15,6,15,55,60,-5,51
Annan Athlet,9035,7,11,11,14,47,43,4,44
Berwick,9035,8,8,10,18,31,61,-30,34
Edinburgh Ci,9035,9,7,9,20,36,61,-25,30
Cowdenbeath,9035,10,5,10,21,25,54,-29,25
Montrose,9036,1,24,7,5,61,34,27,79
Peterhead,9036,2,23,5,8,77,38,39,74
Stirling,9036,3,17,6,13,61,51,10,57
Clyde,9036,4,15,9,12,54,48,6,54
Stenhousem'r,9036,5,15,8,13,55,47,8,53
Elgin,9036,6,14,6,16,53,62,-9,48
Annan Athlet,9036,7,11,12,13,49,43,6,45
Berwick,9036,8,8,10,18,29,61,-32,34
Edinburgh Ci,9036,9,7,10,19,36,60,-24,31
Cowdenbeath,9036,10,4,11,21,25,56,-31,23
Montrose,9037,1,24,7,5,62,35,27,79
Peterhead,9037,2,23,4,9,78,40,38,73
Stirling,9037,3,16,7,13,62,53,9,55
Stenhousem'r,9037,4,15,9,12,57,48,9,54
Clyde,9037,5,15,9,12,53,48,5,54
Elgin,9037,6,14,6,16,54,63,-9,48
Annan Athlet,9037,7,11,12,13,50,44,6,45
Berwick,9037,8,8,10,18,29,60,-31,34
Edinburgh Ci,9037,9,8,9,19,38,61,-23,33
Cowdenbeath,9037,10,4,11,21,26,57,-31,23
Montrose,9038,1,24,7,5,61,35,26,79
Peterhead,9038,2,24,4,8,79,39,40,76
Stenhousem'r,9038,3,16,8,12,58,47,11,56
Stirling,9038,4,16,6,14,61,54,7,54
Clyde,9038,5,15,9,12,54,48,6,54
Elgin,9038,6,14,6,16,54,62,-8,48
Annan Athlet,9038,7,11,12,13,48,42,6,45
Berwick,9038,8,8,10,18,29,61,-32,34
Edinburgh Ci,9038,9,7,9,20,37,62,-25,30
Cowdenbeath,9038,10,4,11,21,24,55,-31,23
Montrose,9039,1,23,8,5,60,35,25,77
Peterhead,9039,2,24,4,8,79,38,41,76
Stirling,9039,3,17,6,13,64,51,13,57
Clyde,9039,4,15,9,12,53,48,5,54
Stenhousem'r,9039,5,15,8,13,55,50,5,53
Elgin,9039,6,14,7,15,54,61,-7,49
Annan Athlet,9039,7,11,11,14,47,43,4,44
Berwick,9039,8,8,10,18,29,60,-31,34
Edinburgh Ci,9039,9,7,9,20,36,62,-26,30
Cowdenbeath,9039,10,5,10,21,25,54,-29,25
Peterhead,9040,1,24,4,8,79,38,41,76
Montrose,9040,2,23,7,6,59,37,22,76
Stenhousem'r,9040,3,16,8,12,57,47,10,56
Stirling,9040,4,16,6,14,61,53,8,54
Clyde,9040,5,15,9,12,52,48,4,54
Elgin,9040,6,15,6,15,56,60,-4,51
Annan Athlet,9040,7,12,11,13,49,42,7,47
Berwick,9040,8,8,10,18,29,59,-30,34
Edinburgh Ci,9040,9,7,9,20,36,62,-26,30
Cowdenbeath,9040,10,4,10,22,24,56,-32,22
Montrose,9041,1,24,7,5,63,37,26,79
Peterhead,9041,2,24,4,8,80,39,41,76
Stirling,9041,3,16,7,13,61,52,9,55
Stenhousem'r,9041,4,15,9,12,56,47,9,54
Clyde,9041,5,14,10,12,52,49,3,52
Elgin,9041,6,14,6,16,56,64,-8,48
Annan Athlet,9041,7,12,11,13,50,41,9,47
Berwick,9041,8,8,11,17,30,59,-29,35
Edinburgh Ci,9041,9,7,9,20,37,63,-26,30
Cowdenbeath,9041,10,4,10,22,23,57,-34,22
Montrose,9042,1,24,7,5,62,34,28,79
Peterhead,9042,2,24,4,8,84,38,46,76
Stirling,9042,3,16,7,13,61,52,9,55
Stenhousem'r,9042,4,15,9,12,56,47,9,54
Clyde,9042,5,14,9,13,52,50,2,51
Elgin,9042,6,14,6,16,53,63,-10,48
Annan Athlet,9042,7,11,11,14,47,42,5,44
Berwick,9042,8,9,10,17,31,59,-28,37
Edinburgh Ci,9042,9,7,9,20,36,67,-31,30
Cowdenbeath,9042,10,5,10,21,24,54,-30,25
Peterhead,9043,1,24,4,8,81,39,42,76
Montrose,9043,2,23,7,6,60,36,24,76
Stirling,9043,3,17,6,13,61,51,10,57
Clyde,9043,4,15,9,12,53,49,4,54
Stenhousem'r,9043,5,15,8,13,55,47,8,53
Elgin,9043,6,15,6,15,55,61,-6,51
Annan Athlet,9043,7,11,11,14,49,44,5,44
Berwick,9043,8,8,10,18,30,60,-30,34
Edinburgh Ci,9043,9,7,9,20,37,64,-27,30
Cowdenbeath,9043,10,5,10,21,26,56,-30,25
Montrose,9044,1,24,7,5,62,36,26,79
Peterhead,9044,2,23,5,8,77,38,39,74
Stenhousem'r,9044,3,16,8,12,57,46,11,56
Stirling,9044,4,16,6,14,60,53,7,54
Clyde,9044,5,15,9,12,52,48,4,54
Elgin,9044,6,14,6,16,55,63,-8,48
Annan Athlet,9044,7,11,11,14,47,42,5,44
Berwick,9044,8,8,10,18,29,59,-30,34
Edinburgh Ci,9044,9,7,10,19,36,60,-24,31
Cowdenbeath,9044,10,5,10,21,24,54,-30,25
Montrose,9045,1,24,7,5,61,35,26,79
Peterhead,9045,2,24,4,8,81,39,42,76
Stirling,9045,3,17,6,13,63,52,11,57
Clyde,9045,4,15,9,12,53,48,5,54
Stenhousem'r,9045,5,15,8,13,56,49,7,53
Elgin,9045,6,14,6,16,54,62,-8,48
Annan Athlet,9045,7,11,11,14,47,42,5,44
Berwick,9045,8,8,10,18,29,60,-31,34
Edinburgh Ci,9045,9,7,9,20,37,64,-27,30
Cowdenbeath,9045,10,5,10,21,24,54,-30,25
Montrose,9046,1,24,7,5,61,34,27,79
Peterhead,9046,2,24,4,8,81,39,42,76
Stirling,9046,3,16,7,13,62,53,9,55
Stenhousem'r,9046,4,15,9,12,57,48,9,54
Clyde,9046,5,15,9,12,53,48,5,54
Elgin,9046,6,14,6,16,53,62,-9,48
Annan Athlet,9046,7,12,11,13,49,41,8,47
Berwick,9046,8,8,10,18,29,60,-31,34
Edinburgh Ci,9046,9,7,9,20,37,64,-27,30
Cowdenbeath,9046,10,4,10,22,23,56,-33,22
Montrose,9047,1,24,7,5,61,35,26,79
Peterhead,9047,2,24,4,8,79,39,40,76
Stirling,9047,3,17,6,13,62,51,11,57
Clyde,9047,4,15,9,12,52,48,4,54
Stenhousem'r,9047,5,15,8,13,55,48,7,53
Elgin,9047,6,14,6,16,54,62,-8,48
Annan Athlet,9047,7,12,11,13,48,41,7,47
Berwick,9047,8,8,10,18,29,59,-30,34
Edinburgh Ci,9047,9,7,9,20,37,62,-25,30
Cowdenbeath,9047,10,4,10,22,23,55,-32,22
Montrose,9048,1,24,7,5,60,34,26,79
Peterhead,9048,2,24,4,8,81,39,42,76
Stirling,9048,3,16,7,13,61,52,9,55
Stenhousem'r,9048,4,15,9,12,56,47,9,54
Clyde,9048,5,14,9,13,52,50,2,51
Elgin,9048,6,14,6,16,53,61,-8,48
Annan Athlet,9048,7,11,11,14,48,43,5,44
Berwick,9048,8,9,10,17,31,59,-28,37
Edinburgh Ci,9048,9,7,9,20,37,64,-27,30
Cowdenbeath,9048,10,5,10,21,25,55,-30,25
Montrose,9049,1,23,7,6,59,35,24,76
Peterhead,9049,2,23,4,9,81,43,38,73
Stenhousem'r,9049,3,16,8,12,57,47,10,56
Stirling,9049,4,16,6,14,61,53,8,54
Clyde,9049,5,15,9,12,53,49,4,54
Elgin,9049,6,15,6,15,54,60,-6,51
Annan Athlet,9049,7,11,11,14,48,43,5,44
Berwick,9049,8,8,10,18,30,60,-30,34
Edinburgh Ci,9049,9,8,9,19,41,64,-23,33
Cowdenbeath,9049,10,5,10,21,25,55,-30,25
Montrose,9050,1,24,7,5,64,35,29,79
Peterhead,9050,2,24,4,8,79,38,41,76
Stirling,9050,3,17,6,13,62,52,10,57
Stenhousem'r,9050,4,15,8,13,56,48,8,53
Clyde,9050,5,14,9,13,51,50,1,51
Elgin,9050,6,14,6,16,54,65,-11,48
Annan Athlet,9050,7,11,12,13,47,41,6,45
Berwick,9050,8,9,10,17,31,58,-27,37
Edinburgh Ci,9050,9,7,9,20,36,62,-26,30
Cowdenbeath,9050,10,4,11,21,23,54,-31,23
Montrose,9051,1,24,7,5,63,35,28,79
Peterhead,9051,2,24,4,8,80,40,40,76
Stenhousem'r,9051,3,16,8,12,58,48,10,56
Stirling,9051,4,16,6,14,62,54,8,54
Clyde,9051,5,15,9,12,55,51,4,54
Elgin,9051,6,14,6,16,54,64,-10,48
Annan Athlet,9051,7,11,11,14,47,42,5,44
Berwick,9051,8,8,10,18,32,62,-30,34
Edinburgh Ci,9051,9,7,9,20,38,63,-25,30
Cowdenbeath,9051,10,5,10,21,24,54,-30,25
Montrose,9052,1,24,7,5,63,35,28,79
Peterhead,9052,2,24,4,8,79,38,41,76
Stirling,9052,3,16,7,13,60,51,9,55
Stenhousem'r,9052,4,15,9,12,55,46,9,54
Clyde,9052,5,15,9,12,54,50,4,54
Elgin,9052,6,14,6,16,54,64,-10,48
Annan Athlet,9052,7,11,11,14,47,42,5,44
Berwick,9052,8,8,10,18,31,61,-30,34
Edinburgh Ci,9052,9,7,9,20,36,62,-26,30
Cowdenbeath,9052,10,5,10,21,24,54,-30,25
Montrose,9053,1,24,7,5,61,34,27,79
Peterhead,9053,2,23,4,9,80,42,38,73
Stirling,9053,3,17,6,13,64,52,12,57
Clyde,9053,4,15,9,12,53,49,4,54
Stenhousem'r,9053,5,15,8,13,56,50,6,53
Elgin,9053,6,14,6,16,53,62,-9,48
Annan Athlet,9053,7,12,11,13,49,41,8,47
Berwick,9053,8,8,10,18,30,60,-30,34
Edinburgh Ci,9053,9,8,9,19,40,63,-23,33
Cowdenbeath,9053,10,4,10,22,23,56,-33,22
Montrose,9054,1,23,7,6,61,37,24,76
Peterhead,9054,2,23,4,9,78,40,38,73
Stirling,9054,3,17,6,13,63,52,11,57
Clyde,9054,4,15,9,12,54,49,5,54
Stenhousem'r,9054,5,15,8,13,56,49,7,53
Elgin,9054,6,15,6,15,56,62,-6,51
Annan Athlet,9054,7,11,12,13,48,42,6,45
Berwick,9054,8,8,10,18,30,61,-31,34
Edinburgh Ci,9054,9,8,9,19,38,61,-23,33
Cowdenbeath,9054,10,4,11,21,24,55,-31,23
Montrose,9055,1,24,7,5,61,35,26,79
Peterhead,9055,2,24,4,8,81,40,41,76
Stirling,9055,3,16,7,13,61,52,9,55
Stenhousem'r,9055,4,15,9,12,56,47,9,54
Clyde,9055,5,14,9,13,52,51,1,51
Elgin,9055,6,14,6,16,54,62,-8,48
Annan Athlet,9055,7,12,11,13,50,41,9,47
Berwick,9055,8,9,10,17,32,59,-27,37
Edinburgh Ci,9055,9,7,9,20,38,64,-26,30
Cowdenbeath,9055,10,4,10,22,23,57,-34,22
Montrose,9056,1,24,7,5,61,35,26,79
Peterhead,9056,2,23,4,9,78,42,36,73
Stirling,9056,3,16,7,13,61,52,9,55
Stenhousem'r,9056,4,15,9,12,56,47,9,54
Clyde,9056,5,14,10,12,51,48,3,52
Elgin,9056,6,14,6,16,54,62,-8,48
Annan Athlet,9056,7,11,11,14,48,43,5,44
Berwick,9056,8,8,11,17,29,58,-29,35
Edinburgh Ci,9056,9,8,9,19,40,61,-21,33
Cowdenbeath,9056,10,5,10,21,25,55,-30,25
Montrose,9057,1,24,7,5,61,34,27,79
Peterhead,9057,2,24,4,8,79,38,41,76
Stirling,9057,3,17,6,13,61,51,10,57
Clyde,9057,4,15,9,12,53,48,5,54
Stenhousem'r,9057,5,15,8,13,55,47,8,53
Elgin,9057,6,14,6,16,53,62,-9,48
Annan Athlet,9057,7,12,11,13,48,41,7,47
Berwick,9057,8,8,10,18,29,60,-31,34
Edinburgh Ci,9057,9,7,9,20,36,62,-26,30
Cowdenbeath,9057,10,4,10,22,23,55,-32,22
Montrose,9058,1,23,8,5,59,34,25,77
Peterhead,9058,2,23,5,8,77,38,39,74
Stenhousem'r,9058,3,16,8,12,57,47,10,56
Stirling,9058,4,16,6,14,61,53,8,54
Clyde,9058,5,15,9,12,56,50,6,54
Elgin,9058,6,14,7,15,53,60,-7,49
Annan Athlet,9058,7,12,11,13,48,41,7,47
Berwick,9058,8,8,10,18,31,63,-32,34
Edinburgh Ci,9058,9,7,10,19,36,60,-24,31
Cowdenbeath,9058,10,4,10,22,23,55,-32,22
Montrose,9059,1,24,7,5,60,34,26,79
Peterhead,9059,2,23,4,9,77,39,38,73
Stirling,9059,3,16,7,13,61,52,9,55
Stenhousem'r,9059,4,15,9,12,56,47,9,54
Clyde,9059,5,15,9,12,55,48,7,54
Elgin,9059,6,14,6,16,53,61,-8,48
Annan Athlet,9059,7,12,11,13,49,42,7,47
Berwick,9059,8,8,10,18,29,62,-33,34
Edinburgh Ci,9059,9,8,9,19,37,60,-23,33
Cowdenbeath,9059,10,4,10,22,24,56,-32,22
Peterhead,9060,1,24,4,8,80,38,42,76
Montrose,9060,2,23,7,6,61,37,24,76
Stirling,9060,3,16,7,13,60,51,9,55
Stenhousem'r,9060,4,15,9,12,55,46,9,54
Clyde,9060,5,15,9,12,53,49,4,54
Elgin,9060,6,15,6,15,56,62,-6,51
Annan Athlet,9060,7,11,12,13,48,42,6,45
Berwick,9060,8,8,10,18,30,60,-30,34
Edinburgh Ci,9060,9,7,9,20,36,63,-27,30
Cowdenbeath,9060,10,4,11,21,24,55,-31,23
Montrose,9061,1,24,7,5,60,34,26,79
Peterhead,9061,2,24,4,8,80,39,41,76
Stirling,9061,3,17,6,13,62,52,10,57
Clyde,9061,4,15,9,12,52,48,4,54
Stenhousem'r,9061,5,15,8,13,56,48,8,53
Elgin,9061,6,14,6,16,53,61,-8,48
Annan Athlet,9061,7,11,12,13,47,41,6,45
Berwick,9061,8,8,10,18,29,59,-30,34
Edinburgh Ci,9061,9,7,9,20,37,63,-26,30
Cowdenbeath,9061,10,4,11,21,23,54,-31,23
Montrose,9062,1,24,7,5,60,34,26,79
Peterhead,9062,2,23,5,8,79,40,39,74
Stirling,9062,3,16,7,13,61,52,9,55
Stenhousem'r,9062,4,15,9,12,56,47,9,54
Clyde,9062,5,15,9,12,53,49,4,54
Elgin,9062,6,14,6,16,53,61,-8,48
Annan Athlet,9062,7,11,12,13,49,43,6,45
Berwick,9062,8,8,10,18,30,60,-30,34
Edinburgh Ci,9062,9,7,10,19,38,62,-24,31
Cowdenbeath,9062,10,4,11,21,25,56,-31,23
Montrose,9063,1,24,7,5,61,34,27,79
Peterhead,9063,2,24,4,8,81,38,43,76
Stenhousem'r,9063,3,16,8,12,59,48,11,56
Stirling,9063,4,16,6,14,62,55,7,54
Clyde,9063,5,15,9,12,54,49,5,54
Elgin,9063,6,14,6,16,53,62,-9,48
Annan Athlet,9063,7,11,11,14,47,42,5,44
Berwick,9063,8,8,10,18,30,61,-31,34
Edinburgh Ci,9063,9,7,9,20,36,64,-28,30
Cowdenbeath,9063,10,5,10,21,24,54,-30,25
Montrose,9064,1,23,8,5,60,35,25,77
Peterhead,9064,2,24,4,8,79,38,41,76
Stirling,9064,3,17,6,13,63,51,12,57
Stenhousem'r,9064,4,15,8,13,55,49,6,53
Clyde,9064,5,14,10,12,52,49,3,52
Elgin,9064,6,14,7,15,54,61,-7,49
Annan Athlet,9064,7,11,11,14,49,45,4,44
Berwick,9064,8,8,11,17,30,59,-29,35
Edinburgh Ci,9064,9,7,9,20,36,62,-26,30
Cowdenbeath,9064,10,5,10,21,27,56,-29,25
Montrose,9065,1,24,7,5,61,35,26,79
Peterhead,9065,2,24,4,8,81,40,41,76
Stirling,9065,3,16,7,13,62,53,9,55
Stenhousem'r,9065,4,15,9,12,57,48,9,54
Clyde,9065,5,15,9,12,54,50,4,54
Elgin,9065,6,14,6,16,54,62,-8,48
Annan Athlet,9065,7,12,11,13,48,41,7,47
Berwick,9065,8,8,10,18,31,61,-30,34
Edinburgh Ci,9065,9,7,9,20,38,64,-26,30
Cowdenbeath,9065,10,4,10,22,23,55,-32,22
Montrose,9066,1,24,7,5,61,35,26,79
Peterhead,9066,2,24,4,8,78,38,40,76
Stirling,9066,3,16,7,13,61,52,9,55
Stenhousem'r,9066,4,15,9,12,56,47,9,54
Clyde,9066,5,15,9,12,53,49,4,54
Elgin,9066,6,14,6,16,54,62,-8,48
Annan Athlet,9066,7,11,11,14,47,43,4,44
Berwick,9066,8,8,10,18,30,60,-30,34
Edinburgh Ci,9066,9,7,9,20,36,61,-25,30
Cowdenbeath,9066,10,5,10,21,25,54,-29,25
Montrose,9067,1,23,8,5,60,35,25,77
Peterhead,9067,2,23,4,9,77,39,38,73
Stirling,9067,3,17,6,13,62,52,10,57
Clyde,9067,4,15,9,12,52,48,4,54
Stenhousem'r,9067,5,15,8,13,56,48,8,53
Elgin,9067,6,14,7,15,54,61,-7,49
Annan Athlet,9067,7,11,11,14,49,45,4,44
Berwick,9067,8,8,10,18,29,59,-30,34
Edinburgh Ci,9067,9,8,9,19,37,60,-23,33
Cowdenbeath,9067,10,5,10,21,27,56,-29,25
Montrose,9068,1,24,7,5,61,34,27,79
Peterhead,9068,2,24,4,8,79,38,41,76
Stenhousem'r,9068,3,16,8,12,58,48,10,56
Stirling,9068,4,16,6,14,62,54,8,54
Clyde,9068,5,14,9,13,51,50,1,51
Elgin,9068,6,14,6,16,53,62,-9,48
Annan Athlet,9068,7,11,12,13,47,41,6,45
Berwick,9068,8,9,10,17,31,58,-27,37
Edinburgh Ci,9068,9,7,9,20,36,62,-26,30
Cowdenbeath,9068,10,4,11,21,23,54,-31,23
Montrose,9069,1,23,8,5,60,35,25,77
Peterhead,9069,2,24,4,8,81,39,42,76
Stenhousem'r,9069,3,16,8,12,56,46,10,56
Stirling,9069,4,16,6,14,60,52,8,54
Clyde,9069,5,15,9,12,54,49,5,54
Elgin,9069,6,14,7,15,54,61,-7,49
Annan Athlet,9069,7,12,11,13,48,41,7,47
Berwick,9069,8,8,10,18,30,61,-31,34
Edinburgh Ci,9069,9,7,9,20,37,64,-27,30
Cowdenbeath,9069,10,4,10,22,23,55,-32,22
Peterhead,9070,1,24,4,8,81,38,43,76
Montrose,9070,2,23,7,6,59,35,24,76
Stirling,9070,3,17,6,13,63,51,12,57
Stenhousem'r,9070,4,15,8,13,55,49,6,53
Clyde,9070,5,14,9,13,51,49,2,51
Elgin,9070,6,15,6,15,54,60,-6,51
Annan Athlet,9070,7,12,11,13,50,42,8,47
Berwick,9070,8,9,10,17,30,58,-28,37
Edinburgh Ci,9070,9,7,9,20,36,64,-28,30
Cowdenbeath,9070,10,4,10,22,24,57,-33,22
Montrose,9071,1,23,8,5,60,35,25,77
Peterhead,9071,2,23,5,8,78,39,39,74
Stenhousem'r,9071,3,16,8,12,56,46,10,56
Stirling,9071,4,16,6,14,60,52,8,54
Clyde,9071,5,14,9,13,51,50,1,51
Elgin,9071,6,14,7,15,54,61,-7,49
Annan Athlet,9071,7,11,11,14,48,43,5,44
Berwick,9071,8,9,10,17,31,58,-27,37
Edinburgh Ci,9071,9,7,10,19,37,61,-24,31
Cowdenbeath,9071,10,5,10,21,25,55,-30,25
Montrose,9072,1,24,7,5,63,35,28,79
Peterhead,9072,2,24,4,8,81,39,42,76
Stenhousem'r,9072,3,16,8,12,56,46,10,56
Stirling,9072,4,16,6,14,60,52,8,54
Clyde,9072,5,14,9,13,51,49,2,51
Elgin,9072,6,14,6,16,54,64,-10,48
Annan Athlet,9072,7,11,11,14,47,43,4,44
Berwick,9072,8,9,10,17,30,58,-28,37
Edinburgh Ci,9072,9,7,9,20,37,64,-27,30
Cowdenbeath,9072,10,5,10,21,25,54,-29,25
Montrose,9073,1,24,7,5,62,35,27,79
Peterhead,9073,2,23,5,8,78,39,39,74
Stirling,9073,3,17,6,13,61,51,10,57
Clyde,9073,4,15,9,12,52,48,4,54
Stenhousem'r,9073,5,15,8,13,55,47,8,53
Elgin,9073,6,14,6,16,54,63,-9,48
Annan Athlet,9073,7,11,11,14,47,42,5,44
Berwick,9073,8,8,10,18,29,59,-30,34
Edinburgh Ci,9073,9,7,10,19,37,61,-24,31
Cowdenbeath,9073,10,5,10,21,24,54,-30,25
Montrose,9074,1,23,8,5,61,36,25,77
Peterhead,9074,2,24,4,8,80,39,41,76
Stenhousem'r,9074,3,16,8,12,57,47,10,56
Stirling,9074,4,16,6,14,61,53,8,54
Clyde,9074,5,15,9,12,54,48,6,54
Elgin,9074,6,14,7,15,55,62,-7,49
Annan Athlet,9074,7,12,11,13,48,41,7,47
Berwick,9074,8,8,10,18,29,61,-32,34
Edinburgh Ci,9074,9,7,9,20,37,63,-26,30
Cowdenbeath,9074,10,4,10,22,23,55,-32,22
Montrose,9075,1,23,7,6,60,36,24,76
Peterhead,9075,2,23,5,8,80,41,39,74
Stirling,9075,3,17,6,13,62,52,10,57
Clyde,9075,4,15,9,12,53,48,5,54
Stenhousem'r,9075,5,15,8,13,56,48,8,53
Elgin,9075,6,15,6,15,55,61,-6,51
Annan Athlet,9075,7,11,11,14,48,43,5,44
Berwick,9075,8,8,10,18,29,60,-31,34
Edinburgh Ci,9075,9,7,10,19,39,63,-24,31
Cowdenbeath,9075,10,5,10,21,25,55,-30,25
Peterhead,9076,1,24,4,8,81,38,43,76
Montrose,9076,2,23,7,6,60,36,24,76
Stenhousem'r,9076,3,16,8,12,57,47,10,56
Stirling,9076,4,16,6,14,61,53,8,54
Clyde,9076,5,15,9,12,54,49,5,54
Elgin,9076,6,15,6,15,55,61,-6,51
Annan Athlet,9076,7,11,12,13,47,41,6,45
Berwick,9076,8,8,10,18,30,61,-31,34
Edinburgh Ci,9076,9,7,9,20,36,64,-28,30
Cowdenbeath,9076,10,4,11,21,23,54,-31,23
Montrose,9077,1,24,7,5,61,35,26,79
Peterhead,9077,2,23,4,9,77,40,37,73
Stirling,9077,3,17,6,13,63,51,12,57
Clyde,9077,4,15,9,12,52,48,4,54
Stenhousem'r,9077,5,15,8,13,55,49,6,53
Elgin,9077,6,14,6,16,54,62,-8,48
Annan Athlet,9077,7,11,11,14,47,45,2,44
Berwick,9077,8,8,10,18,29,59,-30,34
Edinburgh Ci,9077,9,8,9,19,38,60,-22,33
Cowdenbeath,9077,10,5,10,21,27,54,-27,25
Montrose,9078,1,24,7,5,65,36,29,79
Peterhead,9078,2,24,4,8,80,39,41,76
Stirling,9078,3,17,6,13,64,52,12,57
Stenhousem'r,9078,4,15,8,13,56,50,6,53
Clyde,9078,5,14,9,13,51,50,1,51
Elgin,9078,6,14,6,16,55,66,-11,48
Annan Athlet,9078,7,11,12,13,47,41,6,45
Berwick,9078,8,9,10,17,31,58,-27,37
Edinburgh Ci,9078,9,7,9,20,37,63,-26,30
Cowdenbeath,9078,10,4,11,21,23,54,-31,23
Montrose,9079,1,23,8,5,60,35,25,77
Peterhead,9079,2,23,5,8,78,39,39,74
Stirling,9079,3,17,6,13,61,51,10,57
Stenhousem'r,9079,4,15,8,13,55,47,8,53
Clyde,9079,5,14,9,13,51,50,1,51
Elgin,9079,6,14,7,15,54,61,-7,49
Annan Athlet,9079,7,11,11,14,47,44,3,44
Berwick,9079,8,9,10,17,31,58,-27,37
Edinburgh Ci,9079,9,7,10,19,37,61,-24,31
Cowdenbeath,9079,10,5,10,21,26,54,-28,25
Montrose,9080,1,24,7,5,62,34,28,79
Peterhead,9080,2,23,5,8,78,39,39,74
Stirling,9080,3,17,6,13,65,53,12,57
Stenhousem'r,9080,4,15,8,13,57,51,6,53
Clyde,9080,5,14,10,12,52,49,3,52
Elgin,9080,6,14,6,16,53,63,-10,48
Annan Athlet,9080,7,12,11,13,48,41,7,47
Berwick,9080,8,8,11,17,30,59,-29,35
Edinburgh Ci,9080,9,7,10,19,37,61,-24,31
Cowdenbeath,9080,10,4,10,22,23,55,-32,22
Montrose,9081,1,23,8,5,62,37,25,77
Peterhead,9081,2,24,4,8,81,38,43,76
Stirling,9081,3,16,7,13,61,52,9,55
Stenhousem'r,9081,4,15,9,12,56,47,9,54
Clyde,9081,5,14,9,13,51,49,2,51
Elgin,9081,6,14,7,15,56,63,-7,49
Annan Athlet,9081,7,11,11,14,49,44,5,44
Berwick,9081,8,9,10,17,30,58,-28,37
Edinburgh Ci,9081,9,7,9,20,36,64,-28,30
Cowdenbeath,9081,10,5,10,21,26,56,-30,25
Peterhead,9082,1,24,4,8,81,40,41,76
Montrose,9082,2,23,7,6,61,37,24,76
Stirling,9082,3,16,7,13,62,53,9,55
Stenhousem'r,9082,4,15,9,12,57,48,9,54
Clyde,9082,5,14,10,12,51,48,3,52
Elgin,9082,6,15,6,15,56,62,-6,51
Annan Athlet,9082,7,11,11,14,47,42,5,44
Berwick,9082,8,8,11,17,29,58,-29,35
Edinburgh Ci,9082,9,7,9,20,38,64,-26,30
Cowdenbeath,9082,10,5,10,21,24,54,-30,25
Montrose,9083,1,24,7,5,63,36,27,79
Peterhead,9083,2,24,4,8,79,39,40,76
Stirling,9083,3,16,7,13,60,51,9,55
Stenhousem'r,9083,4,15,9,12,55,46,9,54
Clyde,9083,5,14,9,13,51,49,2,51
Elgin,9083,6,14,6,16,55,64,-9,48
Annan Athlet,9083,7,11,11,14,47,43,4,44
Berwick,9083,8,9,10,17,30,58,-28,37
Edinburgh Ci,9083,9,7,9,20,37,62,-25,30
Cowdenbeath,9083,10,5,10,21,25,54,-29,25
Montrose,9084,1,24,7,5,62,36,26,79
Peterhead,9084,2,24,4,8,79,38,41,76
Stenhousem'r,9084,3,16,8,12,56,46,10,56
Stirling,9084,4,16,6,14,60,52,8,54
Clyde,9084,5,15,9,12,54,48,6,54
Elgin,9084,6,14,6,16,55,63,-8,48
Annan Athlet,9084,7,11,12,13,48,42,6,45
Berwick,9084,8,8,10,18,29,61,-32,34
Edinburgh Ci,9084,9,7,9,20,36,62,-26,30
Cowdenbeath,9084,10,4,11,21,24,55,-31,23
Montrose,9085,1,24,7,5,60,34,26,79
Peterhead,9085,2,24,4,8,80,38,42,76
Stirling,9085,3,17,6,13,63,53,10,57
Clyde,9085,4,15,9,12,53,49,4,54
Stenhousem'r,9085,5,15,8,13,57,49,8,53
Elgin,9085,6,14,6,16,53,61,-8,48
Annan Athlet,9085,7,11,11,14,47,42,5,44
Berwick,9085,8,8,10,18,30,60,-30,34
Edinburgh Ci,9085,9,7,9,20,36,63,-27,30
Cowdenbeath,9085,10,5,10,21,24,54,-30,25
Montrose,9086,1,24,7,5,64,34,30,79
Peterhead,9086,2,23,4,9,77,40,37,73
Stenhousem'r,9086,3,16,8,12,58,46,12,56
Stirling,9086,4,16,6,14,60,54,6,54
Clyde,9086,5,14,10,12,52,49,3,52
Elgin,9086,6,14,6,16,53,65,-12,48
Annan Athlet,9086,7,11,12,13,48,42,6,45
Berwick,9086,8,8,11,17,30,59,-29,35
Edinburgh Ci,9086,9,8,9,19,38,60,-22,33
Cowdenbeath,9086,10,4,11,21,24,55,-31,23
Montrose,9087,1,23,8,5,60,35,25,77
Peterhead,9087,2,23,5,8,79,40,39,74
Stirling,9087,3,17,6,13,61,51,10,57
Clyde,9087,4,15,9,12,52,48,4,54
Stenhousem'r,9087,5,15,8,13,55,47,8,53
Elgin,9087,6,14,7,15,54,61,-7,49
Annan Athlet,9087,7,11,12,13,48,42,6,45
Berwick,9087,8,8,10,18,29,59,-30,34
Edinburgh Ci,9087,9,7,10,19,38,62,-24,31
Cowdenbeath,9087,10,4,11,21,24,55,-31,23
Montrose,9088,1,24,7,5,61,35,26,79
Peterhead,9088,2,24,4,8,80,39,41,76
Stirling,9088,3,17,6,13,63,53,10,57
Clyde,9088,4,15,9,12,52,48,4,54
Stenhousem'r,9088,5,15,8,13,57,49,8,53
Elgin,9088,6,14,6,16,54,62,-8,48
Annan Athlet,9088,7,12,11,13,48,41,7,47
Berwick,9088,8,8,10,18,29,59,-30,34
Edinburgh Ci,9088,9,7,9,20,37,63,-26,30
Cowdenbeath,9088,10,4,10,22,23,55,-32,22
Montrose,9089,1,23,7,6,60,36,24,76
Peterhead,9089,2,23,5,8,80,41,39,74
Stirling,9089,3,17,6,13,63,52,11,57
Stenhousem'r,9089,4,15,8,13,56,49,7,53
Clyde,9089,5,14,10,12,51,48,3,52
Elgin,9089,6,15,6,15,55,61,-6,51
Annan Athlet,9089,7,11,12,13,49,43,6,45
Berwick,9089,8,8,11,17,29,58,-29,35
Edinburgh Ci,9089,9,7,10,19,39,63,-24,31
Cowdenbeath,9089,10,4,11,21,25,56,-31,23
Montrose,9090,1,23,8,5,60,35,25,77
Peterhead,9090,2,23,5,8,78,39,39,74
Stirling,9090,3,17,6,13,61,51,10,57
Clyde,9090,4,15,9,12,54,48,6,54
Stenhousem'r,9090,5,15,8,13,55,47,8,53
Elgin,9090,6,14,7,15,54,61,-7,49
Annan Athlet,9090,7,12,11,13,48,41,7,47
Berwick,9090,8,8,10,18,29,61,-32,34
Edinburgh Ci,9090,9,7,10,19,37,61,-24,31
Cowdenbeath,9090,10,4,10,22,23,55,-32,22
Montrose,9091,1,24,7,5,61,35,26,79
Peterhead,9091,2,23,4,9,79,43,36,73
Stirling,9091,3,16,7,13,60,51,9,55
Stenhousem'r,9091,4,15,9,12,55,46,9,54
Clyde,9091,5,14,10,12,52,49,3,52
Elgin,9091,6,14,6,16,54,62,-8,48
Annan Athlet,9091,7,11,12,13,48,42,6,45
Berwick,9091,8,8,11,17,30,59,-29,35
Edinburgh Ci,9091,9,8,9,19,41,62,-21,33
Cowdenbeath,9091,10,4,11,21,24,55,-31,23
Montrose,9092,1,24,7,5,61,34,27,79
Peterhead,9092,2,23,5,8,78,39,39,74
Stenhousem'r,9092,3,16,8,12,57,47,10,56
Stirling,9092,4,16,6,14,61,53,8,54
Clyde,9092,5,15,9,12,55,49,6,54
Elgin,9092,6,14,6,16,53,62,-9,48
Annan Athlet,9092,7,11,12,13,47,41,6,45
Berwick,9092,8,8,10,18,30,62,-32,34
Edinburgh Ci,9092,9,7,10,19,37,61,-24,31
Cowdenbeath,9092,10,4,11,21,23,54,-31,23
Montrose,9093,1,23,8,5,59,34,25,77
Peterhead,9093,2,24,4,8,80,40,40,76
Stirling,9093,3,17,6,13,61,51,10,57
Clyde,9093,4,15,9,12,54,48,6,54
Stenhousem'r,9093,5,15,8,13,55,47,8,53
Elgin,9093,6,14,7,15,53,60,-7,49
Annan Athlet,9093,7,11,12,13,48,42,6,45
Berwick,9093,8,8,10,18,29,61,-32,34
Edinburgh Ci,9093,9,7,9,20,38,63,-25,30
Cowdenbeath,9093,10,4,11,21,24,55,-31,23
Peterhead,9094,1,24,4,8,79,39,40,76
Montrose,9094,2,23,7,6,61,37,24,76
Stirling,9094,3,16,7,13,61,52,9,55
Stenhousem'r,9094,4,15,9,12,56,47,9,54
Clyde,9094,5,15,9,12,54,48,6,54
Elgin,9094,6,15,6,15,56,62,-6,51
Annan Athlet,9094,7,12,11,13,48,41,7,47
Berwick,9094,8,8,10,18,29,61,-32,34
Edinburgh Ci,9094,9,7,9,20,37,62,-25,30
Cowdenbeath,9094,10,4,10,22,23,55,-32,22
Montrose,9095,1,24,7,5,61,34,27,79
Peterhead,9095,2,24,4,8,80,39,41,76
Stirling,9095,3,16,7,13,62,53,9,55
Stenhousem'r,9095,4,15,9,12,57,48,9,54
Clyde,9095,5,15,9,12,57,49,8,54
Elgin,9095,6,14,6,16,53,62,-9,48
Annan Athlet,9095,7,11,11,14,47,42,5,44
Berwick,9095,8,8,10,18,30,64,-34,34
Edinburgh Ci,9095,9,7,9,20,37,63,-26,30
Cowdenbeath,9095,10,5,10,21,24,54,-30,25
Montrose,9096,1,24,7,5,61,35,26,79
Peterhead,9096,2,24,4,8,80,39,41,76
Stirling,9096,3,17,6,13,63,52,11,57
Clyde,9096,4,15,9,12,52,48,4,54
Stenhousem'r,9096,5,15,8,13,56,49,7,53
Elgin,9096,6,14,6,16,54,62,-8,48
Annan Athlet,9096,7,12,11,13,48,41,7,47
Berwick,9096,8,8,10,18,29,59,-30,34
Edinburgh Ci,9096,9,7,9,20,37,63,-26,30
Cowdenbeath,9096,10,4,10,22,23,55,-32,22
Montrose,9097,1,24,7,5,64,34,30,79
Peterhead,9097,2,24,4,8,80,38,42,76
Stirling,9097,3,17,6,13,63,53,10,57
Clyde,9097,4,15,9,12,54,48,6,54
Stenhousem'r,9097,5,15,8,13,57,49,8,53
Elgin,9097,6,14,6,16,53,65,-12,48
Annan Athlet,9097,7,11,11,14,47,43,4,44
Berwick,9097,8,8,10,18,29,61,-32,34
Edinburgh Ci,9097,9,7,9,20,36,63,-27,30
Cowdenbeath,9097,10,5,10,21,25,54,-29,25
Peterhead,9098,1,24,4,8,79,38,41,76
Montrose,9098,2,23,7,6,61,37,24,76
Stirling,9098,3,17,6,13,62,51,11,57
Clyde,9098,4,15,9,12,53,48,5,54
Stenhousem'r,9098,5,15,8,13,55,48,7,53
Elgin,9098,6,15,6,15,56,62,-6,51
Annan Athlet,9098,7,12,11,13,49,42,7,47
Berwick,9098,8,8,10,18,29,60,-31,34
Edinburgh Ci,9098,9,7,9,20,36,62,-26,30
Cowdenbeath,9098,10,4,10,22,24,56,-32,22
Montrose,9099,1,24,7,5,62,36,26,79
Peterhead,9099,2,24,4,8,79,38,41,76
Stenhousem'r,9099,3,16,8,12,56,46,10,56
Stirling,9099,4,16,6,14,60,52,8,54
Clyde,9099,5,14,10,12,52,49,3,52
Elgin,9099,6,14,6,16,55,63,-8,48
Annan Athlet,9099,7,11,12,13,48,42,6,45
Berwick,9099,8,8,11,17,30,59,-29,35
Edinburgh Ci,9099,9,7,9,20,36,62,-26,30
Cowdenbeath,9099,10,4,11,21,24,55,-31,23
Montrose,9100,1,23,8,5,59,34,25,77
Peterhead,9100,2,24,4,8,79,38,41,76
Stirling,9100,3,17,6,13,65,52,13,57
Clyde,9100,4,15,9,12,55,48,7,54
Stenhousem'r,9100,5,15,8,13,56,51,5,53
Elgin,9100,6,14,7,15,53,60,-7,49
Annan Athlet,9100,7,12,11,13,49,41,8,47
Berwick,9100,8,8,10,18,29,62,-33,34
Edinburgh Ci,9100,9,7,9,20,36,62,-26,30
Cowdenbeath,9100,10,4,10,22,23,56,-33,22
Montrose,9101,1,24,7,5,61,35,26,79
Peterhead,9101,2,24,4,8,83,38,45,76
Stirling,9101,3,17,6,13,63,51,12,57
Stenhousem'r,9101,4,15,8,13,55,49,6,53
Clyde,9101,5,14,10,12,53,50,3,52
Elgin,9101,6,14,6,16,54,62,-8,48
Annan Athlet,9101,7,11,12,13,48,42,6,45
Berwick,9101,8,8,11,17,31,60,-29,35
Edinburgh Ci,9101,9,7,9,20,36,66,-30,30
Cowdenbeath,9101,10,4,11,21,24,55,-31,23
Montrose,9102,1,24,7,5,60,34,26,79
Peterhead,9102,2,24,4,8,78,38,40,76
Stirling,9102,3,17,6,13,64,53,11,57
Stenhousem'r,9102,4,15,8,13,57,50,7,53
Clyde,9102,5,14,10,12,52,49,3,52
Elgin,9102,6,14,6,16,53,61,-8,48
Annan Athlet,9102,7,11,11,14,48,43,5,44
Berwick,9102,8,8,11,17,30,59,-29,35
Edinburgh Ci,9102,9,7,9,20,36,61,-25,30
Cowdenbeath,9102,10,5,10,21,25,55,-30,25
Montrose,9103,1,23,8,5,61,36,25,77
Peterhead,9103,2,24,4,8,83,40,43,76
Stirling,9103,3,17,6,13,65,54,11,57
Clyde,9103,4,15,9,12,52,48,4,54
Stenhousem'r,9103,5,15,8,13,58,51,7,53
Elgin,9103,6,14,7,15,55,62,-7,49
Annan Athlet,9103,7,11,11,14,47,42,5,44
Berwick,9103,8,8,10,18,29,59,-30,34
Edinburgh Ci,9103,9,7,9,20,38,66,-28,30
Cowdenbeath,9103,10,5,10,21,24,54,-30,25
Montrose,9104,1,23,8,5,60,35,25,77
Peterhead,9104,2,24,4,8,80,38,42,76
Stirling,9104,3,16,7,13,61,52,9,55
Stenhousem'r,9104,4,15,9,12,56,47,9,54
Clyde,9104,5,14,9,13,54,52,2,51
Elgin,9104,6,14,7,15,54,61,-7,49
Annan Athlet,9104,7,11,12,13,48,42,6,45
Berwick,9104,8,9,10,17,33,61,-28,37
Edinburgh Ci,9104,9,7,9,20,36,63,-27,30
Cowdenbeath,9104,10,4,11,21,24,55,-31,23
Montrose,9105,1,24,7,5,62,35,27,79
Peterhead,9105,2,24,4,8,79,39,40,76
Stirling,9105,3,17,6,13,61,51,10,57
Clyde,9105,4,15,9,12,54,49,5,54
Stenhousem'r,9105,5,15,8,13,55,47,8,53
Elgin,9105,6,14,6,16,54,63,-9,48
Annan Athlet,9105,7,11,11,14,48,43,5,44
Berwick,9105,8,8,10,18,30,61,-31,34
Edinburgh Ci,9105,9,7,9,20,37,62,-25,30
Cowdenbeath,9105,10,5,10,21,25,55,-30,25
Montrose,9106,1,24,7,5,60,34,26,79
Peterhead,9106,2,24,4,8,80,38,42,76
Stirling,9106,3,17,6,13,61,51,10,57
Clyde,9106,4,15,9,12,52,48,4,54
Stenhousem'r,9106,5,15,8,13,55,47,8,53
Elgin,9106,6,14,6,16,53,61,-8,48
Annan Athlet,9106,7,12,11,13,49,41,8,47
Berwick,9106,8,8,10,18,29,59,-30,34
Edinburgh Ci,9106,9,7,9,20,36,63,-27,30
Cowdenbeath,9106,10,4,10,22,23,56,-33,22
Montrose,9107,1,24,7,5,62,35,27,79
Peterhead,9107,2,24,4,8,85,40,45,76
Stenhousem'r,9107,3,16,8,12,58,47,11,56
Stirling,9107,4,16,6,14,61,54,7,54
Clyde,9107,5,15,9,12,54,48,6,54
Elgin,9107,6,14,6,16,54,63,-9,48
Annan Athlet,9107,7,11,11,14,47,42,5,44
Berwick,9107,8,8,10,18,29,61,-32,34
Edinburgh Ci,9107,9,7,9,20,38,68,-30,30
Cowdenbeath,9107,10,5,10,21,24,54,-30,25
Montrose,9108,1,23,8,5,60,35,25,77
Peterhead,9108,2,24,4,8,80,40,40,76
Stirling,9108,3,17,6,13,62,52,10,57
Clyde,9108,4,15,9,12,53,49,4,54
Stenhousem'r,9108,5,15,8,13,56,48,8,53
Elgin,9108,6,14,7,15,54,61,-7,49
Annan Athlet,9108,7,11,11,14,48,43,5,44
Berwick,9108,8,8,10,18,30,60,-30,34
Edinburgh Ci,9108,9,7,9,20,38,63,-25,30
Cowdenbeath,9108,10,5,10,21,25,55,-30,25
Montrose,9109,1,24,7,5,62,36,26,79
Peterhead,9109,2,24,4,8,83,38,45,76
Stenhousem'r,9109,3,16,8,12,57,46,11,56
Stirling,9109,4,16,6,14,60,53,7,54
Clyde,9109,5,14,9,13,51,50,1,51
Elgin,9109,6,14,6,16,55,63,-8,48
Annan Athlet,9109,7,11,11,14,48,43,5,44
Berwick,9109,8,9,10,17,31,58,-27,37
Edinburgh Ci,9109,9,7,9,20,36,66,-30,30
Cowdenbeath,9109,10,5,10,21,25,55,-30,25
Montrose,9110,1,24,7,5,61,34,27,79
Peterhead,9110,2,24,4,8,78,38,40,76
Stirling,9110,3,16,7,13,61,52,9,55
Stenhousem'r,9110,4,15,9,12,56,47,9,54
Clyde,9110,5,15,9,12,53,48,5,54
Elgin,9110,6,14,6,16,53,62,-9,48
Annan Athlet,9110,7,12,11,13,48,41,7,47
Berwick,9110,8,8,10,18,29,60,-31,34
Edinburgh Ci,9110,9,7,9,20,36,61,-25,30
Cowdenbeath,9110,10,4,10,22,23,55,-32,22
Montrose,9111,1,24,7,5,64,34,30,79
Peterhead,9111,2,24,4,8,78,38,40,76
Stirling,9111,3,17,6,13,64,51,13,57
Clyde,9111,4,15,9,12,53,49,4,54
Stenhousem'r,9111,5,15,8,13,55,50,5,53
Elgin,9111,6,14,6,16,53,65,-12,48
Annan Athlet,9111,7,11,11,14,47,42,5,44
Berwick,9111,8,8,10,18,30,60,-30,34
Edinburgh Ci,9111,9,7,9,20,36,61,-25,30
Cowdenbeath,9111,10,5,10,21,24,54,-30,25
Peterhead,9112,1,24,4,8,81,38,43,76
Montrose,9112,2,23,7,6,59,35,24,76
Stirling,9112,3,17,6,13,61,51,10,57
Clyde,9112,4,15,9,12,54,48,6,54
Stenhousem'r,9112,5,15,8,13,55,47,8,53
Elgin,9112,6,15,6,15,54,60,-6,51
Annan Athlet,9112,7,11,12,13,47,41,6,45
Berwick,9112,8,8,10,18,29,61,-32,34
Edinburgh Ci,9112,9,7,9,20,36,64,-28,30
Cowdenbeath,9112,10,4,11,21,23,54,-31,23
Montrose,9113,1,24,7,5,61,35,26,79
Peterhead,9113,2,23,5,8,77,38,39,74
Stirling,9113,3,17,6,13,63,52,11,57
Clyde,9113,4,15,9,12,52,48,4,54
Stenhousem'r,9113,5,15,8,13,56,49,7,53
Elgin,9113,6,14,6,16,54,62,-8,48
Annan Athlet,9113,7,12,11,13,49,42,7,47
Berwick,9113,8,8,10,18,29,59,-30,34
Edinburgh Ci,9113,9,7,10,19,36,60,-24,31
Cowdenbeath,9113,10,4,10,22,24,56,-32,22
Montrose,9114,1,24,7,5,60,34,26,79
Peterhead,9114,2,24,4,8,79,39,40,76
Stirling,9114,3,16,7,13,62,53,9,55
Stenhousem'r,9114,4,15,9,12,57,48,9,54
Clyde,9114,5,15,9,12,52,48,4,54
Elgin,9114,6,14,6,16,53,61,-8,48
Annan Athlet,9114,7,12,11,13,49,41,8,47
Berwick,9114,8,8,10,18,29,59,-30,34
Edinburgh Ci,9114,9,7,9,20,37,62,-25,30
Cowdenbeath,9114,10,4,10,22,23,56,-33,22
Montrose,9115,1,23,8,5,61,36,25,77
Peterhead,9115,2,24,4,8,83,39,44,76
Stenhousem'r,9115,3,16,8,12,58,47,11,56
Stirling,9115,4,16,6,14,61,54,7,54
Clyde,9115,5,15,9,12,53,48,5,54
Elgin,9115,6,14,7,15,55,62,-7,49
Annan Athlet,9115,7,11,11,14,47,43,4,44
Berwick,9115,8,8,10,18,29,60,-31,34
Edinburgh Ci,9115,9,7,9,20,37,66,-29,30
Cowdenbeath,9115,10,5,10,21,25,54,-29,25
Peterhead,9116,1,24,4,8,82,38,44,76
Montrose,9116,2,23,7,6,60,36,24,76
Stirling,9116,3,16,7,13,60,51,9,55
Stenhousem'r,9116,4,15,9,12,55,46,9,54
Clyde,9116,5,14,10,12,52,49,3,52
Elgin,9116,6,15,6,15,55,61,-6,51
Annan Athlet,9116,7,11,12,13,48,42,6,45
Berwick,9116,8,8,11,17,30,59,-29,35
Edinburgh Ci,9116,9,7,9,20,36,65,-29,30
Cowdenbeath,9116,10,4,11,21,24,55,-31,23
Montrose,9117,1,24,7,5,63,35,28,79
Peterhead,9117,2,24,4,8,79,38,41,76
Stenhousem'r,9117,3,16,8,12,58,46,12,56
Stirling,9117,4,16,6,14,60,54,6,54
Clyde,9117,5,14,9,13,53,51,2,51
Elgin,9117,6,14,6,16,54,64,-10,48
Annan Athlet,9117,7,12,11,13,48,41,7,47
Berwick,9117,8,9,10,17,32,60,-28,37
Edinburgh Ci,9117,9,7,9,20,36,62,-26,30
Cowdenbeath,9117,10,4,10,22,23,55,-32,22
Montrose,9118,1,24,7,5,63,34,29,79
Peterhead,9118,2,24,4,8,82,39,43,76
Stenhousem'r,9118,3,16,8,12,57,47,10,56
Stirling,9118,4,16,6,14,61,53,8,54
Clyde,9118,5,14,10,12,51,48,3,52
Elgin,9118,6,14,6,16,53,64,-11,48
Annan Athlet,9118,7,11,12,13,49,43,6,45
Berwick,9118,8,8,11,17,29,58,-29,35
Edinburgh Ci,9118,9,7,9,20,37,65,-28,30
Cowdenbeath,9118,10,4,11,21,25,56,-31,23
Montrose,9119,1,24,7,5,62,35,27,79
Peterhead,9119,2,23,5,8,79,40,39,74
Stirling,9119,3,16,7,13,60,51,9,55
Stenhousem'r,9119,4,15,9,12,55,46,9,54
Clyde,9119,5,14,10,12,52,49,3,52
Elgin,9119,6,14,6,16,54,63,-9,48
Annan Athlet,9119,7,12,11,13,49,42,7,47
Berwick,9119,8,8,11,17,30,59,-29,35
Edinburgh Ci,9119,9,7,10,19,38,62,-24,31
Cowdenbeath,9119,10,4,10,22,24,56,-32,22
Montrose,9120,1,24,7,5,61,34,27,79
Peterhead,9120,2,23,5,8,79,40,39,74
Stirling,9120,3,17,6,13,63,51,12,57
Clyde,9120,4,15,9,12,53,48,5,54
Stenhousem'r,9120,5,15,8,13,55,49,6,53
Elgin,9120,6,14,6,16,53,62,-9,48
Annan Athlet,9120,7,11,12,13,47,41,6,45
Berwick,9120,8,8,10,18,29,60,-31,34
Edinburgh Ci,9120,9,7,10,19,38,62,-24,31
Cowdenbeath,9120,10,4,11,21,23,54,-31,23
Peterhead,9121,1,24,4,8,82,38,44,76
Montrose,9121,2,23,7,6,59,35,24,76
Stenhousem'r,9121,3,16,8,12,57,47,10,56
Stirling,9121,4,16,6,14,61,53,8,54
Clyde,9121,5,15,9,12,54,48,6,54
Elgin,9121,6,15,6,15,54,60,-6,51
Annan Athlet,9121,7,11,12,13,48,42,6,45
Berwick,9121,8,8,10,18,29,61,-32,34
Edinburgh Ci,9121,9,7,9,20,36,65,-29,30
Cowdenbeath,9121,10,4,11,21,24,55,-31,23
Montrose,9122,1,23,8,5,60,35,25,77
Peterhead,9122,2,23,5,8,78,39,39,74
Stirling,9122,3,16,7,13,60,51,9,55
Stenhousem'r,9122,4,15,9,12,55,46,9,54
Clyde,9122,5,14,10,12,52,49,3,52
Elgin,9122,6,14,7,15,54,61,-7,49
Annan Athlet,9122,7,12,11,13,49,42,7,47
Berwick,9122,8,8,11,17,30,59,-29,35
Edinburgh Ci,9122,9,7,10,19,37,61,-24,31
Cowdenbeath,9122,10,4,10,22,24,56,-32,22
Montrose,9123,1,24,7,5,63,34,29,79
Peterhead,9123,2,24,4,8,79,38,41,76
Stirling,9123,3,17,6,13,63,51,12,57
Clyde,9123,4,15,9,12,53,48,5,54
Stenhousem'r,9123,5,15,8,13,55,49,6,53
Elgin,9123,6,14,6,16,53,64,-11,48
Annan Athlet,9123,7,12,11,13,48,41,7,47
Berwick,9123,8,8,10,18,29,60,-31,34
Edinburgh Ci,9123,9,7,9,20,36,62,-26,30
Cowdenbeath,9123,10,4,10,22,23,55,-32,22
Montrose,9124,1,23,8,5,60,35,25,77
Peterhead,9124,2,24,4,8,83,39,44,76
Stirling,9124,3,16,7,13,61,52,9,55
Stenhousem'r,9124,4,15,9,12,56,47,9,54
Clyde,9124,5,14,10,12,51,48,3,52
Elgin,9124,6,14,7,15,54,61,-7,49
Annan Athlet,9124,7,11,12,13,47,41,6,45
Berwick,9124,8,8,11,17,29,58,-29,35
Edinburgh Ci,9124,9,7,9,20,37,66,-29,30
Cowdenbeath,9124,10,4,11,21,23,54,-31,23
Montrose,9125,1,24,7,5,63,35,28,79
Peterhead,9125,2,23,4,9,78,40,38,73
Stirling,9125,3,17,6,13,62,52,10,57
Clyde,9125,4,15,9,12,53,49,4,54
Stenhousem'r,9125,5,15,8,13,56,48,8,53
Elgin,9125,6,14,6,16,54,64,-10,48
Annan Athlet,9125,7,11,12,13,48,42,6,45
Berwick,9125,8,8,10,18,30,60,-30,34
Edinburgh Ci,9125,9,8,9,19,38,61,-23,33
Cowdenbeath,9125,10,4,11,21,24,55,-31,23
Montrose,9126,1,24,7,5,61,35,26,79
Peterhead,9126,2,24,4,8,80,38,42,76
Stirling,9126,3,17,6,13,62,52,10,57
Clyde,9126,4,15,9,12,56,49,7,54
Stenhousem'r,9126,5,15,8,13,56,48,8,53
Elgin,9126,6,14,6,16,54,62,-8,48
Annan Athlet,9126,7,12,11,13,48,41,7,47
Berwick,9126,8,8,10,18,30,63,-33,34
Edinburgh Ci,9126,9,7,9,20,36,63,-27,30
Cowdenbeath,9126,10,4,10,22,23,55,-32,22
Montrose,9127,1,24,7,5,61,35,26,79
Peterhead,9127,2,24,4,8,79,38,41,76
Stirling,9127,3,16,7,13,62,53,9,55
Stenhousem'r,9127,4,15,9,12,57,48,9,54
Clyde,9127,5,14,9,13,53,53,0,51
Elgin,9127,6,14,6,16,54,62,-8,48
Annan Athlet,9127,7,11,11,14,47,44,3,44
Berwick,9127,8,9,10,17,34,60,-26,37
Edinburgh Ci,9127,9,7,9,20,36,62,-26,30
Cowdenbeath,9127,10,5,10,21,26,54,-28,25
Montrose,9128,1,24,7,5,63,35,28,79
Peterhead,9128,2,23,5,8,79,40,39,74
Stirling,9128,3,17,6,13,65,51,14,57
Stenhousem'r,9128,4,15,8,13,55,51,4,53
Clyde,9128,5,14,9,13,51,49,2,51
Elgin,9128,6,14,6,16,54,64,-10,48
Annan Athlet,9128,7,11,11,14,47,43,4,44
Berwick,9128,8,9,10,17,30,58,-28,37
Edinburgh Ci,9128,9,7,10,19,38,62,-24,31
Cowdenbeath,9128,10,5,10,21,25,54,-29,25
Montrose,9129,1,24,7,5,61,34,27,79
Peterhead,9129,2,24,4,8,80,38,42,76
Stirling,9129,3,16,7,13,62,53,9,55
Stenhousem'r,9129,4,15,9,12,57,48,9,54
Clyde,9129,5,15,9,12,53,49,4,54
Elgin,9129,6,14,6,16,53,62,-9,48
Annan Athlet,9129,7,11,11,14,47,42,5,44
Berwick,9129,8,8,10,18,30,60,-30,34
Edinburgh Ci,9129,9,7,9,20,36,63,-27,30
Cowdenbeath,9129,10,5,10,21,24,54,-30,25
Montrose,9130,1,24,7,5,62,35,27,79
Peterhead,9130,2,24,4,8,79,38,41,76
Stirling,9130,3,16,7,13,62,53,9,55
Stenhousem'r,9130,4,15,9,12,57,48,9,54
Clyde,9130,5,15,9,12,56,49,7,54
Elgin,9130,6,14,6,16,54,63,-9,48
Annan Athlet,9130,7,11,12,13,49,43,6,45
Berwick,9130,8,8,10,18,30,63,-33,34
Edinburgh Ci,9130,9,7,9,20,36,62,-26,30
Cowdenbeath,9130,10,4,11,21,25,56,-31,23
Montrose,9131,1,24,7,5,63,35,28,79
Peterhead,9131,2,24,4,8,81,38,43,76
Stirling,9131,3,17,6,13,64,53,11,57
Stenhousem'r,9131,4,15,8,13,57,50,7,53
Clyde,9131,5,14,10,12,52,49,3,52
Elgin,9131,6,14,6,16,54,64,-10,48
Annan Athlet,9131,7,11,11,14,48,44,4,44
Berwick,9131,8,8,11,17,30,59,-29,35
Edinburgh Ci,9131,9,7,9,20,36,64,-28,30
Cowdenbeath,9131,10,5,10,21,26,55,-29,25
Montrose,9132,1,24,7,5,60,34,26,79
Peterhead,9132,2,24,4,8,81,38,43,76
Stirling,9132,3,17,6,13,63,51,12,57
Clyde,9132,4,15,9,12,55,48,7,54
Stenhousem'r,9132,5,15,8,13,55,49,6,53
Elgin,9132,6,14,6,16,53,61,-8,48
Annan Athlet,9132,7,11,12,13,48,42,6,45
Berwick,9132,8,8,10,18,29,62,-33,34
Edinburgh Ci,9132,9,7,9,20,36,64,-28,30
Cowdenbeath,9132,10,4,11,21,24,55,-31,23
Montrose,9133,1,24,7,5,63,34,29,79
Peterhead,9133,2,24,4,8,79,39,40,76
Stirling,9133,3,16,7,13,61,52,9,55
Stenhousem'r,9133,4,15,9,12,56,47,9,54
Clyde,9133,5,15,9,12,56,51,5,54
Elgin,9133,6,14,6,16,53,64,-11,48
Annan Athlet,9133,7,12,11,13,48,41,7,47
Berwick,9133,8,8,10,18,32,63,-31,34
Edinburgh Ci,9133,9,7,9,20,37,62,-25,30
Cowdenbeath,9133,10,4,10,22,23,55,-32,22
Montrose,9134,1,24,7,5,62,34,28,79
Peterhead,9134,2,24,4,8,79,39,40,76
Stirling,9134,3,17,6,13,63,51,12,57
Clyde,9134,4,15,9,12,56,49,7,54
Stenhousem'r,9134,5,15,8,13,55,49,6,53
Elgin,9134,6,14,6,16,53,63,-10,48
Annan Athlet,9134,7,12,11,13,48,41,7,47
Berwick,9134,8,8,10,18,30,63,-33,34
Edinburgh Ci,9134,9,7,9,20,37,62,-25,30
Cowdenbeath,9134,10,4,10,22,23,55,-32,22
Montrose,9135,1,24,7,5,61,34,27,79
Peterhead,9135,2,23,5,8,80,41,39,74
Stirling,9135,3,17,6,13,63,53,10,57
Stenhousem'r,9135,4,15,8,13,57,49,8,53
Clyde,9135,5,14,9,13,52,50,2,51
Elgin,9135,6,14,6,16,53,62,-9,48
Annan Athlet,9135,7,12,11,13,51,41,10,47
Berwick,9135,8,9,10,17,31,59,-28,37
Edinburgh Ci,9135,9,7,10,19,39,63,-24,31
Cowdenbeath,9135,10,4,10,22,23,58,-35,22
Montrose,9136,1,24,7,5,60,34,26,79
Peterhead,9136,2,24,4,8,80,38,42,76
Stirling,9136,3,16,7,13,61,52,9,55
Stenhousem'r,9136,4,15,9,12,56,47,9,54
Clyde,9136,5,15,9,12,52,48,4,54
Elgin,9136,6,14,6,16,53,61,-8,48
Annan Athlet,9136,7,11,12,13,48,42,6,45
Berwick,9136,8,8,10,18,29,59,-30,34
Edinburgh Ci,9136,9,7,9,20,36,63,-27,30
Cowdenbeath,9136,10,4,11,21,24,55,-31,23
Montrose,9137,1,23,8,5,60,35,25,77
Peterhead,9137,2,24,4,8,80,40,40,76
Stirling,9137,3,16,7,13,60,51,9,55
Stenhousem'r,9137,4,15,9,12,55,46,9,54
Clyde,9137,5,14,9,13,51,51,0,51
Elgin,9137,6,14,7,15,54,61,-7,49
Annan Athlet,9137,7,11,12,13,47,41,6,45
Berwick,9137,8,9,10,17,32,58,-26,37
Edinburgh Ci,9137,9,7,9,20,38,63,-25,30
Cowdenbeath,9137,10,4,11,21,23,54,-31,23
Montrose,9138,1,23,7,6,61,38,23,76
Peterhead,9138,2,23,4,9,77,43,34,73
Stirling,9138,3,17,6,13,64,51,13,57
Clyde,9138,4,15,9,12,55,50,5,54
Stenhousem'r,9138,5,15,8,13,55,50,5,53
Elgin,9138,6,15,6,15,57,62,-5,51
Annan Athlet,9138,7,12,11,13,48,41,7,47
Berwick,9138,8,8,10,18,31,62,-31,34
Edinburgh Ci,9138,9,8,9,19,41,60,-19,33
Cowdenbeath,9138,10,4,10,22,23,55,-32,22
Montrose,9139,1,23,8,5,60,35,25,77
Peterhead,9139,2,24,4,8,79,38,41,76
Stirling,9139,3,16,7,13,61,52,9,55
Stenhousem'r,9139,4,15,9,12,56,47,9,54
Clyde,9139,5,15,9,12,54,49,5,54
Elgin,9139,6,14,7,15,54,61,-7,49
Annan Athlet,9139,7,12,11,13,50,42,8,47
Berwick,9139,8,8,10,18,30,61,-31,34
Edinburgh Ci,9139,9,7,9,20,36,62,-26,30
Cowdenbeath,9139,10,4,10,22,24,57,-33,22
Montrose,9140,1,23,8,5,60,35,25,77
Peterhead,9140,2,24,4,8,80,40,40,76
Stirling,9140,3,16,7,13,63,54,9,55
Stenhousem'r,9140,4,15,9,12,58,49,9,54
Clyde,9140,5,15,9,12,52,48,4,54
Elgin,9140,6,14,7,15,54,61,-7,49
Annan Athlet,9140,7,12,11,13,48,41,7,47
Berwick,9140,8,8,10,18,29,59,-30,34
Edinburgh Ci,9140,9,7,9,20,38,63,-25,30
Cowdenbeath,9140,10,4,10,22,23,55,-32,22
Montrose,9141,1,24,7,5,60,34,26,79
Peterhead,9141,2,24,4,8,79,38,41,76
Stenhousem'r,9141,3,16,8,12,58,47,11,56
Stirling,9141,4,16,6,14,61,54,7,54
Clyde,9141,5,14,9,13,53,52,1,51
Elgin,9141,6,14,6,16,53,61,-8,48
Annan Athlet,9141,7,11,11,14,47,42,5,44
Berwick,9141,8,9,10,17,33,60,-27,37
Edinburgh Ci,9141,9,7,9,20,36,62,-26,30
Cowdenbeath,9141,10,5,10,21,24,54,-30,25
Montrose,9142,1,24,7,5,60,34,26,79
Peterhead,9142,2,24,4,8,80,40,40,76
Stenhousem'r,9142,3,16,8,12,57,47,10,56
Stirling,9142,4,16,6,14,61,53,8,54
Clyde,9142,5,15,9,12,55,49,6,54
Elgin,9142,6,14,6,16,53,61,-8,48
Annan Athlet,9142,7,11,12,13,47,41,6,45
Berwick,9142,8,8,10,18,30,62,-32,34
Edinburgh Ci,9142,9,7,9,20,38,63,-25,30
Cowdenbeath,9142,10,4,11,21,23,54,-31,23
Montrose,9143,1,24,7,5,61,34,27,79
Peterhead,9143,2,24,4,8,83,39,44,76
Stirling,9143,3,17,6,13,62,51,11,57
Stenhousem'r,9143,4,15,8,13,55,48,7,53
Clyde,9143,5,14,10,12,51,48,3,52
Elgin,9143,6,14,6,16,53,62,-9,48
Annan Athlet,9143,7,11,11,14,48,43,5,44
Berwick,9143,8,8,11,17,29,58,-29,35
Edinburgh Ci,9143,9,7,9,20,37,66,-29,30
Cowdenbeath,9143,10,5,10,21,25,55,-30,25
Montrose,9144,1,24,7,5,62,36,26,79
Peterhead,9144,2,24,4,8,80,39,41,76
Stenhousem'r,9144,3,16,8,12,57,47,10,56
Stirling,9144,4,16,6,14,61,53,8,54
Clyde,9144,5,14,10,12,51,48,3,52
Elgin,9144,6,14,6,16,55,63,-8,48
Annan Athlet,9144,7,12,11,13,48,41,7,47
Berwick,9144,8,8,11,17,29,58,-29,35
Edinburgh Ci,9144,9,7,9,20,37,63,-26,30
Cowdenbeath,9144,10,4,10,22,23,55,-32,22
Montrose,9145,1,24,7,5,60,34,26,79
Peterhead,9145,2,24,4,8,83,38,45,76
Stirling,9145,3,17,6,13,61,51,10,57
Clyde,9145,4,15,9,12,55,49,6,54
Stenhousem'r,9145,5,15,8,13,55,47,8,53
Elgin,9145,6,14,6,16,53,61,-8,48
Annan Athlet,9145,7,12,11,13,49,42,7,47
Berwick,9145,8,8,10,18,30,62,-32,34
Edinburgh Ci,9145,9,7,9,20,36,66,-30,30
Cowdenbeath,9145,10,4,10,22,24,56,-32,22
Peterhead,9146,1,24,4,8,79,38,41,76
Montrose,9146,2,23,7,6,59,35,24,76
Stirling,9146,3,17,6,13,63,51,12,57
Stenhousem'r,9146,4,15,8,13,55,49,6,53
Clyde,9146,5,14,10,12,54,51,3,52
Elgin,9146,6,15,6,15,54,60,-6,51
Annan Athlet,9146,7,12,11,13,49,41,8,47
Berwick,9146,8,8,11,17,32,61,-29,35
Edinburgh Ci,9146,9,7,9,20,36,62,-26,30
Cowdenbeath,9146,10,4,10,22,23,56,-33,22
Peterhead,9147,1,24,4,8,82,38,44,76
Montrose,9147,2,23,7,6,59,35,24,76
Stenhousem'r,9147,3,16,8,12,59,48,11,56
Stirling,9147,4,16,6,14,62,55,7,54
Clyde,9147,5,15,9,12,54,48,6,54
Elgin,9147,6,15,6,15,54,60,-6,51
Annan Athlet,9147,7,12,11,13,49,41,8,47
Berwick,9147,8,8,10,18,29,61,-32,34
Edinburgh Ci,9147,9,7,9,20,36,65,-29,30
Cowdenbeath,9147,10,4,10,22,23,56,-33,22
Montrose,9148,1,24,7,5,66,35,31,79
Peterhead,9148,2,23,5,8,79,40,39,74
Stirling,9148,3,17,6,13,62,52,10,57
Stenhousem'r,9148,4,15,8,13,56,48,8,53
Clyde,9148,5,14,9,13,54,52,2,51
Elgin,9148,6,14,6,16,54,67,-13,48
Annan Athlet,9148,7,12,11,13,48,41,7,47
Berwick,9148,8,9,10,17,33,61,-28,37
Edinburgh Ci,9148,9,7,10,19,38,62,-24,31
Cowdenbeath,9148,10,4,10,22,23,55,-32,22
Montrose,9149,1,24,7,5,61,35,26,79
Peterhead,9149,2,23,5,8,79,40,39,74
Stirling,9149,3,16,7,13,60,51,9,55
Stenhousem'r,9149,4,15,9,12,55,46,9,54
Clyde,9149,5,15,9,12,53,49,4,54
Elgin,9149,6,14,6,16,54,62,-8,48
Annan Athlet,9149,7,11,12,13,50,44,6,45
Berwick,9149,8,8,10,18,30,60,-30,34
Edinburgh Ci,9149,9,7,10,19,38,62,-24,31
Cowdenbeath,9149,10,4,11,21,26,57,-31,23
Montrose,9150,1,24,7,5,62,35,27,79
Peterhead,9150,2,24,4,8,79,38,41,76
Stirling,9150,3,17,6,13,63,52,11,57
Clyde,9150,4,15,9,12,56,50,6,54
Stenhousem'r,9150,5,15,8,13,56,49,7,53
Elgin,9150,6,14,6,16,54,63,-9,48
Annan Athlet,9150,7,11,11,14,47,43,4,44
Berwick,9150,8,8,10,18,31,63,-32,34
Edinburgh Ci,9150,9,7,9,20,36,62,-26,30
Cowdenbeath,9150,10,5,10,21,25,54,-29,25
Montrose,9151,1,24,7,5,61,35,26,79
Peterhead,9151,2,24,4,8,78,38,40,76
Stirling,9151,3,17,6,13,65,53,12,57
Clyde,9151,4,15,9,12,53,48,5,54
Stenhousem'r,9151,5,15,8,13,57,51,6,53
Elgin,9151,6,14,6,16,54,62,-8,48
Annan Athlet,9151,7,11,11,14,49,45,4,44
Berwick,9151,8,8,10,18,29,60,-31,34
Edinburgh Ci,9151,9,7,9,20,36,61,-25,30
Cowdenbeath,9151,10,5,10,21,27,56,-29,25
Peterhead,9152,1,24,4,8,82,38,44,76
Montrose,9152,2,23,7,6,60,36,24,76
Stenhousem'r,9152,3,16,8,12,58,47,11,56
Stirling,9152,4,16,6,14,61,54,7,54
Clyde,9152,5,15,9,12,53,49,4,54
Elgin,9152,6,15,6,15,55,61,-6,51
Annan Athlet,9152,7,12,11,13,48,41,7,47
Berwick,9152,8,8,10,18,30,60,-30,34
Edinburgh Ci,9152,9,7,9,20,36,65,-29,30
Cowdenbeath,9152,10,4,10,22,23,55,-32,22
Montrose,9153,1,24,7,5,61,35,26,79
Peterhead,9153,2,23,5,8,79,40,39,74
Stenhousem'r,9153,3,16,8,12,57,47,10,56
Stirling,9153,4,16,6,14,61,53,8,54
Clyde,9153,5,14,10,12,53,50,3,52
Elgin,9153,6,14,6,16,54,62,-8,48
Annan Athlet,9153,7,11,12,13,47,41,6,45
Berwick,9153,8,8,11,17,31,60,-29,35
Edinburgh Ci,9153,9,7,10,19,38,62,-24,31
Cowdenbeath,9153,10,4,11,21,23,54,-31,23
Peterhead,9154,1,24,4,8,80,38,42,76
Montrose,9154,2,23,7,6,59,35,24,76
Stirling,9154,3,16,7,13,61,52,9,55
Stenhousem'r,9154,4,15,9,12,56,47,9,54
Clyde,9154,5,15,9,12,53,48,5,54
Elgin,9154,6,15,6,15,54,60,-6,51
Annan Athlet,9154,7,11,11,14,47,42,5,44
Berwick,9154,8,8,10,18,29,60,-31,34
Edinburgh Ci,9154,9,7,9,20,36,63,-27,30
Cowdenbeath,9154,10,5,10,21,24,54,-30,25
Montrose,9155,1,24,7,5,63,36,27,79
Peterhead,9155,2,23,5,8,78,39,39,74
Stirling,9155,3,16,7,13,61,52,9,55
Stenhousem'r,9155,4,15,9,12,56,47,9,54
Clyde,9155,5,15,9,12,52,48,4,54
Elgin,9155,6,14,6,16,55,64,-9,48
Annan Athlet,9155,7,11,12,13,47,41,6,45
Berwick,9155,8,8,10,18,29,59,-30,34
Edinburgh Ci,9155,9,7,10,19,37,61,-24,31
Cowdenbeath,9155,10,4,11,21,23,54,-31,23
Peterhead,9156,1,24,4,8,81,39,42,76
Montrose,9156,2,23,7,6,60,37,23,76
Stirling,9156,3,16,7,13,60,51,9,55
Stenhousem'r,9156,4,15,9,12,55,46,9,54
Clyde,9156,5,15,9,12,53,48,5,54
Elgin,9156,6,15,6,15,56,61,-5,51
Annan Athlet,9156,7,12,11,13,49,42,7,47
Berwick,9156,8,8,10,18,29,60,-31,34
Edinburgh Ci,9156,9,7,9,20,37,64,-27,30
Cowdenbeath,9156,10,4,10,22,24,56,-32,22
Montrose,9157,1,24,7,5,65,37,28,79
Peterhead,9157,2,24,4,8,81,39,42,76
Stirling,9157,3,16,7,13,60,51,9,55
Clyde,9157,4,15,9,12,58,48,10,54
Stenhousem'r,9157,5,15,9,12,55,46,9,54
Elgin,9157,6,14,6,16,56,66,-10,48
Annan Athlet,9157,7,11,11,14,47,45,2,44
Berwick,9157,8,8,10,18,29,65,-36,34
Edinburgh Ci,9157,9,7,9,20,37,64,-27,30
Cowdenbeath,9157,10,5,10,21,27,54,-27,25
Peterhead,9158,1,24,4,8,82,38,44,76
Montrose,9158,2,23,7,6,61,37,24,76
Stirling,9158,3,17,6,13,64,52,12,57
Stenhousem'r,9158,4,15,8,13,56,50,6,53
Clyde,9158,5,14,9,13,51,49,2,51
Elgin,9158,6,15,6,15,56,62,-6,51
Annan Athlet,9158,7,11,11,14,47,42,5,44
Berwick,9158,8,9,10,17,30,58,-28,37
Edinburgh Ci,9158,9,7,9,20,36,65,-29,30
Cowdenbeath,9158,10,5,10,21,24,54,-30,25
Montrose,9159,1,24,7,5,62,35,27,79
Peterhead,9159,2,24,4,8,79,38,41,76
Stirling,9159,3,17,6,13,61,51,10,57
Stenhousem'r,9159,4,15,8,13,55,47,8,53
Clyde,9159,5,14,9,13,52,50,2,51
Elgin,9159,6,14,6,16,54,63,-9,48
Annan Athlet,9159,7,11,12,13,48,42,6,45
Berwick,9159,8,9,10,17,31,59,-28,37
Edinburgh Ci,9159,9,7,9,20,36,62,-26,30
Cowdenbeath,9159,10,4,11,21,24,55,-31,23
Montrose,9160,1,23,8,5,60,35,25,77
Peterhead,9160,2,24,4,8,81,39,42,76
Stirling,9160,3,17,6,13,65,52,13,57
Stenhousem'r,9160,4,15,8,13,56,51,5,53
Clyde,9160,5,14,10,12,52,49,3,52
Elgin,9160,6,14,7,15,54,61,-7,49
Annan Athlet,9160,7,11,11,14,47,42,5,44
Berwick,9160,8,8,11,17,30,59,-29,35
Edinburgh Ci,9160,9,7,9,20,37,64,-27,30
Cowdenbeath,9160,10,5,10,21,24,54,-30,25
Montrose,9161,1,24,7,5,61,35,26,79
Peterhead,9161,2,24,4,8,80,39,41,76
Stirling,9161,3,17,6,13,64,54,10,57
Clyde,9161,4,15,9,12,54,50,4,54
Stenhousem'r,9161,5,15,8,13,58,50,8,53
Elgin,9161,6,14,6,16,54,62,-8,48
Annan Athlet,9161,7,11,11,14,48,43,5,44
Berwick,9161,8,8,10,18,31,61,-30,34
Edinburgh Ci,9161,9,7,9,20,37,63,-26,30
Cowdenbeath,9161,10,5,10,21,25,55,-30,25
Montrose,9162,1,23,8,5,61,36,25,77
Peterhead,9162,2,24,4,8,80,39,41,76
Stirling,9162,3,17,6,13,62,52,10,57
Clyde,9162,4,15,9,12,54,49,5,54
Stenhousem'r,9162,5,15,8,13,56,48,8,53
Elgin,9162,6,14,7,15,55,62,-7,49
Annan Athlet,9162,7,12,11,13,49,41,8,47
Berwick,9162,8,8,10,18,30,61,-31,34
Edinburgh Ci,9162,9,7,9,20,37,63,-26,30
Cowdenbeath,9162,10,4,10,22,23,56,-33,22
Montrose,9163,1,24,7,5,61,34,27,79
Peterhead,9163,2,24,4,8,79,38,41,76
Stirling,9163,3,17,6,13,65,52,13,57
Stenhousem'r,9163,4,15,8,13,56,51,5,53
Clyde,9163,5,14,9,13,51,49,2,51
Elgin,9163,6,14,6,16,53,62,-9,48
Annan Athlet,9163,7,11,11,14,47,42,5,44
Berwick,9163,8,9,10,17,30,58,-28,37
Edinburgh Ci,9163,9,7,9,20,36,62,-26,30
Cowdenbeath,9163,10,5,10,21,24,54,-30,25
Montrose,9164,1,24,7,5,61,34,27,79
Peterhead,9164,2,23,5,8,78,39,39,74
Stenhousem'r,9164,3,16,8,12,58,48,10,56
Stirling,9164,4,16,6,14,62,54,8,54
Clyde,9164,5,14,9,13,52,50,2,51
Elgin,9164,6,14,6,16,53,62,-9,48
Annan Athlet,9164,7,11,11,14,47,43,4,44
Berwick,9164,8,9,10,17,31,59,-28,37
Edinburgh Ci,9164,9,7,10,19,37,61,-24,31
Cowdenbeath,9164,10,5,10,21,25,54,-29,25
Montrose,9165,1,24,7,5,60,34,26,79
Peterhead,9165,2,23,4,9,77,39,38,73
Stirling,9165,3,16,7,13,62,53,9,55
Stenhousem'r,9165,4,15,9,12,57,48,9,54
Clyde,9165,5,14,9,13,52,50,2,51
Elgin,9165,6,14,6,16,53,61,-8,48
Annan Athlet,9165,7,11,12,13,48,42,6,45
Berwick,9165,8,9,10,17,31,59,-28,37
Edinburgh Ci,9165,9,8,9,19,37,60,-23,33
Cowdenbeath,9165,10,4,11,21,24,55,-31,23
Montrose,9166,1,23,8,5,60,35,25,77
Peterhead,9166,2,23,5,8,77,38,39,74
Stirling,9166,3,16,7,13,61,52,9,55
Stenhousem'r,9166,4,15,9,12,56,47,9,54
Clyde,9166,5,14,9,13,52,51,1,51
Elgin,9166,6,14,7,15,54,61,-7,49
Annan Athlet,9166,7,12,11,13,49,42,7,47
Berwick,9166,8,9,10,17,32,59,-27,37
Edinburgh Ci,9166,9,7,10,19,36,60,-24,31
Cowdenbeath,9166,10,4,10,22,24,56,-32,22
Montrose,9167,1,24,7,5,62,35,27,79
Peterhead,9167,2,24,4,8,79,39,40,76
Stirling,9167,3,17,6,13,62,51,11,57
Clyde,9167,4,15,9,12,53,48,5,54
Stenhousem'r,9167,5,15,8,13,55,48,7,53
Elgin,9167,6,14,6,16,54,63,-9,48
Annan Athlet,9167,7,12,11,13,48,41,7,47
Berwick,9167,8,8,10,18,29,60,-31,34
Edinburgh Ci,9167,9,7,9,20,37,62,-25,30
Cowdenbeath,9167,10,4,10,22,23,55,-32,22
Montrose,9168,1,24,7,5,62,36,26,79
Peterhead,9168,2,24,4,8,79,38,41,76
Stirling,9168,3,16,7,13,61,52,9,55
Stenhousem'r,9168,4,15,9,12,56,47,9,54
Clyde,9168,5,15,9,12,53,49,4,54
Elgin,9168,6,14,6,16,55,63,-8,48
Annan Athlet,9168,7,11,12,13,47,41,6,45
Berwick,9168,8,8,10,18,30,60,-30,34
Edinburgh Ci,9168,9,7,9,20,36,62,-26,30
Cowdenbeath,9168,10,4,11,21,23,54,-31,23
Montrose,9169,1,24,7,5,61,34,27,79
Peterhead,9169,2,24,4,8,80,40,40,76
Stenhousem'r,9169,3,16,8,12,57,47,10,56
Stirling,9169,4,16,6,14,61,53,8,54
Clyde,9169,5,15,9,12,53,49,4,54
Elgin,9169,6,14,6,16,53,62,-9,48
Annan Athlet,9169,7,12,11,13,49,42,7,47
Berwick,9169,8,8,10,18,30,60,-30,34
Edinburgh Ci,9169,9,7,9,20,38,63,-25,30
Cowdenbeath,9169,10,4,10,22,24,56,-32,22
Montrose,9170,1,24,7,5,61,35,26,79
Peterhead,9170,2,23,4,9,77,39,38,73
Stirling,9170,3,16,7,13,61,52,9,55
Stenhousem'r,9170,4,15,9,12,56,47,9,54
Clyde,9170,5,15,9,12,52,48,4,54
Elgin,9170,6,14,6,16,54,62,-8,48
Annan Athlet,9170,7,11,12,13,47,41,6,45
Berwick,9170,8,8,10,18,29,59,-30,34
Edinburgh Ci,9170,9,8,9,19,37,60,-23,33
Cowdenbeath,9170,10,4,11,21,23,54,-31,23
Peterhead,9171,1,24,4,8,82,39,43,76
Montrose,9171,2,23,7,6,59,36,23,76
Stirling,9171,3,16,7,13,62,53,9,55
Stenhousem'r,9171,4,15,9,12,57,48,9,54
Clyde,9171,5,15,9,12,52,48,4,54
Elgin,9171,6,15,6,15,55,60,-5,51
Annan Athlet,9171,7,11,11,14,47,42,5,44
Berwick,9171,8,8,10,18,29,59,-30,34
Edinburgh Ci,9171,9,7,9,20,37,65,-28,30
Cowdenbeath,9171,10,5,10,21,24,54,-30,25
Montrose,9172,1,24,7,5,61,35,26,79
Peterhead,9172,2,23,5,8,79,40,39,74
Stirling,9172,3,16,7,13,60,51,9,55
Stenhousem'r,9172,4,15,9,12,55,46,9,54
Clyde,9172,5,15,9,12,52,48,4,54
Elgin,9172,6,14,6,16,54,62,-8,48
Annan Athlet,9172,7,11,11,14,47,43,4,44
Berwick,9172,8,8,10,18,29,59,-30,34
Edinburgh Ci,9172,9,7,10,19,38,62,-24,31
Cowdenbeath,9172,10,5,10,21,25,54,-29,25
Montrose,9173,1,24,7,5,62,35,27,79
Peterhead,9173,2,24,4,8,82,38,44,76
Stirling,9173,3,16,7,13,61,52,9,55
Stenhousem'r,9173,4,15,9,12,56,47,9,54
Clyde,9173,5,15,9,12,53,48,5,54
Elgin,9173,6,14,6,16,54,63,-9,48
Annan Athlet,9173,7,11,11,14,48,43,5,44
Berwick,9173,8,8,10,18,29,60,-31,34
Edinburgh Ci,9173,9,7,9,20,36,65,-29,30
Cowdenbeath,9173,10,5,10,21,25,55,-30,25
Montrose,9174,1,23,8,5,61,36,25,77
Peterhead,9174,2,24,4,8,79,39,40,76
Stirling,9174,3,17,6,13,63,52,11,57
Clyde,9174,4,15,9,12,53,49,4,54
Stenhousem'r,9174,5,15,8,13,56,49,7,53
Elgin,9174,6,14,7,15,55,62,-7,49
Annan Athlet,9174,7,12,11,13,48,41,7,47
Berwick,9174,8,8,10,18,30,60,-30,34
Edinburgh Ci,9174,9,7,9,20,37,62,-25,30
Cowdenbeath,9174,10,4,10,22,23,55,-32,22
Montrose,9175,1,24,7,5,60,34,26,79
Peterhead,9175,2,24,4,8,81,39,42,76
Stirling,9175,3,17,6,13,63,52,11,57
Clyde,9175,4,15,9,12,54,49,5,54
Stenhousem'r,9175,5,15,8,13,56,49,7,53
Elgin,9175,6,14,6,16,53,61,-8,48
Annan Athlet,9175,7,11,11,14,47,42,5,44
Berwick,9175,8,8,10,18,30,61,-31,34
Edinburgh Ci,9175,9,7,9,20,37,64,-27,30
Cowdenbeath,9175,10,5,10,21,24,54,-30,25
Peterhead,9176,1,24,4,8,79,38,41,76
Montrose,9176,2,23,7,6,59,35,24,76
Stirling,9176,3,17,6,13,64,52,12,57
Stenhousem'r,9176,4,15,8,13,56,50,6,53
Clyde,9176,5,14,9,13,51,49,2,51
Elgin,9176,6,15,6,15,54,60,-6,51
Annan Athlet,9176,7,12,11,13,49,41,8,47
Berwick,9176,8,9,10,17,30,58,-28,37
Edinburgh Ci,9176,9,7,9,20,36,62,-26,30
Cowdenbeath,9176,10,4,10,22,23,56,-33,22
Montrose,9177,1,24,7,5,63,34,29,79
Peterhead,9177,2,24,4,8,81,39,42,76
Stirling,9177,3,17,6,13,63,51,12,57
Clyde,9177,4,15,9,12,54,50,4,54
Stenhousem'r,9177,5,15,8,13,55,49,6,53
Elgin,9177,6,14,6,16,53,64,-11,48
Annan Athlet,9177,7,11,11,14,47,43,4,44
Berwick,9177,8,8,10,18,31,61,-30,34
Edinburgh Ci,9177,9,7,9,20,37,64,-27,30
Cowdenbeath,9177,10,5,10,21,25,54,-29,25
Montrose,9178,1,24,7,5,61,35,26,79
Peterhead,9178,2,24,4,8,81,38,43,76
Stirling,9178,3,17,6,13,63,52,11,57
Clyde,9178,4,15,9,12,58,48,10,54
Stenhousem'r,9178,5,15,8,13,56,49,7,53
Elgin,9178,6,14,6,16,54,62,-8,48
Annan Athlet,9178,7,12,11,13,49,42,7,47
Berwick,9178,8,8,10,18,29,65,-36,34
Edinburgh Ci,9178,9,7,9,20,36,64,-28,30
Cowdenbeath,9178,10,4,10,22,24,56,-32,22
Montrose,9179,1,23,8,5,60,35,25,77
Peterhead,9179,2,24,4,8,78,38,40,76
Stirling,9179,3,17,6,13,63,52,11,57
Stenhousem'r,9179,4,15,8,13,56,49,7,53
Clyde,9179,5,14,9,13,52,51,1,51
Elgin,9179,6,14,7,15,54,61,-7,49
Annan Athlet,9179,7,11,11,14,47,42,5,44
Berwick,9179,8,9,10,17,32,59,-27,37
Edinburgh Ci,9179,9,7,9,20,36,61,-25,30
Cowdenbeath,9179,10,5,10,21,24,54,-30,25
Montrose,9180,1,23,8,5,61,36,25,77
Peterhead,9180,2,24,4,8,79,38,41,76
Stirling,9180,3,17,6,13,64,52,12,57
Clyde,9180,4,15,9,12,52,48,4,54
Stenhousem'r,9180,5,15,8,13,56,50,6,53
Elgin,9180,6,14,7,15,55,62,-7,49
Annan Athlet,9180,7,12,11,13,48,41,7,47
Berwick,9180,8,8,10,18,29,59,-30,34
Edinburgh Ci,9180,9,7,9,20,36,62,-26,30
Cowdenbeath,9180,10,4,10,22,23,55,-32,22
Peterhead,9181,1,24,4,8,81,40,41,76
Montrose,9181,2,23,7,6,59,35,24,76
Stirling,9181,3,17,6,13,62,52,10,57
Clyde,9181,4,15,9,12,53,49,4,54
Stenhousem'r,9181,5,15,8,13,56,48,8,53
Elgin,9181,6,15,6,15,54,60,-6,51
Annan Athlet,9181,7,12,11,13,48,41,7,47
Berwick,9181,8,8,10,18,30,60,-30,34
Edinburgh Ci,9181,9,7,9,20,38,64,-26,30
Cowdenbeath,9181,10,4,10,22,23,55,-32,22
Montrose,9182,1,24,7,5,61,35,26,79
Peterhead,9182,2,24,4,8,79,39,40,76
Stenhousem'r,9182,3,16,8,12,57,46,11,56
Stirling,9182,4,16,6,14,60,53,7,54
Clyde,9182,5,15,9,12,53,49,4,54
Elgin,9182,6,14,6,16,54,62,-8,48
Annan Athlet,9182,7,11,11,14,47,42,5,44
Berwick,9182,8,8,10,18,30,60,-30,34
Edinburgh Ci,9182,9,7,9,20,37,62,-25,30
Cowdenbeath,9182,10,5,10,21,24,54,-30,25
Montrose,9183,1,24,7,5,61,34,27,79
Peterhead,9183,2,24,4,8,79,38,41,76
Stirling,9183,3,17,6,13,63,52,11,57
Stenhousem'r,9183,4,15,8,13,56,49,7,53
Clyde,9183,5,14,10,12,52,49,3,52
Elgin,9183,6,14,6,16,53,62,-9,48
Annan Athlet,9183,7,11,11,14,47,42,5,44
Berwick,9183,8,8,11,17,30,59,-29,35
Edinburgh Ci,9183,9,7,9,20,36,62,-26,30
Cowdenbeath,9183,10,5,10,21,24,54,-30,25
Montrose,9184,1,23,8,5,59,34,25,77
Peterhead,9184,2,24,4,8,79,39,40,76
Stirling,9184,3,17,6,13,64,52,12,57
Stenhousem'r,9184,4,15,8,13,56,50,6,53
Clyde,9184,5,14,10,12,51,48,3,52
Elgin,9184,6,14,7,15,53,60,-7,49
Annan Athlet,9184,7,12,11,13,51,41,10,47
Berwick,9184,8,8,11,17,29,58,-29,35
Edinburgh Ci,9184,9,7,9,20,37,62,-25,30
Cowdenbeath,9184,10,4,10,22,23,58,-35,22
Montrose,9185,1,24,7,5,60,34,26,79
Peterhead,9185,2,23,4,9,78,40,38,73
Stirling,9185,3,16,7,13,62,53,9,55
Stenhousem'r,9185,4,15,9,12,57,48,9,54
Clyde,9185,5,14,9,13,53,51,2,51
Elgin,9185,6,14,6,16,53,61,-8,48
Annan Athlet,9185,7,11,12,13,49,43,6,45
Berwick,9185,8,9,10,17,32,60,-28,37
Edinburgh Ci,9185,9,8,9,19,38,61,-23,33
Cowdenbeath,9185,10,4,11,21,25,56,-31,23
Montrose,9186,1,23,8,5,59,34,25,77
Peterhead,9186,2,24,4,8,82,38,44,76
Stenhousem'r,9186,3,16,8,12,58,46,12,56
Stirling,9186,4,16,6,14,60,54,6,54
Clyde,9186,5,14,10,12,52,49,3,52
Elgin,9186,6,14,7,15,53,60,-7,49
Annan Athlet,9186,7,12,11,13,49,42,7,47
Berwick,9186,8,8,11,17,30,59,-29,35
Edinburgh Ci,9186,9,7,9,20,36,65,-29,30
Cowdenbeath,9186,10,4,10,22,24,56,-32,22
Montrose,9187,1,24,7,5,63,36,27,79
Peterhead,9187,2,24,4,8,81,39,42,76
Stirling,9187,3,16,7,13,62,53,9,55
Stenhousem'r,9187,4,15,9,12,57,48,9,54
Clyde,9187,5,15,9,12,55,50,5,54
Elgin,9187,6,14,6,16,55,64,-9,48
Annan Athlet,9187,7,11,12,13,48,42,6,45
Berwick,9187,8,8,10,18,31,62,-31,34
Edinburgh Ci,9187,9,7,9,20,37,64,-27,30
Cowdenbeath,9187,10,4,11,21,24,55,-31,23
Peterhead,9188,1,24,4,8,81,39,42,76
Montrose,9188,2,23,7,6,59,37,22,76
Stirling,9188,3,16,7,13,61,52,9,55
Stenhousem'r,9188,4,15,9,12,56,47,9,54
Clyde,9188,5,15,9,12,55,48,7,54
Elgin,9188,6,15,6,15,56,60,-4,51
Annan Athlet,9188,7,11,11,14,47,42,5,44
Berwick,9188,8,8,10,18,29,62,-33,34
Edinburgh Ci,9188,9,7,9,20,37,64,-27,30
Cowdenbeath,9188,10,5,10,21,24,54,-30,25
Montrose,9189,1,23,8,5,59,34,25,77
Peterhead,9189,2,23,5,8,78,39,39,74
Stenhousem'r,9189,3,16,8,12,58,48,10,56
Stirling,9189,4,16,6,14,62,54,8,54
Clyde,9189,5,14,10,12,51,48,3,52
Elgin,9189,6,14,7,15,53,60,-7,49
Annan Athlet,9189,7,12,11,13,48,41,7,47
Berwick,9189,8,8,11,17,29,58,-29,35
Edinburgh Ci,9189,9,7,10,19,37,61,-24,31
Cowdenbeath,9189,10,4,10,22,23,55,-32,22
Peterhead,9190,1,24,4,8,81,38,43,76
Montrose,9190,2,23,7,6,60,36,24,76
Stirling,9190,3,16,7,13,61,52,9,55
Stenhousem'r,9190,4,15,9,12,56,47,9,54
Clyde,9190,5,15,9,12,53,49,4,54
Elgin,9190,6,15,6,15,55,61,-6,51
Annan Athlet,9190,7,12,11,13,48,41,7,47
Berwick,9190,8,8,10,18,30,60,-30,34
Edinburgh Ci,9190,9,7,9,20,36,64,-28,30
Cowdenbeath,9190,10,4,10,22,23,55,-32,22
Montrose,9191,1,24,7,5,62,34,28,79
Peterhead,9191,2,24,4,8,80,38,42,76
Stirling,9191,3,16,7,13,60,51,9,55
Stenhousem'r,9191,4,15,9,12,55,46,9,54
Clyde,9191,5,15,9,12,52,48,4,54
Elgin,9191,6,14,6,16,53,63,-10,48
Annan Athlet,9191,7,12,11,13,49,41,8,47
Berwick,9191,8,8,10,18,29,59,-30,34
Edinburgh Ci,9191,9,7,9,20,36,63,-27,30
Cowdenbeath,9191,10,4,10,22,23,56,-33,22
Montrose,9192,1,24,7,5,62,35,27,79
Peterhead,9192,2,23,5,8,77,38,39,74
Stenhousem'r,9192,3,16,8,12,57,47,10,56
Stirling,9192,4,16,6,14,61,53,8,54
Clyde,9192,5,15,9,12,53,49,4,54
Elgin,9192,6,14,6,16,54,63,-9,48
Annan Athlet,9192,7,12,11,13,49,42,7,47
Berwick,9192,8,8,10,18,30,60,-30,34
Edinburgh Ci,9192,9,7,10,19,36,60,-24,31
Cowdenbeath,9192,10,4,10,22,24,56,-32,22
Montrose,9193,1,24,7,5,61,34,27,79
Peterhead,9193,2,24,4,8,81,38,43,76
Stirling,9193,3,16,7,13,61,52,9,55
Stenhousem'r,9193,4,15,9,12,56,47,9,54
Clyde,9193,5,15,9,12,53,48,5,54
Elgin,9193,6,14,6,16,53,62,-9,48
Annan Athlet,9193,7,11,12,13,47,41,6,45
Berwick,9193,8,8,10,18,29,60,-31,34
Edinburgh Ci,9193,9,7,9,20,36,64,-28,30
Cowdenbeath,9193,10,4,11,21,23,54,-31,23
Montrose,9194,1,24,7,5,62,35,27,79
Peterhead,9194,2,23,4,9,79,41,38,73
Stirling,9194,3,17,6,13,62,51,11,57
Stenhousem'r,9194,4,15,8,13,55,48,7,53
Clyde,9194,5,14,9,13,52,50,2,51
Elgin,9194,6,14,6,16,54,63,-9,48
Annan Athlet,9194,7,11,11,14,48,43,5,44
Berwick,9194,8,9,10,17,31,59,-28,37
Edinburgh Ci,9194,9,8,9,19,39,62,-23,33
Cowdenbeath,9194,10,5,10,21,25,55,-30,25
Montrose,9195,1,24,7,5,62,34,28,79
Peterhead,9195,2,23,5,8,80,41,39,74
Stenhousem'r,9195,3,16,8,12,58,48,10,56
Stirling,9195,4,16,6,14,62,54,8,54
Clyde,9195,5,15,9,12,53,49,4,54
Elgin,9195,6,14,6,16,53,63,-10,48
Annan Athlet,9195,7,12,11,13,48,41,7,47
Berwick,9195,8,8,10,18,30,60,-30,34
Edinburgh Ci,9195,9,7,10,19,39,63,-24,31
Cowdenbeath,9195,10,4,10,22,23,55,-32,22
Montrose,9196,1,23,7,6,60,37,23,76
Peterhead,9196,2,23,5,8,79,40,39,74
Stirling,9196,3,16,7,13,61,52,9,55
Stenhousem'r,9196,4,15,9,12,56,47,9,54
Clyde,9196,5,15,9,12,52,48,4,54
Elgin,9196,6,15,6,15,56,61,-5,51
Annan Athlet,9196,7,11,12,13,47,41,6,45
Berwick,9196,8,8,10,18,29,59,-30,34
Edinburgh Ci,9196,9,7,10,19,38,62,-24,31
Cowdenbeath,9196,10,4,11,21,23,54,-31,23
Montrose,9197,1,24,7,5,61,34,27,79
Peterhead,9197,2,24,4,8,80,38,42,76
Stirling,9197,3,17,6,13,65,52,13,57
Clyde,9197,4,15,9,12,52,48,4,54
Stenhousem'r,9197,5,15,8,13,56,51,5,53
Elgin,9197,6,14,6,16,53,62,-9,48
Annan Athlet,9197,7,11,11,14,47,43,4,44
Berwick,9197,8,8,10,18,29,59,-30,34
Edinburgh Ci,9197,9,7,9,20,36,63,-27,30
Cowdenbeath,9197,10,5,10,21,25,54,-29,25
Montrose,9198,1,24,7,5,62,35,27,79
Peterhead,9198,2,24,4,8,83,40,43,76
Stirling,9198,3,17,6,13,63,52,11,57
Clyde,9198,4,15,9,12,54,48,6,54
Stenhousem'r,9198,5,15,8,13,56,49,7,53
Elgin,9198,6,14,6,16,54,63,-9,48
Annan Athlet,9198,7,11,11,14,48,43,5,44
Berwick,9198,8,8,10,18,29,61,-32,34
Edinburgh Ci,9198,9,7,9,20,38,66,-28,30
Cowdenbeath,9198,10,5,10,21,25,55,-30,25
Montrose,9199,1,24,7,5,63,34,29,79
Peterhead,9199,2,24,4,8,82,40,42,76
Stirling,9199,3,17,6,13,64,52,12,57
Clyde,9199,4,15,9,12,53,48,5,54
Stenhousem'r,9199,5,15,8,13,56,50,6,53
Elgin,9199,6,14,6,16,53,64,-11,48
Annan Athlet,9199,7,12,11,13,50,41,9,47
Berwick,9199,8,8,10,18,29,60,-31,34
Edinburgh Ci,9199,9,7,9,20,38,65,-27,30
Cowdenbeath,9199,10,4,10,22,23,57,-34,22
Montrose,9200,1,24,7,5,62,35,27,79
Peterhead,9200,2,23,4,9,78,40,38,73
Stirling,9200,3,16,7,13,63,54,9,55
Stenhousem'r,9200,4,15,9,12,58,49,9,54
Clyde,9200,5,15,9,12,53,48,5,54
Elgin,9200,6,14,6,16,54,63,-9,48
Annan Athlet,9200,7,11,11,14,47,43,4,44
Berwick,9200,8,8,10,18,29,60,-31,34
Edinburgh Ci,9200,9,8,9,19,38,61,-23,33
Cowdenbeath,9200,10,5,10,21,25,54,-29,25
Montrose,9201,1,24,7,5,61,34,27,79
Peterhead,9201,2,24,4,8,80,39,41,76
Stirling,9201,3,16,7,13,62,53,9,55
Stenhousem'r,9201,4,15,9,12,57,48,9,54
Clyde,9201,5,15,9,12,52,48,4,54
Elgin,9201,6,14,6,16,53,62,-9,48
Annan Athlet,9201,7,12,11,13,48,41,7,47
Berwick,9201,8,8,10,18,29,59,-30,34
Edinburgh Ci,9201,9,7,9,20,37,63,-26,30
Cowdenbeath,9201,10,4,10,22,23,55,-32,22
Montrose,9202,1,23,8,5,61,36,25,77
Peterhead,9202,2,24,4,8,80,40,40,76
Stenhousem'r,9202,3,16,8,12,57,46,11,56
Stirling,9202,4,16,6,14,60,53,7,54
Clyde,9202,5,14,10,12,52,49,3,52
Elgin,9202,6,14,7,15,55,62,-7,49
Annan Athlet,9202,7,12,11,13,49,41,8,47
Berwick,9202,8,8,11,17,30,59,-29,35
Edinburgh Ci,9202,9,7,9,20,38,63,-25,30
Cowdenbeath,9202,10,4,10,22,23,56,-33,22
Montrose,9203,1,24,7,5,61,35,26,79
Peterhead,9203,2,24,4,8,79,39,40,76
Stirling,9203,3,17,6,13,61,51,10,57
Clyde,9203,4,15,9,12,53,48,5,54
Stenhousem'r,9203,5,15,8,13,55,47,8,53
Elgin,9203,6,14,6,16,54,62,-8,48
Annan Athlet,9203,7,11,12,13,48,42,6,45
Berwick,9203,8,8,10,18,29,60,-31,34
Edinburgh Ci,9203,9,7,9,20,37,62,-25,30
Cowdenbeath,9203,10,4,11,21,24,55,-31,23
Montrose,9204,1,24,7,5,60,34,26,79
Peterhead,9204,2,23,5,8,77,38,39,74
Stenhousem'r,9204,3,16,8,12,59,46,13,56
Stirling,9204,4,16,6,14,60,55,5,54
Clyde,9204,5,15,9,12,52,48,4,54
Elgin,9204,6,14,6,16,53,61,-8,48
Annan Athlet,9204,7,12,11,13,50,42,8,47
Berwick,9204,8,8,10,18,29,59,-30,34
Edinburgh Ci,9204,9,7,10,19,36,60,-24,31
Cowdenbeath,9204,10,4,10,22,24,57,-33,22
Montrose,9205,1,24,7,5,60,34,26,79
Peterhead,9205,2,24,4,8,80,38,42,76
Stirling,9205,3,16,7,13,60,51,9,55
Stenhousem'r,9205,4,15,9,12,55,46,9,54
Clyde,9205,5,15,9,12,54,49,5,54
Elgin,9205,6,14,6,16,53,61,-8,48
Annan Athlet,9205,7,12,11,13,50,41,9,47
Berwick,9205,8,8,10,18,30,61,-31,34
Edinburgh Ci,9205,9,7,9,20,36,63,-27,30
Cowdenbeath,9205,10,4,10,22,23,57,-34,22
Peterhead,9206,1,24,4,8,80,40,40,76
Montrose,9206,2,23,7,6,60,36,24,76
Stirling,9206,3,17,6,13,63,51,12,57
Stenhousem'r,9206,4,15,8,13,55,49,6,53
Clyde,9206,5,14,9,13,52,50,2,51
Elgin,9206,6,15,6,15,55,61,-6,51
Annan Athlet,9206,7,12,11,13,50,42,8,47
Berwick,9206,8,9,10,17,31,59,-28,37
Edinburgh Ci,9206,9,7,9,20,38,63,-25,30
Cowdenbeath,9206,10,4,10,22,24,57,-33,22
Montrose,9207,1,24,7,5,61,35,26,79
Peterhead,9207,2,24,4,8,79,39,40,76
Stirling,9207,3,17,6,13,61,51,10,57
Stenhousem'r,9207,4,15,8,13,55,47,8,53
Clyde,9207,5,14,9,13,52,50,2,51
Elgin,9207,6,14,6,16,54,62,-8,48
Annan Athlet,9207,7,12,11,13,49,41,8,47
Berwick,9207,8,9,10,17,31,59,-28,37
Edinburgh Ci,9207,9,7,9,20,37,62,-25,30
Cowdenbeath,9207,10,4,10,22,23,56,-33,22
Peterhead,9208,1,24,4,8,82,40,42,76
Montrose,9208,2,23,7,6,59,35,24,76
Stirling,9208,3,17,6,13,63,52,11,57
Clyde,9208,4,15,9,12,57,48,9,54
Stenhousem'r,9208,5,15,8,13,56,49,7,53
Elgin,9208,6,15,6,15,54,60,-6,51
Annan Athlet,9208,7,12,11,13,49,41,8,47
Berwick,9208,8,8,10,18,29,64,-35,34
Edinburgh Ci,9208,9,7,9,20,38,65,-27,30
Cowdenbeath,9208,10,4,10,22,23,56,-33,22
Montrose,9209,1,24,7,5,61,35,26,79
Peterhead,9209,2,24,4,8,79,39,40,76
Stenhousem'r,9209,3,16,8,12,56,46,10,56
Stirling,9209,4,16,6,14,60,52,8,54
Clyde,9209,5,15,9,12,52,48,4,54
Elgin,9209,6,14,6,16,54,62,-8,48
Annan Athlet,9209,7,11,11,14,47,42,5,44
Berwick,9209,8,8,10,18,29,59,-30,34
Edinburgh Ci,9209,9,7,9,20,37,62,-25,30
Cowdenbeath,9209,10,5,10,21,24,54,-30,25
Montrose,9210,1,24,7,5,62,36,26,79
Peterhead,9210,2,23,5,8,78,39,39,74
Stirling,9210,3,17,6,13,63,53,10,57
Stenhousem'r,9210,4,15,8,13,57,49,8,53
Clyde,9210,5,14,10,12,52,49,3,52
Elgin,9210,6,14,6,16,55,63,-8,48
Annan Athlet,9210,7,11,11,14,47,42,5,44
Berwick,9210,8,8,11,17,30,59,-29,35
Edinburgh Ci,9210,9,7,10,19,37,61,-24,31
Cowdenbeath,9210,10,5,10,21,24,54,-30,25
Montrose,9211,1,23,8,5,61,36,25,77
Peterhead,9211,2,24,4,8,80,38,42,76
Stenhousem'r,9211,3,16,8,12,57,47,10,56
Stirling,9211,4,16,6,14,61,53,8,54
Clyde,9211,5,14,9,13,51,50,1,51
Elgin,9211,6,14,7,15,55,62,-7,49
Annan Athlet,9211,7,11,11,14,47,42,5,44
Berwick,9211,8,9,10,17,31,58,-27,37
Edinburgh Ci,9211,9,7,9,20,36,63,-27,30
Cowdenbeath,9211,10,5,10,21,24,54,-30,25
Peterhead,9212,1,24,4,8,81,38,43,76
Montrose,9212,2,23,7,6,60,37,23,76
Stirling,9212,3,17,6,13,64,51,13,57
Stenhousem'r,9212,4,15,8,13,55,50,5,53
Clyde,9212,5,14,10,12,53,50,3,52
Elgin,9212,6,15,6,15,56,61,-5,51
Annan Athlet,9212,7,12,11,13,49,41,8,47
Berwick,9212,8,8,11,17,31,60,-29,35
Edinburgh Ci,9212,9,7,9,20,36,64,-28,30
Cowdenbeath,9212,10,4,10,22,23,56,-33,22
Montrose,9213,1,23,7,6,59,36,23,76
Peterhead,9213,2,23,4,9,78,40,38,73
Stirling,9213,3,17,6,13,62,52,10,57
Clyde,9213,4,15,9,12,52,48,4,54
Stenhousem'r,9213,5,15,8,13,56,48,8,53
Elgin,9213,6,15,6,15,55,60,-5,51
Annan Athlet,9213,7,12,11,13,51,42,9,47
Berwick,9213,8,8,10,18,29,59,-30,34
Edinburgh Ci,9213,9,8,9,19,38,61,-23,33
Cowdenbeath,9213,10,4,10,22,24,58,-34,22
Montrose,9214,1,24,7,5,61,34,27,79
Peterhead,9214,2,24,4,8,79,39,40,76
Stirling,9214,3,16,7,13,61,52,9,55
Stenhousem'r,9214,4,15,9,12,56,47,9,54
Clyde,9214,5,15,9,12,54,49,5,54
Elgin,9214,6,14,6,16,53,62,-9,48
Annan Athlet,9214,7,12,11,13,50,43,7,47
Berwick,9214,8,8,10,18,30,61,-31,34
Edinburgh Ci,9214,9,7,9,20,37,62,-25,30
Cowdenbeath,9214,10,4,10,22,25,57,-32,22
Montrose,9215,1,23,8,5,60,35,25,77
Peterhead,9215,2,24,4,8,80,39,41,76
Stirling,9215,3,17,6,13,63,52,11,57
Clyde,9215,4,15,9,12,52,48,4,54
Stenhousem'r,9215,5,15,8,13,56,49,7,53
Elgin,9215,6,14,7,15,54,61,-7,49
Annan Athlet,9215,7,11,11,14,48,43,5,44
Berwick,9215,8,8,10,18,29,59,-30,34
Edinburgh Ci,9215,9,7,9,20,37,63,-26,30
Cowdenbeath,9215,10,5,10,21,25,55,-30,25
Montrose,9216,1,24,7,5,61,34,27,79
Peterhead,9216,2,23,4,9,78,40,38,73
Stirling,9216,3,16,7,13,61,52,9,55
Stenhousem'r,9216,4,15,9,12,56,47,9,54
Clyde,9216,5,15,9,12,53,48,5,54
Elgin,9216,6,14,6,16,53,62,-9,48
Annan Athlet,9216,7,11,12,13,48,42,6,45
Berwick,9216,8,8,10,18,29,60,-31,34
Edinburgh Ci,9216,9,8,9,19,38,61,-23,33
Cowdenbeath,9216,10,4,11,21,24,55,-31,23
Montrose,9217,1,24,7,5,61,35,26,79
Peterhead,9217,2,23,5,8,77,38,39,74
Stirling,9217,3,17,6,13,63,52,11,57
Clyde,9217,4,15,9,12,56,48,8,54
Stenhousem'r,9217,5,15,8,13,56,49,7,53
Elgin,9217,6,14,6,16,54,62,-8,48
Annan Athlet,9217,7,12,11,13,49,42,7,47
Berwick,9217,8,8,10,18,29,63,-34,34
Edinburgh Ci,9217,9,7,10,19,36,60,-24,31
Cowdenbeath,9217,10,4,10,22,24,56,-32,22
Peterhead,9218,1,24,4,8,81,40,41,76
Montrose,9218,2,23,7,6,59,36,23,76
Stirling,9218,3,16,7,13,63,54,9,55
Stenhousem'r,9218,4,15,9,12,58,49,9,54
Clyde,9218,5,15,9,12,56,49,7,54
Elgin,9218,6,15,6,15,55,60,-5,51
Annan Athlet,9218,7,12,11,13,50,43,7,47
Berwick,9218,8,8,10,18,30,63,-33,34
Edinburgh Ci,9218,9,7,9,20,38,64,-26,30
Cowdenbeath,9218,10,4,10,22,25,57,-32,22
Montrose,9219,1,24,7,5,61,35,26,79
Peterhead,9219,2,24,4,8,78,38,40,76
Stirling,9219,3,17,6,13,63,52,11,57
Stenhousem'r,9219,4,15,8,13,56,49,7,53
Clyde,9219,5,14,10,12,53,50,3,52
Elgin,9219,6,14,6,16,54,62,-8,48
Annan Athlet,9219,7,11,11,14,48,44,4,44
Berwick,9219,8,8,11,17,31,60,-29,35
Edinburgh Ci,9219,9,7,9,20,36,61,-25,30
Cowdenbeath,9219,10,5,10,21,26,55,-29,25
Montrose,9220,1,23,8,5,61,36,25,77
Peterhead,9220,2,24,4,8,81,38,43,76
Stirling,9220,3,17,6,13,63,51,12,57
Stenhousem'r,9220,4,15,8,13,55,49,6,53
Clyde,9220,5,14,10,12,51,48,3,52
Elgin,9220,6,14,7,15,55,62,-7,49
Annan Athlet,9220,7,11,12,13,47,41,6,45
Berwick,9220,8,8,11,17,29,58,-29,35
Edinburgh Ci,9220,9,7,9,20,36,64,-28,30
Cowdenbeath,9220,10,4,11,21,23,54,-31,23
Montrose,9221,1,24,7,5,63,34,29,79
Peterhead,9221,2,24,4,8,79,38,41,76
Stirling,9221,3,17,6,13,62,52,10,57
Clyde,9221,4,15,9,12,54,49,5,54
Stenhousem'r,9221,5,15,8,13,56,48,8,53
Elgin,9221,6,14,6,16,53,64,-11,48
Annan Athlet,9221,7,11,12,13,47,41,6,45
Berwick,9221,8,8,10,18,30,61,-31,34
Edinburgh Ci,9221,9,7,9,20,36,62,-26,30
Cowdenbeath,9221,10,4,11,21,23,54,-31,23
Montrose,9222,1,24,7,5,63,34,29,79
Peterhead,9222,2,24,4,8,79,39,40,76
Stenhousem'r,9222,3,16,8,12,56,46,10,56
Stirling,9222,4,16,6,14,60,52,8,54
Clyde,9222,5,14,9,13,52,50,2,51
Elgin,9222,6,14,6,16,53,64,-11,48
Annan Athlet,9222,7,11,11,14,48,43,5,44
Berwick,9222,8,9,10,17,31,59,-28,37
Edinburgh Ci,9222,9,7,9,20,37,62,-25,30
Cowdenbeath,9222,10,5,10,21,25,55,-30,25
Montrose,9223,1,24,7,5,61,34,27,79
Peterhead,9223,2,24,4,8,80,39,41,76
Stirling,9223,3,17,6,13,64,52,12,57
Clyde,9223,4,15,9,12,53,49,4,54
Stenhousem'r,9223,5,15,8,13,56,50,6,53
Elgin,9223,6,14,6,16,53,62,-9,48
Annan Athlet,9223,7,12,11,13,50,41,9,47
Berwick,9223,8,8,10,18,30,60,-30,34
Edinburgh Ci,9223,9,7,9,20,37,63,-26,30
Cowdenbeath,9223,10,4,10,22,23,57,-34,22
Montrose,9224,1,24,7,5,61,35,26,79
Peterhead,9224,2,24,4,8,83,38,45,76
Stirling,9224,3,17,6,13,62,52,10,57
Stenhousem'r,9224,4,15,8,13,56,48,8,53
Clyde,9224,5,14,10,12,53,50,3,52
Elgin,9224,6,14,6,16,54,62,-8,48
Annan Athlet,9224,7,12,11,13,49,42,7,47
Berwick,9224,8,8,11,17,31,60,-29,35
Edinburgh Ci,9224,9,7,9,20,36,66,-30,30
Cowdenbeath,9224,10,4,10,22,24,56,-32,22
Montrose,9225,1,23,8,5,59,34,25,77
Peterhead,9225,2,24,4,8,80,38,42,76
Stirling,9225,3,17,6,13,65,51,14,57
Stenhousem'r,9225,4,15,8,13,55,51,4,53
Clyde,9225,5,14,9,13,51,51,0,51
Elgin,9225,6,14,7,15,53,60,-7,49
Annan Athlet,9225,7,11,12,13,48,42,6,45
Berwick,9225,8,9,10,17,32,58,-26,37
Edinburgh Ci,9225,9,7,9,20,36,63,-27,30
Cowdenbeath,9225,10,4,11,21,24,55,-31,23
Montrose,9226,1,24,7,5,62,34,28,79
Peterhead,9226,2,24,4,8,83,39,44,76
Stirling,9226,3,17,6,13,63,52,11,57
Stenhousem'r,9226,4,15,8,13,56,49,7,53
Clyde,9226,5,14,10,12,54,51,3,52
Elgin,9226,6,14,6,16,53,63,-10,48
Annan Athlet,9226,7,11,11,14,48,43,5,44
Berwick,9226,8,8,11,17,32,61,-29,35
Edinburgh Ci,9226,9,7,9,20,37,66,-29,30
Cowdenbeath,9226,10,5,10,21,25,55,-30,25
Montrose,9227,1,24,7,5,61,34,27,79
Peterhead,9227,2,24,4,8,79,38,41,76
Stirling,9227,3,17,6,13,62,51,11,57
Stenhousem'r,9227,4,15,8,13,55,48,7,53
Clyde,9227,5,14,9,13,51,49,2,51
Elgin,9227,6,14,6,16,53,62,-9,48
Annan Athlet,9227,7,12,11,13,50,41,9,47
Berwick,9227,8,9,10,17,30,58,-28,37
Edinburgh Ci,9227,9,7,9,20,36,62,-26,30
Cowdenbeath,9227,10,4,10,22,23,57,-34,22
Montrose,9228,1,23,8,5,60,35,25,77
Peterhead,9228,2,24,4,8,79,39,40,76
Stirling,9228,3,17,6,13,64,52,12,57
Clyde,9228,4,15,9,12,53,49,4,54
Stenhousem'r,9228,5,15,8,13,56,50,6,53
Elgin,9228,6,14,7,15,54,61,-7,49
Annan Athlet,9228,7,12,11,13,48,41,7,47
Berwick,9228,8,8,10,18,30,60,-30,34
Edinburgh Ci,9228,9,7,9,20,37,62,-25,30
Cowdenbeath,9228,10,4,10,22,23,55,-32,22
Peterhead,9229,1,24,4,8,81,38,43,76
Montrose,9229,2,23,7,6,60,36,24,76
Stirling,9229,3,17,6,13,62,51,11,57
Clyde,9229,4,15,9,12,54,49,5,54
Stenhousem'r,9229,5,15,8,13,55,48,7,53
Elgin,9229,6,15,6,15,55,61,-6,51
Annan Athlet,9229,7,11,11,14,48,43,5,44
Berwick,9229,8,8,10,18,30,61,-31,34
Edinburgh Ci,9229,9,7,9,20,36,64,-28,30
Cowdenbeath,9229,10,5,10,21,25,55,-30,25
Montrose,9230,1,24,7,5,60,34,26,79
Peterhead,9230,2,24,4,8,80,38,42,76
Stirling,9230,3,17,6,13,63,53,10,57
Clyde,9230,4,15,9,12,55,48,7,54
Stenhousem'r,9230,5,15,8,13,57,49,8,53
Elgin,9230,6,14,6,16,53,61,-8,48
Annan Athlet,9230,7,11,11,14,47,42,5,44
Berwick,9230,8,8,10,18,29,62,-33,34
Edinburgh Ci,9230,9,7,9,20,36,63,-27,30
Cowdenbeath,9230,10,5,10,21,24,54,-30,25
Montrose,9231,1,23,8,5,61,36,25,77
Peterhead,9231,2,24,4,8,79,38,41,76
Stirling,9231,3,17,6,13,64,53,11,57
Clyde,9231,4,15,9,12,53,49,4,54
Stenhousem'r,9231,5,15,8,13,57,50,7,53
Elgin,9231,6,14,7,15,55,62,-7,49
Annan Athlet,9231,7,12,11,13,49,42,7,47
Berwick,9231,8,8,10,18,30,60,-30,34
Edinburgh Ci,9231,9,7,9,20,36,62,-26,30
Cowdenbeath,9231,10,4,10,22,24,56,-32,22
Montrose,9232,1,24,7,5,61,35,26,79
Peterhead,9232,2,24,4,8,79,39,40,76
Stenhousem'r,9232,3,16,8,12,57,47,10,56
Stirling,9232,4,16,6,14,61,53,8,54
Clyde,9232,5,14,9,13,53,52,1,51
Elgin,9232,6,14,6,16,54,62,-8,48
Annan Athlet,9232,7,12,11,13,50,41,9,47
Berwick,9232,8,9,10,17,33,60,-27,37
Edinburgh Ci,9232,9,7,9,20,37,62,-25,30
Cowdenbeath,9232,10,4,10,22,23,57,-34,22
Montrose,9233,1,24,7,5,61,34,27,79
Peterhead,9233,2,24,4,8,81,39,42,76
Stirling,9233,3,17,6,13,64,54,10,57
Clyde,9233,4,15,9,12,53,48,5,54
Stenhousem'r,9233,5,15,8,13,58,50,8,53
Elgin,9233,6,14,6,16,53,62,-9,48
Annan Athlet,9233,7,12,11,13,48,41,7,47
Berwick,9233,8,8,10,18,29,60,-31,34
Edinburgh Ci,9233,9,7,9,20,37,64,-27,30
Cowdenbeath,9233,10,4,10,22,23,55,-32,22
Montrose,9234,1,23,8,5,61,36,25,77
Peterhead,9234,2,23,5,8,78,39,39,74
Stirling,9234,3,17,6,13,63,52,11,57
Clyde,9234,4,15,9,12,53,48,5,54
Stenhousem'r,9234,5,15,8,13,56,49,7,53
Elgin,9234,6,14,7,15,55,62,-7,49
Annan Athlet,9234,7,12,11,13,49,42,7,47
Berwick,9234,8,8,10,18,29,60,-31,34
Edinburgh Ci,9234,9,7,10,19,37,61,-24,31
Cowdenbeath,9234,10,4,10,22,24,56,-32,22
Montrose,9235,1,24,7,5,62,35,27,79
Peterhead,9235,2,24,4,8,79,38,41,76
Stirling,9235,3,16,7,13,61,52,9,55
Stenhousem'r,9235,4,15,9,12,56,47,9,54
Clyde,9235,5,14,9,13,53,51,2,51
Elgin,9235,6,14,6,16,54,63,-9,48
Annan Athlet,9235,7,11,11,14,48,44,4,44
Berwick,9235,8,9,10,17,32,60,-28,37
Edinburgh Ci,9235,9,7,9,20,36,62,-26,30
Cowdenbeath,9235,10,5,10,21,26,55,-29,25
Montrose,9236,1,24,7,5,60,34,26,79
Peterhead,9236,2,24,4,8,81,38,43,76
Stirling,9236,3,17,6,13,64,54,10,57
Stenhousem'r,9236,4,15,8,13,58,50,8,53
Clyde,9236,5,14,9,13,51,49,2,51
Elgin,9236,6,14,6,16,53,61,-8,48
Annan Athlet,9236,7,11,11,14,47,45,2,44
Berwick,9236,8,9,10,17,30,58,-28,37
Edinburgh Ci,9236,9,7,9,20,36,64,-28,30
Cowdenbeath,9236,10,5,10,21,27,54,-27,25
Montrose,9237,1,23,8,5,61,36,25,77
Peterhead,9237,2,24,4,8,81,40,41,76
Stirling,9237,3,17,6,13,63,52,11,57
Stenhousem'r,9237,4,15,8,13,56,49,7,53
Clyde,9237,5,14,10,12,51,48,3,52
Elgin,9237,6,14,7,15,55,62,-7,49
Annan Athlet,9237,7,12,11,13,50,43,7,47
Berwick,9237,8,8,11,17,29,58,-29,35
Edinburgh Ci,9237,9,7,9,20,38,64,-26,30
Cowdenbeath,9237,10,4,10,22,25,57,-32,22
Montrose,9238,1,24,7,5,60,34,26,79
Peterhead,9238,2,23,4,9,77,41,36,73
Stenhousem'r,9238,3,16,8,12,56,46,10,56
Stirling,9238,4,16,6,14,60,52,8,54
Clyde,9238,5,15,9,12,55,49,6,54
Elgin,9238,6,14,6,16,53,61,-8,48
Annan Athlet,9238,7,11,11,14,48,43,5,44
Berwick,9238,8,8,10,18,30,62,-32,34
Edinburgh Ci,9238,9,8,9,19,39,60,-21,33
Cowdenbeath,9238,10,5,10,21,25,55,-30,25
Montrose,9239,1,24,7,5,63,37,26,79
Peterhead,9239,2,24,4,8,79,39,40,76
Stirling,9239,3,17,6,13,64,53,11,57
Clyde,9239,4,15,9,12,52,48,4,54
Stenhousem'r,9239,5,15,8,13,57,50,7,53
Elgin,9239,6,14,6,16,56,64,-8,48
Annan Athlet,9239,7,12,11,13,48,41,7,47
Berwick,9239,8,8,10,18,29,59,-30,34
Edinburgh Ci,9239,9,7,9,20,37,62,-25,30
Cowdenbeath,9239,10,4,10,22,23,55,-32,22
Montrose,9240,1,24,7,5,61,35,26,79
Peterhead,9240,2,23,5,8,78,39,39,74
Stenhousem'r,9240,3,16,8,12,59,49,10,56
Stirling,9240,4,16,6,14,63,55,8,54
Clyde,9240,5,14,10,12,51,48,3,52
Elgin,9240,6,14,6,16,54,62,-8,48
Annan Athlet,9240,7,11,12,13,48,42,6,45
Berwick,9240,8,8,11,17,29,58,-29,35
Edinburgh Ci,9240,9,7,10,19,37,61,-24,31
Cowdenbeath,9240,10,4,11,21,24,55,-31,23
Peterhead,9241,1,24,4,8,81,39,42,76
Montrose,9241,2,23,7,6,59,36,23,76
Stirling,9241,3,16,7,13,60,51,9,55
Stenhousem'r,9241,4,15,9,12,55,46,9,54
Clyde,9241,5,15,9,12,55,50,5,54
Elgin,9241,6,15,6,15,55,60,-5,51
Annan Athlet,9241,7,12,11,13,49,42,7,47
Berwick,9241,8,8,10,18,31,62,-31,34
Edinburgh Ci,9241,9,7,9,20,37,64,-27,30
Cowdenbeath,9241,10,4,10,22,24,56,-32,22
Montrose,9242,1,24,7,5,60,34,26,79
Peterhead,9242,2,23,4,9,78,40,38,73
Stirling,9242,3,17,6,13,62,52,10,57
Stenhousem'r,9242,4,15,8,13,56,48,8,53
Clyde,9242,5,14,10,12,52,49,3,52
Elgin,9242,6,14,6,16,53,61,-8,48
Annan Athlet,9242,7,12,11,13,49,42,7,47
Berwick,9242,8,8,11,17,30,59,-29,35
Edinburgh Ci,9242,9,8,9,19,38,61,-23,33
Cowdenbeath,9242,10,4,10,22,24,56,-32,22
Montrose,9243,1,24,7,5,61,35,26,79
Peterhead,9243,2,24,4,8,78,38,40,76
Stirling,9243,3,17,6,13,64,51,13,57
Stenhousem'r,9243,4,15,8,13,55,50,5,53
Clyde,9243,5,14,9,13,51,49,2,51
Elgin,9243,6,14,6,16,54,62,-8,48
Annan Athlet,9243,7,11,11,14,48,44,4,44
Berwick,9243,8,9,10,17,30,58,-28,37
Edinburgh Ci,9243,9,7,9,20,36,61,-25,30
Cowdenbeath,9243,10,5,10,21,26,55,-29,25
Montrose,9244,1,23,8,5,60,35,25,77
Peterhead,9244,2,24,4,8,80,39,41,76
Stirling,9244,3,17,6,13,64,52,12,57
Stenhousem'r,9244,4,15,8,13,56,50,6,53
Clyde,9244,5,14,10,12,51,48,3,52
Elgin,9244,6,14,7,15,54,61,-7,49
Annan Athlet,9244,7,12,11,13,49,41,8,47
Berwick,9244,8,8,11,17,29,58,-29,35
Edinburgh Ci,9244,9,7,9,20,37,63,-26,30
Cowdenbeath,9244,10,4,10,22,23,56,-33,22
Montrose,9245,1,24,7,5,61,35,26,79
Peterhead,9245,2,24,4,8,81,38,43,76
Stenhousem'r,9245,3,16,8,12,56,46,10,56
Stirling,9245,4,16,6,14,60,52,8,54
Clyde,9245,5,14,9,13,51,51,0,51
Elgin,9245,6,14,6,16,54,62,-8,48
Annan Athlet,9245,7,11,12,13,47,41,6,45
Berwick,9245,8,9,10,17,32,58,-26,37
Edinburgh Ci,9245,9,7,9,20,36,64,-28,30
Cowdenbeath,9245,10,4,11,21,23,54,-31,23
Peterhead,9246,1,24,4,8,80,40,40,76
Montrose,9246,2,23,7,6,60,36,24,76
Stenhousem'r,9246,3,16,8,12,60,48,12,56
Stirling,9246,4,16,6,14,62,56,6,54
Clyde,9246,5,14,10,12,53,50,3,52
Elgin,9246,6,15,6,15,55,61,-6,51
Annan Athlet,9246,7,11,11,14,47,42,5,44
Berwick,9246,8,8,11,17,31,60,-29,35
Edinburgh Ci,9246,9,7,9,20,38,63,-25,30
Cowdenbeath,9246,10,5,10,21,24,54,-30,25
Montrose,9247,1,24,7,5,61,35,26,79
Peterhead,9247,2,24,4,8,81,38,43,76
Stirling,9247,3,17,6,13,63,51,12,57
Clyde,9247,4,15,9,12,54,49,5,54
Stenhousem'r,9247,5,15,8,13,55,49,6,53
Elgin,9247,6,14,6,16,54,62,-8,48
Annan Athlet,9247,7,11,11,14,48,43,5,44
Berwick,9247,8,8,10,18,30,61,-31,34
Edinburgh Ci,9247,9,7,9,20,36,64,-28,30
Cowdenbeath,9247,10,5,10,21,25,55,-30,25
Montrose,9248,1,23,8,5,59,34,25,77
Peterhead,9248,2,23,5,8,77,38,39,74
Stenhousem'r,9248,3,16,8,12,58,47,11,56
Stirling,9248,4,16,6,14,61,54,7,54
Clyde,9248,5,14,10,12,53,50,3,52
Elgin,9248,6,14,7,15,53,60,-7,49
Annan Athlet,9248,7,11,12,13,47,41,6,45
Berwick,9248,8,8,11,17,31,60,-29,35
Edinburgh Ci,9248,9,7,10,19,36,60,-24,31
Cowdenbeath,9248,10,4,11,21,23,54,-31,23
Montrose,9249,1,24,7,5,61,35,26,79
Peterhead,9249,2,23,5,8,77,38,39,74
Stenhousem'r,9249,3,16,8,12,56,46,10,56
Stirling,9249,4,16,6,14,60,52,8,54
Clyde,9249,5,14,9,13,51,49,2,51
Elgin,9249,6,14,6,16,54,62,-8,48
Annan Athlet,9249,7,12,11,13,50,41,9,47
Berwick,9249,8,9,10,17,30,58,-28,37
Edinburgh Ci,9249,9,7,10,19,36,60,-24,31
Cowdenbeath,9249,10,4,10,22,23,57,-34,22
Peterhead,9250,1,24,4,8,79,38,41,76
Montrose,9250,2,23,7,6,60,36,24,76
Stirling,9250,3,16,7,13,61,52,9,55
Stenhousem'r,9250,4,15,9,12,56,47,9,54
Clyde,9250,5,15,9,12,53,48,5,54
Elgin,9250,6,15,6,15,55,61,-6,51
Annan Athlet,9250,7,11,11,14,47,42,5,44
Berwick,9250,8,8,10,18,29,60,-31,34
Edinburgh Ci,9250,9,7,9,20,36,62,-26,30
Cowdenbeath,9250,10,5,10,21,24,54,-30,25
Montrose,9251,1,24,7,5,60,34,26,79
Peterhead,9251,2,24,4,8,80,38,42,76
Stenhousem'r,9251,3,16,8,12,59,49,10,56
Stirling,9251,4,16,6,14,63,55,8,54
Clyde,9251,5,14,10,12,51,48,3,52
Elgin,9251,6,14,6,16,53,61,-8,48
Annan Athlet,9251,7,11,11,14,48,43,5,44
Berwick,9251,8,8,11,17,29,58,-29,35
Edinburgh Ci,9251,9,7,9,20,36,63,-27,30
Cowdenbeath,9251,10,5,10,21,25,55,-30,25
Montrose,9252,1,24,7,5,61,34,27,79
Peterhead,9252,2,23,4,9,78,40,38,73
Stirling,9252,3,17,6,13,62,52,10,57
Clyde,9252,4,15,9,12,52,48,4,54
Stenhousem'r,9252,5,15,8,13,56,48,8,53
Elgin,9252,6,14,6,16,53,62,-9,48
Annan Athlet,9252,7,11,12,13,47,41,6,45
Berwick,9252,8,8,10,18,29,59,-30,34
Edinburgh Ci,9252,9,8,9,19,38,61,-23,33
Cowdenbeath,9252,10,4,11,21,23,54,-31,23
Montrose,9253,1,23,8,5,61,36,25,77
Peterhead,9253,2,24,4,8,82,41,41,76
Stirling,9253,3,16,7,13,62,53,9,55
Stenhousem'r,9253,4,15,9,12,57,48,9,54
Clyde,9253,5,14,10,12,53,50,3,52
Elgin,9253,6,14,7,15,55,62,-7,49
Annan Athlet,9253,7,12,11,13,50,43,7,47
Berwick,9253,8,8,11,17,31,60,-29,35
Edinburgh Ci,9253,9,7,9,20,39,65,-26,30
Cowdenbeath,9253,10,4,10,22,25,57,-32,22
Montrose,9254,1,23,7,6,60,36,24,76
Peterhead,9254,2,23,5,8,78,39,39,74
Stirling,9254,3,16,7,13,60,51,9,55
Stenhousem'r,9254,4,15,9,12,55,46,9,54
Clyde,9254,5,15,9,12,53,49,4,54
Elgin,9254,6,15,6,15,55,61,-6,51
Annan Athlet,9254,7,11,12,13,47,41,6,45
Berwick,9254,8,8,10,18,30,60,-30,34
Edinburgh Ci,9254,9,7,10,19,37,61,-24,31
Cowdenbeath,9254,10,4,11,21,23,54,-31,23
Montrose,9255,1,24,7,5,61,34,27,79
Peterhead,9255,2,24,4,8,81,39,42,76
Stirling,9255,3,17,6,13,62,52,10,57
Clyde,9255,4,15,9,12,53,48,5,54
Stenhousem'r,9255,5,15,8,13,56,48,8,53
Elgin,9255,6,14,6,16,53,62,-9,48
Annan Athlet,9255,7,12,11,13,48,41,7,47
Berwick,9255,8,8,10,18,29,60,-31,34
Edinburgh Ci,9255,9,7,9,20,37,64,-27,30
Cowdenbeath,9255,10,4,10,22,23,55,-32,22
Peterhead,9256,1,24,4,8,80,39,41,76
Montrose,9256,2,23,7,6,59,38,21,76
Stirling,9256,3,16,7,13,61,52,9,55
Stenhousem'r,9256,4,15,9,12,56,47,9,54
Clyde,9256,5,14,9,13,53,52,1,51
Elgin,9256,6,15,6,15,57,60,-3,51
Annan Athlet,9256,7,11,12,13,49,43,6,45
Berwick,9256,8,9,10,17,33,60,-27,37
Edinburgh Ci,9256,9,7,9,20,37,63,-26,30
Cowdenbeath,9256,10,4,11,21,25,56,-31,23
Montrose,9257,1,23,8,5,60,35,25,77
Peterhead,9257,2,24,4,8,80,38,42,76
Stenhousem'r,9257,3,16,8,12,57,47,10,56
Stirling,9257,4,16,6,14,61,53,8,54
Clyde,9257,5,14,10,12,52,49,3,52
Elgin,9257,6,14,7,15,54,61,-7,49
Annan Athlet,9257,7,11,12,13,48,42,6,45
Berwick,9257,8,8,11,17,30,59,-29,35
Edinburgh Ci,9257,9,7,9,20,36,63,-27,30
Cowdenbeath,9257,10,4,11,21,24,55,-31,23
Montrose,9258,1,24,7,5,64,34,30,79
Peterhead,9258,2,23,4,9,78,40,38,73
Stirling,9258,3,17,6,13,62,52,10,57
Clyde,9258,4,15,9,12,54,50,4,54
Stenhousem'r,9258,5,15,8,13,56,48,8,53
Elgin,9258,6,14,6,16,53,65,-12,48
Annan Athlet,9258,7,11,11,14,47,43,4,44
Berwick,9258,8,8,10,18,31,61,-30,34
Edinburgh Ci,9258,9,8,9,19,38,61,-23,33
Cowdenbeath,9258,10,5,10,21,25,54,-29,25
Montrose,9259,1,24,7,5,64,34,30,79
Peterhead,9259,2,23,5,8,77,38,39,74
Stirling,9259,3,17,6,13,62,52,10,57
Stenhousem'r,9259,4,15,8,13,56,48,8,53
Clyde,9259,5,14,10,12,51,48,3,52
Elgin,9259,6,14,6,16,53,65,-12,48
Annan Athlet,9259,7,11,11,14,47,44,3,44
Berwick,9259,8,8,11,17,29,58,-29,35
Edinburgh Ci,9259,9,7,10,19,36,60,-24,31
Cowdenbeath,9259,10,5,10,21,26,54,-28,25
Montrose,9260,1,24,7,5,62,34,28,79
Peterhead,9260,2,24,4,8,79,39,40,76
Stirling,9260,3,17,6,13,62,51,11,57
Clyde,9260,4,15,9,12,54,48,6,54
Stenhousem'r,9260,5,15,8,13,55,48,7,53
Elgin,9260,6,14,6,16,53,63,-10,48
Annan Athlet,9260,7,12,11,13,49,41,8,47
Berwick,9260,8,8,10,18,29,61,-32,34
Edinburgh Ci,9260,9,7,9,20,37,62,-25,30
Cowdenbeath,9260,10,4,10,22,23,56,-33,22
Montrose,9261,1,23,8,5,59,34,25,77
Peterhead,9261,2,24,4,8,81,38,43,76
Stirling,9261,3,16,7,13,62,53,9,55
Stenhousem'r,9261,4,15,9,12,57,48,9,54
Clyde,9261,5,14,9,13,52,52,0,51
Elgin,9261,6,14,7,15,53,60,-7,49
Annan Athlet,9261,7,11,12,13,48,42,6,45
Berwick,9261,8,9,10,17,33,59,-26,37
Edinburgh Ci,9261,9,7,9,20,36,64,-28,30
Cowdenbeath,9261,10,4,11,21,24,55,-31,23
Montrose,9262,1,24,7,5,63,36,27,79
Peterhead,9262,2,23,5,8,78,39,39,74
Stirling,9262,3,16,7,13,61,52,9,55
Stenhousem'r,9262,4,15,9,12,56,47,9,54
Clyde,9262,5,15,9,12,55,51,4,54
Elgin,9262,6,14,6,16,55,64,-9,48
Annan Athlet,9262,7,12,11,13,49,42,7,47
Berwick,9262,8,8,10,18,32,62,-30,34
Edinburgh Ci,9262,9,7,10,19,37,61,-24,31
Cowdenbeath,9262,10,4,10,22,24,56,-32,22
Montrose,9263,1,23,7,6,59,36,23,76
Peterhead,9263,2,23,5,8,78,39,39,74
Stirling,9263,3,17,6,13,62,51,11,57
Clyde,9263,4,15,9,12,55,51,4,54
Stenhousem'r,9263,5,15,8,13,55,48,7,53
Elgin,9263,6,15,6,15,55,60,-5,51
Annan Athlet,9263,7,11,12,13,47,41,6,45
Berwick,9263,8,8,10,18,32,62,-30,34
Edinburgh Ci,9263,9,7,10,19,37,61,-24,31
Cowdenbeath,9263,10,4,11,21,23,54,-31,23
Montrose,9264,1,24,7,5,63,34,29,79
Peterhead,9264,2,24,4,8,80,39,41,76
Stenhousem'r,9264,3,16,8,12,58,48,10,56
Stirling,9264,4,16,6,14,62,54,8,54
Clyde,9264,5,14,10,12,52,49,3,52
Elgin,9264,6,14,6,16,53,64,-11,48
Annan Athlet,9264,7,11,11,14,48,43,5,44
Berwick,9264,8,8,11,17,30,59,-29,35
Edinburgh Ci,9264,9,7,9,20,37,63,-26,30
Cowdenbeath,9264,10,5,10,21,25,55,-30,25
Montrose,9265,1,23,8,5,59,34,25,77
Peterhead,9265,2,24,4,8,80,38,42,76
Stirling,9265,3,17,6,13,64,52,12,57
Clyde,9265,4,15,9,12,53,49,4,54
Stenhousem'r,9265,5,15,8,13,56,50,6,53
Elgin,9265,6,14,7,15,53,60,-7,49
Annan Athlet,9265,7,12,11,13,49,42,7,47
Berwick,9265,8,8,10,18,30,60,-30,34
Edinburgh Ci,9265,9,7,9,20,36,63,-27,30
Cowdenbeath,9265,10,4,10,22,24,56,-32,22
Montrose,9266,1,23,8,5,60,35,25,77
Peterhead,9266,2,24,4,8,84,38,46,76
Stenhousem'r,9266,3,16,8,12,57,46,11,56
Stirling,9266,4,16,6,14,60,53,7,54
Clyde,9266,5,14,9,13,51,50,1,51
Elgin,9266,6,14,7,15,54,61,-7,49
Annan Athlet,9266,7,11,12,13,48,42,6,45
Berwick,9266,8,9,10,17,31,58,-27,37
Edinburgh Ci,9266,9,7,9,20,36,67,-31,30
Cowdenbeath,9266,10,4,11,21,24,55,-31,23
Peterhead,9267,1,24,4,8,80,39,41,76
Montrose,9267,2,23,7,6,60,36,24,76
Stirling,9267,3,16,7,13,62,53,9,55
Stenhousem'r,9267,4,15,9,12,57,48,9,54
Clyde,9267,5,15,9,12,52,48,4,54
Elgin,9267,6,15,6,15,55,61,-6,51
Annan Athlet,9267,7,11,12,13,48,42,6,45
Berwick,9267,8,8,10,18,29,59,-30,34
Edinburgh Ci,9267,9,7,9,20,37,63,-26,30
Cowdenbeath,9267,10,4,11,21,24,55,-31,23
Montrose,9268,1,23,7,6,59,36,23,76
Peterhead,9268,2,23,5,8,79,40,39,74
Stenhousem'r,9268,3,16,8,12,57,46,11,56
Stirling,9268,4,16,6,14,60,53,7,54
Clyde,9268,5,15,9,12,54,49,5,54
Elgin,9268,6,15,6,15,55,60,-5,51
Annan Athlet,9268,7,11,11,14,47,43,4,44
Berwick,9268,8,8,10,18,30,61,-31,34
Edinburgh Ci,9268,9,7,10,19,38,62,-24,31
Cowdenbeath,9268,10,5,10,21,25,54,-29,25
Montrose,9269,1,24,7,5,62,35,27,79
Peterhead,9269,2,24,4,8,80,38,42,76
Stenhousem'r,9269,3,16,8,12,56,46,10,56
Stirling,9269,4,16,6,14,60,52,8,54
Clyde,9269,5,15,9,12,54,48,6,54
Elgin,9269,6,14,6,16,54,63,-9,48
Annan Athlet,9269,7,11,12,13,49,43,6,45
Berwick,9269,8,8,10,18,29,61,-32,34
Edinburgh Ci,9269,9,7,9,20,36,63,-27,30
Cowdenbeath,9269,10,4,11,21,25,56,-31,23
Montrose,9270,1,24,7,5,62,36,26,79
Peterhead,9270,2,24,4,8,80,38,42,76
Stenhousem'r,9270,3,16,8,12,58,46,12,56
Stirling,9270,4,16,6,14,60,54,6,54
Clyde,9270,5,14,10,12,52,49,3,52
Elgin,9270,6,14,6,16,55,63,-8,48
Annan Athlet,9270,7,11,12,13,48,42,6,45
Berwick,9270,8,8,11,17,30,59,-29,35
Edinburgh Ci,9270,9,7,9,20,36,63,-27,30
Cowdenbeath,9270,10,4,11,21,24,55,-31,23
Montrose,9271,1,24,7,5,61,34,27,79
Peterhead,9271,2,24,4,8,79,38,41,76
Stirling,9271,3,16,7,13,61,52,9,55
Stenhousem'r,9271,4,15,9,12,56,47,9,54
Clyde,9271,5,15,9,12,55,49,6,54
Elgin,9271,6,14,6,16,53,62,-9,48
Annan Athlet,9271,7,11,11,14,47,42,5,44
Berwick,9271,8,8,10,18,30,62,-32,34
Edinburgh Ci,9271,9,7,9,20,36,62,-26,30
Cowdenbeath,9271,10,5,10,21,24,54,-30,25
Montrose,9272,1,24,7,5,61,35,26,79
Peterhead,9272,2,24,4,8,79,39,40,76
Stirling,9272,3,16,7,13,61,52,9,55
Stenhousem'r,9272,4,15,9,12,56,47,9,54
Clyde,9272,5,14,10,12,52,49,3,52
Elgin,9272,6,14,6,16,54,62,-8,48
Annan Athlet,9272,7,11,11,14,47,42,5,44
Berwick,9272,8,8,11,17,30,59,-29,35
Edinburgh Ci,9272,9,7,9,20,37,62,-25,30
Cowdenbeath,9272,10,5,10,21,24,54,-30,25
Peterhead,9273,1,24,4,8,80,39,41,76
Montrose,9273,2,23,7,6,60,36,24,76
Stirling,9273,3,17,6,13,62,52,10,57
Clyde,9273,4,15,9,12,53,49,4,54
Stenhousem'r,9273,5,15,8,13,56,48,8,53
Elgin,9273,6,15,6,15,55,61,-6,51
Annan Athlet,9273,7,12,11,13,49,42,7,47
Berwick,9273,8,8,10,18,30,60,-30,34
Edinburgh Ci,9273,9,7,9,20,37,63,-26,30
Cowdenbeath,9273,10,4,10,22,24,56,-32,22
Peterhead,9274,1,24,4,8,81,39,42,76
Montrose,9274,2,23,7,6,59,35,24,76
Stirling,9274,3,16,7,13,60,51,9,55
Stenhousem'r,9274,4,15,9,12,55,46,9,54
Clyde,9274,5,15,9,12,54,50,4,54
Elgin,9274,6,15,6,15,54,60,-6,51
Annan Athlet,9274,7,11,12,13,48,42,6,45
Berwick,9274,8,8,10,18,31,61,-30,34
Edinburgh Ci,9274,9,7,9,20,37,64,-27,30
Cowdenbeath,9274,10,4,11,21,24,55,-31,23
Montrose,9275,1,24,7,5,63,34,29,79
Peterhead,9275,2,24,4,8,80,38,42,76
Stenhousem'r,9275,3,16,8,12,57,47,10,56
Stirling,9275,4,16,6,14,61,53,8,54
Clyde,9275,5,15,9,12,52,48,4,54
Elgin,9275,6,14,6,16,53,64,-11,48
Annan Athlet,9275,7,12,11,13,50,41,9,47
Berwick,9275,8,8,10,18,29,59,-30,34
Edinburgh Ci,9275,9,7,9,20,36,63,-27,30
Cowdenbeath,9275,10,4,10,22,23,57,-34,22
Montrose,9276,1,24,7,5,61,34,27,79
Peterhead,9276,2,24,4,8,81,38,43,76
Stirling,9276,3,16,7,13,60,51,9,55
Stenhousem'r,9276,4,15,9,12,55,46,9,54
Clyde,9276,5,14,10,12,51,48,3,52
Elgin,9276,6,14,6,16,53,62,-9,48
Annan Athlet,9276,7,11,11,14,47,43,4,44
Berwick,9276,8,8,11,17,29,58,-29,35
Edinburgh Ci,9276,9,7,9,20,36,64,-28,30
Cowdenbeath,9276,10,5,10,21,25,54,-29,25
Montrose,9277,1,24,7,5,62,36,26,79
Peterhead,9277,2,24,4,8,78,38,40,76
Stenhousem'r,9277,3,16,8,12,56,46,10,56
Stirling,9277,4,16,6,14,60,52,8,54
Clyde,9277,5,15,9,12,53,48,5,54
Elgin,9277,6,14,6,16,55,63,-8,48
Annan Athlet,9277,7,12,11,13,49,42,7,47
Berwick,9277,8,8,10,18,29,60,-31,34
Edinburgh Ci,9277,9,7,9,20,36,61,-25,30
Cowdenbeath,9277,10,4,10,22,24,56,-32,22
Montrose,9278,1,23,8,5,59,34,25,77
Peterhead,9278,2,24,4,8,83,42,41,76
Stirling,9278,3,17,6,13,63,52,11,57
Stenhousem'r,9278,4,15,8,13,56,49,7,53
Clyde,9278,5,14,9,13,51,49,2,51
Elgin,9278,6,14,7,15,53,60,-7,49
Annan Athlet,9278,7,11,12,13,47,41,6,45
Berwick,9278,8,9,10,17,30,58,-28,37
Edinburgh Ci,9278,9,7,9,20,40,66,-26,30
Cowdenbeath,9278,10,4,11,21,23,54,-31,23
Montrose,9279,1,24,7,5,62,35,27,79
Peterhead,9279,2,23,5,8,78,39,39,74
Stirling,9279,3,17,6,13,64,52,12,57
Clyde,9279,4,15,9,12,56,52,4,54
Stenhousem'r,9279,5,15,8,13,56,50,6,53
Elgin,9279,6,14,6,16,54,63,-9,48
Annan Athlet,9279,7,11,11,14,47,43,4,44
Berwick,9279,8,8,10,18,33,63,-30,34
Edinburgh Ci,9279,9,7,10,19,37,61,-24,31
Cowdenbeath,9279,10,5,10,21,25,54,-29,25
Peterhead,9280,1,24,4,8,81,39,42,76
Montrose,9280,2,23,7,6,61,38,23,76
Stirling,9280,3,17,6,13,66,52,14,57
Clyde,9280,4,15,9,12,54,48,6,54
Stenhousem'r,9280,5,15,8,13,56,52,4,53
Elgin,9280,6,15,6,15,57,62,-5,51
Annan Athlet,9280,7,12,11,13,49,42,7,47
Berwick,9280,8,8,10,18,29,61,-32,34
Edinburgh Ci,9280,9,7,9,20,37,64,-27,30
Cowdenbeath,9280,10,4,10,22,24,56,-32,22
Peterhead,9281,1,24,4,8,83,40,43,76
Montrose,9281,2,23,7,6,60,36,24,76
Stirling,9281,3,17,6,13,64,52,12,57
Clyde,9281,4,15,9,12,53,49,4,54
Stenhousem'r,9281,5,15,8,13,56,50,6,53
Elgin,9281,6,15,6,15,55,61,-6,51
Annan Athlet,9281,7,12,11,13,48,41,7,47
Berwick,9281,8,8,10,18,30,60,-30,34
Edinburgh Ci,9281,9,7,9,20,38,66,-28,30
Cowdenbeath,9281,10,4,10,22,23,55,-32,22
Montrose,9282,1,24,7,5,64,35,29,79
Peterhead,9282,2,24,4,8,80,39,41,76
Stenhousem'r,9282,3,16,8,12,58,47,11,56
Stirling,9282,4,16,6,14,61,54,7,54
Clyde,9282,5,14,10,12,51,48,3,52
Elgin,9282,6,14,6,16,54,65,-11,48
Annan Athlet,9282,7,12,11,13,51,42,9,47
Berwick,9282,8,8,11,17,29,58,-29,35
Edinburgh Ci,9282,9,7,9,20,37,63,-26,30
Cowdenbeath,9282,10,4,10,22,24,58,-34,22
Montrose,9283,1,23,8,5,61,36,25,77
Peterhead,9283,2,24,4,8,79,39,40,76
Stirling,9283,3,16,7,13,61,52,9,55
Stenhousem'r,9283,4,15,9,12,56,47,9,54
Clyde,9283,5,14,10,12,51,48,3,52
Elgin,9283,6,14,7,15,55,62,-7,49
Annan Athlet,9283,7,11,11,14,47,45,2,44
Berwick,9283,8,8,11,17,29,58,-29,35
Edinburgh Ci,9283,9,7,9,20,37,62,-25,30
Cowdenbeath,9283,10,5,10,21,27,54,-27,25
Peterhead,9284,1,24,4,8,80,39,41,76
Montrose,9284,2,23,7,6,61,37,24,76
Stirling,9284,3,16,7,13,61,52,9,55
Stenhousem'r,9284,4,15,9,12,56,47,9,54
Clyde,9284,5,15,9,12,54,48,6,54
Elgin,9284,6,15,6,15,56,62,-6,51
Annan Athlet,9284,7,11,11,14,48,43,5,44
Berwick,9284,8,8,10,18,29,61,-32,34
Edinburgh Ci,9284,9,7,9,20,37,63,-26,30
Cowdenbeath,9284,10,5,10,21,25,55,-30,25
Montrose,9285,1,24,7,5,60,34,26,79
Peterhead,9285,2,23,4,9,78,40,38,73
Stirling,9285,3,16,7,13,62,53,9,55
Stenhousem'r,9285,4,15,9,12,57,48,9,54
Clyde,9285,5,15,9,12,58,50,8,54
Elgin,9285,6,14,6,16,53,61,-8,48
Annan Athlet,9285,7,12,11,13,49,42,7,47
Berwick,9285,8,8,10,18,31,65,-34,34
Edinburgh Ci,9285,9,8,9,19,38,61,-23,33
Cowdenbeath,9285,10,4,10,22,24,56,-32,22
Montrose,9286,1,24,7,5,62,34,28,79
Peterhead,9286,2,24,4,8,79,39,40,76
Stirling,9286,3,17,6,13,62,51,11,57
Clyde,9286,4,15,9,12,56,48,8,54
Stenhousem'r,9286,5,15,8,13,55,48,7,53
Elgin,9286,6,14,6,16,53,63,-10,48
Annan Athlet,9286,7,12,11,13,48,41,7,47
Berwick,9286,8,8,10,18,29,63,-34,34
Edinburgh Ci,9286,9,7,9,20,37,62,-25,30
Cowdenbeath,9286,10,4,10,22,23,55,-32,22
Montrose,9287,1,24,7,5,60,34,26,79
Peterhead,9287,2,24,4,8,78,38,40,76
Stirling,9287,3,17,6,13,62,52,10,57
Clyde,9287,4,15,9,12,52,48,4,54
Stenhousem'r,9287,5,15,8,13,56,48,8,53
Elgin,9287,6,14,6,16,53,61,-8,48
Annan Athlet,9287,7,12,11,13,49,42,7,47
Berwick,9287,8,8,10,18,29,59,-30,34
Edinburgh Ci,9287,9,7,9,20,36,61,-25,30
Cowdenbeath,9287,10,4,10,22,24,56,-32,22
Peterhead,9288,1,24,4,8,80,39,41,76
Montrose,9288,2,23,7,6,59,35,24,76
Stirling,9288,3,17,6,13,62,51,11,57
Stenhousem'r,9288,4,15,8,13,55,48,7,53
Clyde,9288,5,14,10,12,52,49,3,52
Elgin,9288,6,15,6,15,54,60,-6,51
Annan Athlet,9288,7,12,11,13,48,41,7,47
Berwick,9288,8,8,11,17,30,59,-29,35
Edinburgh Ci,9288,9,7,9,20,37,63,-26,30
Cowdenbeath,9288,10,4,10,22,23,55,-32,22
Peterhead,9289,1,24,4,8,79,39,40,76
Montrose,9289,2,23,7,6,60,36,24,76
Stirling,9289,3,16,7,13,61,52,9,55
Stenhousem'r,9289,4,15,9,12,56,47,9,54
Clyde,9289,5,14,10,12,52,49,3,52
Elgin,9289,6,15,6,15,55,61,-6,51
Annan Athlet,9289,7,11,11,14,48,43,5,44
Berwick,9289,8,8,11,17,30,59,-29,35
Edinburgh Ci,9289,9,7,9,20,37,62,-25,30
Cowdenbeath,9289,10,5,10,21,25,55,-30,25
Montrose,9290,1,24,7,5,61,34,27,79
Peterhead,9290,2,24,4,8,78,38,40,76
Stirling,9290,3,17,6,13,63,51,12,57
Stenhousem'r,9290,4,15,8,13,55,49,6,53
Clyde,9290,5,14,10,12,52,49,3,52
Elgin,9290,6,14,6,16,53,62,-9,48
Annan Athlet,9290,7,11,11,14,48,43,5,44
Berwick,9290,8,8,11,17,30,59,-29,35
Edinburgh Ci,9290,9,7,9,20,36,61,-25,30
Cowdenbeath,9290,10,5,10,21,25,55,-30,25
Montrose,9291,1,24,7,5,61,34,27,79
Peterhead,9291,2,23,5,8,78,39,39,74
Stenhousem'r,9291,3,16,8,12,57,47,10,56
Stirling,9291,4,16,6,14,61,53,8,54
Clyde,9291,5,14,10,12,52,49,3,52
Elgin,9291,6,14,6,16,53,62,-9,48
Annan Athlet,9291,7,11,11,14,48,43,5,44
Berwick,9291,8,8,11,17,30,59,-29,35
Edinburgh Ci,9291,9,7,10,19,37,61,-24,31
Cowdenbeath,9291,10,5,10,21,25,55,-30,25
Montrose,9292,1,23,8,5,60,35,25,77
Peterhead,9292,2,24,4,8,83,38,45,76
Stenhousem'r,9292,3,16,8,12,58,48,10,56
Stirling,9292,4,16,6,14,62,54,8,54
Clyde,9292,5,14,9,13,51,50,1,51
Elgin,9292,6,14,7,15,54,61,-7,49
Annan Athlet,9292,7,11,11,14,47,44,3,44
Berwick,9292,8,9,10,17,31,58,-27,37
Edinburgh Ci,9292,9,7,9,20,36,66,-30,30
Cowdenbeath,9292,10,5,10,21,26,54,-28,25
Montrose,9293,1,23,8,5,61,36,25,77
Peterhead,9293,2,24,4,8,79,39,40,76
Stirling,9293,3,16,7,13,61,52,9,55
Stenhousem'r,9293,4,15,9,12,56,47,9,54
Clyde,9293,5,14,10,12,51,48,3,52
Elgin,9293,6,14,7,15,55,62,-7,49
Annan Athlet,9293,7,11,11,14,48,43,5,44
Berwick,9293,8,8,11,17,29,58,-29,35
Edinburgh Ci,9293,9,7,9,20,37,62,-25,30
Cowdenbeath,9293,10,5,10,21,25,55,-30,25
Montrose,9294,1,23,8,5,61,36,25,77
Peterhead,9294,2,23,5,8,79,40,39,74
Stenhousem'r,9294,3,16,8,12,57,47,10,56
Stirling,9294,4,16,6,14,61,53,8,54
Clyde,9294,5,15,9,12,54,48,6,54
Elgin,9294,6,14,7,15,55,62,-7,49
Annan Athlet,9294,7,11,12,13,48,42,6,45
Berwick,9294,8,8,10,18,29,61,-32,34
Edinburgh Ci,9294,9,7,10,19,38,62,-24,31
Cowdenbeath,9294,10,4,11,21,24,55,-31,23
Montrose,9295,1,23,8,5,59,34,25,77
Peterhead,9295,2,24,4,8,81,38,43,76
Stenhousem'r,9295,3,16,8,12,59,47,12,56
Stirling,9295,4,16,6,14,61,55,6,54
Clyde,9295,5,14,9,13,51,49,2,51
Elgin,9295,6,14,7,15,53,60,-7,49
Annan Athlet,9295,7,12,11,13,48,41,7,47
Berwick,9295,8,9,10,17,30,58,-28,37
Edinburgh Ci,9295,9,7,9,20,36,64,-28,30
Cowdenbeath,9295,10,4,10,22,23,55,-32,22
Montrose,9296,1,24,7,5,63,34,29,79
Peterhead,9296,2,24,4,8,80,38,42,76
Stirling,9296,3,17,6,13,61,51,10,57
Clyde,9296,4,15,9,12,52,48,4,54
Stenhousem'r,9296,5,15,8,13,55,47,8,53
Elgin,9296,6,14,6,16,53,64,-11,48
Annan Athlet,9296,7,12,11,13,50,41,9,47
Berwick,9296,8,8,10,18,29,59,-30,34
Edinburgh Ci,9296,9,7,9,20,36,63,-27,30
Cowdenbeath,9296,10,4,10,22,23,57,-34,22
Montrose,9297,1,24,7,5,61,34,27,79
Peterhead,9297,2,24,4,8,80,39,41,76
Stirling,9297,3,17,6,13,63,52,11,57
Stenhousem'r,9297,4,15,8,13,56,49,7,53
Clyde,9297,5,14,10,12,51,48,3,52
Elgin,9297,6,14,6,16,53,62,-9,48
Annan Athlet,9297,7,11,12,13,47,41,6,45
Berwick,9297,8,8,11,17,29,58,-29,35
Edinburgh Ci,9297,9,7,9,20,37,63,-26,30
Cowdenbeath,9297,10,4,11,21,23,54,-31,23
Montrose,9298,1,24,7,5,62,34,28,79
Peterhead,9298,2,24,4,8,79,38,41,76
Stenhousem'r,9298,3,16,8,12,57,47,10,56
Stirling,9298,4,16,6,14,61,53,8,54
Clyde,9298,5,15,9,12,52,48,4,54
Elgin,9298,6,14,6,16,53,63,-10,48
Annan Athlet,9298,7,11,12,13,48,42,6,45
Berwick,9298,8,8,10,18,29,59,-30,34
Edinburgh Ci,9298,9,7,9,20,36,62,-26,30
Cowdenbeath,9298,10,4,11,21,24,55,-31,23
Montrose,9299,1,24,7,5,62,34,28,79
Peterhead,9299,2,23,5,8,78,39,39,74
Stirling,9299,3,17,6,13,62,52,10,57
Stenhousem'r,9299,4,15,8,13,56,48,8,53
Clyde,9299,5,14,10,12,51,48,3,52
Elgin,9299,6,14,6,16,53,63,-10,48
Annan Athlet,9299,7,11,11,14,47,42,5,44
Berwick,9299,8,8,11,17,29,58,-29,35
Edinburgh Ci,9299,9,7,10,19,37,61,-24,31
Cowdenbeath,9299,10,5,10,21,24,54,-30,25
Peterhead,9300,1,24,4,8,80,38,42,76
Montrose,9300,2,23,7,6,61,37,24,76
Stirling,9300,3,17,6,13,62,52,10,57
Clyde,9300,4,15,9,12,53,49,4,54
Stenhousem'r,9300,5,15,8,13,56,48,8,53
Elgin,9300,6,15,6,15,56,62,-6,51
Annan Athlet,9300,7,11,12,13,47,41,6,45
Berwick,9300,8,8,10,18,30,60,-30,34
Edinburgh Ci,9300,9,7,9,20,36,63,-27,30
Cowdenbeath,9300,10,4,11,21,23,54,-31,23
Montrose,9301,1,24,7,5,60,34,26,79
Peterhead,9301,2,24,4,8,82,38,44,76
Stirling,9301,3,17,6,13,65,51,14,57
Stenhousem'r,9301,4,15,8,13,55,51,4,53
Clyde,9301,5,14,10,12,52,49,3,52
Elgin,9301,6,14,6,16,53,61,-8,48
Annan Athlet,9301,7,12,11,13,48,41,7,47
Berwick,9301,8,8,11,17,30,59,-29,35
Edinburgh Ci,9301,9,7,9,20,36,65,-29,30
Cowdenbeath,9301,10,4,10,22,23,55,-32,22
Montrose,9302,1,23,8,5,61,36,25,77
Peterhead,9302,2,23,5,8,78,39,39,74
Stirling,9302,3,17,6,13,63,53,10,57
Clyde,9302,4,15,9,12,58,50,8,54
Stenhousem'r,9302,5,15,8,13,57,49,8,53
Elgin,9302,6,14,7,15,55,62,-7,49
Annan Athlet,9302,7,11,11,14,47,42,5,44
Berwick,9302,8,8,10,18,31,65,-34,34
Edinburgh Ci,9302,9,7,10,19,37,61,-24,31
Cowdenbeath,9302,10,5,10,21,24,54,-30,25
Montrose,9303,1,23,8,5,60,35,25,77
Peterhead,9303,2,24,4,8,78,38,40,76
Stenhousem'r,9303,3,16,8,12,59,47,12,56
Stirling,9303,4,16,6,14,61,55,6,54
Clyde,9303,5,15,9,12,53,49,4,54
Elgin,9303,6,14,7,15,54,61,-7,49
Annan Athlet,9303,7,11,11,14,47,42,5,44
Berwick,9303,8,8,10,18,30,60,-30,34
Edinburgh Ci,9303,9,7,9,20,36,61,-25,30
Cowdenbeath,9303,10,5,10,21,24,54,-30,25
Peterhead,9304,1,24,4,8,78,38,40,76
Montrose,9304,2,23,7,6,59,35,24,76
Stirling,9304,3,17,6,13,65,52,13,57
Clyde,9304,4,15,9,12,54,48,6,54
Stenhousem'r,9304,5,15,8,13,56,51,5,53
Elgin,9304,6,15,6,15,54,60,-6,51
Annan Athlet,9304,7,11,12,13,48,42,6,45
Berwick,9304,8,8,10,18,29,61,-32,34
Edinburgh Ci,9304,9,7,9,20,36,61,-25,30
Cowdenbeath,9304,10,4,11,21,24,55,-31,23
Montrose,9305,1,24,7,5,62,35,27,79
Peterhead,9305,2,24,4,8,78,38,40,76
Stirling,9305,3,17,6,13,62,51,11,57
Clyde,9305,4,15,9,12,55,50,5,54
Stenhousem'r,9305,5,15,8,13,55,48,7,53
Elgin,9305,6,14,6,16,54,63,-9,48
Annan Athlet,9305,7,11,12,13,48,42,6,45
Berwick,9305,8,8,10,18,31,62,-31,34
Edinburgh Ci,9305,9,7,9,20,36,61,-25,30
Cowdenbeath,9305,10,4,11,21,24,55,-31,23
Montrose,9306,1,24,7,5,63,35,28,79
Peterhead,9306,2,24,4,8,80,40,40,76
Stenhousem'r,9306,3,16,8,12,56,46,10,56
Stirling,9306,4,16,6,14,60,52,8,54
Clyde,9306,5,15,9,12,53,48,5,54
Elgin,9306,6,14,6,16,54,64,-10,48
Annan Athlet,9306,7,12,11,13,49,42,7,47
Berwick,9306,8,8,10,18,29,60,-31,34
Edinburgh Ci,9306,9,7,9,20,38,63,-25,30
Cowdenbeath,9306,10,4,10,22,24,56,-32,22
Montrose,9307,1,23,8,5,60,35,25,77
Peterhead,9307,2,24,4,8,80,38,42,76
Stirling,9307,3,17,6,13,62,52,10,57
Clyde,9307,4,15,9,12,53,49,4,54
Stenhousem'r,9307,5,15,8,13,56,48,8,53
Elgin,9307,6,14,7,15,54,61,-7,49
Annan Athlet,9307,7,11,11,14,48,43,5,44
Berwick,9307,8,8,10,18,30,60,-30,34
Edinburgh Ci,9307,9,7,9,20,36,63,-27,30
Cowdenbeath,9307,10,5,10,21,25,55,-30,25
Montrose,9308,1,24,7,5,63,35,28,79
Peterhead,9308,2,24,4,8,81,39,42,76
Stenhousem'r,9308,3,16,8,12,58,48,10,56
Stirling,9308,4,16,6,14,62,54,8,54
Clyde,9308,5,14,9,13,52,50,2,51
Elgin,9308,6,14,6,16,54,64,-10,48
Annan Athlet,9308,7,11,12,13,48,42,6,45
Berwick,9308,8,9,10,17,31,59,-28,37
Edinburgh Ci,9308,9,7,9,20,37,64,-27,30
Cowdenbeath,9308,10,4,11,21,24,55,-31,23
Montrose,9309,1,24,7,5,61,34,27,79
Peterhead,9309,2,24,4,8,80,39,41,76
Stirling,9309,3,17,6,13,61,51,10,57
Clyde,9309,4,15,9,12,55,48,7,54
Stenhousem'r,9309,5,15,8,13,55,47,8,53
Elgin,9309,6,14,6,16,53,62,-9,48
Annan Athlet,9309,7,11,11,14,48,43,5,44
Berwick,9309,8,8,10,18,29,62,-33,34
Edinburgh Ci,9309,9,7,9,20,37,63,-26,30
Cowdenbeath,9309,10,5,10,21,25,55,-30,25
Montrose,9310,1,24,7,5,61,34,27,79
Peterhead,9310,2,24,4,8,79,38,41,76
Stenhousem'r,9310,3,16,8,12,57,47,10,56
Stirling,9310,4,16,6,14,61,53,8,54
Clyde,9310,5,14,10,12,51,48,3,52
Elgin,9310,6,14,6,16,53,62,-9,48
Annan Athlet,9310,7,11,12,13,47,41,6,45
Berwick,9310,8,8,11,17,29,58,-29,35
Edinburgh Ci,9310,9,7,9,20,36,62,-26,30
Cowdenbeath,9310,10,4,11,21,23,54,-31,23
Montrose,9311,1,23,8,5,59,34,25,77
Peterhead,9311,2,24,4,8,79,39,40,76
Stenhousem'r,9311,3,16,8,12,56,46,10,56
Stirling,9311,4,16,6,14,60,52,8,54
Clyde,9311,5,14,9,13,51,49,2,51
Elgin,9311,6,14,7,15,53,60,-7,49
Annan Athlet,9311,7,11,11,14,47,45,2,44
Berwick,9311,8,9,10,17,30,58,-28,37
Edinburgh Ci,9311,9,7,9,20,37,62,-25,30
Cowdenbeath,9311,10,5,10,21,27,54,-27,25
Montrose,9312,1,24,7,5,62,34,28,79
Peterhead,9312,2,24,4,8,80,40,40,76
Stirling,9312,3,17,6,13,62,52,10,57
Stenhousem'r,9312,4,15,8,13,56,48,8,53
Clyde,9312,5,14,10,12,53,50,3,52
Elgin,9312,6,14,6,16,53,63,-10,48
Annan Athlet,9312,7,11,11,14,48,43,5,44
Berwick,9312,8,8,11,17,31,60,-29,35
Edinburgh Ci,9312,9,7,9,20,38,63,-25,30
Cowdenbeath,9312,10,5,10,21,25,55,-30,25
Montrose,9313,1,24,7,5,60,34,26,79
Peterhead,9313,2,24,4,8,83,38,45,76
Stirling,9313,3,16,7,13,62,53,9,55
Stenhousem'r,9313,4,15,9,12,57,48,9,54
Clyde,9313,5,14,10,12,51,48,3,52
Elgin,9313,6,14,6,16,53,61,-8,48
Annan Athlet,9313,7,11,11,14,47,42,5,44
Berwick,9313,8,8,11,17,29,58,-29,35
Edinburgh Ci,9313,9,7,9,20,36,66,-30,30
Cowdenbeath,9313,10,5,10,21,24,54,-30,25
Montrose,9314,1,23,8,5,60,35,25,77
Peterhead,9314,2,24,4,8,79,38,41,76
Stirling,9314,3,16,7,13,60,51,9,55
Stenhousem'r,9314,4,15,9,12,55,46,9,54
Clyde,9314,5,15,9,12,53,49,4,54
Elgin,9314,6,14,7,15,54,61,-7,49
Annan Athlet,9314,7,12,11,13,51,42,9,47
Berwick,9314,8,8,10,18,30,60,-30,34
Edinburgh Ci,9314,9,7,9,20,36,62,-26,30
Cowdenbeath,9314,10,4,10,22,24,58,-34,22
Montrose,9315,1,24,7,5,63,35,28,79
Peterhead,9315,2,24,4,8,81,39,42,76
Stirling,9315,3,16,7,13,61,52,9,55
Stenhousem'r,9315,4,15,9,12,56,47,9,54
Clyde,9315,5,14,9,13,52,50,2,51
Elgin,9315,6,14,6,16,54,64,-10,48
Annan Athlet,9315,7,12,11,13,51,43,8,47
Berwick,9315,8,9,10,17,31,59,-28,37
Edinburgh Ci,9315,9,7,9,20,37,64,-27,30
Cowdenbeath,9315,10,4,10,22,25,58,-33,22
Montrose,9316,1,24,7,5,61,35,26,79
Peterhead,9316,2,24,4,8,81,41,40,76
Stirling,9316,3,17,6,13,63,51,12,57
Clyde,9316,4,15,9,12,54,50,4,54
Stenhousem'r,9316,5,15,8,13,55,49,6,53
Elgin,9316,6,14,6,16,54,62,-8,48
Annan Athlet,9316,7,12,11,13,48,41,7,47
Berwick,9316,8,8,10,18,31,61,-30,34
Edinburgh Ci,9316,9,7,9,20,39,64,-25,30
Cowdenbeath,9316,10,4,10,22,23,55,-32,22
Montrose,9317,1,23,8,5,59,34,25,77
Peterhead,9317,2,24,4,8,79,38,41,76
Stenhousem'r,9317,3,16,8,12,58,48,10,56
Stirling,9317,4,16,6,14,62,54,8,54
Clyde,9317,5,14,9,13,51,50,1,51
Elgin,9317,6,14,7,15,53,60,-7,49
Annan Athlet,9317,7,12,11,13,49,42,7,47
Berwick,9317,8,9,10,17,31,58,-27,37
Edinburgh Ci,9317,9,7,9,20,36,62,-26,30
Cowdenbeath,9317,10,4,10,22,24,56,-32,22
Montrose,9318,1,24,7,5,60,34,26,79
Peterhead,9318,2,24,4,8,81,39,42,76
Stirling,9318,3,16,7,13,60,51,9,55
Stenhousem'r,9318,4,15,9,12,55,46,9,54
Clyde,9318,5,15,9,12,54,48,6,54
Elgin,9318,6,14,6,16,53,61,-8,48
Annan Athlet,9318,7,12,11,13,48,41,7,47
Berwick,9318,8,8,10,18,29,61,-32,34
Edinburgh Ci,9318,9,7,9,20,37,64,-27,30
Cowdenbeath,9318,10,4,10,22,23,55,-32,22
Montrose,9319,1,24,7,5,62,35,27,79
Peterhead,9319,2,24,4,8,80,38,42,76
Stirling,9319,3,16,7,13,62,53,9,55
Stenhousem'r,9319,4,15,9,12,57,48,9,54
Clyde,9319,5,15,9,12,53,48,5,54
Elgin,9319,6,14,6,16,54,63,-9,48
Annan Athlet,9319,7,12,11,13,49,41,8,47
Berwick,9319,8,8,10,18,29,60,-31,34
Edinburgh Ci,9319,9,7,9,20,36,63,-27,30
Cowdenbeath,9319,10,4,10,22,23,56,-33,22
Montrose,9320,1,23,8,5,62,37,25,77
Peterhead,9320,2,23,5,8,79,40,39,74
Stirling,9320,3,17,6,13,62,52,10,57
Clyde,9320,4,15,9,12,52,48,4,54
Stenhousem'r,9320,5,15,8,13,56,48,8,53
Elgin,9320,6,14,7,15,56,63,-7,49
Annan Athlet,9320,7,12,11,13,50,41,9,47
Berwick,9320,8,8,10,18,29,59,-30,34
Edinburgh Ci,9320,9,7,10,19,38,62,-24,31
Cowdenbeath,9320,10,4,10,22,23,57,-34,22
Montrose,9321,1,24,7,5,62,34,28,79
Peterhead,9321,2,24,4,8,80,39,41,76
Stirling,9321,3,16,7,13,62,53,9,55
Stenhousem'r,9321,4,15,9,12,57,48,9,54
Clyde,9321,5,14,10,12,52,49,3,52
Elgin,9321,6,14,6,16,53,63,-10,48
Annan Athlet,9321,7,11,12,13,48,42,6,45
Berwick,9321,8,8,11,17,30,59,-29,35
Edinburgh Ci,9321,9,7,9,20,37,63,-26,30
Cowdenbeath,9321,10,4,11,21,24,55,-31,23
Montrose,9322,1,24,7,5,64,36,28,79
Peterhead,9322,2,23,5,8,78,39,39,74
Stenhousem'r,9322,3,16,8,12,58,47,11,56
Stirling,9322,4,16,6,14,61,54,7,54
Clyde,9322,5,14,10,12,52,49,3,52
Elgin,9322,6,14,6,16,55,65,-10,48
Annan Athlet,9322,7,11,11,14,47,43,4,44
Berwick,9322,8,8,11,17,30,59,-29,35
Edinburgh Ci,9322,9,7,10,19,37,61,-24,31
Cowdenbeath,9322,10,5,10,21,25,54,-29,25
Montrose,9323,1,23,7,6,60,36,24,76
Peterhead,9323,2,23,4,9,77,40,37,73
Stirling,9323,3,17,6,13,62,51,11,57
Clyde,9323,4,15,9,12,52,48,4,54
Stenhousem'r,9323,5,15,8,13,55,48,7,53
Elgin,9323,6,15,6,15,55,61,-6,51
Annan Athlet,9323,7,11,11,14,47,42,5,44
Berwick,9323,8,8,10,18,29,59,-30,34
Edinburgh Ci,9323,9,8,9,19,38,60,-22,33
Cowdenbeath,9323,10,5,10,21,24,54,-30,25
Montrose,9324,1,23,7,6,60,36,24,76
Peterhead,9324,2,23,5,8,79,40,39,74
Stirling,9324,3,16,7,13,61,52,9,55
Stenhousem'r,9324,4,15,9,12,56,47,9,54
Clyde,9324,5,14,9,13,52,50,2,51
Elgin,9324,6,15,6,15,55,61,-6,51
Annan Athlet,9324,7,12,11,13,49,41,8,47
Berwick,9324,8,9,10,17,31,59,-28,37
Edinburgh Ci,9324,9,7,10,19,38,62,-24,31
Cowdenbeath,9324,10,4,10,22,23,56,-33,22
Montrose,9325,1,23,8,5,60,35,25,77
Peterhead,9325,2,24,4,8,79,38,41,76
Stirling,9325,3,17,6,13,62,52,10,57
Clyde,9325,4,15,9,12,55,48,7,54
Stenhousem'r,9325,5,15,8,13,56,48,8,53
Elgin,9325,6,14,7,15,54,61,-7,49
Annan Athlet,9325,7,11,11,14,48,43,5,44
Berwick,9325,8,8,10,18,29,62,-33,34
Edinburgh Ci,9325,9,7,9,20,36,62,-26,30
Cowdenbeath,9325,10,5,10,21,25,55,-30,25
Montrose,9326,1,23,8,5,60,35,25,77
Peterhead,9326,2,23,4,9,78,41,37,73
Stirling,9326,3,17,6,13,61,51,10,57
Clyde,9326,4,15,9,12,54,49,5,54
Stenhousem'r,9326,5,15,8,13,55,47,8,53
Elgin,9326,6,14,7,15,54,61,-7,49
Annan Athlet,9326,7,11,11,14,47,42,5,44
Berwick,9326,8,8,10,18,30,61,-31,34
Edinburgh Ci,9326,9,8,9,19,39,61,-22,33
Cowdenbeath,9326,10,5,10,21,24,54,-30,25
Montrose,9327,1,23,8,5,60,35,25,77
Peterhead,9327,2,24,4,8,78,38,40,76
Stirling,9327,3,16,7,13,63,54,9,55
Stenhousem'r,9327,4,15,9,12,58,49,9,54
Clyde,9327,5,14,10,12,53,50,3,52
Elgin,9327,6,14,7,15,54,61,-7,49
Annan Athlet,9327,7,12,11,13,49,42,7,47
Berwick,9327,8,8,11,17,31,60,-29,35
Edinburgh Ci,9327,9,7,9,20,36,61,-25,30
Cowdenbeath,9327,10,4,10,22,24,56,-32,22
Peterhead,9328,1,24,4,8,79,39,40,76
Montrose,9328,2,23,7,6,59,36,23,76
Stirling,9328,3,16,7,13,61,52,9,55
Stenhousem'r,9328,4,15,9,12,56,47,9,54
Clyde,9328,5,14,9,13,51,49,2,51
Elgin,9328,6,15,6,15,55,60,-5,51
Annan Athlet,9328,7,11,11,14,47,42,5,44
Berwick,9328,8,9,10,17,30,58,-28,37
Edinburgh Ci,9328,9,7,9,20,37,62,-25,30
Cowdenbeath,9328,10,5,10,21,24,54,-30,25
Montrose,9329,1,24,7,5,64,35,29,79
Peterhead,9329,2,24,4,8,82,39,43,76
Stenhousem'r,9329,3,16,8,12,59,46,13,56
Stirling,9329,4,16,6,14,60,55,5,54
Clyde,9329,5,15,9,12,52,48,4,54
Elgin,9329,6,14,6,16,54,65,-11,48
Annan Athlet,9329,7,11,11,14,47,42,5,44
Berwick,9329,8,8,10,18,29,59,-30,34
Edinburgh Ci,9329,9,7,9,20,37,65,-28,30
Cowdenbeath,9329,10,5,10,21,24,54,-30,25
Montrose,9330,1,24,7,5,64,35,29,79
Peterhead,9330,2,24,4,8,84,38,46,76
Stirling,9330,3,17,6,13,62,51,11,57
Stenhousem'r,9330,4,15,8,13,55,48,7,53
Clyde,9330,5,14,10,12,51,48,3,52
Elgin,9330,6,14,6,16,54,65,-11,48
Annan Athlet,9330,7,11,12,13,49,43,6,45
Berwick,9330,8,8,11,17,29,58,-29,35
Edinburgh Ci,9330,9,7,9,20,36,67,-31,30
Cowdenbeath,9330,10,4,11,21,25,56,-31,23
Peterhead,9331,1,24,4,8,79,39,40,76
Montrose,9331,2,23,7,6,59,36,23,76
Stirling,9331,3,17,6,13,62,52,10,57
Clyde,9331,4,15,9,12,52,48,4,54
Stenhousem'r,9331,5,15,8,13,56,48,8,53
Elgin,9331,6,15,6,15,55,60,-5,51
Annan Athlet,9331,7,11,11,14,47,44,3,44
Berwick,9331,8,8,10,18,29,59,-30,34
Edinburgh Ci,9331,9,7,9,20,37,62,-25,30
Cowdenbeath,9331,10,5,10,21,26,54,-28,25
Montrose,9332,1,23,7,6,60,37,23,76
Peterhead,9332,2,23,5,8,80,41,39,74
Stirling,9332,3,17,6,13,63,52,11,57
Clyde,9332,4,15,9,12,53,48,5,54
Stenhousem'r,9332,5,15,8,13,56,49,7,53
Elgin,9332,6,15,6,15,56,61,-5,51
Annan Athlet,9332,7,11,11,14,47,43,4,44
Berwick,9332,8,8,10,18,29,60,-31,34
Edinburgh Ci,9332,9,7,10,19,39,63,-24,31
Cowdenbeath,9332,10,5,10,21,25,54,-29,25
Montrose,9333,1,23,8,5,61,36,25,77
Peterhead,9333,2,23,4,9,79,41,38,73
Stirling,9333,3,17,6,13,62,52,10,57
Clyde,9333,4,15,9,12,52,48,4,54
Stenhousem'r,9333,5,15,8,13,56,48,8,53
Elgin,9333,6,14,7,15,55,62,-7,49
Annan Athlet,9333,7,12,11,13,49,42,7,47
Berwick,9333,8,8,10,18,29,59,-30,34
Edinburgh Ci,9333,9,8,9,19,39,62,-23,33
Cowdenbeath,9333,10,4,10,22,24,56,-32,22
Montrose,9334,1,23,8,5,60,35,25,77
Peterhead,9334,2,24,4,8,79,38,41,76
Stenhousem'r,9334,3,16,8,12,56,46,10,56
Stirling,9334,4,16,6,14,60,52,8,54
Clyde,9334,5,15,9,12,54,48,6,54
Elgin,9334,6,14,7,15,54,61,-7,49
Annan Athlet,9334,7,11,11,14,48,43,5,44
Berwick,9334,8,8,10,18,29,61,-32,34
Edinburgh Ci,9334,9,7,9,20,36,62,-26,30
Cowdenbeath,9334,10,5,10,21,25,55,-30,25
Montrose,9335,1,24,7,5,64,38,26,79
Peterhead,9335,2,24,4,8,79,39,40,76
Stenhousem'r,9335,3,16,8,12,56,46,10,56
Stirling,9335,4,16,6,14,60,52,8,54
Clyde,9335,5,15,9,12,52,48,4,54
Elgin,9335,6,14,6,16,57,65,-8,48
Annan Athlet,9335,7,12,11,13,49,41,8,47
Berwick,9335,8,8,10,18,29,59,-30,34
Edinburgh Ci,9335,9,7,9,20,37,62,-25,30
Cowdenbeath,9335,10,4,10,22,23,56,-33,22
Peterhead,9336,1,24,4,8,82,38,44,76
Montrose,9336,2,23,7,6,60,36,24,76
Stirling,9336,3,17,6,13,64,51,13,57
Clyde,9336,4,15,9,12,54,49,5,54
Stenhousem'r,9336,5,15,8,13,55,50,5,53
Elgin,9336,6,15,6,15,55,61,-6,51
Annan Athlet,9336,7,11,11,14,47,43,4,44
Berwick,9336,8,8,10,18,30,61,-31,34
Edinburgh Ci,9336,9,7,9,20,36,65,-29,30
Cowdenbeath,9336,10,5,10,21,25,54,-29,25
Montrose,9337,1,24,7,5,60,34,26,79
Peterhead,9337,2,24,4,8,79,38,41,76
Stirling,9337,3,17,6,13,64,51,13,57
Clyde,9337,4,15,9,12,57,50,7,54
Stenhousem'r,9337,5,15,8,13,55,50,5,53
Elgin,9337,6,14,6,16,53,61,-8,48
Annan Athlet,9337,7,11,12,13,47,41,6,45
Berwick,9337,8,8,10,18,31,64,-33,34
Edinburgh Ci,9337,9,7,9,20,36,62,-26,30
Cowdenbeath,9337,10,4,11,21,23,54,-31,23
Montrose,9338,1,24,7,5,63,35,28,79
Peterhead,9338,2,24,4,8,80,38,42,76
Stirling,9338,3,17,6,13,63,52,11,57
Stenhousem'r,9338,4,15,8,13,56,49,7,53
Clyde,9338,5,14,10,12,52,49,3,52
Elgin,9338,6,14,6,16,54,64,-10,48
Annan Athlet,9338,7,11,11,14,48,43,5,44
Berwick,9338,8,8,11,17,30,59,-29,35
Edinburgh Ci,9338,9,7,9,20,36,63,-27,30
Cowdenbeath,9338,10,5,10,21,25,55,-30,25
Montrose,9339,1,23,8,5,60,35,25,77
Peterhead,9339,2,24,4,8,80,40,40,76
Stenhousem'r,9339,3,16,8,12,57,47,10,56
Stirling,9339,4,16,6,14,61,53,8,54
Clyde,9339,5,15,9,12,54,50,4,54
Elgin,9339,6,14,7,15,54,61,-7,49
Annan Athlet,9339,7,11,12,13,48,42,6,45
Berwick,9339,8,8,10,18,31,61,-30,34
Edinburgh Ci,9339,9,7,9,20,38,63,-25,30
Cowdenbeath,9339,10,4,11,21,24,55,-31,23
Montrose,9340,1,23,8,5,60,35,25,77
Peterhead,9340,2,23,5,8,77,38,39,74
Stirling,9340,3,17,6,13,64,52,12,57
Stenhousem'r,9340,4,15,8,13,56,50,6,53
Clyde,9340,5,14,9,13,51,49,2,51
Elgin,9340,6,14,7,15,54,61,-7,49
Annan Athlet,9340,7,11,11,14,47,42,5,44
Berwick,9340,8,9,10,17,30,58,-28,37
Edinburgh Ci,9340,9,7,10,19,36,60,-24,31
Cowdenbeath,9340,10,5,10,21,24,54,-30,25
Montrose,9341,1,23,8,5,59,34,25,77
Peterhead,9341,2,24,4,8,79,39,40,76
Stirling,9341,3,17,6,13,62,51,11,57
Clyde,9341,4,15,9,12,52,48,4,54
Stenhousem'r,9341,5,15,8,13,55,48,7,53
Elgin,9341,6,14,7,15,53,60,-7,49
Annan Athlet,9341,7,12,11,13,49,42,7,47
Berwick,9341,8,8,10,18,29,59,-30,34
Edinburgh Ci,9341,9,7,9,20,37,62,-25,30
Cowdenbeath,9341,10,4,10,22,24,56,-32,22
Montrose,9342,1,24,7,5,60,34,26,79
Peterhead,9342,2,24,4,8,82,38,44,76
Stirling,9342,3,17,6,13,63,53,10,57
Stenhousem'r,9342,4,15,8,13,57,49,8,53
Clyde,9342,5,14,9,13,52,50,2,51
Elgin,9342,6,14,6,16,53,61,-8,48
Annan Athlet,9342,7,12,11,13,49,42,7,47
Berwick,9342,8,9,10,17,31,59,-28,37
Edinburgh Ci,9342,9,7,9,20,36,65,-29,30
Cowdenbeath,9342,10,4,10,22,24,56,-32,22
Montrose,9343,1,24,7,5,62,35,27,79
Peterhead,9343,2,24,4,8,79,38,41,76
Stirling,9343,3,17,6,13,63,51,12,57
Stenhousem'r,9343,4,15,8,13,55,49,6,53
Clyde,9343,5,14,9,13,52,50,2,51
Elgin,9343,6,14,6,16,54,63,-9,48
Annan Athlet,9343,7,11,11,14,48,43,5,44
Berwick,9343,8,9,10,17,31,59,-28,37
Edinburgh Ci,9343,9,7,9,20,36,62,-26,30
Cowdenbeath,9343,10,5,10,21,25,55,-30,25
Montrose,9344,1,24,7,5,62,35,27,79
Peterhead,9344,2,24,4,8,80,39,41,76
Stirling,9344,3,17,6,13,63,51,12,57
Stenhousem'r,9344,4,15,8,13,55,49,6,53
Clyde,9344,5,14,10,12,52,49,3,52
Elgin,9344,6,14,6,16,54,63,-9,48
Annan Athlet,9344,7,12,11,13,50,41,9,47
Berwick,9344,8,8,11,17,30,59,-29,35
Edinburgh Ci,9344,9,7,9,20,37,63,-26,30
Cowdenbeath,9344,10,4,10,22,23,57,-34,22
Montrose,9345,1,24,7,5,60,34,26,79
Peterhead,9345,2,24,4,8,82,39,43,76
Stirling,9345,3,16,7,13,61,52,9,55
Stenhousem'r,9345,4,15,9,12,56,47,9,54
Clyde,9345,5,14,9,13,51,49,2,51
Elgin,9345,6,14,6,16,53,61,-8,48
Annan Athlet,9345,7,11,12,13,48,42,6,45
Berwick,9345,8,9,10,17,30,58,-28,37
Edinburgh Ci,9345,9,7,9,20,37,65,-28,30
Cowdenbeath,9345,10,4,11,21,24,55,-31,23
Montrose,9346,1,23,8,5,61,36,25,77
Peterhead,9346,2,24,4,8,83,40,43,76
Stirling,9346,3,17,6,13,65,51,14,57
Clyde,9346,4,15,9,12,53,49,4,54
Stenhousem'r,9346,5,15,8,13,55,51,4,53
Elgin,9346,6,14,7,15,55,62,-7,49
Annan Athlet,9346,7,11,11,14,47,42,5,44
Berwick,9346,8,8,10,18,30,60,-30,34
Edinburgh Ci,9346,9,7,9,20,38,66,-28,30
Cowdenbeath,9346,10,5,10,21,24,54,-30,25
Montrose,9347,1,24,7,5,63,35,28,79
Peterhead,9347,2,24,4,8,79,38,41,76
Stirling,9347,3,17,6,13,63,52,11,57
Clyde,9347,4,15,9,12,54,48,6,54
Stenhousem'r,9347,5,15,8,13,56,49,7,53
Elgin,9347,6,14,6,16,54,64,-10,48
Annan Athlet,9347,7,11,12,13,47,41,6,45
Berwick,9347,8,8,10,18,29,61,-32,34
Edinburgh Ci,9347,9,7,9,20,36,62,-26,30
Cowdenbeath,9347,10,4,11,21,23,54,-31,23
Montrose,9348,1,23,8,5,59,34,25,77
Peterhead,9348,2,24,4,8,84,38,46,76
Stenhousem'r,9348,3,16,8,12,58,46,12,56
Stirling,9348,4,16,6,14,60,54,6,54
Clyde,9348,5,15,9,12,53,48,5,54
Elgin,9348,6,14,7,15,53,60,-7,49
Annan Athlet,9348,7,11,11,14,47,42,5,44
Berwick,9348,8,8,10,18,29,60,-31,34
Edinburgh Ci,9348,9,7,9,20,36,67,-31,30
Cowdenbeath,9348,10,5,10,21,24,54,-30,25
Montrose,9349,1,24,7,5,62,34,28,79
Peterhead,9349,2,23,4,9,78,41,37,73
Stenhousem'r,9349,3,16,8,12,56,46,10,56
Stirling,9349,4,16,6,14,60,52,8,54
Clyde,9349,5,15,9,12,53,48,5,54
Elgin,9349,6,14,6,16,53,63,-10,48
Annan Athlet,9349,7,12,11,13,49,41,8,47
Berwick,9349,8,8,10,18,29,60,-31,34
Edinburgh Ci,9349,9,8,9,19,39,61,-22,33
Cowdenbeath,9349,10,4,10,22,23,56,-33,22
Montrose,9350,1,23,8,5,62,37,25,77
Peterhead,9350,2,24,4,8,81,39,42,76
Stirling,9350,3,17,6,13,63,51,12,57
Clyde,9350,4,15,9,12,53,48,5,54
Stenhousem'r,9350,5,15,8,13,55,49,6,53
Elgin,9350,6,14,7,15,56,63,-7,49
Annan Athlet,9350,7,11,12,13,47,41,6,45
Berwick,9350,8,8,10,18,29,60,-31,34
Edinburgh Ci,9350,9,7,9,20,37,64,-27,30
Cowdenbeath,9350,10,4,11,21,23,54,-31,23
Montrose,9351,1,23,8,5,60,35,25,77
Peterhead,9351,2,24,4,8,79,39,40,76
Stirling,9351,3,16,7,13,63,54,9,55
Stenhousem'r,9351,4,15,9,12,58,49,9,54
Clyde,9351,5,15,9,12,53,48,5,54
Elgin,9351,6,14,7,15,54,61,-7,49
Annan Athlet,9351,7,12,11,13,52,42,10,47
Berwick,9351,8,8,10,18,29,60,-31,34
Edinburgh Ci,9351,9,7,9,20,37,62,-25,30
Cowdenbeath,9351,10,4,10,22,24,59,-35,22
Montrose,9352,1,24,7,5,63,35,28,79
Peterhead,9352,2,24,4,8,78,38,40,76
Stirling,9352,3,17,6,13,63,52,11,57
Clyde,9352,4,15,9,12,52,48,4,54
Stenhousem'r,9352,5,15,8,13,56,49,7,53
Elgin,9352,6,14,6,16,54,64,-10,48
Annan Athlet,9352,7,11,12,13,47,41,6,45
Berwick,9352,8,8,10,18,29,59,-30,34
Edinburgh Ci,9352,9,7,9,20,36,61,-25,30
Cowdenbeath,9352,10,4,11,21,23,54,-31,23
Montrose,9353,1,24,7,5,62,35,27,79
Peterhead,9353,2,24,4,8,80,38,42,76
Stirling,9353,3,17,6,13,61,51,10,57
Stenhousem'r,9353,4,15,8,13,55,47,8,53
Clyde,9353,5,14,10,12,52,49,3,52
Elgin,9353,6,14,6,16,54,63,-9,48
Annan Athlet,9353,7,11,11,14,47,42,5,44
Berwick,9353,8,8,11,17,30,59,-29,35
Edinburgh Ci,9353,9,7,9,20,36,63,-27,30
Cowdenbeath,9353,10,5,10,21,24,54,-30,25
Montrose,9354,1,24,7,5,61,35,26,79
Peterhead,9354,2,24,4,8,81,39,42,76
Stirling,9354,3,17,6,13,62,52,10,57
Clyde,9354,4,15,9,12,53,48,5,54
Stenhousem'r,9354,5,15,8,13,56,48,8,53
Elgin,9354,6,14,6,16,54,62,-8,48
Annan Athlet,9354,7,11,11,14,48,43,5,44
Berwick,9354,8,8,10,18,29,60,-31,34
Edinburgh Ci,9354,9,7,9,20,37,64,-27,30
Cowdenbeath,9354,10,5,10,21,25,55,-30,25
Peterhead,9355,1,24,4,8,82,38,44,76
Montrose,9355,2,23,7,6,59,35,24,76
Stirling,9355,3,17,6,13,61,51,10,57
Clyde,9355,4,15,9,12,52,48,4,54
Stenhousem'r,9355,5,15,8,13,55,47,8,53
Elgin,9355,6,15,6,15,54,60,-6,51
Annan Athlet,9355,7,12,11,13,49,41,8,47
Berwick,9355,8,8,10,18,29,59,-30,34
Edinburgh Ci,9355,9,7,9,20,36,65,-29,30
Cowdenbeath,9355,10,4,10,22,23,56,-33,22
Montrose,9356,1,24,7,5,61,34,27,79
Peterhead,9356,2,23,4,9,77,39,38,73
Stirling,9356,3,17,6,13,63,52,11,57
Clyde,9356,4,15,9,12,52,48,4,54
Stenhousem'r,9356,5,15,8,13,56,49,7,53
Elgin,9356,6,14,6,16,53,62,-9,48
Annan Athlet,9356,7,11,12,13,47,41,6,45
Berwick,9356,8,8,10,18,29,59,-30,34
Edinburgh Ci,9356,9,8,9,19,37,60,-23,33
Cowdenbeath,9356,10,4,11,21,23,54,-31,23
Montrose,9357,1,24,7,5,64,34,30,79
Peterhead,9357,2,23,5,8,79,40,39,74
Stirling,9357,3,17,6,13,62,51,11,57
Stenhousem'r,9357,4,15,8,13,55,48,7,53
Clyde,9357,5,14,10,12,53,50,3,52
Elgin,9357,6,14,6,16,53,65,-12,48
Annan Athlet,9357,7,11,12,13,48,42,6,45
Berwick,9357,8,8,11,17,31,60,-29,35
Edinburgh Ci,9357,9,7,10,19,38,62,-24,31
Cowdenbeath,9357,10,4,11,21,24,55,-31,23
Peterhead,9358,1,24,4,8,81,39,42,76
Montrose,9358,2,23,7,6,60,36,24,76
Stenhousem'r,9358,3,16,8,12,57,47,10,56
Stirling,9358,4,16,6,14,61,53,8,54
Clyde,9358,5,14,9,13,52,50,2,51
Elgin,9358,6,15,6,15,55,61,-6,51
Annan Athlet,9358,7,12,11,13,49,42,7,47
Berwick,9358,8,9,10,17,31,59,-28,37
Edinburgh Ci,9358,9,7,9,20,37,64,-27,30
Cowdenbeath,9358,10,4,10,22,24,56,-32,22
Montrose,9359,1,24,7,5,63,35,28,79
Peterhead,9359,2,24,4,8,81,41,40,76
Stirling,9359,3,17,6,13,64,53,11,57
Stenhousem'r,9359,4,15,8,13,57,50,7,53
Clyde,9359,5,14,9,13,51,49,2,51
Elgin,9359,6,14,6,16,54,64,-10,48
Annan Athlet,9359,7,12,11,13,49,41,8,47
Berwick,9359,8,9,10,17,30,58,-28,37
Edinburgh Ci,9359,9,7,9,20,39,64,-25,30
Cowdenbeath,9359,10,4,10,22,23,56,-33,22
Peterhead,9360,1,24,4,8,81,38,43,76
Montrose,9360,2,23,7,6,61,37,24,76
Stirling,9360,3,16,7,13,61,52,9,55
Stenhousem'r,9360,4,15,9,12,56,47,9,54
Clyde,9360,5,14,10,12,52,49,3,52
Elgin,9360,6,15,6,15,56,62,-6,51
Annan Athlet,9360,7,11,12,13,48,42,6,45
Berwick,9360,8,8,11,17,30,59,-29,35
Edinburgh Ci,9360,9,7,9,20,36,64,-28,30
Cowdenbeath,9360,10,4,11,21,24,55,-31,23
Montrose,9361,1,24,7,5,61,34,27,79
Peterhead,9361,2,23,5,8,78,39,39,74
Stenhousem'r,9361,3,16,8,12,57,46,11,56
Stirling,9361,4,16,6,14,60,53,7,54
Clyde,9361,5,15,9,12,55,49,6,54
Elgin,9361,6,14,6,16,53,62,-9,48
Annan Athlet,9361,7,12,11,13,49,41,8,47
Berwick,9361,8,8,10,18,30,62,-32,34
Edinburgh Ci,9361,9,7,10,19,37,61,-24,31
Cowdenbeath,9361,10,4,10,22,23,56,-33,22
Montrose,9362,1,24,7,5,62,34,28,79
Peterhead,9362,2,24,4,8,78,38,40,76
Stirling,9362,3,17,6,13,64,51,13,57
Clyde,9362,4,15,9,12,58,48,10,54
Stenhousem'r,9362,5,15,8,13,55,50,5,53
Elgin,9362,6,14,6,16,53,63,-10,48
Annan Athlet,9362,7,11,11,14,48,43,5,44
Berwick,9362,8,8,10,18,29,65,-36,34
Edinburgh Ci,9362,9,7,9,20,36,61,-25,30
Cowdenbeath,9362,10,5,10,21,25,55,-30,25
Montrose,9363,1,24,7,5,62,34,28,79
Peterhead,9363,2,24,4,8,79,38,41,76
Stirling,9363,3,17,6,13,62,51,11,57
Clyde,9363,4,15,9,12,56,49,7,54
Stenhousem'r,9363,5,15,8,13,55,48,7,53
Elgin,9363,6,14,6,16,53,63,-10,48
Annan Athlet,9363,7,12,11,13,49,42,7,47
Berwick,9363,8,8,10,18,30,63,-33,34
Edinburgh Ci,9363,9,7,9,20,36,62,-26,30
Cowdenbeath,9363,10,4,10,22,24,56,-32,22
Montrose,9364,1,23,8,5,61,36,25,77
Peterhead,9364,2,24,4,8,81,40,41,76
Stirling,9364,3,17,6,13,63,53,10,57
Clyde,9364,4,15,9,12,54,49,5,54
Stenhousem'r,9364,5,15,8,13,57,49,8,53
Elgin,9364,6,14,7,15,55,62,-7,49
Annan Athlet,9364,7,12,11,13,48,41,7,47
Berwick,9364,8,8,10,18,30,61,-31,34
Edinburgh Ci,9364,9,7,9,20,38,64,-26,30
Cowdenbeath,9364,10,4,10,22,23,55,-32,22
Montrose,9365,1,24,7,5,61,35,26,79
Peterhead,9365,2,24,4,8,78,38,40,76
Stirling,9365,3,16,7,13,61,52,9,55
Stenhousem'r,9365,4,15,9,12,56,47,9,54
Clyde,9365,5,15,9,12,53,49,4,54
Elgin,9365,6,14,6,16,54,62,-8,48
Annan Athlet,9365,7,11,11,14,48,43,5,44
Berwick,9365,8,8,10,18,30,60,-30,34
Edinburgh Ci,9365,9,7,9,20,36,61,-25,30
Cowdenbeath,9365,10,5,10,21,25,55,-30,25
Peterhead,9366,1,24,4,8,80,38,42,76
Montrose,9366,2,23,7,6,61,37,24,76
Stirling,9366,3,17,6,13,64,52,12,57
Stenhousem'r,9366,4,15,8,13,56,50,6,53
Clyde,9366,5,14,9,13,51,49,2,51
Elgin,9366,6,15,6,15,56,62,-6,51
Annan Athlet,9366,7,11,11,14,48,43,5,44
Berwick,9366,8,9,10,17,30,58,-28,37
Edinburgh Ci,9366,9,7,9,20,36,63,-27,30
Cowdenbeath,9366,10,5,10,21,25,55,-30,25
Montrose,9367,1,24,7,5,62,34,28,79
Peterhead,9367,2,23,4,9,78,42,36,73
Stirling,9367,3,17,6,13,66,54,12,57
Clyde,9367,4,15,9,12,53,48,5,54
Stenhousem'r,9367,5,15,8,13,58,52,6,53
Elgin,9367,6,14,6,16,53,63,-10,48
Annan Athlet,9367,7,12,11,13,50,42,8,47
Berwick,9367,8,8,10,18,29,60,-31,34
Edinburgh Ci,9367,9,8,9,19,40,61,-21,33
Cowdenbeath,9367,10,4,10,22,24,57,-33,22
Montrose,9368,1,24,7,5,62,35,27,79
Peterhead,9368,2,24,4,8,78,38,40,76
Stirling,9368,3,16,7,13,60,51,9,55
Stenhousem'r,9368,4,15,9,12,55,46,9,54
Clyde,9368,5,15,9,12,52,48,4,54
Elgin,9368,6,14,6,16,54,63,-9,48
Annan Athlet,9368,7,12,11,13,49,41,8,47
Berwick,9368,8,8,10,18,29,59,-30,34
Edinburgh Ci,9368,9,7,9,20,36,61,-25,30
Cowdenbeath,9368,10,4,10,22,23,56,-33,22
Montrose,9369,1,24,7,5,60,34,26,79
Peterhead,9369,2,24,4,8,78,38,40,76
Stirling,9369,3,17,6,13,62,52,10,57
Clyde,9369,4,15,9,12,56,50,6,54
Stenhousem'r,9369,5,15,8,13,56,48,8,53
Elgin,9369,6,14,6,16,53,61,-8,48
Annan Athlet,9369,7,12,11,13,49,41,8,47
Berwick,9369,8,8,10,18,31,63,-32,34
Edinburgh Ci,9369,9,7,9,20,36,61,-25,30
Cowdenbeath,9369,10,4,10,22,23,56,-33,22
Peterhead,9370,1,24,4,8,79,38,41,76
Montrose,9370,2,23,7,6,59,37,22,76
Stirling,9370,3,17,6,13,62,52,10,57
Clyde,9370,4,15,9,12,52,48,4,54
Stenhousem'r,9370,5,15,8,13,56,48,8,53
Elgin,9370,6,15,6,15,56,60,-4,51
Annan Athlet,9370,7,12,11,13,50,43,7,47
Berwick,9370,8,8,10,18,29,59,-30,34
Edinburgh Ci,9370,9,7,9,20,36,62,-26,30
Cowdenbeath,9370,10,4,10,22,25,57,-32,22
Montrose,9371,1,24,7,5,62,34,28,79
Peterhead,9371,2,24,4,8,80,39,41,76
Stirling,9371,3,17,6,13,61,51,10,57
Clyde,9371,4,15,9,12,56,48,8,54
Stenhousem'r,9371,5,15,8,13,55,47,8,53
Elgin,9371,6,14,6,16,53,63,-10,48
Annan Athlet,9371,7,11,12,13,47,41,6,45
Berwick,9371,8,8,10,18,29,63,-34,34
Edinburgh Ci,9371,9,7,9,20,37,63,-26,30
Cowdenbeath,9371,10,4,11,21,23,54,-31,23
Montrose,9372,1,23,7,6,59,35,24,76
Peterhead,9372,2,23,5,8,77,38,39,74
Stirling,9372,3,16,7,13,61,52,9,55
Stenhousem'r,9372,4,15,9,12,56,47,9,54
Clyde,9372,5,15,9,12,54,48,6,54
Elgin,9372,6,15,6,15,54,60,-6,51
Annan Athlet,9372,7,12,11,13,48,41,7,47
Berwick,9372,8,8,10,18,29,61,-32,34
Edinburgh Ci,9372,9,7,10,19,36,60,-24,31
Cowdenbeath,9372,10,4,10,22,23,55,-32,22
Montrose,9373,1,24,7,5,61,35,26,79
Peterhead,9373,2,24,4,8,79,38,41,76
Stenhousem'r,9373,3,16,8,12,59,49,10,56
Stirling,9373,4,16,6,14,63,55,8,54
Clyde,9373,5,14,9,13,52,50,2,51
Elgin,9373,6,14,6,16,54,62,-8,48
Annan Athlet,9373,7,11,11,14,47,42,5,44
Berwick,9373,8,9,10,17,31,59,-28,37
Edinburgh Ci,9373,9,7,9,20,36,62,-26,30
Cowdenbeath,9373,10,5,10,21,24,54,-30,25
Montrose,9374,1,24,7,5,61,34,27,79
Peterhead,9374,2,24,4,8,80,40,40,76
Stirling,9374,3,16,7,13,61,52,9,55
Stenhousem'r,9374,4,15,9,12,56,47,9,54
Clyde,9374,5,14,9,13,51,49,2,51
Elgin,9374,6,14,6,16,53,62,-9,48
Annan Athlet,9374,7,12,11,13,49,42,7,47
Berwick,9374,8,9,10,17,30,58,-28,37
Edinburgh Ci,9374,9,7,9,20,38,63,-25,30
Cowdenbeath,9374,10,4,10,22,24,56,-32,22
Montrose,9375,1,24,7,5,60,34,26,79
Peterhead,9375,2,24,4,8,79,38,41,76
Stenhousem'r,9375,3,16,8,12,58,48,10,56
Stirling,9375,4,16,6,14,62,54,8,54
Clyde,9375,5,14,9,13,52,50,2,51
Elgin,9375,6,14,6,16,53,61,-8,48
Annan Athlet,9375,7,11,11,14,48,45,3,44
Berwick,9375,8,9,10,17,31,59,-28,37
Edinburgh Ci,9375,9,7,9,20,36,62,-26,30
Cowdenbeath,9375,10,5,10,21,27,55,-28,25
Montrose,9376,1,24,7,5,62,36,26,79
Peterhead,9376,2,23,4,9,78,40,38,73
Stirling,9376,3,17,6,13,63,52,11,57
Clyde,9376,4,15,9,12,54,49,5,54
Stenhousem'r,9376,5,15,8,13,56,49,7,53
Elgin,9376,6,14,6,16,55,63,-8,48
Annan Athlet,9376,7,11,12,13,47,41,6,45
Berwick,9376,8,8,10,18,30,61,-31,34
Edinburgh Ci,9376,9,8,9,19,38,61,-23,33
Cowdenbeath,9376,10,4,11,21,23,54,-31,23
Montrose,9377,1,23,8,5,60,35,25,77
Peterhead,9377,2,24,4,8,80,39,41,76
Stenhousem'r,9377,3,16,8,12,58,47,11,56
Stirling,9377,4,16,6,14,61,54,7,54
Clyde,9377,5,15,9,12,53,48,5,54
Elgin,9377,6,14,7,15,54,61,-7,49
Annan Athlet,9377,7,11,12,13,48,42,6,45
Berwick,9377,8,8,10,18,29,60,-31,34
Edinburgh Ci,9377,9,7,9,20,37,63,-26,30
Cowdenbeath,9377,10,4,11,21,24,55,-31,23
Montrose,9378,1,23,7,6,59,35,24,76
Peterhead,9378,2,23,5,8,79,40,39,74
Stenhousem'r,9378,3,16,8,12,59,46,13,56
Stirling,9378,4,16,6,14,60,55,5,54
Clyde,9378,5,14,9,13,51,51,0,51
Elgin,9378,6,15,6,15,54,60,-6,51
Annan Athlet,9378,7,11,12,13,48,42,6,45
Berwick,9378,8,9,10,17,32,58,-26,37
Edinburgh Ci,9378,9,7,10,19,38,62,-24,31
Cowdenbeath,9378,10,4,11,21,24,55,-31,23
Montrose,9379,1,23,8,5,61,36,25,77
Peterhead,9379,2,24,4,8,79,38,41,76
Stirling,9379,3,16,7,13,61,52,9,55
Stenhousem'r,9379,4,15,9,12,56,47,9,54
Clyde,9379,5,15,9,12,52,48,4,54
Elgin,9379,6,14,7,15,55,62,-7,49
Annan Athlet,9379,7,11,11,14,47,42,5,44
Berwick,9379,8,8,10,18,29,59,-30,34
Edinburgh Ci,9379,9,7,9,20,36,62,-26,30
Cowdenbeath,9379,10,5,10,21,24,54,-30,25
Montrose,9380,1,23,8,5,61,36,25,77
Peterhead,9380,2,24,4,8,79,38,41,76
Stirling,9380,3,17,6,13,61,51,10,57
Stenhousem'r,9380,4,15,8,13,55,47,8,53
Clyde,9380,5,14,10,12,53,50,3,52
Elgin,9380,6,14,7,15,55,62,-7,49
Annan Athlet,9380,7,11,11,14,47,44,3,44
Berwick,9380,8,8,11,17,31,60,-29,35
Edinburgh Ci,9380,9,7,9,20,36,62,-26,30
Cowdenbeath,9380,10,5,10,21,26,54,-28,25
Montrose,9381,1,23,8,5,59,34,25,77
Peterhead,9381,2,24,4,8,82,39,43,76
Stirling,9381,3,16,7,13,60,51,9,55
Stenhousem'r,9381,4,15,9,12,55,46,9,54
Clyde,9381,5,15,9,12,55,48,7,54
Elgin,9381,6,14,7,15,53,60,-7,49
Annan Athlet,9381,7,12,11,13,50,43,7,47
Berwick,9381,8,8,10,18,29,62,-33,34
Edinburgh Ci,9381,9,7,9,20,37,65,-28,30
Cowdenbeath,9381,10,4,10,22,25,57,-32,22
Montrose,9382,1,23,8,5,60,35,25,77
Peterhead,9382,2,24,4,8,78,38,40,76
Stirling,9382,3,17,6,13,62,51,11,57
Clyde,9382,4,15,9,12,55,48,7,54
Stenhousem'r,9382,5,15,8,13,55,48,7,53
Elgin,9382,6,14,7,15,54,61,-7,49
Annan Athlet,9382,7,12,11,13,49,42,7,47
Berwick,9382,8,8,10,18,29,62,-33,34
Edinburgh Ci,9382,9,7,9,20,36,61,-25,30
Cowdenbeath,9382,10,4,10,22,24,56,-32,22
Montrose,9383,1,23,7,6,59,36,23,76
Peterhead,9383,2,23,5,8,78,39,39,74
Stenhousem'r,9383,3,16,8,12,57,46,11,56
Stirling,9383,4,16,6,14,60,53,7,54
Clyde,9383,5,14,10,12,52,49,3,52
Elgin,9383,6,15,6,15,55,60,-5,51
Annan Athlet,9383,7,11,12,13,48,42,6,45
Berwick,9383,8,8,11,17,30,59,-29,35
Edinburgh Ci,9383,9,7,10,19,37,61,-24,31
Cowdenbeath,9383,10,4,11,21,24,55,-31,23
Montrose,9384,1,23,8,5,60,35,25,77
Peterhead,9384,2,24,4,8,81,38,43,76
Stenhousem'r,9384,3,16,8,12,57,46,11,56
Stirling,9384,4,16,6,14,60,53,7,54
Clyde,9384,5,14,9,13,52,51,1,51
Elgin,9384,6,14,7,15,54,61,-7,49
Annan Athlet,9384,7,11,11,14,47,43,4,44
Berwick,9384,8,9,10,17,32,59,-27,37
Edinburgh Ci,9384,9,7,9,20,36,64,-28,30
Cowdenbeath,9384,10,5,10,21,25,54,-29,25
Montrose,9385,1,24,7,5,64,36,28,79
Peterhead,9385,2,23,5,8,79,40,39,74
Stenhousem'r,9385,3,16,8,12,57,47,10,56
Stirling,9385,4,16,6,14,61,53,8,54
Clyde,9385,5,15,9,12,53,49,4,54
Elgin,9385,6,14,6,16,55,65,-10,48
Annan Athlet,9385,7,11,11,14,47,42,5,44
Berwick,9385,8,8,10,18,30,60,-30,34
Edinburgh Ci,9385,9,7,10,19,38,62,-24,31
Cowdenbeath,9385,10,5,10,21,24,54,-30,25
Peterhead,9386,1,24,4,8,82,38,44,76
Montrose,9386,2,23,7,6,61,37,24,76
Stirling,9386,3,16,7,13,60,51,9,55
Stenhousem'r,9386,4,15,9,12,55,46,9,54
Clyde,9386,5,14,9,13,51,50,1,51
Elgin,9386,6,15,6,15,56,62,-6,51
Annan Athlet,9386,7,11,12,13,50,44,6,45
Berwick,9386,8,9,10,17,31,58,-27,37
Edinburgh Ci,9386,9,7,9,20,36,65,-29,30
Cowdenbeath,9386,10,4,11,21,26,57,-31,23
Montrose,9387,1,23,8,5,62,37,25,77
Peterhead,9387,2,24,4,8,79,39,40,76
Stirling,9387,3,16,7,13,61,52,9,55
Stenhousem'r,9387,4,15,9,12,56,47,9,54
Clyde,9387,5,15,9,12,54,48,6,54
Elgin,9387,6,14,7,15,56,63,-7,49
Annan Athlet,9387,7,12,11,13,48,41,7,47
Berwick,9387,8,8,10,18,29,61,-32,34
Edinburgh Ci,9387,9,7,9,20,37,62,-25,30
Cowdenbeath,9387,10,4,10,22,23,55,-32,22
Montrose,9388,1,24,7,5,62,35,27,79
Peterhead,9388,2,24,4,8,80,38,42,76
Stirling,9388,3,16,7,13,61,52,9,55
Stenhousem'r,9388,4,15,9,12,56,47,9,54
Clyde,9388,5,14,10,12,51,48,3,52
Elgin,9388,6,14,6,16,54,63,-9,48
Annan Athlet,9388,7,12,11,13,49,42,7,47
Berwick,9388,8,8,11,17,29,58,-29,35
Edinburgh Ci,9388,9,7,9,20,36,63,-27,30
Cowdenbeath,9388,10,4,10,22,24,56,-32,22
Montrose,9389,1,24,7,5,62,36,26,79
Peterhead,9389,2,24,4,8,80,39,41,76
Stirling,9389,3,17,6,13,62,51,11,57
Clyde,9389,4,15,9,12,53,48,5,54
Stenhousem'r,9389,5,15,8,13,55,48,7,53
Elgin,9389,6,14,6,16,55,63,-8,48
Annan Athlet,9389,7,11,12,13,48,42,6,45
Berwick,9389,8,8,10,18,29,60,-31,34
Edinburgh Ci,9389,9,7,9,20,37,63,-26,30
Cowdenbeath,9389,10,4,11,21,24,55,-31,23
Montrose,9390,1,24,7,5,63,34,29,79
Peterhead,9390,2,23,5,8,78,39,39,74
Stirling,9390,3,17,6,13,64,52,12,57
Stenhousem'r,9390,4,15,8,13,56,50,6,53
Clyde,9390,5,14,9,13,53,51,2,51
Elgin,9390,6,14,6,16,53,64,-11,48
Annan Athlet,9390,7,11,11,14,48,43,5,44
Berwick,9390,8,9,10,17,32,60,-28,37
Edinburgh Ci,9390,9,7,10,19,37,61,-24,31
Cowdenbeath,9390,10,5,10,21,25,55,-30,25
Montrose,9391,1,24,7,5,65,35,30,79
Peterhead,9391,2,24,4,8,79,39,40,76
Stenhousem'r,9391,3,16,8,12,56,46,10,56
Stirling,9391,4,16,6,14,60,52,8,54
Clyde,9391,5,14,10,12,52,49,3,52
Elgin,9391,6,14,6,16,54,66,-12,48
Annan Athlet,9391,7,11,12,13,48,42,6,45
Berwick,9391,8,8,11,17,30,59,-29,35
Edinburgh Ci,9391,9,7,9,20,37,62,-25,30
Cowdenbeath,9391,10,4,11,21,24,55,-31,23
Montrose,9392,1,23,7,6,59,38,21,76
Peterhead,9392,2,23,4,9,77,39,38,73
Stirling,9392,3,17,6,13,62,51,11,57
Clyde,9392,4,15,9,12,53,48,5,54
Stenhousem'r,9392,5,15,8,13,55,48,7,53
Elgin,9392,6,15,6,15,57,60,-3,51
Annan Athlet,9392,7,11,11,14,47,44,3,44
Berwick,9392,8,8,10,18,29,60,-31,34
Edinburgh Ci,9392,9,8,9,19,37,60,-23,33
Cowdenbeath,9392,10,5,10,21,26,54,-28,25
Montrose,9393,1,24,7,5,61,34,27,79
Peterhead,9393,2,24,4,8,80,39,41,76
Stirling,9393,3,17,6,13,62,52,10,57
Clyde,9393,4,15,9,12,54,48,6,54
Stenhousem'r,9393,5,15,8,13,56,48,8,53
Elgin,9393,6,14,6,16,53,62,-9,48
Annan Athlet,9393,7,12,11,13,48,41,7,47
Berwick,9393,8,8,10,18,29,61,-32,34
Edinburgh Ci,9393,9,7,9,20,37,63,-26,30
Cowdenbeath,9393,10,4,10,22,23,55,-32,22
Montrose,9394,1,24,7,5,63,36,27,79
Peterhead,9394,2,24,4,8,79,39,40,76
Stenhousem'r,9394,3,16,8,12,57,47,10,56
Stirling,9394,4,16,6,14,61,53,8,54
Clyde,9394,5,15,9,12,52,48,4,54
Elgin,9394,6,14,6,16,55,64,-9,48
Annan Athlet,9394,7,11,11,14,47,42,5,44
Berwick,9394,8,8,10,18,29,59,-30,34
Edinburgh Ci,9394,9,7,9,20,37,62,-25,30
Cowdenbeath,9394,10,5,10,21,24,54,-30,25
Montrose,9395,1,24,7,5,61,35,26,79
Peterhead,9395,2,23,5,8,77,38,39,74
Stenhousem'r,9395,3,16,8,12,57,47,10,56
Stirling,9395,4,16,6,14,61,53,8,54
Clyde,9395,5,15,9,12,52,48,4,54
Elgin,9395,6,14,6,16,54,62,-8,48
Annan Athlet,9395,7,11,12,13,48,42,6,45
Berwick,9395,8,8,10,18,29,59,-30,34
Edinburgh Ci,9395,9,7,10,19,36,60,-24,31
Cowdenbeath,9395,10,4,11,21,24,55,-31,23
Peterhead,9396,1,24,4,8,79,39,40,76
Montrose,9396,2,23,7,6,59,37,22,76
Stirling,9396,3,17,6,13,64,52,12,57
Clyde,9396,4,15,9,12,54,50,4,54
Stenhousem'r,9396,5,15,8,13,56,50,6,53
Elgin,9396,6,15,6,15,56,60,-4,51
Annan Athlet,9396,7,12,11,13,50,42,8,47
Berwick,9396,8,8,10,18,31,61,-30,34
Edinburgh Ci,9396,9,7,9,20,37,62,-25,30
Cowdenbeath,9396,10,4,10,22,24,57,-33,22
Montrose,9397,1,24,7,5,61,34,27,79
Peterhead,9397,2,24,4,8,80,39,41,76
Stenhousem'r,9397,3,16,8,12,56,46,10,56
Stirling,9397,4,16,6,14,60,52,8,54
Clyde,9397,5,15,9,12,54,48,6,54
Elgin,9397,6,14,6,16,53,62,-9,48
Annan Athlet,9397,7,11,12,13,49,43,6,45
Berwick,9397,8,8,10,18,29,61,-32,34
Edinburgh Ci,9397,9,7,9,20,37,63,-26,30
Cowdenbeath,9397,10,4,11,21,25,56,-31,23
Montrose,9398,1,24,7,5,62,35,27,79
Peterhead,9398,2,24,4,8,80,38,42,76
Stenhousem'r,9398,3,16,8,12,57,46,11,56
Stirling,9398,4,16,6,14,60,53,7,54
Clyde,9398,5,14,10,12,52,49,3,52
Elgin,9398,6,14,6,16,54,63,-9,48
Annan Athlet,9398,7,12,11,13,50,42,8,47
Berwick,9398,8,8,11,17,30,59,-29,35
Edinburgh Ci,9398,9,7,9,20,36,63,-27,30
Cowdenbeath,9398,10,4,10,22,24,57,-33,22
Montrose,9399,1,24,7,5,62,36,26,79
Peterhead,9399,2,23,4,9,79,41,38,73
Stirling,9399,3,17,6,13,65,53,12,57
Clyde,9399,4,15,9,12,52,48,4,54
Stenhousem'r,9399,5,15,8,13,57,51,6,53
Elgin,9399,6,14,6,16,55,63,-8,48
Annan Athlet,9399,7,12,11,13,48,41,7,47
Berwick,9399,8,8,10,18,29,59,-30,34
Edinburgh Ci,9399,9,8,9,19,39,62,-23,33
Cowdenbeath,9399,10,4,10,22,23,55,-32,22
Montrose,9400,1,23,8,5,60,35,25,77
Peterhead,9400,2,24,4,8,83,38,45,76
Stirling,9400,3,16,7,13,60,51,9,55
Stenhousem'r,9400,4,15,9,12,55,46,9,54
Clyde,9400,5,15,9,12,53,48,5,54
Elgin,9400,6,14,7,15,54,61,-7,49
Annan Athlet,9400,7,11,11,14,47,42,5,44
Berwick,9400,8,8,10,18,29,60,-31,34
Edinburgh Ci,9400,9,7,9,20,36,66,-30,30
Cowdenbeath,9400,10,5,10,21,24,54,-30,25
Montrose,9401,1,24,7,5,60,34,26,79
Peterhead,9401,2,24,4,8,81,38,43,76
Stirling,9401,3,17,6,13,63,52,11,57
Clyde,9401,4,15,9,12,58,48,10,54
Stenhousem'r,9401,5,15,8,13,56,49,7,53
Elgin,9401,6,14,6,16,53,61,-8,48
Annan Athlet,9401,7,12,11,13,49,42,7,47
Berwick,9401,8,8,10,18,29,65,-36,34
Edinburgh Ci,9401,9,7,9,20,36,64,-28,30
Cowdenbeath,9401,10,4,10,22,24,56,-32,22
Peterhead,9402,1,24,4,8,81,38,43,76
Montrose,9402,2,23,7,6,59,36,23,76
Stirling,9402,3,17,6,13,63,52,11,57
Clyde,9402,4,15,9,12,52,48,4,54
Stenhousem'r,9402,5,15,8,13,56,49,7,53
Elgin,9402,6,15,6,15,55,60,-5,51
Annan Athlet,9402,7,11,11,14,47,42,5,44
Berwick,9402,8,8,10,18,29,59,-30,34
Edinburgh Ci,9402,9,7,9,20,36,64,-28,30
Cowdenbeath,9402,10,5,10,21,24,54,-30,25
Montrose,9403,1,24,7,5,61,34,27,79
Peterhead,9403,2,24,4,8,80,38,42,76
Stenhousem'r,9403,3,16,8,12,57,47,10,56
Stirling,9403,4,16,6,14,61,53,8,54
Clyde,9403,5,15,9,12,55,49,6,54
Elgin,9403,6,14,6,16,53,62,-9,48
Annan Athlet,9403,7,11,12,13,49,43,6,45
Berwick,9403,8,8,10,18,30,62,-32,34
Edinburgh Ci,9403,9,7,9,20,36,63,-27,30
Cowdenbeath,9403,10,4,11,21,25,56,-31,23
Montrose,9404,1,24,7,5,64,34,30,79
Peterhead,9404,2,24,4,8,79,39,40,76
Stirling,9404,3,17,6,13,64,53,11,57
Stenhousem'r,9404,4,15,8,13,57,50,7,53
Clyde,9404,5,14,9,13,51,49,2,51
Elgin,9404,6,14,6,16,53,65,-12,48
Annan Athlet,9404,7,11,11,14,48,43,5,44
Berwick,9404,8,9,10,17,30,58,-28,37
Edinburgh Ci,9404,9,7,9,20,37,62,-25,30
Cowdenbeath,9404,10,5,10,21,25,55,-30,25
Montrose,9405,1,24,7,5,64,35,29,79
Peterhead,9405,2,23,4,9,77,39,38,73
Stirling,9405,3,16,7,13,63,54,9,55
Stenhousem'r,9405,4,15,9,12,58,49,9,54
Clyde,9405,5,14,9,13,55,54,1,51
Elgin,9405,6,14,6,16,54,65,-11,48
Annan Athlet,9405,7,11,11,14,48,45,3,44
Berwick,9405,8,9,10,17,35,62,-27,37
Edinburgh Ci,9405,9,8,9,19,37,60,-23,33
Cowdenbeath,9405,10,5,10,21,27,55,-28,25
Montrose,9406,1,23,7,6,60,36,24,76
Peterhead,9406,2,23,5,8,80,41,39,74
Stirling,9406,3,17,6,13,61,51,10,57
Clyde,9406,4,15,9,12,54,48,6,54
Stenhousem'r,9406,5,15,8,13,55,47,8,53
Elgin,9406,6,15,6,15,55,61,-6,51
Annan Athlet,9406,7,12,11,13,48,41,7,47
Berwick,9406,8,8,10,18,29,61,-32,34
Edinburgh Ci,9406,9,7,10,19,39,63,-24,31
Cowdenbeath,9406,10,4,10,22,23,55,-32,22
Montrose,9407,1,24,7,5,63,34,29,79
Peterhead,9407,2,24,4,8,82,40,42,76
Stirling,9407,3,17,6,13,64,54,10,57
Stenhousem'r,9407,4,15,8,13,58,50,8,53
Clyde,9407,5,14,9,13,51,50,1,51
Elgin,9407,6,14,6,16,53,64,-11,48
Annan Athlet,9407,7,12,11,13,51,42,9,47
Berwick,9407,8,9,10,17,31,58,-27,37
Edinburgh Ci,9407,9,7,9,20,38,65,-27,30
Cowdenbeath,9407,10,4,10,22,24,58,-34,22
Montrose,9408,1,23,7,6,59,35,24,76
Peterhead,9408,2,23,5,8,80,41,39,74
Stirling,9408,3,17,6,13,62,52,10,57
Clyde,9408,4,15,9,12,52,48,4,54
Stenhousem'r,9408,5,15,8,13,56,48,8,53
Elgin,9408,6,15,6,15,54,60,-6,51
Annan Athlet,9408,7,11,12,13,47,41,6,45
Berwick,9408,8,8,10,18,29,59,-30,34
Edinburgh Ci,9408,9,7,10,19,39,63,-24,31
Cowdenbeath,9408,10,4,11,21,23,54,-31,23
Montrose,9409,1,24,7,5,62,35,27,79
Peterhead,9409,2,24,4,8,81,39,42,76
Stenhousem'r,9409,3,16,8,12,58,46,12,56
Stirling,9409,4,16,6,14,60,54,6,54
Clyde,9409,5,15,9,12,53,49,4,54
Elgin,9409,6,14,6,16,54,63,-9,48
Annan Athlet,9409,7,12,11,13,48,41,7,47
Berwick,9409,8,8,10,18,30,60,-30,34
Edinburgh Ci,9409,9,7,9,20,37,64,-27,30
Cowdenbeath,9409,10,4,10,22,23,55,-32,22
Montrose,9410,1,24,7,5,62,36,26,79
Peterhead,9410,2,24,4,8,79,38,41,76
Stenhousem'r,9410,3,16,8,12,60,49,11,56
Stirling,9410,4,16,6,14,63,56,7,54
Clyde,9410,5,15,9,12,54,49,5,54
Elgin,9410,6,14,6,16,55,63,-8,48
Annan Athlet,9410,7,12,11,13,49,41,8,47
Berwick,9410,8,8,10,18,30,61,-31,34
Edinburgh Ci,9410,9,7,9,20,36,62,-26,30
Cowdenbeath,9410,10,4,10,22,23,56,-33,22
Montrose,9411,1,24,7,5,61,35,26,79
Peterhead,9411,2,24,4,8,79,38,41,76
Stirling,9411,3,17,6,13,63,52,11,57
Clyde,9411,4,15,9,12,53,48,5,54
Stenhousem'r,9411,5,15,8,13,56,49,7,53
Elgin,9411,6,14,6,16,54,62,-8,48
Annan Athlet,9411,7,12,11,13,50,42,8,47
Berwick,9411,8,8,10,18,29,60,-31,34
Edinburgh Ci,9411,9,7,9,20,36,62,-26,30
Cowdenbeath,9411,10,4,10,22,24,57,-33,22
Montrose,9412,1,24,7,5,61,34,27,79
Peterhead,9412,2,24,4,8,80,39,41,76
Stirling,9412,3,16,7,13,61,52,9,55
Stenhousem'r,9412,4,15,9,12,56,47,9,54
Clyde,9412,5,15,9,12,55,48,7,54
Elgin,9412,6,14,6,16,53,62,-9,48
Annan Athlet,9412,7,12,11,13,48,41,7,47
Berwick,9412,8,8,10,18,29,62,-33,34
Edinburgh Ci,9412,9,7,9,20,37,63,-26,30
Cowdenbeath,9412,10,4,10,22,23,55,-32,22
Peterhead,9413,1,24,4,8,79,39,40,76
Montrose,9413,2,23,7,6,62,38,24,76
Stirling,9413,3,17,6,13,64,52,12,57
Clyde,9413,4,15,9,12,55,48,7,54
Stenhousem'r,9413,5,15,8,13,56,50,6,53
Elgin,9413,6,15,6,15,57,63,-6,51
Annan Athlet,9413,7,11,12,13,47,41,6,45
Berwick,9413,8,8,10,18,29,62,-33,34
Edinburgh Ci,9413,9,7,9,20,37,62,-25,30
Cowdenbeath,9413,10,4,11,21,23,54,-31,23
Montrose,9414,1,24,7,5,62,35,27,79
Peterhead,9414,2,24,4,8,78,38,40,76
Stirling,9414,3,17,6,13,63,51,12,57
Stenhousem'r,9414,4,15,8,13,55,49,6,53
Clyde,9414,5,14,9,13,53,51,2,51
Elgin,9414,6,14,6,16,54,63,-9,48
Annan Athlet,9414,7,12,11,13,48,41,7,47
Berwick,9414,8,9,10,17,32,60,-28,37
Edinburgh Ci,9414,9,7,9,20,36,61,-25,30
Cowdenbeath,9414,10,4,10,22,23,55,-32,22
Montrose,9415,1,24,7,5,62,36,26,79
Peterhead,9415,2,24,4,8,79,39,40,76
Stirling,9415,3,17,6,13,63,53,10,57
Clyde,9415,4,15,9,12,55,49,6,54
Stenhousem'r,9415,5,15,8,13,57,49,8,53
Elgin,9415,6,14,6,16,55,63,-8,48
Annan Athlet,9415,7,11,12,13,47,41,6,45
Berwick,9415,8,8,10,18,30,62,-32,34
Edinburgh Ci,9415,9,7,9,20,37,62,-25,30
Cowdenbeath,9415,10,4,11,21,23,54,-31,23
Montrose,9416,1,24,7,5,62,35,27,79
Peterhead,9416,2,23,4,9,78,42,36,73
Stirling,9416,3,16,7,13,61,52,9,55
Stenhousem'r,9416,4,15,9,12,56,47,9,54
Clyde,9416,5,15,9,12,53,48,5,54
Elgin,9416,6,14,6,16,54,63,-9,48
Annan Athlet,9416,7,12,11,13,48,41,7,47
Berwick,9416,8,8,10,18,29,60,-31,34
Edinburgh Ci,9416,9,8,9,19,40,61,-21,33
Cowdenbeath,9416,10,4,10,22,23,55,-32,22
Peterhead,9417,1,24,4,8,80,39,41,76
Montrose,9417,2,23,7,6,60,38,22,76
Stirling,9417,3,16,7,13,62,53,9,55
Stenhousem'r,9417,4,15,9,12,57,48,9,54
Clyde,9417,5,14,10,12,51,48,3,52
Elgin,9417,6,15,6,15,57,61,-4,51
Annan Athlet,9417,7,11,11,14,48,44,4,44
Berwick,9417,8,8,11,17,29,58,-29,35
Edinburgh Ci,9417,9,7,9,20,37,63,-26,30
Cowdenbeath,9417,10,5,10,21,26,55,-29,25
Montrose,9418,1,24,7,5,61,34,27,79
Peterhead,9418,2,24,4,8,80,39,41,76
Stirling,9418,3,17,6,13,63,51,12,57
Clyde,9418,4,15,9,12,53,48,5,54
Stenhousem'r,9418,5,15,8,13,55,49,6,53
Elgin,9418,6,14,6,16,53,62,-9,48
Annan Athlet,9418,7,12,11,13,49,42,7,47
Berwick,9418,8,8,10,18,29,60,-31,34
Edinburgh Ci,9418,9,7,9,20,37,63,-26,30
Cowdenbeath,9418,10,4,10,22,24,56,-32,22
Montrose,9419,1,24,7,5,61,35,26,79
Peterhead,9419,2,24,4,8,82,39,43,76
Stenhousem'r,9419,3,16,8,12,57,47,10,56
Stirling,9419,4,16,6,14,61,53,8,54
Clyde,9419,5,14,10,12,52,49,3,52
Elgin,9419,6,14,6,16,54,62,-8,48
Annan Athlet,9419,7,11,12,13,47,41,6,45
Berwick,9419,8,8,11,17,30,59,-29,35
Edinburgh Ci,9419,9,7,9,20,37,65,-28,30
Cowdenbeath,9419,10,4,11,21,23,54,-31,23
Montrose,9420,1,23,8,5,61,36,25,77
Peterhead,9420,2,24,4,8,81,41,40,76
Stirling,9420,3,17,6,13,63,51,12,57
Stenhousem'r,9420,4,15,8,13,55,49,6,53
Clyde,9420,5,14,9,13,51,49,2,51
Elgin,9420,6,14,7,15,55,62,-7,49
Annan Athlet,9420,7,12,11,13,48,41,7,47
Berwick,9420,8,9,10,17,30,58,-28,37
Edinburgh Ci,9420,9,7,9,20,39,64,-25,30
Cowdenbeath,9420,10,4,10,22,23,55,-32,22
Montrose,9421,1,24,7,5,62,35,27,79
Peterhead,9421,2,24,4,8,82,39,43,76
Stirling,9421,3,16,7,13,60,51,9,55
Stenhousem'r,9421,4,15,9,12,55,46,9,54
Clyde,9421,5,15,9,12,54,49,5,54
Elgin,9421,6,14,6,16,54,63,-9,48
Annan Athlet,9421,7,11,11,14,48,43,5,44
Berwick,9421,8,8,10,18,30,61,-31,34
Edinburgh Ci,9421,9,7,9,20,37,65,-28,30
Cowdenbeath,9421,10,5,10,21,25,55,-30,25
Montrose,9422,1,23,8,5,60,35,25,77
Peterhead,9422,2,24,4,8,81,38,43,76
Stenhousem'r,9422,3,16,8,12,60,48,12,56
Stirling,9422,4,16,6,14,62,56,6,54
Clyde,9422,5,15,9,12,53,48,5,54
Elgin,9422,6,14,7,15,54,61,-7,49
Annan Athlet,9422,7,12,11,13,49,41,8,47
Berwick,9422,8,8,10,18,29,60,-31,34
Edinburgh Ci,9422,9,7,9,20,36,64,-28,30
Cowdenbeath,9422,10,4,10,22,23,56,-33,22
Montrose,9423,1,24,7,5,63,37,26,79
Peterhead,9423,2,24,4,8,79,39,40,76
Stirling,9423,3,16,7,13,61,52,9,55
Stenhousem'r,9423,4,15,9,12,56,47,9,54
Clyde,9423,5,15,9,12,53,48,5,54
Elgin,9423,6,14,6,16,56,64,-8,48
Annan Athlet,9423,7,12,11,13,49,42,7,47
Berwick,9423,8,8,10,18,29,60,-31,34
Edinburgh Ci,9423,9,7,9,20,37,62,-25,30
Cowdenbeath,9423,10,4,10,22,24,56,-32,22
Montrose,9424,1,23,7,6,60,36,24,76
Peterhead,9424,2,23,4,9,79,42,37,73
Stenhousem'r,9424,3,16,8,12,57,46,11,56
Stirling,9424,4,16,6,14,60,53,7,54
Clyde,9424,5,15,9,12,55,48,7,54
Elgin,9424,6,15,6,15,55,61,-6,51
Annan Athlet,9424,7,12,11,13,50,41,9,47
Berwick,9424,8,8,10,18,29,62,-33,34
Edinburgh Ci,9424,9,8,9,19,40,62,-22,33
Cowdenbeath,9424,10,4,10,22,23,57,-34,22
Montrose,9425,1,23,7,6,60,36,24,76
Peterhead,9425,2,23,4,9,77,39,38,73
Stirling,9425,3,16,7,13,62,53,9,55
Stenhousem'r,9425,4,15,9,12,57,48,9,54
Clyde,9425,5,14,10,12,52,49,3,52
Elgin,9425,6,15,6,15,55,61,-6,51
Annan Athlet,9425,7,11,11,14,47,43,4,44
Berwick,9425,8,8,11,17,30,59,-29,35
Edinburgh Ci,9425,9,8,9,19,37,60,-23,33
Cowdenbeath,9425,10,5,10,21,25,54,-29,25
Montrose,9426,1,23,8,5,60,35,25,77
Peterhead,9426,2,24,4,8,83,38,45,76
Stirling,9426,3,17,6,13,63,51,12,57
Clyde,9426,4,15,9,12,53,49,4,54
Stenhousem'r,9426,5,15,8,13,55,49,6,53
Elgin,9426,6,14,7,15,54,61,-7,49
Annan Athlet,9426,7,12,11,13,48,41,7,47
Berwick,9426,8,8,10,18,30,60,-30,34
Edinburgh Ci,9426,9,7,9,20,36,66,-30,30
Cowdenbeath,9426,10,4,10,22,23,55,-32,22
Montrose,9427,1,23,8,5,60,35,25,77
Peterhead,9427,2,24,4,8,80,38,42,76
Stenhousem'r,9427,3,16,8,12,58,46,12,56
Stirling,9427,4,16,6,14,60,54,6,54
Clyde,9427,5,15,9,12,52,48,4,54
Elgin,9427,6,14,7,15,54,61,-7,49
Annan Athlet,9427,7,11,11,14,48,44,4,44
Berwick,9427,8,8,10,18,29,59,-30,34
Edinburgh Ci,9427,9,7,9,20,36,63,-27,30
Cowdenbeath,9427,10,5,10,21,26,55,-29,25
Montrose,9428,1,23,8,5,60,35,25,77
Peterhead,9428,2,24,4,8,82,39,43,76
Stenhousem'r,9428,3,16,8,12,56,46,10,56
Stirling,9428,4,16,6,14,60,52,8,54
Clyde,9428,5,15,9,12,52,48,4,54
Elgin,9428,6,14,7,15,54,61,-7,49
Annan Athlet,9428,7,12,11,13,50,43,7,47
Berwick,9428,8,8,10,18,29,59,-30,34
Edinburgh Ci,9428,9,7,9,20,37,65,-28,30
Cowdenbeath,9428,10,4,10,22,25,57,-32,22
Peterhead,9429,1,24,4,8,81,38,43,76
Montrose,9429,2,23,7,6,59,35,24,76
Stirling,9429,3,17,6,13,65,53,12,57
Stenhousem'r,9429,4,15,8,13,57,51,6,53
Clyde,9429,5,14,9,13,52,51,1,51
Elgin,9429,6,15,6,15,54,60,-6,51
Annan Athlet,9429,7,12,11,13,50,42,8,47
Berwick,9429,8,9,10,17,32,59,-27,37
Edinburgh Ci,9429,9,7,9,20,36,64,-28,30
Cowdenbeath,9429,10,4,10,22,24,57,-33,22
Montrose,9430,1,24,7,5,61,34,27,79
Peterhead,9430,2,24,4,8,81,39,42,76
Stirling,9430,3,17,6,13,62,52,10,57
Clyde,9430,4,15,9,12,52,48,4,54
Stenhousem'r,9430,5,15,8,13,56,48,8,53
Elgin,9430,6,14,6,16,53,62,-9,48
Annan Athlet,9430,7,12,11,13,49,42,7,47
Berwick,9430,8,8,10,18,29,59,-30,34
Edinburgh Ci,9430,9,7,9,20,37,64,-27,30
Cowdenbeath,9430,10,4,10,22,24,56,-32,22
Montrose,9431,1,24,7,5,61,34,27,79
Peterhead,9431,2,24,4,8,78,38,40,76
Stirling,9431,3,17,6,13,63,52,11,57
Stenhousem'r,9431,4,15,8,13,56,49,7,53
Clyde,9431,5,14,10,12,51,48,3,52
Elgin,9431,6,14,6,16,53,62,-9,48
Annan Athlet,9431,7,11,12,13,48,42,6,45
Berwick,9431,8,8,11,17,29,58,-29,35
Edinburgh Ci,9431,9,7,9,20,36,61,-25,30
Cowdenbeath,9431,10,4,11,21,24,55,-31,23
Montrose,9432,1,23,8,5,61,36,25,77
Peterhead,9432,2,24,4,8,81,38,43,76
Stirling,9432,3,17,6,13,65,54,11,57
Stenhousem'r,9432,4,15,8,13,58,51,7,53
Clyde,9432,5,14,9,13,52,50,2,51
Elgin,9432,6,14,7,15,55,62,-7,49
Annan Athlet,9432,7,11,12,13,48,42,6,45
Berwick,9432,8,9,10,17,31,59,-28,37
Edinburgh Ci,9432,9,7,9,20,36,64,-28,30
Cowdenbeath,9432,10,4,11,21,24,55,-31,23
Montrose,9433,1,23,8,5,61,36,25,77
Peterhead,9433,2,24,4,8,79,38,41,76
Stenhousem'r,9433,3,16,8,12,57,47,10,56
Stirling,9433,4,16,6,14,61,53,8,54
Clyde,9433,5,14,10,12,52,49,3,52
Elgin,9433,6,14,7,15,55,62,-7,49
Annan Athlet,9433,7,11,11,14,47,42,5,44
Berwick,9433,8,8,11,17,30,59,-29,35
Edinburgh Ci,9433,9,7,9,20,36,62,-26,30
Cowdenbeath,9433,10,5,10,21,24,54,-30,25
Montrose,9434,1,24,7,5,62,36,26,79
Peterhead,9434,2,24,4,8,80,38,42,76
Stirling,9434,3,16,7,13,61,52,9,55
Stenhousem'r,9434,4,15,9,12,56,47,9,54
Clyde,9434,5,14,10,12,53,50,3,52
Elgin,9434,6,14,6,16,55,63,-8,48
Annan Athlet,9434,7,12,11,13,50,42,8,47
Berwick,9434,8,8,11,17,31,60,-29,35
Edinburgh Ci,9434,9,7,9,20,36,63,-27,30
Cowdenbeath,9434,10,4,10,22,24,57,-33,22
Peterhead,9435,1,24,4,8,79,39,40,76
Montrose,9435,2,23,7,6,59,35,24,76
Stenhousem'r,9435,3,16,8,12,58,48,10,56
Stirling,9435,4,16,6,14,62,54,8,54
Clyde,9435,5,15,9,12,54,48,6,54
Elgin,9435,6,15,6,15,54,60,-6,51
Annan Athlet,9435,7,11,11,14,47,43,4,44
Berwick,9435,8,8,10,18,29,61,-32,34
Edinburgh Ci,9435,9,7,9,20,37,62,-25,30
Cowdenbeath,9435,10,5,10,21,25,54,-29,25
Montrose,9436,1,24,7,5,61,35,26,79
Peterhead,9436,2,23,4,9,79,41,38,73
Stirling,9436,3,17,6,13,63,52,11,57
Stenhousem'r,9436,4,15,8,13,56,49,7,53
Clyde,9436,5,14,9,13,51,49,2,51
Elgin,9436,6,14,6,16,54,62,-8,48
Annan Athlet,9436,7,11,12,13,47,41,6,45
Berwick,9436,8,9,10,17,30,58,-28,37
Edinburgh Ci,9436,9,8,9,19,39,62,-23,33
Cowdenbeath,9436,10,4,11,21,23,54,-31,23
Montrose,9437,1,24,7,5,64,34,30,79
Peterhead,9437,2,24,4,8,80,38,42,76
Stirling,9437,3,17,6,13,63,52,11,57
Clyde,9437,4,15,9,12,55,51,4,54
Stenhousem'r,9437,5,15,8,13,56,49,7,53
Elgin,9437,6,14,6,16,53,65,-12,48
Annan Athlet,9437,7,11,12,13,49,43,6,45
Berwick,9437,8,8,10,18,32,62,-30,34
Edinburgh Ci,9437,9,7,9,20,36,63,-27,30
Cowdenbeath,9437,10,4,11,21,25,56,-31,23
Montrose,9438,1,24,7,5,61,35,26,79
Peterhead,9438,2,23,5,8,78,39,39,74
Stirling,9438,3,16,7,13,61,52,9,55
Stenhousem'r,9438,4,15,9,12,56,47,9,54
Clyde,9438,5,14,9,13,54,53,1,51
Elgin,9438,6,14,6,16,54,62,-8,48
Annan Athlet,9438,7,11,11,14,47,42,5,44
Berwick,9438,8,9,10,17,34,61,-27,37
Edinburgh Ci,9438,9,7,10,19,37,61,-24,31
Cowdenbeath,9438,10,5,10,21,24,54,-30,25
Peterhead,9439,1,24,4,8,83,39,44,76
Montrose,9439,2,23,7,6,59,36,23,76
Stirling,9439,3,17,6,13,64,51,13,57
Stenhousem'r,9439,4,15,8,13,55,50,5,53
Clyde,9439,5,14,10,12,52,49,3,52
Elgin,9439,6,15,6,15,55,60,-5,51
Annan Athlet,9439,7,12,11,13,49,41,8,47
Berwick,9439,8,8,11,17,30,59,-29,35
Edinburgh Ci,9439,9,7,9,20,37,66,-29,30
Cowdenbeath,9439,10,4,10,22,23,56,-33,22
Montrose,9440,1,23,8,5,60,35,25,77
Peterhead,9440,2,24,4,8,78,38,40,76
Stenhousem'r,9440,3,16,8,12,58,47,11,56
Stirling,9440,4,16,6,14,61,54,7,54
Clyde,9440,5,15,9,12,54,48,6,54
Elgin,9440,6,14,7,15,54,61,-7,49
Annan Athlet,9440,7,12,11,13,49,42,7,47
Berwick,9440,8,8,10,18,29,61,-32,34
Edinburgh Ci,9440,9,7,9,20,36,61,-25,30
Cowdenbeath,9440,10,4,10,22,24,56,-32,22
Montrose,9441,1,23,8,5,60,35,25,77
Peterhead,9441,2,24,4,8,78,38,40,76
Stirling,9441,3,16,7,13,62,53,9,55
Stenhousem'r,9441,4,15,9,12,57,48,9,54
Clyde,9441,5,14,10,12,52,49,3,52
Elgin,9441,6,14,7,15,54,61,-7,49
Annan Athlet,9441,7,11,11,14,47,42,5,44
Berwick,9441,8,8,11,17,30,59,-29,35
Edinburgh Ci,9441,9,7,9,20,36,61,-25,30
Cowdenbeath,9441,10,5,10,21,24,54,-30,25
Montrose,9442,1,24,7,5,63,34,29,79
Peterhead,9442,2,24,4,8,81,38,43,76
Stirling,9442,3,16,7,13,63,54,9,55
Stenhousem'r,9442,4,15,9,12,58,49,9,54
Clyde,9442,5,15,9,12,54,48,6,54
Elgin,9442,6,14,6,16,53,64,-11,48
Annan Athlet,9442,7,11,11,14,47,42,5,44
Berwick,9442,8,8,10,18,29,61,-32,34
Edinburgh Ci,9442,9,7,9,20,36,64,-28,30
Cowdenbeath,9442,10,5,10,21,24,54,-30,25
Peterhead,9443,1,24,4,8,79,38,41,76
Montrose,9443,2,23,7,6,60,36,24,76
Stenhousem'r,9443,3,16,8,12,58,47,11,56
Stirling,9443,4,16,6,14,61,54,7,54
Clyde,9443,5,15,9,12,53,48,5,54
Elgin,9443,6,15,6,15,55,61,-6,51
Annan Athlet,9443,7,12,11,13,48,41,7,47
Berwick,9443,8,8,10,18,29,60,-31,34
Edinburgh Ci,9443,9,7,9,20,36,62,-26,30
Cowdenbeath,9443,10,4,10,22,23,55,-32,22
Montrose,9444,1,24,7,5,65,34,31,79
Peterhead,9444,2,24,4,8,81,39,42,76
Stenhousem'r,9444,3,16,8,12,57,46,11,56
Stirling,9444,4,16,6,14,60,53,7,54
Clyde,9444,5,15,9,12,53,49,4,54
Elgin,9444,6,14,6,16,53,66,-13,48
Annan Athlet,9444,7,11,11,14,47,43,4,44
Berwick,9444,8,8,10,18,30,60,-30,34
Edinburgh Ci,9444,9,7,9,20,37,64,-27,30
Cowdenbeath,9444,10,5,10,21,25,54,-29,25
Montrose,9445,1,24,7,5,62,36,26,79
Peterhead,9445,2,24,4,8,79,38,41,76
Stirling,9445,3,17,6,13,61,51,10,57
Stenhousem'r,9445,4,15,8,13,55,47,8,53
Clyde,9445,5,14,9,13,51,50,1,51
Elgin,9445,6,14,6,16,55,63,-8,48
Annan Athlet,9445,7,11,12,13,49,43,6,45
Berwick,9445,8,9,10,17,31,58,-27,37
Edinburgh Ci,9445,9,7,9,20,36,62,-26,30
Cowdenbeath,9445,10,4,11,21,25,56,-31,23
Peterhead,9446,1,24,4,8,79,38,41,76
Montrose,9446,2,23,7,6,60,36,24,76
Stenhousem'r,9446,3,16,8,12,57,46,11,56
Stirling,9446,4,16,6,14,60,53,7,54
Clyde,9446,5,14,9,13,51,49,2,51
Elgin,9446,6,15,6,15,55,61,-6,51
Annan Athlet,9446,7,11,11,14,47,42,5,44
Berwick,9446,8,9,10,17,30,58,-28,37
Edinburgh Ci,9446,9,7,9,20,36,62,-26,30
Cowdenbeath,9446,10,5,10,21,24,54,-30,25
Montrose,9447,1,24,7,5,63,35,28,79
Peterhead,9447,2,24,4,8,81,40,41,76
Stirling,9447,3,17,6,13,62,51,11,57
Stenhousem'r,9447,4,15,8,13,55,48,7,53
Clyde,9447,5,14,9,13,51,49,2,51
Elgin,9447,6,14,6,16,54,64,-10,48
Annan Athlet,9447,7,11,12,13,48,42,6,45
Berwick,9447,8,9,10,17,30,58,-28,37
Edinburgh Ci,9447,9,7,9,20,38,64,-26,30
Cowdenbeath,9447,10,4,11,21,24,55,-31,23
Montrose,9448,1,23,7,6,59,35,24,76
Peterhead,9448,2,23,5,8,79,40,39,74
Stirling,9448,3,17,6,13,64,53,11,57
Clyde,9448,4,15,9,12,55,49,6,54
Stenhousem'r,9448,5,15,8,13,57,50,7,53
Elgin,9448,6,15,6,15,54,60,-6,51
Annan Athlet,9448,7,11,12,13,48,42,6,45
Berwick,9448,8,8,10,18,30,62,-32,34
Edinburgh Ci,9448,9,7,10,19,38,62,-24,31
Cowdenbeath,9448,10,4,11,21,24,55,-31,23
Montrose,9449,1,24,7,5,61,35,26,79
Peterhead,9449,2,24,4,8,78,38,40,76
Stenhousem'r,9449,3,16,8,12,57,47,10,56
Stirling,9449,4,16,6,14,61,53,8,54
Clyde,9449,5,15,9,12,52,48,4,54
Elgin,9449,6,14,6,16,54,62,-8,48
Annan Athlet,9449,7,12,11,13,49,41,8,47
Berwick,9449,8,8,10,18,29,59,-30,34
Edinburgh Ci,9449,9,7,9,20,36,61,-25,30
Cowdenbeath,9449,10,4,10,22,23,56,-33,22
Peterhead,9450,1,24,4,8,80,39,41,76
Montrose,9450,2,23,7,6,60,36,24,76
Stirling,9450,3,17,6,13,64,53,11,57
Stenhousem'r,9450,4,15,8,13,57,50,7,53
Clyde,9450,5,14,9,13,51,49,2,51
Elgin,9450,6,15,6,15,55,61,-6,51
Annan Athlet,9450,7,11,11,14,47,44,3,44
Berwick,9450,8,9,10,17,30,58,-28,37
Edinburgh Ci,9450,9,7,9,20,37,63,-26,30
Cowdenbeath,9450,10,5,10,21,26,54,-28,25
Montrose,9451,1,23,8,5,61,36,25,77
Peterhead,9451,2,24,4,8,83,39,44,76
Stenhousem'r,9451,3,16,8,12,58,48,10,56
Stirling,9451,4,16,6,14,62,54,8,54
Clyde,9451,5,14,10,12,51,48,3,52
Elgin,9451,6,14,7,15,55,62,-7,49
Annan Athlet,9451,7,12,11,13,50,41,9,47
Berwick,9451,8,8,11,17,29,58,-29,35
Edinburgh Ci,9451,9,7,9,20,37,66,-29,30
Cowdenbeath,9451,10,4,10,22,23,57,-34,22
Montrose,9452,1,24,7,5,60,34,26,79
Peterhead,9452,2,24,4,8,79,39,40,76
Stirling,9452,3,17,6,13,61,51,10,57
Stenhousem'r,9452,4,15,8,13,55,47,8,53
Clyde,9452,5,14,10,12,51,48,3,52
Elgin,9452,6,14,6,16,53,61,-8,48
Annan Athlet,9452,7,12,11,13,49,41,8,47
Berwick,9452,8,8,11,17,29,58,-29,35
Edinburgh Ci,9452,9,7,9,20,37,62,-25,30
Cowdenbeath,9452,10,4,10,22,23,56,-33,22
Montrose,9453,1,24,7,5,63,36,27,79
Peterhead,9453,2,24,4,8,79,38,41,76
Stenhousem'r,9453,3,16,8,12,56,46,10,56
Stirling,9453,4,16,6,14,60,52,8,54
Clyde,9453,5,15,9,12,52,48,4,54
Elgin,9453,6,14,6,16,55,64,-9,48
Annan Athlet,9453,7,12,11,13,49,42,7,47
Berwick,9453,8,8,10,18,29,59,-30,34
Edinburgh Ci,9453,9,7,9,20,36,62,-26,30
Cowdenbeath,9453,10,4,10,22,24,56,-32,22
Montrose,9454,1,24,7,5,63,35,28,79
Peterhead,9454,2,24,4,8,81,39,42,76
Stirling,9454,3,17,6,13,62,52,10,57
Clyde,9454,4,15,9,12,52,48,4,54
Stenhousem'r,9454,5,15,8,13,56,48,8,53
Elgin,9454,6,14,6,16,54,64,-10,48
Annan Athlet,9454,7,11,12,13,48,42,6,45
Berwick,9454,8,8,10,18,29,59,-30,34
Edinburgh Ci,9454,9,7,9,20,37,64,-27,30
Cowdenbeath,9454,10,4,11,21,24,55,-31,23
Montrose,9455,1,23,8,5,60,35,25,77
Peterhead,9455,2,23,5,8,77,38,39,74
Stirling,9455,3,17,6,13,63,52,11,57
Clyde,9455,4,15,9,12,54,50,4,54
Stenhousem'r,9455,5,15,8,13,56,49,7,53
Elgin,9455,6,14,7,15,54,61,-7,49
Annan Athlet,9455,7,11,12,13,49,43,6,45
Berwick,9455,8,8,10,18,31,61,-30,34
Edinburgh Ci,9455,9,7,10,19,36,60,-24,31
Cowdenbeath,9455,10,4,11,21,25,56,-31,23
Peterhead,9456,1,24,4,8,79,39,40,76
Montrose,9456,2,23,7,6,59,35,24,76
Stirling,9456,3,16,7,13,61,52,9,55
Stenhousem'r,9456,4,15,9,12,56,47,9,54
Clyde,9456,5,14,10,12,52,49,3,52
Elgin,9456,6,15,6,15,54,60,-6,51
Annan Athlet,9456,7,12,11,13,49,41,8,47
Berwick,9456,8,8,11,17,30,59,-29,35
Edinburgh Ci,9456,9,7,9,20,37,62,-25,30
Cowdenbeath,9456,10,4,10,22,23,56,-33,22
Montrose,9457,1,23,7,6,59,35,24,76
Peterhead,9457,2,23,5,8,78,39,39,74
Stirling,9457,3,16,7,13,61,52,9,55
Stenhousem'r,9457,4,15,9,12,56,47,9,54
Clyde,9457,5,14,10,12,51,48,3,52
Elgin,9457,6,15,6,15,54,60,-6,51
Annan Athlet,9457,7,12,11,13,50,41,9,47
Berwick,9457,8,8,11,17,29,58,-29,35
Edinburgh Ci,9457,9,7,10,19,37,61,-24,31
Cowdenbeath,9457,10,4,10,22,23,57,-34,22
Montrose,9458,1,24,7,5,60,34,26,79
Peterhead,9458,2,24,4,8,82,38,44,76
Stirling,9458,3,17,6,13,63,52,11,57
Clyde,9458,4,15,9,12,53,48,5,54
Stenhousem'r,9458,5,15,8,13,56,49,7,53
Elgin,9458,6,14,6,16,53,61,-8,48
Annan Athlet,9458,7,12,11,13,50,42,8,47
Berwick,9458,8,8,10,18,29,60,-31,34
Edinburgh Ci,9458,9,7,9,20,36,65,-29,30
Cowdenbeath,9458,10,4,10,22,24,57,-33,22
Montrose,9459,1,23,7,6,61,37,24,76
Peterhead,9459,2,23,5,8,77,38,39,74
Stenhousem'r,9459,3,16,8,12,56,46,10,56
Stirling,9459,4,16,6,14,60,52,8,54
Clyde,9459,5,15,9,12,52,48,4,54
Elgin,9459,6,15,6,15,56,62,-6,51
Annan Athlet,9459,7,11,12,13,47,41,6,45
Berwick,9459,8,8,10,18,29,59,-30,34
Edinburgh Ci,9459,9,7,10,19,36,60,-24,31
Cowdenbeath,9459,10,4,11,21,23,54,-31,23
Montrose,9460,1,23,8,5,62,37,25,77
Peterhead,9460,2,24,4,8,81,39,42,76
Stirling,9460,3,17,6,13,61,51,10,57
Clyde,9460,4,15,9,12,52,48,4,54
Stenhousem'r,9460,5,15,8,13,55,47,8,53
Elgin,9460,6,14,7,15,56,63,-7,49
Annan Athlet,9460,7,11,11,14,47,42,5,44
Berwick,9460,8,8,10,18,29,59,-30,34
Edinburgh Ci,9460,9,7,9,20,37,64,-27,30
Cowdenbeath,9460,10,5,10,21,24,54,-30,25
Montrose,9461,1,24,7,5,61,35,26,79
Peterhead,9461,2,23,5,8,78,39,39,74
Stirling,9461,3,17,6,13,62,52,10,57
Stenhousem'r,9461,4,15,8,13,56,48,8,53
Clyde,9461,5,14,10,12,52,49,3,52
Elgin,9461,6,14,6,16,54,62,-8,48
Annan Athlet,9461,7,11,11,14,47,42,5,44
Berwick,9461,8,8,11,17,30,59,-29,35
Edinburgh Ci,9461,9,7,10,19,37,61,-24,31
Cowdenbeath,9461,10,5,10,21,24,54,-30,25
Montrose,9462,1,23,7,6,61,37,24,76
Peterhead,9462,2,23,5,8,77,38,39,74
Stenhousem'r,9462,3,16,8,12,58,46,12,56
Stirling,9462,4,16,6,14,60,54,6,54
Clyde,9462,5,15,9,12,54,48,6,54
Elgin,9462,6,15,6,15,56,62,-6,51
Annan Athlet,9462,7,11,11,14,48,43,5,44
Berwick,9462,8,8,10,18,29,61,-32,34
Edinburgh Ci,9462,9,7,10,19,36,60,-24,31
Cowdenbeath,9462,10,5,10,21,25,55,-30,25
Peterhead,9463,1,24,4,8,81,38,43,76
Montrose,9463,2,23,7,6,59,35,24,76
Stenhousem'r,9463,3,16,8,12,56,46,10,56
Stirling,9463,4,16,6,14,60,52,8,54
Clyde,9463,5,15,9,12,53,49,4,54
Elgin,9463,6,15,6,15,54,60,-6,51
Annan Athlet,9463,7,11,12,13,48,42,6,45
Berwick,9463,8,8,10,18,30,60,-30,34
Edinburgh Ci,9463,9,7,9,20,36,64,-28,30
Cowdenbeath,9463,10,4,11,21,24,55,-31,23
Montrose,9464,1,23,8,5,60,35,25,77
Peterhead,9464,2,23,5,8,77,38,39,74
Stirling,9464,3,16,7,13,61,52,9,55
Stenhousem'r,9464,4,15,9,12,56,47,9,54
Clyde,9464,5,14,9,13,51,49,2,51
Elgin,9464,6,14,7,15,54,61,-7,49
Annan Athlet,9464,7,12,11,13,48,41,7,47
Berwick,9464,8,9,10,17,30,58,-28,37
Edinburgh Ci,9464,9,7,10,19,36,60,-24,31
Cowdenbeath,9464,10,4,10,22,23,55,-32,22
Peterhead,9465,1,24,4,8,82,39,43,76
Montrose,9465,2,23,7,6,59,35,24,76
Stenhousem'r,9465,3,16,8,12,57,46,11,56
Stirling,9465,4,16,6,14,60,53,7,54
Clyde,9465,5,15,9,12,54,49,5,54
Elgin,9465,6,15,6,15,54,60,-6,51
Annan Athlet,9465,7,12,11,13,49,41,8,47
Berwick,9465,8,8,10,18,30,61,-31,34
Edinburgh Ci,9465,9,7,9,20,37,65,-28,30
Cowdenbeath,9465,10,4,10,22,23,56,-33,22
Montrose,9466,1,24,7,5,63,34,29,79
Peterhead,9466,2,24,4,8,79,38,41,76
Stirling,9466,3,17,6,13,67,55,12,57
Stenhousem'r,9466,4,15,8,13,59,53,6,53
Clyde,9466,5,14,10,12,52,49,3,52
Elgin,9466,6,14,6,16,53,64,-11,48
Annan Athlet,9466,7,12,11,13,49,41,8,47
Berwick,9466,8,8,11,17,30,59,-29,35
Edinburgh Ci,9466,9,7,9,20,36,62,-26,30
Cowdenbeath,9466,10,4,10,22,23,56,-33,22
Montrose,9467,1,24,7,5,61,35,26,79
Peterhead,9467,2,24,4,8,79,38,41,76
Stirling,9467,3,16,7,13,60,51,9,55
Stenhousem'r,9467,4,15,9,12,55,46,9,54
Clyde,9467,5,15,9,12,54,48,6,54
Elgin,9467,6,14,6,16,54,62,-8,48
Annan Athlet,9467,7,12,11,13,49,42,7,47
Berwick,9467,8,8,10,18,29,61,-32,34
Edinburgh Ci,9467,9,7,9,20,36,62,-26,30
Cowdenbeath,9467,10,4,10,22,24,56,-32,22
Montrose,9468,1,24,7,5,63,34,29,79
Peterhead,9468,2,23,4,9,79,41,38,73
Stirling,9468,3,17,6,13,62,51,11,57
Clyde,9468,4,15,9,12,55,50,5,54
Stenhousem'r,9468,5,15,8,13,55,48,7,53
Elgin,9468,6,14,6,16,53,64,-11,48
Annan Athlet,9468,7,12,11,13,49,41,8,47
Berwick,9468,8,8,10,18,31,62,-31,34
Edinburgh Ci,9468,9,8,9,19,39,62,-23,33
Cowdenbeath,9468,10,4,10,22,23,56,-33,22
Montrose,9469,1,24,7,5,62,34,28,79
Peterhead,9469,2,24,4,8,79,38,41,76
Stenhousem'r,9469,3,16,8,12,57,47,10,56
Stirling,9469,4,16,6,14,61,53,8,54
Clyde,9469,5,14,10,12,53,50,3,52
Elgin,9469,6,14,6,16,53,63,-10,48
Annan Athlet,9469,7,12,11,13,49,42,7,47
Berwick,9469,8,8,11,17,31,60,-29,35
Edinburgh Ci,9469,9,7,9,20,36,62,-26,30
Cowdenbeath,9469,10,4,10,22,24,56,-32,22
Montrose,9470,1,24,7,5,60,34,26,79
Peterhead,9470,2,24,4,8,81,38,43,76
Stirling,9470,3,16,7,13,61,52,9,55
Stenhousem'r,9470,4,15,9,12,56,47,9,54
Clyde,9470,5,15,9,12,56,50,6,54
Elgin,9470,6,14,6,16,53,61,-8,48
Annan Athlet,9470,7,11,11,14,47,42,5,44
Berwick,9470,8,8,10,18,31,63,-32,34
Edinburgh Ci,9470,9,7,9,20,36,64,-28,30
Cowdenbeath,9470,10,5,10,21,24,54,-30,25
Montrose,9471,1,23,8,5,59,34,25,77
Peterhead,9471,2,24,4,8,80,40,40,76
Stirling,9471,3,16,7,13,62,53,9,55
Stenhousem'r,9471,4,15,9,12,57,48,9,54
Clyde,9471,5,15,9,12,52,48,4,54
Elgin,9471,6,14,7,15,53,60,-7,49
Annan Athlet,9471,7,12,11,13,48,41,7,47
Berwick,9471,8,8,10,18,29,59,-30,34
Edinburgh Ci,9471,9,7,9,20,38,63,-25,30
Cowdenbeath,9471,10,4,10,22,23,55,-32,22
Montrose,9472,1,24,7,5,65,38,27,79
Peterhead,9472,2,24,4,8,80,39,41,76
Stirling,9472,3,17,6,13,61,51,10,57
Stenhousem'r,9472,4,15,8,13,55,47,8,53
Clyde,9472,5,14,10,12,51,48,3,52
Elgin,9472,6,14,6,16,57,66,-9,48
Annan Athlet,9472,7,11,12,13,47,41,6,45
Berwick,9472,8,8,11,17,29,58,-29,35
Edinburgh Ci,9472,9,7,9,20,37,63,-26,30
Cowdenbeath,9472,10,4,11,21,23,54,-31,23
Montrose,9473,1,24,7,5,60,34,26,79
Peterhead,9473,2,24,4,8,84,38,46,76
Stenhousem'r,9473,3,16,8,12,57,47,10,56
Stirling,9473,4,16,6,14,61,53,8,54
Clyde,9473,5,14,10,12,52,49,3,52
Elgin,9473,6,14,6,16,53,61,-8,48
Annan Athlet,9473,7,12,11,13,49,42,7,47
Berwick,9473,8,8,11,17,30,59,-29,35
Edinburgh Ci,9473,9,7,9,20,36,67,-31,30
Cowdenbeath,9473,10,4,10,22,24,56,-32,22
Peterhead,9474,1,24,4,8,80,40,40,76
Montrose,9474,2,23,7,6,60,40,20,76
Stenhousem'r,9474,3,16,8,12,57,47,10,56
Stirling,9474,4,16,6,14,61,53,8,54
Clyde,9474,5,15,9,12,53,48,5,54
Elgin,9474,6,15,6,15,59,61,-2,51
Annan Athlet,9474,7,12,11,13,50,42,8,47
Berwick,9474,8,8,10,18,29,60,-31,34
Edinburgh Ci,9474,9,7,9,20,38,63,-25,30
Cowdenbeath,9474,10,4,10,22,24,57,-33,22
Montrose,9475,1,24,7,5,61,35,26,79
Peterhead,9475,2,24,4,8,80,40,40,76
Stenhousem'r,9475,3,16,8,12,58,47,11,56
Stirling,9475,4,16,6,14,61,54,7,54
Clyde,9475,5,15,9,12,54,48,6,54
Elgin,9475,6,14,6,16,54,62,-8,48
Annan Athlet,9475,7,11,11,14,49,44,5,44
Berwick,9475,8,8,10,18,29,61,-32,34
Edinburgh Ci,9475,9,7,9,20,38,63,-25,30
Cowdenbeath,9475,10,5,10,21,26,56,-30,25
Montrose,9476,1,24,7,5,60,34,26,79
Peterhead,9476,2,24,4,8,78,38,40,76
Stirling,9476,3,16,7,13,62,53,9,55
Stenhousem'r,9476,4,15,9,12,57,48,9,54
Clyde,9476,5,15,9,12,54,49,5,54
Elgin,9476,6,14,6,16,53,61,-8,48
Annan Athlet,9476,7,12,11,13,48,41,7,47
Berwick,9476,8,8,10,18,30,61,-31,34
Edinburgh Ci,9476,9,7,9,20,36,61,-25,30
Cowdenbeath,9476,10,4,10,22,23,55,-32,22
Peterhead,9477,1,24,4,8,80,38,42,76
Montrose,9477,2,23,7,6,60,36,24,76
Stirling,9477,3,16,7,13,62,53,9,55
Stenhousem'r,9477,4,15,9,12,57,48,9,54
Clyde,9477,5,15,9,12,54,49,5,54
Elgin,9477,6,15,6,15,55,61,-6,51
Annan Athlet,9477,7,11,11,14,49,44,5,44
Berwick,9477,8,8,10,18,30,61,-31,34
Edinburgh Ci,9477,9,7,9,20,36,63,-27,30
Cowdenbeath,9477,10,5,10,21,26,56,-30,25
Montrose,9478,1,23,8,5,59,34,25,77
Peterhead,9478,2,24,4,8,80,39,41,76
Stirling,9478,3,17,6,13,62,51,11,57
Clyde,9478,4,15,9,12,52,48,4,54
Stenhousem'r,9478,5,15,8,13,55,48,7,53
Elgin,9478,6,14,7,15,53,60,-7,49
Annan Athlet,9478,7,11,12,13,49,43,6,45
Berwick,9478,8,8,10,18,29,59,-30,34
Edinburgh Ci,9478,9,7,9,20,37,63,-26,30
Cowdenbeath,9478,10,4,11,21,25,56,-31,23
Montrose,9479,1,23,8,5,61,36,25,77
Peterhead,9479,2,23,4,9,78,40,38,73
Stirling,9479,3,17,6,13,64,54,10,57
Stenhousem'r,9479,4,15,8,13,58,50,8,53
Clyde,9479,5,14,9,13,51,50,1,51
Elgin,9479,6,14,7,15,55,62,-7,49
Annan Athlet,9479,7,12,11,13,48,41,7,47
Berwick,9479,8,9,10,17,31,58,-27,37
Edinburgh Ci,9479,9,8,9,19,38,61,-23,33
Cowdenbeath,9479,10,4,10,22,23,55,-32,22
Montrose,9480,1,23,8,5,60,35,25,77
Peterhead,9480,2,23,5,8,78,39,39,74
Stirling,9480,3,17,6,13,63,51,12,57
Clyde,9480,4,15,9,12,55,49,6,54
Stenhousem'r,9480,5,15,8,13,55,49,6,53
Elgin,9480,6,14,7,15,54,61,-7,49
Annan Athlet,9480,7,11,11,14,47,42,5,44
Berwick,9480,8,8,10,18,30,62,-32,34
Edinburgh Ci,9480,9,7,10,19,37,61,-24,31
Cowdenbeath,9480,10,5,10,21,24,54,-30,25
Montrose,9481,1,24,7,5,62,35,27,79
Peterhead,9481,2,24,4,8,81,38,43,76
Stirling,9481,3,17,6,13,63,52,11,57
Stenhousem'r,9481,4,15,8,13,56,49,7,53
Clyde,9481,5,14,9,13,53,51,2,51
Elgin,9481,6,14,6,16,54,63,-9,48
Annan Athlet,9481,7,11,11,14,47,44,3,44
Berwick,9481,8,9,10,17,32,60,-28,37
Edinburgh Ci,9481,9,7,9,20,36,64,-28,30
Cowdenbeath,9481,10,5,10,21,26,54,-28,25
Montrose,9482,1,23,8,5,60,35,25,77
Peterhead,9482,2,24,4,8,79,38,41,76
Stirling,9482,3,16,7,13,60,51,9,55
Stenhousem'r,9482,4,15,9,12,55,46,9,54
Clyde,9482,5,14,9,13,53,51,2,51
Elgin,9482,6,14,7,15,54,61,-7,49
Annan Athlet,9482,7,12,11,13,50,41,9,47
Berwick,9482,8,9,10,17,32,60,-28,37
Edinburgh Ci,9482,9,7,9,20,36,62,-26,30
Cowdenbeath,9482,10,4,10,22,23,57,-34,22
Montrose,9483,1,24,7,5,63,35,28,79
Peterhead,9483,2,23,5,8,79,40,39,74
Stirling,9483,3,17,6,13,64,53,11,57
Stenhousem'r,9483,4,15,8,13,57,50,7,53
Clyde,9483,5,14,9,13,51,49,2,51
Elgin,9483,6,14,6,16,54,64,-10,48
Annan Athlet,9483,7,12,11,13,48,41,7,47
Berwick,9483,8,9,10,17,30,58,-28,37
Edinburgh Ci,9483,9,7,10,19,38,62,-24,31
Cowdenbeath,9483,10,4,10,22,23,55,-32,22
Montrose,9484,1,23,8,5,61,36,25,77
Peterhead,9484,2,24,4,8,83,38,45,76
Stirling,9484,3,17,6,13,61,51,10,57
Stenhousem'r,9484,4,15,8,13,55,47,8,53
Clyde,9484,5,14,9,13,52,50,2,51
Elgin,9484,6,14,7,15,55,62,-7,49
Annan Athlet,9484,7,12,11,13,48,41,7,47
Berwick,9484,8,9,10,17,31,59,-28,37
Edinburgh Ci,9484,9,7,9,20,36,66,-30,30
Cowdenbeath,9484,10,4,10,22,23,55,-32,22
Montrose,9485,1,24,7,5,60,34,26,79
Peterhead,9485,2,23,4,9,77,39,38,73
Stenhousem'r,9485,3,16,8,12,56,46,10,56
Stirling,9485,4,16,6,14,60,52,8,54
Clyde,9485,5,14,10,12,53,50,3,52
Elgin,9485,6,14,6,16,53,61,-8,48
Annan Athlet,9485,7,12,11,13,48,41,7,47
Berwick,9485,8,8,11,17,31,60,-29,35
Edinburgh Ci,9485,9,8,9,19,37,60,-23,33
Cowdenbeath,9485,10,4,10,22,23,55,-32,22
Montrose,9486,1,24,7,5,65,34,31,79
Peterhead,9486,2,23,4,9,78,40,38,73
Stirling,9486,3,17,6,13,64,52,12,57
Stenhousem'r,9486,4,15,8,13,56,50,6,53
Clyde,9486,5,14,10,12,52,49,3,52
Elgin,9486,6,14,6,16,53,66,-13,48
Annan Athlet,9486,7,12,11,13,48,41,7,47
Berwick,9486,8,8,11,17,30,59,-29,35
Edinburgh Ci,9486,9,8,9,19,38,61,-23,33
Cowdenbeath,9486,10,4,10,22,23,55,-32,22
Montrose,9487,1,24,7,5,60,34,26,79
Peterhead,9487,2,23,4,9,78,40,38,73
Stirling,9487,3,16,7,13,61,52,9,55
Stenhousem'r,9487,4,15,9,12,56,47,9,54
Clyde,9487,5,14,9,13,51,49,2,51
Elgin,9487,6,14,6,16,53,61,-8,48
Annan Athlet,9487,7,11,12,13,47,41,6,45
Berwick,9487,8,9,10,17,30,58,-28,37
Edinburgh Ci,9487,9,8,9,19,38,61,-23,33
Cowdenbeath,9487,10,4,11,21,23,54,-31,23
Montrose,9488,1,23,8,5,59,34,25,77
Peterhead,9488,2,24,4,8,81,40,41,76
Stirling,9488,3,16,7,13,60,51,9,55
Stenhousem'r,9488,4,15,9,12,55,46,9,54
Clyde,9488,5,14,9,13,51,49,2,51
Elgin,9488,6,14,7,15,53,60,-7,49
Annan Athlet,9488,7,11,11,14,48,43,5,44
Berwick,9488,8,9,10,17,30,58,-28,37
Edinburgh Ci,9488,9,7,9,20,38,64,-26,30
Cowdenbeath,9488,10,5,10,21,25,55,-30,25
Montrose,9489,1,24,7,5,64,34,30,79
Peterhead,9489,2,24,4,8,81,40,41,76
Stirling,9489,3,16,7,13,61,52,9,55
Stenhousem'r,9489,4,15,9,12,56,47,9,54
Clyde,9489,5,15,9,12,53,49,4,54
Elgin,9489,6,14,6,16,53,65,-12,48
Annan Athlet,9489,7,11,11,14,47,42,5,44
Berwick,9489,8,8,10,18,30,60,-30,34
Edinburgh Ci,9489,9,7,9,20,38,64,-26,30
Cowdenbeath,9489,10,5,10,21,24,54,-30,25
Montrose,9490,1,23,8,5,61,36,25,77
Peterhead,9490,2,24,4,8,79,39,40,76
Stenhousem'r,9490,3,16,8,12,58,46,12,56
Stirling,9490,4,16,6,14,60,54,6,54
Clyde,9490,5,14,9,13,53,51,2,51
Elgin,9490,6,14,7,15,55,62,-7,49
Annan Athlet,9490,7,12,11,13,49,42,7,47
Berwick,9490,8,9,10,17,32,60,-28,37
Edinburgh Ci,9490,9,7,9,20,37,62,-25,30
Cowdenbeath,9490,10,4,10,22,24,56,-32,22
Montrose,9491,1,24,7,5,62,34,28,79
Peterhead,9491,2,23,4,9,77,39,38,73
Stenhousem'r,9491,3,16,8,12,60,49,11,56
Stirling,9491,4,16,6,14,63,56,7,54
Clyde,9491,5,15,9,12,53,49,4,54
Elgin,9491,6,14,6,16,53,63,-10,48
Annan Athlet,9491,7,11,11,14,47,42,5,44
Berwick,9491,8,8,10,18,30,60,-30,34
Edinburgh Ci,9491,9,8,9,19,37,60,-23,33
Cowdenbeath,9491,10,5,10,21,24,54,-30,25
Montrose,9492,1,23,8,5,59,34,25,77
Peterhead,9492,2,24,4,8,79,39,40,76
Stirling,9492,3,17,6,13,63,52,11,57
Stenhousem'r,9492,4,15,8,13,56,49,7,53
Clyde,9492,5,14,9,13,51,49,2,51
Elgin,9492,6,14,7,15,53,60,-7,49
Annan Athlet,9492,7,11,11,14,48,45,3,44
Berwick,9492,8,9,10,17,30,58,-28,37
Edinburgh Ci,9492,9,7,9,20,37,62,-25,30
Cowdenbeath,9492,10,5,10,21,27,55,-28,25
Peterhead,9493,1,24,4,8,79,38,41,76
Montrose,9493,2,23,7,6,59,35,24,76
Stirling,9493,3,17,6,13,63,53,10,57
Stenhousem'r,9493,4,15,8,13,57,49,8,53
Clyde,9493,5,14,10,12,52,49,3,52
Elgin,9493,6,15,6,15,54,60,-6,51
Annan Athlet,9493,7,11,12,13,49,43,6,45
Berwick,9493,8,8,11,17,30,59,-29,35
Edinburgh Ci,9493,9,7,9,20,36,62,-26,30
Cowdenbeath,9493,10,4,11,21,25,56,-31,23
Montrose,9494,1,24,7,5,60,34,26,79
Peterhead,9494,2,24,4,8,79,39,40,76
Stirling,9494,3,17,6,13,62,52,10,57
Clyde,9494,4,15,9,12,55,48,7,54
Stenhousem'r,9494,5,15,8,13,56,48,8,53
Elgin,9494,6,14,6,16,53,61,-8,48
Annan Athlet,9494,7,11,12,13,48,42,6,45
Berwick,9494,8,8,10,18,29,62,-33,34
Edinburgh Ci,9494,9,7,9,20,37,62,-25,30
Cowdenbeath,9494,10,4,11,21,24,55,-31,23
Montrose,9495,1,23,8,5,60,35,25,77
Peterhead,9495,2,24,4,8,80,39,41,76
Stirling,9495,3,16,7,13,61,52,9,55
Stenhousem'r,9495,4,15,9,12,56,47,9,54
Clyde,9495,5,14,9,13,51,49,2,51
Elgin,9495,6,14,7,15,54,61,-7,49
Annan Athlet,9495,7,12,11,13,48,41,7,47
Berwick,9495,8,9,10,17,30,58,-28,37
Edinburgh Ci,9495,9,7,9,20,37,63,-26,30
Cowdenbeath,9495,10,4,10,22,23,55,-32,22
Montrose,9496,1,24,7,5,64,35,29,79
Peterhead,9496,2,24,4,8,80,38,42,76
Stenhousem'r,9496,3,16,8,12,58,48,10,56
Stirling,9496,4,16,6,14,62,54,8,54
Clyde,9496,5,15,9,12,52,48,4,54
Elgin,9496,6,14,6,16,54,65,-11,48
Annan Athlet,9496,7,12,11,13,49,41,8,47
Berwick,9496,8,8,10,18,29,59,-30,34
Edinburgh Ci,9496,9,7,9,20,36,63,-27,30
Cowdenbeath,9496,10,4,10,22,23,56,-33,22
Montrose,9497,1,24,7,5,63,34,29,79
Peterhead,9497,2,24,4,8,80,39,41,76
Stenhousem'r,9497,3,16,8,12,58,47,11,56
Stirling,9497,4,16,6,14,61,54,7,54
Clyde,9497,5,15,9,12,52,48,4,54
Elgin,9497,6,14,6,16,53,64,-11,48
Annan Athlet,9497,7,12,11,13,49,41,8,47
Berwick,9497,8,8,10,18,29,59,-30,34
Edinburgh Ci,9497,9,7,9,20,37,63,-26,30
Cowdenbeath,9497,10,4,10,22,23,56,-33,22
Peterhead,9498,1,24,4,8,83,43,40,76
Montrose,9498,2,23,7,6,62,38,24,76
Stirling,9498,3,17,6,13,61,51,10,57
Clyde,9498,4,15,9,12,53,48,5,54
Stenhousem'r,9498,5,15,8,13,55,47,8,53
Elgin,9498,6,15,6,15,57,63,-6,51
Annan Athlet,9498,7,11,12,13,48,42,6,45
Berwick,9498,8,8,10,18,29,60,-31,34
Edinburgh Ci,9498,9,7,9,20,41,66,-25,30
Cowdenbeath,9498,10,4,11,21,24,55,-31,23
Montrose,9499,1,24,7,5,64,34,30,79
Peterhead,9499,2,24,4,8,79,39,40,76
Stirling,9499,3,17,6,13,62,52,10,57
Clyde,9499,4,15,9,12,54,49,5,54
Stenhousem'r,9499,5,15,8,13,56,48,8,53
Elgin,9499,6,14,6,16,53,65,-12,48
Annan Athlet,9499,7,12,11,13,48,41,7,47
Berwick,9499,8,8,10,18,30,61,-31,34
Edinburgh Ci,9499,9,7,9,20,37,62,-25,30
Cowdenbeath,9499,10,4,10,22,23,55,-32,22
Montrose,9500,1,24,7,5,64,35,29,79
Peterhead,9500,2,23,5,8,79,40,39,74
Stirling,9500,3,17,6,13,61,51,10,57
Stenhousem'r,9500,4,15,8,13,55,47,8,53
Clyde,9500,5,14,9,13,51,50,1,51
Elgin,9500,6,14,6,16,54,65,-11,48
Annan Athlet,9500,7,11,11,14,49,45,4,44
Berwick,9500,8,9,10,17,31,58,-27,37
Edinburgh Ci,9500,9,7,10,19,38,62,-24,31
Cowdenbeath,9500,10,5,10,21,27,56,-29,25
Montrose,9501,1,23,7,6,59,36,23,76
Peterhead,9501,2,23,4,9,77,39,38,73
Stirling,9501,3,16,7,13,61,52,9,55
Stenhousem'r,9501,4,15,9,12,56,47,9,54
Clyde,9501,5,14,10,12,52,49,3,52
Elgin,9501,6,15,6,15,55,60,-5,51
Annan Athlet,9501,7,11,12,13,49,43,6,45
Berwick,9501,8,8,11,17,30,59,-29,35
Edinburgh Ci,9501,9,8,9,19,37,60,-23,33
Cowdenbeath,9501,10,4,11,21,25,56,-31,23
Montrose,9502,1,24,7,5,62,35,27,79
Peterhead,9502,2,24,4,8,79,38,41,76
Stirling,9502,3,16,7,13,61,52,9,55
Stenhousem'r,9502,4,15,9,12,56,47,9,54
Clyde,9502,5,14,10,12,53,50,3,52
Elgin,9502,6,14,6,16,54,63,-9,48
Annan Athlet,9502,7,11,12,13,49,43,6,45
Berwick,9502,8,8,11,17,31,60,-29,35
Edinburgh Ci,9502,9,7,9,20,36,62,-26,30
Cowdenbeath,9502,10,4,11,21,25,56,-31,23
Montrose,9503,1,24,7,5,64,36,28,79
Peterhead,9503,2,24,4,8,79,38,41,76
Stirling,9503,3,16,7,13,62,53,9,55
Stenhousem'r,9503,4,15,9,12,57,48,9,54
Clyde,9503,5,14,9,13,52,50,2,51
Elgin,9503,6,14,6,16,55,65,-10,48
Annan Athlet,9503,7,12,11,13,48,41,7,47
Berwick,9503,8,9,10,17,31,59,-28,37
Edinburgh Ci,9503,9,7,9,20,36,62,-26,30
Cowdenbeath,9503,10,4,10,22,23,55,-32,22
Peterhead,9504,1,24,4,8,81,39,42,76
Montrose,9504,2,23,7,6,59,36,23,76
Stirling,9504,3,16,7,13,61,52,9,55
Stenhousem'r,9504,4,15,9,12,56,47,9,54
Clyde,9504,5,15,9,12,55,49,6,54
Elgin,9504,6,15,6,15,55,60,-5,51
Annan Athlet,9504,7,11,12,13,47,41,6,45
Berwick,9504,8,8,10,18,30,62,-32,34
Edinburgh Ci,9504,9,7,9,20,37,64,-27,30
Cowdenbeath,9504,10,4,11,21,23,54,-31,23
Montrose,9505,1,24,7,5,62,34,28,79
Peterhead,9505,2,24,4,8,81,39,42,76
Stirling,9505,3,17,6,13,62,51,11,57
Clyde,9505,4,15,9,12,54,50,4,54
Stenhousem'r,9505,5,15,8,13,55,48,7,53
Elgin,9505,6,14,6,16,53,63,-10,48
Annan Athlet,9505,7,11,12,13,48,42,6,45
Berwick,9505,8,8,10,18,31,61,-30,34
Edinburgh Ci,9505,9,7,9,20,37,64,-27,30
Cowdenbeath,9505,10,4,11,21,24,55,-31,23
Peterhead,9506,1,24,4,8,81,38,43,76
Montrose,9506,2,23,7,6,59,35,24,76
Stirling,9506,3,16,7,13,62,53,9,55
Stenhousem'r,9506,4,15,9,12,57,48,9,54
Clyde,9506,5,14,10,12,52,49,3,52
Elgin,9506,6,15,6,15,54,60,-6,51
Annan Athlet,9506,7,11,12,13,48,42,6,45
Berwick,9506,8,8,11,17,30,59,-29,35
Edinburgh Ci,9506,9,7,9,20,36,64,-28,30
Cowdenbeath,9506,10,4,11,21,24,55,-31,23
Montrose,9507,1,24,7,5,62,34,28,79
Peterhead,9507,2,24,4,8,82,39,43,76
Stirling,9507,3,16,7,13,60,51,9,55
Stenhousem'r,9507,4,15,9,12,55,46,9,54
Clyde,9507,5,15,9,12,54,49,5,54
Elgin,9507,6,14,6,16,53,63,-10,48
Annan Athlet,9507,7,11,12,13,47,41,6,45
Berwick,9507,8,8,10,18,30,61,-31,34
Edinburgh Ci,9507,9,7,9,20,37,65,-28,30
Cowdenbeath,9507,10,4,11,21,23,54,-31,23
Montrose,9508,1,24,7,5,60,34,26,79
Peterhead,9508,2,24,4,8,80,39,41,76
Stirling,9508,3,16,7,13,61,52,9,55
Stenhousem'r,9508,4,15,9,12,56,47,9,54
Clyde,9508,5,14,10,12,51,48,3,52
Elgin,9508,6,14,6,16,53,61,-8,48
Annan Athlet,9508,7,11,11,14,47,42,5,44
Berwick,9508,8,8,11,17,29,58,-29,35
Edinburgh Ci,9508,9,7,9,20,37,63,-26,30
Cowdenbeath,9508,10,5,10,21,24,54,-30,25
Montrose,9509,1,24,7,5,63,36,27,79
Peterhead,9509,2,24,4,8,79,38,41,76
Stenhousem'r,9509,3,16,8,12,57,47,10,56
Stirling,9509,4,16,6,14,61,53,8,54
Clyde,9509,5,15,9,12,54,49,5,54
Elgin,9509,6,14,6,16,55,64,-9,48
Annan Athlet,9509,7,12,11,13,51,42,9,47
Berwick,9509,8,8,10,18,30,61,-31,34
Edinburgh Ci,9509,9,7,9,20,36,62,-26,30
Cowdenbeath,9509,10,4,10,22,24,58,-34,22
Montrose,9510,1,24,7,5,60,34,26,79
Peterhead,9510,2,24,4,8,81,40,41,76
Stirling,9510,3,17,6,13,62,51,11,57
Clyde,9510,4,15,9,12,52,48,4,54
Stenhousem'r,9510,5,15,8,13,55,48,7,53
Elgin,9510,6,14,6,16,53,61,-8,48
Annan Athlet,9510,7,12,11,13,49,42,7,47
Berwick,9510,8,8,10,18,29,59,-30,34
Edinburgh Ci,9510,9,7,9,20,38,64,-26,30
Cowdenbeath,9510,10,4,10,22,24,56,-32,22
Montrose,9511,1,23,8,5,60,35,25,77
Peterhead,9511,2,23,5,8,77,38,39,74
Stirling,9511,3,16,7,13,62,53,9,55
Stenhousem'r,9511,4,15,9,12,57,48,9,54
Clyde,9511,5,15,9,12,53,48,5,54
Elgin,9511,6,14,7,15,54,61,-7,49
Annan Athlet,9511,7,11,11,14,47,42,5,44
Berwick,9511,8,8,10,18,29,60,-31,34
Edinburgh Ci,9511,9,7,10,19,36,60,-24,31
Cowdenbeath,9511,10,5,10,21,24,54,-30,25
Montrose,9512,1,24,7,5,62,35,27,79
Peterhead,9512,2,24,4,8,80,40,40,76
Stirling,9512,3,17,6,13,61,51,10,57
Clyde,9512,4,15,9,12,53,49,4,54
Stenhousem'r,9512,5,15,8,13,55,47,8,53
Elgin,9512,6,14,6,16,54,63,-9,48
Annan Athlet,9512,7,12,11,13,48,41,7,47
Berwick,9512,8,8,10,18,30,60,-30,34
Edinburgh Ci,9512,9,7,9,20,38,63,-25,30
Cowdenbeath,9512,10,4,10,22,23,55,-32,22
Montrose,9513,1,23,8,5,60,35,25,77
Peterhead,9513,2,23,4,9,78,41,37,73
Stirling,9513,3,17,6,13,61,51,10,57
Stenhousem'r,9513,4,15,8,13,55,47,8,53
Clyde,9513,5,14,9,13,52,50,2,51
Elgin,9513,6,14,7,15,54,61,-7,49
Annan Athlet,9513,7,12,11,13,48,41,7,47
Berwick,9513,8,9,10,17,31,59,-28,37
Edinburgh Ci,9513,9,8,9,19,39,61,-22,33
Cowdenbeath,9513,10,4,10,22,23,55,-32,22
Montrose,9514,1,24,7,5,60,34,26,79
Peterhead,9514,2,23,4,9,78,40,38,73
Stirling,9514,3,16,7,13,62,53,9,55
Stenhousem'r,9514,4,15,9,12,57,48,9,54
Clyde,9514,5,15,9,12,53,49,4,54
Elgin,9514,6,14,6,16,53,61,-8,48
Annan Athlet,9514,7,12,11,13,49,42,7,47
Berwick,9514,8,8,10,18,30,60,-30,34
Edinburgh Ci,9514,9,8,9,19,38,61,-23,33
Cowdenbeath,9514,10,4,10,22,24,56,-32,22
Montrose,9515,1,24,7,5,63,35,28,79
Peterhead,9515,2,23,5,8,79,40,39,74
Stenhousem'r,9515,3,16,8,12,56,46,10,56
Stirling,9515,4,16,6,14,60,52,8,54
Clyde,9515,5,14,9,13,51,51,0,51
Elgin,9515,6,14,6,16,54,64,-10,48
Annan Athlet,9515,7,12,11,13,51,42,9,47
Berwick,9515,8,9,10,17,32,58,-26,37
Edinburgh Ci,9515,9,7,10,19,38,62,-24,31
Cowdenbeath,9515,10,4,10,22,24,58,-34,22
Montrose,9516,1,24,7,5,62,34,28,79
Peterhead,9516,2,24,4,8,82,39,43,76
Stirling,9516,3,16,7,13,60,51,9,55
Stenhousem'r,9516,4,15,9,12,55,46,9,54
Clyde,9516,5,15,9,12,52,48,4,54
Elgin,9516,6,14,6,16,53,63,-10,48
Annan Athlet,9516,7,11,11,14,47,42,5,44
Berwick,9516,8,8,10,18,29,59,-30,34
Edinburgh Ci,9516,9,7,9,20,37,65,-28,30
Cowdenbeath,9516,10,5,10,21,24,54,-30,25
Montrose,9517,1,24,7,5,62,34,28,79
Peterhead,9517,2,24,4,8,83,38,45,76
Stirling,9517,3,16,7,13,62,53,9,55
Stenhousem'r,9517,4,15,9,12,57,48,9,54
Clyde,9517,5,14,10,12,52,49,3,52
Elgin,9517,6,14,6,16,53,63,-10,48
Annan Athlet,9517,7,12,11,13,51,42,9,47
Berwick,9517,8,8,11,17,30,59,-29,35
Edinburgh Ci,9517,9,7,9,20,36,66,-30,30
Cowdenbeath,9517,10,4,10,22,24,58,-34,22
Montrose,9518,1,24,7,5,63,36,27,79
Peterhead,9518,2,24,4,8,79,38,41,76
Stenhousem'r,9518,3,16,8,12,56,46,10,56
Stirling,9518,4,16,6,14,60,52,8,54
Clyde,9518,5,14,9,13,51,49,2,51
Elgin,9518,6,14,6,16,55,64,-9,48
Annan Athlet,9518,7,11,12,13,47,41,6,45
Berwick,9518,8,9,10,17,30,58,-28,37
Edinburgh Ci,9518,9,7,9,20,36,62,-26,30
Cowdenbeath,9518,10,4,11,21,23,54,-31,23
Montrose,9519,1,24,7,5,62,36,26,79
Peterhead,9519,2,24,4,8,81,40,41,76
Stenhousem'r,9519,3,16,8,12,58,47,11,56
Stirling,9519,4,16,6,14,61,54,7,54
Clyde,9519,5,15,9,12,52,48,4,54
Elgin,9519,6,14,6,16,55,63,-8,48
Annan Athlet,9519,7,11,11,14,48,43,5,44
Berwick,9519,8,8,10,18,29,59,-30,34
Edinburgh Ci,9519,9,7,9,20,38,64,-26,30
Cowdenbeath,9519,10,5,10,21,25,55,-30,25
Peterhead,9520,1,24,4,8,79,38,41,76
Montrose,9520,2,23,7,6,60,36,24,76
Stirling,9520,3,17,6,13,63,52,11,57
Stenhousem'r,9520,4,15,8,13,56,49,7,53
Clyde,9520,5,14,10,12,51,48,3,52
Elgin,9520,6,15,6,15,55,61,-6,51
Annan Athlet,9520,7,11,11,14,47,42,5,44
Berwick,9520,8,8,11,17,29,58,-29,35
Edinburgh Ci,9520,9,7,9,20,36,62,-26,30
Cowdenbeath,9520,10,5,10,21,24,54,-30,25
Montrose,9521,1,24,7,5,64,35,29,79
Peterhead,9521,2,24,4,8,79,39,40,76
Stirling,9521,3,16,7,13,63,54,9,55
Stenhousem'r,9521,4,15,9,12,58,49,9,54
Clyde,9521,5,14,10,12,52,49,3,52
Elgin,9521,6,14,6,16,54,65,-11,48
Annan Athlet,9521,7,11,12,13,47,41,6,45
Berwick,9521,8,8,11,17,30,59,-29,35
Edinburgh Ci,9521,9,7,9,20,37,62,-25,30
Cowdenbeath,9521,10,4,11,21,23,54,-31,23
Montrose,9522,1,24,7,5,62,34,28,79
Peterhead,9522,2,24,4,8,80,39,41,76
Stirling,9522,3,17,6,13,63,52,11,57
Clyde,9522,4,15,9,12,53,48,5,54
Stenhousem'r,9522,5,15,8,13,56,49,7,53
Elgin,9522,6,14,6,16,53,63,-10,48
Annan Athlet,9522,7,11,12,13,49,43,6,45
Berwick,9522,8,8,10,18,29,60,-31,34
Edinburgh Ci,9522,9,7,9,20,37,63,-26,30
Cowdenbeath,9522,10,4,11,21,25,56,-31,23
Montrose,9523,1,24,7,5,62,35,27,79
Peterhead,9523,2,23,5,8,78,39,39,74
Stenhousem'r,9523,3,16,8,12,57,46,11,56
Stirling,9523,4,16,6,14,60,53,7,54
Clyde,9523,5,15,9,12,52,48,4,54
Elgin,9523,6,14,6,16,54,63,-9,48
Annan Athlet,9523,7,12,11,13,51,42,9,47
Berwick,9523,8,8,10,18,29,59,-30,34
Edinburgh Ci,9523,9,7,10,19,37,61,-24,31
Cowdenbeath,9523,10,4,10,22,24,58,-34,22
Peterhead,9524,1,24,4,8,79,38,41,76
Montrose,9524,2,23,7,6,61,37,24,76
Stirling,9524,3,16,7,13,62,53,9,55
Stenhousem'r,9524,4,15,9,12,57,48,9,54
Clyde,9524,5,15,9,12,53,49,4,54
Elgin,9524,6,15,6,15,56,62,-6,51
Annan Athlet,9524,7,11,11,14,47,43,4,44
Berwick,9524,8,8,10,18,30,60,-30,34
Edinburgh Ci,9524,9,7,9,20,36,62,-26,30
Cowdenbeath,9524,10,5,10,21,25,54,-29,25
Peterhead,9525,1,24,4,8,79,38,41,76
Montrose,9525,2,23,7,6,60,36,24,76
Stirling,9525,3,16,7,13,62,53,9,55
Stenhousem'r,9525,4,15,9,12,57,48,9,54
Clyde,9525,5,15,9,12,54,50,4,54
Elgin,9525,6,15,6,15,55,61,-6,51
Annan Athlet,9525,7,11,11,14,50,46,4,44
Berwick,9525,8,8,10,18,31,61,-30,34
Edinburgh Ci,9525,9,7,9,20,36,62,-26,30
Cowdenbeath,9525,10,5,10,21,28,57,-29,25
Montrose,9526,1,24,7,5,62,34,28,79
Peterhead,9526,2,24,4,8,79,39,40,76
Stirling,9526,3,16,7,13,62,53,9,55
Stenhousem'r,9526,4,15,9,12,57,48,9,54
Clyde,9526,5,15,9,12,53,49,4,54
Elgin,9526,6,14,6,16,53,63,-10,48
Annan Athlet,9526,7,11,11,14,47,42,5,44
Berwick,9526,8,8,10,18,30,60,-30,34
Edinburgh Ci,9526,9,7,9,20,37,62,-25,30
Cowdenbeath,9526,10,5,10,21,24,54,-30,25
Peterhead,9527,1,24,4,8,80,39,41,76
Montrose,9527,2,23,7,6,59,36,23,76
Stirling,9527,3,17,6,13,63,51,12,57
Clyde,9527,4,15,9,12,54,48,6,54
Stenhousem'r,9527,5,15,8,13,55,49,6,53
Elgin,9527,6,15,6,15,55,60,-5,51
Annan Athlet,9527,7,11,12,13,47,41,6,45
Berwick,9527,8,8,10,18,29,61,-32,34
Edinburgh Ci,9527,9,7,9,20,37,63,-26,30
Cowdenbeath,9527,10,4,11,21,23,54,-31,23
Montrose,9528,1,24,7,5,61,35,26,79
Peterhead,9528,2,24,4,8,78,38,40,76
Stirling,9528,3,17,6,13,62,52,10,57
Clyde,9528,4,15,9,12,54,50,4,54
Stenhousem'r,9528,5,15,8,13,56,48,8,53
Elgin,9528,6,14,6,16,54,62,-8,48
Annan Athlet,9528,7,12,11,13,49,41,8,47
Berwick,9528,8,8,10,18,31,61,-30,34
Edinburgh Ci,9528,9,7,9,20,36,61,-25,30
Cowdenbeath,9528,10,4,10,22,23,56,-33,22
Montrose,9529,1,23,8,5,60,35,25,77
Peterhead,9529,2,23,5,8,77,38,39,74
Stenhousem'r,9529,3,16,8,12,56,46,10,56
Stirling,9529,4,16,6,14,60,52,8,54
Clyde,9529,5,15,9,12,54,48,6,54
Elgin,9529,6,14,7,15,54,61,-7,49
Annan Athlet,9529,7,11,12,13,48,42,6,45
Berwick,9529,8,8,10,18,29,61,-32,34
Edinburgh Ci,9529,9,7,10,19,36,60,-24,31
Cowdenbeath,9529,10,4,11,21,24,55,-31,23
Montrose,9530,1,24,7,5,64,35,29,79
Peterhead,9530,2,24,4,8,80,38,42,76
Stirling,9530,3,17,6,13,62,52,10,57
Stenhousem'r,9530,4,15,8,13,56,48,8,53
Clyde,9530,5,14,9,13,52,50,2,51
Elgin,9530,6,14,6,16,54,65,-11,48
Annan Athlet,9530,7,11,11,14,47,43,4,44
Berwick,9530,8,9,10,17,31,59,-28,37
Edinburgh Ci,9530,9,7,9,20,36,63,-27,30
Cowdenbeath,9530,10,5,10,21,25,54,-29,25
Montrose,9531,1,23,8,5,59,34,25,77
Peterhead,9531,2,24,4,8,79,38,41,76
Stirling,9531,3,17,6,13,63,51,12,57
Clyde,9531,4,15,9,12,54,50,4,54
Stenhousem'r,9531,5,15,8,13,55,49,6,53
Elgin,9531,6,14,7,15,53,60,-7,49
Annan Athlet,9531,7,12,11,13,50,42,8,47
Berwick,9531,8,8,10,18,31,61,-30,34
Edinburgh Ci,9531,9,7,9,20,36,62,-26,30
Cowdenbeath,9531,10,4,10,22,24,57,-33,22
Montrose,9532,1,24,7,5,62,34,28,79
Peterhead,9532,2,23,4,9,77,39,38,73
Stenhousem'r,9532,3,16,8,12,57,47,10,56
Stirling,9532,4,16,6,14,61,53,8,54
Clyde,9532,5,14,10,12,51,48,3,52
Elgin,9532,6,14,6,16,53,63,-10,48
Annan Athlet,9532,7,11,12,13,48,42,6,45
Berwick,9532,8,8,11,17,29,58,-29,35
Edinburgh Ci,9532,9,8,9,19,37,60,-23,33
Cowdenbeath,9532,10,4,11,21,24,55,-31,23
Montrose,9533,1,24,7,5,60,34,26,79
Peterhead,9533,2,24,4,8,80,39,41,76
Stirling,9533,3,17,6,13,66,52,14,57
Clyde,9533,4,15,9,12,53,48,5,54
Stenhousem'r,9533,5,15,8,13,56,52,4,53
Elgin,9533,6,14,6,16,53,61,-8,48
Annan Athlet,9533,7,11,12,13,49,43,6,45
Berwick,9533,8,8,10,18,29,60,-31,34
Edinburgh Ci,9533,9,7,9,20,37,63,-26,30
Cowdenbeath,9533,10,4,11,21,25,56,-31,23
Montrose,9534,1,23,8,5,60,35,25,77
Peterhead,9534,2,24,4,8,84,38,46,76
Stirling,9534,3,17,6,13,63,53,10,57
Stenhousem'r,9534,4,15,8,13,57,49,8,53
Clyde,9534,5,14,9,13,52,51,1,51
Elgin,9534,6,14,7,15,54,61,-7,49
Annan Athlet,9534,7,11,11,14,47,42,5,44
Berwick,9534,8,9,10,17,32,59,-27,37
Edinburgh Ci,9534,9,7,9,20,36,67,-31,30
Cowdenbeath,9534,10,5,10,21,24,54,-30,25
Montrose,9535,1,24,7,5,64,34,30,79
Peterhead,9535,2,23,5,8,78,39,39,74
Stirling,9535,3,17,6,13,62,51,11,57
Stenhousem'r,9535,4,15,8,13,55,48,7,53
Clyde,9535,5,14,10,12,51,48,3,52
Elgin,9535,6,14,6,16,53,65,-12,48
Annan Athlet,9535,7,11,12,13,47,41,6,45
Berwick,9535,8,8,11,17,29,58,-29,35
Edinburgh Ci,9535,9,7,10,19,37,61,-24,31
Cowdenbeath,9535,10,4,11,21,23,54,-31,23
Montrose,9536,1,24,7,5,62,34,28,79
Peterhead,9536,2,24,4,8,78,38,40,76
Stenhousem'r,9536,3,16,8,12,58,47,11,56
Stirling,9536,4,16,6,14,61,54,7,54
Clyde,9536,5,15,9,12,54,48,6,54
Elgin,9536,6,14,6,16,53,63,-10,48
Annan Athlet,9536,7,11,11,14,47,42,5,44
Berwick,9536,8,8,10,18,29,61,-32,34
Edinburgh Ci,9536,9,7,9,20,36,61,-25,30
Cowdenbeath,9536,10,5,10,21,24,54,-30,25
Peterhead,9537,1,24,4,8,83,40,43,76
Montrose,9537,2,23,7,6,60,36,24,76
Stirling,9537,3,17,6,13,64,51,13,57
Stenhousem'r,9537,4,15,8,13,55,50,5,53
Clyde,9537,5,14,10,12,53,50,3,52
Elgin,9537,6,15,6,15,55,61,-6,51
Annan Athlet,9537,7,11,11,14,49,44,5,44
Berwick,9537,8,8,11,17,31,60,-29,35
Edinburgh Ci,9537,9,7,9,20,38,66,-28,30
Cowdenbeath,9537,10,5,10,21,26,56,-30,25
Montrose,9538,1,24,7,5,62,34,28,79
Peterhead,9538,2,24,4,8,82,38,44,76
Stirling,9538,3,17,6,13,64,52,12,57
Stenhousem'r,9538,4,15,8,13,56,50,6,53
Clyde,9538,5,14,10,12,52,49,3,52
Elgin,9538,6,14,6,16,53,63,-10,48
Annan Athlet,9538,7,11,11,14,47,42,5,44
Berwick,9538,8,8,11,17,30,59,-29,35
Edinburgh Ci,9538,9,7,9,20,36,65,-29,30
Cowdenbeath,9538,10,5,10,21,24,54,-30,25
Peterhead,9539,1,24,4,8,78,38,40,76
Montrose,9539,2,23,7,6,60,37,23,76
Stirling,9539,3,17,6,13,65,52,13,57
Clyde,9539,4,15,9,12,55,51,4,54
Stenhousem'r,9539,5,15,8,13,56,51,5,53
Elgin,9539,6,15,6,15,56,61,-5,51
Annan Athlet,9539,7,11,12,13,49,43,6,45
Berwick,9539,8,8,10,18,32,62,-30,34
Edinburgh Ci,9539,9,7,9,20,36,61,-25,30
Cowdenbeath,9539,10,4,11,21,25,56,-31,23
Montrose,9540,1,24,7,5,61,34,27,79
Peterhead,9540,2,24,4,8,81,39,42,76
Stenhousem'r,9540,3,16,8,12,57,46,11,56
Stirling,9540,4,16,6,14,60,53,7,54
Clyde,9540,5,14,9,13,53,51,2,51
Elgin,9540,6,14,6,16,53,62,-9,48
Annan Athlet,9540,7,12,11,13,48,41,7,47
Berwick,9540,8,9,10,17,32,60,-28,37
Edinburgh Ci,9540,9,7,9,20,37,64,-27,30
Cowdenbeath,9540,10,4,10,22,23,55,-32,22
Montrose,9541,1,24,7,5,61,35,26,79
Peterhead,9541,2,24,4,8,84,38,46,76
Stirling,9541,3,17,6,13,63,51,12,57
Clyde,9541,4,15,9,12,53,49,4,54
Stenhousem'r,9541,5,15,8,13,55,49,6,53
Elgin,9541,6,14,6,16,54,62,-8,48
Annan Athlet,9541,7,11,11,14,47,42,5,44
Berwick,9541,8,8,10,18,30,60,-30,34
Edinburgh Ci,9541,9,7,9,20,36,67,-31,30
Cowdenbeath,9541,10,5,10,21,24,54,-30,25
Peterhead,9542,1,24,4,8,80,38,42,76
Montrose,9542,2,23,7,6,59,35,24,76
Stirling,9542,3,17,6,13,62,52,10,57
Clyde,9542,4,15,9,12,53,49,4,54
Stenhousem'r,9542,5,15,8,13,56,48,8,53
Elgin,9542,6,15,6,15,54,60,-6,51
Annan Athlet,9542,7,11,11,14,47,43,4,44
Berwick,9542,8,8,10,18,30,60,-30,34
Edinburgh Ci,9542,9,7,9,20,36,63,-27,30
Cowdenbeath,9542,10,5,10,21,25,54,-29,25
Montrose,9543,1,24,7,5,62,34,28,79
Peterhead,9543,2,24,4,8,79,39,40,76
Stirling,9543,3,17,6,13,63,53,10,57
Stenhousem'r,9543,4,15,8,13,57,49,8,53
Clyde,9543,5,14,9,13,52,50,2,51
Elgin,9543,6,14,6,16,53,63,-10,48
Annan Athlet,9543,7,12,11,13,48,41,7,47
Berwick,9543,8,9,10,17,31,59,-28,37
Edinburgh Ci,9543,9,7,9,20,37,62,-25,30
Cowdenbeath,9543,10,4,10,22,23,55,-32,22
Peterhead,9544,1,24,4,8,81,39,42,76
Montrose,9544,2,23,7,6,59,38,21,76
Stirling,9544,3,16,7,13,63,54,9,55
Stenhousem'r,9544,4,15,9,12,58,49,9,54
Clyde,9544,5,14,9,13,51,49,2,51
Elgin,9544,6,15,6,15,57,60,-3,51
Annan Athlet,9544,7,11,11,14,49,44,5,44
Berwick,9544,8,9,10,17,30,58,-28,37
Edinburgh Ci,9544,9,7,9,20,37,64,-27,30
Cowdenbeath,9544,10,5,10,21,26,56,-30,25
Peterhead,9545,1,24,4,8,81,38,43,76
Montrose,9545,2,23,7,6,60,36,24,76
Stirling,9545,3,16,7,13,62,53,9,55
Stenhousem'r,9545,4,15,9,12,57,48,9,54
Clyde,9545,5,14,10,12,52,49,3,52
Elgin,9545,6,15,6,15,55,61,-6,51
Annan Athlet,9545,7,12,11,13,48,41,7,47
Berwick,9545,8,8,11,17,30,59,-29,35
Edinburgh Ci,9545,9,7,9,20,36,64,-28,30
Cowdenbeath,9545,10,4,10,22,23,55,-32,22
Montrose,9546,1,24,7,5,63,34,29,79
Peterhead,9546,2,24,4,8,79,38,41,76
Stirling,9546,3,16,7,13,61,52,9,55
Stenhousem'r,9546,4,15,9,12,56,47,9,54
Clyde,9546,5,14,9,13,51,50,1,51
Elgin,9546,6,14,6,16,53,64,-11,48
Annan Athlet,9546,7,11,12,13,47,41,6,45
Berwick,9546,8,9,10,17,31,58,-27,37
Edinburgh Ci,9546,9,7,9,20,36,62,-26,30
Cowdenbeath,9546,10,4,11,21,23,54,-31,23
Montrose,9547,1,24,7,5,62,35,27,79
Peterhead,9547,2,24,4,8,80,38,42,76
Stenhousem'r,9547,3,16,8,12,59,46,13,56
Stirling,9547,4,16,6,14,60,55,5,54
Clyde,9547,5,14,10,12,52,49,3,52
Elgin,9547,6,14,6,16,54,63,-9,48
Annan Athlet,9547,7,11,12,13,48,42,6,45
Berwick,9547,8,8,11,17,30,59,-29,35
Edinburgh Ci,9547,9,7,9,20,36,63,-27,30
Cowdenbeath,9547,10,4,11,21,24,55,-31,23
Peterhead,9548,1,24,4,8,84,39,45,76
Montrose,9548,2,23,7,6,61,37,24,76
Stenhousem'r,9548,3,16,8,12,57,47,10,56
Stirling,9548,4,16,6,14,61,53,8,54
Clyde,9548,5,14,10,12,51,48,3,52
Elgin,9548,6,15,6,15,56,62,-6,51
Annan Athlet,9548,7,11,12,13,48,42,6,45
Berwick,9548,8,8,11,17,29,58,-29,35
Edinburgh Ci,9548,9,7,9,20,37,67,-30,30
Cowdenbeath,9548,10,4,11,21,24,55,-31,23
Montrose,9549,1,24,7,5,63,36,27,79
Peterhead,9549,2,24,4,8,81,39,42,76
Stirling,9549,3,17,6,13,63,51,12,57
Stenhousem'r,9549,4,15,8,13,55,49,6,53
Clyde,9549,5,14,9,13,51,49,2,51
Elgin,9549,6,14,6,16,55,64,-9,48
Annan Athlet,9549,7,12,11,13,49,42,7,47
Berwick,9549,8,9,10,17,30,58,-28,37
Edinburgh Ci,9549,9,7,9,20,37,64,-27,30
Cowdenbeath,9549,10,4,10,22,24,56,-32,22
Montrose,9550,1,24,7,5,60,34,26,79
Peterhead,9550,2,24,4,8,81,41,40,76
Stirling,9550,3,17,6,13,61,51,10,57
Clyde,9550,4,15,9,12,53,48,5,54
Stenhousem'r,9550,5,15,8,13,55,47,8,53
Elgin,9550,6,14,6,16,53,61,-8,48
Annan Athlet,9550,7,12,11,13,50,42,8,47
Berwick,9550,8,8,10,18,29,60,-31,34
Edinburgh Ci,9550,9,7,9,20,39,64,-25,30
Cowdenbeath,9550,10,4,10,22,24,57,-33,22
Montrose,9551,1,24,7,5,62,36,26,79
Peterhead,9551,2,24,4,8,81,38,43,76
Stirling,9551,3,17,6,13,61,51,10,57
Stenhousem'r,9551,4,15,8,13,55,47,8,53
Clyde,9551,5,14,9,13,51,49,2,51
Elgin,9551,6,14,6,16,55,63,-8,48
Annan Athlet,9551,7,12,11,13,49,41,8,47
Berwick,9551,8,9,10,17,30,58,-28,37
Edinburgh Ci,9551,9,7,9,20,36,64,-28,30
Cowdenbeath,9551,10,4,10,22,23,56,-33,22
Montrose,9552,1,23,8,5,60,35,25,77
Peterhead,9552,2,24,4,8,81,41,40,76
Stirling,9552,3,17,6,13,62,52,10,57
Clyde,9552,4,15,9,12,52,48,4,54
Stenhousem'r,9552,5,15,8,13,56,48,8,53
Elgin,9552,6,14,7,15,54,61,-7,49
Annan Athlet,9552,7,11,12,13,48,42,6,45
Berwick,9552,8,8,10,18,29,59,-30,34
Edinburgh Ci,9552,9,7,9,20,39,64,-25,30
Cowdenbeath,9552,10,4,11,21,24,55,-31,23
Montrose,9553,1,24,7,5,62,36,26,79
Peterhead,9553,2,24,4,8,78,38,40,76
Stenhousem'r,9553,3,16,8,12,59,48,11,56
Stirling,9553,4,16,6,14,62,55,7,54
Clyde,9553,5,15,9,12,52,48,4,54
Elgin,9553,6,14,6,16,55,63,-8,48
Annan Athlet,9553,7,12,11,13,50,42,8,47
Berwick,9553,8,8,10,18,29,59,-30,34
Edinburgh Ci,9553,9,7,9,20,36,61,-25,30
Cowdenbeath,9553,10,4,10,22,24,57,-33,22
Montrose,9554,1,23,8,5,61,36,25,77
Peterhead,9554,2,23,4,9,77,41,36,73
Stirling,9554,3,17,6,13,62,51,11,57
Clyde,9554,4,15,9,12,55,48,7,54
Stenhousem'r,9554,5,15,8,13,55,48,7,53
Elgin,9554,6,14,7,15,55,62,-7,49
Annan Athlet,9554,7,12,11,13,50,42,8,47
Berwick,9554,8,8,10,18,29,62,-33,34
Edinburgh Ci,9554,9,8,9,19,39,60,-21,33
Cowdenbeath,9554,10,4,10,22,24,57,-33,22
Montrose,9555,1,24,7,5,65,34,31,79
Peterhead,9555,2,24,4,8,79,39,40,76
Stirling,9555,3,17,6,13,63,52,11,57
Stenhousem'r,9555,4,15,8,13,56,49,7,53
Clyde,9555,5,14,10,12,51,48,3,52
Elgin,9555,6,14,6,16,53,66,-13,48
Annan Athlet,9555,7,11,12,13,47,41,6,45
Berwick,9555,8,8,11,17,29,58,-29,35
Edinburgh Ci,9555,9,7,9,20,37,62,-25,30
Cowdenbeath,9555,10,4,11,21,23,54,-31,23
Montrose,9556,1,24,7,5,63,35,28,79
Peterhead,9556,2,24,4,8,78,38,40,76
Stirling,9556,3,16,7,13,61,52,9,55
Stenhousem'r,9556,4,15,9,12,56,47,9,54
Clyde,9556,5,15,9,12,53,48,5,54
Elgin,9556,6,14,6,16,54,64,-10,48
Annan Athlet,9556,7,11,12,13,48,42,6,45
Berwick,9556,8,8,10,18,29,60,-31,34
Edinburgh Ci,9556,9,7,9,20,36,61,-25,30
Cowdenbeath,9556,10,4,11,21,24,55,-31,23
Montrose,9557,1,23,8,5,60,35,25,77
Peterhead,9557,2,24,4,8,83,38,45,76
Stenhousem'r,9557,3,16,8,12,56,46,10,56
Stirling,9557,4,16,6,14,60,52,8,54
Clyde,9557,5,15,9,12,54,49,5,54
Elgin,9557,6,14,7,15,54,61,-7,49
Annan Athlet,9557,7,12,11,13,49,42,7,47
Berwick,9557,8,8,10,18,30,61,-31,34
Edinburgh Ci,9557,9,7,9,20,36,66,-30,30
Cowdenbeath,9557,10,4,10,22,24,56,-32,22
Montrose,9558,1,24,7,5,64,35,29,79
Peterhead,9558,2,24,4,8,81,38,43,76
Stenhousem'r,9558,3,16,8,12,57,47,10,56
Stirling,9558,4,16,6,14,61,53,8,54
Clyde,9558,5,14,9,13,51,49,2,51
Elgin,9558,6,14,6,16,54,65,-11,48
Annan Athlet,9558,7,11,11,14,47,42,5,44
Berwick,9558,8,9,10,17,30,58,-28,37
Edinburgh Ci,9558,9,7,9,20,36,64,-28,30
Cowdenbeath,9558,10,5,10,21,24,54,-30,25
Montrose,9559,1,24,7,5,61,35,26,79
Peterhead,9559,2,24,4,8,79,39,40,76
Stirling,9559,3,17,6,13,62,51,11,57
Clyde,9559,4,15,9,12,52,48,4,54
Stenhousem'r,9559,5,15,8,13,55,48,7,53
Elgin,9559,6,14,6,16,54,62,-8,48
Annan Athlet,9559,7,11,12,13,49,43,6,45
Berwick,9559,8,8,10,18,29,59,-30,34
Edinburgh Ci,9559,9,7,9,20,37,62,-25,30
Cowdenbeath,9559,10,4,11,21,25,56,-31,23
Montrose,9560,1,23,8,5,60,35,25,77
Peterhead,9560,2,24,4,8,79,39,40,76
Stirling,9560,3,16,7,13,61,52,9,55
Stenhousem'r,9560,4,15,9,12,56,47,9,54
Clyde,9560,5,15,9,12,52,48,4,54
Elgin,9560,6,14,7,15,54,61,-7,49
Annan Athlet,9560,7,12,11,13,48,41,7,47
Berwick,9560,8,8,10,18,29,59,-30,34
Edinburgh Ci,9560,9,7,9,20,37,62,-25,30
Cowdenbeath,9560,10,4,10,22,23,55,-32,22
Montrose,9561,1,23,8,5,62,37,25,77
Peterhead,9561,2,24,4,8,81,40,41,76
Stenhousem'r,9561,3,16,8,12,58,48,10,56
Stirling,9561,4,16,6,14,62,54,8,54
Clyde,9561,5,15,9,12,53,48,5,54
Elgin,9561,6,14,7,15,56,63,-7,49
Annan Athlet,9561,7,11,11,14,48,43,5,44
Berwick,9561,8,8,10,18,29,60,-31,34
Edinburgh Ci,9561,9,7,9,20,38,64,-26,30
Cowdenbeath,9561,10,5,10,21,25,55,-30,25
Montrose,9562,1,24,7,5,60,34,26,79
Peterhead,9562,2,24,4,8,83,38,45,76
Stenhousem'r,9562,3,16,8,12,57,47,10,56
Stirling,9562,4,16,6,14,61,53,8,54
Clyde,9562,5,15,9,12,52,48,4,54
Elgin,9562,6,14,6,16,53,61,-8,48
Annan Athlet,9562,7,12,11,13,49,42,7,47
Berwick,9562,8,8,10,18,29,59,-30,34
Edinburgh Ci,9562,9,7,9,20,36,66,-30,30
Cowdenbeath,9562,10,4,10,22,24,56,-32,22
Montrose,9563,1,24,7,5,64,34,30,79
Peterhead,9563,2,24,4,8,78,38,40,76
Stirling,9563,3,17,6,13,62,52,10,57
Clyde,9563,4,15,9,12,55,49,6,54
Stenhousem'r,9563,5,15,8,13,56,48,8,53
Elgin,9563,6,14,6,16,53,65,-12,48
Annan Athlet,9563,7,11,12,13,48,42,6,45
Berwick,9563,8,8,10,18,30,62,-32,34
Edinburgh Ci,9563,9,7,9,20,36,61,-25,30
Cowdenbeath,9563,10,4,11,21,24,55,-31,23
Peterhead,9564,1,24,4,8,79,38,41,76
Montrose,9564,2,23,7,6,60,38,22,76
Stenhousem'r,9564,3,16,8,12,57,47,10,56
Stirling,9564,4,16,6,14,61,53,8,54
Clyde,9564,5,14,9,13,51,49,2,51
Elgin,9564,6,15,6,15,57,61,-4,51
Annan Athlet,9564,7,12,11,13,48,41,7,47
Berwick,9564,8,9,10,17,30,58,-28,37
Edinburgh Ci,9564,9,7,9,20,36,62,-26,30
Cowdenbeath,9564,10,4,10,22,23,55,-32,22
Montrose,9565,1,24,7,5,63,36,27,79
Peterhead,9565,2,23,5,8,78,39,39,74
Stirling,9565,3,17,6,13,63,52,11,57
Stenhousem'r,9565,4,15,8,13,56,49,7,53
Clyde,9565,5,14,9,13,51,49,2,51
Elgin,9565,6,14,6,16,55,64,-9,48
Annan Athlet,9565,7,12,11,13,49,41,8,47
Berwick,9565,8,9,10,17,30,58,-28,37
Edinburgh Ci,9565,9,7,10,19,37,61,-24,31
Cowdenbeath,9565,10,4,10,22,23,56,-33,22
Montrose,9566,1,24,7,5,61,34,27,79
Peterhead,9566,2,24,4,8,79,38,41,76
Stenhousem'r,9566,3,16,8,12,57,46,11,56
Stirling,9566,4,16,6,14,60,53,7,54
Clyde,9566,5,14,9,13,52,51,1,51
Elgin,9566,6,14,6,16,53,62,-9,48
Annan Athlet,9566,7,11,11,14,47,42,5,44
Berwick,9566,8,9,10,17,32,59,-27,37
Edinburgh Ci,9566,9,7,9,20,36,62,-26,30
Cowdenbeath,9566,10,5,10,21,24,54,-30,25
Montrose,9567,1,24,7,5,60,34,26,79
Peterhead,9567,2,24,4,8,80,38,42,76
Stenhousem'r,9567,3,16,8,12,56,46,10,56
Stirling,9567,4,16,6,14,60,52,8,54
Clyde,9567,5,14,10,12,51,48,3,52
Elgin,9567,6,14,6,16,53,61,-8,48
Annan Athlet,9567,7,11,12,13,49,43,6,45
Berwick,9567,8,8,11,17,29,58,-29,35
Edinburgh Ci,9567,9,7,9,20,36,63,-27,30
Cowdenbeath,9567,10,4,11,21,25,56,-31,23
Montrose,9568,1,24,7,5,62,36,26,79
Peterhead,9568,2,24,4,8,80,39,41,76
Stirling,9568,3,17,6,13,62,52,10,57
Stenhousem'r,9568,4,15,8,13,56,48,8,53
Clyde,9568,5,14,10,12,52,49,3,52
Elgin,9568,6,14,6,16,55,63,-8,48
Annan Athlet,9568,7,11,12,13,47,41,6,45
Berwick,9568,8,8,11,17,30,59,-29,35
Edinburgh Ci,9568,9,7,9,20,37,63,-26,30
Cowdenbeath,9568,10,4,11,21,23,54,-31,23
Montrose,9569,1,24,7,5,62,34,28,79
Peterhead,9569,2,24,4,8,79,38,41,76
Stirling,9569,3,17,6,13,62,52,10,57
Clyde,9569,4,15,9,12,54,49,5,54
Stenhousem'r,9569,5,15,8,13,56,48,8,53
Elgin,9569,6,14,6,16,53,63,-10,48
Annan Athlet,9569,7,12,11,13,50,42,8,47
Berwick,9569,8,8,10,18,30,61,-31,34
Edinburgh Ci,9569,9,7,9,20,36,62,-26,30
Cowdenbeath,9569,10,4,10,22,24,57,-33,22
Peterhead,9570,1,24,4,8,82,38,44,76
Montrose,9570,2,23,7,6,60,36,24,76
Stirling,9570,3,17,6,13,63,52,11,57
Clyde,9570,4,15,9,12,54,50,4,54
Stenhousem'r,9570,5,15,8,13,56,49,7,53
Elgin,9570,6,15,6,15,55,61,-6,51
Annan Athlet,9570,7,11,11,14,47,42,5,44
Berwick,9570,8,8,10,18,31,61,-30,34
Edinburgh Ci,9570,9,7,9,20,36,65,-29,30
Cowdenbeath,9570,10,5,10,21,24,54,-30,25
Montrose,9571,1,23,8,5,60,35,25,77
Peterhead,9571,2,24,4,8,79,38,41,76
Stenhousem'r,9571,3,16,8,12,57,47,10,56
Stirling,9571,4,16,6,14,61,53,8,54
Clyde,9571,5,14,9,13,51,49,2,51
Elgin,9571,6,14,7,15,54,61,-7,49
Annan Athlet,9571,7,12,11,13,49,41,8,47
Berwick,9571,8,9,10,17,30,58,-28,37
Edinburgh Ci,9571,9,7,9,20,36,62,-26,30
Cowdenbeath,9571,10,4,10,22,23,56,-33,22
Montrose,9572,1,24,7,5,61,34,27,79
Peterhead,9572,2,24,4,8,79,38,41,76
Stirling,9572,3,17,6,13,62,52,10,57
Stenhousem'r,9572,4,15,8,13,56,48,8,53
Clyde,9572,5,14,10,12,53,50,3,52
Elgin,9572,6,14,6,16,53,62,-9,48
Annan Athlet,9572,7,12,11,13,49,41,8,47
Berwick,9572,8,8,11,17,31,60,-29,35
Edinburgh Ci,9572,9,7,9,20,36,62,-26,30
Cowdenbeath,9572,10,4,10,22,23,56,-33,22
Montrose,9573,1,24,7,5,61,34,27,79
Peterhead,9573,2,23,4,9,77,40,37,73
Stirling,9573,3,16,7,13,61,52,9,55
Stenhousem'r,9573,4,15,9,12,56,47,9,54
Clyde,9573,5,14,10,12,52,49,3,52
Elgin,9573,6,14,6,16,53,62,-9,48
Annan Athlet,9573,7,12,11,13,48,41,7,47
Berwick,9573,8,8,11,17,30,59,-29,35
Edinburgh Ci,9573,9,8,9,19,38,60,-22,33
Cowdenbeath,9573,10,4,10,22,23,55,-32,22
Montrose,9574,1,23,8,5,61,36,25,77
Peterhead,9574,2,24,4,8,81,38,43,76
Stirling,9574,3,17,6,13,62,51,11,57
Clyde,9574,4,15,9,12,54,49,5,54
Stenhousem'r,9574,5,15,8,13,55,48,7,53
Elgin,9574,6,14,7,15,55,62,-7,49
Annan Athlet,9574,7,12,11,13,48,41,7,47
Berwick,9574,8,8,10,18,30,61,-31,34
Edinburgh Ci,9574,9,7,9,20,36,64,-28,30
Cowdenbeath,9574,10,4,10,22,23,55,-32,22
Montrose,9575,1,24,7,5,61,34,27,79
Peterhead,9575,2,24,4,8,78,38,40,76
Stenhousem'r,9575,3,16,8,12,58,48,10,56
Stirling,9575,4,16,6,14,62,54,8,54
Clyde,9575,5,14,9,13,52,50,2,51
Elgin,9575,6,14,6,16,53,62,-9,48
Annan Athlet,9575,7,11,11,14,47,42,5,44
Berwick,9575,8,9,10,17,31,59,-28,37
Edinburgh Ci,9575,9,7,9,20,36,61,-25,30
Cowdenbeath,9575,10,5,10,21,24,54,-30,25
Montrose,9576,1,24,7,5,64,34,30,79
Peterhead,9576,2,23,4,9,78,40,38,73
Stirling,9576,3,17,6,13,61,51,10,57
Clyde,9576,4,15,9,12,57,49,8,54
Stenhousem'r,9576,5,15,8,13,55,47,8,53
Elgin,9576,6,14,6,16,53,65,-12,48
Annan Athlet,9576,7,11,11,14,47,45,2,44
Berwick,9576,8,8,10,18,30,64,-34,34
Edinburgh Ci,9576,9,8,9,19,38,61,-23,33
Cowdenbeath,9576,10,5,10,21,27,54,-27,25
Montrose,9577,1,23,8,5,60,35,25,77
Peterhead,9577,2,23,5,8,79,40,39,74
Stenhousem'r,9577,3,16,8,12,57,46,11,56
Stirling,9577,4,16,6,14,60,53,7,54
Clyde,9577,5,15,9,12,54,48,6,54
Elgin,9577,6,14,7,15,54,61,-7,49
Annan Athlet,9577,7,12,11,13,48,41,7,47
Berwick,9577,8,8,10,18,29,61,-32,34
Edinburgh Ci,9577,9,7,10,19,38,62,-24,31
Cowdenbeath,9577,10,4,10,22,23,55,-32,22
Montrose,9578,1,24,7,5,61,35,26,79
Peterhead,9578,2,24,4,8,83,38,45,76
Stirling,9578,3,17,6,13,62,52,10,57
Clyde,9578,4,15,9,12,52,48,4,54
Stenhousem'r,9578,5,15,8,13,56,48,8,53
Elgin,9578,6,14,6,16,54,62,-8,48
Annan Athlet,9578,7,12,11,13,53,41,12,47
Berwick,9578,8,8,10,18,29,59,-30,34
Edinburgh Ci,9578,9,7,9,20,36,66,-30,30
Cowdenbeath,9578,10,4,10,22,23,60,-37,22
Montrose,9579,1,24,7,5,60,34,26,79
Peterhead,9579,2,24,4,8,79,38,41,76
Stenhousem'r,9579,3,16,8,12,58,48,10,56
Stirling,9579,4,16,6,14,62,54,8,54
Clyde,9579,5,15,9,12,53,48,5,54
Elgin,9579,6,14,6,16,53,61,-8,48
Annan Athlet,9579,7,11,12,13,48,42,6,45
Berwick,9579,8,8,10,18,29,60,-31,34
Edinburgh Ci,9579,9,7,9,20,36,62,-26,30
Cowdenbeath,9579,10,4,11,21,24,55,-31,23
Montrose,9580,1,23,8,5,61,36,25,77
Peterhead,9580,2,24,4,8,80,38,42,76
Stirling,9580,3,17,6,13,65,53,12,57
Clyde,9580,4,15,9,12,52,48,4,54
Stenhousem'r,9580,5,15,8,13,57,51,6,53
Elgin,9580,6,14,7,15,55,62,-7,49
Annan Athlet,9580,7,12,11,13,48,41,7,47
Berwick,9580,8,8,10,18,29,59,-30,34
Edinburgh Ci,9580,9,7,9,20,36,63,-27,30
Cowdenbeath,9580,10,4,10,22,23,55,-32,22
Montrose,9581,1,24,7,5,63,35,28,79
Peterhead,9581,2,24,4,8,84,38,46,76
Stirling,9581,3,16,7,13,63,54,9,55
Stenhousem'r,9581,4,15,9,12,58,49,9,54
Clyde,9581,5,15,9,12,54,49,5,54
Elgin,9581,6,14,6,16,54,64,-10,48
Annan Athlet,9581,7,11,11,14,47,42,5,44
Berwick,9581,8,8,10,18,30,61,-31,34
Edinburgh Ci,9581,9,7,9,20,36,67,-31,30
Cowdenbeath,9581,10,5,10,21,24,54,-30,25
Peterhead,9582,1,24,4,8,79,38,41,76
Montrose,9582,2,23,7,6,61,37,24,76
Stirling,9582,3,17,6,13,63,52,11,57
Stenhousem'r,9582,4,15,8,13,56,49,7,53
Clyde,9582,5,14,9,13,51,49,2,51
Elgin,9582,6,15,6,15,56,62,-6,51
Annan Athlet,9582,7,11,11,14,48,43,5,44
Berwick,9582,8,9,10,17,30,58,-28,37
Edinburgh Ci,9582,9,7,9,20,36,62,-26,30
Cowdenbeath,9582,10,5,10,21,25,55,-30,25
Montrose,9583,1,24,7,5,61,35,26,79
Peterhead,9583,2,23,5,8,78,39,39,74
Stenhousem'r,9583,3,16,8,12,56,46,10,56
Stirling,9583,4,16,6,14,60,52,8,54
Clyde,9583,5,15,9,12,54,50,4,54
Elgin,9583,6,14,6,16,54,62,-8,48
Annan Athlet,9583,7,12,11,13,48,41,7,47
Berwick,9583,8,8,10,18,31,61,-30,34
Edinburgh Ci,9583,9,7,10,19,37,61,-24,31
Cowdenbeath,9583,10,4,10,22,23,55,-32,22
Montrose,9584,1,23,8,5,60,35,25,77
Peterhead,9584,2,24,4,8,81,38,43,76
Stirling,9584,3,17,6,13,63,51,12,57
Stenhousem'r,9584,4,15,8,13,55,49,6,53
Clyde,9584,5,14,10,12,51,48,3,52
Elgin,9584,6,14,7,15,54,61,-7,49
Annan Athlet,9584,7,11,11,14,48,43,5,44
Berwick,9584,8,8,11,17,29,58,-29,35
Edinburgh Ci,9584,9,7,9,20,36,64,-28,30
Cowdenbeath,9584,10,5,10,21,25,55,-30,25
Montrose,9585,1,23,8,5,60,35,25,77
Peterhead,9585,2,24,4,8,81,38,43,76
Stirling,9585,3,16,7,13,61,52,9,55
Stenhousem'r,9585,4,15,9,12,56,47,9,54
Clyde,9585,5,15,9,12,53,49,4,54
Elgin,9585,6,14,7,15,54,61,-7,49
Annan Athlet,9585,7,12,11,13,50,41,9,47
Berwick,9585,8,8,10,18,30,60,-30,34
Edinburgh Ci,9585,9,7,9,20,36,64,-28,30
Cowdenbeath,9585,10,4,10,22,23,57,-34,22
Montrose,9586,1,24,7,5,61,35,26,79
Peterhead,9586,2,24,4,8,79,38,41,76
Stenhousem'r,9586,3,16,8,12,60,47,13,56
Stirling,9586,4,16,6,14,61,56,5,54
Clyde,9586,5,14,10,12,51,48,3,52
Elgin,9586,6,14,6,16,54,62,-8,48
Annan Athlet,9586,7,11,11,14,49,44,5,44
Berwick,9586,8,8,11,17,29,58,-29,35
Edinburgh Ci,9586,9,7,9,20,36,62,-26,30
Cowdenbeath,9586,10,5,10,21,26,56,-30,25
Montrose,9587,1,23,8,5,60,35,25,77
Peterhead,9587,2,24,4,8,81,40,41,76
Stenhousem'r,9587,3,16,8,12,56,46,10,56
Stirling,9587,4,16,6,14,60,52,8,54
Clyde,9587,5,15,9,12,55,48,7,54
Elgin,9587,6,14,7,15,54,61,-7,49
Annan Athlet,9587,7,11,12,13,48,42,6,45
Berwick,9587,8,8,10,18,29,62,-33,34
Edinburgh Ci,9587,9,7,9,20,38,64,-26,30
Cowdenbeath,9587,10,4,11,21,24,55,-31,23
Peterhead,9588,1,24,4,8,81,38,43,76
Montrose,9588,2,23,7,6,60,36,24,76
Stirling,9588,3,17,6,13,64,51,13,57
Clyde,9588,4,15,9,12,55,49,6,54
Stenhousem'r,9588,5,15,8,13,55,50,5,53
Elgin,9588,6,15,6,15,55,61,-6,51
Annan Athlet,9588,7,12,11,13,50,42,8,47
Berwick,9588,8,8,10,18,30,62,-32,34
Edinburgh Ci,9588,9,7,9,20,36,64,-28,30
Cowdenbeath,9588,10,4,10,22,24,57,-33,22
Montrose,9589,1,23,8,5,59,34,25,77
Peterhead,9589,2,24,4,8,82,39,43,76
Stirling,9589,3,16,7,13,63,54,9,55
Stenhousem'r,9589,4,15,9,12,58,49,9,54
Clyde,9589,5,14,9,13,52,50,2,51
Elgin,9589,6,14,7,15,53,60,-7,49
Annan Athlet,9589,7,11,11,14,47,43,4,44
Berwick,9589,8,9,10,17,31,59,-28,37
Edinburgh Ci,9589,9,7,9,20,37,65,-28,30
Cowdenbeath,9589,10,5,10,21,25,54,-29,25
Montrose,9590,1,24,7,5,63,36,27,79
Peterhead,9590,2,24,4,8,79,39,40,76
Stirling,9590,3,16,7,13,60,51,9,55
Stenhousem'r,9590,4,15,9,12,55,46,9,54
Clyde,9590,5,14,10,12,53,50,3,52
Elgin,9590,6,14,6,16,55,64,-9,48
Annan Athlet,9590,7,12,11,13,48,41,7,47
Berwick,9590,8,8,11,17,31,60,-29,35
Edinburgh Ci,9590,9,7,9,20,37,62,-25,30
Cowdenbeath,9590,10,4,10,22,23,55,-32,22
Montrose,9591,1,24,7,5,61,35,26,79
Peterhead,9591,2,24,4,8,82,39,43,76
Stenhousem'r,9591,3,16,8,12,58,48,10,56
Stirling,9591,4,16,6,14,62,54,8,54
Clyde,9591,5,15,9,12,56,49,7,54
Elgin,9591,6,14,6,16,54,62,-8,48
Annan Athlet,9591,7,11,11,14,48,43,5,44
Berwick,9591,8,8,10,18,30,63,-33,34
Edinburgh Ci,9591,9,7,9,20,37,65,-28,30
Cowdenbeath,9591,10,5,10,21,25,55,-30,25
Montrose,9592,1,23,8,5,60,35,25,77
Peterhead,9592,2,23,5,8,79,40,39,74
Stirling,9592,3,17,6,13,62,52,10,57
Stenhousem'r,9592,4,15,8,13,56,48,8,53
Clyde,9592,5,14,10,12,51,48,3,52
Elgin,9592,6,14,7,15,54,61,-7,49
Annan Athlet,9592,7,11,11,14,48,43,5,44
Berwick,9592,8,8,11,17,29,58,-29,35
Edinburgh Ci,9592,9,7,10,19,38,62,-24,31
Cowdenbeath,9592,10,5,10,21,25,55,-30,25
Montrose,9593,1,24,7,5,61,34,27,79
Peterhead,9593,2,24,4,8,79,38,41,76
Stirling,9593,3,17,6,13,61,51,10,57
Clyde,9593,4,15,9,12,54,48,6,54
Stenhousem'r,9593,5,15,8,13,55,47,8,53
Elgin,9593,6,14,6,16,53,62,-9,48
Annan Athlet,9593,7,11,11,14,47,42,5,44
Berwick,9593,8,8,10,18,29,61,-32,34
Edinburgh Ci,9593,9,7,9,20,36,62,-26,30
Cowdenbeath,9593,10,5,10,21,24,54,-30,25
Peterhead,9594,1,24,4,8,84,39,45,76
Montrose,9594,2,23,7,6,59,36,23,76
Stirling,9594,3,17,6,13,62,52,10,57
Clyde,9594,4,15,9,12,52,48,4,54
Stenhousem'r,9594,5,15,8,13,56,48,8,53
Elgin,9594,6,15,6,15,55,60,-5,51
Annan Athlet,9594,7,11,11,14,48,43,5,44
Berwick,9594,8,8,10,18,29,59,-30,34
Edinburgh Ci,9594,9,7,9,20,37,67,-30,30
Cowdenbeath,9594,10,5,10,21,25,55,-30,25
Montrose,9595,1,24,7,5,61,35,26,79
Peterhead,9595,2,24,4,8,82,39,43,76
Stirling,9595,3,17,6,13,62,51,11,57
Clyde,9595,4,15,9,12,54,48,6,54
Stenhousem'r,9595,5,15,8,13,55,48,7,53
Elgin,9595,6,14,6,16,54,62,-8,48
Annan Athlet,9595,7,11,12,13,48,42,6,45
Berwick,9595,8,8,10,18,29,61,-32,34
Edinburgh Ci,9595,9,7,9,20,37,65,-28,30
Cowdenbeath,9595,10,4,11,21,24,55,-31,23
Montrose,9596,1,24,7,5,62,34,28,79
Peterhead,9596,2,24,4,8,79,38,41,76
Stirling,9596,3,17,6,13,63,51,12,57
Clyde,9596,4,15,9,12,52,48,4,54
Stenhousem'r,9596,5,15,8,13,55,49,6,53
Elgin,9596,6,14,6,16,53,63,-10,48
Annan Athlet,9596,7,11,12,13,47,41,6,45
Berwick,9596,8,8,10,18,29,59,-30,34
Edinburgh Ci,9596,9,7,9,20,36,62,-26,30
Cowdenbeath,9596,10,4,11,21,23,54,-31,23
Peterhead,9597,1,24,4,8,82,38,44,76
Montrose,9597,2,23,7,6,60,36,24,76
Stirling,9597,3,17,6,13,62,51,11,57
Clyde,9597,4,15,9,12,52,48,4,54
Stenhousem'r,9597,5,15,8,13,55,48,7,53
Elgin,9597,6,15,6,15,55,61,-6,51
Annan Athlet,9597,7,11,11,14,47,42,5,44
Berwick,9597,8,8,10,18,29,59,-30,34
Edinburgh Ci,9597,9,7,9,20,36,65,-29,30
Cowdenbeath,9597,10,5,10,21,24,54,-30,25
Montrose,9598,1,24,7,5,62,35,27,79
Peterhead,9598,2,24,4,8,80,38,42,76
Stenhousem'r,9598,3,16,8,12,57,47,10,56
Stirling,9598,4,16,6,14,61,53,8,54
Clyde,9598,5,15,9,12,56,48,8,54
Elgin,9598,6,14,6,16,54,63,-9,48
Annan Athlet,9598,7,11,12,13,47,41,6,45
Berwick,9598,8,8,10,18,29,63,-34,34
Edinburgh Ci,9598,9,7,9,20,36,63,-27,30
Cowdenbeath,9598,10,4,11,21,23,54,-31,23
Peterhead,9599,1,24,4,8,80,39,41,76
Montrose,9599,2,23,7,6,60,37,23,76
Stenhousem'r,9599,3,16,8,12,58,48,10,56
Stirling,9599,4,16,6,14,62,54,8,54
Clyde,9599,5,15,9,12,54,50,4,54
Elgin,9599,6,15,6,15,56,61,-5,51
Annan Athlet,9599,7,12,11,13,49,41,8,47
Berwick,9599,8,8,10,18,31,61,-30,34
Edinburgh Ci,9599,9,7,9,20,37,63,-26,30
Cowdenbeath,9599,10,4,10,22,23,56,-33,22
Peterhead,9600,1,24,4,8,81,39,42,76
Montrose,9600,2,23,7,6,62,38,24,76
Stenhousem'r,9600,3,16,8,12,58,46,12,56
Stirling,9600,4,16,6,14,60,54,6,54
Clyde,9600,5,14,9,13,51,50,1,51
Elgin,9600,6,15,6,15,57,63,-6,51
Annan Athlet,9600,7,11,12,13,48,42,6,45
Berwick,9600,8,9,10,17,31,58,-27,37
Edinburgh Ci,9600,9,7,9,20,37,64,-27,30
Cowdenbeath,9600,10,4,11,21,24,55,-31,23
Montrose,9601,1,24,7,5,61,34,27,79
Peterhead,9601,2,24,4,8,81,38,43,76
Stirling,9601,3,16,7,13,61,52,9,55
Stenhousem'r,9601,4,15,9,12,56,47,9,54
Clyde,9601,5,15,9,12,53,48,5,54
Elgin,9601,6,14,6,16,53,62,-9,48
Annan Athlet,9601,7,12,11,13,51,41,10,47
Berwick,9601,8,8,10,18,29,60,-31,34
Edinburgh Ci,9601,9,7,9,20,36,64,-28,30
Cowdenbeath,9601,10,4,10,22,23,58,-35,22
Peterhead,9602,1,24,4,8,81,38,43,76
Montrose,9602,2,23,7,6,59,35,24,76
Stirling,9602,3,17,6,13,63,52,11,57
Clyde,9602,4,15,9,12,53,48,5,54
Stenhousem'r,9602,5,15,8,13,56,49,7,53
Elgin,9602,6,15,6,15,54,60,-6,51
Annan Athlet,9602,7,11,11,14,48,43,5,44
Berwick,9602,8,8,10,18,29,60,-31,34
Edinburgh Ci,9602,9,7,9,20,36,64,-28,30
Cowdenbeath,9602,10,5,10,21,25,55,-30,25
Montrose,9603,1,23,7,6,59,35,24,76
Peterhead,9603,2,23,5,8,77,38,39,74
Stenhousem'r,9603,3,16,8,12,56,46,10,56
Stirling,9603,4,16,6,14,60,52,8,54
Clyde,9603,5,15,9,12,56,49,7,54
Elgin,9603,6,15,6,15,54,60,-6,51
Annan Athlet,9603,7,12,11,13,48,41,7,47
Berwick,9603,8,8,10,18,30,63,-33,34
Edinburgh Ci,9603,9,7,10,19,36,60,-24,31
Cowdenbeath,9603,10,4,10,22,23,55,-32,22
Montrose,9604,1,24,7,5,61,34,27,79
Peterhead,9604,2,24,4,8,82,42,40,76
Stirling,9604,3,17,6,13,63,52,11,57
Stenhousem'r,9604,4,15,8,13,56,49,7,53
Clyde,9604,5,14,9,13,51,51,0,51
Elgin,9604,6,14,6,16,53,62,-9,48
Annan Athlet,9604,7,11,11,14,47,43,4,44
Berwick,9604,8,9,10,17,32,58,-26,37
Edinburgh Ci,9604,9,7,9,20,40,65,-25,30
Cowdenbeath,9604,10,5,10,21,25,54,-29,25
Montrose,9605,1,24,7,5,61,35,26,79
Peterhead,9605,2,24,4,8,82,38,44,76
Stirling,9605,3,17,6,13,62,51,11,57
Stenhousem'r,9605,4,15,8,13,55,48,7,53
Clyde,9605,5,14,9,13,51,49,2,51
Elgin,9605,6,14,6,16,54,62,-8,48
Annan Athlet,9605,7,12,11,13,49,42,7,47
Berwick,9605,8,9,10,17,30,58,-28,37
Edinburgh Ci,9605,9,7,9,20,36,65,-29,30
Cowdenbeath,9605,10,4,10,22,24,56,-32,22
Montrose,9606,1,23,8,5,60,35,25,77
Peterhead,9606,2,24,4,8,78,38,40,76
Stirling,9606,3,16,7,13,62,53,9,55
Stenhousem'r,9606,4,15,9,12,57,48,9,54
Clyde,9606,5,15,9,12,52,48,4,54
Elgin,9606,6,14,7,15,54,61,-7,49
Annan Athlet,9606,7,12,11,13,48,41,7,47
Berwick,9606,8,8,10,18,29,59,-30,34
Edinburgh Ci,9606,9,7,9,20,36,61,-25,30
Cowdenbeath,9606,10,4,10,22,23,55,-32,22
Montrose,9607,1,23,8,5,62,37,25,77
Peterhead,9607,2,23,4,9,78,40,38,73
Stenhousem'r,9607,3,16,8,12,56,46,10,56
Stirling,9607,4,16,6,14,60,52,8,54
Clyde,9607,5,14,9,13,52,50,2,51
Elgin,9607,6,14,7,15,56,63,-7,49
Annan Athlet,9607,7,12,11,13,49,41,8,47
Berwick,9607,8,9,10,17,31,59,-28,37
Edinburgh Ci,9607,9,8,9,19,38,61,-23,33
Cowdenbeath,9607,10,4,10,22,23,56,-33,22
Montrose,9608,1,24,7,5,61,35,26,79
Peterhead,9608,2,23,5,8,78,39,39,74
Stenhousem'r,9608,3,16,8,12,56,46,10,56
Stirling,9608,4,16,6,14,60,52,8,54
Clyde,9608,5,15,9,12,54,50,4,54
Elgin,9608,6,14,6,16,54,62,-8,48
Annan Athlet,9608,7,11,12,13,49,43,6,45
Berwick,9608,8,8,10,18,31,61,-30,34
Edinburgh Ci,9608,9,7,10,19,37,61,-24,31
Cowdenbeath,9608,10,4,11,21,25,56,-31,23
Montrose,9609,1,23,8,5,60,35,25,77
Peterhead,9609,2,24,4,8,81,41,40,76
Stirling,9609,3,17,6,13,63,53,10,57
Clyde,9609,4,15,9,12,53,49,4,54
Stenhousem'r,9609,5,15,8,13,57,49,8,53
Elgin,9609,6,14,7,15,54,61,-7,49
Annan Athlet,9609,7,12,11,13,50,41,9,47
Berwick,9609,8,8,10,18,30,60,-30,34
Edinburgh Ci,9609,9,7,9,20,39,64,-25,30
Cowdenbeath,9609,10,4,10,22,23,57,-34,22
Montrose,9610,1,23,8,5,61,36,25,77
Peterhead,9610,2,23,4,9,78,40,38,73
Stenhousem'r,9610,3,16,8,12,56,46,10,56
Stirling,9610,4,16,6,14,60,52,8,54
Clyde,9610,5,15,9,12,53,49,4,54
Elgin,9610,6,14,7,15,55,62,-7,49
Annan Athlet,9610,7,12,11,13,49,42,7,47
Berwick,9610,8,8,10,18,30,60,-30,34
Edinburgh Ci,9610,9,8,9,19,38,61,-23,33
Cowdenbeath,9610,10,4,10,22,24,56,-32,22
Montrose,9611,1,23,7,6,60,36,24,76
Peterhead,9611,2,23,5,8,77,38,39,74
Stirling,9611,3,16,7,13,60,51,9,55
Stenhousem'r,9611,4,15,9,12,55,46,9,54
Clyde,9611,5,14,10,12,53,50,3,52
Elgin,9611,6,15,6,15,55,61,-6,51
Annan Athlet,9611,7,12,11,13,48,41,7,47
Berwick,9611,8,8,11,17,31,60,-29,35
Edinburgh Ci,9611,9,7,10,19,36,60,-24,31
Cowdenbeath,9611,10,4,10,22,23,55,-32,22
Montrose,9612,1,24,7,5,62,35,27,79
Peterhead,9612,2,23,5,8,77,38,39,74
Stenhousem'r,9612,3,16,8,12,57,47,10,56
Stirling,9612,4,16,6,14,61,53,8,54
Clyde,9612,5,15,9,12,52,48,4,54
Elgin,9612,6,14,6,16,54,63,-9,48
Annan Athlet,9612,7,12,11,13,48,41,7,47
Berwick,9612,8,8,10,18,29,59,-30,34
Edinburgh Ci,9612,9,7,10,19,36,60,-24,31
Cowdenbeath,9612,10,4,10,22,23,55,-32,22
Montrose,9613,1,24,7,5,62,35,27,79
Peterhead,9613,2,24,4,8,82,38,44,76
Stirling,9613,3,17,6,13,63,53,10,57
Stenhousem'r,9613,4,15,8,13,57,49,8,53
Clyde,9613,5,14,9,13,51,49,2,51
Elgin,9613,6,14,6,16,54,63,-9,48
Annan Athlet,9613,7,11,11,14,48,44,4,44
Berwick,9613,8,9,10,17,30,58,-28,37
Edinburgh Ci,9613,9,7,9,20,36,65,-29,30
Cowdenbeath,9613,10,5,10,21,26,55,-29,25
Montrose,9614,1,24,7,5,63,34,29,79
Peterhead,9614,2,23,5,8,78,39,39,74
Stenhousem'r,9614,3,16,8,12,57,46,11,56
Stirling,9614,4,16,6,14,60,53,7,54
Clyde,9614,5,15,9,12,53,48,5,54
Elgin,9614,6,14,6,16,53,64,-11,48
Annan Athlet,9614,7,11,11,14,47,42,5,44
Berwick,9614,8,8,10,18,29,60,-31,34
Edinburgh Ci,9614,9,7,10,19,37,61,-24,31
Cowdenbeath,9614,10,5,10,21,24,54,-30,25
Montrose,9615,1,24,7,5,61,34,27,79
Peterhead,9615,2,23,5,8,79,40,39,74
Stirling,9615,3,17,6,13,63,53,10,57
Clyde,9615,4,15,9,12,53,48,5,54
Stenhousem'r,9615,5,15,8,13,57,49,8,53
Elgin,9615,6,14,6,16,53,62,-9,48
Annan Athlet,9615,7,11,11,14,47,42,5,44
Berwick,9615,8,8,10,18,29,60,-31,34
Edinburgh Ci,9615,9,7,10,19,38,62,-24,31
Cowdenbeath,9615,10,5,10,21,24,54,-30,25
Montrose,9616,1,23,8,5,59,34,25,77
Peterhead,9616,2,23,4,9,79,41,38,73
Stirling,9616,3,16,7,13,62,53,9,55
Stenhousem'r,9616,4,15,9,12,57,48,9,54
Clyde,9616,5,15,9,12,53,49,4,54
Elgin,9616,6,14,7,15,53,60,-7,49
Annan Athlet,9616,7,11,12,13,49,43,6,45
Berwick,9616,8,8,10,18,30,60,-30,34
Edinburgh Ci,9616,9,8,9,19,39,62,-23,33
Cowdenbeath,9616,10,4,11,21,25,56,-31,23
Montrose,9617,1,24,7,5,62,35,27,79
Peterhead,9617,2,24,4,8,83,40,43,76
Stirling,9617,3,17,6,13,62,51,11,57
Stenhousem'r,9617,4,15,8,13,55,48,7,53
Clyde,9617,5,14,9,13,51,52,-1,51
Elgin,9617,6,14,6,16,54,63,-9,48
Annan Athlet,9617,7,11,12,13,48,42,6,45
Berwick,9617,8,9,10,17,33,58,-25,37
Edinburgh Ci,9617,9,7,9,20,38,66,-28,30
Cowdenbeath,9617,10,4,11,21,24,55,-31,23
Montrose,9618,1,24,7,5,61,34,27,79
Peterhead,9618,2,23,4,9,79,42,37,73
Stirling,9618,3,17,6,13,63,53,10,57
Clyde,9618,4,15,9,12,52,48,4,54
Stenhousem'r,9618,5,15,8,13,57,49,8,53
Elgin,9618,6,14,6,16,53,62,-9,48
Annan Athlet,9618,7,11,11,14,47,42,5,44
Berwick,9618,8,8,10,18,29,59,-30,34
Edinburgh Ci,9618,9,8,9,19,40,62,-22,33
Cowdenbeath,9618,10,5,10,21,24,54,-30,25
Montrose,9619,1,24,7,5,61,35,26,79
Peterhead,9619,2,24,4,8,80,39,41,76
Stirling,9619,3,17,6,13,66,51,15,57
Clyde,9619,4,15,9,12,55,49,6,54
Stenhousem'r,9619,5,15,8,13,55,52,3,53
Elgin,9619,6,14,6,16,54,62,-8,48
Annan Athlet,9619,7,11,11,14,47,42,5,44
Berwick,9619,8,8,10,18,30,62,-32,34
Edinburgh Ci,9619,9,7,9,20,37,63,-26,30
Cowdenbeath,9619,10,5,10,21,24,54,-30,25
Montrose,9620,1,24,7,5,61,34,27,79
Peterhead,9620,2,24,4,8,82,39,43,76
Stirling,9620,3,16,7,13,61,52,9,55
Stenhousem'r,9620,4,15,9,12,56,47,9,54
Clyde,9620,5,14,10,12,54,51,3,52
Elgin,9620,6,14,6,16,53,62,-9,48
Annan Athlet,9620,7,11,11,14,47,42,5,44
Berwick,9620,8,8,11,17,32,61,-29,35
Edinburgh Ci,9620,9,7,9,20,37,65,-28,30
Cowdenbeath,9620,10,5,10,21,24,54,-30,25
Montrose,9621,1,23,8,5,62,37,25,77
Peterhead,9621,2,23,4,9,78,42,36,73
Stirling,9621,3,16,7,13,62,53,9,55
Stenhousem'r,9621,4,15,9,12,57,48,9,54
Clyde,9621,5,15,9,12,54,49,5,54
Elgin,9621,6,14,7,15,56,63,-7,49
Annan Athlet,9621,7,11,11,14,49,44,5,44
Berwick,9621,8,8,10,18,30,61,-31,34
Edinburgh Ci,9621,9,8,9,19,40,61,-21,33
Cowdenbeath,9621,10,5,10,21,26,56,-30,25
Montrose,9622,1,24,7,5,62,35,27,79
Peterhead,9622,2,24,4,8,80,39,41,76
Stenhousem'r,9622,3,16,8,12,57,47,10,56
Stirling,9622,4,16,6,14,61,53,8,54
Clyde,9622,5,15,9,12,52,48,4,54
Elgin,9622,6,14,6,16,54,63,-9,48
Annan Athlet,9622,7,11,12,13,48,42,6,45
Berwick,9622,8,8,10,18,29,59,-30,34
Edinburgh Ci,9622,9,7,9,20,37,63,-26,30
Cowdenbeath,9622,10,4,11,21,24,55,-31,23
Montrose,9623,1,24,7,5,65,35,30,79
Peterhead,9623,2,24,4,8,79,39,40,76
Stirling,9623,3,16,7,13,62,53,9,55
Stenhousem'r,9623,4,15,9,12,57,48,9,54
Clyde,9623,5,15,9,12,53,48,5,54
Elgin,9623,6,14,6,16,54,66,-12,48
Annan Athlet,9623,7,11,11,14,47,43,4,44
Berwick,9623,8,8,10,18,29,60,-31,34
Edinburgh Ci,9623,9,7,9,20,37,62,-25,30
Cowdenbeath,9623,10,5,10,21,25,54,-29,25
Montrose,9624,1,24,7,5,62,36,26,79
Peterhead,9624,2,23,4,9,78,41,37,73
Stirling,9624,3,17,6,13,62,51,11,57
Clyde,9624,4,15,9,12,54,48,6,54
Stenhousem'r,9624,5,15,8,13,55,48,7,53
Elgin,9624,6,14,6,16,55,63,-8,48
Annan Athlet,9624,7,12,11,13,48,41,7,47
Berwick,9624,8,8,10,18,29,61,-32,34
Edinburgh Ci,9624,9,8,9,19,39,61,-22,33
Cowdenbeath,9624,10,4,10,22,23,55,-32,22
Montrose,9625,1,24,7,5,62,35,27,79
Peterhead,9625,2,24,4,8,81,38,43,76
Stirling,9625,3,17,6,13,62,51,11,57
Clyde,9625,4,15,9,12,53,48,5,54
Stenhousem'r,9625,5,15,8,13,55,48,7,53
Elgin,9625,6,14,6,16,54,63,-9,48
Annan Athlet,9625,7,11,11,14,49,44,5,44
Berwick,9625,8,8,10,18,29,60,-31,34
Edinburgh Ci,9625,9,7,9,20,36,64,-28,30
Cowdenbeath,9625,10,5,10,21,26,56,-30,25
Peterhead,9626,1,24,4,8,78,38,40,76
Montrose,9626,2,23,7,6,60,36,24,76
Stenhousem'r,9626,3,16,8,12,57,47,10,56
Stirling,9626,4,16,6,14,61,53,8,54
Clyde,9626,5,15,9,12,54,48,6,54
Elgin,9626,6,15,6,15,55,61,-6,51
Annan Athlet,9626,7,12,11,13,48,41,7,47
Berwick,9626,8,8,10,18,29,61,-32,34
Edinburgh Ci,9626,9,7,9,20,36,61,-25,30
Cowdenbeath,9626,10,4,10,22,23,55,-32,22
Peterhead,9627,1,24,4,8,82,39,43,76
Montrose,9627,2,23,7,6,61,37,24,76
Stenhousem'r,9627,3,16,8,12,56,46,10,56
Stirling,9627,4,16,6,14,60,52,8,54
Clyde,9627,5,14,10,12,51,48,3,52
Elgin,9627,6,15,6,15,56,62,-6,51
Annan Athlet,9627,7,11,12,13,47,41,6,45
Berwick,9627,8,8,11,17,29,58,-29,35
Edinburgh Ci,9627,9,7,9,20,37,65,-28,30
Cowdenbeath,9627,10,4,11,21,23,54,-31,23
Peterhead,9628,1,24,4,8,79,39,40,76
Montrose,9628,2,23,7,6,60,36,24,76
Stirling,9628,3,17,6,13,63,52,11,57
Stenhousem'r,9628,4,15,8,13,56,49,7,53
Clyde,9628,5,14,10,12,51,48,3,52
Elgin,9628,6,15,6,15,55,61,-6,51
Annan Athlet,9628,7,12,11,13,48,41,7,47
Berwick,9628,8,8,11,17,29,58,-29,35
Edinburgh Ci,9628,9,7,9,20,37,62,-25,30
Cowdenbeath,9628,10,4,10,22,23,55,-32,22
Montrose,9629,1,24,7,5,62,35,27,79
Peterhead,9629,2,23,4,9,77,39,38,73
Stirling,9629,3,17,6,13,61,51,10,57
Stenhousem'r,9629,4,15,8,13,55,47,8,53
Clyde,9629,5,14,9,13,51,51,0,51
Elgin,9629,6,14,6,16,54,63,-9,48
Annan Athlet,9629,7,12,11,13,49,41,8,47
Berwick,9629,8,9,10,17,32,58,-26,37
Edinburgh Ci,9629,9,8,9,19,37,60,-23,33
Cowdenbeath,9629,10,4,10,22,23,56,-33,22
Montrose,9630,1,24,7,5,60,34,26,79
Peterhead,9630,2,24,4,8,80,38,42,76
Stirling,9630,3,17,6,13,63,53,10,57
Clyde,9630,4,15,9,12,53,49,4,54
Stenhousem'r,9630,5,15,8,13,57,49,8,53
Elgin,9630,6,14,6,16,53,61,-8,48
Annan Athlet,9630,7,11,11,14,47,43,4,44
Berwick,9630,8,8,10,18,30,60,-30,34
Edinburgh Ci,9630,9,7,9,20,36,63,-27,30
Cowdenbeath,9630,10,5,10,21,25,54,-29,25
Montrose,9631,1,23,7,6,61,38,23,76
Peterhead,9631,2,23,4,9,79,41,38,73
Stirling,9631,3,16,7,13,61,52,9,55
Stenhousem'r,9631,4,15,9,12,56,47,9,54
Clyde,9631,5,14,9,13,51,49,2,51
Elgin,9631,6,15,6,15,57,62,-5,51
Annan Athlet,9631,7,11,11,14,47,42,5,44
Berwick,9631,8,9,10,17,30,58,-28,37
Edinburgh Ci,9631,9,8,9,19,39,62,-23,33
Cowdenbeath,9631,10,5,10,21,24,54,-30,25
Montrose,9632,1,23,8,5,60,35,25,77
Peterhead,9632,2,24,4,8,84,38,46,76
Stenhousem'r,9632,3,16,8,12,57,47,10,56
Stirling,9632,4,16,6,14,61,53,8,54
Clyde,9632,5,14,9,13,52,51,1,51
Elgin,9632,6,14,7,15,54,61,-7,49
Annan Athlet,9632,7,11,12,13,48,42,6,45
Berwick,9632,8,9,10,17,32,59,-27,37
Edinburgh Ci,9632,9,7,9,20,36,67,-31,30
Cowdenbeath,9632,10,4,11,21,24,55,-31,23
Montrose,9633,1,24,7,5,64,35,29,79
Peterhead,9633,2,24,4,8,82,40,42,76
Stenhousem'r,9633,3,16,8,12,58,47,11,56
Stirling,9633,4,16,6,14,61,54,7,54
Clyde,9633,5,15,9,12,53,48,5,54
Elgin,9633,6,14,6,16,54,65,-11,48
Annan Athlet,9633,7,11,12,13,47,41,6,45
Berwick,9633,8,8,10,18,29,60,-31,34
Edinburgh Ci,9633,9,7,9,20,38,65,-27,30
Cowdenbeath,9633,10,4,11,21,23,54,-31,23
Montrose,9634,1,23,8,5,59,34,25,77
Peterhead,9634,2,23,4,9,78,40,38,73
Stenhousem'r,9634,3,16,8,12,57,47,10,56
Stirling,9634,4,16,6,14,61,53,8,54
Clyde,9634,5,15,9,12,52,48,4,54
Elgin,9634,6,14,7,15,53,60,-7,49
Annan Athlet,9634,7,12,11,13,48,41,7,47
Berwick,9634,8,8,10,18,29,59,-30,34
Edinburgh Ci,9634,9,8,9,19,38,61,-23,33
Cowdenbeath,9634,10,4,10,22,23,55,-32,22
Peterhead,9635,1,24,4,8,82,40,42,76
Montrose,9635,2,23,7,6,60,37,23,76
Stenhousem'r,9635,3,16,8,12,57,47,10,56
Stirling,9635,4,16,6,14,61,53,8,54
Clyde,9635,5,15,9,12,53,48,5,54
Elgin,9635,6,15,6,15,56,61,-5,51
Annan Athlet,9635,7,12,11,13,48,41,7,47
Berwick,9635,8,8,10,18,29,60,-31,34
Edinburgh Ci,9635,9,7,9,20,38,65,-27,30
Cowdenbeath,9635,10,4,10,22,23,55,-32,22
Montrose,9636,1,23,8,5,59,34,25,77
Peterhead,9636,2,24,4,8,83,40,43,76
Stirling,9636,3,16,7,13,62,53,9,55
Stenhousem'r,9636,4,15,9,12,57,48,9,54
Clyde,9636,5,14,10,12,51,48,3,52
Elgin,9636,6,14,7,15,53,60,-7,49
Annan Athlet,9636,7,12,11,13,48,41,7,47
Berwick,9636,8,8,11,17,29,58,-29,35
Edinburgh Ci,9636,9,7,9,20,38,66,-28,30
Cowdenbeath,9636,10,4,10,22,23,55,-32,22
Montrose,9637,1,24,7,5,61,35,26,79
Peterhead,9637,2,24,4,8,79,39,40,76
Stenhousem'r,9637,3,16,8,12,56,46,10,56
Stirling,9637,4,16,6,14,60,52,8,54
Clyde,9637,5,15,9,12,53,48,5,54
Elgin,9637,6,14,6,16,54,62,-8,48
Annan Athlet,9637,7,12,11,13,50,41,9,47
Berwick,9637,8,8,10,18,29,60,-31,34
Edinburgh Ci,9637,9,7,9,20,37,62,-25,30
Cowdenbeath,9637,10,4,10,22,23,57,-34,22
Peterhead,9638,1,24,4,8,80,38,42,76
Montrose,9638,2,23,7,6,59,35,24,76
Stenhousem'r,9638,3,16,8,12,56,46,10,56
Stirling,9638,4,16,6,14,60,52,8,54
Clyde,9638,5,15,9,12,52,48,4,54
Elgin,9638,6,15,6,15,54,60,-6,51
Annan Athlet,9638,7,11,12,13,47,41,6,45
Berwick,9638,8,8,10,18,29,59,-30,34
Edinburgh Ci,9638,9,7,9,20,36,63,-27,30
Cowdenbeath,9638,10,4,11,21,23,54,-31,23
Montrose,9639,1,24,7,5,60,34,26,79
Peterhead,9639,2,24,4,8,80,38,42,76
Stirling,9639,3,16,7,13,61,52,9,55
Stenhousem'r,9639,4,15,9,12,56,47,9,54
Clyde,9639,5,14,10,12,52,49,3,52
Elgin,9639,6,14,6,16,53,61,-8,48
Annan Athlet,9639,7,12,11,13,48,41,7,47
Berwick,9639,8,8,11,17,30,59,-29,35
Edinburgh Ci,9639,9,7,9,20,36,63,-27,30
Cowdenbeath,9639,10,4,10,22,23,55,-32,22
Montrose,9640,1,23,8,5,60,35,25,77
Peterhead,9640,2,24,4,8,80,40,40,76
Stirling,9640,3,17,6,13,66,52,14,57
Stenhousem'r,9640,4,15,8,13,56,52,4,53
Clyde,9640,5,14,10,12,54,51,3,52
Elgin,9640,6,14,7,15,54,61,-7,49
Annan Athlet,9640,7,11,11,14,47,43,4,44
Berwick,9640,8,8,11,17,32,61,-29,35
Edinburgh Ci,9640,9,7,9,20,38,63,-25,30
Cowdenbeath,9640,10,5,10,21,25,54,-29,25
Montrose,9641,1,24,7,5,60,34,26,79
Peterhead,9641,2,24,4,8,80,39,41,76
Stirling,9641,3,17,6,13,64,52,12,57
Clyde,9641,4,15,9,12,52,48,4,54
Stenhousem'r,9641,5,15,8,13,56,50,6,53
Elgin,9641,6,14,6,16,53,61,-8,48
Annan Athlet,9641,7,11,11,14,47,42,5,44
Berwick,9641,8,8,10,18,29,59,-30,34
Edinburgh Ci,9641,9,7,9,20,37,63,-26,30
Cowdenbeath,9641,10,5,10,21,24,54,-30,25
Montrose,9642,1,24,7,5,63,34,29,79
Peterhead,9642,2,23,5,8,78,39,39,74
Stirling,9642,3,17,6,13,63,51,12,57
Stenhousem'r,9642,4,15,8,13,55,49,6,53
Clyde,9642,5,14,9,13,51,49,2,51
Elgin,9642,6,14,6,16,53,64,-11,48
Annan Athlet,9642,7,11,11,14,47,42,5,44
Berwick,9642,8,9,10,17,30,58,-28,37
Edinburgh Ci,9642,9,7,10,19,37,61,-24,31
Cowdenbeath,9642,10,5,10,21,24,54,-30,25
Peterhead,9643,1,24,4,8,79,38,41,76
Montrose,9643,2,23,7,6,60,36,24,76
Stirling,9643,3,16,7,13,61,52,9,55
Stenhousem'r,9643,4,15,9,12,56,47,9,54
Clyde,9643,5,14,9,13,53,51,2,51
Elgin,9643,6,15,6,15,55,61,-6,51
Annan Athlet,9643,7,11,11,14,47,42,5,44
Berwick,9643,8,9,10,17,32,60,-28,37
Edinburgh Ci,9643,9,7,9,20,36,62,-26,30
Cowdenbeath,9643,10,5,10,21,24,54,-30,25
Montrose,9644,1,24,7,5,61,35,26,79
Peterhead,9644,2,23,4,9,77,39,38,73
Stenhousem'r,9644,3,16,8,12,57,46,11,56
Stirling,9644,4,16,6,14,60,53,7,54
Clyde,9644,5,15,9,12,52,48,4,54
Elgin,9644,6,14,6,16,54,62,-8,48
Annan Athlet,9644,7,11,11,14,48,44,4,44
Berwick,9644,8,8,10,18,29,59,-30,34
Edinburgh Ci,9644,9,8,9,19,37,60,-23,33
Cowdenbeath,9644,10,5,10,21,26,55,-29,25
Montrose,9645,1,23,8,5,62,37,25,77
Peterhead,9645,2,24,4,8,79,39,40,76
Stenhousem'r,9645,3,16,8,12,57,46,11,56
Stirling,9645,4,16,6,14,60,53,7,54
Clyde,9645,5,14,9,13,52,50,2,51
Elgin,9645,6,14,7,15,56,63,-7,49
Annan Athlet,9645,7,11,12,13,48,42,6,45
Berwick,9645,8,9,10,17,31,59,-28,37
Edinburgh Ci,9645,9,7,9,20,37,62,-25,30
Cowdenbeath,9645,10,4,11,21,24,55,-31,23
Montrose,9646,1,24,7,5,63,34,29,79
Peterhead,9646,2,24,4,8,80,39,41,76
Stenhousem'r,9646,3,16,8,12,56,46,10,56
Stirling,9646,4,16,6,14,60,52,8,54
Clyde,9646,5,15,9,12,54,48,6,54
Elgin,9646,6,14,6,16,53,64,-11,48
Annan Athlet,9646,7,11,11,14,49,46,3,44
Berwick,9646,8,8,10,18,29,61,-32,34
Edinburgh Ci,9646,9,7,9,20,37,63,-26,30
Cowdenbeath,9646,10,5,10,21,28,56,-28,25
Montrose,9647,1,24,7,5,65,35,30,79
Peterhead,9647,2,24,4,8,80,39,41,76
Stenhousem'r,9647,3,16,8,12,57,47,10,56
Stirling,9647,4,16,6,14,61,53,8,54
Clyde,9647,5,14,9,13,52,50,2,51
Elgin,9647,6,14,6,16,54,66,-12,48
Annan Athlet,9647,7,11,12,13,48,42,6,45
Berwick,9647,8,9,10,17,31,59,-28,37
Edinburgh Ci,9647,9,7,9,20,37,63,-26,30
Cowdenbeath,9647,10,4,11,21,24,55,-31,23
Montrose,9648,1,24,7,5,61,34,27,79
Peterhead,9648,2,24,4,8,80,39,41,76
Stirling,9648,3,16,7,13,61,52,9,55
Stenhousem'r,9648,4,15,9,12,56,47,9,54
Clyde,9648,5,15,9,12,55,49,6,54
Elgin,9648,6,14,6,16,53,62,-9,48
Annan Athlet,9648,7,11,12,13,47,41,6,45
Berwick,9648,8,8,10,18,30,62,-32,34
Edinburgh Ci,9648,9,7,9,20,37,63,-26,30
Cowdenbeath,9648,10,4,11,21,23,54,-31,23
Montrose,9649,1,23,8,5,60,35,25,77
Peterhead,9649,2,24,4,8,79,39,40,76
Stirling,9649,3,17,6,13,62,52,10,57
Clyde,9649,4,15,9,12,55,48,7,54
Stenhousem'r,9649,5,15,8,13,56,48,8,53
Elgin,9649,6,14,7,15,54,61,-7,49
Annan Athlet,9649,7,12,11,13,49,41,8,47
Berwick,9649,8,8,10,18,29,62,-33,34
Edinburgh Ci,9649,9,7,9,20,37,62,-25,30
Cowdenbeath,9649,10,4,10,22,23,56,-33,22
Peterhead,9650,1,24,4,8,80,38,42,76
Montrose,9650,2,23,7,6,59,36,23,76
Stenhousem'r,9650,3,16,8,12,60,46,14,56
Stirling,9650,4,16,6,14,60,56,4,54
Clyde,9650,5,15,9,12,53,49,4,54
Elgin,9650,6,15,6,15,55,60,-5,51
Annan Athlet,9650,7,11,12,13,48,42,6,45
Berwick,9650,8,8,10,18,30,60,-30,34
Edinburgh Ci,9650,9,7,9,20,36,63,-27,30
Cowdenbeath,9650,10,4,11,21,24,55,-31,23
Montrose,9651,1,24,7,5,62,35,27,79
Peterhead,9651,2,24,4,8,80,38,42,76
Stirling,9651,3,17,6,13,63,53,10,57
Stenhousem'r,9651,4,15,8,13,57,49,8,53
Clyde,9651,5,14,10,12,52,49,3,52
Elgin,9651,6,14,6,16,54,63,-9,48
Annan Athlet,9651,7,12,11,13,48,41,7,47
Berwick,9651,8,8,11,17,30,59,-29,35
Edinburgh Ci,9651,9,7,9,20,36,63,-27,30
Cowdenbeath,9651,10,4,10,22,23,55,-32,22
Montrose,9652,1,24,7,5,63,35,28,79
Peterhead,9652,2,24,4,8,82,39,43,76
Stirling,9652,3,17,6,13,62,52,10,57
Clyde,9652,4,15,9,12,55,48,7,54
Stenhousem'r,9652,5,15,8,13,56,48,8,53
Elgin,9652,6,14,6,16,54,64,-10,48
Annan Athlet,9652,7,12,11,13,49,41,8,47
Berwick,9652,8,8,10,18,29,62,-33,34
Edinburgh Ci,9652,9,7,9,20,37,65,-28,30
Cowdenbeath,9652,10,4,10,22,23,56,-33,22
Montrose,9653,1,23,8,5,61,36,25,77
Peterhead,9653,2,24,4,8,80,38,42,76
Stenhousem'r,9653,3,16,8,12,58,47,11,56
Stirling,9653,4,16,6,14,61,54,7,54
Clyde,9653,5,14,9,13,51,51,0,51
Elgin,9653,6,14,7,15,55,62,-7,49
Annan Athlet,9653,7,11,11,14,47,43,4,44
Berwick,9653,8,9,10,17,32,58,-26,37
Edinburgh Ci,9653,9,7,9,20,36,63,-27,30
Cowdenbeath,9653,10,5,10,21,25,54,-29,25
Montrose,9654,1,24,7,5,62,35,27,79
Peterhead,9654,2,24,4,8,80,38,42,76
Stirling,9654,3,17,6,13,64,52,12,57
Clyde,9654,4,15,9,12,54,50,4,54
Stenhousem'r,9654,5,15,8,13,56,50,6,53
Elgin,9654,6,14,6,16,54,63,-9,48
Annan Athlet,9654,7,11,11,14,47,42,5,44
Berwick,9654,8,8,10,18,31,61,-30,34
Edinburgh Ci,9654,9,7,9,20,36,63,-27,30
Cowdenbeath,9654,10,5,10,21,24,54,-30,25
Montrose,9655,1,24,7,5,61,34,27,79
Peterhead,9655,2,24,4,8,78,38,40,76
Stirling,9655,3,17,6,13,64,54,10,57
Clyde,9655,4,15,9,12,53,48,5,54
Stenhousem'r,9655,5,15,8,13,58,50,8,53
Elgin,9655,6,14,6,16,53,62,-9,48
Annan Athlet,9655,7,12,11,13,49,42,7,47
Berwick,9655,8,8,10,18,29,60,-31,34
Edinburgh Ci,9655,9,7,9,20,36,61,-25,30
Cowdenbeath,9655,10,4,10,22,24,56,-32,22
Montrose,9656,1,24,7,5,63,35,28,79
Peterhead,9656,2,24,4,8,81,39,42,76
Stenhousem'r,9656,3,16,8,12,56,46,10,56
Stirling,9656,4,16,6,14,60,52,8,54
Clyde,9656,5,14,10,12,52,49,3,52
Elgin,9656,6,14,6,16,54,64,-10,48
Annan Athlet,9656,7,12,11,13,49,42,7,47
Berwick,9656,8,8,11,17,30,59,-29,35
Edinburgh Ci,9656,9,7,9,20,37,64,-27,30
Cowdenbeath,9656,10,4,10,22,24,56,-32,22
Montrose,9657,1,24,7,5,61,35,26,79
Peterhead,9657,2,23,5,8,79,40,39,74
Stirling,9657,3,16,7,13,63,54,9,55
Stenhousem'r,9657,4,15,9,12,58,49,9,54
Clyde,9657,5,15,9,12,55,48,7,54
Elgin,9657,6,14,6,16,54,62,-8,48
Annan Athlet,9657,7,11,11,14,48,44,4,44
Berwick,9657,8,8,10,18,29,62,-33,34
Edinburgh Ci,9657,9,7,10,19,38,62,-24,31
Cowdenbeath,9657,10,5,10,21,26,55,-29,25
Montrose,9658,1,23,8,5,61,36,25,77
Peterhead,9658,2,24,4,8,83,39,44,76
Stenhousem'r,9658,3,16,8,12,59,46,13,56
Clyde,9658,4,15,9,12,54,48,6,54
Stirling,9658,5,16,6,14,60,55,5,54
Elgin,9658,6,14,7,15,55,62,-7,49
Annan Athlet,9658,7,11,12,13,47,41,6,45
Berwick,9658,8,8,10,18,29,61,-32,34
Edinburgh Ci,9658,9,7,9,20,37,66,-29,30
Cowdenbeath,9658,10,4,11,21,23,54,-31,23
Montrose,9659,1,24,7,5,64,35,29,79
Peterhead,9659,2,24,4,8,80,39,41,76
Stirling,9659,3,16,7,13,62,53,9,55
Stenhousem'r,9659,4,15,9,12,57,48,9,54
Clyde,9659,5,14,10,12,51,48,3,52
Elgin,9659,6,14,6,16,54,65,-11,48
Annan Athlet,9659,7,11,12,13,47,41,6,45
Berwick,9659,8,8,11,17,29,58,-29,35
Edinburgh Ci,9659,9,7,9,20,37,63,-26,30
Cowdenbeath,9659,10,4,11,21,23,54,-31,23
Peterhead,9660,1,24,4,8,80,38,42,76
Montrose,9660,2,23,7,6,59,36,23,76
Stirling,9660,3,17,6,13,63,53,10,57
Stenhousem'r,9660,4,15,8,13,57,49,8,53
Clyde,9660,5,14,9,13,53,51,2,51
Elgin,9660,6,15,6,15,55,60,-5,51
Annan Athlet,9660,7,12,11,13,48,41,7,47
Berwick,9660,8,9,10,17,32,60,-28,37
Edinburgh Ci,9660,9,7,9,20,36,63,-27,30
Cowdenbeath,9660,10,4,10,22,23,55,-32,22
Montrose,9661,1,24,7,5,64,36,28,79
Peterhead,9661,2,24,4,8,81,39,42,76
Stirling,9661,3,17,6,13,63,51,12,57
Clyde,9661,4,15,9,12,53,48,5,54
Stenhousem'r,9661,5,15,8,13,55,49,6,53
Elgin,9661,6,14,6,16,55,65,-10,48
Annan Athlet,9661,7,11,12,13,49,43,6,45
Berwick,9661,8,8,10,18,29,60,-31,34
Edinburgh Ci,9661,9,7,9,20,37,64,-27,30
Cowdenbeath,9661,10,4,11,21,25,56,-31,23
Montrose,9662,1,24,7,5,62,34,28,79
Peterhead,9662,2,24,4,8,81,41,40,76
Stirling,9662,3,17,6,13,62,52,10,57
Clyde,9662,4,15,9,12,52,48,4,54
Stenhousem'r,9662,5,15,8,13,56,48,8,53
Elgin,9662,6,14,6,16,53,63,-10,48
Annan Athlet,9662,7,12,11,13,48,41,7,47
Berwick,9662,8,8,10,18,29,59,-30,34
Edinburgh Ci,9662,9,7,9,20,39,64,-25,30
Cowdenbeath,9662,10,4,10,22,23,55,-32,22
Peterhead,9663,1,24,4,8,80,38,42,76
Montrose,9663,2,23,7,6,60,36,24,76
Stirling,9663,3,17,6,13,62,51,11,57
Stenhousem'r,9663,4,15,8,13,55,48,7,53
Clyde,9663,5,14,9,13,51,49,2,51
Elgin,9663,6,15,6,15,55,61,-6,51
Annan Athlet,9663,7,12,11,13,49,41,8,47
Berwick,9663,8,9,10,17,30,58,-28,37
Edinburgh Ci,9663,9,7,9,20,36,63,-27,30
Cowdenbeath,9663,10,4,10,22,23,56,-33,22
Montrose,9664,1,24,7,5,61,35,26,79
Peterhead,9664,2,24,4,8,81,40,41,76
Stirling,9664,3,17,6,13,63,53,10,57
Clyde,9664,4,15,9,12,53,49,4,54
Stenhousem'r,9664,5,15,8,13,57,49,8,53
Elgin,9664,6,14,6,16,54,62,-8,48
Annan Athlet,9664,7,11,12,13,47,41,6,45
Berwick,9664,8,8,10,18,30,60,-30,34
Edinburgh Ci,9664,9,7,9,20,38,64,-26,30
Cowdenbeath,9664,10,4,11,21,23,54,-31,23
Montrose,9665,1,24,7,5,61,34,27,79
Peterhead,9665,2,24,4,8,80,40,40,76
Stenhousem'r,9665,3,16,8,12,57,47,10,56
Stirling,9665,4,16,6,14,61,53,8,54
Clyde,9665,5,15,9,12,54,48,6,54
Elgin,9665,6,14,6,16,53,62,-9,48
Annan Athlet,9665,7,11,11,14,47,42,5,44
Berwick,9665,8,8,10,18,29,61,-32,34
Edinburgh Ci,9665,9,7,9,20,38,63,-25,30
Cowdenbeath,9665,10,5,10,21,24,54,-30,25
Montrose,9666,1,23,8,5,59,34,25,77
Peterhead,9666,2,24,4,8,79,39,40,76
Stirling,9666,3,17,6,13,62,51,11,57
Stenhousem'r,9666,4,15,8,13,55,48,7,53
Clyde,9666,5,14,10,12,53,50,3,52
Elgin,9666,6,14,7,15,53,60,-7,49
Annan Athlet,9666,7,11,11,14,48,43,5,44
Berwick,9666,8,8,11,17,31,60,-29,35
Edinburgh Ci,9666,9,7,9,20,37,62,-25,30
Cowdenbeath,9666,10,5,10,21,25,55,-30,25
Montrose,9667,1,23,8,5,59,34,25,77
Peterhead,9667,2,24,4,8,82,39,43,76
Stirling,9667,3,17,6,13,61,51,10,57
Clyde,9667,4,15,9,12,53,48,5,54
Stenhousem'r,9667,5,15,8,13,55,47,8,53
Elgin,9667,6,14,7,15,53,60,-7,49
Annan Athlet,9667,7,12,11,13,49,42,7,47
Berwick,9667,8,8,10,18,29,60,-31,34
Edinburgh Ci,9667,9,7,9,20,37,65,-28,30
Cowdenbeath,9667,10,4,10,22,24,56,-32,22
Montrose,9668,1,23,7,6,61,37,24,76
Peterhead,9668,2,23,5,8,77,38,39,74
Stenhousem'r,9668,3,16,8,12,57,46,11,56
Stirling,9668,4,16,6,14,60,53,7,54
Clyde,9668,5,15,9,12,54,49,5,54
Elgin,9668,6,15,6,15,56,62,-6,51
Annan Athlet,9668,7,11,11,14,47,44,3,44
Berwick,9668,8,8,10,18,30,61,-31,34
Edinburgh Ci,9668,9,7,10,19,36,60,-24,31
Cowdenbeath,9668,10,5,10,21,26,54,-28,25
Montrose,9669,1,24,7,5,60,34,26,79
Peterhead,9669,2,24,4,8,81,39,42,76
Stenhousem'r,9669,3,16,8,12,57,46,11,56
Stirling,9669,4,16,6,14,60,53,7,54
Clyde,9669,5,15,9,12,54,48,6,54
Elgin,9669,6,14,6,16,53,61,-8,48
Annan Athlet,9669,7,12,11,13,49,41,8,47
Berwick,9669,8,8,10,18,29,61,-32,34
Edinburgh Ci,9669,9,7,9,20,37,64,-27,30
Cowdenbeath,9669,10,4,10,22,23,56,-33,22
Montrose,9670,1,24,7,5,61,35,26,79
Peterhead,9670,2,24,4,8,79,39,40,76
Stirling,9670,3,17,6,13,61,51,10,57
Stenhousem'r,9670,4,15,8,13,55,47,8,53
Clyde,9670,5,14,10,12,52,49,3,52
Elgin,9670,6,14,6,16,54,62,-8,48
Annan Athlet,9670,7,11,12,13,49,43,6,45
Berwick,9670,8,8,11,17,30,59,-29,35
Edinburgh Ci,9670,9,7,9,20,37,62,-25,30
Cowdenbeath,9670,10,4,11,21,25,56,-31,23
Peterhead,9671,1,24,4,8,80,39,41,76
Montrose,9671,2,23,7,6,61,37,24,76
Stenhousem'r,9671,3,16,8,12,57,46,11,56
Stirling,9671,4,16,6,14,60,53,7,54
Clyde,9671,5,14,10,12,54,51,3,52
Elgin,9671,6,15,6,15,56,62,-6,51
Annan Athlet,9671,7,11,12,13,47,41,6,45
Berwick,9671,8,8,11,17,32,61,-29,35
Edinburgh Ci,9671,9,7,9,20,37,63,-26,30
Cowdenbeath,9671,10,4,11,21,23,54,-31,23
Montrose,9672,1,24,7,5,61,35,26,79
Peterhead,9672,2,23,4,9,78,40,38,73
Stenhousem'r,9672,3,16,8,12,58,46,12,56
Stirling,9672,4,16,6,14,60,54,6,54
Clyde,9672,5,14,9,13,52,50,2,51
Elgin,9672,6,14,6,16,54,62,-8,48
Annan Athlet,9672,7,11,11,14,47,43,4,44
Berwick,9672,8,9,10,17,31,59,-28,37
Edinburgh Ci,9672,9,8,9,19,38,61,-23,33
Cowdenbeath,9672,10,5,10,21,25,54,-29,25
Montrose,9673,1,23,8,5,59,34,25,77
Peterhead,9673,2,23,5,8,80,41,39,74
Stirling,9673,3,16,7,13,60,51,9,55
Stenhousem'r,9673,4,15,9,12,55,46,9,54
Clyde,9673,5,14,10,12,52,49,3,52
Elgin,9673,6,14,7,15,53,60,-7,49
Annan Athlet,9673,7,11,12,13,47,41,6,45
Berwick,9673,8,8,11,17,30,59,-29,35
Edinburgh Ci,9673,9,7,10,19,39,63,-24,31
Cowdenbeath,9673,10,4,11,21,23,54,-31,23
Montrose,9674,1,24,7,5,62,35,27,79
Peterhead,9674,2,24,4,8,79,38,41,76
Stirling,9674,3,16,7,13,61,52,9,55
Stenhousem'r,9674,4,15,9,12,56,47,9,54
Clyde,9674,5,15,9,12,52,48,4,54
Elgin,9674,6,14,6,16,54,63,-9,48
Annan Athlet,9674,7,12,11,13,48,41,7,47
Berwick,9674,8,8,10,18,29,59,-30,34
Edinburgh Ci,9674,9,7,9,20,36,62,-26,30
Cowdenbeath,9674,10,4,10,22,23,55,-32,22
Montrose,9675,1,24,7,5,61,34,27,79
Peterhead,9675,2,23,5,8,80,41,39,74
Stenhousem'r,9675,3,16,8,12,56,46,10,56
Stirling,9675,4,16,6,14,60,52,8,54
Clyde,9675,5,14,10,12,51,48,3,52
Elgin,9675,6,14,6,16,53,62,-9,48
Annan Athlet,9675,7,12,11,13,48,41,7,47
Berwick,9675,8,8,11,17,29,58,-29,35
Edinburgh Ci,9675,9,7,10,19,39,63,-24,31
Cowdenbeath,9675,10,4,10,22,23,55,-32,22
Montrose,9676,1,24,7,5,60,34,26,79
Peterhead,9676,2,24,4,8,81,40,41,76
Stenhousem'r,9676,3,16,8,12,57,46,11,56
Stirling,9676,4,16,6,14,60,53,7,54
Clyde,9676,5,14,10,12,53,50,3,52
Elgin,9676,6,14,6,16,53,61,-8,48
Annan Athlet,9676,7,12,11,13,49,41,8,47
Berwick,9676,8,8,11,17,31,60,-29,35
Edinburgh Ci,9676,9,7,9,20,38,64,-26,30
Cowdenbeath,9676,10,4,10,22,23,56,-33,22
Montrose,9677,1,24,7,5,61,35,26,79
Peterhead,9677,2,24,4,8,80,39,41,76
Stirling,9677,3,17,6,13,62,51,11,57
Stenhousem'r,9677,4,15,8,13,55,48,7,53
Clyde,9677,5,14,10,12,51,48,3,52
Elgin,9677,6,14,6,16,54,62,-8,48
Annan Athlet,9677,7,11,11,14,48,45,3,44
Berwick,9677,8,8,11,17,29,58,-29,35
Edinburgh Ci,9677,9,7,9,20,37,63,-26,30
Cowdenbeath,9677,10,5,10,21,27,55,-28,25
Montrose,9678,1,24,7,5,61,35,26,79
Peterhead,9678,2,23,4,9,79,43,36,73
Stirling,9678,3,17,6,13,61,51,10,57
Clyde,9678,4,15,9,12,53,48,5,54
Stenhousem'r,9678,5,15,8,13,55,47,8,53
Elgin,9678,6,14,6,16,54,62,-8,48
Annan Athlet,9678,7,12,11,13,50,43,7,47
Berwick,9678,8,8,10,18,29,60,-31,34
Edinburgh Ci,9678,9,8,9,19,41,62,-21,33
Cowdenbeath,9678,10,4,10,22,25,57,-32,22
Montrose,9679,1,24,7,5,61,35,26,79
Peterhead,9679,2,24,4,8,80,38,42,76
Stirling,9679,3,17,6,13,63,52,11,57
Stenhousem'r,9679,4,15,8,13,56,49,7,53
Clyde,9679,5,14,10,12,51,48,3,52
Elgin,9679,6,14,6,16,54,62,-8,48
Annan Athlet,9679,7,11,11,14,47,44,3,44
Berwick,9679,8,8,11,17,29,58,-29,35
Edinburgh Ci,9679,9,7,9,20,36,63,-27,30
Cowdenbeath,9679,10,5,10,21,26,54,-28,25
Montrose,9680,1,23,8,5,62,37,25,77
Peterhead,9680,2,24,4,8,79,38,41,76
Stirling,9680,3,16,7,13,61,52,9,55
Stenhousem'r,9680,4,15,9,12,56,47,9,54
Clyde,9680,5,15,9,12,53,49,4,54
Elgin,9680,6,14,7,15,56,63,-7,49
Annan Athlet,9680,7,11,12,13,48,42,6,45
Berwick,9680,8,8,10,18,30,60,-30,34
Edinburgh Ci,9680,9,7,9,20,36,62,-26,30
Cowdenbeath,9680,10,4,11,21,24,55,-31,23
Montrose,9681,1,24,7,5,60,34,26,79
Peterhead,9681,2,24,4,8,82,39,43,76
Stirling,9681,3,17,6,13,64,53,11,57
Stenhousem'r,9681,4,15,8,13,57,50,7,53
Clyde,9681,5,14,9,13,52,50,2,51
Elgin,9681,6,14,6,16,53,61,-8,48
Annan Athlet,9681,7,11,12,13,48,42,6,45
Berwick,9681,8,9,10,17,31,59,-28,37
Edinburgh Ci,9681,9,7,9,20,37,65,-28,30
Cowdenbeath,9681,10,4,11,21,24,55,-31,23
Montrose,9682,1,24,7,5,61,35,26,79
Peterhead,9682,2,24,4,8,81,38,43,76
Stirling,9682,3,17,6,13,61,51,10,57
Stenhousem'r,9682,4,15,8,13,55,47,8,53
Clyde,9682,5,14,10,12,53,50,3,52
Elgin,9682,6,14,6,16,54,62,-8,48
Annan Athlet,9682,7,11,12,13,48,42,6,45
Berwick,9682,8,8,11,17,31,60,-29,35
Edinburgh Ci,9682,9,7,9,20,36,64,-28,30
Cowdenbeath,9682,10,4,11,21,24,55,-31,23
Montrose,9683,1,23,8,5,60,35,25,77
Peterhead,9683,2,24,4,8,80,39,41,76
Stirling,9683,3,17,6,13,62,51,11,57
Stenhousem'r,9683,4,15,8,13,55,48,7,53
Clyde,9683,5,14,10,12,52,49,3,52
Elgin,9683,6,14,7,15,54,61,-7,49
Annan Athlet,9683,7,12,11,13,48,41,7,47
Berwick,9683,8,8,11,17,30,59,-29,35
Edinburgh Ci,9683,9,7,9,20,37,63,-26,30
Cowdenbeath,9683,10,4,10,22,23,55,-32,22
Montrose,9684,1,24,7,5,63,34,29,79
Peterhead,9684,2,24,4,8,82,38,44,76
Stenhousem'r,9684,3,16,8,12,59,46,13,56
Stirling,9684,4,16,6,14,60,55,5,54
Clyde,9684,5,15,9,12,54,50,4,54
Elgin,9684,6,14,6,16,53,64,-11,48
Annan Athlet,9684,7,11,12,13,48,42,6,45
Berwick,9684,8,8,10,18,31,61,-30,34
Edinburgh Ci,9684,9,7,9,20,36,65,-29,30
Cowdenbeath,9684,10,4,11,21,24,55,-31,23
Montrose,9685,1,23,8,5,62,37,25,77
Peterhead,9685,2,24,4,8,80,39,41,76
Stirling,9685,3,17,6,13,63,52,11,57
Stenhousem'r,9685,4,15,8,13,56,49,7,53
Clyde,9685,5,14,9,13,52,50,2,51
Elgin,9685,6,14,7,15,56,63,-7,49
Annan Athlet,9685,7,12,11,13,49,42,7,47
Berwick,9685,8,9,10,17,31,59,-28,37
Edinburgh Ci,9685,9,7,9,20,37,63,-26,30
Cowdenbeath,9685,10,4,10,22,24,56,-32,22
Montrose,9686,1,24,7,5,61,34,27,79
Peterhead,9686,2,23,5,8,79,40,39,74
Stenhousem'r,9686,3,16,8,12,57,47,10,56
Stirling,9686,4,16,6,14,61,53,8,54
Clyde,9686,5,14,10,12,53,50,3,52
Elgin,9686,6,14,6,16,53,62,-9,48
Annan Athlet,9686,7,12,11,13,48,41,7,47
Berwick,9686,8,8,11,17,31,60,-29,35
Edinburgh Ci,9686,9,7,10,19,38,62,-24,31
Cowdenbeath,9686,10,4,10,22,23,55,-32,22
Montrose,9687,1,24,7,5,60,34,26,79
Peterhead,9687,2,24,4,8,82,38,44,76
Stirling,9687,3,17,6,13,62,51,11,57
Clyde,9687,4,15,9,12,54,49,5,54
Stenhousem'r,9687,5,15,8,13,55,48,7,53
Elgin,9687,6,14,6,16,53,61,-8,48
Annan Athlet,9687,7,11,12,13,47,41,6,45
Berwick,9687,8,8,10,18,30,61,-31,34
Edinburgh Ci,9687,9,7,9,20,36,65,-29,30
Cowdenbeath,9687,10,4,11,21,23,54,-31,23
Montrose,9688,1,24,7,5,62,34,28,79
Peterhead,9688,2,24,4,8,79,38,41,76
Stirling,9688,3,17,6,13,63,52,11,57
Stenhousem'r,9688,4,15,8,13,56,49,7,53
Clyde,9688,5,14,10,12,51,48,3,52
Elgin,9688,6,14,6,16,53,63,-10,48
Annan Athlet,9688,7,11,11,14,47,42,5,44
Berwick,9688,8,8,11,17,29,58,-29,35
Edinburgh Ci,9688,9,7,9,20,36,62,-26,30
Cowdenbeath,9688,10,5,10,21,24,54,-30,25
Montrose,9689,1,24,7,5,61,35,26,79
Peterhead,9689,2,24,4,8,78,38,40,76
Stenhousem'r,9689,3,16,8,12,57,47,10,56
Stirling,9689,4,16,6,14,61,53,8,54
Clyde,9689,5,15,9,12,54,49,5,54
Elgin,9689,6,14,6,16,54,62,-8,48
Annan Athlet,9689,7,11,12,13,47,41,6,45
Berwick,9689,8,8,10,18,30,61,-31,34
Edinburgh Ci,9689,9,7,9,20,36,61,-25,30
Cowdenbeath,9689,10,4,11,21,23,54,-31,23
Montrose,9690,1,24,7,5,63,34,29,79
Peterhead,9690,2,24,4,8,81,39,42,76
Stirling,9690,3,17,6,13,61,51,10,57
Clyde,9690,4,15,9,12,53,48,5,54
Stenhousem'r,9690,5,15,8,13,55,47,8,53
Elgin,9690,6,14,6,16,53,64,-11,48
Annan Athlet,9690,7,11,11,14,47,42,5,44
Berwick,9690,8,8,10,18,29,60,-31,34
Edinburgh Ci,9690,9,7,9,20,37,64,-27,30
Cowdenbeath,9690,10,5,10,21,24,54,-30,25
Peterhead,9691,1,24,4,8,79,38,41,76
Montrose,9691,2,23,7,6,59,35,24,76
Stirling,9691,3,17,6,13,64,52,12,57
Stenhousem'r,9691,4,15,8,13,56,50,6,53
Clyde,9691,5,14,10,12,53,50,3,52
Elgin,9691,6,15,6,15,54,60,-6,51
Annan Athlet,9691,7,11,11,14,47,42,5,44
Berwick,9691,8,8,11,17,31,60,-29,35
Edinburgh Ci,9691,9,7,9,20,36,62,-26,30
Cowdenbeath,9691,10,5,10,21,24,54,-30,25
Montrose,9692,1,24,7,5,64,35,29,79
Peterhead,9692,2,24,4,8,83,40,43,76
Stirling,9692,3,16,7,13,64,55,9,55
Stenhousem'r,9692,4,15,9,12,59,50,9,54
Clyde,9692,5,14,10,12,53,50,3,52
Elgin,9692,6,14,6,16,54,65,-11,48
Annan Athlet,9692,7,11,11,14,47,43,4,44
Berwick,9692,8,8,11,17,31,60,-29,35
Edinburgh Ci,9692,9,7,9,20,38,66,-28,30
Cowdenbeath,9692,10,5,10,21,25,54,-29,25
Montrose,9693,1,23,8,5,59,34,25,77
Peterhead,9693,2,24,4,8,79,39,40,76
Stirling,9693,3,17,6,13,63,52,11,57
Stenhousem'r,9693,4,15,8,13,56,49,7,53
Clyde,9693,5,14,10,12,51,48,3,52
Elgin,9693,6,14,7,15,53,60,-7,49
Annan Athlet,9693,7,12,11,13,49,42,7,47
Berwick,9693,8,8,11,17,29,58,-29,35
Edinburgh Ci,9693,9,7,9,20,37,62,-25,30
Cowdenbeath,9693,10,4,10,22,24,56,-32,22
Montrose,9694,1,24,7,5,61,35,26,79
Peterhead,9694,2,24,4,8,80,38,42,76
Stirling,9694,3,16,7,13,62,53,9,55
Stenhousem'r,9694,4,15,9,12,57,48,9,54
Clyde,9694,5,15,9,12,54,49,5,54
Elgin,9694,6,14,6,16,54,62,-8,48
Annan Athlet,9694,7,12,11,13,48,41,7,47
Berwick,9694,8,8,10,18,30,61,-31,34
Edinburgh Ci,9694,9,7,9,20,36,63,-27,30
Cowdenbeath,9694,10,4,10,22,23,55,-32,22
Montrose,9695,1,24,7,5,60,34,26,79
Peterhead,9695,2,23,5,8,77,38,39,74
Stirling,9695,3,17,6,13,62,51,11,57
Stenhousem'r,9695,4,15,8,13,55,48,7,53
Clyde,9695,5,14,10,12,53,50,3,52
Elgin,9695,6,14,6,16,53,61,-8,48
Annan Athlet,9695,7,11,11,14,48,43,5,44
Berwick,9695,8,8,11,17,31,60,-29,35
Edinburgh Ci,9695,9,7,10,19,36,60,-24,31
Cowdenbeath,9695,10,5,10,21,25,55,-30,25
Montrose,9696,1,23,8,5,60,35,25,77
Peterhead,9696,2,23,4,9,77,39,38,73
Stirling,9696,3,17,6,13,61,51,10,57
Clyde,9696,4,15,9,12,53,48,5,54
Stenhousem'r,9696,5,15,8,13,55,47,8,53
Elgin,9696,6,14,7,15,54,61,-7,49
Annan Athlet,9696,7,11,12,13,49,43,6,45
Berwick,9696,8,8,10,18,29,60,-31,34
Edinburgh Ci,9696,9,8,9,19,37,60,-23,33
Cowdenbeath,9696,10,4,11,21,25,56,-31,23
Montrose,9697,1,24,7,5,63,37,26,79
Peterhead,9697,2,24,4,8,79,38,41,76
Stenhousem'r,9697,3,16,8,12,59,46,13,56
Clyde,9697,4,15,9,12,55,49,6,54
Stirling,9697,5,16,6,14,60,55,5,54
Elgin,9697,6,14,6,16,56,64,-8,48
Annan Athlet,9697,7,12,11,13,50,41,9,47
Berwick,9697,8,8,10,18,30,62,-32,34
Edinburgh Ci,9697,9,7,9,20,36,62,-26,30
Cowdenbeath,9697,10,4,10,22,23,57,-34,22
Peterhead,9698,1,24,4,8,80,39,41,76
Montrose,9698,2,23,7,6,59,35,24,76
Stenhousem'r,9698,3,16,8,12,57,47,10,56
Stirling,9698,4,16,6,14,61,53,8,54
Clyde,9698,5,15,9,12,54,49,5,54
Elgin,9698,6,15,6,15,54,60,-6,51
Annan Athlet,9698,7,12,11,13,50,41,9,47
Berwick,9698,8,8,10,18,30,61,-31,34
Edinburgh Ci,9698,9,7,9,20,37,63,-26,30
Cowdenbeath,9698,10,4,10,22,23,57,-34,22
Montrose,9699,1,23,8,5,61,36,25,77
Peterhead,9699,2,24,4,8,82,38,44,76
Stirling,9699,3,17,6,13,62,51,11,57
Clyde,9699,4,15,9,12,54,49,5,54
Stenhousem'r,9699,5,15,8,13,55,48,7,53
Elgin,9699,6,14,7,15,55,62,-7,49
Annan Athlet,9699,7,12,11,13,49,42,7,47
Berwick,9699,8,8,10,18,30,61,-31,34
Edinburgh Ci,9699,9,7,9,20,36,65,-29,30
Cowdenbeath,9699,10,4,10,22,24,56,-32,22
Montrose,9700,1,24,7,5,62,34,28,79
Peterhead,9700,2,24,4,8,80,38,42,76
Stirling,9700,3,17,6,13,62,51,11,57
Clyde,9700,4,15,9,12,55,51,4,54
Stenhousem'r,9700,5,15,8,13,55,48,7,53
Elgin,9700,6,14,6,16,53,63,-10,48
Annan Athlet,9700,7,12,11,13,51,43,8,47
Berwick,9700,8,8,10,18,32,62,-30,34
Edinburgh Ci,9700,9,7,9,20,36,63,-27,30
Cowdenbeath,9700,10,4,10,22,25,58,-33,22
Montrose,9701,1,24,7,5,61,35,26,79
Peterhead,9701,2,24,4,8,79,39,40,76
Stirling,9701,3,16,7,13,62,53,9,55
Stenhousem'r,9701,4,15,9,12,57,48,9,54
Clyde,9701,5,14,9,13,51,49,2,51
Elgin,9701,6,14,6,16,54,62,-8,48
Annan Athlet,9701,7,12,11,13,49,41,8,47
Berwick,9701,8,9,10,17,30,58,-28,37
Edinburgh Ci,9701,9,7,9,20,37,62,-25,30
Cowdenbeath,9701,10,4,10,22,23,56,-33,22
Montrose,9702,1,24,7,5,62,35,27,79
Peterhead,9702,2,24,4,8,80,39,41,76
Stirling,9702,3,17,6,13,63,53,10,57
Stenhousem'r,9702,4,15,8,13,57,49,8,53
Clyde,9702,5,14,10,12,51,48,3,52
Elgin,9702,6,14,6,16,54,63,-9,48
Annan Athlet,9702,7,12,11,13,49,41,8,47
Berwick,9702,8,8,11,17,29,58,-29,35
Edinburgh Ci,9702,9,7,9,20,37,63,-26,30
Cowdenbeath,9702,10,4,10,22,23,56,-33,22
Montrose,9703,1,24,7,5,60,34,26,79
Peterhead,9703,2,24,4,8,80,38,42,76
Stenhousem'r,9703,3,16,8,12,57,47,10,56
Stirling,9703,4,16,6,14,61,53,8,54
Clyde,9703,5,14,10,12,52,49,3,52
Elgin,9703,6,14,6,16,53,61,-8,48
Annan Athlet,9703,7,11,12,13,47,41,6,45
Berwick,9703,8,8,11,17,30,59,-29,35
Edinburgh Ci,9703,9,7,9,20,36,63,-27,30
Cowdenbeath,9703,10,4,11,21,23,54,-31,23
Montrose,9704,1,24,7,5,63,35,28,79
Peterhead,9704,2,23,4,9,81,43,38,73
Stirling,9704,3,17,6,13,63,53,10,57
Stenhousem'r,9704,4,15,8,13,57,49,8,53
Clyde,9704,5,14,9,13,52,50,2,51
Elgin,9704,6,14,6,16,54,64,-10,48
Annan Athlet,9704,7,11,11,14,48,43,5,44
Berwick,9704,8,9,10,17,31,59,-28,37
Edinburgh Ci,9704,9,8,9,19,41,64,-23,33
Cowdenbeath,9704,10,5,10,21,25,55,-30,25
Montrose,9705,1,24,7,5,62,36,26,79
Peterhead,9705,2,24,4,8,79,39,40,76
Stirling,9705,3,17,6,13,65,51,14,57
Clyde,9705,4,15,9,12,52,48,4,54
Stenhousem'r,9705,5,15,8,13,55,51,4,53
Elgin,9705,6,14,6,16,55,63,-8,48
Annan Athlet,9705,7,11,11,14,47,43,4,44
Berwick,9705,8,8,10,18,29,59,-30,34
Edinburgh Ci,9705,9,7,9,20,37,62,-25,30
Cowdenbeath,9705,10,5,10,21,25,54,-29,25
Montrose,9706,1,24,7,5,62,36,26,79
Peterhead,9706,2,24,4,8,80,38,42,76
Stirling,9706,3,16,7,13,62,53,9,55
Stenhousem'r,9706,4,15,9,12,57,48,9,54
Clyde,9706,5,14,10,12,52,49,3,52
Elgin,9706,6,14,6,16,55,63,-8,48
Annan Athlet,9706,7,12,11,13,50,42,8,47
Berwick,9706,8,8,11,17,30,59,-29,35
Edinburgh Ci,9706,9,7,9,20,36,63,-27,30
Cowdenbeath,9706,10,4,10,22,24,57,-33,22
Peterhead,9707,1,24,4,8,78,38,40,76
Montrose,9707,2,23,7,6,59,36,23,76
Stirling,9707,3,17,6,13,63,52,11,57
Clyde,9707,4,15,9,12,54,49,5,54
Stenhousem'r,9707,5,15,8,13,56,49,7,53
Elgin,9707,6,15,6,15,55,60,-5,51
Annan Athlet,9707,7,11,12,13,48,42,6,45
Berwick,9707,8,8,10,18,30,61,-31,34
Edinburgh Ci,9707,9,7,9,20,36,61,-25,30
Cowdenbeath,9707,10,4,11,21,24,55,-31,23
Montrose,9708,1,24,7,5,64,35,29,79
Peterhead,9708,2,24,4,8,80,40,40,76
Stirling,9708,3,17,6,13,62,52,10,57
Clyde,9708,4,15,9,12,55,49,6,54
Stenhousem'r,9708,5,15,8,13,56,48,8,53
Elgin,9708,6,14,6,16,54,65,-11,48
Annan Athlet,9708,7,11,11,14,48,43,5,44
Berwick,9708,8,8,10,18,30,62,-32,34
Edinburgh Ci,9708,9,7,9,20,38,63,-25,30
Cowdenbeath,9708,10,5,10,21,25,55,-30,25
Montrose,9709,1,23,8,5,61,36,25,77
Peterhead,9709,2,24,4,8,78,38,40,76
Stenhousem'r,9709,3,16,8,12,57,47,10,56
Stirling,9709,4,16,6,14,61,53,8,54
Clyde,9709,5,15,9,12,52,48,4,54
Elgin,9709,6,14,7,15,55,62,-7,49
Annan Athlet,9709,7,12,11,13,48,41,7,47
Berwick,9709,8,8,10,18,29,59,-30,34
Edinburgh Ci,9709,9,7,9,20,36,61,-25,30
Cowdenbeath,9709,10,4,10,22,23,55,-32,22
Montrose,9710,1,24,7,5,62,34,28,79
Peterhead,9710,2,24,4,8,79,38,41,76
Stirling,9710,3,17,6,13,62,52,10,57
Stenhousem'r,9710,4,15,8,13,56,48,8,53
Clyde,9710,5,14,10,12,54,51,3,52
Elgin,9710,6,14,6,16,53,63,-10,48
Annan Athlet,9710,7,11,11,14,47,42,5,44
Berwick,9710,8,8,11,17,32,61,-29,35
Edinburgh Ci,9710,9,7,9,20,36,62,-26,30
Cowdenbeath,9710,10,5,10,21,24,54,-30,25
Montrose,9711,1,23,8,5,60,35,25,77
Peterhead,9711,2,24,4,8,79,38,41,76
Stirling,9711,3,17,6,13,61,51,10,57
Clyde,9711,4,15,9,12,56,49,7,54
Stenhousem'r,9711,5,15,8,13,55,47,8,53
Elgin,9711,6,14,7,15,54,61,-7,49
Annan Athlet,9711,7,12,11,13,49,42,7,47
Berwick,9711,8,8,10,18,30,63,-33,34
Edinburgh Ci,9711,9,7,9,20,36,62,-26,30
Cowdenbeath,9711,10,4,10,22,24,56,-32,22
Montrose,9712,1,24,7,5,62,35,27,79
Peterhead,9712,2,24,4,8,79,38,41,76
Stirling,9712,3,17,6,13,63,53,10,57
Clyde,9712,4,15,9,12,52,48,4,54
Stenhousem'r,9712,5,15,8,13,57,49,8,53
Elgin,9712,6,14,6,16,54,63,-9,48
Annan Athlet,9712,7,11,12,13,48,42,6,45
Berwick,9712,8,8,10,18,29,59,-30,34
Edinburgh Ci,9712,9,7,9,20,36,62,-26,30
Cowdenbeath,9712,10,4,11,21,24,55,-31,23
Montrose,9713,1,24,7,5,64,37,27,79
Peterhead,9713,2,24,4,8,80,38,42,76
Stirling,9713,3,17,6,13,64,51,13,57
Clyde,9713,4,15,9,12,56,49,7,54
Stenhousem'r,9713,5,15,8,13,55,50,5,53
Elgin,9713,6,14,6,16,56,65,-9,48
Annan Athlet,9713,7,11,12,13,47,41,6,45
Berwick,9713,8,8,10,18,30,63,-33,34
Edinburgh Ci,9713,9,7,9,20,36,63,-27,30
Cowdenbeath,9713,10,4,11,21,23,54,-31,23
Montrose,9714,1,24,7,5,62,34,28,79
Peterhead,9714,2,23,5,8,77,38,39,74
Stenhousem'r,9714,3,16,8,12,57,47,10,56
Stirling,9714,4,16,6,14,61,53,8,54
Clyde,9714,5,14,9,13,51,49,2,51
Elgin,9714,6,14,6,16,53,63,-10,48
Annan Athlet,9714,7,12,11,13,48,41,7,47
Berwick,9714,8,9,10,17,30,58,-28,37
Edinburgh Ci,9714,9,7,10,19,36,60,-24,31
Cowdenbeath,9714,10,4,10,22,23,55,-32,22
Montrose,9715,1,24,7,5,63,34,29,79
Peterhead,9715,2,24,4,8,82,38,44,76
Stenhousem'r,9715,3,16,8,12,57,46,11,56
Stirling,9715,4,16,6,14,60,53,7,54
Clyde,9715,5,15,9,12,54,48,6,54
Elgin,9715,6,14,6,16,53,64,-11,48
Annan Athlet,9715,7,11,11,14,47,42,5,44
Berwick,9715,8,8,10,18,29,61,-32,34
Edinburgh Ci,9715,9,7,9,20,36,65,-29,30
Cowdenbeath,9715,10,5,10,21,24,54,-30,25
Montrose,9716,1,23,8,5,61,36,25,77
Peterhead,9716,2,23,5,8,78,39,39,74
Stirling,9716,3,17,6,13,61,51,10,57
Clyde,9716,4,15,9,12,55,48,7,54
Stenhousem'r,9716,5,15,8,13,55,47,8,53
Elgin,9716,6,14,7,15,55,62,-7,49
Annan Athlet,9716,7,11,11,14,47,43,4,44
Berwick,9716,8,8,10,18,29,62,-33,34
Edinburgh Ci,9716,9,7,10,19,37,61,-24,31
Cowdenbeath,9716,10,5,10,21,25,54,-29,25
Montrose,9717,1,24,7,5,65,36,29,79
Peterhead,9717,2,24,4,8,80,39,41,76
Stirling,9717,3,17,6,13,63,52,11,57
Clyde,9717,4,15,9,12,53,48,5,54
Stenhousem'r,9717,5,15,8,13,56,49,7,53
Elgin,9717,6,14,6,16,55,66,-11,48
Annan Athlet,9717,7,11,12,13,48,42,6,45
Berwick,9717,8,8,10,18,29,60,-31,34
Edinburgh Ci,9717,9,7,9,20,37,63,-26,30
Cowdenbeath,9717,10,4,11,21,24,55,-31,23
Montrose,9718,1,23,8,5,60,35,25,77
Peterhead,9718,2,24,4,8,80,39,41,76
Stirling,9718,3,16,7,13,63,54,9,55
Stenhousem'r,9718,4,15,9,12,58,49,9,54
Clyde,9718,5,14,9,13,51,49,2,51
Elgin,9718,6,14,7,15,54,61,-7,49
Annan Athlet,9718,7,11,11,14,48,43,5,44
Berwick,9718,8,9,10,17,30,58,-28,37
Edinburgh Ci,9718,9,7,9,20,37,63,-26,30
Cowdenbeath,9718,10,5,10,21,25,55,-30,25
Montrose,9719,1,24,7,5,60,34,26,79
Peterhead,9719,2,24,4,8,79,39,40,76
Stirling,9719,3,17,6,13,62,51,11,57
Clyde,9719,4,15,9,12,56,49,7,54
Stenhousem'r,9719,5,15,8,13,55,48,7,53
Elgin,9719,6,14,6,16,53,61,-8,48
Annan Athlet,9719,7,12,11,13,48,41,7,47
Berwick,9719,8,8,10,18,30,63,-33,34
Edinburgh Ci,9719,9,7,9,20,37,62,-25,30
Cowdenbeath,9719,10,4,10,22,23,55,-32,22
Montrose,9720,1,23,8,5,60,35,25,77
Peterhead,9720,2,24,4,8,86,39,47,76
Stirling,9720,3,16,7,13,63,54,9,55
Stenhousem'r,9720,4,15,9,12,58,49,9,54
Clyde,9720,5,14,9,13,52,51,1,51
Elgin,9720,6,14,7,15,54,61,-7,49
Annan Athlet,9720,7,11,11,14,47,43,4,44
Berwick,9720,8,9,10,17,32,59,-27,37
Edinburgh Ci,9720,9,7,9,20,37,69,-32,30
Cowdenbeath,9720,10,5,10,21,25,54,-29,25
Peterhead,9721,1,24,4,8,78,38,40,76
Montrose,9721,2,23,7,6,60,36,24,76
Stenhousem'r,9721,3,16,8,12,57,47,10,56
Stirling,9721,4,16,6,14,61,53,8,54
Clyde,9721,5,15,9,12,53,49,4,54
Elgin,9721,6,15,6,15,55,61,-6,51
Annan Athlet,9721,7,12,11,13,49,41,8,47
Berwick,9721,8,8,10,18,30,60,-30,34
Edinburgh Ci,9721,9,7,9,20,36,61,-25,30
Cowdenbeath,9721,10,4,10,22,23,56,-33,22
Montrose,9722,1,23,8,5,62,37,25,77
Peterhead,9722,2,24,4,8,80,38,42,76
Stenhousem'r,9722,3,16,8,12,57,47,10,56
Stirling,9722,4,16,6,14,61,53,8,54
Clyde,9722,5,15,9,12,52,48,4,54
Elgin,9722,6,14,7,15,56,63,-7,49
Annan Athlet,9722,7,12,11,13,50,43,7,47
Berwick,9722,8,8,10,18,29,59,-30,34
Edinburgh Ci,9722,9,7,9,20,36,63,-27,30
Cowdenbeath,9722,10,4,10,22,25,57,-32,22
Montrose,9723,1,23,8,5,61,36,25,77
Peterhead,9723,2,24,4,8,78,38,40,76
Stirling,9723,3,17,6,13,64,52,12,57
Clyde,9723,4,15,9,12,54,48,6,54
Stenhousem'r,9723,5,15,8,13,56,50,6,53
Elgin,9723,6,14,7,15,55,62,-7,49
Annan Athlet,9723,7,11,11,14,47,42,5,44
Berwick,9723,8,8,10,18,29,61,-32,34
Edinburgh Ci,9723,9,7,9,20,36,61,-25,30
Cowdenbeath,9723,10,5,10,21,24,54,-30,25
Montrose,9724,1,24,7,5,60,34,26,79
Peterhead,9724,2,24,4,8,79,38,41,76
Stirling,9724,3,17,6,13,63,52,11,57
Stenhousem'r,9724,4,15,8,13,56,49,7,53
Clyde,9724,5,14,9,13,51,50,1,51
Elgin,9724,6,14,6,16,53,61,-8,48
Annan Athlet,9724,7,12,11,13,51,42,9,47
Berwick,9724,8,9,10,17,31,58,-27,37
Edinburgh Ci,9724,9,7,9,20,36,62,-26,30
Cowdenbeath,9724,10,4,10,22,24,58,-34,22
Montrose,9725,1,23,7,6,59,36,23,76
Peterhead,9725,2,23,4,9,78,40,38,73
Stirling,9725,3,16,7,13,62,53,9,55
Stenhousem'r,9725,4,15,9,12,57,48,9,54
Clyde,9725,5,14,10,12,51,48,3,52
Elgin,9725,6,15,6,15,55,60,-5,51
Annan Athlet,9725,7,11,12,13,47,41,6,45
Berwick,9725,8,8,11,17,29,58,-29,35
Edinburgh Ci,9725,9,8,9,19,38,61,-23,33
Cowdenbeath,9725,10,4,11,21,23,54,-31,23
Montrose,9726,1,23,8,5,59,34,25,77
Peterhead,9726,2,24,4,8,78,38,40,76
Stirling,9726,3,16,7,13,63,54,9,55
Stenhousem'r,9726,4,15,9,12,58,49,9,54
Clyde,9726,5,15,9,12,55,49,6,54
Elgin,9726,6,14,7,15,53,60,-7,49
Annan Athlet,9726,7,11,12,13,49,43,6,45
Berwick,9726,8,8,10,18,30,62,-32,34
Edinburgh Ci,9726,9,7,9,20,36,61,-25,30
Cowdenbeath,9726,10,4,11,21,25,56,-31,23
Montrose,9727,1,24,7,5,61,35,26,79
Peterhead,9727,2,23,5,8,77,38,39,74
Stirling,9727,3,17,6,13,63,51,12,57
Clyde,9727,4,15,9,12,53,48,5,54
Stenhousem'r,9727,5,15,8,13,55,49,6,53
Elgin,9727,6,14,6,16,54,62,-8,48
Annan Athlet,9727,7,11,11,14,47,42,5,44
Berwick,9727,8,8,10,18,29,60,-31,34
Edinburgh Ci,9727,9,7,10,19,36,60,-24,31
Cowdenbeath,9727,10,5,10,21,24,54,-30,25
Montrose,9728,1,23,8,5,60,35,25,77
Peterhead,9728,2,24,4,8,78,38,40,76
Stenhousem'r,9728,3,16,8,12,56,46,10,56
Stirling,9728,4,16,6,14,60,52,8,54
Clyde,9728,5,15,9,12,52,48,4,54
Elgin,9728,6,14,7,15,54,61,-7,49
Annan Athlet,9728,7,12,11,13,49,41,8,47
Berwick,9728,8,8,10,18,29,59,-30,34
Edinburgh Ci,9728,9,7,9,20,36,61,-25,30
Cowdenbeath,9728,10,4,10,22,23,56,-33,22
Montrose,9729,1,24,7,5,62,36,26,79
Peterhead,9729,2,24,4,8,80,39,41,76
Stirling,9729,3,17,6,13,62,52,10,57
Clyde,9729,4,15,9,12,54,48,6,54
Stenhousem'r,9729,5,15,8,13,56,48,8,53
Elgin,9729,6,14,6,16,55,63,-8,48
Annan Athlet,9729,7,12,11,13,51,43,8,47
Berwick,9729,8,8,10,18,29,61,-32,34
Edinburgh Ci,9729,9,7,9,20,37,63,-26,30
Cowdenbeath,9729,10,4,10,22,25,58,-33,22
Montrose,9730,1,23,8,5,61,36,25,77
Peterhead,9730,2,23,5,8,77,38,39,74
Stenhousem'r,9730,3,16,8,12,58,48,10,56
Stirling,9730,4,16,6,14,62,54,8,54
Clyde,9730,5,14,10,12,52,49,3,52
Elgin,9730,6,14,7,15,55,62,-7,49
Annan Athlet,9730,7,12,11,13,51,41,10,47
Berwick,9730,8,8,11,17,30,59,-29,35
Edinburgh Ci,9730,9,7,10,19,36,60,-24,31
Cowdenbeath,9730,10,4,10,22,23,58,-35,22
Montrose,9731,1,24,7,5,65,35,30,79
Peterhead,9731,2,24,4,8,80,38,42,76
Stenhousem'r,9731,3,16,8,12,56,46,10,56
Stirling,9731,4,16,6,14,60,52,8,54
Clyde,9731,5,14,10,12,52,49,3,52
Elgin,9731,6,14,6,16,54,66,-12,48
Annan Athlet,9731,7,12,11,13,49,41,8,47
Berwick,9731,8,8,11,17,30,59,-29,35
Edinburgh Ci,9731,9,7,9,20,36,63,-27,30
Cowdenbeath,9731,10,4,10,22,23,56,-33,22
Montrose,9732,1,24,7,5,60,34,26,79
Peterhead,9732,2,24,4,8,78,38,40,76
Stirling,9732,3,16,7,13,62,53,9,55
Stenhousem'r,9732,4,15,9,12,57,48,9,54
Clyde,9732,5,15,9,12,52,48,4,54
Elgin,9732,6,14,6,16,53,61,-8,48
Annan Athlet,9732,7,11,11,14,47,42,5,44
Berwick,9732,8,8,10,18,29,59,-30,34
Edinburgh Ci,9732,9,7,9,20,36,61,-25,30
Cowdenbeath,9732,10,5,10,21,24,54,-30,25
Montrose,9733,1,24,7,5,64,36,28,79
Peterhead,9733,2,23,5,8,79,40,39,74
Stirling,9733,3,17,6,13,63,51,12,57
Clyde,9733,4,15,9,12,53,48,5,54
Stenhousem'r,9733,5,15,8,13,55,49,6,53
Elgin,9733,6,14,6,16,55,65,-10,48
Annan Athlet,9733,7,12,11,13,50,43,7,47
Berwick,9733,8,8,10,18,29,60,-31,34
Edinburgh Ci,9733,9,7,10,19,38,62,-24,31
Cowdenbeath,9733,10,4,10,22,25,57,-32,22
Montrose,9734,1,23,8,5,62,37,25,77
Peterhead,9734,2,24,4,8,82,38,44,76
Stenhousem'r,9734,3,16,8,12,56,46,10,56
Stirling,9734,4,16,6,14,60,52,8,54
Clyde,9734,5,15,9,12,53,48,5,54
Elgin,9734,6,14,7,15,56,63,-7,49
Annan Athlet,9734,7,11,12,13,48,42,6,45
Berwick,9734,8,8,10,18,29,60,-31,34
Edinburgh Ci,9734,9,7,9,20,36,65,-29,30
Cowdenbeath,9734,10,4,11,21,24,55,-31,23
Montrose,9735,1,24,7,5,61,35,26,79
Peterhead,9735,2,24,4,8,81,38,43,76
Stenhousem'r,9735,3,16,8,12,57,47,10,56
Stirling,9735,4,16,6,14,61,53,8,54
Clyde,9735,5,15,9,12,52,48,4,54
Elgin,9735,6,14,6,16,54,62,-8,48
Annan Athlet,9735,7,12,11,13,48,41,7,47
Berwick,9735,8,8,10,18,29,59,-30,34
Edinburgh Ci,9735,9,7,9,20,36,64,-28,30
Cowdenbeath,9735,10,4,10,22,23,55,-32,22
Montrose,9736,1,24,7,5,60,34,26,79
Peterhead,9736,2,24,4,8,80,38,42,76
Stirling,9736,3,17,6,13,62,51,11,57
Clyde,9736,4,15,9,12,54,49,5,54
Stenhousem'r,9736,5,15,8,13,55,48,7,53
Elgin,9736,6,14,6,16,53,61,-8,48
Annan Athlet,9736,7,12,11,13,48,41,7,47
Berwick,9736,8,8,10,18,30,61,-31,34
Edinburgh Ci,9736,9,7,9,20,36,63,-27,30
Cowdenbeath,9736,10,4,10,22,23,55,-32,22
Montrose,9737,1,24,7,5,60,34,26,79
Peterhead,9737,2,24,4,8,80,39,41,76
Stirling,9737,3,17,6,13,62,52,10,57
Stenhousem'r,9737,4,15,8,13,56,48,8,53
Clyde,9737,5,14,9,13,51,50,1,51
Elgin,9737,6,14,6,16,53,61,-8,48
Annan Athlet,9737,7,12,11,13,50,42,8,47
Berwick,9737,8,9,10,17,31,58,-27,37
Edinburgh Ci,9737,9,7,9,20,37,63,-26,30
Cowdenbeath,9737,10,4,10,22,24,57,-33,22
Montrose,9738,1,24,7,5,60,34,26,79
Peterhead,9738,2,24,4,8,79,38,41,76
Stirling,9738,3,17,6,13,62,52,10,57
Clyde,9738,4,15,9,12,55,48,7,54
Stenhousem'r,9738,5,15,8,13,56,48,8,53
Elgin,9738,6,14,6,16,53,61,-8,48
Annan Athlet,9738,7,11,11,14,48,43,5,44
Berwick,9738,8,8,10,18,29,62,-33,34
Edinburgh Ci,9738,9,7,9,20,36,62,-26,30
Cowdenbeath,9738,10,5,10,21,25,55,-30,25
Montrose,9739,1,24,7,5,61,35,26,79
Peterhead,9739,2,24,4,8,83,40,43,76
Stenhousem'r,9739,3,16,8,12,58,47,11,56
Stirling,9739,4,16,6,14,61,54,7,54
Clyde,9739,5,15,9,12,52,48,4,54
Elgin,9739,6,14,6,16,54,62,-8,48
Annan Athlet,9739,7,12,11,13,49,42,7,47
Berwick,9739,8,8,10,18,29,59,-30,34
Edinburgh Ci,9739,9,7,9,20,38,66,-28,30
Cowdenbeath,9739,10,4,10,22,24,56,-32,22
Montrose,9740,1,24,7,5,64,35,29,79
Peterhead,9740,2,24,4,8,81,39,42,76
Stirling,9740,3,17,6,13,61,51,10,57
Clyde,9740,4,15,9,12,53,49,4,54
Stenhousem'r,9740,5,15,8,13,55,47,8,53
Elgin,9740,6,14,6,16,54,65,-11,48
Annan Athlet,9740,7,11,12,13,48,42,6,45
Berwick,9740,8,8,10,18,30,60,-30,34
Edinburgh Ci,9740,9,7,9,20,37,64,-27,30
Cowdenbeath,9740,10,4,11,21,24,55,-31,23
Montrose,9741,1,23,8,5,60,35,25,77
Peterhead,9741,2,23,5,8,79,40,39,74
Stirling,9741,3,16,7,13,60,51,9,55
Stenhousem'r,9741,4,15,9,12,55,46,9,54
Clyde,9741,5,15,9,12,52,48,4,54
Elgin,9741,6,14,7,15,54,61,-7,49
Annan Athlet,9741,7,11,11,14,47,42,5,44
Berwick,9741,8,8,10,18,29,59,-30,34
Edinburgh Ci,9741,9,7,10,19,38,62,-24,31
Cowdenbeath,9741,10,5,10,21,24,54,-30,25
Montrose,9742,1,24,7,5,61,34,27,79
Peterhead,9742,2,24,4,8,81,40,41,76
Stirling,9742,3,16,7,13,61,52,9,55
Stenhousem'r,9742,4,15,9,12,56,47,9,54
Clyde,9742,5,14,10,12,51,48,3,52
Elgin,9742,6,14,6,16,53,62,-9,48
Annan Athlet,9742,7,11,11,14,48,44,4,44
Berwick,9742,8,8,11,17,29,58,-29,35
Edinburgh Ci,9742,9,7,9,20,38,64,-26,30
Cowdenbeath,9742,10,5,10,21,26,55,-29,25
Montrose,9743,1,24,7,5,61,35,26,79
Peterhead,9743,2,24,4,8,79,38,41,76
Stenhousem'r,9743,3,16,8,12,56,46,10,56
Stirling,9743,4,16,6,14,60,52,8,54
Clyde,9743,5,15,9,12,56,50,6,54
Elgin,9743,6,14,6,16,54,62,-8,48
Annan Athlet,9743,7,11,11,14,47,42,5,44
Berwick,9743,8,8,10,18,31,63,-32,34
Edinburgh Ci,9743,9,7,9,20,36,62,-26,30
Cowdenbeath,9743,10,5,10,21,24,54,-30,25
Montrose,9744,1,24,7,5,62,34,28,79
Peterhead,9744,2,24,4,8,81,38,43,76
Stirling,9744,3,16,7,13,62,53,9,55
Stenhousem'r,9744,4,15,9,12,57,48,9,54
Clyde,9744,5,14,9,13,52,50,2,51
Elgin,9744,6,14,6,16,53,63,-10,48
Annan Athlet,9744,7,12,11,13,50,43,7,47
Berwick,9744,8,9,10,17,31,59,-28,37
Edinburgh Ci,9744,9,7,9,20,36,64,-28,30
Cowdenbeath,9744,10,4,10,22,25,57,-32,22
Montrose,9745,1,24,7,5,60,34,26,79
Peterhead,9745,2,24,4,8,80,39,41,76
Stenhousem'r,9745,3,16,8,12,59,46,13,56
Stirling,9745,4,16,6,14,60,55,5,54
Clyde,9745,5,14,9,13,52,50,2,51
Elgin,9745,6,14,6,16,53,61,-8,48
Annan Athlet,9745,7,12,11,13,48,41,7,47
Berwick,9745,8,9,10,17,31,59,-28,37
Edinburgh Ci,9745,9,7,9,20,37,63,-26,30
Cowdenbeath,9745,10,4,10,22,23,55,-32,22
Peterhead,9746,1,24,4,8,80,39,41,76
Montrose,9746,2,23,7,6,59,35,24,76
Stirling,9746,3,16,7,13,62,53,9,55
Stenhousem'r,9746,4,15,9,12,57,48,9,54
Clyde,9746,5,15,9,12,54,48,6,54
Elgin,9746,6,15,6,15,54,60,-6,51
Annan Athlet,9746,7,12,11,13,51,41,10,47
Berwick,9746,8,8,10,18,29,61,-32,34
Edinburgh Ci,9746,9,7,9,20,37,63,-26,30
Cowdenbeath,9746,10,4,10,22,23,58,-35,22
Montrose,9747,1,23,8,5,60,35,25,77
Peterhead,9747,2,24,4,8,80,39,41,76
Stenhousem'r,9747,3,16,8,12,56,46,10,56
Stirling,9747,4,16,6,14,60,52,8,54
Clyde,9747,5,15,9,12,54,48,6,54
Elgin,9747,6,14,7,15,54,61,-7,49
Annan Athlet,9747,7,12,11,13,48,41,7,47
Berwick,9747,8,8,10,18,29,61,-32,34
Edinburgh Ci,9747,9,7,9,20,37,63,-26,30
Cowdenbeath,9747,10,4,10,22,23,55,-32,22
Peterhead,9748,1,24,4,8,82,38,44,76
Montrose,9748,2,23,7,6,60,36,24,76
Stirling,9748,3,17,6,13,62,52,10,57
Stenhousem'r,9748,4,15,8,13,56,48,8,53
Clyde,9748,5,14,10,12,53,50,3,52
Elgin,9748,6,15,6,15,55,61,-6,51
Annan Athlet,9748,7,11,12,13,47,41,6,45
Berwick,9748,8,8,11,17,31,60,-29,35
Edinburgh Ci,9748,9,7,9,20,36,65,-29,30
Cowdenbeath,9748,10,4,11,21,23,54,-31,23
Peterhead,9749,1,24,4,8,81,38,43,76
Montrose,9749,2,23,7,6,60,36,24,76
Stirling,9749,3,16,7,13,61,52,9,55
Stenhousem'r,9749,4,15,9,12,56,47,9,54
Clyde,9749,5,15,9,12,53,48,5,54
Elgin,9749,6,15,6,15,55,61,-6,51
Annan Athlet,9749,7,11,12,13,48,42,6,45
Berwick,9749,8,8,10,18,29,60,-31,34
Edinburgh Ci,9749,9,7,9,20,36,64,-28,30
Cowdenbeath,9749,10,4,11,21,24,55,-31,23
Montrose,9750,1,23,7,6,61,37,24,76
Peterhead,9750,2,23,4,9,78,41,37,73
Stirling,9750,3,17,6,13,62,51,11,57
Stenhousem'r,9750,4,15,8,13,55,48,7,53
Clyde,9750,5,14,9,13,51,51,0,51
Elgin,9750,6,15,6,15,56,62,-6,51
Annan Athlet,9750,7,11,12,13,48,42,6,45
Berwick,9750,8,9,10,17,32,58,-26,37
Edinburgh Ci,9750,9,8,9,19,39,61,-22,33
Cowdenbeath,9750,10,4,11,21,24,55,-31,23
Montrose,9751,1,24,7,5,64,37,27,79
Peterhead,9751,2,24,4,8,81,38,43,76
Stirling,9751,3,16,7,13,61,52,9,55
Stenhousem'r,9751,4,15,9,12,56,47,9,54
Clyde,9751,5,15,9,12,53,49,4,54
Elgin,9751,6,14,6,16,56,65,-9,48
Annan Athlet,9751,7,11,11,14,47,42,5,44
Berwick,9751,8,8,10,18,30,60,-30,34
Edinburgh Ci,9751,9,7,9,20,36,64,-28,30
Cowdenbeath,9751,10,5,10,21,24,54,-30,25
Montrose,9752,1,23,8,5,60,35,25,77
Peterhead,9752,2,24,4,8,84,39,45,76
Stirling,9752,3,17,6,13,62,52,10,57
Clyde,9752,4,15,9,12,55,49,6,54
Stenhousem'r,9752,5,15,8,13,56,48,8,53
Elgin,9752,6,14,7,15,54,61,-7,49
Annan Athlet,9752,7,12,11,13,48,41,7,47
Berwick,9752,8,8,10,18,30,62,-32,34
Edinburgh Ci,9752,9,7,9,20,37,67,-30,30
Cowdenbeath,9752,10,4,10,22,23,55,-32,22
Montrose,9753,1,24,7,5,63,35,28,79
Peterhead,9753,2,23,5,8,79,40,39,74
Stirling,9753,3,17,6,13,62,51,11,57
Clyde,9753,4,15,9,12,54,48,6,54
Stenhousem'r,9753,5,15,8,13,55,48,7,53
Elgin,9753,6,14,6,16,54,64,-10,48
Annan Athlet,9753,7,11,11,14,47,42,5,44
Berwick,9753,8,8,10,18,29,61,-32,34
Edinburgh Ci,9753,9,7,10,19,38,62,-24,31
Cowdenbeath,9753,10,5,10,21,24,54,-30,25
Montrose,9754,1,24,7,5,61,34,27,79
Peterhead,9754,2,23,5,8,79,40,39,74
Stenhousem'r,9754,3,16,8,12,56,46,10,56
Stirling,9754,4,16,6,14,60,52,8,54
Clyde,9754,5,15,9,12,53,48,5,54
Elgin,9754,6,14,6,16,53,62,-9,48
Annan Athlet,9754,7,12,11,13,48,41,7,47
Berwick,9754,8,8,10,18,29,60,-31,34
Edinburgh Ci,9754,9,7,10,19,38,62,-24,31
Cowdenbeath,9754,10,4,10,22,23,55,-32,22
Montrose,9755,1,24,7,5,60,34,26,79
Peterhead,9755,2,23,4,9,78,40,38,73
Stenhousem'r,9755,3,16,8,12,57,46,11,56
Stirling,9755,4,16,6,14,60,53,7,54
Clyde,9755,5,15,9,12,55,50,5,54
Elgin,9755,6,14,6,16,53,61,-8,48
Annan Athlet,9755,7,12,11,13,48,41,7,47
Berwick,9755,8,8,10,18,31,62,-31,34
Edinburgh Ci,9755,9,8,9,19,38,61,-23,33
Cowdenbeath,9755,10,4,10,22,23,55,-32,22
Montrose,9756,1,23,8,5,60,35,25,77
Peterhead,9756,2,24,4,8,80,39,41,76
Stenhousem'r,9756,3,16,8,12,57,46,11,56
Stirling,9756,4,16,6,14,60,53,7,54
Clyde,9756,5,15,9,12,54,48,6,54
Elgin,9756,6,14,7,15,54,61,-7,49
Annan Athlet,9756,7,11,11,14,47,42,5,44
Berwick,9756,8,8,10,18,29,61,-32,34
Edinburgh Ci,9756,9,7,9,20,37,63,-26,30
Cowdenbeath,9756,10,5,10,21,24,54,-30,25
Montrose,9757,1,23,8,5,60,35,25,77
Peterhead,9757,2,24,4,8,81,38,43,76
Stirling,9757,3,17,6,13,62,52,10,57
Stenhousem'r,9757,4,15,8,13,56,48,8,53
Clyde,9757,5,14,9,13,52,50,2,51
Elgin,9757,6,14,7,15,54,61,-7,49
Annan Athlet,9757,7,12,11,13,48,41,7,47
Berwick,9757,8,9,10,17,31,59,-28,37
Edinburgh Ci,9757,9,7,9,20,36,64,-28,30
Cowdenbeath,9757,10,4,10,22,23,55,-32,22
Montrose,9758,1,24,7,5,60,34,26,79
Peterhead,9758,2,23,5,8,77,38,39,74
Stirling,9758,3,17,6,13,63,51,12,57
Stenhousem'r,9758,4,15,8,13,55,49,6,53
Clyde,9758,5,14,9,13,51,50,1,51
Elgin,9758,6,14,6,16,53,61,-8,48
Annan Athlet,9758,7,11,11,14,47,42,5,44
Berwick,9758,8,9,10,17,31,58,-27,37
Edinburgh Ci,9758,9,7,10,19,36,60,-24,31
Cowdenbeath,9758,10,5,10,21,24,54,-30,25
Montrose,9759,1,24,7,5,63,36,27,79
Peterhead,9759,2,24,4,8,79,39,40,76
Stenhousem'r,9759,3,16,8,12,57,47,10,56
Stirling,9759,4,16,6,14,61,53,8,54
Clyde,9759,5,14,10,12,51,48,3,52
Elgin,9759,6,14,6,16,55,64,-9,48
Annan Athlet,9759,7,12,11,13,50,41,9,47
Berwick,9759,8,8,11,17,29,58,-29,35
Edinburgh Ci,9759,9,7,9,20,37,62,-25,30
Cowdenbeath,9759,10,4,10,22,23,57,-34,22
Montrose,9760,1,23,8,5,61,36,25,77
Peterhead,9760,2,24,4,8,79,38,41,76
Stenhousem'r,9760,3,16,8,12,57,47,10,56
Stirling,9760,4,16,6,14,61,53,8,54
Clyde,9760,5,14,9,13,51,49,2,51
Elgin,9760,6,14,7,15,55,62,-7,49
Annan Athlet,9760,7,11,12,13,49,43,6,45
Berwick,9760,8,9,10,17,30,58,-28,37
Edinburgh Ci,9760,9,7,9,20,36,62,-26,30
Cowdenbeath,9760,10,4,11,21,25,56,-31,23
Peterhead,9761,1,24,4,8,79,39,40,76
Montrose,9761,2,23,7,6,60,37,23,76
Stirling,9761,3,17,6,13,61,51,10,57
Clyde,9761,4,15,9,12,54,48,6,54
Stenhousem'r,9761,5,15,8,13,55,47,8,53
Elgin,9761,6,15,6,15,56,61,-5,51
Annan Athlet,9761,7,11,12,13,49,43,6,45
Berwick,9761,8,8,10,18,29,61,-32,34
Edinburgh Ci,9761,9,7,9,20,37,62,-25,30
Cowdenbeath,9761,10,4,11,21,25,56,-31,23
Montrose,9762,1,23,8,5,60,35,25,77
Peterhead,9762,2,24,4,8,83,40,43,76
Stirling,9762,3,16,7,13,62,53,9,55
Stenhousem'r,9762,4,15,9,12,57,48,9,54
Clyde,9762,5,15,9,12,55,49,6,54
Elgin,9762,6,14,7,15,54,61,-7,49
Annan Athlet,9762,7,11,12,13,47,41,6,45
Berwick,9762,8,8,10,18,30,62,-32,34
Edinburgh Ci,9762,9,7,9,20,38,66,-28,30
Cowdenbeath,9762,10,4,11,21,23,54,-31,23
Montrose,9763,1,23,7,6,60,37,23,76
Peterhead,9763,2,23,5,8,79,40,39,74
Stirling,9763,3,17,6,13,61,51,10,57
Stenhousem'r,9763,4,15,8,13,55,47,8,53
Clyde,9763,5,14,10,12,51,48,3,52
Elgin,9763,6,15,6,15,56,61,-5,51
Annan Athlet,9763,7,12,11,13,48,41,7,47
Berwick,9763,8,8,11,17,29,58,-29,35
Edinburgh Ci,9763,9,7,10,19,38,62,-24,31
Cowdenbeath,9763,10,4,10,22,23,55,-32,22
Montrose,9764,1,24,7,5,65,38,27,79
Peterhead,9764,2,24,4,8,80,38,42,76
Stirling,9764,3,17,6,13,62,51,11,57
Clyde,9764,4,15,9,12,54,50,4,54
Stenhousem'r,9764,5,15,8,13,55,48,7,53
Elgin,9764,6,14,6,16,57,66,-9,48
Annan Athlet,9764,7,11,11,14,47,42,5,44
Berwick,9764,8,8,10,18,31,61,-30,34
Edinburgh Ci,9764,9,7,9,20,36,63,-27,30
Cowdenbeath,9764,10,5,10,21,24,54,-30,25
Peterhead,9765,1,24,4,8,79,39,40,76
Montrose,9765,2,23,7,6,59,35,24,76
Stirling,9765,3,17,6,13,62,51,11,57
Stenhousem'r,9765,4,15,8,13,55,48,7,53
Clyde,9765,5,14,10,12,53,50,3,52
Elgin,9765,6,15,6,15,54,60,-6,51
Annan Athlet,9765,7,11,11,14,48,43,5,44
Berwick,9765,8,8,11,17,31,60,-29,35
Edinburgh Ci,9765,9,7,9,20,37,62,-25,30
Cowdenbeath,9765,10,5,10,21,25,55,-30,25
Montrose,9766,1,23,8,5,63,38,25,77
Peterhead,9766,2,24,4,8,81,39,42,76
Stenhousem'r,9766,3,16,8,12,57,46,11,56
Stirling,9766,4,16,6,14,60,53,7,54
Clyde,9766,5,14,10,12,52,49,3,52
Elgin,9766,6,14,7,15,57,64,-7,49
Annan Athlet,9766,7,11,12,13,49,43,6,45
Berwick,9766,8,8,11,17,30,59,-29,35
Edinburgh Ci,9766,9,7,9,20,37,64,-27,30
Cowdenbeath,9766,10,4,11,21,25,56,-31,23
Montrose,9767,1,24,7,5,62,36,26,79
Peterhead,9767,2,23,4,9,79,41,38,73
Stirling,9767,3,17,6,13,61,51,10,57
Stenhousem'r,9767,4,15,8,13,55,47,8,53
Clyde,9767,5,14,10,12,51,48,3,52
Elgin,9767,6,14,6,16,55,63,-8,48
Annan Athlet,9767,7,11,12,13,48,42,6,45
Berwick,9767,8,8,11,17,29,58,-29,35
Edinburgh Ci,9767,9,8,9,19,39,62,-23,33
Cowdenbeath,9767,10,4,11,21,24,55,-31,23
Montrose,9768,1,24,7,5,60,34,26,79
Peterhead,9768,2,23,5,8,79,40,39,74
Stirling,9768,3,17,6,13,61,51,10,57
Clyde,9768,4,15,9,12,53,49,4,54
Stenhousem'r,9768,5,15,8,13,55,47,8,53
Elgin,9768,6,14,6,16,53,61,-8,48
Annan Athlet,9768,7,11,11,14,47,42,5,44
Berwick,9768,8,8,10,18,30,60,-30,34
Edinburgh Ci,9768,9,7,10,19,38,62,-24,31
Cowdenbeath,9768,10,5,10,21,24,54,-30,25
Peterhead,9769,1,24,4,8,78,38,40,76
Montrose,9769,2,23,7,6,59,35,24,76
Stirling,9769,3,16,7,13,61,52,9,55
Stenhousem'r,9769,4,15,9,12,56,47,9,54
Clyde,9769,5,14,10,12,52,49,3,52
Elgin,9769,6,15,6,15,54,60,-6,51
Annan Athlet,9769,7,11,11,14,47,42,5,44
Berwick,9769,8,8,11,17,30,59,-29,35
Edinburgh Ci,9769,9,7,9,20,36,61,-25,30
Cowdenbeath,9769,10,5,10,21,24,54,-30,25
Montrose,9770,1,24,7,5,61,34,27,79
Peterhead,9770,2,24,4,8,79,39,40,76
Stirling,9770,3,17,6,13,61,51,10,57
Clyde,9770,4,15,9,12,53,48,5,54
Stenhousem'r,9770,5,15,8,13,55,47,8,53
Elgin,9770,6,14,6,16,53,62,-9,48
Annan Athlet,9770,7,12,11,13,50,42,8,47
Berwick,9770,8,8,10,18,29,60,-31,34
Edinburgh Ci,9770,9,7,9,20,37,62,-25,30
Cowdenbeath,9770,10,4,10,22,24,57,-33,22
Montrose,9771,1,24,7,5,61,35,26,79
Peterhead,9771,2,23,5,8,78,39,39,74
Stirling,9771,3,17,6,13,63,52,11,57
Clyde,9771,4,15,9,12,56,49,7,54
Stenhousem'r,9771,5,15,8,13,56,49,7,53
Elgin,9771,6,14,6,16,54,62,-8,48
Annan Athlet,9771,7,11,12,13,48,42,6,45
Berwick,9771,8,8,10,18,30,63,-33,34
Edinburgh Ci,9771,9,7,10,19,37,61,-24,31
Cowdenbeath,9771,10,4,11,21,24,55,-31,23
Montrose,9772,1,24,7,5,61,35,26,79
Peterhead,9772,2,23,4,9,77,39,38,73
Stirling,9772,3,17,6,13,61,51,10,57
Clyde,9772,4,15,9,12,52,48,4,54
Stenhousem'r,9772,5,15,8,13,55,47,8,53
Elgin,9772,6,14,6,16,54,62,-8,48
Annan Athlet,9772,7,12,11,13,49,41,8,47
Berwick,9772,8,8,10,18,29,59,-30,34
Edinburgh Ci,9772,9,8,9,19,37,60,-23,33
Cowdenbeath,9772,10,4,10,22,23,56,-33,22
Peterhead,9773,1,24,4,8,80,40,40,76
Montrose,9773,2,23,7,6,59,35,24,76
Stirling,9773,3,16,7,13,62,53,9,55
Stenhousem'r,9773,4,15,9,12,57,48,9,54
Clyde,9773,5,14,10,12,52,49,3,52
Elgin,9773,6,15,6,15,54,60,-6,51
Annan Athlet,9773,7,11,12,13,47,41,6,45
Berwick,9773,8,8,11,17,30,59,-29,35
Edinburgh Ci,9773,9,7,9,20,38,63,-25,30
Cowdenbeath,9773,10,4,11,21,23,54,-31,23
Montrose,9774,1,23,7,6,61,37,24,76
Peterhead,9774,2,23,4,9,78,40,38,73
Stenhousem'r,9774,3,16,8,12,56,46,10,56
Stirling,9774,4,16,6,14,60,52,8,54
Clyde,9774,5,15,9,12,53,48,5,54
Elgin,9774,6,15,6,15,56,62,-6,51
Annan Athlet,9774,7,12,11,13,51,41,10,47
Berwick,9774,8,8,10,18,29,60,-31,34
Edinburgh Ci,9774,9,8,9,19,38,61,-23,33
Cowdenbeath,9774,10,4,10,22,23,58,-35,22
Montrose,9775,1,24,7,5,61,35,26,79
Peterhead,9775,2,24,4,8,81,38,43,76
Stenhousem'r,9775,3,16,8,12,58,47,11,56
Stirling,9775,4,16,6,14,61,54,7,54
Clyde,9775,5,15,9,12,55,50,5,54
Elgin,9775,6,14,6,16,54,62,-8,48
Annan Athlet,9775,7,12,11,13,49,41,8,47
Berwick,9775,8,8,10,18,31,62,-31,34
Edinburgh Ci,9775,9,7,9,20,36,64,-28,30
Cowdenbeath,9775,10,4,10,22,23,56,-33,22
Montrose,9776,1,23,8,5,61,36,25,77
Peterhead,9776,2,23,5,8,77,38,39,74
Stirling,9776,3,17,6,13,62,52,10,57
Clyde,9776,4,15,9,12,53,49,4,54
Stenhousem'r,9776,5,15,8,13,56,48,8,53
Elgin,9776,6,14,7,15,55,62,-7,49
Annan Athlet,9776,7,12,11,13,49,42,7,47
Berwick,9776,8,8,10,18,30,60,-30,34
Edinburgh Ci,9776,9,7,10,19,36,60,-24,31
Cowdenbeath,9776,10,4,10,22,24,56,-32,22
Peterhead,9777,1,24,4,8,81,39,42,76
Montrose,9777,2,23,7,6,59,35,24,76
Stirling,9777,3,17,6,13,64,52,12,57
Clyde,9777,4,15,9,12,54,49,5,54
Stenhousem'r,9777,5,15,8,13,56,50,6,53
Elgin,9777,6,15,6,15,54,60,-6,51
Annan Athlet,9777,7,12,11,13,48,41,7,47
Berwick,9777,8,8,10,18,30,61,-31,34
Edinburgh Ci,9777,9,7,9,20,37,64,-27,30
Cowdenbeath,9777,10,4,10,22,23,55,-32,22
Peterhead,9778,1,24,4,8,79,38,41,76
Montrose,9778,2,23,7,6,61,37,24,76
Stirling,9778,3,17,6,13,62,51,11,57
Stenhousem'r,9778,4,15,8,13,55,48,7,53
Clyde,9778,5,14,10,12,52,49,3,52
Elgin,9778,6,15,6,15,56,62,-6,51
Annan Athlet,9778,7,12,11,13,49,41,8,47
Berwick,9778,8,8,11,17,30,59,-29,35
Edinburgh Ci,9778,9,7,9,20,36,62,-26,30
Cowdenbeath,9778,10,4,10,22,23,56,-33,22
Montrose,9779,1,24,7,5,62,35,27,79
Peterhead,9779,2,24,4,8,78,38,40,76
Stirling,9779,3,17,6,13,63,51,12,57
Clyde,9779,4,15,9,12,53,48,5,54
Stenhousem'r,9779,5,15,8,13,55,49,6,53
Elgin,9779,6,14,6,16,54,63,-9,48
Annan Athlet,9779,7,12,11,13,50,43,7,47
Berwick,9779,8,8,10,18,29,60,-31,34
Edinburgh Ci,9779,9,7,9,20,36,61,-25,30
Cowdenbeath,9779,10,4,10,22,25,57,-32,22
Montrose,9780,1,24,7,5,64,36,28,79
Peterhead,9780,2,24,4,8,80,39,41,76
Stirling,9780,3,16,7,13,61,52,9,55
Stenhousem'r,9780,4,15,9,12,56,47,9,54
Clyde,9780,5,15,9,12,53,48,5,54
Elgin,9780,6,14,6,16,55,65,-10,48
Annan Athlet,9780,7,11,12,13,48,42,6,45
Berwick,9780,8,8,10,18,29,60,-31,34
Edinburgh Ci,9780,9,7,9,20,37,63,-26,30
Cowdenbeath,9780,10,4,11,21,24,55,-31,23
Montrose,9781,1,24,7,5,63,35,28,79
Peterhead,9781,2,24,4,8,80,39,41,76
Stirling,9781,3,16,7,13,61,52,9,55
Stenhousem'r,9781,4,15,9,12,56,47,9,54
Clyde,9781,5,14,10,12,52,49,3,52
Elgin,9781,6,14,6,16,54,64,-10,48
Annan Athlet,9781,7,11,12,13,48,42,6,45
Berwick,9781,8,8,11,17,30,59,-29,35
Edinburgh Ci,9781,9,7,9,20,37,63,-26,30
Cowdenbeath,9781,10,4,11,21,24,55,-31,23
Montrose,9782,1,23,8,5,59,34,25,77
Peterhead,9782,2,24,4,8,80,38,42,76
Stirling,9782,3,16,7,13,61,52,9,55
Stenhousem'r,9782,4,15,9,12,56,47,9,54
Clyde,9782,5,15,9,12,52,48,4,54
Elgin,9782,6,14,7,15,53,60,-7,49
Annan Athlet,9782,7,11,12,13,48,42,6,45
Berwick,9782,8,8,10,18,29,59,-30,34
Edinburgh Ci,9782,9,7,9,20,36,63,-27,30
Cowdenbeath,9782,10,4,11,21,24,55,-31,23
Montrose,9783,1,24,7,5,60,34,26,79
Peterhead,9783,2,24,4,8,81,39,42,76
Stirling,9783,3,17,6,13,62,52,10,57
Stenhousem'r,9783,4,15,8,13,56,48,8,53
Clyde,9783,5,14,10,12,52,49,3,52
Elgin,9783,6,14,6,16,53,61,-8,48
Annan Athlet,9783,7,11,11,14,49,44,5,44
Berwick,9783,8,8,11,17,30,59,-29,35
Edinburgh Ci,9783,9,7,9,20,37,64,-27,30
Cowdenbeath,9783,10,5,10,21,26,56,-30,25
Montrose,9784,1,24,7,5,62,34,28,79
Peterhead,9784,2,24,4,8,80,38,42,76
Stenhousem'r,9784,3,16,8,12,59,48,11,56
Stirling,9784,4,16,6,14,62,55,7,54
Clyde,9784,5,14,10,12,52,49,3,52
Elgin,9784,6,14,6,16,53,63,-10,48
Annan Athlet,9784,7,12,11,13,49,41,8,47
Berwick,9784,8,8,11,17,30,59,-29,35
Edinburgh Ci,9784,9,7,9,20,36,63,-27,30
Cowdenbeath,9784,10,4,10,22,23,56,-33,22
Montrose,9785,1,23,8,5,60,35,25,77
Peterhead,9785,2,24,4,8,80,38,42,76
Stirling,9785,3,17,6,13,62,52,10,57
Clyde,9785,4,15,9,12,52,48,4,54
Stenhousem'r,9785,5,15,8,13,56,48,8,53
Elgin,9785,6,14,7,15,54,61,-7,49
Annan Athlet,9785,7,11,11,14,48,44,4,44
Berwick,9785,8,8,10,18,29,59,-30,34
Edinburgh Ci,9785,9,7,9,20,36,63,-27,30
Cowdenbeath,9785,10,5,10,21,26,55,-29,25
Montrose,9786,1,23,8,5,60,35,25,77
Peterhead,9786,2,24,4,8,78,38,40,76
Stirling,9786,3,17,6,13,61,51,10,57
Stenhousem'r,9786,4,15,8,13,55,47,8,53
Clyde,9786,5,14,9,13,51,49,2,51
Elgin,9786,6,14,7,15,54,61,-7,49
Annan Athlet,9786,7,11,11,14,48,43,5,44
Berwick,9786,8,9,10,17,30,58,-28,37
Edinburgh Ci,9786,9,7,9,20,36,61,-25,30
Cowdenbeath,9786,10,5,10,21,25,55,-30,25
Montrose,9787,1,24,7,5,60,34,26,79
Peterhead,9787,2,24,4,8,78,38,40,76
Stenhousem'r,9787,3,16,8,12,58,47,11,56
Stirling,9787,4,16,6,14,61,54,7,54
Clyde,9787,5,14,10,12,53,50,3,52
Elgin,9787,6,14,6,16,53,61,-8,48
Annan Athlet,9787,7,11,11,14,47,42,5,44
Berwick,9787,8,8,11,17,31,60,-29,35
Edinburgh Ci,9787,9,7,9,20,36,61,-25,30
Cowdenbeath,9787,10,5,10,21,24,54,-30,25
Montrose,9788,1,23,8,5,61,36,25,77
Peterhead,9788,2,23,5,8,78,39,39,74
Stenhousem'r,9788,3,16,8,12,56,46,10,56
Stirling,9788,4,16,6,14,60,52,8,54
Clyde,9788,5,15,9,12,53,49,4,54
Elgin,9788,6,14,7,15,55,62,-7,49
Annan Athlet,9788,7,11,11,14,47,42,5,44
Berwick,9788,8,8,10,18,30,60,-30,34
Edinburgh Ci,9788,9,7,10,19,37,61,-24,31
Cowdenbeath,9788,10,5,10,21,24,54,-30,25
Peterhead,9789,1,24,4,8,79,38,41,76
Montrose,9789,2,23,7,6,60,36,24,76
Stirling,9789,3,17,6,13,62,52,10,57
Clyde,9789,4,15,9,12,54,49,5,54
Stenhousem'r,9789,5,15,8,13,56,48,8,53
Elgin,9789,6,15,6,15,55,61,-6,51
Annan Athlet,9789,7,11,11,14,47,42,5,44
Berwick,9789,8,8,10,18,30,61,-31,34
Edinburgh Ci,9789,9,7,9,20,36,62,-26,30
Cowdenbeath,9789,10,5,10,21,24,54,-30,25
Montrose,9790,1,24,7,5,63,34,29,79
Peterhead,9790,2,24,4,8,79,38,41,76
Stirling,9790,3,17,6,13,63,52,11,57
Stenhousem'r,9790,4,15,8,13,56,49,7,53
Clyde,9790,5,14,10,12,51,48,3,52
Elgin,9790,6,14,6,16,53,64,-11,48
Annan Athlet,9790,7,12,11,13,48,41,7,47
Berwick,9790,8,8,11,17,29,58,-29,35
Edinburgh Ci,9790,9,7,9,20,36,62,-26,30
Cowdenbeath,9790,10,4,10,22,23,55,-32,22
Montrose,9791,1,23,8,5,59,34,25,77
Peterhead,9791,2,24,4,8,82,38,44,76
Stirling,9791,3,17,6,13,63,52,11,57
Stenhousem'r,9791,4,15,8,13,56,49,7,53
Clyde,9791,5,14,10,12,51,48,3,52
Elgin,9791,6,14,7,15,53,60,-7,49
Annan Athlet,9791,7,12,11,13,49,41,8,47
Berwick,9791,8,8,11,17,29,58,-29,35
Edinburgh Ci,9791,9,7,9,20,36,65,-29,30
Cowdenbeath,9791,10,4,10,22,23,56,-33,22
Montrose,9792,1,23,7,6,60,36,24,76
Peterhead,9792,2,23,4,9,77,39,38,73
Stenhousem'r,9792,3,16,8,12,57,47,10,56
Stirling,9792,4,16,6,14,61,53,8,54
Clyde,9792,5,14,9,13,51,49,2,51
Elgin,9792,6,15,6,15,55,61,-6,51
Annan Athlet,9792,7,11,11,14,47,43,4,44
Berwick,9792,8,9,10,17,30,58,-28,37
Edinburgh Ci,9792,9,8,9,19,37,60,-23,33
Cowdenbeath,9792,10,5,10,21,25,54,-29,25
Montrose,9793,1,24,7,5,63,35,28,79
Peterhead,9793,2,24,4,8,79,39,40,76
Stenhousem'r,9793,3,16,8,12,57,46,11,56
Stirling,9793,4,16,6,14,60,53,7,54
Clyde,9793,5,14,10,12,52,49,3,52
Elgin,9793,6,14,6,16,54,64,-10,48
Annan Athlet,9793,7,11,12,13,48,42,6,45
Berwick,9793,8,8,11,17,30,59,-29,35
Edinburgh Ci,9793,9,7,9,20,37,62,-25,30
Cowdenbeath,9793,10,4,11,21,24,55,-31,23
Montrose,9794,1,24,7,5,62,35,27,79
Peterhead,9794,2,23,4,9,79,41,38,73
Stirling,9794,3,17,6,13,64,53,11,57
Clyde,9794,4,15,9,12,53,48,5,54
Stenhousem'r,9794,5,15,8,13,57,50,7,53
Elgin,9794,6,14,6,16,54,63,-9,48
Annan Athlet,9794,7,11,11,14,47,42,5,44
Berwick,9794,8,8,10,18,29,60,-31,34
Edinburgh Ci,9794,9,8,9,19,39,62,-23,33
Cowdenbeath,9794,10,5,10,21,24,54,-30,25
Peterhead,9795,1,24,4,8,81,38,43,76
Montrose,9795,2,23,7,6,60,36,24,76
Stenhousem'r,9795,3,16,8,12,57,46,11,56
Stirling,9795,4,16,6,14,60,53,7,54
Clyde,9795,5,15,9,12,52,48,4,54
Elgin,9795,6,15,6,15,55,61,-6,51
Annan Athlet,9795,7,11,12,13,47,41,6,45
Berwick,9795,8,8,10,18,29,59,-30,34
Edinburgh Ci,9795,9,7,9,20,36,64,-28,30
Cowdenbeath,9795,10,4,11,21,23,54,-31,23
Montrose,9796,1,23,8,5,59,34,25,77
Peterhead,9796,2,24,4,8,80,39,41,76
Stenhousem'r,9796,3,16,8,12,58,47,11,56
Stirling,9796,4,16,6,14,61,54,7,54
Clyde,9796,5,14,9,13,52,51,1,51
Elgin,9796,6,14,7,15,53,60,-7,49
Annan Athlet,9796,7,11,12,13,48,42,6,45
Berwick,9796,8,9,10,17,32,59,-27,37
Edinburgh Ci,9796,9,7,9,20,37,63,-26,30
Cowdenbeath,9796,10,4,11,21,24,55,-31,23
Peterhead,9797,1,24,4,8,81,39,42,76
Montrose,9797,2,23,7,6,61,37,24,76
Stirling,9797,3,16,7,13,62,53,9,55
Stenhousem'r,9797,4,15,9,12,57,48,9,54
Clyde,9797,5,15,9,12,55,49,6,54
Elgin,9797,6,15,6,15,56,62,-6,51
Annan Athlet,9797,7,11,11,14,47,42,5,44
Berwick,9797,8,8,10,18,30,62,-32,34
Edinburgh Ci,9797,9,7,9,20,37,64,-27,30
Cowdenbeath,9797,10,5,10,21,24,54,-30,25
Montrose,9798,1,24,7,5,62,34,28,79
Peterhead,9798,2,23,5,8,77,38,39,74
Stirling,9798,3,16,7,13,62,53,9,55
Stenhousem'r,9798,4,15,9,12,57,48,9,54
Clyde,9798,5,14,10,12,51,48,3,52
Elgin,9798,6,14,6,16,53,63,-10,48
Annan Athlet,9798,7,12,11,13,49,42,7,47
Berwick,9798,8,8,11,17,29,58,-29,35
Edinburgh Ci,9798,9,7,10,19,36,60,-24,31
Cowdenbeath,9798,10,4,10,22,24,56,-32,22
Montrose,9799,1,24,7,5,61,35,26,79
Peterhead,9799,2,24,4,8,79,39,40,76
Stirling,9799,3,16,7,13,63,54,9,55
Stenhousem'r,9799,4,15,9,12,58,49,9,54
Clyde,9799,5,14,9,13,51,53,-2,51
Elgin,9799,6,14,6,16,54,62,-8,48
Annan Athlet,9799,7,11,12,13,47,41,6,45
Berwick,9799,8,9,10,17,34,58,-24,37
Edinburgh Ci,9799,9,7,9,20,37,62,-25,30
Cowdenbeath,9799,10,4,11,21,23,54,-31,23
Montrose,9800,1,24,7,5,61,34,27,79
Peterhead,9800,2,24,4,8,79,38,41,76
Stirling,9800,3,17,6,13,62,51,11,57
Stenhousem'r,9800,4,15,8,13,55,48,7,53
Clyde,9800,5,14,9,13,51,49,2,51
Elgin,9800,6,14,6,16,53,62,-9,48
Annan Athlet,9800,7,11,11,14,48,43,5,44
Berwick,9800,8,9,10,17,30,58,-28,37
Edinburgh Ci,9800,9,7,9,20,36,62,-26,30
Cowdenbeath,9800,10,5,10,21,25,55,-30,25
Montrose,9801,1,23,8,5,60,35,25,77
Peterhead,9801,2,24,4,8,83,40,43,76
Stirling,9801,3,17,6,13,63,51,12,57
Clyde,9801,4,15,9,12,52,48,4,54
Stenhousem'r,9801,5,15,8,13,55,49,6,53
Elgin,9801,6,14,7,15,54,61,-7,49
Annan Athlet,9801,7,12,11,13,52,42,10,47
Berwick,9801,8,8,10,18,29,59,-30,34
Edinburgh Ci,9801,9,7,9,20,38,66,-28,30
Cowdenbeath,9801,10,4,10,22,24,59,-35,22
Montrose,9802,1,24,7,5,63,35,28,79
Peterhead,9802,2,24,4,8,80,38,42,76
Stirling,9802,3,17,6,13,62,52,10,57
Stenhousem'r,9802,4,15,8,13,56,48,8,53
Clyde,9802,5,14,10,12,52,49,3,52
Elgin,9802,6,14,6,16,54,64,-10,48
Annan Athlet,9802,7,12,11,13,48,41,7,47
Berwick,9802,8,8,11,17,30,59,-29,35
Edinburgh Ci,9802,9,7,9,20,36,63,-27,30
Cowdenbeath,9802,10,4,10,22,23,55,-32,22
Montrose,9803,1,24,7,5,63,34,29,79
Peterhead,9803,2,23,4,9,78,40,38,73
Stirling,9803,3,17,6,13,61,51,10,57
Clyde,9803,4,15,9,12,54,50,4,54
Stenhousem'r,9803,5,15,8,13,55,47,8,53
Elgin,9803,6,14,6,16,53,64,-11,48
Annan Athlet,9803,7,12,11,13,48,41,7,47
Berwick,9803,8,8,10,18,31,61,-30,34
Edinburgh Ci,9803,9,8,9,19,38,61,-23,33
Cowdenbeath,9803,10,4,10,22,23,55,-32,22
Montrose,9804,1,23,8,5,59,34,25,77
Peterhead,9804,2,23,5,8,79,40,39,74
Stirling,9804,3,16,7,13,60,51,9,55
Stenhousem'r,9804,4,15,9,12,55,46,9,54
Clyde,9804,5,14,10,12,52,49,3,52
Elgin,9804,6,14,7,15,53,60,-7,49
Annan Athlet,9804,7,12,11,13,49,42,7,47
Berwick,9804,8,8,11,17,30,59,-29,35
Edinburgh Ci,9804,9,7,10,19,38,62,-24,31
Cowdenbeath,9804,10,4,10,22,24,56,-32,22
Montrose,9805,1,23,8,5,59,34,25,77
Peterhead,9805,2,23,5,8,78,39,39,74
Stirling,9805,3,17,6,13,62,52,10,57
Stenhousem'r,9805,4,15,8,13,56,48,8,53
Clyde,9805,5,14,9,13,53,51,2,51
Elgin,9805,6,14,7,15,53,60,-7,49
Annan Athlet,9805,7,12,11,13,48,41,7,47
Berwick,9805,8,9,10,17,32,60,-28,37
Edinburgh Ci,9805,9,7,10,19,37,61,-24,31
Cowdenbeath,9805,10,4,10,22,23,55,-32,22
Montrose,9806,1,24,7,5,61,34,27,79
Peterhead,9806,2,24,4,8,79,38,41,76
Stirling,9806,3,17,6,13,62,52,10,57
Stenhousem'r,9806,4,15,8,13,56,48,8,53
Clyde,9806,5,14,10,12,52,49,3,52
Elgin,9806,6,14,6,16,53,62,-9,48
Annan Athlet,9806,7,11,11,14,47,43,4,44
Berwick,9806,8,8,11,17,30,59,-29,35
Edinburgh Ci,9806,9,7,9,20,36,62,-26,30
Cowdenbeath,9806,10,5,10,21,25,54,-29,25
Montrose,9807,1,23,8,5,60,35,25,77
Peterhead,9807,2,24,4,8,81,39,42,76
Stenhousem'r,9807,3,16,8,12,58,47,11,56
Stirling,9807,4,16,6,14,61,54,7,54
Clyde,9807,5,15,9,12,53,49,4,54
Elgin,9807,6,14,7,15,54,61,-7,49
Annan Athlet,9807,7,11,12,13,49,43,6,45
Berwick,9807,8,8,10,18,30,60,-30,34
Edinburgh Ci,9807,9,7,9,20,37,64,-27,30
Cowdenbeath,9807,10,4,11,21,25,56,-31,23
Montrose,9808,1,23,8,5,61,36,25,77
Peterhead,9808,2,24,4,8,79,39,40,76
Stirling,9808,3,16,7,13,62,53,9,55
Stenhousem'r,9808,4,15,9,12,57,48,9,54
Clyde,9808,5,15,9,12,53,48,5,54
Elgin,9808,6,14,7,15,55,62,-7,49
Annan Athlet,9808,7,12,11,13,51,41,10,47
Berwick,9808,8,8,10,18,29,60,-31,34
Edinburgh Ci,9808,9,7,9,20,37,62,-25,30
Cowdenbeath,9808,10,4,10,22,23,58,-35,22
Montrose,9809,1,23,7,6,60,37,23,76
Peterhead,9809,2,23,4,9,77,40,37,73
Stirling,9809,3,16,7,13,62,53,9,55
Stenhousem'r,9809,4,15,9,12,57,48,9,54
Clyde,9809,5,14,9,13,51,49,2,51
Elgin,9809,6,15,6,15,56,61,-5,51
Annan Athlet,9809,7,12,11,13,49,42,7,47
Berwick,9809,8,9,10,17,30,58,-28,37
Edinburgh Ci,9809,9,8,9,19,38,60,-22,33
Cowdenbeath,9809,10,4,10,22,24,56,-32,22
Montrose,9810,1,23,8,5,59,34,25,77
Peterhead,9810,2,24,4,8,79,38,41,76
Stirling,9810,3,16,7,13,60,51,9,55
Stenhousem'r,9810,4,15,9,12,55,46,9,54
Clyde,9810,5,14,10,12,52,49,3,52
Elgin,9810,6,14,7,15,53,60,-7,49
Annan Athlet,9810,7,11,11,14,47,44,3,44
Berwick,9810,8,8,11,17,30,59,-29,35
Edinburgh Ci,9810,9,7,9,20,36,62,-26,30
Cowdenbeath,9810,10,5,10,21,26,54,-28,25
Montrose,9811,1,24,7,5,61,35,26,79
Peterhead,9811,2,24,4,8,79,39,40,76
Stirling,9811,3,17,6,13,62,52,10,57
Clyde,9811,4,15,9,12,53,49,4,54
Stenhousem'r,9811,5,15,8,13,56,48,8,53
Elgin,9811,6,14,6,16,54,62,-8,48
Annan Athlet,9811,7,11,11,14,48,43,5,44
Berwick,9811,8,8,10,18,30,60,-30,34
Edinburgh Ci,9811,9,7,9,20,37,62,-25,30
Cowdenbeath,9811,10,5,10,21,25,55,-30,25
Montrose,9812,1,24,7,5,64,34,30,79
Peterhead,9812,2,23,5,8,77,38,39,74
Stirling,9812,3,17,6,13,62,52,10,57
Stenhousem'r,9812,4,15,8,13,56,48,8,53
Clyde,9812,5,14,10,12,51,48,3,52
Elgin,9812,6,14,6,16,53,65,-12,48
Annan Athlet,9812,7,12,11,13,51,41,10,47
Berwick,9812,8,8,11,17,29,58,-29,35
Edinburgh Ci,9812,9,7,10,19,36,60,-24,31
Cowdenbeath,9812,10,4,10,22,23,58,-35,22
Peterhead,9813,1,24,4,8,81,39,42,76
Montrose,9813,2,23,7,6,59,37,22,76
Stirling,9813,3,17,6,13,63,51,12,57
Clyde,9813,4,15,9,12,54,49,5,54
Stenhousem'r,9813,5,15,8,13,55,49,6,53
Elgin,9813,6,15,6,15,56,60,-4,51
Annan Athlet,9813,7,12,11,13,49,42,7,47
Berwick,9813,8,8,10,18,30,61,-31,34
Edinburgh Ci,9813,9,7,9,20,37,64,-27,30
Cowdenbeath,9813,10,4,10,22,24,56,-32,22
Montrose,9814,1,24,7,5,61,35,26,79
Peterhead,9814,2,24,4,8,80,39,41,76
Stenhousem'r,9814,3,16,8,12,58,48,10,56
Stirling,9814,4,16,6,14,62,54,8,54
Clyde,9814,5,15,9,12,55,49,6,54
Elgin,9814,6,14,6,16,54,62,-8,48
Annan Athlet,9814,7,12,11,13,50,41,9,47
Berwick,9814,8,8,10,18,30,62,-32,34
Edinburgh Ci,9814,9,7,9,20,37,63,-26,30
Cowdenbeath,9814,10,4,10,22,23,57,-34,22
Peterhead,9815,1,24,4,8,80,39,41,76
Montrose,9815,2,23,7,6,59,35,24,76
Stirling,9815,3,16,7,13,63,54,9,55
Stenhousem'r,9815,4,15,9,12,58,49,9,54
Clyde,9815,5,14,9,13,51,49,2,51
Elgin,9815,6,15,6,15,54,60,-6,51
Annan Athlet,9815,7,12,11,13,50,42,8,47
Berwick,9815,8,9,10,17,30,58,-28,37
Edinburgh Ci,9815,9,7,9,20,37,63,-26,30
Cowdenbeath,9815,10,4,10,22,24,57,-33,22
Montrose,9816,1,24,7,5,65,34,31,79
Peterhead,9816,2,23,4,9,78,40,38,73
Stirling,9816,3,17,6,13,64,52,12,57
Clyde,9816,4,15,9,12,52,48,4,54
Stenhousem'r,9816,5,15,8,13,56,50,6,53
Elgin,9816,6,14,6,16,53,66,-13,48
Annan Athlet,9816,7,11,11,14,48,43,5,44
Berwick,9816,8,8,10,18,29,59,-30,34
Edinburgh Ci,9816,9,8,9,19,38,61,-23,33
Cowdenbeath,9816,10,5,10,21,25,55,-30,25
Montrose,9817,1,24,7,5,62,36,26,79
Peterhead,9817,2,23,4,9,78,41,37,73
Stirling,9817,3,17,6,13,62,51,11,57
Stenhousem'r,9817,4,15,8,13,55,48,7,53
Clyde,9817,5,14,9,13,52,50,2,51
Elgin,9817,6,14,6,16,55,63,-8,48
Annan Athlet,9817,7,11,12,13,47,41,6,45
Berwick,9817,8,9,10,17,31,59,-28,37
Edinburgh Ci,9817,9,8,9,19,39,61,-22,33
Cowdenbeath,9817,10,4,11,21,23,54,-31,23
Montrose,9818,1,23,7,6,59,35,24,76
Peterhead,9818,2,23,4,9,77,39,38,73
Stirling,9818,3,17,6,13,64,52,12,57
Stenhousem'r,9818,4,15,8,13,56,50,6,53
Clyde,9818,5,14,10,12,52,49,3,52
Elgin,9818,6,15,6,15,54,60,-6,51
Annan Athlet,9818,7,12,11,13,48,41,7,47
Berwick,9818,8,8,11,17,30,59,-29,35
Edinburgh Ci,9818,9,8,9,19,37,60,-23,33
Cowdenbeath,9818,10,4,10,22,23,55,-32,22
Montrose,9819,1,24,7,5,60,34,26,79
Peterhead,9819,2,23,5,8,78,39,39,74
Stirling,9819,3,17,6,13,63,51,12,57
Stenhousem'r,9819,4,15,8,13,55,49,6,53
Clyde,9819,5,14,9,13,52,50,2,51
Elgin,9819,6,14,6,16,53,61,-8,48
Annan Athlet,9819,7,11,12,13,48,42,6,45
Berwick,9819,8,9,10,17,31,59,-28,37
Edinburgh Ci,9819,9,7,10,19,37,61,-24,31
Cowdenbeath,9819,10,4,11,21,24,55,-31,23
Peterhead,9820,1,24,4,8,79,38,41,76
Montrose,9820,2,23,7,6,60,37,23,76
Stirling,9820,3,16,7,13,61,52,9,55
Stenhousem'r,9820,4,15,9,12,56,47,9,54
Clyde,9820,5,15,9,12,53,49,4,54
Elgin,9820,6,15,6,15,56,61,-5,51
Annan Athlet,9820,7,11,11,14,47,42,5,44
Berwick,9820,8,8,10,18,30,60,-30,34
Edinburgh Ci,9820,9,7,9,20,36,62,-26,30
Cowdenbeath,9820,10,5,10,21,24,54,-30,25
Peterhead,9821,1,24,4,8,78,38,40,76
Montrose,9821,2,23,7,6,60,36,24,76
Stenhousem'r,9821,3,16,8,12,56,46,10,56
Stirling,9821,4,16,6,14,60,52,8,54
Clyde,9821,5,15,9,12,53,48,5,54
Elgin,9821,6,15,6,15,55,61,-6,51
Annan Athlet,9821,7,12,11,13,50,42,8,47
Berwick,9821,8,8,10,18,29,60,-31,34
Edinburgh Ci,9821,9,7,9,20,36,61,-25,30
Cowdenbeath,9821,10,4,10,22,24,57,-33,22
Montrose,9822,1,24,7,5,62,34,28,79
Peterhead,9822,2,24,4,8,79,38,41,76
Stirling,9822,3,16,7,13,62,53,9,55
Stenhousem'r,9822,4,15,9,12,57,48,9,54
Clyde,9822,5,15,9,12,53,49,4,54
Elgin,9822,6,14,6,16,53,63,-10,48
Annan Athlet,9822,7,12,11,13,50,43,7,47
Berwick,9822,8,8,10,18,30,60,-30,34
Edinburgh Ci,9822,9,7,9,20,36,62,-26,30
Cowdenbeath,9822,10,4,10,22,25,57,-32,22
Montrose,9823,1,24,7,5,63,35,28,79
Peterhead,9823,2,23,5,8,78,39,39,74
Stirling,9823,3,16,7,13,61,52,9,55
Stenhousem'r,9823,4,15,9,12,56,47,9,54
Clyde,9823,5,15,9,12,55,49,6,54
Elgin,9823,6,14,6,16,54,64,-10,48
Annan Athlet,9823,7,12,11,13,49,42,7,47
Berwick,9823,8,8,10,18,30,62,-32,34
Edinburgh Ci,9823,9,7,10,19,37,61,-24,31
Cowdenbeath,9823,10,4,10,22,24,56,-32,22
Montrose,9824,1,24,7,5,60,34,26,79
Peterhead,9824,2,24,4,8,78,38,40,76
Stirling,9824,3,17,6,13,62,51,11,57
Stenhousem'r,9824,4,15,8,13,55,48,7,53
Clyde,9824,5,14,10,12,52,49,3,52
Elgin,9824,6,14,6,16,53,61,-8,48
Annan Athlet,9824,7,11,11,14,47,46,1,44
Berwick,9824,8,8,11,17,30,59,-29,35
Edinburgh Ci,9824,9,7,9,20,36,61,-25,30
Cowdenbeath,9824,10,5,10,21,28,54,-26,25
Montrose,9825,1,23,7,6,59,35,24,76
Peterhead,9825,2,23,5,8,78,39,39,74
Stirling,9825,3,16,7,13,60,51,9,55
Stenhousem'r,9825,4,15,9,12,55,46,9,54
Clyde,9825,5,15,9,12,53,48,5,54
Elgin,9825,6,15,6,15,54,60,-6,51
Annan Athlet,9825,7,12,11,13,50,41,9,47
Berwick,9825,8,8,10,18,29,60,-31,34
Edinburgh Ci,9825,9,7,10,19,37,61,-24,31
Cowdenbeath,9825,10,4,10,22,23,57,-34,22
Montrose,9826,1,24,7,5,62,35,27,79
Peterhead,9826,2,24,4,8,79,39,40,76
Stirling,9826,3,17,6,13,63,52,11,57
Stenhousem'r,9826,4,15,8,13,56,49,7,53
Clyde,9826,5,14,10,12,52,49,3,52
Elgin,9826,6,14,6,16,54,63,-9,48
Annan Athlet,9826,7,11,12,13,47,41,6,45
Berwick,9826,8,8,11,17,30,59,-29,35
Edinburgh Ci,9826,9,7,9,20,37,62,-25,30
Cowdenbeath,9826,10,4,11,21,23,54,-31,23
Montrose,9827,1,24,7,5,61,34,27,79
Peterhead,9827,2,24,4,8,81,39,42,76
Stirling,9827,3,16,7,13,62,53,9,55
Stenhousem'r,9827,4,15,9,12,57,48,9,54
Clyde,9827,5,14,10,12,52,49,3,52
Elgin,9827,6,14,6,16,53,62,-9,48
Annan Athlet,9827,7,11,11,14,49,44,5,44
Berwick,9827,8,8,11,17,30,59,-29,35
Edinburgh Ci,9827,9,7,9,20,37,64,-27,30
Cowdenbeath,9827,10,5,10,21,26,56,-30,25
Montrose,9828,1,23,8,5,60,35,25,77
Peterhead,9828,2,24,4,8,78,38,40,76
Stirling,9828,3,16,7,13,62,53,9,55
Stenhousem'r,9828,4,15,9,12,57,48,9,54
Clyde,9828,5,14,9,13,53,51,2,51
Elgin,9828,6,14,7,15,54,61,-7,49
Annan Athlet,9828,7,11,12,13,47,41,6,45
Berwick,9828,8,9,10,17,32,60,-28,37
Edinburgh Ci,9828,9,7,9,20,36,61,-25,30
Cowdenbeath,9828,10,4,11,21,23,54,-31,23
Montrose,9829,1,24,7,5,61,35,26,79
Peterhead,9829,2,23,5,8,79,40,39,74
Stirling,9829,3,17,6,13,65,53,12,57
Stenhousem'r,9829,4,15,8,13,57,51,6,53
Clyde,9829,5,14,10,12,52,49,3,52
Elgin,9829,6,14,6,16,54,62,-8,48
Annan Athlet,9829,7,12,11,13,49,41,8,47
Berwick,9829,8,8,11,17,30,59,-29,35
Edinburgh Ci,9829,9,7,10,19,38,62,-24,31
Cowdenbeath,9829,10,4,10,22,23,56,-33,22
Montrose,9830,1,24,7,5,61,35,26,79
Peterhead,9830,2,23,4,9,77,40,37,73
Stirling,9830,3,17,6,13,66,52,14,57
Stenhousem'r,9830,4,15,8,13,56,52,4,53
Clyde,9830,5,14,10,12,52,49,3,52
Elgin,9830,6,14,6,16,54,62,-8,48
Annan Athlet,9830,7,12,11,13,48,41,7,47
Berwick,9830,8,8,11,17,30,59,-29,35
Edinburgh Ci,9830,9,8,9,19,38,60,-22,33
Cowdenbeath,9830,10,4,10,22,23,55,-32,22
Montrose,9831,1,24,7,5,60,34,26,79
Peterhead,9831,2,23,4,9,79,41,38,73
Stenhousem'r,9831,3,16,8,12,58,47,11,56
Stirling,9831,4,16,6,14,61,54,7,54
Clyde,9831,5,15,9,12,53,48,5,54
Elgin,9831,6,14,6,16,53,61,-8,48
Annan Athlet,9831,7,12,11,13,49,42,7,47
Berwick,9831,8,8,10,18,29,60,-31,34
Edinburgh Ci,9831,9,8,9,19,39,62,-23,33
Cowdenbeath,9831,10,4,10,22,24,56,-32,22
Montrose,9832,1,23,8,5,61,36,25,77
Peterhead,9832,2,24,4,8,81,39,42,76
Stirling,9832,3,16,7,13,62,53,9,55
Stenhousem'r,9832,4,15,9,12,57,48,9,54
Clyde,9832,5,14,9,13,52,50,2,51
Elgin,9832,6,14,7,15,55,62,-7,49
Annan Athlet,9832,7,11,11,14,47,42,5,44
Berwick,9832,8,9,10,17,31,59,-28,37
Edinburgh Ci,9832,9,7,9,20,37,64,-27,30
Cowdenbeath,9832,10,5,10,21,24,54,-30,25
Peterhead,9833,1,24,4,8,80,38,42,76
Montrose,9833,2,23,7,6,59,36,23,76
Stenhousem'r,9833,3,16,8,12,58,48,10,56
Stirling,9833,4,16,6,14,62,54,8,54
Clyde,9833,5,14,10,12,52,49,3,52
Elgin,9833,6,15,6,15,55,60,-5,51
Annan Athlet,9833,7,12,11,13,48,41,7,47
Berwick,9833,8,8,11,17,30,59,-29,35
Edinburgh Ci,9833,9,7,9,20,36,63,-27,30
Cowdenbeath,9833,10,4,10,22,23,55,-32,22
Peterhead,9834,1,24,4,8,79,39,40,76
Montrose,9834,2,23,7,6,59,35,24,76
Stirling,9834,3,16,7,13,62,53,9,55
Stenhousem'r,9834,4,15,9,12,57,48,9,54
Clyde,9834,5,15,9,12,54,48,6,54
Elgin,9834,6,15,6,15,54,60,-6,51
Annan Athlet,9834,7,11,12,13,48,42,6,45
Berwick,9834,8,8,10,18,29,61,-32,34
Edinburgh Ci,9834,9,7,9,20,37,62,-25,30
Cowdenbeath,9834,10,4,11,21,24,55,-31,23
Montrose,9835,1,23,7,6,59,35,24,76
Peterhead,9835,2,23,5,8,78,39,39,74
Stenhousem'r,9835,3,16,8,12,58,48,10,56
Stirling,9835,4,16,6,14,62,54,8,54
Clyde,9835,5,14,10,12,52,49,3,52
Elgin,9835,6,15,6,15,54,60,-6,51
Annan Athlet,9835,7,12,11,13,49,42,7,47
Berwick,9835,8,8,11,17,30,59,-29,35
Edinburgh Ci,9835,9,7,10,19,37,61,-24,31
Cowdenbeath,9835,10,4,10,22,24,56,-32,22
Montrose,9836,1,24,7,5,63,36,27,79
Peterhead,9836,2,24,4,8,78,38,40,76
Stirling,9836,3,17,6,13,63,51,12,57
Clyde,9836,4,15,9,12,52,48,4,54
Stenhousem'r,9836,5,15,8,13,55,49,6,53
Elgin,9836,6,14,6,16,55,64,-9,48
Annan Athlet,9836,7,11,11,14,49,44,5,44
Berwick,9836,8,8,10,18,29,59,-30,34
Edinburgh Ci,9836,9,7,9,20,36,61,-25,30
Cowdenbeath,9836,10,5,10,21,26,56,-30,25
Peterhead,9837,1,24,4,8,82,39,43,76
Montrose,9837,2,23,7,6,59,35,24,76
Stirling,9837,3,16,7,13,63,54,9,55
Stenhousem'r,9837,4,15,9,12,58,49,9,54
Clyde,9837,5,15,9,12,54,48,6,54
Elgin,9837,6,15,6,15,54,60,-6,51
Annan Athlet,9837,7,11,11,14,47,42,5,44
Berwick,9837,8,8,10,18,29,61,-32,34
Edinburgh Ci,9837,9,7,9,20,37,65,-28,30
Cowdenbeath,9837,10,5,10,21,24,54,-30,25
Montrose,9838,1,24,7,5,62,34,28,79
Peterhead,9838,2,24,4,8,79,39,40,76
Stenhousem'r,9838,3,16,8,12,57,47,10,56
Stirling,9838,4,16,6,14,61,53,8,54
Clyde,9838,5,15,9,12,53,49,4,54
Elgin,9838,6,14,6,16,53,63,-10,48
Annan Athlet,9838,7,11,12,13,48,42,6,45
Berwick,9838,8,8,10,18,30,60,-30,34
Edinburgh Ci,9838,9,7,9,20,37,62,-25,30
Cowdenbeath,9838,10,4,11,21,24,55,-31,23
Montrose,9839,1,24,7,5,62,36,26,79
Peterhead,9839,2,23,5,8,79,40,39,74
Stirling,9839,3,16,7,13,62,53,9,55
Stenhousem'r,9839,4,15,9,12,57,48,9,54
Clyde,9839,5,14,9,13,51,49,2,51
Elgin,9839,6,14,6,16,55,63,-8,48
Annan Athlet,9839,7,11,11,14,47,42,5,44
Berwick,9839,8,9,10,17,30,58,-28,37
Edinburgh Ci,9839,9,7,10,19,38,62,-24,31
Cowdenbeath,9839,10,5,10,21,24,54,-30,25
Montrose,9840,1,24,7,5,64,34,30,79
Peterhead,9840,2,24,4,8,79,39,40,76
Stirling,9840,3,17,6,13,62,52,10,57
Stenhousem'r,9840,4,15,8,13,56,48,8,53
Clyde,9840,5,14,9,13,52,52,0,51
Elgin,9840,6,14,6,16,53,65,-12,48
Annan Athlet,9840,7,11,11,14,48,43,5,44
Berwick,9840,8,9,10,17,33,59,-26,37
Edinburgh Ci,9840,9,7,9,20,37,62,-25,30
Cowdenbeath,9840,10,5,10,21,25,55,-30,25
Montrose,9841,1,24,7,5,60,34,26,79
Peterhead,9841,2,23,5,8,77,38,39,74
Stirling,9841,3,17,6,13,61,51,10,57
Clyde,9841,4,15,9,12,53,49,4,54
Stenhousem'r,9841,5,15,8,13,55,47,8,53
Elgin,9841,6,14,6,16,53,61,-8,48
Annan Athlet,9841,7,12,11,13,48,41,7,47
Berwick,9841,8,8,10,18,30,60,-30,34
Edinburgh Ci,9841,9,7,10,19,36,60,-24,31
Cowdenbeath,9841,10,4,10,22,23,55,-32,22
Montrose,9842,1,24,7,5,60,34,26,79
Peterhead,9842,2,24,4,8,83,39,44,76
Stirling,9842,3,17,6,13,64,53,11,57
Stenhousem'r,9842,4,15,8,13,57,50,7,53
Clyde,9842,5,14,9,13,52,51,1,51
Elgin,9842,6,14,6,16,53,61,-8,48
Annan Athlet,9842,7,12,11,13,49,42,7,47
Berwick,9842,8,9,10,17,32,59,-27,37
Edinburgh Ci,9842,9,7,9,20,37,66,-29,30
Cowdenbeath,9842,10,4,10,22,24,56,-32,22
Montrose,9843,1,24,7,5,64,34,30,79
Peterhead,9843,2,24,4,8,82,39,43,76
Stirling,9843,3,17,6,13,64,51,13,57
Stenhousem'r,9843,4,15,8,13,55,50,5,53
Clyde,9843,5,14,10,12,52,49,3,52
Elgin,9843,6,14,6,16,53,65,-12,48
Annan Athlet,9843,7,11,11,14,47,42,5,44
Berwick,9843,8,8,11,17,30,59,-29,35
Edinburgh Ci,9843,9,7,9,20,37,65,-28,30
Cowdenbeath,9843,10,5,10,21,24,54,-30,25
Montrose,9844,1,24,7,5,62,35,27,79
Peterhead,9844,2,24,4,8,79,38,41,76
Stenhousem'r,9844,3,16,8,12,56,46,10,56
Stirling,9844,4,16,6,14,60,52,8,54
Clyde,9844,5,15,9,12,55,48,7,54
Elgin,9844,6,14,6,16,54,63,-9,48
Annan Athlet,9844,7,11,11,14,47,42,5,44
Berwick,9844,8,8,10,18,29,62,-33,34
Edinburgh Ci,9844,9,7,9,20,36,62,-26,30
Cowdenbeath,9844,10,5,10,21,24,54,-30,25
Montrose,9845,1,24,7,5,60,34,26,79
Peterhead,9845,2,24,4,8,78,38,40,76
Stirling,9845,3,16,7,13,60,51,9,55
Stenhousem'r,9845,4,15,9,12,55,46,9,54
Clyde,9845,5,15,9,12,53,49,4,54
Elgin,9845,6,14,6,16,53,61,-8,48
Annan Athlet,9845,7,12,11,13,48,41,7,47
Berwick,9845,8,8,10,18,30,60,-30,34
Edinburgh Ci,9845,9,7,9,20,36,61,-25,30
Cowdenbeath,9845,10,4,10,22,23,55,-32,22
Peterhead,9846,1,24,4,8,79,38,41,76
Montrose,9846,2,23,7,6,59,36,23,76
Stirling,9846,3,17,6,13,61,51,10,57
Clyde,9846,4,15,9,12,54,48,6,54
Stenhousem'r,9846,5,15,8,13,55,47,8,53
Elgin,9846,6,15,6,15,55,60,-5,51
Annan Athlet,9846,7,11,12,13,48,42,6,45
Berwick,9846,8,8,10,18,29,61,-32,34
Edinburgh Ci,9846,9,7,9,20,36,62,-26,30
Cowdenbeath,9846,10,4,11,21,24,55,-31,23
Montrose,9847,1,23,8,5,61,36,25,77
Peterhead,9847,2,24,4,8,80,38,42,76
Stirling,9847,3,17,6,13,64,51,13,57
Clyde,9847,4,15,9,12,54,48,6,54
Stenhousem'r,9847,5,15,8,13,55,50,5,53
Elgin,9847,6,14,7,15,55,62,-7,49
Annan Athlet,9847,7,12,11,13,48,41,7,47
Berwick,9847,8,8,10,18,29,61,-32,34
Edinburgh Ci,9847,9,7,9,20,36,63,-27,30
Cowdenbeath,9847,10,4,10,22,23,55,-32,22
Montrose,9848,1,23,7,6,60,36,24,76
Peterhead,9848,2,23,4,9,79,41,38,73
Stirling,9848,3,16,7,13,62,53,9,55
Stenhousem'r,9848,4,15,9,12,57,48,9,54
Clyde,9848,5,15,9,12,53,49,4,54
Elgin,9848,6,15,6,15,55,61,-6,51
Annan Athlet,9848,7,11,11,14,47,42,5,44
Berwick,9848,8,8,10,18,30,60,-30,34
Edinburgh Ci,9848,9,8,9,19,39,62,-23,33
Cowdenbeath,9848,10,5,10,21,24,54,-30,25
Montrose,9849,1,24,7,5,62,36,26,79
Peterhead,9849,2,24,4,8,81,38,43,76
Stirling,9849,3,17,6,13,65,52,13,57
Clyde,9849,4,15,9,12,55,49,6,54
Stenhousem'r,9849,5,15,8,13,56,51,5,53
Elgin,9849,6,14,6,16,55,63,-8,48
Annan Athlet,9849,7,11,11,14,47,43,4,44
Berwick,9849,8,8,10,18,30,62,-32,34
Edinburgh Ci,9849,9,7,9,20,36,64,-28,30
Cowdenbeath,9849,10,5,10,21,25,54,-29,25
Montrose,9850,1,24,7,5,62,35,27,79
Peterhead,9850,2,23,5,8,77,38,39,74
Stirling,9850,3,16,7,13,62,53,9,55
Stenhousem'r,9850,4,15,9,12,57,48,9,54
Clyde,9850,5,14,9,13,52,50,2,51
Elgin,9850,6,14,6,16,54,63,-9,48
Annan Athlet,9850,7,12,11,13,49,41,8,47
Berwick,9850,8,9,10,17,31,59,-28,37
Edinburgh Ci,9850,9,7,10,19,36,60,-24,31
Cowdenbeath,9850,10,4,10,22,23,56,-33,22
Montrose,9851,1,23,8,5,61,36,25,77
Peterhead,9851,2,24,4,8,79,38,41,76
Stirling,9851,3,17,6,13,61,51,10,57
Stenhousem'r,9851,4,15,8,13,55,47,8,53
Clyde,9851,5,14,9,13,51,49,2,51
Elgin,9851,6,14,7,15,55,62,-7,49
Annan Athlet,9851,7,11,12,13,47,41,6,45
Berwick,9851,8,9,10,17,30,58,-28,37
Edinburgh Ci,9851,9,7,9,20,36,62,-26,30
Cowdenbeath,9851,10,4,11,21,23,54,-31,23
Peterhead,9852,1,24,4,8,80,38,42,76
Montrose,9852,2,23,7,6,60,36,24,76
Stirling,9852,3,17,6,13,62,52,10,57
Clyde,9852,4,15,9,12,54,48,6,54
Stenhousem'r,9852,5,15,8,13,56,48,8,53
Elgin,9852,6,15,6,15,55,61,-6,51
Annan Athlet,9852,7,12,11,13,48,41,7,47
Berwick,9852,8,8,10,18,29,61,-32,34
Edinburgh Ci,9852,9,7,9,20,36,63,-27,30
Cowdenbeath,9852,10,4,10,22,23,55,-32,22
Montrose,9853,1,24,7,5,61,35,26,79
Peterhead,9853,2,24,4,8,78,38,40,76
Stirling,9853,3,16,7,13,62,53,9,55
Stenhousem'r,9853,4,15,9,12,57,48,9,54
Clyde,9853,5,15,9,12,55,48,7,54
Elgin,9853,6,14,6,16,54,62,-8,48
Annan Athlet,9853,7,12,11,13,49,41,8,47
Berwick,9853,8,8,10,18,29,62,-33,34
Edinburgh Ci,9853,9,7,9,20,36,61,-25,30
Cowdenbeath,9853,10,4,10,22,23,56,-33,22
Montrose,9854,1,24,7,5,61,35,26,79
Peterhead,9854,2,24,4,8,80,38,42,76
Stirling,9854,3,17,6,13,63,53,10,57
Stenhousem'r,9854,4,15,8,13,57,49,8,53
Clyde,9854,5,14,10,12,52,49,3,52
Elgin,9854,6,14,6,16,54,62,-8,48
Annan Athlet,9854,7,11,11,14,47,42,5,44
Berwick,9854,8,8,11,17,30,59,-29,35
Edinburgh Ci,9854,9,7,9,20,36,63,-27,30
Cowdenbeath,9854,10,5,10,21,24,54,-30,25
Montrose,9855,1,24,7,5,60,34,26,79
Peterhead,9855,2,24,4,8,80,40,40,76
Stirling,9855,3,17,6,13,62,52,10,57
Clyde,9855,4,15,9,12,53,49,4,54
Stenhousem'r,9855,5,15,8,13,56,48,8,53
Elgin,9855,6,14,6,16,53,61,-8,48
Annan Athlet,9855,7,11,11,14,47,42,5,44
Berwick,9855,8,8,10,18,30,60,-30,34
Edinburgh Ci,9855,9,7,9,20,38,63,-25,30
Cowdenbeath,9855,10,5,10,21,24,54,-30,25
Montrose,9856,1,23,8,5,59,34,25,77
Peterhead,9856,2,24,4,8,84,39,45,76
Stirling,9856,3,17,6,13,63,52,11,57
Stenhousem'r,9856,4,15,8,13,56,49,7,53
Clyde,9856,5,14,9,13,52,50,2,51
Elgin,9856,6,14,7,15,53,60,-7,49
Annan Athlet,9856,7,11,11,14,47,45,2,44
Berwick,9856,8,9,10,17,31,59,-28,37
Edinburgh Ci,9856,9,7,9,20,37,67,-30,30
Cowdenbeath,9856,10,5,10,21,27,54,-27,25
Montrose,9857,1,23,8,5,60,35,25,77
Peterhead,9857,2,23,4,9,78,40,38,73
Stenhousem'r,9857,3,16,8,12,58,46,12,56
Stirling,9857,4,16,6,14,60,54,6,54
Clyde,9857,5,15,9,12,53,48,5,54
Elgin,9857,6,14,7,15,54,61,-7,49
Annan Athlet,9857,7,11,12,13,48,42,6,45
Berwick,9857,8,8,10,18,29,60,-31,34
Edinburgh Ci,9857,9,8,9,19,38,61,-23,33
Cowdenbeath,9857,10,4,11,21,24,55,-31,23
Montrose,9858,1,24,7,5,62,35,27,79
Peterhead,9858,2,24,4,8,80,39,41,76
Stenhousem'r,9858,3,16,8,12,59,48,11,56
Stirling,9858,4,16,6,14,62,55,7,54
Clyde,9858,5,14,9,13,51,49,2,51
Elgin,9858,6,14,6,16,54,63,-9,48
Annan Athlet,9858,7,11,11,14,48,43,5,44
Berwick,9858,8,9,10,17,30,58,-28,37
Edinburgh Ci,9858,9,7,9,20,37,63,-26,30
Cowdenbeath,9858,10,5,10,21,25,55,-30,25
Montrose,9859,1,24,7,5,61,35,26,79
Peterhead,9859,2,24,4,8,81,38,43,76
Stenhousem'r,9859,3,16,8,12,58,46,12,56
Stirling,9859,4,16,6,14,60,54,6,54
Clyde,9859,5,14,10,12,51,48,3,52
Elgin,9859,6,14,6,16,54,62,-8,48
Annan Athlet,9859,7,12,11,13,50,42,8,47
Berwick,9859,8,8,11,17,29,58,-29,35
Edinburgh Ci,9859,9,7,9,20,36,64,-28,30
Cowdenbeath,9859,10,4,10,22,24,57,-33,22
Montrose,9860,1,24,7,5,61,34,27,79
Peterhead,9860,2,24,4,8,78,38,40,76
Stirling,9860,3,16,7,13,61,52,9,55
Stenhousem'r,9860,4,15,9,12,56,47,9,54
Clyde,9860,5,15,9,12,55,48,7,54
Elgin,9860,6,14,6,16,53,62,-9,48
Annan Athlet,9860,7,11,11,14,49,44,5,44
Berwick,9860,8,8,10,18,29,62,-33,34
Edinburgh Ci,9860,9,7,9,20,36,61,-25,30
Cowdenbeath,9860,10,5,10,21,26,56,-30,25
Peterhead,9861,1,24,4,8,81,38,43,76
Montrose,9861,2,23,7,6,62,38,24,76
Stirling,9861,3,17,6,13,63,51,12,57
Stenhousem'r,9861,4,15,8,13,55,49,6,53
Clyde,9861,5,14,9,13,52,51,1,51
Elgin,9861,6,15,6,15,57,63,-6,51
Annan Athlet,9861,7,11,11,14,47,43,4,44
Berwick,9861,8,9,10,17,32,59,-27,37
Edinburgh Ci,9861,9,7,9,20,36,64,-28,30
Cowdenbeath,9861,10,5,10,21,25,54,-29,25
Montrose,9862,1,24,7,5,63,36,27,79
Peterhead,9862,2,24,4,8,80,38,42,76
Stenhousem'r,9862,3,16,8,12,57,47,10,56
Stirling,9862,4,16,6,14,61,53,8,54
Clyde,9862,5,15,9,12,54,48,6,54
Elgin,9862,6,14,6,16,55,64,-9,48
Annan Athlet,9862,7,12,11,13,49,41,8,47
Berwick,9862,8,8,10,18,29,61,-32,34
Edinburgh Ci,9862,9,7,9,20,36,63,-27,30
Cowdenbeath,9862,10,4,10,22,23,56,-33,22
Montrose,9863,1,24,7,5,61,34,27,79
Peterhead,9863,2,24,4,8,79,39,40,76
Stenhousem'r,9863,3,16,8,12,57,47,10,56
Stirling,9863,4,16,6,14,61,53,8,54
Clyde,9863,5,14,9,13,52,50,2,51
Elgin,9863,6,14,6,16,53,62,-9,48
Annan Athlet,9863,7,11,11,14,47,43,4,44
Berwick,9863,8,9,10,17,31,59,-28,37
Edinburgh Ci,9863,9,7,9,20,37,62,-25,30
Cowdenbeath,9863,10,5,10,21,25,54,-29,25
Montrose,9864,1,23,7,6,60,37,23,76
Peterhead,9864,2,23,5,8,79,40,39,74
Stirling,9864,3,17,6,13,63,51,12,57
Stenhousem'r,9864,4,15,8,13,55,49,6,53
Clyde,9864,5,14,9,13,51,50,1,51
Elgin,9864,6,15,6,15,56,61,-5,51
Annan Athlet,9864,7,11,12,13,47,41,6,45
Berwick,9864,8,9,10,17,31,58,-27,37
Edinburgh Ci,9864,9,7,10,19,38,62,-24,31
Cowdenbeath,9864,10,4,11,21,23,54,-31,23
Montrose,9865,1,24,7,5,65,34,31,79
Peterhead,9865,2,23,5,8,77,38,39,74
Stirling,9865,3,17,6,13,63,52,11,57
Stenhousem'r,9865,4,15,8,13,56,49,7,53
Clyde,9865,5,14,10,12,51,48,3,52
Elgin,9865,6,14,6,16,53,66,-13,48
Annan Athlet,9865,7,12,11,13,51,41,10,47
Berwick,9865,8,8,11,17,29,58,-29,35
Edinburgh Ci,9865,9,7,10,19,36,60,-24,31
Cowdenbeath,9865,10,4,10,22,23,58,-35,22
Montrose,9866,1,24,7,5,60,34,26,79
Peterhead,9866,2,24,4,8,79,39,40,76
Stirling,9866,3,17,6,13,62,51,11,57
Clyde,9866,4,15,9,12,57,49,8,54
Stenhousem'r,9866,5,15,8,13,55,48,7,53
Elgin,9866,6,14,6,16,53,61,-8,48
Annan Athlet,9866,7,11,12,13,48,42,6,45
Berwick,9866,8,8,10,18,30,64,-34,34
Edinburgh Ci,9866,9,7,9,20,37,62,-25,30
Cowdenbeath,9866,10,4,11,21,24,55,-31,23
Peterhead,9867,1,24,4,8,83,40,43,76
Montrose,9867,2,23,7,6,59,35,24,76
Stenhousem'r,9867,3,16,8,12,57,47,10,56
Stirling,9867,4,16,6,14,61,53,8,54
Clyde,9867,5,15,9,12,52,48,4,54
Elgin,9867,6,15,6,15,54,60,-6,51
Annan Athlet,9867,7,12,11,13,49,42,7,47
Berwick,9867,8,8,10,18,29,59,-30,34
Edinburgh Ci,9867,9,7,9,20,38,66,-28,30
Cowdenbeath,9867,10,4,10,22,24,56,-32,22
Montrose,9868,1,23,7,6,59,35,24,76
Peterhead,9868,2,23,5,8,77,38,39,74
Stenhousem'r,9868,3,16,8,12,57,46,11,56
Stirling,9868,4,16,6,14,60,53,7,54
Clyde,9868,5,14,9,13,51,50,1,51
Elgin,9868,6,15,6,15,54,60,-6,51
Annan Athlet,9868,7,11,12,13,47,41,6,45
Berwick,9868,8,9,10,17,31,58,-27,37
Edinburgh Ci,9868,9,7,10,19,36,60,-24,31
Cowdenbeath,9868,10,4,11,21,23,54,-31,23
Montrose,9869,1,24,7,5,62,34,28,79
Peterhead,9869,2,24,4,8,82,40,42,76
Stirling,9869,3,16,7,13,61,52,9,55
Stenhousem'r,9869,4,15,9,12,56,47,9,54
Clyde,9869,5,14,10,12,52,49,3,52
Elgin,9869,6,14,6,16,53,63,-10,48
Annan Athlet,9869,7,11,11,14,48,43,5,44
Berwick,9869,8,8,11,17,30,59,-29,35
Edinburgh Ci,9869,9,7,9,20,38,65,-27,30
Cowdenbeath,9869,10,5,10,21,25,55,-30,25
Peterhead,9870,1,24,4,8,79,38,41,76
Montrose,9870,2,23,7,6,61,37,24,76
Stirling,9870,3,17,6,13,63,51,12,57
Stenhousem'r,9870,4,15,8,13,55,49,6,53
Clyde,9870,5,14,10,12,52,49,3,52
Elgin,9870,6,15,6,15,56,62,-6,51
Annan Athlet,9870,7,12,11,13,48,41,7,47
Berwick,9870,8,8,11,17,30,59,-29,35
Edinburgh Ci,9870,9,7,9,20,36,62,-26,30
Cowdenbeath,9870,10,4,10,22,23,55,-32,22
Montrose,9871,1,24,7,5,63,34,29,79
Peterhead,9871,2,24,4,8,79,39,40,76
Stirling,9871,3,17,6,13,63,52,11,57
Clyde,9871,4,15,9,12,52,48,4,54
Stenhousem'r,9871,5,15,8,13,56,49,7,53
Elgin,9871,6,14,6,16,53,64,-11,48
Annan Athlet,9871,7,11,12,13,49,43,6,45
Berwick,9871,8,8,10,18,29,59,-30,34
Edinburgh Ci,9871,9,7,9,20,37,62,-25,30
Cowdenbeath,9871,10,4,11,21,25,56,-31,23
Montrose,9872,1,23,8,5,60,35,25,77
Peterhead,9872,2,24,4,8,80,39,41,76
Stenhousem'r,9872,3,16,8,12,59,47,12,56
Stirling,9872,4,16,6,14,61,55,6,54
Clyde,9872,5,15,9,12,54,49,5,54
Elgin,9872,6,14,7,15,54,61,-7,49
Annan Athlet,9872,7,12,11,13,49,42,7,47
Berwick,9872,8,8,10,18,30,61,-31,34
Edinburgh Ci,9872,9,7,9,20,37,63,-26,30
Cowdenbeath,9872,10,4,10,22,24,56,-32,22
Montrose,9873,1,24,7,5,60,34,26,79
Peterhead,9873,2,24,4,8,80,38,42,76
Stirling,9873,3,17,6,13,63,52,11,57
Clyde,9873,4,15,9,12,53,48,5,54
Stenhousem'r,9873,5,15,8,13,56,49,7,53
Elgin,9873,6,14,6,16,53,61,-8,48
Annan Athlet,9873,7,11,12,13,48,42,6,45
Berwick,9873,8,8,10,18,29,60,-31,34
Edinburgh Ci,9873,9,7,9,20,36,63,-27,30
Cowdenbeath,9873,10,4,11,21,24,55,-31,23
Montrose,9874,1,24,7,5,62,34,28,79
Peterhead,9874,2,24,4,8,83,40,43,76
Stenhousem'r,9874,3,16,8,12,58,46,12,56
Stirling,9874,4,16,6,14,60,54,6,54
Clyde,9874,5,14,9,13,54,53,1,51
Elgin,9874,6,14,6,16,53,63,-10,48
Annan Athlet,9874,7,11,11,14,48,43,5,44
Berwick,9874,8,9,10,17,34,61,-27,37
Edinburgh Ci,9874,9,7,9,20,38,66,-28,30
Cowdenbeath,9874,10,5,10,21,25,55,-30,25
Peterhead,9875,1,24,4,8,79,39,40,76
Montrose,9875,2,23,7,6,60,37,23,76
Stirling,9875,3,17,6,13,64,52,12,57
Clyde,9875,4,15,9,12,54,48,6,54
Stenhousem'r,9875,5,15,8,13,56,50,6,53
Elgin,9875,6,15,6,15,56,61,-5,51
Annan Athlet,9875,7,12,11,13,51,42,9,47
Berwick,9875,8,8,10,18,29,61,-32,34
Edinburgh Ci,9875,9,7,9,20,37,62,-25,30
Cowdenbeath,9875,10,4,10,22,24,58,-34,22
Peterhead,9876,1,24,4,8,80,39,41,76
Montrose,9876,2,23,7,6,59,36,23,76
Stirling,9876,3,17,6,13,62,52,10,57
Stenhousem'r,9876,4,15,8,13,56,48,8,53
Clyde,9876,5,14,10,12,53,50,3,52
Elgin,9876,6,15,6,15,55,60,-5,51
Annan Athlet,9876,7,11,12,13,47,41,6,45
Berwick,9876,8,8,11,17,31,60,-29,35
Edinburgh Ci,9876,9,7,9,20,37,63,-26,30
Cowdenbeath,9876,10,4,11,21,23,54,-31,23
Montrose,9877,1,23,8,5,60,35,25,77
Peterhead,9877,2,24,4,8,78,38,40,76
Stirling,9877,3,16,7,13,61,52,9,55
Stenhousem'r,9877,4,15,9,12,56,47,9,54
Clyde,9877,5,14,10,12,51,48,3,52
Elgin,9877,6,14,7,15,54,61,-7,49
Annan Athlet,9877,7,12,11,13,49,41,8,47
Berwick,9877,8,8,11,17,29,58,-29,35
Edinburgh Ci,9877,9,7,9,20,36,61,-25,30
Cowdenbeath,9877,10,4,10,22,23,56,-33,22
Montrose,9878,1,24,7,5,60,34,26,79
Peterhead,9878,2,23,5,8,78,39,39,74
Stenhousem'r,9878,3,16,8,12,56,46,10,56
Stirling,9878,4,16,6,14,60,52,8,54
Clyde,9878,5,14,10,12,54,51,3,52
Elgin,9878,6,14,6,16,53,61,-8,48
Annan Athlet,9878,7,11,11,14,48,43,5,44
Berwick,9878,8,8,11,17,32,61,-29,35
Edinburgh Ci,9878,9,7,10,19,37,61,-24,31
Cowdenbeath,9878,10,5,10,21,25,55,-30,25
Peterhead,9879,1,24,4,8,82,40,42,76
Montrose,9879,2,23,7,6,60,36,24,76
Stirling,9879,3,16,7,13,62,53,9,55
Stenhousem'r,9879,4,15,9,12,57,48,9,54
Clyde,9879,5,15,9,12,52,48,4,54
Elgin,9879,6,15,6,15,55,61,-6,51
Annan Athlet,9879,7,12,11,13,49,42,7,47
Berwick,9879,8,8,10,18,29,59,-30,34
Edinburgh Ci,9879,9,7,9,20,38,65,-27,30
Cowdenbeath,9879,10,4,10,22,24,56,-32,22
Peterhead,9880,1,24,4,8,78,38,40,76
Montrose,9880,2,23,7,6,59,36,23,76
Stenhousem'r,9880,3,16,8,12,56,46,10,56
Stirling,9880,4,16,6,14,60,52,8,54
Clyde,9880,5,15,9,12,54,49,5,54
Elgin,9880,6,15,6,15,55,60,-5,51
Annan Athlet,9880,7,11,12,13,47,41,6,45
Berwick,9880,8,8,10,18,30,61,-31,34
Edinburgh Ci,9880,9,7,9,20,36,61,-25,30
Cowdenbeath,9880,10,4,11,21,23,54,-31,23
Montrose,9881,1,24,7,5,62,34,28,79
Peterhead,9881,2,24,4,8,82,38,44,76
Stirling,9881,3,17,6,13,62,51,11,57
Stenhousem'r,9881,4,15,8,13,55,48,7,53
Clyde,9881,5,14,10,12,51,48,3,52
Elgin,9881,6,14,6,16,53,63,-10,48
Annan Athlet,9881,7,12,11,13,49,42,7,47
Berwick,9881,8,8,11,17,29,58,-29,35
Edinburgh Ci,9881,9,7,9,20,36,65,-29,30
Cowdenbeath,9881,10,4,10,22,24,56,-32,22
Peterhead,9882,1,24,4,8,79,39,40,76
Montrose,9882,2,23,7,6,62,38,24,76
Stenhousem'r,9882,3,16,8,12,58,48,10,56
Stirling,9882,4,16,6,14,62,54,8,54
Clyde,9882,5,15,9,12,54,48,6,54
Elgin,9882,6,15,6,15,57,63,-6,51
Annan Athlet,9882,7,11,12,13,48,42,6,45
Berwick,9882,8,8,10,18,29,61,-32,34
Edinburgh Ci,9882,9,7,9,20,37,62,-25,30
Cowdenbeath,9882,10,4,11,21,24,55,-31,23
Montrose,9883,1,23,8,5,61,36,25,77
Peterhead,9883,2,23,5,8,79,40,39,74
Stenhousem'r,9883,3,16,8,12,58,48,10,56
Stirling,9883,4,16,6,14,62,54,8,54
Clyde,9883,5,14,9,13,52,50,2,51
Elgin,9883,6,14,7,15,55,62,-7,49
Annan Athlet,9883,7,12,11,13,48,41,7,47
Berwick,9883,8,9,10,17,31,59,-28,37
Edinburgh Ci,9883,9,7,10,19,38,62,-24,31
Cowdenbeath,9883,10,4,10,22,23,55,-32,22
Peterhead,9884,1,24,4,8,78,38,40,76
Montrose,9884,2,23,7,6,59,35,24,76
Stirling,9884,3,17,6,13,63,51,12,57
Clyde,9884,4,15,9,12,54,50,4,54
Stenhousem'r,9884,5,15,8,13,55,49,6,53
Elgin,9884,6,15,6,15,54,60,-6,51
Annan Athlet,9884,7,11,12,13,48,42,6,45
Berwick,9884,8,8,10,18,31,61,-30,34
Edinburgh Ci,9884,9,7,9,20,36,61,-25,30
Cowdenbeath,9884,10,4,11,21,24,55,-31,23
Montrose,9885,1,24,7,5,62,35,27,79
Peterhead,9885,2,24,4,8,80,38,42,76
Stirling,9885,3,17,6,13,63,53,10,57
Clyde,9885,4,15,9,12,54,49,5,54
Stenhousem'r,9885,5,15,8,13,57,49,8,53
Elgin,9885,6,14,6,16,54,63,-9,48
Annan Athlet,9885,7,11,11,14,48,44,4,44
Berwick,9885,8,8,10,18,30,61,-31,34
Edinburgh Ci,9885,9,7,9,20,36,63,-27,30
Cowdenbeath,9885,10,5,10,21,26,55,-29,25
Montrose,9886,1,23,8,5,62,37,25,77
Peterhead,9886,2,24,4,8,82,38,44,76
Stirling,9886,3,17,6,13,63,52,11,57
Clyde,9886,4,15,9,12,53,48,5,54
Stenhousem'r,9886,5,15,8,13,56,49,7,53
Elgin,9886,6,14,7,15,56,63,-7,49
Annan Athlet,9886,7,12,11,13,50,43,7,47
Berwick,9886,8,8,10,18,29,60,-31,34
Edinburgh Ci,9886,9,7,9,20,36,65,-29,30
Cowdenbeath,9886,10,4,10,22,25,57,-32,22
Montrose,9887,1,24,7,5,62,35,27,79
Peterhead,9887,2,24,4,8,80,40,40,76
Stirling,9887,3,17,6,13,61,51,10,57
Clyde,9887,4,15,9,12,54,49,5,54
Stenhousem'r,9887,5,15,8,13,55,47,8,53
Elgin,9887,6,14,6,16,54,63,-9,48
Annan Athlet,9887,7,11,11,14,47,42,5,44
Berwick,9887,8,8,10,18,30,61,-31,34
Edinburgh Ci,9887,9,7,9,20,38,63,-25,30
Cowdenbeath,9887,10,5,10,21,24,54,-30,25
Montrose,9888,1,24,7,5,61,34,27,79
Peterhead,9888,2,24,4,8,78,38,40,76
Stirling,9888,3,17,6,13,61,51,10,57
Clyde,9888,4,15,9,12,53,48,5,54
Stenhousem'r,9888,5,15,8,13,55,47,8,53
Elgin,9888,6,14,6,16,53,62,-9,48
Annan Athlet,9888,7,12,11,13,48,41,7,47
Berwick,9888,8,8,10,18,29,60,-31,34
Edinburgh Ci,9888,9,7,9,20,36,61,-25,30
Cowdenbeath,9888,10,4,10,22,23,55,-32,22
Montrose,9889,1,24,7,5,63,36,27,79
Peterhead,9889,2,24,4,8,81,40,41,76
Stenhousem'r,9889,3,16,8,12,56,46,10,56
Stirling,9889,4,16,6,14,60,52,8,54
Clyde,9889,5,15,9,12,55,50,5,54
Elgin,9889,6,14,6,16,55,64,-9,48
Annan Athlet,9889,7,11,12,13,47,41,6,45
Berwick,9889,8,8,10,18,31,62,-31,34
Edinburgh Ci,9889,9,7,9,20,38,64,-26,30
Cowdenbeath,9889,10,4,11,21,23,54,-31,23
Montrose,9890,1,23,8,5,61,36,25,77
Peterhead,9890,2,24,4,8,81,40,41,76
Stirling,9890,3,17,6,13,62,52,10,57
Stenhousem'r,9890,4,15,8,13,56,48,8,53
Clyde,9890,5,14,10,12,52,49,3,52
Elgin,9890,6,14,7,15,55,62,-7,49
Annan Athlet,9890,7,12,11,13,48,41,7,47
Berwick,9890,8,8,11,17,30,59,-29,35
Edinburgh Ci,9890,9,7,9,20,38,64,-26,30
Cowdenbeath,9890,10,4,10,22,23,55,-32,22
Montrose,9891,1,24,7,5,61,35,26,79
Peterhead,9891,2,24,4,8,80,38,42,76
Stirling,9891,3,17,6,13,61,51,10,57
Clyde,9891,4,15,9,12,52,48,4,54
Stenhousem'r,9891,5,15,8,13,55,47,8,53
Elgin,9891,6,14,6,16,54,62,-8,48
Annan Athlet,9891,7,12,11,13,48,41,7,47
Berwick,9891,8,8,10,18,29,59,-30,34
Edinburgh Ci,9891,9,7,9,20,36,63,-27,30
Cowdenbeath,9891,10,4,10,22,23,55,-32,22
Montrose,9892,1,24,7,5,63,34,29,79
Peterhead,9892,2,24,4,8,80,38,42,76
Stirling,9892,3,17,6,13,64,51,13,57
Stenhousem'r,9892,4,15,8,13,55,50,5,53
Clyde,9892,5,14,10,12,51,48,3,52
Elgin,9892,6,14,6,16,53,64,-11,48
Annan Athlet,9892,7,11,12,13,48,42,6,45
Berwick,9892,8,8,11,17,29,58,-29,35
Edinburgh Ci,9892,9,7,9,20,36,63,-27,30
Cowdenbeath,9892,10,4,11,21,24,55,-31,23
Peterhead,9893,1,24,4,8,83,40,43,76
Montrose,9893,2,23,7,6,59,35,24,76
Stirling,9893,3,16,7,13,60,51,9,55
Stenhousem'r,9893,4,15,9,12,55,46,9,54
Clyde,9893,5,14,10,12,53,50,3,52
Elgin,9893,6,15,6,15,54,60,-6,51
Annan Athlet,9893,7,11,11,14,47,43,4,44
Berwick,9893,8,8,11,17,31,60,-29,35
Edinburgh Ci,9893,9,7,9,20,38,66,-28,30
Cowdenbeath,9893,10,5,10,21,25,54,-29,25
Montrose,9894,1,23,8,5,61,36,25,77
Peterhead,9894,2,24,4,8,78,38,40,76
Stirling,9894,3,17,6,13,64,53,11,57
Clyde,9894,4,15,9,12,55,48,7,54
Stenhousem'r,9894,5,15,8,13,57,50,7,53
Elgin,9894,6,14,7,15,55,62,-7,49
Annan Athlet,9894,7,11,12,13,47,41,6,45
Berwick,9894,8,8,10,18,29,62,-33,34
Edinburgh Ci,9894,9,7,9,20,36,61,-25,30
Cowdenbeath,9894,10,4,11,21,23,54,-31,23
Montrose,9895,1,23,7,6,60,36,24,76
Peterhead,9895,2,23,5,8,79,40,39,74
Stenhousem'r,9895,3,16,8,12,57,46,11,56
Stirling,9895,4,16,6,14,60,53,7,54
Clyde,9895,5,15,9,12,55,51,4,54
Elgin,9895,6,15,6,15,55,61,-6,51
Annan Athlet,9895,7,11,11,14,47,42,5,44
Berwick,9895,8,8,10,18,32,62,-30,34
Edinburgh Ci,9895,9,7,10,19,38,62,-24,31
Cowdenbeath,9895,10,5,10,21,24,54,-30,25
Montrose,9896,1,24,7,5,62,35,27,79
Peterhead,9896,2,24,4,8,79,38,41,76
Stirling,9896,3,17,6,13,62,52,10,57
Stenhousem'r,9896,4,15,8,13,56,48,8,53
Clyde,9896,5,14,10,12,53,50,3,52
Elgin,9896,6,14,6,16,54,63,-9,48
Annan Athlet,9896,7,11,11,14,47,43,4,44
Berwick,9896,8,8,11,17,31,60,-29,35
Edinburgh Ci,9896,9,7,9,20,36,62,-26,30
Cowdenbeath,9896,10,5,10,21,25,54,-29,25
Peterhead,9897,1,24,4,8,80,38,42,76
Montrose,9897,2,23,7,6,60,36,24,76
Stenhousem'r,9897,3,16,8,12,56,46,10,56
Stirling,9897,4,16,6,14,60,52,8,54
Clyde,9897,5,15,9,12,52,48,4,54
Elgin,9897,6,15,6,15,55,61,-6,51
Annan Athlet,9897,7,11,12,13,48,42,6,45
Berwick,9897,8,8,10,18,29,59,-30,34
Edinburgh Ci,9897,9,7,9,20,36,63,-27,30
Cowdenbeath,9897,10,4,11,21,24,55,-31,23
Montrose,9898,1,23,8,5,60,35,25,77
Peterhead,9898,2,24,4,8,79,39,40,76
Stenhousem'r,9898,3,16,8,12,57,47,10,56
Stirling,9898,4,16,6,14,61,53,8,54
Clyde,9898,5,14,9,13,52,51,1,51
Elgin,9898,6,14,7,15,54,61,-7,49
Annan Athlet,9898,7,12,11,13,49,42,7,47
Berwick,9898,8,9,10,17,32,59,-27,37
Edinburgh Ci,9898,9,7,9,20,37,62,-25,30
Cowdenbeath,9898,10,4,10,22,24,56,-32,22
Peterhead,9899,1,24,4,8,79,39,40,76
Montrose,9899,2,23,7,6,59,39,20,76
Stirling,9899,3,17,6,13,65,51,14,57
Stenhousem'r,9899,4,15,8,13,55,51,4,53
Clyde,9899,5,14,10,12,52,49,3,52
Elgin,9899,6,15,6,15,58,60,-2,51
Annan Athlet,9899,7,12,11,13,49,42,7,47
Berwick,9899,8,8,11,17,30,59,-29,35
Edinburgh Ci,9899,9,7,9,20,37,62,-25,30
Cowdenbeath,9899,10,4,10,22,24,56,-32,22
Montrose,9900,1,23,8,5,60,35,25,77
Peterhead,9900,2,24,4,8,80,38,42,76
Stirling,9900,3,16,7,13,61,52,9,55
Stenhousem'r,9900,4,15,9,12,56,47,9,54
Clyde,9900,5,15,9,12,54,48,6,54
Elgin,9900,6,14,7,15,54,61,-7,49
Annan Athlet,9900,7,11,12,13,48,42,6,45
Berwick,9900,8,8,10,18,29,61,-32,34
Edinburgh Ci,9900,9,7,9,20,36,63,-27,30
Cowdenbeath,9900,10,4,11,21,24,55,-31,23
Montrose,9901,1,24,7,5,61,35,26,79
Peterhead,9901,2,23,5,8,78,39,39,74
Stirling,9901,3,17,6,13,63,52,11,57
Clyde,9901,4,15,9,12,53,48,5,54
Stenhousem'r,9901,5,15,8,13,56,49,7,53
Elgin,9901,6,14,6,16,54,62,-8,48
Annan Athlet,9901,7,12,11,13,48,41,7,47
Berwick,9901,8,8,10,18,29,60,-31,34
Edinburgh Ci,9901,9,7,10,19,37,61,-24,31
Cowdenbeath,9901,10,4,10,22,23,55,-32,22
Montrose,9902,1,24,7,5,64,35,29,79
Peterhead,9902,2,24,4,8,82,39,43,76
Stirling,9902,3,16,7,13,61,52,9,55
Stenhousem'r,9902,4,15,9,12,56,47,9,54
Clyde,9902,5,15,9,12,53,49,4,54
Elgin,9902,6,14,6,16,54,65,-11,48
Annan Athlet,9902,7,11,11,14,47,42,5,44
Berwick,9902,8,8,10,18,30,60,-30,34
Edinburgh Ci,9902,9,7,9,20,37,65,-28,30
Cowdenbeath,9902,10,5,10,21,24,54,-30,25
Montrose,9903,1,24,7,5,63,34,29,79
Peterhead,9903,2,24,4,8,80,40,40,76
Stirling,9903,3,17,6,13,62,51,11,57
Clyde,9903,4,15,9,12,52,48,4,54
Stenhousem'r,9903,5,15,8,13,55,48,7,53
Elgin,9903,6,14,6,16,53,64,-11,48
Annan Athlet,9903,7,12,11,13,49,42,7,47
Berwick,9903,8,8,10,18,29,59,-30,34
Edinburgh Ci,9903,9,7,9,20,38,63,-25,30
Cowdenbeath,9903,10,4,10,22,24,56,-32,22
Montrose,9904,1,24,7,5,63,34,29,79
Peterhead,9904,2,24,4,8,79,38,41,76
Stirling,9904,3,17,6,13,61,51,10,57
Clyde,9904,4,15,9,12,54,48,6,54
Stenhousem'r,9904,5,15,8,13,55,47,8,53
Elgin,9904,6,14,6,16,53,64,-11,48
Annan Athlet,9904,7,11,12,13,47,41,6,45
Berwick,9904,8,8,10,18,29,61,-32,34
Edinburgh Ci,9904,9,7,9,20,36,62,-26,30
Cowdenbeath,9904,10,4,11,21,23,54,-31,23
Peterhead,9905,1,24,4,8,81,40,41,76
Montrose,9905,2,23,7,6,60,36,24,76
Stenhousem'r,9905,3,16,8,12,59,49,10,56
Stirling,9905,4,16,6,14,63,55,8,54
Clyde,9905,5,15,9,12,54,50,4,54
Elgin,9905,6,15,6,15,55,61,-6,51
Annan Athlet,9905,7,12,11,13,49,42,7,47
Berwick,9905,8,8,10,18,31,61,-30,34
Edinburgh Ci,9905,9,7,9,20,38,64,-26,30
Cowdenbeath,9905,10,4,10,22,24,56,-32,22
Montrose,9906,1,23,8,5,61,36,25,77
Peterhead,9906,2,24,4,8,81,38,43,76
Stirling,9906,3,16,7,13,62,53,9,55
Stenhousem'r,9906,4,15,9,12,57,48,9,54
Clyde,9906,5,15,9,12,54,48,6,54
Elgin,9906,6,14,7,15,55,62,-7,49
Annan Athlet,9906,7,11,11,14,48,43,5,44
Berwick,9906,8,8,10,18,29,61,-32,34
Edinburgh Ci,9906,9,7,9,20,36,64,-28,30
Cowdenbeath,9906,10,5,10,21,25,55,-30,25
Montrose,9907,1,24,7,5,61,35,26,79
Peterhead,9907,2,24,4,8,80,38,42,76
Stenhousem'r,9907,3,16,8,12,57,47,10,56
Stirling,9907,4,16,6,14,61,53,8,54
Clyde,9907,5,15,9,12,52,48,4,54
Elgin,9907,6,14,6,16,54,62,-8,48
Annan Athlet,9907,7,11,11,14,49,46,3,44
Berwick,9907,8,8,10,18,29,59,-30,34
Edinburgh Ci,9907,9,7,9,20,36,63,-27,30
Cowdenbeath,9907,10,5,10,21,28,56,-28,25
Montrose,9908,1,24,7,5,62,35,27,79
Peterhead,9908,2,23,4,9,77,39,38,73
Stirling,9908,3,17,6,13,61,51,10,57
Clyde,9908,4,15,9,12,55,48,7,54
Stenhousem'r,9908,5,15,8,13,55,47,8,53
Elgin,9908,6,14,6,16,54,63,-9,48
Annan Athlet,9908,7,12,11,13,49,41,8,47
Berwick,9908,8,8,10,18,29,62,-33,34
Edinburgh Ci,9908,9,8,9,19,37,60,-23,33
Cowdenbeath,9908,10,4,10,22,23,56,-33,22
Montrose,9909,1,24,7,5,63,36,27,79
Peterhead,9909,2,23,5,8,77,38,39,74
Stenhousem'r,9909,3,16,8,12,57,47,10,56
Stirling,9909,4,16,6,14,61,53,8,54
Clyde,9909,5,15,9,12,54,50,4,54
Elgin,9909,6,14,6,16,55,64,-9,48
Annan Athlet,9909,7,11,12,13,49,43,6,45
Berwick,9909,8,8,10,18,31,61,-30,34
Edinburgh Ci,9909,9,7,10,19,36,60,-24,31
Cowdenbeath,9909,10,4,11,21,25,56,-31,23
Montrose,9910,1,23,8,5,63,38,25,77
Peterhead,9910,2,24,4,8,82,39,43,76
Stirling,9910,3,17,6,13,63,51,12,57
Stenhousem'r,9910,4,15,8,13,55,49,6,53
Clyde,9910,5,14,9,13,51,50,1,51
Elgin,9910,6,14,7,15,57,64,-7,49
Annan Athlet,9910,7,11,11,14,48,44,4,44
Berwick,9910,8,9,10,17,31,58,-27,37
Edinburgh Ci,9910,9,7,9,20,37,65,-28,30
Cowdenbeath,9910,10,5,10,21,26,55,-29,25
Montrose,9911,1,23,8,5,59,34,25,77
Peterhead,9911,2,23,5,8,78,39,39,74
Stenhousem'r,9911,3,16,8,12,58,48,10,56
Stirling,9911,4,16,6,14,62,54,8,54
Clyde,9911,5,14,10,12,52,49,3,52
Elgin,9911,6,14,7,15,53,60,-7,49
Annan Athlet,9911,7,11,12,13,47,41,6,45
Berwick,9911,8,8,11,17,30,59,-29,35
Edinburgh Ci,9911,9,7,10,19,37,61,-24,31
Cowdenbeath,9911,10,4,11,21,23,54,-31,23
Peterhead,9912,1,24,4,8,79,38,41,76
Montrose,9912,2,23,7,6,60,36,24,76
Stirling,9912,3,17,6,13,63,51,12,57
Clyde,9912,4,15,9,12,54,48,6,54
Stenhousem'r,9912,5,15,8,13,55,49,6,53
Elgin,9912,6,15,6,15,55,61,-6,51
Annan Athlet,9912,7,12,11,13,49,42,7,47
Berwick,9912,8,8,10,18,29,61,-32,34
Edinburgh Ci,9912,9,7,9,20,36,62,-26,30
Cowdenbeath,9912,10,4,10,22,24,56,-32,22
Montrose,9913,1,23,8,5,59,34,25,77
Peterhead,9913,2,23,5,8,79,40,39,74
Stirling,9913,3,17,6,13,61,51,10,57
Clyde,9913,4,15,9,12,55,50,5,54
Stenhousem'r,9913,5,15,8,13,55,47,8,53
Elgin,9913,6,14,7,15,53,60,-7,49
Annan Athlet,9913,7,11,11,14,48,44,4,44
Berwick,9913,8,8,10,18,31,62,-31,34
Edinburgh Ci,9913,9,7,10,19,38,62,-24,31
Cowdenbeath,9913,10,5,10,21,26,55,-29,25
Montrose,9914,1,24,7,5,62,35,27,79
Peterhead,9914,2,23,5,8,78,39,39,74
Stirling,9914,3,17,6,13,62,51,11,57
Stenhousem'r,9914,4,15,8,13,55,48,7,53
Clyde,9914,5,14,10,12,53,50,3,52
Elgin,9914,6,14,6,16,54,63,-9,48
Annan Athlet,9914,7,12,11,13,48,41,7,47
Berwick,9914,8,8,11,17,31,60,-29,35
Edinburgh Ci,9914,9,7,10,19,37,61,-24,31
Cowdenbeath,9914,10,4,10,22,23,55,-32,22
Montrose,9915,1,24,7,5,62,35,27,79
Peterhead,9915,2,23,5,8,78,39,39,74
Stirling,9915,3,17,6,13,63,52,11,57
Clyde,9915,4,15,9,12,55,49,6,54
Stenhousem'r,9915,5,15,8,13,56,49,7,53
Elgin,9915,6,14,6,16,54,63,-9,48
Annan Athlet,9915,7,11,12,13,47,41,6,45
Berwick,9915,8,8,10,18,30,62,-32,34
Edinburgh Ci,9915,9,7,10,19,37,61,-24,31
Cowdenbeath,9915,10,4,11,21,23,54,-31,23
Montrose,9916,1,24,7,5,63,35,28,79
Peterhead,9916,2,24,4,8,81,39,42,76
Stirling,9916,3,16,7,13,62,53,9,55
Stenhousem'r,9916,4,15,9,12,57,48,9,54
Clyde,9916,5,14,9,13,52,50,2,51
Elgin,9916,6,14,6,16,54,64,-10,48
Annan Athlet,9916,7,11,12,13,48,42,6,45
Berwick,9916,8,9,10,17,31,59,-28,37
Edinburgh Ci,9916,9,7,9,20,37,64,-27,30
Cowdenbeath,9916,10,4,11,21,24,55,-31,23
Montrose,9917,1,24,7,5,62,34,28,79
Peterhead,9917,2,24,4,8,82,39,43,76
Stirling,9917,3,16,7,13,61,52,9,55
Stenhousem'r,9917,4,15,9,12,56,47,9,54
Clyde,9917,5,15,9,12,53,48,5,54
Elgin,9917,6,14,6,16,53,63,-10,48
Annan Athlet,9917,7,12,11,13,48,41,7,47
Berwick,9917,8,8,10,18,29,60,-31,34
Edinburgh Ci,9917,9,7,9,20,37,65,-28,30
Cowdenbeath,9917,10,4,10,22,23,55,-32,22
Montrose,9918,1,23,8,5,61,36,25,77
Peterhead,9918,2,24,4,8,78,38,40,76
Stirling,9918,3,16,7,13,61,52,9,55
Stenhousem'r,9918,4,15,9,12,56,47,9,54
Clyde,9918,5,14,9,13,51,49,2,51
Elgin,9918,6,14,7,15,55,62,-7,49
Annan Athlet,9918,7,12,11,13,48,41,7,47
Berwick,9918,8,9,10,17,30,58,-28,37
Edinburgh Ci,9918,9,7,9,20,36,61,-25,30
Cowdenbeath,9918,10,4,10,22,23,55,-32,22
Montrose,9919,1,24,7,5,62,35,27,79
Peterhead,9919,2,24,4,8,79,38,41,76
Stirling,9919,3,16,7,13,62,53,9,55
Stenhousem'r,9919,4,15,9,12,57,48,9,54
Clyde,9919,5,15,9,12,52,48,4,54
Elgin,9919,6,14,6,16,54,63,-9,48
Annan Athlet,9919,7,11,11,14,47,44,3,44
Berwick,9919,8,8,10,18,29,59,-30,34
Edinburgh Ci,9919,9,7,9,20,36,62,-26,30
Cowdenbeath,9919,10,5,10,21,26,54,-28,25
Montrose,9920,1,24,7,5,61,34,27,79
Peterhead,9920,2,24,4,8,79,39,40,76
Stirling,9920,3,17,6,13,62,52,10,57
Clyde,9920,4,15,9,12,53,49,4,54
Stenhousem'r,9920,5,15,8,13,56,48,8,53
Elgin,9920,6,14,6,16,53,62,-9,48
Annan Athlet,9920,7,11,12,13,48,42,6,45
Berwick,9920,8,8,10,18,30,60,-30,34
Edinburgh Ci,9920,9,7,9,20,37,62,-25,30
Cowdenbeath,9920,10,4,11,21,24,55,-31,23
Peterhead,9921,1,24,4,8,79,38,41,76
Montrose,9921,2,23,7,6,60,36,24,76
Stenhousem'r,9921,3,16,8,12,58,47,11,56
Stirling,9921,4,16,6,14,61,54,7,54
Clyde,9921,5,15,9,12,52,48,4,54
Elgin,9921,6,15,6,15,55,61,-6,51
Annan Athlet,9921,7,12,11,13,50,41,9,47
Berwick,9921,8,8,10,18,29,59,-30,34
Edinburgh Ci,9921,9,7,9,20,36,62,-26,30
Cowdenbeath,9921,10,4,10,22,23,57,-34,22
Montrose,9922,1,24,7,5,60,34,26,79
Peterhead,9922,2,24,4,8,80,38,42,76
Stirling,9922,3,17,6,13,63,52,11,57
Clyde,9922,4,15,9,12,53,48,5,54
Stenhousem'r,9922,5,15,8,13,56,49,7,53
Elgin,9922,6,14,6,16,53,61,-8,48
Annan Athlet,9922,7,11,11,14,48,43,5,44
Berwick,9922,8,8,10,18,29,60,-31,34
Edinburgh Ci,9922,9,7,9,20,36,63,-27,30
Cowdenbeath,9922,10,5,10,21,25,55,-30,25
Montrose,9923,1,24,7,5,62,36,26,79
Peterhead,9923,2,24,4,8,80,39,41,76
Stirling,9923,3,17,6,13,62,51,11,57
Clyde,9923,4,15,9,12,54,49,5,54
Stenhousem'r,9923,5,15,8,13,55,48,7,53
Elgin,9923,6,14,6,16,55,63,-8,48
Annan Athlet,9923,7,11,12,13,48,42,6,45
Berwick,9923,8,8,10,18,30,61,-31,34
Edinburgh Ci,9923,9,7,9,20,37,63,-26,30
Cowdenbeath,9923,10,4,11,21,24,55,-31,23
Montrose,9924,1,23,8,5,61,36,25,77
Peterhead,9924,2,24,4,8,79,38,41,76
Stenhousem'r,9924,3,16,8,12,57,46,11,56
Stirling,9924,4,16,6,14,60,53,7,54
Clyde,9924,5,14,10,12,52,49,3,52
Elgin,9924,6,14,7,15,55,62,-7,49
Annan Athlet,9924,7,11,11,14,47,43,4,44
Berwick,9924,8,8,11,17,30,59,-29,35
Edinburgh Ci,9924,9,7,9,20,36,62,-26,30
Cowdenbeath,9924,10,5,10,21,25,54,-29,25
Montrose,9925,1,24,7,5,64,35,29,79
Peterhead,9925,2,24,4,8,79,38,41,76
Stirling,9925,3,17,6,13,62,52,10,57
Stenhousem'r,9925,4,15,8,13,56,48,8,53
Clyde,9925,5,14,10,12,52,49,3,52
Elgin,9925,6,14,6,16,54,65,-11,48
Annan Athlet,9925,7,12,11,13,50,41,9,47
Berwick,9925,8,8,11,17,30,59,-29,35
Edinburgh Ci,9925,9,7,9,20,36,62,-26,30
Cowdenbeath,9925,10,4,10,22,23,57,-34,22
Montrose,9926,1,23,8,5,59,34,25,77
Peterhead,9926,2,24,4,8,79,38,41,76
Stirling,9926,3,17,6,13,61,51,10,57
Clyde,9926,4,15,9,12,54,50,4,54
Stenhousem'r,9926,5,15,8,13,55,47,8,53
Elgin,9926,6,14,7,15,53,60,-7,49
Annan Athlet,9926,7,11,12,13,47,41,6,45
Berwick,9926,8,8,10,18,31,61,-30,34
Edinburgh Ci,9926,9,7,9,20,36,62,-26,30
Cowdenbeath,9926,10,4,11,21,23,54,-31,23
Montrose,9927,1,23,8,5,60,35,25,77
Peterhead,9927,2,24,4,8,80,38,42,76
Stirling,9927,3,17,6,13,64,53,11,57
Clyde,9927,4,15,9,12,55,49,6,54
Stenhousem'r,9927,5,15,8,13,57,50,7,53
Elgin,9927,6,14,7,15,54,61,-7,49
Annan Athlet,9927,7,12,11,13,48,41,7,47
Berwick,9927,8,8,10,18,30,62,-32,34
Edinburgh Ci,9927,9,7,9,20,36,63,-27,30
Cowdenbeath,9927,10,4,10,22,23,55,-32,22
Montrose,9928,1,24,7,5,61,34,27,79
Peterhead,9928,2,24,4,8,80,40,40,76
Stirling,9928,3,16,7,13,61,52,9,55
Stenhousem'r,9928,4,15,9,12,56,47,9,54
Clyde,9928,5,15,9,12,52,48,4,54
Elgin,9928,6,14,6,16,53,62,-9,48
Annan Athlet,9928,7,11,11,14,48,43,5,44
Berwick,9928,8,8,10,18,29,59,-30,34
Edinburgh Ci,9928,9,7,9,20,38,63,-25,30
Cowdenbeath,9928,10,5,10,21,25,55,-30,25
Montrose,9929,1,23,8,5,60,35,25,77
Peterhead,9929,2,23,5,8,78,39,39,74
Stenhousem'r,9929,3,16,8,12,58,48,10,56
Stirling,9929,4,16,6,14,62,54,8,54
Clyde,9929,5,15,9,12,52,48,4,54
Elgin,9929,6,14,7,15,54,61,-7,49
Annan Athlet,9929,7,12,11,13,50,43,7,47
Berwick,9929,8,8,10,18,29,59,-30,34
Edinburgh Ci,9929,9,7,10,19,37,61,-24,31
Cowdenbeath,9929,10,4,10,22,25,57,-32,22
Montrose,9930,1,24,7,5,61,34,27,79
Peterhead,9930,2,24,4,8,83,39,44,76
Stirling,9930,3,17,6,13,62,51,11,57
Stenhousem'r,9930,4,15,8,13,55,48,7,53
Clyde,9930,5,14,10,12,52,49,3,52
Elgin,9930,6,14,6,16,53,62,-9,48
Annan Athlet,9930,7,11,12,13,47,41,6,45
Berwick,9930,8,8,11,17,30,59,-29,35
Edinburgh Ci,9930,9,7,9,20,37,66,-29,30
Cowdenbeath,9930,10,4,11,21,23,54,-31,23
Montrose,9931,1,24,7,5,63,34,29,79
Peterhead,9931,2,24,4,8,79,39,40,76
Stirling,9931,3,16,7,13,60,51,9,55
Stenhousem'r,9931,4,15,9,12,55,46,9,54
Clyde,9931,5,15,9,12,53,49,4,54
Elgin,9931,6,14,6,16,53,64,-11,48
Annan Athlet,9931,7,11,11,14,47,43,4,44
Berwick,9931,8,8,10,18,30,60,-30,34
Edinburgh Ci,9931,9,7,9,20,37,62,-25,30
Cowdenbeath,9931,10,5,10,21,25,54,-29,25
Montrose,9932,1,24,7,5,63,34,29,79
Peterhead,9932,2,23,5,8,78,39,39,74
Stenhousem'r,9932,3,16,8,12,56,46,10,56
Stirling,9932,4,16,6,14,60,52,8,54
Clyde,9932,5,14,10,12,51,48,3,52
Elgin,9932,6,14,6,16,53,64,-11,48
Annan Athlet,9932,7,12,11,13,49,41,8,47
Berwick,9932,8,8,11,17,29,58,-29,35
Edinburgh Ci,9932,9,7,10,19,37,61,-24,31
Cowdenbeath,9932,10,4,10,22,23,56,-33,22
Montrose,9933,1,24,7,5,64,35,29,79
Peterhead,9933,2,23,5,8,78,39,39,74
Stenhousem'r,9933,3,16,8,12,57,46,11,56
Stirling,9933,4,16,6,14,60,53,7,54
Clyde,9933,5,15,9,12,54,49,5,54
Elgin,9933,6,14,6,16,54,65,-11,48
Annan Athlet,9933,7,12,11,13,48,41,7,47
Berwick,9933,8,8,10,18,30,61,-31,34
Edinburgh Ci,9933,9,7,10,19,37,61,-24,31
Cowdenbeath,9933,10,4,10,22,23,55,-32,22
Peterhead,9934,1,24,4,8,81,39,42,76
Montrose,9934,2,23,7,6,61,37,24,76
Stirling,9934,3,17,6,13,62,51,11,57
Clyde,9934,4,15,9,12,53,48,5,54
Stenhousem'r,9934,5,15,8,13,55,48,7,53
Elgin,9934,6,15,6,15,56,62,-6,51
Annan Athlet,9934,7,12,11,13,48,41,7,47
Berwick,9934,8,8,10,18,29,60,-31,34
Edinburgh Ci,9934,9,7,9,20,37,64,-27,30
Cowdenbeath,9934,10,4,10,22,23,55,-32,22
Peterhead,9935,1,24,4,8,80,39,41,76
Montrose,9935,2,23,7,6,60,37,23,76
Stirling,9935,3,17,6,13,62,51,11,57
Clyde,9935,4,15,9,12,52,48,4,54
Stenhousem'r,9935,5,15,8,13,55,48,7,53
Elgin,9935,6,15,6,15,56,61,-5,51
Annan Athlet,9935,7,11,12,13,48,42,6,45
Berwick,9935,8,8,10,18,29,59,-30,34
Edinburgh Ci,9935,9,7,9,20,37,63,-26,30
Cowdenbeath,9935,10,4,11,21,24,55,-31,23
Peterhead,9936,1,24,4,8,79,38,41,76
Montrose,9936,2,23,7,6,60,36,24,76
Stenhousem'r,9936,3,16,8,12,56,46,10,56
Stirling,9936,4,16,6,14,60,52,8,54
Clyde,9936,5,14,10,12,53,50,3,52
Elgin,9936,6,15,6,15,55,61,-6,51
Annan Athlet,9936,7,12,11,13,48,41,7,47
Berwick,9936,8,8,11,17,31,60,-29,35
Edinburgh Ci,9936,9,7,9,20,36,62,-26,30
Cowdenbeath,9936,10,4,10,22,23,55,-32,22
Montrose,9937,1,24,7,5,60,34,26,79
Peterhead,9937,2,24,4,8,78,38,40,76
Stirling,9937,3,16,7,13,61,52,9,55
Stenhousem'r,9937,4,15,9,12,56,47,9,54
Clyde,9937,5,14,10,12,52,49,3,52
Elgin,9937,6,14,6,16,53,61,-8,48
Annan Athlet,9937,7,11,12,13,47,41,6,45
Berwick,9937,8,8,11,17,30,59,-29,35
Edinburgh Ci,9937,9,7,9,20,36,61,-25,30
Cowdenbeath,9937,10,4,11,21,23,54,-31,23
Montrose,9938,1,24,7,5,61,35,26,79
Peterhead,9938,2,24,4,8,80,39,41,76
Stirling,9938,3,17,6,13,62,52,10,57
Stenhousem'r,9938,4,15,8,13,56,48,8,53
Clyde,9938,5,14,10,12,53,50,3,52
Elgin,9938,6,14,6,16,54,62,-8,48
Annan Athlet,9938,7,11,11,14,48,43,5,44
Berwick,9938,8,8,11,17,31,60,-29,35
Edinburgh Ci,9938,9,7,9,20,37,63,-26,30
Cowdenbeath,9938,10,5,10,21,25,55,-30,25
Montrose,9939,1,24,7,5,65,35,30,79
Peterhead,9939,2,24,4,8,80,38,42,76
Stirling,9939,3,17,6,13,63,52,11,57
Clyde,9939,4,15,9,12,54,48,6,54
Stenhousem'r,9939,5,15,8,13,56,49,7,53
Elgin,9939,6,14,6,16,54,66,-12,48
Annan Athlet,9939,7,12,11,13,48,41,7,47
Berwick,9939,8,8,10,18,29,61,-32,34
Edinburgh Ci,9939,9,7,9,20,36,63,-27,30
Cowdenbeath,9939,10,4,10,22,23,55,-32,22
Montrose,9940,1,24,7,5,60,34,26,79
Peterhead,9940,2,24,4,8,78,38,40,76
Stenhousem'r,9940,3,16,8,12,58,46,12,56
Stirling,9940,4,16,6,14,60,54,6,54
Clyde,9940,5,14,9,13,52,50,2,51
Elgin,9940,6,14,6,16,53,61,-8,48
Annan Athlet,9940,7,11,11,14,47,42,5,44
Berwick,9940,8,9,10,17,31,59,-28,37
Edinburgh Ci,9940,9,7,9,20,36,61,-25,30
Cowdenbeath,9940,10,5,10,21,24,54,-30,25
Peterhead,9941,1,24,4,8,81,38,43,76
Montrose,9941,2,23,7,6,59,35,24,76
Stenhousem'r,9941,3,16,8,12,57,46,11,56
Stirling,9941,4,16,6,14,60,53,7,54
Clyde,9941,5,14,9,13,51,49,2,51
Elgin,9941,6,15,6,15,54,60,-6,51
Annan Athlet,9941,7,11,11,14,47,42,5,44
Berwick,9941,8,9,10,17,30,58,-28,37
Edinburgh Ci,9941,9,7,9,20,36,64,-28,30
Cowdenbeath,9941,10,5,10,21,24,54,-30,25
Montrose,9942,1,24,7,5,61,35,26,79
Peterhead,9942,2,24,4,8,78,38,40,76
Stenhousem'r,9942,3,16,8,12,59,47,12,56
Stirling,9942,4,16,6,14,61,55,6,54
Clyde,9942,5,14,9,13,52,50,2,51
Elgin,9942,6,14,6,16,54,62,-8,48
Annan Athlet,9942,7,12,11,13,49,41,8,47
Berwick,9942,8,9,10,17,31,59,-28,37
Edinburgh Ci,9942,9,7,9,20,36,61,-25,30
Cowdenbeath,9942,10,4,10,22,23,56,-33,22
Montrose,9943,1,24,7,5,60,34,26,79
Peterhead,9943,2,24,4,8,81,38,43,76
Stirling,9943,3,16,7,13,60,51,9,55
Stenhousem'r,9943,4,15,9,12,55,46,9,54
Clyde,9943,5,14,10,12,52,49,3,52
Elgin,9943,6,14,6,16,53,61,-8,48
Annan Athlet,9943,7,11,11,14,48,43,5,44
Berwick,9943,8,8,11,17,30,59,-29,35
Edinburgh Ci,9943,9,7,9,20,36,64,-28,30
Cowdenbeath,9943,10,5,10,21,25,55,-30,25
Montrose,9944,1,23,8,5,61,36,25,77
Peterhead,9944,2,24,4,8,79,38,41,76
Stirling,9944,3,17,6,13,62,51,11,57
Clyde,9944,4,15,9,12,53,48,5,54
Stenhousem'r,9944,5,15,8,13,55,48,7,53
Elgin,9944,6,14,7,15,55,62,-7,49
Annan Athlet,9944,7,11,12,13,47,41,6,45
Berwick,9944,8,8,10,18,29,60,-31,34
Edinburgh Ci,9944,9,7,9,20,36,62,-26,30
Cowdenbeath,9944,10,4,11,21,23,54,-31,23
Montrose,9945,1,23,8,5,60,35,25,77
Peterhead,9945,2,24,4,8,82,38,44,76
Stenhousem'r,9945,3,16,8,12,57,47,10,56
Stirling,9945,4,16,6,14,61,53,8,54
Clyde,9945,5,14,10,12,51,48,3,52
Elgin,9945,6,14,7,15,54,61,-7,49
Annan Athlet,9945,7,11,12,13,48,42,6,45
Berwick,9945,8,8,11,17,29,58,-29,35
Edinburgh Ci,9945,9,7,9,20,36,65,-29,30
Cowdenbeath,9945,10,4,11,21,24,55,-31,23
Montrose,9946,1,23,7,6,59,35,24,76
Peterhead,9946,2,23,4,9,79,41,38,73
Stirling,9946,3,17,6,13,61,51,10,57
Clyde,9946,4,15,9,12,53,49,4,54
Stenhousem'r,9946,5,15,8,13,55,47,8,53
Elgin,9946,6,15,6,15,54,60,-6,51
Annan Athlet,9946,7,11,11,14,48,45,3,44
Berwick,9946,8,8,10,18,30,60,-30,34
Edinburgh Ci,9946,9,8,9,19,39,62,-23,33
Cowdenbeath,9946,10,5,10,21,27,55,-28,25
Montrose,9947,1,24,7,5,60,34,26,79
Peterhead,9947,2,24,4,8,81,39,42,76
Stirling,9947,3,17,6,13,62,52,10,57
Stenhousem'r,9947,4,15,8,13,56,48,8,53
Clyde,9947,5,14,10,12,52,49,3,52
Elgin,9947,6,14,6,16,53,61,-8,48
Annan Athlet,9947,7,11,12,13,48,42,6,45
Berwick,9947,8,8,11,17,30,59,-29,35
Edinburgh Ci,9947,9,7,9,20,37,64,-27,30
Cowdenbeath,9947,10,4,11,21,24,55,-31,23
Montrose,9948,1,24,7,5,63,36,27,79
Peterhead,9948,2,24,4,8,79,39,40,76
Stirling,9948,3,17,6,13,65,51,14,57
Stenhousem'r,9948,4,15,8,13,55,51,4,53
Clyde,9948,5,14,9,13,51,51,0,51
Elgin,9948,6,14,6,16,55,64,-9,48
Annan Athlet,9948,7,11,12,13,47,41,6,45
Berwick,9948,8,9,10,17,32,58,-26,37
Edinburgh Ci,9948,9,7,9,20,37,62,-25,30
Cowdenbeath,9948,10,4,11,21,23,54,-31,23
Montrose,9949,1,23,7,6,59,35,24,76
Peterhead,9949,2,23,5,8,78,39,39,74
Stirling,9949,3,16,7,13,61,52,9,55
Stenhousem'r,9949,4,15,9,12,56,47,9,54
Clyde,9949,5,14,10,12,52,49,3,52
Elgin,9949,6,15,6,15,54,60,-6,51
Annan Athlet,9949,7,11,11,14,47,43,4,44
Berwick,9949,8,8,11,17,30,59,-29,35
Edinburgh Ci,9949,9,7,10,19,37,61,-24,31
Cowdenbeath,9949,10,5,10,21,25,54,-29,25
Montrose,9950,1,23,8,5,59,34,25,77
Peterhead,9950,2,23,5,8,79,40,39,74
Stirling,9950,3,16,7,13,61,52,9,55
Stenhousem'r,9950,4,15,9,12,56,47,9,54
Clyde,9950,5,14,10,12,51,48,3,52
Elgin,9950,6,14,7,15,53,60,-7,49
Annan Athlet,9950,7,12,11,13,48,41,7,47
Berwick,9950,8,8,11,17,29,58,-29,35
Edinburgh Ci,9950,9,7,10,19,38,62,-24,31
Cowdenbeath,9950,10,4,10,22,23,55,-32,22
Montrose,9951,1,24,7,5,64,34,30,79
Peterhead,9951,2,24,4,8,81,38,43,76
Stirling,9951,3,17,6,13,62,52,10,57
Stenhousem'r,9951,4,15,8,13,56,48,8,53
Clyde,9951,5,14,10,12,51,48,3,52
Elgin,9951,6,14,6,16,53,65,-12,48
Annan Athlet,9951,7,12,11,13,49,41,8,47
Berwick,9951,8,8,11,17,29,58,-29,35
Edinburgh Ci,9951,9,7,9,20,36,64,-28,30
Cowdenbeath,9951,10,4,10,22,23,56,-33,22
Peterhead,9952,1,24,4,8,78,38,40,76
Montrose,9952,2,23,7,6,60,37,23,76
Stenhousem'r,9952,3,16,8,12,57,47,10,56
Stirling,9952,4,16,6,14,61,53,8,54
Clyde,9952,5,14,10,12,52,49,3,52
Elgin,9952,6,15,6,15,56,61,-5,51
Annan Athlet,9952,7,11,12,13,47,41,6,45
Berwick,9952,8,8,11,17,30,59,-29,35
Edinburgh Ci,9952,9,7,9,20,36,61,-25,30
Cowdenbeath,9952,10,4,11,21,23,54,-31,23
Montrose,9953,1,24,7,5,60,34,26,79
Peterhead,9953,2,24,4,8,80,40,40,76
Stirling,9953,3,17,6,13,61,51,10,57
Stenhousem'r,9953,4,15,8,13,55,47,8,53
Clyde,9953,5,14,10,12,52,49,3,52
Elgin,9953,6,14,6,16,53,61,-8,48
Annan Athlet,9953,7,11,11,14,47,43,4,44
Berwick,9953,8,8,11,17,30,59,-29,35
Edinburgh Ci,9953,9,7,9,20,38,63,-25,30
Cowdenbeath,9953,10,5,10,21,25,54,-29,25
Montrose,9954,1,24,7,5,61,35,26,79
Peterhead,9954,2,24,4,8,80,39,41,76
Stenhousem'r,9954,3,16,8,12,56,46,10,56
Stirling,9954,4,16,6,14,60,52,8,54
Clyde,9954,5,15,9,12,54,50,4,54
Elgin,9954,6,14,6,16,54,62,-8,48
Annan Athlet,9954,7,11,11,14,48,44,4,44
Berwick,9954,8,8,10,18,31,61,-30,34
Edinburgh Ci,9954,9,7,9,20,37,63,-26,30
Cowdenbeath,9954,10,5,10,21,26,55,-29,25
Montrose,9955,1,24,7,5,61,34,27,79
Peterhead,9955,2,23,5,8,78,39,39,74
Stirling,9955,3,16,7,13,61,52,9,55
Stenhousem'r,9955,4,15,9,12,56,47,9,54
Clyde,9955,5,15,9,12,53,49,4,54
Elgin,9955,6,14,6,16,53,62,-9,48
Annan Athlet,9955,7,11,11,14,47,44,3,44
Berwick,9955,8,8,10,18,30,60,-30,34
Edinburgh Ci,9955,9,7,10,19,37,61,-24,31
Cowdenbeath,9955,10,5,10,21,26,54,-28,25
Montrose,9956,1,24,7,5,61,35,26,79
Peterhead,9956,2,24,4,8,83,40,43,76
Stirling,9956,3,17,6,13,61,51,10,57
Clyde,9956,4,15,9,12,53,48,5,54
Stenhousem'r,9956,5,15,8,13,55,47,8,53
Elgin,9956,6,14,6,16,54,62,-8,48
Annan Athlet,9956,7,11,12,13,48,42,6,45
Berwick,9956,8,8,10,18,29,60,-31,34
Edinburgh Ci,9956,9,7,9,20,38,66,-28,30
Cowdenbeath,9956,10,4,11,21,24,55,-31,23
Peterhead,9957,1,24,4,8,80,39,41,76
Montrose,9957,2,23,7,6,61,37,24,76
Stirling,9957,3,16,7,13,61,52,9,55
Stenhousem'r,9957,4,15,9,12,56,47,9,54
Clyde,9957,5,14,9,13,51,49,2,51
Elgin,9957,6,15,6,15,56,62,-6,51
Annan Athlet,9957,7,12,11,13,49,42,7,47
Berwick,9957,8,9,10,17,30,58,-28,37
Edinburgh Ci,9957,9,7,9,20,37,63,-26,30
Cowdenbeath,9957,10,4,10,22,24,56,-32,22
Montrose,9958,1,24,7,5,62,35,27,79
Peterhead,9958,2,24,4,8,82,38,44,76
Stirling,9958,3,17,6,13,63,52,11,57
Clyde,9958,4,15,9,12,53,48,5,54
Stenhousem'r,9958,5,15,8,13,56,49,7,53
Elgin,9958,6,14,6,16,54,63,-9,48
Annan Athlet,9958,7,11,12,13,48,42,6,45
Berwick,9958,8,8,10,18,29,60,-31,34
Edinburgh Ci,9958,9,7,9,20,36,65,-29,30
Cowdenbeath,9958,10,4,11,21,24,55,-31,23
Montrose,9959,1,23,8,5,59,34,25,77
Peterhead,9959,2,24,4,8,80,39,41,76
Stenhousem'r,9959,3,16,8,12,57,46,11,56
Stirling,9959,4,16,6,14,60,53,7,54
Clyde,9959,5,14,10,12,52,49,3,52
Elgin,9959,6,14,7,15,53,60,-7,49
Annan Athlet,9959,7,12,11,13,49,41,8,47
Berwick,9959,8,8,11,17,30,59,-29,35
Edinburgh Ci,9959,9,7,9,20,37,63,-26,30
Cowdenbeath,9959,10,4,10,22,23,56,-33,22
Montrose,9960,1,24,7,5,63,34,29,79
Peterhead,9960,2,24,4,8,79,39,40,76
Stenhousem'r,9960,3,16,8,12,58,47,11,56
Stirling,9960,4,16,6,14,61,54,7,54
Clyde,9960,5,14,9,13,51,49,2,51
Elgin,9960,6,14,6,16,53,64,-11,48
Annan Athlet,9960,7,12,11,13,48,41,7,47
Berwick,9960,8,9,10,17,30,58,-28,37
Edinburgh Ci,9960,9,7,9,20,37,62,-25,30
Cowdenbeath,9960,10,4,10,22,23,55,-32,22
Montrose,9961,1,24,7,5,61,34,27,79
Peterhead,9961,2,24,4,8,80,38,42,76
Stirling,9961,3,17,6,13,62,52,10,57
Clyde,9961,4,15,9,12,55,50,5,54
Stenhousem'r,9961,5,15,8,13,56,48,8,53
Elgin,9961,6,14,6,16,53,62,-9,48
Annan Athlet,9961,7,11,11,14,47,43,4,44
Berwick,9961,8,8,10,18,31,62,-31,34
Edinburgh Ci,9961,9,7,9,20,36,63,-27,30
Cowdenbeath,9961,10,5,10,21,25,54,-29,25
Montrose,9962,1,23,8,5,60,35,25,77
Peterhead,9962,2,24,4,8,82,38,44,76
Stirling,9962,3,17,6,13,65,52,13,57
Clyde,9962,4,15,9,12,54,48,6,54
Stenhousem'r,9962,5,15,8,13,56,51,5,53
Elgin,9962,6,14,7,15,54,61,-7,49
Annan Athlet,9962,7,11,11,14,48,43,5,44
Berwick,9962,8,8,10,18,29,61,-32,34
Edinburgh Ci,9962,9,7,9,20,36,65,-29,30
Cowdenbeath,9962,10,5,10,21,25,55,-30,25
Montrose,9963,1,24,7,5,61,35,26,79
Peterhead,9963,2,24,4,8,78,38,40,76
Stirling,9963,3,16,7,13,63,54,9,55
Stenhousem'r,9963,4,15,9,12,58,49,9,54
Clyde,9963,5,15,9,12,53,49,4,54
Elgin,9963,6,14,6,16,54,62,-8,48
Annan Athlet,9963,7,12,11,13,51,42,9,47
Berwick,9963,8,8,10,18,30,60,-30,34
Edinburgh Ci,9963,9,7,9,20,36,61,-25,30
Cowdenbeath,9963,10,4,10,22,24,58,-34,22
Montrose,9964,1,24,7,5,60,34,26,79
Peterhead,9964,2,24,4,8,82,38,44,76
Stirling,9964,3,16,7,13,61,52,9,55
Stenhousem'r,9964,4,15,9,12,56,47,9,54
Clyde,9964,5,14,10,12,54,51,3,52
Elgin,9964,6,14,6,16,53,61,-8,48
Annan Athlet,9964,7,11,11,14,47,42,5,44
Berwick,9964,8,8,11,17,32,61,-29,35
Edinburgh Ci,9964,9,7,9,20,36,65,-29,30
Cowdenbeath,9964,10,5,10,21,24,54,-30,25
Montrose,9965,1,23,8,5,59,34,25,77
Peterhead,9965,2,23,4,9,77,40,37,73
Stirling,9965,3,17,6,13,62,52,10,57
Stenhousem'r,9965,4,15,8,13,56,48,8,53
Clyde,9965,5,14,9,13,51,50,1,51
Elgin,9965,6,14,7,15,53,60,-7,49
Annan Athlet,9965,7,12,11,13,49,41,8,47
Berwick,9965,8,9,10,17,31,58,-27,37
Edinburgh Ci,9965,9,8,9,19,38,60,-22,33
Cowdenbeath,9965,10,4,10,22,23,56,-33,22
Montrose,9966,1,24,7,5,61,35,26,79
Peterhead,9966,2,24,4,8,80,38,42,76
Stirling,9966,3,17,6,13,64,52,12,57
Clyde,9966,4,15,9,12,54,49,5,54
Stenhousem'r,9966,5,15,8,13,56,50,6,53
Elgin,9966,6,14,6,16,54,62,-8,48
Annan Athlet,9966,7,12,11,13,50,41,9,47
Berwick,9966,8,8,10,18,30,61,-31,34
Edinburgh Ci,9966,9,7,9,20,36,63,-27,30
Cowdenbeath,9966,10,4,10,22,23,57,-34,22
Montrose,9967,1,24,7,5,61,35,26,79
Peterhead,9967,2,24,4,8,80,40,40,76
Stirling,9967,3,17,6,13,63,52,11,57
Clyde,9967,4,15,9,12,55,49,6,54
Stenhousem'r,9967,5,15,8,13,56,49,7,53
Elgin,9967,6,14,6,16,54,62,-8,48
Annan Athlet,9967,7,11,12,13,48,42,6,45
Berwick,9967,8,8,10,18,30,62,-32,34
Edinburgh Ci,9967,9,7,9,20,38,63,-25,30
Cowdenbeath,9967,10,4,11,21,24,55,-31,23
Montrose,9968,1,24,7,5,60,34,26,79
Peterhead,9968,2,24,4,8,79,39,40,76
Stenhousem'r,9968,3,16,8,12,60,47,13,56
Clyde,9968,4,15,9,12,55,48,7,54
Stirling,9968,5,16,6,14,61,56,5,54
Elgin,9968,6,14,6,16,53,61,-8,48
Annan Athlet,9968,7,12,11,13,51,42,9,47
Berwick,9968,8,8,10,18,29,62,-33,34
Edinburgh Ci,9968,9,7,9,20,37,62,-25,30
Cowdenbeath,9968,10,4,10,22,24,58,-34,22
Montrose,9969,1,24,7,5,63,34,29,79
Peterhead,9969,2,24,4,8,79,39,40,76
Stirling,9969,3,17,6,13,62,52,10,57
Clyde,9969,4,15,9,12,52,48,4,54
Stenhousem'r,9969,5,15,8,13,56,48,8,53
Elgin,9969,6,14,6,16,53,64,-11,48
Annan Athlet,9969,7,11,11,14,47,42,5,44
Berwick,9969,8,8,10,18,29,59,-30,34
Edinburgh Ci,9969,9,7,9,20,37,62,-25,30
Cowdenbeath,9969,10,5,10,21,24,54,-30,25
Montrose,9970,1,24,7,5,62,35,27,79
Peterhead,9970,2,24,4,8,83,38,45,76
Stirling,9970,3,16,7,13,61,52,9,55
Stenhousem'r,9970,4,15,9,12,56,47,9,54
Clyde,9970,5,15,9,12,53,49,4,54
Elgin,9970,6,14,6,16,54,63,-9,48
Annan Athlet,9970,7,12,11,13,49,41,8,47
Berwick,9970,8,8,10,18,30,60,-30,34
Edinburgh Ci,9970,9,7,9,20,36,66,-30,30
Cowdenbeath,9970,10,4,10,22,23,56,-33,22
Montrose,9971,1,23,8,5,60,35,25,77
Peterhead,9971,2,23,4,9,79,42,37,73
Stirling,9971,3,17,6,13,63,53,10,57
Clyde,9971,4,15,9,12,52,48,4,54
Stenhousem'r,9971,5,15,8,13,57,49,8,53
Elgin,9971,6,14,7,15,54,61,-7,49
Annan Athlet,9971,7,11,11,14,48,44,4,44
Berwick,9971,8,8,10,18,29,59,-30,34
Edinburgh Ci,9971,9,8,9,19,40,62,-22,33
Cowdenbeath,9971,10,5,10,21,26,55,-29,25
Montrose,9972,1,24,7,5,62,35,27,79
Peterhead,9972,2,24,4,8,81,38,43,76
Stirling,9972,3,17,6,13,61,51,10,57
Stenhousem'r,9972,4,15,8,13,55,47,8,53
Clyde,9972,5,14,10,12,51,48,3,52
Elgin,9972,6,14,6,16,54,63,-9,48
Annan Athlet,9972,7,12,11,13,49,42,7,47
Berwick,9972,8,8,11,17,29,58,-29,35
Edinburgh Ci,9972,9,7,9,20,36,64,-28,30
Cowdenbeath,9972,10,4,10,22,24,56,-32,22
Montrose,9973,1,24,7,5,61,34,27,79
Peterhead,9973,2,24,4,8,79,38,41,76
Stirling,9973,3,16,7,13,60,51,9,55
Stenhousem'r,9973,4,15,9,12,55,46,9,54
Clyde,9973,5,14,9,13,51,50,1,51
Elgin,9973,6,14,6,16,53,62,-9,48
Annan Athlet,9973,7,11,12,13,49,43,6,45
Berwick,9973,8,9,10,17,31,58,-27,37
Edinburgh Ci,9973,9,7,9,20,36,62,-26,30
Cowdenbeath,9973,10,4,11,21,25,56,-31,23
Montrose,9974,1,24,7,5,62,34,28,79
Peterhead,9974,2,24,4,8,80,39,41,76
Stirling,9974,3,17,6,13,65,52,13,57
Clyde,9974,4,15,9,12,54,49,5,54
Stenhousem'r,9974,5,15,8,13,56,51,5,53
Elgin,9974,6,14,6,16,53,63,-10,48
Annan Athlet,9974,7,11,12,13,49,43,6,45
Berwick,9974,8,8,10,18,30,61,-31,34
Edinburgh Ci,9974,9,7,9,20,37,63,-26,30
Cowdenbeath,9974,10,4,11,21,25,56,-31,23
Montrose,9975,1,24,7,5,63,35,28,79
Peterhead,9975,2,24,4,8,82,38,44,76
Stirling,9975,3,16,7,13,61,52,9,55
Stenhousem'r,9975,4,15,9,12,56,47,9,54
Clyde,9975,5,15,9,12,55,48,7,54
Elgin,9975,6,14,6,16,54,64,-10,48
Annan Athlet,9975,7,12,11,13,49,42,7,47
Berwick,9975,8,8,10,18,29,62,-33,34
Edinburgh Ci,9975,9,7,9,20,36,65,-29,30
Cowdenbeath,9975,10,4,10,22,24,56,-32,22
Montrose,9976,1,24,7,5,62,34,28,79
Peterhead,9976,2,24,4,8,80,39,41,76
Stenhousem'r,9976,3,16,8,12,57,47,10,56
Stirling,9976,4,16,6,14,61,53,8,54
Clyde,9976,5,14,10,12,51,48,3,52
Elgin,9976,6,14,6,16,53,63,-10,48
Annan Athlet,9976,7,11,11,14,48,43,5,44
Berwick,9976,8,8,11,17,29,58,-29,35
Edinburgh Ci,9976,9,7,9,20,37,63,-26,30
Cowdenbeath,9976,10,5,10,21,25,55,-30,25
Montrose,9977,1,24,7,5,62,35,27,79
Peterhead,9977,2,24,4,8,81,38,43,76
Stirling,9977,3,16,7,13,61,52,9,55
Stenhousem'r,9977,4,15,9,12,56,47,9,54
Clyde,9977,5,14,9,13,52,50,2,51
Elgin,9977,6,14,6,16,54,63,-9,48
Annan Athlet,9977,7,11,11,14,47,42,5,44
Berwick,9977,8,9,10,17,31,59,-28,37
Edinburgh Ci,9977,9,7,9,20,36,64,-28,30
Cowdenbeath,9977,10,5,10,21,24,54,-30,25
Montrose,9978,1,24,7,5,61,35,26,79
Peterhead,9978,2,23,5,8,78,39,39,74
Stirling,9978,3,17,6,13,64,53,11,57
Stenhousem'r,9978,4,15,8,13,57,50,7,53
Clyde,9978,5,14,10,12,51,48,3,52
Elgin,9978,6,14,6,16,54,62,-8,48
Annan Athlet,9978,7,12,11,13,49,42,7,47
Berwick,9978,8,8,11,17,29,58,-29,35
Edinburgh Ci,9978,9,7,10,19,37,61,-24,31
Cowdenbeath,9978,10,4,10,22,24,56,-32,22
Montrose,9979,1,24,7,5,61,34,27,79
Peterhead,9979,2,24,4,8,79,38,41,76
Stirling,9979,3,16,7,13,62,53,9,55
Stenhousem'r,9979,4,15,9,12,57,48,9,54
Clyde,9979,5,15,9,12,56,48,8,54
Elgin,9979,6,14,6,16,53,62,-9,48
Annan Athlet,9979,7,11,12,13,47,41,6,45
Berwick,9979,8,8,10,18,29,63,-34,34
Edinburgh Ci,9979,9,7,9,20,36,62,-26,30
Cowdenbeath,9979,10,4,11,21,23,54,-31,23
Montrose,9980,1,23,7,6,59,35,24,76
Peterhead,9980,2,23,4,9,77,39,38,73
Stirling,9980,3,16,7,13,61,52,9,55
Stenhousem'r,9980,4,15,9,12,56,47,9,54
Clyde,9980,5,14,9,13,51,49,2,51
Elgin,9980,6,15,6,15,54,60,-6,51
Annan Athlet,9980,7,11,12,13,48,42,6,45
Berwick,9980,8,9,10,17,30,58,-28,37
Edinburgh Ci,9980,9,8,9,19,37,60,-23,33
Cowdenbeath,9980,10,4,11,21,24,55,-31,23
Montrose,9981,1,24,7,5,62,34,28,79
Peterhead,9981,2,24,4,8,79,38,41,76
Stenhousem'r,9981,3,16,8,12,59,47,12,56
Stirling,9981,4,16,6,14,61,55,6,54
Clyde,9981,5,15,9,12,54,49,5,54
Elgin,9981,6,14,6,16,53,63,-10,48
Annan Athlet,9981,7,11,11,14,47,42,5,44
Berwick,9981,8,8,10,18,30,61,-31,34
Edinburgh Ci,9981,9,7,9,20,36,62,-26,30
Cowdenbeath,9981,10,5,10,21,24,54,-30,25
Montrose,9982,1,23,8,5,59,34,25,77
Peterhead,9982,2,23,5,8,79,40,39,74
Stirling,9982,3,16,7,13,63,54,9,55
Stenhousem'r,9982,4,15,9,12,58,49,9,54
Clyde,9982,5,15,9,12,53,48,5,54
Elgin,9982,6,14,7,15,53,60,-7,49
Annan Athlet,9982,7,12,11,13,48,41,7,47
Berwick,9982,8,8,10,18,29,60,-31,34
Edinburgh Ci,9982,9,7,10,19,38,62,-24,31
Cowdenbeath,9982,10,4,10,22,23,55,-32,22
Montrose,9983,1,24,7,5,62,34,28,79
Peterhead,9983,2,23,5,8,78,39,39,74
Stirling,9983,3,16,7,13,61,52,9,55
Stenhousem'r,9983,4,15,9,12,56,47,9,54
Clyde,9983,5,15,9,12,53,49,4,54
Elgin,9983,6,14,6,16,53,63,-10,48
Annan Athlet,9983,7,12,11,13,48,41,7,47
Berwick,9983,8,8,10,18,30,60,-30,34
Edinburgh Ci,9983,9,7,10,19,37,61,-24,31
Cowdenbeath,9983,10,4,10,22,23,55,-32,22
Peterhead,9984,1,24,4,8,83,38,45,76
Montrose,9984,2,23,7,6,59,36,23,76
Stirling,9984,3,16,7,13,60,51,9,55
Stenhousem'r,9984,4,15,9,12,55,46,9,54
Clyde,9984,5,15,9,12,52,48,4,54
Elgin,9984,6,15,6,15,55,60,-5,51
Annan Athlet,9984,7,11,11,14,48,44,4,44
Berwick,9984,8,8,10,18,29,59,-30,34
Edinburgh Ci,9984,9,7,9,20,36,66,-30,30
Cowdenbeath,9984,10,5,10,21,26,55,-29,25
Montrose,9985,1,24,7,5,62,34,28,79
Peterhead,9985,2,24,4,8,79,39,40,76
Stirling,9985,3,17,6,13,62,52,10,57
Stenhousem'r,9985,4,15,8,13,56,48,8,53
Clyde,9985,5,14,9,13,53,51,2,51
Elgin,9985,6,14,6,16,53,63,-10,48
Annan Athlet,9985,7,11,11,14,47,42,5,44
Berwick,9985,8,9,10,17,32,60,-28,37
Edinburgh Ci,9985,9,7,9,20,37,62,-25,30
Cowdenbeath,9985,10,5,10,21,24,54,-30,25
Montrose,9986,1,24,7,5,60,34,26,79
Peterhead,9986,2,24,4,8,79,39,40,76
Stirling,9986,3,17,6,13,63,51,12,57
Clyde,9986,4,15,9,12,53,48,5,54
Stenhousem'r,9986,5,15,8,13,55,49,6,53
Elgin,9986,6,14,6,16,53,61,-8,48
Annan Athlet,9986,7,11,12,13,49,43,6,45
Berwick,9986,8,8,10,18,29,60,-31,34
Edinburgh Ci,9986,9,7,9,20,37,62,-25,30
Cowdenbeath,9986,10,4,11,21,25,56,-31,23
Montrose,9987,1,23,8,5,62,37,25,77
Peterhead,9987,2,24,4,8,80,38,42,76
Stirling,9987,3,17,6,13,62,51,11,57
Clyde,9987,4,15,9,12,54,49,5,54
Stenhousem'r,9987,5,15,8,13,55,48,7,53
Elgin,9987,6,14,7,15,56,63,-7,49
Annan Athlet,9987,7,11,11,14,47,45,2,44
Berwick,9987,8,8,10,18,30,61,-31,34
Edinburgh Ci,9987,9,7,9,20,36,63,-27,30
Cowdenbeath,9987,10,5,10,21,27,54,-27,25
Montrose,9988,1,24,7,5,62,35,27,79
Peterhead,9988,2,24,4,8,83,40,43,76
Stirling,9988,3,17,6,13,63,53,10,57
Clyde,9988,4,15,9,12,53,48,5,54
Stenhousem'r,9988,5,15,8,13,57,49,8,53
Elgin,9988,6,14,6,16,54,63,-9,48
Annan Athlet,9988,7,11,12,13,47,41,6,45
Berwick,9988,8,8,10,18,29,60,-31,34
Edinburgh Ci,9988,9,7,9,20,38,66,-28,30
Cowdenbeath,9988,10,4,11,21,23,54,-31,23
Montrose,9989,1,23,7,6,59,36,23,76
Peterhead,9989,2,23,5,8,78,39,39,74
Stirling,9989,3,17,6,13,65,54,11,57
Stenhousem'r,9989,4,15,8,13,58,51,7,53
Clyde,9989,5,14,9,13,51,49,2,51
Elgin,9989,6,15,6,15,55,60,-5,51
Annan Athlet,9989,7,12,11,13,52,42,10,47
Berwick,9989,8,9,10,17,30,58,-28,37
Edinburgh Ci,9989,9,7,10,19,37,61,-24,31
Cowdenbeath,9989,10,4,10,22,24,59,-35,22
Montrose,9990,1,23,8,5,60,35,25,77
Peterhead,9990,2,24,4,8,79,39,40,76
Stenhousem'r,9990,3,16,8,12,56,46,10,56
Stirling,9990,4,16,6,14,60,52,8,54
Clyde,9990,5,14,10,12,52,49,3,52
Elgin,9990,6,14,7,15,54,61,-7,49
Annan Athlet,9990,7,12,11,13,51,41,10,47
Berwick,9990,8,8,11,17,30,59,-29,35
Edinburgh Ci,9990,9,7,9,20,37,62,-25,30
Cowdenbeath,9990,10,4,10,22,23,58,-35,22
Montrose,9991,1,23,8,5,60,35,25,77
Peterhead,9991,2,24,4,8,80,40,40,76
Stirling,9991,3,17,6,13,63,53,10,57
Clyde,9991,4,15,9,12,54,49,5,54
Stenhousem'r,9991,5,15,8,13,57,49,8,53
Elgin,9991,6,14,7,15,54,61,-7,49
Annan Athlet,9991,7,11,12,13,47,41,6,45
Berwick,9991,8,8,10,18,30,61,-31,34
Edinburgh Ci,9991,9,7,9,20,38,63,-25,30
Cowdenbeath,9991,10,4,11,21,23,54,-31,23
Peterhead,9992,1,24,4,8,80,38,42,76
Montrose,9992,2,23,7,6,61,37,24,76
Stirling,9992,3,17,6,13,62,52,10,57
Clyde,9992,4,15,9,12,55,49,6,54
Stenhousem'r,9992,5,15,8,13,56,48,8,53
Elgin,9992,6,15,6,15,56,62,-6,51
Annan Athlet,9992,7,12,11,13,51,43,8,47
Berwick,9992,8,8,10,18,30,62,-32,34
Edinburgh Ci,9992,9,7,9,20,36,63,-27,30
Cowdenbeath,9992,10,4,10,22,25,58,-33,22
Montrose,9993,1,24,7,5,61,34,27,79
Peterhead,9993,2,23,4,9,79,41,38,73
Stenhousem'r,9993,3,16,8,12,57,47,10,56
Stirling,9993,4,16,6,14,61,53,8,54
Clyde,9993,5,14,10,12,51,48,3,52
Elgin,9993,6,14,6,16,53,62,-9,48
Annan Athlet,9993,7,11,12,13,48,42,6,45
Berwick,9993,8,8,11,17,29,58,-29,35
Edinburgh Ci,9993,9,8,9,19,39,62,-23,33
Cowdenbeath,9993,10,4,11,21,24,55,-31,23
Montrose,9994,1,24,7,5,64,36,28,79
Peterhead,9994,2,23,5,8,77,38,39,74
Stirling,9994,3,17,6,13,62,52,10,57
Clyde,9994,4,15,9,12,53,48,5,54
Stenhousem'r,9994,5,15,8,13,56,48,8,53
Elgin,9994,6,14,6,16,55,65,-10,48
Annan Athlet,9994,7,12,11,13,49,42,7,47
Berwick,9994,8,8,10,18,29,60,-31,34
Edinburgh Ci,9994,9,7,10,19,36,60,-24,31
Cowdenbeath,9994,10,4,10,22,24,56,-32,22
Montrose,9995,1,24,7,5,64,34,30,79
Peterhead,9995,2,24,4,8,81,38,43,76
Stenhousem'r,9995,3,16,8,12,58,47,11,56
Stirling,9995,4,16,6,14,61,54,7,54
Clyde,9995,5,15,9,12,53,49,4,54
Elgin,9995,6,14,6,16,53,65,-12,48
Annan Athlet,9995,7,12,11,13,49,41,8,47
Berwick,9995,8,8,10,18,30,60,-30,34
Edinburgh Ci,9995,9,7,9,20,36,64,-28,30
Cowdenbeath,9995,10,4,10,22,23,56,-33,22
Montrose,9996,1,23,7,6,60,36,24,76
Peterhead,9996,2,23,4,9,77,39,38,73
Stenhousem'r,9996,3,16,8,12,57,47,10,56
Stirling,9996,4,16,6,14,61,53,8,54
Clyde,9996,5,15,9,12,53,49,4,54
Elgin,9996,6,15,6,15,55,61,-6,51
Annan Athlet,9996,7,11,11,14,47,43,4,44
Berwick,9996,8,8,10,18,30,60,-30,34
Edinburgh Ci,9996,9,8,9,19,37,60,-23,33
Cowdenbeath,9996,10,5,10,21,25,54,-29,25
Montrose,9997,1,24,7,5,63,37,26,79
Peterhead,9997,2,23,5,8,78,39,39,74
Stenhousem'r,9997,3,16,8,12,58,47,11,56
Stirling,9997,4,16,6,14,61,54,7,54
Clyde,9997,5,15,9,12,55,48,7,54
Elgin,9997,6,14,6,16,56,64,-8,48
Annan Athlet,9997,7,11,11,14,47,42,5,44
Berwick,9997,8,8,10,18,29,62,-33,34
Edinburgh Ci,9997,9,7,10,19,37,61,-24,31
Cowdenbeath,9997,10,5,10,21,24,54,-30,25
Peterhead,9998,1,24,4,8,78,38,40,76
Montrose,9998,2,23,7,6,61,37,24,76
Stirling,9998,3,17,6,13,61,51,10,57
Stenhousem'r,9998,4,15,8,13,55,47,8,53
Clyde,9998,5,14,10,12,51,48,3,52
Elgin,9998,6,15,6,15,56,62,-6,51
Annan Athlet,9998,7,12,11,13,48,41,7,47
Berwick,9998,8,8,11,17,29,58,-29,35
Edinburgh Ci,9998,9,7,9,20,36,61,-25,30
Cowdenbeath,9998,10,4,10,22,23,55,-32,22
Montrose,9999,1,24,7,5,62,34,28,79
Peterhead,9999,2,24,4,8,79,39,40,76
Stirling,9999,3,17,6,13,66,53,13,57
Stenhousem'r,9999,4,15,8,13,57,52,5,53
Clyde,9999,5,14,10,12,53,50,3,52
Elgin,9999,6,14,6,16,53,63,-10,48
Annan Athlet,9999,7,12,11,13,48,41,7,47
Berwick,9999,8,8,11,17,31,60,-29,35
Edinburgh Ci,9999,9,7,9,20,37,62,-25,30
Cowdenbeath,9999,10,4,10,22,23,55,-32,22
