team,n,rank,w,d,l,gf,ga,gd,pts
Young Boys,0,1,21,8,3,73,36,37,71
FC Basel,0,2,19,8,5,54,25,29,65
Lucerne,0,3,12,8,12,39,43,-4,44
St Gallen,0,4,14,2,16,42,55,-13,44
FC Zürich,0,5,11,9,12,41,36,5,42
FC Thun,0,6,10,7,15,44,56,-12,37
Grasshoppers,0,7,9,8,15,41,50,-9,35
FC Lugano,0,8,10,5,17,30,48,-18,35
FC Sion,0,9,6,9,17,39,54,-15,27
Young Boys,1,1,23,7,2,72,32,40,76
FC Basel,1,2,16,10,6,51,24,27,58
St Gallen,1,3,15,3,14,43,53,-10,48
Lucerne,1,4,12,9,11,40,42,-2,45
FC Zürich,1,5,9,12,11,39,36,3,39
Grasshoppers,1,6,11,6,15,42,49,-7,39
FC Lugano,1,7,10,7,15,31,46,-15,37
FC Thun,1,8,8,7,17,39,58,-19,31
FC Sion,1,9,5,9,18,39,56,-17,24
Young Boys,2,1,20,7,5,72,41,31,67
FC Basel,2,2,19,7,6,54,25,29,64
Lucerne,2,3,15,7,10,46,42,4,52
St Gallen,2,4,14,2,16,40,53,-13,44
FC Zürich,2,5,9,11,12,40,40,0,38
Grasshoppers,2,6,10,7,15,43,50,-7,37
FC Lugano,2,7,10,6,16,33,49,-16,36
FC Thun,2,8,8,8,16,45,62,-17,32
FC Sion,2,9,7,9,16,42,53,-11,30
Young Boys,3,1,23,7,2,75,34,41,76
FC Basel,3,2,17,8,7,54,29,25,59
St Gallen,3,3,14,3,15,46,56,-10,45
Lucerne,3,4,12,7,13,38,46,-8,43
FC Lugano,3,5,12,5,15,33,45,-12,41
FC Zürich,3,6,10,10,12,40,37,3,40
FC Sion,3,7,8,9,15,43,53,-10,33
FC Thun,3,8,8,8,16,45,63,-18,32
Grasshoppers,3,9,8,7,17,40,51,-11,31
Young Boys,4,1,21,7,4,69,35,34,70
FC Basel,4,2,18,8,6,56,26,30,62
St Gallen,4,3,15,3,14,44,53,-9,48
Lucerne,4,4,13,7,12,45,46,-1,46
FC Zürich,4,5,11,10,11,39,34,5,43
Grasshoppers,4,6,10,7,15,44,50,-6,37
FC Thun,4,7,10,5,17,47,65,-18,35
FC Lugano,4,8,10,5,17,31,49,-18,35
FC Sion,4,9,5,10,17,39,56,-17,25
Young Boys,5,1,21,6,5,72,39,33,69
FC Basel,5,2,18,8,6,60,25,35,62
St Gallen,5,3,15,3,14,45,58,-13,48
FC Zürich,5,4,11,10,11,40,36,4,43
Lucerne,5,5,12,7,13,40,51,-11,43
Grasshoppers,5,6,11,6,15,45,51,-6,39
FC Lugano,5,7,11,5,16,34,46,-12,38
FC Thun,5,8,10,5,17,45,60,-15,35
FC Sion,5,9,6,8,18,45,60,-15,26
Young Boys,6,1,22,7,3,74,34,40,73
FC Basel,6,2,19,7,6,59,28,31,64
St Gallen,6,3,15,2,15,44,57,-13,47
Lucerne,6,4,12,7,13,41,46,-5,43
FC Zürich,6,5,10,10,12,40,37,3,40
FC Lugano,6,6,11,5,16,34,50,-16,38
Grasshoppers,6,7,10,7,15,38,45,-7,37
FC Thun,6,8,8,7,17,42,61,-19,31
FC Sion,6,9,6,10,16,38,52,-14,28
Young Boys,7,1,20,9,3,69,35,34,69
FC Basel,7,2,17,8,7,54,26,28,59
Lucerne,7,3,13,9,10,45,41,4,48
St Gallen,7,4,15,3,14,43,52,-9,48
FC Zürich,7,5,11,10,11,39,33,6,43
FC Lugano,7,6,11,5,16,29,49,-20,38
Grasshoppers,7,7,10,6,16,42,49,-7,36
FC Thun,7,8,8,6,18,40,62,-22,30
FC Sion,7,9,6,10,16,39,53,-14,28
Young Boys,8,1,22,7,3,72,36,36,73
FC Basel,8,2,16,9,7,49,29,20,57
St Gallen,8,3,15,3,14,43,53,-10,48
Lucerne,8,4,13,7,12,44,45,-1,46
FC Zürich,8,5,12,9,11,44,36,8,45
Grasshoppers,8,6,10,6,16,42,49,-7,36
FC Thun,8,7,10,5,17,45,60,-15,35
FC Lugano,8,8,10,5,17,29,49,-20,35
FC Sion,8,9,7,7,18,41,52,-11,28
Young Boys,9,1,20,8,4,65,33,32,68
FC Basel,9,2,19,8,5,57,22,35,65
St Gallen,9,3,14,4,14,42,52,-10,46
Lucerne,9,4,11,11,10,40,43,-3,44
FC Lugano,9,5,11,7,14,30,43,-13,40
FC Zürich,9,6,10,9,13,40,39,1,39
Grasshoppers,9,7,9,7,16,42,51,-9,34
FC Thun,9,8,9,6,17,43,63,-20,33
FC Sion,9,9,7,8,17,41,54,-13,29
Young Boys,10,1,20,6,6,69,39,30,66
FC Basel,10,2,19,7,6,58,26,32,64
St Gallen,10,3,14,4,14,41,52,-11,46
FC Zürich,10,4,12,9,11,43,39,4,45
Lucerne,10,5,12,9,11,39,42,-3,45
FC Lugano,10,6,10,7,15,32,46,-14,37
FC Thun,10,7,10,6,16,45,60,-15,36
Grasshoppers,10,8,8,8,16,39,50,-11,32
FC Sion,10,9,6,10,16,40,52,-12,28
Young Boys,11,1,22,6,4,70,35,35,72
FC Basel,11,2,18,7,7,52,27,25,61
St Gallen,11,3,15,2,15,44,55,-11,47
FC Zürich,11,4,12,10,10,44,34,10,46
Lucerne,11,5,11,8,13,38,45,-7,41
Grasshoppers,11,6,11,6,15,43,47,-4,39
FC Lugano,11,7,10,7,15,33,48,-15,37
FC Thun,11,8,9,5,18,43,60,-17,32
FC Sion,11,9,7,7,18,39,55,-16,28
Young Boys,12,1,23,6,3,75,38,37,75
FC Basel,12,2,18,8,6,56,26,30,62
Lucerne,12,3,14,7,11,46,43,3,49
FC Zürich,12,4,11,11,10,41,34,7,44
St Gallen,12,5,13,3,16,40,56,-16,42
Grasshoppers,12,6,10,6,16,42,54,-12,36
FC Lugano,12,7,10,6,16,33,49,-16,36
FC Thun,12,8,8,6,18,46,66,-20,30
FC Sion,12,9,6,9,17,42,55,-13,27
Young Boys,13,1,22,6,4,76,42,34,72
FC Basel,13,2,18,9,5,60,29,31,63
St Gallen,13,3,14,5,13,44,53,-9,47
Lucerne,13,4,12,10,10,45,44,1,46
FC Zürich,13,5,10,11,11,40,36,4,41
Grasshoppers,13,6,9,8,15,47,52,-5,35
FC Lugano,13,7,9,5,18,28,53,-25,32
FC Thun,13,8,8,7,17,41,61,-20,31
FC Sion,13,9,7,9,16,44,55,-11,30
Young Boys,14,1,22,8,2,70,30,40,74
FC Basel,14,2,19,8,5,57,25,32,65
Lucerne,14,3,12,9,11,41,42,-1,45
St Gallen,14,4,14,3,15,40,53,-13,45
FC Zürich,14,5,10,10,12,40,40,0,40
Grasshoppers,14,6,9,7,16,39,52,-13,34
FC Thun,14,7,9,6,17,45,60,-15,33
FC Lugano,14,8,9,6,17,29,47,-18,33
FC Sion,14,9,7,9,16,39,51,-12,30
Young Boys,15,1,22,8,2,80,36,44,74
FC Basel,15,2,17,9,6,57,30,27,60
Lucerne,15,3,14,8,10,45,45,0,50
St Gallen,15,4,14,2,16,42,58,-16,44
FC Zürich,15,5,11,10,11,41,36,5,43
FC Lugano,15,6,11,6,15,34,47,-13,39
FC Thun,15,7,9,5,18,40,57,-17,32
Grasshoppers,15,8,8,7,17,39,53,-14,31
FC Sion,15,9,7,7,18,39,55,-16,28
Young Boys,16,1,21,8,3,67,32,35,71
FC Basel,16,2,16,9,7,55,30,25,57
St Gallen,16,3,15,4,13,44,53,-9,49
Lucerne,16,4,13,7,12,47,45,2,46
FC Zürich,16,5,12,9,11,43,36,7,45
FC Lugano,16,6,10,6,16,30,48,-18,36
Grasshoppers,16,7,9,8,15,39,47,-8,35
FC Thun,16,8,8,7,17,39,60,-21,31
FC Sion,16,9,7,8,17,37,50,-13,29
Young Boys,17,1,20,10,2,71,36,35,70
FC Basel,17,2,17,9,6,54,28,26,60
Lucerne,17,3,13,8,11,46,43,3,47
St Gallen,17,4,14,2,16,45,58,-13,44
FC Zürich,17,5,10,10,12,41,38,3,40
FC Thun,17,6,11,5,16,45,57,-12,38
FC Lugano,17,7,11,5,16,32,49,-17,38
Grasshoppers,17,8,9,7,16,41,52,-11,34
FC Sion,17,9,7,8,17,43,57,-14,29
Young Boys,18,1,22,7,3,75,35,40,73
FC Basel,18,2,18,9,5,57,25,32,63
Lucerne,18,3,13,7,12,39,44,-5,46
FC Zürich,18,4,11,9,12,41,40,1,42
St Gallen,18,5,13,3,16,38,54,-16,42
FC Lugano,18,6,12,5,15,33,44,-11,41
FC Thun,18,7,10,6,16,45,56,-11,36
Grasshoppers,18,8,8,6,18,39,53,-14,30
FC Sion,18,9,7,8,17,40,56,-16,29
Young Boys,19,1,23,6,3,72,34,38,75
FC Basel,19,2,19,8,5,57,26,31,65
Lucerne,19,3,13,7,12,47,46,1,46
St Gallen,19,4,14,2,16,44,58,-14,44
FC Zürich,19,5,10,10,12,39,36,3,40
FC Thun,19,6,10,5,17,46,60,-14,35
FC Lugano,19,7,10,5,17,30,50,-20,35
Grasshoppers,19,8,9,6,17,41,54,-13,33
FC Sion,19,9,8,7,17,47,59,-12,31
Young Boys,20,1,21,7,4,74,36,38,70
FC Basel,20,2,16,8,8,50,27,23,56
Lucerne,20,3,15,7,10,46,44,2,52
St Gallen,20,4,14,3,15,42,53,-11,45
FC Zürich,20,5,11,9,12,42,36,6,42
FC Thun,20,6,12,5,15,48,59,-11,41
FC Lugano,20,7,10,6,16,32,51,-19,36
Grasshoppers,20,8,8,7,17,38,52,-14,31
FC Sion,20,9,7,8,17,39,53,-14,29
Young Boys,21,1,23,6,3,76,36,40,75
FC Basel,21,2,17,9,6,52,25,27,60
St Gallen,21,3,16,3,13,48,52,-4,51
Lucerne,21,4,12,7,13,41,49,-8,43
FC Zürich,21,5,11,9,12,40,37,3,42
FC Lugano,21,6,11,5,16,33,50,-17,38
Grasshoppers,21,7,9,7,16,44,54,-10,34
FC Thun,21,8,8,6,18,44,63,-19,30
FC Sion,21,9,7,8,17,41,53,-12,29
Young Boys,22,1,22,7,3,70,33,37,73
FC Basel,22,2,17,9,6,52,24,28,60
FC Zürich,22,3,13,9,10,44,36,8,48
St Gallen,22,4,14,4,14,43,55,-12,46
Lucerne,22,5,12,8,12,40,43,-3,44
Grasshoppers,22,6,10,7,15,43,48,-5,37
FC Lugano,22,7,10,5,17,32,50,-18,35
FC Thun,22,8,9,6,17,43,61,-18,33
FC Sion,22,9,5,9,18,39,56,-17,24
Young Boys,23,1,20,7,5,69,38,31,67
FC Basel,23,2,19,7,6,56,25,31,64
St Gallen,23,3,15,2,15,44,53,-9,47
FC Zürich,23,4,12,9,11,41,34,7,45
Lucerne,23,5,11,8,13,38,47,-9,41
FC Lugano,23,6,11,7,14,32,45,-13,40
Grasshoppers,23,7,11,6,15,44,46,-2,39
FC Thun,23,8,9,5,18,42,65,-23,32
FC Sion,23,9,7,7,18,39,52,-13,28
Young Boys,24,1,22,6,4,72,36,36,72
FC Basel,24,2,19,7,6,59,25,34,64
Lucerne,24,3,13,8,11,44,48,-4,47
St Gallen,24,4,14,3,15,45,58,-13,45
FC Zürich,24,5,9,11,12,39,39,0,38
Grasshoppers,24,6,10,7,15,43,49,-6,37
FC Lugano,24,7,10,6,16,30,48,-18,36
FC Thun,24,8,9,7,16,44,59,-15,34
FC Sion,24,9,6,9,17,39,53,-14,27
Young Boys,25,1,22,7,3,69,35,34,73
FC Basel,25,2,19,7,6,59,23,36,64
St Gallen,25,3,15,3,14,43,57,-14,48
Lucerne,25,4,13,7,12,43,46,-3,46
FC Zürich,25,5,11,10,11,42,35,7,43
Grasshoppers,25,6,9,7,16,43,53,-10,34
FC Lugano,25,7,9,7,16,30,48,-18,34
FC Thun,25,8,9,5,18,42,59,-17,32
FC Sion,25,9,7,7,18,40,55,-15,28
Young Boys,26,1,22,8,2,71,31,40,74
FC Basel,26,2,17,8,7,50,25,25,59
FC Zürich,26,3,13,9,10,46,34,12,48
St Gallen,26,4,15,3,14,45,55,-10,48
Lucerne,26,5,12,7,13,45,49,-4,43
Grasshoppers,26,6,11,7,14,46,49,-3,40
FC Lugano,26,7,10,5,17,31,50,-19,35
FC Thun,26,8,9,5,18,45,62,-17,32
FC Sion,26,9,5,8,19,39,63,-24,23
Young Boys,27,1,21,8,3,73,36,37,71
FC Basel,27,2,18,7,7,54,26,28,61
Lucerne,27,3,13,9,10,45,46,-1,48
St Gallen,27,4,14,3,15,41,52,-11,45
FC Zürich,27,5,11,10,11,41,36,5,43
FC Thun,27,6,10,7,15,45,58,-13,37
FC Lugano,27,7,9,7,16,30,48,-18,34
Grasshoppers,27,8,8,8,16,43,55,-12,32
FC Sion,27,9,6,9,17,39,54,-15,27
Young Boys,28,1,21,9,2,72,31,41,72
FC Basel,28,2,17,9,6,54,28,26,60
Lucerne,28,3,12,8,12,41,48,-7,44
St Gallen,28,4,13,5,14,44,56,-12,44
FC Zürich,28,5,11,9,12,41,36,5,42
FC Lugano,28,6,11,6,15,34,47,-13,39
Grasshoppers,28,7,9,8,15,41,49,-8,35
FC Sion,28,8,8,9,15,40,50,-10,33
FC Thun,28,9,8,5,19,39,61,-22,29
Young Boys,29,1,21,6,5,72,37,35,69
FC Basel,29,2,18,8,6,60,24,36,62
Lucerne,29,3,14,9,9,47,44,3,51
St Gallen,29,4,14,4,14,45,57,-12,46
FC Zürich,29,5,12,9,11,43,40,3,45
FC Lugano,29,6,9,7,16,29,48,-19,34
FC Thun,29,7,9,5,18,42,61,-19,32
Grasshoppers,29,8,8,7,17,40,53,-13,31
FC Sion,29,9,8,7,17,40,54,-14,31
Young Boys,30,1,22,6,4,70,34,36,72
FC Basel,30,2,18,9,5,53,22,31,63
FC Zürich,30,3,12,10,10,41,33,8,46
St Gallen,30,4,14,3,15,42,54,-12,45
Lucerne,30,5,12,8,12,42,46,-4,44
Grasshoppers,30,6,10,6,16,40,51,-11,36
FC Lugano,30,7,10,5,17,29,46,-17,35
FC Thun,30,8,9,6,17,40,57,-17,33
FC Sion,30,9,7,7,18,40,54,-14,28
Young Boys,31,1,21,7,4,71,40,31,70
FC Basel,31,2,17,8,7,55,28,27,59
Lucerne,31,3,14,8,10,48,47,1,50
St Gallen,31,4,15,2,15,49,59,-10,47
FC Zürich,31,5,10,10,12,41,40,1,40
Grasshoppers,31,6,10,7,15,47,49,-2,37
FC Lugano,31,7,10,6,16,33,49,-16,36
FC Thun,31,8,9,7,16,44,59,-15,34
FC Sion,31,9,6,9,17,43,60,-17,27
Young Boys,32,1,23,7,2,77,33,44,76
FC Basel,32,2,16,7,9,49,30,19,55
Lucerne,32,3,13,9,10,45,45,0,48
St Gallen,32,4,15,3,14,43,52,-9,48
FC Zürich,32,5,11,11,10,44,36,8,44
Grasshoppers,32,6,9,8,15,43,52,-9,35
FC Thun,32,7,9,6,17,45,61,-16,33
FC Lugano,32,8,9,6,17,29,50,-21,33
FC Sion,32,9,7,7,18,41,57,-16,28
Young Boys,33,1,21,7,4,73,36,37,70
FC Basel,33,2,18,9,5,55,26,29,63
St Gallen,33,3,15,2,15,43,54,-11,47
Lucerne,33,4,13,7,12,47,45,2,46
FC Zürich,33,5,10,11,11,41,37,4,41
FC Lugano,33,6,11,5,16,32,50,-18,38
FC Thun,33,7,9,8,15,44,55,-11,35
Grasshoppers,33,8,9,8,15,41,52,-11,35
FC Sion,33,9,5,9,18,38,59,-21,24
Young Boys,34,1,23,6,3,72,31,41,75
FC Basel,34,2,17,7,8,50,26,24,58
Lucerne,34,3,14,8,10,42,39,3,50
St Gallen,34,4,14,4,14,41,52,-11,46
FC Zürich,34,5,11,10,11,40,34,6,43
FC Thun,34,6,11,5,16,45,57,-12,38
FC Lugano,34,7,9,7,16,28,48,-20,34
Grasshoppers,34,8,8,7,17,42,55,-13,31
FC Sion,34,9,6,8,18,40,58,-18,26
Young Boys,35,1,19,8,5,70,40,30,65
FC Basel,35,2,17,9,6,53,26,27,60
St Gallen,35,3,15,3,14,44,53,-9,48
Lucerne,35,4,11,10,11,43,46,-3,43
FC Lugano,35,5,12,6,14,35,47,-12,42
Grasshoppers,35,6,11,7,14,43,47,-4,40
FC Zürich,35,7,9,12,11,41,38,3,39
FC Thun,35,8,10,6,16,45,58,-13,36
FC Sion,35,9,5,9,18,38,57,-19,24
Young Boys,36,1,23,6,3,75,33,42,75
FC Basel,36,2,16,10,6,50,26,24,58
Lucerne,36,3,13,8,11,43,41,2,47
St Gallen,36,4,14,2,16,44,57,-13,44
FC Zürich,36,5,11,10,11,42,37,5,43
FC Lugano,36,6,12,5,15,32,46,-14,41
FC Thun,36,7,10,6,16,43,56,-13,36
Grasshoppers,36,8,9,6,17,39,51,-12,33
FC Sion,36,9,6,7,19,41,62,-21,25
Young Boys,37,1,21,6,5,69,36,33,69
FC Basel,37,2,17,9,6,54,26,28,60
Lucerne,37,3,14,7,11,47,42,5,49
St Gallen,37,4,15,3,14,45,54,-9,48
FC Zürich,37,5,11,10,11,43,37,6,43
FC Thun,37,6,10,5,17,48,64,-16,35
FC Lugano,37,7,10,5,17,30,51,-21,35
Grasshoppers,37,8,9,7,16,43,53,-10,34
FC Sion,37,9,7,8,17,41,57,-16,29
Young Boys,38,1,23,7,2,80,34,46,76
FC Basel,38,2,17,9,6,59,30,29,60
Lucerne,38,3,12,9,11,42,51,-9,45
St Gallen,38,4,13,4,15,43,63,-20,43
FC Zürich,38,5,10,10,12,42,38,4,40
FC Lugano,38,6,11,5,16,36,49,-13,38
FC Thun,38,7,10,6,16,48,60,-12,36
Grasshoppers,38,8,8,9,15,40,49,-9,33
FC Sion,38,9,6,9,17,42,58,-16,27
Young Boys,39,1,23,6,3,76,39,37,75
FC Basel,39,2,17,10,5,52,24,28,61
Lucerne,39,3,13,8,11,46,45,1,47
St Gallen,39,4,14,3,15,43,56,-13,45
FC Zürich,39,5,10,11,11,45,37,8,41
FC Lugano,39,6,10,6,16,34,50,-16,36
Grasshoppers,39,7,9,7,16,43,53,-10,34
FC Thun,39,8,9,7,16,46,64,-18,34
FC Sion,39,9,6,8,18,39,56,-17,26
Young Boys,40,1,22,7,3,77,36,41,73
FC Basel,40,2,19,8,5,57,23,34,65
Lucerne,40,3,14,7,11,43,46,-3,49
St Gallen,40,4,14,3,15,44,56,-12,45
FC Zürich,40,5,10,9,13,40,39,1,39
FC Lugano,40,6,11,5,16,35,50,-15,38
Grasshoppers,40,7,10,6,16,43,52,-9,36
FC Thun,40,8,9,5,18,42,59,-17,32
FC Sion,40,9,6,8,18,41,61,-20,26
Young Boys,41,1,21,8,3,68,30,38,71
FC Basel,41,2,15,12,5,50,25,25,57
Lucerne,41,3,12,9,11,40,43,-3,45
St Gallen,41,4,13,3,16,41,56,-15,42
FC Zürich,41,5,10,11,11,38,35,3,41
FC Lugano,41,6,10,7,15,29,47,-18,37
Grasshoppers,41,7,10,6,16,39,47,-8,36
FC Sion,41,8,9,8,15,40,47,-7,35
FC Thun,41,9,9,6,17,42,57,-15,33
Young Boys,42,1,21,7,4,72,37,35,70
FC Basel,42,2,18,7,7,53,25,28,61
Lucerne,42,3,15,7,10,44,41,3,52
St Gallen,42,4,14,3,15,42,53,-11,45
FC Zürich,42,5,11,10,11,42,36,6,43
Grasshoppers,42,6,10,7,15,41,47,-6,37
FC Lugano,42,7,9,6,17,29,49,-20,33
FC Thun,42,8,8,7,17,42,63,-21,31
FC Sion,42,9,6,10,16,44,58,-14,28
Young Boys,43,1,21,8,3,69,34,35,71
FC Basel,43,2,18,9,5,56,24,32,63
Lucerne,43,3,13,7,12,43,46,-3,46
St Gallen,43,4,13,3,16,42,58,-16,42
FC Zürich,43,5,10,10,12,40,38,2,40
FC Lugano,43,6,11,7,14,33,45,-12,40
FC Thun,43,7,10,6,16,43,58,-15,36
Grasshoppers,43,8,8,8,16,40,51,-11,32
FC Sion,43,9,7,8,17,45,57,-12,29
Young Boys,44,1,22,6,4,73,35,38,72
FC Basel,44,2,17,8,7,54,27,27,59
St Gallen,44,3,16,3,13,47,54,-7,51
Lucerne,44,4,13,7,12,45,48,-3,46
FC Zürich,44,5,11,10,11,43,38,5,43
FC Lugano,44,6,11,5,16,35,50,-15,38
Grasshoppers,44,7,10,7,15,45,54,-9,37
FC Thun,44,8,8,7,17,41,60,-19,31
FC Sion,44,9,5,9,18,37,54,-17,24
Young Boys,45,1,20,7,5,71,37,34,67
FC Basel,45,2,18,9,5,54,24,30,63
Lucerne,45,3,14,7,11,45,46,-1,49
FC Zürich,45,4,11,10,11,43,36,7,43
St Gallen,45,5,13,4,15,40,54,-14,43
FC Lugano,45,6,11,6,15,33,46,-13,39
Grasshoppers,45,7,10,6,16,40,50,-10,36
FC Thun,45,8,10,5,17,43,60,-17,35
FC Sion,45,9,6,8,18,40,56,-16,26
Young Boys,46,1,21,9,2,70,34,36,72
FC Basel,46,2,19,8,5,58,23,35,65
Lucerne,46,3,13,8,11,41,44,-3,47
St Gallen,46,4,14,2,16,42,57,-15,44
FC Zürich,46,5,9,11,12,39,37,2,38
Grasshoppers,46,6,10,6,16,40,47,-7,36
FC Lugano,46,7,9,8,15,32,48,-16,35
FC Thun,46,8,9,5,18,41,62,-21,32
FC Sion,46,9,7,9,16,41,52,-11,30
Young Boys,47,1,22,7,3,72,33,39,73
FC Basel,47,2,18,7,7,54,24,30,61
St Gallen,47,3,15,4,13,42,50,-8,49
Lucerne,47,4,13,8,11,41,42,-1,47
FC Zürich,47,5,10,9,13,41,40,1,39
FC Thun,47,6,11,5,16,46,59,-13,38
FC Lugano,47,7,10,5,17,30,49,-19,35
Grasshoppers,47,8,8,8,16,38,51,-13,32
FC Sion,47,9,6,9,17,39,55,-16,27
Young Boys,48,1,21,6,5,75,38,37,69
FC Basel,48,2,17,8,7,53,27,26,59
Lucerne,48,3,14,7,11,43,43,0,49
St Gallen,48,4,15,2,15,42,57,-15,47
FC Zrich,48,5,10,11,11,42,35,7,41
FC Lugano,48,6,11,6,15,33,46,-13,39
FC Thun,48,7,10,6,16,42,57,-15,36
Grasshoppers,48,8,9,8,15,41,48,-7,35
FC Sion,48,9,6,8,18,39,59,-20,26
Young Boys,49,1,21,8,3,72,37,35,71
FC Basel,49,2,19,8,5,57,25,32,65
St Gallen,49,3,15,3,14,44,53,-9,48
Lucerne,49,4,12,9,11,41,44,-3,45
FC Zürich,49,5,10,11,11,40,34,6,41
FC Thun,49,6,10,6,16,48,58,-10,36
FC Lugano,49,7,10,6,16,30,48,-18,36
Grasshoppers,49,8,9,8,15,44,50,-6,35
FC Sion,49,9,5,7,20,38,65,-27,22
Young Boys,50,1,22,7,3,73,34,39,73
FC Basel,50,2,17,9,6,52,26,26,60
St Gallen,50,3,15,2,15,44,55,-11,47
FC Zürich,50,4,11,10,11,39,35,4,43
Lucerne,50,5,11,8,13,38,44,-6,41
FC Lugano,50,6,11,5,16,32,48,-16,38
FC Thun,50,7,10,6,16,42,56,-14,36
Grasshoppers,50,8,8,9,15,39,48,-9,33
FC Sion,50,9,7,8,17,39,52,-13,29
Young Boys,51,1,21,8,3,71,36,35,71
FC Basel,51,2,20,7,5,57,26,31,67
Lucerne,51,3,13,8,11,45,45,0,47
St Gallen,51,4,14,3,15,47,58,-11,45
FC Thun,51,5,11,5,16,44,56,-12,38
FC Zürich,51,6,9,10,13,40,39,1,37
Grasshoppers,51,7,9,8,15,40,48,-8,35
FC Lugano,51,8,9,7,16,30,48,-18,34
FC Sion,51,9,6,8,18,39,57,-18,26
Young Boys,52,1,21,9,2,72,34,38,72
FC Basel,52,2,17,8,7,58,29,29,59
St Gallen,52,3,14,3,15,41,54,-13,45
FC Zürich,52,4,11,11,10,41,35,6,44
Lucerne,52,5,12,8,12,39,44,-5,44
Grasshoppers,52,6,10,7,15,41,49,-8,37
FC Lugano,52,7,10,6,16,31,46,-15,36
FC Thun,52,8,10,5,17,46,64,-18,35
FC Sion,52,9,6,9,17,38,52,-14,27
Young Boys,53,1,23,6,3,78,33,45,75
FC Basel,53,2,19,7,6,54,23,31,64
St Gallen,53,3,15,2,15,43,55,-12,47
Lucerne,53,4,13,7,12,46,45,1,46
FC Zürich,53,5,11,10,11,42,37,5,43
FC Thun,53,6,10,6,16,45,61,-16,36
FC Lugano,53,7,10,6,16,33,50,-17,36
Grasshoppers,53,8,9,7,16,41,58,-17,34
FC Sion,53,9,5,7,20,37,57,-20,22
Young Boys,54,1,23,6,3,72,32,40,75
FC Basel,54,2,18,8,6,51,23,28,62
St Gallen,54,3,15,3,14,43,55,-12,48
FC Zürich,54,4,12,10,10,39,32,7,46
Lucerne,54,5,13,7,12,43,45,-2,46
FC Lugano,54,6,10,5,17,31,49,-18,35
Grasshoppers,54,7,9,6,17,40,51,-11,33
FC Thun,54,8,9,5,18,42,58,-16,32
FC Sion,54,9,6,8,18,40,56,-16,26
Young Boys,55,1,23,7,2,73,31,42,76
FC Basel,55,2,17,8,7,51,26,25,59
Lucerne,55,3,14,8,10,43,42,1,50
St Gallen,55,4,15,2,15,45,55,-10,47
FC Zürich,55,5,9,10,13,37,37,0,37
FC Lugano,55,6,10,6,16,32,48,-16,36
FC Thun,55,7,9,6,17,42,60,-18,33
FC Sion,55,8,8,8,16,42,54,-12,32
Grasshoppers,55,9,8,7,17,40,52,-12,31
Young Boys,56,1,22,7,3,72,34,38,73
FC Basel,56,2,17,9,6,53,25,28,60
FC Zürich,56,3,12,9,11,42,34,8,45
St Gallen,56,4,14,3,15,43,54,-11,45
Lucerne,56,5,12,8,12,42,45,-3,44
Grasshoppers,56,6,11,6,15,41,47,-6,39
FC Lugano,56,7,10,5,17,31,52,-21,35
FC Thun,56,8,9,5,18,41,63,-22,32
FC Sion,56,9,7,8,17,40,51,-11,29
Young Boys,57,1,20,8,4,70,37,33,68
FC Basel,57,2,16,9,7,52,26,26,57
Lucerne,57,3,14,9,9,44,41,3,51
FC Zürich,57,4,13,9,10,43,33,10,48
St Gallen,57,5,13,4,15,39,53,-14,43
FC Lugano,57,6,11,5,16,32,47,-15,38
Grasshoppers,57,7,10,7,15,41,48,-7,37
FC Thun,57,8,8,6,18,41,63,-22,30
FC Sion,57,9,6,9,17,39,53,-14,27
Young Boys,58,1,22,6,4,72,34,38,72
FC Basel,58,2,16,9,7,53,28,25,57
Lucerne,58,3,14,8,10,46,45,1,50
St Gallen,58,4,15,4,13,45,54,-9,49
Grasshoppers,58,5,12,6,14,46,46,0,42
FC Zürich,58,6,9,12,11,37,35,2,39
FC Lugano,58,7,10,5,17,31,51,-20,35
FC Thun,58,8,9,6,17,41,59,-18,33
FC Sion,58,9,5,8,19,35,54,-19,23
Young Boys,59,1,21,7,4,71,37,34,70
FC Basel,59,2,17,8,7,52,26,26,59
St Gallen,59,3,16,2,14,44,53,-9,50
Lucerne,59,4,12,7,13,44,48,-4,43
FC Zürich,59,5,9,11,12,40,38,2,38
FC Lugano,59,6,11,5,16,33,51,-18,38
Grasshoppers,59,7,10,7,15,43,50,-7,37
FC Thun,59,8,10,7,15,47,55,-8,37
FC Sion,59,9,6,10,16,42,58,-16,28
Young Boys,60,1,23,7,2,82,34,48,76
FC Basel,60,2,17,8,7,52,29,23,59
St Gallen,60,3,16,3,13,46,54,-8,51
FC Zürich,60,4,11,9,12,42,36,6,42
Lucerne,60,5,11,8,13,41,49,-8,41
FC Lugano,60,6,11,5,16,31,50,-19,38
Grasshoppers,60,7,10,7,15,43,51,-8,37
FC Thun,60,8,8,7,17,42,59,-17,31
FC Sion,60,9,5,10,17,39,56,-17,25
Young Boys,61,1,23,6,3,79,33,46,75
FC Basel,61,2,16,7,9,55,34,21,55
Lucerne,61,3,14,7,11,43,42,1,49
St Gallen,61,4,14,3,15,47,60,-13,45
FC Zürich,61,5,11,9,12,43,37,6,42
Grasshoppers,61,6,11,6,15,45,48,-3,39
FC Lugano,61,7,11,6,15,34,54,-20,39
FC Thun,61,8,10,5,17,41,61,-20,35
FC Sion,61,9,6,7,19,40,58,-18,25
Young Boys,62,1,21,6,5,69,39,30,69
FC Basel,62,2,18,9,5,58,23,35,63
Lucerne,62,3,13,8,11,45,48,-3,47
St Gallen,62,4,13,4,15,43,58,-15,43
Grasshoppers,62,5,10,8,14,45,50,-5,38
FC Zürich,62,6,9,10,13,40,40,0,37
FC Thun,62,7,10,7,15,43,54,-11,37
FC Lugano,62,8,10,7,15,30,47,-17,37
FC Sion,62,9,7,7,18,41,55,-14,28
Young Boys,63,1,22,7,3,73,36,37,73
FC Basel,63,2,19,8,5,57,24,33,65
St Gallen,63,3,15,3,14,44,56,-12,48
Lucerne,63,4,13,7,12,46,47,-1,46
FC Zürich,63,5,10,10,12,38,37,1,40
FC Thun,63,6,10,5,17,47,60,-13,35
Grasshoppers,63,7,9,7,16,40,50,-10,34
FC Lugano,63,8,9,6,17,31,50,-19,33
FC Sion,63,9,6,9,17,39,55,-16,27
Young Boys,64,1,23,7,2,73,32,41,76
FC Basel,64,2,16,9,7,54,29,25,57
St Gallen,64,3,15,3,14,43,53,-10,48
Lucerne,64,4,12,8,12,41,43,-2,44
FC Zürich,64,5,11,9,12,44,40,4,42
FC Thun,64,6,11,5,16,47,58,-11,38
FC Lugano,64,7,10,5,17,32,52,-20,35
Grasshoppers,64,8,9,6,17,38,53,-15,33
FC Sion,64,9,7,8,17,41,53,-12,29
Young Boys,65,1,21,8,3,73,35,38,71
FC Basel,65,2,17,9,6,56,27,29,60
Lucerne,65,3,15,8,9,50,42,8,53
St Gallen,65,4,14,4,14,41,52,-11,46
FC Zürich,65,5,11,9,12,42,38,4,42
FC Lugano,65,6,10,6,16,31,51,-20,36
Grasshoppers,65,7,9,6,17,41,56,-15,33
FC Thun,65,8,9,5,18,42,63,-21,32
FC Sion,65,9,7,7,18,45,57,-12,28
Young Boys,66,1,23,6,3,70,31,39,75
FC Basel,66,2,17,8,7,52,27,25,59
St Gallen,66,3,14,2,16,42,57,-15,44
FC Zürich,66,4,11,9,12,38,34,4,42
Lucerne,66,5,11,9,12,40,44,-4,42
FC Lugano,66,6,11,6,15,32,45,-13,39
FC Thun,66,7,11,5,16,44,58,-14,38
Grasshoppers,66,8,9,7,16,38,47,-9,34
FC Sion,66,9,7,8,17,40,53,-13,29
Young Boys,67,1,22,7,3,77,37,40,73
FC Basel,67,2,17,8,7,54,29,25,59
Lucerne,67,3,14,8,10,46,44,2,50
St Gallen,67,4,15,2,15,45,57,-12,47
FC Zürich,67,5,12,9,11,42,35,7,45
FC Thun,67,6,11,5,16,45,57,-12,38
Grasshoppers,67,7,8,8,16,39,51,-12,32
FC Lugano,67,8,9,5,18,32,55,-23,32
FC Sion,67,9,6,8,18,40,55,-15,26
Young Boys,68,1,21,7,4,72,35,37,70
FC Basel,68,2,16,9,7,56,31,25,57
St Gallen,68,3,17,2,13,44,50,-6,53
Lucerne,68,4,14,8,10,42,42,0,50
FC Zürich,68,5,11,9,12,44,39,5,42
FC Thun,68,6,11,5,16,48,59,-11,38
Grasshoppers,68,7,10,6,16,42,50,-8,36
FC Lugano,68,8,9,5,18,30,51,-21,32
FC Sion,68,9,6,7,19,39,60,-21,25
Young Boys,69,1,23,6,3,74,32,42,75
FC Basel,69,2,17,8,7,53,28,25,59
St Gallen,69,3,15,2,15,42,54,-12,47
FC Zürich,69,4,12,9,11,40,34,6,45
Lucerne,69,5,11,9,12,39,46,-7,42
FC Thun,69,6,11,6,15,51,62,-11,39
Grasshoppers,69,7,10,6,16,46,54,-8,36
FC Lugano,69,8,9,6,17,28,47,-19,33
FC Sion,69,9,6,8,18,38,54,-16,26
Young Boys,70,1,22,7,3,72,34,38,73
FC Basel,70,2,18,8,6,57,26,31,62
Lucerne,70,3,13,8,11,44,46,-2,47
FC Zürich,70,4,11,10,11,41,35,6,43
FC Lugano,70,5,12,5,15,31,44,-13,41
St Gallen,70,6,13,2,17,39,58,-19,41
FC Thun,70,7,9,7,16,43,59,-16,34
Grasshoppers,70,8,8,8,16,42,53,-11,32
FC Sion,70,9,6,9,17,39,53,-14,27
Young Boys,71,1,22,7,3,75,33,42,73
FC Basel,71,2,16,8,8,55,32,23,56
Lucerne,71,3,15,8,9,48,43,5,53
St Gallen,71,4,14,3,15,44,58,-14,45
FC Zürich,71,5,10,10,12,41,39,2,40
FC Thun,71,6,11,6,15,54,61,-7,39
FC Lugano,71,7,10,6,16,30,50,-20,36
Grasshoppers,71,8,8,7,17,40,55,-15,31
FC Sion,71,9,6,9,17,41,57,-16,27
Young Boys,72,1,21,8,3,70,34,36,71
FC Basel,72,2,19,8,5,55,23,32,65
Lucerne,72,3,12,10,10,42,42,0,46
St Gallen,72,4,14,3,15,44,58,-14,45
FC Zürich,72,5,10,10,12,39,38,1,40
FC Lugano,72,6,10,7,15,31,47,-16,37
FC Thun,72,7,9,7,16,41,56,-15,34
Grasshoppers,72,8,8,7,17,37,49,-12,31
FC Sion,72,9,7,8,17,42,54,-12,29
Young Boys,73,1,22,6,4,73,36,37,72
FC Basel,73,2,17,8,7,50,24,26,59
FC Zürich,73,3,13,9,10,46,34,12,48
St Gallen,73,4,14,4,14,41,53,-12,46
Lucerne,73,5,12,7,13,40,46,-6,43
Grasshoppers,73,6,11,6,15,45,49,-4,39
FC Lugano,73,7,11,5,16,32,46,-14,38
FC Thun,73,8,10,5,17,47,62,-15,35
FC Sion,73,9,5,8,19,37,61,-24,23
Young Boys,74,1,20,9,3,76,39,37,69
FC Basel,74,2,18,9,5,57,29,28,63
Lucerne,74,3,13,7,12,42,48,-6,46
St Gallen,74,4,14,2,16,43,58,-15,44
FC Zürich,74,5,10,11,11,44,38,6,41
FC Lugano,74,6,11,6,15,37,49,-12,39
Grasshoppers,74,7,9,8,15,41,49,-8,35
FC Thun,74,8,9,8,15,46,57,-11,35
FC Sion,74,9,6,8,18,39,58,-19,26
Young Boys,75,1,22,7,3,73,32,41,73
FC Basel,75,2,19,7,6,54,26,28,64
St Gallen,75,3,14,3,15,40,53,-13,45
Lucerne,75,4,12,8,12,40,44,-4,44
FC Zürich,75,5,11,10,11,40,35,5,43
FC Lugano,75,6,11,6,15,33,46,-13,39
Grasshoppers,75,7,10,7,15,40,48,-8,37
FC Thun,75,8,8,6,18,41,62,-21,30
FC Sion,75,9,6,8,18,37,52,-15,26
Young Boys,76,1,23,6,3,72,33,39,75
FC Basel,76,2,17,9,6,53,24,29,60
Lucerne,76,3,14,7,11,42,41,1,49
St Gallen,76,4,15,2,15,40,57,-17,47
FC Zürich,76,5,10,10,12,41,38,3,40
Grasshoppers,76,6,10,6,16,38,47,-9,36
FC Lugano,76,7,10,5,17,29,48,-19,35
FC Thun,76,8,9,7,16,42,56,-14,34
FC Sion,76,9,6,8,18,41,54,-13,26
FC Basel,77,1,20,7,5,57,25,32,67
Young Boys,77,2,20,7,5,68,37,31,67
St Gallen,77,3,15,2,15,44,56,-12,47
Lucerne,77,4,12,8,12,42,45,-3,44
FC Zürich,77,5,9,11,12,40,39,1,38
FC Thun,77,6,10,6,16,48,59,-11,36
FC Lugano,77,7,10,6,16,31,48,-17,36
Grasshoppers,77,8,9,8,15,42,52,-10,35
FC Sion,77,9,8,7,17,45,56,-11,31
Young Boys,78,1,22,6,4,80,39,41,72
FC Basel,78,2,18,8,6,55,28,27,62
Lucerne,78,3,13,8,11,44,43,1,47
St Gallen,78,4,15,2,15,45,58,-13,47
FC Zürich,78,5,10,10,12,40,36,4,40
Grasshoppers,78,6,9,9,14,44,51,-7,36
FC Thun,78,7,9,8,15,45,59,-14,35
FC Lugano,78,8,10,5,17,31,51,-20,35
FC Sion,78,9,5,10,17,43,62,-19,25
Young Boys,79,1,22,6,4,73,39,34,72
FC Basel,79,2,17,8,7,56,28,28,59
St Gallen,79,3,16,3,13,42,50,-8,51
FC Zürich,79,4,11,10,11,45,38,7,43
Lucerne,79,5,12,7,13,39,48,-9,43
FC Thun,79,6,11,6,15,46,58,-12,39
Grasshoppers,79,7,9,7,16,42,51,-9,34
FC Lugano,79,8,9,6,17,29,47,-18,33
FC Sion,79,9,6,9,17,43,56,-13,27
Young Boys,80,1,23,6,3,69,32,37,75
FC Basel,80,2,18,7,7,55,26,29,61
Lucerne,80,3,14,7,11,43,42,1,49
St Gallen,80,4,14,3,15,42,57,-15,45
FC Zürich,80,5,11,10,11,43,38,5,43
FC Thun,80,6,9,7,16,44,60,-16,34
FC Lugano,80,7,9,6,17,29,47,-18,33
FC Sion,80,8,8,7,17,44,55,-11,31
Grasshoppers,80,9,8,7,17,41,53,-12,31
Young Boys,81,1,23,6,3,74,36,38,75
FC Basel,81,2,18,8,6,58,27,31,62
Lucerne,81,3,14,8,10,44,42,2,50
St Gallen,81,4,13,4,15,41,57,-16,43
FC Zürich,81,5,10,10,12,38,38,0,40
FC Lugano,81,6,10,6,16,31,48,-17,36
FC Thun,81,7,10,5,17,45,64,-19,35
Grasshoppers,81,8,9,7,16,45,51,-6,34
FC Sion,81,9,6,8,18,42,55,-13,26
Young Boys,82,1,20,8,4,70,38,32,68
FC Basel,82,2,18,9,5,56,27,29,63
St Gallen,82,3,14,3,15,41,52,-11,45
Lucerne,82,4,12,8,12,42,47,-5,44
FC Zürich,82,5,11,9,12,40,38,2,42
FC Lugano,82,6,12,5,15,34,45,-11,41
Grasshoppers,82,7,9,8,15,41,49,-8,35
FC Thun,82,8,9,6,17,44,60,-16,33
FC Sion,82,9,7,8,17,39,51,-12,29
Young Boys,83,1,22,6,4,73,36,37,72
FC Basel,83,2,17,8,7,54,29,25,59
St Gallen,83,3,15,4,13,46,54,-8,49
Lucerne,83,4,11,8,13,40,46,-6,41
Grasshoppers,83,5,11,7,14,43,48,-5,40
FC Zürich,83,6,9,12,11,40,38,2,39
FC Lugano,83,7,11,5,16,32,46,-14,38
FC Thun,83,8,9,7,16,43,60,-17,34
FC Sion,83,9,6,9,17,41,55,-14,27
Young Boys,84,1,21,7,4,72,38,34,70
FC Basel,84,2,18,7,7,54,26,28,61
Lucerne,84,3,14,8,10,42,39,3,50
St Gallen,84,4,15,2,15,45,53,-8,47
FC Zürich,84,5,11,10,11,43,38,5,43
Grasshoppers,84,6,9,8,15,39,47,-8,35
FC Thun,84,7,10,5,17,42,59,-17,35
FC Lugano,84,8,9,6,17,29,53,-24,33
FC Sion,84,9,7,7,18,42,55,-13,28
Young Boys,85,1,21,7,4,69,34,35,70
FC Basel,85,2,18,7,7,53,26,27,61
Lucerne,85,3,13,9,10,43,43,0,48
St Gallen,85,4,15,2,15,43,54,-11,47
FC Zürich,85,5,9,10,13,41,40,1,37
FC Sion,85,6,10,7,15,46,54,-8,37
FC Lugano,85,7,9,8,15,32,48,-16,35
Grasshoppers,85,8,9,7,16,40,51,-11,34
FC Thun,85,9,9,5,18,42,59,-17,32
Young Boys,86,1,21,9,2,73,34,39,72
FC Basel,86,2,18,9,5,62,28,34,63
Lucerne,86,3,14,7,11,43,48,-5,49
St Gallen,86,4,13,3,16,44,61,-17,42
FC Zürich,86,5,10,10,12,41,37,4,40
FC Lugano,86,6,10,7,15,32,48,-16,37
Grasshoppers,86,7,9,7,16,40,48,-8,34
FC Thun,86,8,9,7,16,43,58,-15,34
FC Sion,86,9,7,7,18,42,58,-16,28
Young Boys,87,1,22,7,3,76,35,41,73
FC Basel,87,2,17,8,7,56,27,29,59
Lucerne,87,3,14,7,11,45,45,0,49
St Gallen,87,4,14,3,15,43,54,-11,45
FC Thun,87,5,12,5,15,50,56,-6,41
FC Zürich,87,6,10,10,12,41,38,3,40
FC Lugano,87,7,10,5,17,31,55,-24,35
Grasshoppers,87,8,9,6,17,41,56,-15,33
FC Sion,87,9,6,9,17,39,56,-17,27
Young Boys,88,1,20,7,5,67,39,28,67
FC Basel,88,2,18,8,6,57,23,34,62
St Gallen,88,3,15,3,14,46,55,-9,48
Lucerne,88,4,13,7,12,41,46,-5,46
FC Zürich,88,5,10,11,11,39,35,4,41
FC Thun,88,6,10,6,16,42,58,-16,36
FC Lugano,88,7,10,6,16,31,47,-16,36
FC Sion,88,8,8,8,16,45,53,-8,32
Grasshoppers,88,9,8,8,16,39,51,-12,32
Young Boys,89,1,21,7,4,71,37,34,70
FC Basel,89,2,18,8,6,61,27,34,62
FC Zürich,89,3,12,10,10,41,34,7,46
St Gallen,89,4,14,4,14,45,57,-12,46
Lucerne,89,5,12,9,11,41,43,-2,45
Grasshoppers,89,6,9,9,14,42,49,-7,36
FC Lugano,89,7,10,5,17,30,49,-19,35
FC Thun,89,8,8,8,16,42,61,-19,32
FC Sion,89,9,5,10,17,41,57,-16,25
Young Boys,90,1,22,6,4,69,37,32,72
FC Basel,90,2,17,8,7,56,27,29,59
Lucerne,90,3,14,7,11,45,45,0,49
St Gallen,90,4,15,2,15,49,59,-10,47
FC Zürich,90,5,10,10,12,37,35,2,40
FC Lugano,90,6,11,5,16,32,50,-18,38
FC Thun,90,7,9,7,16,43,59,-16,34
Grasshoppers,90,8,9,6,17,42,52,-10,33
FC Sion,90,9,8,7,17,45,54,-9,31
Young Boys,91,1,22,6,4,73,39,34,72
FC Basel,91,2,19,8,5,57,23,34,65
St Gallen,91,3,15,2,15,44,57,-13,47
Lucerne,91,4,12,8,12,42,47,-5,44
FC Zürich,91,5,11,10,11,43,38,5,43
FC Lugano,91,6,11,5,16,36,49,-13,38
Grasshoppers,91,7,9,8,15,44,51,-7,35
FC Thun,91,8,9,6,17,42,60,-18,33
FC Sion,91,9,5,9,18,40,57,-17,24
Young Boys,92,1,19,8,5,66,40,26,65
FC Basel,92,2,18,9,5,53,23,30,63
Lucerne,92,3,14,9,9,49,42,7,51
St Gallen,92,4,14,4,14,44,54,-10,46
FC Zürich,92,5,10,10,12,39,35,4,40
FC Lugano,92,6,11,5,16,34,48,-14,38
FC Thun,92,7,10,6,16,41,57,-16,36
Grasshoppers,92,8,8,8,16,39,51,-12,32
FC Sion,92,9,6,9,17,40,55,-15,27
Young Boys,93,1,21,7,4,70,33,37,70
FC Basel,93,2,16,7,9,50,28,22,55
Lucerne,93,3,13,9,10,43,44,-1,48
St Gallen,93,4,14,4,14,44,55,-11,46
FC Zürich,93,5,11,9,12,40,36,4,42
FC Thun,93,6,11,6,15,41,53,-12,39
FC Lugano,93,7,10,6,16,31,48,-17,36
FC Sion,93,8,8,9,15,40,50,-10,33
Grasshoppers,93,9,8,7,17,36,48,-12,31
Young Boys,94,1,21,7,4,68,34,34,70
FC Basel,94,2,19,7,6,58,27,31,64
Lucerne,94,3,13,8,11,42,47,-5,47
FC Zürich,94,4,12,10,10,45,35,10,46
St Gallen,94,5,14,2,16,44,57,-13,44
FC Lugano,94,6,10,5,17,32,51,-19,35
FC Thun,94,7,9,7,16,45,56,-11,34
Grasshoppers,94,8,8,8,16,41,52,-11,32
FC Sion,94,9,7,8,17,42,58,-16,29
Young Boys,95,1,22,6,4,73,36,37,72
FC Basel,95,2,17,8,7,55,32,23,59
St Gallen,95,3,14,5,13,42,51,-9,47
Lucerne,95,4,13,7,12,43,43,0,46
FC Zürich,95,5,11,10,11,44,37,7,43
Grasshoppers,95,6,9,7,16,40,52,-12,34
FC Thun,95,7,9,7,16,47,63,-16,34
FC Lugano,95,8,9,7,16,29,48,-19,34
FC Sion,95,9,7,9,16,43,54,-11,30
Young Boys,96,1,23,7,2,75,32,43,76
FC Basel,96,2,19,8,5,57,26,31,65
St Gallen,96,3,15,2,15,44,56,-12,47
Lucerne,96,4,13,7,12,41,46,-5,46
FC Thun,96,5,11,5,16,45,58,-13,38
FC Lugano,96,6,11,5,16,30,47,-17,38
FC Zürich,96,7,9,9,14,39,40,-1,36
Grasshoppers,96,8,9,6,17,42,50,-8,33
FC Sion,96,9,6,7,19,42,60,-18,25
Young Boys,97,1,23,6,3,74,34,40,75
FC Basel,97,2,19,7,6,62,27,35,64
St Gallen,97,3,15,2,15,44,59,-15,47
Lucerne,97,4,13,7,12,46,50,-4,46
FC Zürich,97,5,11,10,11,41,36,5,43
FC Lugano,97,6,10,5,17,31,49,-18,35
Grasshoppers,97,7,9,7,16,40,50,-10,34
FC Thun,97,8,9,7,16,46,63,-17,34
FC Sion,97,9,5,9,18,39,55,-16,24
Young Boys,98,1,22,8,2,73,33,40,74
FC Basel,98,2,19,7,6,53,26,27,64
Lucerne,98,3,12,9,11,41,44,-3,45
St Gallen,98,4,14,2,16,44,57,-13,44
FC Zürich,98,5,10,11,11,40,35,5,41
FC Lugano,98,6,10,8,14,31,45,-14,38
Grasshoppers,98,7,8,9,15,37,47,-10,33
FC Thun,98,8,9,6,17,45,59,-14,33
FC Sion,98,9,6,8,18,43,61,-18,26
Young Boys,99,1,22,7,3,74,33,41,73
FC Basel,99,2,16,9,7,52,29,23,57
Lucerne,99,3,13,9,10,43,44,-1,48
St Gallen,99,4,14,4,14,44,54,-10,46
FC Zürich,99,5,10,10,12,42,37,5,40
FC Lugano,99,6,10,8,14,32,46,-14,38
FC Thun,99,7,10,6,16,45,58,-13,36
Grasshoppers,99,8,9,6,17,39,52,-13,33
FC Sion,99,9,7,7,18,37,55,-18,28
Young Boys,100,1,23,7,2,81,38,43,76
FC Basel,100,2,17,7,8,52,30,22,58
St Gallen,100,3,16,3,13,46,53,-7,51
Lucerne,100,4,13,7,12,45,47,-2,46
FC Zürich,100,5,12,9,11,46,36,10,45
Grasshoppers,100,6,9,8,15,44,52,-8,35
FC Thun,100,7,9,7,16,43,57,-14,34
FC Lugano,100,8,9,5,18,32,55,-23,32
FC Sion,100,9,5,9,18,37,58,-21,24
Young Boys,101,1,20,8,4,69,36,33,68
FC Basel,101,2,18,8,6,59,27,32,62
St Gallen,101,3,15,2,15,44,55,-11,47
Lucerne,101,4,13,7,12,42,52,-10,46
FC Zürich,101,5,10,12,10,41,36,5,42
FC Lugano,101,6,11,5,16,34,45,-11,38
Grasshoppers,101,7,9,8,15,40,48,-8,35
FC Thun,101,8,9,6,17,43,59,-16,33
FC Sion,101,9,6,10,16,42,56,-14,28
Young Boys,102,1,19,10,3,67,34,33,67
FC Basel,102,2,19,8,5,58,23,35,65
St Gallen,102,3,14,4,14,42,54,-12,46
Lucerne,102,4,12,9,11,40,43,-3,45
FC Zürich,102,5,10,12,10,41,34,7,42
Grasshoppers,102,6,10,7,15,44,50,-6,37
FC Lugano,102,7,9,8,15,33,50,-17,35
FC Thun,102,8,9,6,17,40,60,-20,33
FC Sion,102,9,6,8,18,36,53,-17,26
Young Boys,103,1,20,7,5,68,35,33,67
FC Basel,103,2,18,8,6,55,28,27,62
St Gallen,103,3,16,3,13,44,52,-8,51
Lucerne,103,4,13,8,11,41,42,-1,47
FC Zürich,103,5,12,9,11,42,35,7,45
Grasshoppers,103,6,10,6,16,41,49,-8,36
FC Lugano,103,7,10,5,17,30,49,-19,35
FC Thun,103,8,8,6,18,41,59,-18,30
FC Sion,103,9,7,8,17,40,53,-13,29
Young Boys,104,1,22,7,3,72,33,39,73
FC Basel,104,2,16,9,7,55,30,25,57
Lucerne,104,3,14,8,10,46,43,3,50
St Gallen,104,4,15,2,15,43,55,-12,47
FC Zürich,104,5,9,13,10,40,36,4,40
Grasshoppers,104,6,9,8,15,40,48,-8,35
FC Lugano,104,7,9,6,17,31,54,-23,33
FC Thun,104,8,8,8,16,42,59,-17,32
FC Sion,104,9,7,9,16,40,51,-11,30
Young Boys,105,1,22,7,3,71,32,39,73
FC Basel,105,2,18,9,5,56,26,30,63
FC Zürich,105,3,11,11,10,42,35,7,44
St Gallen,105,4,14,2,16,42,54,-12,44
Lucerne,105,5,12,7,13,37,44,-7,43
FC Thun,105,6,10,7,15,46,58,-12,37
FC Lugano,105,7,10,5,17,29,49,-20,35
Grasshoppers,105,8,9,6,17,38,49,-11,33
FC Sion,105,9,7,8,17,39,53,-14,29
Young Boys,106,1,20,7,5,72,40,32,67
FC Basel,106,2,17,9,6,57,28,29,60
Lucerne,106,3,14,9,9,49,44,5,51
St Gallen,106,4,13,4,15,43,58,-15,43
FC Zürich,106,5,10,12,10,40,35,5,42
FC Lugano,106,6,10,7,15,32,47,-15,37
FC Sion,106,7,8,9,15,42,51,-9,33
Grasshoppers,106,8,9,6,17,42,54,-12,33
FC Thun,106,9,9,5,18,40,60,-20,32
Young Boys,107,1,23,7,2,78,32,46,76
FC Basel,107,2,17,9,6,53,26,27,60
FC Zürich,107,3,12,10,10,43,34,9,46
Lucerne,107,4,12,9,11,42,43,-1,45
St Gallen,107,5,14,2,16,42,59,-17,44
FC Lugano,107,6,11,6,15,32,51,-19,39
Grasshoppers,107,7,8,8,16,39,49,-10,32
FC Thun,107,8,9,5,18,43,63,-20,32
FC Sion,107,9,6,8,18,38,53,-15,26
Young Boys,108,1,22,8,2,75,32,43,74
FC Basel,108,2,17,8,7,49,26,23,59
St Gallen,108,3,14,5,13,42,52,-10,47
FC Zürich,108,4,11,11,10,42,32,10,44
Lucerne,108,5,12,8,12,40,44,-4,44
FC Lugano,108,6,9,9,14,29,44,-15,36
FC Thun,108,7,9,7,16,39,54,-15,34
Grasshoppers,108,8,8,8,16,38,49,-11,32
FC Sion,108,9,6,8,18,36,57,-21,26
Young Boys,109,1,23,6,3,72,35,37,75
FC Basel,109,2,19,7,6,53,23,30,64
Lucerne,109,3,12,9,11,42,45,-3,45
St Gallen,109,4,13,3,16,39,54,-15,42
FC Zürich,109,5,10,9,13,43,43,0,39
FC Lugano,109,6,11,5,16,31,46,-15,38
FC Thun,109,7,10,6,16,46,59,-13,36
Grasshoppers,109,8,9,7,16,42,50,-8,34
FC Sion,109,9,7,8,17,43,56,-13,29
Young Boys,110,1,20,7,5,68,38,30,67
FC Basel,110,2,17,10,5,55,25,30,61
Lucerne,110,3,13,9,10,43,44,-1,48
St Gallen,110,4,15,3,14,42,53,-11,48
FC Zürich,110,5,9,12,11,38,37,1,39
FC Thun,110,6,11,6,15,48,56,-8,39
Grasshoppers,110,7,10,7,15,40,49,-9,37
FC Lugano,110,8,10,6,16,32,47,-15,36
FC Sion,110,9,5,8,19,36,53,-17,23
Young Boys,111,1,20,6,6,71,41,30,66
FC Basel,111,2,19,7,6,56,25,31,64
Lucerne,111,3,14,9,9,42,39,3,51
St Gallen,111,4,14,3,15,41,55,-14,45
Grasshoppers,111,5,11,7,14,44,46,-2,40
FC Zürich,111,6,10,9,13,39,40,-1,39
FC Thun,111,7,10,5,17,46,58,-12,35
FC Lugano,111,8,10,5,17,30,48,-18,35
FC Sion,111,9,7,7,18,40,57,-17,28
Young Boys,112,1,22,7,3,79,36,43,73
FC Basel,112,2,17,9,6,56,26,30,60
Lucerne,112,3,14,8,10,46,43,3,50
FC Zürich,112,4,12,10,10,45,36,9,46
St Gallen,112,5,13,3,16,41,57,-16,42
FC Lugano,112,6,10,6,16,30,48,-18,36
FC Sion,112,7,8,8,16,40,51,-11,32
FC Thun,112,8,9,5,18,42,63,-21,32
Grasshoppers,112,9,8,6,18,37,56,-19,30
Young Boys,113,1,22,8,2,73,33,40,74
FC Basel,113,2,16,10,6,52,25,27,58
Lucerne,113,3,13,9,10,43,41,2,48
St Gallen,113,4,15,2,15,42,52,-10,47
FC Zürich,113,5,11,10,11,41,35,6,43
FC Lugano,113,6,11,5,16,30,45,-15,38
Grasshoppers,113,7,10,6,16,39,51,-12,36
FC Thun,113,8,8,5,19,39,61,-22,29
FC Sion,113,9,7,7,18,37,53,-16,28
Young Boys,114,1,21,8,3,70,35,35,71
FC Basel,114,2,17,9,6,56,26,30,60
Lucerne,114,3,14,7,11,42,44,-2,49
St Gallen,114,4,14,5,13,44,53,-9,47
FC Zürich,114,5,11,10,11,41,36,5,43
Grasshoppers,114,6,9,8,15,39,47,-8,35
FC Lugano,114,7,9,6,17,32,51,-19,33
FC Thun,114,8,8,7,17,40,59,-19,31
FC Sion,114,9,7,8,17,41,54,-13,29
Young Boys,115,1,21,6,5,68,37,31,69
FC Basel,115,2,18,8,6,55,28,27,62
Lucerne,115,3,13,7,12,47,47,0,46
St Gallen,115,4,14,2,16,42,58,-16,44
FC Zürich,115,5,10,10,12,42,40,2,40
FC Thun,115,6,11,6,15,51,57,-6,39
FC Lugano,115,7,11,5,16,37,49,-12,38
Grasshoppers,115,8,10,6,16,41,53,-12,36
FC Sion,115,9,7,8,17,40,54,-14,29
Young Boys,116,1,23,6,3,72,33,39,75
FC Basel,116,2,16,11,5,50,24,26,59
Lucerne,116,3,13,9,10,42,40,2,48
St Gallen,116,4,14,4,14,40,54,-14,46
FC Zürich,116,5,10,10,12,42,42,0,40
FC Thun,116,6,9,8,15,43,57,-14,35
FC Lugano,116,7,10,5,17,33,48,-15,35
Grasshoppers,116,8,8,7,17,39,52,-13,31
FC Sion,116,9,7,8,17,42,53,-11,29
Young Boys,117,1,23,7,2,73,35,38,76
FC Basel,117,2,19,8,5,61,23,38,65
St Gallen,117,3,15,2,15,43,55,-12,47
Lucerne,117,4,13,7,12,44,49,-5,46
FC Zürich,117,5,10,11,11,39,36,3,41
FC Thun,117,6,9,7,16,44,62,-18,34
FC Lugano,117,7,9,5,18,30,51,-21,32
Grasshoppers,117,8,8,7,17,41,52,-11,31
FC Sion,117,9,6,10,16,43,55,-12,28
Young Boys,118,1,23,7,2,76,33,43,76
FC Basel,118,2,17,8,7,51,25,26,59
St Gallen,118,3,15,2,15,44,54,-10,47
FC Zürich,118,4,11,11,10,45,35,10,44
Lucerne,118,5,12,8,12,40,46,-6,44
Grasshoppers,118,6,10,7,15,43,48,-5,37
FC Lugano,118,7,10,6,16,31,52,-21,36
FC Thun,118,8,9,6,17,42,59,-17,33
FC Sion,118,9,5,9,18,37,57,-20,24
Young Boys,119,1,20,8,4,71,37,34,68
FC Basel,119,2,19,8,5,58,25,33,65
St Gallen,119,3,15,3,14,44,53,-9,48
Lucerne,119,4,13,7,12,41,43,-2,46
FC Zürich,119,5,10,11,11,39,37,2,41
FC Lugano,119,6,10,7,15,31,47,-16,37
Grasshoppers,119,7,9,8,15,41,50,-9,35
FC Thun,119,8,9,7,16,45,62,-17,34
FC Sion,119,9,6,7,19,42,58,-16,25
Young Boys,120,1,21,6,5,72,40,32,69
FC Basel,120,2,19,8,5,57,25,32,65
St Gallen,120,3,15,2,15,45,57,-12,47
Lucerne,120,4,12,9,11,41,44,-3,45
FC Zürich,120,5,10,10,12,40,37,3,40
FC Lugano,120,6,10,5,17,31,50,-19,35
FC Thun,120,7,9,7,16,40,56,-16,34
FC Sion,120,8,8,9,15,44,50,-6,33
Grasshoppers,120,9,8,8,16,41,52,-11,32
Young Boys,121,1,22,7,3,71,35,36,73
FC Basel,121,2,18,8,6,56,28,28,62
St Gallen,121,3,14,3,15,41,54,-13,45
FC Zürich,121,4,11,11,10,44,37,7,44
Lucerne,121,5,11,8,13,40,47,-7,41
Grasshoppers,121,6,11,7,14,43,47,-4,40
FC Lugano,121,7,10,7,15,30,43,-13,37
FC Thun,121,8,8,7,17,41,60,-19,31
FC Sion,121,9,5,10,17,38,53,-15,25
Young Boys,122,1,21,7,4,68,35,33,70
FC Basel,122,2,19,8,5,56,23,33,65
Lucerne,122,3,13,8,11,41,43,-2,47
St Gallen,122,4,13,3,16,41,57,-16,42
FC Zürich,122,5,10,11,11,42,36,6,41
Grasshoppers,122,6,10,7,15,43,49,-6,37
FC Lugano,122,7,10,6,16,32,48,-16,36
FC Thun,122,8,8,7,17,42,63,-21,31
FC Sion,122,9,6,11,15,39,50,-11,29
Young Boys,123,1,23,6,3,75,34,41,75
FC Basel,123,2,18,7,7,57,28,29,61
St Gallen,123,3,16,2,14,48,52,-4,50
Lucerne,123,4,12,7,13,40,48,-8,43
FC Zürich,123,5,10,11,11,41,37,4,41
Grasshoppers,123,6,11,6,15,41,48,-7,39
FC Thun,123,7,10,6,16,46,60,-14,36
FC Lugano,123,8,10,5,17,29,49,-20,35
FC Sion,123,9,5,8,19,38,59,-21,23
Young Boys,124,1,21,6,5,69,36,33,69
FC Basel,124,2,19,7,6,57,26,31,64
Lucerne,124,3,15,7,10,42,40,2,52
St Gallen,124,4,14,4,14,42,54,-12,46
FC Zürich,124,5,9,11,12,38,38,0,38
FC Thun,124,6,11,5,16,49,60,-11,38
FC Lugano,124,7,9,7,16,29,47,-18,34
Grasshoppers,124,8,8,7,17,40,53,-13,31
FC Sion,124,9,6,10,16,39,51,-12,28
Young Boys,125,1,21,6,5,76,38,38,69
FC Basel,125,2,17,7,8,49,26,23,58
St Gallen,125,3,15,4,13,45,54,-9,49
Lucerne,125,4,13,8,11,42,46,-4,47
FC Zürich,125,5,11,9,12,39,34,5,42
FC Lugano,125,6,10,7,15,31,48,-17,37
FC Thun,125,7,10,6,16,46,55,-9,36
Grasshoppers,125,8,9,7,16,40,49,-9,34
FC Sion,125,9,7,8,17,41,59,-18,29
Young Boys,126,1,23,6,3,77,36,41,75
FC Basel,126,2,17,8,7,56,26,30,59
Lucerne,126,3,13,9,10,43,43,0,48
St Gallen,126,4,13,4,15,41,56,-15,43
FC Zürich,126,5,10,11,11,40,36,4,41
FC Thun,126,6,11,5,16,47,62,-15,38
FC Lugano,126,7,9,8,15,31,49,-18,35
Grasshoppers,126,8,9,7,16,39,50,-11,34
FC Sion,126,9,6,8,18,43,59,-16,26
Young Boys,127,1,22,7,3,74,35,39,73
FC Basel,127,2,17,8,7,52,28,24,59
St Gallen,127,3,14,3,15,43,55,-12,45
Lucerne,127,4,12,7,13,39,46,-7,43
FC Zürich,127,5,11,9,12,41,36,5,42
FC Lugano,127,6,11,6,15,33,47,-14,39
Grasshoppers,127,7,10,8,14,43,46,-3,38
FC Thun,127,8,9,7,16,42,58,-16,34
FC Sion,127,9,7,7,18,40,56,-16,28
Young Boys,128,1,21,7,4,73,40,33,70
FC Basel,128,2,18,9,5,54,24,30,63
St Gallen,128,3,15,4,13,43,51,-8,49
Lucerne,128,4,12,8,12,41,46,-5,44
FC Zürich,128,5,10,10,12,41,37,4,40
Grasshoppers,128,6,10,7,15,46,49,-3,37
FC Lugano,128,7,10,7,15,34,49,-15,37
FC Thun,128,8,10,5,17,43,58,-15,35
FC Sion,128,9,5,9,18,38,59,-21,24
Young Boys,129,1,22,8,2,74,36,38,74
FC Basel,129,2,17,10,5,53,24,29,61
St Gallen,129,3,15,3,14,42,52,-10,48
Lucerne,129,4,12,8,12,42,43,-1,44
FC Lugano,129,5,11,6,15,35,47,-12,39
FC Zürich,129,6,9,11,12,40,39,1,38
FC Thun,129,7,10,6,16,48,62,-14,36
Grasshoppers,129,8,8,8,16,41,55,-14,32
FC Sion,129,9,6,8,18,38,55,-17,26
Young Boys,130,1,21,7,4,71,39,32,70
FC Basel,130,2,17,9,6,51,24,27,60
St Gallen,130,3,14,4,14,45,52,-7,46
Lucerne,130,4,11,9,12,42,47,-5,42
FC Zürich,130,5,10,11,11,44,41,3,41
FC Thun,130,6,12,5,15,47,56,-9,41
FC Lugano,130,7,10,6,16,33,53,-20,36
Grasshoppers,130,8,9,8,15,44,51,-7,35
FC Sion,130,9,6,9,17,40,54,-14,27
Young Boys,131,1,22,6,4,68,34,34,72
FC Basel,131,2,17,7,8,51,25,26,58
St Gallen,131,3,17,2,13,47,52,-5,53
Lucerne,131,4,14,8,10,43,41,2,50
FC Zürich,131,5,11,10,11,38,34,4,43
FC Lugano,131,6,10,6,16,31,47,-16,36
FC Thun,131,7,10,5,17,43,59,-16,35
Grasshoppers,131,8,9,6,17,42,49,-7,33
FC Sion,131,9,5,8,19,36,58,-22,23
Young Boys,132,1,21,7,4,72,36,36,70
FC Basel,132,2,18,7,7,59,28,31,61
St Gallen,132,3,15,3,14,44,56,-12,48
FC Zürich,132,4,12,10,10,41,34,7,46
Lucerne,132,5,12,8,12,40,45,-5,44
FC Thun,132,6,10,5,17,45,61,-16,35
FC Lugano,132,7,9,6,17,29,50,-21,33
FC Sion,132,8,8,8,16,42,50,-8,32
Grasshoppers,132,9,8,8,16,40,52,-12,32
Young Boys,133,1,22,7,3,76,38,38,73
FC Basel,133,2,18,9,5,61,29,32,63
St Gallen,133,3,15,3,14,45,57,-12,48
Lucerne,133,4,12,8,12,42,49,-7,44
FC Zürich,133,5,10,9,13,43,43,0,39
Grasshoppers,133,6,11,6,15,42,46,-4,39
FC Lugano,133,7,11,5,16,39,51,-12,38
FC Thun,133,8,9,6,17,42,57,-15,33
FC Sion,133,9,5,9,18,37,57,-20,24
Young Boys,134,1,23,6,3,72,34,38,75
FC Basel,134,2,18,8,6,52,23,29,62
St Gallen,134,3,15,3,14,45,55,-10,48
Lucerne,134,4,13,7,12,44,45,-1,46
FC Zürich,134,5,11,11,10,40,34,6,44
Grasshoppers,134,6,9,7,16,42,52,-10,34
FC Lugano,134,7,9,6,17,31,50,-19,33
FC Thun,134,8,8,7,17,39,58,-19,31
FC Sion,134,9,6,9,17,41,55,-14,27
Young Boys,135,1,21,7,4,73,40,33,70
FC Basel,135,2,19,8,5,59,27,32,65
Lucerne,135,3,13,8,11,43,46,-3,47
St Gallen,135,4,14,4,14,42,52,-10,46
FC Zürich,135,5,12,9,11,46,37,9,45
Grasshoppers,135,6,9,7,16,42,51,-9,34
FC Thun,135,7,9,7,16,44,61,-17,34
FC Lugano,135,8,9,6,17,28,48,-20,33
FC Sion,135,9,6,8,18,40,55,-15,26
Young Boys,136,1,23,6,3,75,37,38,75
FC Basel,136,2,17,8,7,58,27,31,59
Lucerne,136,3,13,8,11,39,42,-3,47
St Gallen,136,4,14,3,15,43,58,-15,45
FC Zürich,136,5,11,10,11,44,39,5,43
FC Lugano,136,6,11,6,15,33,44,-11,39
Grasshoppers,136,7,10,6,16,41,51,-10,36
FC Thun,136,8,9,6,17,42,59,-17,33
FC Sion,136,9,6,7,19,45,63,-18,25
Young Boys,137,1,20,8,4,72,41,31,68
FC Basel,137,2,18,8,6,54,28,26,62
St Gallen,137,3,15,3,14,47,54,-7,48
Lucerne,137,4,13,8,11,45,43,2,47
FC Zürich,137,5,10,11,11,40,36,4,41
Grasshoppers,137,6,10,6,16,41,47,-6,36
FC Lugano,137,7,9,7,16,31,51,-20,34
FC Sion,137,8,8,8,16,42,52,-10,32
FC Thun,137,9,9,5,18,40,60,-20,32
Young Boys,138,1,22,8,2,70,31,39,74
FC Basel,138,2,15,11,6,49,25,24,56
St Gallen,138,3,15,3,14,47,52,-5,48
FC Zürich,138,4,11,11,10,43,35,8,44
Lucerne,138,5,12,8,12,39,44,-5,44
Grasshoppers,138,6,10,7,15,40,49,-9,37
FC Lugano,138,7,10,6,16,31,48,-17,36
FC Thun,138,8,9,6,17,43,60,-17,33
FC Sion,138,9,5,10,17,40,58,-18,25
Young Boys,139,1,22,6,4,70,37,33,72
FC Basel,139,2,18,8,6,58,27,31,62
Lucerne,139,3,13,8,11,44,45,-1,47
St Gallen,139,4,14,4,14,44,57,-13,46
FC Zürich,139,5,12,9,11,42,36,6,45
Grasshoppers,139,6,10,7,15,43,49,-6,37
FC Thun,139,7,9,7,16,42,60,-18,34
FC Lugano,139,8,9,5,18,30,49,-19,32
FC Sion,139,9,6,8,18,39,52,-13,26
Young Boys,140,1,22,6,4,75,35,40,72
FC Basel,140,2,18,9,5,55,23,32,63
St Gallen,140,3,14,3,15,42,55,-13,45
Lucerne,140,4,12,8,12,39,48,-9,44
FC Zürich,140,5,10,9,13,41,40,1,39
Grasshoppers,140,6,10,8,14,42,47,-5,38
FC Lugano,140,7,11,5,16,31,48,-17,38
FC Thun,140,8,9,7,16,42,56,-14,34
FC Sion,140,9,7,7,18,42,57,-15,28
Young Boys,141,1,21,8,3,70,34,36,71
FC Basel,141,2,16,8,8,52,28,24,56
St Gallen,141,3,16,3,13,44,51,-7,51
Lucerne,141,4,13,8,11,40,41,-1,47
FC Zürich,141,5,11,10,11,40,35,5,43
Grasshoppers,141,6,10,7,15,45,50,-5,37
FC Thun,141,7,9,8,15,46,60,-14,35
FC Lugano,141,8,10,5,17,29,49,-20,35
FC Sion,141,9,5,9,18,37,55,-18,24
Young Boys,142,1,20,7,5,67,37,30,67
FC Basel,142,2,19,8,5,58,22,36,65
St Gallen,142,3,15,3,14,41,53,-12,48
Lucerne,142,4,13,7,12,42,48,-6,46
FC Zürich,142,5,11,9,12,42,38,4,42
Grasshoppers,142,6,10,7,15,42,48,-6,37
FC Sion,142,7,9,8,15,44,50,-6,35
FC Lugano,142,8,9,5,18,31,50,-19,32
FC Thun,142,9,8,6,18,41,62,-21,30
Young Boys,143,1,22,6,4,75,38,37,72
FC Basel,143,2,18,9,5,58,26,32,63
Lucerne,143,3,15,7,10,47,44,3,52
St Gallen,143,4,14,3,15,43,55,-12,45
FC Zürich,143,5,10,10,12,39,38,1,40
FC Thun,143,6,10,6,16,41,55,-14,36
Grasshoppers,143,7,8,8,16,39,52,-13,32
FC Lugano,143,8,9,5,18,29,49,-20,32
FC Sion,143,9,7,8,17,40,54,-14,29
Young Boys,144,1,21,7,4,69,34,35,70
FC Basel,144,2,18,7,7,51,26,25,61
St Gallen,144,3,15,2,15,44,53,-9,47
Lucerne,144,4,13,7,12,41,44,-3,46
FC Zürich,144,5,10,9,13,40,40,0,39
FC Lugano,144,6,11,5,16,30,46,-16,38
FC Sion,144,7,10,7,15,45,50,-5,37
FC Thun,144,8,10,5,17,47,59,-12,35
Grasshoppers,144,9,8,7,17,39,54,-15,31
Young Boys,145,1,22,7,3,72,34,38,73
FC Basel,145,2,18,8,6,55,25,30,62
Lucerne,145,3,14,8,10,45,42,3,50
St Gallen,145,4,13,3,16,42,62,-20,42
FC Zürich,145,5,10,10,12,39,37,2,40
Grasshoppers,145,6,10,7,15,43,52,-9,37
FC Lugano,145,7,10,6,16,37,50,-13,36
FC Thun,145,8,10,5,17,52,61,-9,35
FC Sion,145,9,6,8,18,37,59,-22,26
Young Boys,146,1,22,6,4,74,39,35,72
FC Basel,146,2,18,8,6,54,24,30,62
Lucerne,146,3,13,9,10,42,44,-2,48
St Gallen,146,4,15,3,14,45,53,-8,48
FC Zürich,146,5,9,12,11,41,38,3,39
FC Thun,146,6,10,6,16,46,56,-10,36
FC Lugano,146,7,9,7,16,33,52,-19,34
Grasshoppers,146,8,8,7,17,37,52,-15,31
FC Sion,146,9,7,8,17,39,53,-14,29
Young Boys,147,1,22,8,2,69,31,38,74
FC Basel,147,2,16,9,7,50,27,23,57
St Gallen,147,3,15,3,14,43,54,-11,48
Lucerne,147,4,13,8,11,40,40,0,47
FC Zürich,147,5,12,9,11,41,35,6,45
FC Thun,147,6,10,5,17,44,58,-14,35
FC Lugano,147,7,9,6,17,31,50,-19,33
FC Sion,147,8,8,8,16,41,50,-9,32
Grasshoppers,147,9,8,6,18,40,54,-14,30
Young Boys,148,1,20,9,3,72,38,34,69
FC Basel,148,2,18,9,5,56,26,30,63
St Gallen,148,3,15,4,13,45,52,-7,49
Lucerne,148,4,13,7,12,45,47,-2,46
FC Zürich,148,5,11,9,12,39,38,1,42
FC Thun,148,6,11,5,16,48,57,-9,38
Grasshoppers,148,7,10,6,16,42,52,-10,36
FC Lugano,148,8,9,6,17,33,52,-19,33
FC Sion,148,9,5,9,18,36,54,-18,24
Young Boys,149,1,22,7,3,76,34,42,73
FC Basel,149,2,18,8,6,53,26,27,62
St Gallen,149,3,15,4,13,44,51,-7,49
Lucerne,149,4,12,9,11,41,44,-3,45
FC Zürich,149,5,11,9,12,43,37,6,42
FC Lugano,149,6,10,8,14,31,44,-13,38
FC Thun,149,7,10,5,17,44,59,-15,35
Grasshoppers,149,8,8,6,18,37,54,-17,30
FC Sion,149,9,6,8,18,40,60,-20,26
Young Boys,150,1,23,7,2,73,33,40,76
FC Basel,150,2,18,7,7,51,23,28,61
Lucerne,150,3,13,8,11,43,43,0,47
St Gallen,150,4,14,2,16,41,58,-17,44
FC Thun,150,5,11,5,16,46,59,-13,38
FC Lugano,150,6,11,5,16,34,48,-14,38
FC Zürich,150,7,9,10,13,41,41,0,37
Grasshoppers,150,8,10,6,16,43,52,-9,36
FC Sion,150,9,6,8,18,43,58,-15,26
Young Boys,151,1,22,6,4,79,35,44,72
FC Basel,151,2,19,8,5,52,23,29,65
St Gallen,151,3,14,2,16,45,58,-13,44
FC Zürich,151,4,11,10,11,45,36,9,43
Lucerne,151,5,12,7,13,40,51,-11,43
FC Lugano,151,6,11,5,16,31,49,-18,38
Grasshoppers,151,7,10,7,15,42,53,-11,37
FC Thun,151,8,9,6,17,44,59,-15,33
FC Sion,151,9,7,7,18,46,60,-14,28
Young Boys,152,1,21,7,4,75,40,35,70
FC Basel,152,2,18,8,6,54,27,27,62
St Gallen,152,3,14,5,13,46,55,-9,47
Lucerne,152,4,11,10,11,42,47,-5,43
FC Lugano,152,5,11,7,14,31,44,-13,40
FC Zürich,152,6,9,11,12,39,37,2,38
Grasshoppers,152,7,10,7,15,45,52,-7,37
FC Sion,152,8,7,9,16,47,56,-9,30
FC Thun,152,9,8,6,18,41,62,-21,30
Young Boys,153,1,22,7,3,68,32,36,73
FC Basel,153,2,18,7,7,52,25,27,61
St Gallen,153,3,14,3,15,41,53,-12,45
Lucerne,153,4,11,9,12,40,44,-4,42
FC Lugano,153,5,12,5,15,36,45,-9,41
FC Zürich,153,6,10,10,12,39,41,-2,40
FC Thun,153,7,11,5,16,46,57,-11,38
Grasshoppers,153,8,8,9,15,39,49,-10,33
FC Sion,153,9,6,9,17,40,55,-15,27
Young Boys,154,1,20,9,3,68,33,35,69
FC Basel,154,2,19,8,5,53,23,30,65
Lucerne,154,3,13,8,11,44,41,3,47
St Gallen,154,4,15,2,15,44,56,-12,47
FC Zürich,154,5,11,10,11,44,38,6,43
FC Lugano,154,6,10,6,16,32,50,-18,36
FC Thun,154,7,9,6,17,44,60,-16,33
Grasshoppers,154,8,8,7,17,40,54,-14,31
FC Sion,154,9,7,8,17,44,58,-14,29
Young Boys,155,1,20,6,6,72,42,30,66
FC Basel,155,2,19,8,5,53,23,30,65
Lucerne,155,3,13,8,11,44,44,0,47
St Gallen,155,4,13,5,14,42,55,-13,44
Grasshoppers,155,5,11,7,14,46,49,-3,40
FC Zürich,155,6,9,10,13,40,41,-1,37
FC Lugano,155,7,10,7,15,34,50,-16,37
FC Thun,155,8,9,6,17,43,59,-16,33
FC Sion,155,9,6,11,15,42,53,-11,29
Young Boys,156,1,20,7,5,72,38,34,67
FC Basel,156,2,19,8,5,56,23,33,65
Lucerne,156,3,13,9,10,41,43,-2,48
FC Zürich,156,4,11,11,10,42,35,7,44
St Gallen,156,5,13,4,15,41,57,-16,43
FC Thun,156,6,10,5,17,46,56,-10,35
FC Lugano,156,7,9,7,16,29,50,-21,34
Grasshoppers,156,8,9,6,17,41,56,-15,33
FC Sion,156,9,8,7,17,46,56,-10,31
Young Boys,157,1,22,8,2,79,38,41,74
FC Basel,157,2,17,8,7,49,26,23,59
St Gallen,157,3,14,3,15,44,55,-11,45
FC Zürich,157,4,11,11,10,45,37,8,44
Lucerne,157,5,12,8,12,42,48,-6,44
FC Lugano,157,6,10,6,16,35,53,-18,36
Grasshoppers,157,7,9,7,16,47,56,-9,34
FC Sion,157,8,7,10,15,44,54,-10,31
FC Thun,157,9,8,7,17,42,60,-18,31
Young Boys,158,1,20,10,2,74,36,38,70
FC Basel,158,2,18,9,5,53,24,29,63
Lucerne,158,3,12,9,11,42,46,-4,45
St Gallen,158,4,14,2,16,42,55,-13,44
FC Zürich,158,5,10,10,12,39,36,3,40
FC Lugano,158,6,10,5,17,30,50,-20,35
Grasshoppers,158,7,8,10,14,41,49,-8,34
FC Sion,158,8,8,9,15,43,52,-9,33
FC Thun,158,9,8,8,16,39,55,-16,32
Young Boys,159,1,22,8,2,79,35,44,74
FC Basel,159,2,17,10,5,55,27,28,61
Lucerne,159,3,13,8,11,43,44,-1,47
St Gallen,159,4,13,3,16,41,56,-15,42
FC Zürich,159,5,10,11,11,42,38,4,41
FC Lugano,159,6,12,5,15,33,52,-19,41
Grasshoppers,159,7,9,7,16,42,50,-8,34
FC Thun,159,8,8,7,17,44,63,-19,31
FC Sion,159,9,7,7,18,42,56,-14,28
Young Boys,160,1,20,7,5,68,38,30,67
FC Basel,160,2,18,8,6,53,25,28,62
St Gallen,160,3,15,2,15,43,55,-12,47
Lucerne,160,4,13,7,12,41,45,-4,46
FC Zürich,160,5,11,9,12,44,39,5,42
FC Lugano,160,6,12,5,15,36,44,-8,41
Grasshoppers,160,7,9,8,15,40,48,-8,35
FC Sion,160,8,8,7,17,41,53,-12,31
FC Thun,160,9,8,7,17,41,60,-19,31
Young Boys,161,1,21,8,3,71,35,36,71
FC Basel,161,2,19,7,6,54,23,31,64
Lucerne,161,3,13,8,11,45,45,0,47
St Gallen,161,4,14,2,16,44,57,-13,44
FC Zürich,161,5,11,10,11,39,36,3,43
FC Lugano,161,6,11,5,16,33,47,-14,38
FC Thun,161,7,10,5,17,45,59,-14,35
Grasshoppers,161,8,8,8,16,41,53,-12,32
FC Sion,161,9,6,9,17,40,57,-17,27
Young Boys,162,1,22,6,4,71,34,37,72
FC Basel,162,2,18,9,5,55,24,31,63
Lucerne,162,3,14,8,10,44,43,1,50
St Gallen,162,4,15,3,14,44,53,-9,48
FC Zürich,162,5,10,9,13,39,39,0,39
FC Lugano,162,6,11,5,16,30,45,-15,38
Grasshoppers,162,7,9,6,17,39,50,-11,33
FC Thun,162,8,9,5,18,41,60,-19,32
FC Sion,162,9,7,7,18,40,55,-15,28
Young Boys,163,1,22,7,3,73,36,37,73
FC Basel,163,2,17,8,7,53,27,26,59
St Gallen,163,3,14,3,15,42,55,-13,45
Lucerne,163,4,12,8,12,40,46,-6,44
FC Zürich,163,5,9,12,11,39,36,3,39
FC Thun,163,6,11,5,16,42,56,-14,38
FC Lugano,163,7,10,7,15,33,47,-14,37
Grasshoppers,163,8,10,6,16,44,51,-7,36
FC Sion,163,9,7,8,17,41,53,-12,29
Young Boys,164,1,20,9,3,74,39,35,69
FC Basel,164,2,18,9,5,57,24,33,63
St Gallen,164,3,16,2,14,43,52,-9,50
Lucerne,164,4,11,8,13,38,49,-11,41
FC Zürich,164,5,10,9,13,40,38,2,39
FC Lugano,164,6,11,6,15,33,47,-14,39
FC Thun,164,7,10,7,15,46,59,-13,37
Grasshoppers,164,8,9,6,17,44,54,-10,33
FC Sion,164,9,7,8,17,46,59,-13,29
Young Boys,165,1,21,8,3,71,36,35,71
FC Basel,165,2,16,8,8,52,32,20,56
Lucerne,165,3,12,10,10,45,42,3,46
St Gallen,165,4,14,3,15,43,54,-11,45
FC Zürich,165,5,10,11,11,41,37,4,41
FC Lugano,165,6,11,6,15,30,44,-14,39
Grasshoppers,165,7,10,7,15,43,53,-10,37
FC Thun,165,8,8,9,15,45,60,-15,33
FC Sion,165,9,6,10,16,44,56,-12,28
Young Boys,166,1,21,8,3,74,34,40,71
FC Basel,166,2,17,10,5,57,29,28,61
St Gallen,166,3,13,4,15,40,53,-13,43
FC Zürich,166,4,10,11,11,41,40,1,41
Lucerne,166,5,11,8,13,40,50,-10,41
FC Lugano,166,6,11,6,15,33,48,-15,39
Grasshoppers,166,7,10,7,15,42,50,-8,37
FC Thun,166,8,10,5,17,46,60,-14,35
FC Sion,166,9,8,7,17,45,54,-9,31
Young Boys,167,1,22,7,3,72,32,40,73
FC Basel,167,2,17,9,6,54,25,29,60
St Gallen,167,3,14,3,15,46,59,-13,45
Lucerne,167,4,12,8,12,42,51,-9,44
FC Zürich,167,5,11,10,11,45,37,8,43
FC Thun,167,6,10,6,16,43,60,-17,36
FC Lugano,167,7,9,8,15,30,47,-17,35
Grasshoppers,167,8,9,6,17,40,54,-14,33
FC Sion,167,9,8,7,17,46,53,-7,31
Young Boys,168,1,22,6,4,73,34,39,72
FC Basel,168,2,18,8,6,55,29,26,62
Lucerne,168,3,14,7,11,46,43,3,49
St Gallen,168,4,14,4,14,44,57,-13,46
FC Zürich,168,5,11,10,11,45,38,7,43
Grasshoppers,168,6,11,6,15,43,49,-6,39
FC Thun,168,7,10,6,16,48,57,-9,36
FC Lugano,168,8,9,5,18,28,51,-23,32
FC Sion,168,9,5,8,19,40,64,-24,23
Young Boys,169,1,22,8,2,71,33,38,74
FC Basel,169,2,18,8,6,54,24,30,62
Lucerne,169,3,12,9,11,42,47,-5,45
St Gallen,169,4,13,5,14,41,54,-13,44
FC Zürich,169,5,9,11,12,39,37,2,38
Grasshoppers,169,6,10,8,14,45,48,-3,38
FC Lugano,169,7,9,7,16,32,51,-19,34
FC Sion,169,8,8,7,17,41,52,-11,31
FC Thun,169,9,8,7,17,41,60,-19,31
Young Boys,170,1,22,8,2,69,31,38,74
FC Basel,170,2,17,9,6,53,24,29,60
Lucerne,170,3,12,10,10,41,42,-1,46
St Gallen,170,4,14,2,16,46,60,-14,44
FC Lugano,170,5,12,5,15,37,49,-12,41
FC Zürich,170,6,10,10,12,39,39,0,40
FC Thun,170,7,10,6,16,46,59,-13,36
Grasshoppers,170,8,9,8,15,42,49,-7,35
FC Sion,170,9,5,8,19,39,59,-20,23
Young Boys,171,1,22,7,3,76,36,40,73
FC Basel,171,2,19,8,5,57,22,35,65
St Gallen,171,3,14,3,15,44,57,-13,45
FC Zürich,171,4,10,11,11,40,38,2,41
Lucerne,171,5,11,8,13,38,51,-13,41
FC Lugano,171,6,10,6,16,33,49,-16,36
FC Thun,171,7,10,5,17,45,60,-15,35
Grasshoppers,171,8,9,7,16,40,50,-10,34
FC Sion,171,9,7,9,16,41,51,-10,30
Young Boys,172,1,23,6,3,75,30,45,75
FC Basel,172,2,16,9,7,51,28,23,57
FC Zürich,172,3,12,10,10,42,34,8,46
Lucerne,172,4,12,8,12,42,49,-7,44
St Gallen,172,5,13,5,14,40,52,-12,44
Grasshoppers,172,6,10,6,16,39,49,-10,36
FC Thun,172,7,10,6,16,46,58,-12,36
FC Lugano,172,8,10,6,16,29,48,-19,36
FC Sion,172,9,6,8,18,37,53,-16,26
Young Boys,173,1,22,7,3,71,33,38,73
FC Basel,173,2,17,8,7,55,31,24,59
Lucerne,173,3,14,7,11,42,43,-1,49
FC Zürich,173,4,11,11,10,44,36,8,44
St Gallen,173,5,13,4,15,42,55,-13,43
FC Lugano,173,6,10,7,15,31,46,-15,37
Grasshoppers,173,7,10,6,16,40,49,-9,36
FC Thun,173,8,9,5,18,44,60,-16,32
FC Sion,173,9,6,9,17,40,56,-16,27
Young Boys,174,1,21,6,5,71,38,33,69
FC Basel,174,2,18,8,6,58,27,31,62
Lucerne,174,3,14,8,10,49,45,4,50
St Gallen,174,4,15,3,14,45,55,-10,48
FC Zürich,174,5,11,10,11,41,38,3,43
Grasshoppers,174,6,10,6,16,45,51,-6,36
FC Thun,174,7,10,5,17,46,62,-16,35
FC Lugano,174,8,9,5,18,28,51,-23,32
FC Sion,174,9,7,7,18,42,58,-16,28
Young Boys,175,1,20,8,4,71,36,35,68
FC Basel,175,2,18,8,6,53,25,28,62
St Gallen,175,3,15,2,15,43,53,-10,47
FC Zürich,175,4,12,10,10,43,34,9,46
Lucerne,175,5,13,7,12,40,42,-2,46
Grasshoppers,175,6,10,6,16,43,51,-8,36
FC Lugano,175,7,10,6,16,28,48,-20,36
FC Thun,175,8,9,5,18,44,64,-20,32
FC Sion,175,9,7,8,17,44,56,-12,29
Young Boys,176,1,22,8,2,73,35,38,74
FC Basel,176,2,17,9,6,51,24,27,60
Lucerne,176,3,13,8,11,40,41,-1,47
St Gallen,176,4,13,4,15,40,53,-13,43
FC Lugano,176,5,10,8,14,34,45,-11,38
FC Zürich,176,6,9,9,14,39,42,-3,36
Grasshoppers,176,7,10,6,16,42,52,-10,36
FC Thun,176,8,9,7,16,44,59,-15,34
FC Sion,176,9,7,9,16,44,56,-12,30
Young Boys,177,1,22,8,2,74,35,39,74
FC Basel,177,2,17,10,5,51,24,27,61
FC Zürich,177,3,11,11,10,41,34,7,44
St Gallen,177,4,13,5,14,45,57,-12,44
Lucerne,177,5,11,10,11,39,43,-4,43
FC Lugano,177,6,9,8,15,31,47,-16,35
Grasshoppers,177,7,9,7,16,40,50,-10,34
FC Thun,177,8,9,7,16,45,60,-15,34
FC Sion,177,9,6,8,18,41,57,-16,26
Young Boys,178,1,23,7,2,79,36,43,76
FC Basel,178,2,17,9,6,54,26,28,60
Lucerne,178,3,13,9,10,40,40,0,48
FC Zürich,178,4,12,9,11,47,36,11,45
St Gallen,178,5,14,3,15,44,56,-12,45
FC Thun,178,6,10,5,17,41,59,-18,35
FC Lugano,178,7,9,5,18,30,55,-25,32
Grasshoppers,178,8,8,7,17,38,52,-14,31
FC Sion,178,9,7,8,17,44,57,-13,29
Young Boys,179,1,21,7,4,71,38,33,70
FC Basel,179,2,17,9,6,52,25,27,60
Lucerne,179,3,13,8,11,44,47,-3,47
St Gallen,179,4,13,5,14,40,52,-12,44
FC Lugano,179,5,11,7,14,32,44,-12,40
FC Zürich,179,6,10,9,13,39,37,2,39
FC Thun,179,7,11,5,16,44,57,-13,38
Grasshoppers,179,8,9,7,16,42,50,-8,34
FC Sion,179,9,6,9,17,37,51,-14,27
Young Boys,180,1,21,8,3,70,35,35,71
FC Basel,180,2,18,8,6,56,27,29,62
FC Zürich,180,3,13,9,10,47,35,12,48
St Gallen,180,4,15,3,14,45,55,-10,48
Lucerne,180,5,13,8,11,39,42,-3,47
FC Lugano,180,6,10,5,17,32,48,-16,35
Grasshoppers,180,7,9,6,17,42,52,-10,33
FC Thun,180,8,9,6,17,43,63,-20,33
FC Sion,180,9,5,9,18,41,58,-17,24
Young Boys,181,1,21,6,5,72,37,35,69
FC Basel,181,2,19,8,5,59,24,35,65
Lucerne,181,3,14,7,11,42,44,-2,49
St Gallen,181,4,15,2,15,44,55,-11,47
FC Zürich,181,5,9,12,11,41,39,2,39
Grasshoppers,181,6,10,6,16,43,49,-6,36
FC Thun,181,7,10,6,16,45,59,-14,36
FC Lugano,181,8,10,6,16,34,53,-19,36
FC Sion,181,9,6,7,19,39,59,-20,25
Young Boys,182,1,22,7,3,80,33,47,73
FC Basel,182,2,19,8,5,55,22,33,65
St Gallen,182,3,14,4,14,43,55,-12,46
Lucerne,182,4,12,9,11,41,45,-4,45
FC Zürich,182,5,10,10,12,41,41,0,40
FC Lugano,182,6,11,6,15,34,50,-16,39
Grasshoppers,182,7,9,7,16,42,51,-9,34
FC Thun,182,8,8,6,18,42,61,-19,30
FC Sion,182,9,7,7,18,41,61,-20,28
Young Boys,183,1,21,9,2,74,34,40,72
FC Basel,183,2,15,9,8,49,27,22,54
Lucerne,183,3,13,7,12,39,43,-4,46
St Gallen,183,4,14,4,14,43,54,-11,46
FC Zürich,183,5,11,10,11,40,35,5,43
Grasshoppers,183,6,10,7,15,41,50,-9,37
FC Lugano,183,7,10,6,16,29,47,-18,36
FC Thun,183,8,10,5,17,45,56,-11,35
FC Sion,183,9,7,9,16,42,56,-14,30
Young Boys,184,1,22,7,3,73,36,37,73
FC Basel,184,2,16,10,6,56,31,25,58
Lucerne,184,3,12,10,10,43,44,-1,46
FC Zürich,184,4,11,10,11,41,37,4,43
St Gallen,184,5,13,3,16,44,61,-17,42
Grasshoppers,184,6,10,7,15,43,49,-6,37
FC Lugano,184,7,10,7,15,36,49,-13,37
FC Thun,184,8,10,5,17,45,59,-14,35
FC Sion,184,9,7,7,18,40,55,-15,28
Young Boys,185,1,22,7,3,73,34,39,73
FC Basel,185,2,20,7,5,54,21,33,67
St Gallen,185,3,15,3,14,44,54,-10,48
FC Zürich,185,4,12,9,11,43,34,9,45
Lucerne,185,5,12,7,13,39,43,-4,43
Grasshoppers,185,6,10,7,15,38,47,-9,37
FC Thun,185,7,9,6,17,42,57,-15,33
FC Lugano,185,8,9,6,17,28,48,-20,33
FC Sion,185,9,5,8,19,39,62,-23,23
Young Boys,186,1,22,6,4,75,36,39,72
FC Basel,186,2,16,8,8,52,29,23,56
Lucerne,186,3,12,8,12,41,46,-5,44
St Gallen,186,4,13,4,15,40,55,-15,43
Grasshoppers,186,5,12,6,14,44,45,-1,42
FC Zürich,186,6,9,12,11,44,43,1,39
FC Lugano,186,7,11,6,15,34,50,-16,39
FC Thun,186,8,10,6,16,42,56,-14,36
FC Sion,186,9,7,8,17,43,55,-12,29
Young Boys,187,1,23,6,3,72,33,39,75
FC Basel,187,2,18,8,6,56,28,28,62
Lucerne,187,3,13,9,10,42,43,-1,48
St Gallen,187,4,13,5,14,43,55,-12,44
FC Zürich,187,5,10,11,11,42,38,4,41
FC Lugano,187,6,9,8,15,31,47,-16,35
FC Thun,187,7,9,7,16,45,60,-15,34
Grasshoppers,187,8,8,7,17,38,50,-12,31
FC Sion,187,9,6,9,17,42,57,-15,27
Young Boys,188,1,21,7,4,70,37,33,70
FC Basel,188,2,17,7,8,49,27,22,58
Lucerne,188,3,14,7,11,42,42,0,49
St Gallen,188,4,15,2,15,43,54,-11,47
FC Zürich,188,5,10,10,12,38,35,3,40
FC Lugano,188,6,11,5,16,31,47,-16,38
FC Thun,188,7,9,7,16,41,55,-14,34
FC Sion,188,8,8,9,15,46,51,-5,33
Grasshoppers,188,9,9,6,17,42,54,-12,33
Young Boys,189,1,23,7,2,75,34,41,76
FC Basel,189,2,17,9,6,55,29,26,60
Lucerne,189,3,14,7,11,43,44,-1,49
St Gallen,189,4,15,2,15,47,58,-11,47
FC Zürich,189,5,10,11,11,41,38,3,41
FC Lugano,189,6,10,6,16,31,48,-17,36
Grasshoppers,189,7,9,7,16,43,52,-9,34
FC Thun,189,8,9,6,17,43,60,-17,33
FC Sion,189,9,6,7,19,42,57,-15,25
Young Boys,190,1,22,7,3,77,32,45,73
FC Basel,190,2,18,7,7,55,31,24,61
St Gallen,190,3,16,3,13,49,53,-4,51
FC Zürich,190,4,12,9,11,43,34,9,45
Lucerne,190,5,12,8,12,38,46,-8,44
Grasshoppers,190,6,9,9,14,38,45,-7,36
FC Lugano,190,7,9,6,17,30,52,-22,33
FC Thun,190,8,9,5,18,41,59,-18,32
FC Sion,190,9,6,8,18,37,56,-19,26
Young Boys,191,1,22,8,2,75,34,41,74
FC Basel,191,2,17,7,8,49,27,22,58
St Gallen,191,3,16,3,13,46,52,-6,51
Lucerne,191,4,12,8,12,41,44,-3,44
FC Zürich,191,5,10,10,12,40,37,3,40
Grasshoppers,191,6,10,8,14,44,48,-4,38
FC Lugano,191,7,10,6,16,28,48,-20,36
FC Thun,191,8,10,5,17,43,59,-16,35
FC Sion,191,9,5,9,18,42,59,-17,24
Young Boys,192,1,21,7,4,70,36,34,70
FC Basel,192,2,17,9,6,53,25,28,60
FC Zürich,192,3,12,10,10,44,36,8,46
St Gallen,192,4,14,4,14,43,56,-13,46
Lucerne,192,5,12,9,11,41,43,-2,45
Grasshoppers,192,6,10,7,15,44,50,-6,37
FC Thun,192,7,10,6,16,47,57,-10,36
FC Lugano,192,8,9,6,17,29,51,-22,33
FC Sion,192,9,6,8,18,42,59,-17,26
Young Boys,193,1,23,7,2,73,30,43,76
FC Basel,193,2,16,7,9,50,26,24,55
Lucerne,193,3,15,7,10,47,42,5,52
St Gallen,193,4,16,2,14,45,56,-11,50
FC Zürich,193,5,13,9,10,44,32,12,48
Grasshoppers,193,6,9,7,16,40,51,-11,34
FC Lugano,193,7,9,6,17,30,48,-18,33
FC Thun,193,8,8,6,18,39,60,-21,30
FC Sion,193,9,5,9,18,37,60,-23,24
Young Boys,194,1,24,6,2,76,34,42,78
FC Basel,194,2,18,8,6,57,26,31,62
St Gallen,194,3,16,2,14,44,52,-8,50
Lucerne,194,4,12,8,12,43,48,-5,44
FC Zürich,194,5,11,10,11,42,38,4,43
Grasshoppers,194,6,10,6,16,44,52,-8,36
FC Lugano,194,7,10,6,16,32,48,-16,36
FC Thun,194,8,9,5,18,42,60,-18,32
FC Sion,194,9,5,7,20,36,58,-22,22
Young Boys,195,1,22,7,3,75,36,39,73
FC Basel,195,2,18,8,6,54,23,31,62
St Gallen,195,3,15,3,14,41,51,-10,48
Lucerne,195,4,12,7,13,42,47,-5,43
FC Zürich,195,5,10,11,11,38,35,3,41
Grasshoppers,195,6,11,6,15,45,47,-2,39
FC Lugano,195,7,10,5,17,29,48,-19,35
FC Thun,195,8,9,7,16,43,61,-18,34
FC Sion,195,9,5,10,17,38,57,-19,25
Young Boys,196,1,23,6,3,75,37,38,75
FC Basel,196,2,18,9,5,57,28,29,63
Lucerne,196,3,14,8,10,48,45,3,50
St Gallen,196,4,14,2,16,43,57,-14,44
FC Zürich,196,5,10,10,12,39,37,2,40
Grasshoppers,196,6,10,6,16,42,50,-8,36
FC Thun,196,7,9,7,16,48,63,-15,34
FC Lugano,196,8,9,6,17,28,48,-20,33
FC Sion,196,9,6,8,18,42,57,-15,26
Young Boys,197,1,22,7,3,72,32,40,73
FC Basel,197,2,18,8,6,56,26,30,62
Lucerne,197,3,13,7,12,43,45,-2,46
St Gallen,197,4,14,3,15,42,54,-12,45
FC Zürich,197,5,11,10,11,42,38,4,43
FC Lugano,197,6,11,6,15,33,47,-14,39
Grasshoppers,197,7,10,6,16,42,52,-10,36
FC Thun,197,8,10,5,17,46,62,-16,35
FC Sion,197,9,5,8,19,39,59,-20,23
Young Boys,198,1,23,6,3,73,32,41,75
FC Basel,198,2,17,8,7,51,29,22,59
Lucerne,198,3,14,9,9,43,39,4,51
St Gallen,198,4,15,2,15,44,53,-9,47
FC Zürich,198,5,10,10,12,41,38,3,40
FC Thun,198,6,10,5,17,45,59,-14,35
Grasshoppers,198,7,9,7,16,42,50,-8,34
FC Lugano,198,8,9,6,17,28,50,-22,33
FC Sion,198,9,7,7,18,44,61,-17,28
Young Boys,199,1,21,7,4,72,36,36,70
FC Basel,199,2,16,8,8,51,28,23,56
Lucerne,199,3,12,10,10,41,42,-1,46
FC Zürich,199,4,11,10,11,40,36,4,43
St Gallen,199,5,13,4,15,41,54,-13,43
FC Thun,199,6,11,6,15,46,56,-10,39
FC Lugano,199,7,11,6,15,32,45,-13,39
Grasshoppers,199,8,10,6,16,40,50,-10,36
FC Sion,199,9,7,7,18,40,56,-16,28
Young Boys,200,1,22,6,4,73,36,37,72
FC Basel,200,2,17,10,5,54,25,29,61
Lucerne,200,3,13,8,11,48,48,0,47
St Gallen,200,4,13,5,14,43,57,-14,44
FC Zürich,200,5,11,10,11,41,35,6,43
Grasshoppers,200,6,11,6,15,45,52,-7,39
FC Lugano,200,7,10,5,17,34,50,-16,35
FC Thun,200,8,9,6,17,42,59,-17,33
FC Sion,200,9,6,8,18,39,57,-18,26
Young Boys,201,1,20,6,6,69,41,28,66
FC Basel,201,2,19,7,6,53,23,30,64
St Gallen,201,3,15,3,14,45,55,-10,48
Lucerne,201,4,13,7,12,45,47,-2,46
FC Zürich,201,5,11,10,11,39,35,4,43
FC Lugano,201,6,11,6,15,36,46,-10,39
FC Thun,201,7,10,6,16,44,58,-14,36
Grasshoppers,201,8,8,7,17,40,53,-13,31
FC Sion,201,9,6,10,16,43,56,-13,28
Young Boys,202,1,23,6,3,75,37,38,75
FC Basel,202,2,17,8,7,49,26,23,59
Lucerne,202,3,14,8,10,44,40,4,50
St Gallen,202,4,15,2,15,41,53,-12,47
FC Zürich,202,5,11,11,10,45,37,8,44
FC Thun,202,6,10,6,16,44,56,-12,36
Grasshoppers,202,7,9,6,17,42,54,-12,33
FC Lugano,202,8,9,6,17,30,49,-19,33
FC Sion,202,9,6,7,19,37,55,-18,25
Young Boys,203,1,22,7,3,72,35,37,73
FC Basel,203,2,17,8,7,49,26,23,59
St Gallen,203,3,16,3,13,46,52,-6,51
Lucerne,203,4,14,7,11,43,42,1,49
FC Zürich,203,5,10,10,12,40,38,2,40
Grasshoppers,203,6,9,7,16,38,48,-10,34
FC Thun,203,7,9,7,16,43,57,-14,34
FC Lugano,203,8,9,6,17,29,47,-18,33
FC Sion,203,9,6,9,17,42,57,-15,27
Young Boys,204,1,20,8,4,68,37,31,68
FC Basel,204,2,18,8,6,54,24,30,62
St Gallen,204,3,16,2,14,44,53,-9,50
Lucerne,204,4,12,10,10,43,44,-1,46
FC Zürich,204,5,10,9,13,40,37,3,39
FC Lugano,204,6,11,5,16,35,48,-13,38
FC Thun,204,7,11,5,16,43,58,-15,38
Grasshoppers,204,8,8,9,15,38,48,-10,33
FC Sion,204,9,6,8,18,38,54,-16,26
Young Boys,205,1,22,6,4,69,33,36,72
FC Basel,205,2,17,9,6,52,25,27,60
St Gallen,205,3,15,2,15,43,54,-11,47
Lucerne,205,4,12,8,12,40,46,-6,44
FC Lugano,205,5,11,6,15,35,44,-9,39
FC Zürich,205,6,9,10,13,38,42,-4,37
Grasshoppers,205,7,10,7,15,41,48,-7,37
FC Thun,205,8,10,7,15,44,57,-13,37
FC Sion,205,9,7,7,18,41,54,-13,28
Young Boys,206,1,22,7,3,70,32,38,73
FC Basel,206,2,18,8,6,57,25,32,62
Lucerne,206,3,13,9,10,42,41,1,48
St Gallen,206,4,13,3,16,39,58,-19,42
FC Zürich,206,5,9,13,10,42,38,4,40
Grasshoppers,206,6,10,7,15,41,47,-6,37
FC Lugano,206,7,10,6,16,32,50,-18,36
FC Thun,206,8,8,7,17,39,60,-21,31
FC Sion,206,9,7,8,17,42,53,-11,29
Young Boys,207,1,23,6,3,76,33,43,75
FC Basel,207,2,17,8,7,56,30,26,59
Lucerne,207,3,13,9,10,47,46,1,48
St Gallen,207,4,14,3,15,43,56,-13,45
FC Zürich,207,5,10,10,12,37,35,2,40
FC Lugano,207,6,10,7,15,29,45,-16,37
FC Thun,207,7,10,5,17,43,60,-17,35
Grasshoppers,207,8,9,7,16,41,52,-11,34
FC Sion,207,9,7,7,18,41,56,-15,28
Young Boys,208,1,23,7,2,73,35,38,76
FC Basel,208,2,18,7,7,56,28,28,61
Lucerne,208,3,14,7,11,44,45,-1,49
FC Zürich,208,4,11,9,12,43,36,7,42
St Gallen,208,5,13,2,17,41,57,-16,41
FC Lugano,208,6,11,5,16,32,47,-15,38
Grasshoppers,208,7,10,6,16,43,48,-5,36
FC Thun,208,8,9,6,17,40,60,-20,33
FC Sion,208,9,6,9,17,40,56,-16,27
Young Boys,209,1,22,8,2,70,32,38,74
FC Basel,209,2,17,7,8,51,27,24,58
Lucerne,209,3,14,8,10,44,41,3,50
St Gallen,209,4,14,3,15,43,55,-12,45
FC Zürich,209,5,11,9,12,41,37,4,42
Grasshoppers,209,6,10,6,16,43,49,-6,36
FC Lugano,209,7,10,6,16,32,50,-18,36
FC Thun,209,8,9,6,17,44,63,-19,33
FC Sion,209,9,6,9,17,37,51,-14,27
Young Boys,210,1,22,7,3,73,34,39,73
FC Basel,210,2,18,7,7,54,28,26,61
St Gallen,210,3,14,4,14,42,53,-11,46
Lucerne,210,4,11,8,13,40,48,-8,41
FC Zürich,210,5,10,9,13,38,37,1,39
FC Lugano,210,6,11,5,16,32,49,-17,38
Grasshoppers,210,7,9,8,15,43,49,-6,35
FC Sion,210,8,9,8,15,43,52,-9,35
FC Thun,210,9,9,6,17,45,60,-15,33
Young Boys,211,1,22,7,3,74,37,37,73
FC Basel,211,2,18,8,6,53,24,29,62
FC Zürich,211,3,12,10,10,41,33,8,46
Lucerne,211,4,13,7,12,41,43,-2,46
St Gallen,211,5,14,3,15,42,55,-13,45
FC Thun,211,6,10,7,15,44,57,-13,37
FC Lugano,211,7,10,5,17,31,49,-18,35
Grasshoppers,211,8,8,6,18,36,51,-15,30
FC Sion,211,9,6,9,17,43,56,-13,27
Young Boys,212,1,21,8,3,72,35,37,71
FC Basel,212,2,18,8,6,55,26,29,62
Lucerne,212,3,16,7,9,45,39,6,55
St Gallen,212,4,14,3,15,41,53,-12,45
FC Zürich,212,5,9,11,12,39,37,2,38
FC Thun,212,6,10,6,16,46,59,-13,36
FC Lugano,212,7,10,6,16,29,47,-18,36
Grasshoppers,212,8,8,7,17,38,53,-15,31
FC Sion,212,9,5,10,17,37,53,-16,25
Young Boys,213,1,22,7,3,68,31,37,73
FC Basel,213,2,18,7,7,54,27,27,61
Lucerne,213,3,13,8,11,39,41,-2,47
St Gallen,213,4,15,2,15,44,55,-11,47
FC Zürich,213,5,9,11,12,41,39,2,38
FC Thun,213,6,10,6,16,44,58,-14,36
FC Lugano,213,7,10,6,16,30,46,-16,36
Grasshoppers,213,8,9,7,16,37,47,-10,34
FC Sion,213,9,7,8,17,43,56,-13,29
Young Boys,214,1,20,6,6,68,37,31,66
FC Basel,214,2,17,9,6,53,26,27,60
Lucerne,214,3,13,8,11,43,47,-4,47
St Gallen,214,4,14,4,14,46,56,-10,46
FC Zürich,214,5,11,9,12,40,39,1,42
FC Lugano,214,6,11,6,15,37,49,-12,39
Grasshoppers,214,7,10,6,16,40,48,-8,36
FC Thun,214,8,9,7,16,44,59,-15,34
FC Sion,214,9,7,9,16,44,54,-10,30
Young Boys,215,1,20,10,2,70,34,36,70
FC Basel,215,2,18,9,5,53,23,30,63
Lucerne,215,3,14,8,10,45,45,0,50
St Gallen,215,4,14,3,15,46,59,-13,45
FC Zürich,215,5,11,10,11,43,36,7,43
FC Lugano,215,6,10,6,16,35,49,-14,36
Grasshoppers,215,7,8,8,16,39,49,-10,32
FC Thun,215,8,9,5,18,41,60,-19,32
FC Sion,215,9,6,9,17,40,57,-17,27
Young Boys,216,1,22,6,4,73,34,39,72
FC Basel,216,2,19,7,6,55,26,29,64
Lucerne,216,3,14,7,11,43,44,-1,49
St Gallen,216,4,14,3,15,45,58,-13,45
FC Zürich,216,5,10,9,13,39,39,0,39
Grasshoppers,216,6,11,6,15,44,48,-4,39
FC Lugano,216,7,10,5,17,30,50,-20,35
FC Thun,216,8,9,6,17,41,56,-15,33
FC Sion,216,9,6,9,17,43,58,-15,27
Young Boys,217,1,21,8,3,71,33,38,71
FC Basel,217,2,18,8,6,56,26,30,62
Lucerne,217,3,13,8,11,43,44,-1,47
St Gallen,217,4,14,3,15,40,53,-13,45
FC Zürich,217,5,10,9,13,44,42,2,39
FC Lugano,217,6,10,6,16,32,51,-19,36
Grasshoppers,217,7,9,8,15,42,50,-8,35
FC Thun,217,8,10,5,17,45,62,-17,35
FC Sion,217,9,7,9,16,42,54,-12,30
Young Boys,218,1,21,6,5,72,41,31,69
FC Basel,218,2,19,8,5,55,23,32,65
St Gallen,218,3,14,4,14,45,55,-10,46
FC Lugano,218,4,12,6,14,32,43,-11,42
Lucerne,218,5,11,8,13,39,47,-8,41
FC Zürich,218,6,10,10,12,40,36,4,40
Grasshoppers,218,7,9,7,16,44,53,-9,34
FC Sion,218,8,9,7,16,44,54,-10,34
FC Thun,218,9,8,6,18,41,60,-19,30
Young Boys,219,1,21,8,3,73,38,35,71
FC Basel,219,2,16,9,7,51,27,24,57
Lucerne,219,3,13,8,11,42,45,-3,47
St Gallen,219,4,15,2,15,44,54,-10,47
FC Zürich,219,5,10,10,12,41,39,2,40
Grasshoppers,219,6,10,8,14,44,48,-4,38
FC Thun,219,7,10,6,16,47,61,-14,36
FC Lugano,219,8,10,5,17,32,49,-17,35
FC Sion,219,9,7,8,17,42,55,-13,29
Young Boys,220,1,21,7,4,77,40,37,70
FC Basel,220,2,17,7,8,57,26,31,58
Lucerne,220,3,14,8,10,43,45,-2,50
St Gallen,220,4,15,3,14,43,52,-9,48
FC Zürich,220,5,11,9,12,40,36,4,42
FC Thun,220,6,11,5,16,43,56,-13,38
FC Lugano,220,7,10,5,17,31,50,-19,35
Grasshoppers,220,8,9,6,17,39,53,-14,33
FC Sion,220,9,7,8,17,39,54,-15,29
FC Basel,221,1,20,7,5,58,22,36,67
Young Boys,221,2,20,7,5,68,40,28,67
St Gallen,221,3,14,4,14,41,51,-10,46
Lucerne,221,4,12,9,11,41,43,-2,45
FC Zürich,221,5,9,11,12,40,39,1,38
Grasshoppers,221,6,10,7,15,40,48,-8,37
FC Thun,221,7,10,6,16,42,56,-14,36
FC Lugano,221,8,10,6,16,30,49,-19,36
FC Sion,221,9,6,9,17,40,52,-12,27
Young Boys,222,1,22,7,3,76,38,38,73
FC Basel,222,2,18,7,7,54,27,27,61
St Gallen,222,3,16,2,14,44,50,-6,50
Lucerne,222,4,12,9,11,43,45,-2,45
FC Zürich,222,5,11,9,12,43,36,7,42
Grasshoppers,222,6,10,7,15,43,51,-8,37
FC Thun,222,7,9,6,17,41,58,-17,33
FC Lugano,222,8,9,6,17,31,53,-22,33
FC Sion,222,9,6,9,17,39,56,-17,27
Young Boys,223,1,23,6,3,68,32,36,75
FC Basel,223,2,19,8,5,58,24,34,65
St Gallen,223,3,16,2,14,46,53,-7,50
Lucerne,223,4,12,7,13,38,47,-9,43
FC Zürich,223,5,10,10,12,42,39,3,40
FC Thun,223,6,10,7,15,47,57,-10,37
FC Lugano,223,7,10,5,17,30,46,-16,35
Grasshoppers,223,8,9,6,17,41,54,-13,33
FC Sion,223,9,6,7,19,42,60,-18,25
Young Boys,224,1,20,7,5,70,42,28,67
FC Basel,224,2,19,7,6,61,25,36,64
Lucerne,224,3,12,9,11,42,44,-2,45
FC Zürich,224,4,11,11,10,42,36,6,44
FC Lugano,224,5,12,5,15,35,45,-10,41
St Gallen,224,6,13,2,17,39,62,-23,41
Grasshoppers,224,7,11,7,14,45,47,-2,40
FC Thun,224,8,9,6,17,42,59,-17,33
FC Sion,224,9,6,8,18,40,56,-16,26
Young Boys,225,1,22,7,3,72,34,38,73
FC Basel,225,2,17,8,7,56,29,27,59
St Gallen,225,3,16,2,14,45,52,-7,50
Lucerne,225,4,11,9,12,39,47,-8,42
FC Lugano,225,5,12,6,14,34,42,-8,42
FC Zürich,225,6,9,10,13,38,38,0,37
FC Thun,225,7,10,6,16,46,62,-16,36
Grasshoppers,225,8,9,7,16,39,48,-9,34
FC Sion,225,9,7,7,18,38,55,-17,28
Young Boys,226,1,22,7,3,72,33,39,73
FC Basel,226,2,17,8,7,51,26,25,59
St Gallen,226,3,15,4,13,44,51,-7,49
Lucerne,226,4,12,8,12,39,45,-6,44
FC Zürich,226,5,11,10,11,45,36,9,43
FC Thun,226,6,10,5,17,45,59,-14,35
FC Lugano,226,7,9,7,16,29,51,-22,34
Grasshoppers,226,8,9,6,17,40,52,-12,33
FC Sion,226,9,7,9,16,41,53,-12,30
Young Boys,227,1,21,8,3,74,36,38,71
FC Basel,227,2,18,8,6,57,30,27,62
Lucerne,227,3,14,7,11,41,41,0,49
St Gallen,227,4,13,2,17,39,56,-17,41
FC Zürich,227,5,10,9,13,42,42,0,39
FC Lugano,227,6,11,6,15,33,45,-12,39
FC Thun,227,7,10,6,16,45,58,-13,36
Grasshoppers,227,8,9,7,16,43,54,-11,34
FC Sion,227,9,8,7,17,42,54,-12,31
Young Boys,228,1,22,7,3,78,35,43,73
FC Basel,228,2,19,7,6,56,25,31,64
St Gallen,228,3,15,2,15,44,59,-15,47
FC Zürich,228,4,12,9,11,44,38,6,45
Lucerne,228,5,12,8,12,40,47,-7,44
FC Lugano,228,6,10,6,16,33,45,-12,36
Grasshoppers,228,7,9,6,17,43,59,-16,33
FC Thun,228,8,9,5,18,44,62,-18,32
FC Sion,228,9,7,8,17,45,57,-12,29
Young Boys,229,1,21,7,4,71,37,34,70
FC Basel,229,2,20,7,5,65,27,38,67
Lucerne,229,3,12,8,12,39,51,-12,44
St Gallen,229,4,14,2,16,42,55,-13,44
FC Lugano,229,5,12,5,15,35,44,-9,41
FC Zürich,229,6,10,9,13,38,38,0,39
FC Thun,229,7,9,6,17,42,59,-17,33
Grasshoppers,229,8,8,8,16,41,51,-10,32
FC Sion,229,9,8,8,16,40,51,-11,32
Young Boys,230,1,21,6,5,66,36,30,69
FC Basel,230,2,16,8,8,49,28,21,56
Lucerne,230,3,15,8,9,46,39,7,53
FC Zürich,230,4,12,10,10,42,35,7,46
St Gallen,230,5,14,4,14,41,53,-12,46
FC Thun,230,6,10,7,15,47,56,-9,37
Grasshoppers,230,7,9,7,16,41,52,-11,34
FC Lugano,230,8,9,6,17,32,51,-19,33
FC Sion,230,9,6,8,18,38,52,-14,26
Young Boys,231,1,20,8,4,72,41,31,68
FC Basel,231,2,18,9,5,60,25,35,63
Lucerne,231,3,14,8,10,49,49,0,50
St Gallen,231,4,13,5,14,42,55,-13,44
FC Zürich,231,5,10,9,13,40,40,0,39
FC Lugano,231,6,11,5,16,31,50,-19,38
Grasshoppers,231,7,10,6,16,44,49,-5,36
FC Thun,231,8,10,5,17,42,58,-16,35
FC Sion,231,9,6,9,17,42,55,-13,27
Young Boys,232,1,22,8,2,72,31,41,74
FC Basel,232,2,17,8,7,52,25,27,59
Lucerne,232,3,13,9,10,44,44,0,48
St Gallen,232,4,15,3,14,46,57,-11,48
FC Zürich,232,5,10,11,11,43,40,3,41
FC Lugano,232,6,10,5,17,36,53,-17,35
FC Thun,232,7,9,7,16,46,60,-14,34
Grasshoppers,232,8,8,7,17,38,54,-16,31
FC Sion,232,9,6,10,16,40,53,-13,28
Young Boys,233,1,23,6,3,72,33,39,75
FC Basel,233,2,19,8,5,66,24,42,65
Lucerne,233,3,13,7,12,44,52,-8,46
St Gallen,233,4,14,3,15,47,61,-14,45
FC Zürich,233,5,11,10,11,42,36,6,43
FC Thun,233,6,10,5,17,45,64,-19,35
FC Lugano,233,7,9,6,17,30,53,-23,33
FC Sion,233,8,8,7,17,45,54,-9,31
Grasshoppers,233,9,8,6,18,39,53,-14,30
Young Boys,234,1,22,7,3,72,35,37,73
FC Basel,234,2,18,7,7,58,27,31,61
FC Zürich,234,3,13,9,10,44,36,8,48
St Gallen,234,4,15,2,15,43,57,-14,47
Lucerne,234,5,12,8,12,42,46,-4,44
Grasshoppers,234,6,9,8,15,40,48,-8,35
FC Lugano,234,7,10,5,17,31,48,-17,35
FC Thun,234,8,9,5,18,39,59,-20,32
FC Sion,234,9,7,7,18,41,54,-13,28
Young Boys,235,1,21,7,4,73,37,36,70
FC Basel,235,2,17,10,5,55,23,32,61
Lucerne,235,3,14,7,11,46,48,-2,49
St Gallen,235,4,14,3,15,41,55,-14,45
FC Zürich,235,5,11,11,10,44,35,9,44
FC Thun,235,6,10,6,16,43,57,-14,36
FC Lugano,235,7,9,7,16,32,50,-18,34
Grasshoppers,235,8,9,6,17,43,55,-12,33
FC Sion,235,9,7,7,18,41,58,-17,28
Young Boys,236,1,22,8,2,72,34,38,74
FC Basel,236,2,16,10,6,51,26,25,58
Lucerne,236,3,13,9,10,46,43,3,48
St Gallen,236,4,15,2,15,42,53,-11,47
FC Zürich,236,5,10,10,12,40,39,1,40
Grasshoppers,236,6,10,7,15,48,50,-2,37
FC Lugano,236,7,10,5,17,31,50,-19,35
FC Thun,236,8,9,7,16,44,59,-15,34
FC Sion,236,9,6,8,18,39,59,-20,26
Young Boys,237,1,21,6,5,70,36,34,69
FC Basel,237,2,17,8,7,52,27,25,59
Lucerne,237,3,14,7,11,46,45,1,49
St Gallen,237,4,14,4,14,46,57,-11,46
FC Zürich,237,5,11,10,11,41,36,5,43
Grasshoppers,237,6,10,7,15,43,50,-7,37
FC Lugano,237,7,10,6,16,31,48,-17,36
FC Thun,237,8,9,6,17,45,59,-14,33
FC Sion,237,9,7,8,17,40,56,-16,29
Young Boys,238,1,22,6,4,72,37,35,72
FC Basel,238,2,17,10,5,53,23,30,61
St Gallen,238,3,15,4,13,45,52,-7,49
Lucerne,238,4,12,9,11,42,43,-1,45
FC Zürich,238,5,10,11,11,39,36,3,41
FC Lugano,238,6,10,6,16,32,53,-21,36
FC Thun,238,7,10,5,17,44,59,-15,35
Grasshoppers,238,8,9,7,16,42,51,-9,34
FC Sion,238,9,6,8,18,40,55,-15,26
Young Boys,239,1,21,6,5,73,41,32,69
FC Basel,239,2,17,8,7,53,28,25,59
St Gallen,239,3,16,2,14,45,56,-11,50
FC Zürich,239,4,11,11,10,42,35,7,44
Lucerne,239,5,11,8,13,39,48,-9,41
FC Lugano,239,6,11,6,15,32,45,-13,39
Grasshoppers,239,7,10,8,14,47,51,-4,38
FC Thun,239,8,8,7,17,42,59,-17,31
FC Sion,239,9,7,8,17,44,54,-10,29
Young Boys,240,1,23,7,2,74,34,40,76
FC Basel,240,2,17,8,7,53,27,26,59
Lucerne,240,3,13,7,12,42,46,-4,46
St Gallen,240,4,13,3,16,41,59,-18,42
FC Zürich,240,5,10,11,11,39,35,4,41
Grasshoppers,240,6,10,7,15,43,49,-6,37
FC Thun,240,7,10,7,15,46,58,-12,37
FC Lugano,240,8,10,6,16,34,48,-14,36
FC Sion,240,9,6,8,18,37,53,-16,26
Young Boys,241,1,22,7,3,74,33,41,73
FC Basel,241,2,17,9,6,54,24,30,60
Lucerne,241,3,13,8,11,44,47,-3,47
St Gallen,241,4,14,4,14,46,54,-8,46
FC Zürich,241,5,12,9,11,43,35,8,45
FC Lugano,241,6,10,5,17,31,50,-19,35
Grasshoppers,241,7,9,7,16,43,54,-11,34
FC Thun,241,8,9,6,17,42,62,-20,33
FC Sion,241,9,7,7,18,39,57,-18,28
Young Boys,242,1,21,7,4,69,35,34,70
FC Basel,242,2,20,7,5,60,24,36,67
St Gallen,242,3,14,3,15,41,53,-12,45
Lucerne,242,4,12,8,12,38,42,-4,44
FC Zürich,242,5,10,10,12,40,36,4,40
Grasshoppers,242,6,10,8,14,43,48,-5,38
FC Lugano,242,7,11,5,16,31,46,-15,38
FC Thun,242,8,9,5,18,45,69,-24,32
FC Sion,242,9,5,11,16,39,53,-14,26
Young Boys,243,1,21,9,2,75,38,37,72
FC Basel,243,2,17,9,6,52,27,25,60
St Gallen,243,3,17,2,13,48,53,-5,53
Lucerne,243,4,13,7,12,42,44,-2,46
FC Zürich,243,5,11,10,11,42,36,6,43
FC Lugano,243,6,10,6,16,32,47,-15,36
Grasshoppers,243,7,9,7,16,43,52,-9,34
FC Thun,243,8,9,5,18,43,60,-17,32
FC Sion,243,9,6,7,19,39,59,-20,25
Young Boys,244,1,22,6,4,78,36,42,72
FC Basel,244,2,17,9,6,58,31,27,60
FC Zürich,244,3,12,9,11,43,36,7,45
Lucerne,244,4,12,9,11,43,45,-2,45
St Gallen,244,5,13,5,14,40,52,-12,44
FC Lugano,244,6,11,5,16,29,49,-20,38
Grasshoppers,244,7,10,6,16,41,52,-11,36
FC Sion,244,8,7,9,16,42,54,-12,30
FC Thun,244,9,8,6,18,40,59,-19,30
Young Boys,245,1,20,6,6,66,40,26,66
FC Basel,245,2,17,7,8,56,31,25,58
Lucerne,245,3,14,8,10,42,40,2,50
St Gallen,245,4,15,3,14,43,53,-10,48
FC Zürich,245,5,11,11,10,45,36,9,44
Grasshoppers,245,6,10,8,14,44,46,-2,38
FC Thun,245,7,10,7,15,45,58,-13,37
FC Lugano,245,8,9,7,16,29,47,-18,34
FC Sion,245,9,6,7,19,39,58,-19,25
Young Boys,246,1,20,8,4,73,40,33,68
FC Basel,246,2,17,10,5,55,26,29,61
Lucerne,246,3,13,8,11,48,48,0,47
St Gallen,246,4,14,3,15,45,59,-14,45
FC Zürich,246,5,10,11,11,40,36,4,41
FC Lugano,246,6,11,7,14,35,45,-10,40
Grasshoppers,246,7,11,6,15,44,49,-5,39
FC Thun,246,8,8,7,17,39,57,-18,31
FC Sion,246,9,6,8,18,37,56,-19,26
Young Boys,247,1,23,6,3,69,31,38,75
FC Basel,247,2,18,7,7,53,26,27,61
Lucerne,247,3,13,7,12,43,45,-2,46
St Gallen,247,4,14,2,16,44,59,-15,44
FC Lugano,247,5,12,5,15,34,46,-12,41
FC Thun,247,6,11,6,15,48,59,-11,39
FC Zürich,247,7,9,10,13,38,38,0,37
Grasshoppers,247,8,9,6,17,43,52,-9,33
FC Sion,247,9,6,9,17,42,58,-16,27
Young Boys,248,1,21,9,2,71,34,37,72
FC Basel,248,2,16,8,8,55,31,24,56
St Gallen,248,3,16,2,14,45,57,-12,50
FC Zürich,248,4,12,10,10,45,35,10,46
Lucerne,248,5,12,9,11,42,43,-1,45
FC Lugano,248,6,11,7,14,37,45,-8,40
Grasshoppers,248,7,9,8,15,39,47,-8,35
FC Thun,248,8,8,7,17,40,63,-23,31
FC Sion,248,9,5,8,19,36,55,-19,23
Young Boys,249,1,21,7,4,77,39,38,70
FC Basel,249,2,19,8,5,60,25,35,65
Lucerne,249,3,13,8,11,43,46,-3,47
St Gallen,249,4,14,4,14,42,51,-9,46
FC Zürich,249,5,10,9,13,38,37,1,39
FC Lugano,249,6,10,6,16,30,51,-21,36
Grasshoppers,249,7,9,8,15,45,52,-7,35
FC Thun,249,8,9,7,16,42,61,-19,34
FC Sion,249,9,6,9,17,41,56,-15,27
Young Boys,250,1,22,6,4,73,37,36,72
FC Basel,250,2,17,8,7,53,28,25,59
Lucerne,250,3,14,7,11,45,42,3,49
St Gallen,250,4,14,3,15,43,56,-13,45
FC Zürich,250,5,11,11,10,42,33,9,44
FC Thun,250,6,11,6,15,43,55,-12,39
Grasshoppers,250,7,10,6,16,43,51,-8,36
FC Lugano,250,8,9,6,17,29,54,-25,33
FC Sion,250,9,6,7,19,39,54,-15,25
Young Boys,251,1,23,7,2,77,32,45,76
FC Basel,251,2,18,8,6,52,23,29,62
Lucerne,251,3,12,10,10,41,44,-3,46
St Gallen,251,4,14,3,15,41,52,-11,45
FC Zürich,251,5,11,9,12,39,35,4,42
FC Lugano,251,6,11,6,15,32,45,-13,39
Grasshoppers,251,7,9,7,16,40,50,-10,34
FC Thun,251,8,9,6,17,42,60,-18,33
FC Sion,251,9,5,8,19,35,58,-23,23
Young Boys,252,1,21,6,5,72,37,35,69
FC Basel,252,2,18,8,6,57,27,30,62
Lucerne,252,3,12,8,12,39,43,-4,44
FC Lugano,252,4,13,5,14,36,46,-10,44
Grasshoppers,252,5,12,6,14,43,47,-4,42
St Gallen,252,6,13,3,16,41,60,-19,42
FC Zürich,252,7,10,11,11,42,36,6,41
FC Thun,252,8,9,6,17,43,57,-14,33
FC Sion,252,9,6,7,19,40,60,-20,25
Young Boys,253,1,22,6,4,72,37,35,72
FC Basel,253,2,18,8,6,56,23,33,62
St Gallen,253,3,15,4,13,44,51,-7,49
Lucerne,253,4,13,8,11,42,44,-2,47
FC Zürich,253,5,11,11,10,45,36,9,44
Grasshoppers,253,6,10,6,16,42,51,-9,36
FC Lugano,253,7,9,7,16,32,50,-18,34
FC Thun,253,8,9,5,18,44,63,-19,32
FC Sion,253,9,6,7,19,37,59,-22,25
Young Boys,254,1,21,7,4,70,38,32,70
FC Basel,254,2,18,9,5,57,24,33,63
Lucerne,254,3,13,10,9,45,42,3,49
St Gallen,254,4,15,2,15,42,56,-14,47
FC Zürich,254,5,10,11,11,38,34,4,41
Grasshoppers,254,6,10,7,15,42,47,-5,37
FC Lugano,254,7,10,5,17,30,48,-18,35
FC Thun,254,8,9,5,18,42,62,-20,32
FC Sion,254,9,6,8,18,40,55,-15,26
Young Boys,255,1,21,7,4,74,38,36,70
FC Basel,255,2,18,9,5,58,25,33,63
FC Zürich,255,3,12,10,10,40,32,8,46
Lucerne,255,4,13,7,12,43,45,-2,46
St Gallen,255,5,14,4,14,44,59,-15,46
Grasshoppers,255,6,9,9,14,41,48,-7,36
FC Lugano,255,7,9,6,17,30,51,-21,33
FC Thun,255,8,8,8,16,43,60,-17,32
FC Sion,255,9,5,10,17,39,54,-15,25
Young Boys,256,1,22,6,4,75,35,40,72
FC Basel,256,2,18,8,6,53,25,28,62
St Gallen,256,3,14,5,13,43,51,-8,47
Lucerne,256,4,12,9,11,40,45,-5,45
FC Zürich,256,5,11,11,10,42,35,7,44
Grasshoppers,256,6,10,7,15,45,52,-7,37
FC Thun,256,7,10,5,17,44,59,-15,35
FC Lugano,256,8,9,6,17,29,51,-22,33
FC Sion,256,9,5,9,18,37,55,-18,24
Young Boys,257,1,22,7,3,74,36,38,73
FC Basel,257,2,18,8,6,52,23,29,62
Lucerne,257,3,13,7,12,42,46,-4,46
St Gallen,257,4,13,4,15,40,55,-15,43
FC Zürich,257,5,10,9,13,40,41,-1,39
FC Lugano,257,6,11,6,15,32,45,-13,39
Grasshoppers,257,7,10,6,16,46,52,-6,36
FC Sion,257,8,8,8,16,43,52,-9,32
FC Thun,257,9,9,5,18,43,62,-19,32
Young Boys,258,1,19,10,3,69,37,32,67
FC Basel,258,2,17,9,6,52,25,27,60
Lucerne,258,3,13,9,10,40,40,0,48
St Gallen,258,4,14,3,15,43,59,-16,45
FC Lugano,258,5,11,7,14,32,45,-13,40
FC Zürich,258,6,10,9,13,39,38,1,39
FC Thun,258,7,10,6,16,47,59,-12,36
Grasshoppers,258,8,9,7,16,43,52,-9,34
FC Sion,258,9,7,8,17,45,55,-10,29
Young Boys,259,1,22,6,4,74,39,35,72
FC Basel,259,2,19,7,6,60,30,30,64
Lucerne,259,3,13,8,11,42,45,-3,47
St Gallen,259,4,14,3,15,46,61,-15,45
FC Zürich,259,5,11,10,11,43,37,6,43
Grasshoppers,259,6,11,6,15,45,46,-1,39
FC Lugano,259,7,10,6,16,34,48,-14,36
FC Thun,259,8,10,5,17,44,63,-19,35
FC Sion,259,9,5,7,20,42,61,-19,22
Young Boys,260,1,21,8,3,71,35,36,71
FC Basel,260,2,18,8,6,55,26,29,62
St Gallen,260,3,15,2,15,45,59,-14,47
FC Zürich,260,4,12,9,11,43,37,6,45
Lucerne,260,5,12,7,13,40,47,-7,43
Grasshoppers,260,6,10,7,15,43,49,-6,37
FC Lugano,260,7,10,5,17,29,48,-19,35
FC Thun,260,8,9,6,17,43,59,-16,33
FC Sion,260,9,7,8,17,43,52,-9,29
Young Boys,261,1,21,7,4,73,34,39,70
FC Basel,261,2,17,7,8,53,27,26,58
Lucerne,261,3,14,7,11,45,48,-3,49
St Gallen,261,4,14,2,16,40,56,-16,44
FC Zürich,261,5,10,10,12,41,38,3,40
FC Lugano,261,6,11,6,15,31,45,-14,39
Grasshoppers,261,7,9,8,15,44,53,-9,35
FC Sion,261,8,8,9,15,44,52,-8,33
FC Thun,261,9,8,8,16,44,62,-18,32
Young Boys,262,1,21,7,4,73,36,37,70
FC Basel,262,2,18,8,6,55,26,29,62
Lucerne,262,3,13,9,10,44,44,0,48
St Gallen,262,4,15,2,15,44,53,-9,47
FC Zürich,262,5,10,11,11,40,35,5,41
FC Lugano,262,6,11,5,16,33,50,-17,38
Grasshoppers,262,7,9,8,15,43,51,-8,35
FC Thun,262,8,9,7,16,40,58,-18,34
FC Sion,262,9,6,7,19,37,56,-19,25
Young Boys,263,1,20,10,2,69,34,35,70
FC Basel,263,2,19,8,5,59,23,36,65
Lucerne,263,3,13,8,11,39,43,-4,47
St Gallen,263,4,14,3,15,46,57,-11,45
FC Zürich,263,5,10,11,11,42,40,2,41
FC Lugano,263,6,10,7,15,32,47,-15,37
Grasshoppers,263,7,10,6,16,41,48,-7,36
FC Thun,263,8,8,7,17,41,61,-20,31
FC Sion,263,9,5,10,17,40,56,-16,25
Young Boys,264,1,22,6,4,72,34,38,72
FC Basel,264,2,16,9,7,51,29,22,57
Lucerne,264,3,13,9,10,41,41,0,48
St Gallen,264,4,14,4,14,43,53,-10,46
FC Zürich,264,5,11,11,10,45,37,8,44
FC Thun,264,6,11,6,15,45,55,-10,39
Grasshoppers,264,7,9,7,16,37,47,-10,34
FC Lugano,264,8,9,6,17,30,52,-22,33
FC Sion,264,9,6,8,18,38,54,-16,26
Young Boys,265,1,23,6,3,77,33,44,75
FC Basel,265,2,17,7,8,54,29,25,58
Lucerne,265,3,14,8,10,46,44,2,50
St Gallen,265,4,15,4,13,45,53,-8,49
FC Zürich,265,5,11,10,11,39,34,5,43
FC Thun,265,6,9,7,16,41,59,-18,34
Grasshoppers,265,7,8,9,15,36,45,-9,33
FC Lugano,265,8,9,6,17,31,51,-20,33
FC Sion,265,9,5,9,18,36,57,-21,24
Young Boys,266,1,21,6,5,71,35,36,69
FC Basel,266,2,18,9,5,55,27,28,63
St Gallen,266,3,14,4,14,42,52,-10,46
FC Zürich,266,4,10,11,11,40,36,4,41
Lucerne,266,5,11,8,13,38,48,-10,41
FC Lugano,266,6,11,7,14,31,44,-13,40
Grasshoppers,266,7,10,7,15,42,47,-5,37
FC Thun,266,8,9,6,17,44,60,-16,33
FC Sion,266,9,7,8,17,40,54,-14,29
Young Boys,267,1,22,7,3,68,32,36,73
FC Basel,267,2,19,7,6,54,23,31,64
St Gallen,267,3,15,3,14,45,57,-12,48
Lucerne,267,4,13,7,12,43,45,-2,46
FC Zürich,267,5,10,10,12,39,36,3,40
FC Lugano,267,6,10,5,17,30,47,-17,35
Grasshoppers,267,7,9,7,16,42,51,-9,34
FC Thun,267,8,9,6,17,47,63,-16,33
FC Sion,267,9,6,10,16,40,54,-14,28
Young Boys,268,1,20,8,4,67,34,33,68
FC Basel,268,2,15,9,8,52,32,20,54
Lucerne,268,3,13,9,10,45,45,0,48
St Gallen,268,4,14,4,14,44,57,-13,46
FC Zürich,268,5,12,9,11,45,39,6,45
FC Lugano,268,6,11,6,15,35,46,-11,39
FC Thun,268,7,10,5,17,45,59,-14,35
Grasshoppers,268,8,9,7,16,41,51,-10,34
FC Sion,268,9,7,9,16,40,51,-11,30
Young Boys,269,1,21,8,3,70,33,37,71
FC Basel,269,2,17,7,8,55,29,26,58
Lucerne,269,3,13,9,10,42,43,-1,48
FC Zürich,269,4,12,10,10,45,37,8,46
St Gallen,269,5,14,4,14,44,56,-12,46
FC Thun,269,6,10,7,15,45,58,-13,37
Grasshoppers,269,7,9,9,14,42,49,-7,36
FC Lugano,269,8,9,6,17,29,50,-21,33
FC Sion,269,9,5,8,19,38,55,-17,23
Young Boys,270,1,20,8,4,68,36,32,68
FC Basel,270,2,18,9,5,60,27,33,63
St Gallen,270,3,15,4,13,46,55,-9,49
FC Zürich,270,4,11,10,11,42,36,6,43
Lucerne,270,5,11,8,13,38,47,-9,41
Grasshoppers,270,6,10,7,15,44,50,-6,37
FC Lugano,270,7,10,6,16,33,49,-16,36
FC Sion,270,8,8,8,16,43,51,-8,32
FC Thun,270,9,8,6,18,43,66,-23,30
Young Boys,271,1,22,7,3,76,38,38,73
FC Basel,271,2,16,8,8,50,26,24,56
Lucerne,271,3,13,8,11,44,45,-1,47
St Gallen,271,4,15,2,15,45,55,-10,47
FC Zürich,271,5,11,11,10,46,36,10,44
FC Lugano,271,6,12,6,14,40,51,-11,42
FC Thun,271,7,10,5,17,44,60,-16,35
Grasshoppers,271,8,8,9,15,42,52,-10,33
FC Sion,271,9,5,8,19,37,61,-24,23
Young Boys,272,1,21,9,2,69,32,37,72
FC Basel,272,2,15,9,8,48,26,22,54
Lucerne,272,3,12,11,9,42,42,0,47
St Gallen,272,4,14,4,14,44,56,-12,46
FC Zürich,272,5,12,9,11,43,35,8,45
FC Thun,272,6,10,6,16,44,56,-12,36
FC Lugano,272,7,10,6,16,32,50,-18,36
Grasshoppers,272,8,8,7,17,38,49,-11,31
FC Sion,272,9,7,9,16,38,52,-14,30
Young Boys,273,1,22,8,2,74,35,39,74
FC Basel,273,2,16,10,6,51,26,25,58
Lucerne,273,3,13,10,9,42,41,1,49
St Gallen,273,4,15,3,14,43,52,-9,48
FC Zürich,273,5,9,10,13,38,41,-3,37
FC Thun,273,6,10,6,16,42,55,-13,36
FC Lugano,273,7,10,6,16,36,50,-14,36
Grasshoppers,273,8,9,8,15,40,48,-8,35
FC Sion,273,9,5,9,18,36,54,-18,24
Young Boys,274,1,20,7,5,70,39,31,67
FC Basel,274,2,18,7,7,52,25,27,61
St Gallen,274,3,15,2,15,42,51,-9,47
FC Zürich,274,4,12,10,10,44,34,10,46
Lucerne,274,5,12,7,13,46,52,-6,43
FC Lugano,274,6,11,6,15,32,46,-14,39
FC Thun,274,7,11,5,16,44,57,-13,38
Grasshoppers,274,8,10,7,15,43,50,-7,37
FC Sion,274,9,6,7,19,39,58,-19,25
Young Boys,275,1,23,6,3,73,36,37,75
FC Basel,275,2,16,9,7,52,27,25,57
Lucerne,275,3,14,8,10,44,43,1,50
St Gallen,275,4,16,2,14,46,54,-8,50
FC Zürich,275,5,10,10,12,39,36,3,40
Grasshoppers,275,6,10,6,16,40,47,-7,36
FC Thun,275,7,10,6,16,44,58,-14,36
FC Lugano,275,8,10,5,17,34,53,-19,35
FC Sion,275,9,5,8,19,39,57,-18,23
Young Boys,276,1,23,7,2,72,30,42,76
FC Basel,276,2,18,8,6,56,29,27,62
St Gallen,276,3,16,2,14,47,56,-9,50
Lucerne,276,4,13,9,10,44,42,2,48
FC Zürich,276,5,10,9,13,39,38,1,39
Grasshoppers,276,6,10,6,16,41,48,-7,36
FC Lugano,276,7,10,5,17,33,52,-19,35
FC Thun,276,8,9,6,17,44,61,-17,33
FC Sion,276,9,5,8,19,36,56,-20,23
Young Boys,277,1,22,8,2,75,32,43,74
FC Basel,277,2,17,8,7,52,29,23,59
St Gallen,277,3,15,2,15,47,56,-9,47
Lucerne,277,4,13,7,12,42,47,-5,46
FC Zürich,277,5,11,9,12,42,37,5,42
FC Lugano,277,6,11,6,15,35,48,-13,39
Grasshoppers,277,7,10,7,15,41,49,-8,37
FC Thun,277,8,9,6,17,40,57,-17,33
FC Sion,277,9,6,7,19,38,57,-19,25
Young Boys,278,1,21,8,3,73,36,37,71
FC Basel,278,2,18,9,5,54,26,28,63
Lucerne,278,3,13,8,11,51,46,5,47
St Gallen,278,4,14,3,15,41,56,-15,45
FC Zürich,278,5,11,11,10,42,36,6,44
FC Lugano,278,6,10,6,16,31,51,-20,36
Grasshoppers,278,7,9,8,15,45,51,-6,35
FC Thun,278,8,8,6,18,43,61,-18,30
FC Sion,278,9,7,7,18,39,56,-17,28
Young Boys,279,1,21,6,5,71,40,31,69
FC Basel,279,2,17,9,6,56,30,26,60
St Gallen,279,3,14,4,14,41,51,-10,46
FC Lugano,279,4,13,5,14,35,44,-9,44
Lucerne,279,5,11,8,13,38,46,-8,41
FC Zürich,279,6,10,10,12,42,41,1,40
Grasshoppers,279,7,10,8,14,46,47,-1,38
FC Thun,279,8,8,7,17,43,62,-19,31
FC Sion,279,9,7,9,16,39,50,-11,30
Young Boys,280,1,21,7,4,71,39,32,70
FC Basel,280,2,19,8,5,56,25,31,65
St Gallen,280,3,16,2,14,48,53,-5,50
Lucerne,280,4,13,8,11,43,43,0,47
FC Zürich,280,5,10,10,12,40,36,4,40
FC Lugano,280,6,11,5,16,31,48,-17,38
FC Thun,280,7,9,6,17,45,62,-17,33
Grasshoppers,280,8,8,8,16,45,56,-11,32
FC Sion,280,9,5,10,17,38,55,-17,25
Young Boys,281,1,23,6,3,74,36,38,75
FC Basel,281,2,17,9,6,53,26,27,60
St Gallen,281,3,14,4,14,41,53,-12,46
Lucerne,281,4,12,8,12,41,48,-7,44
FC Zürich,281,5,10,11,11,39,35,4,41
FC Lugano,281,6,11,6,15,35,46,-11,39
Grasshoppers,281,7,10,7,15,44,49,-5,37
FC Thun,281,8,9,5,18,43,61,-18,32
FC Sion,281,9,6,8,18,36,52,-16,26
Young Boys,282,1,22,6,4,70,37,33,72
FC Basel,282,2,17,9,6,52,26,26,60
FC Zürich,282,3,12,10,10,44,34,10,46
Lucerne,282,4,12,9,11,40,42,-2,45
St Gallen,282,5,13,4,15,43,59,-16,43
FC Lugano,282,6,10,7,15,33,47,-14,37
Grasshoppers,282,7,9,7,16,42,51,-9,34
FC Thun,282,8,9,7,16,42,57,-15,34
FC Sion,282,9,7,7,18,43,56,-13,28
Young Boys,283,1,22,6,4,80,40,40,72
FC Basel,283,2,16,9,7,56,30,26,57
Lucerne,283,3,13,8,11,43,47,-4,47
St Gallen,283,4,14,3,15,46,58,-12,45
FC Zürich,283,5,10,10,12,38,39,-1,40
Grasshoppers,283,6,11,7,14,44,47,-3,40
FC Lugano,283,7,10,6,16,35,52,-17,36
FC Sion,283,8,8,8,16,46,54,-8,32
FC Thun,283,9,9,5,18,43,64,-21,32
Young Boys,284,1,22,6,4,73,36,37,72
FC Basel,284,2,16,8,8,49,28,21,56
St Gallen,284,3,15,3,14,45,52,-7,48
Lucerne,284,4,12,8,12,42,45,-3,44
FC Zürich,284,5,11,10,11,44,39,5,43
FC Thun,284,6,11,6,15,44,56,-12,39
FC Lugano,284,7,11,5,16,33,49,-16,38
Grasshoppers,284,8,9,8,15,39,48,-9,35
FC Sion,284,9,6,8,18,44,60,-16,26
Young Boys,285,1,22,8,2,73,32,41,74
FC Basel,285,2,16,9,7,51,28,23,57
Lucerne,285,3,14,8,10,46,46,0,50
FC Zürich,285,4,13,9,10,44,32,12,48
St Gallen,285,5,13,6,13,44,55,-11,45
Grasshoppers,285,6,9,7,16,42,52,-10,34
FC Lugano,285,7,9,7,16,31,50,-19,34
FC Thun,285,8,8,6,18,42,61,-19,30
FC Sion,285,9,6,8,18,39,56,-17,26
Young Boys,286,1,20,6,6,70,41,29,66
FC Basel,286,2,18,8,6,53,26,27,62
Lucerne,286,3,14,8,10,42,40,2,50
St Gallen,286,4,14,2,16,42,57,-15,44
FC Zürich,286,5,11,9,12,40,36,4,42
FC Lugano,286,6,11,5,16,34,48,-14,38
Grasshoppers,286,7,10,6,16,43,51,-8,36
FC Thun,286,8,10,5,17,42,57,-15,35
FC Sion,286,9,8,7,17,40,50,-10,31
Young Boys,287,1,22,8,2,71,30,41,74
FC Basel,287,2,18,9,5,51,23,28,63
St Gallen,287,3,14,4,14,44,54,-10,46
Lucerne,287,4,12,9,11,40,42,-2,45
FC Zürich,287,5,9,11,12,37,36,1,38
FC Thun,287,6,10,6,16,43,56,-13,36
FC Lugano,287,7,9,7,16,31,52,-21,34
FC Sion,287,8,8,8,16,39,50,-11,32
Grasshoppers,287,9,8,6,18,37,50,-13,30
Young Boys,288,1,20,8,4,76,40,36,68
FC Basel,288,2,16,10,6,54,29,25,58
Lucerne,288,3,12,9,11,42,47,-5,45
St Gallen,288,4,14,3,15,43,56,-13,45
FC Zürich,288,5,11,10,11,45,38,7,43
Grasshoppers,288,6,11,6,15,45,49,-4,39
FC Thun,288,7,10,7,15,44,57,-13,37
FC Lugano,288,8,10,6,16,32,53,-21,36
FC Sion,288,9,7,7,18,42,54,-12,28
Young Boys,289,1,21,7,4,73,38,35,70
FC Basel,289,2,20,7,5,56,21,35,67
St Gallen,289,3,15,2,15,46,58,-12,47
Lucerne,289,4,13,7,12,45,47,-2,46
FC Zürich,289,5,9,11,12,37,36,1,38
FC Lugano,289,6,10,6,16,31,48,-17,36
Grasshoppers,289,7,9,8,15,41,49,-8,35
FC Sion,289,8,8,8,16,44,56,-12,32
FC Thun,289,9,8,6,18,40,60,-20,30
Young Boys,290,1,20,8,4,69,36,33,68
FC Basel,290,2,15,9,8,51,32,19,54
Lucerne,290,3,15,8,9,48,43,5,53
St Gallen,290,4,14,3,15,43,55,-12,45
FC Zürich,290,5,11,11,10,43,36,7,44
FC Lugano,290,6,10,8,14,31,45,-14,38
FC Thun,290,7,9,7,16,44,59,-15,34
Grasshoppers,290,8,8,7,17,41,54,-13,31
FC Sion,290,9,7,9,16,42,52,-10,30
Young Boys,291,1,21,6,5,75,35,40,69
FC Basel,291,2,17,10,5,51,23,28,61
St Gallen,291,3,15,4,13,45,54,-9,49
Lucerne,291,4,13,8,11,42,46,-4,47
FC Zürich,291,5,11,10,11,41,34,7,43
Grasshoppers,291,6,10,6,16,41,49,-8,36
FC Thun,291,7,10,6,16,44,59,-15,36
FC Lugano,291,8,9,5,18,28,52,-24,32
FC Sion,291,9,6,9,17,40,55,-15,27
Young Boys,292,1,20,9,3,67,34,33,69
FC Basel,292,2,17,10,5,54,26,28,61
Lucerne,292,3,13,9,10,41,41,0,48
St Gallen,292,4,14,5,13,46,56,-10,47
FC Zürich,292,5,11,10,11,42,36,6,43
Grasshoppers,292,6,11,6,15,42,46,-4,39
FC Thun,292,7,9,6,17,44,60,-16,33
FC Lugano,292,8,9,6,17,32,50,-18,33
FC Sion,292,9,5,9,18,35,54,-19,24
Young Boys,293,1,23,6,3,78,37,41,75
FC Basel,293,2,19,8,5,58,25,33,65
Lucerne,293,3,14,7,11,48,44,4,49
St Gallen,293,4,15,2,15,46,58,-12,47
FC Zürich,293,5,12,10,10,44,36,8,46
Grasshoppers,293,6,10,6,16,44,50,-6,36
FC Lugano,293,7,9,5,18,29,55,-26,32
FC Thun,293,8,8,6,18,40,61,-21,30
FC Sion,293,9,5,8,19,39,60,-21,23
Young Boys,294,1,22,7,3,69,34,35,73
FC Basel,294,2,18,8,6,58,25,33,62
FC Zürich,294,3,12,9,11,42,35,7,45
Lucerne,294,4,12,8,12,41,46,-5,44
St Gallen,294,5,14,2,16,43,56,-13,44
Grasshoppers,294,6,9,8,15,44,52,-8,35
FC Lugano,294,7,10,5,17,28,49,-21,35
FC Thun,294,8,9,6,17,42,57,-15,33
FC Sion,294,9,8,7,17,41,54,-13,31
Young Boys,295,1,21,6,5,76,37,39,69
FC Basel,295,2,17,9,6,53,27,26,60
FC Zürich,295,3,12,10,10,43,36,7,46
St Gallen,295,4,14,4,14,47,57,-10,46
Lucerne,295,5,12,9,11,41,46,-5,45
FC Lugano,295,6,10,5,17,32,53,-21,35
Grasshoppers,295,7,9,7,16,43,54,-11,34
FC Thun,295,8,9,6,17,45,62,-17,33
FC Sion,295,9,8,8,16,46,54,-8,32
Young Boys,296,1,23,7,2,83,34,49,76
FC Basel,296,2,17,9,6,55,26,29,60
St Gallen,296,3,14,3,15,41,54,-13,45
Lucerne,296,4,12,8,12,38,49,-11,44
FC Zürich,296,5,9,12,11,43,41,2,39
Grasshoppers,296,6,10,7,15,43,48,-5,37
FC Lugano,296,7,9,8,15,30,46,-16,35
FC Thun,296,8,9,7,16,43,59,-16,34
FC Sion,296,9,6,9,17,40,59,-19,27
Young Boys,297,1,23,7,2,72,29,43,76
FC Basel,297,2,19,8,5,58,23,35,65
St Gallen,297,3,15,3,14,43,54,-11,48
Lucerne,297,4,12,8,12,38,43,-5,44
FC Zürich,297,5,11,9,12,45,40,5,42
FC Thun,297,6,10,5,17,43,60,-17,35
FC Lugano,297,7,9,7,16,30,52,-22,34
Grasshoppers,297,8,8,7,17,38,50,-12,31
FC Sion,297,9,6,8,18,39,55,-16,26
Young Boys,298,1,23,6,3,76,35,41,75
FC Basel,298,2,17,8,7,57,28,29,59
FC Zürich,298,3,12,9,11,40,34,6,45
St Gallen,298,4,14,3,15,41,55,-14,45
Lucerne,298,5,12,7,13,39,50,-11,43
Grasshoppers,298,6,10,8,14,44,49,-5,38
FC Lugano,298,7,11,5,16,32,47,-15,38
FC Thun,298,8,9,6,17,44,59,-15,33
FC Sion,298,9,6,8,18,39,55,-16,26
Young Boys,299,1,21,7,4,75,36,39,70
FC Basel,299,2,17,10,5,50,21,29,61
Lucerne,299,3,12,9,11,39,46,-7,45
St Gallen,299,4,13,4,15,41,54,-13,43
Grasshoppers,299,5,11,6,15,49,53,-4,39
FC Zürich,299,6,9,11,12,37,35,2,38
FC Lugano,299,7,10,7,15,32,50,-18,37
FC Thun,299,8,9,6,17,42,59,-17,33
FC Sion,299,9,8,8,16,41,52,-11,32
Young Boys,300,1,21,7,4,70,36,34,70
FC Basel,300,2,18,8,6,52,23,29,62
Lucerne,300,3,12,9,11,41,46,-5,45
FC Zürich,300,4,11,10,11,42,35,7,43
St Gallen,300,5,13,2,17,40,58,-18,41
FC Thun,300,6,11,5,16,46,56,-10,38
Grasshoppers,300,7,10,7,15,43,50,-7,37
FC Lugano,300,8,10,7,15,32,47,-15,37
FC Sion,300,9,7,7,18,40,55,-15,28
Young Boys,301,1,20,8,4,67,35,32,68
FC Basel,301,2,17,10,5,54,25,29,61
Lucerne,301,3,13,9,10,44,41,3,48
St Gallen,301,4,13,4,15,40,58,-18,43
FC Zürich,301,5,11,9,12,43,37,6,42
Grasshoppers,301,6,11,6,15,45,51,-6,39
FC Thun,301,7,10,6,16,44,57,-13,36
FC Lugano,301,8,9,6,17,30,54,-24,33
FC Sion,301,9,7,8,17,42,51,-9,29
Young Boys,302,1,22,7,3,73,36,37,73
FC Basel,302,2,17,8,7,54,28,26,59
Lucerne,302,3,12,10,10,45,45,0,46
St Gallen,302,4,14,4,14,43,57,-14,46
Grasshoppers,302,5,11,7,14,42,45,-3,40
FC Zürich,302,6,10,9,13,40,38,2,39
FC Lugano,302,7,11,5,16,37,50,-13,38
FC Thun,302,8,8,6,18,39,60,-21,30
FC Sion,302,9,7,8,17,39,53,-14,29
Young Boys,303,1,24,6,2,72,30,42,78
FC Basel,303,2,15,8,9,47,31,16,53
St Gallen,303,3,15,3,14,44,53,-9,48
Lucerne,303,4,12,8,12,39,45,-6,44
FC Zürich,303,5,10,11,11,40,38,2,41
FC Lugano,303,6,11,6,15,32,46,-14,39
FC Thun,303,7,10,6,16,46,56,-10,36
Grasshoppers,303,8,9,8,15,37,45,-8,35
FC Sion,303,9,6,8,18,40,53,-13,26
Young Boys,304,1,21,8,3,71,35,36,71
FC Basel,304,2,18,8,6,52,23,29,62
Lucerne,304,3,13,8,11,41,42,-1,47
St Gallen,304,4,13,4,15,38,52,-14,43
FC Zürich,304,5,10,10,12,39,38,1,40
FC Lugano,304,6,11,6,15,29,43,-14,39
FC Thun,304,7,10,5,17,45,60,-15,35
Grasshoppers,304,8,9,7,16,43,53,-10,34
FC Sion,304,9,6,10,16,44,56,-12,28
FC Basel,305,1,20,7,5,59,24,35,67
Young Boys,305,2,20,6,6,67,37,30,66
Lucerne,305,3,14,7,11,48,47,1,49
St Gallen,305,4,13,2,17,41,60,-19,41
FC Zürich,305,5,9,12,11,38,35,3,39
FC Lugano,305,6,11,6,15,31,48,-17,39
Grasshoppers,305,7,10,7,15,44,46,-2,37
FC Thun,305,8,9,6,17,44,62,-18,33
FC Sion,305,9,7,9,16,40,53,-13,30
Young Boys,306,1,21,8,3,72,36,36,71
FC Basel,306,2,16,9,7,54,30,24,57
St Gallen,306,3,15,3,14,45,57,-12,48
FC Zürich,306,4,12,9,11,42,35,7,45
Lucerne,306,5,12,9,11,43,46,-3,45
FC Lugano,306,6,11,5,16,35,47,-12,38
FC Thun,306,7,10,6,16,45,59,-14,36
Grasshoppers,306,8,9,8,15,44,52,-8,35
FC Sion,306,9,6,7,19,39,57,-18,25
Young Boys,307,1,22,6,4,71,36,35,72
FC Basel,307,2,17,9,6,52,25,27,60
Lucerne,307,3,15,8,9,45,41,4,53
St Gallen,307,4,15,3,14,44,54,-10,48
FC Zürich,307,5,9,11,12,39,38,1,38
Grasshoppers,307,6,10,6,16,45,49,-4,36
FC Lugano,307,7,10,5,17,30,48,-18,35
FC Thun,307,8,9,6,17,41,59,-18,33
FC Sion,307,9,6,8,18,39,56,-17,26
Young Boys,308,1,23,7,2,75,31,44,76
FC Basel,308,2,16,10,6,49,25,24,58
Lucerne,308,3,13,8,11,39,42,-3,47
St Gallen,308,4,14,2,16,42,57,-15,44
FC Zürich,308,5,10,11,11,41,38,3,41
FC Thun,308,6,11,6,15,50,58,-8,39
FC Lugano,308,7,11,6,15,35,48,-13,39
Grasshoppers,308,8,8,8,16,40,51,-11,32
FC Sion,308,9,5,8,19,39,60,-21,23
Young Boys,309,1,19,8,5,70,40,30,65
FC Basel,309,2,17,9,6,52,26,26,60
St Gallen,309,3,15,4,13,47,54,-7,49
FC Zürich,309,4,13,9,10,43,33,10,48
Lucerne,309,5,12,8,12,39,47,-8,44
Grasshoppers,309,6,10,7,15,44,49,-5,37
FC Lugano,309,7,10,6,16,36,50,-14,36
FC Thun,309,8,8,7,17,42,60,-18,31
FC Sion,309,9,7,8,17,40,54,-14,29
Young Boys,310,1,21,8,3,72,36,36,71
FC Basel,310,2,18,8,6,60,31,29,62
Lucerne,310,3,13,7,12,42,48,-6,46
St Gallen,310,4,14,3,15,44,55,-11,45
FC Zürich,310,5,10,10,12,38,35,3,40
FC Lugano,310,6,11,6,15,32,46,-14,39
Grasshoppers,310,7,10,7,15,39,46,-7,37
FC Thun,310,8,10,6,16,46,58,-12,36
FC Sion,310,9,5,9,18,37,55,-18,24
Young Boys,311,1,23,6,3,69,31,38,75
FC Basel,311,2,17,9,6,57,26,31,60
Lucerne,311,3,14,8,10,46,41,5,50
St Gallen,311,4,14,3,15,44,58,-14,45
FC Zürich,311,5,9,10,13,40,40,0,37
FC Lugano,311,6,10,6,16,35,52,-17,36
FC Thun,311,7,10,5,17,44,63,-19,35
Grasshoppers,311,8,9,6,17,40,51,-11,33
FC Sion,311,9,8,7,17,43,56,-13,31
Young Boys,312,1,22,7,3,75,39,36,73
FC Basel,312,2,18,7,7,54,28,26,61
Lucerne,312,3,14,8,10,43,41,2,50
St Gallen,312,4,16,2,14,42,50,-8,50
FC Zürich,312,5,11,9,12,41,38,3,42
FC Thun,312,6,11,5,16,49,60,-11,38
FC Lugano,312,7,9,5,18,31,50,-19,32
Grasshoppers,312,8,8,7,17,40,51,-11,31
FC Sion,312,9,6,8,18,38,56,-18,26
Young Boys,313,1,23,7,2,71,32,39,76
FC Basel,313,2,16,9,7,52,29,23,57
St Gallen,313,3,16,3,13,45,52,-7,51
Lucerne,313,4,14,8,10,43,42,1,50
FC Zürich,313,5,9,10,13,40,47,-7,37
FC Thun,313,6,10,5,17,45,58,-13,35
FC Lugano,313,7,10,5,17,32,47,-15,35
Grasshoppers,313,8,9,6,17,42,51,-9,33
FC Sion,313,9,7,7,18,41,53,-12,28
Young Boys,314,1,22,6,4,73,36,37,72
FC Basel,314,2,17,9,6,56,28,28,60
St Gallen,314,3,14,4,14,47,57,-10,46
Lucerne,314,4,12,9,11,44,46,-2,45
FC Zürich,314,5,10,11,11,41,37,4,41
FC Lugano,314,6,11,6,15,30,45,-15,39
FC Thun,314,7,11,5,16,43,57,-14,38
Grasshoppers,314,8,10,6,16,41,48,-7,36
FC Sion,314,9,5,8,19,38,59,-21,23
Young Boys,315,1,23,6,3,71,33,38,75
FC Basel,315,2,16,10,6,54,26,28,58
Lucerne,315,3,13,9,10,40,39,1,48
FC Zürich,315,4,12,10,10,46,35,11,46
St Gallen,315,5,14,4,14,41,53,-12,46
Grasshoppers,315,6,10,7,15,41,48,-7,37
FC Lugano,315,7,9,5,18,30,50,-20,32
FC Thun,315,8,8,6,18,44,66,-22,30
FC Sion,315,9,7,7,18,42,59,-17,28
Young Boys,316,1,21,7,4,70,34,36,70
FC Basel,316,2,17,9,6,54,26,28,60
Lucerne,316,3,14,7,11,43,43,0,49
FC Zürich,316,4,12,10,10,43,34,9,46
St Gallen,316,5,13,3,16,40,57,-17,42
Grasshoppers,316,6,10,7,15,39,45,-6,37
FC Lugano,316,7,9,6,17,30,53,-23,33
FC Thun,316,8,8,8,16,39,55,-16,32
FC Sion,316,9,7,9,16,40,51,-11,30
Young Boys,317,1,21,8,3,71,34,37,71
FC Basel,317,2,18,8,6,54,24,30,62
FC Zürich,317,3,13,9,10,41,32,9,48
St Gallen,317,4,14,4,14,41,52,-11,46
Lucerne,317,5,11,10,11,41,44,-3,43
Grasshoppers,317,6,10,8,14,43,49,-6,38
FC Lugano,317,7,10,5,17,28,48,-20,35
FC Thun,317,8,8,5,19,40,63,-23,29
FC Sion,317,9,7,7,18,38,51,-13,28
Young Boys,318,1,19,9,4,68,38,30,66
FC Basel,318,2,17,9,6,51,24,27,60
Lucerne,318,3,14,7,11,45,40,5,49
St Gallen,318,4,14,4,14,43,54,-11,46
FC Zürich,318,5,10,12,10,41,36,5,42
FC Lugano,318,6,11,6,15,34,47,-13,39
FC Thun,318,7,9,7,16,44,58,-14,34
Grasshoppers,318,8,8,8,16,38,52,-14,32
FC Sion,318,9,6,10,16,40,55,-15,28
Young Boys,319,1,22,7,3,71,34,37,73
FC Basel,319,2,18,8,6,56,27,29,62
St Gallen,319,3,16,2,14,44,53,-9,50
FC Zürich,319,4,11,10,11,40,36,4,43
Lucerne,319,5,12,7,13,41,46,-5,43
Grasshoppers,319,6,11,6,15,42,46,-4,39
FC Lugano,319,7,10,5,17,31,51,-20,35
FC Thun,319,8,9,6,17,42,58,-16,33
FC Sion,319,9,5,9,18,36,52,-16,24
Young Boys,320,1,22,8,2,72,32,40,74
FC Basel,320,2,15,9,8,49,28,21,54
Lucerne,320,3,15,7,10,46,43,3,52
St Gallen,320,4,15,3,14,43,54,-11,48
FC Zürich,320,5,10,10,12,43,39,4,40
FC Thun,320,6,10,6,16,44,57,-13,36
FC Lugano,320,7,9,6,17,30,50,-20,33
FC Sion,320,8,8,8,16,46,54,-8,32
Grasshoppers,320,9,8,7,17,36,52,-16,31
Young Boys,321,1,21,7,4,73,35,38,70
FC Basel,321,2,15,11,6,52,28,24,56
Lucerne,321,3,12,10,10,41,42,-1,46
St Gallen,321,4,14,4,14,42,53,-11,46
FC Zürich,321,5,11,10,11,40,35,5,43
Grasshoppers,321,6,12,6,14,44,46,-2,42
FC Thun,321,7,10,6,16,43,56,-13,36
FC Lugano,321,8,10,6,16,29,45,-16,36
FC Sion,321,9,5,8,19,35,59,-24,23
Young Boys,322,1,20,8,4,69,38,31,68
FC Basel,322,2,17,9,6,53,26,27,60
St Gallen,322,3,15,3,14,44,54,-10,48
Lucerne,322,4,13,8,11,40,42,-2,47
FC Lugano,322,5,11,6,15,35,48,-13,39
FC Zürich,322,6,9,10,13,39,40,-1,37
Grasshoppers,322,7,10,7,15,42,47,-5,37
FC Thun,322,8,9,6,17,43,59,-16,33
FC Sion,322,9,8,7,17,43,54,-11,31
Young Boys,323,1,23,6,3,75,37,38,75
FC Basel,323,2,18,8,6,58,27,31,62
Lucerne,323,3,14,7,11,44,47,-3,49
FC Zürich,323,4,13,9,10,43,33,10,48
St Gallen,323,5,14,2,16,42,56,-14,44
FC Thun,323,6,10,6,16,47,59,-12,36
FC Lugano,323,7,9,5,18,29,48,-19,32
Grasshoppers,323,8,8,7,17,39,52,-13,31
FC Sion,323,9,6,8,18,42,60,-18,26
Young Boys,324,1,23,6,3,75,36,39,75
FC Basel,324,2,17,8,7,53,26,27,59
St Gallen,324,3,14,2,16,45,58,-13,44
FC Zürich,324,4,11,10,11,45,37,8,43
Lucerne,324,5,11,9,12,40,47,-7,42
FC Lugano,324,6,11,6,15,34,49,-15,39
FC Thun,324,7,10,6,16,45,58,-13,36
Grasshoppers,324,8,9,7,16,42,52,-10,34
FC Sion,324,9,7,8,17,42,58,-16,29
Young Boys,325,1,23,7,2,71,31,40,76
FC Basel,325,2,18,7,7,55,29,26,61
St Gallen,325,3,14,3,15,42,58,-16,45
Lucerne,325,4,12,7,13,38,43,-5,43
FC Zürich,325,5,11,9,12,42,36,6,42
FC Lugano,325,6,11,7,14,31,43,-12,40
FC Thun,325,7,11,5,16,46,60,-14,38
Grasshoppers,325,8,9,6,17,39,49,-10,33
FC Sion,325,9,6,7,19,43,58,-15,25
Young Boys,326,1,19,7,6,65,36,29,64
FC Basel,326,2,17,7,8,54,29,25,58
Lucerne,326,3,15,8,9,49,42,7,53
St Gallen,326,4,14,4,14,46,57,-11,46
FC Lugano,326,5,12,5,15,35,48,-13,41
FC Zürich,326,6,10,9,13,43,40,3,39
FC Thun,326,7,11,5,16,46,59,-13,38
Grasshoppers,326,8,9,6,17,43,56,-13,33
FC Sion,326,9,7,9,16,44,58,-14,30
Young Boys,327,1,21,8,3,66,30,36,71
FC Basel,327,2,19,7,6,55,26,29,64
Lucerne,327,3,13,8,11,42,43,-1,47
FC Zürich,327,4,11,11,10,43,35,8,44
St Gallen,327,5,13,2,17,41,60,-19,41
FC Lugano,327,6,10,7,15,32,46,-14,37
Grasshoppers,327,7,9,7,16,39,50,-11,34
FC Thun,327,8,9,5,18,42,59,-17,32
FC Sion,327,9,7,9,16,41,52,-11,30
Young Boys,328,1,21,8,3,72,37,35,71
FC Basel,328,2,19,8,5,60,24,36,65
Lucerne,328,3,13,8,11,38,44,-6,47
St Gallen,328,4,14,3,15,41,54,-13,45
FC Zürich,328,5,11,9,12,41,35,6,42
FC Thun,328,6,11,5,16,46,58,-12,38
FC Lugano,328,7,10,7,15,32,46,-14,37
Grasshoppers,328,8,9,7,16,39,50,-11,34
FC Sion,328,9,5,7,20,42,63,-21,22
Young Boys,329,1,22,7,3,73,33,40,73
FC Basel,329,2,19,7,6,56,27,29,64
Lucerne,329,3,13,7,12,42,46,-4,46
St Gallen,329,4,14,3,15,43,56,-13,45
FC Zürich,329,5,11,9,12,44,36,8,42
FC Thun,329,6,11,5,16,46,57,-11,38
Grasshoppers,329,7,10,6,16,41,50,-9,36
FC Lugano,329,8,9,7,16,30,47,-17,34
FC Sion,329,9,6,7,19,39,62,-23,25
Young Boys,330,1,23,6,3,69,31,38,75
FC Basel,330,2,17,9,6,53,25,28,60
St Gallen,330,3,14,4,14,43,53,-10,46
Lucerne,330,4,12,8,12,40,44,-4,44
FC Zürich,330,5,10,11,11,41,36,5,41
FC Thun,330,6,10,5,17,46,61,-15,35
FC Lugano,330,7,9,7,16,29,47,-18,34
Grasshoppers,330,8,9,6,17,41,55,-14,33
FC Sion,330,9,8,8,16,42,52,-10,32
Young Boys,331,1,21,8,3,71,35,36,71
FC Basel,331,2,17,10,5,52,23,29,61
Lucerne,331,3,14,8,10,47,42,5,50
St Gallen,331,4,14,3,15,42,54,-12,45
FC Zürich,331,5,10,9,13,41,41,0,39
FC Lugano,331,6,11,6,15,35,47,-12,39
FC Thun,331,7,10,6,16,48,58,-10,36
Grasshoppers,331,8,9,7,16,40,52,-12,34
FC Sion,331,9,6,7,19,36,60,-24,25
Young Boys,332,1,22,7,3,74,35,39,73
FC Basel,332,2,15,9,8,49,29,20,54
Lucerne,332,3,13,9,10,43,42,1,48
St Gallen,332,4,15,3,14,42,52,-10,48
FC Zürich,332,5,12,10,10,46,36,10,46
Grasshoppers,332,6,10,7,15,43,49,-6,37
FC Lugano,332,7,10,5,17,30,49,-19,35
FC Thun,332,8,9,6,17,42,61,-19,33
FC Sion,332,9,6,8,18,36,52,-16,26
Young Boys,333,1,20,7,5,71,41,30,67
FC Basel,333,2,19,8,5,55,23,32,65
St Gallen,333,3,16,3,13,48,53,-5,51
Lucerne,333,4,13,8,11,44,47,-3,47
FC Zürich,333,5,11,9,12,41,36,5,42
Grasshoppers,333,6,9,8,15,41,48,-7,35
FC Thun,333,7,10,5,17,41,58,-17,35
FC Lugano,333,8,9,5,18,34,53,-19,32
FC Sion,333,9,7,7,18,41,57,-16,28
Young Boys,334,1,21,7,4,68,36,32,70
FC Basel,334,2,19,8,5,57,24,33,65
St Gallen,334,3,13,5,14,43,55,-12,44
Lucerne,334,4,11,9,12,39,43,-4,42
FC Lugano,334,5,10,8,14,31,44,-13,38
FC Zürich,334,6,9,10,13,39,40,-1,37
Grasshoppers,334,7,10,7,15,43,49,-6,37
FC Sion,334,8,8,8,16,44,55,-11,32
FC Thun,334,9,8,8,16,43,61,-18,32
Young Boys,335,1,23,6,3,77,34,43,75
FC Basel,335,2,18,8,6,52,25,27,62
Lucerne,335,3,13,9,10,43,42,1,48
St Gallen,335,4,14,4,14,44,55,-11,46
FC Zürich,335,5,9,11,12,40,38,2,38
Grasshoppers,335,6,10,7,15,45,51,-6,37
FC Thun,335,7,10,5,17,43,59,-16,35
FC Lugano,335,8,9,7,16,33,54,-21,34
FC Sion,335,9,6,7,19,38,57,-19,25
Young Boys,336,1,22,7,3,71,33,38,73
FC Basel,336,2,18,8,6,54,26,28,62
Lucerne,336,3,13,8,11,43,42,1,47
St Gallen,336,4,14,3,15,44,57,-13,45
FC Zürich,336,5,11,10,11,42,36,6,43
FC Lugano,336,6,11,5,16,31,49,-18,38
FC Thun,336,7,10,5,17,45,59,-14,35
Grasshoppers,336,8,8,8,16,38,50,-12,32
FC Sion,336,9,5,10,17,40,56,-16,25
Young Boys,337,1,21,7,4,71,37,34,70
FC Basel,337,2,18,8,6,52,25,27,62
St Gallen,337,3,14,3,15,42,53,-11,45
Lucerne,337,4,12,8,12,41,46,-5,44
FC Zürich,337,5,11,10,11,43,35,8,43
FC Lugano,337,6,12,6,14,34,44,-10,42
Grasshoppers,337,7,9,9,14,43,50,-7,36
FC Thun,337,8,9,6,17,41,58,-17,33
FC Sion,337,9,6,7,19,40,59,-19,25
Young Boys,338,1,21,8,3,74,39,35,71
FC Basel,338,2,16,8,8,51,28,23,56
St Gallen,338,3,16,2,14,46,54,-8,50
FC Zürich,338,4,12,10,10,44,36,8,46
Lucerne,338,5,12,9,11,40,44,-4,45
Grasshoppers,338,6,10,7,15,43,47,-4,37
FC Thun,338,7,10,7,15,43,56,-13,37
FC Lugano,338,8,9,6,17,32,53,-21,33
FC Sion,338,9,6,7,19,40,56,-16,25
Young Boys,339,1,21,9,2,74,37,37,72
FC Basel,339,2,18,9,5,54,24,30,63
Lucerne,339,3,13,9,10,42,43,-1,48
St Gallen,339,4,13,4,15,42,56,-14,43
FC Zürich,339,5,11,9,12,42,37,5,42
FC Thun,339,6,10,6,16,42,56,-14,36
FC Lugano,339,7,10,5,17,30,49,-19,35
FC Sion,339,8,7,9,16,44,56,-12,30
Grasshoppers,339,9,8,6,18,42,54,-12,30
Young Boys,340,1,22,7,3,77,37,40,73
FC Basel,340,2,16,8,8,49,28,21,56
FC Zürich,340,3,13,9,10,47,34,13,48
St Gallen,340,4,15,3,14,45,53,-8,48
Lucerne,340,5,12,9,11,42,46,-4,45
FC Thun,340,6,11,5,16,44,57,-13,38
FC Lugano,340,7,10,5,17,31,52,-21,35
Grasshoppers,340,8,9,7,16,40,50,-10,34
FC Sion,340,9,6,7,19,41,59,-18,25
Young Boys,341,1,22,7,3,71,33,38,73
FC Basel,341,2,19,8,5,59,25,34,65
St Gallen,341,3,15,3,14,41,51,-10,48
Lucerne,341,4,13,8,11,43,44,-1,47
FC Zürich,341,5,10,9,13,38,37,1,39
FC Lugano,341,6,10,6,16,31,47,-16,36
Grasshoppers,341,7,9,7,16,40,49,-9,34
FC Thun,341,8,8,7,17,42,63,-21,31
FC Sion,341,9,6,9,17,39,55,-16,27
Young Boys,342,1,21,8,3,75,38,37,71
FC Basel,342,2,17,10,5,54,24,30,61
Lucerne,342,3,12,9,11,42,46,-4,45
FC Lugano,342,4,13,5,14,39,50,-11,44
FC Zürich,342,5,11,9,12,45,42,3,42
St Gallen,342,6,13,3,16,44,58,-14,42
Grasshoppers,342,7,9,7,16,41,51,-10,34
FC Thun,342,8,9,6,17,41,58,-17,33
FC Sion,342,9,6,9,17,42,56,-14,27
Young Boys,343,1,21,8,3,74,36,38,71
FC Basel,343,2,18,9,5,57,26,31,63
Lucerne,343,3,13,8,11,41,41,0,47
St Gallen,343,4,15,2,15,43,54,-11,47
FC Zürich,343,5,11,10,11,45,39,6,43
Grasshoppers,343,6,11,6,15,41,49,-8,39
FC Lugano,343,7,9,6,17,31,53,-22,33
FC Thun,343,8,8,6,18,42,63,-21,30
FC Sion,343,9,6,9,17,40,53,-13,27
Young Boys,344,1,22,6,4,71,36,35,72
FC Basel,344,2,17,9,6,51,24,27,60
St Gallen,344,3,15,4,13,47,53,-6,49
FC Zürich,344,4,11,11,10,40,34,6,44
Lucerne,344,5,11,9,12,40,44,-4,42
Grasshoppers,344,6,10,6,16,43,53,-10,36
FC Thun,344,7,10,6,16,46,59,-13,36
FC Lugano,344,8,10,6,16,30,48,-18,36
FC Sion,344,9,6,7,19,39,56,-17,25
Young Boys,345,1,20,8,4,67,33,34,68
FC Basel,345,2,18,7,7,59,25,34,61
St Gallen,345,3,16,2,14,45,52,-7,50
Lucerne,345,4,13,7,12,43,46,-3,46
FC Zürich,345,5,10,10,12,41,44,-3,40
Grasshoppers,345,6,11,6,15,43,49,-6,39
FC Lugano,345,7,9,7,16,31,51,-20,34
FC Thun,345,8,9,6,17,42,60,-18,33
FC Sion,345,9,7,9,16,38,49,-11,30
Young Boys,346,1,20,7,5,71,43,28,67
FC Basel,346,2,18,8,6,55,27,28,62
Lucerne,346,3,14,8,10,46,45,1,50
St Gallen,346,4,14,2,16,43,57,-14,44
FC Zürich,346,5,10,9,13,42,37,5,39
Grasshoppers,346,6,11,6,15,44,46,-2,39
FC Lugano,346,7,11,6,15,35,49,-14,39
FC Thun,346,8,9,6,17,43,63,-20,33
FC Sion,346,9,7,8,17,43,55,-12,29
Young Boys,347,1,22,6,4,71,39,32,72
FC Basel,347,2,18,8,6,58,23,35,62
St Gallen,347,3,15,3,14,45,55,-10,48
Lucerne,347,4,13,7,12,43,46,-3,46
FC Zürich,347,5,11,11,10,41,34,7,44
Grasshoppers,347,6,10,7,15,40,50,-10,37
FC Lugano,347,7,9,6,17,31,49,-18,33
FC Sion,347,8,7,9,16,42,52,-10,30
FC Thun,347,9,8,5,19,38,61,-23,29
Young Boys,348,1,23,6,3,73,33,40,75
FC Basel,348,2,19,7,6,55,26,29,64
Lucerne,348,3,13,7,12,41,44,-3,46
St Gallen,348,4,14,3,15,41,54,-13,45
FC Zürich,348,5,10,10,12,41,36,5,40
FC Thun,348,6,11,5,16,43,54,-11,38
FC Lugano,348,7,10,6,16,32,49,-17,36
Grasshoppers,348,8,9,6,17,38,51,-13,33
FC Sion,348,9,6,8,18,38,55,-17,26
Young Boys,349,1,23,6,3,75,37,38,75
FC Basel,349,2,17,9,6,57,30,27,60
St Gallen,349,3,15,2,15,43,55,-12,47
FC Zürich,349,4,12,9,11,45,39,6,45
Lucerne,349,5,12,8,12,39,43,-4,44
FC Lugano,349,6,11,5,16,31,46,-15,38
Grasshoppers,349,7,10,7,15,45,51,-6,37
FC Thun,349,8,8,7,17,44,61,-17,31
FC Sion,349,9,6,7,19,41,58,-17,25
Young Boys,350,1,20,9,3,67,34,33,69
FC Basel,350,2,17,8,7,54,27,27,59
St Gallen,350,3,16,2,14,45,53,-8,50
Lucerne,350,4,13,8,11,44,41,3,47
FC Zürich,350,5,11,10,11,38,35,3,43
Grasshoppers,350,6,9,7,16,42,50,-8,34
FC Thun,350,7,9,7,16,45,62,-17,34
FC Lugano,350,8,9,6,17,28,50,-22,33
FC Sion,350,9,8,7,17,44,55,-11,31
Young Boys,351,1,22,7,3,70,34,36,73
FC Basel,351,2,16,9,7,51,25,26,57
Lucerne,351,3,14,7,11,43,41,2,49
St Gallen,351,4,14,4,14,44,56,-12,46
FC Lugano,351,5,11,6,15,33,47,-14,39
FC Zürich,351,6,9,11,12,40,39,1,38
FC Thun,351,7,10,5,17,44,63,-19,35
Grasshoppers,351,8,9,7,16,43,51,-8,34
FC Sion,351,9,7,8,17,46,58,-12,29
Young Boys,352,1,21,7,4,68,33,35,70
FC Basel,352,2,18,8,6,56,26,30,62
Lucerne,352,3,13,9,10,40,40,0,48
St Gallen,352,4,14,3,15,41,53,-12,45
FC Zürich,352,5,10,10,12,38,38,0,40
FC Lugano,352,6,11,5,16,30,46,-16,38
FC Thun,352,7,9,7,16,46,61,-15,34
FC Sion,352,8,8,8,16,41,50,-9,32
Grasshoppers,352,9,8,7,17,38,51,-13,31
Young Boys,353,1,20,8,4,70,38,32,68
FC Basel,353,2,16,9,7,52,28,24,57
St Gallen,353,3,15,3,14,45,54,-9,48
Lucerne,353,4,13,8,11,40,42,-2,47
FC Zürich,353,5,11,11,10,43,36,7,44
FC Lugano,353,6,11,6,15,33,47,-14,39
FC Thun,353,7,10,6,16,50,57,-7,36
Grasshoppers,353,8,8,8,16,41,55,-14,32
FC Sion,353,9,6,9,17,43,60,-17,27
Young Boys,354,1,22,6,4,69,33,36,72
FC Basel,354,2,17,8,7,50,26,24,59
Lucerne,354,3,15,7,10,44,40,4,52
St Gallen,354,4,15,3,14,45,51,-6,48
FC Zürich,354,5,10,9,13,40,40,0,39
FC Lugano,354,6,11,5,16,31,44,-13,38
FC Thun,354,7,10,5,17,42,57,-15,35
Grasshoppers,354,8,9,6,17,43,54,-11,33
FC Sion,354,9,7,7,18,43,62,-19,28
Young Boys,355,1,22,8,2,72,31,41,74
FC Basel,355,2,17,9,6,55,27,28,60
St Gallen,355,3,15,2,15,44,57,-13,47
Lucerne,355,4,12,9,11,43,46,-3,45
FC Zürich,355,5,10,10,12,39,38,1,40
FC Lugano,355,6,11,7,14,34,46,-12,40
Grasshoppers,355,7,9,7,16,42,52,-10,34
FC Thun,355,8,8,7,17,44,61,-17,31
FC Sion,355,9,7,7,18,40,55,-15,28
Young Boys,356,1,23,6,3,77,32,45,75
FC Basel,356,2,17,7,8,53,29,24,58
St Gallen,356,3,16,2,14,47,53,-6,50
Lucerne,356,4,12,8,12,39,43,-4,44
FC Zürich,356,5,11,10,11,41,35,6,43
FC Thun,356,6,10,7,15,42,55,-13,37
Grasshoppers,356,7,8,9,15,37,50,-13,33
FC Lugano,356,8,9,6,17,28,50,-22,33
FC Sion,356,9,6,9,17,37,54,-17,27
Young Boys,357,1,21,8,3,68,33,35,71
FC Basel,357,2,18,8,6,55,26,29,62
St Gallen,357,3,15,2,15,44,55,-11,47
Lucerne,357,4,13,7,12,42,46,-4,46
FC Zürich,357,5,11,10,11,43,37,6,43
FC Thun,357,6,10,6,16,46,60,-14,36
FC Lugano,357,7,10,6,16,33,48,-15,36
Grasshoppers,357,8,8,8,16,39,50,-11,32
FC Sion,357,9,7,7,18,39,54,-15,28
Young Boys,358,1,20,8,4,66,34,32,68
FC Basel,358,2,18,8,6,56,29,27,62
St Gallen,358,3,15,3,14,44,54,-10,48
Lucerne,358,4,13,8,11,46,46,0,47
Grasshoppers,358,5,11,6,15,47,50,-3,39
FC Zürich,358,6,9,10,13,37,39,-2,37
FC Lugano,358,7,10,6,16,31,47,-16,36
FC Thun,358,8,9,7,16,46,60,-14,34
FC Sion,358,9,7,8,17,40,54,-14,29
Young Boys,359,1,19,10,3,66,34,32,67
FC Basel,359,2,17,9,6,58,33,25,60
Lucerne,359,3,14,8,10,45,41,4,50
St Gallen,359,4,13,3,16,43,60,-17,42
FC Zürich,359,5,10,10,12,41,38,3,40
FC Lugano,359,6,10,8,14,32,44,-12,38
FC Thun,359,7,10,6,16,47,58,-11,36
Grasshoppers,359,8,9,8,15,42,53,-11,35
FC Sion,359,9,6,10,16,39,52,-13,28
Young Boys,360,1,21,8,3,73,40,33,71
FC Basel,360,2,19,8,5,58,24,34,65
Lucerne,360,3,12,8,12,42,47,-5,44
St Gallen,360,4,13,3,16,40,56,-16,42
FC Zürich,360,5,10,11,11,40,37,3,41
FC Lugano,360,6,10,8,14,32,45,-13,38
Grasshoppers,360,7,10,7,15,43,50,-7,37
FC Thun,360,8,9,6,17,44,60,-16,33
FC Sion,360,9,6,9,17,44,57,-13,27
Young Boys,361,1,22,8,2,74,35,39,74
FC Basel,361,2,18,9,5,52,23,29,63
St Gallen,361,3,14,2,16,42,56,-14,44
Lucerne,361,4,11,9,12,37,43,-6,42
FC Lugano,361,5,12,6,14,35,46,-11,42
FC Zürich,361,6,10,9,13,41,40,1,39
FC Thun,361,7,10,6,16,47,58,-11,36
Grasshoppers,361,8,8,8,16,39,51,-12,32
FC Sion,361,9,6,9,17,41,56,-15,27
Young Boys,362,1,20,8,4,68,34,34,68
FC Basel,362,2,17,9,6,52,27,25,60
Lucerne,362,3,12,10,10,44,45,-1,46
FC Zürich,362,4,11,10,11,42,39,3,43
St Gallen,362,5,13,4,15,43,56,-13,43
FC Lugano,362,6,11,7,14,30,43,-13,40
FC Thun,362,7,10,7,15,50,59,-9,37
Grasshoppers,362,8,9,9,14,47,54,-7,36
FC Sion,362,9,5,8,19,40,59,-19,23
Young Boys,363,1,22,8,2,72,33,39,74
FC Basel,363,2,17,8,7,56,26,30,59
St Gallen,363,3,17,2,13,48,53,-5,53
Lucerne,363,4,12,8,12,40,48,-8,44
FC Zürich,363,5,11,10,11,41,35,6,43
Grasshoppers,363,6,8,9,15,41,50,-9,33
FC Lugano,363,7,9,6,17,30,48,-18,33
FC Thun,363,8,9,6,17,43,62,-19,33
FC Sion,363,9,6,9,17,42,58,-16,27
Young Boys,364,1,22,7,3,76,37,39,73
FC Basel,364,2,18,8,6,52,23,29,62
St Gallen,364,3,16,2,14,44,53,-9,50
Lucerne,364,4,13,8,11,40,43,-3,47
FC Zürich,364,5,9,11,12,38,37,1,38
Grasshoppers,364,6,10,6,16,40,48,-8,36
FC Lugano,364,7,10,5,17,31,50,-19,35
FC Thun,364,8,9,6,17,42,57,-15,33
FC Sion,364,9,6,9,17,41,56,-15,27
Young Boys,365,1,22,8,2,72,35,37,74
FC Basel,365,2,18,7,7,58,29,29,61
St Gallen,365,3,15,2,15,47,60,-13,47
FC Zürich,365,4,12,10,10,48,38,10,46
Lucerne,365,5,13,7,12,47,47,0,46
FC Lugano,365,6,9,7,16,35,55,-20,34
FC Thun,365,7,9,6,17,40,57,-17,33
Grasshoppers,365,8,8,8,16,40,52,-12,32
FC Sion,365,9,7,7,18,38,52,-14,28
Young Boys,366,1,22,6,4,70,37,33,72
FC Basel,366,2,17,7,8,54,28,26,58
St Gallen,366,3,15,2,15,44,55,-11,47
FC Zürich,366,4,11,10,11,43,38,5,43
Lucerne,366,5,12,7,13,40,46,-6,43
FC Lugano,366,6,11,5,16,34,50,-16,38
Grasshoppers,366,7,9,8,15,39,47,-8,35
FC Thun,366,8,9,7,16,44,58,-14,34
FC Sion,366,9,7,10,15,44,53,-9,31
Young Boys,367,1,21,9,2,72,36,36,72
FC Basel,367,2,16,11,5,54,28,26,59
St Gallen,367,3,13,6,13,44,55,-11,45
Lucerne,367,4,11,10,11,42,46,-4,43
FC Thun,367,5,11,6,15,48,56,-8,39
FC Lugano,367,6,10,8,14,32,46,-14,38
FC Zürich,367,7,9,10,13,39,38,1,37
Grasshoppers,367,8,9,7,16,41,53,-12,34
FC Sion,367,9,6,9,17,39,53,-14,27
Young Boys,368,1,21,7,4,71,36,35,70
FC Basel,368,2,17,8,7,52,27,25,59
St Gallen,368,3,15,2,15,43,54,-11,47
Lucerne,368,4,13,7,12,42,45,-3,46
FC Zürich,368,5,12,9,11,41,35,6,45
Grasshoppers,368,6,11,6,15,45,49,-4,39
FC Lugano,368,7,10,5,17,31,50,-19,35
FC Thun,368,8,9,7,16,44,59,-15,34
FC Sion,368,9,6,9,17,39,53,-14,27
Young Boys,369,1,21,6,5,70,35,35,69
FC Basel,369,2,19,8,5,62,27,35,65
Lucerne,369,3,13,8,11,42,44,-2,47
St Gallen,369,4,15,2,15,46,58,-12,47
FC Zürich,369,5,10,11,11,44,35,9,41
FC Lugano,369,6,11,6,15,31,45,-14,39
Grasshoppers,369,7,9,7,16,42,50,-8,34
FC Thun,369,8,9,6,17,45,65,-20,33
FC Sion,369,9,6,8,18,38,61,-23,26
Young Boys,370,1,21,7,4,69,35,34,70
FC Basel,370,2,17,8,7,54,28,26,59
St Gallen,370,3,15,3,14,44,54,-10,48
Lucerne,370,4,12,9,11,43,44,-1,45
FC Zürich,370,5,10,11,11,42,37,5,41
FC Lugano,370,6,10,7,15,32,48,-16,37
Grasshoppers,370,7,10,6,16,41,52,-11,36
FC Thun,370,8,9,7,16,43,58,-15,34
FC Sion,370,9,6,10,16,42,54,-12,28
Young Boys,371,1,21,8,3,71,35,36,71
FC Basel,371,2,16,10,6,54,29,25,58
St Gallen,371,3,15,3,14,44,53,-9,48
FC Zürich,371,4,11,10,11,43,35,8,43
FC Lugano,371,5,12,6,14,33,45,-12,42
Lucerne,371,6,11,8,13,38,44,-6,41
Grasshoppers,371,7,8,9,15,40,50,-10,33
FC Thun,371,8,8,8,16,46,63,-17,32
FC Sion,371,9,7,8,17,42,57,-15,29
Young Boys,372,1,21,8,3,67,32,35,71
FC Basel,372,2,17,9,6,53,26,27,60
Lucerne,372,3,13,8,11,42,45,-3,47
St Gallen,372,4,14,3,15,44,54,-10,45
FC Zürich,372,5,10,11,11,39,35,4,41
FC Thun,372,6,12,5,15,48,56,-8,41
FC Lugano,372,7,10,6,16,32,48,-16,36
Grasshoppers,372,8,9,6,17,37,49,-12,33
FC Sion,372,9,6,8,18,36,53,-17,26
Young Boys,373,1,23,7,2,81,36,45,76
FC Basel,373,2,16,9,7,55,32,23,57
St Gallen,373,3,16,3,13,47,54,-7,51
FC Zürich,373,4,11,9,12,43,38,5,42
Lucerne,373,5,11,9,12,44,51,-7,42
FC Lugano,373,6,10,6,16,31,51,-20,36
Grasshoppers,373,7,9,8,15,46,53,-7,35
FC Thun,373,8,9,8,15,46,60,-14,35
FC Sion,373,9,5,9,18,41,59,-18,24
Young Boys,374,1,20,9,3,71,37,34,69
FC Basel,374,2,16,9,7,54,28,26,57
St Gallen,374,3,16,2,14,47,55,-8,50
FC Zürich,374,4,12,9,11,43,37,6,45
Lucerne,374,5,12,8,12,42,48,-6,44
Grasshoppers,374,6,10,8,14,43,49,-6,38
FC Lugano,374,7,10,7,15,32,47,-15,37
FC Thun,374,8,8,8,16,41,57,-16,32
FC Sion,374,9,6,8,18,37,52,-15,26
Young Boys,375,1,21,8,3,72,39,33,71
FC Basel,375,2,18,8,6,55,27,28,62
Lucerne,375,3,13,7,12,43,44,-1,46
St Gallen,375,4,14,2,16,43,58,-15,44
FC Zürich,375,5,11,10,11,40,35,5,43
FC Lugano,375,6,11,6,15,36,47,-11,39
Grasshoppers,375,7,9,8,15,39,48,-9,35
FC Thun,375,8,9,6,17,40,56,-16,33
FC Sion,375,9,6,9,17,39,53,-14,27
Young Boys,376,1,20,7,5,72,38,34,67
FC Basel,376,2,17,8,7,52,26,26,59
FC Zürich,376,3,12,10,10,42,34,8,46
St Gallen,376,4,14,4,14,43,55,-12,46
Lucerne,376,5,12,8,12,41,47,-6,44
FC Lugano,376,6,11,5,16,33,48,-15,38
Grasshoppers,376,7,10,6,16,41,51,-10,36
FC Thun,376,8,10,5,17,44,59,-15,35
FC Sion,376,9,7,9,16,43,53,-10,30
Young Boys,377,1,22,7,3,71,35,36,73
FC Basel,377,2,19,7,6,58,24,34,64
Lucerne,377,3,13,8,11,43,46,-3,47
St Gallen,377,4,14,2,16,42,56,-14,44
FC Zürich,377,5,9,11,12,39,40,-1,38
FC Lugano,377,6,10,6,16,33,51,-18,36
FC Thun,377,7,10,5,17,48,62,-14,35
Grasshoppers,377,8,9,7,16,43,52,-9,34
FC Sion,377,9,7,9,16,42,53,-11,30
Young Boys,378,1,20,7,5,68,39,29,67
FC Basel,378,2,19,8,5,56,23,33,65
Lucerne,378,3,12,10,10,41,43,-2,46
St Gallen,378,4,14,3,15,44,56,-12,45
FC Zürich,378,5,10,10,12,41,37,4,40
FC Sion,378,6,9,7,16,45,54,-9,34
Grasshoppers,378,7,9,7,16,40,49,-9,34
FC Thun,378,8,9,7,16,42,59,-17,34
FC Lugano,378,9,9,7,16,30,47,-17,34
Young Boys,379,1,24,6,2,74,33,41,78
FC Basel,379,2,18,8,6,52,23,29,62
Lucerne,379,3,13,8,11,44,43,1,47
St Gallen,379,4,14,4,14,41,54,-13,46
FC Zürich,379,5,10,11,11,39,34,5,41
FC Lugano,379,6,9,7,16,30,50,-20,34
Grasshoppers,379,7,8,8,16,39,50,-11,32
FC Thun,379,8,8,6,18,43,63,-20,30
FC Sion,379,9,7,8,17,41,53,-12,29
Young Boys,380,1,20,7,5,68,35,33,67
FC Basel,380,2,18,8,6,56,29,27,62
Lucerne,380,3,14,7,11,43,41,2,49
FC Zürich,380,4,11,11,10,43,32,11,44
St Gallen,380,5,13,4,15,45,58,-13,43
Grasshoppers,380,6,11,6,15,41,46,-5,39
FC Lugano,380,7,10,5,17,30,54,-24,35
FC Thun,380,8,9,7,16,40,57,-17,34
FC Sion,380,9,5,11,16,38,52,-14,26
Young Boys,381,1,22,8,2,72,32,40,74
FC Basel,381,2,17,8,7,55,28,27,59
Lucerne,381,3,13,9,10,42,42,0,48
FC Zürich,381,4,11,10,11,40,34,6,43
St Gallen,381,5,13,3,16,39,58,-19,42
Grasshoppers,381,6,10,6,16,43,51,-8,36
FC Lugano,381,7,10,5,17,31,48,-17,35
FC Thun,381,8,9,7,16,43,60,-17,34
FC Sion,381,9,7,8,17,39,51,-12,29
Young Boys,382,1,21,7,4,75,39,36,70
FC Basel,382,2,20,7,5,59,21,38,67
Lucerne,382,3,13,8,11,43,45,-2,47
St Gallen,382,4,13,3,16,40,59,-19,42
FC Zürich,382,5,10,11,11,41,36,5,41
FC Thun,382,6,10,6,16,45,57,-12,36
FC Lugano,382,7,10,6,16,29,51,-22,36
FC Sion,382,8,8,8,16,43,52,-9,32
Grasshoppers,382,9,8,6,18,39,54,-15,30
Young Boys,383,1,23,6,3,77,35,42,75
FC Basel,383,2,17,8,7,55,31,24,59
St Gallen,383,3,16,2,14,47,56,-9,50
FC Zürich,383,4,11,10,11,45,39,6,43
Lucerne,383,5,11,8,13,41,48,-7,41
FC Lugano,383,6,11,6,15,33,46,-13,39
Grasshoppers,383,7,9,7,16,41,51,-10,34
FC Thun,383,8,9,7,16,46,60,-14,34
FC Sion,383,9,6,8,18,39,58,-19,26
Young Boys,384,1,21,9,2,69,29,40,72
FC Basel,384,2,17,9,6,52,25,27,60
Lucerne,384,3,14,8,10,44,46,-2,50
St Gallen,384,4,14,3,15,42,54,-12,45
FC Zürich,384,5,10,9,13,39,38,1,39
FC Thun,384,6,11,5,16,44,57,-13,38
FC Lugano,384,7,10,7,15,32,47,-15,37
Grasshoppers,384,8,8,7,17,39,52,-13,31
FC Sion,384,9,7,7,18,38,51,-13,28
Young Boys,385,1,23,7,2,73,31,42,76
FC Basel,385,2,17,9,6,53,26,27,60
Lucerne,385,3,12,9,11,42,45,-3,45
St Gallen,385,4,13,3,16,42,57,-15,42
FC Zürich,385,5,10,11,11,40,38,2,41
FC Lugano,385,6,10,7,15,32,46,-14,37
FC Thun,385,7,10,5,17,44,58,-14,35
Grasshoppers,385,8,9,7,16,41,50,-9,34
FC Sion,385,9,7,8,17,39,55,-16,29
Young Boys,386,1,21,8,3,76,36,40,71
FC Basel,386,2,19,7,6,55,25,30,64
St Gallen,386,3,15,3,14,45,56,-11,48
Lucerne,386,4,12,9,11,42,45,-3,45
FC Zürich,386,5,11,11,10,42,34,8,44
FC Lugano,386,6,10,6,16,33,52,-19,36
Grasshoppers,386,7,9,6,17,41,55,-14,33
FC Thun,386,8,8,6,18,42,62,-20,30
FC Sion,386,9,7,8,17,42,53,-11,29
Young Boys,387,1,20,7,5,68,34,34,67
FC Basel,387,2,18,8,6,54,24,30,62
St Gallen,387,3,14,5,13,39,49,-10,47
Lucerne,387,4,12,9,11,42,46,-4,45
FC Thun,387,5,12,5,15,48,55,-7,41
FC Zürich,387,6,10,10,12,39,36,3,40
Grasshoppers,387,7,9,7,16,39,50,-11,34
FC Lugano,387,8,9,7,16,29,48,-19,34
FC Sion,387,9,6,10,16,37,53,-16,28
Young Boys,388,1,21,7,4,73,34,39,70
FC Basel,388,2,20,7,5,54,21,33,67
Lucerne,388,3,13,9,10,41,42,-1,48
St Gallen,388,4,14,4,14,43,55,-12,46
FC Zürich,388,5,10,9,13,38,39,-1,39
FC Thun,388,6,11,5,16,46,55,-9,38
FC Lugano,388,7,10,6,16,30,51,-21,36
Grasshoppers,388,8,9,7,16,43,49,-6,34
FC Sion,388,9,5,8,19,38,60,-22,23
Young Boys,389,1,22,7,3,70,34,36,73
FC Basel,389,2,19,8,5,57,24,33,65
St Gallen,389,3,15,2,15,43,55,-12,47
Lucerne,389,4,12,9,11,43,42,1,45
FC Zürich,389,5,10,10,12,39,38,1,40
FC Thun,389,6,11,5,16,46,57,-11,38
Grasshoppers,389,7,9,7,16,44,53,-9,34
FC Lugano,389,8,9,5,18,29,53,-24,32
FC Sion,389,9,6,9,17,39,54,-15,27
Young Boys,390,1,21,7,4,68,35,33,70
FC Basel,390,2,17,8,7,52,26,26,59
Lucerne,390,3,15,8,9,43,39,4,53
St Gallen,390,4,13,5,14,40,53,-13,44
FC Zürich,390,5,10,12,10,43,37,6,42
Grasshoppers,390,6,9,7,16,40,49,-9,34
FC Lugano,390,7,9,7,16,29,47,-18,34
FC Thun,390,8,9,6,17,45,62,-17,33
FC Sion,390,9,6,10,16,40,52,-12,28
Young Boys,391,1,22,8,2,76,33,43,74
FC Basel,391,2,18,8,6,52,25,27,62
St Gallen,391,3,14,2,16,41,55,-14,44
Lucerne,391,4,12,7,13,40,45,-5,43
FC Zürich,391,5,10,11,11,42,40,2,41
FC Lugano,391,6,12,5,15,34,45,-11,41
Grasshoppers,391,7,9,7,16,39,52,-13,34
FC Sion,391,8,7,10,15,42,53,-11,31
FC Thun,391,9,8,6,18,42,60,-18,30
Young Boys,392,1,20,9,3,72,36,36,69
FC Basel,392,2,17,9,6,53,26,27,60
St Gallen,392,3,16,2,14,47,53,-6,50
Lucerne,392,4,12,9,11,41,47,-6,45
FC Zürich,392,5,10,11,11,40,38,2,41
FC Lugano,392,6,11,6,15,32,46,-14,39
Grasshoppers,392,7,9,6,17,40,52,-12,33
FC Thun,392,8,9,6,17,43,59,-16,33
FC Sion,392,9,7,8,17,43,54,-11,29
Young Boys,393,1,22,7,3,73,35,38,73
FC Basel,393,2,19,7,6,57,24,33,64
St Gallen,393,3,14,4,14,42,54,-12,46
Lucerne,393,4,12,8,12,42,46,-4,44
FC Zürich,393,5,11,9,12,40,39,1,42
Grasshoppers,393,6,10,7,15,44,52,-8,37
FC Lugano,393,7,10,6,16,34,52,-18,36
FC Thun,393,8,10,5,17,47,59,-12,35
FC Sion,393,9,6,7,19,39,57,-18,25
Young Boys,394,1,22,6,4,72,40,32,72
FC Basel,394,2,18,8,6,61,26,35,62
St Gallen,394,3,14,3,15,43,55,-12,45
FC Zürich,394,4,11,11,10,46,36,10,44
Lucerne,394,5,12,8,12,38,44,-6,44
FC Lugano,394,6,11,6,15,33,47,-14,39
Grasshoppers,394,7,9,7,16,41,51,-10,34
FC Thun,394,8,9,7,16,44,59,-15,34
FC Sion,394,9,6,8,18,40,60,-20,26
Young Boys,395,1,20,9,3,68,36,32,69
FC Basel,395,2,17,8,7,53,26,27,59
St Gallen,395,3,15,2,15,44,54,-10,47
FC Zürich,395,4,12,9,11,43,36,7,45
Lucerne,395,5,11,10,11,41,46,-5,43
FC Lugano,395,6,11,6,15,30,45,-15,39
Grasshoppers,395,7,10,8,14,49,51,-2,38
FC Thun,395,8,9,6,17,44,61,-17,33
FC Sion,395,9,6,8,18,39,56,-17,26
Young Boys,396,1,22,7,3,74,37,37,73
FC Basel,396,2,18,7,7,53,28,25,61
Lucerne,396,3,15,8,9,45,41,4,53
FC Zürich,396,4,10,11,11,39,34,5,41
St Gallen,396,5,13,2,17,43,59,-16,41
FC Thun,396,6,10,6,16,44,55,-11,36
FC Lugano,396,7,10,6,16,31,47,-16,36
Grasshoppers,396,8,9,7,16,39,48,-9,34
FC Sion,396,9,6,8,18,39,58,-19,26
Young Boys,397,1,20,8,4,69,37,32,68
FC Basel,397,2,17,9,6,54,27,27,60
St Gallen,397,3,16,2,14,47,55,-8,50
Lucerne,397,4,13,9,10,47,43,4,48
FC Zürich,397,5,12,10,10,43,34,9,46
Grasshoppers,397,6,10,6,16,43,53,-10,36
FC Thun,397,7,10,5,17,43,61,-18,35
FC Lugano,397,8,9,5,18,30,51,-21,32
FC Sion,397,9,6,8,18,43,58,-15,26
Young Boys,398,1,23,7,2,74,33,41,76
FC Basel,398,2,17,10,5,53,25,28,61
St Gallen,398,3,14,4,14,44,54,-10,46
Lucerne,398,4,11,9,12,40,45,-5,42
FC Lugano,398,5,12,5,15,34,46,-12,41
FC Zürich,398,6,10,10,12,40,38,2,40
FC Thun,398,7,10,7,15,44,57,-13,37
Grasshoppers,398,8,9,7,16,43,53,-10,34
FC Sion,398,9,5,7,20,37,58,-21,22
Young Boys,399,1,22,7,3,75,39,36,73
FC Basel,399,2,18,9,5,55,24,31,63
St Gallen,399,3,15,3,14,42,52,-10,48
FC Zürich,399,4,11,10,11,40,34,6,43
Lucerne,399,5,12,7,13,42,48,-6,43
Grasshoppers,399,6,10,6,16,44,52,-8,36
FC Lugano,399,7,10,6,16,31,47,-16,36
FC Thun,399,8,10,5,17,43,59,-16,35
FC Sion,399,9,6,7,19,41,58,-17,25
Young Boys,400,1,21,8,3,69,34,35,71
FC Basel,400,2,18,9,5,54,24,30,63
St Gallen,400,3,14,4,14,42,51,-9,46
FC Zürich,400,4,12,9,11,46,37,9,45
Lucerne,400,5,12,8,12,40,44,-4,44
Grasshoppers,400,6,10,6,16,38,47,-9,36
FC Lugano,400,7,10,6,16,34,52,-18,36
FC Thun,400,8,10,5,17,42,58,-16,35
FC Sion,400,9,5,9,18,37,55,-18,24
Young Boys,401,1,20,8,4,69,38,31,68
FC Basel,401,2,20,7,5,63,27,36,67
Lucerne,401,3,14,7,11,45,46,-1,49
St Gallen,401,4,13,3,16,43,60,-17,42
FC Zürich,401,5,10,11,11,40,37,3,41
FC Lugano,401,6,10,8,14,31,45,-14,38
Grasshoppers,401,7,9,7,16,43,49,-6,34
FC Thun,401,8,8,8,16,43,59,-16,32
FC Sion,401,9,6,9,17,40,56,-16,27
Young Boys,402,1,21,7,4,71,37,34,70
FC Basel,402,2,17,8,7,54,27,27,59
Lucerne,402,3,15,7,10,46,41,5,52
St Gallen,402,4,15,2,15,42,53,-11,47
FC Zürich,402,5,12,10,10,43,35,8,46
Grasshoppers,402,6,10,6,16,42,49,-7,36
FC Thun,402,7,10,5,17,45,60,-15,35
FC Lugano,402,8,10,5,17,31,53,-22,35
FC Sion,402,9,5,8,19,36,55,-19,23
Young Boys,403,1,22,8,2,77,36,41,74
FC Basel,403,2,18,7,7,57,27,30,61
Lucerne,403,3,13,8,11,44,47,-3,47
St Gallen,403,4,15,2,15,43,56,-13,47
FC Zürich,403,5,10,10,12,44,42,2,40
FC Thun,403,6,11,5,16,45,60,-15,38
Grasshoppers,403,7,10,6,16,44,54,-10,36
FC Lugano,403,8,10,6,16,33,47,-14,36
FC Sion,403,9,5,8,19,41,59,-18,23
Young Boys,404,1,21,8,3,70,36,34,71
FC Basel,404,2,18,8,6,54,25,29,62
St Gallen,404,3,16,2,14,45,55,-10,50
Lucerne,404,4,13,7,12,43,44,-1,46
FC Zürich,404,5,11,10,11,42,36,6,43
Grasshoppers,404,6,9,8,15,39,48,-9,35
FC Lugano,404,7,9,6,17,31,49,-18,33
FC Thun,404,8,8,7,17,41,60,-19,31
FC Sion,404,9,7,8,17,40,52,-12,29
Young Boys,405,1,22,6,4,75,38,37,72
FC Basel,405,2,17,9,6,58,30,28,60
St Gallen,405,3,15,4,13,45,54,-9,49
FC Zürich,405,4,10,12,10,39,32,7,42
Lucerne,405,5,11,9,12,43,51,-8,42
Grasshoppers,405,6,10,7,15,41,47,-6,37
FC Lugano,405,7,10,7,15,33,48,-15,37
FC Thun,405,8,9,6,17,40,59,-19,33
FC Sion,405,9,6,8,18,38,53,-15,26
Young Boys,406,1,23,7,2,77,32,45,76
FC Basel,406,2,18,7,7,54,30,24,61
Lucerne,406,3,13,8,11,43,43,0,47
St Gallen,406,4,14,4,14,40,50,-10,46
FC Zürich,406,5,11,9,12,39,37,2,42
Grasshoppers,406,6,10,6,16,40,50,-10,36
FC Lugano,406,7,9,6,17,27,47,-20,33
FC Thun,406,8,9,5,18,45,62,-17,32
FC Sion,406,9,7,8,17,40,54,-14,29
Young Boys,407,1,21,7,4,72,36,36,70
FC Basel,407,2,17,8,7,57,30,27,59
Lucerne,407,3,13,8,11,39,42,-3,47
St Gallen,407,4,14,4,14,45,54,-9,46
FC Zürich,407,5,11,9,12,43,38,5,42
FC Thun,407,6,11,5,16,45,58,-13,38
Grasshoppers,407,7,10,6,16,40,50,-10,36
FC Lugano,407,8,10,6,16,31,50,-19,36
FC Sion,407,9,7,7,18,40,54,-14,28
Young Boys,408,1,22,6,4,69,34,35,72
FC Basel,408,2,19,8,5,56,22,34,65
Lucerne,408,3,13,7,12,39,41,-2,46
St Gallen,408,4,14,2,16,41,58,-17,44
FC Zürich,408,5,11,9,12,41,37,4,42
FC Lugano,408,6,10,5,17,29,46,-17,35
Grasshoppers,408,7,9,7,16,39,49,-10,34
FC Sion,408,8,8,9,15,43,52,-9,33
FC Thun,408,9,8,7,17,39,57,-18,31
Young Boys,409,1,22,8,2,70,32,38,74
FC Basel,409,2,18,9,5,57,26,31,63
Lucerne,409,3,13,8,11,43,46,-3,47
FC Zürich,409,4,10,12,10,38,33,5,42
St Gallen,409,5,13,2,17,39,55,-16,41
FC Lugano,409,6,10,8,14,31,45,-14,38
FC Thun,409,7,10,5,17,45,57,-12,35
Grasshoppers,409,8,8,7,17,37,50,-13,31
FC Sion,409,9,6,9,17,38,54,-16,27
Young Boys,410,1,20,7,5,66,35,31,67
FC Basel,410,2,18,9,5,56,26,30,63
Lucerne,410,3,13,8,11,42,44,-2,47
St Gallen,410,4,14,2,16,42,58,-16,44
FC Zürich,410,5,10,11,11,40,36,4,41
FC Lugano,410,6,11,5,16,32,46,-14,38
Grasshoppers,410,7,10,7,15,41,47,-6,37
FC Sion,410,8,8,8,16,43,53,-10,32
FC Thun,410,9,8,7,17,41,58,-17,31
Young Boys,411,1,22,7,3,74,34,40,73
FC Basel,411,2,18,7,7,58,30,28,61
FC Lugano,411,3,13,5,14,37,44,-7,44
St Gallen,411,4,13,4,15,43,58,-15,43
FC Zürich,411,5,11,9,12,45,38,7,42
Lucerne,411,6,11,8,13,41,48,-7,41
FC Thun,411,7,10,5,17,43,63,-20,35
Grasshoppers,411,8,9,7,16,41,53,-12,34
FC Sion,411,9,6,10,16,40,54,-14,28
Young Boys,412,1,22,7,3,74,35,39,73
FC Basel,412,2,18,7,7,57,29,28,61
St Gallen,412,3,16,2,14,44,52,-8,50
Lucerne,412,4,13,8,11,43,45,-2,47
FC Zürich,412,5,9,11,12,38,37,1,38
FC Thun,412,6,11,5,16,44,57,-13,38
Grasshoppers,412,7,9,8,15,41,49,-8,35
FC Lugano,412,8,9,7,16,28,47,-19,34
FC Sion,412,9,5,9,18,38,56,-18,24
Young Boys,413,1,21,7,4,71,34,37,70
FC Basel,413,2,18,8,6,58,27,31,62
FC Zürich,413,3,13,9,10,47,34,13,48
St Gallen,413,4,15,2,15,48,57,-9,47
Lucerne,413,5,12,9,11,41,46,-5,45
Grasshoppers,413,6,10,7,15,44,50,-6,37
FC Thun,413,7,10,5,17,44,61,-17,35
FC Lugano,413,8,9,6,17,30,55,-25,33
FC Sion,413,9,6,7,19,42,61,-19,25
Young Boys,414,1,22,7,3,77,38,39,73
FC Basel,414,2,17,8,7,55,28,27,59
St Gallen,414,3,15,2,15,46,56,-10,47
FC Zürich,414,4,12,9,11,43,37,6,45
Lucerne,414,5,12,9,11,44,47,-3,45
Grasshoppers,414,6,11,6,15,46,51,-5,39
FC Thun,414,7,10,6,16,48,61,-13,36
FC Lugano,414,8,10,5,17,31,47,-16,35
FC Sion,414,9,5,8,19,42,67,-25,23
Young Boys,415,1,22,6,4,70,34,36,72
FC Basel,415,2,18,9,5,57,25,32,63
Lucerne,415,3,13,8,11,40,42,-2,47
St Gallen,415,4,14,2,16,42,58,-16,44
FC Zürich,415,5,10,10,12,41,41,0,40
FC Lugano,415,6,11,5,16,32,46,-14,38
FC Thun,415,7,10,6,16,49,59,-10,36
Grasshoppers,415,8,9,7,16,37,46,-9,34
FC Sion,415,9,7,7,18,42,59,-17,28
Young Boys,416,1,20,7,5,66,33,33,67
FC Basel,416,2,20,7,5,54,23,31,67
Lucerne,416,3,14,7,11,45,44,1,49
St Gallen,416,4,15,2,15,48,57,-9,47
FC Zürich,416,5,12,9,11,42,34,8,45
FC Lugano,416,6,10,6,16,32,49,-17,36
FC Thun,416,7,10,5,17,43,59,-16,35
Grasshoppers,416,8,9,6,17,42,53,-11,33
FC Sion,416,9,6,7,19,39,59,-20,25
Young Boys,417,1,22,7,3,71,32,39,73
FC Basel,417,2,18,7,7,52,26,26,61
FC Zürich,417,3,12,10,10,42,34,8,46
St Gallen,417,4,14,3,15,44,57,-13,45
Lucerne,417,5,12,8,12,41,48,-7,44
Grasshoppers,417,6,11,7,14,47,47,0,40
FC Lugano,417,7,10,5,17,33,49,-16,35
FC Thun,417,8,9,7,16,41,58,-17,34
FC Sion,417,9,5,8,19,37,57,-20,23
Young Boys,418,1,21,8,3,70,36,34,71
FC Basel,418,2,16,10,6,52,26,26,58
FC Zürich,418,3,12,9,11,45,37,8,45
St Gallen,418,4,14,3,15,43,55,-12,45
Lucerne,418,5,11,8,13,41,50,-9,41
FC Lugano,418,6,11,5,16,33,47,-14,38
Grasshoppers,418,7,10,7,15,43,48,-5,37
FC Thun,418,8,10,5,17,42,60,-18,35
FC Sion,418,9,8,7,17,42,52,-10,31
Young Boys,419,1,21,9,2,72,31,41,72
FC Basel,419,2,17,8,7,56,30,26,59
St Gallen,419,3,17,2,13,47,51,-4,53
FC Zürich,419,4,12,9,11,43,34,9,45
Lucerne,419,5,12,8,12,42,50,-8,44
FC Thun,419,6,10,5,17,42,58,-16,35
FC Lugano,419,7,9,7,16,29,48,-19,34
Grasshoppers,419,8,8,7,17,42,56,-14,31
FC Sion,419,9,6,9,17,39,54,-15,27
Young Boys,420,1,23,6,3,73,31,42,75
FC Basel,420,2,17,8,7,53,24,29,59
Lucerne,420,3,13,9,10,41,42,-1,48
St Gallen,420,4,13,4,15,43,63,-20,43
FC Zürich,420,5,10,11,11,41,35,6,41
Grasshoppers,420,6,10,7,15,43,49,-6,37
FC Lugano,420,7,10,6,16,34,49,-15,36
FC Thun,420,8,10,5,17,42,58,-16,35
FC Sion,420,9,6,8,18,39,58,-19,26
Young Boys,421,1,21,8,3,71,36,35,71
FC Basel,421,2,17,8,7,54,26,28,59
Lucerne,421,3,13,8,11,42,43,-1,47
St Gallen,421,4,14,3,15,42,55,-13,45
FC Zürich,421,5,11,10,11,43,36,7,43
FC Lugano,421,6,12,5,15,33,46,-13,41
FC Thun,421,7,10,6,16,46,59,-13,36
Grasshoppers,421,8,9,6,17,40,52,-12,33
FC Sion,421,9,6,8,18,39,57,-18,26
Young Boys,422,1,21,7,4,72,36,36,70
FC Basel,422,2,18,8,6,54,26,28,62
St Gallen,422,3,14,2,16,42,55,-13,44
FC Thun,422,4,12,5,15,50,58,-8,41
Lucerne,422,5,11,8,13,39,49,-10,41
FC Zürich,422,6,10,9,13,41,38,3,39
FC Lugano,422,7,11,5,16,32,47,-15,38
Grasshoppers,422,8,10,6,16,45,53,-8,36
FC Sion,422,9,8,8,16,41,54,-13,32
Young Boys,423,1,22,7,3,71,34,37,73
FC Basel,423,2,17,8,7,52,24,28,59
St Gallen,423,3,15,3,14,44,53,-9,48
Lucerne,423,4,13,8,11,43,44,-1,47
FC Thun,423,5,11,5,16,45,57,-12,38
FC Zürich,423,6,9,10,13,40,41,-1,37
FC Lugano,423,7,9,8,15,33,50,-17,35
Grasshoppers,423,8,9,7,16,41,51,-10,34
FC Sion,423,9,7,8,17,38,53,-15,29
Young Boys,424,1,20,6,6,70,39,31,66
FC Basel,424,2,18,9,5,53,24,29,63
Lucerne,424,3,13,10,9,43,41,2,49
St Gallen,424,4,13,4,15,40,55,-15,43
FC Zürich,424,5,9,12,11,37,34,3,39
FC Lugano,424,6,10,8,14,33,46,-13,38
FC Thun,424,7,10,5,17,43,58,-15,35
Grasshoppers,424,8,9,6,17,41,54,-13,33
FC Sion,424,9,8,8,16,43,52,-9,32
Young Boys,425,1,23,7,2,73,31,42,76
FC Basel,425,2,18,7,7,55,26,29,61
FC Zürich,425,3,12,10,10,48,39,9,46
St Gallen,425,4,14,3,15,42,55,-13,45
Lucerne,425,5,12,8,12,40,47,-7,44
Grasshoppers,425,6,10,6,16,41,47,-6,36
FC Lugano,425,7,10,6,16,32,48,-16,36
FC Thun,425,8,8,6,18,42,67,-25,30
FC Sion,425,9,6,9,17,44,57,-13,27
Young Boys,426,1,21,8,3,72,33,39,71
FC Basel,426,2,17,9,6,55,28,27,60
Lucerne,426,3,13,8,11,41,46,-5,47
St Gallen,426,4,15,2,15,47,55,-8,47
FC Zürich,426,5,10,11,11,41,38,3,41
FC Lugano,426,6,11,6,15,32,46,-14,39
FC Thun,426,7,9,7,16,42,58,-16,34
Grasshoppers,426,8,9,6,17,43,52,-9,33
FC Sion,426,9,6,9,17,41,58,-17,27
Young Boys,427,1,20,8,4,69,35,34,68
FC Basel,427,2,17,8,7,55,27,28,59
Lucerne,427,3,13,9,10,44,44,0,48
St Gallen,427,4,15,3,14,43,54,-11,48
FC Thun,427,5,12,5,15,48,54,-6,41
FC Zürich,427,6,9,12,11,38,38,0,39
Grasshoppers,427,7,9,8,15,42,52,-10,35
FC Lugano,427,8,9,6,17,30,51,-21,33
FC Sion,427,9,6,9,17,37,51,-14,27
Young Boys,428,1,23,6,3,78,35,43,75
FC Basel,428,2,18,9,5,53,23,30,63
Lucerne,428,3,13,8,11,43,44,-1,47
St Gallen,428,4,15,2,15,45,56,-11,47
FC Zürich,428,5,10,10,12,38,37,1,40
FC Thun,428,6,10,6,16,46,57,-11,36
FC Lugano,428,7,10,5,17,31,50,-19,35
Grasshoppers,428,8,9,7,16,41,52,-11,34
FC Sion,428,9,6,7,19,39,60,-21,25
Young Boys,429,1,23,6,3,70,32,38,75
FC Basel,429,2,18,8,6,53,25,28,62
St Gallen,429,3,16,2,14,46,53,-7,50
Lucerne,429,4,12,8,12,44,45,-1,44
FC Zürich,429,5,10,10,12,37,37,0,40
FC Lugano,429,6,11,5,16,32,46,-14,38
FC Thun,429,7,10,6,16,43,57,-14,36
Grasshoppers,429,8,9,6,17,39,53,-14,33
FC Sion,429,9,6,7,19,42,58,-16,25
Young Boys,430,1,20,6,6,66,45,21,66
FC Basel,430,2,19,8,5,58,22,36,65
Lucerne,430,3,13,7,12,41,44,-3,46
St Gallen,430,4,13,5,14,42,54,-12,44
FC Zürich,430,5,11,9,12,41,36,5,42
Grasshoppers,430,6,11,6,15,46,47,-1,39
FC Lugano,430,7,11,6,15,33,45,-12,39
FC Thun,430,8,10,5,17,42,60,-18,35
FC Sion,430,9,6,8,18,38,54,-16,26
Young Boys,431,1,22,7,3,77,36,41,73
FC Basel,431,2,18,8,6,53,26,27,62
St Gallen,431,3,16,3,13,46,53,-7,51
Lucerne,431,4,13,8,11,44,42,2,47
FC Zürich,431,5,9,11,12,39,38,1,38
Grasshoppers,431,6,9,7,16,41,51,-10,34
FC Lugano,431,7,9,7,16,30,52,-22,34
FC Thun,431,8,9,6,17,41,57,-16,33
FC Sion,431,9,7,7,18,38,54,-16,28
Young Boys,432,1,21,8,3,75,34,41,71
FC Basel,432,2,18,8,6,55,27,28,62
Lucerne,432,3,13,8,11,45,48,-3,47
St Gallen,432,4,14,3,15,45,58,-13,45
FC Zürich,432,5,10,10,12,38,35,3,40
FC Thun,432,6,11,6,15,48,59,-11,39
Grasshoppers,432,7,9,8,15,41,48,-7,35
FC Lugano,432,8,9,7,16,30,51,-21,34
FC Sion,432,9,6,8,18,40,57,-17,26
Young Boys,433,1,22,8,2,72,33,39,74
FC Basel,433,2,18,9,5,57,24,33,63
Lucerne,433,3,13,9,10,45,42,3,48
St Gallen,433,4,15,2,15,41,56,-15,47
FC Zürich,433,5,11,10,11,41,37,4,43
FC Lugano,433,6,10,6,16,30,48,-18,36
FC Thun,433,7,10,5,17,43,59,-16,35
Grasshoppers,433,8,8,6,18,38,51,-13,30
FC Sion,433,9,6,7,19,36,53,-17,25
Young Boys,434,1,23,6,3,72,35,37,75
FC Basel,434,2,18,8,6,54,24,30,62
FC Zürich,434,3,12,10,10,42,34,8,46
Lucerne,434,4,12,8,12,40,45,-5,44
St Gallen,434,5,13,3,16,40,57,-17,42
FC Thun,434,6,10,6,16,48,58,-10,36
FC Lugano,434,7,10,6,16,29,45,-16,36
Grasshoppers,434,8,9,6,17,40,51,-11,33
FC Sion,434,9,7,7,18,42,58,-16,28
Young Boys,435,1,21,6,5,69,37,32,69
FC Basel,435,2,20,7,5,62,21,41,67
Lucerne,435,3,14,7,11,42,45,-3,49
FC Zürich,435,4,11,10,11,44,40,4,43
St Gallen,435,5,13,3,16,43,58,-15,42
Grasshoppers,435,6,10,6,16,43,53,-10,36
FC Lugano,435,7,10,6,16,30,48,-18,36
FC Sion,435,8,8,7,17,49,57,-8,31
FC Thun,435,9,8,6,18,41,64,-23,30
Young Boys,436,1,20,8,4,66,34,32,68
FC Basel,436,2,17,10,5,52,24,28,61
Lucerne,436,3,13,10,9,43,38,5,49
FC Zürich,436,4,11,11,10,42,35,7,44
St Gallen,436,5,13,3,16,40,56,-16,42
Grasshoppers,436,6,9,9,14,42,48,-6,36
FC Lugano,436,7,10,5,17,30,49,-19,35
FC Thun,436,8,9,6,17,41,56,-15,33
FC Sion,436,9,7,8,17,41,57,-16,29
Young Boys,437,1,23,6,3,75,30,45,75
FC Basel,437,2,17,7,8,50,27,23,58
Lucerne,437,3,15,7,10,44,43,1,52
St Gallen,437,4,14,2,16,42,55,-13,44
FC Zürich,437,5,11,9,12,40,36,4,42
FC Thun,437,6,11,5,16,44,57,-13,38
FC Lugano,437,7,11,5,16,30,48,-18,38
Grasshoppers,437,8,9,6,17,41,51,-10,33
FC Sion,437,9,6,7,19,39,58,-19,25
Young Boys,438,1,22,6,4,75,37,38,72
FC Basel,438,2,17,8,7,52,24,28,59
Lucerne,438,3,15,7,10,41,39,2,52
FC Zürich,438,4,12,9,11,42,33,9,45
St Gallen,438,5,13,3,16,40,56,-16,42
FC Lugano,438,6,11,6,15,33,46,-13,39
FC Thun,438,7,10,6,16,45,58,-13,36
Grasshoppers,438,8,9,6,17,41,52,-11,33
FC Sion,438,9,6,7,19,38,62,-24,25
Young Boys,439,1,21,7,4,69,36,33,70
FC Basel,439,2,18,8,6,57,25,32,62
Lucerne,439,3,15,8,9,44,39,5,53
FC Zürich,439,4,11,11,10,45,37,8,44
St Gallen,439,5,13,4,15,39,54,-15,43
Grasshoppers,439,6,9,7,16,39,49,-10,34
FC Lugano,439,7,9,6,17,29,47,-18,33
FC Thun,439,8,8,8,16,41,59,-18,32
FC Sion,439,9,6,9,17,36,53,-17,27
Young Boys,440,1,21,7,4,72,36,36,70
FC Basel,440,2,19,7,6,57,24,33,64
Lucerne,440,3,12,9,11,38,45,-7,45
FC Lugano,440,4,12,6,14,31,43,-12,42
St Gallen,440,5,13,3,16,38,58,-20,42
FC Zürich,440,6,9,11,12,40,39,1,38
Grasshoppers,440,7,10,7,15,42,49,-7,37
FC Sion,440,8,8,8,16,50,55,-5,32
FC Thun,440,9,8,6,18,42,61,-19,30
Young Boys,441,1,21,8,3,76,38,38,71
FC Basel,441,2,18,9,5,56,24,32,63
St Gallen,441,3,14,3,15,43,56,-13,45
Lucerne,441,4,12,8,12,43,48,-5,44
FC Zürich,441,5,10,10,12,41,38,3,40
FC Lugano,441,6,11,6,15,35,48,-13,39
Grasshoppers,441,7,10,7,15,44,52,-8,37
FC Thun,441,8,9,5,18,43,62,-19,32
FC Sion,441,9,7,8,17,41,56,-15,29
Young Boys,442,1,22,7,3,70,33,37,73
FC Basel,442,2,17,7,8,51,28,23,58
Lucerne,442,3,12,8,12,40,46,-6,44
St Gallen,442,4,14,2,16,42,56,-14,44
FC Zürich,442,5,11,9,12,42,40,2,42
FC Lugano,442,6,12,5,15,36,45,-9,41
Grasshoppers,442,7,11,6,15,44,49,-5,39
FC Thun,442,8,11,5,16,48,55,-7,38
FC Sion,442,9,6,7,19,38,59,-21,25
Young Boys,443,1,22,6,4,75,36,39,72
FC Basel,443,2,17,7,8,52,29,23,58
St Gallen,443,3,15,2,15,47,59,-12,47
Lucerne,443,4,12,7,13,43,46,-3,43
FC Zürich,443,5,10,11,11,42,40,2,41
FC Lugano,443,6,11,5,16,34,49,-15,38
Grasshoppers,443,7,10,7,15,43,53,-10,37
FC Thun,443,8,10,6,16,49,58,-9,36
FC Sion,443,9,7,9,16,43,58,-15,30
Young Boys,444,1,22,8,2,76,36,40,74
FC Basel,444,2,16,9,7,50,33,17,57
St Gallen,444,3,16,2,14,51,53,-2,50
FC Zürich,444,4,11,9,12,41,35,6,42
Lucerne,444,5,11,8,13,40,46,-6,41
FC Thun,444,6,10,7,15,44,55,-11,37
Grasshoppers,444,7,9,8,15,42,49,-7,35
FC Lugano,444,8,10,5,17,28,49,-21,35
FC Sion,444,9,7,8,17,38,54,-16,29
Young Boys,445,1,22,6,4,74,38,36,72
FC Basel,445,2,19,7,6,56,26,30,64
Lucerne,445,3,12,8,12,40,45,-5,44
FC Zürich,445,4,10,12,10,40,35,5,42
St Gallen,445,5,13,2,17,39,57,-18,41
FC Lugano,445,6,11,7,14,31,44,-13,40
Grasshoppers,445,7,11,6,15,45,49,-4,39
FC Thun,445,8,9,6,17,46,60,-14,33
FC Sion,445,9,6,8,18,40,57,-17,26
Young Boys,446,1,20,8,4,70,35,35,68
FC Basel,446,2,17,8,7,53,30,23,59
Lucerne,446,3,14,9,9,44,41,3,51
St Gallen,446,4,14,3,15,43,56,-13,45
FC Zürich,446,5,11,10,11,43,36,7,43
Grasshoppers,446,6,9,7,16,38,49,-11,34
FC Thun,446,7,9,7,16,44,56,-12,34
FC Lugano,446,8,9,7,16,29,48,-19,34
FC Sion,446,9,7,9,16,45,58,-13,30
Young Boys,447,1,23,6,3,78,36,42,75
FC Basel,447,2,18,8,6,54,24,30,62
Lucerne,447,3,13,8,11,41,44,-3,47
St Gallen,447,4,14,4,14,40,50,-10,46
FC Zürich,447,5,12,9,11,40,34,6,45
Grasshoppers,447,6,10,6,16,42,50,-8,36
FC Lugano,447,7,9,6,17,29,49,-20,33
FC Thun,447,8,8,6,18,40,60,-20,30
FC Sion,447,9,7,7,18,38,55,-17,28
Young Boys,448,1,22,6,4,72,34,38,72
FC Basel,448,2,18,7,7,55,31,24,61
Lucerne,448,3,14,8,10,47,44,3,50
FC Zürich,448,4,11,10,11,41,35,6,43
St Gallen,448,5,13,3,16,44,59,-15,42
FC Lugano,448,6,10,6,16,29,47,-18,36
FC Thun,448,7,9,6,17,45,60,-15,33
Grasshoppers,448,8,8,8,16,38,50,-12,32
FC Sion,448,9,7,10,15,45,56,-11,31
Young Boys,449,1,21,8,3,73,41,32,71
FC Basel,449,2,16,11,5,54,28,26,59
St Gallen,449,3,14,4,14,43,54,-11,46
Lucerne,449,4,12,9,11,45,47,-2,45
FC Zürich,449,5,11,10,11,42,35,7,43
FC Lugano,449,6,11,6,15,29,44,-15,39
Grasshoppers,449,7,10,7,15,49,51,-2,37
FC Thun,449,8,9,6,17,45,63,-18,33
FC Sion,449,9,5,9,18,41,58,-17,24
Young Boys,450,1,21,7,4,72,38,34,70
FC Basel,450,2,18,9,5,56,24,32,63
Lucerne,450,3,13,9,10,45,43,2,48
St Gallen,450,4,13,3,16,42,58,-16,42
FC Zürich,450,5,9,12,11,41,38,3,39
Grasshoppers,450,6,10,8,14,44,48,-4,38
FC Lugano,450,7,10,7,15,32,50,-18,37
FC Thun,450,8,8,8,16,41,60,-19,32
FC Sion,450,9,6,9,17,40,54,-14,27
Young Boys,451,1,21,8,3,78,39,39,71
FC Basel,451,2,17,9,6,58,30,28,60
Lucerne,451,3,13,8,11,44,51,-7,47
St Gallen,451,4,14,3,15,50,59,-9,45
FC Zürich,451,5,11,9,12,39,36,3,42
Grasshoppers,451,6,10,6,16,43,51,-8,36
FC Thun,451,7,10,6,16,41,56,-15,36
FC Lugano,451,8,10,5,17,32,51,-19,35
FC Sion,451,9,7,8,17,42,54,-12,29
Young Boys,452,1,22,7,3,73,35,38,73
FC Basel,452,2,17,9,6,54,26,28,60
St Gallen,452,3,15,4,13,42,51,-9,49
Lucerne,452,4,11,9,12,41,49,-8,42
FC Zürich,452,5,10,11,11,40,36,4,41
FC Lugano,452,6,10,7,15,31,45,-14,37
FC Thun,452,7,9,7,16,44,60,-16,34
Grasshoppers,452,8,8,7,17,39,50,-11,31
FC Sion,452,9,7,9,16,40,52,-12,30
Young Boys,453,1,20,8,4,69,35,34,68
FC Basel,453,2,19,8,5,55,25,30,65
Lucerne,453,3,13,9,10,41,40,1,48
St Gallen,453,4,14,2,16,42,56,-14,44
FC Lugano,453,5,11,5,16,31,50,-19,38
FC Zürich,453,6,9,10,13,41,40,1,37
FC Thun,453,7,10,5,17,43,58,-15,35
Grasshoppers,453,8,9,7,16,44,51,-7,34
FC Sion,453,9,8,8,16,39,50,-11,32
Young Boys,454,1,22,7,3,72,35,37,73
FC Basel,454,2,18,7,7,53,26,27,61
St Gallen,454,3,15,2,15,42,54,-12,47
Lucerne,454,4,12,8,12,43,46,-3,44
FC Zürich,454,5,10,10,12,39,36,3,40
FC Lugano,454,6,11,5,16,31,46,-15,38
Grasshoppers,454,7,9,8,15,45,50,-5,35
FC Thun,454,8,9,7,16,43,59,-16,34
FC Sion,454,9,7,8,17,39,55,-16,29
Young Boys,455,1,22,6,4,70,36,34,72
FC Basel,455,2,18,8,6,58,28,30,62
FC Zürich,455,3,13,9,10,47,35,12,48
St Gallen,455,4,15,3,14,45,53,-8,48
Lucerne,455,5,12,8,12,45,49,-4,44
Grasshoppers,455,6,10,6,16,43,51,-8,36
FC Lugano,455,7,9,6,17,27,47,-20,33
FC Thun,455,8,9,5,18,41,64,-23,32
FC Sion,455,9,7,7,18,43,56,-13,28
Young Boys,456,1,21,7,4,71,38,33,70
FC Basel,456,2,19,7,6,63,28,35,64
Lucerne,456,3,13,9,10,42,45,-3,48
St Gallen,456,4,14,4,14,43,57,-14,46
FC Zürich,456,5,10,10,12,41,39,2,40
FC Thun,456,6,10,6,16,45,59,-14,36
FC Lugano,456,7,10,6,16,32,47,-15,36
Grasshoppers,456,8,9,8,15,42,48,-6,35
FC Sion,456,9,5,9,18,40,58,-18,24
Young Boys,457,1,23,6,3,77,34,43,75
FC Basel,457,2,19,7,6,55,27,28,64
Lucerne,457,3,15,7,10,44,40,4,52
St Gallen,457,4,13,3,16,42,58,-16,42
FC Zürich,457,5,10,9,13,40,38,2,39
FC Thun,457,6,11,5,16,48,58,-10,38
FC Lugano,457,7,11,5,16,34,51,-17,38
Grasshoppers,457,8,8,7,17,39,55,-16,31
FC Sion,457,9,5,9,18,40,58,-18,24
Young Boys,458,1,23,7,2,73,32,41,76
FC Basel,458,2,17,9,6,55,24,31,60
St Gallen,458,3,14,3,15,45,63,-18,45
Lucerne,458,4,12,8,12,45,47,-2,44
FC Zürich,458,5,9,11,12,41,42,-1,38
Grasshoppers,458,6,10,8,14,43,49,-6,38
FC Lugano,458,7,10,6,16,35,51,-16,36
FC Thun,458,8,9,7,16,45,60,-15,34
FC Sion,458,9,6,9,17,41,55,-14,27
Young Boys,459,1,20,7,5,67,34,33,67
FC Basel,459,2,19,8,5,57,25,32,65
Lucerne,459,3,14,7,11,45,47,-2,49
St Gallen,459,4,14,3,15,42,52,-10,45
FC Zürich,459,5,10,12,10,45,38,7,42
FC Lugano,459,6,10,7,15,31,49,-18,37
FC Thun,459,7,9,7,16,49,59,-10,34
Grasshoppers,459,8,8,7,17,39,52,-13,31
FC Sion,459,9,7,8,17,38,57,-19,29
Young Boys,460,1,21,9,2,70,33,37,72
FC Basel,460,2,17,9,6,55,27,28,60
Lucerne,460,3,12,11,9,41,40,1,47
St Gallen,460,4,14,3,15,44,55,-11,45
FC Zürich,460,5,11,9,12,44,38,6,42
Grasshoppers,460,6,9,9,14,41,48,-7,36
FC Lugano,460,7,9,6,17,29,50,-21,33
FC Sion,460,8,8,7,17,41,53,-12,31
FC Thun,460,9,8,7,17,43,64,-21,31
Young Boys,461,1,22,7,3,74,40,34,73
FC Basel,461,2,19,8,5,62,27,35,65
Lucerne,461,3,13,7,12,41,43,-2,46
St Gallen,461,4,14,3,15,44,54,-10,45
FC Zürich,461,5,10,10,12,41,40,1,40
FC Lugano,461,6,11,5,16,31,46,-15,38
FC Thun,461,7,10,6,16,43,58,-15,36
Grasshoppers,461,8,9,6,17,40,51,-11,33
FC Sion,461,9,6,8,18,40,57,-17,26
Young Boys,462,1,20,8,4,68,37,31,68
FC Basel,462,2,19,7,6,59,27,32,64
Lucerne,462,3,14,8,10,44,42,2,50
St Gallen,462,4,15,3,14,43,53,-10,48
FC Zürich,462,5,10,10,12,41,40,1,40
FC Lugano,462,6,10,7,15,32,48,-16,37
Grasshoppers,462,7,10,6,16,42,50,-8,36
FC Thun,462,8,8,7,17,43,60,-17,31
FC Sion,462,9,6,8,18,40,55,-15,26
Young Boys,463,1,21,7,4,70,37,33,70
FC Basel,463,2,17,8,7,52,29,23,59
St Gallen,463,3,14,4,14,43,54,-11,46
Lucerne,463,4,12,8,12,41,43,-2,44
FC Lugano,463,5,12,6,14,34,45,-11,42
Grasshoppers,463,6,10,7,15,44,50,-6,37
FC Zürich,463,7,9,9,14,38,39,-1,36
FC Sion,463,8,9,8,15,47,51,-4,35
FC Thun,463,9,9,5,18,40,61,-21,32
Young Boys,464,1,21,7,4,72,37,35,70
FC Basel,464,2,18,8,6,54,24,30,62
Lucerne,464,3,13,8,11,46,45,1,47
St Gallen,464,4,13,6,13,42,53,-11,45
FC Zürich,464,5,11,10,11,44,38,6,43
Grasshoppers,464,6,9,8,15,42,49,-7,35
FC Thun,464,7,10,5,17,43,61,-18,35
FC Lugano,464,8,9,7,16,32,54,-22,34
FC Sion,464,9,6,9,17,40,54,-14,27
Young Boys,465,1,22,6,4,73,37,36,72
FC Basel,465,2,17,8,7,53,26,27,59
Lucerne,465,3,13,9,10,42,42,0,48
St Gallen,465,4,14,3,15,45,58,-13,45
FC Zürich,465,5,11,10,11,42,36,6,43
FC Sion,465,6,10,7,15,45,51,-6,37
FC Lugano,465,7,10,6,16,34,50,-16,36
FC Thun,465,8,9,5,18,42,62,-20,32
Grasshoppers,465,9,8,6,18,39,53,-14,30
Young Boys,466,1,22,6,4,69,32,37,72
FC Basel,466,2,17,9,6,53,28,25,60
Lucerne,466,3,14,8,10,43,43,0,50
FC Zürich,466,4,12,9,11,46,33,13,45
St Gallen,466,5,13,3,16,41,58,-17,42
FC Lugano,466,6,12,5,15,34,46,-12,41
Grasshoppers,466,7,9,7,16,39,48,-9,34
FC Thun,466,8,8,7,17,44,63,-19,31
FC Sion,466,9,6,8,18,40,58,-18,26
Young Boys,467,1,21,8,3,71,36,35,71
FC Basel,467,2,19,8,5,55,21,34,65
Lucerne,467,3,13,7,12,47,44,3,46
FC Zürich,467,4,11,10,11,41,37,4,43
St Gallen,467,5,13,2,17,40,58,-18,41
FC Lugano,467,6,11,5,16,34,47,-13,38
Grasshoppers,467,7,10,7,15,41,53,-12,37
FC Thun,467,8,8,7,17,43,62,-19,31
FC Sion,467,9,6,10,16,42,56,-14,28
Young Boys,468,1,21,7,4,74,36,38,70
FC Basel,468,2,18,7,7,54,27,27,61
Lucerne,468,3,14,7,11,49,49,0,49
St Gallen,468,4,15,3,14,45,52,-7,48
FC Zürich,468,5,10,9,13,40,38,2,39
FC Lugano,468,6,10,7,15,31,51,-20,37
FC Thun,468,7,10,5,17,44,58,-14,35
FC Sion,468,8,9,7,16,39,51,-12,34
Grasshoppers,468,9,8,6,18,38,52,-14,30
Young Boys,469,1,21,7,4,69,35,34,70
FC Basel,469,2,17,9,6,51,24,27,60
Lucerne,469,3,13,8,11,41,42,-1,47
St Gallen,469,4,14,3,15,43,55,-12,45
FC Zürich,469,5,10,11,11,39,36,3,41
FC Lugano,469,6,11,6,15,35,47,-12,39
Grasshoppers,469,7,10,7,15,42,50,-8,37
FC Thun,469,8,9,7,16,43,59,-16,34
FC Sion,469,9,6,8,18,41,56,-15,26
Young Boys,470,1,20,9,3,66,33,33,69
FC Basel,470,2,18,7,7,55,29,26,61
Lucerne,470,3,14,7,11,43,40,3,49
FC Zürich,470,4,11,11,10,45,37,8,44
St Gallen,470,5,13,4,15,42,55,-13,43
FC Lugano,470,6,10,8,14,31,45,-14,38
Grasshoppers,470,7,9,7,16,38,48,-10,34
FC Thun,470,8,9,7,16,40,56,-16,34
FC Sion,470,9,5,10,17,37,54,-17,25
Young Boys,471,1,20,7,5,65,36,29,67
FC Basel,471,2,18,9,5,56,26,30,63
St Gallen,471,3,15,3,14,44,54,-10,48
Lucerne,471,4,12,8,12,39,44,-5,44
FC Zürich,471,5,10,11,11,43,40,3,41
FC Lugano,471,6,9,8,15,32,48,-16,35
Grasshoppers,471,7,9,7,16,42,49,-7,34
FC Sion,471,8,8,9,15,42,50,-8,33
FC Thun,471,9,9,6,17,45,61,-16,33
Young Boys,472,1,23,7,2,75,32,43,76
FC Basel,472,2,18,9,5,55,24,31,63
Lucerne,472,3,13,8,11,42,48,-6,47
St Gallen,472,4,14,2,16,45,56,-11,44
FC Zürich,472,5,10,10,12,38,36,2,40
FC Lugano,472,6,10,7,15,33,48,-15,37
Grasshoppers,472,7,9,6,17,43,51,-8,33
FC Thun,472,8,9,6,17,44,63,-19,33
FC Sion,472,9,7,7,18,41,58,-17,28
Young Boys,473,1,23,7,2,75,32,43,76
FC Basel,473,2,18,8,6,54,25,29,62
St Gallen,473,3,15,3,14,44,54,-10,48
Lucerne,473,4,13,8,11,41,45,-4,47
FC Zürich,473,5,11,9,12,40,36,4,42
FC Lugano,473,6,10,5,17,33,49,-16,35
FC Thun,473,7,9,7,16,42,59,-17,34
Grasshoppers,473,8,8,7,17,41,54,-13,31
FC Sion,473,9,6,8,18,41,57,-16,26
Young Boys,474,1,22,7,3,74,38,36,73
FC Basel,474,2,17,8,7,52,28,24,59
St Gallen,474,3,15,3,14,44,53,-9,48
FC Zürich,474,4,11,10,11,43,34,9,43
Lucerne,474,5,11,9,12,40,46,-6,42
Grasshoppers,474,6,11,6,15,45,49,-4,39
FC Thun,474,7,10,6,16,45,60,-15,36
FC Lugano,474,8,9,7,16,30,47,-17,34
FC Sion,474,9,6,8,18,39,57,-18,26
Young Boys,475,1,22,7,3,73,36,37,73
FC Basel,475,2,20,7,5,56,23,33,67
St Gallen,475,3,14,3,15,41,54,-13,45
Lucerne,475,4,11,7,14,37,46,-9,40
FC Zürich,475,5,9,10,13,39,42,-3,37
FC Lugano,475,6,10,7,15,33,47,-14,37
Grasshoppers,475,7,9,8,15,42,50,-8,35
FC Sion,475,8,8,9,15,43,52,-9,33
FC Thun,475,9,9,6,17,44,58,-14,33
Young Boys,476,1,23,7,2,75,32,43,76
FC Basel,476,2,17,8,7,52,24,28,59
Lucerne,476,3,13,8,11,43,47,-4,47
FC Zürich,476,4,12,10,10,44,34,10,46
St Gallen,476,5,14,2,16,41,56,-15,44
FC Thun,476,6,10,5,17,45,59,-14,35
FC Lugano,476,7,10,5,17,31,51,-20,35
Grasshoppers,476,8,8,8,16,39,51,-12,32
FC Sion,476,9,7,7,18,38,54,-16,28
Young Boys,477,1,22,7,3,79,36,43,73
FC Basel,477,2,17,8,7,55,32,23,59
St Gallen,477,3,14,3,15,43,55,-12,45
FC Zürich,477,4,11,11,10,40,34,6,44
Lucerne,477,5,12,7,13,41,48,-7,43
FC Lugano,477,6,11,5,16,30,45,-15,38
FC Thun,477,7,10,7,15,50,58,-8,37
Grasshoppers,477,8,9,7,16,42,56,-14,34
FC Sion,477,9,5,11,16,41,57,-16,26
Young Boys,478,1,20,7,5,66,33,33,67
FC Basel,478,2,19,8,5,60,26,34,65
Lucerne,478,3,13,8,11,44,44,0,47
St Gallen,478,4,14,2,16,44,60,-16,44
FC Lugano,478,5,12,6,14,35,45,-10,42
FC Zürich,478,6,10,10,12,41,41,0,40
FC Thun,478,7,11,5,16,45,58,-13,38
Grasshoppers,478,8,9,7,16,42,53,-11,34
FC Sion,478,9,5,9,18,38,55,-17,24
Young Boys,479,1,21,8,3,68,33,35,71
FC Basel,479,2,18,9,5,52,24,28,63
St Gallen,479,3,15,3,14,41,50,-9,48
Lucerne,479,4,13,8,11,43,43,0,47
FC Zürich,479,5,10,9,13,39,38,1,39
FC Thun,479,6,11,6,15,49,60,-11,39
FC Lugano,479,7,9,6,17,29,49,-20,33
Grasshoppers,479,8,8,8,16,39,49,-10,32
FC Sion,479,9,6,9,17,41,55,-14,27
Young Boys,480,1,20,8,4,68,36,32,68
FC Basel,480,2,18,8,6,52,23,29,62
Lucerne,480,3,13,9,10,44,40,4,48
St Gallen,480,4,14,5,13,42,52,-10,47
FC Zürich,480,5,12,9,11,42,35,7,45
FC Thun,480,6,10,5,17,47,61,-14,35
FC Lugano,480,7,10,5,17,31,51,-20,35
Grasshoppers,480,8,8,7,17,39,53,-14,31
FC Sion,480,9,7,8,17,39,53,-14,29
Young Boys,481,1,22,7,3,70,34,36,73
FC Basel,481,2,19,7,6,57,24,33,64
Lucerne,481,3,13,7,12,41,43,-2,46
FC Zürich,481,4,10,11,11,42,38,4,41
St Gallen,481,5,13,2,17,41,58,-17,41
FC Lugano,481,6,11,6,15,34,50,-16,39
Grasshoppers,481,7,10,7,15,40,47,-7,37
FC Thun,481,8,8,7,17,41,59,-18,31
FC Sion,481,9,6,10,16,40,53,-13,28
Young Boys,482,1,21,6,5,71,38,33,69
FC Basel,482,2,17,8,7,53,26,27,59
St Gallen,482,3,15,4,13,41,50,-9,49
FC Zürich,482,4,12,9,11,42,35,7,45
Lucerne,482,5,12,8,12,40,44,-4,44
Grasshoppers,482,6,10,7,15,41,49,-8,37
FC Thun,482,7,10,5,17,44,60,-16,35
FC Lugano,482,8,9,6,17,30,49,-19,33
FC Sion,482,9,8,7,17,42,53,-11,31
Young Boys,483,1,22,7,3,76,34,42,73
FC Basel,483,2,17,9,6,54,28,26,60
Lucerne,483,3,14,7,11,41,44,-3,49
St Gallen,483,4,14,2,16,42,56,-14,44
FC Lugano,483,5,12,5,15,35,46,-11,41
FC Zürich,483,6,10,9,13,40,39,1,39
FC Thun,483,7,10,6,16,44,58,-14,36
FC Sion,483,8,8,7,17,44,58,-14,31
Grasshoppers,483,9,8,6,18,38,51,-13,30
Young Boys,484,1,22,7,3,70,32,38,73
FC Basel,484,2,18,7,7,56,25,31,61
Lucerne,484,3,13,8,11,39,43,-4,47
St Gallen,484,4,15,2,15,44,57,-13,47
FC Zürich,484,5,12,9,11,43,36,7,45
Grasshoppers,484,6,10,6,16,40,49,-9,36
FC Lugano,484,7,10,5,17,33,49,-16,35
FC Thun,484,8,9,5,18,39,60,-21,32
FC Sion,484,9,7,7,18,41,54,-13,28
Young Boys,485,1,21,6,5,69,40,29,69
FC Basel,485,2,18,8,6,56,26,30,62
Lucerne,485,3,15,7,10,46,42,4,52
FC Zürich,485,4,12,10,10,45,34,11,46
St Gallen,485,5,14,2,16,40,55,-15,44
FC Lugano,485,6,10,5,17,31,47,-16,35
Grasshoppers,485,7,9,7,16,41,51,-10,34
FC Thun,485,8,9,5,18,43,61,-18,32
FC Sion,485,9,7,8,17,40,55,-15,29
Young Boys,486,1,22,7,3,74,36,38,73
FC Basel,486,2,18,8,6,56,24,32,62
Lucerne,486,3,13,8,11,43,44,-1,47
FC Zürich,486,4,12,10,10,41,33,8,46
St Gallen,486,5,13,3,16,42,58,-16,42
FC Lugano,486,6,11,5,16,32,50,-18,38
Grasshoppers,486,7,8,9,15,41,50,-9,33
FC Thun,486,8,8,7,17,41,60,-19,31
FC Sion,486,9,6,9,17,39,54,-15,27
Young Boys,487,1,21,8,3,70,35,35,71
FC Basel,487,2,18,8,6,58,29,29,62
St Gallen,487,3,15,3,14,44,56,-12,48
Lucerne,487,4,11,10,11,39,43,-4,43
FC Zürich,487,5,10,9,13,39,40,-1,39
FC Lugano,487,6,10,8,14,30,44,-14,38
FC Thun,487,7,10,7,15,50,57,-7,37
Grasshoppers,487,8,9,7,16,41,52,-11,34
FC Sion,487,9,6,8,18,42,57,-15,26
Young Boys,488,1,20,8,4,71,36,35,68
FC Basel,488,2,16,10,6,51,26,25,58
Lucerne,488,3,14,9,9,44,41,3,51
FC Zürich,488,4,11,9,12,41,37,4,42
St Gallen,488,5,13,3,16,41,60,-19,42
FC Thun,488,6,12,5,15,48,58,-10,41
FC Lugano,488,7,10,6,16,35,51,-16,36
FC Sion,488,8,8,7,17,42,52,-10,31
Grasshoppers,488,9,8,7,17,40,52,-12,31
Young Boys,489,1,20,8,4,69,35,34,68
FC Basel,489,2,18,8,6,52,25,27,62
St Gallen,489,3,15,3,14,44,52,-8,48
Lucerne,489,4,11,11,10,40,44,-4,44
FC Zürich,489,5,11,9,12,43,37,6,42
FC Thun,489,6,12,5,15,46,57,-11,41
FC Lugano,489,7,10,7,15,31,48,-17,37
Grasshoppers,489,8,9,8,15,43,48,-5,35
FC Sion,489,9,5,7,20,40,62,-22,22
Young Boys,490,1,22,8,2,71,33,38,74
FC Basel,490,2,17,10,5,59,30,29,61
Lucerne,490,3,13,9,10,41,40,1,48
St Gallen,490,4,15,2,15,44,56,-12,47
FC Zürich,490,5,11,11,10,47,39,8,44
FC Lugano,490,6,10,6,16,30,46,-16,36
Grasshoppers,490,7,9,7,16,41,50,-9,34
FC Thun,490,8,9,6,17,49,65,-16,33
FC Sion,490,9,5,7,20,39,62,-23,22
Young Boys,491,1,22,7,3,73,34,39,73
FC Basel,491,2,19,7,6,58,24,34,64
Lucerne,491,3,13,8,11,45,46,-1,47
FC Zürich,491,4,12,9,11,42,34,8,45
St Gallen,491,5,13,2,17,38,59,-21,41
Grasshoppers,491,6,9,8,15,40,48,-8,35
FC Lugano,491,7,10,5,17,33,53,-20,35
FC Thun,491,8,8,7,17,40,58,-18,31
FC Sion,491,9,7,9,16,39,52,-13,30
Young Boys,492,1,21,7,4,72,36,36,70
FC Basel,492,2,17,9,6,55,28,27,60
Lucerne,492,3,14,9,9,47,44,3,51
St Gallen,492,4,14,2,16,43,57,-14,44
FC Zürich,492,5,10,10,12,40,40,0,40
FC Lugano,492,6,11,7,14,35,45,-10,40
FC Thun,492,7,10,7,15,48,58,-10,37
Grasshoppers,492,8,9,6,17,40,52,-12,33
FC Sion,492,9,5,9,18,37,57,-20,24
Young Boys,493,1,22,7,3,72,35,37,73
FC Basel,493,2,18,7,7,58,27,31,61
St Gallen,493,3,15,3,14,47,57,-10,48
Lucerne,493,4,12,8,12,38,42,-4,44
FC Zürich,493,5,10,11,11,43,40,3,41
FC Lugano,493,6,10,8,14,32,46,-14,38
Grasshoppers,493,7,9,8,15,39,48,-9,35
FC Thun,493,8,10,5,17,43,60,-17,35
FC Sion,493,9,5,9,18,41,58,-17,24
Young Boys,494,1,20,8,4,68,37,31,68
FC Basel,494,2,17,8,7,52,29,23,59
St Gallen,494,3,16,2,14,46,54,-8,50
Lucerne,494,4,12,9,11,43,44,-1,45
FC Zürich,494,5,9,11,12,38,38,0,38
Grasshoppers,494,6,10,8,14,42,46,-4,38
FC Lugano,494,7,10,6,16,34,48,-14,36
FC Thun,494,8,9,7,16,42,58,-16,34
FC Sion,494,9,7,9,16,43,54,-11,30
Young Boys,495,1,23,7,2,72,33,39,76
FC Basel,495,2,16,11,5,56,29,27,59
Lucerne,495,3,12,9,11,42,43,-1,45
St Gallen,495,4,13,2,17,41,60,-19,41
FC Zürich,495,5,9,13,10,40,36,4,40
FC Lugano,495,6,11,6,15,34,47,-13,39
Grasshoppers,495,7,9,8,15,42,49,-7,35
FC Thun,495,8,9,7,16,44,60,-16,34
FC Sion,495,9,6,9,17,40,54,-14,27
Young Boys,496,1,24,6,2,79,33,46,78
FC Basel,496,2,17,8,7,55,28,27,59
St Gallen,496,3,15,3,14,46,56,-10,48
Lucerne,496,4,12,7,13,43,49,-6,43
FC Zürich,496,5,10,10,12,43,41,2,40
FC Thun,496,6,10,7,15,48,61,-13,37
FC Lugano,496,7,10,5,17,33,56,-23,35
Grasshoppers,496,8,9,6,17,43,53,-10,33
FC Sion,496,9,7,8,17,43,56,-13,29
Young Boys,497,1,24,6,2,82,37,45,78
FC Basel,497,2,17,8,7,54,26,28,59
St Gallen,497,3,15,3,14,47,57,-10,48
Lucerne,497,4,12,8,12,41,48,-7,44
FC Zürich,497,5,11,10,11,42,35,7,43
FC Thun,497,6,11,5,16,44,58,-14,38
Grasshoppers,497,7,10,6,16,46,51,-5,36
FC Lugano,497,8,10,5,17,31,49,-18,35
FC Sion,497,9,5,7,20,39,65,-26,22
Young Boys,498,1,22,7,3,68,32,36,73
FC Basel,498,2,17,8,7,51,26,25,59
Lucerne,498,3,12,9,11,41,43,-2,45
St Gallen,498,4,13,3,16,42,58,-16,42
FC Zürich,498,5,10,10,12,40,38,2,40
FC Lugano,498,6,11,7,14,37,48,-11,40
FC Thun,498,7,10,6,16,46,61,-15,36
Grasshoppers,498,8,9,6,17,41,50,-9,33
FC Sion,498,9,8,8,16,42,52,-10,32
Young Boys,499,1,21,7,4,73,35,38,70
FC Basel,499,2,17,10,5,52,25,27,61
Lucerne,499,3,14,8,10,44,43,1,50
St Gallen,499,4,14,4,14,45,55,-10,46
FC Zürich,499,5,10,11,11,41,37,4,41
Grasshoppers,499,6,9,8,15,40,48,-8,35
FC Thun,499,7,9,7,16,45,58,-13,34
FC Lugano,499,8,9,7,16,33,54,-21,34
FC Sion,499,9,6,8,18,37,55,-18,26
Young Boys,500,1,22,7,3,70,34,36,73
FC Basel,500,2,19,7,6,57,23,34,64
St Gallen,500,3,15,4,13,43,52,-9,49
Lucerne,500,4,11,10,11,40,45,-5,43
FC Zürich,500,5,11,9,12,41,37,4,42
Grasshoppers,500,6,10,7,15,43,48,-5,37
FC Thun,500,7,10,5,17,47,64,-17,35
FC Lugano,500,8,9,6,17,27,45,-18,33
FC Sion,500,9,5,9,18,38,58,-20,24
Young Boys,501,1,23,6,3,72,32,40,75
FC Basel,501,2,19,8,5,60,27,33,65
Lucerne,501,3,13,8,11,41,40,1,47
St Gallen,501,4,13,2,17,42,61,-19,41
FC Zürich,501,5,10,10,12,40,36,4,40
FC Lugano,501,6,11,5,16,30,47,-17,38
Grasshoppers,501,7,9,7,16,41,53,-12,34
FC Thun,501,8,9,5,18,46,65,-19,32
FC Sion,501,9,8,7,17,44,55,-11,31
Young Boys,502,1,22,6,4,68,37,31,72
FC Basel,502,2,18,9,5,58,26,32,63
St Gallen,502,3,13,5,14,42,54,-12,44
FC Zürich,502,4,10,11,11,41,37,4,41
Lucerne,502,5,11,8,13,40,47,-7,41
FC Lugano,502,6,11,5,16,30,46,-16,38
Grasshoppers,502,7,9,8,15,41,48,-7,35
FC Thun,502,8,9,6,17,43,59,-16,33
FC Sion,502,9,7,10,15,43,52,-9,31
Young Boys,503,1,21,7,4,72,35,37,70
FC Basel,503,2,19,8,5,58,24,34,65
Lucerne,503,3,12,9,11,42,47,-5,45
St Gallen,503,4,13,4,15,41,57,-16,43
FC Lugano,503,5,11,6,15,31,44,-13,39
FC Zürich,503,6,9,10,13,38,37,1,37
FC Thun,503,7,10,5,17,42,60,-18,35
Grasshoppers,503,8,9,7,16,42,53,-11,34
FC Sion,503,9,8,8,16,43,52,-9,32
Young Boys,504,1,24,6,2,77,31,46,78
FC Basel,504,2,17,7,8,51,29,22,58
St Gallen,504,3,15,3,14,45,55,-10,48
Lucerne,504,4,13,7,12,40,46,-6,46
FC Zürich,504,5,10,9,13,39,39,0,39
FC Lugano,504,6,10,6,16,32,48,-16,36
FC Thun,504,7,10,5,17,44,58,-14,35
FC Sion,504,8,9,7,16,44,51,-7,34
Grasshoppers,504,9,8,6,18,37,52,-15,30
Young Boys,505,1,21,7,4,67,32,35,70
FC Basel,505,2,17,8,7,54,27,27,59
Lucerne,505,3,12,10,10,43,44,-1,46
St Gallen,505,4,14,4,14,43,54,-11,46
FC Zürich,505,5,11,10,11,42,37,5,43
Grasshoppers,505,6,10,7,15,43,50,-7,37
FC Thun,505,7,10,6,16,44,61,-17,36
FC Lugano,505,8,10,5,17,31,48,-17,35
FC Sion,505,9,6,9,17,41,55,-14,27
Young Boys,506,1,20,9,3,71,38,33,69
FC Basel,506,2,17,9,6,50,27,23,60
Lucerne,506,3,14,8,10,46,41,5,50
FC Zürich,506,4,11,10,11,42,37,5,43
St Gallen,506,5,13,4,15,39,55,-16,43
Grasshoppers,506,6,10,7,15,45,51,-6,37
FC Lugano,506,7,10,6,16,34,49,-15,36
FC Thun,506,8,9,6,17,44,62,-18,33
FC Sion,506,9,7,7,18,44,55,-11,28
Young Boys,507,1,21,8,3,69,37,32,71
FC Basel,507,2,19,7,6,57,25,32,64
St Gallen,507,3,15,2,15,44,56,-12,47
Lucerne,507,4,12,8,12,43,47,-4,44
FC Zürich,507,5,10,9,13,41,42,-1,39
FC Lugano,507,6,10,6,16,31,46,-15,36
Grasshoppers,507,7,9,8,15,44,49,-5,35
FC Thun,507,8,9,7,16,41,55,-14,34
FC Sion,507,9,7,9,16,42,55,-13,30
Young Boys,508,1,21,7,4,71,36,35,70
FC Basel,508,2,17,9,6,58,28,30,60
St Gallen,508,3,15,2,15,44,54,-10,47
Lucerne,508,4,12,9,11,42,46,-4,45
FC Zürich,508,5,10,11,11,44,40,4,41
Grasshoppers,508,6,11,7,14,41,46,-5,40
FC Lugano,508,7,10,6,16,34,50,-16,36
FC Thun,508,8,10,5,17,50,64,-14,35
FC Sion,508,9,6,8,18,38,58,-20,26
Young Boys,509,1,21,7,4,72,37,35,70
FC Basel,509,2,18,8,6,54,24,30,62
Lucerne,509,3,13,7,12,41,45,-4,46
St Gallen,509,4,14,2,16,42,58,-16,44
FC Zürich,509,5,10,11,11,38,34,4,41
FC Lugano,509,6,11,6,15,34,49,-15,39
FC Thun,509,7,10,6,16,44,55,-11,36
Grasshoppers,509,8,9,6,17,38,49,-11,33
FC Sion,509,9,8,7,17,41,53,-12,31
Young Boys,510,1,21,8,3,70,34,36,71
FC Basel,510,2,18,7,7,57,25,32,61
Lucerne,510,3,12,8,12,41,46,-5,44
St Gallen,510,4,13,3,16,43,58,-15,42
FC Zürich,510,5,10,11,11,40,39,1,41
FC Thun,510,6,11,5,16,47,62,-15,38
Grasshoppers,510,7,10,7,15,43,49,-6,37
FC Lugano,510,8,9,9,14,30,45,-15,36
FC Sion,510,9,7,8,17,42,55,-13,29
Young Boys,511,1,23,7,2,75,29,46,76
FC Basel,511,2,16,9,7,50,26,24,57
St Gallen,511,3,15,3,14,45,55,-10,48
Lucerne,511,4,12,9,11,45,46,-1,45
FC Zürich,511,5,11,11,10,44,38,6,44
FC Thun,511,6,11,6,15,50,57,-7,39
FC Lugano,511,7,9,6,17,30,53,-23,33
Grasshoppers,511,8,8,6,18,39,57,-18,30
FC Sion,511,9,6,9,17,41,58,-17,27
Young Boys,512,1,22,6,4,73,39,34,72
FC Basel,512,2,18,8,6,54,25,29,62
St Gallen,512,3,14,3,15,40,53,-13,45
Lucerne,512,4,12,8,12,43,46,-3,44
FC Zürich,512,5,10,10,12,39,40,-1,40
FC Lugano,512,6,11,6,15,34,45,-11,39
Grasshoppers,512,7,10,6,16,42,52,-10,36
FC Sion,512,8,9,7,16,43,49,-6,34
FC Thun,512,9,8,6,18,41,60,-19,30
Young Boys,513,1,24,6,2,77,35,42,78
FC Basel,513,2,18,7,7,58,27,31,61
Lucerne,513,3,13,7,12,45,46,-1,46
FC Zürich,513,4,11,10,11,42,37,5,43
St Gallen,513,5,13,3,16,41,58,-17,42
FC Lugano,513,6,11,6,15,33,48,-15,39
FC Thun,513,7,9,6,17,44,62,-18,33
Grasshoppers,513,8,8,8,16,40,51,-11,32
FC Sion,513,9,6,9,17,38,54,-16,27
Young Boys,514,1,21,9,2,72,35,37,72
FC Basel,514,2,16,8,8,53,31,22,56
St Gallen,514,3,16,3,13,44,52,-8,51
Lucerne,514,4,13,8,11,41,41,0,47
FC Zürich,514,5,11,11,10,44,36,8,44
Grasshoppers,514,6,9,8,15,41,50,-9,35
FC Thun,514,7,9,7,16,46,61,-15,34
FC Lugano,514,8,9,7,16,31,48,-17,34
FC Sion,514,9,5,9,18,38,56,-18,24
Young Boys,515,1,21,8,3,71,32,39,71
FC Basel,515,2,18,7,7,56,27,29,61
Lucerne,515,3,14,9,9,47,45,2,51
FC Zürich,515,4,12,9,11,43,37,6,45
St Gallen,515,5,13,2,17,44,61,-17,41
FC Lugano,515,6,11,7,14,35,46,-11,40
Grasshoppers,515,7,9,6,17,40,53,-13,33
FC Thun,515,8,9,5,18,41,61,-20,32
FC Sion,515,9,7,7,18,39,54,-15,28
Young Boys,516,1,24,6,2,75,31,44,78
FC Basel,516,2,19,7,6,58,24,34,64
St Gallen,516,3,15,3,14,45,55,-10,48
FC Zürich,516,4,11,10,11,42,38,4,43
Lucerne,516,5,11,7,14,42,53,-11,40
Grasshoppers,516,6,9,8,15,44,52,-8,35
FC Lugano,516,7,10,5,17,34,53,-19,35
FC Thun,516,8,8,7,17,44,61,-17,31
FC Sion,516,9,6,9,17,40,57,-17,27
Young Boys,517,1,22,8,2,69,31,38,74
FC Basel,517,2,18,8,6,53,24,29,62
FC Zürich,517,3,11,10,11,43,39,4,43
Lucerne,517,4,11,10,11,41,45,-4,43
St Gallen,517,5,13,4,15,42,56,-14,43
Grasshoppers,517,6,10,7,15,42,47,-5,37
FC Lugano,517,7,9,8,15,31,49,-18,35
FC Thun,517,8,9,6,17,47,60,-13,33
FC Sion,517,9,6,9,17,40,57,-17,27
Young Boys,518,1,20,9,3,70,38,32,69
FC Basel,518,2,18,7,7,55,24,31,61
Lucerne,518,3,13,10,9,46,42,4,49
FC Zürich,518,4,12,9,11,41,34,7,45
St Gallen,518,5,14,3,15,42,59,-17,45
FC Thun,518,6,11,5,16,46,61,-15,38
Grasshoppers,518,7,9,8,15,43,51,-8,35
FC Lugano,518,8,9,5,18,31,53,-22,32
FC Sion,518,9,6,8,18,42,54,-12,26
Young Boys,519,1,21,7,4,69,35,34,70
FC Basel,519,2,20,7,5,61,27,34,67
Lucerne,519,3,14,7,11,43,44,-1,49
St Gallen,519,4,15,2,15,44,54,-10,47
FC Zürich,519,5,11,10,11,41,37,4,43
FC Thun,519,6,10,6,16,52,60,-8,36
Grasshoppers,519,7,10,6,16,42,55,-13,36
FC Lugano,519,8,9,5,18,28,48,-20,32
FC Sion,519,9,5,8,19,36,56,-20,23
Young Boys,520,1,22,7,3,73,33,40,73
FC Basel,520,2,19,8,5,57,23,34,65
Lucerne,520,3,13,8,11,43,43,0,47
St Gallen,520,4,14,4,14,42,54,-12,46
FC Zürich,520,5,9,12,11,39,37,2,39
Grasshoppers,520,6,10,7,15,42,49,-7,37
FC Lugano,520,7,9,7,16,30,50,-20,34
FC Thun,520,8,8,8,16,42,59,-17,32
FC Sion,520,9,5,9,18,38,58,-20,24
Young Boys,521,1,20,8,4,68,34,34,68
FC Basel,521,2,19,8,5,54,23,31,65
Lucerne,521,3,13,7,12,42,48,-6,46
FC Zürich,521,4,11,11,10,45,36,9,44
St Gallen,521,5,14,2,16,44,55,-11,44
Grasshoppers,521,6,10,7,15,42,50,-8,37
FC Thun,521,7,10,6,16,48,58,-10,36
FC Lugano,521,8,9,6,17,29,51,-22,33
FC Sion,521,9,7,7,18,41,58,-17,28
Young Boys,522,1,22,7,3,72,38,34,73
FC Basel,522,2,18,9,5,58,24,34,63
Lucerne,522,3,12,10,10,41,42,-1,46
St Gallen,522,4,14,4,14,41,55,-14,46
FC Zürich,522,5,11,9,12,41,37,4,42
Grasshoppers,522,6,9,8,15,42,50,-8,35
FC Lugano,522,7,10,5,17,32,46,-14,35
FC Thun,522,8,9,6,17,44,63,-19,33
FC Sion,522,9,6,8,18,41,57,-16,26
Young Boys,523,1,21,8,3,72,35,37,71
FC Basel,523,2,18,8,6,57,26,31,62
Lucerne,523,3,13,10,9,43,41,2,49
St Gallen,523,4,13,4,15,43,57,-14,43
FC Zürich,523,5,10,9,13,41,40,1,39
FC Lugano,523,6,11,5,16,32,49,-17,38
FC Thun,523,7,10,6,16,47,62,-15,36
Grasshoppers,523,8,8,8,16,40,52,-12,32
FC Sion,523,9,7,8,17,42,55,-13,29
Young Boys,524,1,23,6,3,71,31,40,75
FC Basel,524,2,19,8,5,58,23,35,65
Lucerne,524,3,13,8,11,44,46,-2,47
St Gallen,524,4,14,4,14,45,54,-9,46
FC Zürich,524,5,10,9,13,39,44,-5,39
FC Thun,524,6,11,5,16,45,58,-13,38
FC Lugano,524,7,10,6,16,33,48,-15,36
Grasshoppers,524,8,9,7,16,43,50,-7,34
FC Sion,524,9,5,7,20,38,62,-24,22
Young Boys,525,1,22,6,4,73,35,38,72
FC Basel,525,2,17,8,7,56,29,27,59
Lucerne,525,3,14,7,11,43,43,0,49
FC Zürich,525,4,12,10,10,41,34,7,46
St Gallen,525,5,14,2,16,41,57,-16,44
FC Thun,525,6,11,5,16,45,58,-13,38
Grasshoppers,525,7,10,6,16,46,54,-8,36
FC Lugano,525,8,10,5,17,29,48,-19,35
FC Sion,525,9,6,7,19,38,54,-16,25
Young Boys,526,1,21,7,4,74,37,37,70
FC Basel,526,2,18,9,5,54,26,28,63
St Gallen,526,3,13,4,15,44,58,-14,43
Lucerne,526,4,11,9,12,39,45,-6,42
FC Zürich,526,5,10,11,11,38,34,4,41
Grasshoppers,526,6,10,7,15,43,50,-7,37
FC Lugano,526,7,10,6,16,31,50,-19,36
FC Sion,526,8,8,9,15,46,54,-8,33
FC Thun,526,9,9,6,17,44,59,-15,33
Young Boys,527,1,22,8,2,73,32,41,74
FC Basel,527,2,18,9,5,56,24,32,63
Lucerne,527,3,13,9,10,46,44,2,48
St Gallen,527,4,13,3,16,38,57,-19,42
FC Zürich,527,5,9,11,12,38,37,1,38
FC Lugano,527,6,10,6,16,29,49,-20,36
FC Thun,527,7,10,5,17,42,58,-16,35
Grasshoppers,527,8,9,7,16,42,52,-10,34
FC Sion,527,9,7,8,17,41,52,-11,29
Young Boys,528,1,21,9,2,72,34,38,72
FC Basel,528,2,18,7,7,50,24,26,61
Lucerne,528,3,13,8,11,43,44,-1,47
FC Zürich,528,4,12,9,11,44,35,9,45
St Gallen,528,5,14,3,15,43,57,-14,45
FC Lugano,528,6,10,6,16,31,48,-17,36
FC Thun,528,7,10,5,17,45,61,-16,35
Grasshoppers,528,8,9,7,16,42,52,-10,34
FC Sion,528,9,6,8,18,41,56,-15,26
Young Boys,529,1,22,7,3,74,37,37,73
FC Basel,529,2,19,7,6,52,23,29,64
St Gallen,529,3,16,2,14,43,54,-11,50
Lucerne,529,4,13,7,12,45,45,0,46
FC Zürich,529,5,12,9,11,47,35,12,45
Grasshoppers,529,6,10,6,16,42,52,-10,36
FC Lugano,529,7,10,5,17,29,47,-18,35
FC Thun,529,8,9,5,18,42,62,-20,32
FC Sion,529,9,5,8,19,40,59,-19,23
Young Boys,530,1,22,7,3,75,34,41,73
FC Basel,530,2,18,8,6,56,27,29,62
Lucerne,530,3,14,7,11,41,45,-4,49
St Gallen,530,4,14,2,16,43,56,-13,44
FC Zürich,530,5,11,10,11,45,38,7,43
FC Lugano,530,6,11,5,16,31,49,-18,38
Grasshoppers,530,7,10,6,16,41,50,-9,36
FC Thun,530,8,10,5,17,47,62,-15,35
FC Sion,530,9,5,8,19,41,59,-18,23
Young Boys,531,1,21,7,4,71,35,36,70
FC Basel,531,2,17,8,7,56,29,27,59
FC Zürich,531,3,12,9,11,42,35,7,45
Lucerne,531,4,12,9,11,43,45,-2,45
St Gallen,531,5,14,3,15,44,58,-14,45
FC Thun,531,6,11,5,16,42,55,-13,38
Grasshoppers,531,7,10,6,16,43,50,-7,36
FC Lugano,531,8,10,6,16,32,48,-16,36
FC Sion,531,9,7,7,18,40,58,-18,28
Young Boys,532,1,22,8,2,77,34,43,74
FC Basel,532,2,18,8,6,58,27,31,62
FC Zürich,532,3,13,9,10,48,36,12,48
St Gallen,532,4,15,2,15,47,55,-8,47
Lucerne,532,5,12,7,13,44,53,-9,43
Grasshoppers,532,6,9,8,15,44,55,-11,35
FC Lugano,532,7,9,6,17,28,49,-21,33
FC Thun,532,8,8,6,18,42,63,-21,30
FC Sion,532,9,7,8,17,42,58,-16,29
Young Boys,533,1,23,6,3,75,37,38,75
FC Basel,533,2,19,8,5,57,24,33,65
St Gallen,533,3,15,2,15,46,53,-7,47
Lucerne,533,4,12,8,12,41,47,-6,44
Grasshoppers,533,5,11,6,15,44,48,-4,39
FC Lugano,533,6,11,5,16,34,49,-15,38
FC Zürich,533,7,9,10,13,40,42,-2,37
FC Thun,533,8,10,5,17,44,59,-15,35
FC Sion,533,9,5,8,19,39,61,-22,23
Young Boys,534,1,21,7,4,73,36,37,70
FC Basel,534,2,17,8,7,54,27,27,59
Lucerne,534,3,13,8,11,42,41,1,47
St Gallen,534,4,15,2,15,42,52,-10,47
FC Zürich,534,5,11,11,10,45,36,9,44
FC Lugano,534,6,10,7,15,31,50,-19,37
FC Thun,534,7,10,6,16,45,62,-17,36
Grasshoppers,534,8,9,6,17,44,54,-10,33
FC Sion,534,9,7,7,18,37,55,-18,28
Young Boys,535,1,22,7,3,72,33,39,73
FC Basel,535,2,18,8,6,52,24,28,62
Lucerne,535,3,13,8,11,42,46,-4,47
St Gallen,535,4,14,3,15,43,54,-11,45
FC Zürich,535,5,9,11,12,40,39,1,38
FC Lugano,535,6,10,8,14,34,48,-14,38
FC Thun,535,7,9,6,17,43,60,-17,33
FC Sion,535,8,8,8,16,43,51,-8,32
Grasshoppers,535,9,8,7,17,39,53,-14,31
Young Boys,536,1,20,7,5,71,39,32,67
FC Basel,536,2,18,9,5,58,28,30,63
FC Zürich,536,3,11,11,10,43,37,6,44
St Gallen,536,4,13,4,15,43,59,-16,43
Lucerne,536,5,11,9,12,43,51,-8,42
FC Lugano,536,6,11,6,15,34,44,-10,39
FC Thun,536,7,10,5,17,44,56,-12,35
Grasshoppers,536,8,9,7,16,40,51,-11,34
FC Sion,536,9,8,8,16,44,55,-11,32
Young Boys,537,1,21,7,4,71,39,32,70
FC Basel,537,2,18,9,5,57,24,33,63
Lucerne,537,3,13,9,10,43,43,0,48
St Gallen,537,4,15,3,14,46,55,-9,48
FC Zürich,537,5,9,12,11,40,37,3,39
FC Lugano,537,6,11,6,15,33,48,-15,39
FC Thun,537,7,9,7,16,43,60,-17,34
Grasshoppers,537,8,8,7,17,38,50,-12,31
FC Sion,537,9,5,10,17,38,53,-15,25
Young Boys,538,1,22,7,3,75,35,40,73
FC Basel,538,2,18,8,6,58,25,33,62
Lucerne,538,3,14,7,11,51,46,5,49
FC Zürich,538,4,12,10,10,44,34,10,46
St Gallen,538,5,13,3,16,41,58,-17,42
FC Lugano,538,6,11,5,16,32,54,-22,38
Grasshoppers,538,7,9,7,16,38,51,-13,34
FC Thun,538,8,8,7,17,39,59,-20,31
FC Sion,538,9,6,8,18,38,54,-16,26
Young Boys,539,1,22,6,4,73,38,35,72
FC Basel,539,2,19,8,5,57,27,30,65
Lucerne,539,3,12,8,12,41,45,-4,44
FC Zürich,539,4,11,10,11,45,40,5,43
St Gallen,539,5,13,4,15,41,54,-13,43
Grasshoppers,539,6,10,6,16,44,53,-9,36
FC Lugano,539,7,10,5,17,32,49,-17,35
FC Thun,539,8,9,6,17,47,62,-15,33
FC Sion,539,9,7,9,16,43,55,-12,30
Young Boys,540,1,21,7,4,73,36,37,70
FC Basel,540,2,18,8,6,57,25,32,62
Lucerne,540,3,13,8,11,46,48,-2,47
St Gallen,540,4,15,2,15,46,57,-11,47
FC Zürich,540,5,10,11,11,40,37,3,41
Grasshoppers,540,6,10,6,16,42,51,-9,36
FC Thun,540,7,10,6,16,44,60,-16,36
FC Lugano,540,8,9,6,17,31,52,-21,33
FC Sion,540,9,6,10,16,41,54,-13,28
Young Boys,541,1,21,6,5,72,38,34,69
FC Basel,541,2,18,7,7,55,29,26,61
Lucerne,541,3,14,7,11,47,45,2,49
St Gallen,541,4,15,4,13,46,53,-7,49
FC Zürich,541,5,10,11,11,43,37,6,41
FC Thun,541,6,9,7,16,45,58,-13,34
Grasshoppers,541,7,9,6,17,42,56,-14,33
FC Lugano,541,8,9,6,17,27,50,-23,33
FC Sion,541,9,7,10,15,45,56,-11,31
Young Boys,542,1,19,9,4,66,34,32,66
FC Basel,542,2,18,9,5,56,25,31,63
St Gallen,542,3,15,4,13,46,53,-7,49
Lucerne,542,4,12,10,10,44,43,1,46
FC Zürich,542,5,10,10,12,40,36,4,40
Grasshoppers,542,6,10,8,14,42,48,-6,38
FC Lugano,542,7,11,5,16,34,51,-17,38
FC Thun,542,8,8,7,17,42,63,-21,31
FC Sion,542,9,5,10,17,37,54,-17,25
Young Boys,543,1,20,8,4,73,36,37,68
FC Basel,543,2,20,7,5,60,25,35,67
St Gallen,543,3,14,3,15,42,58,-16,45
FC Zürich,543,4,11,10,11,43,39,4,43
Lucerne,543,5,11,9,12,40,44,-4,42
Grasshoppers,543,6,10,7,15,38,47,-9,37
FC Lugano,543,7,10,6,16,30,49,-19,36
FC Thun,543,8,8,7,17,41,60,-19,31
FC Sion,543,9,7,9,16,44,53,-9,30
Young Boys,544,1,21,6,5,67,36,31,69
FC Basel,544,2,19,8,5,52,22,30,65
St Gallen,544,3,14,3,15,44,56,-12,45
Lucerne,544,4,12,7,13,41,45,-4,43
FC Zürich,544,5,10,12,10,40,35,5,42
Grasshoppers,544,6,11,7,14,42,45,-3,40
FC Lugano,544,7,10,6,16,33,50,-17,36
FC Thun,544,8,8,7,17,41,58,-17,31
FC Sion,544,9,6,10,16,43,56,-13,28
Young Boys,545,1,22,8,2,71,33,38,74
FC Basel,545,2,18,9,5,55,26,29,63
Lucerne,545,3,12,10,10,43,44,-1,46
FC Zürich,545,4,10,12,10,39,33,6,42
St Gallen,545,5,13,3,16,42,56,-14,42
FC Lugano,545,6,10,7,15,31,46,-15,37
FC Thun,545,7,10,6,16,45,58,-13,36
Grasshoppers,545,8,9,6,17,41,52,-11,33
FC Sion,545,9,6,7,19,38,57,-19,25
Young Boys,546,1,21,6,5,74,37,37,69
FC Basel,546,2,17,8,7,52,28,24,59
St Gallen,546,3,16,2,14,47,55,-8,50
Grasshoppers,546,4,12,6,14,47,48,-1,42
Lucerne,546,5,11,8,13,39,47,-8,41
FC Zürich,546,6,10,10,12,39,38,1,40
FC Lugano,546,7,11,6,15,35,50,-15,39
FC Thun,546,8,11,5,16,51,58,-7,38
FC Sion,546,9,6,7,19,40,63,-23,25
Young Boys,547,1,21,8,3,74,37,37,71
FC Basel,547,2,17,9,6,54,26,28,60
St Gallen,547,3,15,3,14,44,55,-11,48
FC Zürich,547,4,12,9,11,50,36,14,45
Lucerne,547,5,12,8,12,41,48,-7,44
Grasshoppers,547,6,10,7,15,42,50,-8,37
FC Thun,547,7,9,6,17,45,64,-19,33
FC Lugano,547,8,9,6,17,29,48,-19,33
FC Sion,547,9,7,8,17,44,59,-15,29
Young Boys,548,1,21,8,3,71,32,39,71
FC Basel,548,2,17,9,6,54,26,28,60
Lucerne,548,3,13,10,9,42,41,1,49
St Gallen,548,4,14,5,13,46,55,-9,47
FC Zürich,548,5,11,9,12,41,38,3,42
Grasshoppers,548,6,9,9,14,41,47,-6,36
FC Thun,548,7,9,6,17,42,60,-18,33
FC Lugano,548,8,9,5,18,29,53,-24,32
FC Sion,548,9,6,9,17,41,55,-14,27
Young Boys,549,1,22,7,3,75,36,39,73
FC Basel,549,2,17,8,7,53,26,27,59
Lucerne,549,3,13,8,11,45,48,-3,47
St Gallen,549,4,14,4,14,45,54,-9,46
FC Zürich,549,5,11,10,11,42,36,6,43
FC Sion,549,6,9,7,16,43,53,-10,34
FC Lugano,549,7,9,7,16,33,52,-19,34
Grasshoppers,549,8,9,6,17,40,52,-12,33
FC Thun,549,9,9,5,18,43,62,-19,32
Young Boys,550,1,21,8,3,68,35,33,71
FC Basel,550,2,17,7,8,56,29,27,58
St Gallen,550,3,16,3,13,47,51,-4,51
Lucerne,550,4,14,7,11,45,42,3,49
FC Zürich,550,5,10,11,11,41,38,3,41
Grasshoppers,550,6,10,6,16,45,53,-8,36
FC Lugano,550,7,9,8,15,27,44,-17,35
FC Thun,550,8,8,6,18,45,68,-23,30
FC Sion,550,9,7,8,17,42,56,-14,29
Young Boys,551,1,21,7,4,75,44,31,70
FC Basel,551,2,19,8,5,64,28,36,65
St Gallen,551,3,15,3,14,44,53,-9,48
FC Zürich,551,4,11,10,11,41,38,3,43
Lucerne,551,5,11,10,11,39,42,-3,43
Grasshoppers,551,6,10,8,14,46,51,-5,38
FC Lugano,551,7,9,7,16,28,45,-17,34
FC Thun,551,8,9,5,18,44,63,-19,32
FC Sion,551,9,5,10,17,41,58,-17,25
Young Boys,552,1,22,6,4,71,33,38,72
FC Basel,552,2,19,8,5,52,22,30,65
FC Zürich,552,3,12,10,10,43,35,8,46
St Gallen,552,4,14,3,15,43,56,-13,45
Lucerne,552,5,11,9,12,42,48,-6,42
FC Lugano,552,6,10,6,16,30,46,-16,36
Grasshoppers,552,7,9,7,16,42,55,-13,34
FC Thun,552,8,9,6,17,43,60,-17,33
FC Sion,552,9,7,7,18,44,55,-11,28
Young Boys,553,1,22,6,4,72,36,36,72
FC Basel,553,2,19,7,6,57,24,33,64
St Gallen,553,3,16,2,14,47,54,-7,50
FC Lugano,553,4,12,5,15,38,49,-11,41
Lucerne,553,5,11,7,14,38,47,-9,40
FC Zürich,553,6,9,10,13,38,40,-2,37
Grasshoppers,553,7,10,6,16,40,48,-8,36
FC Thun,553,8,10,6,16,44,59,-15,36
FC Sion,553,9,7,7,18,38,55,-17,28
Young Boys,554,1,21,9,2,74,38,36,72
FC Basel,554,2,18,7,7,59,29,30,61
St Gallen,554,3,15,2,15,43,56,-13,47
FC Zürich,554,4,11,10,11,44,37,7,43
Lucerne,554,5,11,10,11,43,47,-4,43
FC Lugano,554,6,11,7,14,31,44,-13,40
Grasshoppers,554,7,9,9,14,44,51,-7,36
FC Thun,554,8,8,7,17,44,62,-18,31
FC Sion,554,9,6,7,19,39,57,-18,25
Young Boys,555,1,21,6,5,73,40,33,69
FC Basel,555,2,19,7,6,58,27,31,64
St Gallen,555,3,15,2,15,43,56,-13,47
Lucerne,555,4,13,7,12,43,46,-3,46
FC Zürich,555,5,12,9,11,43,34,9,45
Grasshoppers,555,6,11,6,15,43,49,-6,39
FC Thun,555,7,10,5,17,45,58,-13,35
FC Lugano,555,8,10,5,17,30,50,-20,35
FC Sion,555,9,6,7,19,39,57,-18,25
Young Boys,556,1,21,7,4,66,32,34,70
FC Basel,556,2,18,8,6,52,26,26,62
Lucerne,556,3,13,8,11,48,47,1,47
St Gallen,556,4,15,2,15,45,61,-16,47
FC Zürich,556,5,11,10,11,40,35,5,43
FC Lugano,556,6,11,6,15,37,47,-10,39
FC Thun,556,7,9,7,16,44,58,-14,34
Grasshoppers,556,8,8,8,16,39,49,-10,32
FC Sion,556,9,5,10,17,38,54,-16,25
Young Boys,557,1,22,7,3,72,35,37,73
FC Basel,557,2,16,9,7,54,28,26,57
Lucerne,557,3,12,11,9,44,43,1,47
St Gallen,557,4,13,4,15,45,61,-16,43
FC Thun,557,5,11,5,16,45,58,-13,38
FC Zürich,557,6,9,10,13,37,39,-2,37
Grasshoppers,557,7,10,7,15,44,48,-4,37
FC Lugano,557,8,10,7,15,33,50,-17,37
FC Sion,557,9,7,8,17,44,56,-12,29
Young Boys,558,1,23,6,3,72,33,39,75
FC Basel,558,2,18,7,7,52,24,28,61
St Gallen,558,3,16,3,13,46,52,-6,51
FC Zürich,558,4,11,9,12,42,38,4,42
Lucerne,558,5,11,8,13,37,44,-7,41
Grasshoppers,558,6,11,6,15,47,50,-3,39
FC Thun,558,7,11,5,16,46,58,-12,38
FC Lugano,558,8,10,5,17,28,48,-20,35
FC Sion,558,9,5,7,20,38,61,-23,22
Young Boys,559,1,21,7,4,72,35,37,70
FC Basel,559,2,16,8,8,51,27,24,56
St Gallen,559,3,15,2,15,44,55,-11,47
Lucerne,559,4,12,7,13,38,46,-8,43
FC Lugano,559,5,12,6,14,34,46,-12,42
FC Zürich,559,6,9,12,11,38,35,3,39
FC Thun,559,7,11,5,16,45,59,-14,38
Grasshoppers,559,8,10,7,15,41,48,-7,37
FC Sion,559,9,6,10,16,40,52,-12,28
Young Boys,560,1,21,8,3,72,35,37,71
FC Basel,560,2,16,9,7,53,27,26,57
St Gallen,560,3,15,3,14,46,55,-9,48
Lucerne,560,4,11,9,12,39,46,-7,42
FC Zürich,560,5,10,11,11,44,38,6,41
FC Lugano,560,6,11,7,14,34,47,-13,40
FC Thun,560,7,11,6,15,46,57,-11,39
Grasshoppers,560,8,10,7,15,42,48,-6,37
FC Sion,560,9,5,8,19,37,60,-23,23
Young Boys,561,1,22,7,3,74,37,37,73
FC Basel,561,2,19,7,6,60,23,37,64
St Gallen,561,3,16,2,14,45,54,-9,50
Lucerne,561,4,12,8,12,46,48,-2,44
FC Zürich,561,5,11,10,11,40,35,5,43
FC Lugano,561,6,10,5,17,31,53,-22,35
Grasshoppers,561,7,8,9,15,40,50,-10,33
FC Thun,561,8,8,7,17,41,62,-21,31
FC Sion,561,9,6,9,17,40,55,-15,27
Young Boys,562,1,22,7,3,75,32,43,73
FC Basel,562,2,17,9,6,49,23,26,60
Lucerne,562,3,13,8,11,40,42,-2,47
St Gallen,562,4,14,3,15,44,56,-12,45
FC Zürich,562,5,11,9,12,43,37,6,42
Grasshoppers,562,6,11,6,15,44,48,-4,39
FC Lugano,562,7,11,5,16,33,50,-17,38
FC Thun,562,8,10,5,17,43,57,-14,35
FC Sion,562,9,5,8,19,38,64,-26,23
Young Boys,563,1,23,6,3,80,37,43,75
FC Basel,563,2,18,8,6,56,26,30,62
FC Zürich,563,3,12,10,10,43,35,8,46
St Gallen,563,4,14,3,15,41,53,-12,45
Lucerne,563,5,12,8,12,41,45,-4,44
Grasshoppers,563,6,11,6,15,42,50,-8,39
FC Lugano,563,7,10,5,17,30,51,-21,35
FC Thun,563,8,8,6,18,42,63,-21,30
FC Sion,563,9,6,8,18,40,55,-15,26
Young Boys,564,1,23,6,3,76,31,45,75
FC Basel,564,2,18,8,6,55,27,28,62
Lucerne,564,3,13,8,11,45,47,-2,47
St Gallen,564,4,13,6,13,43,54,-11,45
FC Zürich,564,5,11,9,12,46,38,8,42
FC Thun,564,6,11,6,15,45,56,-11,39
FC Lugano,564,7,9,6,17,28,52,-24,33
Grasshoppers,564,8,8,6,18,39,53,-14,30
FC Sion,564,9,6,9,17,41,60,-19,27
Young Boys,565,1,22,7,3,74,36,38,73
FC Basel,565,2,18,9,5,56,23,33,63
Lucerne,565,3,13,7,12,42,49,-7,46
St Gallen,565,4,14,3,15,43,55,-12,45
FC Zürich,565,5,10,9,13,41,41,0,39
Grasshoppers,565,6,10,7,15,48,51,-3,37
FC Thun,565,7,10,6,16,43,58,-15,36
FC Lugano,565,8,10,5,17,31,50,-19,35
FC Sion,565,9,7,7,18,41,56,-15,28
Young Boys,566,1,21,7,4,68,35,33,70
FC Basel,566,2,19,7,6,55,25,30,64
Lucerne,566,3,13,8,11,43,44,-1,47
St Gallen,566,4,14,2,16,43,57,-14,44
Grasshoppers,566,5,11,6,15,42,48,-6,39
FC Zürich,566,6,9,11,12,40,39,1,38
FC Lugano,566,7,10,7,15,31,46,-15,37
FC Thun,566,8,9,6,17,44,60,-16,33
FC Sion,566,9,6,10,16,44,56,-12,28
Young Boys,567,1,22,8,2,76,33,43,74
FC Basel,567,2,17,8,7,55,31,24,59
Lucerne,567,3,14,7,11,47,45,2,49
St Gallen,567,4,14,3,15,44,58,-14,45
FC Zürich,567,5,10,9,13,41,39,2,39
Grasshoppers,567,6,10,7,15,42,48,-6,37
FC Lugano,567,7,10,6,16,31,51,-20,36
FC Thun,567,8,9,5,18,41,59,-18,32
FC Sion,567,9,8,7,17,44,57,-13,31
Young Boys,568,1,20,6,6,74,41,33,66
FC Basel,568,2,19,7,6,59,25,34,64
Lucerne,568,3,14,8,10,43,47,-4,50
St Gallen,568,4,14,2,16,40,57,-17,44
FC Lugano,568,5,12,6,14,34,46,-12,42
FC Zürich,568,6,9,10,13,37,39,-2,37
Grasshoppers,568,7,10,7,15,46,50,-4,37
FC Thun,568,8,9,7,16,43,58,-15,34
FC Sion,568,9,7,7,18,44,57,-13,28
Young Boys,569,1,20,8,4,71,38,33,68
FC Basel,569,2,18,7,7,55,29,26,61
St Gallen,569,3,15,4,13,46,53,-7,49
Lucerne,569,4,11,10,11,40,45,-5,43
FC Zürich,569,5,10,10,12,40,36,4,40
FC Lugano,569,6,11,7,14,33,44,-11,40
Grasshoppers,569,7,10,8,14,44,49,-5,38
FC Thun,569,8,10,5,17,44,59,-15,35
FC Sion,569,9,6,7,19,39,59,-20,25
Young Boys,570,1,21,9,2,70,33,37,72
FC Basel,570,2,18,8,6,54,25,29,62
Lucerne,570,3,13,9,10,43,40,3,48
FC Zürich,570,4,12,9,11,43,34,9,45
St Gallen,570,5,14,2,16,43,59,-16,44
Grasshoppers,570,6,9,8,15,40,49,-9,35
FC Lugano,570,7,10,5,17,31,50,-19,35
FC Thun,570,8,9,5,18,42,61,-19,32
FC Sion,570,9,7,7,18,39,54,-15,28
Young Boys,571,1,22,7,3,73,34,39,73
FC Basel,571,2,16,10,6,50,25,25,58
St Gallen,571,3,14,3,15,44,57,-13,45
Lucerne,571,4,12,8,12,40,47,-7,44
FC Zürich,571,5,10,12,10,39,33,6,42
Grasshoppers,571,6,11,7,14,46,49,-3,40
FC Lugano,571,7,10,5,17,34,52,-18,35
FC Thun,571,8,8,8,16,43,59,-16,32
FC Sion,571,9,6,10,16,40,53,-13,28
Young Boys,572,1,22,7,3,73,33,40,73
FC Basel,572,2,17,8,7,55,30,25,59
Lucerne,572,3,13,9,10,41,42,-1,48
St Gallen,572,4,15,3,14,43,53,-10,48
FC Zürich,572,5,10,11,11,44,41,3,41
Grasshoppers,572,6,9,7,16,39,52,-13,34
FC Lugano,572,7,9,7,16,31,49,-18,34
FC Thun,572,8,9,6,17,44,58,-14,33
FC Sion,572,9,6,10,16,39,51,-12,28
Young Boys,573,1,21,6,5,73,36,37,69
FC Basel,573,2,19,7,6,56,23,33,64
Lucerne,573,3,15,7,10,46,42,4,52
St Gallen,573,4,15,3,14,42,54,-12,48
FC Zürich,573,5,10,10,12,41,39,2,40
Grasshoppers,573,6,10,6,16,42,50,-8,36
FC Thun,573,7,10,5,17,43,59,-16,35
FC Lugano,573,8,9,6,17,31,49,-18,33
FC Sion,573,9,6,8,18,39,61,-22,26
Young Boys,574,1,22,7,3,71,34,37,73
FC Basel,574,2,18,8,6,55,29,26,62
Lucerne,574,3,13,8,11,41,40,1,47
St Gallen,574,4,14,2,16,41,59,-18,44
FC Lugano,574,5,11,5,16,32,46,-14,38
FC Zürich,574,6,9,10,13,39,39,0,37
Grasshoppers,574,7,10,7,15,40,47,-7,37
FC Thun,574,8,10,6,16,47,61,-14,36
FC Sion,574,9,6,9,17,42,53,-11,27
Young Boys,575,1,23,7,2,75,33,42,76
FC Basel,575,2,18,9,5,55,26,29,63
Lucerne,575,3,14,7,11,44,43,1,49
St Gallen,575,4,13,3,16,42,56,-14,42
FC Zürich,575,5,10,10,12,39,36,3,40
FC Thun,575,6,10,6,16,43,57,-14,36
FC Lugano,575,7,9,6,17,29,49,-20,33
Grasshoppers,575,8,8,8,16,41,53,-12,32
FC Sion,575,9,7,8,17,40,55,-15,29
Young Boys,576,1,22,7,3,77,38,39,73
FC Basel,576,2,18,8,6,53,26,27,62
Lucerne,576,3,13,8,11,42,45,-3,47
St Gallen,576,4,13,5,14,41,53,-12,44
FC Zürich,576,5,10,11,11,40,36,4,41
FC Thun,576,6,10,5,17,42,59,-17,35
FC Lugano,576,7,9,7,16,31,48,-17,34
Grasshoppers,576,8,8,8,16,40,51,-11,32
FC Sion,576,9,7,9,16,43,53,-10,30
Young Boys,577,1,21,8,3,72,34,38,71
FC Basel,577,2,18,8,6,52,24,28,62
St Gallen,577,3,15,2,15,42,53,-11,47
Lucerne,577,4,11,9,12,37,45,-8,42
FC Zürich,577,5,10,10,12,39,36,3,40
Grasshoppers,577,6,10,8,14,40,45,-5,38
FC Lugano,577,7,10,7,15,32,47,-15,37
FC Thun,577,8,10,5,17,42,57,-15,35
FC Sion,577,9,7,7,18,39,54,-15,28
Young Boys,578,1,19,9,4,66,34,32,66
FC Basel,578,2,18,8,6,55,27,28,62
Lucerne,578,3,13,8,11,39,42,-3,47
St Gallen,578,4,14,3,15,42,56,-14,45
FC Zürich,578,5,10,12,10,42,34,8,42
FC Lugano,578,6,10,7,15,30,45,-15,37
Grasshoppers,578,7,10,6,16,41,48,-7,36
FC Thun,578,8,9,6,17,45,60,-15,33
FC Sion,578,9,7,9,16,43,57,-14,30
Young Boys,579,1,23,7,2,76,33,43,76
FC Basel,579,2,18,9,5,59,26,33,63
Lucerne,579,3,13,9,10,43,45,-2,48
St Gallen,579,4,15,3,14,43,54,-11,48
FC Zürich,579,5,10,10,12,42,42,0,40
Grasshoppers,579,6,10,6,16,44,52,-8,36
FC Thun,579,7,10,5,17,44,59,-15,35
FC Lugano,579,8,9,6,17,31,52,-21,33
FC Sion,579,9,5,7,20,38,57,-19,22
Young Boys,580,1,21,8,3,73,33,40,71
FC Basel,580,2,16,9,7,51,27,24,57
Lucerne,580,3,14,7,11,44,46,-2,49
St Gallen,580,4,15,2,15,44,54,-10,47
FC Zürich,580,5,11,10,11,42,37,5,43
FC Lugano,580,6,11,6,15,34,46,-12,39
FC Thun,580,7,11,5,16,50,61,-11,38
Grasshoppers,580,8,9,6,17,40,56,-16,33
FC Sion,580,9,6,7,19,40,58,-18,25
Young Boys,581,1,21,6,5,73,36,37,69
FC Basel,581,2,17,9,6,54,27,27,60
Lucerne,581,3,14,8,10,42,40,2,50
St Gallen,581,4,14,4,14,45,56,-11,46
FC Zürich,581,5,10,9,13,43,40,3,39
Grasshoppers,581,6,10,7,15,41,48,-7,37
FC Thun,581,7,10,7,15,43,55,-12,37
FC Lugano,581,8,10,6,16,33,52,-19,36
FC Sion,581,9,6,8,18,41,61,-20,26
Young Boys,582,1,20,7,5,69,35,34,67
FC Basel,582,2,19,7,6,61,27,34,64
St Gallen,582,3,16,3,13,47,54,-7,51
Lucerne,582,4,12,8,12,41,52,-11,44
FC Lugano,582,5,12,5,15,36,45,-9,41
FC Zürich,582,6,10,9,13,41,38,3,39
FC Thun,582,7,10,5,17,43,63,-20,35
Grasshoppers,582,8,9,6,17,43,54,-11,33
FC Sion,582,9,7,8,17,41,54,-13,29
Young Boys,583,1,22,7,3,76,41,35,73
FC Basel,583,2,18,9,5,57,24,33,63
Lucerne,583,3,13,8,11,40,42,-2,47
St Gallen,583,4,14,3,15,45,56,-11,45
FC Zürich,583,5,10,10,12,41,40,1,40
Grasshoppers,583,6,10,7,15,42,50,-8,37
FC Lugano,583,7,10,6,16,32,52,-20,36
FC Thun,583,8,9,5,18,45,60,-15,32
FC Sion,583,9,7,7,18,44,57,-13,28
Young Boys,584,1,22,6,4,74,39,35,72
FC Basel,584,2,17,7,8,52,27,25,58
St Gallen,584,3,16,2,14,48,56,-8,50
Lucerne,584,4,14,7,11,50,45,5,49
FC Zürich,584,5,10,10,12,37,38,-1,40
FC Lugano,584,6,11,5,16,36,51,-15,38
FC Thun,584,7,9,8,15,43,56,-13,35
Grasshoppers,584,8,9,7,16,42,52,-10,34
FC Sion,584,9,6,8,18,39,57,-18,26
Young Boys,585,1,22,6,4,72,40,32,72
FC Basel,585,2,16,9,7,55,28,27,57
Lucerne,585,3,16,7,9,49,40,9,55
St Gallen,585,4,14,3,15,42,53,-11,45
FC Zürich,585,5,11,10,11,43,37,6,43
FC Thun,585,6,11,5,16,49,57,-8,38
FC Lugano,585,7,10,5,17,31,52,-21,35
Grasshoppers,585,8,8,6,18,38,58,-20,30
FC Sion,585,9,7,7,18,43,57,-14,28
Young Boys,586,1,22,7,3,73,34,39,73
FC Basel,586,2,17,8,7,52,27,25,59
FC Zürich,586,3,12,10,10,46,37,9,46
St Gallen,586,4,14,3,15,42,55,-13,45
Lucerne,586,5,11,8,13,40,48,-8,41
FC Thun,586,6,11,6,15,51,60,-9,39
Grasshoppers,586,7,10,6,16,42,51,-9,36
FC Lugano,586,8,10,6,16,32,48,-16,36
FC Sion,586,9,6,8,18,38,56,-18,26
Young Boys,587,1,22,8,2,72,32,40,74
FC Basel,587,2,17,8,7,52,24,28,59
Lucerne,587,3,13,7,12,39,44,-5,46
St Gallen,587,4,14,2,16,41,57,-16,44
FC Zürich,587,5,10,12,10,42,35,7,42
FC Lugano,587,6,11,6,15,34,47,-13,39
FC Thun,587,7,10,6,16,44,59,-15,36
Grasshoppers,587,8,9,7,16,41,49,-8,34
FC Sion,587,9,6,8,18,37,55,-18,26
Young Boys,588,1,22,7,3,72,35,37,73
FC Basel,588,2,18,7,7,55,29,26,61
Lucerne,588,3,13,8,11,43,44,-1,47
St Gallen,588,4,14,2,16,41,56,-15,44
FC Zürich,588,5,9,11,12,39,39,0,38
FC Lugano,588,6,10,7,15,35,50,-15,37
Grasshoppers,588,7,10,6,16,43,48,-5,36
FC Sion,588,8,8,9,15,41,48,-7,33
FC Thun,588,9,9,5,18,42,62,-20,32
Young Boys,589,1,23,7,2,79,32,47,76
FC Basel,589,2,17,9,6,53,26,27,60
St Gallen,589,3,15,2,15,42,54,-12,47
Lucerne,589,4,11,8,13,40,48,-8,41
FC Lugano,589,5,12,5,15,35,50,-15,41
FC Zürich,589,6,10,10,12,39,39,0,40
Grasshoppers,589,7,9,7,16,39,49,-10,34
FC Thun,589,8,9,6,17,47,62,-15,33
FC Sion,589,9,7,8,17,39,53,-14,29
Young Boys,590,1,23,7,2,79,37,42,76
FC Basel,590,2,17,7,8,51,25,26,58
Lucerne,590,3,13,7,12,44,47,-3,46
St Gallen,590,4,14,2,16,42,56,-14,44
FC Zürich,590,5,11,10,11,43,37,6,43
FC Lugano,590,6,11,5,16,35,51,-16,38
Grasshoppers,590,7,10,7,15,45,52,-7,37
FC Thun,590,8,8,6,18,41,63,-22,30
FC Sion,590,9,6,11,15,43,55,-12,29
Young Boys,591,1,22,8,2,72,33,39,74
FC Basel,591,2,18,9,5,53,22,31,63
St Gallen,591,3,16,2,14,47,52,-5,50
Lucerne,591,4,12,8,12,41,44,-3,44
FC Zürich,591,5,10,10,12,39,38,1,40
FC Thun,591,6,11,5,16,45,57,-12,38
FC Lugano,591,7,9,7,16,31,50,-19,34
Grasshoppers,591,8,9,6,17,41,54,-13,33
FC Sion,591,9,6,7,19,36,55,-19,25
Young Boys,592,1,21,7,4,73,36,37,70
FC Basel,592,2,18,8,6,53,25,28,62
Lucerne,592,3,13,10,9,43,41,2,49
St Gallen,592,4,13,2,17,40,58,-18,41
FC Zürich,592,5,10,9,13,40,41,-1,39
FC Lugano,592,6,11,6,15,34,48,-14,39
FC Thun,592,7,11,5,16,48,57,-9,38
FC Sion,592,8,8,8,16,43,54,-11,32
Grasshoppers,592,9,8,7,17,39,53,-14,31
Young Boys,593,1,22,6,4,72,33,39,72
FC Basel,593,2,19,8,5,55,23,32,65
St Gallen,593,3,14,5,13,43,53,-10,47
Lucerne,593,4,12,7,13,40,46,-6,43
FC Lugano,593,5,11,6,15,33,48,-15,39
FC Thun,593,6,11,5,16,46,55,-9,38
FC Zürich,593,7,9,10,13,38,40,-2,37
Grasshoppers,593,8,9,6,17,41,52,-11,33
FC Sion,593,9,6,9,17,38,56,-18,27
Young Boys,594,1,22,7,3,72,35,37,73
FC Basel,594,2,19,8,5,58,28,30,65
Lucerne,594,3,13,9,10,45,40,5,48
St Gallen,594,4,13,5,14,41,54,-13,44
FC Zürich,594,5,9,10,13,39,40,-1,37
Grasshoppers,594,6,9,7,16,44,53,-9,34
FC Lugano,594,7,9,7,16,28,49,-21,34
FC Sion,594,8,8,8,16,43,51,-8,32
FC Thun,594,9,9,5,18,44,64,-20,32
Young Boys,595,1,21,7,4,71,36,35,70
FC Basel,595,2,17,8,7,54,30,24,59
St Gallen,595,3,15,4,13,46,54,-8,49
Lucerne,595,4,12,7,13,43,47,-4,43
FC Zürich,595,5,11,9,12,41,36,5,42
Grasshoppers,595,6,11,6,15,43,49,-6,39
FC Lugano,595,7,10,6,16,29,49,-20,36
FC Thun,595,8,10,5,17,43,58,-15,35
FC Sion,595,9,7,8,17,43,54,-11,29
Young Boys,596,1,22,8,2,71,34,37,74
FC Basel,596,2,17,9,6,53,25,28,60
Lucerne,596,3,13,8,11,41,42,-1,47
St Gallen,596,4,14,3,15,42,55,-13,45
FC Zürich,596,5,10,11,11,40,37,3,41
FC Lugano,596,6,10,7,15,33,47,-14,37
FC Thun,596,7,9,6,17,43,63,-20,33
FC Sion,596,8,8,8,16,46,52,-6,32
Grasshoppers,596,9,8,6,18,38,52,-14,30
Young Boys,597,1,21,7,4,67,35,32,70
FC Basel,597,2,20,7,5,63,26,37,67
Lucerne,597,3,13,8,11,46,47,-1,47
St Gallen,597,4,14,2,16,50,63,-13,44
FC Zürich,597,5,10,10,12,41,41,0,40
FC Lugano,597,6,11,6,15,33,47,-14,39
FC Thun,597,7,10,5,17,43,60,-17,35
Grasshoppers,597,8,9,7,16,37,47,-10,34
FC Sion,597,9,6,8,18,41,55,-14,26
Young Boys,598,1,21,7,4,69,37,32,70
FC Basel,598,2,18,8,6,58,25,33,62
Lucerne,598,3,14,7,11,41,41,0,49
FC Zürich,598,4,12,10,10,44,34,10,46
St Gallen,598,5,13,3,16,39,56,-17,42
FC Lugano,598,6,11,6,15,34,46,-12,39
Grasshoppers,598,7,9,8,15,41,49,-8,35
FC Thun,598,8,9,6,17,44,64,-20,33
FC Sion,598,9,6,7,19,39,57,-18,25
FC Basel,599,1,19,8,5,58,24,34,65
Young Boys,599,2,19,7,6,67,39,28,64
Lucerne,599,3,13,7,12,43,44,-1,46
St Gallen,599,4,14,2,16,40,55,-15,44
FC Lugano,599,5,12,5,15,36,45,-9,41
Grasshoppers,599,6,11,6,15,42,49,-7,39
FC Thun,599,7,11,5,16,46,61,-15,38
FC Zürich,599,8,9,10,13,40,41,-1,37
FC Sion,599,9,7,8,17,41,55,-14,29
Young Boys,600,1,22,8,2,74,32,42,74
FC Basel,600,2,18,8,6,53,24,29,62
Lucerne,600,3,13,8,11,41,40,1,47
St Gallen,600,4,14,3,15,41,53,-12,45
FC Zürich,600,5,10,10,12,40,38,2,40
FC Thun,600,6,10,6,16,45,58,-13,36
Grasshoppers,600,7,9,7,16,41,52,-11,34
FC Lugano,600,8,9,7,16,31,53,-22,34
FC Sion,600,9,6,9,17,39,55,-16,27
Young Boys,601,1,22,6,4,70,34,36,72
FC Basel,601,2,19,7,6,54,26,28,64
Lucerne,601,3,13,7,12,46,47,-1,46
St Gallen,601,4,14,4,14,44,54,-10,46
FC Zürich,601,5,9,11,12,38,38,0,38
FC Lugano,601,6,10,7,15,32,49,-17,37
Grasshoppers,601,7,9,7,16,42,51,-9,34
FC Sion,601,8,8,8,16,44,52,-8,32
FC Thun,601,9,8,7,17,40,59,-19,31
Young Boys,602,1,20,7,5,70,41,29,67
FC Basel,602,2,18,8,6,54,26,28,62
St Gallen,602,3,16,3,13,44,51,-7,51
Lucerne,602,4,13,9,10,47,44,3,48
FC Zürich,602,5,11,9,12,42,37,5,42
Grasshoppers,602,6,10,6,16,38,48,-10,36
FC Lugano,602,7,10,6,16,32,53,-21,36
FC Thun,602,8,10,5,17,45,57,-12,35
FC Sion,602,9,6,7,19,39,54,-15,25
Young Boys,603,1,22,6,4,69,35,34,72
FC Basel,603,2,20,7,5,61,24,37,67
St Gallen,603,3,14,3,15,43,54,-11,45
Lucerne,603,4,12,8,12,43,44,-1,44
FC Zürich,603,5,10,11,11,42,38,4,41
Grasshoppers,603,6,9,7,16,38,49,-11,34
FC Lugano,603,7,9,7,16,29,49,-20,34
FC Thun,603,8,9,6,17,43,62,-19,33
FC Sion,603,9,8,7,17,42,55,-13,31
Young Boys,604,1,23,7,2,75,30,45,76
FC Basel,604,2,16,8,8,54,28,26,56
Lucerne,604,3,14,7,11,43,45,-2,49
St Gallen,604,4,14,4,14,43,54,-11,46
FC Zürich,604,5,10,10,12,38,36,2,40
FC Lugano,604,6,11,5,16,31,49,-18,38
FC Thun,604,7,10,5,17,44,61,-17,35
Grasshoppers,604,8,9,7,16,38,48,-10,34
FC Sion,604,9,6,9,17,39,54,-15,27
Young Boys,605,1,21,8,3,71,34,37,71
FC Basel,605,2,18,8,6,57,23,34,62
FC Zürich,605,3,12,10,10,42,35,7,46
St Gallen,605,4,14,3,15,42,54,-12,45
Lucerne,605,5,12,8,12,39,46,-7,44
FC Lugano,605,6,11,6,15,31,45,-14,39
Grasshoppers,605,7,10,7,15,46,51,-5,37
FC Thun,605,8,9,6,17,42,61,-19,33
FC Sion,605,9,5,8,19,38,59,-21,23
Young Boys,606,1,22,7,3,71,34,37,73
FC Basel,606,2,16,10,6,54,30,24,58
St Gallen,606,3,15,3,14,45,54,-9,48
FC Zürich,606,4,12,10,10,40,33,7,46
Lucerne,606,5,12,10,10,43,44,-1,46
FC Thun,606,6,10,6,16,44,58,-14,36
Grasshoppers,606,7,9,7,16,42,50,-8,34
FC Lugano,606,8,9,5,18,28,48,-20,32
FC Sion,606,9,6,8,18,37,53,-16,26
Young Boys,607,1,23,6,3,78,33,45,75
FC Basel,607,2,17,9,6,54,26,28,60
Lucerne,607,3,13,8,11,45,50,-5,47
St Gallen,607,4,13,5,14,42,57,-15,44
FC Zürich,607,5,11,10,11,45,41,4,43
FC Thun,607,6,11,5,16,47,57,-10,38
FC Lugano,607,7,10,5,17,32,52,-20,35
Grasshoppers,607,8,9,6,17,40,52,-12,33
FC Sion,607,9,6,8,18,42,57,-15,26
Young Boys,608,1,22,7,3,75,36,39,73
FC Basel,608,2,18,8,6,56,26,30,62
St Gallen,608,3,14,4,14,42,54,-12,46
FC Zürich,608,4,12,9,11,41,34,7,45
Lucerne,608,5,12,9,11,42,48,-6,45
FC Thun,608,6,9,6,17,43,61,-18,33
FC Lugano,608,7,9,6,17,34,53,-19,33
Grasshoppers,608,8,8,8,16,41,51,-10,32
FC Sion,608,9,7,9,16,45,56,-11,30
Young Boys,609,1,22,7,3,72,34,38,73
FC Basel,609,2,17,7,8,48,26,22,58
St Gallen,609,3,16,2,14,45,53,-8,50
Lucerne,609,4,13,8,11,42,42,0,47
FC Zürich,609,5,12,10,10,47,36,11,46
Grasshoppers,609,6,9,7,16,41,51,-10,34
FC Thun,609,7,9,7,16,44,59,-15,34
FC Lugano,609,8,9,5,18,31,54,-23,32
FC Sion,609,9,6,9,17,43,58,-15,27
Young Boys,610,1,22,6,4,71,37,34,72
FC Basel,610,2,19,7,6,59,28,31,64
Lucerne,610,3,14,7,11,44,45,-1,49
St Gallen,610,4,13,3,16,44,59,-15,42
FC Zürich,610,5,10,9,13,38,39,-1,39
FC Thun,610,6,11,5,16,52,60,-8,38
FC Lugano,610,7,11,5,16,33,49,-16,38
FC Sion,610,8,8,8,16,43,53,-10,32
Grasshoppers,610,9,8,6,18,40,54,-14,30
Young Boys,611,1,22,7,3,75,36,39,73
FC Basel,611,2,16,9,7,53,30,23,57
Lucerne,611,3,13,9,10,44,44,0,48
FC Zürich,611,4,12,10,10,41,32,9,46
St Gallen,611,5,13,3,16,41,57,-16,42
FC Thun,611,6,10,6,16,47,58,-11,36
FC Lugano,611,7,10,6,16,31,50,-19,36
Grasshoppers,611,8,9,7,16,44,53,-9,34
FC Sion,611,9,6,9,17,39,55,-16,27
Young Boys,612,1,21,8,3,68,33,35,71
FC Basel,612,2,18,8,6,53,24,29,62
FC Zürich,612,3,12,10,10,41,34,7,46
Lucerne,612,4,12,8,12,44,46,-2,44
St Gallen,612,5,14,2,16,44,57,-13,44
Grasshoppers,612,6,10,8,14,43,48,-5,38
FC Lugano,612,7,10,5,17,30,50,-20,35
FC Thun,612,8,8,7,17,41,59,-18,31
FC Sion,612,9,6,10,16,37,50,-13,28
Young Boys,613,1,21,8,3,76,34,42,71
FC Basel,613,2,19,7,6,55,25,30,64
St Gallen,613,3,14,3,15,43,55,-12,45
Lucerne,613,4,11,8,13,40,47,-7,41
FC Zürich,613,5,10,10,12,37,35,2,40
FC Lugano,613,6,11,6,15,31,49,-18,39
Grasshoppers,613,7,10,6,16,41,51,-10,36
FC Thun,613,8,10,5,17,43,59,-16,35
FC Sion,613,9,7,9,16,41,52,-11,30
Young Boys,614,1,23,7,2,78,33,45,76
FC Basel,614,2,18,9,5,56,25,31,63
Lucerne,614,3,13,8,11,43,47,-4,47
St Gallen,614,4,14,3,15,43,56,-13,45
FC Zürich,614,5,9,12,11,39,36,3,39
FC Thun,614,6,10,6,16,44,58,-14,36
FC Lugano,614,7,9,6,17,31,52,-21,33
Grasshoppers,614,8,8,7,17,40,54,-14,31
FC Sion,614,9,7,8,17,39,52,-13,29
Young Boys,615,1,21,7,4,73,40,33,70
FC Basel,615,2,17,8,7,56,32,24,59
Lucerne,615,3,13,8,11,40,41,-1,47
St Gallen,615,4,14,4,14,45,57,-12,46
FC Thun,615,5,12,5,15,47,55,-8,41
FC Zürich,615,6,10,9,13,41,38,3,39
FC Lugano,615,7,11,6,15,34,47,-13,39
FC Sion,615,8,8,7,17,44,56,-12,31
Grasshoppers,615,9,8,6,18,37,51,-14,30
Young Boys,616,1,22,6,4,76,37,39,72
FC Basel,616,2,17,8,7,53,29,24,59
Lucerne,616,3,13,8,11,44,45,-1,47
FC Zürich,616,4,11,11,10,43,37,6,44
St Gallen,616,5,13,3,16,41,57,-16,42
Grasshoppers,616,6,10,7,15,41,48,-7,37
FC Thun,616,7,10,7,15,45,57,-12,37
FC Lugano,616,8,9,7,16,31,51,-20,34
FC Sion,616,9,7,7,18,42,55,-13,28
Young Boys,617,1,22,6,4,72,39,33,72
FC Basel,617,2,16,8,8,51,30,21,56
Lucerne,617,3,13,9,10,41,40,1,48
FC Zürich,617,4,12,9,11,41,34,7,45
St Gallen,617,5,13,5,14,42,54,-12,44
FC Lugano,617,6,10,7,15,30,45,-15,37
FC Thun,617,7,10,6,16,45,57,-12,36
Grasshoppers,617,8,9,7,16,43,50,-7,34
FC Sion,617,9,7,7,18,41,57,-16,28
Young Boys,618,1,22,8,2,72,32,40,74
FC Basel,618,2,17,10,5,56,25,31,61
Lucerne,618,3,14,7,11,47,46,1,49
FC Zürich,618,4,10,12,10,43,36,7,42
St Gallen,618,5,13,3,16,40,59,-19,42
FC Thun,618,6,10,7,15,47,57,-10,37
FC Lugano,618,7,10,6,16,30,44,-14,36
Grasshoppers,618,8,8,7,17,39,55,-16,31
FC Sion,618,9,5,10,17,36,56,-20,25
Young Boys,619,1,21,6,5,71,38,33,69
FC Basel,619,2,18,9,5,60,30,30,63
Lucerne,619,3,14,8,10,44,42,2,50
FC Zürich,619,4,11,11,10,43,37,6,44
St Gallen,619,5,14,2,16,41,55,-14,44
Grasshoppers,619,6,10,7,15,44,48,-4,37
FC Lugano,619,7,10,5,17,29,48,-19,35
FC Thun,619,8,8,7,17,41,61,-20,31
FC Sion,619,9,6,9,17,38,52,-14,27
Young Boys,620,1,20,6,6,68,42,26,66
FC Basel,620,2,16,10,6,53,28,25,58
Lucerne,620,3,13,9,10,45,42,3,48
St Gallen,620,4,14,3,15,44,55,-11,45
FC Lugano,620,5,12,6,14,34,43,-9,42
Grasshoppers,620,6,11,6,15,44,50,-6,39
FC Zürich,620,7,9,11,12,38,39,-1,38
FC Thun,620,8,8,8,16,41,60,-19,32
FC Sion,620,9,7,9,16,44,52,-8,30
Young Boys,621,1,21,6,5,70,37,33,69
FC Basel,621,2,17,9,6,54,26,28,60
St Gallen,621,3,14,3,15,42,57,-15,45
Lucerne,621,4,12,7,13,41,47,-6,43
FC Zürich,621,5,10,12,10,41,36,5,42
Grasshoppers,621,6,11,6,15,41,46,-5,39
FC Thun,621,7,10,6,16,43,58,-15,36
FC Lugano,621,8,10,6,16,32,48,-16,36
FC Sion,621,9,8,7,17,43,52,-9,31
Young Boys,622,1,22,7,3,72,36,36,73
FC Basel,622,2,17,8,7,55,32,23,59
St Gallen,622,3,15,2,15,46,56,-10,47
FC Zürich,622,4,12,9,11,43,36,7,45
Lucerne,622,5,12,8,12,47,46,1,44
FC Lugano,622,6,12,5,15,35,46,-11,41
FC Thun,622,7,10,6,16,49,57,-8,36
Grasshoppers,622,8,9,6,17,39,57,-18,33
FC Sion,622,9,6,7,19,38,58,-20,25
Young Boys,623,1,22,7,3,71,35,36,73
FC Basel,623,2,18,7,7,52,26,26,61
St Gallen,623,3,16,2,14,47,54,-7,50
FC Zürich,623,4,12,9,11,44,35,9,45
Lucerne,623,5,12,7,13,40,46,-6,43
FC Lugano,623,6,11,5,16,31,46,-15,38
FC Thun,623,7,9,6,17,44,61,-17,33
Grasshoppers,623,8,8,7,17,41,54,-13,31
FC Sion,623,9,7,8,17,41,54,-13,29
Young Boys,624,1,21,7,4,72,39,33,70
FC Basel,624,2,18,8,6,51,23,28,62
St Gallen,624,3,15,2,15,44,57,-13,47
FC Zürich,624,4,11,10,11,42,35,7,43
Lucerne,624,5,11,9,12,39,46,-7,42
FC Lugano,624,6,11,6,15,33,47,-14,39
Grasshoppers,624,7,10,7,15,44,47,-3,37
FC Thun,624,8,9,6,17,42,59,-17,33
FC Sion,624,9,6,9,17,40,54,-14,27
Young Boys,625,1,23,6,3,73,35,38,75
FC Basel,625,2,18,8,6,56,24,32,62
FC Zürich,625,3,12,9,11,39,34,5,45
Lucerne,625,4,12,8,12,39,46,-7,44
St Gallen,625,5,13,4,15,39,52,-13,43
FC Thun,625,6,10,6,16,43,57,-14,36
Grasshoppers,625,7,9,7,16,40,50,-10,34
FC Lugano,625,8,9,7,16,28,45,-17,34
FC Sion,625,9,6,9,17,37,51,-14,27
Young Boys,626,1,21,8,3,70,34,36,71
FC Basel,626,2,18,8,6,52,23,29,62
St Gallen,626,3,15,2,15,46,55,-9,47
Lucerne,626,4,13,7,12,45,48,-3,46
FC Zürich,626,5,10,12,10,42,37,5,42
Grasshoppers,626,6,9,9,14,43,49,-6,36
FC Thun,626,7,9,7,16,43,58,-15,34
FC Lugano,626,8,9,6,17,31,52,-21,33
FC Sion,626,9,6,9,17,39,55,-16,27
Young Boys,627,1,21,9,2,68,31,37,72
FC Basel,627,2,15,10,7,49,28,21,55
St Gallen,627,3,16,2,14,49,54,-5,50
Lucerne,627,4,12,10,10,39,43,-4,46
FC Zürich,627,5,11,10,11,41,36,5,43
Grasshoppers,627,6,9,7,16,41,51,-10,34
FC Thun,627,7,9,6,17,41,57,-16,33
FC Lugano,627,8,9,6,17,30,49,-19,33
FC Sion,627,9,8,8,16,42,51,-9,32
Young Boys,628,1,20,8,4,74,37,37,68
FC Basel,628,2,16,10,6,52,27,25,58
St Gallen,628,3,15,3,14,45,53,-8,48
Lucerne,628,4,12,9,11,42,43,-1,45
FC Zürich,628,5,10,11,11,42,36,6,41
FC Lugano,628,6,11,5,16,33,56,-23,38
Grasshoppers,628,7,10,7,15,41,48,-7,37
FC Thun,628,8,10,6,16,43,57,-14,36
FC Sion,628,9,6,9,17,39,54,-15,27
Young Boys,629,1,21,8,3,76,38,38,71
FC Basel,629,2,18,8,6,58,28,30,62
FC Zürich,629,3,13,9,10,45,36,9,48
Lucerne,629,4,13,8,11,40,43,-3,47
St Gallen,629,5,13,2,17,40,59,-19,41
FC Lugano,629,6,11,5,16,31,50,-19,38
FC Thun,629,7,9,7,16,44,59,-15,34
Grasshoppers,629,8,8,8,16,39,50,-11,32
FC Sion,629,9,6,9,17,43,53,-10,27
Young Boys,630,1,22,6,4,74,34,40,72
FC Basel,630,2,20,7,5,61,22,39,67
FC Zürich,630,3,12,9,11,43,39,4,45
St Gallen,630,4,14,3,15,41,52,-11,45
Lucerne,630,5,12,8,12,38,44,-6,44
Grasshoppers,630,6,10,7,15,40,50,-10,37
FC Thun,630,7,9,6,17,44,63,-19,33
FC Lugano,630,8,9,6,17,31,51,-20,33
FC Sion,630,9,6,8,18,36,53,-17,26
Young Boys,631,1,22,8,2,75,34,41,74
FC Basel,631,2,18,7,7,54,30,24,61
Lucerne,631,3,14,8,10,45,43,2,50
St Gallen,631,4,14,3,15,43,55,-12,45
FC Zürich,631,5,10,11,11,40,36,4,41
FC Lugano,631,6,9,7,16,29,47,-18,34
Grasshoppers,631,7,9,6,17,41,52,-11,33
FC Sion,631,8,8,8,16,44,52,-8,32
FC Thun,631,9,8,6,18,39,61,-22,30
Young Boys,632,1,21,8,3,74,38,36,71
FC Basel,632,2,16,11,5,56,29,27,59
St Gallen,632,3,15,3,14,43,58,-15,48
Lucerne,632,4,12,9,11,43,45,-2,45
Grasshoppers,632,5,11,6,15,46,46,0,39
FC Zürich,632,6,9,11,12,40,38,2,38
FC Thun,632,7,10,5,17,41,57,-16,35
FC Lugano,632,8,10,5,17,32,52,-20,35
FC Sion,632,9,7,8,17,42,54,-12,29
Young Boys,633,1,23,7,2,73,33,40,76
FC Basel,633,2,18,9,5,56,25,31,63
St Gallen,633,3,14,4,14,43,54,-11,46
FC Zürich,633,4,12,9,11,44,38,6,45
Lucerne,633,5,12,9,11,41,43,-2,45
Grasshoppers,633,6,10,7,15,39,46,-7,37
FC Lugano,633,7,9,6,17,31,51,-20,33
FC Thun,633,8,8,6,18,41,62,-21,30
FC Sion,633,9,5,9,18,40,56,-16,24
Young Boys,634,1,21,7,4,69,35,34,70
FC Basel,634,2,16,10,6,50,24,26,58
St Gallen,634,3,16,2,14,43,55,-12,50
Lucerne,634,4,13,8,11,46,46,0,47
FC Zürich,634,5,10,12,10,38,33,5,42
Grasshoppers,634,6,10,6,16,40,49,-9,36
FC Lugano,634,7,10,6,16,29,46,-17,36
FC Thun,634,8,9,7,16,43,57,-14,34
FC Sion,634,9,6,8,18,43,56,-13,26
Young Boys,635,1,23,6,3,73,32,41,75
FC Basel,635,2,18,8,6,55,25,30,62
Lucerne,635,3,14,7,11,44,46,-2,49
FC Zürich,635,4,12,10,10,42,33,9,46
St Gallen,635,5,13,2,17,40,59,-19,41
Grasshoppers,635,6,11,6,15,42,46,-4,39
FC Lugano,635,7,10,5,17,32,50,-18,35
FC Thun,635,8,8,6,18,41,60,-19,30
FC Sion,635,9,6,8,18,39,57,-18,26
Young Boys,636,1,23,6,3,73,33,40,75
FC Basel,636,2,17,7,8,50,28,22,58
St Gallen,636,3,15,4,13,45,51,-6,49
FC Zürich,636,4,12,10,10,44,35,9,46
Lucerne,636,5,12,9,11,39,41,-2,45
FC Thun,636,6,10,5,17,45,60,-15,35
FC Lugano,636,7,9,8,15,30,48,-18,35
Grasshoppers,636,8,9,6,17,37,48,-11,33
FC Sion,636,9,6,7,19,38,57,-19,25
Young Boys,637,1,21,7,4,70,38,32,70
FC Basel,637,2,19,7,6,57,25,32,64
FC Zürich,637,3,13,9,10,42,32,10,48
Lucerne,637,4,12,8,12,43,46,-3,44
St Gallen,637,5,14,2,16,43,59,-16,44
FC Lugano,637,6,10,6,16,32,46,-14,36
FC Thun,637,7,10,5,17,43,59,-16,35
Grasshoppers,637,8,9,7,16,39,50,-11,34
FC Sion,637,9,7,7,18,38,52,-14,28
Young Boys,638,1,20,9,3,72,37,35,69
FC Basel,638,2,17,10,5,54,26,28,61
St Gallen,638,3,15,3,14,46,55,-9,48
FC Zürich,638,4,12,10,10,45,38,7,46
Lucerne,638,5,12,8,12,41,44,-3,44
Grasshoppers,638,6,11,6,15,46,52,-6,39
FC Lugano,638,7,10,7,15,32,47,-15,37
FC Thun,638,8,9,5,18,44,62,-18,32
FC Sion,638,9,5,8,19,42,61,-19,23
Young Boys,639,1,23,7,2,76,30,46,76
FC Basel,639,2,16,9,7,52,29,23,57
St Gallen,639,3,17,2,13,48,51,-3,53
Lucerne,639,4,12,8,12,42,50,-8,44
FC Zürich,639,5,10,12,10,40,34,6,42
FC Lugano,639,6,10,6,16,32,52,-20,36
Grasshoppers,639,7,9,6,17,40,50,-10,33
FC Thun,639,8,9,6,17,42,60,-18,33
FC Sion,639,9,6,8,18,37,53,-16,26
Young Boys,640,1,22,6,4,70,33,37,72
FC Basel,640,2,17,8,7,51,26,25,59
St Gallen,640,3,17,2,13,47,52,-5,53
Lucerne,640,4,11,7,14,38,45,-7,40
FC Thun,640,5,11,6,15,47,55,-8,39
FC Lugano,640,6,11,5,16,35,50,-15,38
FC Zürich,640,7,9,10,13,40,44,-4,37
Grasshoppers,640,8,9,8,15,40,48,-8,35
FC Sion,640,9,7,8,17,40,55,-15,29
Young Boys,641,1,22,7,3,74,35,39,73
FC Basel,641,2,18,8,6,57,27,30,62
St Gallen,641,3,16,2,14,47,51,-4,50
Lucerne,641,4,12,10,10,43,45,-2,46
FC Zürich,641,5,11,9,12,42,36,6,42
Grasshoppers,641,6,9,8,15,43,51,-8,35
FC Lugano,641,7,10,5,17,30,50,-20,35
FC Thun,641,8,9,6,17,43,63,-20,33
FC Sion,641,9,6,7,19,38,59,-21,25
Young Boys,642,1,21,9,2,73,35,38,72
FC Basel,642,2,17,9,6,58,25,33,60
Lucerne,642,3,13,7,12,40,48,-8,46
FC Zürich,642,4,12,9,11,43,37,6,45
St Gallen,642,5,14,3,15,41,53,-12,45
FC Lugano,642,6,10,6,16,34,50,-16,36
FC Sion,642,7,9,8,15,46,51,-5,35
Grasshoppers,642,8,9,6,17,39,50,-11,33
FC Thun,642,9,8,5,19,43,68,-25,29
Young Boys,643,1,22,8,2,70,32,38,74
FC Basel,643,2,17,8,7,50,24,26,59
St Gallen,643,3,14,4,14,42,52,-10,46
FC Zürich,643,4,11,10,11,42,36,6,43
Lucerne,643,5,12,7,13,40,45,-5,43
FC Lugano,643,6,11,6,15,33,47,-14,39
FC Thun,643,7,10,6,16,44,59,-15,36
Grasshoppers,643,8,8,8,16,38,48,-10,32
FC Sion,643,9,6,9,17,38,54,-16,27
Young Boys,644,1,20,6,6,71,41,30,66
FC Basel,644,2,16,9,7,54,28,26,57
Lucerne,644,3,13,9,10,41,41,0,48
St Gallen,644,4,15,3,14,43,53,-10,48
FC Zürich,644,5,12,9,11,41,35,6,45
Grasshoppers,644,6,12,6,14,47,47,0,42
FC Lugano,644,7,10,5,17,31,48,-17,35
FC Thun,644,8,9,7,16,43,62,-19,34
FC Sion,644,9,6,8,18,42,58,-16,26
Young Boys,645,1,22,7,3,72,32,40,73
FC Basel,645,2,18,8,6,52,23,29,62
Lucerne,645,3,13,8,11,42,45,-3,47
FC Zürich,645,4,12,9,11,43,36,7,45
St Gallen,645,5,14,3,15,43,58,-15,45
FC Lugano,645,6,11,5,16,32,49,-17,38
Grasshoppers,645,7,9,7,16,41,50,-9,34
FC Sion,645,8,7,8,17,45,55,-10,29
FC Thun,645,9,8,5,19,39,61,-22,29
Young Boys,646,1,22,7,3,70,35,35,73
FC Basel,646,2,18,7,7,59,28,31,61
Lucerne,646,3,12,10,10,44,45,-1,46
St Gallen,646,4,13,5,14,42,56,-14,44
FC Zürich,646,5,11,9,12,38,35,3,42
FC Thun,646,6,10,6,16,44,58,-14,36
Grasshoppers,646,7,9,8,15,41,49,-8,35
FC Lugano,646,8,9,6,17,29,48,-19,33
FC Sion,646,9,7,8,17,40,53,-13,29
Young Boys,647,1,22,6,4,75,36,39,72
FC Basel,647,2,17,8,7,53,30,23,59
St Gallen,647,3,16,3,13,46,52,-6,51
Lucerne,647,4,13,7,12,48,47,1,46
FC Zürich,647,5,11,10,11,42,35,7,43
Grasshoppers,647,6,9,7,16,40,53,-13,34
FC Thun,647,7,9,7,16,42,60,-18,34
FC Lugano,647,8,9,6,17,28,49,-21,33
FC Sion,647,9,7,8,17,42,54,-12,29
Young Boys,648,1,20,7,5,71,42,29,67
FC Basel,648,2,18,9,5,53,24,29,63
St Gallen,648,3,15,2,15,45,54,-9,47
FC Lugano,648,4,13,5,14,40,46,-6,44
Lucerne,648,5,11,10,11,41,46,-5,43
FC Zürich,648,6,10,11,11,39,35,4,41
Grasshoppers,648,7,10,8,14,43,48,-5,38
FC Thun,648,8,9,6,17,44,57,-13,33
FC Sion,648,9,5,8,19,37,61,-24,23
Young Boys,649,1,20,8,4,70,35,35,68
FC Basel,649,2,19,8,5,59,24,35,65
St Gallen,649,3,15,2,15,41,56,-15,47
Lucerne,649,4,13,7,12,42,48,-6,46
FC Zürich,649,5,10,11,11,42,38,4,41
Grasshoppers,649,6,11,6,15,44,50,-6,39
FC Lugano,649,7,10,6,16,30,49,-19,36
FC Thun,649,8,8,7,17,45,63,-18,31
FC Sion,649,9,6,9,17,44,54,-10,27
Young Boys,650,1,23,6,3,71,33,38,75
FC Basel,650,2,17,7,8,53,32,21,58
St Gallen,650,3,15,3,14,48,55,-7,48
FC Zürich,650,4,11,10,11,44,36,8,43
Lucerne,650,5,11,8,13,37,44,-7,41
Grasshoppers,650,6,11,7,14,41,46,-5,40
FC Lugano,650,7,10,7,15,34,49,-15,37
FC Thun,650,8,10,5,17,44,60,-16,35
FC Sion,650,9,6,7,19,36,53,-17,25
Young Boys,651,1,23,7,2,77,32,45,76
FC Basel,651,2,17,8,7,51,26,25,59
Lucerne,651,3,14,8,10,43,43,0,50
St Gallen,651,4,15,3,14,44,53,-9,48
FC Zürich,651,5,11,10,11,43,40,3,43
Grasshoppers,651,6,9,7,16,44,54,-10,34
FC Thun,651,7,9,6,17,45,60,-15,33
FC Lugano,651,8,9,5,18,29,52,-23,32
FC Sion,651,9,6,8,18,39,55,-16,26
Young Boys,652,1,21,8,3,70,34,36,71
FC Basel,652,2,18,8,6,59,29,30,62
St Gallen,652,3,16,2,14,47,52,-5,50
Lucerne,652,4,12,8,12,38,46,-8,44
FC Zürich,652,5,10,9,13,43,47,-4,39
FC Lugano,652,6,11,5,16,37,47,-10,38
Grasshoppers,652,7,10,6,16,41,52,-11,36
FC Thun,652,8,10,6,16,45,58,-13,36
FC Sion,652,9,6,8,18,39,54,-15,26
Young Boys,653,1,22,8,2,74,33,41,74
FC Basel,653,2,18,8,6,54,25,29,62
FC Zürich,653,3,12,10,10,45,33,12,46
St Gallen,653,4,14,3,15,40,53,-13,45
Lucerne,653,5,11,8,13,40,52,-12,41
FC Lugano,653,6,10,6,16,32,51,-19,36
Grasshoppers,653,7,9,8,15,40,47,-7,35
FC Thun,653,8,9,6,17,41,58,-17,33
FC Sion,653,9,6,9,17,39,53,-14,27
Young Boys,654,1,20,7,5,71,41,30,67
FC Basel,654,2,17,9,6,54,29,25,60
Lucerne,654,3,15,8,9,46,40,6,53
St Gallen,654,4,14,3,15,44,55,-11,45
FC Zürich,654,5,10,10,12,40,38,2,40
FC Thun,654,6,9,8,15,44,56,-12,35
FC Lugano,654,7,10,5,17,31,48,-17,35
FC Sion,654,8,8,8,16,45,55,-10,32
Grasshoppers,654,9,8,8,16,38,51,-13,32
Young Boys,655,1,20,8,4,72,36,36,68
FC Basel,655,2,18,8,6,53,25,28,62
St Gallen,655,3,16,2,14,44,50,-6,50
FC Zürich,655,4,12,10,10,44,36,8,46
Lucerne,655,5,12,8,12,41,45,-4,44
Grasshoppers,655,6,10,7,15,40,46,-6,37
FC Thun,655,7,9,5,18,46,63,-17,32
FC Lugano,655,8,9,5,18,29,54,-25,32
FC Sion,655,9,8,7,17,42,56,-14,31
Young Boys,656,1,21,7,4,69,35,34,70
FC Basel,656,2,16,8,8,53,30,23,56
Lucerne,656,3,13,8,11,46,46,0,47
St Gallen,656,4,14,3,15,44,55,-11,45
FC Zürich,656,5,11,9,12,40,36,4,42
FC Lugano,656,6,11,5,16,29,47,-18,38
Grasshoppers,656,7,10,7,15,43,49,-6,37
FC Thun,656,8,10,7,15,44,57,-13,37
FC Sion,656,9,7,8,17,45,58,-13,29
Young Boys,657,1,22,6,4,73,35,38,72
FC Basel,657,2,18,7,7,53,26,27,61
Lucerne,657,3,13,7,12,43,49,-6,46
St Gallen,657,4,14,3,15,41,54,-13,45
FC Zürich,657,5,11,9,12,40,35,5,42
FC Thun,657,6,11,5,16,46,58,-12,38
FC Lugano,657,7,11,5,16,31,46,-15,38
Grasshoppers,657,8,8,7,17,41,55,-14,31
FC Sion,657,9,7,9,16,43,53,-10,30
Young Boys,658,1,22,7,3,77,40,37,73
FC Basel,658,2,19,7,6,60,25,35,64
Lucerne,658,3,14,8,10,44,40,4,50
St Gallen,658,4,14,2,16,43,57,-14,44
FC Zürich,658,5,10,10,12,42,38,4,40
FC Thun,658,6,10,6,16,41,59,-18,36
Grasshoppers,658,7,9,7,16,41,49,-8,34
FC Lugano,658,8,9,6,17,31,54,-23,33
FC Sion,658,9,7,7,18,39,56,-17,28
Young Boys,659,1,21,6,5,66,35,31,69
FC Basel,659,2,19,7,6,55,28,27,64
Lucerne,659,3,15,7,10,49,43,6,52
FC Zürich,659,4,13,9,10,45,34,11,48
St Gallen,659,5,13,2,17,40,57,-17,41
FC Lugano,659,6,10,5,17,29,47,-18,35
FC Sion,659,7,8,8,16,41,52,-11,32
Grasshoppers,659,8,8,7,17,41,53,-12,31
FC Thun,659,9,8,7,17,41,58,-17,31
Young Boys,660,1,21,8,3,69,32,37,71
FC Basel,660,2,16,8,8,47,26,21,56
Lucerne,660,3,14,7,11,41,41,0,49
St Gallen,660,4,15,2,15,44,56,-12,47
FC Lugano,660,5,12,5,15,35,45,-10,41
FC Zürich,660,6,10,10,12,39,37,2,40
FC Thun,660,7,11,5,16,45,56,-11,38
Grasshoppers,660,8,9,8,15,40,48,-8,35
FC Sion,660,9,5,9,18,38,57,-19,24
Young Boys,661,1,22,7,3,70,33,37,73
FC Basel,661,2,18,7,7,51,25,26,61
Lucerne,661,3,14,8,10,42,40,2,50
St Gallen,661,4,14,3,15,41,53,-12,45
FC Zürich,661,5,10,10,12,42,39,3,40
FC Lugano,661,6,10,7,15,31,45,-14,37
FC Thun,661,7,10,6,16,45,57,-12,36
Grasshoppers,661,8,8,8,16,38,50,-12,32
FC Sion,661,9,6,8,18,38,56,-18,26
Young Boys,662,1,20,6,6,66,35,31,66
FC Basel,662,2,17,9,6,52,26,26,60
Lucerne,662,3,14,9,9,46,38,8,51
St Gallen,662,4,14,4,14,46,57,-11,46
FC Zürich,662,5,12,9,11,43,39,4,45
FC Thun,662,6,10,7,15,49,56,-7,37
Grasshoppers,662,7,9,8,15,39,51,-12,35
FC Lugano,662,8,9,5,18,30,52,-22,32
FC Sion,662,9,6,9,17,40,57,-17,27
Young Boys,663,1,22,6,4,72,39,33,72
FC Basel,663,2,19,7,6,56,25,31,64
Lucerne,663,3,13,8,11,43,41,2,47
St Gallen,663,4,15,2,15,41,52,-11,47
FC Zürich,663,5,9,11,12,40,40,0,38
FC Lugano,663,6,11,5,16,33,47,-14,38
Grasshoppers,663,7,9,7,16,41,49,-8,34
FC Thun,663,8,9,7,16,41,58,-17,34
FC Sion,663,9,6,9,17,37,53,-16,27
Young Boys,664,1,21,6,5,72,39,33,69
FC Basel,664,2,18,8,6,58,26,32,62
St Gallen,664,3,15,4,13,44,52,-8,49
Lucerne,664,4,12,9,11,42,44,-2,45
FC Zürich,664,5,11,10,11,43,35,8,43
Grasshoppers,664,6,11,7,14,42,47,-5,40
FC Lugano,664,7,9,7,16,30,50,-20,34
FC Thun,664,8,9,5,18,42,63,-21,32
FC Sion,664,9,6,8,18,40,57,-17,26
Young Boys,665,1,23,6,3,75,38,37,75
FC Basel,665,2,17,8,7,56,30,26,59
St Gallen,665,3,16,2,14,46,54,-8,50
Lucerne,665,4,13,7,12,43,44,-1,46
FC Zürich,665,5,10,12,10,39,34,5,42
FC Thun,665,6,10,6,16,45,57,-12,36
Grasshoppers,665,7,9,6,17,41,55,-14,33
FC Lugano,665,8,9,5,18,29,52,-23,32
FC Sion,665,9,7,8,17,42,52,-10,29
Young Boys,666,1,21,7,4,72,35,37,70
FC Basel,666,2,19,8,5,56,25,31,65
St Gallen,666,3,15,3,14,43,52,-9,48
Lucerne,666,4,12,9,11,40,41,-1,45
FC Zürich,666,5,11,9,12,43,38,5,42
FC Thun,666,6,11,5,16,49,58,-9,38
Grasshoppers,666,7,10,6,16,43,53,-10,36
FC Lugano,666,8,9,5,18,30,54,-24,32
FC Sion,666,9,6,8,18,39,59,-20,26
Young Boys,667,1,22,8,2,69,32,37,74
FC Basel,667,2,18,9,5,55,26,29,63
St Gallen,667,3,15,3,14,44,54,-10,48
Lucerne,667,4,13,7,12,39,41,-2,46
FC Zürich,667,5,11,9,12,41,37,4,42
FC Thun,667,6,10,7,15,47,59,-12,37
Grasshoppers,667,7,9,7,16,40,50,-10,34
FC Lugano,667,8,9,6,17,30,48,-18,33
FC Sion,667,9,5,8,19,39,57,-18,23
Young Boys,668,1,21,8,3,77,39,38,71
FC Basel,668,2,20,7,5,60,28,32,67
Lucerne,668,3,13,9,10,43,42,1,48
St Gallen,668,4,14,3,15,43,55,-12,45
FC Thun,668,5,11,5,16,46,59,-13,38
FC Zürich,668,6,9,10,13,41,40,1,37
FC Lugano,668,7,10,6,16,34,51,-17,36
Grasshoppers,668,8,8,6,18,40,55,-15,30
FC Sion,668,9,7,8,17,40,55,-15,29
Young Boys,669,1,24,6,2,76,34,42,78
FC Basel,669,2,19,7,6,63,30,33,64
St Gallen,669,3,15,3,14,47,56,-9,48
Lucerne,669,4,12,8,12,41,46,-5,44
FC Zürich,669,5,11,9,12,47,38,9,42
FC Lugano,669,6,10,6,16,33,49,-16,36
FC Thun,669,7,10,5,17,45,63,-18,35
Grasshoppers,669,8,9,6,17,41,53,-12,33
FC Sion,669,9,5,8,19,38,62,-24,23
Young Boys,670,1,20,8,4,68,35,33,68
FC Basel,670,2,19,7,6,58,25,33,64
St Gallen,670,3,14,3,15,44,57,-13,45
FC Zürich,670,4,11,10,11,42,36,6,43
Lucerne,670,5,11,10,11,41,46,-5,43
Grasshoppers,670,6,10,7,15,43,48,-5,37
FC Lugano,670,7,9,9,14,34,49,-15,36
FC Thun,670,8,9,5,18,42,65,-23,32
FC Sion,670,9,8,7,17,42,53,-11,31
Young Boys,671,1,22,6,4,74,38,36,72
FC Basel,671,2,17,8,7,52,26,26,59
Lucerne,671,3,14,8,10,43,42,1,50
St Gallen,671,4,14,3,15,40,52,-12,45
FC Zürich,671,5,10,11,11,42,38,4,41
FC Lugano,671,6,11,6,15,35,46,-11,39
FC Thun,671,7,10,7,15,49,59,-10,37
Grasshoppers,671,8,9,6,17,39,52,-13,33
FC Sion,671,9,6,7,19,40,61,-21,25
Young Boys,672,1,23,7,2,72,31,41,76
FC Basel,672,2,17,10,5,57,27,30,61
Lucerne,672,3,14,7,11,47,46,1,49
St Gallen,672,4,13,4,15,43,57,-14,43
FC Zürich,672,5,10,11,11,42,38,4,41
FC Thun,672,6,10,6,16,44,59,-15,36
Grasshoppers,672,7,9,7,16,40,50,-10,34
FC Lugano,672,8,9,7,16,31,50,-19,34
FC Sion,672,9,6,7,19,40,58,-18,25
Young Boys,673,1,20,8,4,69,37,32,68
FC Basel,673,2,18,9,5,56,26,30,63
Lucerne,673,3,14,7,11,43,40,3,49
St Gallen,673,4,14,4,14,42,53,-11,46
FC Zürich,673,5,10,10,12,41,39,2,40
FC Thun,673,6,11,5,16,46,56,-10,38
FC Lugano,673,7,10,6,16,33,51,-18,36
Grasshoppers,673,8,9,7,16,41,50,-9,34
FC Sion,673,9,6,8,18,37,56,-19,26
Young Boys,674,1,23,6,3,74,36,38,75
FC Basel,674,2,15,10,7,49,28,21,55
St Gallen,674,3,15,3,14,43,50,-7,48
FC Zürich,674,4,10,11,11,43,37,6,41
Lucerne,674,5,11,8,13,41,48,-7,41
FC Lugano,674,6,11,6,15,30,46,-16,39
FC Thun,674,7,10,7,15,45,57,-12,37
Grasshoppers,674,8,9,7,16,37,47,-10,34
FC Sion,674,9,7,8,17,39,52,-13,29
Young Boys,675,1,20,6,6,74,42,32,66
FC Basel,675,2,17,9,6,54,25,29,60
Lucerne,675,3,14,9,9,43,38,5,51
St Gallen,675,4,15,3,14,43,54,-11,48
FC Zürich,675,5,10,11,11,41,37,4,41
Grasshoppers,675,6,11,6,15,47,53,-6,39
FC Lugano,675,7,9,7,16,29,49,-20,34
FC Thun,675,8,9,5,18,44,62,-18,32
FC Sion,675,9,7,8,17,43,58,-15,29
Young Boys,676,1,23,6,3,72,31,41,75
FC Basel,676,2,17,10,5,51,23,28,61
Lucerne,676,3,13,9,10,41,40,1,48
FC Zürich,676,4,11,11,10,43,35,8,44
St Gallen,676,5,13,4,15,39,53,-14,43
Grasshoppers,676,6,9,8,15,42,48,-6,35
FC Lugano,676,7,10,5,17,30,50,-20,35
FC Thun,676,8,9,6,17,46,61,-15,33
FC Sion,676,9,5,9,18,36,59,-23,24
Young Boys,677,1,21,7,4,73,40,33,70
FC Basel,677,2,19,8,5,60,24,36,65
St Gallen,677,3,15,2,15,42,54,-12,47
Lucerne,677,4,13,7,12,49,48,1,46
FC Zürich,677,5,9,11,12,43,41,2,38
FC Sion,677,6,9,8,15,43,52,-9,35
FC Thun,677,7,10,5,17,45,58,-13,35
FC Lugano,677,8,9,7,16,33,54,-21,34
Grasshoppers,677,9,8,7,17,37,54,-17,31
Young Boys,678,1,22,6,4,73,36,37,72
FC Basel,678,2,18,8,6,55,25,30,62
St Gallen,678,3,15,2,15,43,54,-11,47
Lucerne,678,4,13,7,12,43,44,-1,46
FC Zürich,678,5,10,10,12,42,39,3,40
FC Thun,678,6,10,7,15,45,57,-12,37
FC Lugano,678,7,10,6,16,28,47,-19,36
Grasshoppers,678,8,9,8,15,43,52,-9,35
FC Sion,678,9,6,8,18,39,57,-18,26
Young Boys,679,1,20,8,4,67,36,31,68
FC Basel,679,2,18,9,5,57,23,34,63
Lucerne,679,3,14,8,10,46,42,4,50
FC Zürich,679,4,11,10,11,41,35,6,43
St Gallen,679,5,13,4,15,43,56,-13,43
FC Lugano,679,6,10,6,16,32,48,-16,36
FC Thun,679,7,10,6,16,44,62,-18,36
Grasshoppers,679,8,9,8,15,41,49,-8,35
FC Sion,679,9,6,7,19,40,60,-20,25
Young Boys,680,1,21,7,4,72,36,36,70
FC Basel,680,2,18,9,5,55,23,32,63
Lucerne,680,3,13,7,12,43,47,-4,46
FC Zürich,680,4,11,11,10,42,35,7,44
St Gallen,680,5,13,3,16,40,55,-15,42
FC Lugano,680,6,11,6,15,34,47,-13,39
Grasshoppers,680,7,10,6,16,42,53,-11,36
FC Thun,680,8,9,8,15,42,56,-14,35
FC Sion,680,9,5,9,18,41,59,-18,24
Young Boys,681,1,24,6,2,79,33,46,78
FC Basel,681,2,16,9,7,50,27,23,57
FC Zürich,681,3,12,10,10,44,33,11,46
Lucerne,681,4,12,9,11,41,43,-2,45
St Gallen,681,5,14,3,15,43,55,-12,45
Grasshoppers,681,6,10,7,15,43,53,-10,37
FC Lugano,681,7,10,5,17,29,51,-22,35
FC Thun,681,8,8,6,18,40,59,-19,30
FC Sion,681,9,6,9,17,40,55,-15,27
Young Boys,682,1,20,8,4,70,37,33,68
FC Basel,682,2,19,7,6,53,23,30,64
St Gallen,682,3,16,2,14,46,53,-7,50
Lucerne,682,4,13,8,11,42,46,-4,47
FC Zürich,682,5,10,10,12,39,36,3,40
FC Lugano,682,6,9,8,15,29,45,-16,35
Grasshoppers,682,7,9,7,16,40,48,-8,34
FC Thun,682,8,9,5,18,41,59,-18,32
FC Sion,682,9,8,7,17,43,56,-13,31
Young Boys,683,1,20,10,2,69,31,38,70
FC Basel,683,2,17,8,7,57,30,27,59
Lucerne,683,3,14,7,11,42,45,-3,49
St Gallen,683,4,15,2,15,44,58,-14,47
FC Zürich,683,5,10,11,11,40,38,2,41
FC Lugano,683,6,10,6,16,31,46,-15,36
Grasshoppers,683,7,9,7,16,39,48,-9,34
FC Thun,683,8,9,6,17,43,59,-16,33
FC Sion,683,9,7,9,16,41,51,-10,30
Young Boys,684,1,21,8,3,74,37,37,71
FC Basel,684,2,17,8,7,55,31,24,59
Lucerne,684,3,14,9,9,46,42,4,51
FC Zürich,684,4,11,11,10,44,35,9,44
St Gallen,684,5,14,2,16,39,59,-20,44
Grasshoppers,684,6,10,6,16,45,54,-9,36
FC Thun,684,7,9,7,16,46,61,-15,34
FC Lugano,684,8,9,6,17,27,47,-20,33
FC Sion,684,9,6,9,17,46,56,-10,27
Young Boys,685,1,23,7,2,77,33,44,76
FC Basel,685,2,17,8,7,54,28,26,59
Lucerne,685,3,14,7,11,45,46,-1,49
St Gallen,685,4,14,2,16,44,55,-11,44
FC Zürich,685,5,11,10,11,40,35,5,43
FC Lugano,685,6,12,5,15,35,48,-13,41
FC Thun,685,7,10,5,17,43,60,-17,35
Grasshoppers,685,8,8,8,16,39,50,-11,32
FC Sion,685,9,5,8,19,35,57,-22,23
Young Boys,686,1,23,6,3,79,32,47,75
FC Basel,686,2,17,7,8,52,29,23,58
St Gallen,686,3,15,2,15,45,54,-9,47
Lucerne,686,4,12,8,12,38,46,-8,44
FC Zürich,686,5,11,10,11,42,38,4,43
FC Lugano,686,6,11,6,15,32,49,-17,39
Grasshoppers,686,7,10,8,14,43,47,-4,38
FC Thun,686,8,10,5,17,47,62,-15,35
FC Sion,686,9,5,8,19,39,60,-21,23
Young Boys,687,1,23,7,2,73,32,41,76
FC Basel,687,2,17,9,6,52,24,28,60
St Gallen,687,3,14,5,13,44,54,-10,47
Lucerne,687,4,12,9,11,42,42,0,45
FC Zürich,687,5,10,12,10,40,35,5,42
FC Lugano,687,6,9,7,16,32,51,-19,34
FC Thun,687,7,9,5,18,43,62,-19,32
Grasshoppers,687,8,8,7,17,38,50,-12,31
FC Sion,687,9,7,9,16,41,55,-14,30
Young Boys,688,1,22,7,3,72,36,36,73
FC Basel,688,2,18,8,6,54,25,29,62
St Gallen,688,3,15,2,15,45,55,-10,47
Lucerne,688,4,13,7,12,42,46,-4,46
FC Lugano,688,5,11,5,16,31,50,-19,38
FC Zürich,688,6,9,10,13,39,39,0,37
FC Thun,688,7,10,5,17,48,60,-12,35
Grasshoppers,688,8,9,6,17,43,53,-10,33
FC Sion,688,9,8,8,16,43,53,-10,32
Young Boys,689,1,22,6,4,74,35,39,72
FC Basel,689,2,18,8,6,54,25,29,62
FC Zürich,689,3,13,9,10,44,35,9,48
St Gallen,689,4,14,3,15,41,52,-11,45
Lucerne,689,5,12,8,12,41,50,-9,44
FC Lugano,689,6,10,6,16,32,48,-16,36
FC Thun,689,7,9,7,16,42,57,-15,34
Grasshoppers,689,8,8,9,15,39,49,-10,33
FC Sion,689,9,6,8,18,36,52,-16,26
Young Boys,690,1,22,8,2,73,33,40,74
FC Basel,690,2,16,10,6,57,28,29,58
St Gallen,690,3,14,4,14,44,55,-11,46
Lucerne,690,4,11,11,10,45,47,-2,44
FC Zürich,690,5,11,10,11,41,35,6,43
FC Lugano,690,6,10,6,16,31,49,-18,36
Grasshoppers,690,7,9,7,16,40,50,-10,34
FC Sion,690,8,7,10,15,41,51,-10,31
FC Thun,690,9,8,6,18,41,65,-24,30
Young Boys,691,1,22,7,3,76,34,42,73
FC Basel,691,2,17,10,5,51,23,28,61
Lucerne,691,3,12,11,9,46,42,4,47
St Gallen,691,4,13,5,14,41,53,-12,44
FC Zürich,691,5,10,11,11,42,36,6,41
Grasshoppers,691,6,9,7,16,43,56,-13,34
FC Lugano,691,7,9,7,16,30,52,-22,34
FC Thun,691,8,8,7,17,41,59,-18,31
FC Sion,691,9,7,9,16,43,58,-15,30
Young Boys,692,1,22,7,3,75,36,39,73
FC Basel,692,2,15,8,9,48,28,20,53
Lucerne,692,3,13,9,10,44,44,0,48
St Gallen,692,4,14,4,14,45,56,-11,46
FC Zürich,692,5,10,9,13,40,40,0,39
FC Lugano,692,6,11,5,16,35,51,-16,38
Grasshoppers,692,7,10,7,15,41,49,-8,37
FC Thun,692,8,10,5,17,42,58,-16,35
FC Sion,692,9,8,8,16,44,52,-8,32
Young Boys,693,1,22,7,3,69,33,36,73
FC Basel,693,2,19,7,6,54,24,30,64
Lucerne,693,3,14,8,10,45,39,6,50
FC Zürich,693,4,12,9,11,42,35,7,45
St Gallen,693,5,13,3,16,41,57,-16,42
Grasshoppers,693,6,10,6,16,42,51,-9,36
FC Lugano,693,7,10,5,17,31,51,-20,35
FC Thun,693,8,9,5,18,43,63,-20,32
FC Sion,693,9,6,8,18,41,55,-14,26
Young Boys,694,1,23,7,2,76,35,41,76
FC Basel,694,2,18,8,6,54,27,27,62
St Gallen,694,3,15,3,14,42,51,-9,48
FC Zürich,694,4,11,11,10,45,36,9,44
Lucerne,694,5,12,7,13,40,44,-4,43
Grasshoppers,694,6,10,7,15,43,51,-8,37
FC Lugano,694,7,9,6,17,29,50,-21,33
FC Thun,694,8,8,6,18,42,62,-20,30
FC Sion,694,9,7,7,18,42,57,-15,28
Young Boys,695,1,21,9,2,69,33,36,72
FC Basel,695,2,19,8,5,57,24,33,65
St Gallen,695,3,14,3,15,44,58,-14,45
FC Zürich,695,4,11,10,11,43,34,9,43
Lucerne,695,5,12,7,13,41,46,-5,43
Grasshoppers,695,6,10,7,15,43,49,-6,37
FC Lugano,695,7,10,6,16,33,50,-17,36
FC Thun,695,8,8,6,18,46,69,-23,30
FC Sion,695,9,6,10,16,42,55,-13,28
Young Boys,696,1,22,8,2,74,31,43,74
FC Basel,696,2,19,7,6,57,28,29,64
St Gallen,696,3,15,2,15,45,55,-10,47
Lucerne,696,4,12,8,12,39,45,-6,44
FC Zürich,696,5,9,11,12,41,39,2,38
FC Lugano,696,6,10,6,16,32,51,-19,36
Grasshoppers,696,7,9,8,15,40,47,-7,35
FC Thun,696,8,9,7,16,44,61,-17,34
FC Sion,696,9,6,9,17,44,59,-15,27
Young Boys,697,1,20,7,5,67,36,31,67
FC Basel,697,2,19,7,6,58,26,32,64
St Gallen,697,3,15,2,15,44,53,-9,47
Lucerne,697,4,12,9,11,41,44,-3,45
FC Zürich,697,5,10,9,13,39,40,-1,39
FC Lugano,697,6,11,6,15,31,45,-14,39
Grasshoppers,697,7,10,6,16,40,51,-11,36
FC Thun,697,8,10,5,17,45,62,-17,35
FC Sion,697,9,8,7,17,44,52,-8,31
Young Boys,698,1,22,8,2,73,32,41,74
FC Basel,698,2,18,9,5,56,25,31,63
Lucerne,698,3,14,8,10,47,43,4,50
FC Zürich,698,4,11,10,11,42,36,6,43
St Gallen,698,5,13,4,15,45,59,-14,43
FC Lugano,698,6,10,5,17,31,55,-24,35
Grasshoppers,698,7,9,6,17,40,53,-13,33
FC Thun,698,8,8,6,18,39,59,-20,30
FC Sion,698,9,7,8,17,43,54,-11,29
Young Boys,699,1,24,6,2,72,32,40,78
FC Basel,699,2,17,8,7,52,27,25,59
Lucerne,699,3,12,10,10,39,41,-2,46
St Gallen,699,4,13,5,14,41,53,-12,44
FC Lugano,699,5,10,7,15,30,45,-15,37
FC Zürich,699,6,9,9,14,36,37,-1,36
FC Thun,699,7,10,5,17,43,57,-14,35
FC Sion,699,8,8,8,16,42,52,-10,32
Grasshoppers,699,9,8,8,16,38,49,-11,32
Young Boys,700,1,22,7,3,70,36,34,73
FC Basel,700,2,19,7,6,57,26,31,64
St Gallen,700,3,14,3,15,44,56,-12,45
Lucerne,700,4,11,9,12,37,43,-6,42
FC Zürich,700,5,10,11,11,39,35,4,41
FC Lugano,700,6,9,8,15,29,45,-16,35
FC Sion,700,7,8,9,15,44,51,-7,33
Grasshoppers,700,8,9,6,17,39,50,-11,33
FC Thun,700,9,9,6,17,41,58,-17,33
Young Boys,701,1,22,6,4,67,31,36,72
FC Basel,701,2,19,8,5,57,25,32,65
St Gallen,701,3,15,2,15,45,56,-11,47
Lucerne,701,4,12,8,12,41,44,-3,44
Grasshoppers,701,5,11,7,14,44,47,-3,40
FC Zürich,701,6,9,10,13,40,41,-1,37
FC Lugano,701,7,10,5,17,31,50,-19,35
FC Thun,701,8,9,7,16,45,63,-18,34
FC Sion,701,9,7,7,18,44,57,-13,28
Young Boys,702,1,22,7,3,76,36,40,73
FC Basel,702,2,17,9,6,49,23,26,60
St Gallen,702,3,15,3,14,44,56,-12,48
Lucerne,702,4,13,7,12,39,44,-5,46
FC Lugano,702,5,12,5,15,37,47,-10,41
FC Zürich,702,6,9,9,14,36,41,-5,36
FC Thun,702,7,10,5,17,46,58,-12,35
Grasshoppers,702,8,9,6,17,43,51,-8,33
FC Sion,702,9,8,7,17,43,57,-14,31
Young Boys,703,1,22,6,4,69,35,34,72
FC Basel,703,2,19,7,6,57,26,31,64
St Gallen,703,3,16,2,14,49,56,-7,50
Lucerne,703,4,13,7,12,47,46,1,46
FC Zürich,703,5,11,9,12,40,38,2,42
FC Lugano,703,6,10,5,17,31,50,-19,35
Grasshoppers,703,7,9,6,17,39,53,-14,33
FC Thun,703,8,9,6,17,43,58,-15,33
FC Sion,703,9,7,8,17,40,53,-13,29
Young Boys,704,1,22,7,3,72,36,36,73
FC Basel,704,2,19,8,5,57,24,33,65
Lucerne,704,3,12,8,12,42,51,-9,44
St Gallen,704,4,14,2,16,42,54,-12,44
FC Zürich,704,5,10,11,11,40,34,6,41
FC Lugano,704,6,11,6,15,33,47,-14,39
Grasshoppers,704,7,9,7,16,41,49,-8,34
FC Sion,704,8,7,9,16,42,52,-10,30
FC Thun,704,9,8,6,18,39,61,-22,30
Young Boys,705,1,21,8,3,74,36,38,71
FC Basel,705,2,19,8,5,58,24,34,65
Lucerne,705,3,13,8,11,42,46,-4,47
St Gallen,705,4,14,3,15,42,54,-12,45
FC Zürich,705,5,10,10,12,41,38,3,40
FC Lugano,705,6,11,5,16,32,51,-19,38
Grasshoppers,705,7,8,8,16,44,54,-10,32
FC Sion,705,8,7,10,15,47,58,-11,31
FC Thun,705,9,8,6,18,45,64,-19,30
Young Boys,706,1,23,6,3,76,35,41,75
FC Basel,706,2,16,7,9,49,32,17,55
Lucerne,706,3,14,8,10,42,40,2,50
St Gallen,706,4,14,3,15,41,53,-12,45
FC Zürich,706,5,11,10,11,43,35,8,43
Grasshoppers,706,6,11,6,15,46,49,-3,39
FC Thun,706,7,11,5,16,46,59,-13,38
FC Lugano,706,8,10,6,16,30,47,-17,36
FC Sion,706,9,5,7,20,38,61,-23,22
Young Boys,707,1,23,7,2,74,34,40,76
FC Basel,707,2,17,9,6,58,27,31,60
St Gallen,707,3,16,3,13,45,50,-5,51
FC Zürich,707,4,10,12,10,40,35,5,42
Lucerne,707,5,11,8,13,39,47,-8,41
FC Lugano,707,6,9,7,16,29,47,-18,34
Grasshoppers,707,7,9,6,17,42,53,-11,33
FC Thun,707,8,9,6,17,42,62,-20,33
FC Sion,707,9,7,8,17,41,55,-14,29
Young Boys,708,1,22,8,2,72,33,39,74
FC Basel,708,2,16,9,7,50,25,25,57
Lucerne,708,3,13,8,11,41,48,-7,47
St Gallen,708,4,15,2,15,42,53,-11,47
FC Zürich,708,5,11,10,11,42,36,6,43
Grasshoppers,708,6,10,6,16,45,50,-5,36
FC Lugano,708,7,10,5,17,28,47,-19,35
FC Thun,708,8,9,7,16,42,55,-13,34
FC Sion,708,9,6,9,17,41,56,-15,27
Young Boys,709,1,21,8,3,67,33,34,71
FC Basel,709,2,17,8,7,56,25,31,59
Lucerne,709,3,12,8,12,41,47,-6,44
St Gallen,709,4,14,2,16,42,58,-16,44
FC Zürich,709,5,11,10,11,44,38,6,43
Grasshoppers,709,6,11,7,14,44,48,-4,40
FC Lugano,709,7,11,7,14,37,46,-9,40
FC Thun,709,8,9,5,18,42,63,-21,32
FC Sion,709,9,7,7,18,41,56,-15,28
Young Boys,710,1,21,7,4,73,37,36,70
FC Basel,710,2,17,8,7,55,29,26,59
FC Zürich,710,3,13,9,10,45,34,11,48
St Gallen,710,4,15,2,15,45,53,-8,47
Lucerne,710,5,13,7,12,43,50,-7,46
Grasshoppers,710,6,11,6,15,45,49,-4,39
FC Sion,710,7,8,8,16,41,52,-11,32
FC Lugano,710,8,9,5,18,30,54,-24,32
FC Thun,710,9,8,6,18,44,63,-19,30
Young Boys,711,1,23,6,3,77,39,38,75
FC Basel,711,2,18,7,7,51,25,26,61
St Gallen,711,3,16,2,14,45,52,-7,50
FC Zürich,711,4,12,10,10,44,36,8,46
Lucerne,711,5,12,8,12,41,46,-5,44
Grasshoppers,711,6,10,8,14,42,45,-3,38
FC Thun,711,7,9,6,17,46,60,-14,33
FC Lugano,711,8,9,6,17,29,48,-19,33
FC Sion,711,9,5,7,20,42,66,-24,22
Young Boys,712,1,20,9,3,78,39,39,69
FC Basel,712,2,16,9,7,52,29,23,57
Lucerne,712,3,14,8,10,48,45,3,50
St Gallen,712,4,14,4,14,45,54,-9,46
FC Zürich,712,5,10,11,11,39,34,5,41
Grasshoppers,712,6,9,8,15,42,50,-8,35
FC Lugano,712,7,10,5,17,30,56,-26,35
FC Thun,712,8,8,8,16,42,58,-16,32
FC Sion,712,9,7,10,15,43,54,-11,31
Young Boys,713,1,21,6,5,67,36,31,69
FC Basel,713,2,18,8,6,57,26,31,62
St Gallen,713,3,15,3,14,44,53,-9,48
Lucerne,713,4,12,8,12,40,45,-5,44
FC Zürich,713,5,10,11,11,40,36,4,41
Grasshoppers,713,6,11,7,14,42,46,-4,40
FC Lugano,713,7,10,5,17,28,47,-19,35
FC Thun,713,8,9,5,18,39,57,-18,32
FC Sion,713,9,7,9,16,40,51,-11,30
Young Boys,714,1,22,6,4,77,40,37,72
FC Basel,714,2,17,8,7,55,28,27,59
Lucerne,714,3,15,7,10,45,43,2,52
St Gallen,714,4,14,2,16,40,58,-18,44
FC Zürich,714,5,11,10,11,40,35,5,43
FC Lugano,714,6,11,5,16,31,46,-15,38
FC Thun,714,7,10,6,16,44,58,-14,36
Grasshoppers,714,8,9,6,17,43,53,-10,33
FC Sion,714,9,6,8,18,41,55,-14,26
Young Boys,715,1,24,6,2,77,32,45,78
FC Basel,715,2,16,7,9,48,30,18,55
Lucerne,715,3,15,7,10,46,41,5,52
St Gallen,715,4,15,2,15,41,54,-13,47
FC Zürich,715,5,11,9,12,44,38,6,42
FC Lugano,715,6,11,5,16,33,50,-17,38
FC Thun,715,7,9,7,16,43,57,-14,34
Grasshoppers,715,8,8,8,16,41,51,-10,32
FC Sion,715,9,5,9,18,40,60,-20,24
Young Boys,716,1,21,6,5,66,35,31,69
FC Basel,716,2,20,7,5,60,22,38,67
Lucerne,716,3,13,7,12,38,46,-8,46
St Gallen,716,4,14,2,16,43,57,-14,44
FC Zürich,716,5,11,9,12,41,36,5,42
Grasshoppers,716,6,10,6,16,41,50,-9,36
FC Lugano,716,7,10,5,17,30,46,-16,35
FC Sion,716,8,9,7,16,44,51,-7,34
FC Thun,716,9,9,5,18,42,62,-20,32
Young Boys,717,1,20,7,5,70,40,30,67
FC Basel,717,2,17,9,6,53,27,26,60
Lucerne,717,3,13,8,11,43,46,-3,47
St Gallen,717,4,14,4,14,46,54,-8,46
FC Zürich,717,5,11,10,11,39,36,3,43
FC Thun,717,6,9,8,15,45,57,-12,35
FC Lugano,717,7,9,8,15,30,47,-17,35
Grasshoppers,717,8,9,7,16,41,49,-8,34
FC Sion,717,9,7,9,16,41,52,-11,30
Young Boys,718,1,22,7,3,70,34,36,73
FC Basel,718,2,19,8,5,57,24,33,65
Lucerne,718,3,14,7,11,41,41,0,49
St Gallen,718,4,14,3,15,42,55,-13,45
FC Zürich,718,5,10,11,11,43,39,4,41
FC Thun,718,6,11,5,16,43,56,-13,38
FC Lugano,718,7,9,6,17,32,50,-18,33
Grasshoppers,718,8,8,7,17,39,53,-14,31
FC Sion,718,9,5,10,17,41,56,-15,25
Young Boys,719,1,22,7,3,73,32,41,73
FC Basel,719,2,18,9,5,51,22,29,63
Lucerne,719,3,13,8,11,42,45,-3,47
St Gallen,719,4,15,2,15,46,53,-7,47
FC Lugano,719,5,11,5,16,31,46,-15,38
FC Zürich,719,6,9,10,13,38,37,1,37
Grasshoppers,719,7,10,6,16,42,54,-12,36
FC Thun,719,8,10,5,17,46,58,-12,35
FC Sion,719,9,6,8,18,38,60,-22,26
Young Boys,720,1,19,7,6,67,37,30,64
FC Basel,720,2,18,8,6,54,26,28,62
Lucerne,720,3,14,7,11,41,40,1,49
St Gallen,720,4,15,4,13,43,52,-9,49
FC Zürich,720,5,12,9,11,44,38,6,45
Grasshoppers,720,6,10,6,16,40,47,-7,36
FC Thun,720,7,9,6,17,41,59,-18,33
FC Lugano,720,8,9,6,17,30,48,-18,33
FC Sion,720,9,7,9,16,42,55,-13,30
Young Boys,721,1,21,7,4,70,38,32,70
FC Basel,721,2,17,9,6,56,27,29,60
FC Zürich,721,3,12,10,10,43,35,8,46
Lucerne,721,4,12,8,12,41,43,-2,44
St Gallen,721,5,14,2,16,41,59,-18,44
Grasshoppers,721,6,11,6,15,43,48,-5,39
FC Lugano,721,7,10,6,16,35,50,-15,36
FC Sion,721,8,8,8,16,45,53,-8,32
FC Thun,721,9,8,6,18,43,64,-21,30
Young Boys,722,1,21,7,4,70,37,33,70
FC Basel,722,2,19,8,5,56,23,33,65
Lucerne,722,3,12,9,11,43,46,-3,45
FC Zürich,722,4,11,11,10,42,36,6,44
St Gallen,722,5,13,4,15,40,54,-14,43
FC Lugano,722,6,10,7,15,30,45,-15,37
Grasshoppers,722,7,9,8,15,42,50,-8,35
FC Thun,722,8,8,7,17,44,62,-18,31
FC Sion,722,9,5,11,16,41,55,-14,26
Young Boys,723,1,20,8,4,67,32,35,68
FC Basel,723,2,17,9,6,54,25,29,60
Lucerne,723,3,14,8,10,40,42,-2,50
St Gallen,723,4,15,2,15,43,53,-10,47
FC Zürich,723,5,9,11,12,41,39,2,38
FC Lugano,723,6,10,6,16,30,49,-19,36
Grasshoppers,723,7,9,7,16,38,47,-9,34
FC Thun,723,8,9,7,16,40,55,-15,34
FC Sion,723,9,7,10,15,38,49,-11,31
Young Boys,724,1,24,6,2,77,34,43,78
FC Basel,724,2,16,9,7,50,27,23,57
Lucerne,724,3,13,9,10,43,42,1,48
FC Zürich,724,4,12,10,10,45,32,13,46
St Gallen,724,5,13,6,13,41,52,-11,45
Grasshoppers,724,6,9,7,16,41,55,-14,34
FC Lugano,724,7,9,6,17,27,48,-21,33
FC Thun,724,8,8,6,18,40,58,-18,30
FC Sion,724,9,6,9,17,41,57,-16,27
Young Boys,725,1,21,7,4,71,37,34,70
FC Basel,725,2,18,9,5,55,23,32,63
St Gallen,725,3,15,3,14,42,52,-10,48
Lucerne,725,4,12,9,11,40,41,-1,45
FC Zürich,725,5,10,11,11,42,39,3,41
Grasshoppers,725,6,10,6,16,41,51,-10,36
FC Lugano,725,7,10,5,17,33,53,-20,35
FC Thun,725,8,9,7,16,43,58,-15,34
FC Sion,725,9,6,9,17,42,55,-13,27
Young Boys,726,1,23,6,3,71,31,40,75
FC Basel,726,2,17,7,8,56,34,22,58
FC Zürich,726,3,11,10,11,46,41,5,43
Lucerne,726,4,11,9,12,38,44,-6,42
St Gallen,726,5,13,3,16,40,54,-14,42
FC Thun,726,6,11,5,16,48,58,-10,38
FC Lugano,726,7,11,5,16,30,47,-17,38
Grasshoppers,726,8,9,8,15,42,50,-8,35
FC Sion,726,9,7,9,16,41,53,-12,30
Young Boys,727,1,21,8,3,71,34,37,71
FC Basel,727,2,16,9,7,52,26,26,57
Lucerne,727,3,13,10,9,40,39,1,49
St Gallen,727,4,15,4,13,45,52,-7,49
FC Zürich,727,5,12,9,11,42,36,6,45
FC Lugano,727,6,11,6,15,34,47,-13,39
Grasshoppers,727,7,9,6,17,37,49,-12,33
FC Thun,727,8,9,5,18,42,61,-19,32
FC Sion,727,9,6,7,19,38,57,-19,25
Young Boys,728,1,22,7,3,74,38,36,73
FC Basel,728,2,19,8,5,59,26,33,65
St Gallen,728,3,15,2,15,43,54,-11,47
Lucerne,728,4,12,9,11,39,40,-1,45
FC Zürich,728,5,10,10,12,40,36,4,40
FC Lugano,728,6,10,6,16,31,47,-16,36
Grasshoppers,728,7,8,8,16,39,50,-11,32
FC Thun,728,8,8,7,17,42,64,-22,31
FC Sion,728,9,7,9,16,39,51,-12,30
Young Boys,729,1,20,7,5,69,39,30,67
FC Basel,729,2,19,7,6,56,22,34,64
Lucerne,729,3,14,8,10,44,41,3,50
St Gallen,729,4,15,3,14,49,55,-6,48
FC Zürich,729,5,11,9,12,41,37,4,42
Grasshoppers,729,6,10,6,16,42,53,-11,36
FC Thun,729,7,10,5,17,46,61,-15,35
FC Lugano,729,8,9,8,15,32,49,-17,35
FC Sion,729,9,6,7,19,39,61,-22,25
Young Boys,730,1,21,7,4,69,34,35,70
FC Basel,730,2,18,8,6,53,24,29,62
Lucerne,730,3,14,7,11,45,44,1,49
St Gallen,730,4,13,3,16,41,56,-15,42
FC Lugano,730,5,11,6,15,31,45,-14,39
FC Zürich,730,6,9,11,12,38,36,2,38
Grasshoppers,730,7,10,7,15,39,49,-10,37
FC Thun,730,8,9,8,15,43,57,-14,35
FC Sion,730,9,6,9,17,39,53,-14,27
Young Boys,731,1,23,7,2,74,35,39,76
FC Basel,731,2,17,7,8,53,30,23,58
Lucerne,731,3,13,8,11,40,44,-4,47
St Gallen,731,4,15,2,15,44,56,-12,47
FC Zürich,731,5,12,9,11,42,35,7,45
FC Thun,731,6,10,6,16,41,55,-14,36
FC Lugano,731,7,9,7,16,31,48,-17,34
Grasshoppers,731,8,8,7,17,38,51,-13,31
FC Sion,731,9,7,7,18,43,52,-9,28
Young Boys,732,1,23,6,3,73,34,39,75
FC Basel,732,2,17,8,7,55,27,28,59
St Gallen,732,3,14,3,15,43,55,-12,45
Lucerne,732,4,12,7,13,41,50,-9,43
FC Zürich,732,5,11,9,12,43,37,6,42
FC Lugano,732,6,12,5,15,35,46,-11,41
Grasshoppers,732,7,10,7,15,42,47,-5,37
FC Thun,732,8,8,7,17,38,59,-21,31
FC Sion,732,9,6,10,16,38,53,-15,28
Young Boys,733,1,24,6,2,75,34,41,78
FC Basel,733,2,17,8,7,53,26,27,59
FC Zürich,733,3,12,10,10,44,34,10,46
Lucerne,733,4,12,9,11,42,43,-1,45
St Gallen,733,5,14,3,15,44,56,-12,45
FC Lugano,733,6,10,6,16,29,49,-20,36
FC Thun,733,7,10,5,17,41,58,-17,35
Grasshoppers,733,8,9,7,16,40,50,-10,34
FC Sion,733,9,5,8,19,38,56,-18,23
Young Boys,734,1,20,7,5,68,39,29,67
FC Basel,734,2,18,9,5,56,26,30,63
Lucerne,734,3,13,8,11,48,44,4,47
St Gallen,734,4,15,2,15,43,54,-11,47
FC Zürich,734,5,10,10,12,40,37,3,40
FC Lugano,734,6,11,6,15,33,47,-14,39
FC Thun,734,7,10,6,16,44,56,-12,36
Grasshoppers,734,8,8,7,17,39,54,-15,31
FC Sion,734,9,7,9,16,41,55,-14,30
Young Boys,735,1,21,8,3,72,36,36,71
FC Basel,735,2,16,10,6,50,26,24,58
FC Zürich,735,3,13,9,10,49,36,13,48
Lucerne,735,4,12,9,11,41,44,-3,45
St Gallen,735,5,14,3,15,42,55,-13,45
Grasshoppers,735,6,10,7,15,44,48,-4,37
FC Lugano,735,7,9,7,16,30,51,-21,34
FC Thun,735,8,8,7,17,43,62,-19,31
FC Sion,735,9,7,8,17,42,55,-13,29
Young Boys,736,1,21,9,2,69,33,36,72
FC Basel,736,2,18,8,6,56,26,30,62
St Gallen,736,3,15,2,15,42,52,-10,47
FC Zürich,736,4,11,11,10,43,36,7,44
Lucerne,736,5,11,9,12,42,47,-5,42
Grasshoppers,736,6,9,8,15,41,49,-8,35
FC Lugano,736,7,9,7,16,33,51,-18,34
FC Thun,736,8,9,6,17,41,60,-19,33
FC Sion,736,9,7,8,17,39,52,-13,29
Young Boys,737,1,23,6,3,71,33,38,75
FC Basel,737,2,17,8,7,55,28,27,59
Lucerne,737,3,13,7,12,41,45,-4,46
St Gallen,737,4,14,2,16,39,56,-17,44
FC Thun,737,5,12,5,15,50,60,-10,41
FC Zürich,737,6,9,11,12,42,40,2,38
FC Lugano,737,7,11,5,16,33,45,-12,38
Grasshoppers,737,8,8,7,17,40,53,-13,31
FC Sion,737,9,7,9,16,41,52,-11,30
Young Boys,738,1,21,8,3,71,36,35,71
FC Basel,738,2,18,8,6,54,28,26,62
Lucerne,738,3,13,10,9,44,42,2,49
St Gallen,738,4,14,3,15,46,59,-13,45
FC Zürich,738,5,9,11,12,38,36,2,38
FC Lugano,738,6,10,7,15,35,49,-14,37
Grasshoppers,738,7,9,7,16,40,48,-8,34
FC Sion,738,8,8,8,16,45,54,-9,32
FC Thun,738,9,8,6,18,41,62,-21,30
Young Boys,739,1,23,6,3,76,33,43,75
FC Basel,739,2,18,7,7,56,29,27,61
Lucerne,739,3,13,9,10,48,45,3,48
St Gallen,739,4,14,4,14,45,56,-11,46
FC Zürich,739,5,10,9,13,45,42,3,39
FC Lugano,739,6,10,6,16,33,54,-21,36
FC Thun,739,7,10,5,17,45,62,-17,35
Grasshoppers,739,8,8,8,16,42,56,-14,32
FC Sion,739,9,7,8,17,42,55,-13,29
Young Boys,740,1,20,7,5,73,37,36,67
FC Basel,740,2,17,10,5,52,23,29,61
Lucerne,740,3,14,8,10,44,42,2,50
FC Zürich,740,4,12,10,10,42,34,8,46
St Gallen,740,5,13,3,16,41,57,-16,42
Grasshoppers,740,6,10,6,16,40,51,-11,36
FC Lugano,740,7,10,5,17,30,52,-22,35
FC Thun,740,8,9,6,17,45,62,-17,33
FC Sion,740,9,8,7,17,47,56,-9,31
Young Boys,741,1,21,8,3,71,36,35,71
FC Basel,741,2,17,10,5,51,23,28,61
Lucerne,741,3,12,9,11,43,44,-1,45
St Gallen,741,4,13,4,15,40,54,-14,43
FC Zürich,741,5,10,10,12,46,39,7,40
Grasshoppers,741,6,10,7,15,42,49,-7,37
FC Lugano,741,7,10,6,16,35,53,-18,36
FC Thun,741,8,9,8,15,43,57,-14,35
FC Sion,741,9,7,8,17,43,59,-16,29
Young Boys,742,1,22,6,4,69,36,33,72
FC Basel,742,2,19,7,6,57,24,33,64
Lucerne,742,3,13,8,11,43,46,-3,47
St Gallen,742,4,14,3,15,41,52,-11,45
FC Zürich,742,5,11,11,10,40,34,6,44
FC Lugano,742,6,9,8,15,29,45,-16,35
FC Thun,742,7,9,5,18,41,59,-18,32
Grasshoppers,742,8,8,7,17,39,52,-13,31
FC Sion,742,9,7,9,16,39,50,-11,30
Young Boys,743,1,21,8,3,74,33,41,71
FC Basel,743,2,17,9,6,54,29,25,60
Lucerne,743,3,13,9,10,41,42,-1,48
St Gallen,743,4,13,3,16,40,57,-17,42
FC Lugano,743,5,11,6,15,33,46,-13,39
FC Zürich,743,6,9,10,13,37,39,-2,37
Grasshoppers,743,7,9,9,14,41,48,-7,36
FC Thun,743,8,10,6,16,45,58,-13,36
FC Sion,743,9,6,10,16,38,51,-13,28
Young Boys,744,1,23,7,2,73,32,41,76
FC Basel,744,2,18,9,5,54,24,30,63
Lucerne,744,3,13,7,12,40,44,-4,46
St Gallen,744,4,14,4,14,40,51,-11,46
FC Zürich,744,5,11,9,12,45,37,8,42
FC Lugano,744,6,10,6,16,29,47,-18,36
Grasshoppers,744,7,8,7,17,38,50,-12,31
FC Sion,744,8,8,7,17,43,56,-13,31
FC Thun,744,9,8,6,18,43,64,-21,30
Young Boys,745,1,22,7,3,76,37,39,73
FC Basel,745,2,17,9,6,55,28,27,60
Lucerne,745,3,13,9,10,43,43,0,48
St Gallen,745,4,14,3,15,42,59,-17,45
FC Zürich,745,5,9,11,12,40,40,0,38
FC Lugano,745,6,11,5,16,34,46,-12,38
FC Thun,745,7,9,7,16,43,58,-15,34
FC Sion,745,8,8,8,16,47,56,-9,32
Grasshoppers,745,9,8,7,17,42,55,-13,31
Young Boys,746,1,21,7,4,72,40,32,70
FC Basel,746,2,17,7,8,52,26,26,58
Lucerne,746,3,13,9,10,42,41,1,48
FC Zürich,746,4,12,10,10,42,35,7,46
St Gallen,746,5,14,2,16,41,54,-13,44
FC Lugano,746,6,10,6,16,34,50,-16,36
FC Thun,746,7,10,5,17,47,62,-15,35
FC Sion,746,8,8,8,16,46,56,-10,32
Grasshoppers,746,9,8,8,16,44,56,-12,32
Young Boys,747,1,23,6,3,79,38,41,75
FC Basel,747,2,16,9,7,49,26,23,57
Lucerne,747,3,14,7,11,46,45,1,49
St Gallen,747,4,15,3,14,47,52,-5,48
FC Zürich,747,5,9,12,11,38,35,3,39
Grasshoppers,747,6,10,7,15,45,51,-6,37
FC Lugano,747,7,9,6,17,28,56,-28,33
FC Thun,747,8,8,8,16,41,57,-16,32
FC Sion,747,9,7,8,17,40,53,-13,29
Young Boys,748,1,19,9,4,69,37,32,66
FC Basel,748,2,18,7,7,56,29,27,61
St Gallen,748,3,16,3,13,44,52,-8,51
Lucerne,748,4,14,7,11,45,45,0,49
FC Zürich,748,5,10,11,11,44,39,5,41
Grasshoppers,748,6,10,7,15,42,47,-5,37
FC Lugano,748,7,10,6,16,33,48,-15,36
FC Thun,748,8,9,6,17,41,59,-18,33
FC Sion,748,9,5,10,17,39,57,-18,25
Young Boys,749,1,22,8,2,69,31,38,74
FC Basel,749,2,17,9,6,54,27,27,60
Lucerne,749,3,13,9,10,43,41,2,48
St Gallen,749,4,15,2,15,45,55,-10,47
FC Zürich,749,5,10,10,12,38,35,3,40
Grasshoppers,749,6,10,6,16,39,47,-8,36
FC Lugano,749,7,9,6,17,29,50,-21,33
FC Sion,749,8,8,8,16,41,52,-11,32
FC Thun,749,9,8,6,18,41,61,-20,30
Young Boys,750,1,20,9,3,70,35,35,69
FC Basel,750,2,17,9,6,55,29,26,60
St Gallen,750,3,16,2,14,47,51,-4,50
Lucerne,750,4,13,9,10,44,41,3,48
FC Zürich,750,5,9,11,12,38,36,2,38
FC Lugano,750,6,10,7,15,30,47,-17,37
FC Thun,750,7,9,6,17,43,62,-19,33
FC Sion,750,8,8,8,16,40,51,-11,32
Grasshoppers,750,9,8,7,17,39,54,-15,31
Young Boys,751,1,20,6,6,66,37,29,66
FC Basel,751,2,18,8,6,54,26,28,62
Lucerne,751,3,13,9,10,42,40,2,48
St Gallen,751,4,13,5,14,43,56,-13,44
FC Zürich,751,5,10,11,11,41,37,4,41
FC Lugano,751,6,11,7,14,33,45,-12,40
Grasshoppers,751,7,9,8,15,41,49,-8,35
FC Thun,751,8,9,7,16,43,57,-14,34
FC Sion,751,9,6,9,17,37,53,-16,27
Young Boys,752,1,22,6,4,73,37,36,72
FC Basel,752,2,19,7,6,54,24,30,64
Lucerne,752,3,14,7,11,45,43,2,49
St Gallen,752,4,15,3,14,44,54,-10,48
FC Zürich,752,5,10,10,12,41,37,4,40
FC Thun,752,6,10,5,17,43,60,-17,35
Grasshoppers,752,7,9,7,16,39,48,-9,34
FC Lugano,752,8,9,7,16,30,49,-19,34
FC Sion,752,9,6,8,18,38,55,-17,26
Young Boys,753,1,22,7,3,77,35,42,73
FC Basel,753,2,17,9,6,53,27,26,60
FC Zürich,753,3,12,10,10,46,36,10,46
Lucerne,753,4,13,7,12,40,48,-8,46
St Gallen,753,5,14,3,15,43,54,-11,45
Grasshoppers,753,6,9,8,15,40,49,-9,35
FC Lugano,753,7,10,5,17,34,52,-18,35
FC Thun,753,8,9,7,16,44,60,-16,34
FC Sion,753,9,6,8,18,38,54,-16,26
Young Boys,754,1,21,7,4,72,36,36,70
FC Basel,754,2,19,8,5,59,26,33,65
St Gallen,754,3,15,2,15,45,58,-13,47
Lucerne,754,4,12,8,12,45,49,-4,44
FC Zürich,754,5,10,11,11,41,36,5,41
Grasshoppers,754,6,11,7,14,44,46,-2,40
FC Lugano,754,7,10,5,17,33,52,-19,35
FC Thun,754,8,9,6,17,45,61,-16,33
FC Sion,754,9,6,8,18,41,61,-20,26
Young Boys,755,1,21,6,5,71,36,35,69
FC Basel,755,2,19,8,5,54,21,33,65
St Gallen,755,3,16,3,13,46,50,-4,51
Lucerne,755,4,14,7,11,42,43,-1,49
FC Zürich,755,5,11,10,11,42,39,3,43
FC Thun,755,6,9,7,16,40,57,-17,34
Grasshoppers,755,7,9,6,17,39,50,-11,33
FC Lugano,755,8,9,5,18,31,52,-21,32
FC Sion,755,9,6,8,18,40,57,-17,26
Young Boys,756,1,21,8,3,73,36,37,71
FC Basel,756,2,17,9,6,54,22,32,60
St Gallen,756,3,15,3,14,42,53,-11,48
Lucerne,756,4,12,7,13,42,46,-4,43
FC Zürich,756,5,10,12,10,39,32,7,42
FC Lugano,756,6,9,8,15,31,50,-19,35
FC Thun,756,7,9,7,16,40,60,-20,34
Grasshoppers,756,8,9,6,17,43,53,-10,33
FC Sion,756,9,8,8,16,43,55,-12,32
Young Boys,757,1,21,8,3,71,33,38,71
FC Basel,757,2,16,10,6,50,27,23,58
Lucerne,757,3,13,10,9,44,40,4,49
St Gallen,757,4,14,5,13,42,52,-10,47
FC Zürich,757,5,11,10,11,42,36,6,43
FC Thun,757,6,10,6,16,44,57,-13,36
FC Lugano,757,7,10,5,17,30,48,-18,35
Grasshoppers,757,8,8,9,15,41,53,-12,33
FC Sion,757,9,5,9,18,38,56,-18,24
Young Boys,758,1,21,8,3,73,39,34,71
FC Basel,758,2,17,8,7,56,29,27,59
Lucerne,758,3,13,8,11,43,48,-5,47
St Gallen,758,4,14,4,14,42,54,-12,46
FC Zürich,758,5,11,11,10,41,35,6,44
Grasshoppers,758,6,10,7,15,46,49,-3,37
FC Lugano,758,7,10,6,16,34,48,-14,36
FC Sion,758,8,7,9,16,45,57,-12,30
FC Thun,758,9,8,5,19,40,61,-21,29
Young Boys,759,1,22,6,4,78,37,41,72
FC Basel,759,2,18,8,6,59,27,32,62
Lucerne,759,3,14,8,10,43,47,-4,50
FC Zürich,759,4,11,11,10,42,36,6,44
St Gallen,759,5,14,2,16,40,56,-16,44
FC Lugano,759,6,10,6,16,30,49,-19,36
FC Thun,759,7,10,5,17,47,61,-14,35
Grasshoppers,759,8,9,6,17,41,52,-11,33
FC Sion,759,9,6,8,18,39,54,-15,26
Young Boys,760,1,22,7,3,75,33,42,73
FC Basel,760,2,18,7,7,52,26,26,61
St Gallen,760,3,15,3,14,46,56,-10,48
FC Zürich,760,4,11,9,12,43,40,3,42
Lucerne,760,5,11,8,13,39,46,-7,41
Grasshoppers,760,6,10,8,14,42,47,-5,38
FC Lugano,760,7,11,5,16,32,49,-17,38
FC Thun,760,8,9,6,17,43,59,-16,33
FC Sion,760,9,7,7,18,43,59,-16,28
Young Boys,761,1,22,7,3,75,39,36,73
FC Basel,761,2,18,8,6,56,27,29,62
St Gallen,761,3,14,3,15,40,54,-14,45
Lucerne,761,4,12,7,13,41,45,-4,43
FC Zürich,761,5,9,12,11,39,36,3,39
FC Lugano,761,6,10,7,15,31,45,-14,37
FC Thun,761,7,10,6,16,44,56,-12,36
Grasshoppers,761,8,9,8,15,39,47,-8,35
FC Sion,761,9,7,8,17,36,52,-16,29
Young Boys,762,1,22,6,4,76,41,35,72
FC Basel,762,2,16,8,8,50,29,21,56
St Gallen,762,3,15,3,14,41,51,-10,48
Lucerne,762,4,12,8,12,45,47,-2,44
FC Zürich,762,5,11,10,11,45,38,7,43
FC Lugano,762,6,11,6,15,33,49,-16,39
Grasshoppers,762,7,10,6,16,43,51,-8,36
FC Thun,762,8,10,6,16,44,55,-11,36
FC Sion,762,9,6,9,17,39,55,-16,27
Young Boys,763,1,19,9,4,70,39,31,66
FC Basel,763,2,19,8,5,56,23,33,65
Lucerne,763,3,13,8,11,43,41,2,47
St Gallen,763,4,14,3,15,43,56,-13,45
FC Zürich,763,5,10,10,12,39,37,2,40
Grasshoppers,763,6,10,6,16,42,51,-9,36
FC Thun,763,7,10,5,17,42,59,-17,35
FC Lugano,763,8,9,8,15,31,49,-18,35
FC Sion,763,9,8,7,17,45,56,-11,31
Young Boys,764,1,21,7,4,68,34,34,70
FC Basel,764,2,18,9,5,56,26,30,63
Lucerne,764,3,13,9,10,41,43,-2,48
St Gallen,764,4,15,2,15,44,57,-13,47
FC Zürich,764,5,10,10,12,39,36,3,40
Grasshoppers,764,6,9,9,14,41,48,-7,36
FC Thun,764,7,9,8,15,47,58,-11,35
FC Lugano,764,8,9,5,18,28,48,-20,32
FC Sion,764,9,7,7,18,43,57,-14,28
Young Boys,765,1,22,7,3,77,36,41,73
FC Basel,765,2,20,7,5,58,27,31,67
Lucerne,765,3,12,9,11,39,43,-4,45
St Gallen,765,4,14,3,15,44,57,-13,45
FC Zürich,765,5,10,10,12,41,38,3,40
Grasshoppers,765,6,9,9,14,41,46,-5,36
FC Thun,765,7,10,6,16,44,57,-13,36
FC Lugano,765,8,10,5,17,33,50,-17,35
FC Sion,765,9,5,8,19,36,59,-23,23
Young Boys,766,1,21,6,5,73,35,38,69
FC Basel,766,2,19,8,5,57,24,33,65
Lucerne,766,3,13,9,10,41,44,-3,48
St Gallen,766,4,14,3,15,40,53,-13,45
FC Zürich,766,5,10,9,13,40,39,1,39
Grasshoppers,766,6,11,6,15,44,46,-2,39
FC Sion,766,7,9,7,16,42,53,-11,34
FC Thun,766,8,9,5,18,39,59,-20,32
FC Lugano,766,9,9,5,18,27,50,-23,32
Young Boys,767,1,21,8,3,75,39,36,71
FC Basel,767,2,18,8,6,57,28,29,62
Lucerne,767,3,13,9,10,50,47,3,48
St Gallen,767,4,14,3,15,42,58,-16,45
FC Zürich,767,5,11,10,11,40,36,4,43
Grasshoppers,767,6,10,7,15,45,51,-6,37
FC Lugano,767,7,10,6,16,29,46,-17,36
FC Thun,767,8,9,5,18,44,62,-18,32
FC Sion,767,9,6,8,18,41,56,-15,26
Young Boys,768,1,21,7,4,78,42,36,70
FC Basel,768,2,18,7,7,55,27,28,61
Lucerne,768,3,12,10,10,41,42,-1,46
FC Zürich,768,4,11,9,12,39,36,3,42
St Gallen,768,5,13,3,16,40,61,-21,42
FC Lugano,768,6,11,6,15,37,50,-13,39
Grasshoppers,768,7,9,9,14,43,47,-4,36
FC Sion,768,8,8,8,16,47,54,-7,32
FC Thun,768,9,9,5,18,40,61,-21,32
Young Boys,769,1,21,8,3,69,33,36,71
FC Basel,769,2,17,8,7,48,25,23,59
St Gallen,769,3,15,2,15,41,53,-12,47
FC Zürich,769,4,12,9,11,41,34,7,45
Lucerne,769,5,12,8,12,37,40,-3,44
FC Thun,769,6,10,7,15,42,54,-12,37
Grasshoppers,769,7,10,6,16,42,47,-5,36
FC Lugano,769,8,10,5,17,30,49,-19,35
FC Sion,769,9,6,9,17,38,53,-15,27
Young Boys,770,1,22,7,3,70,34,36,73
FC Basel,770,2,17,9,6,53,25,28,60
Lucerne,770,3,14,7,11,42,42,0,49
St Gallen,770,4,13,3,16,40,57,-17,42
FC Zürich,770,5,10,11,11,39,35,4,41
FC Lugano,770,6,11,7,14,35,45,-10,40
FC Thun,770,7,10,5,17,44,60,-16,35
Grasshoppers,770,8,8,7,17,39,51,-12,31
FC Sion,770,9,7,8,17,40,53,-13,29
Young Boys,771,1,21,6,5,71,39,32,69
FC Basel,771,2,18,8,6,61,25,36,62
St Gallen,771,3,16,3,13,44,51,-7,51
Lucerne,771,4,13,8,11,45,46,-1,47
FC Zürich,771,5,11,10,11,39,34,5,43
FC Thun,771,6,11,5,16,44,61,-17,38
Grasshoppers,771,7,10,6,16,41,50,-9,36
FC Lugano,771,8,9,7,16,30,47,-17,34
FC Sion,771,9,5,7,20,36,58,-22,22
Young Boys,772,1,21,9,2,70,33,37,72
FC Basel,772,2,16,9,7,50,26,24,57
St Gallen,772,3,16,2,14,49,55,-6,50
Lucerne,772,4,12,8,12,42,49,-7,44
FC Thun,772,5,12,5,15,45,54,-9,41
FC Lugano,772,6,11,6,15,34,46,-12,39
FC Zürich,772,7,9,10,13,38,39,-1,37
Grasshoppers,772,8,8,9,15,39,48,-9,33
FC Sion,772,9,6,8,18,40,57,-17,26
Young Boys,773,1,20,9,3,68,34,34,69
FC Basel,773,2,16,9,7,52,31,21,57
St Gallen,773,3,15,3,14,45,51,-6,48
Lucerne,773,4,12,7,13,41,44,-3,43
FC Zürich,773,5,11,9,12,40,35,5,42
FC Thun,773,6,10,7,15,45,58,-13,37
Grasshoppers,773,7,9,8,15,40,51,-11,35
FC Sion,773,8,9,7,16,42,49,-7,34
FC Lugano,773,9,9,7,16,28,48,-20,34
Young Boys,774,1,21,8,3,68,31,37,71
FC Basel,774,2,20,7,5,54,23,31,67
Lucerne,774,3,13,8,11,43,45,-2,47
St Gallen,774,4,14,2,16,42,55,-13,44
FC Zürich,774,5,11,9,12,40,37,3,42
FC Lugano,774,6,11,6,15,34,47,-13,39
Grasshoppers,774,7,9,7,16,41,53,-12,34
FC Thun,774,8,9,5,18,43,59,-16,32
FC Sion,774,9,6,8,18,37,52,-15,26
Young Boys,775,1,21,7,4,70,37,33,70
FC Basel,775,2,17,7,8,54,29,25,58
Lucerne,775,3,14,8,10,44,43,1,50
FC Zürich,775,4,11,9,12,42,39,3,42
St Gallen,775,5,13,3,16,42,57,-15,42
Grasshoppers,775,6,10,6,16,44,52,-8,36
FC Lugano,775,7,10,6,16,32,48,-16,36
FC Thun,775,8,10,5,17,45,59,-14,35
FC Sion,775,9,9,7,16,43,52,-9,34
Young Boys,776,1,22,7,3,75,41,34,73
FC Basel,776,2,17,8,7,53,25,28,59
St Gallen,776,3,16,2,14,45,52,-7,50
Lucerne,776,4,13,9,10,42,43,-1,48
FC Zürich,776,5,11,10,11,43,39,4,43
FC Thun,776,6,10,5,17,46,62,-16,35
FC Lugano,776,7,10,5,17,33,49,-16,35
Grasshoppers,776,8,9,6,17,43,51,-8,33
FC Sion,776,9,6,8,18,40,58,-18,26
Young Boys,777,1,23,7,2,75,35,40,76
FC Basel,777,2,18,7,7,60,28,32,61
Lucerne,777,3,12,9,11,41,47,-6,45
FC Zürich,777,4,11,9,12,41,38,3,42
St Gallen,777,5,13,3,16,41,58,-17,42
FC Lugano,777,6,11,6,15,33,47,-14,39
FC Sion,777,7,8,9,15,46,53,-7,33
FC Thun,777,8,9,5,18,45,65,-20,32
Grasshoppers,777,9,8,7,17,40,51,-11,31
Young Boys,778,1,21,7,4,70,37,33,70
FC Basel,778,2,17,7,8,50,25,25,58
St Gallen,778,3,15,2,15,43,54,-11,47
Lucerne,778,4,13,7,12,43,46,-3,46
FC Zürich,778,5,11,11,10,43,37,6,44
Grasshoppers,778,6,11,6,15,46,47,-1,39
FC Lugano,778,7,11,6,15,33,48,-15,39
FC Thun,778,8,9,7,16,43,59,-16,34
FC Sion,778,9,5,9,18,38,56,-18,24
Young Boys,779,1,21,8,3,73,35,38,71
FC Basel,779,2,18,9,5,52,24,28,63
FC Zürich,779,3,11,11,10,40,34,6,44
Lucerne,779,4,12,8,12,46,47,-1,44
St Gallen,779,5,14,2,16,42,57,-15,44
FC Lugano,779,6,10,7,15,32,47,-15,37
Grasshoppers,779,7,10,6,16,41,52,-11,36
FC Thun,779,8,10,5,17,42,56,-14,35
FC Sion,779,9,6,8,18,37,53,-16,26
Young Boys,780,1,21,8,3,70,35,35,71
FC Basel,780,2,19,8,5,58,25,33,65
St Gallen,780,3,14,3,15,43,55,-12,45
Lucerne,780,4,12,8,12,38,44,-6,44
FC Lugano,780,5,12,6,14,36,46,-10,42
FC Zürich,780,6,10,10,12,41,38,3,40
FC Thun,780,7,10,6,16,44,56,-12,36
Grasshoppers,780,8,8,7,17,36,48,-12,31
FC Sion,780,9,6,8,18,37,56,-19,26
Young Boys,781,1,19,10,3,69,36,33,67
FC Basel,781,2,17,9,6,52,28,24,60
Lucerne,781,3,13,8,11,41,41,0,47
St Gallen,781,4,15,2,15,42,54,-12,47
FC Zürich,781,5,10,11,11,39,37,2,41
FC Lugano,781,6,11,5,16,33,46,-13,38
FC Thun,781,7,10,7,15,46,57,-11,37
Grasshoppers,781,8,8,8,16,40,52,-12,32
FC Sion,781,9,6,10,16,41,52,-11,28
Young Boys,782,1,23,6,3,77,35,42,75
FC Basel,782,2,18,8,6,52,25,27,62
St Gallen,782,3,16,2,14,46,52,-6,50
Lucerne,782,4,12,7,13,42,48,-6,43
FC Zürich,782,5,10,11,11,44,38,6,41
Grasshoppers,782,6,9,7,16,38,48,-10,34
FC Thun,782,7,9,7,16,41,57,-16,34
FC Lugano,782,8,9,6,17,32,55,-23,33
FC Sion,782,9,7,8,17,44,58,-14,29
Young Boys,783,1,21,9,2,71,34,37,72
FC Basel,783,2,17,8,7,53,29,24,59
Lucerne,783,3,13,8,11,45,46,-1,47
FC Zürich,783,4,12,10,10,43,34,9,46
St Gallen,783,5,13,3,16,42,58,-16,42
FC Thun,783,6,10,7,15,46,58,-12,37
FC Lugano,783,7,10,7,15,34,50,-16,37
Grasshoppers,783,8,8,7,17,42,54,-12,31
FC Sion,783,9,6,9,17,41,54,-13,27
Young Boys,784,1,23,7,2,77,31,46,76
FC Basel,784,2,18,7,7,56,27,29,61
St Gallen,784,3,17,2,13,45,50,-5,53
Lucerne,784,4,12,7,13,44,50,-6,43
FC Zürich,784,5,9,10,13,38,42,-4,37
Grasshoppers,784,6,10,7,15,44,51,-7,37
FC Lugano,784,7,10,5,17,33,51,-18,35
FC Thun,784,8,9,6,17,42,62,-20,33
FC Sion,784,9,7,7,18,40,55,-15,28
Young Boys,785,1,20,7,5,69,36,33,67
FC Basel,785,2,17,9,6,53,24,29,60
Lucerne,785,3,14,8,10,45,44,1,50
St Gallen,785,4,14,4,14,43,55,-12,46
FC Zürich,785,5,9,11,12,39,37,2,38
Grasshoppers,785,6,10,6,16,42,48,-6,36
FC Thun,785,7,10,6,16,42,58,-16,36
FC Lugano,785,8,10,6,16,33,52,-19,36
FC Sion,785,9,7,9,16,41,53,-12,30
Young Boys,786,1,22,7,3,75,36,39,73
FC Basel,786,2,19,7,6,54,25,29,64
Lucerne,786,3,13,8,11,45,43,2,47
St Gallen,786,4,15,2,15,44,57,-13,47
FC Zürich,786,5,9,11,12,39,38,1,38
Grasshoppers,786,6,10,6,16,43,53,-10,36
FC Lugano,786,7,9,8,15,30,47,-17,35
FC Sion,786,8,8,7,17,45,58,-13,31
FC Thun,786,9,8,6,18,43,61,-18,30
Young Boys,787,1,24,6,2,71,31,40,78
FC Basel,787,2,18,7,7,55,27,28,61
St Gallen,787,3,14,5,13,42,52,-10,47
Lucerne,787,4,11,10,11,39,42,-3,43
FC Zürich,787,5,9,10,13,37,38,-1,37
FC Lugano,787,6,10,7,15,30,45,-15,37
Grasshoppers,787,7,9,7,16,40,49,-9,34
FC Thun,787,8,8,7,17,44,63,-19,31
FC Sion,787,9,7,9,16,40,51,-11,30
Young Boys,788,1,22,7,3,77,35,42,73
FC Basel,788,2,17,10,5,55,25,30,61
St Gallen,788,3,14,5,13,48,56,-8,47
Lucerne,788,4,12,9,11,43,48,-5,45
FC Zürich,788,5,11,11,10,43,35,8,44
Grasshoppers,788,6,9,8,15,39,48,-9,35
FC Lugano,788,7,9,6,17,32,56,-24,33
FC Thun,788,8,8,6,18,39,60,-21,30
FC Sion,788,9,6,10,16,37,50,-13,28
Young Boys,789,1,23,6,3,76,34,42,75
FC Basel,789,2,18,7,7,57,28,29,61
Lucerne,789,3,13,9,10,47,44,3,48
FC Zürich,789,4,11,10,11,40,37,3,43
St Gallen,789,5,13,4,15,43,58,-15,43
Grasshoppers,789,6,9,8,15,41,49,-8,35
FC Lugano,789,7,10,5,17,28,51,-23,35
FC Thun,789,8,8,6,18,42,61,-19,30
FC Sion,789,9,6,11,15,39,51,-12,29
Young Boys,790,1,22,7,3,74,37,37,73
FC Basel,790,2,17,9,6,56,28,28,60
St Gallen,790,3,15,3,14,45,53,-8,48
FC Zürich,790,4,11,11,10,44,36,8,44
Lucerne,790,5,11,8,13,43,50,-7,41
Grasshoppers,790,6,11,6,15,46,52,-6,39
FC Lugano,790,7,10,6,16,31,50,-19,36
FC Thun,790,8,8,7,17,44,61,-17,31
FC Sion,790,9,6,9,17,38,54,-16,27
Young Boys,791,1,21,8,3,68,35,33,71
FC Basel,791,2,18,8,6,55,25,30,62
St Gallen,791,3,15,3,14,42,52,-10,48
Lucerne,791,4,11,8,13,39,46,-7,41
FC Zürich,791,5,10,9,13,39,37,2,39
FC Thun,791,6,10,6,16,43,57,-14,36
FC Lugano,791,7,10,6,16,30,45,-15,36
Grasshoppers,791,8,9,8,15,39,47,-8,35
FC Sion,791,9,8,8,16,43,54,-11,32
Young Boys,792,1,24,6,2,74,31,43,78
FC Basel,792,2,18,8,6,55,27,28,62
Lucerne,792,3,13,7,12,42,46,-4,46
FC Zürich,792,4,11,10,11,43,37,6,43
St Gallen,792,5,13,3,16,41,55,-14,42
FC Lugano,792,6,10,6,16,32,50,-18,36
Grasshoppers,792,7,9,6,17,41,50,-9,33
FC Thun,792,8,9,6,17,42,59,-17,33
FC Sion,792,9,7,8,17,39,54,-15,29
Young Boys,793,1,23,6,3,75,37,38,75
FC Basel,793,2,17,8,7,57,30,27,59
St Gallen,793,3,16,3,13,45,53,-8,51
FC Zürich,793,4,13,9,10,49,38,11,48
Lucerne,793,5,11,7,14,38,47,-9,40
Grasshoppers,793,6,10,7,15,42,46,-4,37
FC Lugano,793,7,10,5,17,33,52,-19,35
FC Thun,793,8,9,6,17,44,64,-20,33
FC Sion,793,9,6,7,19,38,54,-16,25
Young Boys,794,1,21,6,5,71,34,37,69
FC Basel,794,2,18,7,7,52,28,24,61
Lucerne,794,3,13,8,11,41,44,-3,47
St Gallen,794,4,14,4,14,45,54,-9,46
FC Zürich,794,5,11,9,12,40,35,5,42
FC Lugano,794,6,11,5,16,33,49,-16,38
Grasshoppers,794,7,10,6,16,40,49,-9,36
FC Thun,794,8,10,5,17,44,59,-15,35
FC Sion,794,9,7,8,17,39,53,-14,29
Young Boys,795,1,19,10,3,68,35,33,67
FC Basel,795,2,16,9,7,53,28,25,57
St Gallen,795,3,15,3,14,45,53,-8,48
Lucerne,795,4,12,8,12,41,46,-5,44
FC Zürich,795,5,10,9,13,39,37,2,39
FC Thun,795,6,11,6,15,41,53,-12,39
FC Lugano,795,7,11,6,15,34,47,-13,39
Grasshoppers,795,8,10,6,16,41,49,-8,36
FC Sion,795,9,7,9,16,37,51,-14,30
Young Boys,796,1,22,8,2,74,31,43,74
FC Basel,796,2,18,7,7,59,28,31,61
Lucerne,796,3,13,9,10,40,41,-1,48
St Gallen,796,4,14,2,16,43,58,-15,44
FC Zürich,796,5,10,10,12,41,39,2,40
FC Lugano,796,6,11,6,15,31,49,-18,39
FC Thun,796,7,9,6,17,40,62,-22,33
Grasshoppers,796,8,8,8,16,36,46,-10,32
FC Sion,796,9,7,8,17,42,52,-10,29
Young Boys,797,1,21,7,4,70,34,36,70
FC Basel,797,2,19,8,5,59,22,37,65
Lucerne,797,3,13,7,12,42,47,-5,46
St Gallen,797,4,14,3,15,41,55,-14,45
FC Zürich,797,5,11,10,11,42,35,7,43
Grasshoppers,797,6,10,7,15,41,48,-7,37
FC Lugano,797,7,10,5,17,30,50,-20,35
FC Sion,797,8,8,8,16,42,50,-8,32
FC Thun,797,9,8,5,19,40,66,-26,29
Young Boys,798,1,21,7,4,75,37,38,70
FC Basel,798,2,16,9,7,51,28,23,57
Lucerne,798,3,14,8,10,47,44,3,50
St Gallen,798,4,13,4,15,41,57,-16,43
FC Zürich,798,5,10,10,12,40,39,1,40
Grasshoppers,798,6,11,6,15,42,48,-6,39
FC Lugano,798,7,11,5,16,32,47,-15,38
FC Thun,798,8,10,5,17,44,59,-15,35
FC Sion,798,9,6,10,16,42,55,-13,28
Young Boys,799,1,23,6,3,73,32,41,75
FC Basel,799,2,18,9,5,56,25,31,63
St Gallen,799,3,15,2,15,43,56,-13,47
Lucerne,799,4,12,9,11,44,46,-2,45
FC Zürich,799,5,9,11,12,40,39,1,38
FC Lugano,799,6,10,6,16,29,47,-18,36
Grasshoppers,799,7,9,8,15,43,51,-8,35
FC Thun,799,8,9,6,17,42,58,-16,33
FC Sion,799,9,7,7,18,44,60,-16,28
Young Boys,800,1,21,7,4,73,37,36,70
FC Basel,800,2,17,8,7,52,26,26,59
Lucerne,800,3,14,8,10,42,41,1,50
FC Zürich,800,4,11,11,10,41,34,7,44
St Gallen,800,5,13,3,16,43,60,-17,42
FC Lugano,800,6,11,6,15,30,45,-15,39
FC Thun,800,7,10,6,16,42,57,-15,36
Grasshoppers,800,8,8,7,17,40,52,-12,31
FC Sion,800,9,6,10,16,44,55,-11,28
Young Boys,801,1,21,8,3,73,36,37,71
FC Basel,801,2,17,8,7,50,25,25,59
Lucerne,801,3,13,8,11,44,44,0,47
St Gallen,801,4,15,2,15,44,55,-11,47
FC Zürich,801,5,11,9,12,43,36,7,42
Grasshoppers,801,6,11,7,14,46,47,-1,40
FC Thun,801,7,10,6,16,43,58,-15,36
FC Lugano,801,8,10,5,17,35,55,-20,35
FC Sion,801,9,6,7,19,38,60,-22,25
Young Boys,802,1,21,7,4,73,40,33,70
FC Basel,802,2,18,7,7,57,29,28,61
St Gallen,802,3,15,2,15,45,56,-11,47
Lucerne,802,4,13,7,12,43,47,-4,46
FC Zürich,802,5,10,9,13,42,38,4,39
FC Lugano,802,6,11,5,16,33,51,-18,38
Grasshoppers,802,7,10,7,15,45,49,-4,37
FC Thun,802,8,10,7,15,44,57,-13,37
FC Sion,802,9,6,9,17,39,54,-15,27
Young Boys,803,1,21,6,5,71,39,32,69
FC Basel,803,2,17,8,7,54,27,27,59
Lucerne,803,3,13,7,12,43,49,-6,46
St Gallen,803,4,14,2,16,42,56,-14,44
FC Zürich,803,5,11,10,11,43,39,4,43
Grasshoppers,803,6,11,6,15,48,50,-2,39
FC Thun,803,7,10,6,16,48,60,-12,36
FC Lugano,803,8,10,6,16,34,49,-15,36
FC Sion,803,9,8,7,17,43,57,-14,31
Young Boys,804,1,22,7,3,72,35,37,73
FC Basel,804,2,17,8,7,51,25,26,59
St Gallen,804,3,15,4,13,44,53,-9,49
Lucerne,804,4,12,9,11,42,45,-3,45
FC Zürich,804,5,10,11,11,42,37,5,41
FC Lugano,804,6,11,5,16,30,45,-15,38
Grasshoppers,804,7,10,6,16,43,49,-6,36
FC Thun,804,8,9,5,18,40,60,-20,32
FC Sion,804,9,6,9,17,37,52,-15,27
Young Boys,805,1,23,6,3,76,35,41,75
FC Basel,805,2,19,8,5,56,26,30,65
St Gallen,805,3,15,3,14,46,56,-10,48
Lucerne,805,4,13,7,12,40,44,-4,46
FC Lugano,805,5,11,5,16,33,50,-17,38
FC Zürich,805,6,9,9,14,36,38,-2,36
Grasshoppers,805,7,9,7,16,37,46,-9,34
FC Thun,805,8,9,6,17,42,57,-15,33
FC Sion,805,9,7,7,18,41,55,-14,28
Young Boys,806,1,20,7,5,68,34,34,67
FC Basel,806,2,17,10,5,53,23,30,61
St Gallen,806,3,15,4,13,45,53,-8,49
Lucerne,806,4,13,9,10,46,47,-1,48
FC Zürich,806,5,10,9,13,37,39,-2,39
Grasshoppers,806,6,11,6,15,43,48,-5,39
FC Lugano,806,7,10,6,16,33,49,-16,36
FC Thun,806,8,10,5,17,44,58,-14,35
FC Sion,806,9,6,8,18,39,57,-18,26
Young Boys,807,1,20,8,4,71,38,33,68
FC Basel,807,2,18,8,6,53,27,26,62
Lucerne,807,3,12,10,10,43,43,0,46
St Gallen,807,4,14,3,15,43,54,-11,45
Grasshoppers,807,5,11,7,14,43,47,-4,40
FC Zürich,807,6,9,11,12,39,37,2,38
FC Thun,807,7,11,5,16,46,59,-13,38
FC Lugano,807,8,10,7,15,31,47,-16,37
FC Sion,807,9,5,9,18,39,56,-17,24
Young Boys,808,1,24,6,2,74,32,42,78
FC Basel,808,2,16,10,6,53,26,27,58
FC Zürich,808,3,12,10,10,42,32,10,46
St Gallen,808,4,14,3,15,45,57,-12,45
Lucerne,808,5,11,8,13,39,49,-10,41
FC Lugano,808,6,11,5,16,33,46,-13,38
Grasshoppers,808,7,9,7,16,40,49,-9,34
FC Thun,808,8,9,6,17,41,61,-20,33
FC Sion,808,9,7,7,18,39,54,-15,28
Young Boys,809,1,23,6,3,78,36,42,75
FC Basel,809,2,19,8,5,58,25,33,65
Lucerne,809,3,12,9,11,45,48,-3,45
St Gallen,809,4,14,2,16,45,60,-15,44
FC Zürich,809,5,9,13,10,43,39,4,40
FC Thun,809,6,10,6,16,46,59,-13,36
FC Lugano,809,7,9,7,16,33,52,-19,34
Grasshoppers,809,8,8,7,17,38,54,-16,31
FC Sion,809,9,7,8,17,42,55,-13,29
Young Boys,810,1,21,6,5,73,40,33,69
FC Basel,810,2,19,8,5,56,26,30,65
Lucerne,810,3,13,8,11,46,42,4,47
St Gallen,810,4,14,4,14,42,52,-10,46
FC Zürich,810,5,10,11,11,40,36,4,41
Grasshoppers,810,6,10,6,16,41,52,-11,36
FC Lugano,810,7,10,6,16,31,51,-20,36
FC Thun,810,8,9,5,18,41,59,-18,32
FC Sion,810,9,7,8,17,41,53,-12,29
Young Boys,811,1,20,8,4,72,39,33,68
FC Basel,811,2,17,10,5,56,27,29,61
St Gallen,811,3,14,4,14,43,55,-12,46
Lucerne,811,4,12,8,12,41,47,-6,44
FC Zürich,811,5,10,11,11,42,39,3,41
Grasshoppers,811,6,11,6,15,48,51,-3,39
FC Lugano,811,7,10,7,15,34,48,-14,37
FC Thun,811,8,9,6,17,42,60,-18,33
FC Sion,811,9,7,8,17,42,54,-12,29
Young Boys,812,1,23,6,3,76,35,41,75
FC Basel,812,2,19,8,5,57,24,33,65
Lucerne,812,3,13,7,12,46,47,-1,46
FC Zürich,812,4,10,11,11,39,34,5,41
St Gallen,812,5,13,2,17,41,61,-20,41
FC Lugano,812,6,10,6,16,31,49,-18,36
FC Thun,812,7,10,5,17,43,58,-15,35
Grasshoppers,812,8,9,7,16,41,52,-11,34
FC Sion,812,9,7,8,17,42,56,-14,29
Young Boys,813,1,21,7,4,71,36,35,70
FC Basel,813,2,18,9,5,53,23,30,63
St Gallen,813,3,15,3,14,45,53,-8,48
Lucerne,813,4,12,9,11,39,44,-5,45
FC Zürich,813,5,11,11,10,42,34,8,44
Grasshoppers,813,6,10,7,15,43,47,-4,37
FC Lugano,813,7,10,6,16,33,49,-16,36
FC Thun,813,8,9,6,17,41,59,-18,33
FC Sion,813,9,5,8,19,36,58,-22,23
Young Boys,814,1,22,8,2,73,34,39,74
FC Basel,814,2,17,8,7,54,28,26,59
Lucerne,814,3,13,9,10,45,45,0,48
FC Zürich,814,4,11,11,10,46,36,10,44
St Gallen,814,5,13,2,17,41,60,-19,41
Grasshoppers,814,6,10,6,16,43,50,-7,36
FC Thun,814,7,10,6,16,47,58,-11,36
FC Lugano,814,8,10,6,16,32,48,-16,36
FC Sion,814,9,6,8,18,39,61,-22,26
Young Boys,815,1,22,6,4,71,39,32,72
FC Basel,815,2,20,7,5,60,25,35,67
Lucerne,815,3,12,9,11,42,43,-1,45
St Gallen,815,4,14,3,15,43,57,-14,45
FC Zürich,815,5,10,10,12,39,36,3,40
FC Thun,815,6,10,6,16,44,57,-13,36
Grasshoppers,815,7,9,7,16,41,51,-10,34
FC Lugano,815,8,9,6,17,30,50,-20,33
FC Sion,815,9,7,8,17,42,54,-12,29
Young Boys,816,1,21,8,3,73,37,36,71
FC Basel,816,2,17,10,5,52,25,27,61
Lucerne,816,3,13,8,11,42,44,-2,47
FC Zürich,816,4,11,9,12,41,36,5,42
Grasshoppers,816,5,12,6,14,46,47,-1,42
St Gallen,816,6,13,2,17,39,54,-15,41
FC Lugano,816,7,11,5,16,32,48,-16,38
FC Thun,816,8,9,6,17,45,60,-15,33
FC Sion,816,9,6,8,18,39,58,-19,26
Young Boys,817,1,22,8,2,69,30,39,74
FC Basel,817,2,17,10,5,54,24,30,61
St Gallen,817,3,15,3,14,47,54,-7,48
Lucerne,817,4,12,9,11,39,44,-5,45
FC Zürich,817,5,10,10,12,38,36,2,40
FC Thun,817,6,11,5,16,46,56,-10,38
Grasshoppers,817,7,8,9,15,40,50,-10,33
FC Lugano,817,8,9,6,17,28,46,-18,33
FC Sion,817,9,6,8,18,37,58,-21,26
Young Boys,818,1,21,7,4,72,37,35,70
FC Basel,818,2,19,8,5,56,24,32,65
St Gallen,818,3,14,3,15,40,53,-13,45
Lucerne,818,4,12,8,12,41,44,-3,44
FC Zürich,818,5,10,10,12,39,38,1,40
FC Thun,818,6,11,5,16,47,60,-13,38
FC Lugano,818,7,11,5,16,33,48,-15,38
Grasshoppers,818,8,9,8,15,40,49,-9,35
FC Sion,818,9,5,10,17,40,55,-15,25
Young Boys,819,1,23,6,3,76,35,41,75
FC Basel,819,2,18,8,6,54,28,26,62
St Gallen,819,3,16,2,14,48,53,-5,50
Lucerne,819,4,13,8,11,44,43,1,47
FC Zürich,819,5,12,9,11,45,37,8,45
FC Thun,819,6,10,5,17,43,59,-16,35
FC Lugano,819,7,10,5,17,31,51,-20,35
Grasshoppers,819,8,8,7,17,42,57,-15,31
FC Sion,819,9,5,8,19,41,61,-20,23
Young Boys,820,1,20,8,4,68,36,32,68
FC Basel,820,2,19,8,5,57,24,33,65
Lucerne,820,3,14,7,11,44,43,1,49
St Gallen,820,4,14,3,15,41,53,-12,45
FC Zürich,820,5,11,10,11,45,37,8,43
FC Lugano,820,6,11,5,16,32,50,-18,38
Grasshoppers,820,7,9,7,16,42,50,-8,34
FC Sion,820,8,7,9,16,41,54,-13,30
FC Thun,820,9,8,5,19,43,66,-23,29
Young Boys,821,1,20,9,3,72,38,34,69
FC Basel,821,2,17,9,6,56,29,27,60
Lucerne,821,3,14,8,10,43,41,2,50
St Gallen,821,4,14,3,15,41,56,-15,45
FC Zürich,821,5,11,10,11,42,37,5,43
FC Thun,821,6,11,5,16,46,57,-11,38
FC Lugano,821,7,10,7,15,34,47,-13,37
Grasshoppers,821,8,9,6,17,37,50,-13,33
FC Sion,821,9,6,7,19,41,57,-16,25
Young Boys,822,1,22,6,4,79,37,42,72
FC Basel,822,2,19,8,5,54,24,30,65
St Gallen,822,3,14,2,16,41,54,-13,44
FC Zürich,822,4,11,9,12,43,36,7,42
Lucerne,822,5,11,9,12,41,49,-8,42
FC Lugano,822,6,11,5,16,31,48,-17,38
Grasshoppers,822,7,10,7,15,42,50,-8,37
FC Thun,822,8,10,5,17,44,59,-15,35
FC Sion,822,9,7,7,18,40,58,-18,28
Young Boys,823,1,22,6,4,69,34,35,72
FC Basel,823,2,20,7,5,59,26,33,67
Lucerne,823,3,13,9,10,41,40,1,48
St Gallen,823,4,15,2,15,45,55,-10,47
FC Zürich,823,5,9,10,13,39,39,0,37
Grasshoppers,823,6,10,7,15,40,47,-7,37
FC Lugano,823,7,10,6,16,28,45,-17,36
FC Thun,823,8,9,5,18,42,63,-21,32
FC Sion,823,9,6,8,18,42,56,-14,26
Young Boys,824,1,20,8,4,69,39,30,68
FC Basel,824,2,19,7,6,57,26,31,64
Lucerne,824,3,15,7,10,49,42,7,52
St Gallen,824,4,14,2,16,45,60,-15,44
FC Zürich,824,5,11,10,11,39,34,5,43
Grasshoppers,824,6,10,7,15,39,47,-8,37
FC Lugano,824,7,9,6,17,29,49,-20,33
FC Thun,824,8,8,8,16,40,56,-16,32
FC Sion,824,9,6,9,17,39,53,-14,27
Young Boys,825,1,21,7,4,68,31,37,70
FC Basel,825,2,20,7,5,56,24,32,67
St Gallen,825,3,14,3,15,43,55,-12,45
Lucerne,825,4,12,7,13,43,49,-6,43
FC Zürich,825,5,10,10,12,41,39,2,40
Grasshoppers,825,6,10,8,14,41,47,-6,38
FC Thun,825,7,10,6,16,44,56,-12,36
FC Lugano,825,8,10,6,16,31,50,-19,36
FC Sion,825,9,5,10,17,37,53,-16,25
Young Boys,826,1,22,6,4,69,34,35,72
FC Basel,826,2,20,7,5,60,22,38,67
Lucerne,826,3,12,8,12,41,45,-4,44
St Gallen,826,4,13,5,14,44,59,-15,44
FC Zürich,826,5,10,11,11,40,36,4,41
FC Thun,826,6,10,6,16,43,57,-14,36
Grasshoppers,826,7,9,6,17,38,50,-12,33
FC Lugano,826,8,9,6,17,29,49,-20,33
FC Sion,826,9,7,9,16,41,53,-12,30
Young Boys,827,1,20,9,3,74,35,39,69
FC Basel,827,2,19,7,6,58,22,36,64
Lucerne,827,3,13,8,11,44,47,-3,47
FC Zürich,827,4,11,10,11,39,34,5,43
St Gallen,827,5,13,3,16,39,57,-18,42
FC Lugano,827,6,12,5,15,35,52,-17,41
Grasshoppers,827,7,9,7,16,42,52,-10,34
FC Thun,827,8,9,6,17,45,63,-18,33
FC Sion,827,9,6,9,17,39,53,-14,27
Young Boys,828,1,21,7,4,69,36,33,70
FC Basel,828,2,18,9,5,59,26,33,63
Lucerne,828,3,14,7,11,42,40,2,49
St Gallen,828,4,15,2,15,44,58,-14,47
FC Zürich,828,5,10,11,11,41,36,5,41
FC Lugano,828,6,10,5,17,32,50,-18,35
Grasshoppers,828,7,9,7,16,40,50,-10,34
FC Thun,828,8,8,8,16,42,59,-17,32
FC Sion,828,9,6,10,16,38,52,-14,28
Young Boys,829,1,22,7,3,75,35,40,73
FC Basel,829,2,19,8,5,58,23,35,65
St Gallen,829,3,14,3,15,44,54,-10,45
Lucerne,829,4,12,8,12,39,43,-4,44
FC Zürich,829,5,10,10,12,41,41,0,40
FC Thun,829,6,11,5,16,44,56,-12,38
Grasshoppers,829,7,10,7,15,41,48,-7,37
FC Lugano,829,8,10,7,15,31,50,-19,37
FC Sion,829,9,5,7,20,39,62,-23,22
Young Boys,830,1,22,7,3,71,35,36,73
FC Basel,830,2,18,8,6,56,24,32,62
St Gallen,830,3,14,3,15,44,54,-10,45
FC Zürich,830,4,11,11,10,42,36,6,44
Lucerne,830,5,12,8,12,38,44,-6,44
Grasshoppers,830,6,10,8,14,40,46,-6,38
FC Lugano,830,7,10,5,17,30,49,-19,35
FC Thun,830,8,8,7,17,41,59,-18,31
FC Sion,830,9,6,9,17,38,53,-15,27
Young Boys,831,1,23,6,3,70,33,37,75
FC Basel,831,2,18,7,7,58,31,27,61
Lucerne,831,3,13,7,12,49,48,1,46
St Gallen,831,4,14,2,16,44,60,-16,44
FC Lugano,831,5,12,5,15,34,47,-13,41
FC Zürich,831,6,10,10,12,40,39,1,40
Grasshoppers,831,7,10,6,16,41,50,-9,36
FC Thun,831,8,10,5,17,46,61,-15,35
FC Sion,831,9,6,8,18,39,52,-13,26
Young Boys,832,1,21,7,4,72,35,37,70
FC Basel,832,2,18,8,6,55,24,31,62
St Gallen,832,3,15,2,15,45,58,-13,47
Lucerne,832,4,12,9,11,42,45,-3,45
FC Zürich,832,5,10,10,12,38,36,2,40
Grasshoppers,832,6,11,6,15,43,50,-7,39
FC Thun,832,7,11,5,16,45,56,-11,38
FC Lugano,832,8,10,5,17,33,52,-19,35
FC Sion,832,9,6,8,18,42,59,-17,26
Young Boys,833,1,22,7,3,69,32,37,73
FC Basel,833,2,18,8,6,52,24,28,62
St Gallen,833,3,15,4,13,45,53,-8,49
Lucerne,833,4,12,7,13,38,43,-5,43
FC Zürich,833,5,11,9,12,41,36,5,42
FC Thun,833,6,11,5,16,44,57,-13,38
FC Lugano,833,7,10,5,17,29,48,-19,35
Grasshoppers,833,8,9,7,16,40,50,-10,34
FC Sion,833,9,6,8,18,38,53,-15,26
Young Boys,834,1,23,6,3,70,31,39,75
FC Basel,834,2,19,8,5,57,23,34,65
Lucerne,834,3,13,8,11,42,46,-4,47
St Gallen,834,4,14,4,14,43,54,-11,46
FC Zürich,834,5,11,9,12,40,35,5,42
Grasshoppers,834,6,10,7,15,44,50,-6,37
FC Thun,834,7,9,5,18,43,61,-18,32
FC Lugano,834,8,9,5,18,27,48,-21,32
FC Sion,834,9,6,8,18,40,58,-18,26
Young Boys,835,1,22,7,3,74,34,40,73
FC Basel,835,2,18,7,7,53,25,28,61
St Gallen,835,3,15,2,15,40,53,-13,47
Lucerne,835,4,13,7,12,41,43,-2,46
FC Zürich,835,5,11,10,11,41,36,5,43
FC Lugano,835,6,11,6,15,32,47,-15,39
FC Thun,835,7,10,5,17,44,58,-14,35
Grasshoppers,835,8,9,6,17,39,53,-14,33
FC Sion,835,9,6,8,18,39,54,-15,26
Young Boys,836,1,22,8,2,70,33,37,74
FC Basel,836,2,19,7,6,53,24,29,64
Lucerne,836,3,12,8,12,41,45,-4,44
St Gallen,836,4,13,3,16,43,57,-14,42
FC Zürich,836,5,10,9,13,41,40,1,39
FC Lugano,836,6,11,6,15,34,47,-13,39
Grasshoppers,836,7,10,7,15,42,48,-6,37
FC Sion,836,8,8,9,15,43,52,-9,33
FC Thun,836,9,8,5,19,43,64,-21,29
Young Boys,837,1,20,8,4,71,38,33,68
FC Basel,837,2,17,9,6,55,30,25,60
Lucerne,837,3,13,9,10,42,41,1,48
St Gallen,837,4,13,5,14,43,55,-12,44
FC Zürich,837,5,10,10,12,42,38,4,40
FC Thun,837,6,11,6,15,46,56,-10,39
FC Lugano,837,7,10,7,15,30,46,-16,37
Grasshoppers,837,8,9,8,15,42,50,-8,35
FC Sion,837,9,5,10,17,37,54,-17,25
Young Boys,838,1,22,7,3,74,32,42,73
FC Basel,838,2,18,7,7,54,26,28,61
St Gallen,838,3,14,5,13,44,54,-10,47
Lucerne,838,4,12,8,12,41,48,-7,44
FC Zürich,838,5,11,10,11,40,36,4,43
Grasshoppers,838,6,10,7,15,41,48,-7,37
FC Thun,838,7,9,7,16,43,59,-16,34
FC Lugano,838,8,9,6,17,28,48,-20,33
FC Sion,838,9,5,11,16,38,52,-14,26
Young Boys,839,1,22,7,3,72,36,36,73
FC Basel,839,2,17,9,6,54,27,27,60
St Gallen,839,3,15,3,14,46,54,-8,48
Lucerne,839,4,12,8,12,39,48,-9,44
FC Zürich,839,5,10,11,11,44,40,4,41
FC Lugano,839,6,10,8,14,34,46,-12,38
Grasshoppers,839,7,9,6,17,40,49,-9,33
FC Thun,839,8,9,5,18,43,60,-17,32
FC Sion,839,9,8,7,17,39,51,-12,31
Young Boys,840,1,21,8,3,70,34,36,71
FC Basel,840,2,19,7,6,55,25,30,64
Lucerne,840,3,13,9,10,40,40,0,48
St Gallen,840,4,15,2,15,42,52,-10,47
FC Zürich,840,5,12,9,11,42,34,8,45
FC Thun,840,6,10,5,17,44,58,-14,35
Grasshoppers,840,7,8,8,16,40,52,-12,32
FC Lugano,840,8,9,5,18,28,51,-23,32
FC Sion,840,9,6,9,17,38,53,-15,27
Young Boys,841,1,21,9,2,70,34,36,72
FC Basel,841,2,18,8,6,60,29,31,62
St Gallen,841,3,15,3,14,47,54,-7,48
Lucerne,841,4,13,7,12,41,46,-5,46
FC Zürich,841,5,11,10,11,40,35,5,43
FC Lugano,841,6,10,5,17,29,45,-16,35
FC Thun,841,7,9,6,17,45,64,-19,33
Grasshoppers,841,8,8,8,16,37,49,-12,32
FC Sion,841,9,5,12,15,37,50,-13,27
Young Boys,842,1,21,8,3,73,33,40,71
FC Basel,842,2,16,9,7,51,29,22,57
St Gallen,842,3,16,2,14,47,57,-10,50
Lucerne,842,4,13,7,12,43,49,-6,46
FC Lugano,842,5,12,5,15,36,49,-13,41
FC Zürich,842,6,10,9,13,44,38,6,39
Grasshoppers,842,7,10,7,15,45,49,-4,37
FC Thun,842,8,10,6,16,45,61,-16,36
FC Sion,842,9,6,7,19,39,58,-19,25
Young Boys,843,1,22,7,3,72,32,40,73
FC Basel,843,2,19,8,5,55,24,31,65
FC Zürich,843,3,12,10,10,43,36,7,46
Lucerne,843,4,12,9,11,45,48,-3,45
St Gallen,843,5,13,3,16,42,56,-14,42
FC Lugano,843,6,10,6,16,29,46,-17,36
FC Thun,843,7,10,5,17,47,60,-13,35
Grasshoppers,843,8,8,7,17,42,56,-14,31
FC Sion,843,9,7,7,18,45,62,-17,28
Young Boys,844,1,23,7,2,77,34,43,76
FC Basel,844,2,16,9,7,53,29,24,57
Lucerne,844,3,13,9,10,42,43,-1,48
FC Zürich,844,4,12,9,11,44,36,8,45
St Gallen,844,5,14,3,15,44,54,-10,45
FC Lugano,844,6,11,5,16,32,49,-17,38
Grasshoppers,844,7,9,6,17,42,53,-11,33
FC Thun,844,8,9,5,18,43,61,-18,32
FC Sion,844,9,7,7,18,40,58,-18,28
Young Boys,845,1,23,6,3,73,33,40,75
FC Basel,845,2,19,7,6,58,28,30,64
FC Zürich,845,3,13,9,10,47,34,13,48
St Gallen,845,4,15,2,15,47,56,-9,47
Lucerne,845,5,12,8,12,46,50,-4,44
Grasshoppers,845,6,9,8,15,42,49,-7,35
FC Lugano,845,7,10,5,17,32,55,-23,35
FC Thun,845,8,8,6,18,41,62,-21,30
FC Sion,845,9,5,9,18,38,57,-19,24
Young Boys,846,1,22,7,3,72,35,37,73
FC Basel,846,2,17,9,6,52,26,26,60
FC Zürich,846,3,13,9,10,45,36,9,48
St Gallen,846,4,14,4,14,44,55,-11,46
Lucerne,846,5,11,8,13,41,46,-5,41
FC Lugano,846,6,10,6,16,30,47,-17,36
Grasshoppers,846,7,9,8,15,40,48,-8,35
FC Sion,846,8,7,9,16,44,55,-11,30
FC Thun,846,9,8,6,18,42,62,-20,30
Young Boys,847,1,22,7,3,74,34,40,73
FC Basel,847,2,18,8,6,55,26,29,62
Lucerne,847,3,13,8,11,42,45,-3,47
St Gallen,847,4,14,2,16,41,56,-15,44
FC Zürich,847,5,10,10,12,43,37,6,40
FC Thun,847,6,9,8,15,41,54,-13,35
FC Lugano,847,7,10,5,17,29,52,-23,35
Grasshoppers,847,8,8,10,14,38,46,-8,34
FC Sion,847,9,7,8,17,40,53,-13,29
Young Boys,848,1,20,7,5,67,40,27,67
FC Basel,848,2,17,9,6,53,26,27,60
Lucerne,848,3,13,9,10,47,42,5,48
St Gallen,848,4,14,4,14,42,54,-12,46
FC Zürich,848,5,10,10,12,40,36,4,40
Grasshoppers,848,6,10,8,14,43,48,-5,38
FC Thun,848,7,9,7,16,42,58,-16,34
FC Lugano,848,8,9,6,17,28,49,-21,33
FC Sion,848,9,8,8,16,42,51,-9,32
Young Boys,849,1,21,9,2,69,32,37,72
FC Basel,849,2,17,8,7,54,29,25,59
St Gallen,849,3,17,2,13,48,54,-6,53
Lucerne,849,4,13,7,12,42,44,-2,46
FC Zürich,849,5,10,9,13,41,38,3,39
Grasshoppers,849,6,10,6,16,39,47,-8,36
FC Lugano,849,7,10,6,16,34,50,-16,36
FC Thun,849,8,9,5,18,39,61,-22,32
FC Sion,849,9,7,8,17,42,53,-11,29
Young Boys,850,1,19,8,5,68,40,28,65
FC Basel,850,2,16,10,6,51,28,23,58
Lucerne,850,3,14,8,10,44,43,1,50
St Gallen,850,4,15,3,14,43,53,-10,48
FC Zürich,850,5,11,10,11,43,37,6,43
Grasshoppers,850,6,10,7,15,45,52,-7,37
FC Thun,850,7,10,6,16,46,57,-11,36
FC Lugano,850,8,9,6,17,33,52,-19,33
FC Sion,850,9,7,8,17,42,53,-11,29
Young Boys,851,1,21,8,3,75,39,36,71
FC Basel,851,2,19,8,5,59,26,33,65
FC Zürich,851,3,12,9,11,44,37,7,45
St Gallen,851,4,14,3,15,40,52,-12,45
Lucerne,851,5,11,9,12,39,46,-7,42
Grasshoppers,851,6,10,6,16,43,49,-6,36
FC Lugano,851,7,10,6,16,33,49,-16,36
FC Thun,851,8,9,5,18,42,61,-19,32
FC Sion,851,9,7,8,17,38,54,-16,29
Young Boys,852,1,23,6,3,73,35,38,75
FC Basel,852,2,17,7,8,51,28,23,58
Lucerne,852,3,15,7,10,48,45,3,52
St Gallen,852,4,15,2,15,45,56,-11,47
FC Zürich,852,5,11,9,12,43,39,4,42
FC Thun,852,6,10,6,16,47,59,-12,36
FC Lugano,852,7,10,5,17,30,49,-19,35
Grasshoppers,852,8,9,7,16,45,54,-9,34
FC Sion,852,9,5,9,18,39,56,-17,24
Young Boys,853,1,23,6,3,77,31,46,75
FC Basel,853,2,15,9,8,47,27,20,54
Lucerne,853,3,12,10,10,44,45,-1,46
St Gallen,853,4,14,4,14,43,54,-11,46
FC Zürich,853,5,10,10,12,39,41,-2,40
FC Thun,853,6,11,6,15,50,56,-6,39
FC Lugano,853,7,9,8,15,29,47,-18,35
Grasshoppers,853,8,9,6,17,37,54,-17,33
FC Sion,853,9,8,7,17,45,56,-11,31
Young Boys,854,1,21,8,3,73,35,38,71
FC Basel,854,2,17,8,7,53,28,25,59
Lucerne,854,3,13,10,9,42,39,3,49
St Gallen,854,4,14,3,15,43,57,-14,45
FC Zürich,854,5,11,10,11,42,36,6,43
FC Lugano,854,6,10,7,15,33,47,-14,37
FC Thun,854,7,9,6,17,41,59,-18,33
Grasshoppers,854,8,8,7,17,40,54,-14,31
FC Sion,854,9,7,9,16,44,56,-12,30
Young Boys,855,1,22,8,2,72,34,38,74
FC Basel,855,2,17,10,5,53,24,29,61
St Gallen,855,3,15,2,15,45,56,-11,47
Lucerne,855,4,12,8,12,39,44,-5,44
FC Zürich,855,5,11,10,11,41,35,6,43
FC Lugano,855,6,11,7,14,33,44,-11,40
FC Thun,855,7,9,7,16,43,58,-15,34
Grasshoppers,855,8,9,6,17,41,51,-10,33
FC Sion,855,9,5,8,19,38,59,-21,23
Young Boys,856,1,21,8,3,71,34,37,71
FC Basel,856,2,16,9,7,54,30,24,57
Lucerne,856,3,13,9,10,46,42,4,48
St Gallen,856,4,14,2,16,43,62,-19,44
FC Lugano,856,5,12,5,15,36,48,-12,41
FC Zürich,856,6,10,9,13,39,39,0,39
FC Thun,856,7,10,5,17,46,60,-14,35
Grasshoppers,856,8,9,7,16,40,53,-13,34
FC Sion,856,9,8,8,16,45,52,-7,32
Young Boys,857,1,21,6,5,72,36,36,69
FC Basel,857,2,19,7,6,57,24,33,64
Lucerne,857,3,14,8,10,44,43,1,50
St Gallen,857,4,14,3,15,41,54,-13,45
FC Zürich,857,5,11,9,12,42,38,4,42
FC Thun,857,6,11,5,16,45,58,-13,38
FC Lugano,857,7,10,5,17,29,47,-18,35
Grasshoppers,857,8,9,6,17,40,52,-12,33
FC Sion,857,9,7,7,18,42,60,-18,28
Young Boys,858,1,21,9,2,73,34,39,72
FC Basel,858,2,16,9,7,52,29,23,57
St Gallen,858,3,15,2,15,45,52,-7,47
Lucerne,858,4,12,9,11,44,51,-7,45
FC Zürich,858,5,11,10,11,41,36,5,43
FC Lugano,858,6,11,5,16,33,47,-14,38
Grasshoppers,858,7,10,6,16,41,51,-10,36
FC Thun,858,8,9,6,17,43,61,-18,33
FC Sion,858,9,7,8,17,41,52,-11,29
Young Boys,859,1,22,7,3,74,34,40,73
FC Basel,859,2,19,7,6,58,27,31,64
St Gallen,859,3,15,3,14,46,56,-10,48
Lucerne,859,4,12,8,12,44,48,-4,44
FC Zürich,859,5,11,9,12,40,35,5,42
FC Thun,859,6,11,5,16,45,59,-14,38
FC Lugano,859,7,10,8,14,35,49,-14,38
Grasshoppers,859,8,9,6,17,42,53,-11,33
FC Sion,859,9,5,7,20,36,59,-23,22
Young Boys,860,1,22,8,2,74,31,43,74
FC Basel,860,2,18,8,6,52,29,23,62
Lucerne,860,3,13,7,12,41,44,-3,46
FC Zürich,860,4,11,11,10,40,34,6,44
St Gallen,860,5,14,2,16,41,53,-12,44
FC Lugano,860,6,10,7,15,28,43,-15,37
FC Sion,860,7,8,8,16,42,52,-10,32
Grasshoppers,860,8,8,7,17,38,51,-13,31
FC Thun,860,9,8,6,18,40,59,-19,30
Young Boys,861,1,22,6,4,75,38,37,72
FC Basel,861,2,18,8,6,56,29,27,62
St Gallen,861,3,14,5,13,45,55,-10,47
Lucerne,861,4,12,8,12,45,48,-3,44
FC Zürich,861,5,10,10,12,41,39,2,40
FC Lugano,861,6,11,6,15,32,48,-16,39
Grasshoppers,861,7,9,7,16,41,50,-9,34
FC Thun,861,8,8,7,17,44,61,-17,31
FC Sion,861,9,7,9,16,41,52,-11,30
Young Boys,862,1,21,6,5,69,40,29,69
FC Basel,862,2,17,10,5,56,27,29,61
Lucerne,862,3,13,9,10,44,42,2,48
FC Zürich,862,4,11,10,11,42,37,5,43
St Gallen,862,5,13,3,16,41,61,-20,42
Grasshoppers,862,6,10,6,16,41,49,-8,36
FC Lugano,862,7,10,6,16,33,48,-15,36
FC Sion,862,8,9,7,16,50,55,-5,34
FC Thun,862,9,9,5,18,45,62,-17,32
Young Boys,863,1,21,8,3,71,35,36,71
FC Basel,863,2,16,8,8,54,28,26,56
St Gallen,863,3,15,3,14,44,54,-10,48
Lucerne,863,4,13,8,11,43,45,-2,47
FC Zürich,863,5,11,9,12,40,36,4,42
FC Lugano,863,6,11,5,16,30,46,-16,38
FC Thun,863,7,10,7,15,43,55,-12,37
Grasshoppers,863,8,9,8,15,38,48,-10,35
FC Sion,863,9,6,8,18,40,56,-16,26
Young Boys,864,1,22,7,3,72,35,37,73
FC Basel,864,2,18,7,7,53,26,27,61
Lucerne,864,3,14,8,10,43,42,1,50
FC Lugano,864,4,12,6,14,37,46,-9,42
St Gallen,864,5,13,2,17,41,61,-20,41
FC Zürich,864,6,10,10,12,41,36,5,40
Grasshoppers,864,7,10,7,15,41,48,-7,37
FC Thun,864,8,9,5,18,43,60,-17,32
FC Sion,864,9,6,8,18,40,57,-17,26
Young Boys,865,1,21,6,5,69,43,26,69
FC Basel,865,2,18,7,7,54,28,26,61
Lucerne,865,3,13,9,10,44,43,1,48
St Gallen,865,4,13,4,15,40,55,-15,43
FC Zürich,865,5,11,9,12,43,39,4,42
Grasshoppers,865,6,10,6,16,45,49,-4,36
FC Thun,865,7,10,6,16,46,59,-13,36
FC Lugano,865,8,10,6,16,29,46,-17,36
FC Sion,865,9,7,9,16,46,54,-8,30
Young Boys,866,1,21,7,4,72,36,36,70
FC Basel,866,2,18,8,6,53,23,30,62
St Gallen,866,3,15,4,13,43,51,-8,49
FC Zürich,866,4,11,10,11,40,35,5,43
Lucerne,866,5,11,9,12,41,48,-7,42
Grasshoppers,866,6,10,7,15,40,47,-7,37
FC Thun,866,7,9,6,17,40,56,-16,33
FC Lugano,866,8,9,6,17,29,49,-20,33
FC Sion,866,9,7,9,16,39,52,-13,30
Young Boys,867,1,21,8,3,71,35,36,71
FC Basel,867,2,18,9,5,61,29,32,63
Lucerne,867,3,12,9,11,41,43,-2,45
St Gallen,867,4,13,5,14,41,54,-13,44
FC Zürich,867,5,11,10,11,44,38,6,43
FC Lugano,867,6,11,6,15,33,47,-14,39
FC Thun,867,7,9,6,17,50,64,-14,33
Grasshoppers,867,8,8,6,18,39,60,-21,30
FC Sion,867,9,6,11,15,43,53,-10,29
Young Boys,868,1,20,7,5,70,39,31,67
FC Basel,868,2,18,8,6,57,26,31,62
St Gallen,868,3,16,3,13,46,53,-7,51
Lucerne,868,4,13,8,11,41,42,-1,47
FC Zürich,868,5,10,11,11,42,38,4,41
Grasshoppers,868,6,10,6,16,43,52,-9,36
FC Thun,868,7,9,7,16,48,66,-18,34
FC Lugano,868,8,9,6,17,34,52,-18,33
FC Sion,868,9,7,8,17,42,55,-13,29
Young Boys,869,1,23,7,2,76,35,41,76
FC Basel,869,2,17,9,6,55,26,29,60
FC Zürich,869,3,11,11,10,40,33,7,44
Lucerne,869,4,12,8,12,40,48,-8,44
St Gallen,869,5,13,3,16,40,58,-18,42
Grasshoppers,869,6,11,6,15,45,50,-5,39
FC Lugano,869,7,10,6,16,32,48,-16,36
FC Thun,869,8,10,5,17,43,58,-15,35
FC Sion,869,9,6,7,19,41,56,-15,25
Young Boys,870,1,23,6,3,71,32,39,75
FC Basel,870,2,19,8,5,56,25,31,65
Lucerne,870,3,13,8,11,43,44,-1,47
St Gallen,870,4,14,4,14,44,55,-11,46
FC Thun,870,5,11,6,15,45,55,-10,39
FC Zürich,870,6,9,10,13,42,41,1,37
FC Lugano,870,7,10,5,17,30,50,-20,35
Grasshoppers,870,8,8,6,18,36,54,-18,30
FC Sion,870,9,6,9,17,44,55,-11,27
Young Boys,871,1,21,6,5,70,35,35,69
FC Basel,871,2,18,8,6,54,26,28,62
Lucerne,871,3,14,9,9,43,40,3,51
St Gallen,871,4,15,2,15,43,55,-12,47
FC Zürich,871,5,11,10,11,39,34,5,43
FC Lugano,871,6,10,5,17,30,50,-20,35
Grasshoppers,871,7,9,7,16,40,51,-11,34
FC Thun,871,8,9,7,16,42,55,-13,34
FC Sion,871,9,6,8,18,36,51,-15,26
Young Boys,872,1,21,6,5,71,39,32,69
FC Basel,872,2,19,7,6,55,25,30,64
Lucerne,872,3,13,8,11,39,44,-5,47
St Gallen,872,4,14,3,15,43,55,-12,45
FC Zürich,872,5,10,9,13,40,40,0,39
FC Lugano,872,6,11,5,16,35,49,-14,38
FC Thun,872,7,10,5,17,43,57,-14,35
Grasshoppers,872,8,9,7,16,38,47,-9,34
FC Sion,872,9,8,8,16,41,49,-8,32
Young Boys,873,1,21,6,5,71,37,34,69
FC Basel,873,2,20,7,5,56,21,35,67
Lucerne,873,3,14,7,11,43,44,-1,49
FC Zürich,873,4,11,9,12,42,38,4,42
St Gallen,873,5,13,3,16,41,55,-14,42
FC Lugano,873,6,12,5,15,35,47,-12,41
Grasshoppers,873,7,10,7,15,47,53,-6,37
FC Thun,873,8,8,7,17,41,61,-20,31
FC Sion,873,9,5,9,18,40,60,-20,24
Young Boys,874,1,21,7,4,73,38,35,70
FC Basel,874,2,18,8,6,56,24,32,62
Lucerne,874,3,12,9,11,42,46,-4,45
St Gallen,874,4,14,3,15,43,57,-14,45
FC Zürich,874,5,10,10,12,38,38,0,40
FC Thun,874,6,11,6,15,48,57,-9,39
Grasshoppers,874,7,10,7,15,47,54,-7,37
FC Lugano,874,8,9,8,15,29,48,-19,35
FC Sion,874,9,6,8,18,40,54,-14,26
Young Boys,875,1,22,7,3,72,35,37,73
FC Basel,875,2,18,8,6,53,23,30,62
FC Zürich,875,3,11,11,10,40,34,6,44
Lucerne,875,4,11,10,11,42,45,-3,43
St Gallen,875,5,13,4,15,39,54,-15,43
FC Lugano,875,6,11,6,15,32,45,-13,39
Grasshoppers,875,7,9,7,16,42,53,-11,34
FC Thun,875,8,9,5,18,42,58,-16,32
FC Sion,875,9,7,8,17,40,55,-15,29
Young Boys,876,1,21,6,5,71,40,31,69
FC Basel,876,2,17,7,8,52,27,25,58
St Gallen,876,3,16,2,14,46,53,-7,50
Lucerne,876,4,12,8,12,41,46,-5,44
FC Zürich,876,5,10,10,12,40,39,1,40
FC Lugano,876,6,11,6,15,37,49,-12,39
Grasshoppers,876,7,9,7,16,43,52,-9,34
FC Thun,876,8,9,7,16,44,59,-15,34
FC Sion,876,9,8,9,15,42,51,-9,33
Young Boys,877,1,20,9,3,70,38,32,69
FC Basel,877,2,17,7,8,52,27,25,58
St Gallen,877,3,16,2,14,46,53,-7,50
Lucerne,877,4,13,9,10,43,43,0,48
FC Zürich,877,5,11,9,12,40,37,3,42
FC Lugano,877,6,10,6,16,34,50,-16,36
FC Sion,877,7,8,9,15,40,49,-9,33
Grasshoppers,877,8,8,9,15,39,49,-10,33
FC Thun,877,9,8,6,18,41,59,-18,30
Young Boys,878,1,21,6,5,65,37,28,69
FC Basel,878,2,18,7,7,57,28,29,61
Lucerne,878,3,12,9,11,42,44,-2,45
FC Lugano,878,4,13,5,14,34,44,-10,44
St Gallen,878,5,13,3,16,43,58,-15,42
FC Zürich,878,6,10,10,12,41,35,6,40
Grasshoppers,878,7,10,7,15,44,49,-5,37
FC Sion,878,8,8,8,16,43,52,-9,32
FC Thun,878,9,9,5,18,44,66,-22,32
Young Boys,879,1,23,7,2,78,33,45,76
FC Basel,879,2,18,8,6,53,25,28,62
St Gallen,879,3,16,3,13,48,53,-5,51
Lucerne,879,4,12,8,12,43,49,-6,44
FC Zürich,879,5,9,10,13,41,44,-3,37
FC Lugano,879,6,10,6,16,33,48,-15,36
Grasshoppers,879,7,9,7,16,40,49,-9,34
FC Thun,879,8,9,7,16,42,57,-15,34
FC Sion,879,9,6,8,18,41,61,-20,26
Young Boys,880,1,19,9,4,69,37,32,66
FC Basel,880,2,17,8,7,50,28,22,59
St Gallen,880,3,16,2,14,49,54,-5,50
FC Zürich,880,4,12,9,11,44,36,8,45
Lucerne,880,5,12,8,12,42,44,-2,44
Grasshoppers,880,6,10,6,16,43,50,-7,36
FC Sion,880,7,9,8,15,44,51,-7,35
FC Thun,880,8,9,6,17,42,60,-18,33
FC Lugano,880,9,9,6,17,31,54,-23,33
Young Boys,881,1,20,8,4,68,34,34,68
FC Basel,881,2,16,9,7,50,27,23,57
Lucerne,881,3,12,11,9,40,40,0,47
St Gallen,881,4,14,3,15,43,55,-12,45
FC Zürich,881,5,10,11,11,41,37,4,41
FC Thun,881,6,11,6,15,49,57,-8,39
FC Lugano,881,7,10,7,15,29,45,-16,37
Grasshoppers,881,8,8,8,16,38,52,-14,32
FC Sion,881,9,7,9,16,43,54,-11,30
Young Boys,882,1,24,6,2,73,31,42,78
FC Basel,882,2,19,7,6,62,29,33,64
Lucerne,882,3,12,7,13,42,46,-4,43
FC Zürich,882,4,11,9,12,41,41,0,42
St Gallen,882,5,13,3,16,40,57,-17,42
Grasshoppers,882,6,10,6,16,40,47,-7,36
FC Lugano,882,7,10,6,16,30,46,-16,36
FC Thun,882,8,9,5,18,43,63,-20,32
FC Sion,882,9,8,7,17,43,54,-11,31
Young Boys,883,1,20,7,5,68,40,28,67
FC Basel,883,2,17,10,5,55,26,29,61
Lucerne,883,3,14,7,11,45,43,2,49
FC Zürich,883,4,12,10,10,42,34,8,46
St Gallen,883,5,14,3,15,41,54,-13,45
FC Lugano,883,6,11,5,16,31,46,-15,38
Grasshoppers,883,7,9,6,17,43,53,-10,33
FC Thun,883,8,9,6,17,43,59,-16,33
FC Sion,883,9,7,8,17,40,53,-13,29
Young Boys,884,1,23,6,3,75,37,38,75
FC Basel,884,2,16,8,8,53,29,24,56
Lucerne,884,3,14,8,10,47,42,5,50
St Gallen,884,4,14,4,14,44,56,-12,46
FC Zürich,884,5,11,10,11,40,33,7,43
FC Lugano,884,6,10,6,16,33,51,-18,36
FC Thun,884,7,9,6,17,42,61,-19,33
Grasshoppers,884,8,8,7,17,39,52,-13,31
FC Sion,884,9,7,9,16,44,56,-12,30
Young Boys,885,1,21,7,4,70,38,32,70
FC Basel,885,2,17,10,5,57,28,29,61
Lucerne,885,3,13,8,11,42,44,-2,47
St Gallen,885,4,14,3,15,43,55,-12,45
FC Zürich,885,5,9,13,10,38,34,4,40
FC Lugano,885,6,10,6,16,30,48,-18,36
Grasshoppers,885,7,9,8,15,41,49,-8,35
FC Thun,885,8,8,8,16,42,59,-17,32
FC Sion,885,9,7,9,16,44,52,-8,30
Young Boys,886,1,21,8,3,71,34,37,71
FC Basel,886,2,16,9,7,51,27,24,57
Lucerne,886,3,13,7,12,46,47,-1,46
St Gallen,886,4,14,2,16,40,57,-17,44
FC Zürich,886,5,11,10,11,39,36,3,43
FC Lugano,886,6,12,5,15,36,46,-10,41
FC Thun,886,7,10,6,16,46,57,-11,36
Grasshoppers,886,8,9,6,17,42,57,-15,33
FC Sion,886,9,7,9,16,44,54,-10,30
Young Boys,887,1,20,9,3,72,38,34,69
FC Basel,887,2,19,7,6,62,26,36,64
St Gallen,887,3,14,4,14,44,56,-12,46
Lucerne,887,4,11,10,11,40,45,-5,43
FC Lugano,887,5,12,6,14,32,43,-11,42
FC Zürich,887,6,9,10,13,38,41,-3,37
Grasshoppers,887,7,9,8,15,41,52,-11,35
FC Thun,887,8,9,7,16,43,57,-14,34
FC Sion,887,9,5,11,16,40,54,-14,26
Young Boys,888,1,21,8,3,71,35,36,71
FC Basel,888,2,18,9,5,60,24,36,63
Lucerne,888,3,13,7,12,40,45,-5,46
St Gallen,888,4,13,4,15,39,52,-13,43
FC Zürich,888,5,10,10,12,40,39,1,40
Grasshoppers,888,6,11,6,15,46,50,-4,39
FC Lugano,888,7,10,7,15,33,46,-13,37
FC Thun,888,8,10,5,17,44,65,-21,35
FC Sion,888,9,6,8,18,39,56,-17,26
Young Boys,889,1,23,6,3,76,39,37,75
FC Basel,889,2,16,10,6,52,27,25,58
Lucerne,889,3,13,8,11,43,43,0,47
St Gallen,889,4,13,5,14,43,57,-14,44
FC Thun,889,5,11,6,15,48,56,-8,39
FC Zürich,889,6,9,11,12,39,37,2,38
FC Lugano,889,7,10,6,16,32,47,-15,36
Grasshoppers,889,8,8,7,17,39,53,-14,31
FC Sion,889,9,7,9,16,42,55,-13,30
Young Boys,890,1,22,6,4,68,37,31,72
FC Basel,890,2,17,8,7,54,24,30,59
Lucerne,890,3,12,9,11,41,45,-4,45
St Gallen,890,4,14,2,16,42,59,-17,44
FC Zürich,890,5,11,10,11,39,35,4,43
Grasshoppers,890,6,11,7,14,44,46,-2,40
FC Lugano,890,7,10,6,16,32,48,-16,36
FC Thun,890,8,9,7,16,41,55,-14,34
FC Sion,890,9,7,7,18,41,53,-12,28
Young Boys,891,1,22,8,2,70,32,38,74
FC Basel,891,2,18,8,6,54,24,30,62
St Gallen,891,3,15,2,15,43,53,-10,47
Lucerne,891,4,13,7,12,43,46,-3,46
FC Lugano,891,5,12,5,15,35,47,-12,41
FC Zürich,891,6,10,10,12,42,38,4,40
Grasshoppers,891,7,9,6,17,41,50,-9,33
FC Thun,891,8,9,6,17,42,64,-22,33
FC Sion,891,9,5,10,17,38,54,-16,25
Young Boys,892,1,22,7,3,76,34,42,73
FC Basel,892,2,16,10,6,53,29,24,58
FC Zürich,892,3,11,10,11,43,35,8,43
Lucerne,892,4,11,10,11,42,48,-6,43
St Gallen,892,5,13,4,15,45,58,-13,43
FC Lugano,892,6,12,6,14,35,47,-12,42
FC Thun,892,7,9,8,15,47,56,-9,35
Grasshoppers,892,8,8,8,16,39,53,-14,32
FC Sion,892,9,7,7,18,43,63,-20,28
Young Boys,893,1,22,7,3,74,36,38,73
FC Basel,893,2,18,7,7,58,30,28,61
St Gallen,893,3,14,2,16,44,56,-12,44
Lucerne,893,4,11,8,13,41,52,-11,41
FC Zürich,893,5,9,12,11,40,38,2,39
Grasshoppers,893,6,11,6,15,43,48,-5,39
FC Lugano,893,7,11,6,15,35,47,-12,39
FC Thun,893,8,10,6,16,44,60,-16,36
FC Sion,893,9,7,8,17,44,56,-12,29
Young Boys,894,1,23,7,2,74,32,42,76
FC Basel,894,2,16,10,6,51,25,26,58
FC Zürich,894,3,13,9,10,46,34,12,48
St Gallen,894,4,14,4,14,41,53,-12,46
Lucerne,894,5,11,9,12,40,44,-4,42
Grasshoppers,894,6,10,6,16,45,54,-9,36
FC Lugano,894,7,9,7,16,28,47,-19,34
FC Sion,894,8,8,7,17,45,56,-11,31
FC Thun,894,9,8,5,19,40,65,-25,29
Young Boys,895,1,19,8,5,68,38,30,65
FC Basel,895,2,18,9,5,54,25,29,63
Lucerne,895,3,14,7,11,44,42,2,49
St Gallen,895,4,14,4,14,43,54,-11,46
FC Zürich,895,5,10,9,13,40,40,0,39
FC Lugano,895,6,10,7,15,31,45,-14,37
Grasshoppers,895,7,10,6,16,44,51,-7,36
FC Thun,895,8,10,6,16,44,58,-14,36
FC Sion,895,9,7,8,17,39,54,-15,29
Young Boys,896,1,21,7,4,74,36,38,70
FC Basel,896,2,19,8,5,64,23,41,65
St Gallen,896,3,15,3,14,43,54,-11,48
Lucerne,896,4,13,7,12,42,48,-6,46
FC Zürich,896,5,9,12,11,40,39,1,39
FC Thun,896,6,9,7,16,46,64,-18,34
FC Sion,896,7,8,9,15,46,54,-8,33
FC Lugano,896,8,9,6,17,33,55,-22,33
Grasshoppers,896,9,8,7,17,39,54,-15,31
Young Boys,897,1,21,6,5,73,36,37,69
FC Basel,897,2,19,7,6,58,26,32,64
St Gallen,897,3,15,2,15,45,57,-12,47
Lucerne,897,4,13,7,12,41,45,-4,46
FC Zürich,897,5,10,10,12,40,37,3,40
Grasshoppers,897,6,10,7,15,42,50,-8,37
FC Lugano,897,7,10,6,16,30,46,-16,36
FC Thun,897,8,9,7,16,43,59,-16,34
FC Sion,897,9,7,8,17,42,58,-16,29
Young Boys,898,1,21,8,3,69,35,34,71
FC Basel,898,2,20,7,5,59,22,37,67
St Gallen,898,3,14,2,16,42,56,-14,44
Lucerne,898,4,12,7,13,43,51,-8,43
FC Zürich,898,5,9,11,12,38,37,1,38
Grasshoppers,898,6,10,7,15,41,49,-8,37
FC Lugano,898,7,10,7,15,32,46,-14,37
FC Thun,898,8,10,6,16,44,56,-12,36
FC Sion,898,9,7,7,18,40,56,-16,28
Young Boys,899,1,21,8,3,71,33,38,71
FC Basel,899,2,19,7,6,58,28,30,64
Lucerne,899,3,13,7,12,40,45,-5,46
St Gallen,899,4,14,3,15,43,55,-12,45
FC Zürich,899,5,11,9,12,42,38,4,42
Grasshoppers,899,6,9,8,15,43,50,-7,35
FC Lugano,899,7,9,7,16,30,50,-20,34
FC Thun,899,8,9,6,17,43,58,-15,33
FC Sion,899,9,8,7,17,43,56,-13,31
Young Boys,900,1,20,8,4,67,34,33,68
FC Basel,900,2,18,9,5,57,29,28,63
St Gallen,900,3,15,3,14,46,56,-10,48
Lucerne,900,4,12,10,10,44,45,-1,46
FC Zürich,900,5,11,11,10,43,35,8,44
Grasshoppers,900,6,9,8,15,41,49,-8,35
FC Thun,900,7,9,7,16,42,57,-15,34
FC Lugano,900,8,9,6,17,31,50,-19,33
FC Sion,900,9,6,8,18,39,55,-16,26
Young Boys,901,1,22,7,3,76,35,41,73
FC Basel,901,2,17,9,6,51,26,25,60
Lucerne,901,3,13,9,10,42,46,-4,48
FC Zürich,901,4,12,9,11,41,33,8,45
St Gallen,901,5,14,3,15,42,54,-12,45
Grasshoppers,901,6,9,7,16,41,49,-8,34
FC Thun,901,7,9,7,16,47,57,-10,34
FC Lugano,901,8,9,6,17,31,50,-19,33
FC Sion,901,9,7,7,18,38,59,-21,28
Young Boys,902,1,20,8,4,71,38,33,68
FC Basel,902,2,17,8,7,49,24,25,59
St Gallen,902,3,15,3,14,40,52,-12,48
FC Zürich,902,4,11,9,12,41,36,5,42
Lucerne,902,5,11,9,12,39,43,-4,42
FC Thun,902,6,11,5,16,44,57,-13,38
Grasshoppers,902,7,10,7,15,42,49,-7,37
FC Lugano,902,8,10,7,15,32,46,-14,37
FC Sion,902,9,7,8,17,40,53,-13,29
Young Boys,903,1,23,7,2,78,34,44,76
FC Basel,903,2,19,7,6,61,26,35,64
St Gallen,903,3,15,2,15,49,61,-12,47
Lucerne,903,4,12,8,12,44,53,-9,44
FC Zürich,903,5,10,11,11,40,37,3,41
FC Lugano,903,6,11,6,15,35,48,-13,39
FC Thun,903,7,9,7,16,41,57,-16,34
Grasshoppers,903,8,9,6,17,43,54,-11,33
FC Sion,903,9,5,8,19,37,58,-21,23
Young Boys,904,1,21,8,3,68,32,36,71
FC Basel,904,2,17,9,6,54,26,28,60
St Gallen,904,3,15,4,13,48,53,-5,49
Lucerne,904,4,11,9,12,39,48,-9,42
FC Zürich,904,5,10,11,11,40,36,4,41
Grasshoppers,904,6,10,7,15,41,49,-8,37
FC Lugano,904,7,9,8,15,30,47,-17,35
FC Sion,904,8,7,10,15,44,54,-10,31
FC Thun,904,9,8,6,18,41,60,-19,30
Young Boys,905,1,21,7,4,71,39,32,70
FC Basel,905,2,20,7,5,61,26,35,67
Lucerne,905,3,13,8,11,44,41,3,47
St Gallen,905,4,15,2,15,43,55,-12,47
FC Zürich,905,5,10,10,12,39,36,3,40
FC Lugano,905,6,11,6,15,29,44,-15,39
Grasshoppers,905,7,9,8,15,41,49,-8,35
FC Thun,905,8,9,6,17,42,59,-17,33
FC Sion,905,9,5,8,19,36,57,-21,23
Young Boys,906,1,22,6,4,73,40,33,72
FC Basel,906,2,19,8,5,59,25,34,65
St Gallen,906,3,15,3,14,44,56,-12,48
FC Zürich,906,4,11,9,12,44,38,6,42
Lucerne,906,5,11,7,14,40,47,-7,40
Grasshoppers,906,6,11,6,15,40,48,-8,39
FC Lugano,906,7,10,5,17,31,49,-18,35
FC Thun,906,8,9,5,18,42,63,-21,32
FC Sion,906,9,8,7,17,46,53,-7,31
Young Boys,907,1,19,8,5,68,38,30,65
FC Basel,907,2,18,8,6,57,25,32,62
FC Zürich,907,3,12,10,10,47,33,14,46
Lucerne,907,4,13,7,12,40,43,-3,46
St Gallen,907,5,14,4,14,44,57,-13,46
FC Lugano,907,6,12,6,14,33,43,-10,42
FC Thun,907,7,10,5,17,44,61,-17,35
Grasshoppers,907,8,8,7,17,40,54,-14,31
FC Sion,907,9,6,9,17,43,62,-19,27
Young Boys,908,1,21,6,5,70,38,32,69
FC Basel,908,2,20,7,5,65,24,41,67
St Gallen,908,3,15,3,14,44,57,-13,48
Lucerne,908,4,12,8,12,40,46,-6,44
FC Zürich,908,5,11,10,11,42,37,5,43
FC Lugano,908,6,10,6,16,32,48,-16,36
FC Thun,908,7,10,5,17,41,60,-19,35
Grasshoppers,908,8,9,7,16,39,47,-8,34
FC Sion,908,9,6,8,18,39,55,-16,26
Young Boys,909,1,21,8,3,68,33,35,71
FC Basel,909,2,17,9,6,52,26,26,60
Lucerne,909,3,13,8,11,46,45,1,47
FC Zürich,909,4,12,10,10,43,33,10,46
St Gallen,909,5,14,2,16,43,59,-16,44
FC Lugano,909,6,10,6,16,31,47,-16,36
Grasshoppers,909,7,9,8,15,41,50,-9,35
FC Thun,909,8,8,7,17,41,62,-21,31
FC Sion,909,9,7,8,17,42,52,-10,29
Young Boys,910,1,21,6,5,73,38,35,69
FC Basel,910,2,17,9,6,53,27,26,60
Lucerne,910,3,15,8,9,47,41,6,53
St Gallen,910,4,15,2,15,45,56,-11,47
FC Zürich,910,5,9,11,12,42,43,-1,38
FC Thun,910,6,10,7,15,48,57,-9,37
Grasshoppers,910,7,10,6,16,39,49,-10,36
FC Lugano,910,8,10,6,16,34,52,-18,36
FC Sion,910,9,5,9,18,42,60,-18,24
Young Boys,911,1,22,6,4,71,38,33,72
FC Basel,911,2,17,7,8,50,26,24,58
Lucerne,911,3,14,9,9,45,40,5,51
FC Zürich,911,4,13,9,10,49,34,15,48
St Gallen,911,5,14,3,15,43,55,-12,45
FC Thun,911,6,10,5,17,43,60,-17,35
FC Lugano,911,7,10,5,17,32,49,-17,35
Grasshoppers,911,8,9,7,16,40,48,-8,34
FC Sion,911,9,6,7,19,36,59,-23,25
Young Boys,912,1,21,7,4,69,33,36,70
FC Basel,912,2,18,8,6,54,25,29,62
Lucerne,912,3,12,9,11,45,48,-3,45
St Gallen,912,4,13,3,16,44,61,-17,42
FC Zürich,912,5,9,12,11,37,34,3,39
FC Lugano,912,6,11,6,15,31,45,-14,39
FC Thun,912,7,10,7,15,45,57,-12,37
Grasshoppers,912,8,9,9,14,41,48,-7,36
FC Sion,912,9,6,9,17,39,54,-15,27
Young Boys,913,1,20,7,5,72,41,31,67
FC Basel,913,2,17,8,7,55,30,25,59
Lucerne,913,3,14,8,10,44,44,0,50
St Gallen,913,4,15,2,15,43,55,-12,47
FC Zürich,913,5,11,11,10,42,36,6,44
FC Thun,913,6,10,6,16,47,58,-11,36
FC Lugano,913,7,9,6,17,34,54,-20,33
FC Sion,913,8,8,8,16,43,51,-8,32
Grasshoppers,913,9,8,8,16,39,50,-11,32
Young Boys,914,1,21,6,5,71,38,33,69
FC Basel,914,2,19,7,6,54,26,28,64
St Gallen,914,3,14,3,15,42,54,-12,45
Lucerne,914,4,12,8,12,41,46,-5,44
FC Lugano,914,5,13,5,14,36,46,-10,44
FC Zürich,914,6,11,9,12,43,38,5,42
Grasshoppers,914,7,8,8,16,38,48,-10,32
FC Thun,914,8,8,7,17,43,60,-17,31
FC Sion,914,9,7,9,16,40,52,-12,30
Young Boys,915,1,22,8,2,76,35,41,74
FC Basel,915,2,18,9,5,56,26,30,63
St Gallen,915,3,15,3,14,45,54,-9,48
FC Zürich,915,4,12,10,10,42,34,8,46
Lucerne,915,5,12,7,13,41,49,-8,43
Grasshoppers,915,6,9,8,15,44,52,-8,35
FC Lugano,915,7,10,5,17,31,49,-18,35
FC Thun,915,8,9,6,17,42,59,-17,33
FC Sion,915,9,5,8,19,35,54,-19,23
Young Boys,916,1,22,6,4,73,38,35,72
FC Basel,916,2,18,9,5,56,23,33,63
Lucerne,916,3,13,8,11,44,41,3,47
St Gallen,916,4,13,5,14,41,54,-13,44
FC Zürich,916,5,10,10,12,40,38,2,40
FC Lugano,916,6,10,6,16,30,48,-18,36
Grasshoppers,916,7,9,7,16,40,55,-15,34
FC Sion,916,8,8,8,16,45,54,-9,32
FC Thun,916,9,9,5,18,42,60,-18,32
Young Boys,917,1,22,7,3,73,36,37,73
FC Basel,917,2,15,8,9,48,28,20,53
St Gallen,917,3,16,3,13,45,52,-7,51
Lucerne,917,4,13,7,12,43,47,-4,46
FC Zürich,917,5,10,9,13,38,36,2,39
Grasshoppers,917,6,11,6,15,49,52,-3,39
FC Lugano,917,7,11,6,15,31,43,-12,39
FC Thun,917,8,10,6,16,44,59,-15,36
FC Sion,917,9,6,8,18,41,59,-18,26
Young Boys,918,1,21,7,4,70,34,36,70
FC Basel,918,2,17,8,7,54,28,26,59
St Gallen,918,3,15,3,14,43,53,-10,48
Lucerne,918,4,12,9,11,40,46,-6,45
FC Zürich,918,5,9,11,12,43,45,-2,38
Grasshoppers,918,6,10,7,15,41,49,-8,37
FC Lugano,918,7,10,6,16,34,48,-14,36
FC Thun,918,8,10,5,17,48,59,-11,35
FC Sion,918,9,8,8,16,41,52,-11,32
Young Boys,919,1,21,9,2,75,33,42,72
FC Basel,919,2,17,10,5,54,24,30,61
St Gallen,919,3,14,5,13,43,53,-10,47
Lucerne,919,4,12,8,12,40,49,-9,44
FC Zürich,919,5,10,11,11,44,40,4,41
FC Thun,919,6,10,7,15,47,60,-13,37
FC Lugano,919,7,9,8,15,32,49,-17,35
Grasshoppers,919,8,8,8,16,43,53,-10,32
FC Sion,919,9,5,10,17,41,58,-17,25
Young Boys,920,1,21,8,3,72,35,37,71
FC Basel,920,2,18,8,6,55,24,31,62
Lucerne,920,3,14,8,10,40,40,0,50
St Gallen,920,4,15,3,14,43,53,-10,48
FC Zürich,920,5,11,10,11,41,39,2,43
FC Lugano,920,6,10,6,16,30,47,-17,36
FC Thun,920,7,10,5,17,45,58,-13,35
Grasshoppers,920,8,9,7,16,41,51,-10,34
FC Sion,920,9,5,7,20,40,60,-20,22
FC Basel,921,1,20,7,5,58,25,33,67
Young Boys,921,2,20,7,5,67,37,30,67
Lucerne,921,3,14,7,11,45,44,1,49
St Gallen,921,4,14,2,16,39,57,-18,44
FC Lugano,921,5,11,5,16,33,45,-12,38
FC Zürich,921,6,9,10,13,38,42,-4,37
FC Thun,921,7,10,6,16,49,59,-10,36
Grasshoppers,921,8,8,9,15,40,50,-10,33
FC Sion,921,9,7,9,16,41,51,-10,30
Young Boys,922,1,21,7,4,69,35,34,70
FC Basel,922,2,17,7,8,51,26,25,58
Lucerne,922,3,13,9,10,40,39,1,48
FC Zürich,922,4,11,11,10,42,36,6,44
St Gallen,922,5,14,2,16,40,54,-14,44
Grasshoppers,922,6,11,7,14,47,47,0,40
FC Lugano,922,7,11,6,15,32,46,-14,39
FC Thun,922,8,9,5,18,43,61,-18,32
FC Sion,922,9,6,8,18,38,58,-20,26
Young Boys,923,1,22,6,4,69,33,36,72
FC Basel,923,2,19,7,6,53,24,29,64
St Gallen,923,3,14,2,16,40,54,-14,44
Lucerne,923,4,11,9,12,43,47,-4,42
FC Zürich,923,5,10,10,12,39,38,1,40
FC Lugano,923,6,10,7,15,32,46,-14,37
FC Thun,923,7,10,6,16,45,58,-13,36
Grasshoppers,923,8,9,7,16,43,52,-9,34
FC Sion,923,9,8,8,16,43,55,-12,32
Young Boys,924,1,22,7,3,71,32,39,73
FC Basel,924,2,16,9,7,50,27,23,57
St Gallen,924,3,15,3,14,44,53,-9,48
FC Zürich,924,4,11,11,10,42,35,7,44
Grasshoppers,924,5,12,6,14,45,44,1,42
Lucerne,924,6,11,7,14,37,46,-9,40
FC Lugano,924,7,10,6,16,30,47,-17,36
FC Thun,924,8,9,6,17,44,60,-16,33
FC Sion,924,9,6,9,17,37,56,-19,27
Young Boys,925,1,21,8,3,72,34,38,71
FC Basel,925,2,18,7,7,53,29,24,61
Lucerne,925,3,12,8,12,40,43,-3,44
FC Zürich,925,4,11,9,12,41,36,5,42
St Gallen,925,5,13,3,16,41,58,-17,42
Grasshoppers,925,6,11,7,14,42,45,-3,40
FC Lugano,925,7,11,6,15,35,47,-12,39
FC Thun,925,8,9,7,16,42,58,-16,34
FC Sion,925,9,6,9,17,37,53,-16,27
Young Boys,926,1,22,8,2,71,34,37,74
FC Basel,926,2,17,7,8,54,27,27,58
Lucerne,926,3,13,9,10,45,43,2,48
FC Zürich,926,4,12,9,11,41,33,8,45
St Gallen,926,5,14,2,16,44,59,-15,44
Grasshoppers,926,6,11,7,14,44,47,-3,40
FC Lugano,926,7,11,6,15,33,47,-14,39
FC Thun,926,8,8,6,18,41,64,-23,30
FC Sion,926,9,5,8,19,39,58,-19,23
Young Boys,927,1,22,6,4,73,37,36,72
FC Basel,927,2,20,7,5,60,25,35,67
Lucerne,927,3,12,9,11,39,41,-2,45
St Gallen,927,4,13,3,16,42,59,-17,42
FC Lugano,927,5,11,5,16,32,48,-16,38
FC Zürich,927,6,9,10,13,38,38,0,37
FC Thun,927,7,10,5,17,44,60,-16,35
Grasshoppers,927,8,9,7,16,41,50,-9,34
FC Sion,927,9,8,8,16,41,52,-11,32
Young Boys,928,1,22,7,3,71,32,39,73
FC Basel,928,2,19,7,6,55,25,30,64
St Gallen,928,3,16,2,14,47,53,-6,50
Lucerne,928,4,12,8,12,40,43,-3,44
FC Zürich,928,5,11,10,11,43,36,7,43
Grasshoppers,928,6,10,7,15,40,47,-7,37
FC Lugano,928,7,9,7,16,29,50,-21,34
FC Thun,928,8,9,5,18,39,60,-21,32
FC Sion,928,9,6,7,19,38,56,-18,25
Young Boys,929,1,23,7,2,69,30,39,76
FC Basel,929,2,16,9,7,53,28,25,57
Lucerne,929,3,13,9,10,43,43,0,48
St Gallen,929,4,14,3,15,42,56,-14,45
FC Zürich,929,5,11,10,11,43,38,5,43
FC Thun,929,6,9,6,17,42,60,-18,33
FC Lugano,929,7,9,6,17,29,49,-20,33
FC Sion,929,8,8,8,16,45,51,-6,32
Grasshoppers,929,9,8,8,16,40,51,-11,32
Young Boys,930,1,22,6,4,72,36,36,72
FC Basel,930,2,17,9,6,57,29,28,60
Lucerne,930,3,15,7,10,45,42,3,52
St Gallen,930,4,13,5,14,43,56,-13,44
FC Zürich,930,5,9,12,11,41,43,-2,39
FC Lugano,930,6,10,6,16,34,46,-12,36
Grasshoppers,930,7,9,6,17,41,52,-11,33
FC Thun,930,8,9,6,17,45,63,-18,33
FC Sion,930,9,7,9,16,42,53,-11,30
Young Boys,931,1,22,7,3,68,32,36,73
FC Basel,931,2,16,9,7,53,30,23,57
Lucerne,931,3,12,10,10,40,40,0,46
St Gallen,931,4,13,4,15,43,57,-14,43
FC Zürich,931,5,10,11,11,40,36,4,41
FC Lugano,931,6,11,6,15,30,44,-14,39
FC Thun,931,7,9,7,16,44,57,-13,34
FC Sion,931,8,8,9,15,42,50,-8,33
Grasshoppers,931,9,8,7,17,37,51,-14,31
Young Boys,932,1,21,8,3,71,37,34,71
FC Basel,932,2,17,9,6,50,26,24,60
St Gallen,932,3,15,4,13,44,52,-8,49
Lucerne,932,4,12,8,12,41,45,-4,44
FC Zürich,932,5,10,10,12,41,39,2,40
FC Lugano,932,6,11,5,16,35,48,-13,38
FC Thun,932,7,9,7,16,42,56,-14,34
Grasshoppers,932,8,8,9,15,39,48,-9,33
FC Sion,932,9,6,10,16,41,53,-12,28
Young Boys,933,1,22,8,2,67,30,37,74
FC Basel,933,2,19,8,5,56,23,33,65
Lucerne,933,3,13,7,12,41,42,-1,46
St Gallen,933,4,14,2,16,41,58,-17,44
FC Zürich,933,5,11,9,12,40,37,3,42
FC Lugano,933,6,10,5,17,32,48,-16,35
Grasshoppers,933,7,9,6,17,39,48,-9,33
FC Sion,933,8,8,8,16,39,50,-11,32
FC Thun,933,9,9,5,18,42,61,-19,32
Young Boys,934,1,21,9,2,76,35,41,72
FC Basel,934,2,17,9,6,57,29,28,60
Lucerne,934,3,12,9,11,43,47,-4,45
FC Zürich,934,4,11,11,10,44,37,7,44
St Gallen,934,5,13,3,16,42,56,-14,42
FC Lugano,934,6,11,5,16,34,53,-19,38
Grasshoppers,934,7,9,8,15,42,51,-9,35
FC Thun,934,8,9,6,17,44,61,-17,33
FC Sion,934,9,6,10,16,44,57,-13,28
Young Boys,935,1,21,7,4,72,40,32,70
FC Basel,935,2,17,9,6,57,26,31,60
Lucerne,935,3,13,10,9,47,45,2,49
FC Zürich,935,4,13,9,10,47,35,12,48
St Gallen,935,5,14,3,15,44,60,-16,45
FC Lugano,935,6,10,5,17,34,50,-16,35
Grasshoppers,935,7,9,7,16,43,50,-7,34
FC Thun,935,8,8,8,16,42,59,-17,32
FC Sion,935,9,6,8,18,38,59,-21,26
Young Boys,936,1,21,6,5,68,34,34,69
FC Basel,936,2,18,9,5,57,27,30,63
Lucerne,936,3,14,9,9,47,42,5,51
St Gallen,936,4,13,3,16,44,60,-16,42
FC Zürich,936,5,10,11,11,42,37,5,41
FC Thun,936,6,10,6,16,47,56,-9,36
FC Lugano,936,7,10,6,16,30,47,-17,36
Grasshoppers,936,8,8,7,17,38,57,-19,31
FC Sion,936,9,7,9,16,41,54,-13,30
Young Boys,937,1,20,8,4,70,36,34,68
FC Basel,937,2,18,9,5,55,24,31,63
Lucerne,937,3,14,8,10,43,43,0,50
St Gallen,937,4,13,4,15,42,56,-14,43
FC Zürich,937,5,10,10,12,38,36,2,40
FC Lugano,937,6,10,6,16,30,46,-16,36
FC Sion,937,7,9,8,15,45,52,-7,35
FC Thun,937,8,9,6,17,41,58,-17,33
Grasshoppers,937,9,8,7,17,41,54,-13,31
Young Boys,938,1,20,9,3,71,37,34,69
FC Basel,938,2,16,9,7,51,27,24,57
St Gallen,938,3,14,4,14,45,55,-10,46
Lucerne,938,4,12,9,11,44,45,-1,45
FC Zürich,938,5,11,11,10,42,35,7,44
Grasshoppers,938,6,11,6,15,45,51,-6,39
FC Lugano,938,7,10,6,16,32,53,-21,36
FC Thun,938,8,9,5,18,43,60,-17,32
FC Sion,938,9,7,9,16,43,53,-10,30
Young Boys,939,1,21,7,4,71,37,34,70
FC Basel,939,2,19,7,6,55,25,30,64
Lucerne,939,3,13,8,11,44,45,-1,47
St Gallen,939,4,14,4,14,42,52,-10,46
FC Zürich,939,5,9,10,13,38,40,-2,37
Grasshoppers,939,6,10,7,15,41,47,-6,37
FC Lugano,939,7,10,7,15,31,47,-16,37
FC Thun,939,8,10,6,16,44,56,-12,36
FC Sion,939,9,6,8,18,39,56,-17,26
Young Boys,940,1,21,8,3,74,33,41,71
FC Basel,940,2,17,9,6,55,30,25,60
Lucerne,940,3,15,7,10,47,41,6,52
St Gallen,940,4,14,3,15,44,56,-12,45
FC Zürich,940,5,11,10,11,41,37,4,43
FC Thun,940,6,11,5,16,48,58,-10,38
FC Lugano,940,7,10,5,17,30,54,-24,35
Grasshoppers,940,8,9,7,16,38,50,-12,34
FC Sion,940,9,5,8,19,39,57,-18,23
Young Boys,941,1,22,6,4,73,37,36,72
FC Basel,941,2,19,8,5,61,25,36,65
St Gallen,941,3,14,3,15,45,59,-14,45
Lucerne,941,4,11,10,11,42,49,-7,43
FC Zürich,941,5,10,10,12,38,37,1,40
FC Lugano,941,6,10,7,15,32,46,-14,37
Grasshoppers,941,7,8,9,15,41,51,-10,33
FC Thun,941,8,8,8,16,43,59,-16,32
FC Sion,941,9,7,9,16,39,51,-12,30
Young Boys,942,1,20,7,5,70,38,32,67
FC Basel,942,2,18,9,5,55,24,31,63
Lucerne,942,3,13,8,11,44,46,-2,47
St Gallen,942,4,14,2,16,46,60,-14,44
FC Zürich,942,5,10,12,10,42,37,5,42
Grasshoppers,942,6,10,7,15,41,47,-6,37
FC Lugano,942,7,10,7,15,36,52,-16,37
FC Thun,942,8,9,7,16,40,55,-15,34
FC Sion,942,9,6,9,17,39,54,-15,27
Young Boys,943,1,20,7,5,69,38,31,67
FC Basel,943,2,17,8,7,50,28,22,59
Lucerne,943,3,14,8,10,41,40,1,50
St Gallen,943,4,15,2,15,44,52,-8,47
Grasshoppers,943,5,11,6,15,47,49,-2,39
FC Lugano,943,6,11,6,15,29,43,-14,39
FC Zürich,943,7,9,11,12,38,38,0,38
FC Thun,943,8,9,7,16,43,57,-14,34
FC Sion,943,9,6,9,17,41,57,-16,27
Young Boys,944,1,23,6,3,81,35,46,75
FC Basel,944,2,18,8,6,62,29,33,62
Lucerne,944,3,13,7,12,43,46,-3,46
St Gallen,944,4,14,3,15,44,57,-13,45
FC Zürich,944,5,10,10,12,42,41,1,40
FC Lugano,944,6,11,6,15,35,53,-18,39
FC Thun,944,7,11,5,16,45,59,-14,38
Grasshoppers,944,8,8,7,17,38,51,-13,31
FC Sion,944,9,6,8,18,40,59,-19,26
Young Boys,945,1,21,7,4,69,36,33,70
FC Basel,945,2,18,8,6,55,25,30,62
Lucerne,945,3,13,8,11,43,43,0,47
St Gallen,945,4,15,2,15,43,58,-15,47
FC Zürich,945,5,12,9,11,42,35,7,45
Grasshoppers,945,6,10,7,15,43,48,-5,37
FC Thun,945,7,9,6,17,44,60,-16,33
FC Lugano,945,8,9,6,17,29,50,-21,33
FC Sion,945,9,7,7,18,42,55,-13,28
Young Boys,946,1,23,6,3,77,36,41,75
FC Basel,946,2,19,7,6,58,28,30,64
St Gallen,946,3,15,2,15,45,57,-12,47
FC Zürich,946,4,11,10,11,43,38,5,43
Lucerne,946,5,12,7,13,39,47,-8,43
FC Thun,946,6,11,5,16,48,58,-10,38
Grasshoppers,946,7,10,6,16,40,49,-9,36
FC Lugano,946,8,9,6,17,31,51,-20,33
FC Sion,946,9,6,7,19,40,57,-17,25
Young Boys,947,1,21,8,3,72,35,37,71
FC Basel,947,2,17,10,5,57,27,30,61
St Gallen,947,3,15,3,14,49,54,-5,48
Lucerne,947,4,13,8,11,44,49,-5,47
FC Zürich,947,5,12,10,10,42,33,9,46
Grasshoppers,947,6,10,6,16,40,50,-10,36
FC Lugano,947,7,9,6,17,29,51,-22,33
FC Thun,947,8,8,6,18,40,59,-19,30
FC Sion,947,9,6,9,17,37,52,-15,27
Young Boys,948,1,20,7,5,70,42,28,67
FC Basel,948,2,17,7,8,54,30,24,58
Lucerne,948,3,15,8,9,48,40,8,53
St Gallen,948,4,15,3,14,44,55,-11,48
FC Zürich,948,5,11,10,11,43,37,6,43
FC Thun,948,6,10,6,16,50,61,-11,36
FC Lugano,948,7,9,7,16,30,49,-19,34
Grasshoppers,948,8,8,7,17,37,53,-16,31
FC Sion,948,9,7,9,16,46,55,-9,30
Young Boys,949,1,21,7,4,71,35,36,70
FC Basel,949,2,17,8,7,56,28,28,59
Lucerne,949,3,13,9,10,40,40,0,48
St Gallen,949,4,14,4,14,43,54,-11,46
FC Zürich,949,5,12,9,11,46,38,8,45
FC Lugano,949,6,10,6,16,30,47,-17,36
Grasshoppers,949,7,9,7,16,39,50,-11,34
FC Thun,949,8,9,6,17,44,64,-20,33
FC Sion,949,9,7,8,17,39,52,-13,29
Young Boys,950,1,22,7,3,71,33,38,73
FC Basel,950,2,19,8,5,54,22,32,65
Lucerne,950,3,14,7,11,44,44,0,49
FC Zürich,950,4,11,9,12,42,36,6,42
St Gallen,950,5,13,2,17,38,54,-16,41
FC Thun,950,6,10,5,17,44,60,-16,35
FC Lugano,950,7,10,5,17,29,48,-19,35
Grasshoppers,950,8,9,6,17,39,50,-11,33
FC Sion,950,9,8,7,17,39,53,-14,31
Young Boys,951,1,20,7,5,69,36,33,67
FC Basel,951,2,18,9,5,57,25,32,63
Lucerne,951,3,13,9,10,44,44,0,48
St Gallen,951,4,13,4,15,44,57,-13,43
FC Zürich,951,5,10,10,12,39,36,3,40
FC Lugano,951,6,11,6,15,33,47,-14,39
Grasshoppers,951,7,10,6,16,43,53,-10,36
FC Thun,951,8,9,6,17,46,64,-18,33
FC Sion,951,9,7,9,16,44,57,-13,30
Young Boys,952,1,22,6,4,71,34,37,72
FC Basel,952,2,20,7,5,58,21,37,67
FC Zürich,952,3,12,9,11,41,35,6,45
St Gallen,952,4,14,2,16,43,58,-15,44
Lucerne,952,5,12,7,13,39,47,-8,43
Grasshoppers,952,6,11,6,15,43,49,-6,39
FC Lugano,952,7,10,5,17,32,50,-18,35
FC Thun,952,8,9,5,18,43,62,-19,32
FC Sion,952,9,7,7,18,45,59,-14,28
Young Boys,953,1,23,7,2,72,33,39,76
FC Basel,953,2,19,7,6,57,23,34,64
Lucerne,953,3,13,8,11,43,46,-3,47
St Gallen,953,4,13,3,16,43,61,-18,42
FC Zürich,953,5,10,10,12,42,41,1,40
FC Lugano,953,6,10,6,16,32,47,-15,36
Grasshoppers,953,7,9,7,16,39,49,-10,34
FC Thun,953,8,9,6,17,45,61,-16,33
FC Sion,953,9,7,8,17,44,56,-12,29
Young Boys,954,1,22,7,3,71,33,38,73
FC Basel,954,2,18,7,7,52,24,28,61
St Gallen,954,3,15,3,14,46,53,-7,48
Lucerne,954,4,12,9,11,40,45,-5,45
FC Zürich,954,5,11,10,11,44,40,4,43
FC Lugano,954,6,11,5,16,34,49,-15,38
Grasshoppers,954,7,10,7,15,44,50,-6,37
FC Thun,954,8,9,6,17,44,60,-16,33
FC Sion,954,9,5,8,19,43,64,-21,23
Young Boys,955,1,20,8,4,70,38,32,68
FC Basel,955,2,20,7,5,55,21,34,67
St Gallen,955,3,15,2,15,47,56,-9,47
Lucerne,955,4,12,7,13,42,47,-5,43
FC Lugano,955,5,12,6,14,36,44,-8,42
FC Zürich,955,6,9,10,13,38,38,0,37
Grasshoppers,955,7,9,8,15,41,51,-10,35
FC Sion,955,8,8,8,16,43,53,-10,32
FC Thun,955,9,8,6,18,41,65,-24,30
Young Boys,956,1,22,6,4,73,36,37,72
FC Basel,956,2,18,7,7,55,29,26,61
Lucerne,956,3,14,8,10,46,43,3,50
St Gallen,956,4,14,3,15,42,55,-13,45
FC Zürich,956,5,11,9,12,41,37,4,42
Grasshoppers,956,6,10,6,16,46,52,-6,36
FC Thun,956,7,10,6,16,44,59,-15,36
FC Lugano,956,8,9,5,18,29,49,-20,32
FC Sion,956,9,7,8,17,41,57,-16,29
Young Boys,957,1,22,8,2,74,35,39,74
FC Basel,957,2,17,9,6,57,32,25,60
Lucerne,957,3,12,9,11,43,45,-2,45
FC Zürich,957,4,11,11,10,46,38,8,44
St Gallen,957,5,13,2,17,39,56,-17,41
FC Thun,957,6,10,7,15,47,58,-11,37
FC Lugano,957,7,10,7,15,33,47,-14,37
Grasshoppers,957,8,8,7,17,41,55,-14,31
FC Sion,957,9,7,8,17,38,52,-14,29
Young Boys,958,1,21,6,5,72,38,34,69
FC Basel,958,2,19,7,6,57,28,29,64
Lucerne,958,3,12,8,12,43,47,-4,44
St Gallen,958,4,14,2,16,44,57,-13,44
FC Zürich,958,5,11,10,11,42,36,6,43
FC Lugano,958,6,12,5,15,37,51,-14,41
Grasshoppers,958,7,9,9,14,42,48,-6,36
FC Thun,958,8,9,6,17,43,61,-18,33
FC Sion,958,9,6,9,17,41,55,-14,27
Young Boys,959,1,21,7,4,70,38,32,70
FC Basel,959,2,16,9,7,50,27,23,57
Lucerne,959,3,13,9,10,45,42,3,48
FC Zürich,959,4,12,10,10,43,33,10,46
St Gallen,959,5,13,3,16,44,59,-15,42
FC Thun,959,6,10,7,15,43,55,-12,37
FC Lugano,959,7,10,7,15,33,49,-16,37
Grasshoppers,959,8,9,7,16,42,51,-9,34
FC Sion,959,9,7,7,18,39,55,-16,28
Young Boys,960,1,20,8,4,72,39,33,68
FC Basel,960,2,17,8,7,55,30,25,59
Lucerne,960,3,12,11,9,43,43,0,47
St Gallen,960,4,13,4,15,38,52,-14,43
FC Zürich,960,5,9,11,12,39,37,2,38
FC Lugano,960,6,9,9,14,32,47,-15,36
FC Sion,960,7,9,8,15,43,52,-9,35
FC Thun,960,8,9,8,15,45,57,-12,35
Grasshoppers,960,9,9,7,16,40,50,-10,34
Young Boys,961,1,22,8,2,77,33,44,74
FC Basel,961,2,16,9,7,53,29,24,57
Lucerne,961,3,14,8,10,45,41,4,50
St Gallen,961,4,15,2,15,44,58,-14,47
FC Zürich,961,5,10,11,11,38,35,3,41
FC Lugano,961,6,10,5,17,29,48,-19,35
Grasshoppers,961,7,9,7,16,40,50,-10,34
FC Thun,961,8,9,5,18,43,61,-18,32
FC Sion,961,9,7,9,16,41,55,-14,30
Young Boys,962,1,21,6,5,74,40,34,69
FC Basel,962,2,19,8,5,56,25,31,65
St Gallen,962,3,15,2,15,42,53,-11,47
Lucerne,962,4,12,7,13,39,45,-6,43
FC Zürich,962,5,10,11,11,37,34,3,41
Grasshoppers,962,6,11,7,14,44,47,-3,40
FC Lugano,962,7,10,6,16,29,46,-17,36
FC Thun,962,8,10,5,17,43,58,-15,35
FC Sion,962,9,6,8,18,36,52,-16,26
Young Boys,963,1,21,9,2,71,32,39,72
FC Basel,963,2,17,9,6,50,24,26,60
St Gallen,963,3,15,3,14,44,53,-9,48
Lucerne,963,4,13,7,12,39,45,-6,46
FC Zürich,963,5,10,11,11,39,35,4,41
FC Lugano,963,6,10,7,15,32,47,-15,37
FC Thun,963,7,10,6,16,47,60,-13,36
Grasshoppers,963,8,9,6,17,39,50,-11,33
FC Sion,963,9,5,10,17,40,55,-15,25
Young Boys,964,1,22,8,2,69,30,39,74
FC Basel,964,2,16,9,7,55,31,24,57
St Gallen,964,3,15,2,15,42,56,-14,47
FC Zürich,964,4,12,10,10,47,38,9,46
Lucerne,964,5,12,8,12,41,44,-3,44
Grasshoppers,964,6,10,7,15,41,48,-7,37
FC Lugano,964,7,10,6,16,33,48,-15,36
FC Thun,964,8,8,8,16,46,63,-17,32
FC Sion,964,9,6,8,18,39,55,-16,26
Young Boys,965,1,21,9,2,72,36,36,72
FC Basel,965,2,17,10,5,54,25,29,61
Lucerne,965,3,13,9,10,46,46,0,48
St Gallen,965,4,13,4,15,42,60,-18,43
FC Zürich,965,5,10,11,11,42,38,4,41
FC Lugano,965,6,10,6,16,34,51,-17,36
Grasshoppers,965,7,9,8,15,44,51,-7,35
FC Thun,965,8,8,7,17,42,60,-18,31
FC Sion,965,9,6,10,16,45,54,-9,28
Young Boys,966,1,21,8,3,69,33,36,71
FC Basel,966,2,17,8,7,52,25,27,59
FC Zürich,966,3,12,10,10,46,38,8,46
Lucerne,966,4,12,9,11,42,46,-4,45
St Gallen,966,5,14,3,15,41,53,-12,45
Grasshoppers,966,6,10,7,15,41,48,-7,37
FC Lugano,966,7,10,5,17,30,48,-18,35
FC Thun,966,8,9,6,17,41,57,-16,33
FC Sion,966,9,7,8,17,40,54,-14,29
Young Boys,967,1,22,6,4,74,38,36,72
FC Basel,967,2,19,7,6,58,25,33,64
St Gallen,967,3,15,2,15,42,55,-13,47
Lucerne,967,4,12,7,13,43,49,-6,43
FC Zürich,967,5,10,10,12,40,36,4,40
FC Lugano,967,6,11,5,16,34,48,-14,38
FC Thun,967,7,10,5,17,44,59,-15,35
Grasshoppers,967,8,9,6,17,41,56,-15,33
FC Sion,967,9,8,8,16,41,51,-10,32
Young Boys,968,1,21,8,3,70,35,35,71
FC Basel,968,2,18,8,6,55,28,27,62
Lucerne,968,3,14,8,10,45,42,3,50
St Gallen,968,4,14,4,14,42,53,-11,46
FC Zürich,968,5,11,10,11,40,34,6,43
FC Lugano,968,6,10,8,14,31,43,-12,38
FC Thun,968,7,10,5,17,42,59,-17,35
Grasshoppers,968,8,9,6,17,42,50,-8,33
FC Sion,968,9,5,7,20,37,60,-23,22
Young Boys,969,1,21,8,3,75,38,37,71
FC Basel,969,2,16,8,8,50,28,22,56
St Gallen,969,3,15,3,14,45,54,-9,48
Lucerne,969,4,12,11,9,41,41,0,47
FC Zürich,969,5,11,11,10,42,34,8,44
FC Lugano,969,6,9,8,15,32,49,-17,35
Grasshoppers,969,7,9,7,16,41,53,-12,34
FC Sion,969,8,8,8,16,45,55,-10,32
FC Thun,969,9,8,6,18,40,59,-19,30
Young Boys,970,1,20,8,4,70,37,33,68
FC Basel,970,2,16,9,7,51,28,23,57
FC Zürich,970,3,13,9,10,45,33,12,48
St Gallen,970,4,15,2,15,43,53,-10,47
Lucerne,970,5,12,9,11,45,48,-3,45
FC Thun,970,6,11,5,16,48,59,-11,38
FC Lugano,970,7,10,5,17,31,49,-18,35
Grasshoppers,970,8,9,7,16,42,54,-12,34
FC Sion,970,9,7,8,17,42,56,-14,29
Young Boys,971,1,21,7,4,75,37,38,70
FC Basel,971,2,17,9,6,58,27,31,60
Lucerne,971,3,13,9,10,44,44,0,48
St Gallen,971,4,15,2,15,49,58,-9,47
FC Zürich,971,5,9,11,12,40,39,1,38
FC Thun,971,6,10,6,16,44,61,-17,36
FC Lugano,971,7,10,6,16,31,50,-19,36
Grasshoppers,971,8,9,8,15,42,52,-10,35
FC Sion,971,9,7,8,17,45,60,-15,29
Young Boys,972,1,21,8,3,73,33,40,71
FC Basel,972,2,16,9,7,50,28,22,57
St Gallen,972,3,15,2,15,46,53,-7,47
FC Zürich,972,4,12,9,11,44,36,8,45
Lucerne,972,5,12,9,11,41,44,-3,45
FC Lugano,972,6,11,6,15,32,47,-15,39
FC Thun,972,7,11,5,16,46,57,-11,38
Grasshoppers,972,8,10,7,15,41,48,-7,37
FC Sion,972,9,5,7,20,36,63,-27,22
Young Boys,973,1,21,6,5,71,36,35,69
FC Basel,973,2,20,7,5,63,23,40,67
St Gallen,973,3,15,2,15,45,55,-10,47
Lucerne,973,4,12,8,12,42,54,-12,44
FC Zürich,973,5,10,11,11,40,38,2,41
FC Lugano,973,6,11,7,14,33,44,-11,40
FC Thun,973,7,9,6,17,41,56,-15,33
FC Sion,973,8,8,7,17,38,51,-13,31
Grasshoppers,973,9,8,6,18,37,53,-16,30
Young Boys,974,1,21,9,2,78,38,40,72
FC Basel,974,2,16,8,8,51,27,24,56
Lucerne,974,3,14,9,9,45,42,3,51
St Gallen,974,4,14,2,16,42,55,-13,44
FC Zürich,974,5,11,10,11,43,37,6,43
FC Lugano,974,6,11,6,15,33,50,-17,39
FC Thun,974,7,9,6,17,42,60,-18,33
FC Sion,974,8,7,10,15,44,55,-11,31
Grasshoppers,974,9,8,6,18,41,55,-14,30
Young Boys,975,1,21,6,5,72,38,34,69
FC Basel,975,2,17,8,7,54,30,24,59
Lucerne,975,3,14,7,11,43,45,-2,49
St Gallen,975,4,13,3,16,39,57,-18,42
FC Lugano,975,5,12,5,15,40,48,-8,41
FC Zürich,975,6,10,10,12,42,40,2,40
Grasshoppers,975,7,10,7,15,45,49,-4,37
FC Thun,975,8,9,7,16,45,59,-14,34
FC Sion,975,9,8,7,17,39,53,-14,31
Young Boys,976,1,20,9,3,70,35,35,69
FC Basel,976,2,17,10,5,52,24,28,61
St Gallen,976,3,15,4,13,49,51,-2,49
Lucerne,976,4,12,8,12,39,46,-7,44
FC Zürich,976,5,10,9,13,42,41,1,39
Grasshoppers,976,6,10,7,15,42,49,-7,37
FC Lugano,976,7,10,6,16,29,48,-19,36
FC Thun,976,8,9,6,17,44,60,-16,33
FC Sion,976,9,7,9,16,42,55,-13,30
Young Boys,977,1,20,7,5,69,35,34,67
FC Basel,977,2,16,9,7,50,27,23,57
St Gallen,977,3,15,4,13,43,52,-9,49
Lucerne,977,4,12,10,10,44,46,-2,46
FC Zürich,977,5,11,10,11,41,37,4,43
Grasshoppers,977,6,11,7,14,42,44,-2,40
FC Lugano,977,7,11,6,15,36,50,-14,39
FC Thun,977,8,9,6,17,41,57,-16,33
FC Sion,977,9,6,7,19,37,55,-18,25
Young Boys,978,1,22,7,3,72,33,39,73
FC Basel,978,2,18,9,5,55,22,33,63
Lucerne,978,3,14,7,11,47,48,-1,49
FC Zürich,978,4,12,9,11,42,35,7,45
St Gallen,978,5,14,3,15,43,54,-11,45
FC Lugano,978,6,10,5,17,31,51,-20,35
FC Thun,978,7,9,5,18,41,60,-19,32
Grasshoppers,978,8,8,7,17,39,54,-15,31
FC Sion,978,9,7,8,17,37,50,-13,29
Young Boys,979,1,20,9,3,69,35,34,69
FC Basel,979,2,17,9,6,56,28,28,60
Lucerne,979,3,15,8,9,45,41,4,53
St Gallen,979,4,15,3,14,48,56,-8,48
FC Zürich,979,5,10,11,11,39,33,6,41
Grasshoppers,979,6,9,7,16,43,53,-10,34
FC Lugano,979,7,9,7,16,31,49,-18,34
FC Thun,979,8,9,5,18,43,64,-21,32
FC Sion,979,9,7,7,18,37,52,-15,28
Young Boys,980,1,22,7,3,79,35,44,73
FC Basel,980,2,17,9,6,52,26,26,60
Lucerne,980,3,14,7,11,45,46,-1,49
St Gallen,980,4,14,4,14,47,54,-7,46
FC Zürich,980,5,11,11,10,41,34,7,44
Grasshoppers,980,6,10,6,16,41,49,-8,36
FC Thun,980,7,9,6,17,41,59,-18,33
FC Lugano,980,8,9,6,17,29,55,-26,33
FC Sion,980,9,5,10,17,38,55,-17,25
Young Boys,981,1,21,8,3,76,36,40,71
FC Basel,981,2,16,9,7,53,30,23,57
Lucerne,981,3,13,9,10,46,42,4,48
St Gallen,981,4,14,2,16,43,59,-16,44
FC Zürich,981,5,11,9,12,43,40,3,42
Grasshoppers,981,6,11,6,15,43,48,-5,39
FC Thun,981,7,11,5,16,44,56,-12,38
FC Lugano,981,8,10,5,17,34,56,-22,35
FC Sion,981,9,7,7,18,44,59,-15,28
Young Boys,982,1,20,9,3,69,36,33,69
FC Basel,982,2,18,7,7,54,29,25,61
St Gallen,982,3,15,4,13,46,55,-9,49
Lucerne,982,4,12,10,10,45,45,0,46
FC Zürich,982,5,11,10,11,44,36,8,43
Grasshoppers,982,6,9,8,15,39,48,-9,35
FC Lugano,982,7,9,8,15,30,46,-16,35
FC Thun,982,8,9,7,16,45,60,-15,34
FC Sion,982,9,6,7,19,39,56,-17,25
Young Boys,983,1,21,6,5,69,37,32,69
FC Basel,983,2,18,9,5,52,23,29,63
Lucerne,983,3,12,8,12,42,46,-4,44
St Gallen,983,4,13,4,15,41,54,-13,43
Grasshoppers,983,5,12,6,14,44,47,-3,42
FC Zürich,983,6,9,11,12,36,37,-1,38
FC Lugano,983,7,10,6,16,29,45,-16,36
FC Thun,983,8,10,5,17,45,56,-11,35
FC Sion,983,9,8,7,17,39,52,-13,31
Young Boys,984,1,22,8,2,73,34,39,74
FC Basel,984,2,16,11,5,56,29,27,59
FC Zürich,984,3,12,10,10,45,36,9,46
Lucerne,984,4,12,9,11,41,43,-2,45
St Gallen,984,5,13,5,14,41,53,-12,44
FC Lugano,984,6,11,5,16,32,48,-16,38
FC Thun,984,7,9,7,16,43,58,-15,34
Grasshoppers,984,8,9,6,17,41,51,-10,33
FC Sion,984,9,5,9,18,36,56,-20,24
Young Boys,985,1,21,7,4,70,36,34,70
FC Basel,985,2,16,10,6,49,24,25,58
St Gallen,985,3,13,6,13,41,52,-11,45
Lucerne,985,4,11,9,12,40,47,-7,42
FC Zürich,985,5,10,11,11,42,37,5,41
Grasshoppers,985,6,10,7,15,44,50,-6,37
FC Lugano,985,7,10,7,15,33,48,-15,37
FC Thun,985,8,10,6,16,44,58,-14,36
FC Sion,985,9,7,9,16,42,53,-11,30
Young Boys,986,1,20,8,4,70,37,33,68
FC Basel,986,2,17,9,6,55,25,30,60
Lucerne,986,3,13,9,10,42,42,0,48
FC Zürich,986,4,12,9,11,42,37,5,45
St Gallen,986,5,13,3,16,40,56,-16,42
Grasshoppers,986,6,11,6,15,44,51,-7,39
FC Lugano,986,7,10,6,16,30,47,-17,36
FC Thun,986,8,9,6,17,46,59,-13,33
FC Sion,986,9,7,8,17,42,57,-15,29
Young Boys,987,1,21,6,5,71,39,32,69
FC Basel,987,2,18,9,5,56,25,31,63
St Gallen,987,3,14,3,15,45,55,-10,45
Lucerne,987,4,11,10,11,41,47,-6,43
FC Zürich,987,5,10,10,12,42,40,2,40
Grasshoppers,987,6,10,6,16,42,49,-7,36
FC Thun,987,7,10,6,16,46,58,-12,36
FC Sion,987,8,9,8,15,42,50,-8,35
FC Lugano,987,9,9,6,17,27,49,-22,33
Young Boys,988,1,20,8,4,70,35,35,68
FC Basel,988,2,18,8,6,54,24,30,62
Lucerne,988,3,14,7,11,41,43,-2,49
St Gallen,988,4,14,2,16,40,54,-14,44
FC Zürich,988,5,11,10,11,42,35,7,43
FC Lugano,988,6,12,6,14,31,43,-12,42
Grasshoppers,988,7,9,7,16,40,48,-8,34
FC Sion,988,8,8,7,17,41,52,-11,31
FC Thun,988,9,8,5,19,39,64,-25,29
Young Boys,989,1,22,7,3,73,36,37,73
FC Basel,989,2,18,7,7,53,24,29,61
St Gallen,989,3,15,2,15,44,57,-13,47
FC Zürich,989,4,12,10,10,43,33,10,46
Lucerne,989,5,13,7,12,43,46,-3,46
FC Thun,989,6,11,5,16,44,59,-15,38
FC Lugano,989,7,9,6,17,32,52,-20,33
Grasshoppers,989,8,8,6,18,38,53,-15,30
FC Sion,989,9,7,8,17,44,54,-10,29
Young Boys,990,1,21,6,5,71,35,36,69
FC Basel,990,2,17,8,7,54,27,27,59
Lucerne,990,3,14,7,11,44,43,1,49
St Gallen,990,4,14,2,16,44,59,-15,44
FC Zürich,990,5,11,10,11,42,37,5,43
FC Lugano,990,6,12,5,15,34,47,-13,41
Grasshoppers,990,7,11,6,15,42,50,-8,39
FC Thun,990,8,8,8,16,42,58,-16,32
FC Sion,990,9,6,8,18,41,58,-17,26
Young Boys,991,1,22,7,3,76,35,41,73
FC Basel,991,2,18,9,5,56,23,33,63
St Gallen,991,3,16,3,13,43,50,-7,51
Lucerne,991,4,12,7,13,41,47,-6,43
FC Zürich,991,5,10,11,11,42,38,4,41
FC Lugano,991,6,11,5,16,32,48,-16,38
Grasshoppers,991,7,9,8,15,44,53,-9,35
FC Thun,991,8,9,6,17,45,60,-15,33
FC Sion,991,9,5,8,19,37,62,-25,23
Young Boys,992,1,22,8,2,73,32,41,74
FC Basel,992,2,18,8,6,56,26,30,62
Lucerne,992,3,12,10,10,40,41,-1,46
St Gallen,992,4,13,4,15,43,57,-14,43
FC Zürich,992,5,10,11,11,40,38,2,41
FC Thun,992,6,11,5,16,45,57,-12,38
FC Lugano,992,7,9,9,14,31,46,-15,36
Grasshoppers,992,8,8,6,18,37,52,-15,30
FC Sion,992,9,7,7,18,41,57,-16,28
Young Boys,993,1,19,8,5,66,38,28,65
FC Basel,993,2,17,8,7,49,23,26,59
St Gallen,993,3,17,2,13,46,51,-5,53
FC Zürich,993,4,13,9,10,42,32,10,48
Lucerne,993,5,11,10,11,40,43,-3,43
FC Thun,993,6,10,6,16,45,56,-11,36
Grasshoppers,993,7,9,8,15,41,48,-7,35
FC Lugano,993,8,9,7,16,29,47,-18,34
FC Sion,993,9,6,8,18,40,60,-20,26
Young Boys,994,1,22,6,4,73,39,34,72
FC Basel,994,2,18,9,5,57,25,32,63
St Gallen,994,3,15,4,13,44,52,-8,49
Lucerne,994,4,12,8,12,43,47,-4,44
FC Thun,994,5,11,6,15,45,56,-11,39
FC Lugano,994,6,11,5,16,33,47,-14,38
FC Zürich,994,7,9,9,14,37,38,-1,36
Grasshoppers,994,8,10,6,16,43,53,-10,36
FC Sion,994,9,6,7,19,37,55,-18,25
Young Boys,995,1,20,7,5,69,36,33,67
FC Basel,995,2,18,7,7,55,28,27,61
Lucerne,995,3,13,9,10,45,47,-2,48
St Gallen,995,4,14,3,15,44,55,-11,45
FC Zürich,995,5,11,10,11,42,36,6,43
Grasshoppers,995,6,9,9,14,44,49,-5,36
FC Lugano,995,7,10,6,16,30,49,-19,36
FC Sion,995,8,8,8,16,40,50,-10,32
FC Thun,995,9,8,7,17,42,61,-19,31
Young Boys,996,1,20,7,5,73,40,33,67
FC Basel,996,2,19,8,5,56,25,31,65
Lucerne,996,3,12,8,12,45,47,-2,44
St Gallen,996,4,14,2,16,41,57,-16,44
FC Zürich,996,5,10,10,12,40,38,2,40
FC Lugano,996,6,10,8,14,35,48,-13,38
Grasshoppers,996,7,10,7,15,45,54,-9,37
FC Thun,996,8,10,6,16,51,60,-9,36
FC Sion,996,9,7,8,17,43,60,-17,29
Young Boys,997,1,21,7,4,74,38,36,70
FC Basel,997,2,17,8,7,52,27,25,59
FC Zürich,997,3,13,9,10,42,32,10,48
St Gallen,997,4,15,3,14,46,58,-12,48
Lucerne,997,5,12,8,12,40,49,-9,44
FC Lugano,997,6,10,6,16,34,49,-15,36
FC Sion,997,7,9,7,16,46,51,-5,34
Grasshoppers,997,8,8,8,16,37,49,-12,32
FC Thun,997,9,8,6,18,39,57,-18,30
Young Boys,998,1,21,7,4,68,33,35,70
FC Basel,998,2,19,7,6,52,22,30,64
Lucerne,998,3,14,7,11,43,43,0,49
St Gallen,998,4,13,3,16,40,57,-17,42
FC Zürich,998,5,9,11,12,38,37,1,38
Grasshoppers,998,6,10,8,14,43,48,-5,38
FC Lugano,998,7,11,5,16,35,49,-14,38
FC Thun,998,8,9,7,16,43,59,-16,34
FC Sion,998,9,6,9,17,39,53,-14,27
Young Boys,999,1,21,7,4,73,37,36,70
FC Basel,999,2,18,8,6,54,26,28,62
Lucerne,999,3,13,9,10,47,43,4,48
St Gallen,999,4,14,2,16,42,58,-16,44
FC Zürich,999,5,11,10,11,43,37,6,43
Grasshoppers,999,6,11,6,15,44,53,-9,39
FC Lugano,999,7,11,6,15,32,49,-17,39
FC Thun,999,8,9,5,18,46,61,-15,32
FC Sion,999,9,6,7,19,42,59,-17,25
Young Boys,1000,1,23,7,2,73,32,41,76
FC Basel,1000,2,18,9,5,55,23,32,63
St Gallen,1000,3,15,2,15,41,54,-13,47
Lucerne,1000,4,12,9,11,39,45,-6,45
FC Zürich,1000,5,10,9,13,39,36,3,39
FC Thun,1000,6,10,6,16,45,59,-14,36
FC Lugano,1000,7,10,6,16,30,46,-16,36
Grasshoppers,1000,8,8,7,17,38,49,-11,31
FC Sion,1000,9,7,7,18,39,55,-16,28
Young Boys,1001,1,22,7,3,76,38,38,73
FC Basel,1001,2,18,8,6,56,29,27,62
St Gallen,1001,3,14,3,15,42,54,-12,45
Lucerne,1001,4,11,9,12,43,50,-7,42
FC Zürich,1001,5,10,10,12,41,39,2,40
FC Lugano,1001,6,11,7,14,33,45,-12,40
Grasshoppers,1001,7,10,8,14,47,52,-5,38
FC Thun,1001,8,9,5,18,48,65,-17,32
FC Sion,1001,9,6,9,17,41,55,-14,27
Young Boys,1002,1,20,7,5,68,35,33,67
FC Basel,1002,2,19,7,6,58,28,30,64
St Gallen,1002,3,15,2,15,46,57,-11,47
Lucerne,1002,4,12,8,12,40,47,-7,44
FC Zürich,1002,5,11,10,11,45,40,5,43
Grasshoppers,1002,6,9,8,15,44,51,-7,35
FC Sion,1002,7,9,7,16,44,52,-8,34
FC Lugano,1002,8,9,7,16,35,53,-18,34
FC Thun,1002,9,9,6,17,45,62,-17,33
Young Boys,1003,1,22,7,3,72,36,36,73
FC Basel,1003,2,16,9,7,52,26,26,57
St Gallen,1003,3,16,2,14,46,54,-8,50
FC Zürich,1003,4,11,11,10,42,34,8,44
Lucerne,1003,5,12,7,13,41,45,-4,43
Grasshoppers,1003,6,10,7,15,45,50,-5,37
FC Lugano,1003,7,10,5,17,30,51,-21,35
FC Sion,1003,8,7,10,15,43,53,-10,31
FC Thun,1003,9,8,6,18,38,60,-22,30
Young Boys,1004,1,22,6,4,73,34,39,72
FC Basel,1004,2,19,8,5,53,21,32,65
Lucerne,1004,3,14,9,9,46,40,6,51
St Gallen,1004,4,14,3,15,41,54,-13,45
FC Zürich,1004,5,10,9,13,38,38,0,39
Grasshoppers,1004,6,10,6,16,40,51,-11,36
FC Lugano,1004,7,10,6,16,29,48,-19,36
FC Thun,1004,8,9,5,18,41,58,-17,32
FC Sion,1004,9,6,8,18,40,57,-17,26
Young Boys,1005,1,22,6,4,70,34,36,72
FC Basel,1005,2,18,8,6,54,24,30,62
St Gallen,1005,3,15,2,15,44,54,-10,47
Lucerne,1005,4,12,7,13,40,48,-8,43
FC Zürich,1005,5,10,10,12,42,39,3,40
FC Thun,1005,6,11,6,15,43,55,-12,39
FC Lugano,1005,7,11,5,16,34,50,-16,38
Grasshoppers,1005,8,9,6,17,43,54,-11,33
FC Sion,1005,9,7,8,17,43,55,-12,29
Young Boys,1006,1,23,7,2,77,35,42,76
FC Basel,1006,2,18,8,6,56,30,26,62
St Gallen,1006,3,14,4,14,42,52,-10,46
FC Zürich,1006,4,11,9,12,44,35,9,42
Lucerne,1006,5,11,7,14,39,49,-10,40
FC Lugano,1006,6,11,6,15,30,45,-15,39
Grasshoppers,1006,7,10,7,15,42,49,-7,37
FC Thun,1006,8,9,5,18,39,61,-22,32
FC Sion,1006,9,6,9,17,41,54,-13,27
Young Boys,1007,1,21,6,5,72,39,33,69
FC Basel,1007,2,19,8,5,54,23,31,65
Lucerne,1007,3,12,10,10,42,43,-1,46
St Gallen,1007,4,14,4,14,43,54,-11,46
FC Zürich,1007,5,9,10,13,39,38,1,37
Grasshoppers,1007,6,9,8,15,41,49,-8,35
FC Thun,1007,7,9,8,15,41,55,-14,35
FC Lugano,1007,8,9,7,16,30,49,-19,34
FC Sion,1007,9,7,9,16,42,54,-12,30
Young Boys,1008,1,23,6,3,74,35,39,75
FC Basel,1008,2,18,8,6,60,25,35,62
St Gallen,1008,3,15,2,15,44,58,-14,47
Lucerne,1008,4,12,8,12,41,46,-5,44
FC Zürich,1008,5,10,9,13,40,42,-2,39
FC Lugano,1008,6,11,5,16,33,48,-15,38
FC Thun,1008,7,10,7,15,48,59,-11,37
Grasshoppers,1008,8,9,8,15,46,50,-4,35
FC Sion,1008,9,6,7,19,40,63,-23,25
Young Boys,1009,1,22,7,3,70,36,34,73
FC Basel,1009,2,18,7,7,58,27,31,61
St Gallen,1009,3,15,4,13,43,52,-9,49
Lucerne,1009,4,12,9,11,41,44,-3,45
FC Zürich,1009,5,10,9,13,42,40,2,39
FC Thun,1009,6,11,5,16,48,61,-13,38
FC Lugano,1009,7,10,6,16,31,46,-15,36
Grasshoppers,1009,8,9,6,17,42,50,-8,33
FC Sion,1009,9,6,9,17,38,57,-19,27
Young Boys,1010,1,21,8,3,69,34,35,71
FC Basel,1010,2,18,8,6,53,27,26,62
Lucerne,1010,3,13,8,11,43,43,0,47
St Gallen,1010,4,13,3,16,43,58,-15,42
FC Zürich,1010,5,9,11,12,40,38,2,38
Grasshoppers,1010,6,10,7,15,43,46,-3,37
FC Lugano,1010,7,10,7,15,33,48,-15,37
FC Thun,1010,8,10,6,16,44,60,-16,36
FC Sion,1010,9,6,10,16,42,56,-14,28
Young Boys,1011,1,23,6,3,75,36,39,75
FC Basel,1011,2,18,7,7,54,26,28,61
St Gallen,1011,3,15,3,14,43,54,-11,48
FC Zürich,1011,4,12,9,11,42,37,5,45
Lucerne,1011,5,12,9,11,42,45,-3,45
FC Thun,1011,6,11,5,16,47,59,-12,38
FC Lugano,1011,7,9,7,16,30,49,-19,34
Grasshoppers,1011,8,8,7,17,41,52,-11,31
FC Sion,1011,9,6,7,19,42,58,-16,25
Young Boys,1012,1,22,7,3,75,36,39,73
FC Basel,1012,2,18,9,5,58,28,30,63
Lucerne,1012,3,14,7,11,49,53,-4,49
St Gallen,1012,4,13,2,17,43,58,-15,41
FC Zürich,1012,5,10,10,12,40,41,-1,40
FC Thun,1012,6,10,7,15,51,56,-5,37
FC Lugano,1012,7,10,5,17,29,47,-18,35
Grasshoppers,1012,8,8,8,16,40,54,-14,32
FC Sion,1012,9,7,9,16,43,55,-12,30
Young Boys,1013,1,21,8,3,70,32,38,71
FC Basel,1013,2,19,8,5,56,24,32,65
Lucerne,1013,3,13,9,10,40,42,-2,48
St Gallen,1013,4,13,2,17,39,57,-18,41
FC Zürich,1013,5,10,10,12,40,38,2,40
FC Thun,1013,6,11,5,16,47,58,-11,38
FC Lugano,1013,7,10,7,15,30,47,-17,37
Grasshoppers,1013,8,8,8,16,39,49,-10,32
FC Sion,1013,9,6,9,17,41,55,-14,27
Young Boys,1014,1,21,7,4,68,38,30,70
FC Basel,1014,2,19,7,6,61,23,38,64
Lucerne,1014,3,13,8,11,44,47,-3,47
St Gallen,1014,4,13,3,16,40,58,-18,42
FC Zürich,1014,5,10,11,11,39,35,4,41
FC Lugano,1014,6,10,7,15,33,47,-14,37
Grasshoppers,1014,7,9,8,15,40,50,-10,35
FC Thun,1014,8,9,6,17,40,57,-17,33
FC Sion,1014,9,7,9,16,42,52,-10,30
Young Boys,1015,1,22,6,4,73,32,41,72
FC Basel,1015,2,19,8,5,54,25,29,65
Lucerne,1015,3,13,7,12,40,44,-4,46
St Gallen,1015,4,14,4,14,44,53,-9,46
FC Zürich,1015,5,10,10,12,42,40,2,40
FC Lugano,1015,6,10,7,15,30,46,-16,37
Grasshoppers,1015,7,10,6,16,42,51,-9,36
FC Thun,1015,8,10,5,17,43,58,-15,35
FC Sion,1015,9,6,7,19,39,58,-19,25
Young Boys,1016,1,21,7,4,70,38,32,70
FC Basel,1016,2,20,7,5,58,26,32,67
St Gallen,1016,3,16,2,14,46,54,-8,50
Lucerne,1016,4,11,8,13,40,46,-6,41
FC Zürich,1016,5,10,10,12,40,37,3,40
FC Lugano,1016,6,11,6,15,33,47,-14,39
Grasshoppers,1016,7,9,8,15,43,50,-7,35
FC Thun,1016,8,8,8,16,43,59,-16,32
FC Sion,1016,9,6,8,18,41,57,-16,26
Young Boys,1017,1,22,8,2,72,33,39,74
FC Basel,1017,2,17,9,6,53,27,26,60
St Gallen,1017,3,14,4,14,42,53,-11,46
Lucerne,1017,4,11,9,12,44,48,-4,42
FC Zürich,1017,5,10,10,12,43,36,7,40
FC Thun,1017,6,11,6,15,46,58,-12,39
Grasshoppers,1017,7,9,8,15,41,51,-10,35
FC Lugano,1017,8,9,8,15,29,45,-16,35
FC Sion,1017,9,6,8,18,38,57,-19,26
Young Boys,1018,1,21,9,2,76,36,40,72
FC Basel,1018,2,16,7,9,51,27,24,55
St Gallen,1018,3,15,2,15,42,52,-10,47
Lucerne,1018,4,12,8,12,39,49,-10,44
FC Zürich,1018,5,10,11,11,37,34,3,41
FC Thun,1018,6,12,5,15,43,53,-10,41
FC Lugano,1018,7,10,8,14,31,44,-13,38
Grasshoppers,1018,8,10,7,15,42,48,-6,37
FC Sion,1018,9,5,9,18,36,54,-18,24
Young Boys,1019,1,24,6,2,73,33,40,78
FC Basel,1019,2,19,7,6,53,23,30,64
Lucerne,1019,3,13,8,11,44,44,0,47
St Gallen,1019,4,15,2,15,46,53,-7,47
FC Zürich,1019,5,11,10,11,44,35,9,43
Grasshoppers,1019,6,9,8,15,42,50,-8,35
FC Lugano,1019,7,9,6,17,27,52,-25,33
FC Thun,1019,8,9,5,18,41,63,-22,32
FC Sion,1019,9,5,8,19,37,54,-17,23
Young Boys,1020,1,20,8,4,66,35,31,68
FC Basel,1020,2,19,8,5,56,24,32,65
Lucerne,1020,3,13,8,11,40,42,-2,47
St Gallen,1020,4,15,2,15,44,54,-10,47
FC Zürich,1020,5,10,9,13,40,42,-2,39
FC Sion,1020,6,10,7,15,50,51,-1,37
FC Lugano,1020,7,10,5,17,30,48,-18,35
FC Thun,1020,8,9,6,17,43,58,-15,33
Grasshoppers,1020,9,8,7,17,38,53,-15,31
Young Boys,1021,1,23,6,3,77,35,42,75
FC Basel,1021,2,19,8,5,59,24,35,65
Lucerne,1021,3,14,8,10,48,44,4,50
St Gallen,1021,4,14,2,16,43,57,-14,44
FC Zürich,1021,5,10,9,13,39,36,3,39
FC Lugano,1021,6,10,5,17,35,53,-18,35
FC Thun,1021,7,10,5,17,44,64,-20,35
Grasshoppers,1021,8,9,6,17,40,56,-16,33
FC Sion,1021,9,7,7,18,43,59,-16,28
Young Boys,1022,1,21,8,3,69,33,36,71
FC Basel,1022,2,17,8,7,54,31,23,59
St Gallen,1022,3,17,2,13,52,54,-2,53
FC Zürich,1022,4,11,11,10,44,36,8,44
Lucerne,1022,5,12,8,12,43,48,-5,44
FC Lugano,1022,6,10,6,16,31,48,-17,36
Grasshoppers,1022,7,9,6,17,38,50,-12,33
FC Thun,1022,8,8,8,16,40,56,-16,32
FC Sion,1022,9,6,9,17,39,54,-15,27
Young Boys,1023,1,22,7,3,71,35,36,73
FC Basel,1023,2,20,7,5,63,22,41,67
Lucerne,1023,3,14,8,10,41,42,-1,50
St Gallen,1023,4,14,2,16,44,58,-14,44
FC Zürich,1023,5,11,9,12,41,35,6,42
FC Lugano,1023,6,11,5,16,30,47,-17,38
Grasshoppers,1023,7,9,7,16,39,47,-8,34
FC Thun,1023,8,8,6,18,38,61,-23,30
FC Sion,1023,9,6,7,19,39,59,-20,25
Young Boys,1024,1,22,6,4,73,37,36,72
FC Basel,1024,2,18,8,6,61,27,34,62
Lucerne,1024,3,15,7,10,43,39,4,52
St Gallen,1024,4,13,2,17,39,61,-22,41
FC Zürich,1024,5,10,10,12,38,37,1,40
Grasshoppers,1024,6,10,6,16,40,47,-7,36
FC Thun,1024,7,10,5,17,46,63,-17,35
FC Lugano,1024,8,10,5,17,32,49,-17,35
FC Sion,1024,9,8,7,17,43,55,-12,31
Young Boys,1025,1,23,6,3,76,35,41,75
FC Basel,1025,2,19,8,5,57,23,34,65
Lucerne,1025,3,13,7,12,41,48,-7,46
St Gallen,1025,4,13,2,17,40,60,-20,41
FC Lugano,1025,5,11,5,16,34,48,-14,38
FC Zürich,1025,6,9,10,13,37,39,-2,37
FC Thun,1025,7,9,8,15,43,57,-14,35
Grasshoppers,1025,8,9,7,16,42,51,-9,34
FC Sion,1025,9,7,9,16,43,52,-9,30
Young Boys,1026,1,21,7,4,72,40,32,70
FC Basel,1026,2,20,7,5,57,21,36,67
St Gallen,1026,3,14,4,14,44,54,-10,46
Lucerne,1026,4,12,8,12,46,51,-5,44
FC Zürich,1026,5,11,9,12,40,37,3,42
Grasshoppers,1026,6,10,6,16,45,51,-6,36
FC Thun,1026,7,10,6,16,44,56,-12,36
FC Lugano,1026,8,9,7,16,28,49,-21,34
FC Sion,1026,9,6,8,18,38,55,-17,26
Young Boys,1027,1,22,7,3,78,38,40,73
FC Basel,1027,2,16,10,6,55,25,30,58
Lucerne,1027,3,14,8,10,47,45,2,50
St Gallen,1027,4,15,4,13,45,53,-8,49
FC Zürich,1027,5,12,10,10,44,36,8,46
Grasshoppers,1027,6,9,7,16,41,53,-12,34
FC Thun,1027,7,9,5,18,45,64,-19,32
FC Lugano,1027,8,9,5,18,28,53,-25,32
FC Sion,1027,9,6,8,18,46,62,-16,26
Young Boys,1028,1,22,6,4,73,34,39,72
FC Basel,1028,2,18,7,7,52,23,29,61
Lucerne,1028,3,14,8,10,43,44,-1,50
FC Zürich,1028,4,12,9,11,46,36,10,45
St Gallen,1028,5,14,2,16,41,55,-14,44
FC Lugano,1028,6,10,6,16,31,48,-17,36
Grasshoppers,1028,7,9,7,16,40,49,-9,34
FC Thun,1028,8,8,7,17,38,59,-21,31
FC Sion,1028,9,7,8,17,38,54,-16,29
Young Boys,1029,1,21,7,4,73,37,36,70
FC Basel,1029,2,17,8,7,54,28,26,59
St Gallen,1029,3,15,3,14,44,52,-8,48
FC Zürich,1029,4,11,10,11,43,36,7,43
Lucerne,1029,5,11,8,13,39,48,-9,41
FC Lugano,1029,6,11,6,15,32,47,-15,39
FC Thun,1029,7,11,5,16,46,56,-10,38
Grasshoppers,1029,8,9,7,16,46,56,-10,34
FC Sion,1029,9,7,8,17,41,58,-17,29
Young Boys,1030,1,21,9,2,68,32,36,72
FC Basel,1030,2,17,7,8,51,27,24,58
Lucerne,1030,3,14,7,11,46,42,4,49
FC Zürich,1030,4,11,9,12,43,37,6,42
FC Lugano,1030,5,12,6,14,35,47,-12,42
St Gallen,1030,6,13,2,17,41,60,-19,41
FC Thun,1030,7,11,5,16,44,56,-12,38
Grasshoppers,1030,8,8,7,17,40,52,-12,31
FC Sion,1030,9,7,8,17,37,52,-15,29
Young Boys,1031,1,22,7,3,70,31,39,73
FC Basel,1031,2,16,10,6,52,26,26,58
Lucerne,1031,3,13,7,12,39,46,-7,46
St Gallen,1031,4,14,4,14,46,56,-10,46
FC Zürich,1031,5,11,10,11,41,36,5,43
Grasshoppers,1031,6,10,7,15,41,49,-8,37
FC Sion,1031,7,9,7,16,42,50,-8,34
FC Lugano,1031,8,9,6,17,32,51,-19,33
FC Thun,1031,9,8,6,18,41,59,-18,30
Young Boys,1032,1,21,7,4,73,40,33,70
FC Basel,1032,2,18,7,7,55,27,28,61
St Gallen,1032,3,15,2,15,47,61,-14,47
FC Zürich,1032,4,11,10,11,38,34,4,43
Lucerne,1032,5,12,7,13,43,46,-3,43
FC Lugano,1032,6,11,6,15,32,47,-15,39
FC Thun,1032,7,10,6,16,44,57,-13,36
Grasshoppers,1032,8,8,8,16,38,50,-12,32
FC Sion,1032,9,8,7,17,48,56,-8,31
Young Boys,1033,1,23,6,3,75,32,43,75
FC Basel,1033,2,18,8,6,56,29,27,62
FC Zürich,1033,3,12,10,10,47,35,12,46
St Gallen,1033,4,14,2,16,40,54,-14,44
Lucerne,1033,5,11,8,13,40,48,-8,41
Grasshoppers,1033,6,10,6,16,41,51,-10,36
FC Lugano,1033,7,10,6,16,32,52,-20,36
FC Thun,1033,8,10,5,17,46,61,-15,35
FC Sion,1033,9,7,7,18,40,55,-15,28
Young Boys,1034,1,23,6,3,73,32,41,75
FC Basel,1034,2,19,8,5,57,25,32,65
Lucerne,1034,3,13,7,12,42,47,-5,46
St Gallen,1034,4,14,3,15,43,54,-11,45
FC Zürich,1034,5,10,9,13,40,39,1,39
FC Thun,1034,6,10,6,16,42,56,-14,36
FC Lugano,1034,7,10,6,16,31,47,-16,36
Grasshoppers,1034,8,9,6,17,43,52,-9,33
FC Sion,1034,9,7,7,18,39,58,-19,28
Young Boys,1035,1,23,6,3,72,34,38,75
FC Basel,1035,2,18,7,7,55,25,30,61
St Gallen,1035,3,16,2,14,46,53,-7,50
Lucerne,1035,4,13,8,11,42,42,0,47
FC Zürich,1035,5,10,10,12,40,40,0,40
FC Thun,1035,6,10,6,16,46,60,-14,36
Grasshoppers,1035,7,9,8,15,42,51,-9,35
FC Lugano,1035,8,9,6,17,29,51,-22,33
FC Sion,1035,9,6,7,19,40,56,-16,25
Young Boys,1036,1,19,10,3,69,36,33,67
FC Basel,1036,2,20,7,5,56,23,33,67
St Gallen,1036,3,14,3,15,44,59,-15,45
Lucerne,1036,4,12,8,12,44,44,0,44
FC Zürich,1036,5,10,10,12,38,35,3,40
Grasshoppers,1036,6,10,7,15,40,47,-7,37
FC Lugano,1036,7,10,7,15,32,50,-18,37
FC Thun,1036,8,10,5,17,42,57,-15,35
FC Sion,1036,9,6,9,17,41,55,-14,27
Young Boys,1037,1,20,8,4,66,35,31,68
FC Basel,1037,2,18,8,6,54,24,30,62
Lucerne,1037,3,14,8,10,43,41,2,50
FC Zürich,1037,4,12,10,10,42,34,8,46
St Gallen,1037,5,13,3,16,40,56,-16,42
FC Thun,1037,6,10,5,17,46,61,-15,35
FC Lugano,1037,7,9,6,17,29,48,-19,33
FC Sion,1037,8,8,8,16,41,51,-10,32
Grasshoppers,1037,9,8,8,16,38,49,-11,32
Young Boys,1038,1,23,6,3,72,31,41,75
FC Basel,1038,2,16,10,6,53,26,27,58
St Gallen,1038,3,14,5,13,42,51,-9,47
Lucerne,1038,4,12,8,12,40,46,-6,44
FC Zürich,1038,5,10,12,10,41,36,5,42
Grasshoppers,1038,6,10,6,16,42,51,-9,36
FC Thun,1038,7,9,7,16,42,58,-16,34
FC Lugano,1038,8,9,6,17,29,50,-21,33
FC Sion,1038,9,7,8,17,39,51,-12,29
Young Boys,1039,1,21,8,3,70,36,34,71
FC Basel,1039,2,18,8,6,52,23,29,62
St Gallen,1039,3,15,3,14,41,51,-10,48
FC Zürich,1039,4,12,9,11,44,35,9,45
Lucerne,1039,5,12,7,13,38,44,-6,43
FC Lugano,1039,6,11,6,15,32,46,-14,39
FC Thun,1039,7,10,6,16,45,59,-14,36
Grasshoppers,1039,8,8,8,16,39,50,-11,32
FC Sion,1039,9,6,7,19,40,57,-17,25
Young Boys,1040,1,22,7,3,76,39,37,73
FC Basel,1040,2,18,8,6,58,26,32,62
Lucerne,1040,3,14,7,11,46,49,-3,49
FC Zürich,1040,4,12,10,10,44,37,7,46
St Gallen,1040,5,14,4,14,42,52,-10,46
FC Thun,1040,6,10,5,17,44,57,-13,35
Grasshoppers,1040,7,9,6,17,41,55,-14,33
FC Lugano,1040,8,9,6,17,30,49,-19,33
FC Sion,1040,9,5,9,18,40,57,-17,24
Young Boys,1041,1,21,7,4,69,40,29,70
FC Basel,1041,2,20,7,5,61,23,38,67
Lucerne,1041,3,13,7,12,42,45,-3,46
St Gallen,1041,4,14,3,15,44,54,-10,45
FC Zürich,1041,5,10,11,11,41,36,5,41
Grasshoppers,1041,6,10,7,15,41,48,-7,37
FC Lugano,1041,7,10,5,17,29,49,-20,35
FC Thun,1041,8,8,7,17,40,59,-19,31
FC Sion,1041,9,5,12,15,40,53,-13,27
Young Boys,1042,1,21,7,4,72,35,37,70
FC Basel,1042,2,18,7,7,54,28,26,61
Lucerne,1042,3,13,7,12,41,43,-2,46
FC Lugano,1042,4,13,5,14,36,42,-6,44
St Gallen,1042,5,14,2,16,42,64,-22,44
FC Zürich,1042,6,9,9,14,38,41,-3,36
FC Thun,1042,7,10,6,16,47,55,-8,36
Grasshoppers,1042,8,9,7,16,39,50,-11,34
FC Sion,1042,9,8,8,16,46,57,-11,32
Young Boys,1043,1,22,7,3,79,33,46,73
FC Basel,1043,2,20,7,5,61,27,34,67
Lucerne,1043,3,13,8,11,42,47,-5,47
St Gallen,1043,4,14,4,14,42,54,-12,46
FC Zürich,1043,5,10,10,12,41,37,4,40
FC Thun,1043,6,10,5,17,46,61,-15,35
FC Lugano,1043,7,9,7,16,28,52,-24,34
Grasshoppers,1043,8,8,7,17,41,54,-13,31
FC Sion,1043,9,6,9,17,39,54,-15,27
Young Boys,1044,1,20,8,4,69,38,31,68
FC Basel,1044,2,16,11,5,56,29,27,59
St Gallen,1044,3,14,4,14,44,56,-12,46
FC Zürich,1044,4,11,11,10,44,38,6,44
Lucerne,1044,5,11,10,11,42,45,-3,43
Grasshoppers,1044,6,11,7,14,41,45,-4,40
FC Lugano,1044,7,10,6,16,32,48,-16,36
FC Thun,1044,8,9,6,17,48,60,-12,33
FC Sion,1044,9,6,9,17,40,57,-17,27
Young Boys,1045,1,20,10,2,68,33,35,70
FC Basel,1045,2,18,8,6,53,24,29,62
St Gallen,1045,3,14,3,15,42,58,-16,45
Lucerne,1045,4,11,10,11,40,43,-3,43
FC Zürich,1045,5,9,10,13,40,44,-4,37
FC Thun,1045,6,10,7,15,45,57,-12,37
FC Lugano,1045,7,10,7,15,33,45,-12,37
Grasshoppers,1045,8,9,9,14,43,49,-6,36
FC Sion,1045,9,6,10,16,44,55,-11,28
Young Boys,1046,1,21,8,3,68,34,34,71
FC Basel,1046,2,18,8,6,59,28,31,62
Lucerne,1046,3,12,9,11,43,44,-1,45
FC Zürich,1046,4,11,11,10,43,36,7,44
St Gallen,1046,5,13,4,15,40,55,-15,43
Grasshoppers,1046,6,10,7,15,44,53,-9,37
FC Thun,1046,7,9,7,16,45,60,-15,34
FC Lugano,1046,8,9,7,16,30,48,-18,34
FC Sion,1046,9,6,9,17,37,51,-14,27
Young Boys,1047,1,21,6,5,70,39,31,69
FC Basel,1047,2,17,10,5,52,24,28,61
St Gallen,1047,3,14,4,14,44,55,-11,46
Lucerne,1047,4,12,9,11,44,45,-1,45
FC Zürich,1047,5,10,11,11,39,35,4,41
Grasshoppers,1047,6,11,7,14,45,48,-3,40
FC Lugano,1047,7,9,7,16,32,50,-18,34
FC Thun,1047,8,9,6,17,42,58,-16,33
FC Sion,1047,9,7,8,17,38,52,-14,29
Young Boys,1048,1,23,6,3,69,32,37,75
FC Basel,1048,2,19,7,6,56,25,31,64
St Gallen,1048,3,15,2,15,45,53,-8,47
FC Zürich,1048,4,12,10,10,43,34,9,46
Lucerne,1048,5,12,8,12,38,46,-8,44
FC Lugano,1048,6,10,6,16,31,48,-17,36
FC Thun,1048,7,10,5,17,44,60,-16,35
Grasshoppers,1048,8,8,6,18,40,54,-14,30
FC Sion,1048,9,6,8,18,39,53,-14,26
Young Boys,1049,1,22,7,3,72,34,38,73
FC Basel,1049,2,16,9,7,53,32,21,57
Lucerne,1049,3,14,8,10,46,43,3,50
FC Zürich,1049,4,12,9,11,42,35,7,45
St Gallen,1049,5,14,2,16,46,59,-13,44
Grasshoppers,1049,6,11,6,15,41,47,-6,39
FC Thun,1049,7,10,5,17,42,57,-15,35
FC Lugano,1049,8,10,5,17,32,50,-18,35
FC Sion,1049,9,6,7,19,37,54,-17,25
Young Boys,1050,1,23,6,3,79,34,45,75
FC Basel,1050,2,19,8,5,55,24,31,65
Lucerne,1050,3,13,7,12,42,48,-6,46
St Gallen,1050,4,13,3,16,40,54,-14,42
FC Zürich,1050,5,10,10,12,37,36,1,40
FC Lugano,1050,6,11,6,15,31,47,-16,39
Grasshoppers,1050,7,9,6,17,40,52,-12,33
FC Thun,1050,8,9,5,18,42,59,-17,32
FC Sion,1050,9,8,7,17,39,51,-12,31
Young Boys,1051,1,20,6,6,68,38,30,66
FC Basel,1051,2,19,7,6,58,25,33,64
St Gallen,1051,3,16,2,14,47,55,-8,50
Lucerne,1051,4,13,8,11,44,47,-3,47
FC Zürich,1051,5,10,10,12,39,36,3,40
Grasshoppers,1051,6,10,8,14,43,49,-6,38
FC Lugano,1051,7,10,5,17,28,47,-19,35
FC Thun,1051,8,8,7,17,42,61,-19,31
FC Sion,1051,9,7,9,16,45,56,-11,30
Young Boys,1052,1,21,7,4,75,39,36,70
FC Basel,1052,2,18,7,7,54,28,26,61
St Gallen,1052,3,16,3,13,45,51,-6,51
Lucerne,1052,4,12,10,10,41,42,-1,46
FC Zürich,1052,5,10,9,13,39,38,1,39
Grasshoppers,1052,6,10,6,16,44,49,-5,36
FC Lugano,1052,7,10,6,16,33,51,-18,36
FC Thun,1052,8,10,5,17,48,63,-15,35
FC Sion,1052,9,7,7,18,39,57,-18,28
Young Boys,1053,1,21,8,3,68,32,36,71
FC Basel,1053,2,18,9,5,52,23,29,63
St Gallen,1053,3,14,4,14,41,52,-11,46
Lucerne,1053,4,12,8,12,44,45,-1,44
FC Zürich,1053,5,10,11,11,45,39,6,41
Grasshoppers,1053,6,9,8,15,38,48,-10,35
FC Lugano,1053,7,9,8,15,30,48,-18,35
FC Thun,1053,8,9,7,16,44,58,-14,34
FC Sion,1053,9,6,9,17,38,55,-17,27
Young Boys,1054,1,21,6,5,73,40,33,69
FC Basel,1054,2,19,7,6,56,25,31,64
Lucerne,1054,3,15,7,10,43,40,3,52
St Gallen,1054,4,14,3,15,44,54,-10,45
FC Zürich,1054,5,11,9,12,44,38,6,42
FC Thun,1054,6,11,5,16,50,61,-11,38
Grasshoppers,1054,7,9,6,17,39,54,-15,33
FC Lugano,1054,8,9,6,17,32,52,-20,33
FC Sion,1054,9,7,7,18,42,59,-17,28
Young Boys,1055,1,21,8,3,72,37,35,71
FC Basel,1055,2,19,8,5,54,22,32,65
St Gallen,1055,3,15,3,14,43,53,-10,48
FC Zürich,1055,4,11,10,11,39,35,4,43
Lucerne,1055,5,12,7,13,40,46,-6,43
Grasshoppers,1055,6,10,6,16,40,50,-10,36
FC Thun,1055,7,10,6,16,45,57,-12,36
FC Lugano,1055,8,9,6,17,29,47,-18,33
FC Sion,1055,9,5,10,17,40,55,-15,25
Young Boys,1056,1,21,8,3,70,34,36,71
FC Basel,1056,2,17,8,7,51,27,24,59
FC Zürich,1056,3,13,9,10,43,33,10,48
Lucerne,1056,4,12,11,9,43,43,0,47
St Gallen,1056,5,14,3,15,42,56,-14,45
FC Lugano,1056,6,11,5,16,33,46,-13,38
Grasshoppers,1056,7,9,7,16,41,51,-10,34
FC Thun,1056,8,9,5,18,41,59,-18,32
FC Sion,1056,9,6,8,18,39,54,-15,26
Young Boys,1057,1,21,7,4,71,38,33,70
FC Basel,1057,2,18,8,6,56,29,27,62
St Gallen,1057,3,16,2,14,46,53,-7,50
FC Zürich,1057,4,11,10,11,41,36,5,43
Lucerne,1057,5,11,7,14,38,47,-9,40
FC Lugano,1057,6,11,6,15,32,46,-14,39
Grasshoppers,1057,7,10,7,15,41,49,-8,37
FC Thun,1057,8,9,6,17,47,62,-15,33
FC Sion,1057,9,7,7,18,43,55,-12,28
Young Boys,1058,1,23,6,3,76,34,42,75
FC Basel,1058,2,19,7,6,55,24,31,64
FC Zürich,1058,3,13,9,10,43,32,11,48
Lucerne,1058,4,12,9,11,43,43,0,45
St Gallen,1058,5,13,5,14,43,55,-12,44
Grasshoppers,1058,6,9,7,16,41,50,-9,34
FC Lugano,1058,7,9,6,17,31,53,-22,33
FC Sion,1058,8,7,8,17,41,59,-18,29
FC Thun,1058,9,8,5,19,39,62,-23,29
Young Boys,1059,1,21,8,3,72,35,37,71
FC Basel,1059,2,17,8,7,53,26,27,59
Lucerne,1059,3,13,8,11,42,43,-1,47
St Gallen,1059,4,14,3,15,43,54,-11,45
FC Zürich,1059,5,9,12,11,40,38,2,39
FC Thun,1059,6,11,6,15,45,56,-11,39
Grasshoppers,1059,7,10,7,15,39,47,-8,37
FC Lugano,1059,8,9,7,16,29,51,-22,34
FC Sion,1059,9,7,7,18,42,55,-13,28
Young Boys,1060,1,21,7,4,69,34,35,70
FC Basel,1060,2,17,8,7,50,26,24,59
Lucerne,1060,3,13,9,10,43,43,0,48
St Gallen,1060,4,13,4,15,41,55,-14,43
FC Zürich,1060,5,10,10,12,38,35,3,40
Grasshoppers,1060,6,11,7,14,48,50,-2,40
FC Lugano,1060,7,10,6,16,30,46,-16,36
FC Thun,1060,8,9,6,17,47,61,-14,33
FC Sion,1060,9,8,7,17,40,56,-16,31
Young Boys,1061,1,21,7,4,71,33,38,70
FC Basel,1061,2,17,9,6,54,27,27,60
Lucerne,1061,3,13,8,11,42,43,-1,47
St Gallen,1061,4,14,3,15,46,59,-13,45
FC Zürich,1061,5,11,9,12,43,36,7,42
Grasshoppers,1061,6,12,6,14,44,46,-2,42
FC Lugano,1061,7,11,5,16,33,51,-18,38
FC Thun,1061,8,9,5,18,41,61,-20,32
FC Sion,1061,9,6,8,18,37,55,-18,26
Young Boys,1062,1,20,7,5,68,36,32,67
FC Basel,1062,2,19,8,5,60,24,36,65
Lucerne,1062,3,14,7,11,43,46,-3,49
St Gallen,1062,4,14,4,14,45,55,-10,46
FC Zürich,1062,5,10,10,12,41,39,2,40
Grasshoppers,1062,6,10,6,16,43,52,-9,36
FC Lugano,1062,7,10,6,16,33,49,-16,36
FC Thun,1062,8,10,5,17,45,59,-14,35
FC Sion,1062,9,6,9,17,38,56,-18,27
Young Boys,1063,1,20,8,4,68,36,32,68
FC Basel,1063,2,18,8,6,56,26,30,62
Lucerne,1063,3,12,10,10,42,42,0,46
FC Zürich,1063,4,12,9,11,45,37,8,45
St Gallen,1063,5,13,5,14,43,57,-14,44
FC Thun,1063,6,10,6,16,46,60,-14,36
FC Lugano,1063,7,10,6,16,33,50,-17,36
Grasshoppers,1063,8,9,8,15,39,48,-9,35
FC Sion,1063,9,6,8,18,40,56,-16,26
Young Boys,1064,1,21,8,3,71,33,38,71
FC Basel,1064,2,17,10,5,52,23,29,61
Lucerne,1064,3,13,8,11,45,43,2,47
St Gallen,1064,4,14,3,15,40,56,-16,45
FC Zürich,1064,5,11,9,12,42,40,2,42
FC Thun,1064,6,10,6,16,46,59,-13,36
FC Lugano,1064,7,10,5,17,33,51,-18,35
Grasshoppers,1064,8,9,7,16,42,53,-11,34
FC Sion,1064,9,7,8,17,43,56,-13,29
Young Boys,1065,1,22,6,4,70,33,37,72
FC Basel,1065,2,17,8,7,50,25,25,59
St Gallen,1065,3,17,2,13,46,51,-5,53
Lucerne,1065,4,11,10,11,38,43,-5,43
FC Zürich,1065,5,11,9,12,41,35,6,42
FC Lugano,1065,6,10,6,16,31,49,-18,36
Grasshoppers,1065,7,9,8,15,40,49,-9,35
FC Thun,1065,8,9,5,18,42,60,-18,32
FC Sion,1065,9,7,8,17,37,50,-13,29
Young Boys,1066,1,21,7,4,69,35,34,70
FC Basel,1066,2,16,9,7,52,28,24,57
St Gallen,1066,3,16,2,14,44,51,-7,50
FC Zürich,1066,4,11,11,10,40,34,6,44
Lucerne,1066,5,12,7,13,40,46,-6,43
Grasshoppers,1066,6,10,7,15,41,46,-5,37
FC Lugano,1066,7,10,6,16,32,49,-17,36
FC Sion,1066,8,7,10,15,40,51,-11,31
FC Thun,1066,9,8,7,17,42,60,-18,31
Young Boys,1067,1,20,7,5,70,40,30,67
FC Basel,1067,2,17,8,7,50,25,25,59
Lucerne,1067,3,11,11,10,42,44,-2,44
FC Zürich,1067,4,11,10,11,43,36,7,43
St Gallen,1067,5,13,4,15,41,55,-14,43
Grasshoppers,1067,6,11,6,15,46,48,-2,39
FC Lugano,1067,7,10,7,15,32,47,-15,37
FC Thun,1067,8,10,6,16,41,55,-14,36
FC Sion,1067,9,8,7,17,43,58,-15,31
Young Boys,1068,1,21,7,4,69,34,35,70
FC Basel,1068,2,17,7,8,53,29,24,58
St Gallen,1068,3,17,2,13,45,51,-6,53
Lucerne,1068,4,13,7,12,41,43,-2,46
FC Zürich,1068,5,11,9,12,40,35,5,42
Grasshoppers,1068,6,10,8,14,40,46,-6,38
FC Thun,1068,7,10,6,16,44,57,-13,36
FC Lugano,1068,8,9,5,18,29,50,-21,32
FC Sion,1068,9,6,9,17,35,51,-16,27
Young Boys,1069,1,24,6,2,78,32,46,78
FC Basel,1069,2,18,7,7,55,27,28,61
Lucerne,1069,3,13,8,11,43,46,-3,47
St Gallen,1069,4,15,2,15,45,60,-15,47
FC Zürich,1069,5,11,10,11,43,38,5,43
FC Thun,1069,6,10,6,16,42,56,-14,36
Grasshoppers,1069,7,9,6,17,41,51,-10,33
FC Lugano,1069,8,9,6,17,29,51,-22,33
FC Sion,1069,9,6,7,19,41,56,-15,25
Young Boys,1070,1,21,7,4,68,36,32,70
FC Basel,1070,2,19,7,6,53,24,29,64
St Gallen,1070,3,15,3,14,42,51,-9,48
Lucerne,1070,4,13,8,11,43,42,1,47
FC Zürich,1070,5,10,11,11,40,35,5,41
Grasshoppers,1070,6,10,7,15,42,50,-8,37
FC Lugano,1070,7,10,6,16,29,46,-17,36
FC Thun,1070,8,9,5,18,41,60,-19,32
FC Sion,1070,9,6,8,18,41,55,-14,26
Young Boys,1071,1,23,6,3,77,36,41,75
FC Basel,1071,2,18,8,6,56,25,31,62
St Gallen,1071,3,14,3,15,43,57,-14,45
Lucerne,1071,4,12,7,13,38,48,-10,43
FC Lugano,1071,5,12,5,15,32,46,-14,41
FC Zürich,1071,6,10,10,12,42,40,2,40
Grasshoppers,1071,7,11,6,15,47,49,-2,39
FC Thun,1071,8,9,5,18,47,64,-17,32
FC Sion,1071,9,6,8,18,44,61,-17,26
Young Boys,1072,1,19,7,6,67,40,27,64
FC Basel,1072,2,18,7,7,56,28,28,61
St Gallen,1072,3,15,2,15,41,53,-12,47
Lucerne,1072,4,13,7,12,41,43,-2,46
FC Zürich,1072,5,10,10,12,41,37,4,40
FC Lugano,1072,6,11,7,14,31,43,-12,40
Grasshoppers,1072,7,11,6,15,43,49,-6,39
FC Thun,1072,8,10,5,17,44,57,-13,35
FC Sion,1072,9,8,7,17,41,55,-14,31
Young Boys,1073,1,21,9,2,69,31,38,72
FC Basel,1073,2,17,8,7,49,27,22,59
Lucerne,1073,3,14,8,10,40,39,1,50
St Gallen,1073,4,15,2,15,45,53,-8,47
FC Zürich,1073,5,12,9,11,49,35,14,45
Grasshoppers,1073,6,9,8,15,41,51,-10,35
FC Lugano,1073,7,10,5,17,30,49,-19,35
FC Thun,1073,8,9,5,18,42,62,-20,32
FC Sion,1073,9,6,8,18,37,55,-18,26
Young Boys,1074,1,19,6,7,66,43,23,63
FC Basel,1074,2,17,8,7,54,30,24,59
Lucerne,1074,3,15,7,10,47,41,6,52
St Gallen,1074,4,14,4,14,43,54,-11,46
FC Zürich,1074,5,10,12,10,43,38,5,42
FC Thun,1074,6,10,7,15,44,56,-12,37
FC Lugano,1074,7,10,7,15,32,46,-14,37
Grasshoppers,1074,8,10,6,16,43,50,-7,36
FC Sion,1074,9,6,9,17,40,54,-14,27
Young Boys,1075,1,21,8,3,71,35,36,71
FC Basel,1075,2,18,8,6,51,25,26,62
FC Zürich,1075,3,12,9,11,45,36,9,45
St Gallen,1075,4,14,3,15,41,54,-13,45
Lucerne,1075,5,11,8,13,38,45,-7,41
FC Lugano,1075,6,11,6,15,33,46,-13,39
Grasshoppers,1075,7,10,7,15,47,52,-5,37
FC Thun,1075,8,10,5,17,46,58,-12,35
FC Sion,1075,9,6,8,18,38,59,-21,26
Young Boys,1076,1,22,6,4,71,37,34,72
FC Basel,1076,2,17,9,6,56,26,30,60
St Gallen,1076,3,15,3,14,43,55,-12,48
Lucerne,1076,4,12,9,11,41,45,-4,45
FC Zürich,1076,5,10,11,11,41,38,3,41
FC Lugano,1076,6,12,5,15,39,46,-7,41
Grasshoppers,1076,7,10,7,15,40,48,-8,37
FC Thun,1076,8,9,6,17,41,57,-16,33
FC Sion,1076,9,5,8,19,37,57,-20,23
Young Boys,1077,1,21,6,5,73,40,33,69
FC Basel,1077,2,18,7,7,57,26,31,61
St Gallen,1077,3,15,3,14,44,56,-12,48
Lucerne,1077,4,13,8,11,45,46,-1,47
FC Zürich,1077,5,12,9,11,41,35,6,45
Grasshoppers,1077,6,11,6,15,42,47,-5,39
FC Thun,1077,7,10,5,17,42,58,-16,35
FC Lugano,1077,8,9,5,18,33,53,-20,32
FC Sion,1077,9,7,7,18,41,57,-16,28
Young Boys,1078,1,22,7,3,77,34,43,73
FC Basel,1078,2,16,11,5,55,24,31,59
St Gallen,1078,3,13,5,14,47,59,-12,44
Lucerne,1078,4,11,9,12,39,48,-9,42
FC Lugano,1078,5,12,6,14,36,47,-11,42
Grasshoppers,1078,6,11,6,15,45,50,-5,39
FC Zürich,1078,7,9,11,12,41,39,2,38
FC Sion,1078,8,8,7,17,44,58,-14,31
FC Thun,1078,9,8,6,18,42,67,-25,30
Young Boys,1079,1,22,7,3,74,37,37,73
FC Basel,1079,2,17,7,8,52,28,24,58
St Gallen,1079,3,16,2,14,51,55,-4,50
Lucerne,1079,4,13,8,11,43,46,-3,47
Grasshoppers,1079,5,11,7,14,44,48,-4,40
FC Zürich,1079,6,9,9,14,39,40,-1,36
FC Lugano,1079,7,10,6,16,33,53,-20,36
FC Thun,1079,8,9,5,18,43,61,-18,32
FC Sion,1079,9,8,7,17,42,53,-11,31
Young Boys,1080,1,22,6,4,73,36,37,72
FC Basel,1080,2,18,9,5,52,23,29,63
St Gallen,1080,3,15,4,13,45,53,-8,49
Lucerne,1080,4,12,8,12,38,43,-5,44
FC Zürich,1080,5,11,10,11,39,34,5,43
FC Thun,1080,6,10,5,17,43,57,-14,35
FC Lugano,1080,7,9,6,17,29,47,-18,33
FC Sion,1080,8,8,7,17,43,55,-12,31
Grasshoppers,1080,9,8,7,17,38,52,-14,31
Young Boys,1081,1,20,7,5,72,36,36,67
FC Basel,1081,2,19,7,6,62,27,35,64
Lucerne,1081,3,15,7,10,45,46,-1,52
St Gallen,1081,4,14,3,15,41,54,-13,45
FC Zürich,1081,5,10,11,11,39,36,3,41
FC Lugano,1081,6,10,6,16,31,47,-16,36
Grasshoppers,1081,7,9,7,16,39,49,-10,34
FC Thun,1081,8,9,6,17,41,58,-17,33
FC Sion,1081,9,7,8,17,39,56,-17,29
Young Boys,1082,1,20,9,3,69,35,34,69
FC Basel,1082,2,17,10,5,55,27,28,61
Lucerne,1082,3,14,7,11,48,44,4,49
FC Zürich,1082,4,11,11,10,43,35,8,44
St Gallen,1082,5,13,4,15,44,58,-14,43
Grasshoppers,1082,6,10,7,15,42,52,-10,37
FC Lugano,1082,7,9,8,15,31,47,-16,35
FC Sion,1082,8,7,9,16,43,55,-12,30
FC Thun,1082,9,8,5,19,39,61,-22,29
Young Boys,1083,1,22,6,4,72,36,36,72
FC Basel,1083,2,19,7,6,54,24,30,64
Lucerne,1083,3,12,8,12,41,47,-6,44
St Gallen,1083,4,14,2,16,43,57,-14,44
FC Zürich,1083,5,11,10,11,41,36,5,43
FC Thun,1083,6,11,5,16,45,59,-14,38
Grasshoppers,1083,7,10,6,16,45,51,-6,36
FC Lugano,1083,8,10,6,16,37,50,-13,36
FC Sion,1083,9,6,8,18,36,54,-18,26
Young Boys,1084,1,21,7,4,74,40,34,70
FC Basel,1084,2,19,7,6,54,25,29,64
Lucerne,1084,3,13,7,12,43,46,-3,46
St Gallen,1084,4,14,4,14,44,55,-11,46
FC Zürich,1084,5,11,10,11,40,34,6,43
Grasshoppers,1084,6,10,7,15,44,50,-6,37
FC Lugano,1084,7,9,8,15,30,46,-16,35
FC Thun,1084,8,9,5,18,42,59,-17,32
FC Sion,1084,9,6,9,17,43,59,-16,27
Young Boys,1085,1,20,8,4,68,35,33,68
FC Basel,1085,2,18,9,5,58,26,32,63
St Gallen,1085,3,15,4,13,50,54,-4,49
FC Zürich,1085,4,11,11,10,46,34,12,44
Lucerne,1085,5,11,10,11,42,47,-5,43
Grasshoppers,1085,6,10,7,15,43,50,-7,37
FC Thun,1085,7,9,6,17,44,62,-18,33
FC Lugano,1085,8,9,6,17,29,53,-24,33
FC Sion,1085,9,7,7,18,40,59,-19,28
Young Boys,1086,1,22,6,4,73,39,34,72
FC Basel,1086,2,19,8,5,60,24,36,65
Lucerne,1086,3,12,9,11,42,48,-6,45
St Gallen,1086,4,13,4,15,46,59,-13,43
FC Zürich,1086,5,10,10,12,40,38,2,40
FC Lugano,1086,6,11,5,16,33,47,-14,38
FC Thun,1086,7,10,5,17,50,64,-14,35
Grasshoppers,1086,8,9,7,16,45,57,-12,34
FC Sion,1086,9,7,8,17,45,58,-13,29
Young Boys,1087,1,24,6,2,71,30,41,78
FC Basel,1087,2,16,9,7,52,28,24,57
St Gallen,1087,3,16,3,13,44,51,-7,51
Lucerne,1087,4,13,9,10,42,40,2,48
FC Zürich,1087,5,11,11,10,45,38,7,44
FC Thun,1087,6,10,5,17,44,59,-15,35
FC Lugano,1087,7,9,6,17,31,51,-20,33
Grasshoppers,1087,8,8,6,18,39,53,-14,30
FC Sion,1087,9,6,7,19,39,57,-18,25
Young Boys,1088,1,21,7,4,73,37,36,70
FC Basel,1088,2,18,8,6,54,25,29,62
FC Zürich,1088,3,12,10,10,40,33,7,46
St Gallen,1088,4,14,3,15,42,54,-12,45
Lucerne,1088,5,12,8,12,42,46,-4,44
Grasshoppers,1088,6,11,6,15,45,49,-4,39
FC Lugano,1088,7,11,6,15,33,48,-15,39
FC Thun,1088,8,10,5,17,46,59,-13,35
FC Sion,1088,9,5,7,20,37,61,-24,22
Young Boys,1089,1,21,7,4,78,39,39,70
FC Basel,1089,2,19,7,6,56,26,30,64
St Gallen,1089,3,15,3,14,46,56,-10,48
Lucerne,1089,4,12,8,12,45,50,-5,44
FC Zürich,1089,5,10,9,13,38,37,1,39
FC Thun,1089,6,11,5,16,47,60,-13,38
FC Lugano,1089,7,9,7,16,29,50,-21,34
FC Sion,1089,8,8,8,16,44,54,-10,32
Grasshoppers,1089,9,8,8,16,44,55,-11,32
Young Boys,1090,1,23,7,2,74,35,39,76
FC Basel,1090,2,18,8,6,59,27,32,62
Lucerne,1090,3,13,8,11,45,46,-1,47
St Gallen,1090,4,15,2,15,46,57,-11,47
FC Zürich,1090,5,10,11,11,42,38,4,41
FC Thun,1090,6,11,5,16,44,59,-15,38
FC Lugano,1090,7,10,6,16,31,47,-16,36
Grasshoppers,1090,8,9,6,17,42,51,-9,33
FC Sion,1090,9,5,7,20,37,60,-23,22
Young Boys,1091,1,20,7,5,69,39,30,67
FC Basel,1091,2,18,8,6,56,26,30,62
Lucerne,1091,3,14,9,9,46,41,5,51
St Gallen,1091,4,15,4,13,46,55,-9,49
FC Zürich,1091,5,10,9,13,39,37,2,39
FC Lugano,1091,6,10,6,16,31,47,-16,36
Grasshoppers,1091,7,9,8,15,40,49,-9,35
FC Thun,1091,8,10,5,17,41,58,-17,35
FC Sion,1091,9,6,8,18,37,53,-16,26
Young Boys,1092,1,19,8,5,69,40,29,65
FC Basel,1092,2,19,7,6,59,29,30,64
Lucerne,1092,3,13,8,11,46,45,1,47
FC Zürich,1092,4,12,9,11,45,36,9,45
FC Lugano,1092,5,12,6,14,37,47,-10,42
St Gallen,1092,6,13,2,17,40,56,-16,41
FC Thun,1092,7,10,5,17,43,60,-17,35
Grasshoppers,1092,8,9,7,16,39,53,-14,34
FC Sion,1092,9,7,8,17,39,51,-12,29
Young Boys,1093,1,22,8,2,74,36,38,74
FC Basel,1093,2,17,8,7,53,29,24,59
Lucerne,1093,3,13,8,11,41,42,-1,47
St Gallen,1093,4,14,2,16,40,53,-13,44
FC Zürich,1093,5,11,10,11,42,35,7,43
FC Thun,1093,6,12,5,15,49,59,-10,41
Grasshoppers,1093,7,9,8,15,41,49,-8,35
FC Lugano,1093,8,9,6,17,29,48,-19,33
FC Sion,1093,9,6,7,19,39,57,-18,25
Young Boys,1094,1,22,8,2,74,34,40,74
FC Basel,1094,2,16,11,5,54,26,28,59
Lucerne,1094,3,13,8,11,42,44,-2,47
St Gallen,1094,4,13,4,15,41,55,-14,43
FC Zürich,1094,5,10,11,11,38,34,4,41
FC Lugano,1094,6,10,7,15,30,48,-18,37
FC Thun,1094,7,9,6,17,46,61,-15,33
Grasshoppers,1094,8,8,8,16,41,53,-12,32
FC Sion,1094,9,7,9,16,41,52,-11,30
Young Boys,1095,1,21,6,5,71,34,37,69
FC Basel,1095,2,19,8,5,56,26,30,65
Lucerne,1095,3,12,10,10,41,44,-3,46
St Gallen,1095,4,13,3,16,43,60,-17,42
FC Zürich,1095,5,10,10,12,43,40,3,40
Grasshoppers,1095,6,10,7,15,49,52,-3,37
FC Lugano,1095,7,10,6,16,32,48,-16,36
FC Thun,1095,8,9,7,16,42,58,-16,34
FC Sion,1095,9,7,9,16,45,60,-15,30
Young Boys,1096,1,22,7,3,74,37,37,73
FC Basel,1096,2,19,7,6,59,27,32,64
Lucerne,1096,3,13,8,11,43,41,2,47
St Gallen,1096,4,14,2,16,43,64,-21,44
FC Lugano,1096,5,11,5,16,32,46,-14,38
FC Zürich,1096,6,9,10,13,42,41,1,37
FC Thun,1096,7,9,7,16,45,61,-16,34
FC Sion,1096,8,8,9,15,51,55,-4,33
Grasshoppers,1096,9,8,7,17,40,57,-17,31
Young Boys,1097,1,21,8,3,70,34,36,71
FC Basel,1097,2,15,8,9,49,29,20,53
Lucerne,1097,3,14,8,10,46,44,2,50
St Gallen,1097,4,14,4,14,43,55,-12,46
FC Thun,1097,5,12,5,15,47,54,-7,41
FC Zürich,1097,6,10,10,12,39,37,2,40
FC Lugano,1097,7,10,5,17,32,49,-17,35
Grasshoppers,1097,8,9,7,16,40,49,-9,34
FC Sion,1097,9,7,9,16,41,56,-15,30
Young Boys,1098,1,23,6,3,72,35,37,75
FC Basel,1098,2,16,9,7,51,26,25,57
Lucerne,1098,3,14,8,10,45,41,4,50
St Gallen,1098,4,14,3,15,42,56,-14,45
FC Thun,1098,5,12,5,15,50,57,-7,41
FC Zürich,1098,6,10,10,12,40,37,3,40
FC Lugano,1098,7,10,5,17,30,49,-19,35
Grasshoppers,1098,8,8,6,18,39,55,-16,30
FC Sion,1098,9,7,8,17,41,54,-13,29
Young Boys,1099,1,23,6,3,72,38,34,75
FC Basel,1099,2,19,8,5,59,24,35,65
Lucerne,1099,3,11,10,11,40,45,-5,43
FC Zürich,1099,4,11,9,12,42,37,5,42
St Gallen,1099,5,13,3,16,41,56,-15,42
FC Lugano,1099,6,12,5,15,35,45,-10,41
FC Thun,1099,7,10,5,17,45,63,-18,35
Grasshoppers,1099,8,8,8,16,40,51,-11,32
FC Sion,1099,9,6,8,18,41,56,-15,26
Young Boys,1100,1,22,7,3,70,37,33,73
FC Basel,1100,2,17,8,7,54,26,28,59
FC Zürich,1100,3,13,9,10,45,34,11,48
Lucerne,1100,4,13,8,11,45,46,-1,47
St Gallen,1100,5,15,2,15,46,57,-11,47
Grasshoppers,1100,6,10,7,15,40,47,-7,37
FC Thun,1100,7,10,5,17,45,59,-14,35
FC Lugano,1100,8,10,5,17,31,48,-17,35
FC Sion,1100,9,5,7,20,38,60,-22,22
Young Boys,1101,1,20,9,3,68,34,34,69
FC Basel,1101,2,15,12,5,50,25,25,57
Lucerne,1101,3,14,9,9,41,38,3,51
St Gallen,1101,4,15,3,14,45,54,-9,48
FC Zürich,1101,5,10,11,11,41,36,5,41
FC Thun,1101,6,9,8,15,42,56,-14,35
FC Lugano,1101,7,10,5,17,33,50,-17,35
Grasshoppers,1101,8,8,9,15,39,48,-9,33
FC Sion,1101,9,5,10,17,38,56,-18,25
Young Boys,1102,1,21,8,3,70,33,37,71
FC Basel,1102,2,18,9,5,57,28,29,63
Lucerne,1102,3,13,9,10,44,43,1,48
St Gallen,1102,4,14,2,16,43,57,-14,44
FC Zürich,1102,5,11,10,11,42,36,6,43
FC Thun,1102,6,10,7,15,49,56,-7,37
FC Lugano,1102,7,10,6,16,29,47,-18,36
Grasshoppers,1102,8,9,7,16,39,53,-14,34
FC Sion,1102,9,5,8,19,36,56,-20,23
Young Boys,1103,1,22,7,3,70,33,37,73
FC Basel,1103,2,17,8,7,53,27,26,59
St Gallen,1103,3,14,5,13,45,53,-8,47
Lucerne,1103,4,12,9,11,40,44,-4,45
FC Zürich,1103,5,11,10,11,39,35,4,43
FC Lugano,1103,6,10,7,15,32,47,-15,37
FC Thun,1103,7,10,6,16,44,58,-14,36
Grasshoppers,1103,8,8,8,16,39,50,-11,32
FC Sion,1103,9,6,8,18,41,56,-15,26
Young Boys,1104,1,23,6,3,76,37,39,75
FC Basel,1104,2,19,8,5,57,25,32,65
Lucerne,1104,3,14,7,11,46,43,3,49
St Gallen,1104,4,13,3,16,43,62,-19,42
FC Zürich,1104,5,9,10,13,38,37,1,37
FC Thun,1104,6,10,7,15,44,55,-11,37
FC Lugano,1104,7,10,6,16,29,46,-17,36
Grasshoppers,1104,8,8,7,17,40,52,-12,31
FC Sion,1104,9,7,8,17,42,58,-16,29
Young Boys,1105,1,22,7,3,74,38,36,73
FC Basel,1105,2,17,8,7,55,29,26,59
St Gallen,1105,3,15,2,15,43,56,-13,47
Lucerne,1105,4,13,7,12,45,44,1,46
FC Zürich,1105,5,11,10,11,39,35,4,43
FC Thun,1105,6,11,5,16,46,57,-11,38
Grasshoppers,1105,7,10,6,16,43,51,-8,36
FC Lugano,1105,8,10,6,16,32,49,-17,36
FC Sion,1105,9,6,7,19,37,55,-18,25
Young Boys,1106,1,23,7,2,73,32,41,76
FC Basel,1106,2,17,9,6,59,26,33,60
St Gallen,1106,3,15,2,15,42,57,-15,47
Lucerne,1106,4,12,10,10,42,45,-3,46
FC Zürich,1106,5,10,11,11,40,38,2,41
FC Lugano,1106,6,10,6,16,31,45,-14,36
Grasshoppers,1106,7,9,8,15,43,50,-7,35
FC Thun,1106,8,9,6,17,42,63,-21,33
FC Sion,1106,9,5,9,18,41,57,-16,24
Young Boys,1107,1,21,7,4,73,38,35,70
FC Basel,1107,2,16,9,7,53,29,24,57
St Gallen,1107,3,16,2,14,48,54,-6,50
Lucerne,1107,4,13,9,10,44,43,1,48
FC Zürich,1107,5,12,9,11,43,38,5,45
FC Thun,1107,6,11,5,16,46,56,-10,38
Grasshoppers,1107,7,10,6,16,41,53,-12,36
FC Lugano,1107,8,9,6,17,30,51,-21,33
FC Sion,1107,9,6,7,19,42,58,-16,25
Young Boys,1108,1,23,6,3,73,34,39,75
FC Basel,1108,2,18,9,5,54,24,30,63
St Gallen,1108,3,15,4,13,43,52,-9,49
Lucerne,1108,4,12,8,12,42,48,-6,44
FC Zürich,1108,5,10,12,10,39,34,5,42
FC Lugano,1108,6,9,7,16,30,47,-17,34
FC Thun,1108,7,9,6,17,42,59,-17,33
Grasshoppers,1108,8,8,7,17,37,48,-11,31
FC Sion,1108,9,6,9,17,37,51,-14,27
Young Boys,1109,1,21,7,4,72,36,36,70
FC Basel,1109,2,16,10,6,50,25,25,58
St Gallen,1109,3,15,4,13,43,51,-8,49
Lucerne,1109,4,13,7,12,38,43,-5,46
FC Zürich,1109,5,10,11,11,39,36,3,41
FC Thun,1109,6,10,7,15,43,54,-11,37
FC Lugano,1109,7,10,7,15,32,45,-13,37
Grasshoppers,1109,8,10,6,16,41,48,-7,36
FC Sion,1109,9,6,7,19,36,56,-20,25
Young Boys,1110,1,22,6,4,70,35,35,72
FC Basel,1110,2,18,8,6,53,23,30,62
Lucerne,1110,3,14,7,11,41,40,1,49
St Gallen,1110,4,14,4,14,41,52,-11,46
FC Thun,1110,5,11,5,16,42,56,-14,38
FC Zürich,1110,6,9,10,13,39,40,-1,37
Grasshoppers,1110,7,10,6,16,41,48,-7,36
FC Lugano,1110,8,9,7,16,29,47,-18,34
FC Sion,1110,9,7,7,18,37,52,-15,28
Young Boys,1111,1,23,7,2,69,30,39,76
FC Basel,1111,2,18,8,6,57,26,31,62
Lucerne,1111,3,13,8,11,41,44,-3,47
FC Zürich,1111,4,12,10,10,44,35,9,46
St Gallen,1111,5,13,2,17,41,58,-17,41
FC Lugano,1111,6,10,6,16,31,48,-17,36
FC Thun,1111,7,9,7,16,43,59,-16,34
Grasshoppers,1111,8,9,6,17,37,47,-10,33
FC Sion,1111,9,6,8,18,37,53,-16,26
Young Boys,1112,1,20,9,3,73,38,35,69
FC Basel,1112,2,16,11,5,58,28,30,59
Lucerne,1112,3,14,9,9,46,40,6,51
St Gallen,1112,4,14,3,15,41,56,-15,45
FC Zürich,1112,5,10,11,11,43,39,4,41
FC Lugano,1112,6,10,7,15,33,47,-14,37
Grasshoppers,1112,7,9,8,15,43,53,-10,35
FC Thun,1112,8,9,5,18,45,68,-23,32
FC Sion,1112,9,6,9,17,42,55,-13,27
Young Boys,1113,1,22,6,4,71,36,35,72
FC Basel,1113,2,20,7,5,57,23,34,67
St Gallen,1113,3,14,3,15,44,57,-13,45
FC Zürich,1113,4,10,11,11,41,37,4,41
Lucerne,1113,5,11,8,13,38,46,-8,41
Grasshoppers,1113,6,11,6,15,48,49,-1,39
FC Lugano,1113,7,11,6,15,33,49,-16,39
FC Thun,1113,8,9,5,18,45,61,-16,32
FC Sion,1113,9,6,8,18,41,60,-19,26
Young Boys,1114,1,22,7,3,71,33,38,73
FC Basel,1114,2,17,8,7,52,27,25,59
Lucerne,1114,3,12,10,10,41,41,0,46
FC Zürich,1114,4,12,9,11,43,35,8,45
St Gallen,1114,5,14,3,15,40,54,-14,45
Grasshoppers,1114,6,10,7,15,41,48,-7,37
FC Lugano,1114,7,10,7,15,30,45,-15,37
FC Sion,1114,8,7,8,17,40,54,-14,29
FC Thun,1114,9,8,5,19,41,62,-21,29
Young Boys,1115,1,23,6,3,75,32,43,75
FC Basel,1115,2,18,8,6,52,26,26,62
St Gallen,1115,3,14,3,15,40,54,-14,45
Lucerne,1115,4,12,8,12,39,43,-4,44
FC Zürich,1115,5,11,9,12,43,38,5,42
FC Lugano,1115,6,12,5,15,32,45,-13,41
Grasshoppers,1115,7,10,7,15,41,49,-8,37
FC Thun,1115,8,8,5,19,39,59,-20,29
FC Sion,1115,9,6,9,17,41,56,-15,27
Young Boys,1116,1,21,6,5,74,37,37,69
FC Basel,1116,2,17,8,7,52,29,23,59
Lucerne,1116,3,14,7,11,43,43,0,49
St Gallen,1116,4,14,3,15,42,55,-13,45
FC Zürich,1116,5,10,10,12,42,36,6,40
FC Thun,1116,6,11,5,16,45,57,-12,38
FC Lugano,1116,7,10,6,16,31,51,-20,36
FC Sion,1116,8,9,7,16,42,52,-10,34
Grasshoppers,1116,9,9,6,17,39,50,-11,33
Young Boys,1117,1,23,6,3,75,32,43,75
FC Basel,1117,2,18,8,6,54,25,29,62
Lucerne,1117,3,14,7,11,44,44,0,49
St Gallen,1117,4,14,2,16,40,56,-16,44
FC Zürich,1117,5,10,11,11,40,36,4,41
FC Lugano,1117,6,10,6,16,29,47,-18,36
Grasshoppers,1117,7,9,6,17,40,53,-13,33
FC Thun,1117,8,9,5,18,40,58,-18,32
FC Sion,1117,9,8,7,17,40,51,-11,31
Young Boys,1118,1,22,7,3,72,32,40,73
FC Basel,1118,2,19,8,5,57,23,34,65
St Gallen,1118,3,14,2,16,42,56,-14,44
Lucerne,1118,4,11,9,12,38,46,-8,42
FC Lugano,1118,5,12,5,15,34,47,-13,41
FC Thun,1118,6,11,5,16,46,61,-15,38
FC Zürich,1118,7,9,9,14,39,40,-1,36
Grasshoppers,1118,8,9,8,15,40,48,-8,35
FC Sion,1118,9,7,7,18,38,53,-15,28
Young Boys,1119,1,21,7,4,73,34,39,70
FC Basel,1119,2,17,8,7,54,27,27,59
St Gallen,1119,3,14,4,14,45,56,-11,46
FC Zürich,1119,4,12,9,11,43,36,7,45
Lucerne,1119,5,11,10,11,39,48,-9,43
FC Thun,1119,6,11,5,16,44,56,-12,38
FC Lugano,1119,7,10,7,15,33,49,-16,37
Grasshoppers,1119,8,9,8,15,39,46,-7,35
FC Sion,1119,9,6,8,18,39,57,-18,26
Young Boys,1120,1,21,6,5,70,36,34,69
FC Basel,1120,2,17,7,8,51,27,24,58
St Gallen,1120,3,15,4,13,42,51,-9,49
Lucerne,1120,4,13,8,11,44,47,-3,47
FC Zürich,1120,5,11,10,11,41,36,5,43
FC Thun,1120,6,10,7,15,47,57,-10,37
FC Lugano,1120,7,10,6,16,33,48,-15,36
Grasshoppers,1120,8,9,7,16,41,52,-11,34
FC Sion,1120,9,6,9,17,39,54,-15,27
Young Boys,1121,1,22,7,3,77,36,41,73
FC Basel,1121,2,17,7,8,52,29,23,58
St Gallen,1121,3,16,2,14,47,54,-7,50
FC Zürich,1121,4,12,9,11,42,34,8,45
Lucerne,1121,5,12,8,12,41,49,-8,44
FC Lugano,1121,6,10,6,16,33,47,-14,36
FC Thun,1121,7,10,5,17,44,60,-16,35
Grasshoppers,1121,8,9,7,16,40,50,-10,34
FC Sion,1121,9,7,7,18,40,57,-17,28
Young Boys,1122,1,21,7,4,73,37,36,70
FC Basel,1122,2,18,8,6,54,24,30,62
Lucerne,1122,3,14,9,9,48,42,6,51
St Gallen,1122,4,15,3,14,43,52,-9,48
FC Zürich,1122,5,11,9,12,39,41,-2,42
Grasshoppers,1122,6,9,8,15,41,49,-8,35
FC Lugano,1122,7,10,5,17,34,50,-16,35
FC Thun,1122,8,9,6,17,41,56,-15,33
FC Sion,1122,9,6,7,19,38,60,-22,25
Young Boys,1123,1,22,6,4,73,33,40,72
FC Basel,1123,2,17,8,7,52,28,24,59
St Gallen,1123,3,15,3,14,42,51,-9,48
Lucerne,1123,4,13,7,12,41,44,-3,46
FC Zürich,1123,5,11,11,10,43,35,8,44
FC Lugano,1123,6,10,6,16,29,48,-19,36
FC Thun,1123,7,10,5,17,44,59,-15,35
Grasshoppers,1123,8,9,6,17,39,52,-13,33
FC Sion,1123,9,7,8,17,42,55,-13,29
Young Boys,1124,1,23,6,3,72,32,40,75
FC Basel,1124,2,18,8,6,54,24,30,62
St Gallen,1124,3,15,3,14,45,55,-10,48
Lucerne,1124,4,12,9,11,45,48,-3,45
FC Zürich,1124,5,10,11,11,40,38,2,41
FC Thun,1124,6,10,6,16,45,58,-13,36
FC Lugano,1124,7,10,5,17,32,51,-19,35
Grasshoppers,1124,8,9,7,16,41,51,-10,34
FC Sion,1124,9,5,9,18,40,57,-17,24
Young Boys,1125,1,22,7,3,72,34,38,73
FC Basel,1125,2,19,7,6,56,24,32,64
Lucerne,1125,3,13,8,11,44,47,-3,47
St Gallen,1125,4,13,3,16,41,59,-18,42
FC Zürich,1125,5,10,10,12,37,34,3,40
FC Lugano,1125,6,11,6,15,33,45,-12,39
Grasshoppers,1125,7,10,6,16,41,49,-8,36
FC Thun,1125,8,10,5,17,41,56,-15,35
FC Sion,1125,9,6,8,18,36,53,-17,26
Young Boys,1126,1,21,7,4,70,36,34,70
FC Basel,1126,2,19,7,6,57,25,32,64
St Gallen,1126,3,15,2,15,44,55,-11,47
Lucerne,1126,4,13,7,12,44,45,-1,46
FC Lugano,1126,5,11,6,15,34,49,-15,39
FC Thun,1126,6,11,5,16,45,56,-11,38
FC Zürich,1126,7,9,9,14,39,41,-2,36
Grasshoppers,1126,8,9,6,17,40,53,-13,33
FC Sion,1126,9,8,7,17,40,53,-13,31
Young Boys,1127,1,21,9,2,72,36,36,72
FC Basel,1127,2,15,11,6,52,28,24,56
Lucerne,1127,3,12,10,10,41,42,-1,46
St Gallen,1127,4,14,3,15,41,54,-13,45
FC Zürich,1127,5,11,11,10,43,37,6,44
FC Lugano,1127,6,10,6,16,35,50,-15,36
FC Thun,1127,7,9,7,16,44,57,-13,34
FC Sion,1127,8,7,10,15,39,49,-10,31
Grasshoppers,1127,9,8,7,17,38,52,-14,31
Young Boys,1128,1,20,8,4,68,33,35,68
FC Basel,1128,2,16,9,7,50,28,22,57
Lucerne,1128,3,13,8,11,44,43,1,47
St Gallen,1128,4,14,3,15,45,58,-13,45
FC Zürich,1128,5,11,10,11,39,34,5,43
FC Lugano,1128,6,12,5,15,33,46,-13,41
FC Thun,1128,7,9,7,16,47,56,-9,34
Grasshoppers,1128,8,9,7,16,42,59,-17,34
FC Sion,1128,9,7,9,16,43,54,-11,30
Young Boys,1129,1,22,7,3,75,34,41,73
FC Basel,1129,2,18,7,7,54,28,26,61
St Gallen,1129,3,14,3,15,42,54,-12,45
Lucerne,1129,4,12,8,12,41,45,-4,44
FC Zürich,1129,5,10,10,12,41,37,4,40
FC Lugano,1129,6,10,7,15,31,49,-18,37
Grasshoppers,1129,7,9,7,16,45,54,-9,34
FC Thun,1129,8,9,7,16,42,58,-16,34
FC Sion,1129,9,8,8,16,41,53,-12,32
Young Boys,1130,1,20,7,5,70,37,33,67
FC Basel,1130,2,17,9,6,54,25,29,60
Lucerne,1130,3,14,7,11,41,45,-4,49
St Gallen,1130,4,14,3,15,40,52,-12,45
FC Zürich,1130,5,10,10,12,39,38,1,40
FC Lugano,1130,6,11,6,15,33,46,-13,39
FC Thun,1130,7,10,7,15,44,56,-12,37
Grasshoppers,1130,8,9,6,17,39,49,-10,33
FC Sion,1130,9,7,9,16,40,52,-12,30
Young Boys,1131,1,24,6,2,72,32,40,78
FC Basel,1131,2,16,10,6,57,32,25,58
St Gallen,1131,3,15,3,14,45,55,-10,48
FC Zürich,1131,4,11,11,10,43,36,7,44
Lucerne,1131,5,12,7,13,44,48,-4,43
Grasshoppers,1131,6,9,8,15,42,49,-7,35
FC Thun,1131,7,9,7,16,43,58,-15,34
FC Lugano,1131,8,9,5,18,30,52,-22,32
FC Sion,1131,9,6,9,17,38,52,-14,27
Young Boys,1132,1,21,7,4,72,38,34,70
FC Basel,1132,2,18,9,5,51,22,29,63
Lucerne,1132,3,13,8,11,42,42,0,47
FC Zürich,1132,4,11,10,11,40,34,6,43
St Gallen,1132,5,13,3,16,43,58,-15,42
Grasshoppers,1132,6,10,7,15,41,48,-7,37
FC Lugano,1132,7,10,6,16,31,50,-19,36
FC Thun,1132,8,9,6,17,42,59,-17,33
FC Sion,1132,9,7,8,17,45,56,-11,29
Young Boys,1133,1,21,6,5,71,36,35,69
FC Basel,1133,2,18,8,6,54,24,30,62
Lucerne,1133,3,14,8,10,44,43,1,50
FC Zürich,1133,4,12,9,11,43,36,7,45
St Gallen,1133,5,13,4,15,41,55,-14,43
FC Thun,1133,6,10,5,17,44,62,-18,35
FC Lugano,1133,7,10,5,17,30,48,-18,35
Grasshoppers,1133,8,9,7,16,41,50,-9,34
FC Sion,1133,9,7,8,17,42,56,-14,29
Young Boys,1134,1,22,6,4,75,40,35,72
FC Basel,1134,2,19,7,6,58,26,32,64
St Gallen,1134,3,15,3,14,45,55,-10,48
Lucerne,1134,4,12,8,12,43,47,-4,44
FC Zürich,1134,5,11,10,11,43,37,6,43
Grasshoppers,1134,6,11,7,14,50,50,0,40
FC Thun,1134,7,9,6,17,45,64,-19,33
FC Lugano,1134,8,9,6,17,33,54,-21,33
FC Sion,1134,9,5,9,18,38,57,-19,24
Young Boys,1135,1,21,8,3,72,35,37,71
FC Basel,1135,2,18,8,6,55,25,30,62
St Gallen,1135,3,16,2,14,43,51,-8,50
Lucerne,1135,4,12,8,12,40,47,-7,44
Grasshoppers,1135,5,11,6,15,42,50,-8,39
FC Lugano,1135,6,11,6,15,33,46,-13,39
FC Zürich,1135,7,9,9,14,39,41,-2,36
FC Thun,1135,8,10,5,17,45,59,-14,35
FC Sion,1135,9,6,8,18,41,56,-15,26
Young Boys,1136,1,21,8,3,72,35,37,71
FC Basel,1136,2,17,9,6,52,26,26,60
St Gallen,1136,3,15,3,14,43,52,-9,48
Lucerne,1136,4,12,8,12,38,44,-6,44
FC Zürich,1136,5,11,10,11,41,38,3,43
FC Lugano,1136,6,11,7,14,33,46,-13,40
FC Thun,1136,7,11,5,16,52,58,-6,38
Grasshoppers,1136,8,8,7,17,41,54,-13,31
FC Sion,1136,9,6,7,19,42,61,-19,25
Young Boys,1137,1,19,7,6,67,38,29,64
FC Basel,1137,2,18,7,7,57,28,29,61
Lucerne,1137,3,14,7,11,43,42,1,49
St Gallen,1137,4,15,2,15,45,57,-12,47
FC Zürich,1137,5,10,10,12,38,35,3,40
FC Lugano,1137,6,11,7,14,32,45,-13,40
Grasshoppers,1137,7,10,7,15,44,50,-6,37
FC Thun,1137,8,10,6,16,45,62,-17,36
FC Sion,1137,9,7,7,18,41,55,-14,28
Young Boys,1138,1,22,6,4,71,38,33,72
FC Basel,1138,2,18,8,6,56,25,31,62
St Gallen,1138,3,15,3,14,43,52,-9,48
Lucerne,1138,4,13,8,11,41,42,-1,47
FC Zürich,1138,5,10,11,11,40,38,2,41
Grasshoppers,1138,6,10,6,16,45,51,-6,36
FC Lugano,1138,7,10,6,16,31,46,-15,36
FC Thun,1138,8,9,6,17,44,61,-17,33
FC Sion,1138,9,6,8,18,41,59,-18,26
Young Boys,1139,1,22,7,3,78,36,42,73
FC Basel,1139,2,18,8,6,60,27,33,62
St Gallen,1139,3,15,3,14,51,54,-3,48
Lucerne,1139,4,12,8,12,40,47,-7,44
Grasshoppers,1139,5,11,7,14,47,50,-3,40
FC Lugano,1139,6,11,5,16,31,49,-18,38
FC Zürich,1139,7,9,9,14,36,42,-6,36
FC Thun,1139,8,9,7,16,45,60,-15,34
FC Sion,1139,9,6,8,18,38,61,-23,26
Young Boys,1140,1,21,6,5,69,38,31,69
FC Basel,1140,2,18,9,5,59,25,34,63
Lucerne,1140,3,14,8,10,45,44,1,50
St Gallen,1140,4,15,2,15,47,58,-11,47
FC Zürich,1140,5,9,11,12,38,36,2,38
Grasshoppers,1140,6,10,6,16,41,48,-7,36
FC Lugano,1140,7,10,5,17,30,49,-19,35
FC Thun,1140,8,9,7,16,43,59,-16,34
FC Sion,1140,9,7,8,17,38,53,-15,29
Young Boys,1141,1,24,6,2,78,34,44,78
FC Basel,1141,2,16,9,7,54,31,23,57
Lucerne,1141,3,15,7,10,46,44,2,52
St Gallen,1141,4,14,4,14,42,52,-10,46
FC Zürich,1141,5,11,10,11,44,39,5,43
Grasshoppers,1141,6,9,7,16,41,52,-11,34
FC Thun,1141,7,9,7,16,41,57,-16,34
FC Lugano,1141,8,9,5,18,30,50,-20,32
FC Sion,1141,9,5,9,18,38,55,-17,24
Young Boys,1142,1,22,8,2,69,32,37,74
FC Basel,1142,2,17,8,7,50,26,24,59
St Gallen,1142,3,15,3,14,46,53,-7,48
Lucerne,1142,4,12,10,10,42,42,0,46
FC Zürich,1142,5,12,9,11,43,37,6,45
FC Lugano,1142,6,10,5,17,31,50,-19,35
Grasshoppers,1142,7,8,8,16,37,48,-11,32
FC Sion,1142,8,8,7,17,39,51,-12,31
FC Thun,1142,9,8,6,18,41,59,-18,30
Young Boys,1143,1,20,7,5,69,37,32,67
FC Basel,1143,2,18,9,5,59,26,33,63
Lucerne,1143,3,12,9,11,42,44,-2,45
St Gallen,1143,4,14,2,16,40,58,-18,44
FC Zürich,1143,5,10,11,11,40,36,4,41
Grasshoppers,1143,6,11,7,14,43,48,-5,40
FC Lugano,1143,7,11,7,14,34,45,-11,40
FC Thun,1143,8,9,7,16,44,61,-17,34
FC Sion,1143,9,6,7,19,40,56,-16,25
Young Boys,1144,1,21,8,3,75,35,40,71
FC Basel,1144,2,18,8,6,52,26,26,62
Lucerne,1144,3,14,8,10,42,41,1,50
St Gallen,1144,4,15,3,14,42,51,-9,48
FC Zürich,1144,5,11,11,10,46,37,9,44
Grasshoppers,1144,6,10,6,16,42,48,-6,36
FC Lugano,1144,7,9,7,16,31,53,-22,34
FC Thun,1144,8,9,5,18,40,58,-18,32
FC Sion,1144,9,5,8,19,36,57,-21,23
Young Boys,1145,1,22,6,4,77,37,40,72
FC Basel,1145,2,18,7,7,54,25,29,61
St Gallen,1145,3,14,3,15,43,55,-12,45
FC Lugano,1145,4,13,5,14,36,44,-8,44
Lucerne,1145,5,12,7,13,41,53,-12,43
FC Zürich,1145,6,11,9,12,39,37,2,42
Grasshoppers,1145,7,9,8,15,42,49,-7,35
FC Thun,1145,8,9,6,17,42,59,-17,33
FC Sion,1145,9,6,9,17,38,53,-15,27
Young Boys,1146,1,20,7,5,68,41,27,67
FC Basel,1146,2,18,8,6,56,28,28,62
Lucerne,1146,3,15,7,10,47,42,5,52
St Gallen,1146,4,15,2,15,46,59,-13,47
FC Zürich,1146,5,10,10,12,43,39,4,40
FC Lugano,1146,6,11,5,16,35,48,-13,38
Grasshoppers,1146,7,9,7,16,44,54,-10,34
FC Thun,1146,8,9,6,17,46,64,-18,33
FC Sion,1146,9,7,8,17,43,53,-10,29
Young Boys,1147,1,22,6,4,69,35,34,72
FC Basel,1147,2,19,7,6,55,28,27,64
FC Zürich,1147,3,11,11,10,46,35,11,44
St Gallen,1147,4,14,2,16,46,58,-12,44
Lucerne,1147,5,11,9,12,39,45,-6,42
Grasshoppers,1147,6,10,7,15,42,49,-7,37
FC Lugano,1147,7,10,7,15,31,47,-16,37
FC Sion,1147,8,8,8,16,45,53,-8,32
FC Thun,1147,9,8,5,19,41,64,-23,29
Young Boys,1148,1,21,9,2,70,34,36,72
FC Basel,1148,2,16,9,7,49,24,25,57
FC Zürich,1148,3,13,9,10,44,35,9,48
Lucerne,1148,4,13,9,10,39,39,0,48
St Gallen,1148,5,15,2,15,42,55,-13,47
Grasshoppers,1148,6,10,7,15,42,47,-5,37
FC Lugano,1148,7,9,5,18,29,48,-19,32
FC Thun,1148,8,8,6,18,43,65,-22,30
FC Sion,1148,9,7,8,17,43,54,-11,29
Young Boys,1149,1,22,8,2,79,33,46,74
FC Basel,1149,2,17,10,5,53,26,27,61
FC Zürich,1149,3,12,9,11,44,36,8,45
Lucerne,1149,4,12,9,11,43,45,-2,45
St Gallen,1149,5,14,3,15,45,55,-10,45
Grasshoppers,1149,6,9,8,15,41,50,-9,35
FC Lugano,1149,7,10,5,17,31,55,-24,35
FC Thun,1149,8,8,7,17,42,61,-19,31
FC Sion,1149,9,7,7,18,41,58,-17,28
Young Boys,1150,1,21,9,2,71,33,38,72
FC Basel,1150,2,17,9,6,53,26,27,60
St Gallen,1150,3,15,3,14,44,54,-10,48
FC Zürich,1150,4,12,9,11,45,37,8,45
Lucerne,1150,5,12,8,12,42,49,-7,44
Grasshoppers,1150,6,11,7,14,44,46,-2,40
FC Lugano,1150,7,9,6,17,30,51,-21,33
FC Thun,1150,8,8,7,17,41,58,-17,31
FC Sion,1150,9,6,8,18,38,54,-16,26
Young Boys,1151,1,20,8,4,71,37,34,68
FC Basel,1151,2,16,9,7,53,30,23,57
Lucerne,1151,3,13,10,9,42,40,2,49
St Gallen,1151,4,15,4,13,43,51,-8,49
FC Zürich,1151,5,10,9,13,40,40,0,39
FC Lugano,1151,6,11,6,15,33,46,-13,39
Grasshoppers,1151,7,9,9,14,40,46,-6,36
FC Thun,1151,8,9,8,15,46,60,-14,35
FC Sion,1151,9,5,9,18,39,57,-18,24
Young Boys,1152,1,21,8,3,70,39,31,71
FC Basel,1152,2,18,9,5,61,26,35,63
St Gallen,1152,3,14,4,14,45,55,-10,46
Lucerne,1152,4,12,9,11,39,41,-2,45
FC Zürich,1152,5,11,11,10,45,36,9,44
Grasshoppers,1152,6,8,9,15,44,55,-11,33
FC Lugano,1152,7,9,6,17,28,51,-23,33
FC Thun,1152,8,8,8,16,44,61,-17,32
FC Sion,1152,9,6,10,16,43,55,-12,28
Young Boys,1153,1,22,6,4,69,32,37,72
FC Basel,1153,2,19,7,6,56,26,30,64
St Gallen,1153,3,14,3,15,43,56,-13,45
Lucerne,1153,4,12,8,12,41,47,-6,44
FC Zürich,1153,5,10,10,12,41,39,2,40
FC Thun,1153,6,10,6,16,46,59,-13,36
FC Lugano,1153,7,10,6,16,32,47,-15,36
Grasshoppers,1153,8,9,7,16,42,49,-7,34
FC Sion,1153,9,8,7,17,41,56,-15,31
Young Boys,1154,1,20,8,4,67,33,34,68
FC Basel,1154,2,19,8,5,54,24,30,65
Lucerne,1154,3,13,8,11,43,44,-1,47
St Gallen,1154,4,15,2,15,43,54,-11,47
FC Zürich,1154,5,11,9,12,40,37,3,42
Grasshoppers,1154,6,9,8,15,39,47,-8,35
FC Lugano,1154,7,10,5,17,32,50,-18,35
FC Thun,1154,8,9,5,18,42,59,-17,32
FC Sion,1154,9,7,9,16,40,52,-12,30
Young Boys,1155,1,21,8,3,70,34,36,71
FC Basel,1155,2,18,8,6,52,23,29,62
Lucerne,1155,3,13,8,11,42,43,-1,47
St Gallen,1155,4,14,3,15,45,57,-12,45
FC Zürich,1155,5,11,11,10,38,32,6,44
Grasshoppers,1155,6,10,8,14,43,47,-4,38
FC Lugano,1155,7,10,5,17,29,48,-19,35
FC Thun,1155,8,9,6,17,46,60,-14,33
FC Sion,1155,9,5,9,18,41,62,-21,24
Young Boys,1156,1,22,8,2,75,33,42,74
FC Basel,1156,2,18,8,6,50,23,27,62
Lucerne,1156,3,13,8,11,41,42,-1,47
St Gallen,1156,4,13,3,16,38,53,-15,42
FC Zürich,1156,5,10,10,12,41,39,2,40
Grasshoppers,1156,6,10,7,15,44,52,-8,37
FC Thun,1156,7,10,5,17,45,59,-14,35
FC Lugano,1156,8,10,5,17,31,51,-20,35
FC Sion,1156,9,6,10,16,47,60,-13,28
Young Boys,1157,1,23,6,3,69,32,37,75
FC Basel,1157,2,16,9,7,54,29,25,57
Lucerne,1157,3,15,7,10,46,40,6,52
St Gallen,1157,4,14,4,14,42,52,-10,46
FC Zürich,1157,5,11,10,11,41,34,7,43
FC Thun,1157,6,10,6,16,46,63,-17,36
FC Lugano,1157,7,9,6,17,27,46,-19,33
Grasshoppers,1157,8,8,7,17,39,54,-15,31
FC Sion,1157,9,6,9,17,39,53,-14,27
Young Boys,1158,1,23,7,2,76,35,41,76
FC Basel,1158,2,16,9,7,52,28,24,57
Lucerne,1158,3,14,7,11,51,43,8,49
St Gallen,1158,4,15,3,14,46,57,-11,48
FC Zürich,1158,5,10,9,13,39,40,-1,39
FC Lugano,1158,6,11,5,16,33,52,-19,38
FC Thun,1158,7,9,7,16,45,60,-15,34
Grasshoppers,1158,8,8,8,16,43,55,-12,32
FC Sion,1158,9,7,7,18,42,57,-15,28
Young Boys,1159,1,22,6,4,72,35,37,72
FC Basel,1159,2,18,7,7,53,28,25,61
Lucerne,1159,3,13,7,12,39,44,-5,46
FC Zürich,1159,4,12,9,11,44,35,9,45
St Gallen,1159,5,14,2,16,43,57,-14,44
FC Lugano,1159,6,11,5,16,31,48,-17,38
Grasshoppers,1159,7,10,6,16,40,50,-10,36
FC Thun,1159,8,9,6,17,44,58,-14,33
FC Sion,1159,9,7,8,17,42,53,-11,29
Young Boys,1160,1,23,7,2,74,31,43,76
FC Basel,1160,2,18,9,5,56,24,32,63
Lucerne,1160,3,13,7,12,44,49,-5,46
St Gallen,1160,4,14,2,16,43,60,-17,44
FC Zürich,1160,5,11,10,11,43,37,6,43
FC Lugano,1160,6,10,5,17,33,50,-17,35
Grasshoppers,1160,7,9,7,16,44,53,-9,34
FC Sion,1160,8,8,7,17,40,55,-15,31
FC Thun,1160,9,8,6,18,47,65,-18,30
Young Boys,1161,1,21,7,4,73,36,37,70
FC Basel,1161,2,19,8,5,56,24,32,65
St Gallen,1161,3,14,2,16,40,53,-13,44
Lucerne,1161,4,12,7,13,40,48,-8,43
FC Zürich,1161,5,11,9,12,41,36,5,42
FC Lugano,1161,6,12,5,15,31,47,-16,41
Grasshoppers,1161,7,9,8,15,42,50,-8,35
FC Thun,1161,8,8,8,16,40,56,-16,32
FC Sion,1161,9,6,10,16,41,54,-13,28
Young Boys,1162,1,23,7,2,73,33,40,76
FC Basel,1162,2,17,7,8,51,27,24,58
St Gallen,1162,3,16,2,14,47,55,-8,50
FC Zürich,1162,4,12,10,10,44,32,12,46
Lucerne,1162,5,11,8,13,38,45,-7,41
Grasshoppers,1162,6,10,7,15,41,47,-6,37
FC Lugano,1162,7,10,6,16,31,51,-20,36
FC Thun,1162,8,8,6,18,39,60,-21,30
FC Sion,1162,9,7,7,18,40,54,-14,28
Young Boys,1163,1,21,9,2,72,34,38,72
FC Basel,1163,2,17,8,7,56,26,30,59
Lucerne,1163,3,13,9,10,42,45,-3,48
St Gallen,1163,4,14,3,15,41,57,-16,45
FC Zürich,1163,5,11,10,11,43,37,6,43
FC Lugano,1163,6,11,5,16,33,48,-15,38
Grasshoppers,1163,7,10,7,15,43,50,-7,37
FC Thun,1163,8,10,5,17,47,61,-14,35
FC Sion,1163,9,5,8,19,38,57,-19,23
Young Boys,1164,1,20,9,3,68,37,31,69
FC Basel,1164,2,18,8,6,56,25,31,62
Lucerne,1164,3,12,9,11,45,47,-2,45
FC Zürich,1164,4,10,12,10,39,34,5,42
St Gallen,1164,5,13,2,17,40,58,-18,41
FC Lugano,1164,6,11,7,14,33,45,-12,40
FC Thun,1164,7,10,5,17,43,57,-14,35
FC Sion,1164,8,8,9,15,41,51,-10,33
Grasshoppers,1164,9,8,7,17,42,53,-11,31
Young Boys,1165,1,21,8,3,77,34,43,71
FC Basel,1165,2,18,8,6,52,24,28,62
Lucerne,1165,3,13,10,9,41,39,2,49
FC Zürich,1165,4,12,10,10,41,33,8,46
St Gallen,1165,5,14,3,15,41,53,-12,45
FC Thun,1165,6,10,5,17,41,57,-16,35
FC Lugano,1165,7,10,5,17,30,52,-22,35
Grasshoppers,1165,8,8,7,17,38,53,-15,31
FC Sion,1165,9,6,8,18,37,53,-16,26
FC Basel,1166,1,20,7,5,58,25,33,67
Young Boys,1166,2,19,9,4,72,40,32,66
Lucerne,1166,3,13,8,11,44,49,-5,47
St Gallen,1166,4,14,3,15,47,59,-12,45
FC Zürich,1166,5,10,10,12,43,39,4,40
FC Lugano,1166,6,10,7,15,36,50,-14,37
Grasshoppers,1166,7,9,8,15,41,49,-8,35
FC Thun,1166,8,9,5,18,43,61,-18,32
FC Sion,1166,9,7,9,16,42,54,-12,30
Young Boys,1167,1,22,8,2,70,33,37,74
FC Basel,1167,2,17,9,6,52,22,30,60
Lucerne,1167,3,13,10,9,42,40,2,49
St Gallen,1167,4,14,3,15,44,54,-10,45
FC Zürich,1167,5,10,12,10,42,37,5,42
Grasshoppers,1167,6,9,9,14,44,50,-6,36
FC Thun,1167,7,9,7,16,43,59,-16,34
FC Lugano,1167,8,9,6,17,32,51,-19,33
FC Sion,1167,9,5,8,19,39,62,-23,23
Young Boys,1168,1,21,7,4,69,36,33,70
FC Basel,1168,2,19,7,6,52,24,28,64
Lucerne,1168,3,12,8,12,43,44,-1,44
St Gallen,1168,4,14,2,16,42,56,-14,44
FC Zürich,1168,5,10,11,11,41,36,5,41
FC Lugano,1168,6,10,7,15,33,48,-15,37
Grasshoppers,1168,7,9,8,15,40,51,-11,35
FC Thun,1168,8,9,6,17,42,61,-19,33
FC Sion,1168,9,8,8,16,47,53,-6,32
Young Boys,1169,1,20,7,5,70,38,32,67
FC Basel,1169,2,18,8,6,54,24,30,62
Lucerne,1169,3,14,7,11,46,44,2,49
St Gallen,1169,4,14,2,16,42,58,-16,44
FC Zürich,1169,5,11,10,11,41,36,5,43
Grasshoppers,1169,6,10,7,15,40,46,-6,37
FC Lugano,1169,7,10,7,15,34,53,-19,37
FC Thun,1169,8,9,7,16,45,59,-14,34
FC Sion,1169,9,6,9,17,42,56,-14,27
Young Boys,1170,1,22,6,4,75,35,40,72
FC Basel,1170,2,19,8,5,57,25,32,65
St Gallen,1170,3,14,3,15,45,57,-12,45
FC Zürich,1170,4,11,10,11,45,36,9,43
Lucerne,1170,5,11,7,14,39,50,-11,40
Grasshoppers,1170,6,11,6,15,40,46,-6,39
FC Lugano,1170,7,10,6,16,33,51,-18,36
FC Thun,1170,8,10,5,17,45,58,-13,35
FC Sion,1170,9,7,7,18,39,60,-21,28
Young Boys,1171,1,20,9,3,68,35,33,69
FC Basel,1171,2,17,10,5,58,29,29,61
FC Zürich,1171,3,12,10,10,44,33,11,46
St Gallen,1171,4,14,4,14,41,55,-14,46
Lucerne,1171,5,11,10,11,44,49,-5,43
FC Sion,1171,6,9,7,16,48,51,-3,34
FC Lugano,1171,7,9,7,16,27,45,-18,34
Grasshoppers,1171,8,8,8,16,39,50,-11,32
FC Thun,1171,9,9,5,18,42,64,-22,32
Young Boys,1172,1,20,10,2,71,34,37,70
FC Basel,1172,2,17,9,6,49,23,26,60
St Gallen,1172,3,15,2,15,44,54,-10,47
Lucerne,1172,4,12,9,11,44,44,0,45
FC Lugano,1172,5,12,5,15,34,48,-14,41
FC Zürich,1172,6,10,10,12,40,36,4,40
FC Thun,1172,7,9,7,16,44,60,-16,34
Grasshoppers,1172,8,8,8,16,37,50,-13,32
FC Sion,1172,9,7,8,17,44,58,-14,29
Young Boys,1173,1,22,7,3,71,35,36,73
FC Basel,1173,2,19,8,5,57,24,33,65
Lucerne,1173,3,14,8,10,46,45,1,50
FC Zürich,1173,4,12,9,11,41,37,4,45
St Gallen,1173,5,14,2,16,43,56,-13,44
FC Lugano,1173,6,10,5,17,30,47,-17,35
FC Thun,1173,7,9,7,16,46,60,-14,34
Grasshoppers,1173,8,8,8,16,41,52,-11,32
FC Sion,1173,9,5,8,19,38,57,-19,23
Young Boys,1174,1,22,6,4,73,33,40,72
FC Basel,1174,2,18,8,6,53,25,28,62
Lucerne,1174,3,13,8,11,44,46,-2,47
St Gallen,1174,4,14,2,16,41,59,-18,44
FC Zürich,1174,5,10,12,10,38,33,5,42
FC Thun,1174,6,10,6,16,46,57,-11,36
FC Lugano,1174,7,10,6,16,29,47,-18,36
Grasshoppers,1174,8,8,8,16,41,53,-12,32
FC Sion,1174,9,7,8,17,41,53,-12,29
Young Boys,1175,1,21,8,3,69,36,33,71
FC Basel,1175,2,19,8,5,61,27,34,65
Lucerne,1175,3,13,8,11,45,46,-1,47
St Gallen,1175,4,13,4,15,42,57,-15,43
FC Zürich,1175,5,11,9,12,41,36,5,42
FC Lugano,1175,6,10,6,16,32,47,-15,36
Grasshoppers,1175,7,8,9,15,42,51,-9,33
FC Sion,1175,8,7,10,15,44,54,-10,31
FC Thun,1175,9,8,6,18,41,63,-22,30
Young Boys,1176,1,20,7,5,67,36,31,67
FC Basel,1176,2,18,7,7,54,26,28,61
Lucerne,1176,3,13,8,11,44,46,-2,47
FC Zürich,1176,4,12,10,10,42,35,7,46
St Gallen,1176,5,13,3,16,43,60,-17,42
Grasshoppers,1176,6,11,6,15,44,49,-5,39
FC Lugano,1176,7,10,8,14,31,43,-12,38
FC Thun,1176,8,9,6,17,42,58,-16,33
FC Sion,1176,9,6,9,17,41,55,-14,27
Young Boys,1177,1,23,7,2,77,32,45,76
FC Basel,1177,2,18,7,7,55,27,28,61
Lucerne,1177,3,13,8,11,40,42,-2,47
St Gallen,1177,4,14,3,15,44,56,-12,45
FC Zürich,1177,5,11,10,11,40,34,6,43
FC Lugano,1177,6,10,6,16,29,48,-19,36
FC Sion,1177,7,8,8,16,40,50,-10,32
Grasshoppers,1177,8,8,7,17,38,53,-15,31
FC Thun,1177,9,8,6,18,41,62,-21,30
Young Boys,1178,1,21,6,5,70,38,32,69
FC Basel,1178,2,19,7,6,55,23,32,64
St Gallen,1178,3,15,2,15,43,56,-13,47
FC Lugano,1178,4,13,5,14,38,48,-10,44
Lucerne,1178,5,12,7,13,43,46,-3,43
FC Zürich,1178,6,10,10,12,44,42,2,40
Grasshoppers,1178,7,10,6,16,43,52,-9,36
FC Sion,1178,8,8,7,17,42,52,-10,31
FC Thun,1178,9,8,6,18,41,62,-21,30
Young Boys,1179,1,21,8,3,73,38,35,71
FC Basel,1179,2,18,8,6,55,26,29,62
St Gallen,1179,3,15,3,14,45,52,-7,48
Lucerne,1179,4,13,7,12,44,45,-1,46
FC Zürich,1179,5,10,10,12,39,38,1,40
FC Lugano,1179,6,11,5,16,32,49,-17,38
Grasshoppers,1179,7,9,7,16,44,52,-8,34
FC Thun,1179,8,9,6,17,42,61,-19,33
FC Sion,1179,9,6,10,16,41,54,-13,28
Young Boys,1180,1,21,7,4,68,38,30,70
FC Basel,1180,2,18,9,5,54,23,31,63
Lucerne,1180,3,13,10,9,45,40,5,49
St Gallen,1180,4,13,3,16,39,58,-19,42
FC Zürich,1180,5,10,10,12,39,37,2,40
FC Lugano,1180,6,11,5,16,35,49,-14,38
Grasshoppers,1180,7,10,7,15,45,48,-3,37
FC Thun,1180,8,10,6,16,43,57,-14,36
FC Sion,1180,9,5,9,18,38,56,-18,24
Young Boys,1181,1,22,7,3,75,31,44,73
FC Basel,1181,2,18,9,5,54,25,29,63
St Gallen,1181,3,15,3,14,48,56,-8,48
Lucerne,1181,4,11,9,12,40,46,-6,42
FC Zürich,1181,5,10,10,12,42,39,3,40
Grasshoppers,1181,6,11,7,14,44,46,-2,40
FC Lugano,1181,7,11,5,16,30,51,-21,38
FC Thun,1181,8,8,7,17,42,60,-18,31
FC Sion,1181,9,5,9,18,40,61,-21,24
Young Boys,1182,1,23,6,3,81,40,41,75
FC Basel,1182,2,17,8,7,57,30,27,59
St Gallen,1182,3,15,3,14,43,54,-11,48
FC Zürich,1182,4,11,10,11,46,39,7,43
Lucerne,1182,5,11,8,13,41,50,-9,41
Grasshoppers,1182,6,11,7,14,45,48,-3,40
FC Lugano,1182,7,10,7,15,32,50,-18,37
FC Thun,1182,8,8,6,18,45,65,-20,30
FC Sion,1182,9,6,9,17,42,56,-14,27
Young Boys,1183,1,23,7,2,78,33,45,76
FC Basel,1183,2,18,7,7,54,28,26,61
Lucerne,1183,3,12,10,10,42,45,-3,46
St Gallen,1183,4,14,3,15,44,59,-15,45
FC Lugano,1183,5,11,5,16,33,49,-16,38
FC Zürich,1183,6,9,10,13,39,39,0,37
FC Thun,1183,7,9,7,16,43,57,-14,34
Grasshoppers,1183,8,8,9,15,41,51,-10,33
FC Sion,1183,9,7,8,17,44,57,-13,29
Young Boys,1184,1,22,6,4,77,38,39,72
FC Basel,1184,2,18,8,6,52,26,26,62
Lucerne,1184,3,13,8,11,41,45,-4,47
St Gallen,1184,4,14,3,15,43,55,-12,45
FC Zürich,1184,5,10,10,12,39,36,3,40
FC Lugano,1184,6,11,5,16,33,47,-14,38
Grasshoppers,1184,7,9,7,16,43,54,-11,34
FC Thun,1184,8,9,6,17,41,59,-18,33
FC Sion,1184,9,7,9,16,45,54,-9,30
Young Boys,1185,1,23,6,3,73,32,41,75
FC Basel,1185,2,19,7,6,58,25,33,64
St Gallen,1185,3,15,3,14,42,51,-9,48
FC Zürich,1185,4,12,9,11,40,35,5,45
Lucerne,1185,5,12,8,12,42,47,-5,44
Grasshoppers,1185,6,10,7,15,39,48,-9,37
FC Lugano,1185,7,9,6,17,29,48,-19,33
FC Thun,1185,8,9,5,18,41,60,-19,32
FC Sion,1185,9,6,7,19,39,57,-18,25
Young Boys,1186,1,21,7,4,70,37,33,70
FC Basel,1186,2,16,8,8,52,28,24,56
Lucerne,1186,3,15,8,9,43,38,5,53
St Gallen,1186,4,13,3,16,39,55,-16,42
FC Zürich,1186,5,10,11,11,37,33,4,41
FC Lugano,1186,6,11,6,15,32,45,-13,39
Grasshoppers,1186,7,9,8,15,41,48,-7,35
FC Thun,1186,8,9,7,16,42,59,-17,34
FC Sion,1186,9,6,10,16,38,51,-13,28
Young Boys,1187,1,24,6,2,78,33,45,78
FC Basel,1187,2,18,7,7,56,28,28,61
St Gallen,1187,3,15,3,14,43,54,-11,48
Lucerne,1187,4,13,7,12,46,48,-2,46
FC Zürich,1187,5,11,10,11,39,34,5,43
FC Lugano,1187,6,10,5,17,32,51,-19,35
Grasshoppers,1187,7,9,7,16,42,52,-10,34
FC Thun,1187,8,8,8,16,41,59,-18,32
FC Sion,1187,9,5,9,18,37,55,-18,24
Young Boys,1188,1,22,7,3,76,38,38,73
FC Basel,1188,2,17,10,5,49,22,27,61
St Gallen,1188,3,15,4,13,43,52,-9,49
FC Zürich,1188,4,11,11,10,40,32,8,44
Lucerne,1188,5,11,9,12,40,44,-4,42
Grasshoppers,1188,6,10,6,16,43,51,-8,36
FC Lugano,1188,7,10,5,17,30,50,-20,35
FC Thun,1188,8,9,5,18,42,60,-18,32
FC Sion,1188,9,6,9,17,41,55,-14,27
Young Boys,1189,1,20,10,2,72,35,37,70
FC Basel,1189,2,19,8,5,55,24,31,65
St Gallen,1189,3,15,3,14,41,51,-10,48
FC Zürich,1189,4,11,10,11,40,35,5,43
Lucerne,1189,5,11,8,13,39,45,-6,41
FC Lugano,1189,6,10,7,15,31,46,-15,37
FC Thun,1189,7,10,5,17,44,59,-15,35
Grasshoppers,1189,8,9,7,16,41,53,-12,34
FC Sion,1189,9,5,10,17,37,52,-15,25
Young Boys,1190,1,20,8,4,67,34,33,68
FC Basel,1190,2,18,8,6,60,28,32,62
Lucerne,1190,3,12,9,11,42,50,-8,45
St Gallen,1190,4,13,5,14,44,57,-13,44
FC Zürich,1190,5,11,10,11,42,36,6,43
FC Thun,1190,6,10,5,17,45,59,-14,35
FC Lugano,1190,7,9,8,15,30,47,-17,35
FC Sion,1190,8,8,9,15,43,51,-8,33
Grasshoppers,1190,9,9,6,17,40,51,-11,33
Young Boys,1191,1,21,6,5,69,38,31,69
FC Basel,1191,2,18,9,5,56,25,31,63
St Gallen,1191,3,14,4,14,42,53,-11,46
FC Zürich,1191,4,11,11,10,41,35,6,44
Lucerne,1191,5,12,8,12,41,44,-3,44
FC Lugano,1191,6,11,6,15,31,45,-14,39
Grasshoppers,1191,7,9,7,16,40,49,-9,34
FC Sion,1191,8,8,7,17,41,52,-11,31
FC Thun,1191,9,8,6,18,42,62,-20,30
Young Boys,1192,1,21,7,4,73,34,39,70
FC Basel,1192,2,18,8,6,58,30,28,62
Lucerne,1192,3,14,7,11,44,45,-1,49
St Gallen,1192,4,14,3,15,43,56,-13,45
FC Zürich,1192,5,10,9,13,40,40,0,39
FC Thun,1192,6,10,6,16,48,61,-13,36
FC Lugano,1192,7,10,6,16,32,46,-14,36
FC Sion,1192,8,9,7,16,43,55,-12,34
Grasshoppers,1192,9,8,7,17,38,52,-14,31
Young Boys,1193,1,22,6,4,72,36,36,72
FC Basel,1193,2,17,7,8,54,32,22,58
Lucerne,1193,3,14,7,11,43,46,-3,49
St Gallen,1193,4,15,3,14,49,56,-7,48
FC Zürich,1193,5,12,9,11,41,36,5,45
FC Thun,1193,6,9,6,17,45,58,-13,33
Grasshoppers,1193,7,9,6,17,40,53,-13,33
FC Lugano,1193,8,9,6,17,29,48,-19,33
FC Sion,1193,9,8,8,16,45,53,-8,32
Young Boys,1194,1,22,7,3,70,32,38,73
FC Basel,1194,2,19,7,6,60,24,36,64
St Gallen,1194,3,16,2,14,43,53,-10,50
Lucerne,1194,4,14,7,11,44,41,3,49
FC Zürich,1194,5,10,10,12,42,40,2,40
FC Lugano,1194,6,10,6,16,28,45,-17,36
Grasshoppers,1194,7,9,6,17,37,50,-13,33
FC Thun,1194,8,9,6,17,44,62,-18,33
FC Sion,1194,9,6,7,19,38,59,-21,25
Young Boys,1195,1,21,7,4,67,32,35,70
FC Basel,1195,2,18,7,7,52,29,23,61
St Gallen,1195,3,15,2,15,43,55,-12,47
Lucerne,1195,4,12,7,13,44,46,-2,43
FC Zürich,1195,5,10,10,12,42,36,6,40
Grasshoppers,1195,6,11,6,15,44,50,-6,39
FC Lugano,1195,7,11,6,15,30,47,-17,39
FC Thun,1195,8,11,5,16,44,56,-12,38
FC Sion,1195,9,6,8,18,38,53,-15,26
Young Boys,1196,1,22,6,4,76,38,38,72
FC Basel,1196,2,18,9,5,57,25,32,63
FC Zürich,1196,3,12,10,10,43,36,7,46
Lucerne,1196,4,12,10,10,41,42,-1,46
St Gallen,1196,5,14,3,15,40,57,-17,45
FC Lugano,1196,6,9,7,16,31,50,-19,34
Grasshoppers,1196,7,8,8,16,40,51,-11,32
FC Thun,1196,8,9,5,18,42,61,-19,32
FC Sion,1196,9,7,8,17,42,52,-10,29
Young Boys,1197,1,21,7,4,68,33,35,70
FC Basel,1197,2,19,8,5,56,24,32,65
Lucerne,1197,3,13,9,10,43,43,0,48
St Gallen,1197,4,13,4,15,42,58,-16,43
FC Zürich,1197,5,10,11,11,40,36,4,41
FC Lugano,1197,6,10,6,16,31,47,-16,36
FC Thun,1197,7,9,7,16,43,58,-15,34
Grasshoppers,1197,8,9,6,17,42,52,-10,33
FC Sion,1197,9,7,8,17,38,52,-14,29
Young Boys,1198,1,22,7,3,76,34,42,73
FC Basel,1198,2,20,7,5,58,24,34,67
Lucerne,1198,3,13,7,12,44,49,-5,46
St Gallen,1198,4,13,2,17,41,58,-17,41
FC Zürich,1198,5,10,10,12,38,38,0,40
FC Lugano,1198,6,11,5,16,32,48,-16,38
Grasshoppers,1198,7,9,7,16,42,53,-11,34
FC Sion,1198,8,8,8,16,43,52,-9,32
FC Thun,1198,9,8,7,17,40,58,-18,31
Young Boys,1199,1,21,7,4,71,37,34,70
FC Basel,1199,2,17,9,6,52,26,26,60
Lucerne,1199,3,14,8,10,44,45,-1,50
St Gallen,1199,4,13,5,14,42,54,-12,44
FC Thun,1199,5,12,5,15,50,57,-7,41
FC Zürich,1199,6,10,10,12,38,35,3,40
Grasshoppers,1199,7,10,6,16,47,52,-5,36
FC Lugano,1199,8,9,8,15,29,45,-16,35
FC Sion,1199,9,5,8,19,38,60,-22,23
Young Boys,1200,1,22,7,3,71,34,37,73
FC Basel,1200,2,17,9,6,52,24,28,60
Lucerne,1200,3,13,8,11,42,43,-1,47
St Gallen,1200,4,14,3,15,42,56,-14,45
FC Zürich,1200,5,10,10,12,43,39,4,40
FC Thun,1200,6,11,6,15,45,57,-12,39
FC Lugano,1200,7,11,5,16,32,47,-15,38
Grasshoppers,1200,8,9,7,16,40,49,-9,34
FC Sion,1200,9,6,7,19,41,59,-18,25
Young Boys,1201,1,21,7,4,67,33,34,70
FC Basel,1201,2,18,8,6,55,25,30,62
Lucerne,1201,3,13,8,11,39,42,-3,47
St Gallen,1201,4,13,3,16,40,56,-16,42
FC Lugano,1201,5,11,7,14,31,44,-13,40
FC Zürich,1201,6,9,10,13,39,39,0,37
Grasshoppers,1201,7,10,7,15,41,48,-7,37
FC Thun,1201,8,10,5,17,44,58,-14,35
FC Sion,1201,9,7,9,16,42,53,-11,30
Young Boys,1202,1,22,8,2,78,40,38,74
FC Basel,1202,2,16,9,7,50,26,24,57
Lucerne,1202,3,12,10,10,46,48,-2,46
St Gallen,1202,4,13,5,14,39,52,-13,44
FC Zürich,1202,5,10,11,11,44,37,7,41
FC Thun,1202,6,11,5,16,47,57,-10,38
FC Lugano,1202,7,10,7,15,33,48,-15,37
Grasshoppers,1202,8,10,6,16,49,55,-6,36
FC Sion,1202,9,5,9,18,37,60,-23,24
Young Boys,1203,1,20,8,4,71,39,32,68
FC Basel,1203,2,18,8,6,54,26,28,62
Lucerne,1203,3,13,8,11,45,44,1,47
St Gallen,1203,4,14,3,15,42,56,-14,45
FC Zürich,1203,5,10,10,12,41,38,3,40
FC Thun,1203,6,10,7,15,48,58,-10,37
FC Lugano,1203,7,9,9,14,32,47,-15,36
Grasshoppers,1203,8,9,7,16,45,55,-10,34
FC Sion,1203,9,7,8,17,41,56,-15,29
Young Boys,1204,1,22,8,2,78,35,43,74
FC Basel,1204,2,18,7,7,55,29,26,61
Lucerne,1204,3,13,7,12,46,46,0,46
St Gallen,1204,4,14,3,15,42,55,-13,45
FC Zürich,1204,5,11,9,12,40,35,5,42
FC Lugano,1204,6,11,5,16,31,52,-21,38
Grasshoppers,1204,7,9,8,15,44,52,-8,35
FC Thun,1204,8,10,5,17,42,58,-16,35
FC Sion,1204,9,5,10,17,40,56,-16,25
Young Boys,1205,1,22,6,4,70,33,37,72
FC Basel,1205,2,17,7,8,50,28,22,58
Lucerne,1205,3,14,8,10,43,39,4,50
St Gallen,1205,4,14,3,15,41,53,-12,45
FC Zürich,1205,5,11,9,12,43,36,7,42
FC Lugano,1205,6,10,7,15,30,45,-15,37
Grasshoppers,1205,7,10,6,16,45,55,-10,36
FC Thun,1205,8,10,5,17,43,60,-17,35
FC Sion,1205,9,7,7,18,38,54,-16,28
Young Boys,1206,1,20,9,3,75,39,36,69
FC Basel,1206,2,20,7,5,58,24,34,67
Lucerne,1206,3,12,9,11,45,48,-3,45
St Gallen,1206,4,14,2,16,43,57,-14,44
FC Zürich,1206,5,10,10,12,45,38,7,40
Grasshoppers,1206,6,11,7,14,46,49,-3,40
FC Thun,1206,7,9,6,17,46,57,-11,33
FC Lugano,1206,8,9,6,17,29,56,-27,33
FC Sion,1206,9,7,8,17,39,58,-19,29
Young Boys,1207,1,23,6,3,82,35,47,75
FC Basel,1207,2,19,8,5,56,22,34,65
Lucerne,1207,3,13,7,12,41,45,-4,46
St Gallen,1207,4,14,3,15,42,56,-14,45
FC Zürich,1207,5,11,10,11,41,37,4,43
FC Lugano,1207,6,10,6,16,31,52,-21,36
FC Thun,1207,7,10,5,17,43,61,-18,35
Grasshoppers,1207,8,9,6,17,41,53,-12,33
FC Sion,1207,9,6,7,19,41,57,-16,25
Young Boys,1208,1,23,6,3,74,33,41,75
FC Basel,1208,2,19,7,6,59,27,32,64
Lucerne,1208,3,14,7,11,46,47,-1,49
St Gallen,1208,4,14,2,16,41,55,-14,44
FC Zürich,1208,5,10,11,11,41,38,3,41
Grasshoppers,1208,6,10,6,16,41,50,-9,36
FC Thun,1208,7,10,6,16,45,58,-13,36
FC Lugano,1208,8,9,6,17,30,49,-19,33
FC Sion,1208,9,6,7,19,37,57,-20,25
Young Boys,1209,1,21,7,4,73,38,35,70
FC Basel,1209,2,19,8,5,61,23,38,65
Lucerne,1209,3,13,8,11,42,50,-8,47
St Gallen,1209,4,14,3,15,47,57,-10,45
FC Zürich,1209,5,10,9,13,40,36,4,39
Grasshoppers,1209,6,10,7,15,42,49,-7,37
FC Lugano,1209,7,10,5,17,34,54,-20,35
FC Sion,1209,8,8,8,16,40,52,-12,32
FC Thun,1209,9,9,5,18,41,61,-20,32
Young Boys,1210,1,21,9,2,75,36,39,72
FC Basel,1210,2,16,10,6,53,29,24,58
Lucerne,1210,3,12,10,10,44,44,0,46
FC Zürich,1210,4,12,9,11,47,39,8,45
St Gallen,1210,5,14,3,15,42,56,-14,45
Grasshoppers,1210,6,10,6,16,41,50,-9,36
FC Lugano,1210,7,10,6,16,33,54,-21,36
FC Thun,1210,8,9,6,17,46,62,-16,33
FC Sion,1210,9,6,9,17,44,55,-11,27
Young Boys,1211,1,22,8,2,73,32,41,74
FC Basel,1211,2,17,8,7,59,32,27,59
St Gallen,1211,3,14,3,15,43,56,-13,45
Lucerne,1211,4,12,8,12,41,49,-8,44
FC Zürich,1211,5,11,9,12,40,37,3,42
Grasshoppers,1211,6,10,8,14,45,48,-3,38
FC Lugano,1211,7,11,5,16,31,46,-15,38
FC Thun,1211,8,9,6,17,45,62,-17,33
FC Sion,1211,9,6,9,17,40,55,-15,27
Young Boys,1212,1,21,7,4,70,36,34,70
FC Basel,1212,2,17,8,7,55,29,26,59
St Gallen,1212,3,15,4,13,50,55,-5,49
Lucerne,1212,4,12,7,13,41,51,-10,43
FC Zürich,1212,5,10,10,12,40,38,2,40
Grasshoppers,1212,6,10,8,14,45,49,-4,38
FC Lugano,1212,7,10,6,16,33,50,-17,36
FC Thun,1212,8,9,7,16,41,55,-14,34
FC Sion,1212,9,7,9,16,42,54,-12,30
FC Basel,1213,1,20,7,5,55,23,32,67
Young Boys,1213,2,20,7,5,69,38,31,67
Lucerne,1213,3,13,8,11,45,45,0,47
St Gallen,1213,4,13,4,15,40,53,-13,43
FC Zrich,1213,5,11,9,12,44,37,7,42
FC Lugano,1213,6,11,6,15,33,48,-15,39
Grasshoppers,1213,7,10,7,15,42,50,-8,37
FC Thun,1213,8,9,6,17,42,58,-16,33
FC Sion,1213,9,6,8,18,37,55,-18,26
Young Boys,1214,1,20,7,5,74,43,31,67
FC Basel,1214,2,17,7,8,52,31,21,58
Lucerne,1214,3,14,7,11,47,43,4,49
FC Zürich,1214,4,13,9,10,44,34,10,48
St Gallen,1214,5,15,3,14,41,52,-11,48
Grasshoppers,1214,6,11,7,14,43,46,-3,40
FC Lugano,1214,7,9,6,17,31,52,-21,33
FC Thun,1214,8,8,6,18,41,60,-19,30
FC Sion,1214,9,7,8,17,42,54,-12,29
Young Boys,1215,1,22,7,3,74,37,37,73
FC Basel,1215,2,17,9,6,52,25,27,60
Lucerne,1215,3,13,8,11,41,41,0,47
St Gallen,1215,4,14,3,15,39,53,-14,45
FC Zürich,1215,5,10,12,10,42,36,6,42
Grasshoppers,1215,6,10,8,14,43,48,-5,38
FC Thun,1215,7,9,6,17,42,61,-19,33
FC Lugano,1215,8,9,6,17,30,49,-19,33
FC Sion,1215,9,6,9,17,43,56,-13,27
Young Boys,1216,1,21,9,2,70,32,38,72
FC Basel,1216,2,18,9,5,55,22,33,63
Lucerne,1216,3,12,10,10,42,43,-1,46
St Gallen,1216,4,13,3,16,41,58,-17,42
FC Zürich,1216,5,10,9,13,40,38,2,39
FC Lugano,1216,6,11,5,16,29,46,-17,38
FC Thun,1216,7,10,5,17,44,58,-14,35
FC Sion,1216,8,8,8,16,42,53,-11,32
Grasshoppers,1216,9,8,8,16,37,50,-13,32
Young Boys,1217,1,21,6,5,70,38,32,69
FC Basel,1217,2,18,8,6,54,23,31,62
Lucerne,1217,3,14,7,11,43,43,0,49
St Gallen,1217,4,15,3,14,45,53,-8,48
FC Zürich,1217,5,11,9,12,42,38,4,42
FC Sion,1217,6,9,8,15,44,51,-7,35
Grasshoppers,1217,7,9,7,16,42,51,-9,34
FC Thun,1217,8,9,5,18,42,61,-19,32
FC Lugano,1217,9,9,5,18,28,52,-24,32
Young Boys,1218,1,21,9,2,75,35,40,72
FC Basel,1218,2,17,10,5,54,26,28,61
St Gallen,1218,3,14,4,14,44,55,-11,46
Lucerne,1218,4,12,9,11,46,45,1,45
FC Zürich,1218,5,10,10,12,40,38,2,40
FC Thun,1218,6,10,6,16,47,60,-13,36
FC Lugano,1218,7,9,8,15,30,50,-20,35
Grasshoppers,1218,8,8,7,17,40,56,-16,31
FC Sion,1218,9,7,9,16,47,58,-11,30
Young Boys,1219,1,20,8,4,68,35,33,68
FC Basel,1219,2,18,9,5,57,24,33,63
Lucerne,1219,3,13,10,9,43,42,1,49
St Gallen,1219,4,14,3,15,44,57,-13,45
FC Zürich,1219,5,11,9,12,43,39,4,42
Grasshoppers,1219,6,10,7,15,43,49,-6,37
FC Lugano,1219,7,10,6,16,30,47,-17,36
FC Thun,1219,8,9,6,17,42,61,-19,33
FC Sion,1219,9,6,8,18,41,57,-16,26
Young Boys,1220,1,21,8,3,69,34,35,71
FC Basel,1220,2,19,7,6,54,24,30,64
St Gallen,1220,3,15,3,14,43,53,-10,48
Lucerne,1220,4,13,8,11,47,42,5,47
FC Zürich,1220,5,11,10,11,41,36,5,43
FC Lugano,1220,6,10,7,15,31,46,-15,37
Grasshoppers,1220,7,8,7,17,39,58,-19,31
FC Thun,1220,8,8,6,18,40,60,-20,30
FC Sion,1220,9,7,8,17,43,54,-11,29
Young Boys,1221,1,21,7,4,70,39,31,70
FC Basel,1221,2,17,9,6,55,27,28,60
Lucerne,1221,3,14,8,10,43,40,3,50
St Gallen,1221,4,15,2,15,43,54,-11,47
FC Zürich,1221,5,10,11,11,40,37,3,41
FC Lugano,1221,6,10,6,16,31,48,-17,36
Grasshoppers,1221,7,9,8,15,46,53,-7,35
FC Thun,1221,8,9,7,16,46,60,-14,34
FC Sion,1221,9,6,8,18,40,56,-16,26
Young Boys,1222,1,21,8,3,72,38,34,71
FC Basel,1222,2,18,8,6,55,25,30,62
St Gallen,1222,3,16,2,14,44,56,-12,50
Lucerne,1222,4,12,8,12,45,47,-2,44
FC Zürich,1222,5,10,11,11,39,36,3,41
FC Lugano,1222,6,10,6,16,32,48,-16,36
Grasshoppers,1222,7,9,7,16,43,54,-11,34
FC Thun,1222,8,9,7,16,45,57,-12,34
FC Sion,1222,9,6,9,17,40,54,-14,27
Young Boys,1223,1,22,6,4,70,34,36,72
FC Basel,1223,2,18,8,6,52,25,27,62
Lucerne,1223,3,12,9,11,41,43,-2,45
St Gallen,1223,4,13,3,16,44,60,-16,42
FC Zürich,1223,5,10,11,11,43,40,3,41
FC Lugano,1223,6,10,7,15,33,48,-15,37
FC Sion,1223,7,9,7,16,47,53,-6,34
Grasshoppers,1223,8,9,7,16,39,50,-11,34
FC Thun,1223,9,9,6,17,41,57,-16,33
Young Boys,1224,1,22,7,3,73,37,36,73
FC Basel,1224,2,18,8,6,56,26,30,62
Lucerne,1224,3,13,9,10,46,42,4,48
St Gallen,1224,4,15,2,15,45,56,-11,47
FC Zürich,1224,5,10,10,12,42,39,3,40
FC Thun,1224,6,10,6,16,44,56,-12,36
FC Lugano,1224,7,10,5,17,33,53,-20,35
Grasshoppers,1224,8,9,6,17,38,55,-17,33
FC Sion,1224,9,6,9,17,39,52,-13,27
Young Boys,1225,1,20,10,2,69,34,35,70
FC Basel,1225,2,17,8,7,54,28,26,59
Lucerne,1225,3,13,9,10,45,44,1,48
St Gallen,1225,4,14,3,15,45,58,-13,45
FC Zürich,1225,5,11,10,11,41,38,3,43
FC Thun,1225,6,10,6,16,45,57,-12,36
Grasshoppers,1225,7,9,8,15,40,49,-9,35
FC Lugano,1225,8,9,8,15,31,47,-16,35
FC Sion,1225,9,6,8,18,39,54,-15,26
Young Boys,1226,1,21,6,5,66,34,32,69
FC Basel,1226,2,19,7,6,55,23,32,64
Lucerne,1226,3,14,7,11,44,43,1,49
St Gallen,1226,4,15,3,14,44,57,-13,48
FC Zürich,1226,5,12,10,10,44,36,8,46
FC Lugano,1226,6,10,7,15,32,48,-16,37
Grasshoppers,1226,7,9,7,16,40,49,-9,34
FC Thun,1226,8,8,6,18,41,59,-18,30
FC Sion,1226,9,6,7,19,39,56,-17,25
Young Boys,1227,1,22,8,2,74,36,38,74
FC Basel,1227,2,17,8,7,55,28,27,59
St Gallen,1227,3,15,4,13,44,51,-7,49
Lucerne,1227,4,12,8,12,41,46,-5,44
FC Zürich,1227,5,10,10,12,40,36,4,40
FC Lugano,1227,6,11,6,15,32,46,-14,39
FC Thun,1227,7,10,6,16,42,59,-17,36
Grasshoppers,1227,8,9,6,17,42,50,-8,33
FC Sion,1227,9,6,8,18,37,55,-18,26
Young Boys,1228,1,23,7,2,77,35,42,76
FC Basel,1228,2,18,7,7,60,29,31,61
St Gallen,1228,3,15,2,15,45,54,-9,47
FC Zürich,1228,4,11,10,11,43,40,3,43
Lucerne,1228,5,12,7,13,40,47,-7,43
FC Lugano,1228,6,10,6,16,30,47,-17,36
Grasshoppers,1228,7,9,8,15,38,46,-8,35
FC Thun,1228,8,9,5,18,42,62,-20,32
FC Sion,1228,9,7,8,17,41,56,-15,29
Young Boys,1229,1,21,8,3,69,33,36,71
FC Basel,1229,2,18,9,5,55,23,32,63
Lucerne,1229,3,13,8,11,40,41,-1,47
FC Zürich,1229,4,11,11,10,45,38,7,44
St Gallen,1229,5,14,2,16,39,54,-15,44
FC Lugano,1229,6,11,5,16,32,49,-17,38
FC Thun,1229,7,10,6,16,47,57,-10,36
Grasshoppers,1229,8,8,8,16,37,50,-13,32
FC Sion,1229,9,6,7,19,38,57,-19,25
Young Boys,1230,1,20,9,3,69,36,33,69
FC Basel,1230,2,17,8,7,55,27,28,59
St Gallen,1230,3,15,2,15,45,55,-10,47
FC Zürich,1230,4,10,12,10,41,36,5,42
Lucerne,1230,5,11,9,12,38,45,-7,42
Grasshoppers,1230,6,10,8,14,42,47,-5,38
FC Lugano,1230,7,10,8,14,33,47,-14,38
FC Thun,1230,8,9,7,16,43,59,-16,34
FC Sion,1230,9,7,7,18,41,55,-14,28
Young Boys,1231,1,24,6,2,75,32,43,78
FC Basel,1231,2,19,7,6,56,25,31,64
FC Zürich,1231,3,12,9,11,42,35,7,45
Lucerne,1231,4,12,7,13,42,48,-6,43
St Gallen,1231,5,13,3,16,41,57,-16,42
Grasshoppers,1231,6,11,6,15,41,47,-6,39
FC Lugano,1231,7,10,6,16,29,45,-16,36
FC Thun,1231,8,8,6,18,44,63,-19,30
FC Sion,1231,9,6,8,18,39,57,-18,26
Young Boys,1232,1,22,7,3,73,33,40,73
FC Basel,1232,2,17,9,6,54,27,27,60
Lucerne,1232,3,15,8,9,46,41,5,53
St Gallen,1232,4,14,2,16,45,61,-16,44
FC Zürich,1232,5,9,10,13,38,40,-2,37
Grasshoppers,1232,6,10,7,15,40,50,-10,37
FC Thun,1232,7,10,6,16,47,58,-11,36
FC Lugano,1232,8,10,6,16,35,51,-16,36
FC Sion,1232,9,6,7,19,39,56,-17,25
Young Boys,1233,1,22,7,3,75,33,42,73
FC Basel,1233,2,18,7,7,51,24,27,61
St Gallen,1233,3,16,2,14,45,53,-8,50
Lucerne,1233,4,12,9,11,41,44,-3,45
FC Zürich,1233,5,10,11,11,39,35,4,41
FC Thun,1233,6,10,6,16,43,56,-13,36
FC Lugano,1233,7,10,6,16,32,49,-17,36
Grasshoppers,1233,8,8,7,17,40,54,-14,31
FC Sion,1233,9,7,7,18,40,58,-18,28
Young Boys,1234,1,20,7,5,69,37,32,67
FC Basel,1234,2,17,10,5,51,23,28,61
Lucerne,1234,3,13,9,10,46,45,1,48
St Gallen,1234,4,13,4,15,41,59,-18,43
FC Zürich,1234,5,10,11,11,41,36,5,41
FC Lugano,1234,6,11,7,14,36,47,-11,40
Grasshoppers,1234,7,10,6,16,42,49,-7,36
FC Thun,1234,8,10,5,17,42,58,-16,35
FC Sion,1234,9,7,7,18,42,56,-14,28
Young Boys,1235,1,24,6,2,76,33,43,78
FC Basel,1235,2,16,8,8,51,29,22,56
St Gallen,1235,3,15,3,14,43,53,-10,48
Lucerne,1235,4,13,8,11,42,45,-3,47
FC Zürich,1235,5,12,9,11,45,39,6,45
Grasshoppers,1235,6,10,7,15,43,49,-6,37
FC Thun,1235,7,9,6,17,44,63,-19,33
FC Lugano,1235,8,9,5,18,29,49,-20,32
FC Sion,1235,9,6,8,18,44,57,-13,26
Young Boys,1236,1,21,7,4,70,37,33,70
FC Basel,1236,2,19,8,5,56,23,33,65
Lucerne,1236,3,13,8,11,44,45,-1,47
St Gallen,1236,4,14,3,15,43,55,-12,45
FC Lugano,1236,5,11,7,14,36,45,-9,40
FC Zürich,1236,6,10,9,13,42,42,0,39
Grasshoppers,1236,7,10,6,16,42,52,-10,36
FC Thun,1236,8,10,6,16,47,61,-14,36
FC Sion,1236,9,5,8,19,36,56,-20,23
Young Boys,1237,1,21,7,4,72,38,34,70
FC Basel,1237,2,17,9,6,56,28,28,60
St Gallen,1237,3,14,4,14,40,51,-11,46
Lucerne,1237,4,11,10,11,43,46,-3,43
FC Zürich,1237,5,10,12,10,42,36,6,42
Grasshoppers,1237,6,12,6,14,47,48,-1,42
FC Lugano,1237,7,10,7,15,29,44,-15,37
FC Thun,1237,8,9,6,17,44,65,-21,33
FC Sion,1237,9,5,9,18,38,55,-17,24
Young Boys,1238,1,20,7,5,70,39,31,67
FC Basel,1238,2,18,9,5,54,25,29,63
Lucerne,1238,3,13,9,10,45,43,2,48
St Gallen,1238,4,14,5,13,45,53,-8,47
FC Zürich,1238,5,11,10,11,45,37,8,43
FC Thun,1238,6,10,7,15,46,54,-8,37
Grasshoppers,1238,7,9,6,17,37,51,-14,33
FC Lugano,1238,8,9,6,17,32,53,-21,33
FC Sion,1238,9,7,7,18,41,60,-19,28
Young Boys,1239,1,22,8,2,73,34,39,74
FC Basel,1239,2,18,7,7,55,29,26,61
St Gallen,1239,3,15,2,15,47,56,-9,47
Lucerne,1239,4,12,8,12,40,45,-5,44
FC Zürich,1239,5,11,10,11,43,36,7,43
FC Lugano,1239,6,11,6,15,32,48,-16,39
Grasshoppers,1239,7,10,7,15,41,49,-8,37
FC Thun,1239,8,9,5,18,42,59,-17,32
FC Sion,1239,9,5,9,18,37,54,-17,24
Young Boys,1240,1,20,8,4,68,36,32,68
FC Basel,1240,2,18,8,6,54,25,29,62
St Gallen,1240,3,17,2,13,47,52,-5,53
FC Lugano,1240,4,12,5,15,33,45,-12,41
Lucerne,1240,5,11,7,14,39,50,-11,40
FC Zürich,1240,6,9,10,13,39,39,0,37
FC Thun,1240,7,10,6,16,44,57,-13,36
Grasshoppers,1240,8,9,8,15,44,49,-5,35
FC Sion,1240,9,7,8,17,42,57,-15,29
Young Boys,1241,1,22,6,4,73,35,38,72
FC Basel,1241,2,18,9,5,55,24,31,63
Lucerne,1241,3,13,8,11,45,48,-3,47
St Gallen,1241,4,14,5,13,44,53,-9,47
FC Zürich,1241,5,9,10,13,38,41,-3,37
FC Thun,1241,6,9,8,15,45,57,-12,35
FC Lugano,1241,7,9,7,16,28,48,-20,34
Grasshoppers,1241,8,8,8,16,38,49,-11,32
FC Sion,1241,9,7,9,16,43,54,-11,30
Young Boys,1242,1,20,8,4,68,35,33,68
FC Basel,1242,2,17,9,6,56,27,29,60
Lucerne,1242,3,14,8,10,43,39,4,50
St Gallen,1242,4,15,2,15,44,57,-13,47
FC Lugano,1242,5,11,5,16,31,48,-17,38
FC Zürich,1242,6,9,10,13,39,39,0,37
Grasshoppers,1242,7,10,7,15,43,51,-8,37
FC Thun,1242,8,10,7,15,45,56,-11,37
FC Sion,1242,9,6,8,18,41,58,-17,26
Young Boys,1243,1,22,6,4,73,35,38,72
FC Basel,1243,2,18,8,6,56,26,30,62
St Gallen,1243,3,14,5,13,43,53,-10,47
Lucerne,1243,4,12,8,12,39,46,-7,44
FC Zürich,1243,5,11,9,12,44,39,5,42
Grasshoppers,1243,6,10,7,15,42,50,-8,37
FC Lugano,1243,7,10,6,16,31,47,-16,36
FC Thun,1243,8,10,5,17,46,61,-15,35
FC Sion,1243,9,6,8,18,41,58,-17,26
Young Boys,1244,1,22,8,2,77,34,43,74
FC Basel,1244,2,16,11,5,50,24,26,59
St Gallen,1244,3,16,3,13,45,51,-6,51
Lucerne,1244,4,12,8,12,43,48,-5,44
FC Zürich,1244,5,9,12,11,37,34,3,39
FC Thun,1244,6,9,8,15,42,56,-14,35
FC Lugano,1244,7,9,7,16,30,50,-20,34
Grasshoppers,1244,8,8,8,16,39,51,-12,32
FC Sion,1244,9,7,7,18,40,55,-15,28
Young Boys,1245,1,23,6,3,77,33,44,75
FC Basel,1245,2,17,8,7,53,26,27,59
Lucerne,1245,3,14,7,11,44,48,-4,49
St Gallen,1245,4,14,4,14,43,54,-11,46
FC Zürich,1245,5,11,9,12,39,36,3,42
FC Thun,1245,6,10,6,16,44,55,-11,36
FC Lugano,1245,7,10,6,16,29,49,-20,36
Grasshoppers,1245,8,8,7,17,40,53,-13,31
FC Sion,1245,9,6,9,17,38,53,-15,27
Young Boys,1246,1,23,6,3,75,34,41,75
FC Basel,1246,2,20,7,5,57,22,35,67
Lucerne,1246,3,14,7,11,45,42,3,49
St Gallen,1246,4,14,2,16,42,57,-15,44
FC Zürich,1246,5,10,11,11,40,38,2,41
FC Lugano,1246,6,10,6,16,29,47,-18,36
Grasshoppers,1246,7,8,7,17,40,54,-14,31
FC Thun,1246,8,8,7,17,43,60,-17,31
FC Sion,1246,9,7,7,18,41,58,-17,28
Young Boys,1247,1,21,8,3,76,40,36,71
FC Basel,1247,2,18,9,5,52,24,28,63
Lucerne,1247,3,13,9,10,41,40,1,48
FC Zürich,1247,4,11,10,11,39,33,6,43
St Gallen,1247,5,13,2,17,38,54,-16,41
FC Lugano,1247,6,10,6,16,31,49,-18,36
Grasshoppers,1247,7,9,6,17,41,51,-10,33
FC Thun,1247,8,9,6,17,40,56,-16,33
FC Sion,1247,9,8,8,16,42,53,-11,32
Young Boys,1248,1,23,7,2,74,32,42,76
FC Basel,1248,2,16,9,7,56,30,26,57
St Gallen,1248,3,15,3,14,42,52,-10,48
Lucerne,1248,4,13,8,11,42,42,0,47
FC Zürich,1248,5,11,10,11,42,37,5,43
Grasshoppers,1248,6,10,6,16,42,50,-8,36
FC Lugano,1248,7,9,7,16,29,47,-18,34
FC Sion,1248,8,8,7,17,40,53,-13,31
FC Thun,1248,9,8,5,19,40,64,-24,29
Young Boys,1249,1,21,8,3,72,34,38,71
FC Basel,1249,2,17,9,6,52,26,26,60
St Gallen,1249,3,15,3,14,45,53,-8,48
Lucerne,1249,4,13,8,11,43,49,-6,47
FC Zürich,1249,5,10,10,12,39,37,2,40
FC Lugano,1249,6,11,6,15,33,46,-13,39
FC Thun,1249,7,10,5,17,45,59,-14,35
Grasshoppers,1249,8,9,7,16,41,51,-10,34
FC Sion,1249,9,5,10,17,42,57,-15,25
Young Boys,1250,1,23,6,3,71,32,39,75
FC Basel,1250,2,18,8,6,53,26,27,62
Lucerne,1250,3,13,8,11,40,42,-2,47
St Gallen,1250,4,13,3,16,42,56,-14,42
FC Zürich,1250,5,10,11,11,41,36,5,41
Grasshoppers,1250,6,9,8,15,41,49,-8,35
FC Thun,1250,7,9,7,16,45,60,-15,34
FC Lugano,1250,8,9,6,17,29,48,-19,33
FC Sion,1250,9,8,7,17,38,51,-13,31
Young Boys,1251,1,23,6,3,71,33,38,75
FC Basel,1251,2,17,7,8,52,28,24,58
St Gallen,1251,3,15,2,15,42,54,-12,47
FC Zürich,1251,4,12,10,10,43,34,9,46
Lucerne,1251,5,13,7,12,43,43,0,46
Grasshoppers,1251,6,10,7,15,41,47,-6,37
FC Lugano,1251,7,10,5,17,30,50,-20,35
FC Thun,1251,8,9,6,17,44,60,-16,33
FC Sion,1251,9,6,8,18,38,55,-17,26
Young Boys,1252,1,21,8,3,67,31,36,71
FC Basel,1252,2,19,8,5,58,23,35,65
Lucerne,1252,3,13,8,11,39,41,-2,47
St Gallen,1252,4,14,4,14,45,55,-10,46
FC Zürich,1252,5,9,10,13,40,43,-3,37
FC Lugano,1252,6,9,8,15,32,48,-16,35
FC Thun,1252,7,10,5,17,44,63,-19,35
FC Sion,1252,8,8,8,16,44,53,-9,32
Grasshoppers,1252,9,8,7,17,37,49,-12,31
Young Boys,1253,1,22,6,4,75,34,41,72
FC Basel,1253,2,17,7,8,52,30,22,58
St Gallen,1253,3,15,2,15,46,58,-12,47
Lucerne,1253,4,12,8,12,44,47,-3,44
FC Zürich,1253,5,11,10,11,42,34,8,43
FC Lugano,1253,6,11,6,15,32,49,-17,39
FC Thun,1253,7,10,6,16,45,56,-11,36
Grasshoppers,1253,8,10,6,16,41,53,-12,36
FC Sion,1253,9,7,7,18,42,58,-16,28
Young Boys,1254,1,20,10,2,70,33,37,70
FC Basel,1254,2,16,10,6,54,26,28,58
St Gallen,1254,3,15,4,13,45,53,-8,49
Lucerne,1254,4,12,8,12,40,46,-6,44
FC Zürich,1254,5,10,11,11,37,35,2,41
FC Lugano,1254,6,10,7,15,30,46,-16,37
Grasshoppers,1254,7,10,6,16,41,50,-9,36
FC Thun,1254,8,9,6,17,44,59,-15,33
FC Sion,1254,9,6,10,16,39,52,-13,28
Young Boys,1255,1,20,9,3,73,38,35,69
FC Basel,1255,2,18,9,5,57,26,31,63
St Gallen,1255,3,14,5,13,43,53,-10,47
Lucerne,1255,4,12,9,11,40,44,-4,45
FC Zürich,1255,5,10,10,12,38,35,3,40
Grasshoppers,1255,6,9,8,15,44,50,-6,35
FC Lugano,1255,7,9,8,15,31,47,-16,35
FC Thun,1255,8,9,6,17,41,61,-20,33
FC Sion,1255,9,7,8,17,40,53,-13,29
Young Boys,1256,1,22,6,4,74,35,39,72
FC Basel,1256,2,16,9,7,49,26,23,57
St Gallen,1256,3,14,4,14,40,52,-12,46
Lucerne,1256,4,12,9,11,40,41,-1,45
FC Zürich,1256,5,11,11,10,44,35,9,44
Grasshoppers,1256,6,10,7,15,41,52,-11,37
FC Lugano,1256,7,10,6,16,31,48,-17,36
FC Thun,1256,8,9,7,16,46,59,-13,34
FC Sion,1256,9,7,7,18,38,55,-17,28
Young Boys,1257,1,22,7,3,71,35,36,73
FC Basel,1257,2,19,8,5,61,24,37,65
St Gallen,1257,3,15,2,15,46,55,-9,47
FC Zürich,1257,4,10,12,10,39,33,6,42
Lucerne,1257,5,11,8,13,40,51,-11,41
Grasshoppers,1257,6,11,6,15,44,47,-3,39
FC Lugano,1257,7,10,7,15,31,46,-15,37
FC Thun,1257,8,8,6,18,39,59,-20,30
FC Sion,1257,9,6,8,18,37,58,-21,26
Young Boys,1258,1,23,6,3,72,33,39,75
FC Basel,1258,2,18,8,6,57,25,32,62
St Gallen,1258,3,15,2,15,44,56,-12,47
Lucerne,1258,4,12,8,12,41,44,-3,44
FC Zürich,1258,5,11,9,12,41,37,4,42
FC Lugano,1258,6,11,5,16,34,50,-16,38
Grasshoppers,1258,7,10,6,16,43,49,-6,36
FC Thun,1258,8,10,5,17,45,61,-16,35
FC Sion,1258,9,6,7,19,36,58,-22,25
Young Boys,1259,1,24,6,2,75,32,43,78
FC Basel,1259,2,16,9,7,52,29,23,57
Lucerne,1259,3,14,8,10,43,40,3,50
St Gallen,1259,4,15,3,14,42,52,-10,48
FC Zürich,1259,5,11,9,12,41,38,3,42
FC Thun,1259,6,10,5,17,45,59,-14,35
Grasshoppers,1259,7,9,6,17,38,51,-13,33
FC Lugano,1259,8,9,5,18,28,48,-20,32
FC Sion,1259,9,7,7,18,39,54,-15,28
Young Boys,1260,1,20,9,3,67,33,34,69
FC Basel,1260,2,19,8,5,59,25,34,65
St Gallen,1260,3,15,2,15,48,58,-10,47
Lucerne,1260,4,13,7,12,42,47,-5,46
FC Zürich,1260,5,11,9,12,40,39,1,42
Grasshoppers,1260,6,10,7,15,44,47,-3,37
FC Thun,1260,7,10,6,16,43,55,-12,36
FC Lugano,1260,8,10,6,16,31,47,-16,36
FC Sion,1260,9,5,8,19,37,60,-23,23
Young Boys,1261,1,20,7,5,67,38,29,67
FC Basel,1261,2,19,7,6,56,23,33,64
Lucerne,1261,3,13,8,11,39,42,-3,47
St Gallen,1261,4,14,2,16,39,55,-16,44
FC Zürich,1261,5,10,10,12,40,40,0,40
Grasshoppers,1261,6,11,6,15,44,48,-4,39
FC Lugano,1261,7,11,5,16,34,46,-12,38
FC Sion,1261,8,9,8,15,49,51,-2,35
FC Thun,1261,9,8,5,19,44,69,-25,29
Young Boys,1262,1,23,6,3,73,35,38,75
FC Basel,1262,2,18,7,7,55,25,30,61
St Gallen,1262,3,15,2,15,42,51,-9,47
FC Zürich,1262,4,11,10,11,41,37,4,43
Lucerne,1262,5,12,7,13,41,46,-5,43
FC Lugano,1262,6,11,5,16,29,47,-18,38
FC Thun,1262,7,10,6,16,43,56,-13,36
Grasshoppers,1262,8,9,7,16,39,51,-12,34
FC Sion,1262,9,6,8,18,41,56,-15,26
Young Boys,1263,1,22,6,4,75,36,39,72
FC Basel,1263,2,18,8,6,53,24,29,62
St Gallen,1263,3,14,4,14,43,55,-12,46
Lucerne,1263,4,12,8,12,40,47,-7,44
FC Zürich,1263,5,10,12,10,40,35,5,42
FC Lugano,1263,6,11,6,15,34,47,-13,39
FC Thun,1263,7,10,6,16,45,57,-12,36
Grasshoppers,1263,8,9,6,17,40,53,-13,33
FC Sion,1263,9,6,8,18,42,58,-16,26
Young Boys,1264,1,21,6,5,69,35,34,69
FC Basel,1264,2,17,9,6,51,25,26,60
St Gallen,1264,3,15,2,15,44,55,-11,47
Lucerne,1264,4,13,7,12,45,46,-1,46
FC Zürich,1264,5,9,12,11,38,38,0,39
Grasshoppers,1264,6,11,6,15,48,53,-5,39
FC Lugano,1264,7,10,6,16,28,46,-18,36
FC Thun,1264,8,9,7,16,47,60,-13,34
FC Sion,1264,9,7,9,16,42,54,-12,30
Young Boys,1265,1,23,6,3,73,33,40,75
FC Basel,1265,2,18,8,6,53,27,26,62
Lucerne,1265,3,14,8,10,46,45,1,50
St Gallen,1265,4,14,3,15,44,58,-14,45
FC Zürich,1265,5,11,10,11,44,35,9,43
FC Lugano,1265,6,11,5,16,34,47,-13,38
FC Thun,1265,7,9,6,17,42,61,-19,33
Grasshoppers,1265,8,8,7,17,40,52,-12,31
FC Sion,1265,9,5,9,18,36,54,-18,24
Young Boys,1266,1,24,6,2,76,30,46,78
FC Basel,1266,2,17,9,6,56,26,30,60
St Gallen,1266,3,15,2,15,41,53,-12,47
FC Zürich,1266,4,12,10,10,45,34,11,46
Lucerne,1266,5,11,8,13,39,47,-8,41
FC Lugano,1266,6,11,5,16,31,49,-18,38
Grasshoppers,1266,7,10,6,16,43,50,-7,36
FC Thun,1266,8,10,5,17,44,66,-22,35
FC Sion,1266,9,5,7,20,36,56,-20,22
Young Boys,1267,1,22,6,4,76,37,39,72
FC Basel,1267,2,16,9,7,52,28,24,57
Lucerne,1267,3,14,8,10,46,46,0,50
St Gallen,1267,4,14,2,16,42,55,-13,44
FC Zürich,1267,5,10,11,11,41,38,3,41
FC Lugano,1267,6,11,5,16,32,49,-17,38
Grasshoppers,1267,7,10,7,15,43,51,-8,37
FC Thun,1267,8,10,6,16,46,58,-12,36
FC Sion,1267,9,6,8,18,41,57,-16,26
Young Boys,1268,1,22,8,2,70,31,39,74
FC Basel,1268,2,16,10,6,53,28,25,58
St Gallen,1268,3,14,3,15,43,55,-12,45
Lucerne,1268,4,11,9,12,38,43,-5,42
FC Zürich,1268,5,10,10,12,42,40,2,40
FC Lugano,1268,6,11,6,15,31,46,-15,39
Grasshoppers,1268,7,9,9,14,42,49,-7,36
FC Thun,1268,8,9,6,17,44,60,-16,33
FC Sion,1268,9,7,9,16,39,50,-11,30
Young Boys,1269,1,23,7,2,77,30,47,76
FC Basel,1269,2,17,8,7,52,27,25,59
Lucerne,1269,3,13,8,11,38,42,-4,47
St Gallen,1269,4,14,3,15,41,56,-15,45
FC Zürich,1269,5,11,10,11,43,35,8,43
FC Lugano,1269,6,11,5,16,31,50,-19,38
Grasshoppers,1269,7,9,6,17,40,49,-9,33
FC Sion,1269,8,7,9,16,42,51,-9,30
FC Thun,1269,9,8,6,18,40,64,-24,30
Young Boys,1270,1,21,9,2,69,32,37,72
FC Basel,1270,2,17,10,5,59,24,35,61
Lucerne,1270,3,13,9,10,45,48,-3,48
St Gallen,1270,4,14,3,15,44,59,-15,45
FC Zürich,1270,5,10,10,12,43,35,8,40
FC Thun,1270,6,10,6,16,43,59,-16,36
FC Lugano,1270,7,10,6,16,32,51,-19,36
Grasshoppers,1270,8,9,8,15,44,50,-6,35
FC Sion,1270,9,5,9,18,38,59,-21,24
Young Boys,1271,1,22,8,2,74,34,40,74
FC Basel,1271,2,18,8,6,60,29,31,62
Lucerne,1271,3,13,7,12,41,47,-6,46
FC Zürich,1271,4,12,9,11,45,36,9,45
St Gallen,1271,5,14,3,15,44,57,-13,45
Grasshoppers,1271,6,10,7,15,42,49,-7,37
FC Lugano,1271,7,9,6,17,31,51,-20,33
FC Thun,1271,8,8,6,18,41,62,-21,30
FC Sion,1271,9,7,8,17,38,51,-13,29
Young Boys,1272,1,23,6,3,78,36,42,75
FC Basel,1272,2,17,8,7,55,32,23,59
Lucerne,1272,3,13,9,10,44,45,-1,48
St Gallen,1272,4,14,3,15,43,55,-12,45
FC Zürich,1272,5,10,10,12,40,40,0,40
FC Thun,1272,6,10,6,16,43,57,-14,36
FC Lugano,1272,7,10,6,16,33,47,-14,36
Grasshoppers,1272,8,9,7,16,43,52,-9,34
FC Sion,1272,9,7,7,18,40,55,-15,28
Young Boys,1273,1,21,6,5,72,38,34,69
FC Basel,1273,2,19,7,6,57,25,32,64
Lucerne,1273,3,13,8,11,43,44,-1,47
FC Zürich,1273,4,12,9,11,42,36,6,45
St Gallen,1273,5,14,2,16,42,58,-16,44
FC Lugano,1273,6,11,5,16,30,48,-18,38
FC Thun,1273,7,10,5,17,47,61,-14,35
Grasshoppers,1273,8,9,7,16,40,51,-11,34
FC Sion,1273,9,7,7,18,41,53,-12,28
Young Boys,1274,1,21,8,3,68,32,36,71
FC Basel,1274,2,18,9,5,52,21,31,63
Lucerne,1274,3,14,8,10,43,43,0,50
St Gallen,1274,4,13,2,17,40,57,-17,41
FC Zürich,1274,5,10,10,12,42,40,2,40
FC Lugano,1274,6,11,5,16,33,46,-13,38
FC Sion,1274,7,8,9,15,44,53,-9,33
FC Thun,1274,8,8,8,16,43,61,-18,32
Grasshoppers,1274,9,8,7,17,40,52,-12,31
Young Boys,1275,1,20,8,4,69,39,30,68
FC Basel,1275,2,19,8,5,56,23,33,65
Lucerne,1275,3,15,7,10,47,41,6,52
FC Zürich,1275,4,11,11,10,43,35,8,44
St Gallen,1275,5,13,4,15,40,54,-14,43
FC Thun,1275,6,9,6,17,43,61,-18,33
FC Lugano,1275,7,9,6,17,30,51,-21,33
Grasshoppers,1275,8,8,7,17,41,52,-11,31
FC Sion,1275,9,7,9,16,39,52,-13,30
Young Boys,1276,1,22,6,4,78,36,42,72
FC Basel,1276,2,17,9,6,54,26,28,60
Lucerne,1276,3,13,8,11,43,44,-1,47
St Gallen,1276,4,14,5,13,46,56,-10,47
FC Zürich,1276,5,10,9,13,39,40,-1,39
FC Thun,1276,6,11,5,16,45,58,-13,38
Grasshoppers,1276,7,10,6,16,43,50,-7,36
FC Lugano,1276,8,10,6,16,33,51,-18,36
FC Sion,1276,9,6,8,18,41,61,-20,26
Young Boys,1277,1,22,7,3,72,34,38,73
FC Basel,1277,2,18,9,5,55,25,30,63
Lucerne,1277,3,12,8,12,41,45,-4,44
St Gallen,1277,4,14,2,16,41,56,-15,44
FC Zürich,1277,5,9,12,11,38,36,2,39
Grasshoppers,1277,6,11,6,15,43,48,-5,39
FC Lugano,1277,7,10,7,15,33,47,-14,37
FC Thun,1277,8,8,7,17,41,59,-18,31
FC Sion,1277,9,7,8,17,39,53,-14,29
Young Boys,1278,1,22,6,4,74,37,37,72
FC Basel,1278,2,18,8,6,57,23,34,62
Lucerne,1278,3,13,8,11,41,45,-4,47
St Gallen,1278,4,14,4,14,40,51,-11,46
FC Zürich,1278,5,11,9,12,39,37,2,42
FC Lugano,1278,6,11,5,16,30,48,-18,38
FC Thun,1278,7,10,6,16,44,59,-15,36
Grasshoppers,1278,8,9,6,17,39,50,-11,33
FC Sion,1278,9,6,8,18,39,53,-14,26
Young Boys,1279,1,20,8,4,67,34,33,68
FC Basel,1279,2,19,8,5,53,22,31,65
Lucerne,1279,3,13,7,12,46,44,2,46
St Gallen,1279,4,14,2,16,44,56,-12,44
FC Zürich,1279,5,11,9,12,40,35,5,42
FC Lugano,1279,6,11,6,15,32,49,-17,39
Grasshoppers,1279,7,10,7,15,42,49,-7,37
FC Thun,1279,8,9,6,17,42,61,-19,33
FC Sion,1279,9,6,9,17,36,52,-16,27
Young Boys,1280,1,22,7,3,71,35,36,73
FC Basel,1280,2,17,9,6,54,29,25,60
St Gallen,1280,3,15,2,15,45,54,-9,47
Lucerne,1280,4,12,10,10,42,43,-1,46
FC Zürich,1280,5,11,10,11,45,39,6,43
FC Thun,1280,6,10,6,16,43,55,-12,36
FC Lugano,1280,7,10,6,16,33,51,-18,36
Grasshoppers,1280,8,8,7,17,39,50,-11,31
FC Sion,1280,9,6,9,17,39,55,-16,27
Young Boys,1281,1,21,7,4,69,36,33,70
FC Basel,1281,2,18,8,6,58,27,31,62
Lucerne,1281,3,13,8,11,42,43,-1,47
St Gallen,1281,4,14,4,14,42,54,-12,46
FC Zürich,1281,5,11,10,11,40,35,5,43
Grasshoppers,1281,6,10,7,15,41,49,-8,37
FC Lugano,1281,7,10,6,16,32,48,-16,36
FC Thun,1281,8,8,8,16,40,58,-18,32
FC Sion,1281,9,6,8,18,39,53,-14,26
Young Boys,1282,1,21,7,4,67,33,34,70
FC Basel,1282,2,17,9,6,51,24,27,60
St Gallen,1282,3,15,3,14,44,54,-10,48
Lucerne,1282,4,12,8,12,39,46,-7,44
FC Zürich,1282,5,11,9,12,44,39,5,42
Grasshoppers,1282,6,12,6,14,46,46,0,42
FC Lugano,1282,7,10,5,17,32,49,-17,35
FC Sion,1282,8,7,9,16,40,53,-13,30
FC Thun,1282,9,8,6,18,43,62,-19,30
Young Boys,1283,1,22,6,4,72,39,33,72
FC Basel,1283,2,18,7,7,54,25,29,61
St Gallen,1283,3,15,3,14,41,51,-10,48
Lucerne,1283,4,13,8,11,38,39,-1,47
FC Zürich,1283,5,11,10,11,41,37,4,43
FC Lugano,1283,6,10,6,16,32,47,-15,36
Grasshoppers,1283,7,9,6,17,41,53,-12,33
FC Thun,1283,8,9,6,17,43,58,-15,33
FC Sion,1283,9,7,8,17,43,56,-13,29
Young Boys,1284,1,22,6,4,73,36,37,72
FC Basel,1284,2,19,7,6,54,24,30,64
St Gallen,1284,3,15,2,15,44,52,-8,47
FC Zürich,1284,4,12,10,10,44,36,8,46
Lucerne,1284,5,12,8,12,41,49,-8,44
Grasshoppers,1284,6,10,7,15,41,49,-8,37
FC Thun,1284,7,9,5,18,43,60,-17,32
FC Lugano,1284,8,9,5,18,29,52,-23,32
FC Sion,1284,9,7,8,17,39,50,-11,29
FC Basel,1285,1,20,7,5,64,26,38,67
Young Boys,1285,2,20,7,5,67,35,32,67
St Gallen,1285,3,15,3,14,45,55,-10,48
Lucerne,1285,4,13,7,12,44,48,-4,46
FC Zürich,1285,5,10,10,12,38,36,2,40
FC Lugano,1285,6,10,7,15,30,48,-18,37
FC Thun,1285,7,9,7,16,45,61,-16,34
Grasshoppers,1285,8,8,9,15,38,47,-9,33
FC Sion,1285,9,6,9,17,40,55,-15,27
Young Boys,1286,1,20,9,3,70,34,36,69
FC Basel,1286,2,20,7,5,58,24,34,67
St Gallen,1286,3,15,2,15,43,53,-10,47
FC Zürich,1286,4,11,10,11,39,35,4,43
Lucerne,1286,5,11,9,12,42,48,-6,42
Grasshoppers,1286,6,10,8,14,43,45,-2,38
FC Lugano,1286,7,10,6,16,31,49,-18,36
FC Thun,1286,8,8,6,18,40,61,-21,30
FC Sion,1286,9,6,9,17,39,56,-17,27
Young Boys,1287,1,22,7,3,72,32,40,73
FC Basel,1287,2,17,9,6,51,25,26,60
St Gallen,1287,3,15,3,14,41,51,-10,48
Lucerne,1287,4,12,10,10,45,42,3,46
FC Zürich,1287,5,10,10,12,44,38,6,40
FC Thun,1287,6,10,6,16,47,58,-11,36
FC Lugano,1287,7,9,7,16,31,52,-21,34
Grasshoppers,1287,8,8,7,17,38,53,-15,31
FC Sion,1287,9,8,7,17,38,56,-18,31
Young Boys,1288,1,21,7,4,72,35,37,70
FC Basel,1288,2,19,7,6,57,28,29,64
St Gallen,1288,3,15,3,14,44,55,-11,48
Lucerne,1288,4,13,7,12,44,45,-1,46
FC Zürich,1288,5,11,10,11,44,35,9,43
FC Thun,1288,6,11,5,16,46,58,-12,38
Grasshoppers,1288,7,8,8,16,39,51,-12,32
FC Lugano,1288,8,9,5,18,29,54,-25,32
FC Sion,1288,9,6,10,16,40,54,-14,28
Young Boys,1289,1,21,7,4,76,39,37,70
FC Basel,1289,2,18,8,6,54,28,26,62
Lucerne,1289,3,13,8,11,41,43,-2,47
FC Zürich,1289,4,11,11,10,41,34,7,44
St Gallen,1289,5,13,3,16,40,55,-15,42
Grasshoppers,1289,6,11,6,15,43,50,-7,39
FC Lugano,1289,7,9,9,14,33,48,-15,36
FC Thun,1289,8,9,5,18,41,58,-17,32
FC Sion,1289,9,7,7,18,39,53,-14,28
Young Boys,1290,1,20,6,6,67,38,29,66
FC Basel,1290,2,16,9,7,52,25,27,57
Lucerne,1290,3,13,8,11,43,43,0,47
St Gallen,1290,4,14,3,15,41,56,-15,45
FC Lugano,1290,5,13,5,14,35,45,-10,44
FC Zürich,1290,6,11,10,11,41,35,6,43
Grasshoppers,1290,7,9,7,16,39,48,-9,34
FC Thun,1290,8,9,7,16,45,61,-16,34
FC Sion,1290,9,6,11,15,41,53,-12,29
Young Boys,1291,1,22,6,4,78,36,42,72
FC Basel,1291,2,17,8,7,54,26,28,59
Lucerne,1291,3,14,7,11,42,43,-1,49
FC Zürich,1291,4,11,11,10,41,33,8,44
St Gallen,1291,5,13,3,16,41,57,-16,42
Grasshoppers,1291,6,10,6,16,46,55,-9,36
FC Lugano,1291,7,10,5,17,30,50,-20,35
FC Thun,1291,8,9,6,17,44,63,-19,33
FC Sion,1291,9,8,8,16,41,54,-13,32
Young Boys,1292,1,20,6,6,69,38,31,66
FC Basel,1292,2,18,8,6,55,24,31,62
Lucerne,1292,3,15,8,9,44,40,4,53
St Gallen,1292,4,13,3,16,41,57,-16,42
FC Zürich,1292,5,9,11,12,38,36,2,38
FC Lugano,1292,6,11,5,16,32,48,-16,38
FC Thun,1292,7,10,6,16,43,60,-17,36
Grasshoppers,1292,8,9,7,16,41,50,-9,34
FC Sion,1292,9,8,8,16,41,51,-10,32
Young Boys,1293,1,21,7,4,71,34,37,70
FC Basel,1293,2,17,9,6,53,26,27,60
Lucerne,1293,3,14,9,9,42,38,4,51
St Gallen,1293,4,14,3,15,42,57,-15,45
FC Zürich,1293,5,10,10,12,42,39,3,40
FC Lugano,1293,6,11,6,15,32,47,-15,39
FC Thun,1293,7,10,6,16,48,61,-13,36
Grasshoppers,1293,8,8,8,16,42,54,-12,32
FC Sion,1293,9,5,10,17,41,57,-16,25
Young Boys,1294,1,21,7,4,75,35,40,70
FC Basel,1294,2,17,10,5,54,27,27,61
Lucerne,1294,3,12,9,11,41,48,-7,45
St Gallen,1294,4,13,3,16,41,55,-14,42
FC Zürich,1294,5,10,10,12,40,37,3,40
Grasshoppers,1294,6,10,7,15,44,50,-6,37
FC Thun,1294,7,10,6,16,48,62,-14,36
FC Lugano,1294,8,10,5,17,30,49,-19,35
FC Sion,1294,9,9,7,16,42,52,-10,34
Young Boys,1295,1,22,8,2,80,36,44,74
FC Basel,1295,2,15,10,7,51,29,22,55
Lucerne,1295,3,14,7,11,45,44,1,49
St Gallen,1295,4,14,4,14,42,54,-12,46
FC Zürich,1295,5,10,11,11,42,38,4,41
FC Thun,1295,6,10,6,16,46,60,-14,36
Grasshoppers,1295,7,9,7,16,42,53,-11,34
FC Lugano,1295,8,9,6,17,29,52,-23,33
FC Sion,1295,9,8,7,17,44,55,-11,31
Young Boys,1296,1,21,8,3,70,35,35,71
FC Basel,1296,2,18,7,7,53,25,28,61
St Gallen,1296,3,14,2,16,43,55,-12,44
FC Zürich,1296,4,11,9,12,40,39,1,42
Lucerne,1296,5,11,9,12,39,46,-7,42
FC Lugano,1296,6,11,7,14,33,43,-10,40
Grasshoppers,1296,7,11,6,15,44,50,-6,39
FC Thun,1296,8,9,6,17,41,59,-18,33
FC Sion,1296,9,7,8,17,43,54,-11,29
Young Boys,1297,1,22,8,2,78,37,41,74
FC Basel,1297,2,17,8,7,55,30,25,59
Lucerne,1297,3,15,7,10,46,40,6,52
St Gallen,1297,4,15,2,15,43,56,-13,47
FC Zürich,1297,5,11,10,11,39,33,6,43
FC Lugano,1297,6,10,5,17,30,51,-21,35
Grasshoppers,1297,7,8,8,16,38,51,-13,32
FC Thun,1297,8,9,5,18,43,59,-16,32
FC Sion,1297,9,6,9,17,38,53,-15,27
Young Boys,1298,1,24,6,2,79,34,45,78
FC Basel,1298,2,17,9,6,60,24,36,60
St Gallen,1298,3,15,3,14,43,54,-11,48
Lucerne,1298,4,12,8,12,42,50,-8,44
FC Zürich,1298,5,11,10,11,41,37,4,43
FC Lugano,1298,6,11,6,15,34,47,-13,39
Grasshoppers,1298,7,9,6,17,44,55,-11,33
FC Thun,1298,8,9,5,18,40,65,-25,32
FC Sion,1298,9,6,7,19,40,57,-17,25
Young Boys,1299,1,22,7,3,70,33,37,73
FC Basel,1299,2,17,8,7,51,25,26,59
St Gallen,1299,3,16,2,14,45,51,-6,50
Lucerne,1299,4,12,7,13,40,46,-6,43
FC Zürich,1299,5,10,10,12,39,36,3,40
Grasshoppers,1299,6,10,8,14,43,46,-3,38
FC Lugano,1299,7,11,5,16,32,50,-18,38
FC Thun,1299,8,9,7,16,44,57,-13,34
FC Sion,1299,9,6,8,18,39,59,-20,26
Young Boys,1300,1,20,7,5,70,35,35,67
FC Basel,1300,2,18,9,5,55,21,34,63
Lucerne,1300,3,13,7,12,43,51,-8,46
FC Zürich,1300,4,11,11,10,43,36,7,44
St Gallen,1300,5,13,2,17,38,59,-21,41
FC Lugano,1300,6,11,6,15,35,48,-13,39
FC Thun,1300,7,10,7,15,45,55,-10,37
Grasshoppers,1300,8,10,6,16,43,52,-9,36
FC Sion,1300,9,7,7,18,40,55,-15,28
Young Boys,1301,1,22,6,4,73,37,36,72
FC Basel,1301,2,18,8,6,55,27,28,62
Lucerne,1301,3,13,9,10,42,41,1,48
St Gallen,1301,4,14,3,15,41,54,-13,45
FC Zürich,1301,5,11,9,12,42,39,3,42
FC Thun,1301,6,11,5,16,44,57,-13,38
FC Lugano,1301,7,10,5,17,33,48,-15,35
Grasshoppers,1301,8,9,7,16,41,50,-9,34
FC Sion,1301,9,6,8,18,38,56,-18,26
Young Boys,1302,1,22,7,3,74,37,37,73
FC Basel,1302,2,20,7,5,57,23,34,67
Lucerne,1302,3,13,8,11,43,42,1,47
St Gallen,1302,4,13,3,16,39,55,-16,42
FC Zürich,1302,5,10,11,11,39,34,5,41
FC Lugano,1302,6,10,6,16,28,47,-19,36
FC Thun,1302,7,9,6,17,42,59,-17,33
Grasshoppers,1302,8,8,8,16,41,52,-11,32
FC Sion,1302,9,7,8,17,42,56,-14,29
Young Boys,1303,1,20,7,5,71,41,30,67
FC Basel,1303,2,19,8,5,55,24,31,65
Lucerne,1303,3,14,7,11,42,41,1,49
FC Zürich,1303,4,12,10,10,43,33,10,46
St Gallen,1303,5,13,3,16,41,55,-14,42
Grasshoppers,1303,6,10,6,16,41,49,-8,36
FC Lugano,1303,7,9,7,16,31,51,-20,34
FC Thun,1303,8,9,6,17,40,58,-18,33
FC Sion,1303,9,7,8,17,42,54,-12,29
Young Boys,1304,1,21,7,4,71,36,35,70
FC Basel,1304,2,16,9,7,49,24,25,57
Lucerne,1304,3,14,8,10,42,41,1,50
St Gallen,1304,4,13,4,15,42,57,-15,43
FC Thun,1304,5,12,5,15,44,54,-10,41
FC Zürich,1304,6,10,10,12,43,39,4,40
Grasshoppers,1304,7,10,6,16,44,49,-5,36
FC Lugano,1304,8,10,6,16,35,53,-18,36
FC Sion,1304,9,7,7,18,43,60,-17,28
Young Boys,1305,1,21,7,4,71,35,36,70
FC Basel,1305,2,19,8,5,58,26,32,65
St Gallen,1305,3,14,5,13,44,54,-10,47
FC Zürich,1305,4,12,9,11,42,35,7,45
Lucerne,1305,5,12,8,12,43,54,-11,44
FC Lugano,1305,6,11,5,16,35,46,-11,38
FC Thun,1305,7,9,5,18,40,61,-21,32
Grasshoppers,1305,8,8,7,17,39,51,-12,31
FC Sion,1305,9,6,10,16,42,52,-10,28
Young Boys,1306,1,22,7,3,73,35,38,73
FC Basel,1306,2,18,9,5,56,28,28,63
Lucerne,1306,3,12,9,11,41,43,-2,45
FC Zürich,1306,4,11,10,11,42,36,6,43
St Gallen,1306,5,13,4,15,39,53,-14,43
FC Lugano,1306,6,11,6,15,33,46,-13,39
FC Thun,1306,7,10,6,16,45,58,-13,36
Grasshoppers,1306,8,9,7,16,40,50,-10,34
FC Sion,1306,9,5,8,19,37,57,-20,23
Young Boys,1307,1,22,7,3,70,34,36,73
FC Basel,1307,2,18,9,5,52,24,28,63
Lucerne,1307,3,13,7,12,41,43,-2,46
St Gallen,1307,4,14,4,14,43,54,-11,46
FC Zürich,1307,5,11,10,11,42,37,5,43
Grasshoppers,1307,6,10,6,16,41,47,-6,36
FC Thun,1307,7,10,5,17,47,60,-13,35
FC Lugano,1307,8,9,7,16,30,47,-17,34
FC Sion,1307,9,6,7,19,37,57,-20,25
Young Boys,1308,1,23,6,3,74,33,41,75
FC Basel,1308,2,17,9,6,53,25,28,60
Lucerne,1308,3,13,8,11,44,45,-1,47
St Gallen,1308,4,14,4,14,43,55,-12,46
FC Lugano,1308,5,11,5,16,32,48,-16,38
FC Zürich,1308,6,9,10,13,39,39,0,37
FC Thun,1308,7,10,5,17,42,58,-16,35
Grasshoppers,1308,8,9,6,17,39,51,-12,33
FC Sion,1308,9,8,7,17,41,53,-12,31
Young Boys,1309,1,21,7,4,72,37,35,70
FC Basel,1309,2,18,8,6,55,25,30,62
Lucerne,1309,3,13,8,11,46,46,0,47
St Gallen,1309,4,14,5,13,47,57,-10,47
FC Zürich,1309,5,12,9,11,42,35,7,45
Grasshoppers,1309,6,9,8,15,42,49,-7,35
FC Lugano,1309,7,10,5,17,33,54,-21,35
FC Thun,1309,8,8,6,18,39,60,-21,30
FC Sion,1309,9,6,10,16,40,53,-13,28
Young Boys,1310,1,23,7,2,69,30,39,76
FC Basel,1310,2,18,8,6,56,26,30,62
St Gallen,1310,3,15,3,14,49,57,-8,48
Lucerne,1310,4,12,9,11,43,47,-4,45
FC Zürich,1310,5,10,11,11,41,38,3,41
FC Lugano,1310,6,10,7,15,30,45,-15,37
Grasshoppers,1310,7,9,6,17,38,48,-10,33
FC Thun,1310,8,8,6,18,43,62,-19,30
FC Sion,1310,9,7,7,18,39,55,-16,28
Young Boys,1311,1,19,11,2,70,36,34,68
FC Basel,1311,2,18,8,6,55,26,29,62
Lucerne,1311,3,13,9,10,42,43,-1,48
FC Zürich,1311,4,12,9,11,44,37,7,45
St Gallen,1311,5,13,3,16,39,57,-18,42
FC Lugano,1311,6,9,8,15,30,46,-16,35
Grasshoppers,1311,7,8,9,15,40,49,-9,33
FC Thun,1311,8,9,6,17,44,58,-14,33
FC Sion,1311,9,7,9,16,43,55,-12,30
Young Boys,1312,1,22,7,3,70,33,37,73
FC Basel,1312,2,17,9,6,53,26,27,60
St Gallen,1312,3,14,4,14,44,55,-11,46
Lucerne,1312,4,11,9,12,40,49,-9,42
Grasshoppers,1312,5,11,7,14,44,48,-4,40
FC Lugano,1312,6,10,8,14,30,43,-13,38
FC Zürich,1312,7,9,10,13,39,38,1,37
FC Thun,1312,8,10,5,17,48,60,-12,35
FC Sion,1312,9,7,7,18,39,55,-16,28
Young Boys,1313,1,21,7,4,71,35,36,70
FC Basel,1313,2,17,10,5,50,23,27,61
St Gallen,1313,3,14,3,15,44,59,-15,45
Lucerne,1313,4,12,7,13,38,47,-9,43
FC Zürich,1313,5,10,12,10,42,37,5,42
Grasshoppers,1313,6,11,6,15,45,49,-4,39
FC Lugano,1313,7,11,5,16,35,49,-14,38
FC Thun,1313,8,9,6,17,45,61,-16,33
FC Sion,1313,9,7,8,17,46,56,-10,29
Young Boys,1314,1,21,6,5,73,41,32,69
FC Basel,1314,2,16,9,7,51,26,25,57
Lucerne,1314,3,12,10,10,45,45,0,46
St Gallen,1314,4,14,3,15,43,57,-14,45
FC Zürich,1314,5,10,11,11,41,38,3,41
FC Lugano,1314,6,11,7,14,33,45,-12,40
Grasshoppers,1314,7,10,7,15,47,52,-5,37
FC Thun,1314,8,10,6,16,44,58,-14,36
FC Sion,1314,9,7,7,18,42,57,-15,28
Young Boys,1315,1,20,9,3,70,35,35,69
FC Basel,1315,2,17,10,5,56,28,28,61
Lucerne,1315,3,13,9,10,44,43,1,48
St Gallen,1315,4,14,3,15,44,56,-12,45
Grasshoppers,1315,5,10,8,14,42,46,-4,38
FC Lugano,1315,6,11,5,16,34,50,-16,38
FC Zürich,1315,7,9,10,13,38,38,0,37
FC Thun,1315,8,10,6,16,44,56,-12,36
FC Sion,1315,9,6,8,18,36,56,-20,26
Young Boys,1316,1,21,7,4,69,35,34,70
FC Basel,1316,2,19,8,5,60,23,37,65
Lucerne,1316,3,12,8,12,42,50,-8,44
Grasshoppers,1316,4,12,6,14,44,47,-3,42
St Gallen,1316,5,13,3,16,42,60,-18,42
FC Zürich,1316,6,10,10,12,38,35,3,40
FC Lugano,1316,7,11,5,16,32,47,-15,38
FC Sion,1316,8,7,9,16,41,51,-10,30
FC Thun,1316,9,8,6,18,39,59,-20,30
Young Boys,1317,1,23,7,2,75,34,41,76
FC Basel,1317,2,15,9,8,49,32,17,54
St Gallen,1317,3,15,3,14,46,53,-7,48
Lucerne,1317,4,13,7,12,46,47,-1,46
FC Zürich,1317,5,11,10,11,45,38,7,43
FC Lugano,1317,6,10,7,15,35,52,-17,37
FC Thun,1317,7,10,6,16,48,61,-13,36
Grasshoppers,1317,8,9,6,17,42,51,-9,33
FC Sion,1317,9,7,7,18,38,56,-18,28
Young Boys,1318,1,21,8,3,72,35,37,71
FC Basel,1318,2,17,9,6,52,25,27,60
Lucerne,1318,3,13,8,11,41,42,-1,47
St Gallen,1318,4,14,3,15,43,53,-10,45
FC Zürich,1318,5,10,11,11,41,38,3,41
FC Lugano,1318,6,11,5,16,32,50,-18,38
FC Thun,1318,7,10,5,17,44,58,-14,35
Grasshoppers,1318,8,9,7,16,40,49,-9,34
FC Sion,1318,9,6,10,16,38,53,-15,28
Young Boys,1319,1,21,7,4,67,33,34,70
FC Basel,1319,2,17,9,6,53,25,28,60
St Gallen,1319,3,15,3,14,45,54,-9,48
Lucerne,1319,4,13,7,12,39,41,-2,46
Grasshoppers,1319,5,12,6,14,43,45,-2,42
FC Zürich,1319,6,10,9,13,40,37,3,39
FC Lugano,1319,7,10,5,17,29,51,-22,35
FC Thun,1319,8,9,6,17,40,58,-18,33
FC Sion,1319,9,7,8,17,39,51,-12,29
Young Boys,1320,1,23,7,2,75,34,41,76
FC Basel,1320,2,17,8,7,50,26,24,59
St Gallen,1320,3,16,2,14,42,54,-12,50
FC Zürich,1320,4,11,11,10,42,33,9,44
Lucerne,1320,5,12,7,13,39,46,-7,43
Grasshoppers,1320,6,10,7,15,42,48,-6,37
FC Lugano,1320,7,9,6,17,30,48,-18,33
FC Thun,1320,8,8,6,18,41,60,-19,30
FC Sion,1320,9,6,10,16,43,55,-12,28
Young Boys,1321,1,23,6,3,74,32,42,75
FC Basel,1321,2,18,8,6,57,26,31,62
St Gallen,1321,3,15,3,14,46,55,-9,48
FC Zürich,1321,4,11,9,12,43,36,7,42
Lucerne,1321,5,11,9,12,39,50,-11,42
FC Thun,1321,6,11,5,16,47,59,-12,38
FC Lugano,1321,7,9,6,17,28,48,-20,33
Grasshoppers,1321,8,8,7,17,37,49,-12,31
FC Sion,1321,9,8,7,17,40,56,-16,31
Young Boys,1322,1,20,6,6,67,37,30,66
FC Basel,1322,2,17,9,6,51,25,26,60
Lucerne,1322,3,13,9,10,44,42,2,48
St Gallen,1322,4,15,3,14,45,55,-10,48
FC Zürich,1322,5,11,9,12,44,39,5,42
FC Thun,1322,6,11,6,15,44,54,-10,39
Grasshoppers,1322,7,10,6,16,40,47,-7,36
FC Lugano,1322,8,10,5,17,33,52,-19,35
FC Sion,1322,9,7,7,18,39,56,-17,28
Young Boys,1323,1,21,9,2,67,31,36,72
FC Basel,1323,2,17,10,5,53,24,29,61
FC Zürich,1323,3,12,10,10,47,38,9,46
Lucerne,1323,4,12,10,10,42,44,-2,46
St Gallen,1323,5,13,2,17,40,60,-20,41
FC Lugano,1323,6,11,5,16,34,46,-12,38
Grasshoppers,1323,7,9,8,15,40,48,-8,35
FC Thun,1323,8,9,6,17,47,60,-13,33
FC Sion,1323,9,6,8,18,38,57,-19,26
Young Boys,1324,1,22,7,3,73,36,37,73
FC Basel,1324,2,17,8,7,54,25,29,59
St Gallen,1324,3,16,3,13,47,54,-7,51
FC Zürich,1324,4,11,9,12,42,39,3,42
Lucerne,1324,5,11,8,13,41,50,-9,41
FC Thun,1324,6,11,6,15,50,57,-7,39
FC Lugano,1324,7,10,7,15,34,50,-16,37
Grasshoppers,1324,8,9,6,17,39,50,-11,33
FC Sion,1324,9,6,8,18,38,57,-19,26
Young Boys,1325,1,21,6,5,72,41,31,69
FC Basel,1325,2,18,9,5,59,25,34,63
Lucerne,1325,3,13,9,10,44,44,0,48
St Gallen,1325,4,14,3,15,42,55,-13,45
FC Zürich,1325,5,9,13,10,42,38,4,40
Grasshoppers,1325,6,11,6,15,42,47,-5,39
FC Lugano,1325,7,11,6,15,32,47,-15,39
FC Thun,1325,8,8,6,18,41,62,-21,30
FC Sion,1325,9,6,8,18,38,53,-15,26
Young Boys,1326,1,21,6,5,70,35,35,69
FC Basel,1326,2,18,8,6,51,25,26,62
Lucerne,1326,3,14,7,11,41,41,0,49
St Gallen,1326,4,15,3,14,44,53,-9,48
FC Zürich,1326,5,10,11,11,41,37,4,41
Grasshoppers,1326,6,10,8,14,43,49,-6,38
FC Lugano,1326,7,9,7,16,30,49,-19,34
FC Thun,1326,8,8,8,16,44,61,-17,32
FC Sion,1326,9,6,8,18,42,56,-14,26
Young Boys,1327,1,19,9,4,65,35,30,66
FC Basel,1327,2,19,8,5,56,23,33,65
St Gallen,1327,3,15,4,13,48,52,-4,49
Lucerne,1327,4,13,8,11,40,41,-1,47
FC Thun,1327,5,11,5,16,46,56,-10,38
FC Zürich,1327,6,9,10,13,37,39,-2,37
Grasshoppers,1327,7,10,6,16,40,48,-8,36
FC Lugano,1327,8,9,8,15,30,47,-17,35
FC Sion,1327,9,6,8,18,37,58,-21,26
Young Boys,1328,1,21,8,3,68,32,36,71
FC Basel,1328,2,19,7,6,60,27,33,64
St Gallen,1328,3,14,4,14,44,54,-10,46
Lucerne,1328,4,12,8,12,40,47,-7,44
FC Zürich,1328,5,11,9,12,42,37,5,42
Grasshoppers,1328,6,10,7,15,39,46,-7,37
FC Lugano,1328,7,10,6,16,31,48,-17,36
FC Thun,1328,8,9,6,17,44,62,-18,33
FC Sion,1328,9,6,9,17,39,54,-15,27
Young Boys,1329,1,23,6,3,71,32,39,75
FC Basel,1329,2,18,8,6,57,29,28,62
Lucerne,1329,3,13,7,12,44,49,-5,46
St Gallen,1329,4,14,3,15,43,57,-14,45
FC Zürich,1329,5,10,11,11,43,37,6,41
Grasshoppers,1329,6,10,6,16,44,50,-6,36
FC Lugano,1329,7,10,6,16,32,47,-15,36
FC Thun,1329,8,9,7,16,45,59,-14,34
FC Sion,1329,9,6,8,18,41,60,-19,26
Young Boys,1330,1,21,6,5,74,40,34,69
FC Basel,1330,2,19,7,6,57,27,30,64
St Gallen,1330,3,16,2,14,44,53,-9,50
Lucerne,1330,4,12,7,13,40,50,-10,43
Grasshoppers,1330,5,12,6,14,46,46,0,42
FC Zürich,1330,6,10,10,12,44,37,7,40
FC Lugano,1330,7,11,5,16,31,46,-15,38
FC Thun,1330,8,8,7,17,43,61,-18,31
FC Sion,1330,9,6,8,18,41,60,-19,26
Young Boys,1331,1,21,7,4,71,36,35,70
FC Basel,1331,2,16,10,6,49,27,22,58
Lucerne,1331,3,13,10,9,44,40,4,49
St Gallen,1331,4,13,4,15,43,57,-14,43
FC Zürich,1331,5,10,10,12,38,35,3,40
FC Lugano,1331,6,11,6,15,31,46,-15,39
FC Thun,1331,7,10,7,15,45,54,-9,37
FC Sion,1331,8,8,7,17,44,54,-10,31
Grasshoppers,1331,9,8,7,17,37,53,-16,31
Young Boys,1332,1,22,8,2,74,33,41,74
FC Basel,1332,2,18,8,6,54,26,28,62
St Gallen,1332,3,15,3,14,48,57,-9,48
Lucerne,1332,4,12,9,11,40,43,-3,45
FC Zürich,1332,5,11,10,11,43,38,5,43
Grasshoppers,1332,6,9,8,15,43,50,-7,35
FC Lugano,1332,7,10,5,17,34,55,-21,35
FC Thun,1332,8,8,7,17,43,60,-17,31
FC Sion,1332,9,6,8,18,40,57,-17,26
Young Boys,1333,1,21,9,2,72,33,39,72
FC Basel,1333,2,17,10,5,54,23,31,61
Lucerne,1333,3,13,8,11,42,43,-1,47
St Gallen,1333,4,15,2,15,42,54,-12,47
FC Zürich,1333,5,10,12,10,43,38,5,42
Grasshoppers,1333,6,9,8,15,39,50,-11,35
FC Thun,1333,7,10,5,17,47,61,-14,35
FC Lugano,1333,8,9,7,16,32,49,-17,34
FC Sion,1333,9,5,9,18,36,56,-20,24
Young Boys,1334,1,20,9,3,69,36,33,69
FC Basel,1334,2,17,9,6,52,25,27,60
Lucerne,1334,3,15,8,9,45,42,3,53
FC Zürich,1334,4,11,10,11,40,36,4,43
St Gallen,1334,5,13,3,16,41,56,-15,42
FC Lugano,1334,6,11,6,15,35,48,-13,39
Grasshoppers,1334,7,10,6,16,43,50,-7,36
FC Thun,1334,8,9,5,18,44,58,-14,32
FC Sion,1334,9,6,8,18,37,55,-18,26
Young Boys,1335,1,23,6,3,80,36,44,75
FC Basel,1335,2,17,8,7,55,27,28,59
Lucerne,1335,3,12,8,12,38,46,-8,44
FC Zürich,1335,4,11,10,11,41,37,4,43
St Gallen,1335,5,13,3,16,40,54,-14,42
Grasshoppers,1335,6,11,6,15,44,52,-8,39
FC Lugano,1335,7,10,7,15,31,49,-18,37
FC Sion,1335,8,8,8,16,48,53,-5,32
FC Thun,1335,9,8,6,18,40,63,-23,30
Young Boys,1336,1,20,9,3,75,36,39,69
FC Basel,1336,2,16,10,6,53,26,27,58
Lucerne,1336,3,12,9,11,44,49,-5,45
St Gallen,1336,4,14,3,15,44,58,-14,45
FC Zürich,1336,5,11,11,10,42,35,7,44
FC Thun,1336,6,9,8,15,44,56,-12,35
FC Lugano,1336,7,10,5,17,31,54,-23,35
Grasshoppers,1336,8,9,7,16,42,54,-12,34
FC Sion,1336,9,7,10,15,45,52,-7,31
Young Boys,1337,1,21,8,3,67,31,36,71
FC Basel,1337,2,17,8,7,48,24,24,59
St Gallen,1337,3,15,3,14,44,52,-8,48
Lucerne,1337,4,12,10,10,42,45,-3,46
FC Zürich,1337,5,10,10,12,40,37,3,40
FC Thun,1337,6,11,6,15,46,57,-11,39
Grasshoppers,1337,7,9,9,14,41,48,-7,36
FC Lugano,1337,8,9,7,16,31,48,-17,34
FC Sion,1337,9,5,9,18,35,52,-17,24
Young Boys,1338,1,20,8,4,72,35,37,68
FC Basel,1338,2,19,8,5,56,25,31,65
Lucerne,1338,3,12,9,11,41,43,-2,45
St Gallen,1338,4,14,2,16,46,57,-11,44
FC Zürich,1338,5,10,11,11,40,35,5,41
Grasshoppers,1338,6,10,8,14,41,45,-4,38
FC Lugano,1338,7,10,6,16,29,52,-23,36
FC Sion,1338,8,8,8,16,43,56,-13,32
FC Thun,1338,9,8,6,18,42,62,-20,30
Young Boys,1339,1,22,8,2,73,33,40,74
FC Basel,1339,2,18,7,7,56,28,28,61
FC Zürich,1339,3,12,9,11,44,36,8,45
St Gallen,1339,4,13,4,15,42,56,-14,43
Lucerne,1339,5,11,9,12,41,49,-8,42
FC Lugano,1339,6,12,5,15,34,47,-13,41
Grasshoppers,1339,7,9,9,14,41,48,-7,36
FC Thun,1339,8,9,6,17,45,62,-17,33
FC Sion,1339,9,5,9,18,40,57,-17,24
Young Boys,1340,1,22,7,3,77,37,40,73
FC Basel,1340,2,19,8,5,61,24,37,65
Lucerne,1340,3,11,9,12,41,49,-8,42
St Gallen,1340,4,13,3,16,39,58,-19,42
FC Zürich,1340,5,10,11,11,43,36,7,41
FC Lugano,1340,6,12,5,15,33,46,-13,41
Grasshoppers,1340,7,10,7,15,44,53,-9,37
FC Thun,1340,8,8,6,18,42,65,-23,30
FC Sion,1340,9,6,10,16,42,54,-12,28
Young Boys,1341,1,23,6,3,75,35,40,75
FC Basel,1341,2,17,8,7,53,28,25,59
St Gallen,1341,3,16,2,14,49,52,-3,50
Lucerne,1341,4,14,7,11,43,42,1,49
FC Zürich,1341,5,11,10,11,39,34,5,43
FC Thun,1341,6,11,6,15,46,57,-11,39
Grasshoppers,1341,7,9,6,17,39,51,-12,33
FC Lugano,1341,8,9,5,18,29,54,-25,32
FC Sion,1341,9,5,8,19,38,58,-20,23
Young Boys,1342,1,22,7,3,73,35,38,73
FC Basel,1342,2,18,7,7,54,27,27,61
Lucerne,1342,3,13,8,11,43,46,-3,47
St Gallen,1342,4,15,2,15,48,54,-6,47
FC Zürich,1342,5,11,10,11,43,36,7,43
FC Lugano,1342,6,10,6,16,33,50,-17,36
FC Thun,1342,7,9,8,15,41,55,-14,35
Grasshoppers,1342,8,8,9,15,40,51,-11,33
FC Sion,1342,9,5,9,18,38,59,-21,24
Young Boys,1343,1,21,8,3,71,35,36,71
FC Basel,1343,2,16,8,8,53,29,24,56
St Gallen,1343,3,17,2,13,49,53,-4,53
Lucerne,1343,4,12,9,11,43,46,-3,45
FC Zürich,1343,5,10,10,12,38,35,3,40
FC Lugano,1343,6,11,5,16,30,49,-19,38
FC Thun,1343,7,10,6,16,42,56,-14,36
Grasshoppers,1343,8,9,7,16,42,50,-8,34
FC Sion,1343,9,6,9,17,39,54,-15,27
Young Boys,1344,1,22,8,2,78,36,42,74
FC Basel,1344,2,18,7,7,49,25,24,61
Lucerne,1344,3,14,8,10,45,42,3,50
FC Zürich,1344,4,11,9,12,43,42,1,42
St Gallen,1344,5,13,3,16,40,55,-15,42
FC Thun,1344,6,11,5,16,50,60,-10,38
FC Lugano,1344,7,11,5,16,34,52,-18,38
Grasshoppers,1344,8,8,6,18,42,54,-12,30
FC Sion,1344,9,6,9,17,46,61,-15,27
Young Boys,1345,1,22,6,4,78,38,40,72
FC Basel,1345,2,19,7,6,59,25,34,64
St Gallen,1345,3,15,3,14,41,52,-11,48
Lucerne,1345,4,13,7,12,41,45,-4,46
FC Thun,1345,5,11,5,16,43,55,-12,38
FC Lugano,1345,6,11,5,16,35,50,-15,38
FC Zürich,1345,7,9,10,13,38,44,-6,37
Grasshoppers,1345,8,9,6,17,42,51,-9,33
FC Sion,1345,9,6,9,17,42,59,-17,27
Young Boys,1346,1,23,6,3,72,34,38,75
FC Basel,1346,2,16,10,6,54,29,25,58
St Gallen,1346,3,15,3,14,44,53,-9,48
FC Zürich,1346,4,10,12,10,42,37,5,42
Lucerne,1346,5,11,9,12,41,49,-8,42
FC Lugano,1346,6,9,7,16,29,48,-19,34
FC Sion,1346,7,8,9,15,43,50,-7,33
Grasshoppers,1346,8,9,6,17,42,50,-8,33
FC Thun,1346,9,9,6,17,41,58,-17,33
Young Boys,1347,1,22,6,4,72,38,34,72
FC Basel,1347,2,17,8,7,55,29,26,59
Lucerne,1347,3,14,8,10,47,47,0,50
St Gallen,1347,4,15,4,13,42,51,-9,49
FC Zürich,1347,5,11,10,11,45,37,8,43
FC Thun,1347,6,9,8,15,45,57,-12,35
Grasshoppers,1347,7,9,7,16,44,52,-8,34
FC Lugano,1347,8,9,5,18,29,48,-19,32
FC Sion,1347,9,6,8,18,41,61,-20,26
Young Boys,1348,1,21,9,2,71,34,37,72
FC Basel,1348,2,19,7,6,60,29,31,64
Lucerne,1348,3,13,9,10,40,40,0,48
St Gallen,1348,4,14,3,15,42,56,-14,45
FC Zürich,1348,5,11,9,12,44,39,5,42
Grasshoppers,1348,6,9,8,15,40,48,-8,35
FC Lugano,1348,7,9,6,17,29,50,-21,33
FC Thun,1348,8,9,5,18,43,60,-17,32
FC Sion,1348,9,6,10,16,40,53,-13,28
Young Boys,1349,1,23,6,3,77,32,45,75
FC Basel,1349,2,16,8,8,51,31,20,56
Lucerne,1349,3,12,9,11,41,50,-9,45
St Gallen,1349,4,14,3,15,44,55,-11,45
FC Zürich,1349,5,11,10,11,42,34,8,43
FC Lugano,1349,6,12,5,15,33,44,-11,41
Grasshoppers,1349,7,10,7,15,40,49,-9,37
FC Thun,1349,8,8,6,18,41,61,-20,30
FC Sion,1349,9,6,10,16,41,54,-13,28
Young Boys,1350,1,21,6,5,70,40,30,69
FC Basel,1350,2,19,8,5,58,22,36,65
FC Zürich,1350,3,12,10,10,44,34,10,46
St Gallen,1350,4,14,4,14,42,56,-14,46
Lucerne,1350,5,11,9,12,40,46,-6,42
FC Lugano,1350,6,10,6,16,29,48,-19,36
FC Thun,1350,7,10,5,17,43,60,-17,35
Grasshoppers,1350,8,9,7,16,44,50,-6,34
FC Sion,1350,9,7,7,18,42,56,-14,28
Young Boys,1351,1,20,8,4,67,36,31,68
FC Basel,1351,2,17,8,7,52,26,26,59
St Gallen,1351,3,17,2,13,49,53,-4,53
FC Zürich,1351,4,11,10,11,40,35,5,43
Lucerne,1351,5,11,9,12,39,43,-4,42
Grasshoppers,1351,6,11,7,14,43,47,-4,40
FC Thun,1351,7,10,6,16,42,58,-16,36
FC Lugano,1351,8,9,7,16,31,49,-18,34
FC Sion,1351,9,6,7,19,41,57,-16,25
Young Boys,1352,1,21,8,3,69,34,35,71
FC Basel,1352,2,19,7,6,52,24,28,64
Lucerne,1352,3,13,9,10,44,43,1,48
St Gallen,1352,4,14,2,16,44,56,-12,44
FC Zürich,1352,5,10,10,12,38,35,3,40
FC Lugano,1352,6,10,8,14,30,44,-14,38
FC Thun,1352,7,10,5,17,46,59,-13,35
Grasshoppers,1352,8,8,8,16,42,53,-11,32
FC Sion,1352,9,6,9,17,39,56,-17,27
Young Boys,1353,1,21,7,4,73,37,36,70
FC Basel,1353,2,18,8,6,57,26,31,62
Lucerne,1353,3,14,8,10,43,43,0,50
St Gallen,1353,4,14,2,16,42,54,-12,44
FC Zürich,1353,5,10,11,11,42,35,7,41
FC Thun,1353,6,11,5,16,50,64,-14,38
FC Lugano,1353,7,10,7,15,31,48,-17,37
Grasshoppers,1353,8,9,7,16,44,53,-9,34
FC Sion,1353,9,6,7,19,41,63,-22,25
Young Boys,1354,1,21,7,4,73,41,32,70
FC Basel,1354,2,17,9,6,57,25,32,60
Lucerne,1354,3,14,7,11,44,45,-1,49
St Gallen,1354,4,14,2,16,42,56,-14,44
FC Zürich,1354,5,10,11,11,39,37,2,41
FC Thun,1354,6,11,5,16,44,56,-12,38
FC Lugano,1354,7,11,5,16,34,48,-14,38
Grasshoppers,1354,8,9,6,17,42,52,-10,33
FC Sion,1354,9,7,8,17,43,58,-15,29
Young Boys,1355,1,20,9,3,69,34,35,69
FC Basel,1355,2,17,8,7,53,27,26,59
Lucerne,1355,3,14,7,11,41,44,-3,49
St Gallen,1355,4,15,3,14,45,54,-9,48
FC Zürich,1355,5,11,10,11,42,36,6,43
Grasshoppers,1355,6,9,7,16,39,49,-10,34
FC Lugano,1355,7,9,7,16,30,48,-18,34
FC Sion,1355,8,8,8,16,42,50,-8,32
FC Thun,1355,9,9,5,18,44,63,-19,32
Young Boys,1356,1,21,7,4,70,35,35,70
FC Basel,1356,2,19,7,6,57,25,32,64
FC Zürich,1356,3,12,9,11,43,35,8,45
Lucerne,1356,4,12,8,12,39,48,-9,44
St Gallen,1356,5,14,2,16,45,59,-14,44
FC Lugano,1356,6,11,6,15,33,46,-13,39
Grasshoppers,1356,7,9,7,16,43,52,-9,34
FC Thun,1356,8,9,6,17,42,59,-17,33
FC Sion,1356,9,7,8,17,39,52,-13,29
Young Boys,1357,1,20,9,3,67,34,33,69
FC Basel,1357,2,17,8,7,56,28,28,59
St Gallen,1357,3,17,2,13,50,52,-2,53
Lucerne,1357,4,13,7,12,43,47,-4,46
FC Zürich,1357,5,12,9,11,41,34,7,45
FC Thun,1357,6,11,5,16,44,57,-13,38
FC Lugano,1357,7,10,5,17,29,48,-19,35
Grasshoppers,1357,8,8,8,16,37,49,-12,32
FC Sion,1357,9,5,9,18,36,54,-18,24
Young Boys,1358,1,22,7,3,70,34,36,73
FC Basel,1358,2,17,8,7,51,27,24,59
St Gallen,1358,3,17,2,13,48,51,-3,53
Lucerne,1358,4,12,8,12,43,47,-4,44
FC Zürich,1358,5,10,10,12,42,37,5,40
FC Thun,1358,6,10,7,15,47,59,-12,37
FC Lugano,1358,7,9,7,16,31,52,-21,34
Grasshoppers,1358,8,8,7,17,42,54,-12,31
FC Sion,1358,9,6,10,16,41,54,-13,28
Young Boys,1359,1,20,7,5,69,35,34,67
FC Basel,1359,2,18,9,5,55,25,30,63
Lucerne,1359,3,13,7,12,42,43,-1,46
St Gallen,1359,4,14,3,15,45,60,-15,45
FC Zürich,1359,5,10,11,11,40,36,4,41
FC Lugano,1359,6,12,5,15,33,47,-14,41
Grasshoppers,1359,7,10,7,15,45,51,-6,37
FC Thun,1359,8,8,8,16,44,62,-18,32
FC Sion,1359,9,5,11,16,40,54,-14,26
Young Boys,1360,1,22,7,3,71,33,38,73
FC Basel,1360,2,18,7,7,53,26,27,61
St Gallen,1360,3,15,3,14,44,53,-9,48
FC Zürich,1360,4,12,9,11,41,36,5,45
Lucerne,1360,5,12,7,13,40,46,-6,43
FC Lugano,1360,6,11,6,15,32,44,-12,39
FC Thun,1360,7,10,5,17,45,59,-14,35
Grasshoppers,1360,8,8,7,17,39,52,-13,31
FC Sion,1360,9,6,9,17,40,56,-16,27
Young Boys,1361,1,22,6,4,78,41,37,72
FC Basel,1361,2,19,7,6,55,24,31,64
St Gallen,1361,3,15,3,14,42,51,-9,48
FC Zürich,1361,4,12,9,11,43,36,7,45
Lucerne,1361,5,11,9,12,42,49,-7,42
FC Thun,1361,6,10,5,17,43,60,-17,35
Grasshoppers,1361,7,9,7,16,44,53,-9,34
FC Lugano,1361,8,9,7,16,30,48,-18,34
FC Sion,1361,9,7,7,18,40,55,-15,28
Young Boys,1362,1,21,8,3,70,33,37,71
FC Basel,1362,2,17,8,7,53,26,27,59
St Gallen,1362,3,15,3,14,41,51,-10,48
Lucerne,1362,4,13,8,11,40,42,-2,47
FC Zürich,1362,5,11,10,11,43,39,4,43
FC Lugano,1362,6,10,6,16,32,48,-16,36
Grasshoppers,1362,7,9,7,16,43,51,-8,34
FC Sion,1362,8,8,9,15,44,51,-7,33
FC Thun,1362,9,8,5,19,42,67,-25,29
Young Boys,1363,1,24,6,2,75,31,44,78
FC Basel,1363,2,16,8,8,55,33,22,56
St Gallen,1363,3,15,2,15,46,58,-12,47
Lucerne,1363,4,12,7,13,41,49,-8,43
FC Zürich,1363,5,10,10,12,43,39,4,40
FC Thun,1363,6,11,5,16,45,57,-12,38
FC Lugano,1363,7,11,5,16,35,49,-14,38
Grasshoppers,1363,8,9,7,16,42,50,-8,34
FC Sion,1363,9,7,8,17,40,56,-16,29
Young Boys,1364,1,22,7,3,72,35,37,73
FC Basel,1364,2,18,8,6,53,25,28,62
St Gallen,1364,3,15,3,14,46,53,-7,48
Lucerne,1364,4,13,8,11,42,46,-4,47
FC Zürich,1364,5,10,11,11,40,35,5,41
FC Thun,1364,6,11,5,16,45,57,-12,38
FC Lugano,1364,7,10,6,16,30,47,-17,36
Grasshoppers,1364,8,8,6,18,40,53,-13,30
FC Sion,1364,9,6,8,18,39,56,-17,26
Young Boys,1365,1,23,6,3,79,36,43,75
FC Basel,1365,2,18,7,7,55,27,28,61
St Gallen,1365,3,15,3,14,45,52,-7,48
Lucerne,1365,4,11,10,11,41,47,-6,43
FC Lugano,1365,5,12,6,14,33,45,-12,42
FC Zürich,1365,6,10,9,13,39,38,1,39
FC Thun,1365,7,10,5,17,45,57,-12,35
Grasshoppers,1365,8,8,7,17,40,57,-17,31
FC Sion,1365,9,7,7,18,39,57,-18,28
Young Boys,1366,1,23,6,3,72,31,41,75
FC Basel,1366,2,18,7,7,53,25,28,61
FC Zürich,1366,3,12,9,11,45,36,9,45
Lucerne,1366,4,12,9,11,40,46,-6,45
St Gallen,1366,5,14,2,16,41,54,-13,44
FC Lugano,1366,6,11,6,15,31,47,-16,39
FC Thun,1366,7,9,6,17,42,60,-18,33
Grasshoppers,1366,8,8,7,17,40,53,-13,31
FC Sion,1366,9,7,8,17,43,55,-12,29
Young Boys,1367,1,23,6,3,74,33,41,75
FC Basel,1367,2,18,8,6,55,23,32,62
Lucerne,1367,3,13,8,11,42,43,-1,47
FC Zürich,1367,4,12,10,10,40,33,7,46
St Gallen,1367,5,14,4,14,40,54,-14,46
FC Thun,1367,6,9,6,17,42,59,-17,33
FC Lugano,1367,7,9,6,17,29,49,-20,33
Grasshoppers,1367,8,8,6,18,38,56,-18,30
FC Sion,1367,9,7,8,17,40,50,-10,29
Young Boys,1368,1,22,7,3,78,36,42,73
FC Basel,1368,2,16,9,7,54,30,24,57
Lucerne,1368,3,13,8,11,43,46,-3,47
St Gallen,1368,4,13,4,15,41,57,-16,43
FC Zürich,1368,5,10,10,12,38,38,0,40
FC Thun,1368,6,11,5,16,48,59,-11,38
FC Lugano,1368,7,10,5,17,31,48,-17,35
Grasshoppers,1368,8,9,7,16,39,53,-14,34
FC Sion,1368,9,8,9,15,50,55,-5,33
Young Boys,1369,1,21,8,3,72,37,35,71
FC Basel,1369,2,18,8,6,50,23,27,62
St Gallen,1369,3,15,3,14,44,54,-10,48
Lucerne,1369,4,11,11,10,42,46,-4,44
FC Zürich,1369,5,9,11,12,38,37,1,38
FC Lugano,1369,6,11,5,16,35,48,-13,38
Grasshoppers,1369,7,9,7,16,41,49,-8,34
FC Sion,1369,8,7,10,15,45,54,-9,31
FC Thun,1369,9,8,7,17,42,61,-19,31
Young Boys,1370,1,22,7,3,69,32,37,73
FC Basel,1370,2,18,8,6,56,27,29,62
St Gallen,1370,3,17,2,13,49,53,-4,53
Lucerne,1370,4,11,9,12,42,47,-5,42
FC Zürich,1370,5,10,9,13,39,39,0,39
FC Lugano,1370,6,10,6,16,32,50,-18,36
Grasshoppers,1370,7,9,7,16,38,48,-10,34
FC Thun,1370,8,9,5,18,44,60,-16,32
FC Sion,1370,9,8,7,17,41,54,-13,31
Young Boys,1371,1,22,8,2,74,32,42,74
FC Basel,1371,2,18,9,5,58,26,32,63
St Gallen,1371,3,14,3,15,45,59,-14,45
FC Zürich,1371,4,11,11,10,40,33,7,44
Lucerne,1371,5,12,7,13,46,54,-8,43
FC Lugano,1371,6,11,7,14,34,44,-10,40
FC Thun,1371,7,9,6,17,41,59,-18,33
Grasshoppers,1371,8,8,8,16,41,52,-11,32
FC Sion,1371,9,5,9,18,38,58,-20,24
Young Boys,1372,1,23,7,2,80,32,48,76
FC Basel,1372,2,15,9,8,49,30,19,54
Lucerne,1372,3,12,9,11,44,52,-8,45
St Gallen,1372,4,14,3,15,43,55,-12,45
FC Zürich,1372,5,11,10,11,41,37,4,43
FC Thun,1372,6,11,6,15,47,57,-10,39
Grasshoppers,1372,7,10,7,15,47,49,-2,37
FC Lugano,1372,8,10,7,15,33,51,-18,37
FC Sion,1372,9,5,8,19,39,60,-21,23
Young Boys,1373,1,22,7,3,73,36,37,73
FC Basel,1373,2,17,9,6,54,28,26,60
Lucerne,1373,3,12,11,9,42,42,0,47
St Gallen,1373,4,14,4,14,43,53,-10,46
FC Zürich,1373,5,11,10,11,44,37,7,43
FC Lugano,1373,6,10,7,15,34,48,-14,37
FC Thun,1373,7,10,6,16,47,59,-12,36
Grasshoppers,1373,8,8,8,16,39,53,-14,32
FC Sion,1373,9,5,8,19,40,60,-20,23
Young Boys,1374,1,20,8,4,67,35,32,68
FC Basel,1374,2,17,9,6,52,26,26,60
St Gallen,1374,3,15,3,14,44,54,-10,48
Lucerne,1374,4,12,8,12,41,43,-2,44
FC Lugano,1374,5,12,6,14,33,44,-11,42
Grasshoppers,1374,6,11,7,14,43,48,-5,40
FC Zürich,1374,7,9,10,13,38,38,0,37
FC Thun,1374,8,9,6,17,46,62,-16,33
FC Sion,1374,9,6,9,17,39,53,-14,27
Young Boys,1375,1,19,9,4,72,41,31,66
FC Basel,1375,2,19,8,5,58,28,30,65
Lucerne,1375,3,13,8,11,43,41,2,47
St Gallen,1375,4,13,3,16,44,61,-17,42
FC Zürich,1375,5,10,10,12,40,38,2,40
FC Lugano,1375,6,11,7,14,32,45,-13,40
Grasshoppers,1375,7,10,7,15,42,48,-6,37
FC Thun,1375,8,10,6,16,42,55,-13,36
FC Sion,1375,9,6,8,18,42,58,-16,26
Young Boys,1376,1,21,8,3,71,36,35,71
FC Basel,1376,2,16,9,7,50,27,23,57
Lucerne,1376,3,13,10,9,42,41,1,49
St Gallen,1376,4,15,2,15,45,56,-11,47
FC Zürich,1376,5,9,12,11,40,37,3,39
FC Lugano,1376,6,10,7,15,32,47,-15,37
FC Thun,1376,7,10,5,17,45,60,-15,35
Grasshoppers,1376,8,9,7,16,41,51,-10,34
FC Sion,1376,9,7,8,17,46,57,-11,29
Young Boys,1377,1,23,6,3,76,33,43,75
FC Basel,1377,2,16,9,7,55,27,28,57
St Gallen,1377,3,17,2,13,44,51,-7,53
FC Zürich,1377,4,12,10,10,42,33,9,46
Lucerne,1377,5,12,7,13,40,51,-11,43
Grasshoppers,1377,6,10,6,16,41,53,-12,36
FC Lugano,1377,7,10,5,17,31,49,-18,35
FC Thun,1377,8,9,6,17,47,63,-16,33
FC Sion,1377,9,6,7,19,40,56,-16,25
Young Boys,1378,1,23,7,2,76,32,44,76
FC Basel,1378,2,19,7,6,57,25,32,64
Lucerne,1378,3,14,7,11,44,46,-2,49
St Gallen,1378,4,15,2,15,44,56,-12,47
FC Zürich,1378,5,10,10,12,41,39,2,40
Grasshoppers,1378,6,9,8,15,40,47,-7,35
FC Lugano,1378,7,10,5,17,30,52,-22,35
FC Thun,1378,8,8,8,16,41,58,-17,32
FC Sion,1378,9,5,8,19,39,57,-18,23
Young Boys,1379,1,22,6,4,71,37,34,72
FC Basel,1379,2,18,8,6,53,26,27,62
St Gallen,1379,3,15,3,14,46,55,-9,48
Lucerne,1379,4,13,8,11,45,42,3,47
FC Zürich,1379,5,11,9,12,43,37,6,42
Grasshoppers,1379,6,10,6,16,42,49,-7,36
FC Thun,1379,7,9,6,17,43,61,-18,33
FC Lugano,1379,8,9,6,17,29,51,-22,33
FC Sion,1379,9,7,8,17,42,56,-14,29
Young Boys,1380,1,21,8,3,78,39,39,71
FC Basel,1380,2,18,8,6,53,27,26,62
FC Zürich,1380,3,12,9,11,42,33,9,45
St Gallen,1380,4,14,3,15,40,53,-13,45
Lucerne,1380,5,11,8,13,38,47,-9,41
FC Lugano,1380,6,11,6,15,33,48,-15,39
Grasshoppers,1380,7,10,8,14,43,47,-4,38
FC Thun,1380,8,8,7,17,38,56,-18,31
FC Sion,1380,9,5,11,16,37,52,-15,26
Young Boys,1381,1,24,6,2,71,32,39,78
FC Basel,1381,2,17,9,6,53,24,29,60
Lucerne,1381,3,13,8,11,43,43,0,47
St Gallen,1381,4,14,3,15,42,53,-11,45
FC Zürich,1381,5,10,10,12,40,37,3,40
FC Lugano,1381,6,11,5,16,34,48,-14,38
Grasshoppers,1381,7,9,6,17,39,50,-11,33
FC Thun,1381,8,9,5,18,41,64,-23,32
FC Sion,1381,9,7,8,17,41,53,-12,29
Young Boys,1382,1,21,9,2,73,33,40,72
FC Basel,1382,2,19,8,5,57,25,32,65
Lucerne,1382,3,12,9,11,39,42,-3,45
St Gallen,1382,4,14,2,16,43,56,-13,44
FC Zürich,1382,5,9,11,12,39,38,1,38
Grasshoppers,1382,6,10,8,14,42,48,-6,38
FC Lugano,1382,7,10,6,16,30,52,-22,36
FC Thun,1382,8,10,5,17,43,58,-15,35
FC Sion,1382,9,6,8,18,39,53,-14,26
Young Boys,1383,1,21,7,4,72,37,35,70
FC Basel,1383,2,17,7,8,53,30,23,58
Lucerne,1383,3,14,8,10,45,44,1,50
St Gallen,1383,4,15,3,14,43,53,-10,48
FC Zürich,1383,5,11,10,11,42,35,7,43
Grasshoppers,1383,6,10,7,15,42,47,-5,37
FC Lugano,1383,7,9,8,15,30,48,-18,35
FC Thun,1383,8,9,6,17,42,59,-17,33
FC Sion,1383,9,6,8,18,39,55,-16,26
Young Boys,1384,1,22,8,2,77,34,43,74
FC Basel,1384,2,16,9,7,50,26,24,57
St Gallen,1384,3,14,3,15,44,57,-13,45
Lucerne,1384,4,11,11,10,41,48,-7,44
FC Zürich,1384,5,11,10,11,41,37,4,43
FC Lugano,1384,6,11,7,14,34,44,-10,40
FC Thun,1384,7,10,5,17,49,60,-11,35
Grasshoppers,1384,8,8,9,15,42,53,-11,33
FC Sion,1384,9,6,8,18,40,59,-19,26
Young Boys,1385,1,21,9,2,70,33,37,72
FC Basel,1385,2,17,9,6,51,24,27,60
FC Zürich,1385,3,13,9,10,47,33,14,48
St Gallen,1385,4,15,2,15,42,55,-13,47
Lucerne,1385,5,11,8,13,40,46,-6,41
FC Lugano,1385,6,11,5,16,33,50,-17,38
Grasshoppers,1385,7,10,7,15,46,52,-6,37
FC Thun,1385,8,9,6,17,44,60,-16,33
FC Sion,1385,9,6,7,19,37,57,-20,25
Young Boys,1386,1,23,6,3,77,33,44,75
FC Basel,1386,2,18,8,6,53,26,27,62
FC Zürich,1386,3,13,9,10,43,35,8,48
St Gallen,1386,4,14,3,15,42,56,-14,45
Lucerne,1386,5,12,7,13,42,49,-7,43
FC Lugano,1386,6,11,5,16,32,45,-13,38
Grasshoppers,1386,7,9,7,16,41,53,-12,34
FC Thun,1386,8,8,6,18,41,60,-19,30
FC Sion,1386,9,7,7,18,43,57,-14,28
Young Boys,1387,1,23,7,2,80,33,47,76
FC Basel,1387,2,16,9,7,52,28,24,57
Lucerne,1387,3,13,8,11,47,46,1,47
St Gallen,1387,4,15,2,15,44,58,-14,47
FC Zürich,1387,5,11,11,10,41,34,7,44
FC Lugano,1387,6,10,5,17,29,52,-23,35
Grasshoppers,1387,7,9,7,16,40,51,-11,34
FC Thun,1387,8,9,6,17,41,57,-16,33
FC Sion,1387,9,7,7,18,42,57,-15,28
Young Boys,1388,1,22,6,4,71,35,36,72
FC Basel,1388,2,19,8,5,57,25,32,65
St Gallen,1388,3,14,5,13,41,50,-9,47
Lucerne,1388,4,12,9,11,41,46,-5,45
FC Zürich,1388,5,10,10,12,40,40,0,40
Grasshoppers,1388,6,11,7,14,44,48,-4,40
FC Lugano,1388,7,10,5,17,30,46,-16,35
FC Thun,1388,8,9,6,17,45,60,-15,33
FC Sion,1388,9,5,8,19,38,57,-19,23
Young Boys,1389,1,23,7,2,77,34,43,76
FC Basel,1389,2,18,8,6,59,28,31,62
St Gallen,1389,3,14,3,15,41,55,-14,45
Lucerne,1389,4,12,8,12,41,47,-6,44
FC Zürich,1389,5,10,10,12,41,38,3,40
FC Lugano,1389,6,11,6,15,35,48,-13,39
Grasshoppers,1389,7,9,8,15,40,47,-7,35
FC Thun,1389,8,8,6,18,40,63,-23,30
FC Sion,1389,9,7,8,17,40,54,-14,29
Young Boys,1390,1,20,8,4,70,37,33,68
FC Basel,1390,2,19,7,6,56,26,30,64
St Gallen,1390,3,14,4,14,42,53,-11,46
Lucerne,1390,4,12,9,11,41,45,-4,45
FC Zürich,1390,5,10,10,12,39,37,2,40
Grasshoppers,1390,6,10,7,15,42,47,-5,37
FC Lugano,1390,7,10,7,15,32,46,-14,37
FC Thun,1390,8,10,6,16,44,56,-12,36
FC Sion,1390,9,6,8,18,37,56,-19,26
Young Boys,1391,1,22,6,4,74,38,36,72
FC Basel,1391,2,19,7,6,61,27,34,64
St Gallen,1391,3,15,3,14,41,54,-13,48
Lucerne,1391,4,13,7,12,43,43,0,46
FC Zürich,1391,5,10,9,13,39,39,0,39
FC Lugano,1391,6,11,5,16,34,48,-14,38
FC Thun,1391,7,10,5,17,47,61,-14,35
Grasshoppers,1391,8,9,7,16,41,55,-14,34
FC Sion,1391,9,6,9,17,37,52,-15,27
Young Boys,1392,1,23,6,3,71,33,38,75
FC Basel,1392,2,17,9,6,52,23,29,60
Lucerne,1392,3,12,7,13,38,44,-6,43
St Gallen,1392,4,13,4,15,40,54,-14,43
FC Zürich,1392,5,9,12,11,40,37,3,39
FC Lugano,1392,6,10,7,15,30,45,-15,37
Grasshoppers,1392,7,10,6,16,42,50,-8,36
FC Thun,1392,8,10,6,16,46,60,-14,36
FC Sion,1392,9,8,7,17,43,56,-13,31
Young Boys,1393,1,23,6,3,75,31,44,75
FC Basel,1393,2,18,7,7,54,26,28,61
St Gallen,1393,3,15,3,14,45,53,-8,48
Lucerne,1393,4,12,8,12,42,48,-6,44
FC Thun,1393,5,11,6,15,45,55,-10,39
FC Zürich,1393,6,9,11,12,39,38,1,38
FC Lugano,1393,7,9,8,15,30,48,-18,35
Grasshoppers,1393,8,8,8,16,38,51,-13,32
FC Sion,1393,9,6,9,17,37,55,-18,27
Young Boys,1394,1,20,7,5,73,41,32,67
FC Basel,1394,2,16,10,6,53,28,25,58
Lucerne,1394,3,15,8,9,46,40,6,53
FC Zürich,1394,4,11,10,11,41,35,6,43
St Gallen,1394,5,13,3,16,41,60,-19,42
Grasshoppers,1394,6,11,6,15,46,49,-3,39
FC Lugano,1394,7,11,6,15,35,47,-12,39
FC Thun,1394,8,8,6,18,43,65,-22,30
FC Sion,1394,9,7,8,17,46,59,-13,29
Young Boys,1395,1,21,8,3,69,34,35,71
FC Basel,1395,2,16,8,8,54,30,24,56
Lucerne,1395,3,14,8,10,46,44,2,50
FC Zürich,1395,4,12,9,11,43,34,9,45
St Gallen,1395,5,14,3,15,42,55,-13,45
Grasshoppers,1395,6,11,6,15,41,47,-6,39
FC Thun,1395,7,10,6,16,45,59,-14,36
FC Lugano,1395,8,10,6,16,30,47,-17,36
FC Sion,1395,9,5,8,19,36,56,-20,23
Young Boys,1396,1,20,8,4,67,33,34,68
FC Basel,1396,2,18,8,6,54,25,29,62
Lucerne,1396,3,16,7,9,48,38,10,55
St Gallen,1396,4,13,3,16,40,56,-16,42
FC Zürich,1396,5,10,9,13,43,43,0,39
Grasshoppers,1396,6,10,7,15,42,52,-10,37
FC Lugano,1396,7,10,5,17,32,51,-19,35
FC Thun,1396,8,9,7,16,45,61,-16,34
FC Sion,1396,9,6,10,16,38,50,-12,28
Young Boys,1397,1,22,7,3,75,35,40,73
FC Basel,1397,2,18,8,6,57,26,31,62
Lucerne,1397,3,14,9,9,45,42,3,51
St Gallen,1397,4,13,5,14,44,56,-12,44
FC Zürich,1397,5,11,9,12,43,39,4,42
FC Thun,1397,6,11,5,16,46,60,-14,38
FC Lugano,1397,7,10,5,17,33,51,-18,35
Grasshoppers,1397,8,8,6,18,38,53,-15,30
FC Sion,1397,9,6,8,18,41,60,-19,26
Young Boys,1398,1,20,7,5,68,39,29,67
FC Basel,1398,2,19,7,6,54,24,30,64
FC Zürich,1398,3,13,9,10,43,32,11,48
Lucerne,1398,4,13,8,11,44,42,2,47
St Gallen,1398,5,13,3,16,41,56,-15,42
FC Lugano,1398,6,11,5,16,30,48,-18,38
Grasshoppers,1398,7,8,9,15,38,47,-9,33
FC Thun,1398,8,9,5,18,42,61,-19,32
FC Sion,1398,9,7,9,16,45,56,-11,30
Young Boys,1399,1,21,7,4,68,33,35,70
FC Basel,1399,2,19,8,5,58,23,35,65
Lucerne,1399,3,13,7,12,44,44,0,46
St Gallen,1399,4,13,3,16,41,60,-19,42
Grasshoppers,1399,5,11,7,14,43,47,-4,40
FC Zürich,1399,6,9,11,12,41,40,1,38
FC Lugano,1399,7,10,7,15,31,46,-15,37
FC Thun,1399,8,8,7,17,43,65,-22,31
FC Sion,1399,9,7,9,16,43,54,-11,30
Young Boys,1400,1,23,7,2,75,32,43,76
FC Basel,1400,2,16,11,5,53,23,30,59
Lucerne,1400,3,13,9,10,40,41,-1,48
FC Zürich,1400,4,11,11,10,41,33,8,44
St Gallen,1400,5,13,4,15,42,55,-13,43
Grasshoppers,1400,6,10,7,15,44,48,-4,37
FC Lugano,1400,7,10,5,17,29,50,-21,35
FC Thun,1400,8,9,6,17,40,63,-23,33
FC Sion,1400,9,5,8,19,40,59,-19,23
Young Boys,1401,1,21,7,4,70,37,33,70
FC Basel,1401,2,18,9,5,56,26,30,63
Lucerne,1401,3,12,9,11,40,44,-4,45
St Gallen,1401,4,14,3,15,43,57,-14,45
FC Zürich,1401,5,10,9,13,44,40,4,39
FC Thun,1401,6,11,6,15,46,58,-12,39
FC Lugano,1401,7,11,5,16,32,47,-15,38
Grasshoppers,1401,8,9,6,17,42,50,-8,33
FC Sion,1401,9,7,8,17,44,58,-14,29
Young Boys,1402,1,19,9,4,64,33,31,66
FC Basel,1402,2,18,9,5,53,25,28,63
St Gallen,1402,3,16,3,13,48,56,-8,51
Lucerne,1402,4,12,8,12,46,45,1,44
FC Zürich,1402,5,10,10,12,37,35,2,40
Grasshoppers,1402,6,11,7,14,43,47,-4,40
FC Lugano,1402,7,10,6,16,30,49,-19,36
FC Thun,1402,8,9,5,18,41,58,-17,32
FC Sion,1402,9,6,9,17,40,54,-14,27
Young Boys,1403,1,22,8,2,76,33,43,74
FC Basel,1403,2,16,10,6,50,24,26,58
St Gallen,1403,3,15,3,14,42,51,-9,48
Lucerne,1403,4,13,8,11,41,43,-2,47
FC Zürich,1403,5,11,9,12,39,37,2,42
Grasshoppers,1403,6,10,8,14,42,46,-4,38
FC Lugano,1403,7,11,5,16,33,51,-18,38
FC Thun,1403,8,8,6,18,42,61,-19,30
FC Sion,1403,9,6,7,19,38,57,-19,25
Young Boys,1404,1,22,7,3,70,34,36,73
FC Basel,1404,2,16,10,6,50,25,25,58
Lucerne,1404,3,13,9,10,44,43,1,48
St Gallen,1404,4,14,5,13,41,51,-10,47
FC Zürich,1404,5,10,10,12,37,36,1,40
FC Lugano,1404,6,10,6,16,31,45,-14,36
Grasshoppers,1404,7,9,8,15,44,52,-8,35
FC Thun,1404,8,9,8,15,43,57,-14,35
FC Sion,1404,9,5,9,18,38,55,-17,24
Young Boys,1405,1,21,6,5,71,36,35,69
FC Basel,1405,2,19,7,6,55,26,29,64
Lucerne,1405,3,14,8,10,42,40,2,50
St Gallen,1405,4,13,5,14,42,54,-12,44
FC Zürich,1405,5,11,10,11,40,36,4,43
FC Lugano,1405,6,10,7,15,32,49,-17,37
Grasshoppers,1405,7,9,6,17,42,51,-9,33
FC Thun,1405,8,9,5,18,43,61,-18,32
FC Sion,1405,9,7,8,17,38,52,-14,29
Young Boys,1406,1,19,9,4,68,36,32,66
FC Basel,1406,2,16,9,7,50,28,22,57
Lucerne,1406,3,13,8,11,41,42,-1,47
St Gallen,1406,4,15,2,15,43,55,-12,47
FC Lugano,1406,5,12,6,14,35,44,-9,42
FC Zürich,1406,6,10,11,11,42,40,2,41
Grasshoppers,1406,7,10,6,16,42,49,-7,36
FC Thun,1406,8,9,7,16,43,58,-15,34
FC Sion,1406,9,7,8,17,42,54,-12,29
Young Boys,1407,1,22,7,3,72,33,39,73
FC Basel,1407,2,17,9,6,52,25,27,60
Lucerne,1407,3,14,9,9,43,39,4,51
FC Zürich,1407,4,12,9,11,43,33,10,45
St Gallen,1407,5,14,3,15,42,55,-13,45
FC Thun,1407,6,10,6,16,43,58,-15,36
FC Lugano,1407,7,9,5,18,28,50,-22,32
Grasshoppers,1407,8,8,6,18,38,55,-17,30
FC Sion,1407,9,7,8,17,40,53,-13,29
Young Boys,1408,1,22,6,4,73,37,36,72
FC Basel,1408,2,18,8,6,57,29,28,62
St Gallen,1408,3,15,3,14,46,55,-9,48
Lucerne,1408,4,11,9,12,44,50,-6,42
FC Lugano,1408,5,12,5,15,35,47,-12,41
FC Zürich,1408,6,9,10,13,37,37,0,37
FC Thun,1408,7,10,5,17,45,60,-15,35
Grasshoppers,1408,8,9,7,16,44,54,-10,34
FC Sion,1408,9,8,7,17,40,52,-12,31
Young Boys,1409,1,19,8,5,70,40,30,65
FC Basel,1409,2,17,9,6,54,26,28,60
Lucerne,1409,3,15,7,10,45,42,3,52
St Gallen,1409,4,14,3,15,40,52,-12,45
FC Zürich,1409,5,11,10,11,41,36,5,43
FC Lugano,1409,6,11,5,16,31,47,-16,38
Grasshoppers,1409,7,10,6,16,41,47,-6,36
FC Thun,1409,8,9,7,16,45,62,-17,34
FC Sion,1409,9,6,9,17,40,55,-15,27
Young Boys,1410,1,22,8,2,76,36,40,74
FC Basel,1410,2,17,10,5,57,27,30,61
St Gallen,1410,3,14,5,13,51,56,-5,47
Lucerne,1410,4,12,8,12,43,54,-11,44
FC Zürich,1410,5,10,11,11,42,38,4,41
FC Lugano,1410,6,10,6,16,32,49,-17,36
Grasshoppers,1410,7,8,10,14,41,49,-8,34
FC Thun,1410,8,8,8,16,44,60,-16,32
FC Sion,1410,9,5,10,17,43,60,-17,25
Young Boys,1411,1,22,7,3,68,32,36,73
FC Basel,1411,2,17,7,8,54,26,28,58
St Gallen,1411,3,17,2,13,44,50,-6,53
FC Zürich,1411,4,13,9,10,51,38,13,48
Lucerne,1411,5,13,7,12,40,44,-4,46
Grasshoppers,1411,6,9,8,15,39,47,-8,35
FC Lugano,1411,7,10,5,17,32,48,-16,35
FC Thun,1411,8,9,5,18,42,65,-23,32
FC Sion,1411,9,5,8,19,38,58,-20,23
Young Boys,1412,1,24,6,2,76,34,42,78
FC Basel,1412,2,17,8,7,52,28,24,59
St Gallen,1412,3,15,3,14,45,54,-9,48
Lucerne,1412,4,12,9,11,43,46,-3,45
FC Zürich,1412,5,11,9,12,41,37,4,42
FC Lugano,1412,6,10,6,16,30,48,-18,36
Grasshoppers,1412,7,9,7,16,43,52,-9,34
FC Thun,1412,8,9,6,17,44,60,-16,33
FC Sion,1412,9,6,8,18,38,53,-15,26
Young Boys,1413,1,23,6,3,76,32,44,75
FC Basel,1413,2,20,7,5,53,22,31,67
St Gallen,1413,3,15,3,14,46,55,-9,48
Lucerne,1413,4,12,7,13,41,49,-8,43
FC Zürich,1413,5,10,10,12,39,37,2,40
FC Lugano,1413,6,11,5,16,34,47,-13,38
Grasshoppers,1413,7,9,7,16,41,53,-12,34
FC Thun,1413,8,9,7,16,43,57,-14,34
FC Sion,1413,9,5,8,19,37,58,-21,23
Young Boys,1414,1,19,9,4,68,36,32,66
FC Basel,1414,2,17,8,7,52,27,25,59
FC Zürich,1414,3,12,10,10,41,32,9,46
Lucerne,1414,4,12,9,11,39,40,-1,45
St Gallen,1414,5,14,3,15,41,55,-14,45
FC Lugano,1414,6,12,6,14,32,43,-11,42
Grasshoppers,1414,7,10,7,15,42,50,-8,37
FC Thun,1414,8,9,5,18,42,61,-19,32
FC Sion,1414,9,6,9,17,42,55,-13,27
Young Boys,1415,1,21,6,5,69,36,33,69
FC Basel,1415,2,20,7,5,57,25,32,67
Lucerne,1415,3,14,7,11,45,46,-1,49
St Gallen,1415,4,14,4,14,42,52,-10,46
FC Zürich,1415,5,10,9,13,39,40,-1,39
FC Lugano,1415,6,10,6,16,32,48,-16,36
FC Thun,1415,7,10,5,17,43,59,-16,35
Grasshoppers,1415,8,9,6,17,41,49,-8,33
FC Sion,1415,9,7,8,17,39,52,-13,29
Young Boys,1416,1,22,8,2,70,33,37,74
FC Basel,1416,2,17,10,5,52,25,27,61
St Gallen,1416,3,16,3,13,45,52,-7,51
FC Zürich,1416,4,11,9,12,41,36,5,42
Lucerne,1416,5,11,9,12,39,43,-4,42
FC Lugano,1416,6,10,6,16,34,49,-15,36
Grasshoppers,1416,7,9,8,15,41,49,-8,35
FC Thun,1416,8,9,6,17,45,60,-15,33
FC Sion,1416,9,6,7,19,37,57,-20,25
Young Boys,1417,1,21,8,3,70,37,33,71
FC Basel,1417,2,17,8,7,52,24,28,59
St Gallen,1417,3,16,2,14,42,51,-9,50
Lucerne,1417,4,13,8,11,42,43,-1,47
FC Zürich,1417,5,12,9,11,45,35,10,45
FC Thun,1417,6,10,6,16,43,54,-11,36
Grasshoppers,1417,7,9,8,15,40,48,-8,35
FC Lugano,1417,8,9,6,17,29,51,-22,33
FC Sion,1417,9,5,9,18,36,56,-20,24
Young Boys,1418,1,22,6,4,71,33,38,72
FC Basel,1418,2,17,9,6,53,25,28,60
Lucerne,1418,3,13,8,11,41,44,-3,47
St Gallen,1418,4,15,2,15,41,54,-13,47
FC Zürich,1418,5,9,12,11,41,38,3,39
Grasshoppers,1418,6,11,6,15,44,50,-6,39
FC Lugano,1418,7,10,6,16,31,46,-15,36
FC Sion,1418,8,8,7,17,43,55,-12,31
FC Thun,1418,9,8,6,18,42,62,-20,30
Young Boys,1419,1,22,8,2,78,35,43,74
FC Basel,1419,2,17,8,7,54,29,25,59
St Gallen,1419,3,14,3,15,43,55,-12,45
FC Zürich,1419,4,11,11,10,41,35,6,44
Lucerne,1419,5,12,8,12,40,45,-5,44
FC Lugano,1419,6,11,7,14,33,45,-12,40
Grasshoppers,1419,7,8,7,17,40,56,-16,31
FC Thun,1419,8,8,7,17,42,60,-18,31
FC Sion,1419,9,7,9,16,44,55,-11,30
Young Boys,1420,1,20,9,3,72,36,36,69
FC Basel,1420,2,17,10,5,55,27,28,61
St Gallen,1420,3,15,3,14,44,53,-9,48
Lucerne,1420,4,13,7,12,44,45,-1,46
FC Zürich,1420,5,9,11,12,38,37,1,38
Grasshoppers,1420,6,10,7,15,43,52,-9,37
FC Lugano,1420,7,10,7,15,29,44,-15,37
FC Thun,1420,8,10,6,16,45,59,-14,36
FC Sion,1420,9,6,8,18,38,55,-17,26
Young Boys,1421,1,20,8,4,69,37,32,68
FC Basel,1421,2,19,7,6,59,26,33,64
Lucerne,1421,3,13,9,10,48,46,2,48
FC Zürich,1421,4,12,10,10,44,34,10,46
St Gallen,1421,5,14,2,16,40,60,-20,44
Grasshoppers,1421,6,11,6,15,44,51,-7,39
FC Lugano,1421,7,10,8,14,34,45,-11,38
FC Thun,1421,8,8,6,18,42,62,-20,30
FC Sion,1421,9,5,8,19,35,54,-19,23
Young Boys,1422,1,22,6,4,72,37,35,72
FC Basel,1422,2,18,9,5,56,24,32,63
Lucerne,1422,3,13,9,10,40,42,-2,48
St Gallen,1422,4,13,5,14,41,54,-13,44
FC Zürich,1422,5,11,9,12,43,40,3,42
FC Thun,1422,6,10,7,15,47,58,-11,37
FC Lugano,1422,7,10,5,17,33,51,-18,35
Grasshoppers,1422,8,8,8,16,41,51,-10,32
FC Sion,1422,9,6,8,18,40,56,-16,26
Young Boys,1423,1,20,7,5,67,34,33,67
FC Basel,1423,2,18,8,6,55,24,31,62
St Gallen,1423,3,15,2,15,43,54,-11,47
Lucerne,1423,4,12,7,13,40,45,-5,43
FC Zürich,1423,5,10,11,11,41,37,4,41
FC Lugano,1423,6,12,5,15,31,45,-14,41
Grasshoppers,1423,7,9,7,16,39,49,-10,34
FC Thun,1423,8,9,7,16,42,59,-17,34
FC Sion,1423,9,7,10,15,40,51,-11,31
Young Boys,1424,1,21,7,4,69,35,34,70
FC Basel,1424,2,19,8,5,56,25,31,65
Lucerne,1424,3,12,8,12,40,45,-5,44
St Gallen,1424,4,14,2,16,42,56,-14,44
FC Zürich,1424,5,10,10,12,41,40,1,40
FC Lugano,1424,6,11,5,16,36,48,-12,38
FC Thun,1424,7,10,5,17,44,62,-18,35
FC Sion,1424,8,9,7,16,46,52,-6,34
Grasshoppers,1424,9,9,6,17,43,54,-11,33
Young Boys,1425,1,23,7,2,76,32,44,76
FC Basel,1425,2,17,7,8,52,29,23,58
Lucerne,1425,3,12,8,12,40,44,-4,44
St Gallen,1425,4,14,2,16,41,56,-15,44
FC Zürich,1425,5,11,10,11,42,36,6,43
FC Lugano,1425,6,10,8,14,31,45,-14,38
FC Thun,1425,7,10,6,16,45,58,-13,36
Grasshoppers,1425,8,8,8,16,37,50,-13,32
FC Sion,1425,9,7,8,17,42,56,-14,29
Young Boys,1426,1,21,7,4,74,36,38,70
FC Basel,1426,2,19,8,5,55,24,31,65
Lucerne,1426,3,12,8,12,40,47,-7,44
St Gallen,1426,4,14,2,16,42,56,-14,44
FC Lugano,1426,5,12,5,15,38,48,-10,41
FC Zürich,1426,6,10,9,13,39,39,0,39
Grasshoppers,1426,7,10,8,14,45,48,-3,38
FC Thun,1426,8,10,6,16,45,58,-13,36
FC Sion,1426,9,6,7,19,38,60,-22,25
Young Boys,1427,1,23,7,2,78,33,45,76
FC Basel,1427,2,18,9,5,60,28,32,63
St Gallen,1427,3,15,3,14,43,54,-11,48
Lucerne,1427,4,12,8,12,42,46,-4,44
FC Zürich,1427,5,10,9,13,38,42,-4,39
FC Lugano,1427,6,10,6,16,31,50,-19,36
Grasshoppers,1427,7,9,8,15,42,50,-8,35
FC Thun,1427,8,9,6,17,42,58,-16,33
FC Sion,1427,9,6,8,18,43,58,-15,26
Young Boys,1428,1,21,6,5,74,37,37,69
FC Basel,1428,2,18,8,6,59,29,30,62
Lucerne,1428,3,14,8,10,43,43,0,50
St Gallen,1428,4,14,3,15,44,55,-11,45
FC Zürich,1428,5,10,10,12,39,35,4,40
FC Lugano,1428,6,11,7,14,29,42,-13,40
FC Thun,1428,7,10,5,17,44,62,-18,35
Grasshoppers,1428,8,9,7,16,42,51,-9,34
FC Sion,1428,9,6,8,18,39,59,-20,26
Young Boys,1429,1,22,7,3,76,38,38,73
FC Basel,1429,2,18,7,7,56,25,31,61
Lucerne,1429,3,13,8,11,45,45,0,47
St Gallen,1429,4,14,5,13,42,52,-10,47
FC Zürich,1429,5,12,10,10,45,36,9,46
FC Lugano,1429,6,9,7,16,29,50,-21,34
Grasshoppers,1429,7,9,6,17,38,51,-13,33
FC Thun,1429,8,9,5,18,41,61,-20,32
FC Sion,1429,9,6,9,17,40,54,-14,27
Young Boys,1430,1,21,7,4,73,36,37,70
FC Basel,1430,2,18,8,6,57,26,31,62
Lucerne,1430,3,12,10,10,40,46,-6,46
St Gallen,1430,4,14,3,15,43,57,-14,45
FC Zürich,1430,5,10,10,12,41,40,1,40
Grasshoppers,1430,6,10,7,15,40,46,-6,37
FC Lugano,1430,7,10,7,15,31,46,-15,37
FC Thun,1430,8,9,5,18,44,60,-16,32
FC Sion,1430,9,8,7,17,41,53,-12,31
Young Boys,1431,1,21,8,3,66,33,33,71
FC Basel,1431,2,18,8,6,56,25,31,62
St Gallen,1431,3,15,3,14,49,55,-6,48
Lucerne,1431,4,13,8,11,42,46,-4,47
FC Lugano,1431,5,11,5,16,31,46,-15,38
FC Zürich,1431,6,9,10,13,38,39,-1,37
FC Thun,1431,7,10,6,16,44,57,-13,36
Grasshoppers,1431,8,9,7,16,38,49,-11,34
FC Sion,1431,9,5,11,16,40,54,-14,26
Young Boys,1432,1,21,6,5,70,38,32,69
FC Basel,1432,2,18,7,7,55,27,28,61
FC Zürich,1432,3,13,9,10,43,34,9,48
Lucerne,1432,4,12,9,11,40,43,-3,45
St Gallen,1432,5,14,3,15,42,55,-13,45
FC Thun,1432,6,11,5,16,45,57,-12,38
Grasshoppers,1432,7,10,7,15,44,48,-4,37
FC Lugano,1432,8,9,6,17,28,49,-21,33
FC Sion,1432,9,6,8,18,41,57,-16,26
Young Boys,1433,1,22,8,2,82,38,44,74
FC Basel,1433,2,18,8,6,61,32,29,62
St Gallen,1433,3,14,3,15,46,56,-10,45
FC Zürich,1433,4,11,11,10,45,34,11,44
Lucerne,1433,5,12,8,12,42,47,-5,44
FC Lugano,1433,6,10,7,15,32,50,-18,37
Grasshoppers,1433,7,10,6,16,40,50,-10,36
FC Thun,1433,8,9,6,17,42,61,-19,33
FC Sion,1433,9,5,9,18,40,62,-22,24
Young Boys,1434,1,22,7,3,72,36,36,73
FC Basel,1434,2,17,8,7,51,26,25,59
Lucerne,1434,3,13,7,12,41,43,-2,46
St Gallen,1434,4,14,4,14,42,52,-10,46
FC Zürich,1434,5,11,10,11,43,38,5,43
FC Lugano,1434,6,10,7,15,31,46,-15,37
FC Thun,1434,7,10,5,17,46,61,-15,35
FC Sion,1434,8,8,8,16,48,55,-7,32
Grasshoppers,1434,9,8,6,18,37,54,-17,30
Young Boys,1435,1,22,6,4,77,39,38,72
FC Basel,1435,2,16,7,9,50,30,20,55
Lucerne,1435,3,13,9,10,44,42,2,48
St Gallen,1435,4,15,3,14,43,53,-10,48
FC Zürich,1435,5,11,10,11,41,36,5,43
FC Thun,1435,6,11,5,16,44,54,-10,38
FC Lugano,1435,7,11,5,16,30,48,-18,38
Grasshoppers,1435,8,8,7,17,40,55,-15,31
FC Sion,1435,9,7,8,17,44,56,-12,29
Young Boys,1436,1,22,8,2,76,33,43,74
FC Basel,1436,2,18,8,6,54,24,30,62
St Gallen,1436,3,15,3,14,46,57,-11,48
Lucerne,1436,4,12,8,12,49,54,-5,44
FC Zürich,1436,5,11,10,11,43,36,7,43
Grasshoppers,1436,6,9,8,15,42,54,-12,35
FC Thun,1436,7,9,7,16,42,59,-17,34
FC Lugano,1436,8,9,7,16,31,49,-18,34
FC Sion,1436,9,6,7,19,41,58,-17,25
Young Boys,1437,1,23,7,2,71,32,39,76
FC Basel,1437,2,19,7,6,56,24,32,64
Lucerne,1437,3,13,8,11,41,43,-2,47
St Gallen,1437,4,14,2,16,41,57,-16,44
FC Lugano,1437,5,11,5,16,31,45,-14,38
FC Zürich,1437,6,9,10,13,37,37,0,37
FC Thun,1437,7,10,5,17,44,60,-16,35
Grasshoppers,1437,8,9,7,16,41,49,-8,34
FC Sion,1437,9,6,9,17,41,56,-15,27
Young Boys,1438,1,23,6,3,73,35,38,75
FC Basel,1438,2,17,8,7,54,26,28,59
Lucerne,1438,3,12,9,11,42,45,-3,45
FC Zürich,1438,4,11,11,10,42,35,7,44
St Gallen,1438,5,13,5,14,41,53,-12,44
FC Lugano,1438,6,10,8,14,32,46,-14,38
Grasshoppers,1438,7,9,7,16,45,52,-7,34
FC Thun,1438,8,9,6,17,47,65,-18,33
FC Sion,1438,9,6,8,18,38,57,-19,26
Young Boys,1439,1,22,8,2,73,32,41,74
FC Basel,1439,2,18,8,6,60,30,30,62
Lucerne,1439,3,13,7,12,43,45,-2,46
St Gallen,1439,4,14,3,15,47,61,-14,45
FC Zürich,1439,5,10,9,13,41,39,2,39
FC Thun,1439,6,11,5,16,47,59,-12,38
FC Lugano,1439,7,11,5,16,33,49,-16,38
Grasshoppers,1439,8,10,7,15,41,47,-6,37
FC Sion,1439,9,5,8,19,39,62,-23,23
Young Boys,1440,1,21,9,2,70,32,38,72
FC Basel,1440,2,17,9,6,52,26,26,60
St Gallen,1440,3,16,2,14,46,54,-8,50
Lucerne,1440,4,13,8,11,45,46,-1,47
FC Zürich,1440,5,11,10,11,41,34,7,43
Grasshoppers,1440,6,10,7,15,42,47,-5,37
FC Lugano,1440,7,9,6,17,29,51,-22,33
FC Thun,1440,8,9,5,18,39,58,-19,32
FC Sion,1440,9,6,8,18,38,54,-16,26
Young Boys,1441,1,24,6,2,76,33,43,78
FC Basel,1441,2,18,8,6,58,25,33,62
St Gallen,1441,3,13,6,13,43,54,-11,45
Lucerne,1441,4,12,8,12,41,48,-7,44
FC Lugano,1441,5,11,6,15,33,48,-15,39
FC Thun,1441,6,11,5,16,47,60,-13,38
FC Zürich,1441,7,9,10,13,39,40,-1,37
Grasshoppers,1441,8,8,6,18,39,52,-13,30
FC Sion,1441,9,6,9,17,39,55,-16,27
Young Boys,1442,1,22,7,3,73,35,38,73
FC Basel,1442,2,19,8,5,55,23,32,65
FC Zürich,1442,3,11,11,10,46,36,10,44
St Gallen,1442,4,14,2,16,40,57,-17,44
Lucerne,1442,5,12,7,13,40,46,-6,43
FC Lugano,1442,6,11,5,16,32,47,-15,38
Grasshoppers,1442,7,10,7,15,46,50,-4,37
FC Thun,1442,8,8,7,17,41,63,-22,31
FC Sion,1442,9,6,8,18,43,59,-16,26
Young Boys,1443,1,22,7,3,72,31,41,73
FC Basel,1443,2,17,9,6,53,27,26,60
St Gallen,1443,3,15,2,15,43,57,-14,47
FC Zürich,1443,4,11,11,10,45,37,8,44
Lucerne,1443,5,12,8,12,43,48,-5,44
FC Lugano,1443,6,10,6,16,33,49,-16,36
Grasshoppers,1443,7,9,6,17,41,55,-14,33
FC Thun,1443,8,9,6,17,44,60,-16,33
FC Sion,1443,9,8,7,17,42,52,-10,31
Young Boys,1444,1,21,7,4,73,37,36,70
FC Basel,1444,2,18,8,6,61,29,32,62
Lucerne,1444,3,14,8,10,44,42,2,50
St Gallen,1444,4,14,3,15,43,55,-12,45
FC Zürich,1444,5,10,10,12,40,41,-1,40
FC Thun,1444,6,11,5,16,45,58,-13,38
FC Lugano,1444,7,11,5,16,32,47,-15,38
Grasshoppers,1444,8,10,6,16,43,49,-6,36
FC Sion,1444,9,5,8,19,38,61,-23,23
Young Boys,1445,1,21,7,4,73,35,38,70
FC Basel,1445,2,17,9,6,54,27,27,60
Lucerne,1445,3,12,10,10,44,46,-2,46
St Gallen,1445,4,14,4,14,41,52,-11,46
FC Zürich,1445,5,11,9,12,43,38,5,42
Grasshoppers,1445,6,9,8,15,42,51,-9,35
FC Thun,1445,7,9,7,16,45,59,-14,34
FC Lugano,1445,8,9,6,17,29,53,-24,33
FC Sion,1445,9,8,8,16,43,53,-10,32
Young Boys,1446,1,21,7,4,70,36,34,70
FC Basel,1446,2,17,9,6,55,26,29,60
Lucerne,1446,3,14,9,9,45,40,5,51
FC Zürich,1446,4,11,11,10,41,34,7,44
St Gallen,1446,5,13,4,15,40,56,-16,43
Grasshoppers,1446,6,10,8,14,44,46,-2,38
FC Lugano,1446,7,9,7,16,28,47,-19,34
FC Thun,1446,8,9,5,18,39,61,-22,32
FC Sion,1446,9,6,8,18,42,58,-16,26
Young Boys,1447,1,21,8,3,72,36,36,71
FC Basel,1447,2,18,8,6,56,28,28,62
Lucerne,1447,3,12,9,11,42,43,-1,45
FC Zürich,1447,4,11,10,11,42,38,4,43
St Gallen,1447,5,13,4,15,40,53,-13,43
FC Thun,1447,6,10,7,15,48,60,-12,37
Grasshoppers,1447,7,9,8,15,43,50,-7,35
FC Lugano,1447,8,9,7,16,29,49,-20,34
FC Sion,1447,9,6,9,17,42,57,-15,27
Young Boys,1448,1,21,7,4,69,34,35,70
FC Basel,1448,2,19,7,6,52,26,26,64
FC Zürich,1448,3,12,9,11,44,34,10,45
Lucerne,1448,4,12,9,11,41,43,-2,45
St Gallen,1448,5,14,2,16,43,56,-13,44
FC Thun,1448,6,10,6,16,43,56,-13,36
Grasshoppers,1448,7,9,8,15,40,48,-8,35
FC Lugano,1448,8,10,5,17,29,49,-20,35
FC Sion,1448,9,6,9,17,40,55,-15,27
Young Boys,1449,1,21,7,4,69,35,34,70
FC Basel,1449,2,18,8,6,57,25,32,62
Lucerne,1449,3,12,8,12,38,43,-5,44
St Gallen,1449,4,14,2,16,43,57,-14,44
FC Lugano,1449,5,11,6,15,33,47,-14,39
FC Zürich,1449,6,9,11,12,38,40,-2,38
FC Thun,1449,7,10,6,16,49,59,-10,36
Grasshoppers,1449,8,9,8,15,44,52,-8,35
FC Sion,1449,9,8,8,16,39,52,-13,32
Young Boys,1450,1,22,7,3,73,34,39,73
FC Basel,1450,2,19,7,6,58,29,29,64
St Gallen,1450,3,15,2,15,46,55,-9,47
Lucerne,1450,4,13,7,12,42,44,-2,46
FC Zürich,1450,5,11,9,12,46,36,10,42
Grasshoppers,1450,6,10,7,15,43,51,-8,37
FC Thun,1450,7,10,5,17,44,59,-15,35
FC Lugano,1450,8,10,5,17,30,50,-20,35
FC Sion,1450,9,6,7,19,37,61,-24,25
Young Boys,1451,1,22,7,3,73,34,39,73
FC Basel,1451,2,19,7,6,56,26,30,64
FC Zürich,1451,3,12,9,11,42,35,7,45
St Gallen,1451,4,14,3,15,42,59,-17,45
Lucerne,1451,5,11,9,12,42,47,-5,42
FC Lugano,1451,6,11,5,16,36,48,-12,38
FC Thun,1451,7,11,5,16,45,58,-13,38
Grasshoppers,1451,8,8,8,16,38,50,-12,32
FC Sion,1451,9,5,9,18,37,54,-17,24
Young Boys,1452,1,23,6,3,72,32,40,75
FC Basel,1452,2,15,9,8,51,29,22,54
Lucerne,1452,3,14,9,9,44,42,2,51
FC Zürich,1452,4,12,10,10,44,36,8,46
St Gallen,1452,5,13,3,16,40,55,-15,42
FC Lugano,1452,6,10,7,15,34,48,-14,37
FC Thun,1452,7,10,6,16,47,59,-12,36
Grasshoppers,1452,8,9,7,16,42,56,-14,34
FC Sion,1452,9,6,7,19,37,54,-17,25
Young Boys,1453,1,21,7,4,72,34,38,70
FC Basel,1453,2,16,10,6,49,24,25,58
St Gallen,1453,3,15,3,14,45,52,-7,48
Lucerne,1453,4,13,8,11,41,45,-4,47
FC Zürich,1453,5,10,10,12,41,36,5,40
FC Lugano,1453,6,11,5,16,30,47,-17,38
Grasshoppers,1453,7,9,8,15,39,48,-9,35
FC Thun,1453,8,9,6,17,42,61,-19,33
FC Sion,1453,9,8,7,17,44,56,-12,31
Young Boys,1454,1,21,7,4,69,35,34,70
FC Basel,1454,2,17,9,6,55,28,27,60
Lucerne,1454,3,13,9,10,45,42,3,48
St Gallen,1454,4,14,5,13,44,54,-10,47
FC Zürich,1454,5,9,13,10,39,35,4,40
Grasshoppers,1454,6,10,6,16,42,52,-10,36
FC Lugano,1454,7,9,7,16,30,48,-18,34
FC Sion,1454,8,7,10,15,43,52,-9,31
FC Thun,1454,9,8,6,18,39,60,-21,30
Young Boys,1455,1,20,8,4,69,33,36,68
FC Basel,1455,2,18,8,6,55,26,29,62
St Gallen,1455,3,16,2,14,45,51,-6,50
Lucerne,1455,4,13,7,12,45,45,0,46
FC Zürich,1455,5,11,9,12,41,37,4,42
FC Lugano,1455,6,10,6,16,31,48,-17,36
Grasshoppers,1455,7,9,7,16,37,52,-15,34
FC Sion,1455,8,8,8,16,39,50,-11,32
FC Thun,1455,9,9,5,18,42,62,-20,32
Young Boys,1456,1,21,8,3,70,34,36,71
FC Basel,1456,2,18,9,5,54,24,30,63
St Gallen,1456,3,14,5,13,43,53,-10,47
Lucerne,1456,4,12,9,11,39,43,-4,45
FC Zürich,1456,5,10,11,11,41,35,6,41
FC Lugano,1456,6,9,8,15,31,48,-17,35
FC Thun,1456,7,9,6,17,41,61,-20,33
Grasshoppers,1456,8,8,8,16,39,49,-10,32
FC Sion,1456,9,6,10,16,41,52,-11,28
Young Boys,1457,1,20,9,3,68,34,34,69
FC Basel,1457,2,18,7,7,55,27,28,61
Lucerne,1457,3,15,7,10,46,42,4,52
St Gallen,1457,4,14,2,16,42,59,-17,44
FC Zürich,1457,5,10,12,10,42,36,6,42
FC Thun,1457,6,10,6,16,43,56,-13,36
Grasshoppers,1457,7,9,7,16,38,49,-11,34
FC Lugano,1457,8,9,7,16,27,45,-18,34
FC Sion,1457,9,6,9,17,42,55,-13,27
Young Boys,1458,1,22,8,2,74,36,38,74
FC Basel,1458,2,17,8,7,54,27,27,59
St Gallen,1458,3,15,3,14,46,54,-8,48
FC Zürich,1458,4,11,10,11,42,36,6,43
Lucerne,1458,5,12,7,13,42,50,-8,43
FC Lugano,1458,6,10,7,15,34,48,-14,37
Grasshoppers,1458,7,9,8,15,44,50,-6,35
FC Thun,1458,8,10,5,17,44,62,-18,35
FC Sion,1458,9,6,8,18,38,55,-17,26
Young Boys,1459,1,22,7,3,74,36,38,73
FC Basel,1459,2,18,9,5,52,24,28,63
FC Zürich,1459,3,11,11,10,40,34,6,44
Lucerne,1459,4,12,8,12,42,45,-3,44
St Gallen,1459,5,13,4,15,41,55,-14,43
Grasshoppers,1459,6,9,7,16,45,53,-8,34
FC Thun,1459,7,9,7,16,43,58,-15,34
FC Lugano,1459,8,9,7,16,29,49,-20,34
FC Sion,1459,9,7,8,17,43,55,-12,29
Young Boys,1460,1,21,8,3,69,34,35,71
FC Basel,1460,2,16,9,7,50,26,24,57
St Gallen,1460,3,15,2,15,44,56,-12,47
FC Zürich,1460,4,11,10,11,46,39,7,43
Lucerne,1460,5,11,10,11,42,46,-4,43
FC Thun,1460,6,11,6,15,48,57,-9,39
FC Lugano,1460,7,11,5,16,34,50,-16,38
Grasshoppers,1460,8,8,9,15,38,49,-11,33
FC Sion,1460,9,6,9,17,39,53,-14,27
Young Boys,1461,1,23,6,3,76,35,41,75
FC Basel,1461,2,18,7,7,52,28,24,61
St Gallen,1461,3,14,3,15,41,54,-13,45
Lucerne,1461,4,11,10,11,41,44,-3,43
FC Zürich,1461,5,10,9,13,39,39,0,39
FC Lugano,1461,6,11,6,15,34,48,-14,39
Grasshoppers,1461,7,10,7,15,43,50,-7,37
FC Thun,1461,8,10,5,17,46,60,-14,35
FC Sion,1461,9,7,7,18,41,55,-14,28
Young Boys,1462,1,22,7,3,75,36,39,73
FC Basel,1462,2,16,9,7,54,29,25,57
St Gallen,1462,3,16,2,14,45,54,-9,50
Lucerne,1462,4,13,8,11,43,45,-2,47
FC Zürich,1462,5,10,11,11,41,38,3,41
FC Lugano,1462,6,11,7,14,33,44,-11,40
Grasshoppers,1462,7,10,6,16,44,50,-6,36
FC Thun,1462,8,8,7,17,43,61,-18,31
FC Sion,1462,9,6,7,19,39,60,-21,25
Young Boys,1463,1,22,6,4,69,34,35,72
FC Basel,1463,2,18,8,6,58,30,28,62
St Gallen,1463,3,15,4,13,49,55,-6,49
Lucerne,1463,4,13,8,11,42,43,-1,47
FC Zürich,1463,5,10,10,12,41,36,5,40
FC Thun,1463,6,10,6,16,45,58,-13,36
FC Lugano,1463,7,10,5,17,28,46,-18,35
Grasshoppers,1463,8,9,6,17,42,54,-12,33
FC Sion,1463,9,7,7,18,39,57,-18,28
Young Boys,1464,1,22,6,4,77,35,42,72
FC Basel,1464,2,18,8,6,54,25,29,62
St Gallen,1464,3,14,4,14,42,53,-11,46
FC Zürich,1464,4,11,11,10,46,37,9,44
Lucerne,1464,5,12,8,12,41,45,-4,44
Grasshoppers,1464,6,11,6,15,42,52,-10,39
FC Lugano,1464,7,11,5,16,31,51,-20,38
FC Thun,1464,8,9,6,17,41,58,-17,33
FC Sion,1464,9,5,8,19,40,58,-18,23
Young Boys,1465,1,22,6,4,73,38,35,72
FC Basel,1465,2,18,8,6,57,28,29,62
Lucerne,1465,3,14,7,11,46,43,3,49
St Gallen,1465,4,15,2,15,43,55,-12,47
FC Zürich,1465,5,12,10,10,43,36,7,46
Grasshoppers,1465,6,9,6,17,43,54,-11,33
FC Thun,1465,7,9,5,18,42,60,-18,32
FC Lugano,1465,8,9,5,18,32,53,-21,32
FC Sion,1465,9,8,7,17,38,50,-12,31
Young Boys,1466,1,23,6,3,76,31,45,75
FC Basel,1466,2,18,7,7,55,28,27,61
Lucerne,1466,3,13,8,11,43,42,1,47
St Gallen,1466,4,14,3,15,42,57,-15,45
FC Zürich,1466,5,10,9,13,40,40,0,39
FC Lugano,1466,6,11,5,16,33,50,-17,38
FC Thun,1466,7,10,6,16,47,59,-12,36
Grasshoppers,1466,8,9,8,15,41,52,-11,35
FC Sion,1466,9,6,8,18,36,54,-18,26
Young Boys,1467,1,23,7,2,74,31,43,76
FC Basel,1467,2,18,8,6,52,26,26,62
St Gallen,1467,3,14,5,13,47,57,-10,47
Lucerne,1467,4,11,11,10,42,44,-2,44
FC Zürich,1467,5,10,10,12,42,37,5,40
FC Lugano,1467,6,10,7,15,34,51,-17,37
Grasshoppers,1467,7,9,8,15,39,48,-9,35
FC Thun,1467,8,9,7,16,40,55,-15,34
FC Sion,1467,9,5,7,20,39,60,-21,22
Young Boys,1468,1,22,6,4,70,38,32,72
FC Basel,1468,2,18,7,7,58,27,31,61
Lucerne,1468,3,14,7,11,48,45,3,49
FC Zürich,1468,4,12,10,10,44,36,8,46
St Gallen,1468,5,13,2,17,42,60,-18,41
FC Lugano,1468,6,11,5,16,30,45,-15,38
Grasshoppers,1468,7,9,6,17,42,53,-11,33
FC Thun,1468,8,9,6,17,45,64,-19,33
FC Sion,1468,9,8,7,17,43,54,-11,31
Young Boys,1469,1,22,6,4,70,34,36,72
FC Basel,1469,2,16,8,8,48,25,23,56
St Gallen,1469,3,15,2,15,48,56,-8,47
Lucerne,1469,4,13,7,12,46,48,-2,46
FC Zürich,1469,5,11,10,11,42,36,6,43
Grasshoppers,1469,6,11,6,15,42,49,-7,39
FC Lugano,1469,7,10,5,17,29,51,-22,35
FC Sion,1469,8,8,8,16,45,55,-10,32
FC Thun,1469,9,8,8,16,42,58,-16,32
Young Boys,1470,1,22,7,3,72,33,39,73
FC Basel,1470,2,17,9,6,55,28,27,60
Lucerne,1470,3,14,8,10,45,44,1,50
FC Zürich,1470,4,10,12,10,41,35,6,42
St Gallen,1470,5,13,2,17,40,57,-17,41
FC Lugano,1470,6,11,6,15,30,43,-13,39
FC Thun,1470,7,10,7,15,44,57,-13,37
Grasshoppers,1470,8,9,6,17,40,53,-13,33
FC Sion,1470,9,6,7,19,40,57,-17,25
Young Boys,1471,1,23,7,2,74,33,41,76
FC Basel,1471,2,18,8,6,57,26,31,62
Lucerne,1471,3,13,8,11,46,48,-2,47
FC Zürich,1471,4,12,10,10,46,36,10,46
St Gallen,1471,5,14,2,16,40,56,-16,44
Grasshoppers,1471,6,10,6,16,42,50,-8,36
FC Lugano,1471,7,9,6,17,30,51,-21,33
FC Thun,1471,8,8,6,18,41,62,-21,30
FC Sion,1471,9,6,9,17,38,52,-14,27
Young Boys,1472,1,23,7,2,77,33,44,76
FC Basel,1472,2,17,8,7,56,30,26,59
St Gallen,1472,3,15,3,14,45,54,-9,48
Lucerne,1472,4,11,10,11,42,49,-7,43
FC Zürich,1472,5,9,10,13,42,41,1,37
Grasshoppers,1472,6,10,7,15,42,49,-7,37
FC Lugano,1472,7,10,7,15,32,50,-18,37
FC Thun,1472,8,10,5,17,46,61,-15,35
FC Sion,1472,9,7,7,18,41,56,-15,28
Young Boys,1473,1,22,7,3,73,34,39,73
FC Basel,1473,2,15,8,9,48,30,18,53
St Gallen,1473,3,15,3,14,44,56,-12,48
Lucerne,1473,4,12,10,10,44,46,-2,46
FC Zürich,1473,5,11,9,12,42,38,4,42
FC Thun,1473,6,11,5,16,41,54,-13,38
FC Lugano,1473,7,11,5,16,34,48,-14,38
Grasshoppers,1473,8,9,6,17,40,51,-11,33
FC Sion,1473,9,8,7,17,44,53,-9,31
Young Boys,1474,1,22,7,3,76,40,36,73
FC Basel,1474,2,17,8,7,56,29,27,59
St Gallen,1474,3,16,3,13,45,50,-5,51
Lucerne,1474,4,12,7,13,41,46,-5,43
FC Zürich,1474,5,10,10,12,41,38,3,40
Grasshoppers,1474,6,10,6,16,41,49,-8,36
FC Lugano,1474,7,10,6,16,31,50,-19,36
FC Thun,1474,8,10,5,17,42,61,-19,35
FC Sion,1474,9,7,8,17,43,53,-10,29
Young Boys,1475,1,21,7,4,69,37,32,70
FC Basel,1475,2,19,8,5,56,23,33,65
St Gallen,1475,3,16,3,13,44,51,-7,51
Lucerne,1475,4,13,7,12,43,43,0,46
FC Zürich,1475,5,10,10,12,39,38,1,40
Grasshoppers,1475,6,10,7,15,42,47,-5,37
FC Thun,1475,7,10,6,16,44,59,-15,36
FC Lugano,1475,8,9,6,17,29,50,-21,33
FC Sion,1475,9,5,8,19,36,54,-18,23
Young Boys,1476,1,23,7,2,81,36,45,76
FC Basel,1476,2,15,10,7,53,31,22,55
St Gallen,1476,3,14,4,14,46,57,-11,46
Lucerne,1476,4,12,9,11,42,46,-4,45
FC Zürich,1476,5,11,9,12,42,37,5,42
FC Thun,1476,6,11,6,15,47,58,-11,39
FC Lugano,1476,7,10,6,16,32,50,-18,36
Grasshoppers,1476,8,9,6,17,41,51,-10,33
FC Sion,1476,9,6,9,17,39,57,-18,27
Young Boys,1477,1,22,8,2,75,34,41,74
FC Basel,1477,2,17,8,7,53,27,26,59
Lucerne,1477,3,13,8,11,40,42,-2,47
St Gallen,1477,4,14,2,16,41,55,-14,44
FC Zürich,1477,5,11,10,11,42,36,6,43
Grasshoppers,1477,6,10,8,14,40,46,-6,38
FC Lugano,1477,7,11,5,16,31,47,-16,38
FC Thun,1477,8,8,6,18,40,58,-18,30
FC Sion,1477,9,7,7,18,41,58,-17,28
Young Boys,1478,1,20,8,4,73,41,32,68
FC Basel,1478,2,19,7,6,53,24,29,64
Lucerne,1478,3,14,7,11,46,42,4,49
St Gallen,1478,4,13,3,16,39,56,-17,42
FC Zürich,1478,5,10,10,12,39,36,3,40
FC Lugano,1478,6,11,6,15,33,48,-15,39
FC Thun,1478,7,10,5,17,45,58,-13,35
Grasshoppers,1478,8,9,7,16,41,52,-11,34
FC Sion,1478,9,7,9,16,41,53,-12,30
Young Boys,1479,1,20,10,2,70,35,35,70
FC Basel,1479,2,19,8,5,58,27,31,65
Lucerne,1479,3,13,7,12,44,45,-1,46
St Gallen,1479,4,14,4,14,41,52,-11,46
FC Zürich,1479,5,11,9,12,47,40,7,42
FC Thun,1479,6,10,5,17,42,57,-15,35
Grasshoppers,1479,7,9,7,16,40,50,-10,34
FC Lugano,1479,8,9,7,16,32,51,-19,34
FC Sion,1479,9,6,9,17,42,59,-17,27
Young Boys,1480,1,22,6,4,78,37,41,72
FC Basel,1480,2,20,7,5,58,23,35,67
Lucerne,1480,3,14,7,11,45,45,0,49
St Gallen,1480,4,13,3,16,42,57,-15,42
FC Zürich,1480,5,10,9,13,39,37,2,39
FC Thun,1480,6,11,5,16,47,57,-10,38
Grasshoppers,1480,7,9,6,17,42,54,-12,33
FC Lugano,1480,8,9,6,17,29,55,-26,33
FC Sion,1480,9,8,7,17,45,60,-15,31
Young Boys,1481,1,22,6,4,71,38,33,72
FC Basel,1481,2,17,9,6,53,25,28,60
St Gallen,1481,3,15,3,14,44,54,-10,48
Lucerne,1481,4,12,10,10,39,40,-1,46
FC Zürich,1481,5,10,10,12,40,37,3,40
FC Thun,1481,6,11,6,15,46,56,-10,39
FC Lugano,1481,7,10,6,16,33,50,-17,36
Grasshoppers,1481,8,8,7,17,36,48,-12,31
FC Sion,1481,9,7,7,18,42,56,-14,28
Young Boys,1482,1,23,7,2,70,32,38,76
FC Basel,1482,2,15,10,7,49,28,21,55
Lucerne,1482,3,13,8,11,43,43,0,47
St Gallen,1482,4,14,3,15,46,58,-12,45
FC Zürich,1482,5,11,10,11,42,34,8,43
Grasshoppers,1482,6,10,6,16,39,47,-8,36
FC Lugano,1482,7,10,6,16,30,48,-18,36
FC Thun,1482,8,8,7,17,39,58,-19,31
FC Sion,1482,9,7,9,16,41,51,-10,30
Young Boys,1483,1,21,6,5,70,38,32,69
FC Basel,1483,2,18,7,7,55,27,28,61
Lucerne,1483,3,13,9,10,41,41,0,48
St Gallen,1483,4,15,3,14,47,56,-9,48
FC Lugano,1483,5,12,6,14,33,44,-11,42
FC Zürich,1483,6,10,10,12,39,34,5,40
FC Thun,1483,7,9,6,17,43,61,-18,33
Grasshoppers,1483,8,8,7,17,39,51,-12,31
FC Sion,1483,9,7,8,17,43,58,-15,29
Young Boys,1484,1,21,7,4,72,39,33,70
FC Basel,1484,2,18,8,6,57,26,31,62
St Gallen,1484,3,15,3,14,42,53,-11,48
Lucerne,1484,4,12,9,11,43,48,-5,45
FC Zürich,1484,5,10,9,13,39,37,2,39
FC Thun,1484,6,11,6,15,47,57,-10,39
Grasshoppers,1484,7,10,6,16,43,49,-6,36
FC Lugano,1484,8,9,7,16,29,48,-19,34
FC Sion,1484,9,7,7,18,42,57,-15,28
Young Boys,1485,1,20,7,5,70,39,31,67
FC Basel,1485,2,17,8,7,56,28,28,59
Lucerne,1485,3,13,8,11,43,42,1,47
St Gallen,1485,4,15,2,15,41,52,-11,47
FC Zürich,1485,5,10,9,13,41,40,1,39
FC Lugano,1485,6,11,5,16,31,51,-20,38
Grasshoppers,1485,7,9,9,14,42,49,-7,36
FC Thun,1485,8,10,6,16,50,62,-12,36
FC Sion,1485,9,8,8,16,44,55,-11,32
Young Boys,1486,1,22,8,2,75,32,43,74
FC Basel,1486,2,17,8,7,56,31,25,59
Lucerne,1486,3,13,9,10,45,43,2,48
St Gallen,1486,4,15,2,15,43,55,-12,47
FC Zürich,1486,5,12,9,11,42,36,6,45
FC Lugano,1486,6,10,6,16,31,48,-17,36
FC Thun,1486,7,10,5,17,41,57,-16,35
Grasshoppers,1486,8,9,7,16,39,49,-10,34
FC Sion,1486,9,5,8,19,36,57,-21,23
Young Boys,1487,1,21,8,3,69,33,36,71
FC Basel,1487,2,19,8,5,57,25,32,65
St Gallen,1487,3,15,2,15,45,57,-12,47
Lucerne,1487,4,12,8,12,44,45,-1,44
FC Lugano,1487,5,11,6,15,33,47,-14,39
FC Zürich,1487,6,9,11,12,39,39,0,38
FC Thun,1487,7,11,5,16,46,56,-10,38
Grasshoppers,1487,8,8,7,17,38,55,-17,31
FC Sion,1487,9,6,9,17,39,53,-14,27
Young Boys,1488,1,22,7,3,76,34,42,73
FC Basel,1488,2,19,7,6,56,28,28,64
Lucerne,1488,3,13,8,11,42,44,-2,47
St Gallen,1488,4,15,2,15,46,56,-10,47
FC Zürich,1488,5,11,10,11,42,37,5,43
FC Thun,1488,6,10,6,16,44,58,-14,36
FC Lugano,1488,7,9,6,17,30,51,-21,33
Grasshoppers,1488,8,8,7,17,40,51,-11,31
FC Sion,1488,9,7,7,18,39,56,-17,28
Young Boys,1489,1,22,7,3,75,37,38,73
FC Basel,1489,2,18,8,6,54,27,27,62
Lucerne,1489,3,14,8,10,42,40,2,50
St Gallen,1489,4,15,3,14,42,53,-11,48
FC Zürich,1489,5,10,9,13,40,39,1,39
FC Thun,1489,6,11,5,16,48,57,-9,38
FC Lugano,1489,7,10,5,17,30,48,-18,35
Grasshoppers,1489,8,8,6,18,40,53,-13,30
FC Sion,1489,9,7,7,18,39,56,-17,28
Young Boys,1490,1,21,7,4,69,36,33,70
FC Basel,1490,2,16,7,9,53,34,19,55
Lucerne,1490,3,16,7,9,50,41,9,55
St Gallen,1490,4,16,2,14,49,53,-4,50
FC Zürich,1490,5,11,10,11,41,36,5,43
FC Lugano,1490,6,11,5,16,33,51,-18,38
FC Thun,1490,7,9,6,17,41,60,-19,33
Grasshoppers,1490,8,8,8,16,40,50,-10,32
FC Sion,1490,9,5,10,17,38,53,-15,25
Young Boys,1491,1,22,7,3,75,36,39,73
FC Basel,1491,2,17,9,6,52,26,26,60
St Gallen,1491,3,15,3,14,42,55,-13,48
Lucerne,1491,4,13,8,11,45,45,0,47
FC Zürich,1491,5,11,9,12,40,40,0,42
FC Thun,1491,6,11,5,16,46,57,-11,38
FC Lugano,1491,7,10,5,17,34,49,-15,35
Grasshoppers,1491,8,9,7,16,42,52,-10,34
FC Sion,1491,9,6,7,19,41,57,-16,25
Young Boys,1492,1,21,8,3,74,35,39,71
FC Basel,1492,2,17,9,6,50,25,25,60
Lucerne,1492,3,13,9,10,45,43,2,48
St Gallen,1492,4,14,5,13,42,52,-10,47
FC Zürich,1492,5,9,10,13,37,37,0,37
Grasshoppers,1492,6,10,6,16,40,52,-12,36
FC Thun,1492,7,10,5,17,44,58,-14,35
FC Lugano,1492,8,10,5,17,32,51,-19,35
FC Sion,1492,9,7,9,16,40,51,-11,30
Young Boys,1493,1,22,7,3,73,34,39,73
FC Basel,1493,2,17,9,6,51,24,27,60
St Gallen,1493,3,14,4,14,46,58,-12,46
Lucerne,1493,4,12,9,11,42,46,-4,45
FC Zürich,1493,5,10,10,12,42,38,4,40
Grasshoppers,1493,6,11,6,15,46,52,-6,39
FC Lugano,1493,7,10,6,16,33,51,-18,36
FC Thun,1493,8,10,5,17,46,60,-14,35
FC Sion,1493,9,6,8,18,42,58,-16,26
Young Boys,1494,1,23,6,3,80,36,44,75
FC Basel,1494,2,18,9,5,57,24,33,63
Lucerne,1494,3,13,8,11,42,42,0,47
FC Zürich,1494,4,12,10,10,45,34,11,46
St Gallen,1494,5,14,4,14,42,54,-12,46
FC Thun,1494,6,9,6,17,41,61,-20,33
FC Lugano,1494,7,9,6,17,32,53,-21,33
Grasshoppers,1494,8,8,8,16,39,53,-14,32
FC Sion,1494,9,5,9,18,40,61,-21,24
Young Boys,1495,1,22,7,3,78,31,47,73
FC Basel,1495,2,17,8,7,52,28,24,59
Lucerne,1495,3,14,8,10,46,42,4,50
St Gallen,1495,4,15,2,15,45,56,-11,47
FC Zürich,1495,5,10,10,12,41,39,2,40
FC Thun,1495,6,10,6,16,50,62,-12,36
FC Lugano,1495,7,9,6,17,29,55,-26,33
Grasshoppers,1495,8,8,8,16,38,49,-11,32
FC Sion,1495,9,8,7,17,44,61,-17,31
Young Boys,1496,1,22,7,3,71,34,37,73
FC Basel,1496,2,17,9,6,58,29,29,60
St Gallen,1496,3,15,3,14,48,57,-9,48
Lucerne,1496,4,12,9,11,46,49,-3,45
FC Zürich,1496,5,9,11,12,38,38,0,38
FC Thun,1496,6,11,5,16,46,61,-15,38
FC Lugano,1496,7,10,6,16,30,47,-17,36
Grasshoppers,1496,8,9,8,15,43,51,-8,35
FC Sion,1496,9,6,8,18,41,55,-14,26
Young Boys,1497,1,22,6,4,76,40,36,72
FC Basel,1497,2,19,7,6,57,26,31,64
Lucerne,1497,3,13,7,12,43,47,-4,46
St Gallen,1497,4,14,2,16,41,55,-14,44
FC Lugano,1497,5,12,6,14,36,47,-11,42
Grasshoppers,1497,6,11,6,15,45,47,-2,39
FC Zürich,1497,7,9,11,12,39,39,0,38
FC Thun,1497,8,9,5,18,41,61,-20,32
FC Sion,1497,9,6,8,18,39,55,-16,26
Young Boys,1498,1,20,9,3,69,35,34,69
FC Basel,1498,2,18,9,5,51,22,29,63
Lucerne,1498,3,12,9,11,43,43,0,45
FC Zürich,1498,4,11,10,11,39,36,3,43
St Gallen,1498,5,13,2,17,40,58,-18,41
FC Thun,1498,6,10,7,15,44,55,-11,37
FC Lugano,1498,7,10,7,15,30,45,-15,37
Grasshoppers,1498,8,9,7,16,41,49,-8,34
FC Sion,1498,9,7,8,17,38,52,-14,29
Young Boys,1499,1,23,6,3,75,34,41,75
FC Basel,1499,2,17,8,7,51,26,25,59
St Gallen,1499,3,15,3,14,43,54,-11,48
Lucerne,1499,4,11,10,11,42,47,-5,43
FC Zürich,1499,5,10,10,12,39,37,2,40
FC Lugano,1499,6,11,7,14,32,44,-12,40
Grasshoppers,1499,7,9,7,16,38,48,-10,34
FC Thun,1499,8,9,6,17,41,58,-17,33
FC Sion,1499,9,6,9,17,40,53,-13,27
Young Boys,1500,1,20,9,3,69,35,34,69
FC Basel,1500,2,18,8,6,51,23,28,62
Lucerne,1500,3,13,8,11,43,44,-1,47
FC Zürich,1500,4,12,9,11,43,34,9,45
St Gallen,1500,5,14,3,15,43,54,-11,45
FC Lugano,1500,6,10,6,16,34,51,-17,36
Grasshoppers,1500,7,9,8,15,41,49,-8,35
FC Thun,1500,8,9,6,17,43,58,-15,33
FC Sion,1500,9,6,9,17,37,56,-19,27
Young Boys,1501,1,23,6,3,75,37,38,75
FC Basel,1501,2,18,9,5,55,24,31,63
St Gallen,1501,3,14,5,13,46,55,-9,47
Lucerne,1501,4,12,8,12,46,49,-3,44
FC Zürich,1501,5,11,10,11,39,34,5,43
FC Thun,1501,6,10,5,17,44,59,-15,35
Grasshoppers,1501,7,9,7,16,43,54,-11,34
FC Lugano,1501,8,9,5,18,32,54,-22,32
FC Sion,1501,9,6,9,17,41,55,-14,27
Young Boys,1502,1,22,7,3,73,32,41,73
FC Basel,1502,2,20,7,5,57,23,34,67
St Gallen,1502,3,14,4,14,43,55,-12,46
Lucerne,1502,4,11,10,11,38,42,-4,43
FC Zürich,1502,5,10,10,12,41,37,4,40
FC Thun,1502,6,10,5,17,44,59,-15,35
FC Lugano,1502,7,9,8,15,28,48,-20,35
Grasshoppers,1502,8,8,7,17,38,51,-13,31
FC Sion,1502,9,7,8,17,40,55,-15,29
Young Boys,1503,1,21,8,3,70,33,37,71
FC Basel,1503,2,18,8,6,61,27,34,62
St Gallen,1503,3,15,2,15,45,57,-12,47
Lucerne,1503,4,12,9,11,39,42,-3,45
FC Lugano,1503,5,12,6,14,32,43,-11,42
FC Zürich,1503,6,10,9,13,44,43,1,39
Grasshoppers,1503,7,10,6,16,43,51,-8,36
FC Thun,1503,8,8,6,18,39,63,-24,30
FC Sion,1503,9,7,8,17,42,56,-14,29
Young Boys,1504,1,20,8,4,72,37,35,68
FC Basel,1504,2,18,7,7,51,25,26,61
Lucerne,1504,3,13,9,10,45,44,1,48
St Gallen,1504,4,14,2,16,40,53,-13,44
FC Zürich,1504,5,10,12,10,42,36,6,42
FC Thun,1504,6,11,6,15,46,58,-12,39
FC Lugano,1504,7,10,7,15,31,48,-17,37
Grasshoppers,1504,8,9,7,16,42,51,-9,34
FC Sion,1504,9,6,8,18,39,56,-17,26
Young Boys,1505,1,21,7,4,72,35,37,70
FC Basel,1505,2,18,9,5,53,23,30,63
Lucerne,1505,3,13,7,12,39,44,-5,46
St Gallen,1505,4,14,3,15,41,54,-13,45
FC Zürich,1505,5,10,10,12,40,36,4,40
FC Thun,1505,6,11,5,16,45,55,-10,38
FC Lugano,1505,7,11,5,16,31,48,-17,38
Grasshoppers,1505,8,10,7,15,43,50,-7,37
FC Sion,1505,9,6,7,19,39,58,-19,25
Young Boys,1506,1,21,6,5,70,37,33,69
FC Basel,1506,2,17,9,6,50,24,26,60
St Gallen,1506,3,15,3,14,45,55,-10,48
FC Zürich,1506,4,12,10,10,42,34,8,46
Lucerne,1506,5,11,8,13,38,46,-8,41
Grasshoppers,1506,6,11,6,15,44,46,-2,39
FC Thun,1506,7,11,5,16,44,56,-12,38
FC Lugano,1506,8,10,5,17,31,49,-18,35
FC Sion,1506,9,6,8,18,39,56,-17,26
Young Boys,1507,1,21,8,3,68,35,33,71
FC Basel,1507,2,18,9,5,55,25,30,63
St Gallen,1507,3,16,2,14,48,54,-6,50
Lucerne,1507,4,11,9,12,38,44,-6,42
FC Lugano,1507,5,11,6,15,30,44,-14,39
FC Zürich,1507,6,9,9,14,38,39,-1,36
FC Thun,1507,7,9,8,15,41,55,-14,35
Grasshoppers,1507,8,8,9,15,41,50,-9,33
FC Sion,1507,9,6,10,16,43,56,-13,28
Young Boys,1508,1,21,7,4,72,37,35,70
FC Basel,1508,2,17,7,8,50,30,20,58
Lucerne,1508,3,13,8,11,45,46,-1,47
St Gallen,1508,4,14,4,14,46,55,-9,46
FC Zürich,1508,5,11,10,11,43,37,6,43
Grasshoppers,1508,6,11,6,15,42,48,-6,39
FC Thun,1508,7,10,6,16,42,55,-13,36
FC Lugano,1508,8,9,9,14,30,45,-15,36
FC Sion,1508,9,5,9,18,41,58,-17,24
Young Boys,1509,1,21,7,4,71,36,35,70
FC Basel,1509,2,17,9,6,51,24,27,60
St Gallen,1509,3,15,3,14,43,52,-9,48
Lucerne,1509,4,12,9,11,40,43,-3,45
FC Zürich,1509,5,11,9,12,45,39,6,42
FC Lugano,1509,6,11,7,14,34,47,-13,40
Grasshoppers,1509,7,9,9,14,41,48,-7,36
FC Thun,1509,8,9,7,16,43,61,-18,34
FC Sion,1509,9,5,8,19,37,55,-18,23
Young Boys,1510,1,21,8,3,74,36,38,71
FC Basel,1510,2,17,9,6,51,25,26,60
Lucerne,1510,3,14,9,9,46,42,4,51
St Gallen,1510,4,13,3,16,39,55,-16,42
FC Zürich,1510,5,9,12,11,37,34,3,39
FC Lugano,1510,6,11,5,16,31,46,-15,38
FC Thun,1510,7,9,8,15,47,58,-11,35
Grasshoppers,1510,8,9,8,15,42,53,-11,35
FC Sion,1510,9,5,10,17,38,56,-18,25
Young Boys,1511,1,21,6,5,73,38,35,69
FC Basel,1511,2,18,8,6,55,28,27,62
Lucerne,1511,3,14,7,11,44,42,2,49
FC Zürich,1511,4,12,9,11,43,38,5,45
St Gallen,1511,5,14,3,15,42,57,-15,45
FC Lugano,1511,6,11,5,16,34,47,-13,38
Grasshoppers,1511,7,10,6,16,43,50,-7,36
FC Thun,1511,8,9,6,17,43,61,-18,33
FC Sion,1511,9,6,8,18,40,56,-16,26
Young Boys,1512,1,19,8,5,69,38,31,65
FC Basel,1512,2,17,8,7,53,28,25,59
Lucerne,1512,3,13,9,10,46,45,1,48
St Gallen,1512,4,15,3,14,43,52,-9,48
FC Zürich,1512,5,10,9,13,41,40,1,39
Grasshoppers,1512,6,11,6,15,43,47,-4,39
FC Lugano,1512,7,11,5,16,35,51,-16,38
FC Thun,1512,8,9,6,17,42,59,-17,33
FC Sion,1512,9,8,8,16,41,53,-12,32
Young Boys,1513,1,21,7,4,78,37,41,70
FC Basel,1513,2,19,8,5,57,25,32,65
Lucerne,1513,3,14,7,11,41,46,-5,49
St Gallen,1513,4,14,3,15,41,54,-13,45
FC Zürich,1513,5,11,11,10,41,35,6,44
Grasshoppers,1513,6,10,7,15,43,49,-6,37
FC Thun,1513,7,9,5,18,45,61,-16,32
FC Lugano,1513,8,9,5,18,28,51,-23,32
FC Sion,1513,9,6,9,17,39,55,-16,27
Young Boys,1514,1,22,6,4,70,36,34,72
FC Basel,1514,2,16,7,9,49,31,18,55
St Gallen,1514,3,16,2,14,46,51,-5,50
FC Zürich,1514,4,12,10,10,42,34,8,46
Lucerne,1514,5,13,7,12,41,44,-3,46
FC Lugano,1514,6,11,5,16,31,46,-15,38
Grasshoppers,1514,7,10,7,15,46,50,-4,37
FC Thun,1514,8,10,7,15,45,57,-12,37
FC Sion,1514,9,5,7,20,36,57,-21,22
Young Boys,1515,1,22,6,4,75,35,40,72
FC Basel,1515,2,19,7,6,53,22,31,64
Lucerne,1515,3,13,8,11,45,45,0,47
FC Zürich,1515,4,12,9,11,42,35,7,45
St Gallen,1515,5,13,3,16,41,56,-15,42
FC Lugano,1515,6,11,5,16,33,51,-18,38
Grasshoppers,1515,7,9,7,16,39,52,-13,34
FC Sion,1515,8,8,8,16,41,52,-11,32
FC Thun,1515,9,8,5,19,38,59,-21,29
Young Boys,1516,1,22,6,4,73,38,35,72
FC Basel,1516,2,19,7,6,55,25,30,64
FC Zürich,1516,3,12,9,11,44,34,10,45
St Gallen,1516,4,14,3,15,39,53,-14,45
Lucerne,1516,5,12,8,12,42,45,-3,44
FC Thun,1516,6,11,5,16,44,57,-13,38
FC Lugano,1516,7,9,7,16,28,47,-19,34
Grasshoppers,1516,8,9,6,17,40,51,-11,33
FC Sion,1516,9,7,7,18,40,55,-15,28
Young Boys,1517,1,20,7,5,68,38,30,67
FC Basel,1517,2,18,8,6,55,25,30,62
Lucerne,1517,3,13,8,11,41,43,-2,47
St Gallen,1517,4,15,2,15,45,57,-12,47
FC Zürich,1517,5,10,10,12,40,39,1,40
Grasshoppers,1517,6,9,9,14,39,46,-7,36
FC Lugano,1517,7,10,6,16,32,48,-16,36
FC Thun,1517,8,9,7,16,45,58,-13,34
FC Sion,1517,9,7,9,16,42,53,-11,30
Young Boys,1518,1,21,6,5,70,38,32,69
FC Basel,1518,2,18,9,5,55,26,29,63
Lucerne,1518,3,13,8,11,43,44,-1,47
St Gallen,1518,4,14,2,16,47,59,-12,44
FC Zürich,1518,5,10,10,12,40,39,1,40
Grasshoppers,1518,6,11,7,14,44,47,-3,40
FC Thun,1518,7,10,6,16,45,57,-12,36
FC Lugano,1518,8,9,5,18,29,52,-23,32
FC Sion,1518,9,7,9,16,43,54,-11,30
Young Boys,1519,1,22,7,3,75,34,41,73
FC Basel,1519,2,19,8,5,59,25,34,65
Lucerne,1519,3,13,7,12,40,47,-7,46
St Gallen,1519,4,13,3,16,42,57,-15,42
FC Zürich,1519,5,10,10,12,41,39,2,40
FC Lugano,1519,6,11,6,15,32,47,-15,39
Grasshoppers,1519,7,10,6,16,41,48,-7,36
FC Sion,1519,8,8,8,16,41,52,-11,32
FC Thun,1519,9,8,5,19,39,61,-22,29
Young Boys,1520,1,22,8,2,70,33,37,74
FC Basel,1520,2,16,10,6,50,25,25,58
St Gallen,1520,3,15,2,15,41,51,-10,47
Lucerne,1520,4,13,7,12,43,44,-1,46
FC Zürich,1520,5,11,11,10,43,35,8,44
FC Lugano,1520,6,10,5,17,29,47,-18,35
FC Thun,1520,7,9,7,16,47,59,-12,34
Grasshoppers,1520,8,9,6,17,39,52,-13,33
FC Sion,1520,9,7,8,17,40,56,-16,29
Young Boys,1521,1,22,6,4,73,39,34,72
FC Basel,1521,2,18,8,6,60,27,33,62
St Gallen,1521,3,15,3,14,44,57,-13,48
FC Zürich,1521,4,11,10,11,41,36,5,43
Lucerne,1521,5,12,7,13,43,47,-4,43
FC Thun,1521,6,11,5,16,46,56,-10,38
Grasshoppers,1521,7,10,7,15,42,48,-6,37
FC Lugano,1521,8,9,5,18,29,53,-24,32
FC Sion,1521,9,6,9,17,39,54,-15,27
Young Boys,1522,1,21,8,3,73,36,37,71
FC Basel,1522,2,17,9,6,55,29,26,60
Lucerne,1522,3,13,7,12,43,45,-2,46
St Gallen,1522,4,14,3,15,46,61,-15,45
FC Zürich,1522,5,11,10,11,42,35,7,43
Grasshoppers,1522,6,10,6,16,42,51,-9,36
FC Lugano,1522,7,10,6,16,36,52,-16,36
FC Thun,1522,8,9,7,16,45,60,-15,34
FC Sion,1522,9,7,8,17,40,53,-13,29
Young Boys,1523,1,20,7,5,72,38,34,67
FC Basel,1523,2,18,8,6,56,27,29,62
Lucerne,1523,3,15,7,10,45,42,3,52
St Gallen,1523,4,14,3,15,42,54,-12,45
FC Zürich,1523,5,10,10,12,41,40,1,40
FC Thun,1523,6,11,5,16,45,59,-14,38
FC Lugano,1523,7,10,6,16,29,46,-17,36
Grasshoppers,1523,8,9,7,16,41,50,-9,34
FC Sion,1523,9,6,9,17,40,55,-15,27
Young Boys,1524,1,21,9,2,76,39,37,72
FC Basel,1524,2,18,8,6,56,28,28,62
Lucerne,1524,3,13,8,11,44,46,-2,47
St Gallen,1524,4,14,2,16,41,55,-14,44
FC Lugano,1524,5,12,6,14,35,45,-10,42
FC Thun,1524,6,11,5,16,45,58,-13,38
FC Zürich,1524,7,9,10,13,37,36,1,37
Grasshoppers,1524,8,9,7,16,43,53,-10,34
FC Sion,1524,9,6,7,19,41,58,-17,25
Young Boys,1525,1,20,7,5,68,38,30,67
FC Basel,1525,2,18,9,5,53,23,30,63
Lucerne,1525,3,13,9,10,42,45,-3,48
FC Zürich,1525,4,12,10,10,44,33,11,46
St Gallen,1525,5,13,4,15,42,56,-14,43
Grasshoppers,1525,6,11,7,14,48,47,1,40
FC Lugano,1525,7,10,6,16,30,48,-18,36
FC Thun,1525,8,9,5,18,42,61,-19,32
FC Sion,1525,9,5,9,18,39,57,-18,24
Young Boys,1526,1,20,8,4,70,39,31,68
FC Basel,1526,2,17,9,6,54,27,27,60
St Gallen,1526,3,15,3,14,47,55,-8,48
Lucerne,1526,4,12,8,12,39,46,-7,44
FC Lugano,1526,5,11,7,14,35,46,-11,40
FC Zürich,1526,6,9,10,13,38,39,-1,37
FC Thun,1526,7,10,7,15,47,59,-12,37
Grasshoppers,1526,8,9,7,16,43,51,-8,34
FC Sion,1526,9,8,7,17,46,57,-11,31
Young Boys,1527,1,22,6,4,73,39,34,72
FC Basel,1527,2,16,8,8,51,30,21,56
St Gallen,1527,3,15,3,14,48,57,-9,48
Lucerne,1527,4,13,8,11,43,46,-3,47
FC Zürich,1527,5,11,9,12,43,36,7,42
FC Thun,1527,6,11,5,16,46,59,-13,38
Grasshoppers,1527,7,10,6,16,43,51,-8,36
FC Sion,1527,8,8,8,16,44,53,-9,32
FC Lugano,1527,9,9,5,18,31,51,-20,32
Young Boys,1528,1,22,7,3,71,34,37,73
FC Basel,1528,2,19,7,6,54,25,29,64
Lucerne,1528,3,14,8,10,45,42,3,50
FC Zürich,1528,4,12,9,11,42,34,8,45
St Gallen,1528,5,13,3,16,41,57,-16,42
FC Lugano,1528,6,10,6,16,30,47,-17,36
FC Thun,1528,7,10,5,17,43,58,-15,35
Grasshoppers,1528,8,9,6,17,43,52,-9,33
FC Sion,1528,9,5,9,18,39,59,-20,24
Young Boys,1529,1,21,8,3,74,34,40,71
FC Basel,1529,2,20,7,5,58,21,37,67
Lucerne,1529,3,12,9,11,42,43,-1,45
St Gallen,1529,4,14,3,15,42,54,-12,45
FC Zürich,1529,5,11,10,11,41,39,2,43
FC Lugano,1529,6,11,6,15,32,46,-14,39
Grasshoppers,1529,7,9,8,15,41,50,-9,35
FC Thun,1529,8,8,7,17,42,60,-18,31
FC Sion,1529,9,5,8,19,39,64,-25,23
Young Boys,1530,1,19,9,4,65,33,32,66
FC Basel,1530,2,17,9,6,53,26,27,60
St Gallen,1530,3,15,2,15,42,54,-12,47
FC Lugano,1530,4,13,5,14,35,43,-8,44
Lucerne,1530,5,11,8,13,39,50,-11,41
FC Zürich,1530,6,9,11,12,38,36,2,38
Grasshoppers,1530,7,10,8,14,43,47,-4,38
FC Thun,1530,8,8,8,16,41,57,-16,32
FC Sion,1530,9,7,10,15,41,51,-10,31
Young Boys,1531,1,22,6,4,71,36,35,72
FC Basel,1531,2,18,8,6,57,26,31,62
St Gallen,1531,3,14,4,14,48,61,-13,46
Lucerne,1531,4,12,9,11,46,48,-2,45
FC Zürich,1531,5,10,10,12,41,38,3,40
Grasshoppers,1531,6,10,7,15,40,48,-8,37
FC Thun,1531,7,10,6,16,44,59,-15,36
FC Lugano,1531,8,9,7,16,30,48,-18,34
FC Sion,1531,9,7,7,18,43,56,-13,28
Young Boys,1532,1,21,8,3,77,38,39,71
FC Basel,1532,2,19,8,5,55,24,31,65
St Gallen,1532,3,13,4,15,42,55,-13,43
FC Zürich,1532,4,11,9,12,43,37,6,42
Grasshoppers,1532,5,12,6,14,48,50,-2,42
Lucerne,1532,6,11,9,12,44,50,-6,42
FC Lugano,1532,7,10,8,14,37,50,-13,38
FC Thun,1532,8,9,5,18,44,64,-20,32
FC Sion,1532,9,6,7,19,37,59,-22,25
Young Boys,1533,1,23,6,3,75,36,39,75
FC Basel,1533,2,16,9,7,52,26,26,57
St Gallen,1533,3,13,6,13,42,53,-11,45
Lucerne,1533,4,11,10,11,42,45,-3,43
FC Zürich,1533,5,11,9,12,43,38,5,42
FC Lugano,1533,6,10,7,15,31,45,-14,37
Grasshoppers,1533,7,9,8,15,41,51,-10,35
FC Sion,1533,8,8,9,15,42,51,-9,33
FC Thun,1533,9,8,6,18,40,63,-23,30
Young Boys,1534,1,20,9,3,74,38,36,69
FC Basel,1534,2,17,10,5,54,26,28,61
St Gallen,1534,3,14,4,14,43,55,-12,46
FC Zürich,1534,4,12,9,11,46,34,12,45
Lucerne,1534,5,12,9,11,41,46,-5,45
FC Lugano,1534,6,10,5,17,30,51,-21,35
FC Thun,1534,7,9,6,17,45,60,-15,33
FC Sion,1534,8,8,8,16,45,54,-9,32
Grasshoppers,1534,9,8,8,16,41,55,-14,32
Young Boys,1535,1,21,8,3,72,31,41,71
FC Basel,1535,2,19,8,5,53,21,32,65
Lucerne,1535,3,13,8,11,42,45,-3,47
St Gallen,1535,4,15,2,15,41,54,-13,47
FC Zürich,1535,5,11,9,12,39,36,3,42
FC Lugano,1535,6,11,6,15,30,46,-16,39
FC Thun,1535,7,9,5,18,42,58,-16,32
Grasshoppers,1535,8,8,6,18,38,53,-15,30
FC Sion,1535,9,7,8,17,41,54,-13,29
Young Boys,1536,1,21,8,3,72,34,38,71
FC Basel,1536,2,16,10,6,55,27,28,58
Lucerne,1536,3,15,7,10,43,43,0,52
St Gallen,1536,4,14,2,16,42,55,-13,44
FC Zürich,1536,5,11,10,11,42,37,5,43
FC Lugano,1536,6,10,5,17,30,49,-19,35
Grasshoppers,1536,7,9,7,16,41,51,-10,34
FC Thun,1536,8,9,7,16,45,59,-14,34
FC Sion,1536,9,7,8,17,43,58,-15,29
Young Boys,1537,1,23,6,3,73,35,38,75
FC Basel,1537,2,16,9,7,50,24,26,57
Lucerne,1537,3,13,8,11,42,42,0,47
St Gallen,1537,4,14,4,14,41,53,-12,46
FC Zürich,1537,5,11,11,10,42,35,7,44
Grasshoppers,1537,6,10,7,15,45,51,-6,37
FC Lugano,1537,7,10,6,16,29,45,-16,36
FC Thun,1537,8,8,6,18,41,62,-21,30
FC Sion,1537,9,7,7,18,42,58,-16,28
Young Boys,1538,1,21,7,4,68,34,34,70
FC Basel,1538,2,19,7,6,55,26,29,64
Lucerne,1538,3,12,9,11,40,42,-2,45
St Gallen,1538,4,14,2,16,41,62,-21,44
FC Zürich,1538,5,10,10,12,39,36,3,40
FC Thun,1538,6,11,5,16,44,57,-13,38
FC Lugano,1538,7,10,6,16,31,45,-14,36
Grasshoppers,1538,8,9,8,15,41,49,-8,35
FC Sion,1538,9,6,10,16,44,52,-8,28
Young Boys,1539,1,22,8,2,74,34,40,74
FC Basel,1539,2,17,8,7,53,28,25,59
FC Zürich,1539,3,13,9,10,45,34,11,48
St Gallen,1539,4,14,2,16,41,56,-15,44
Lucerne,1539,5,12,7,13,39,42,-3,43
Grasshoppers,1539,6,10,7,15,43,49,-6,37
FC Lugano,1539,7,10,5,17,30,51,-21,35
FC Thun,1539,8,9,7,16,44,60,-16,34
FC Sion,1539,9,6,9,17,44,59,-15,27
Young Boys,1540,1,21,8,3,73,36,37,71
FC Basel,1540,2,18,7,7,58,27,31,61
FC Zürich,1540,3,12,9,11,45,38,7,45
Lucerne,1540,4,12,8,12,43,46,-3,44
St Gallen,1540,5,13,3,16,42,59,-17,42
FC Thun,1540,6,11,5,16,46,62,-16,38
FC Lugano,1540,7,10,6,16,32,50,-18,36
Grasshoppers,1540,8,9,8,15,42,50,-8,35
FC Sion,1540,9,7,8,17,42,55,-13,29
Young Boys,1541,1,20,9,3,69,35,34,69
FC Basel,1541,2,19,8,5,57,26,31,65
St Gallen,1541,3,16,2,14,45,55,-10,50
Lucerne,1541,4,13,8,11,42,44,-2,47
FC Zürich,1541,5,10,10,12,41,37,4,40
FC Thun,1541,6,9,6,17,43,59,-16,33
FC Lugano,1541,7,9,6,17,31,49,-18,33
Grasshoppers,1541,8,8,8,16,42,52,-10,32
FC Sion,1541,9,8,7,17,39,52,-13,31
Young Boys,1542,1,20,7,5,67,40,27,67
FC Basel,1542,2,18,9,5,58,25,33,63
Lucerne,1542,3,14,8,10,45,43,2,50
St Gallen,1542,4,14,3,15,41,55,-14,45
FC Lugano,1542,5,12,5,15,34,45,-11,41
Grasshoppers,1542,6,10,7,15,42,49,-7,37
FC Zürich,1542,7,9,9,14,39,42,-3,36
FC Thun,1542,8,9,6,17,41,56,-15,33
FC Sion,1542,9,7,8,17,40,52,-12,29
Young Boys,1543,1,21,7,4,70,37,33,70
FC Basel,1543,2,18,9,5,54,23,31,63
Lucerne,1543,3,12,8,12,39,44,-5,44
St Gallen,1543,4,13,5,14,42,55,-13,44
FC Zürich,1543,5,10,10,12,42,39,3,40
FC Lugano,1543,6,10,6,16,30,47,-17,36
Grasshoppers,1543,7,9,8,15,40,50,-10,35
FC Thun,1543,8,9,7,16,45,62,-17,34
FC Sion,1543,9,8,8,16,50,55,-5,32
Young Boys,1544,1,21,8,3,76,34,42,71
FC Basel,1544,2,16,10,6,52,27,25,58
Lucerne,1544,3,14,7,11,46,46,0,49
St Gallen,1544,4,15,3,14,46,55,-9,48
FC Lugano,1544,5,12,5,15,33,46,-13,41
FC Zürich,1544,6,10,10,12,40,35,5,40
FC Thun,1544,7,9,6,17,41,58,-17,33
Grasshoppers,1544,8,8,8,16,38,50,-12,32
FC Sion,1544,9,7,7,18,37,58,-21,28
Young Boys,1545,1,20,7,5,69,37,32,67
FC Basel,1545,2,19,7,6,55,23,32,64
Lucerne,1545,3,13,8,11,39,40,-1,47
FC Zürich,1545,4,11,10,11,41,37,4,43
St Gallen,1545,5,13,3,16,41,55,-14,42
Grasshoppers,1545,6,11,6,15,46,50,-4,39
FC Lugano,1545,7,11,5,16,30,47,-17,38
FC Thun,1545,8,9,5,18,42,61,-19,32
FC Sion,1545,9,7,9,16,42,55,-13,30
Young Boys,1546,1,22,8,2,74,32,42,74
FC Basel,1546,2,17,9,6,51,25,26,60
Lucerne,1546,3,13,7,12,44,46,-2,46
St Gallen,1546,4,14,3,15,44,59,-15,45
FC Zürich,1546,5,10,11,11,41,37,4,41
Grasshoppers,1546,6,11,7,14,43,45,-2,40
FC Lugano,1546,7,11,5,16,32,49,-17,38
FC Thun,1546,8,9,6,17,42,57,-15,33
FC Sion,1546,9,5,8,19,36,57,-21,23
Young Boys,1547,1,23,7,2,76,36,40,76
FC Basel,1547,2,17,9,6,56,28,28,60
Lucerne,1547,3,13,8,11,44,46,-2,47
St Gallen,1547,4,13,3,16,41,55,-14,42
FC Zürich,1547,5,10,11,11,44,40,4,41
Grasshoppers,1547,6,10,7,15,47,52,-5,37
FC Lugano,1547,7,10,6,16,30,48,-18,36
FC Thun,1547,8,10,5,17,46,61,-15,35
FC Sion,1547,9,6,8,18,39,57,-18,26
Young Boys,1548,1,22,6,4,78,34,44,72
FC Basel,1548,2,20,7,5,53,23,30,67
Lucerne,1548,3,13,8,11,41,44,-3,47
St Gallen,1548,4,15,2,15,40,51,-11,47
FC Zürich,1548,5,10,10,12,39,37,2,40
FC Lugano,1548,6,10,6,16,31,50,-19,36
FC Thun,1548,7,9,6,17,42,59,-17,33
FC Sion,1548,8,8,7,17,45,54,-9,31
Grasshoppers,1548,9,8,6,18,37,54,-17,30
Young Boys,1549,1,21,9,2,73,36,37,72
FC Basel,1549,2,16,7,9,50,28,22,55
St Gallen,1549,3,15,4,13,42,51,-9,49
Lucerne,1549,4,13,9,10,45,42,3,48
FC Zürich,1549,5,12,9,11,42,37,5,45
Grasshoppers,1549,6,9,8,15,41,49,-8,35
FC Lugano,1549,7,10,5,17,32,50,-18,35
FC Thun,1549,8,9,5,18,43,63,-20,32
FC Sion,1549,9,6,10,16,41,53,-12,28
Young Boys,1550,1,22,6,4,71,36,35,72
FC Basel,1550,2,16,7,9,50,28,22,55
St Gallen,1550,3,15,2,15,44,57,-13,47
Lucerne,1550,4,13,7,12,42,46,-4,46
FC Zürich,1550,5,10,10,12,40,37,3,40
FC Lugano,1550,6,11,6,15,32,46,-14,39
FC Thun,1550,7,10,7,15,44,57,-13,37
Grasshoppers,1550,8,9,7,16,43,51,-8,34
FC Sion,1550,9,8,8,16,47,55,-8,32
Young Boys,1551,1,21,7,4,72,39,33,70
FC Basel,1551,2,19,7,6,54,24,30,64
Lucerne,1551,3,12,9,11,43,44,-1,45
St Gallen,1551,4,14,2,16,41,60,-19,44
FC Zürich,1551,5,11,9,12,42,41,1,42
FC Lugano,1551,6,11,6,15,38,48,-10,39
Grasshoppers,1551,7,10,6,16,42,52,-10,36
FC Thun,1551,8,10,5,17,44,57,-13,35
FC Sion,1551,9,7,7,18,44,55,-11,28
Young Boys,1552,1,21,6,5,73,38,35,69
FC Basel,1552,2,19,7,6,56,25,31,64
Lucerne,1552,3,13,7,12,39,43,-4,46
FC Zürich,1552,4,11,11,10,42,36,6,44
St Gallen,1552,5,13,2,17,41,57,-16,41
Grasshoppers,1552,6,11,6,15,44,49,-5,39
FC Lugano,1552,7,11,6,15,32,47,-15,39
FC Thun,1552,8,9,6,17,43,60,-17,33
FC Sion,1552,9,7,7,18,44,59,-15,28
Young Boys,1553,1,21,8,3,76,36,40,71
FC Basel,1553,2,19,8,5,58,26,32,65
St Gallen,1553,3,14,3,15,41,53,-12,45
Lucerne,1553,4,12,8,12,44,49,-5,44
FC Lugano,1553,5,12,6,14,33,45,-12,42
FC Zürich,1553,6,10,9,13,40,39,1,39
Grasshoppers,1553,7,10,6,16,41,53,-12,36
FC Thun,1553,8,9,5,18,43,61,-18,32
FC Sion,1553,9,7,7,18,40,54,-14,28
Young Boys,1554,1,23,7,2,74,31,43,76
FC Basel,1554,2,17,9,6,53,26,27,60
St Gallen,1554,3,16,2,14,44,53,-9,50
Lucerne,1554,4,13,8,11,42,45,-3,47
FC Zrich,1554,5,11,10,11,41,35,6,43
Grasshoppers,1554,6,9,7,16,41,51,-10,34
FC Lugano,1554,7,9,6,17,30,49,-19,33
FC Thun,1554,8,9,5,18,41,61,-20,32
FC Sion,1554,9,6,8,18,38,53,-15,26
Young Boys,1555,1,21,7,4,71,38,33,70
FC Basel,1555,2,16,9,7,54,31,23,57
Lucerne,1555,3,13,8,11,45,44,1,47
FC Zürich,1555,4,12,10,10,44,35,9,46
St Gallen,1555,5,14,4,14,44,55,-11,46
Grasshoppers,1555,6,11,6,15,45,48,-3,39
FC Lugano,1555,7,11,6,15,32,48,-16,39
FC Thun,1555,8,8,5,19,41,63,-22,29
FC Sion,1555,9,6,9,17,40,54,-14,27
Young Boys,1556,1,23,6,3,74,33,41,75
FC Basel,1556,2,18,8,6,53,24,29,62
FC Zürich,1556,3,13,9,10,44,33,11,48
St Gallen,1556,4,15,2,15,43,53,-10,47
Lucerne,1556,5,11,8,13,37,48,-11,41
FC Lugano,1556,6,10,5,17,29,48,-19,35
Grasshoppers,1556,7,8,8,16,39,53,-14,32
FC Thun,1556,8,8,8,16,42,58,-16,32
FC Sion,1556,9,7,8,17,40,51,-11,29
Young Boys,1557,1,21,8,3,73,35,38,71
FC Basel,1557,2,18,7,7,53,28,25,61
St Gallen,1557,3,16,2,14,45,53,-8,50
Lucerne,1557,4,13,8,11,42,45,-3,47
FC Zürich,1557,5,10,9,13,39,39,0,39
FC Thun,1557,6,10,6,16,41,55,-14,36
FC Lugano,1557,7,9,7,16,31,48,-17,34
Grasshoppers,1557,8,8,9,15,39,48,-9,33
FC Sion,1557,9,7,8,17,40,52,-12,29
Young Boys,1558,1,21,7,4,68,33,35,70
FC Basel,1558,2,19,8,5,53,23,30,65
Lucerne,1558,3,15,7,10,43,40,3,52
St Gallen,1558,4,14,3,15,43,55,-12,45
FC Zürich,1558,5,10,10,12,37,34,3,40
FC Thun,1558,6,10,7,15,42,55,-13,37
FC Lugano,1558,7,9,6,17,29,47,-18,33
Grasshoppers,1558,8,8,6,18,38,52,-14,30
FC Sion,1558,9,7,8,17,38,52,-14,29
Young Boys,1559,1,21,8,3,70,34,36,71
FC Basel,1559,2,19,8,5,59,25,34,65
Lucerne,1559,3,14,7,11,45,44,1,49
FC Zürich,1559,4,12,9,11,43,36,7,45
St Gallen,1559,5,14,3,15,40,55,-15,45
Grasshoppers,1559,6,10,6,16,43,49,-6,36
FC Thun,1559,7,9,6,17,42,60,-18,33
FC Lugano,1559,8,9,6,17,30,51,-21,33
FC Sion,1559,9,5,9,18,36,54,-18,24
Young Boys,1560,1,22,8,2,73,33,40,74
FC Basel,1560,2,18,8,6,52,23,29,62
St Gallen,1560,3,14,2,16,42,56,-14,44
Lucerne,1560,4,11,9,12,40,47,-7,42
FC Zürich,1560,5,10,11,11,38,34,4,41
Grasshoppers,1560,6,10,7,15,44,53,-9,37
FC Lugano,1560,7,10,7,15,32,47,-15,37
FC Thun,1560,8,9,5,18,40,57,-17,32
FC Sion,1560,9,7,9,16,40,51,-11,30
Young Boys,1561,1,22,8,2,75,35,40,74
FC Basel,1561,2,16,10,6,52,28,24,58
FC Zürich,1561,3,12,10,10,44,34,10,46
St Gallen,1561,4,14,3,15,43,58,-15,45
Lucerne,1561,5,12,8,12,42,46,-4,44
FC Lugano,1561,6,10,7,15,32,47,-15,37
FC Thun,1561,7,10,6,16,43,55,-12,36
Grasshoppers,1561,8,9,6,17,37,51,-14,33
FC Sion,1561,9,6,8,18,41,55,-14,26
Young Boys,1562,1,21,9,2,72,33,39,72
FC Basel,1562,2,17,9,6,55,27,28,60
St Gallen,1562,3,15,2,15,44,55,-11,47
FC Zürich,1562,4,12,10,10,44,35,9,46
Lucerne,1562,5,13,7,12,42,43,-1,46
FC Lugano,1562,6,10,6,16,31,49,-18,36
Grasshoppers,1562,7,9,8,15,39,49,-10,35
FC Sion,1562,8,7,8,17,43,56,-13,29
FC Thun,1562,9,8,5,19,40,63,-23,29
Young Boys,1563,1,23,7,2,77,34,43,76
FC Basel,1563,2,17,9,6,56,29,27,60
FC Zürich,1563,3,12,10,10,46,35,11,46
Lucerne,1563,4,13,7,12,42,43,-1,46
St Gallen,1563,5,13,3,16,39,55,-16,42
Grasshoppers,1563,6,10,6,16,42,50,-8,36
FC Lugano,1563,7,10,6,16,28,48,-20,36
FC Thun,1563,8,8,7,17,43,60,-17,31
FC Sion,1563,9,6,9,17,41,60,-19,27
Young Boys,1564,1,22,6,4,73,36,37,72
FC Basel,1564,2,20,7,5,60,26,34,67
Lucerne,1564,3,13,7,12,45,47,-2,46
FC Zürich,1564,4,12,9,11,43,37,6,45
St Gallen,1564,5,13,3,16,40,58,-18,42
Grasshoppers,1564,6,10,6,16,43,52,-9,36
FC Thun,1564,7,10,5,17,48,60,-12,35
FC Lugano,1564,8,10,5,17,32,49,-17,35
FC Sion,1564,9,6,8,18,40,59,-19,26
Young Boys,1565,1,22,7,3,73,35,38,73
FC Basel,1565,2,17,9,6,53,28,25,60
St Gallen,1565,3,15,4,13,48,53,-5,49
FC Zürich,1565,4,11,9,12,46,39,7,42
Lucerne,1565,5,11,9,12,37,45,-8,42
FC Lugano,1565,6,10,8,14,34,48,-14,38
FC Thun,1565,7,10,6,16,45,58,-13,36
Grasshoppers,1565,8,9,7,16,40,50,-10,34
FC Sion,1565,9,5,9,18,40,60,-20,24
Young Boys,1566,1,23,6,3,78,35,43,75
FC Basel,1566,2,18,9,5,56,27,29,63
Lucerne,1566,3,12,9,11,41,45,-4,45
St Gallen,1566,4,14,3,15,42,53,-11,45
FC Lugano,1566,5,12,5,15,31,47,-16,41
FC Zürich,1566,6,10,9,13,43,39,4,39
Grasshoppers,1566,7,10,7,15,43,50,-7,37
FC Thun,1566,8,9,6,17,44,60,-16,33
FC Sion,1566,9,5,8,19,37,59,-22,23
Young Boys,1567,1,21,8,3,68,32,36,71
FC Basel,1567,2,19,7,6,58,24,34,64
Lucerne,1567,3,13,8,11,41,45,-4,47
St Gallen,1567,4,13,4,15,41,58,-17,43
FC Lugano,1567,5,10,7,15,31,45,-14,37
FC Zürich,1567,6,9,9,14,39,40,-1,36
FC Sion,1567,7,9,8,15,43,48,-5,35
Grasshoppers,1567,8,9,7,16,40,49,-9,34
FC Thun,1567,9,9,6,17,42,62,-20,33
Young Boys,1568,1,21,8,3,70,34,36,71
FC Basel,1568,2,17,9,6,54,27,27,60
Lucerne,1568,3,13,8,11,43,44,-1,47
St Gallen,1568,4,14,3,15,44,57,-13,45
FC Zürich,1568,5,11,10,11,45,39,6,43
FC Thun,1568,6,11,5,16,46,57,-11,38
Grasshoppers,1568,7,10,6,16,42,53,-11,36
FC Lugano,1568,8,10,6,16,31,49,-18,36
FC Sion,1568,9,6,7,19,45,60,-15,25
Young Boys,1569,1,21,7,4,70,36,34,70
FC Basel,1569,2,17,9,6,54,28,26,60
FC Zürich,1569,3,11,10,11,42,37,5,43
Lucerne,1569,4,11,10,11,42,45,-3,43
St Gallen,1569,5,13,4,15,43,58,-15,43
FC Lugano,1569,6,11,6,15,32,44,-12,39
Grasshoppers,1569,7,10,8,14,46,49,-3,38
FC Thun,1569,8,10,5,17,44,60,-16,35
FC Sion,1569,9,7,7,18,40,56,-16,28
Young Boys,1570,1,22,6,4,76,38,38,72
FC Basel,1570,2,18,9,5,55,24,31,63
Lucerne,1570,3,12,10,10,45,46,-1,46
St Gallen,1570,4,13,3,16,44,60,-16,42
FC Zürich,1570,5,10,11,11,42,38,4,41
FC Lugano,1570,6,11,6,15,34,48,-14,39
FC Thun,1570,7,9,7,16,42,57,-15,34
Grasshoppers,1570,8,8,7,17,40,55,-15,31
FC Sion,1570,9,7,9,16,46,58,-12,30
Young Boys,1571,1,23,7,2,75,33,42,76
FC Basel,1571,2,18,7,7,60,26,34,61
Lucerne,1571,3,13,8,11,39,40,-1,47
St Gallen,1571,4,14,3,15,41,57,-16,45
FC Zürich,1571,5,11,10,11,38,33,5,43
Grasshoppers,1571,6,11,6,15,43,49,-6,39
FC Thun,1571,7,9,5,18,42,64,-22,32
FC Lugano,1571,8,9,5,18,29,51,-22,32
FC Sion,1571,9,6,9,17,38,52,-14,27
Young Boys,1572,1,23,6,3,70,32,38,75
FC Basel,1572,2,16,8,8,51,29,22,56
Lucerne,1572,3,12,10,10,40,42,-2,46
FC Zürich,1572,4,12,9,11,46,39,7,45
St Gallen,1572,5,14,3,15,42,53,-11,45
FC Lugano,1572,6,11,6,15,33,46,-13,39
FC Thun,1572,7,10,6,16,46,59,-13,36
Grasshoppers,1572,8,9,7,16,39,48,-9,34
FC Sion,1572,9,6,7,19,37,56,-19,25
Young Boys,1573,1,22,7,3,75,35,40,73
FC Basel,1573,2,19,7,6,56,24,32,64
Lucerne,1573,3,13,8,11,48,47,1,47
FC Zürich,1573,4,12,10,10,41,33,8,46
St Gallen,1573,5,13,3,16,40,56,-16,42
FC Lugano,1573,6,10,6,16,30,49,-19,36
Grasshoppers,1573,7,9,8,15,43,52,-9,35
FC Thun,1573,8,9,5,18,41,62,-21,32
FC Sion,1573,9,6,8,18,38,54,-16,26
Young Boys,1574,1,20,9,3,69,36,33,69
FC Basel,1574,2,16,10,6,51,27,24,58
St Gallen,1574,3,16,3,13,47,52,-5,51
Lucerne,1574,4,12,9,11,42,43,-1,45
FC Zürich,1574,5,11,10,11,39,35,4,43
FC Lugano,1574,6,10,6,16,31,49,-18,36
Grasshoppers,1574,7,9,8,15,40,48,-8,35
FC Thun,1574,8,10,5,17,43,57,-14,35
FC Sion,1574,9,6,8,18,39,54,-15,26
Young Boys,1575,1,21,7,4,71,35,36,70
FC Basel,1575,2,16,10,6,51,26,25,58
FC Zürich,1575,3,12,10,10,43,35,8,46
St Gallen,1575,4,14,4,14,43,55,-12,46
Lucerne,1575,5,12,7,13,39,45,-6,43
Grasshoppers,1575,6,11,6,15,44,49,-5,39
FC Lugano,1575,7,10,6,16,30,48,-18,36
FC Thun,1575,8,9,6,17,46,61,-15,33
FC Sion,1575,9,7,8,17,45,58,-13,29
Young Boys,1576,1,22,6,4,72,37,35,72
FC Basel,1576,2,18,9,5,54,25,29,63
Lucerne,1576,3,13,7,12,46,48,-2,46
St Gallen,1576,4,14,2,16,43,58,-15,44
FC Zürich,1576,5,10,10,12,40,36,4,40
FC Lugano,1576,6,11,5,16,34,51,-17,38
FC Thun,1576,7,9,8,15,44,58,-14,35
Grasshoppers,1576,8,9,7,16,40,48,-8,34
FC Sion,1576,9,7,8,17,41,53,-12,29
Young Boys,1577,1,23,7,2,76,34,42,76
FC Basel,1577,2,18,7,7,51,28,23,61
FC Zürich,1577,3,12,9,11,43,34,9,45
Lucerne,1577,4,12,9,11,43,45,-2,45
St Gallen,1577,5,14,3,15,44,56,-12,45
Grasshoppers,1577,6,10,7,15,41,49,-8,37
FC Lugano,1577,7,10,5,17,31,52,-21,35
FC Thun,1577,8,8,6,18,40,59,-19,30
FC Sion,1577,9,6,9,17,40,52,-12,27
Young Boys,1578,1,21,7,4,71,34,37,70
FC Basel,1578,2,17,9,6,52,25,27,60
St Gallen,1578,3,14,5,13,43,52,-9,47
Lucerne,1578,4,12,10,10,44,43,1,46
FC Zürich,1578,5,10,11,11,40,36,4,41
FC Lugano,1578,6,11,7,14,31,44,-13,40
FC Thun,1578,7,9,6,17,43,58,-15,33
Grasshoppers,1578,8,9,6,17,43,59,-16,33
FC Sion,1578,9,7,7,18,40,56,-16,28
Young Boys,1579,1,22,6,4,75,39,36,72
FC Basel,1579,2,17,9,6,58,28,30,60
St Gallen,1579,3,15,3,14,44,54,-10,48
Lucerne,1579,4,12,9,11,41,44,-3,45
FC Zürich,1579,5,11,10,11,43,36,7,43
FC Lugano,1579,6,11,5,16,30,47,-17,38
Grasshoppers,1579,7,9,8,15,45,53,-8,35
FC Thun,1579,8,8,6,18,44,66,-22,30
FC Sion,1579,9,7,8,17,45,58,-13,29
Young Boys,1580,1,20,7,5,68,36,32,67
FC Basel,1580,2,18,8,6,54,26,28,62
Lucerne,1580,3,14,8,10,48,46,2,50
FC Zürich,1580,4,12,10,10,48,35,13,46
St Gallen,1580,5,13,3,16,40,58,-18,42
Grasshoppers,1580,6,11,6,15,51,51,0,39
FC Lugano,1580,7,10,6,16,29,48,-19,36
FC Thun,1580,8,9,5,18,45,66,-21,32
FC Sion,1580,9,7,7,18,39,56,-17,28
Young Boys,1581,1,22,8,2,70,32,38,74
FC Basel,1581,2,16,11,5,53,26,27,59
St Gallen,1581,3,14,4,14,41,52,-11,46
Lucerne,1581,4,12,9,11,39,42,-3,45
FC Zürich,1581,5,10,10,12,42,39,3,40
Grasshoppers,1581,6,10,7,15,42,46,-4,37
FC Thun,1581,7,10,6,16,44,59,-15,36
FC Lugano,1581,8,9,6,17,30,49,-19,33
FC Sion,1581,9,7,7,18,41,57,-16,28
Young Boys,1582,1,22,6,4,71,34,37,72
FC Basel,1582,2,18,9,5,53,24,29,63
St Gallen,1582,3,14,4,14,46,56,-10,46
Lucerne,1582,4,11,9,12,41,47,-6,42
FC Zürich,1582,5,10,11,11,41,37,4,41
FC Lugano,1582,6,10,6,16,34,50,-16,36
FC Thun,1582,7,9,8,15,44,58,-14,35
FC Sion,1582,8,8,8,16,43,55,-12,32
Grasshoppers,1582,9,8,7,17,38,50,-12,31
Young Boys,1583,1,21,6,5,69,35,34,69
FC Basel,1583,2,18,8,6,55,26,29,62
St Gallen,1583,3,16,2,14,47,55,-8,50
Lucerne,1583,4,13,7,12,39,42,-3,46
FC Zürich,1583,5,11,11,10,42,35,7,44
Grasshoppers,1583,6,11,6,15,41,47,-6,39
FC Thun,1583,7,9,6,17,45,60,-15,33
FC Lugano,1583,8,9,6,17,30,51,-21,33
FC Sion,1583,9,6,8,18,40,57,-17,26
Young Boys,1584,1,23,7,2,76,37,39,76
FC Basel,1584,2,17,9,6,55,27,28,60
Lucerne,1584,3,13,8,11,41,44,-3,47
FC Zürich,1584,4,11,10,11,45,37,8,43
St Gallen,1584,5,13,4,15,42,56,-14,43
FC Thun,1584,6,10,6,16,47,61,-14,36
FC Lugano,1584,7,10,6,16,33,49,-16,36
Grasshoppers,1584,8,9,6,17,40,51,-11,33
FC Sion,1584,9,6,8,18,41,58,-17,26
Young Boys,1585,1,21,7,4,66,32,34,70
FC Basel,1585,2,17,8,7,55,27,28,59
St Gallen,1585,3,16,3,13,47,54,-7,51
Lucerne,1585,4,14,8,10,44,43,1,50
FC Zürich,1585,5,12,9,11,45,37,8,45
FC Thun,1585,6,10,5,17,44,58,-14,35
Grasshoppers,1585,7,9,7,16,39,50,-11,34
FC Lugano,1585,8,9,5,18,29,50,-21,32
FC Sion,1585,9,6,8,18,37,55,-18,26
Young Boys,1586,1,21,6,5,70,35,35,69
FC Basel,1586,2,20,7,5,58,26,32,67
Lucerne,1586,3,14,7,11,42,44,-2,49
St Gallen,1586,4,13,2,17,42,60,-18,41
FC Zürich,1586,5,10,10,12,41,38,3,40
FC Lugano,1586,6,11,6,15,31,45,-14,39
Grasshoppers,1586,7,10,6,16,43,50,-7,36
FC Thun,1586,8,10,5,17,44,58,-14,35
FC Sion,1586,9,7,7,18,42,57,-15,28
Young Boys,1587,1,21,6,5,70,37,33,69
FC Basel,1587,2,18,8,6,56,27,29,62
FC Zürich,1587,3,12,9,11,45,39,6,45
Lucerne,1587,4,12,9,11,40,45,-5,45
St Gallen,1587,5,13,4,15,40,53,-13,43
FC Lugano,1587,6,11,6,15,33,47,-14,39
Grasshoppers,1587,7,10,7,15,41,47,-6,37
FC Sion,1587,8,8,8,16,45,51,-6,32
FC Thun,1587,9,8,5,19,40,64,-24,29
Young Boys,1588,1,22,8,2,70,32,38,74
FC Basel,1588,2,18,8,6,54,26,28,62
Lucerne,1588,3,13,8,11,48,48,0,47
St Gallen,1588,4,13,3,16,42,56,-14,42
FC Zürich,1588,5,10,9,13,40,36,4,39
FC Lugano,1588,6,11,5,16,31,51,-20,38
FC Thun,1588,7,10,7,15,44,57,-13,37
Grasshoppers,1588,8,9,7,16,42,49,-7,34
FC Sion,1588,9,6,9,17,42,58,-16,27
Young Boys,1589,1,20,9,3,67,33,34,69
FC Basel,1589,2,17,9,6,52,27,25,60
St Gallen,1589,3,15,3,14,45,55,-10,48
Lucerne,1589,4,13,8,11,44,44,0,47
FC Zürich,1589,5,11,10,11,42,38,4,43
Grasshoppers,1589,6,10,6,16,42,53,-11,36
FC Thun,1589,7,10,5,17,48,61,-13,35
FC Lugano,1589,8,9,7,16,30,48,-18,34
FC Sion,1589,9,7,7,18,44,55,-11,28
Young Boys,1590,1,21,8,3,71,34,37,71
FC Basel,1590,2,20,7,5,57,25,32,67
St Gallen,1590,3,15,2,15,43,55,-12,47
FC Zürich,1590,4,12,9,11,45,37,8,45
Lucerne,1590,5,12,9,11,42,44,-2,45
FC Lugano,1590,6,9,7,16,31,49,-18,34
Grasshoppers,1590,7,9,6,17,41,53,-12,33
FC Thun,1590,8,9,5,18,44,62,-18,32
FC Sion,1590,9,7,7,18,41,56,-15,28
Young Boys,1591,1,21,7,4,69,37,32,70
FC Basel,1591,2,17,10,5,54,25,29,61
Lucerne,1591,3,13,9,10,41,40,1,48
St Gallen,1591,4,13,5,14,43,55,-12,44
FC Lugano,1591,5,11,6,15,33,46,-13,39
FC Zürich,1591,6,9,11,12,40,39,1,38
Grasshoppers,1591,7,9,8,15,39,47,-8,35
FC Thun,1591,8,9,7,16,41,56,-15,34
FC Sion,1591,9,5,11,16,38,53,-15,26
Young Boys,1592,1,20,7,5,67,36,31,67
FC Basel,1592,2,18,9,5,57,26,31,63
Lucerne,1592,3,14,8,10,45,40,5,50
St Gallen,1592,4,14,3,15,41,54,-13,45
FC Zürich,1592,5,10,10,12,39,37,2,40
FC Lugano,1592,6,10,7,15,32,46,-14,37
FC Thun,1592,7,10,5,17,44,59,-15,35
Grasshoppers,1592,8,9,6,17,38,56,-18,33
FC Sion,1592,9,8,7,17,42,51,-9,31
Young Boys,1593,1,20,6,6,71,40,31,66
FC Basel,1593,2,17,8,7,55,25,30,59
Lucerne,1593,3,15,8,9,45,41,4,53
FC Zürich,1593,4,12,10,10,44,37,7,46
St Gallen,1593,5,14,2,16,41,57,-16,44
FC Lugano,1593,6,11,6,15,33,48,-15,39
Grasshoppers,1593,7,10,6,16,42,50,-8,36
FC Thun,1593,8,9,5,18,42,62,-20,32
FC Sion,1593,9,7,7,18,44,57,-13,28
Young Boys,1594,1,22,6,4,71,37,34,72
FC Basel,1594,2,18,8,6,56,28,28,62
Lucerne,1594,3,13,9,10,44,42,2,48
FC Zürich,1594,4,11,10,11,45,38,7,43
St Gallen,1594,5,13,4,15,39,54,-15,43
FC Lugano,1594,6,9,8,15,31,47,-16,35
Grasshoppers,1594,7,9,7,16,40,49,-9,34
FC Thun,1594,8,9,7,16,43,59,-16,34
FC Sion,1594,9,6,9,17,37,52,-15,27
Young Boys,1595,1,21,8,3,72,34,38,71
FC Basel,1595,2,18,9,5,55,26,29,63
Lucerne,1595,3,13,8,11,42,46,-4,47
St Gallen,1595,4,13,5,14,41,53,-12,44
FC Zürich,1595,5,11,9,12,40,36,4,42
FC Thun,1595,6,11,6,15,46,57,-11,39
FC Lugano,1595,7,9,6,17,31,49,-18,33
Grasshoppers,1595,8,8,8,16,38,49,-11,32
FC Sion,1595,9,6,9,17,38,53,-15,27
Young Boys,1596,1,20,9,3,66,32,34,69
FC Basel,1596,2,16,10,6,49,27,22,58
Lucerne,1596,3,13,9,10,44,42,2,48
St Gallen,1596,4,14,4,14,45,55,-10,46
FC Zürich,1596,5,11,10,11,40,35,5,43
FC Thun,1596,6,10,6,16,45,56,-11,36
Grasshoppers,1596,7,9,8,15,40,48,-8,35
FC Lugano,1596,8,9,7,16,29,46,-17,34
FC Sion,1596,9,7,7,18,42,59,-17,28
Young Boys,1597,1,22,7,3,74,34,40,73
FC Basel,1597,2,17,8,7,55,30,25,59
St Gallen,1597,3,15,3,14,44,55,-11,48
Lucerne,1597,4,13,8,11,42,44,-2,47
FC Zürich,1597,5,9,11,12,40,39,1,38
FC Thun,1597,6,10,7,15,45,57,-12,37
FC Lugano,1597,7,10,6,16,32,49,-17,36
Grasshoppers,1597,8,8,7,17,39,53,-14,31
FC Sion,1597,9,7,9,16,40,50,-10,30
Young Boys,1598,1,22,7,3,71,34,37,73
FC Basel,1598,2,18,8,6,53,23,30,62
Lucerne,1598,3,12,8,12,40,46,-6,44
St Gallen,1598,4,13,5,14,41,53,-12,44
FC Zürich,1598,5,11,9,12,39,36,3,42
FC Thun,1598,6,11,5,16,46,57,-11,38
Grasshoppers,1598,7,10,7,15,43,47,-4,37
FC Lugano,1598,8,10,5,17,29,48,-19,35
FC Sion,1598,9,6,8,18,40,58,-18,26
Young Boys,1599,1,23,6,3,73,34,39,75
FC Basel,1599,2,16,8,8,53,28,25,56
St Gallen,1599,3,15,2,15,43,55,-12,47
Lucerne,1599,4,13,7,12,42,44,-2,46
FC Zürich,1599,5,11,10,11,44,37,7,43
Grasshoppers,1599,6,11,6,15,43,49,-6,39
FC Thun,1599,7,11,5,16,46,58,-12,38
FC Lugano,1599,8,10,5,17,30,49,-19,35
FC Sion,1599,9,6,7,19,38,58,-20,25
Young Boys,1600,1,20,7,5,68,36,32,67
FC Basel,1600,2,16,8,8,49,27,22,56
Lucerne,1600,3,13,9,10,45,43,2,48
St Gallen,1600,4,15,3,14,42,55,-13,48
FC Zürich,1600,5,12,10,10,44,36,8,46
Grasshoppers,1600,6,10,6,16,42,52,-10,36
FC Lugano,1600,7,10,6,16,32,49,-17,36
FC Thun,1600,8,9,6,17,44,57,-13,33
FC Sion,1600,9,8,7,17,41,52,-11,31
Young Boys,1601,1,21,9,2,72,36,36,72
FC Basel,1601,2,16,9,7,53,29,24,57
Lucerne,1601,3,14,9,9,43,40,3,51
FC Zürich,1601,4,12,10,10,46,36,10,46
St Gallen,1601,5,13,2,17,41,56,-15,41
Grasshoppers,1601,6,10,6,16,43,52,-9,36
FC Lugano,1601,7,10,6,16,31,50,-19,36
FC Thun,1601,8,8,8,16,46,62,-16,32
FC Sion,1601,9,6,9,17,44,58,-14,27
Young Boys,1602,1,20,7,5,69,38,31,67
FC Basel,1602,2,18,8,6,58,29,29,62
Lucerne,1602,3,14,9,9,45,42,3,51
St Gallen,1602,4,14,4,14,46,55,-9,46
FC Zürich,1602,5,10,10,12,40,37,3,40
FC Lugano,1602,6,10,6,16,31,46,-15,36
FC Thun,1602,7,10,6,16,44,61,-17,36
Grasshoppers,1602,8,9,7,16,41,51,-10,34
FC Sion,1602,9,6,9,17,41,56,-15,27
Young Boys,1603,1,23,7,2,78,33,45,76
FC Basel,1603,2,18,9,5,55,25,30,63
Lucerne,1603,3,12,8,12,42,44,-2,44
St Gallen,1603,4,13,4,15,41,56,-15,43
FC Zürich,1603,5,10,12,10,42,36,6,42
FC Lugano,1603,6,11,5,16,32,50,-18,38
FC Thun,1603,7,9,7,16,44,59,-15,34
Grasshoppers,1603,8,8,8,16,38,51,-13,32
FC Sion,1603,9,5,10,17,39,57,-18,25
Young Boys,1604,1,20,7,5,68,35,33,67
FC Basel,1604,2,17,9,6,55,27,28,60
St Gallen,1604,3,17,2,13,46,52,-6,53
Lucerne,1604,4,12,9,11,42,45,-3,45
FC Zürich,1604,5,11,10,11,42,38,4,43
Grasshoppers,1604,6,11,6,15,41,47,-6,39
FC Thun,1604,7,10,5,17,45,61,-16,35
FC Lugano,1604,8,9,6,17,31,50,-19,33
FC Sion,1604,9,6,8,18,41,56,-15,26
Young Boys,1605,1,22,8,2,75,33,42,74
FC Basel,1605,2,18,8,6,53,25,28,62
St Gallen,1605,3,16,2,14,45,52,-7,50
Lucerne,1605,4,13,7,12,44,46,-2,46
FC Zürich,1605,5,10,9,13,37,36,1,39
Grasshoppers,1605,6,9,8,15,38,47,-9,35
FC Lugano,1605,7,10,5,17,30,51,-21,35
FC Thun,1605,8,9,6,17,44,60,-16,33
FC Sion,1605,9,6,9,17,42,58,-16,27
Young Boys,1606,1,21,8,3,67,32,35,71
FC Basel,1606,2,16,9,7,54,28,26,57
Lucerne,1606,3,12,9,11,40,42,-2,45
St Gallen,1606,4,14,3,15,44,58,-14,45
FC Zürich,1606,5,11,9,12,41,37,4,42
FC Lugano,1606,6,11,5,16,32,45,-13,38
Grasshoppers,1606,7,10,7,15,44,50,-6,37
FC Thun,1606,8,10,5,17,43,59,-16,35
FC Sion,1606,9,8,7,17,40,54,-14,31
Young Boys,1607,1,21,8,3,70,34,36,71
FC Basel,1607,2,17,9,6,56,28,28,60
Lucerne,1607,3,14,9,9,41,38,3,51
FC Zürich,1607,4,11,11,10,42,33,9,44
St Gallen,1607,5,13,4,15,44,58,-14,43
Grasshoppers,1607,6,10,6,16,41,50,-9,36
FC Lugano,1607,7,9,7,16,30,47,-17,34
FC Thun,1607,8,9,5,18,45,64,-19,32
FC Sion,1607,9,6,9,17,40,57,-17,27
Young Boys,1608,1,21,7,4,72,35,37,70
FC Basel,1608,2,19,7,6,54,24,30,64
St Gallen,1608,3,14,3,15,43,55,-12,45
FC Zürich,1608,4,11,9,12,41,37,4,42
Lucerne,1608,5,11,9,12,38,46,-8,42
FC Sion,1608,6,10,7,15,50,53,-3,37
FC Lugano,1608,7,10,5,17,29,51,-22,35
Grasshoppers,1608,8,8,9,15,41,51,-10,33
FC Thun,1608,9,9,6,17,43,59,-16,33
Young Boys,1609,1,22,8,2,74,32,42,74
FC Basel,1609,2,18,8,6,53,23,30,62
Lucerne,1609,3,13,8,11,40,43,-3,47
St Gallen,1609,4,14,2,16,42,54,-12,44
FC Zürich,1609,5,10,10,12,40,37,3,40
FC Thun,1609,6,10,7,15,41,54,-13,37
FC Lugano,1609,7,10,6,16,32,49,-17,36
Grasshoppers,1609,8,8,8,16,37,51,-14,32
FC Sion,1609,9,6,9,17,40,56,-16,27
Young Boys,1610,1,21,7,4,70,34,36,70
FC Basel,1610,2,16,9,7,53,28,25,57
Lucerne,1610,3,14,8,10,45,42,3,50
St Gallen,1610,4,14,3,15,42,56,-14,45
FC Zürich,1610,5,11,9,12,42,40,2,42
FC Lugano,1610,6,11,6,15,34,50,-16,39
FC Thun,1610,7,10,7,15,49,58,-9,37
Grasshoppers,1610,8,9,7,16,40,51,-11,34
FC Sion,1610,9,6,8,18,38,54,-16,26
Young Boys,1611,1,21,7,4,69,35,34,70
FC Basel,1611,2,16,9,7,53,30,23,57
St Gallen,1611,3,16,2,14,45,52,-7,50
Lucerne,1611,4,13,8,11,46,46,0,47
FC Zürich,1611,5,10,12,10,43,36,7,42
Grasshoppers,1611,6,10,7,15,42,49,-7,37
FC Lugano,1611,7,10,7,15,29,46,-17,37
FC Thun,1611,8,9,7,16,47,62,-15,34
FC Sion,1611,9,6,7,19,39,57,-18,25
Young Boys,1612,1,22,7,3,70,35,35,73
FC Basel,1612,2,17,9,6,53,26,27,60
St Gallen,1612,3,16,2,14,51,56,-5,50
Lucerne,1612,4,11,9,12,39,45,-6,42
FC Zürich,1612,5,10,11,11,43,37,6,41
Grasshoppers,1612,6,11,7,14,45,48,-3,40
FC Lugano,1612,7,10,7,15,33,49,-16,37
FC Thun,1612,8,9,7,16,44,60,-16,34
FC Sion,1612,9,5,7,20,38,60,-22,22
Young Boys,1613,1,21,9,2,72,34,38,72
FC Basel,1613,2,19,8,5,57,26,31,65
Lucerne,1613,3,13,8,11,42,43,-1,47
St Gallen,1613,4,13,5,14,41,53,-12,44
FC Zürich,1613,5,10,11,11,41,37,4,41
Grasshoppers,1613,6,9,7,16,40,49,-9,34
FC Lugano,1613,7,9,7,16,29,47,-18,34
FC Thun,1613,8,9,6,17,44,62,-18,33
FC Sion,1613,9,6,9,17,41,56,-15,27
Young Boys,1614,1,20,8,4,69,37,32,68
FC Basel,1614,2,18,8,6,52,23,29,62
Lucerne,1614,3,14,8,10,44,43,1,50
FC Zürich,1614,4,12,9,11,42,35,7,45
St Gallen,1614,5,14,3,15,46,57,-11,45
FC Lugano,1614,6,11,5,16,37,50,-13,38
FC Thun,1614,7,10,6,16,43,58,-15,36
Grasshoppers,1614,8,8,8,16,41,53,-12,32
FC Sion,1614,9,6,7,19,39,57,-18,25
Young Boys,1615,1,22,6,4,71,34,37,72
FC Basel,1615,2,18,8,6,55,25,30,62
St Gallen,1615,3,14,3,15,40,55,-15,45
FC Zürich,1615,4,10,11,11,42,37,5,41
Lucerne,1615,5,11,8,13,38,47,-9,41
FC Lugano,1615,6,11,5,16,34,48,-14,38
Grasshoppers,1615,7,10,6,16,42,51,-9,36
FC Thun,1615,8,10,5,17,42,58,-16,35
FC Sion,1615,9,8,8,16,41,50,-9,32
Young Boys,1616,1,20,7,5,68,37,31,67
FC Basel,1616,2,19,7,6,58,26,32,64
Lucerne,1616,3,14,8,10,46,43,3,50
St Gallen,1616,4,15,3,14,46,56,-10,48
FC Zürich,1616,5,11,10,11,42,35,7,43
Grasshoppers,1616,6,11,6,15,45,48,-3,39
FC Thun,1616,7,9,6,17,43,61,-18,33
FC Lugano,1616,8,9,6,17,28,51,-23,33
FC Sion,1616,9,6,7,19,40,59,-19,25
Young Boys,1617,1,21,8,3,73,34,39,71
FC Basel,1617,2,16,8,8,51,28,23,56
St Gallen,1617,3,15,3,14,48,57,-9,48
Lucerne,1617,4,13,8,11,45,46,-1,47
FC Zürich,1617,5,11,10,11,41,35,6,43
FC Lugano,1617,6,12,5,15,32,47,-15,41
FC Thun,1617,7,10,6,16,45,57,-12,36
Grasshoppers,1617,8,9,7,16,43,53,-10,34
FC Sion,1617,9,6,7,19,40,61,-21,25
Young Boys,1618,1,24,6,2,76,32,44,78
FC Basel,1618,2,18,8,6,57,26,31,62
St Gallen,1618,3,16,2,14,48,56,-8,50
Lucerne,1618,4,11,9,12,38,47,-9,42
FC Zürich,1618,5,9,11,12,39,38,1,38
FC Thun,1618,6,10,6,16,42,58,-16,36
FC Lugano,1618,7,10,6,16,32,48,-16,36
Grasshoppers,1618,8,8,9,15,41,50,-9,33
FC Sion,1618,9,5,9,18,39,57,-18,24
Young Boys,1619,1,21,7,4,78,41,37,70
FC Basel,1619,2,19,7,6,55,25,30,64
St Gallen,1619,3,15,3,14,44,54,-10,48
Lucerne,1619,4,13,8,11,43,47,-4,47
FC Zürich,1619,5,10,9,13,48,43,5,39
FC Thun,1619,6,10,5,17,46,61,-15,35
Grasshoppers,1619,7,9,7,16,40,50,-10,34
FC Lugano,1619,8,9,6,17,31,55,-24,33
FC Sion,1619,9,8,8,16,47,56,-9,32
Young Boys,1620,1,24,6,2,72,32,40,78
FC Basel,1620,2,19,7,6,56,27,29,64
St Gallen,1620,3,16,2,14,44,52,-8,50
FC Zürich,1620,4,10,10,12,40,39,1,40
Lucerne,1620,5,11,7,14,41,48,-7,40
Grasshoppers,1620,6,11,6,15,42,48,-6,39
FC Lugano,1620,7,10,6,16,33,48,-15,36
FC Thun,1620,8,9,5,18,43,63,-20,32
FC Sion,1620,9,6,7,19,41,55,-14,25
Young Boys,1621,1,21,7,4,69,34,35,70
FC Basel,1621,2,16,8,8,52,28,24,56
Lucerne,1621,3,15,7,10,45,42,3,52
FC Zürich,1621,4,13,9,10,44,34,10,48
St Gallen,1621,5,15,2,15,43,56,-13,47
FC Lugano,1621,6,10,5,17,33,50,-17,35
Grasshoppers,1621,7,9,7,16,41,50,-9,34
FC Thun,1621,8,9,6,17,42,60,-18,33
FC Sion,1621,9,6,9,17,40,55,-15,27
Young Boys,1622,1,23,7,2,72,32,40,76
FC Basel,1622,2,16,9,7,51,27,24,57
St Gallen,1622,3,16,3,13,48,54,-6,51
Lucerne,1622,4,12,8,12,42,46,-4,44
FC Zürich,1622,5,11,9,12,42,37,5,42
FC Lugano,1622,6,10,6,16,33,47,-14,36
Grasshoppers,1622,7,9,8,15,40,47,-7,35
FC Thun,1622,8,9,6,17,42,58,-16,33
FC Sion,1622,9,6,8,18,38,60,-22,26
Young Boys,1623,1,21,6,5,70,38,32,69
FC Basel,1623,2,18,9,5,53,25,28,63
Lucerne,1623,3,13,8,11,43,42,1,47
St Gallen,1623,4,14,2,16,41,54,-13,44
FC Zürich,1623,5,11,10,11,45,36,9,43
FC Thun,1623,6,10,7,15,44,56,-12,37
FC Lugano,1623,7,10,6,16,30,48,-18,36
Grasshoppers,1623,8,9,8,15,40,50,-10,35
FC Sion,1623,9,6,8,18,38,55,-17,26
Young Boys,1624,1,23,6,3,76,34,42,75
FC Basel,1624,2,18,8,6,56,25,31,62
Lucerne,1624,3,15,7,10,45,41,4,52
St Gallen,1624,4,13,3,16,40,54,-14,42
FC Zürich,1624,5,10,9,13,44,40,4,39
FC Thun,1624,6,11,5,16,46,59,-13,38
FC Lugano,1624,7,11,5,16,34,52,-18,38
Grasshoppers,1624,8,9,6,17,40,51,-11,33
FC Sion,1624,9,6,7,19,39,64,-25,25
Young Boys,1625,1,22,6,4,75,33,42,72
FC Basel,1625,2,18,8,6,55,28,27,62
St Gallen,1625,3,15,4,13,48,55,-7,49
FC Zürich,1625,4,12,10,10,45,34,11,46
Lucerne,1625,5,12,8,12,41,48,-7,44
FC Lugano,1625,6,9,7,16,29,50,-21,34
Grasshoppers,1625,7,8,8,16,41,54,-13,32
FC Sion,1625,8,7,9,16,39,52,-13,30
FC Thun,1625,9,8,6,18,41,60,-19,30
Young Boys,1626,1,22,8,2,74,35,39,74
FC Basel,1626,2,17,9,6,53,28,25,60
Lucerne,1626,3,12,10,10,42,42,0,46
St Gallen,1626,4,14,4,14,43,54,-11,46
FC Lugano,1626,5,11,6,15,34,46,-12,39
FC Zürich,1626,6,9,10,13,37,36,1,37
FC Thun,1626,7,10,6,16,45,59,-14,36
Grasshoppers,1626,8,9,6,17,39,50,-11,33
FC Sion,1626,9,6,9,17,36,53,-17,27
Young Boys,1627,1,21,6,5,67,33,34,69
FC Basel,1627,2,20,7,5,55,25,30,67
St Gallen,1627,3,15,2,15,44,54,-10,47
Lucerne,1627,4,12,8,12,37,42,-5,44
FC Lugano,1627,5,11,6,15,34,47,-13,39
FC Zürich,1627,6,9,11,12,40,38,2,38
FC Thun,1627,7,11,5,16,45,57,-12,38
Grasshoppers,1627,8,9,7,16,37,48,-11,34
FC Sion,1627,9,6,8,18,39,54,-15,26
Young Boys,1628,1,21,9,2,71,35,36,72
FC Basel,1628,2,16,9,7,52,30,22,57
St Gallen,1628,3,15,3,14,45,53,-8,48
Lucerne,1628,4,12,9,11,40,42,-2,45
FC Zürich,1628,5,10,11,11,41,36,5,41
FC Thun,1628,6,10,6,16,46,57,-11,36
FC Lugano,1628,7,10,6,16,30,47,-17,36
Grasshoppers,1628,8,9,7,16,41,53,-12,34
FC Sion,1628,9,7,8,17,41,54,-13,29
Young Boys,1629,1,21,8,3,74,36,38,71
FC Basel,1629,2,16,9,7,52,27,25,57
St Gallen,1629,3,15,2,15,45,57,-12,47
FC Zürich,1629,4,12,10,10,44,33,11,46
Lucerne,1629,5,13,7,12,40,44,-4,46
Grasshoppers,1629,6,10,7,15,44,49,-5,37
FC Lugano,1629,7,10,5,17,33,54,-21,35
FC Thun,1629,8,9,6,17,41,58,-17,33
FC Sion,1629,9,6,10,16,42,57,-15,28
Young Boys,1630,1,20,10,2,72,35,37,70
FC Basel,1630,2,18,9,5,54,25,29,63
St Gallen,1630,3,16,3,13,49,55,-6,51
Lucerne,1630,4,12,8,12,41,44,-3,44
FC Zürich,1630,5,10,11,11,42,36,6,41
Grasshoppers,1630,6,10,8,14,46,47,-1,38
FC Lugano,1630,7,9,7,16,34,52,-18,34
FC Thun,1630,8,8,6,18,39,60,-21,30
FC Sion,1630,9,6,8,18,38,61,-23,26
Young Boys,1631,1,22,7,3,73,34,39,73
FC Basel,1631,2,18,9,5,55,24,31,63
St Gallen,1631,3,15,2,15,45,55,-10,47
Lucerne,1631,4,12,10,10,39,40,-1,46
FC Zürich,1631,5,10,11,11,39,38,1,41
FC Lugano,1631,6,10,6,16,33,51,-18,36
Grasshoppers,1631,7,9,8,15,39,46,-7,35
FC Thun,1631,8,9,6,17,40,57,-17,33
FC Sion,1631,9,5,9,18,39,57,-18,24
Young Boys,1632,1,22,8,2,77,35,42,74
FC Basel,1632,2,17,10,5,56,29,27,61
Lucerne,1632,3,13,8,11,47,49,-2,47
St Gallen,1632,4,13,4,15,40,54,-14,43
FC Zürich,1632,5,10,12,10,44,38,6,42
FC Thun,1632,6,10,6,16,45,57,-12,36
FC Lugano,1632,7,10,6,16,34,50,-16,36
Grasshoppers,1632,8,9,7,16,40,48,-8,34
FC Sion,1632,9,6,7,19,35,58,-23,25
Young Boys,1633,1,21,8,3,75,40,35,71
FC Basel,1633,2,18,8,6,56,26,30,62
Lucerne,1633,3,15,8,9,45,40,5,53
FC Zürich,1633,4,10,11,11,40,34,6,41
St Gallen,1633,5,13,2,17,40,58,-18,41
FC Lugano,1633,6,10,8,14,30,44,-14,38
FC Thun,1633,7,10,6,16,46,62,-16,36
Grasshoppers,1633,8,8,7,17,41,52,-11,31
FC Sion,1633,9,6,8,18,43,60,-17,26
Young Boys,1634,1,23,6,3,77,34,43,75
FC Basel,1634,2,16,7,9,49,26,23,55
Lucerne,1634,3,13,8,11,42,46,-4,47
St Gallen,1634,4,14,4,14,43,53,-10,46
FC Zürich,1634,5,12,9,11,43,37,6,45
FC Thun,1634,6,11,5,16,46,58,-12,38
FC Lugano,1634,7,10,5,17,32,52,-20,35
Grasshoppers,1634,8,9,7,16,42,51,-9,34
FC Sion,1634,9,6,9,17,39,56,-17,27
Young Boys,1635,1,23,6,3,73,38,35,75
FC Basel,1635,2,18,8,6,61,27,34,62
Lucerne,1635,3,14,7,11,44,42,2,49
FC Zürich,1635,4,12,9,11,43,37,6,45
St Gallen,1635,5,13,3,16,40,57,-17,42
FC Thun,1635,6,10,5,17,47,59,-12,35
FC Lugano,1635,7,10,5,17,30,50,-20,35
Grasshoppers,1635,8,9,7,16,40,50,-10,34
FC Sion,1635,9,6,8,18,39,57,-18,26
Young Boys,1636,1,21,7,4,74,35,39,70
FC Basel,1636,2,19,7,6,56,25,31,64
St Gallen,1636,3,16,3,13,46,53,-7,51
FC Zürich,1636,4,12,9,11,43,35,8,45
Lucerne,1636,5,11,10,11,38,44,-6,43
Grasshoppers,1636,6,10,7,15,43,49,-6,37
FC Thun,1636,7,10,5,17,44,60,-16,35
FC Lugano,1636,8,9,6,17,28,51,-23,33
FC Sion,1636,9,5,8,19,38,58,-20,23
Young Boys,1637,1,23,6,3,73,33,40,75
FC Basel,1637,2,18,8,6,56,22,34,62
Lucerne,1637,3,12,9,11,44,51,-7,45
St Gallen,1637,4,13,4,15,43,58,-15,43
FC Zürich,1637,5,10,9,13,41,40,1,39
Grasshoppers,1637,6,9,8,15,43,52,-9,35
FC Thun,1637,7,9,7,16,45,61,-16,34
FC Lugano,1637,8,9,7,16,30,50,-20,34
FC Sion,1637,9,8,8,16,43,51,-8,32
Young Boys,1638,1,23,7,2,76,34,42,76
FC Basel,1638,2,17,8,7,56,28,28,59
Lucerne,1638,3,13,9,10,43,42,1,48
FC Zürich,1638,4,12,9,11,45,37,8,45
St Gallen,1638,5,14,3,15,43,59,-16,45
FC Thun,1638,6,9,6,17,46,64,-18,33
FC Lugano,1638,7,9,6,17,29,50,-21,33
Grasshoppers,1638,8,8,8,16,39,50,-11,32
FC Sion,1638,9,7,8,17,43,56,-13,29
Young Boys,1639,1,21,8,3,72,34,38,71
FC Basel,1639,2,16,9,7,53,29,24,57
Lucerne,1639,3,14,8,10,44,42,2,50
St Gallen,1639,4,13,4,15,41,57,-16,43
FC Zürich,1639,5,11,9,12,43,38,5,42
Grasshoppers,1639,6,11,6,15,40,46,-6,39
FC Thun,1639,7,11,5,16,45,57,-12,38
FC Lugano,1639,8,9,7,16,29,48,-19,34
FC Sion,1639,9,6,8,18,38,54,-16,26
Young Boys,1640,1,22,6,4,68,33,35,72
FC Basel,1640,2,18,7,7,56,26,30,61
Lucerne,1640,3,14,8,10,42,42,0,50
St Gallen,1640,4,15,2,15,45,54,-9,47
FC Zürich,1640,5,10,9,13,42,40,2,39
Grasshoppers,1640,6,10,8,14,41,47,-6,38
FC Lugano,1640,7,10,5,17,28,48,-20,35
FC Thun,1640,8,9,6,17,43,59,-16,33
FC Sion,1640,9,6,9,17,40,56,-16,27
Young Boys,1641,1,21,6,5,75,40,35,69
FC Basel,1641,2,20,7,5,60,23,37,67
Lucerne,1641,3,14,7,11,42,40,2,49
St Gallen,1641,4,14,2,16,40,59,-19,44
FC Zürich,1641,5,11,9,12,42,39,3,42
FC Lugano,1641,6,11,5,16,33,52,-19,38
FC Thun,1641,7,10,5,17,46,61,-15,35
Grasshoppers,1641,8,8,7,17,38,53,-15,31
FC Sion,1641,9,7,8,17,44,53,-9,29
Young Boys,1642,1,20,8,4,67,36,31,68
FC Basel,1642,2,17,8,7,53,28,25,59
Lucerne,1642,3,15,8,9,46,42,4,53
St Gallen,1642,4,15,2,15,46,56,-10,47
FC Lugano,1642,5,11,6,15,32,47,-15,39
FC Zürich,1642,6,9,11,12,38,37,1,38
FC Thun,1642,7,10,6,16,44,58,-14,36
Grasshoppers,1642,8,9,8,15,42,48,-6,35
FC Sion,1642,9,5,9,18,37,53,-16,24
Young Boys,1643,1,22,7,3,72,38,34,73
FC Basel,1643,2,17,8,7,56,27,29,59
St Gallen,1643,3,15,3,14,46,55,-9,48
Lucerne,1643,4,12,8,12,42,47,-5,44
FC Zürich,1643,5,10,10,12,41,39,2,40
FC Lugano,1643,6,11,6,15,35,48,-13,39
FC Thun,1643,7,10,6,16,43,58,-15,36
Grasshoppers,1643,8,9,8,15,43,49,-6,35
FC Sion,1643,9,5,10,17,42,59,-17,25
Young Boys,1644,1,22,6,4,70,36,34,72
FC Basel,1644,2,18,8,6,56,25,31,62
Lucerne,1644,3,13,9,10,44,43,1,48
St Gallen,1644,4,14,3,15,42,56,-14,45
FC Zürich,1644,5,9,11,12,39,38,1,38
FC Lugano,1644,6,10,7,15,30,45,-15,37
Grasshoppers,1644,7,10,6,16,42,50,-8,36
FC Thun,1644,8,10,5,17,45,57,-12,35
FC Sion,1644,9,7,7,18,41,59,-18,28
Young Boys,1645,1,21,8,3,71,32,39,71
FC Basel,1645,2,18,9,5,52,23,29,63
Lucerne,1645,3,13,8,11,44,47,-3,47
FC Zürich,1645,4,12,10,10,43,35,8,46
St Gallen,1645,5,13,4,15,42,56,-14,43
Grasshoppers,1645,6,10,7,15,42,49,-7,37
FC Lugano,1645,7,10,5,17,32,49,-17,35
FC Thun,1645,8,9,5,18,42,60,-18,32
FC Sion,1645,9,6,8,18,37,54,-17,26
Young Boys,1646,1,23,6,3,69,33,36,75
FC Basel,1646,2,19,7,6,57,23,34,64
Lucerne,1646,3,13,8,11,44,46,-2,47
St Gallen,1646,4,14,3,15,40,53,-13,45
FC Zürich,1646,5,11,11,10,40,34,6,44
FC Thun,1646,6,10,6,16,42,56,-14,36
FC Lugano,1646,7,10,6,16,30,48,-18,36
Grasshoppers,1646,8,9,6,17,41,51,-10,33
FC Sion,1646,9,5,7,20,36,55,-19,22
Young Boys,1647,1,20,8,4,70,35,35,68
FC Basel,1647,2,20,7,5,58,24,34,67
St Gallen,1647,3,15,2,15,43,58,-15,47
Lucerne,1647,4,12,7,13,39,43,-4,43
Grasshoppers,1647,5,11,7,14,43,46,-3,40
FC Zürich,1647,6,10,9,13,40,38,2,39
FC Lugano,1647,7,11,5,16,33,50,-17,38
FC Thun,1647,8,9,5,18,42,60,-18,32
FC Sion,1647,9,7,8,17,40,54,-14,29
Young Boys,1648,1,24,6,2,77,32,45,78
FC Basel,1648,2,17,8,7,52,30,22,59
St Gallen,1648,3,13,6,13,42,53,-11,45
Lucerne,1648,4,12,8,12,40,43,-3,44
FC Zürich,1648,5,10,10,12,41,38,3,40
FC Lugano,1648,6,10,7,15,30,47,-17,37
FC Thun,1648,7,10,6,16,45,59,-14,36
Grasshoppers,1648,8,9,7,16,41,52,-11,34
FC Sion,1648,9,6,8,18,44,58,-14,26
Young Boys,1649,1,21,7,4,76,37,39,70
FC Basel,1649,2,19,8,5,58,27,31,65
Lucerne,1649,3,13,7,12,42,46,-4,46
St Gallen,1649,4,14,2,16,42,58,-16,44
FC Zürich,1649,5,11,10,11,42,36,6,43
Grasshoppers,1649,6,12,6,14,47,46,1,42
FC Lugano,1649,7,9,5,18,27,51,-24,32
FC Thun,1649,8,8,7,17,43,63,-20,31
FC Sion,1649,9,7,8,17,41,54,-13,29
Young Boys,1650,1,21,7,4,75,38,37,70
FC Basel,1650,2,18,9,5,57,22,35,63
Lucerne,1650,3,13,8,11,43,44,-1,47
St Gallen,1650,4,13,4,15,42,57,-15,43
FC Zürich,1650,5,11,9,12,41,40,1,42
FC Thun,1650,6,11,5,16,46,57,-11,38
Grasshoppers,1650,7,10,7,15,42,52,-10,37
FC Lugano,1650,8,10,5,17,33,53,-20,35
FC Sion,1650,9,5,10,17,38,54,-16,25
Young Boys,1651,1,22,6,4,70,32,38,72
FC Basel,1651,2,17,8,7,54,31,23,59
Lucerne,1651,3,13,8,11,42,41,1,47
St Gallen,1651,4,14,3,15,47,56,-9,45
FC Zürich,1651,5,10,11,11,39,36,3,41
FC Thun,1651,6,11,6,15,50,56,-6,39
FC Lugano,1651,7,11,5,16,31,49,-18,38
FC Sion,1651,8,7,9,16,39,54,-15,30
Grasshoppers,1651,9,8,6,18,38,55,-17,30
Young Boys,1652,1,21,7,4,69,36,33,70
FC Basel,1652,2,15,10,7,49,30,19,55
Lucerne,1652,3,13,9,10,42,43,-1,48
St Gallen,1652,4,15,2,15,45,53,-8,47
FC Zürich,1652,5,12,9,11,45,37,8,45
Grasshoppers,1652,6,10,7,15,43,48,-5,37
FC Lugano,1652,7,10,6,16,31,47,-16,36
FC Thun,1652,8,9,7,16,44,56,-12,34
FC Sion,1652,9,7,7,18,39,57,-18,28
Young Boys,1653,1,20,8,4,68,38,30,68
FC Basel,1653,2,18,9,5,56,26,30,63
Lucerne,1653,3,14,8,10,47,40,7,50
St Gallen,1653,4,13,4,15,41,59,-18,43
FC Zürich,1653,5,9,10,13,38,40,-2,37
FC Lugano,1653,6,10,7,15,30,44,-14,37
Grasshoppers,1653,7,9,8,15,42,49,-7,35
FC Sion,1653,8,8,9,15,43,50,-7,33
FC Thun,1653,9,8,7,17,40,59,-19,31
Young Boys,1654,1,20,10,2,71,36,35,70
FC Basel,1654,2,16,9,7,52,29,23,57
Lucerne,1654,3,13,8,11,43,42,1,47
St Gallen,1654,4,14,2,16,45,56,-11,44
FC Zürich,1654,5,11,9,12,38,37,1,42
FC Thun,1654,6,10,6,16,46,59,-13,36
FC Lugano,1654,7,10,6,16,30,48,-18,36
Grasshoppers,1654,8,9,8,15,42,50,-8,35
FC Sion,1654,9,7,10,15,42,52,-10,31
Young Boys,1655,1,20,8,4,73,40,33,68
FC Basel,1655,2,18,9,5,57,25,32,63
St Gallen,1655,3,14,5,13,44,54,-10,47
Lucerne,1655,4,12,9,11,43,48,-5,45
FC Zürich,1655,5,10,10,12,43,39,4,40
Grasshoppers,1655,6,11,6,15,46,50,-4,39
FC Lugano,1655,7,10,7,15,30,46,-16,37
FC Thun,1655,8,9,6,17,44,63,-19,33
FC Sion,1655,9,5,10,17,42,57,-15,25
Young Boys,1656,1,21,8,3,71,36,35,71
FC Basel,1656,2,18,9,5,54,26,28,63
Lucerne,1656,3,13,7,12,43,46,-3,46
St Gallen,1656,4,13,2,17,40,60,-20,41
Grasshoppers,1656,5,11,6,15,44,48,-4,39
FC Lugano,1656,6,11,5,16,32,47,-15,38
FC Zürich,1656,7,9,10,13,40,42,-2,37
FC Thun,1656,8,10,6,16,46,58,-12,36
FC Sion,1656,9,7,9,16,46,53,-7,30
Young Boys,1657,1,23,6,3,74,34,40,75
FC Basel,1657,2,19,7,6,60,25,35,64
Lucerne,1657,3,13,7,12,40,46,-6,46
St Gallen,1657,4,14,3,15,41,57,-16,45
FC Zürich,1657,5,11,11,10,43,36,7,44
Grasshoppers,1657,6,10,6,16,39,50,-11,36
FC Thun,1657,7,9,6,17,43,59,-16,33
FC Lugano,1657,8,9,6,17,29,48,-19,33
FC Sion,1657,9,6,8,18,42,56,-14,26
Young Boys,1658,1,22,7,3,73,34,39,73
FC Basel,1658,2,18,7,7,53,27,26,61
St Gallen,1658,3,15,2,15,44,55,-11,47
FC Zürich,1658,4,11,10,11,44,34,10,43
Lucerne,1658,5,11,7,14,39,48,-9,40
FC Lugano,1658,6,11,5,16,33,49,-16,38
Grasshoppers,1658,7,9,9,14,41,48,-7,36
FC Thun,1658,8,8,8,16,43,59,-16,32
FC Sion,1658,9,7,9,16,40,56,-16,30
Young Boys,1659,1,23,6,3,77,37,40,75
FC Basel,1659,2,17,8,7,56,32,24,59
St Gallen,1659,3,14,5,13,47,55,-8,47
Lucerne,1659,4,11,9,12,41,47,-6,42
FC Zürich,1659,5,9,11,12,40,38,2,38
Grasshoppers,1659,6,9,8,15,39,48,-9,35
FC Lugano,1659,7,9,8,15,32,51,-19,35
FC Thun,1659,8,9,7,16,44,60,-16,34
FC Sion,1659,9,7,10,15,43,51,-8,31
Young Boys,1660,1,20,8,4,70,39,31,68
FC Basel,1660,2,17,9,6,53,27,26,60
St Gallen,1660,3,15,4,13,46,53,-7,49
Lucerne,1660,4,13,9,10,45,44,1,48
FC Zürich,1660,5,11,9,12,45,37,8,42
FC Thun,1660,6,11,5,16,48,57,-9,38
FC Lugano,1660,7,10,6,16,33,51,-18,36
Grasshoppers,1660,8,9,7,16,39,52,-13,34
FC Sion,1660,9,6,7,19,41,60,-19,25
Young Boys,1661,1,21,7,4,67,32,35,70
FC Basel,1661,2,16,10,6,55,29,26,58
Lucerne,1661,3,14,8,10,46,43,3,50
St Gallen,1661,4,15,2,15,42,57,-15,47
FC Zürich,1661,5,10,10,12,40,38,2,40
FC Sion,1661,6,9,8,15,45,48,-3,35
FC Lugano,1661,7,10,5,17,30,48,-18,35
Grasshoppers,1661,8,9,7,16,39,50,-11,34
FC Thun,1661,9,8,7,17,44,63,-19,31
Young Boys,1662,1,23,6,3,79,34,45,75
FC Basel,1662,2,18,7,7,54,26,28,61
Lucerne,1662,3,13,7,12,44,47,-3,46
St Gallen,1662,4,14,4,14,43,56,-13,46
FC Zürich,1662,5,11,10,11,40,37,3,43
FC Thun,1662,6,10,6,16,45,56,-11,36
Grasshoppers,1662,7,9,8,15,39,51,-12,35
FC Lugano,1662,8,9,6,17,29,49,-20,33
FC Sion,1662,9,5,10,17,39,56,-17,25
Young Boys,1663,1,23,7,2,74,35,39,76
FC Basel,1663,2,18,7,7,55,25,30,61
St Gallen,1663,3,14,4,14,43,54,-11,46
Lucerne,1663,4,11,9,12,40,45,-5,42
FC Zürich,1663,5,10,10,12,37,38,-1,40
Grasshoppers,1663,6,10,6,16,41,51,-10,36
FC Thun,1663,7,10,6,16,45,57,-12,36
FC Lugano,1663,8,10,6,16,30,46,-16,36
FC Sion,1663,9,5,11,16,37,51,-14,26
Young Boys,1664,1,21,8,3,68,32,36,71
FC Basel,1664,2,19,7,6,56,26,30,64
Lucerne,1664,3,13,7,12,43,43,0,46
St Gallen,1664,4,14,3,15,41,56,-15,45
FC Zürich,1664,5,10,10,12,42,40,2,40
FC Lugano,1664,6,11,6,15,31,45,-14,39
FC Thun,1664,7,10,5,17,45,58,-13,35
Grasshoppers,1664,8,8,8,16,41,52,-11,32
FC Sion,1664,9,6,10,16,42,57,-15,28
Young Boys,1665,1,22,7,3,75,35,40,73
FC Basel,1665,2,17,10,5,54,26,28,61
Lucerne,1665,3,12,9,11,43,44,-1,45
FC Zürich,1665,4,11,11,10,47,36,11,44
St Gallen,1665,5,13,3,16,40,57,-17,42
FC Thun,1665,6,10,7,15,44,56,-12,37
FC Lugano,1665,7,10,6,16,31,49,-18,36
Grasshoppers,1665,8,9,6,17,40,52,-12,33
FC Sion,1665,9,7,7,18,43,62,-19,28
Young Boys,1666,1,21,7,4,75,39,36,70
FC Basel,1666,2,18,7,7,57,28,29,61
Lucerne,1666,3,13,7,12,42,46,-4,46
FC Zürich,1666,4,12,9,11,44,38,6,45
St Gallen,1666,5,14,2,16,43,57,-14,44
Grasshoppers,1666,6,12,6,14,47,48,-1,42
FC Lugano,1666,7,10,5,17,29,49,-20,35
FC Thun,1666,8,9,5,18,44,63,-19,32
FC Sion,1666,9,7,8,17,44,57,-13,29
Young Boys,1667,1,21,7,4,72,36,36,70
FC Basel,1667,2,17,9,6,58,28,30,60
Lucerne,1667,3,13,9,10,46,45,1,48
St Gallen,1667,4,14,2,16,42,58,-16,44
FC Zürich,1667,5,10,11,11,42,39,3,41
FC Lugano,1667,6,11,5,16,35,47,-12,38
Grasshoppers,1667,7,8,9,15,41,51,-10,33
FC Thun,1667,8,9,6,17,46,67,-21,33
FC Sion,1667,9,8,8,16,44,55,-11,32
Young Boys,1668,1,22,6,4,71,36,35,72
FC Basel,1668,2,17,8,7,48,23,25,59
Lucerne,1668,3,12,9,11,44,45,-1,45
St Gallen,1668,4,14,3,15,43,57,-14,45
FC Zürich,1668,5,11,9,12,39,35,4,42
FC Lugano,1668,6,11,6,15,33,46,-13,39
Grasshoppers,1668,7,10,7,15,43,49,-6,37
FC Thun,1668,8,9,6,17,39,56,-17,33
FC Sion,1668,9,7,8,17,39,52,-13,29
Young Boys,1669,1,21,8,3,71,35,36,71
FC Basel,1669,2,17,8,7,53,28,25,59
Lucerne,1669,3,13,9,10,45,45,0,48
St Gallen,1669,4,15,3,14,45,55,-10,48
FC Zürich,1669,5,10,10,12,42,38,4,40
FC Lugano,1669,6,10,7,15,30,45,-15,37
Grasshoppers,1669,7,10,6,16,40,50,-10,36
FC Sion,1669,8,7,9,16,41,51,-10,30
FC Thun,1669,9,8,6,18,40,60,-20,30
Young Boys,1670,1,21,8,3,73,36,37,71
FC Basel,1670,2,17,8,7,62,35,27,59
St Gallen,1670,3,14,4,14,49,59,-10,46
Lucerne,1670,4,11,10,11,44,49,-5,43
FC Zürich,1670,5,11,9,12,40,37,3,42
FC Thun,1670,6,11,5,16,44,56,-12,38
FC Lugano,1670,7,11,5,16,31,47,-16,38
FC Sion,1670,8,8,8,16,43,52,-9,32
Grasshoppers,1670,9,8,7,17,37,52,-15,31
Young Boys,1671,1,24,6,2,77,31,46,78
FC Basel,1671,2,18,8,6,52,23,29,62
Lucerne,1671,3,12,9,11,45,45,0,45
St Gallen,1671,4,14,3,15,41,54,-13,45
FC Zürich,1671,5,11,9,12,40,38,2,42
FC Thun,1671,6,11,5,16,46,58,-12,38
FC Lugano,1671,7,10,5,17,31,55,-24,35
Grasshoppers,1671,8,8,8,16,41,52,-11,32
FC Sion,1671,9,5,9,18,39,56,-17,24
Young Boys,1672,1,21,7,4,70,36,34,70
FC Basel,1672,2,19,7,6,58,24,34,64
St Gallen,1672,3,15,4,13,44,52,-8,49
Lucerne,1672,4,12,9,11,39,41,-2,45
FC Zürich,1672,5,11,10,11,44,38,6,43
Grasshoppers,1672,6,10,7,15,44,51,-7,37
FC Lugano,1672,7,9,7,16,30,49,-19,34
FC Sion,1672,8,7,8,17,42,55,-13,29
FC Thun,1672,9,8,5,19,41,66,-25,29
Young Boys,1673,1,21,9,2,73,36,37,72
FC Basel,1673,2,16,7,9,50,30,20,55
St Gallen,1673,3,15,3,14,43,53,-10,48
Lucerne,1673,4,12,7,13,43,48,-5,43
Grasshoppers,1673,5,11,7,14,45,48,-3,40
FC Zürich,1673,6,10,9,13,38,36,2,39
FC Thun,1673,7,11,5,16,49,58,-9,38
FC Lugano,1673,8,10,7,15,31,46,-15,37
FC Sion,1673,9,7,8,17,40,57,-17,29
Young Boys,1674,1,21,8,3,73,35,38,71
FC Basel,1674,2,18,8,6,54,23,31,62
Lucerne,1674,3,13,8,11,43,43,0,47
FC Zürich,1674,4,12,10,10,43,35,8,46
St Gallen,1674,5,13,4,15,40,53,-13,43
Grasshoppers,1674,6,10,7,15,40,50,-10,37
FC Lugano,1674,7,9,7,16,29,47,-18,34
FC Sion,1674,8,7,9,16,42,55,-13,30
FC Thun,1674,9,8,5,19,40,63,-23,29
Young Boys,1675,1,21,7,4,78,38,40,70
FC Basel,1675,2,18,9,5,56,26,30,63
St Gallen,1675,3,14,3,15,43,56,-13,45
Lucerne,1675,4,11,10,11,41,46,-5,43
FC Zürich,1675,5,9,12,11,39,37,2,39
FC Lugano,1675,6,11,6,15,32,45,-13,39
Grasshoppers,1675,7,9,7,16,42,52,-10,34
FC Thun,1675,8,8,9,15,43,58,-15,33
FC Sion,1675,9,7,9,16,41,57,-16,30
Young Boys,1676,1,21,6,5,72,36,36,69
FC Basel,1676,2,19,8,5,55,25,30,65
St Gallen,1676,3,15,3,14,45,53,-8,48
Lucerne,1676,4,12,8,12,42,46,-4,44
FC Zürich,1676,5,10,10,12,41,38,3,40
Grasshoppers,1676,6,10,8,14,42,46,-4,38
FC Thun,1676,7,9,7,16,45,60,-15,34
FC Lugano,1676,8,9,5,18,28,52,-24,32
FC Sion,1676,9,7,9,16,38,52,-14,30
Young Boys,1677,1,23,7,2,77,32,45,76
FC Basel,1677,2,17,10,5,59,24,35,61
Lucerne,1677,3,12,9,11,42,47,-5,45
FC Zürich,1677,4,11,11,10,39,33,6,44
St Gallen,1677,5,13,4,15,41,55,-14,43
FC Lugano,1677,6,10,6,16,29,49,-20,36
FC Thun,1677,7,9,5,18,44,62,-18,32
FC Sion,1677,8,8,7,17,39,50,-11,31
Grasshoppers,1677,9,8,7,17,37,55,-18,31
Young Boys,1678,1,21,8,3,71,33,38,71
FC Basel,1678,2,19,8,5,54,23,31,65
Lucerne,1678,3,13,8,11,42,43,-1,47
St Gallen,1678,4,14,3,15,43,55,-12,45
FC Zürich,1678,5,10,10,12,40,35,5,40
FC Thun,1678,6,10,6,16,44,59,-15,36
FC Lugano,1678,7,10,6,16,31,48,-17,36
Grasshoppers,1678,8,8,8,16,41,54,-13,32
FC Sion,1678,9,6,9,17,40,56,-16,27
Young Boys,1679,1,22,6,4,71,35,36,72
FC Basel,1679,2,18,7,7,51,25,26,61
St Gallen,1679,3,15,3,14,45,56,-11,48
Lucerne,1679,4,13,7,12,40,43,-3,46
FC Lugano,1679,5,11,5,16,31,46,-15,38
FC Zürich,1679,6,9,10,13,40,39,1,37
FC Thun,1679,7,10,6,16,45,61,-16,36
Grasshoppers,1679,8,9,6,17,39,50,-11,33
FC Sion,1679,9,8,8,16,48,55,-7,32
Young Boys,1680,1,23,7,2,71,33,38,76
FC Basel,1680,2,16,10,6,53,26,27,58
St Gallen,1680,3,15,2,15,44,55,-11,47
Lucerne,1680,4,12,9,11,42,46,-4,45
FC Zürich,1680,5,10,11,11,41,36,5,41
FC Lugano,1680,6,11,5,16,33,47,-14,38
Grasshoppers,1680,7,9,7,16,37,47,-10,34
FC Thun,1680,8,9,7,16,44,59,-15,34
FC Sion,1680,9,6,8,18,42,58,-16,26
Young Boys,1681,1,19,9,4,67,35,32,66
FC Basel,1681,2,16,9,7,50,26,24,57
Lucerne,1681,3,14,9,9,44,39,5,51
St Gallen,1681,4,15,2,15,42,55,-13,47
FC Zürich,1681,5,10,11,11,40,37,3,41
Grasshoppers,1681,6,10,6,16,41,50,-9,36
FC Lugano,1681,7,10,6,16,32,50,-18,36
FC Thun,1681,8,10,5,17,43,61,-18,35
FC Sion,1681,9,7,9,16,45,51,-6,30
Young Boys,1682,1,20,9,3,73,39,34,69
FC Basel,1682,2,19,8,5,58,22,36,65
St Gallen,1682,3,15,3,14,46,55,-9,48
Lucerne,1682,4,12,11,9,44,43,1,47
FC Zürich,1682,5,9,11,12,39,37,2,38
FC Lugano,1682,6,9,8,15,31,49,-18,35
Grasshoppers,1682,7,9,7,16,39,51,-12,34
FC Thun,1682,8,9,5,18,39,59,-20,32
FC Sion,1682,9,6,10,16,39,53,-14,28
Young Boys,1683,1,22,6,4,68,32,36,72
FC Basel,1683,2,20,7,5,54,21,33,67
Lucerne,1683,3,13,7,12,41,45,-4,46
St Gallen,1683,4,14,2,16,43,59,-16,44
FC Lugano,1683,5,12,5,15,34,44,-10,41
FC Zürich,1683,6,10,9,13,38,39,-1,39
FC Thun,1683,7,11,5,16,43,55,-12,38
Grasshoppers,1683,8,8,7,17,39,51,-12,31
FC Sion,1683,9,6,8,18,41,55,-14,26
Young Boys,1684,1,20,7,5,72,41,31,67
FC Basel,1684,2,20,7,5,55,24,31,67
Lucerne,1684,3,13,8,11,42,42,0,47
St Gallen,1684,4,14,2,16,44,57,-13,44
FC Zürich,1684,5,11,10,11,44,37,7,43
Grasshoppers,1684,6,9,8,15,40,49,-9,35
FC Thun,1684,7,10,5,17,45,62,-17,35
FC Lugano,1684,8,10,5,17,32,49,-17,35
FC Sion,1684,9,6,10,16,43,56,-13,28
Young Boys,1685,1,20,8,4,67,35,32,68
FC Basel,1685,2,18,8,6,52,25,27,62
St Gallen,1685,3,15,3,14,43,54,-11,48
FC Zürich,1685,4,12,9,11,43,37,6,45
Lucerne,1685,5,12,8,12,39,42,-3,44
FC Thun,1685,6,10,6,16,48,60,-12,36
Grasshoppers,1685,7,9,7,16,42,50,-8,34
FC Lugano,1685,8,9,7,16,28,45,-17,34
FC Sion,1685,9,7,8,17,43,57,-14,29
Young Boys,1686,1,23,7,2,72,33,39,76
FC Basel,1686,2,17,10,5,52,25,27,61
Lucerne,1686,3,12,9,11,42,43,-1,45
St Gallen,1686,4,14,3,15,42,55,-13,45
FC Zürich,1686,5,11,9,12,43,37,6,42
FC Thun,1686,6,11,5,16,46,57,-11,38
FC Lugano,1686,7,10,6,16,32,48,-16,36
Grasshoppers,1686,8,9,6,17,39,50,-11,33
FC Sion,1686,9,6,7,19,40,60,-20,25
Young Boys,1687,1,22,8,2,73,34,39,74
FC Basel,1687,2,17,9,6,52,25,27,60
Lucerne,1687,3,13,7,12,43,44,-1,46
St Gallen,1687,4,14,2,16,40,55,-15,44
FC Zürich,1687,5,11,10,11,39,34,5,43
FC Thun,1687,6,11,5,16,44,57,-13,38
FC Lugano,1687,7,10,6,16,33,49,-16,36
Grasshoppers,1687,8,9,6,17,38,49,-11,33
FC Sion,1687,9,7,7,18,40,55,-15,28
Young Boys,1688,1,22,7,3,76,37,39,73
FC Basel,1688,2,17,9,6,54,29,25,60
Lucerne,1688,3,14,9,9,45,40,5,51
FC Zürich,1688,4,11,9,12,45,40,5,42
St Gallen,1688,5,13,3,16,43,58,-15,42
Grasshoppers,1688,6,8,10,14,42,50,-8,34
FC Lugano,1688,7,9,6,17,31,51,-20,33
FC Thun,1688,8,8,8,16,44,62,-18,32
FC Sion,1688,9,7,9,16,45,58,-13,30
Young Boys,1689,1,20,8,4,68,34,34,68
FC Basel,1689,2,18,8,6,53,24,29,62
Lucerne,1689,3,13,9,10,44,43,1,48
St Gallen,1689,4,14,4,14,42,52,-10,46
FC Zürich,1689,5,12,9,11,42,34,8,45
Grasshoppers,1689,6,9,8,15,42,50,-8,35
FC Thun,1689,7,9,6,17,44,59,-15,33
FC Lugano,1689,8,9,6,17,30,53,-23,33
FC Sion,1689,9,7,8,17,39,55,-16,29
Young Boys,1690,1,20,7,5,72,39,33,67
FC Basel,1690,2,19,8,5,55,25,30,65
Lucerne,1690,3,14,9,9,48,38,10,51
St Gallen,1690,4,14,2,16,42,59,-17,44
FC Zürich,1690,5,10,10,12,38,35,3,40
Grasshoppers,1690,6,10,7,15,47,52,-5,37
FC Lugano,1690,7,10,5,17,31,54,-23,35
FC Thun,1690,8,9,6,17,44,60,-16,33
FC Sion,1690,9,7,8,17,40,55,-15,29
Young Boys,1691,1,23,6,3,71,34,37,75
FC Basel,1691,2,18,8,6,53,25,28,62
St Gallen,1691,3,15,3,14,48,53,-5,48
Lucerne,1691,4,13,7,12,42,47,-5,46
FC Zürich,1691,5,11,10,11,46,37,9,43
FC Lugano,1691,6,10,6,16,32,50,-18,36
FC Thun,1691,7,10,5,17,44,59,-15,35
Grasshoppers,1691,8,9,6,17,40,52,-12,33
FC Sion,1691,9,6,7,19,38,57,-19,25
Young Boys,1692,1,21,7,4,71,38,33,70
FC Basel,1692,2,19,8,5,58,24,34,65
Lucerne,1692,3,12,9,11,41,43,-2,45
St Gallen,1692,4,13,4,15,42,56,-14,43
FC Lugano,1692,5,11,6,15,33,46,-13,39
FC Zürich,1692,6,9,11,12,38,38,0,38
Grasshoppers,1692,7,9,8,15,42,50,-8,35
FC Thun,1692,8,9,7,16,42,59,-17,34
FC Sion,1692,9,7,8,17,40,53,-13,29
Young Boys,1693,1,20,9,3,67,33,34,69
FC Basel,1693,2,18,8,6,54,27,27,62
Lucerne,1693,3,13,10,9,42,39,3,49
St Gallen,1693,4,15,2,15,41,54,-13,47
FC Zürich,1693,5,11,10,11,44,33,11,43
Grasshoppers,1693,6,10,7,15,40,45,-5,37
FC Lugano,1693,7,9,8,15,29,46,-17,35
FC Thun,1693,8,9,6,17,42,58,-16,33
FC Sion,1693,9,5,8,19,35,59,-24,23
Young Boys,1694,1,22,7,3,72,35,37,73
FC Basel,1694,2,17,9,6,54,26,28,60
St Gallen,1694,3,15,4,13,43,51,-8,49
FC Zürich,1694,4,11,11,10,42,36,6,44
Lucerne,1694,5,11,9,12,40,47,-7,42
FC Lugano,1694,6,9,8,15,30,48,-18,35
FC Thun,1694,7,9,7,16,44,59,-15,34
Grasshoppers,1694,8,8,7,17,43,54,-11,31
FC Sion,1694,9,7,8,17,40,52,-12,29
Young Boys,1695,1,22,8,2,71,32,39,74
FC Basel,1695,2,18,9,5,55,23,32,63
St Gallen,1695,3,15,4,13,44,52,-8,49
Lucerne,1695,4,12,9,11,40,42,-2,45
FC Zürich,1695,5,10,11,11,39,37,2,41
FC Thun,1695,6,10,6,16,44,57,-13,36
Grasshoppers,1695,7,9,8,15,45,50,-5,35
FC Lugano,1695,8,9,6,17,28,49,-21,33
FC Sion,1695,9,5,7,20,37,61,-24,22
Young Boys,1696,1,23,6,3,70,33,37,75
FC Basel,1696,2,18,7,7,57,27,30,61
Lucerne,1696,3,14,7,11,46,46,0,49
St Gallen,1696,4,14,3,15,43,56,-13,45
FC Zürich,1696,5,10,10,12,41,37,4,40
FC Lugano,1696,6,11,5,16,33,48,-15,38
Grasshoppers,1696,7,9,6,17,37,51,-14,33
FC Thun,1696,8,9,5,18,42,59,-17,32
FC Sion,1696,9,7,9,16,40,52,-12,30
Young Boys,1697,1,21,7,4,71,36,35,70
FC Basel,1697,2,19,7,6,60,28,32,64
Lucerne,1697,3,13,8,11,40,44,-4,47
St Gallen,1697,4,14,4,14,40,52,-12,46
FC Thun,1697,5,11,5,16,48,60,-12,38
FC Zürich,1697,6,9,10,13,40,42,-2,37
FC Lugano,1697,7,10,6,16,32,47,-15,36
Grasshoppers,1697,8,9,7,16,44,51,-7,34
FC Sion,1697,9,7,8,17,42,57,-15,29
Young Boys,1698,1,21,7,4,74,36,38,70
FC Basel,1698,2,18,9,5,57,25,32,63
St Gallen,1698,3,15,4,13,42,49,-7,49
FC Zürich,1698,4,11,10,11,45,36,9,43
Lucerne,1698,5,12,7,13,39,47,-8,43
Grasshoppers,1698,6,10,7,15,43,49,-6,37
FC Lugano,1698,7,10,6,16,31,50,-19,36
FC Thun,1698,8,10,5,17,47,63,-16,35
FC Sion,1698,9,5,9,18,41,64,-23,24
Young Boys,1699,1,20,8,4,67,34,33,68
FC Basel,1699,2,18,9,5,55,25,30,63
St Gallen,1699,3,14,5,13,44,54,-10,47
Lucerne,1699,4,12,10,10,44,45,-1,46
FC Zürich,1699,5,10,9,13,42,43,-1,39
FC Thun,1699,6,10,7,15,45,57,-12,37
Grasshoppers,1699,7,10,6,16,40,48,-8,36
FC Lugano,1699,8,10,6,16,32,48,-16,36
FC Sion,1699,9,5,10,17,40,55,-15,25
Young Boys,1700,1,21,6,5,68,34,34,69
FC Basel,1700,2,16,9,7,50,27,23,57
St Gallen,1700,3,15,3,14,44,57,-13,48
Lucerne,1700,4,12,8,12,39,43,-4,44
Grasshoppers,1700,5,12,6,14,46,47,-1,42
FC Lugano,1700,6,11,6,15,32,43,-11,39
FC Zürich,1700,7,9,10,13,39,39,0,37
FC Thun,1700,8,9,6,17,40,60,-20,33
FC Sion,1700,9,8,8,16,48,56,-8,32
Young Boys,1701,1,20,7,5,69,38,31,67
FC Basel,1701,2,18,9,5,60,31,29,63
St Gallen,1701,3,14,4,14,46,58,-12,46
Lucerne,1701,4,12,9,11,46,49,-3,45
FC Lugano,1701,5,12,5,15,37,44,-7,41
FC Zürich,1701,6,9,12,11,40,40,0,39
Grasshoppers,1701,7,11,6,15,45,52,-7,39
FC Thun,1701,8,8,6,18,48,67,-19,30
FC Sion,1701,9,7,8,17,44,56,-12,29
Young Boys,1702,1,22,6,4,74,32,42,72
FC Basel,1702,2,18,8,6,54,26,28,62
St Gallen,1702,3,14,4,14,43,54,-11,46
Lucerne,1702,4,12,8,12,40,47,-7,44
FC Zürich,1702,5,11,10,11,40,35,5,43
Grasshoppers,1702,6,10,6,16,42,47,-5,36
FC Lugano,1702,7,10,6,16,30,50,-20,36
FC Thun,1702,8,9,7,16,45,61,-16,34
FC Sion,1702,9,6,9,17,39,55,-16,27
Young Boys,1703,1,21,7,4,70,38,32,70
FC Basel,1703,2,19,8,5,54,24,30,65
St Gallen,1703,3,15,3,14,40,50,-10,48
Lucerne,1703,4,11,8,13,39,45,-6,41
FC Zürich,1703,5,10,10,12,41,39,2,40
Grasshoppers,1703,6,11,6,15,43,48,-5,39
FC Lugano,1703,7,11,5,16,33,46,-13,38
FC Thun,1703,8,10,6,16,46,57,-11,36
FC Sion,1703,9,5,9,18,37,56,-19,24
Young Boys,1704,1,21,8,3,68,34,34,71
FC Basel,1704,2,17,7,8,52,29,23,58
St Gallen,1704,3,15,2,15,45,57,-12,47
Lucerne,1704,4,12,8,12,40,42,-2,44
FC Zürich,1704,5,11,9,12,39,34,5,42
FC Lugano,1704,6,11,6,15,31,46,-15,39
FC Thun,1704,7,11,5,16,45,57,-12,38
Grasshoppers,1704,8,9,6,17,40,51,-11,33
FC Sion,1704,9,8,7,17,41,51,-10,31
Young Boys,1705,1,22,7,3,71,35,36,73
FC Basel,1705,2,18,8,6,59,26,33,62
Lucerne,1705,3,14,7,11,43,45,-2,49
St Gallen,1705,4,14,2,16,41,56,-15,44
FC Zürich,1705,5,9,11,12,43,41,2,38
Grasshoppers,1705,6,10,7,15,43,48,-5,37
FC Lugano,1705,7,10,6,16,31,49,-18,36
FC Thun,1705,8,10,5,17,44,58,-14,35
FC Sion,1705,9,7,7,18,40,57,-17,28
Young Boys,1706,1,21,6,5,69,38,31,69
FC Basel,1706,2,18,7,7,56,28,28,61
St Gallen,1706,3,16,3,13,45,53,-8,51
Lucerne,1706,4,14,7,11,44,42,2,49
FC Zürich,1706,5,12,9,11,44,38,6,45
FC Lugano,1706,6,10,6,16,30,47,-17,36
Grasshoppers,1706,7,9,7,16,42,50,-8,34
FC Thun,1706,8,9,6,17,46,62,-16,33
FC Sion,1706,9,6,7,19,41,59,-18,25
Young Boys,1707,1,21,7,4,73,35,38,70
FC Basel,1707,2,19,8,5,59,27,32,65
Lucerne,1707,3,12,10,10,41,41,0,46
St Gallen,1707,4,14,4,14,45,57,-12,46
FC Zürich,1707,5,11,9,12,42,40,2,42
FC Lugano,1707,6,11,5,16,32,47,-15,38
Grasshoppers,1707,7,9,8,15,38,49,-11,35
FC Thun,1707,8,9,6,17,43,59,-16,33
FC Sion,1707,9,5,9,18,36,54,-18,24
Young Boys,1708,1,21,9,2,76,37,39,72
FC Basel,1708,2,17,8,7,55,33,22,59
FC Zürich,1708,3,12,9,11,44,33,11,45
St Gallen,1708,4,14,3,15,42,55,-13,45
Lucerne,1708,5,11,11,10,44,46,-2,44
FC Lugano,1708,6,11,6,15,33,47,-14,39
FC Thun,1708,7,10,5,17,50,58,-8,35
Grasshoppers,1708,8,8,8,16,40,54,-14,32
FC Sion,1708,9,7,7,18,40,61,-21,28
Young Boys,1709,1,22,7,3,71,34,37,73
FC Basel,1709,2,18,7,7,60,26,34,61
Lucerne,1709,3,13,8,11,44,47,-3,47
St Gallen,1709,4,15,2,15,48,62,-14,47
FC Zürich,1709,5,12,9,11,44,37,7,45
FC Lugano,1709,6,10,5,17,33,50,-17,35
Grasshoppers,1709,7,8,9,15,39,48,-9,33
FC Thun,1709,8,9,6,17,43,63,-20,33
FC Sion,1709,9,6,9,17,37,52,-15,27
Young Boys,1710,1,22,8,2,76,34,42,74
FC Basel,1710,2,18,7,7,54,29,25,61
Lucerne,1710,3,12,8,12,40,44,-4,44
St Gallen,1710,4,14,2,16,41,57,-16,44
FC Zürich,1710,5,10,9,13,41,38,3,39
FC Lugano,1710,6,11,6,15,31,45,-14,39
Grasshoppers,1710,7,10,8,14,43,49,-6,38
FC Thun,1710,8,10,5,17,45,60,-15,35
FC Sion,1710,9,7,7,18,44,59,-15,28
Young Boys,1711,1,21,8,3,69,33,36,71
FC Basel,1711,2,17,8,7,53,28,25,59
St Gallen,1711,3,14,5,13,46,56,-10,47
FC Zürich,1711,4,11,11,10,42,35,7,44
Lucerne,1711,5,12,8,12,42,44,-2,44
FC Lugano,1711,6,10,7,15,32,48,-16,37
Grasshoppers,1711,7,8,9,15,39,49,-10,33
FC Thun,1711,8,9,6,17,42,58,-16,33
FC Sion,1711,9,6,10,16,39,53,-14,28
Young Boys,1712,1,22,7,3,74,34,40,73
FC Basel,1712,2,17,10,5,57,26,31,61
Lucerne,1712,3,13,10,9,46,42,4,49
St Gallen,1712,4,13,4,15,42,57,-15,43
FC Zürich,1712,5,10,11,11,41,38,3,41
FC Lugano,1712,6,11,5,16,34,51,-17,38
FC Thun,1712,7,10,6,16,45,62,-17,36
Grasshoppers,1712,8,8,8,16,41,53,-12,32
FC Sion,1712,9,5,9,18,40,57,-17,24
Young Boys,1713,1,22,7,3,71,35,36,73
FC Basel,1713,2,18,8,6,55,25,30,62
Lucerne,1713,3,12,9,11,46,47,-1,45
FC Zürich,1713,4,11,10,11,44,37,7,43
St Gallen,1713,5,13,4,15,44,59,-15,43
Grasshoppers,1713,6,10,8,14,46,50,-4,38
FC Lugano,1713,7,10,6,16,32,48,-16,36
FC Thun,1713,8,8,7,17,44,65,-21,31
FC Sion,1713,9,6,9,17,40,56,-16,27
Young Boys,1714,1,22,7,3,72,35,37,73
FC Basel,1714,2,18,8,6,55,24,31,62
Lucerne,1714,3,14,8,10,46,42,4,50
St Gallen,1714,4,14,3,15,43,55,-12,45
FC Zürich,1714,5,10,10,12,41,38,3,40
FC Lugano,1714,6,11,5,16,32,47,-15,38
Grasshoppers,1714,7,10,6,16,45,53,-8,36
FC Thun,1714,8,9,6,17,41,59,-18,33
FC Sion,1714,9,6,7,19,40,62,-22,25
Young Boys,1715,1,22,7,3,69,30,39,73
FC Basel,1715,2,17,8,7,50,25,25,59
St Gallen,1715,3,15,4,13,41,50,-9,49
FC Zürich,1715,4,13,9,10,41,33,8,48
Lucerne,1715,5,13,9,10,41,41,0,48
Grasshoppers,1715,6,9,6,17,40,50,-10,33
FC Lugano,1715,7,9,6,17,29,49,-20,33
FC Thun,1715,8,9,5,18,44,61,-17,32
FC Sion,1715,9,6,8,18,38,54,-16,26
Young Boys,1716,1,22,7,3,73,32,41,73
FC Basel,1716,2,16,10,6,51,26,25,58
Lucerne,1716,3,13,9,10,41,43,-2,48
FC Zürich,1716,4,11,11,10,44,35,9,44
St Gallen,1716,5,13,4,15,40,54,-14,43
Grasshoppers,1716,6,9,7,16,40,50,-10,34
FC Lugano,1716,7,9,7,16,29,49,-20,34
FC Thun,1716,8,9,6,17,43,59,-16,33
FC Sion,1716,9,7,9,16,40,53,-13,30
Young Boys,1717,1,22,6,4,68,33,35,72
FC Basel,1717,2,19,7,6,56,24,32,64
Lucerne,1717,3,12,9,11,42,44,-2,45
St Gallen,1717,4,13,4,15,43,58,-15,43
FC Zürich,1717,5,10,11,11,40,35,5,41
FC Lugano,1717,6,10,8,14,31,45,-14,38
Grasshoppers,1717,7,9,6,17,42,51,-9,33
FC Thun,1717,8,9,6,17,41,57,-16,33
FC Sion,1717,9,8,7,17,40,56,-16,31
Young Boys,1718,1,21,6,5,71,38,33,69
FC Basel,1718,2,19,7,6,59,27,32,64
St Gallen,1718,3,15,2,15,43,55,-12,47
Lucerne,1718,4,13,7,12,38,43,-5,46
FC Thun,1718,5,11,5,16,46,60,-14,38
FC Zürich,1718,6,9,10,13,40,41,-1,37
Grasshoppers,1718,7,10,7,15,44,50,-6,37
FC Lugano,1718,8,10,5,17,31,48,-17,35
FC Sion,1718,9,7,9,16,44,54,-10,30
Young Boys,1719,1,21,6,5,71,40,31,69
FC Basel,1719,2,17,10,5,59,29,30,61
St Gallen,1719,3,15,4,13,45,54,-9,49
Lucerne,1719,4,11,10,11,39,43,-4,43
FC Zürich,1719,5,10,10,12,43,42,1,40
FC Lugano,1719,6,11,5,16,33,48,-15,38
Grasshoppers,1719,7,9,9,14,43,49,-6,36
FC Thun,1719,8,9,7,16,43,57,-14,34
FC Sion,1719,9,6,9,17,39,53,-14,27
Young Boys,1720,1,22,7,3,74,34,40,73
FC Basel,1720,2,18,9,5,54,24,30,63
St Gallen,1720,3,14,4,14,42,54,-12,46
FC Zürich,1720,4,11,10,11,43,38,5,43
Lucerne,1720,5,12,7,13,41,48,-7,43
FC Thun,1720,6,11,5,16,44,55,-11,38
Grasshoppers,1720,7,10,6,16,43,49,-6,36
FC Lugano,1720,8,9,6,17,28,50,-22,33
FC Sion,1720,9,6,8,18,41,58,-17,26
Young Boys,1721,1,22,6,4,74,36,38,72
FC Basel,1721,2,16,9,7,51,28,23,57
St Gallen,1721,3,15,4,13,49,53,-4,49
Lucerne,1721,4,13,8,11,42,46,-4,47
FC Zürich,1721,5,11,10,11,41,34,7,43
FC Thun,1721,6,10,7,15,43,56,-13,37
FC Lugano,1721,7,10,5,17,29,51,-22,35
Grasshoppers,1721,8,9,7,16,41,51,-10,34
FC Sion,1721,9,6,8,18,40,55,-15,26
Young Boys,1722,1,21,8,3,72,32,40,71
FC Basel,1722,2,19,8,5,55,24,31,65
Lucerne,1722,3,13,7,12,40,47,-7,46
FC Zürich,1722,4,11,9,12,41,37,4,42
St Gallen,1722,5,13,3,16,42,56,-14,42
FC Lugano,1722,6,11,6,15,31,46,-15,39
Grasshoppers,1722,7,10,7,15,38,46,-8,37
FC Thun,1722,8,8,7,17,39,56,-17,31
FC Sion,1722,9,6,9,17,41,55,-14,27
Young Boys,1723,1,22,7,3,72,35,37,73
FC Basel,1723,2,17,8,7,52,30,22,59
St Gallen,1723,3,16,2,14,46,53,-7,50
FC Zürich,1723,4,12,10,10,45,32,13,46
Lucerne,1723,5,12,10,10,43,44,-1,46
Grasshoppers,1723,6,10,6,16,43,51,-8,36
FC Lugano,1723,7,10,6,16,29,47,-18,36
FC Thun,1723,8,8,7,17,44,62,-18,31
FC Sion,1723,9,5,8,19,38,58,-20,23
Young Boys,1724,1,21,7,4,73,37,36,70
FC Basel,1724,2,19,8,5,54,24,30,65
Lucerne,1724,3,14,7,11,43,42,1,49
St Gallen,1724,4,14,2,16,44,59,-15,44
FC Zürich,1724,5,11,10,11,41,36,5,43
Grasshoppers,1724,6,10,7,15,41,48,-7,37
FC Lugano,1724,7,10,5,17,35,52,-17,35
FC Thun,1724,8,9,5,18,42,57,-15,32
FC Sion,1724,9,7,7,18,38,56,-18,28
Young Boys,1725,1,22,6,4,72,34,38,72
FC Basel,1725,2,16,10,6,51,26,25,58
Lucerne,1725,3,14,9,9,48,42,6,51
FC Zürich,1725,4,12,10,10,40,33,7,46
St Gallen,1725,5,14,4,14,44,54,-10,46
Grasshoppers,1725,6,10,6,16,41,47,-6,36
FC Lugano,1725,7,10,5,17,31,53,-22,35
FC Thun,1725,8,8,8,16,41,59,-18,32
FC Sion,1725,9,5,8,19,37,57,-20,23
Young Boys,1726,1,21,6,5,69,36,33,69
FC Basel,1726,2,19,7,6,56,26,30,64
Lucerne,1726,3,15,7,10,45,42,3,52
FC Zürich,1726,4,12,9,11,43,37,6,45
St Gallen,1726,5,13,4,15,41,54,-13,43
FC Lugano,1726,6,10,6,16,31,48,-17,36
Grasshoppers,1726,7,9,6,17,40,51,-11,33
FC Thun,1726,8,9,5,18,42,60,-18,32
FC Sion,1726,9,7,8,17,40,53,-13,29
Young Boys,1727,1,21,9,2,73,36,37,72
FC Basel,1727,2,16,8,8,55,34,21,56
Lucerne,1727,3,14,9,9,45,40,5,51
St Gallen,1727,4,16,2,14,46,54,-8,50
FC Zürich,1727,5,11,10,11,42,35,7,43
FC Thun,1727,6,10,5,17,46,64,-18,35
FC Lugano,1727,7,9,7,16,32,49,-17,34
Grasshoppers,1727,8,9,6,17,40,56,-16,33
FC Sion,1727,9,6,8,18,46,57,-11,26
Young Boys,1728,1,22,6,4,73,36,37,72
FC Basel,1728,2,20,7,5,60,24,36,67
Lucerne,1728,3,14,7,11,44,45,-1,49
St Gallen,1728,4,14,2,16,41,57,-16,44
FC Zürich,1728,5,10,10,12,42,38,4,40
FC Lugano,1728,6,10,5,17,29,49,-20,35
Grasshoppers,1728,7,9,7,16,42,51,-9,34
FC Thun,1728,8,9,7,16,41,58,-17,34
FC Sion,1728,9,7,7,18,41,55,-14,28
Young Boys,1729,1,22,7,3,71,34,37,73
FC Basel,1729,2,17,9,6,56,28,28,60
St Gallen,1729,3,16,2,14,43,50,-7,50
Lucerne,1729,4,13,7,12,41,46,-5,46
FC Zürich,1729,5,11,10,11,40,35,5,43
Grasshoppers,1729,6,10,7,15,41,48,-7,37
FC Thun,1729,7,10,6,16,48,59,-11,36
FC Lugano,1729,8,10,5,17,30,49,-19,35
FC Sion,1729,9,5,7,20,35,56,-21,22
Young Boys,1730,1,21,8,3,71,36,35,71
FC Basel,1730,2,18,7,7,52,26,26,61
Lucerne,1730,3,13,8,11,44,44,0,47
St Gallen,1730,4,14,3,15,43,54,-11,45
FC Zürich,1730,5,11,10,11,38,33,5,43
Grasshoppers,1730,6,10,6,16,41,50,-9,36
FC Lugano,1730,7,10,6,16,31,48,-17,36
FC Thun,1730,8,10,5,17,44,58,-14,35
FC Sion,1730,9,6,9,17,36,51,-15,27
Young Boys,1731,1,22,6,4,71,34,37,72
FC Basel,1731,2,18,9,5,54,24,30,63
Lucerne,1731,3,13,7,12,43,49,-6,46
St Gallen,1731,4,14,3,15,41,53,-12,45
FC Zürich,1731,5,11,10,11,44,37,7,43
FC Lugano,1731,6,11,5,16,33,47,-14,38
Grasshoppers,1731,7,10,7,15,41,48,-7,37
FC Thun,1731,8,9,6,17,42,60,-18,33
FC Sion,1731,9,5,9,18,41,58,-17,24
Young Boys,1732,1,20,9,3,68,34,34,69
FC Basel,1732,2,19,8,5,57,22,35,65
St Gallen,1732,3,15,3,14,43,53,-10,48
Lucerne,1732,4,13,8,11,41,43,-2,47
FC Zürich,1732,5,11,10,11,40,34,6,43
FC Thun,1732,6,10,6,16,42,58,-16,36
Grasshoppers,1732,7,9,7,16,40,51,-11,34
FC Lugano,1732,8,9,7,16,29,47,-18,34
FC Sion,1732,9,5,8,19,36,54,-18,23
Young Boys,1733,1,22,6,4,70,36,34,72
FC Basel,1733,2,19,7,6,54,24,30,64
St Gallen,1733,3,14,4,14,44,56,-12,46
FC Zürich,1733,4,11,11,10,40,34,6,44
Lucerne,1733,5,12,8,12,42,45,-3,44
Grasshoppers,1733,6,10,6,16,40,48,-8,36
FC Thun,1733,7,10,5,17,41,56,-15,35
FC Lugano,1733,8,9,7,16,30,49,-19,34
FC Sion,1733,9,6,8,18,41,54,-13,26
Young Boys,1734,1,22,7,3,73,34,39,73
FC Basel,1734,2,17,9,6,51,24,27,60
FC Zürich,1734,3,11,11,10,40,33,7,44
St Gallen,1734,4,14,2,16,40,55,-15,44
Lucerne,1734,5,12,7,13,42,45,-3,43
FC Lugano,1734,6,11,5,16,31,50,-19,38
Grasshoppers,1734,7,10,6,16,42,51,-9,36
FC Thun,1734,8,10,5,17,44,57,-13,35
FC Sion,1734,9,7,8,17,38,52,-14,29
Young Boys,1735,1,20,9,3,69,34,35,69
FC Basel,1735,2,18,8,6,53,24,29,62
St Gallen,1735,3,15,2,15,41,53,-12,47
FC Zürich,1735,4,11,9,12,40,38,2,42
Lucerne,1735,5,11,7,14,38,45,-7,40
FC Lugano,1735,6,11,6,15,33,47,-14,39
FC Thun,1735,7,10,5,17,45,61,-16,35
FC Sion,1735,8,9,7,16,46,52,-6,34
Grasshoppers,1735,9,9,7,16,39,50,-11,34
Young Boys,1736,1,20,7,5,71,39,32,67
FC Basel,1736,2,19,7,6,58,27,31,64
St Gallen,1736,3,15,2,15,42,56,-14,47
FC Zürich,1736,4,11,11,10,44,36,8,44
Lucerne,1736,5,11,7,14,42,52,-10,40
Grasshoppers,1736,6,11,6,15,43,49,-6,39
FC Lugano,1736,7,11,6,15,33,47,-14,39
FC Thun,1736,8,10,6,16,43,56,-13,36
FC Sion,1736,9,6,8,18,40,54,-14,26
Young Boys,1737,1,22,6,4,73,35,38,72
FC Basel,1737,2,18,8,6,56,26,30,62
Lucerne,1737,3,14,7,11,42,43,-1,49
FC Zürich,1737,4,11,10,11,42,36,6,43
St Gallen,1737,5,13,4,15,42,57,-15,43
Grasshoppers,1737,6,11,6,15,45,48,-3,39
FC Thun,1737,7,9,6,17,46,65,-19,33
FC Lugano,1737,8,9,6,17,28,49,-21,33
FC Sion,1737,9,6,9,17,40,55,-15,27
Young Boys,1738,1,22,7,3,74,34,40,73
FC Basel,1738,2,18,9,5,56,25,31,63
Lucerne,1738,3,13,8,11,43,46,-3,47
St Gallen,1738,4,14,3,15,41,54,-13,45
FC Zürich,1738,5,10,11,11,43,40,3,41
FC Lugano,1738,6,10,6,16,33,49,-16,36
Grasshoppers,1738,7,9,7,16,40,50,-10,34
FC Thun,1738,8,9,6,17,42,58,-16,33
FC Sion,1738,9,6,9,17,40,56,-16,27
Young Boys,1739,1,21,8,3,69,36,33,71
FC Basel,1739,2,18,7,7,56,26,30,61
St Gallen,1739,3,15,2,15,44,57,-13,47
Lucerne,1739,4,12,9,11,42,46,-4,45
FC Zürich,1739,5,10,11,11,39,38,1,41
FC Lugano,1739,6,11,7,14,38,45,-7,40
FC Thun,1739,7,10,6,16,44,57,-13,36
Grasshoppers,1739,8,9,6,17,39,51,-12,33
FC Sion,1739,9,6,8,18,39,54,-15,26
Young Boys,1740,1,19,9,4,70,39,31,66
FC Basel,1740,2,17,10,5,52,23,29,61
Lucerne,1740,3,13,10,9,44,42,2,49
St Gallen,1740,4,14,2,16,44,59,-15,44
FC Zürich,1740,5,9,11,12,38,38,0,38
FC Thun,1740,6,10,7,15,46,57,-11,37
FC Lugano,1740,7,10,6,16,36,50,-14,36
Grasshoppers,1740,8,9,8,15,41,47,-6,35
FC Sion,1740,9,8,7,17,44,60,-16,31
Young Boys,1741,1,22,7,3,75,34,41,73
FC Basel,1741,2,16,11,5,51,25,26,59
St Gallen,1741,3,15,3,14,45,56,-11,48
FC Zürich,1741,4,11,11,10,44,35,9,44
Lucerne,1741,5,12,8,12,43,51,-8,44
Grasshoppers,1741,6,10,6,16,41,49,-8,36
FC Lugano,1741,7,9,7,16,32,49,-17,34
FC Thun,1741,8,8,7,17,42,60,-18,31
FC Sion,1741,9,7,8,17,43,57,-14,29
Young Boys,1742,1,22,7,3,75,34,41,73
FC Basel,1742,2,18,9,5,58,25,33,63
St Gallen,1742,3,14,4,14,44,55,-11,46
Lucerne,1742,4,12,8,12,39,46,-7,44
FC Zürich,1742,5,9,11,12,38,37,1,38
FC Lugano,1742,6,10,7,15,31,48,-17,37
Grasshoppers,1742,7,10,6,16,44,49,-5,36
FC Thun,1742,8,9,5,18,44,67,-23,32
FC Sion,1742,9,7,9,16,43,55,-12,30
Young Boys,1743,1,21,7,4,69,36,33,70
FC Basel,1743,2,16,8,8,50,28,22,56
Lucerne,1743,3,14,7,11,46,46,0,49
FC Zürich,1743,4,13,9,10,44,32,12,48
St Gallen,1743,5,14,3,15,43,55,-12,45
Grasshoppers,1743,6,10,6,16,45,54,-9,36
FC Thun,1743,7,10,5,17,45,59,-14,35
FC Lugano,1743,8,10,5,17,32,49,-17,35
FC Sion,1743,9,7,8,17,40,55,-15,29
Young Boys,1744,1,23,7,2,74,30,44,76
FC Basel,1744,2,16,8,8,50,26,24,56
Lucerne,1744,3,14,7,11,47,48,-1,49
FC Zürich,1744,4,12,10,10,40,32,8,46
St Gallen,1744,5,14,3,15,44,56,-12,45
Grasshoppers,1744,6,10,6,16,43,53,-10,36
FC Lugano,1744,7,10,6,16,31,47,-16,36
FC Thun,1744,8,8,6,18,40,61,-21,30
FC Sion,1744,9,7,7,18,40,56,-16,28
Young Boys,1745,1,22,6,4,75,39,36,72
FC Basel,1745,2,18,8,6,63,31,32,62
St Gallen,1745,3,15,3,14,51,57,-6,48
Lucerne,1745,4,13,7,12,45,51,-6,46
FC Zürich,1745,5,11,11,10,45,37,8,44
Grasshoppers,1745,6,10,6,16,42,50,-8,36
FC Thun,1745,7,10,5,17,42,58,-16,35
FC Lugano,1745,8,9,6,17,33,56,-23,33
FC Sion,1745,9,6,8,18,42,59,-17,26
Young Boys,1746,1,22,7,3,67,31,36,73
FC Basel,1746,2,19,7,6,53,23,30,64
Lucerne,1746,3,13,8,11,42,46,-4,47
St Gallen,1746,4,14,3,15,43,54,-11,45
FC Zürich,1746,5,10,9,13,41,40,1,39
FC Lugano,1746,6,10,6,16,32,47,-15,36
Grasshoppers,1746,7,9,8,15,43,51,-8,35
FC Thun,1746,8,10,5,17,48,63,-15,35
FC Sion,1746,9,6,9,17,42,56,-14,27
Young Boys,1747,1,21,8,3,70,31,39,71
FC Basel,1747,2,19,8,5,57,24,33,65
Lucerne,1747,3,13,8,11,43,44,-1,47
St Gallen,1747,4,13,5,14,43,57,-14,44
FC Zürich,1747,5,10,11,11,43,40,3,41
FC Lugano,1747,6,9,8,15,29,47,-18,35
FC Thun,1747,7,9,7,16,42,58,-16,34
Grasshoppers,1747,8,8,8,16,39,51,-12,32
FC Sion,1747,9,5,11,16,43,57,-14,26
Young Boys,1748,1,21,6,5,72,38,34,69
FC Basel,1748,2,18,7,7,58,26,32,61
St Gallen,1748,3,15,3,14,43,53,-10,48
Lucerne,1748,4,11,8,13,43,50,-7,41
FC Lugano,1748,5,11,7,14,34,47,-13,40
FC Zürich,1748,6,10,9,13,42,42,0,39
Grasshoppers,1748,7,11,6,15,44,51,-7,39
FC Sion,1748,8,9,7,16,43,51,-8,34
FC Thun,1748,9,9,5,18,43,64,-21,32
Young Boys,1749,1,21,7,4,72,39,33,70
FC Basel,1749,2,17,7,8,54,28,26,58
Lucerne,1749,3,15,8,9,47,43,4,53
FC Zürich,1749,4,11,10,11,43,40,3,43
St Gallen,1749,5,13,3,16,39,56,-17,42
FC Thun,1749,6,11,5,16,50,59,-9,38
Grasshoppers,1749,7,10,6,16,46,56,-10,36
FC Lugano,1749,8,10,6,16,33,49,-16,36
FC Sion,1749,9,6,8,18,43,57,-14,26
Young Boys,1750,1,22,7,3,70,33,37,73
FC Basel,1750,2,17,9,6,53,27,26,60
Lucerne,1750,3,13,7,12,42,44,-2,46
FC Lugano,1750,4,13,5,14,37,44,-7,44
FC Zürich,1750,5,11,10,11,42,36,6,43
St Gallen,1750,6,13,3,16,41,59,-18,42
FC Thun,1750,7,10,6,16,45,59,-14,36
Grasshoppers,1750,8,8,7,17,41,53,-12,31
FC Sion,1750,9,6,8,18,38,54,-16,26
Young Boys,1751,1,22,6,4,71,33,38,72
FC Basel,1751,2,17,8,7,54,28,26,59
FC Zürich,1751,3,13,9,10,51,36,15,48
Lucerne,1751,4,12,9,11,40,44,-4,45
St Gallen,1751,5,14,2,16,43,56,-13,44
FC Lugano,1751,6,12,5,15,33,48,-15,41
Grasshoppers,1751,7,9,7,16,41,51,-10,34
FC Thun,1751,8,8,6,18,42,63,-21,30
FC Sion,1751,9,7,8,17,42,58,-16,29
Young Boys,1752,1,20,10,2,71,33,38,70
FC Basel,1752,2,17,9,6,54,26,28,60
St Gallen,1752,3,15,2,15,44,56,-12,47
Lucerne,1752,4,12,10,10,44,44,0,46
FC Zürich,1752,5,9,11,12,39,39,0,38
Grasshoppers,1752,6,10,7,15,44,51,-7,37
FC Lugano,1752,7,10,7,15,33,49,-16,37
FC Thun,1752,8,10,5,17,45,60,-15,35
FC Sion,1752,9,6,9,17,41,57,-16,27
Young Boys,1753,1,21,7,4,72,37,35,70
FC Basel,1753,2,18,9,5,58,26,32,63
St Gallen,1753,3,14,3,15,42,55,-13,45
Lucerne,1753,4,12,8,12,43,48,-5,44
FC Zürich,1753,5,10,11,11,41,35,6,41
Grasshoppers,1753,6,10,8,14,40,46,-6,38
FC Thun,1753,7,10,6,16,42,58,-16,36
FC Lugano,1753,8,10,5,17,30,49,-19,35
FC Sion,1753,9,6,9,17,40,54,-14,27
Young Boys,1754,1,21,7,4,71,38,33,70
FC Basel,1754,2,19,8,5,54,22,32,65
St Gallen,1754,3,15,3,14,45,54,-9,48
Lucerne,1754,4,11,8,13,40,47,-7,41
Grasshoppers,1754,5,11,6,15,42,48,-6,39
FC Zürich,1754,6,9,11,12,40,38,2,38
FC Lugano,1754,7,10,8,14,31,45,-14,38
FC Thun,1754,8,10,5,17,43,58,-15,35
FC Sion,1754,9,6,8,18,41,57,-16,26
Young Boys,1755,1,21,9,2,68,32,36,72
FC Basel,1755,2,16,10,6,51,27,24,58
Lucerne,1755,3,14,8,10,44,42,2,50
St Gallen,1755,4,14,4,14,44,54,-10,46
FC Zürich,1755,5,10,11,11,39,35,4,41
Grasshoppers,1755,6,10,6,16,40,49,-9,36
FC Lugano,1755,7,9,8,15,30,46,-16,35
FC Sion,1755,8,8,7,17,42,54,-12,31
FC Thun,1755,9,8,5,19,40,59,-19,29
Young Boys,1756,1,23,7,2,73,33,40,76
FC Basel,1756,2,16,8,8,52,29,23,56
St Gallen,1756,3,15,2,15,42,56,-14,47
Lucerne,1756,4,12,8,12,40,44,-4,44
FC Zürich,1756,5,10,11,11,40,38,2,41
Grasshoppers,1756,6,11,6,15,42,49,-7,39
FC Lugano,1756,7,10,6,16,31,47,-16,36
FC Thun,1756,8,8,8,16,43,59,-16,32
FC Sion,1756,9,7,8,17,44,52,-8,29
Young Boys,1757,1,21,8,3,71,34,37,71
FC Basel,1757,2,16,11,5,56,30,26,59
St Gallen,1757,3,14,4,14,46,56,-10,46
FC Zürich,1757,4,11,11,10,43,36,7,44
Lucerne,1757,5,12,8,12,42,44,-2,44
Grasshoppers,1757,6,12,6,14,44,48,-4,42
FC Lugano,1757,7,10,7,15,29,45,-16,37
FC Thun,1757,8,9,6,17,43,59,-16,33
FC Sion,1757,9,5,7,20,38,60,-22,22
Young Boys,1758,1,21,7,4,76,39,37,70
FC Basel,1758,2,17,9,6,55,29,26,60
St Gallen,1758,3,15,2,15,42,53,-11,47
Lucerne,1758,4,12,9,11,40,42,-2,45
FC Zürich,1758,5,10,11,11,41,39,2,41
FC Lugano,1758,6,10,6,16,33,50,-17,36
Grasshoppers,1758,7,9,8,15,43,52,-9,35
FC Thun,1758,8,9,8,15,46,60,-14,35
FC Sion,1758,9,6,10,16,42,54,-12,28
Young Boys,1759,1,21,7,4,73,36,37,70
FC Basel,1759,2,17,9,6,58,30,28,60
Lucerne,1759,3,12,9,11,44,46,-2,45
St Gallen,1759,4,14,2,16,43,56,-13,44
FC Zürich,1759,5,10,10,12,43,38,5,40
FC Thun,1759,6,11,5,16,46,61,-15,38
Grasshoppers,1759,7,10,7,15,42,47,-5,37
FC Lugano,1759,8,10,6,16,30,51,-21,36
FC Sion,1759,9,8,7,17,41,55,-14,31
Young Boys,1760,1,20,9,3,70,37,33,69
FC Basel,1760,2,20,7,5,60,26,34,67
FC Zürich,1760,3,11,9,12,44,40,4,42
Lucerne,1760,4,11,9,12,42,47,-5,42
St Gallen,1760,5,13,3,16,41,56,-15,42
Grasshoppers,1760,6,10,8,14,42,48,-6,38
FC Lugano,1760,7,11,5,16,33,49,-16,38
FC Thun,1760,8,9,6,17,47,63,-16,33
FC Sion,1760,9,6,10,16,42,55,-13,28
Young Boys,1761,1,21,8,3,72,37,35,71
FC Basel,1761,2,18,7,7,54,29,25,61
Lucerne,1761,3,14,7,11,43,43,0,49
St Gallen,1761,4,13,3,16,41,56,-15,42
FC Zürich,1761,5,10,10,12,39,36,3,40
Grasshoppers,1761,6,10,8,14,42,48,-6,38
FC Thun,1761,7,10,6,16,42,55,-13,36
FC Lugano,1761,8,10,6,16,30,46,-16,36
FC Sion,1761,9,6,9,17,40,53,-13,27
Young Boys,1762,1,23,6,3,76,37,39,75
FC Basel,1762,2,20,7,5,60,23,37,67
Lucerne,1762,3,13,8,11,43,44,-1,47
St Gallen,1762,4,14,3,15,43,56,-13,45
FC Zürich,1762,5,10,9,13,45,47,-2,39
FC Lugano,1762,6,11,5,16,35,51,-16,38
FC Thun,1762,7,9,6,17,48,64,-16,33
Grasshoppers,1762,8,8,6,18,37,54,-17,30
FC Sion,1762,9,7,8,17,43,54,-11,29
Young Boys,1763,1,22,8,2,71,34,37,74
FC Basel,1763,2,16,9,7,53,30,23,57
St Gallen,1763,3,15,3,14,43,57,-14,48
Lucerne,1763,4,11,10,11,40,43,-3,43
FC Zürich,1763,5,10,11,11,41,39,2,41
FC Thun,1763,6,10,7,15,47,56,-9,37
Grasshoppers,1763,7,9,8,15,40,49,-9,35
FC Lugano,1763,8,9,7,16,33,51,-18,34
FC Sion,1763,9,7,7,18,45,54,-9,28
Young Boys,1764,1,22,8,2,75,34,41,74
FC Basel,1764,2,17,7,8,55,31,24,58
St Gallen,1764,3,15,2,15,43,57,-14,47
Lucerne,1764,4,13,7,12,45,49,-4,46
FC Zürich,1764,5,11,10,11,43,39,4,43
FC Lugano,1764,6,11,7,14,33,46,-13,40
FC Thun,1764,7,9,6,17,46,58,-12,33
Grasshoppers,1764,8,8,8,16,42,52,-10,32
FC Sion,1764,9,7,7,18,41,57,-16,28
Young Boys,1765,1,22,7,3,73,36,37,73
FC Basel,1765,2,18,8,6,55,26,29,62
Lucerne,1765,3,14,7,11,45,42,3,49
St Gallen,1765,4,15,2,15,45,56,-11,47
FC Zürich,1765,5,10,10,12,40,36,4,40
FC Lugano,1765,6,10,5,17,30,50,-20,35
Grasshoppers,1765,7,9,7,16,41,50,-9,34
FC Thun,1765,8,9,6,17,44,63,-19,33
FC Sion,1765,9,7,8,17,42,56,-14,29
Young Boys,1766,1,23,7,2,76,31,45,76
FC Basel,1766,2,19,8,5,59,27,32,65
St Gallen,1766,3,14,3,15,43,56,-13,45
Lucerne,1766,4,12,8,12,41,45,-4,44
FC Lugano,1766,5,10,7,15,31,50,-19,37
FC Zürich,1766,6,9,9,14,36,39,-3,36
FC Thun,1766,7,10,6,16,48,59,-11,36
Grasshoppers,1766,8,10,6,16,40,52,-12,36
FC Sion,1766,9,6,8,18,39,54,-15,26
Young Boys,1767,1,23,7,2,78,35,43,76
FC Basel,1767,2,19,7,6,58,27,31,64
Lucerne,1767,3,12,9,11,41,45,-4,45
St Gallen,1767,4,14,3,15,42,55,-13,45
Grasshoppers,1767,5,11,6,15,44,51,-7,39
FC Lugano,1767,6,11,5,16,34,47,-13,38
FC Zürich,1767,7,9,9,14,38,43,-5,36
FC Thun,1767,8,9,5,18,45,60,-15,32
FC Sion,1767,9,7,7,18,40,57,-17,28
Young Boys,1768,1,22,7,3,69,34,35,73
FC Basel,1768,2,19,8,5,57,24,33,65
St Gallen,1768,3,14,2,16,40,57,-17,44
Lucerne,1768,4,11,9,12,39,44,-5,42
FC Lugano,1768,5,11,6,15,34,45,-11,39
FC Zürich,1768,6,9,9,14,38,39,-1,36
FC Thun,1768,7,10,6,16,44,60,-16,36
Grasshoppers,1768,8,9,7,16,39,48,-9,34
FC Sion,1768,9,8,8,16,41,50,-9,32
Young Boys,1769,1,22,8,2,76,37,39,74
FC Basel,1769,2,18,9,5,55,24,31,63
Lucerne,1769,3,12,9,11,42,44,-2,45
St Gallen,1769,4,14,3,15,44,57,-13,45
FC Zürich,1769,5,10,11,11,38,35,3,41
FC Lugano,1769,6,11,6,15,33,46,-13,39
FC Thun,1769,7,9,7,16,42,57,-15,34
Grasshoppers,1769,8,8,7,17,37,52,-15,31
FC Sion,1769,9,5,10,17,39,54,-15,25
Young Boys,1770,1,22,6,4,76,37,39,72
FC Basel,1770,2,19,8,5,60,24,36,65
St Gallen,1770,3,14,4,14,43,55,-12,46
FC Zürich,1770,4,11,9,12,40,36,4,42
Lucerne,1770,5,11,9,12,41,46,-5,42
Grasshoppers,1770,6,11,6,15,47,50,-3,39
FC Lugano,1770,7,10,6,16,32,51,-19,36
FC Thun,1770,8,9,5,18,42,68,-26,32
FC Sion,1770,9,7,7,18,42,56,-14,28
Young Boys,1771,1,21,7,4,74,38,36,70
FC Basel,1771,2,19,8,5,60,27,33,65
Lucerne,1771,3,13,7,12,43,46,-3,46
St Gallen,1771,4,14,3,15,44,56,-12,45
FC Zürich,1771,5,10,10,12,38,34,4,40
Grasshoppers,1771,6,9,9,14,39,46,-7,36
FC Lugano,1771,7,10,5,17,31,51,-20,35
FC Thun,1771,8,9,6,17,40,58,-18,33
FC Sion,1771,9,7,9,16,38,51,-13,30
Young Boys,1772,1,24,6,2,73,29,44,78
FC Basel,1772,2,17,9,6,52,27,25,60
Lucerne,1772,3,13,8,11,44,43,1,47
St Gallen,1772,4,13,4,15,43,56,-13,43
FC Zürich,1772,5,9,11,12,38,39,-1,38
FC Lugano,1772,6,10,6,16,33,49,-16,36
Grasshoppers,1772,7,9,7,16,39,50,-11,34
FC Sion,1772,8,8,8,16,41,53,-12,32
FC Thun,1772,9,8,7,17,43,60,-17,31
Young Boys,1773,1,22,7,3,74,35,39,73
FC Basel,1773,2,19,8,5,55,23,32,65
Lucerne,1773,3,14,7,11,43,44,-1,49
FC Zürich,1773,4,11,9,12,41,35,6,42
St Gallen,1773,5,13,3,16,45,59,-14,42
FC Lugano,1773,6,10,6,16,31,48,-17,36
FC Thun,1773,7,10,5,17,43,57,-14,35
Grasshoppers,1773,8,9,7,16,39,52,-13,34
FC Sion,1773,9,6,8,18,39,57,-18,26
Young Boys,1774,1,21,9,2,71,34,37,72
FC Basel,1774,2,17,8,7,54,26,28,59
Lucerne,1774,3,12,10,10,43,46,-3,46
FC Zürich,1774,4,11,11,10,42,35,7,44
St Gallen,1774,5,13,3,16,40,60,-20,42
FC Lugano,1774,6,10,8,14,36,46,-10,38
Grasshoppers,1774,7,9,7,16,40,49,-9,34
FC Thun,1774,8,9,7,16,43,58,-15,34
FC Sion,1774,9,6,9,17,40,55,-15,27
Young Boys,1775,1,23,6,3,77,37,40,75
FC Basel,1775,2,16,8,8,50,28,22,56
FC Zürich,1775,3,12,10,10,41,33,8,46
St Gallen,1775,4,14,4,14,41,52,-11,46
Lucerne,1775,5,12,7,13,43,48,-5,43
Grasshoppers,1775,6,11,7,14,46,50,-4,40
FC Lugano,1775,7,10,7,15,33,48,-15,37
FC Thun,1775,8,8,6,18,44,62,-18,30
FC Sion,1775,9,6,9,17,42,59,-17,27
Young Boys,1776,1,22,6,4,72,34,38,72
FC Basel,1776,2,18,8,6,53,25,28,62
Lucerne,1776,3,14,7,11,42,43,-1,49
St Gallen,1776,4,15,2,15,43,54,-11,47
FC Zürich,1776,5,10,9,13,40,39,1,39
Grasshoppers,1776,6,10,6,16,42,49,-7,36
FC Thun,1776,7,10,6,16,49,57,-8,36
FC Lugano,1776,8,9,5,18,30,53,-23,32
FC Sion,1776,9,8,7,17,39,56,-17,31
Young Boys,1777,1,22,6,4,74,37,37,72
FC Basel,1777,2,18,9,5,54,25,29,63
St Gallen,1777,3,15,4,13,43,52,-9,49
Lucerne,1777,4,12,8,12,43,46,-3,44
FC Zürich,1777,5,10,10,12,39,36,3,40
Grasshoppers,1777,6,11,7,14,43,46,-3,40
FC Lugano,1777,7,9,6,17,27,49,-22,33
FC Thun,1777,8,9,5,18,39,56,-17,32
FC Sion,1777,9,6,9,17,38,53,-15,27
Young Boys,1778,1,24,6,2,77,30,47,78
FC Basel,1778,2,17,8,7,55,26,29,59
Lucerne,1778,3,13,8,11,40,42,-2,47
St Gallen,1778,4,14,2,16,41,57,-16,44
FC Zürich,1778,5,10,10,12,37,35,2,40
FC Thun,1778,6,10,7,15,48,58,-10,37
FC Lugano,1778,7,10,5,17,29,48,-19,35
Grasshoppers,1778,8,8,8,16,39,50,-11,32
FC Sion,1778,9,7,8,17,39,59,-20,29
Young Boys,1779,1,20,9,3,66,32,34,69
FC Basel,1779,2,19,7,6,55,23,32,64
St Gallen,1779,3,16,3,13,47,52,-5,51
Lucerne,1779,4,12,8,12,41,46,-5,44
FC Zürich,1779,5,10,11,11,43,40,3,41
FC Lugano,1779,6,10,7,15,33,48,-15,37
FC Thun,1779,7,10,5,17,44,59,-15,35
Grasshoppers,1779,8,8,7,17,38,53,-15,31
FC Sion,1779,9,6,9,17,41,55,-14,27
Young Boys,1780,1,22,7,3,74,37,37,73
FC Basel,1780,2,17,8,7,52,27,25,59
St Gallen,1780,3,15,2,15,43,55,-12,47
Lucerne,1780,4,12,8,12,42,46,-4,44
FC Zürich,1780,5,10,11,11,40,34,6,41
FC Lugano,1780,6,11,5,16,32,46,-14,38
Grasshoppers,1780,7,10,7,15,41,47,-6,37
FC Thun,1780,8,10,6,16,43,58,-15,36
FC Sion,1780,9,6,8,18,40,57,-17,26
Young Boys,1781,1,22,6,4,70,36,34,72
FC Basel,1781,2,17,7,8,55,29,26,58
St Gallen,1781,3,15,3,14,41,51,-10,48
Lucerne,1781,4,13,8,11,39,40,-1,47
FC Zürich,1781,5,10,12,10,41,36,5,42
FC Thun,1781,6,10,6,16,46,61,-15,36
FC Lugano,1781,7,10,6,16,33,49,-16,36
Grasshoppers,1781,8,8,7,17,39,50,-11,31
FC Sion,1781,9,7,9,16,41,53,-12,30
Young Boys,1782,1,22,7,3,74,33,41,73
FC Basel,1782,2,18,8,6,55,25,30,62
St Gallen,1782,3,17,2,13,48,55,-7,53
Lucerne,1782,4,11,7,14,39,47,-8,40
FC Lugano,1782,5,11,5,16,30,49,-19,38
FC Zürich,1782,6,9,9,14,37,38,-1,36
FC Thun,1782,7,10,6,16,46,56,-10,36
Grasshoppers,1782,8,9,6,17,40,56,-16,33
FC Sion,1782,9,8,8,16,43,53,-10,32
Young Boys,1783,1,21,7,4,71,39,32,70
FC Basel,1783,2,19,8,5,59,24,35,65
Lucerne,1783,3,13,7,12,40,45,-5,46
FC Zürich,1783,4,11,11,10,39,33,6,44
St Gallen,1783,5,14,2,16,42,56,-14,44
FC Lugano,1783,6,10,6,16,30,46,-16,36
Grasshoppers,1783,7,9,7,16,42,53,-11,34
FC Thun,1783,8,9,7,16,43,58,-15,34
FC Sion,1783,9,7,7,18,41,53,-12,28
Young Boys,1784,1,22,8,2,70,32,38,74
FC Basel,1784,2,18,9,5,55,25,30,63
Lucerne,1784,3,12,9,11,42,44,-2,45
St Gallen,1784,4,13,4,15,43,58,-15,43
Grasshoppers,1784,5,11,7,14,49,49,0,40
FC Lugano,1784,6,10,7,15,30,45,-15,37
FC Zürich,1784,7,9,9,14,38,40,-2,36
FC Thun,1784,8,10,5,17,49,65,-16,35
FC Sion,1784,9,6,8,18,41,59,-18,26
Young Boys,1785,1,21,6,5,68,36,32,69
FC Basel,1785,2,18,7,7,59,25,34,61
Lucerne,1785,3,14,7,11,45,46,-1,49
St Gallen,1785,4,15,2,15,45,59,-14,47
FC Zürich,1785,5,12,10,10,43,36,7,46
FC Lugano,1785,6,11,5,16,33,47,-14,38
FC Thun,1785,7,10,6,16,42,61,-19,36
Grasshoppers,1785,8,9,6,17,41,51,-10,33
FC Sion,1785,9,6,7,19,40,55,-15,25
Young Boys,1786,1,23,6,3,78,35,43,75
FC Basel,1786,2,18,7,7,56,27,29,61
Lucerne,1786,3,13,8,11,41,45,-4,47
St Gallen,1786,4,14,3,15,43,56,-13,45
Grasshoppers,1786,5,11,7,14,45,49,-4,40
FC Zürich,1786,6,10,9,13,39,37,2,39
FC Lugano,1786,7,11,5,16,32,50,-18,38
FC Thun,1786,8,9,5,18,43,64,-21,32
FC Sion,1786,9,6,8,18,44,58,-14,26
Young Boys,1787,1,22,7,3,72,34,38,73
FC Basel,1787,2,18,9,5,56,24,32,63
St Gallen,1787,3,14,3,15,41,53,-12,45
Lucerne,1787,4,12,8,12,39,42,-3,44
Grasshoppers,1787,5,12,6,14,43,44,-1,42
FC Zürich,1787,6,10,10,12,42,40,2,40
FC Lugano,1787,7,11,6,15,31,45,-14,39
FC Thun,1787,8,8,5,19,41,62,-21,29
FC Sion,1787,9,6,8,18,41,62,-21,26
Young Boys,1788,1,21,7,4,72,39,33,70
FC Basel,1788,2,18,9,5,58,25,33,63
Lucerne,1788,3,13,8,11,43,44,-1,47
St Gallen,1788,4,14,3,15,45,57,-12,45
FC Zürich,1788,5,11,9,12,43,40,3,42
Grasshoppers,1788,6,10,7,15,43,48,-5,37
FC Thun,1788,7,10,5,17,42,58,-16,35
FC Lugano,1788,8,9,6,17,33,53,-20,33
FC Sion,1788,9,7,8,17,41,56,-15,29
Young Boys,1789,1,21,6,5,70,37,33,69
FC Basel,1789,2,18,8,6,57,25,32,62
St Gallen,1789,3,15,2,15,45,54,-9,47
FC Zürich,1789,4,12,9,11,45,36,9,45
Lucerne,1789,5,12,9,11,44,46,-2,45
FC Lugano,1789,6,11,5,16,32,49,-17,38
Grasshoppers,1789,7,10,7,15,42,49,-7,37
FC Thun,1789,8,10,5,17,43,64,-21,35
FC Sion,1789,9,6,7,19,38,56,-18,25
Young Boys,1790,1,22,8,2,74,36,38,74
FC Basel,1790,2,17,8,7,54,25,29,59
St Gallen,1790,3,15,2,15,43,57,-14,47
Lucerne,1790,4,12,7,13,39,45,-6,43
FC Zürich,1790,5,11,9,12,42,37,5,42
FC Lugano,1790,6,11,5,16,36,51,-15,38
FC Thun,1790,7,10,5,17,44,58,-14,35
Grasshoppers,1790,8,9,7,16,40,49,-9,34
FC Sion,1790,9,8,7,17,42,56,-14,31
Young Boys,1791,1,20,8,4,74,42,32,68
FC Basel,1791,2,19,8,5,54,24,30,65
Lucerne,1791,3,12,9,11,42,45,-3,45
St Gallen,1791,4,14,2,16,41,53,-12,44
FC Zürich,1791,5,11,9,12,40,38,2,42
FC Lugano,1791,6,11,5,16,37,51,-14,38
FC Thun,1791,7,10,6,16,45,57,-12,36
Grasshoppers,1791,8,9,8,15,40,48,-8,35
FC Sion,1791,9,7,7,18,41,56,-15,28
Young Boys,1792,1,21,6,5,70,39,31,69
FC Basel,1792,2,18,9,5,59,25,34,63
St Gallen,1792,3,14,3,15,43,57,-14,45
Lucerne,1792,4,12,8,12,40,43,-3,44
FC Zürich,1792,5,10,11,11,40,38,2,41
Grasshoppers,1792,6,11,7,14,46,48,-2,40
FC Lugano,1792,7,11,6,15,32,44,-12,39
FC Thun,1792,8,9,6,17,44,64,-20,33
FC Sion,1792,9,6,8,18,43,59,-16,26
Young Boys,1793,1,21,7,4,73,36,37,70
FC Basel,1793,2,19,7,6,55,24,31,64
Lucerne,1793,3,13,7,12,40,43,-3,46
FC Zürich,1793,4,11,10,11,42,38,4,43
St Gallen,1793,5,13,3,16,40,55,-15,42
FC Lugano,1793,6,11,6,15,32,48,-16,39
FC Thun,1793,7,11,5,16,47,56,-9,38
Grasshoppers,1793,8,10,6,16,39,51,-12,36
FC Sion,1793,9,5,9,18,39,56,-17,24
Young Boys,1794,1,22,6,4,72,33,39,72
FC Basel,1794,2,18,8,6,54,24,30,62
Lucerne,1794,3,12,9,11,39,43,-4,45
FC Zürich,1794,4,11,10,11,38,34,4,43
St Gallen,1794,5,13,4,15,41,57,-16,43
FC Lugano,1794,6,11,6,15,31,44,-13,39
Grasshoppers,1794,7,10,6,16,44,49,-5,36
FC Thun,1794,8,9,5,18,43,64,-21,32
FC Sion,1794,9,7,8,17,42,56,-14,29
Young Boys,1795,1,22,6,4,75,38,37,72
FC Basel,1795,2,19,7,6,57,23,34,64
Lucerne,1795,3,14,8,10,50,42,8,50
St Gallen,1795,4,14,3,15,46,59,-13,45
FC Zürich,1795,5,11,9,12,39,35,4,42
FC Lugano,1795,6,11,5,16,32,50,-18,38
Grasshoppers,1795,7,9,6,17,39,59,-20,33
FC Thun,1795,8,9,5,18,43,63,-20,32
FC Sion,1795,9,7,7,18,44,56,-12,28
Young Boys,1796,1,21,8,3,70,35,35,71
FC Basel,1796,2,17,9,6,53,26,27,60
St Gallen,1796,3,15,4,13,45,54,-9,49
Lucerne,1796,4,11,9,12,41,46,-5,42
FC Zürich,1796,5,10,11,11,41,37,4,41
Grasshoppers,1796,6,11,7,14,46,48,-2,40
FC Lugano,1796,7,9,9,14,32,47,-15,36
FC Thun,1796,8,9,6,17,42,60,-18,33
FC Sion,1796,9,5,9,18,40,57,-17,24
Young Boys,1797,1,22,6,4,78,38,40,72
FC Basel,1797,2,16,10,6,52,27,25,58
St Gallen,1797,3,14,3,15,42,56,-14,45
FC Zürich,1797,4,11,10,11,44,38,6,43
Lucerne,1797,5,11,8,13,39,49,-10,41
FC Lugano,1797,6,11,6,15,38,52,-14,39
Grasshoppers,1797,7,10,6,16,45,53,-8,36
FC Thun,1797,8,10,6,16,44,55,-11,36
FC Sion,1797,9,8,7,17,41,55,-14,31
Young Boys,1798,1,22,6,4,71,33,38,72
FC Basel,1798,2,20,7,5,56,24,32,67
Lucerne,1798,3,12,9,11,41,44,-3,45
St Gallen,1798,4,14,3,15,41,52,-11,45
FC Zürich,1798,5,10,9,13,41,39,2,39
Grasshoppers,1798,6,10,6,16,41,50,-9,36
FC Lugano,1798,7,10,6,16,29,47,-18,36
FC Thun,1798,8,9,5,18,45,62,-17,32
FC Sion,1798,9,8,7,17,41,55,-14,31
Young Boys,1799,1,23,7,2,72,32,40,76
FC Basel,1799,2,18,9,5,57,24,33,63
Lucerne,1799,3,13,8,11,43,44,-1,47
FC Zürich,1799,4,11,11,10,43,37,6,44
St Gallen,1799,5,13,2,17,40,60,-20,41
FC Lugano,1799,6,10,5,17,32,50,-18,35
Grasshoppers,1799,7,9,7,16,42,50,-8,34
FC Thun,1799,8,9,6,17,46,63,-17,33
FC Sion,1799,9,7,7,18,44,59,-15,28
Young Boys,1800,1,21,8,3,72,35,37,71
FC Basel,1800,2,16,10,6,50,26,24,58
Lucerne,1800,3,13,8,11,42,45,-3,47
St Gallen,1800,4,14,3,15,43,56,-13,45
FC Zürich,1800,5,11,11,10,44,35,9,44
FC Lugano,1800,6,10,6,16,29,46,-17,36
Grasshoppers,1800,7,8,9,15,40,49,-9,33
FC Thun,1800,8,8,8,16,41,57,-16,32
FC Sion,1800,9,7,9,16,44,56,-12,30
Young Boys,1801,1,22,7,3,77,37,40,73
FC Basel,1801,2,19,8,5,59,26,33,65
St Gallen,1801,3,13,4,15,39,52,-13,43
Lucerne,1801,4,11,9,12,40,47,-7,42
FC Zürich,1801,5,10,10,12,41,36,5,40
FC Thun,1801,6,11,5,16,47,57,-10,38
Grasshoppers,1801,7,10,6,16,40,52,-12,36
FC Lugano,1801,8,10,6,16,30,49,-19,36
FC Sion,1801,9,6,9,17,37,54,-17,27
Young Boys,1802,1,23,6,3,73,35,38,75
FC Basel,1802,2,19,8,5,58,24,34,65
St Gallen,1802,3,15,3,14,45,55,-10,48
Lucerne,1802,4,12,8,12,40,46,-6,44
FC Zürich,1802,5,10,11,11,42,36,6,41
FC Lugano,1802,6,10,6,16,34,51,-17,36
Grasshoppers,1802,7,9,7,16,44,51,-7,34
FC Thun,1802,8,9,5,18,43,64,-21,32
FC Sion,1802,9,6,8,18,41,58,-17,26
Young Boys,1803,1,22,8,2,72,34,38,74
FC Basel,1803,2,17,8,7,54,27,27,59
St Gallen,1803,3,16,3,13,43,49,-6,51
Lucerne,1803,4,11,10,11,37,42,-5,43
FC Zürich,1803,5,10,9,13,38,38,0,39
FC Thun,1803,6,10,7,15,44,56,-12,37
Grasshoppers,1803,7,9,9,14,41,47,-6,36
FC Lugano,1803,8,9,6,17,28,49,-21,33
FC Sion,1803,9,6,8,18,40,55,-15,26
Young Boys,1804,1,23,6,3,70,31,39,75
FC Basel,1804,2,18,8,6,61,26,35,62
St Gallen,1804,3,15,2,15,43,55,-12,47
Lucerne,1804,4,13,7,12,40,48,-8,46
FC Zürich,1804,5,9,11,12,38,37,1,38
FC Lugano,1804,6,11,5,16,31,47,-16,38
Grasshoppers,1804,7,10,6,16,39,47,-8,36
FC Thun,1804,8,8,7,17,44,62,-18,31
FC Sion,1804,9,7,8,17,38,51,-13,29
Young Boys,1805,1,23,6,3,75,38,37,75
FC Basel,1805,2,16,10,6,53,29,24,58
Lucerne,1805,3,13,8,11,47,47,0,47
St Gallen,1805,4,15,2,15,47,57,-10,47
FC Zürich,1805,5,10,11,11,40,35,5,41
FC Thun,1805,6,11,6,15,51,57,-6,39
Grasshoppers,1805,7,11,6,15,43,49,-6,39
FC Lugano,1805,8,9,6,17,32,51,-19,33
FC Sion,1805,9,5,7,20,36,61,-25,22
Young Boys,1806,1,21,7,4,72,33,39,70
FC Basel,1806,2,17,8,7,52,26,26,59
St Gallen,1806,3,16,2,14,46,52,-6,50
Lucerne,1806,4,14,7,11,44,44,0,49
FC Zürich,1806,5,12,9,11,41,36,5,45
FC Thun,1806,6,10,7,15,47,59,-12,37
Grasshoppers,1806,7,9,8,15,40,48,-8,35
FC Lugano,1806,8,9,5,18,29,54,-25,32
FC Sion,1806,9,5,9,18,37,56,-19,24
Young Boys,1807,1,22,6,4,72,36,36,72
FC Basel,1807,2,19,8,5,56,24,32,65
Lucerne,1807,3,13,9,10,45,42,3,48
FC Zürich,1807,4,11,11,10,42,36,6,44
St Gallen,1807,5,13,3,16,41,57,-16,42
FC Lugano,1807,6,10,7,15,32,48,-16,37
FC Thun,1807,7,10,5,17,44,61,-17,35
Grasshoppers,1807,8,8,7,17,38,52,-14,31
FC Sion,1807,9,6,8,18,44,58,-14,26
Young Boys,1808,1,21,7,4,69,35,34,70
FC Basel,1808,2,20,7,5,56,24,32,67
St Gallen,1808,3,14,3,15,42,56,-14,45
Lucerne,1808,4,12,8,12,40,44,-4,44
FC Zürich,1808,5,9,10,13,39,40,-1,37
Grasshoppers,1808,6,9,9,14,41,47,-6,36
FC Thun,1808,7,10,6,16,47,61,-14,36
FC Lugano,1808,8,10,6,16,33,49,-16,36
FC Sion,1808,9,7,8,17,42,53,-11,29
Young Boys,1809,1,21,6,5,69,33,36,69
FC Basel,1809,2,18,9,5,50,22,28,63
Lucerne,1809,3,14,7,11,44,44,0,49
St Gallen,1809,4,15,3,14,47,56,-9,48
FC Zürich,1809,5,9,12,11,37,34,3,39
FC Lugano,1809,6,10,5,17,30,52,-22,35
Grasshoppers,1809,7,9,6,17,42,52,-10,33
FC Thun,1809,8,9,6,17,40,57,-17,33
FC Sion,1809,9,8,8,16,43,52,-9,32
Young Boys,1810,1,22,7,3,75,33,42,73
FC Basel,1810,2,18,7,7,52,25,27,61
Lucerne,1810,3,11,10,11,41,48,-7,43
St Gallen,1810,4,13,4,15,41,54,-13,43
FC Zürich,1810,5,10,9,13,38,43,-5,39
FC Lugano,1810,6,10,7,15,33,49,-16,37
Grasshoppers,1810,7,9,8,15,42,49,-7,35
FC Thun,1810,8,10,5,17,46,59,-13,35
FC Sion,1810,9,9,7,16,44,52,-8,34
Young Boys,1811,1,20,7,5,72,40,32,67
FC Basel,1811,2,17,8,7,51,27,24,59
St Gallen,1811,3,16,2,14,43,53,-10,50
Lucerne,1811,4,13,9,10,45,44,1,48
FC Zürich,1811,5,12,10,10,42,32,10,46
FC Lugano,1811,6,10,7,15,31,46,-15,37
FC Thun,1811,7,9,5,18,40,58,-18,32
FC Sion,1811,8,8,7,17,41,53,-12,31
Grasshoppers,1811,9,8,7,17,38,50,-12,31
Young Boys,1812,1,22,7,3,73,36,37,73
FC Basel,1812,2,16,9,7,53,29,24,57
St Gallen,1812,3,14,5,13,41,51,-10,47
Lucerne,1812,4,12,7,13,43,50,-7,43
FC Zürich,1812,5,10,11,11,41,35,6,41
FC Lugano,1812,6,10,8,14,33,46,-13,38
Grasshoppers,1812,7,10,6,16,40,49,-9,36
FC Thun,1812,8,9,7,16,43,58,-15,34
FC Sion,1812,9,6,10,16,41,54,-13,28
Young Boys,1813,1,23,6,3,76,34,42,75
FC Basel,1813,2,18,8,6,56,26,30,62
FC Zürich,1813,3,12,9,11,43,35,8,45
St Gallen,1813,4,14,3,15,41,58,-17,45
Lucerne,1813,5,11,10,11,40,44,-4,43
Grasshoppers,1813,6,9,7,16,40,52,-12,34
FC Lugano,1813,7,9,7,16,29,46,-17,34
FC Thun,1813,8,9,6,17,41,59,-18,33
FC Sion,1813,9,7,8,17,41,53,-12,29
Young Boys,1814,1,21,7,4,69,37,32,70
FC Basel,1814,2,16,8,8,52,27,25,56
St Gallen,1814,3,16,2,14,46,53,-7,50
Lucerne,1814,4,12,9,11,47,44,3,45
FC Zürich,1814,5,11,10,11,39,35,4,43
Grasshoppers,1814,6,10,7,15,44,54,-10,37
FC Lugano,1814,7,10,7,15,29,44,-15,37
FC Sion,1814,8,8,8,16,42,54,-12,32
FC Thun,1814,9,8,6,18,38,58,-20,30
Young Boys,1815,1,20,8,4,70,38,32,68
FC Basel,1815,2,18,8,6,59,27,32,62
Lucerne,1815,3,15,7,10,47,44,3,52
St Gallen,1815,4,15,2,15,46,57,-11,47
FC Zürich,1815,5,10,9,13,39,42,-3,39
Grasshoppers,1815,6,9,8,15,42,50,-8,35
FC Sion,1815,7,9,7,16,48,54,-6,34
FC Thun,1815,8,9,6,17,45,62,-17,33
FC Lugano,1815,9,9,5,18,30,52,-22,32
Young Boys,1816,1,21,9,2,69,31,38,72
FC Basel,1816,2,17,9,6,53,23,30,60
St Gallen,1816,3,16,3,13,42,49,-7,51
Lucerne,1816,4,13,9,10,41,42,-1,48
FC Zürich,1816,5,11,9,12,43,39,4,42
FC Thun,1816,6,10,5,17,44,62,-18,35
Grasshoppers,1816,7,9,6,17,40,53,-13,33
FC Lugano,1816,8,9,6,17,28,47,-19,33
FC Sion,1816,9,6,8,18,43,57,-14,26
Young Boys,1817,1,23,6,3,73,35,38,75
FC Basel,1817,2,19,7,6,57,26,31,64
St Gallen,1817,3,14,3,15,41,55,-14,45
FC Zürich,1817,4,11,10,11,39,36,3,43
Lucerne,1817,5,11,8,13,39,46,-7,41
Grasshoppers,1817,6,11,6,15,43,48,-5,39
FC Thun,1817,7,10,5,17,47,60,-13,35
FC Lugano,1817,8,9,7,16,29,46,-17,34
FC Sion,1817,9,6,8,18,40,56,-16,26
Young Boys,1818,1,22,7,3,73,35,38,73
FC Basel,1818,2,18,8,6,54,25,29,62
Lucerne,1818,3,13,7,12,40,45,-5,46
Grasshoppers,1818,4,12,6,14,47,49,-2,42
St Gallen,1818,5,13,3,16,38,53,-15,42
FC Lugano,1818,6,11,5,16,31,48,-17,38
FC Zürich,1818,7,9,10,13,37,40,-3,37
FC Thun,1818,8,10,5,17,48,61,-13,35
FC Sion,1818,9,6,9,17,39,51,-12,27
Young Boys,1819,1,22,8,2,73,35,38,74
FC Basel,1819,2,17,9,6,53,24,29,60
St Gallen,1819,3,15,2,15,44,54,-10,47
Lucerne,1819,4,13,7,12,42,47,-5,46
FC Zürich,1819,5,9,12,11,41,38,3,39
Grasshoppers,1819,6,9,8,15,41,50,-9,35
FC Thun,1819,7,9,8,15,46,60,-14,35
FC Lugano,1819,8,9,6,17,30,49,-19,33
FC Sion,1819,9,7,8,17,45,58,-13,29
Young Boys,1820,1,22,7,3,70,33,37,73
FC Basel,1820,2,19,7,6,54,22,32,64
Lucerne,1820,3,14,8,10,43,39,4,50
St Gallen,1820,4,14,3,15,43,58,-15,45
FC Zürich,1820,5,10,10,12,40,37,3,40
FC Thun,1820,6,10,5,17,41,57,-16,35
FC Lugano,1820,7,9,7,16,30,49,-19,34
FC Sion,1820,8,7,9,16,41,53,-12,30
Grasshoppers,1820,9,8,6,18,37,51,-14,30
Young Boys,1821,1,20,7,5,66,35,31,67
FC Basel,1821,2,17,9,6,53,24,29,60
Lucerne,1821,3,13,8,11,43,43,0,47
St Gallen,1821,4,15,2,15,43,58,-15,47
FC Zürich,1821,5,12,10,10,45,35,10,46
Grasshoppers,1821,6,11,6,15,43,46,-3,39
FC Lugano,1821,7,9,6,17,30,48,-18,33
FC Thun,1821,8,9,6,17,41,60,-19,33
FC Sion,1821,9,7,8,17,43,58,-15,29
Young Boys,1822,1,21,8,3,72,34,38,71
FC Basel,1822,2,18,7,7,61,30,31,61
Lucerne,1822,3,14,7,11,43,44,-1,49
FC Zürich,1822,4,12,10,10,45,35,10,46
St Gallen,1822,5,14,2,16,46,60,-14,44
Grasshoppers,1822,6,10,7,15,42,49,-7,37
FC Lugano,1822,7,10,6,16,30,49,-19,36
FC Thun,1822,8,9,5,18,43,64,-21,32
FC Sion,1822,9,6,8,18,41,58,-17,26
Young Boys,1823,1,21,9,2,74,35,39,72
FC Basel,1823,2,17,9,6,55,28,27,60
St Gallen,1823,3,13,4,15,42,55,-13,43
Lucerne,1823,4,11,8,13,38,47,-9,41
Grasshoppers,1823,5,11,7,14,44,46,-2,40
FC Lugano,1823,6,11,7,14,34,47,-13,40
FC Zürich,1823,7,9,12,11,36,33,3,39
FC Thun,1823,8,10,5,17,44,61,-17,35
FC Sion,1823,9,6,9,17,41,56,-15,27
Young Boys,1824,1,21,8,3,72,36,36,71
FC Basel,1824,2,17,8,7,53,27,26,59
Lucerne,1824,3,13,9,10,45,44,1,48
FC Zürich,1824,4,11,10,11,39,34,5,43
FC Lugano,1824,5,12,6,14,34,44,-10,42
St Gallen,1824,6,13,3,16,42,58,-16,42
FC Thun,1824,7,10,6,16,43,57,-14,36
Grasshoppers,1824,8,8,8,16,38,51,-13,32
FC Sion,1824,9,6,8,18,38,53,-15,26
Young Boys,1825,1,22,8,2,79,37,42,74
FC Basel,1825,2,17,10,5,51,24,27,61
FC Zürich,1825,3,12,9,11,40,34,6,45
Lucerne,1825,4,12,8,12,43,47,-4,44
St Gallen,1825,5,13,4,15,41,56,-15,43
FC Lugano,1825,6,11,5,16,32,47,-15,38
Grasshoppers,1825,7,8,9,15,40,50,-10,33
FC Thun,1825,8,9,6,17,40,55,-15,33
FC Sion,1825,9,6,9,17,39,55,-16,27
Young Boys,1826,1,21,8,3,74,35,39,71
FC Basel,1826,2,17,9,6,52,25,27,60
Lucerne,1826,3,13,8,11,43,43,0,47
St Gallen,1826,4,13,2,17,39,57,-18,41
FC Zürich,1826,5,9,11,12,40,40,0,38
FC Lugano,1826,6,11,5,16,34,49,-15,38
FC Sion,1826,7,10,7,15,43,50,-7,37
FC Thun,1826,8,10,6,16,45,59,-14,36
Grasshoppers,1826,9,9,6,17,41,53,-12,33
Young Boys,1827,1,21,7,4,69,33,36,70
FC Basel,1827,2,19,8,5,54,23,31,65
St Gallen,1827,3,14,3,15,42,55,-13,45
Lucerne,1827,4,11,9,12,41,46,-5,42
FC Lugano,1827,5,12,5,15,33,47,-14,41
FC Zürich,1827,6,10,10,12,39,36,3,40
Grasshoppers,1827,7,11,6,15,44,50,-6,39
FC Thun,1827,8,9,6,17,44,60,-16,33
FC Sion,1827,9,6,8,18,38,54,-16,26
Young Boys,1828,1,21,8,3,71,32,39,71
FC Basel,1828,2,17,9,6,59,32,27,60
Lucerne,1828,3,12,9,11,40,45,-5,45
St Gallen,1828,4,13,5,14,45,57,-12,44
FC Zürich,1828,5,10,11,11,42,39,3,41
FC Lugano,1828,6,11,6,15,34,47,-13,39
FC Thun,1828,7,10,6,16,44,57,-13,36
Grasshoppers,1828,8,9,8,15,43,52,-9,35
FC Sion,1828,9,5,10,17,38,55,-17,25
Young Boys,1829,1,22,7,3,73,34,39,73
FC Basel,1829,2,19,7,6,56,25,31,64
Lucerne,1829,3,14,7,11,45,44,1,49
St Gallen,1829,4,14,2,16,47,60,-13,44
FC Zürich,1829,5,10,10,12,38,35,3,40
FC Thun,1829,6,10,6,16,43,56,-13,36
FC Lugano,1829,7,10,6,16,29,50,-21,36
Grasshoppers,1829,8,8,8,16,38,50,-12,32
FC Sion,1829,9,6,9,17,38,53,-15,27
Young Boys,1830,1,22,7,3,72,32,40,73
FC Basel,1830,2,20,7,5,54,22,32,67
St Gallen,1830,3,15,2,15,41,54,-13,47
Lucerne,1830,4,12,7,13,40,45,-5,43
FC Zürich,1830,5,11,9,12,42,38,4,42
FC Lugano,1830,6,12,5,15,33,47,-14,41
Grasshoppers,1830,7,10,6,16,45,52,-7,36
FC Thun,1830,8,8,6,18,43,64,-21,30
FC Sion,1830,9,5,9,18,40,56,-16,24
Young Boys,1831,1,23,6,3,76,31,45,75
FC Basel,1831,2,17,8,7,57,26,31,59
Lucerne,1831,3,14,7,11,46,46,0,49
St Gallen,1831,4,14,4,14,47,57,-10,46
FC Zürich,1831,5,10,10,12,39,39,0,40
FC Thun,1831,6,11,5,16,44,57,-13,38
FC Lugano,1831,7,10,6,16,33,52,-19,36
Grasshoppers,1831,8,9,6,17,38,56,-18,33
FC Sion,1831,9,6,8,18,38,54,-16,26
Young Boys,1832,1,22,6,4,73,36,37,72
FC Basel,1832,2,19,8,5,62,26,36,65
Lucerne,1832,3,14,8,10,43,43,0,50
St Gallen,1832,4,13,4,15,42,56,-14,43
FC Zürich,1832,5,10,12,10,41,35,6,42
Grasshoppers,1832,6,10,7,15,42,49,-7,37
FC Lugano,1832,7,9,6,17,29,52,-23,33
FC Thun,1832,8,8,6,18,43,62,-19,30
FC Sion,1832,9,6,9,17,39,55,-16,27
Young Boys,1833,1,20,8,4,67,35,32,68
FC Basel,1833,2,18,9,5,54,25,29,63
St Gallen,1833,3,15,3,14,48,54,-6,48
Lucerne,1833,4,11,9,12,43,54,-11,42
FC Zürich,1833,5,10,11,11,39,35,4,41
Grasshoppers,1833,6,10,7,15,42,49,-7,37
FC Lugano,1833,7,9,9,14,32,47,-15,36
FC Thun,1833,8,8,8,16,40,57,-17,32
FC Sion,1833,9,7,8,17,42,51,-9,29
Young Boys,1834,1,22,6,4,70,36,34,72
FC Basel,1834,2,20,7,5,57,23,34,67
St Gallen,1834,3,15,2,15,43,58,-15,47
Lucerne,1834,4,13,7,12,46,46,0,46
FC Zürich,1834,5,10,11,11,43,39,4,41
FC Thun,1834,6,9,7,16,42,56,-14,34
FC Lugano,1834,7,9,5,18,30,50,-20,32
FC Sion,1834,8,7,10,15,45,52,-7,31
Grasshoppers,1834,9,8,7,17,39,55,-16,31
Young Boys,1835,1,23,7,2,74,33,41,76
FC Basel,1835,2,19,7,6,58,24,34,64
Lucerne,1835,3,13,7,12,47,47,0,46
St Gallen,1835,4,14,3,15,42,53,-11,45
FC Zürich,1835,5,9,11,12,40,39,1,38
FC Thun,1835,6,11,5,16,47,62,-15,38
FC Lugano,1835,7,10,6,16,29,48,-19,36
Grasshoppers,1835,8,9,6,17,41,55,-14,33
FC Sion,1835,9,5,10,17,42,59,-17,25
Young Boys,1836,1,21,7,4,74,39,35,70
FC Basel,1836,2,18,7,7,55,25,30,61
Lucerne,1836,3,13,10,9,42,39,3,49
St Gallen,1836,4,14,3,15,40,54,-14,45
FC Zürich,1836,5,10,9,13,38,40,-2,39
FC Lugano,1836,6,10,6,16,32,48,-16,36
FC Sion,1836,7,9,8,15,44,51,-7,35
Grasshoppers,1836,8,9,7,16,41,53,-12,34
FC Thun,1836,9,9,5,18,42,59,-17,32
Young Boys,1837,1,24,6,2,81,33,48,78
FC Basel,1837,2,16,8,8,56,30,26,56
Lucerne,1837,3,13,8,11,41,44,-3,47
St Gallen,1837,4,14,4,14,49,60,-11,46
FC Zürich,1837,5,10,10,12,39,37,2,40
FC Lugano,1837,6,10,6,16,34,54,-20,36
Grasshoppers,1837,7,9,8,15,41,50,-9,35
FC Thun,1837,8,9,6,17,42,61,-19,33
FC Sion,1837,9,7,8,17,43,57,-14,29
Young Boys,1838,1,23,6,3,76,34,42,75
FC Basel,1838,2,19,7,6,57,27,30,64
Lucerne,1838,3,12,9,11,43,44,-1,45
St Gallen,1838,4,13,4,15,42,55,-13,43
FC Zürich,1838,5,11,9,12,40,36,4,42
Grasshoppers,1838,6,10,6,16,41,53,-12,36
FC Thun,1838,7,10,6,16,44,58,-14,36
FC Lugano,1838,8,9,7,16,31,49,-18,34
FC Sion,1838,9,6,8,18,38,56,-18,26
Young Boys,1839,1,22,6,4,73,35,38,72
FC Basel,1839,2,16,10,6,53,28,25,58
St Gallen,1839,3,15,3,14,44,54,-10,48
Lucerne,1839,4,12,9,11,41,42,-1,45
FC Zürich,1839,5,10,11,11,40,36,4,41
FC Lugano,1839,6,11,6,15,32,47,-15,39
Grasshoppers,1839,7,10,7,15,42,50,-8,37
FC Thun,1839,8,8,9,15,43,58,-15,33
FC Sion,1839,9,5,9,18,35,53,-18,24
Young Boys,1840,1,22,6,4,75,34,41,72
FC Basel,1840,2,19,7,6,59,26,33,64
St Gallen,1840,3,16,2,14,46,55,-9,50
Lucerne,1840,4,13,7,12,39,45,-6,46
FC Zürich,1840,5,10,10,12,43,39,4,40
FC Thun,1840,6,11,5,16,46,62,-16,38
Grasshoppers,1840,7,9,7,16,38,48,-10,34
FC Lugano,1840,8,9,5,18,32,53,-21,32
FC Sion,1840,9,6,9,17,39,55,-16,27
Young Boys,1841,1,22,7,3,70,34,36,73
FC Basel,1841,2,17,7,8,55,28,27,58
St Gallen,1841,3,16,2,14,47,56,-9,50
Lucerne,1841,4,13,8,11,41,41,0,47
FC Zürich,1841,5,12,10,10,43,33,10,46
FC Lugano,1841,6,10,7,15,33,47,-14,37
Grasshoppers,1841,7,9,7,16,40,50,-10,34
FC Thun,1841,8,8,5,19,40,66,-26,29
FC Sion,1841,9,6,9,17,40,54,-14,27
Young Boys,1842,1,22,8,2,74,34,40,74
FC Basel,1842,2,17,9,6,52,23,29,60
Lucerne,1842,3,12,10,10,44,44,0,46
St Gallen,1842,4,14,3,15,44,58,-14,45
FC Zürich,1842,5,10,10,12,41,40,1,40
Grasshoppers,1842,6,10,7,15,42,48,-6,37
FC Lugano,1842,7,9,8,15,35,51,-16,35
FC Thun,1842,8,9,6,17,40,57,-17,33
FC Sion,1842,9,7,7,18,41,58,-17,28
Young Boys,1843,1,24,6,2,79,31,48,78
FC Basel,1843,2,17,8,7,53,28,25,59
St Gallen,1843,3,15,3,14,43,52,-9,48
Lucerne,1843,4,12,7,13,41,42,-1,43
FC Lugano,1843,5,11,6,15,32,48,-16,39
FC Zürich,1843,6,9,11,12,39,40,-1,38
FC Thun,1843,7,11,5,16,47,58,-11,38
Grasshoppers,1843,8,9,6,17,37,54,-17,33
FC Sion,1843,9,6,8,18,38,56,-18,26
Young Boys,1844,1,23,6,3,76,34,42,75
FC Basel,1844,2,16,8,8,50,27,23,56
Lucerne,1844,3,13,8,11,42,44,-2,47
St Gallen,1844,4,14,4,14,41,53,-12,46
FC Zürich,1844,5,10,11,11,43,39,4,41
FC Thun,1844,6,12,5,15,47,56,-9,41
FC Lugano,1844,7,10,7,15,31,47,-16,37
Grasshoppers,1844,8,9,6,17,40,50,-10,33
FC Sion,1844,9,6,7,19,39,59,-20,25
Young Boys,1845,1,24,6,2,77,30,47,78
FC Basel,1845,2,17,9,6,53,26,27,60
St Gallen,1845,3,14,4,14,41,52,-11,46
Lucerne,1845,4,12,8,12,41,44,-3,44
FC Zürich,1845,5,10,10,12,49,43,6,40
FC Thun,1845,6,11,6,15,47,57,-10,39
FC Lugano,1845,7,11,6,15,33,50,-17,39
Grasshoppers,1845,8,9,6,17,39,53,-14,33
FC Sion,1845,9,5,7,20,36,61,-25,22
Young Boys,1846,1,22,7,3,72,33,39,73
FC Basel,1846,2,17,9,6,51,24,27,60
Lucerne,1846,3,13,10,9,45,43,2,49
St Gallen,1846,4,15,3,14,43,53,-10,48
FC Zürich,1846,5,10,9,13,41,40,1,39
FC Thun,1846,6,10,6,16,44,57,-13,36
FC Lugano,1846,7,10,5,17,30,47,-17,35
Grasshoppers,1846,8,9,6,17,42,53,-11,33
FC Sion,1846,9,7,7,18,37,55,-18,28
Young Boys,1847,1,21,7,4,70,34,36,70
FC Basel,1847,2,19,7,6,57,23,34,64
Lucerne,1847,3,14,7,11,45,46,-1,49
St Gallen,1847,4,15,2,15,47,59,-12,47
FC Zürich,1847,5,12,9,11,44,37,7,45
FC Thun,1847,6,10,5,17,46,61,-15,35
Grasshoppers,1847,7,9,7,16,41,48,-7,34
FC Lugano,1847,8,9,5,18,34,56,-22,32
FC Sion,1847,9,7,7,18,40,60,-20,28
Young Boys,1848,1,21,8,3,73,33,40,71
FC Basel,1848,2,18,8,6,54,26,28,62
St Gallen,1848,3,15,3,14,44,55,-11,48
FC Zürich,1848,4,12,9,11,46,37,9,45
Lucerne,1848,5,12,8,12,43,45,-2,44
Grasshoppers,1848,6,11,7,14,41,45,-4,40
FC Thun,1848,7,9,6,17,41,58,-17,33
FC Lugano,1848,8,9,6,17,30,54,-24,33
FC Sion,1848,9,6,7,19,39,58,-19,25
Young Boys,1849,1,24,6,2,73,31,42,78
FC Basel,1849,2,18,7,7,58,26,32,61
St Gallen,1849,3,15,2,15,41,57,-16,47
Lucerne,1849,4,12,8,12,40,43,-3,44
FC Zürich,1849,5,11,9,12,44,37,7,42
FC Lugano,1849,6,11,6,15,30,44,-14,39
FC Thun,1849,7,10,5,17,44,60,-16,35
Grasshoppers,1849,8,8,7,17,38,51,-13,31
FC Sion,1849,9,6,8,18,38,57,-19,26
Young Boys,1850,1,22,7,3,71,33,38,73
FC Basel,1850,2,18,8,6,56,24,32,62
FC Zürich,1850,3,11,10,11,41,35,6,43
Lucerne,1850,4,12,7,13,39,46,-7,43
FC Lugano,1850,5,12,5,15,32,45,-13,41
St Gallen,1850,6,13,2,17,39,61,-22,41
Grasshoppers,1850,7,10,8,14,44,48,-4,38
FC Thun,1850,8,9,5,18,45,65,-20,32
FC Sion,1850,9,7,8,17,44,54,-10,29
Young Boys,1851,1,21,8,3,71,35,36,71
FC Basel,1851,2,17,8,7,56,30,26,59
St Gallen,1851,3,15,3,14,45,56,-11,48
Lucerne,1851,4,13,7,12,41,46,-5,46
FC Zürich,1851,5,11,11,10,43,34,9,44
Grasshoppers,1851,6,12,6,14,46,47,-1,42
FC Lugano,1851,7,9,8,15,31,47,-16,35
FC Thun,1851,8,8,5,19,43,62,-19,29
FC Sion,1851,9,6,8,18,40,59,-19,26
Young Boys,1852,1,23,6,3,76,33,43,75
FC Basel,1852,2,20,7,5,65,26,39,67
Lucerne,1852,3,13,8,11,42,50,-8,47
St Gallen,1852,4,14,2,16,45,58,-13,44
FC Zürich,1852,5,11,10,11,44,39,5,43
FC Lugano,1852,6,10,7,15,30,47,-17,37
Grasshoppers,1852,7,9,6,17,40,51,-11,33
FC Thun,1852,8,9,5,18,43,64,-21,32
FC Sion,1852,9,6,7,19,42,59,-17,25
Young Boys,1853,1,20,8,4,69,38,31,68
FC Basel,1853,2,19,8,5,59,27,32,65
Lucerne,1853,3,13,8,11,48,44,4,47
St Gallen,1853,4,14,4,14,43,56,-13,46
FC Zürich,1853,5,10,9,13,41,38,3,39
FC Lugano,1853,6,10,7,15,30,49,-19,37
Grasshoppers,1853,7,9,8,15,40,48,-8,35
FC Thun,1853,8,9,6,17,42,59,-17,33
FC Sion,1853,9,7,8,17,41,54,-13,29
Young Boys,1854,1,22,7,3,75,32,43,73
FC Basel,1854,2,18,8,6,55,28,27,62
St Gallen,1854,3,15,4,13,44,53,-9,49
Lucerne,1854,4,12,8,12,42,48,-6,44
FC Zürich,1854,5,10,10,12,39,36,3,40
Grasshoppers,1854,6,9,7,16,41,53,-12,34
FC Thun,1854,7,9,7,16,44,59,-15,34
FC Lugano,1854,8,9,7,16,31,49,-18,34
FC Sion,1854,9,6,10,16,38,51,-13,28
Young Boys,1855,1,19,10,3,68,36,32,67
FC Basel,1855,2,16,10,6,51,26,25,58
Lucerne,1855,3,13,9,10,43,41,2,48
St Gallen,1855,4,14,5,13,45,53,-8,47
FC Zürich,1855,5,10,11,11,43,35,8,41
Grasshoppers,1855,6,11,7,14,43,46,-3,40
FC Thun,1855,7,10,6,16,43,57,-14,36
FC Lugano,1855,8,9,7,16,31,53,-22,34
FC Sion,1855,9,5,9,18,37,57,-20,24
Young Boys,1856,1,21,6,5,74,39,35,69
FC Basel,1856,2,20,7,5,60,26,34,67
St Gallen,1856,3,15,3,14,45,57,-12,48
Lucerne,1856,4,13,7,12,43,47,-4,46
FC Zürich,1856,5,11,9,12,44,36,8,42
FC Thun,1856,6,11,5,16,48,58,-10,38
Grasshoppers,1856,7,9,7,16,42,52,-10,34
FC Lugano,1856,8,9,6,17,28,49,-21,33
FC Sion,1856,9,6,8,18,43,63,-20,26
Young Boys,1857,1,22,7,3,73,36,37,73
FC Basel,1857,2,18,8,6,54,25,29,62
Lucerne,1857,3,12,10,10,44,42,2,46
St Gallen,1857,4,14,3,15,40,53,-13,45
FC Lugano,1857,5,12,5,15,36,45,-9,41
FC Zürich,1857,6,10,10,12,41,39,2,40
FC Thun,1857,7,10,6,16,44,58,-14,36
Grasshoppers,1857,8,9,6,17,39,56,-17,33
FC Sion,1857,9,6,7,19,41,58,-17,25
Young Boys,1858,1,21,7,4,72,36,36,70
FC Basel,1858,2,18,8,6,53,26,27,62
St Gallen,1858,3,15,2,15,48,56,-8,47
FC Zürich,1858,4,11,10,11,42,36,6,43
Lucerne,1858,5,11,9,12,42,48,-6,42
Grasshoppers,1858,6,11,7,14,42,45,-3,40
FC Lugano,1858,7,11,6,15,31,47,-16,39
FC Thun,1858,8,9,6,17,42,59,-17,33
FC Sion,1858,9,6,7,19,40,59,-19,25
Young Boys,1859,1,22,8,2,73,31,42,74
FC Basel,1859,2,18,8,6,54,23,31,62
Lucerne,1859,3,12,8,12,39,45,-6,44
St Gallen,1859,4,14,2,16,40,59,-19,44
FC Zürich,1859,5,11,9,12,38,34,4,42
FC Lugano,1859,6,11,5,16,31,48,-17,38
Grasshoppers,1859,7,9,9,14,41,47,-6,36
FC Thun,1859,8,10,6,16,41,56,-15,36
FC Sion,1859,9,6,7,19,41,55,-14,25
Young Boys,1860,1,20,7,5,68,39,29,67
FC Basel,1860,2,18,8,6,58,26,32,62
Lucerne,1860,3,14,7,11,48,46,2,49
FC Zürich,1860,4,12,9,11,43,37,6,45
St Gallen,1860,5,14,3,15,43,56,-13,45
FC Lugano,1860,6,11,5,16,35,50,-15,38
FC Sion,1860,7,8,9,15,40,50,-10,33
Grasshoppers,1860,8,8,8,16,39,51,-12,32
FC Thun,1860,9,8,6,18,47,66,-19,30
Young Boys,1861,1,23,6,3,74,35,39,75
FC Basel,1861,2,18,7,7,55,25,30,61
Lucerne,1861,3,13,8,11,42,43,-1,47
FC Zürich,1861,4,12,9,11,44,38,6,45
St Gallen,1861,5,14,2,16,43,57,-14,44
Grasshoppers,1861,6,10,7,15,42,48,-6,37
FC Lugano,1861,7,10,5,17,31,51,-20,35
FC Thun,1861,8,8,6,18,42,61,-19,30
FC Sion,1861,9,7,8,17,41,56,-15,29
Young Boys,1862,1,22,7,3,74,37,37,73
FC Basel,1862,2,17,7,8,52,31,21,58
Lucerne,1862,3,14,7,11,45,44,1,49
St Gallen,1862,4,15,2,15,45,56,-11,47
FC Zürich,1862,5,11,10,11,43,37,6,43
Grasshoppers,1862,6,9,9,14,43,50,-7,36
FC Lugano,1862,7,10,5,17,31,51,-20,35
FC Sion,1862,8,7,9,16,46,55,-9,30
FC Thun,1862,9,8,6,18,43,61,-18,30
Young Boys,1863,1,22,7,3,75,34,41,73
FC Basel,1863,2,18,8,6,53,26,27,62
St Gallen,1863,3,14,5,13,44,54,-10,47
Lucerne,1863,4,12,9,11,42,44,-2,45
FC Lugano,1863,5,11,6,15,33,48,-15,39
FC Zürich,1863,6,9,11,12,40,38,2,38
FC Thun,1863,7,10,6,16,45,57,-12,36
Grasshoppers,1863,8,8,7,17,39,56,-17,31
FC Sion,1863,9,6,9,17,40,54,-14,27
Young Boys,1864,1,22,6,4,70,34,36,72
FC Basel,1864,2,18,8,6,53,28,25,62
St Gallen,1864,3,16,2,14,47,54,-7,50
Lucerne,1864,4,13,8,11,45,45,0,47
FC Zürich,1864,5,10,11,11,44,37,7,41
FC Lugano,1864,6,10,5,17,31,51,-20,35
FC Thun,1864,7,9,7,16,43,58,-15,34
Grasshoppers,1864,8,8,8,16,36,49,-13,32
FC Sion,1864,9,7,7,18,44,57,-13,28
Young Boys,1865,1,22,8,2,71,32,39,74
FC Basel,1865,2,17,8,7,52,28,24,59
St Gallen,1865,3,16,3,13,47,51,-4,51
FC Zürich,1865,4,11,10,11,40,35,5,43
Lucerne,1865,5,11,8,13,39,45,-6,41
FC Lugano,1865,6,11,5,16,32,47,-15,38
Grasshoppers,1865,7,9,7,16,40,50,-10,34
FC Thun,1865,8,9,7,16,47,62,-15,34
FC Sion,1865,9,6,8,18,42,60,-18,26
Young Boys,1866,1,22,7,3,72,33,39,73
FC Basel,1866,2,20,7,5,58,24,34,67
Lucerne,1866,3,13,7,12,42,45,-3,46
FC Zürich,1866,4,11,9,12,44,39,5,42
St Gallen,1866,5,13,3,16,42,57,-15,42
FC Lugano,1866,6,11,6,15,32,48,-16,39
FC Thun,1866,7,10,5,17,44,60,-16,35
Grasshoppers,1866,8,9,7,16,39,48,-9,34
FC Sion,1866,9,6,7,19,38,57,-19,25
Young Boys,1867,1,21,7,4,69,35,34,70
FC Basel,1867,2,19,8,5,57,25,32,65
Lucerne,1867,3,14,7,11,45,46,-1,49
St Gallen,1867,4,13,2,17,43,60,-17,41
FC Zürich,1867,5,10,10,12,38,36,2,40
FC Lugano,1867,6,11,6,15,33,46,-13,39
FC Thun,1867,7,9,7,16,43,57,-14,34
FC Sion,1867,8,8,9,15,38,48,-10,33
Grasshoppers,1867,9,8,6,18,41,54,-13,30
Young Boys,1868,1,20,10,2,74,38,36,70
FC Basel,1868,2,18,9,5,56,23,33,63
Lucerne,1868,3,12,10,10,42,44,-2,46
FC Zürich,1868,4,11,10,11,43,37,6,43
St Gallen,1868,5,13,4,15,40,57,-17,43
FC Lugano,1868,6,10,7,15,35,48,-13,37
FC Thun,1868,7,10,5,17,42,60,-18,35
Grasshoppers,1868,8,9,7,16,39,47,-8,34
FC Sion,1868,9,6,8,18,40,57,-17,26
Young Boys,1869,1,22,8,2,74,33,41,74
FC Basel,1869,2,19,8,5,57,24,33,65
St Gallen,1869,3,15,3,14,50,59,-9,48
Lucerne,1869,4,12,8,12,43,48,-5,44
FC Lugano,1869,5,11,6,15,37,48,-11,39
FC Zürich,1869,6,9,10,13,38,40,-2,37
Grasshoppers,1869,7,8,8,16,39,53,-14,32
FC Thun,1869,8,8,7,17,40,59,-19,31
FC Sion,1869,9,7,8,17,42,56,-14,29
Young Boys,1870,1,22,6,4,69,37,32,72
FC Basel,1870,2,17,8,7,54,26,28,59
Lucerne,1870,3,13,8,11,45,47,-2,47
St Gallen,1870,4,15,2,15,45,55,-10,47
FC Zürich,1870,5,11,10,11,40,35,5,43
FC Sion,1870,6,9,8,15,46,49,-3,35
FC Thun,1870,7,10,5,17,45,62,-17,35
FC Lugano,1870,8,10,5,17,31,49,-18,35
Grasshoppers,1870,9,8,6,18,40,55,-15,30
Young Boys,1871,1,23,7,2,73,31,42,76
FC Basel,1871,2,18,8,6,55,27,28,62
Lucerne,1871,3,13,9,10,48,44,4,48
St Gallen,1871,4,14,3,15,45,55,-10,45
FC Zürich,1871,5,10,11,11,43,38,5,41
FC Lugano,1871,6,10,5,17,30,51,-21,35
Grasshoppers,1871,7,9,6,17,40,52,-12,33
FC Thun,1871,8,8,7,17,43,63,-20,31
FC Sion,1871,9,7,8,17,42,58,-16,29
Young Boys,1872,1,22,8,2,76,35,41,74
FC Basel,1872,2,18,9,5,55,25,30,63
Lucerne,1872,3,13,7,12,43,49,-6,46
St Gallen,1872,4,13,5,14,42,55,-13,44
FC Zürich,1872,5,10,10,12,38,36,2,40
Grasshoppers,1872,6,9,8,15,42,51,-9,35
FC Thun,1872,7,9,7,16,41,55,-14,34
FC Lugano,1872,8,9,7,16,31,49,-18,34
FC Sion,1872,9,6,9,17,41,54,-13,27
Young Boys,1873,1,22,6,4,70,38,32,72
FC Basel,1873,2,19,7,6,57,26,31,64
Lucerne,1873,3,12,8,12,42,45,-3,44
FC Zürich,1873,4,11,9,12,41,36,5,42
St Gallen,1873,5,13,2,17,41,61,-20,41
FC Lugano,1873,6,11,6,15,32,45,-13,39
Grasshoppers,1873,7,10,6,16,43,50,-7,36
FC Thun,1873,8,10,5,17,42,57,-15,35
FC Sion,1873,9,8,7,17,43,53,-10,31
Young Boys,1874,1,21,7,4,71,38,33,70
FC Basel,1874,2,18,9,5,57,26,31,63
St Gallen,1874,3,15,3,14,49,55,-6,48
Lucerne,1874,4,12,9,11,43,47,-4,45
FC Zürich,1874,5,11,10,11,43,37,6,43
Grasshoppers,1874,6,10,7,15,40,47,-7,37
FC Lugano,1874,7,10,6,16,32,51,-19,36
FC Thun,1874,8,8,6,18,40,60,-20,30
FC Sion,1874,9,6,9,17,40,54,-14,27
Young Boys,1875,1,21,8,3,73,35,38,71
FC Basel,1875,2,17,10,5,53,24,29,61
St Gallen,1875,3,15,3,14,45,53,-8,48
Lucerne,1875,4,12,8,12,39,47,-8,44
FC Zürich,1875,5,11,10,11,41,39,2,43
Grasshoppers,1875,6,10,6,16,41,50,-9,36
FC Lugano,1875,7,10,6,16,32,47,-15,36
FC Thun,1875,8,9,6,17,46,59,-13,33
FC Sion,1875,9,7,7,18,40,56,-16,28
Young Boys,1876,1,23,6,3,74,31,43,75
FC Basel,1876,2,19,8,5,55,23,32,65
Lucerne,1876,3,13,8,11,41,42,-1,47
St Gallen,1876,4,14,3,15,45,56,-11,45
FC Zürich,1876,5,10,10,12,42,36,6,40
FC Thun,1876,6,10,5,17,44,62,-18,35
FC Lugano,1876,7,10,5,17,31,55,-24,35
Grasshoppers,1876,8,9,6,17,38,49,-11,33
FC Sion,1876,9,7,7,18,38,54,-16,28
Young Boys,1877,1,21,8,3,68,33,35,71
FC Basel,1877,2,19,8,5,54,25,29,65
Lucerne,1877,3,13,9,10,47,44,3,48
St Gallen,1877,4,14,3,15,46,57,-11,45
FC Zürich,1877,5,11,9,12,45,36,9,42
Grasshoppers,1877,6,9,8,15,45,53,-8,35
FC Thun,1877,7,10,5,17,47,62,-15,35
FC Lugano,1877,8,10,5,17,29,52,-23,35
FC Sion,1877,9,5,9,18,42,61,-19,24
Young Boys,1878,1,21,8,3,73,37,36,71
FC Basel,1878,2,19,7,6,56,24,32,64
St Gallen,1878,3,14,4,14,41,52,-11,46
Lucerne,1878,4,11,11,10,40,43,-3,44
FC Zürich,1878,5,10,11,11,41,37,4,41
FC Lugano,1878,6,10,7,15,30,47,-17,37
Grasshoppers,1878,7,9,7,16,41,52,-11,34
FC Thun,1878,8,9,6,17,43,59,-16,33
FC Sion,1878,9,5,11,16,37,51,-14,26
Young Boys,1879,1,20,8,4,70,39,31,68
FC Basel,1879,2,17,7,8,52,27,25,58
St Gallen,1879,3,15,2,15,48,55,-7,47
Lucerne,1879,4,13,8,11,42,49,-7,47
FC Zürich,1879,5,11,11,10,43,37,6,44
Grasshoppers,1879,6,11,6,15,47,49,-2,39
FC Lugano,1879,7,10,6,16,34,49,-15,36
FC Thun,1879,8,9,6,17,43,59,-16,33
FC Sion,1879,9,7,8,17,40,55,-15,29
Young Boys,1880,1,21,7,4,74,38,36,70
FC Basel,1880,2,18,8,6,56,25,31,62
FC Zürich,1880,3,12,9,11,41,35,6,45
St Gallen,1880,4,13,5,14,40,58,-18,44
Lucerne,1880,5,11,10,11,40,45,-5,43
FC Lugano,1880,6,11,6,15,32,48,-16,39
Grasshoppers,1880,7,9,9,14,42,49,-7,36
FC Thun,1880,8,8,7,17,41,58,-17,31
FC Sion,1880,9,6,9,17,44,54,-10,27
Young Boys,1881,1,22,7,3,73,35,38,73
FC Basel,1881,2,18,8,6,57,25,32,62
St Gallen,1881,3,16,2,14,48,53,-5,50
FC Zürich,1881,4,11,11,10,42,36,6,44
Lucerne,1881,5,11,8,13,39,53,-14,41
FC Thun,1881,6,10,5,17,41,57,-16,35
Grasshoppers,1881,7,9,7,16,41,50,-9,34
FC Lugano,1881,8,9,7,16,31,50,-19,34
FC Sion,1881,9,7,7,18,40,53,-13,28
Young Boys,1882,1,21,7,4,69,35,34,70
FC Basel,1882,2,17,9,6,53,26,27,60
Lucerne,1882,3,13,8,11,43,45,-2,47
FC Zürich,1882,4,12,10,10,42,34,8,46
St Gallen,1882,5,14,2,16,42,59,-17,44
Grasshoppers,1882,6,10,7,15,45,50,-5,37
FC Lugano,1882,7,10,5,17,33,50,-17,35
FC Thun,1882,8,8,8,16,42,59,-17,32
FC Sion,1882,9,6,10,16,41,52,-11,28
Young Boys,1883,1,23,6,3,73,36,37,75
FC Basel,1883,2,16,10,6,55,29,26,58
St Gallen,1883,3,14,4,14,45,56,-11,46
Lucerne,1883,4,11,11,10,43,45,-2,44
FC Zürich,1883,5,11,10,11,42,38,4,43
Grasshoppers,1883,6,10,8,14,42,48,-6,38
FC Thun,1883,7,9,6,17,42,57,-15,33
FC Lugano,1883,8,9,6,17,28,47,-19,33
FC Sion,1883,9,6,9,17,43,57,-14,27
Young Boys,1884,1,22,6,4,74,36,38,72
FC Basel,1884,2,18,9,5,57,25,32,63
Lucerne,1884,3,13,9,10,44,45,-1,48
St Gallen,1884,4,14,2,16,44,60,-16,44
FC Zürich,1884,5,10,11,11,40,36,4,41
FC Lugano,1884,6,11,5,16,36,51,-15,38
FC Thun,1884,7,10,5,17,45,58,-13,35
Grasshoppers,1884,8,9,7,16,43,53,-10,34
FC Sion,1884,9,6,8,18,41,60,-19,26
Young Boys,1885,1,20,7,5,67,37,30,67
FC Basel,1885,2,17,10,5,55,25,30,61
Lucerne,1885,3,13,9,10,43,43,0,48
St Gallen,1885,4,14,4,14,42,53,-11,46
FC Zürich,1885,5,10,11,11,41,37,4,41
Grasshoppers,1885,6,10,7,15,43,48,-5,37
FC Lugano,1885,7,10,6,16,33,49,-16,36
FC Thun,1885,8,9,6,17,43,60,-17,33
FC Sion,1885,9,7,8,17,42,57,-15,29
Young Boys,1886,1,23,6,3,71,34,37,75
FC Basel,1886,2,17,7,8,53,28,25,58
Lucerne,1886,3,13,8,11,46,44,2,47
St Gallen,1886,4,14,4,14,41,51,-10,46
FC Thun,1886,5,12,5,15,47,53,-6,41
FC Zürich,1886,6,9,10,13,38,42,-4,37
Grasshoppers,1886,7,10,6,16,40,48,-8,36
FC Lugano,1886,8,9,7,16,30,49,-19,34
FC Sion,1886,9,7,7,18,39,56,-17,28
Young Boys,1887,1,19,10,3,67,37,30,67
FC Basel,1887,2,17,9,6,51,23,28,60
Lucerne,1887,3,13,8,11,46,45,1,47
St Gallen,1887,4,14,3,15,43,56,-13,45
FC Zürich,1887,5,10,10,12,38,38,0,40
FC Thun,1887,6,11,5,16,48,58,-10,38
FC Lugano,1887,7,10,7,15,32,49,-17,37
Grasshoppers,1887,8,8,9,15,39,49,-10,33
FC Sion,1887,9,7,9,16,42,51,-9,30
Young Boys,1888,1,22,8,2,73,32,41,74
FC Basel,1888,2,19,8,5,57,24,33,65
Lucerne,1888,3,12,8,12,40,45,-5,44
St Gallen,1888,4,13,4,15,40,54,-14,43
FC Zürich,1888,5,10,10,12,42,36,6,40
Grasshoppers,1888,6,10,7,15,46,51,-5,37
FC Lugano,1888,7,10,7,15,31,47,-16,37
FC Thun,1888,8,9,6,17,43,65,-22,33
FC Sion,1888,9,6,8,18,39,57,-18,26
Young Boys,1889,1,21,8,3,71,35,36,71
FC Basel,1889,2,17,8,7,56,29,27,59
St Gallen,1889,3,15,2,15,44,55,-11,47
Lucerne,1889,4,13,7,12,42,46,-4,46
FC Zürich,1889,5,11,10,11,39,34,5,43
FC Lugano,1889,6,10,6,16,30,47,-17,36
Grasshoppers,1889,7,9,7,16,43,52,-9,34
FC Thun,1889,8,9,6,17,41,58,-17,33
FC Sion,1889,9,8,8,16,41,51,-10,32
Young Boys,1890,1,22,7,3,70,34,36,73
FC Basel,1890,2,17,10,5,54,23,31,61
Lucerne,1890,3,12,10,10,46,47,-1,46
St Gallen,1890,4,14,4,14,44,55,-11,46
FC Zürich,1890,5,10,10,12,40,39,1,40
FC Lugano,1890,6,10,5,17,31,50,-19,35
FC Thun,1890,7,9,7,16,40,55,-15,34
Grasshoppers,1890,8,8,8,16,39,50,-11,32
FC Sion,1890,9,7,9,16,40,51,-11,30
Young Boys,1891,1,22,8,2,77,37,40,74
FC Basel,1891,2,16,11,5,51,25,26,59
St Gallen,1891,3,15,2,15,41,54,-13,47
Lucerne,1891,4,11,9,12,40,44,-4,42
FC Lugano,1891,5,12,5,15,34,45,-11,41
FC Zürich,1891,6,10,10,12,42,39,3,40
Grasshoppers,1891,7,10,7,15,45,51,-6,37
FC Thun,1891,8,9,7,16,43,58,-15,34
FC Sion,1891,9,6,7,19,39,59,-20,25
Young Boys,1892,1,22,6,4,71,35,36,72
FC Basel,1892,2,18,8,6,55,27,28,62
Lucerne,1892,3,14,8,10,47,43,4,50
St Gallen,1892,4,14,4,14,44,55,-11,46
FC Zürich,1892,5,12,9,11,48,38,10,45
Grasshoppers,1892,6,9,6,17,42,52,-10,33
FC Lugano,1892,7,9,6,17,30,50,-20,33
FC Thun,1892,8,9,5,18,41,62,-21,32
FC Sion,1892,9,7,8,17,39,55,-16,29
Young Boys,1893,1,24,6,2,75,30,45,78
FC Basel,1893,2,17,9,6,55,25,30,60
Lucerne,1893,3,12,9,11,38,41,-3,45
St Gallen,1893,4,14,2,16,43,60,-17,44
FC Zürich,1893,5,10,12,10,39,34,5,42
FC Lugano,1893,6,10,7,15,31,48,-17,37
FC Thun,1893,7,9,7,16,44,59,-15,34
Grasshoppers,1893,8,8,8,16,39,51,-12,32
FC Sion,1893,9,6,8,18,41,57,-16,26
Young Boys,1894,1,21,7,4,73,33,40,70
FC Basel,1894,2,16,9,7,49,28,21,57
St Gallen,1894,3,15,3,14,46,53,-7,48
Lucerne,1894,4,13,8,11,41,46,-5,47
FC Zürich,1894,5,10,11,11,44,38,6,41
Grasshoppers,1894,6,10,7,15,42,49,-7,37
FC Lugano,1894,7,9,7,16,30,52,-22,34
FC Thun,1894,8,9,6,17,42,57,-15,33
FC Sion,1894,9,8,8,16,44,55,-11,32
Young Boys,1895,1,22,7,3,72,32,40,73
FC Basel,1895,2,20,7,5,57,24,33,67
Lucerne,1895,3,12,9,11,39,42,-3,45
St Gallen,1895,4,14,3,15,45,57,-12,45
FC Zürich,1895,5,11,9,12,41,38,3,42
FC Lugano,1895,6,9,7,16,33,52,-19,34
Grasshoppers,1895,7,9,6,17,40,51,-11,33
FC Thun,1895,8,9,5,18,46,64,-18,32
FC Sion,1895,9,8,7,17,40,53,-13,31
Young Boys,1896,1,22,6,4,72,35,37,72
FC Basel,1896,2,17,8,7,53,29,24,59
St Gallen,1896,3,15,3,14,50,57,-7,48
Lucerne,1896,4,13,8,11,41,42,-1,47
FC Zürich,1896,5,11,11,10,43,35,8,44
Grasshoppers,1896,6,10,6,16,39,48,-9,36
FC Thun,1896,7,10,5,17,43,59,-16,35
FC Lugano,1896,8,9,6,17,29,50,-21,33
FC Sion,1896,9,7,7,18,42,57,-15,28
Young Boys,1897,1,20,7,5,67,35,32,67
FC Basel,1897,2,16,7,9,48,28,20,55
St Gallen,1897,3,15,2,15,46,55,-9,47
Lucerne,1897,4,12,10,10,41,44,-3,46
FC Zürich,1897,5,11,9,12,39,38,1,42
FC Lugano,1897,6,11,6,15,33,45,-12,39
FC Thun,1897,7,11,5,16,45,55,-10,38
FC Sion,1897,8,9,7,16,44,52,-8,34
Grasshoppers,1897,9,9,7,16,38,49,-11,34
Young Boys,1898,1,21,7,4,73,37,36,70
FC Basel,1898,2,18,9,5,56,25,31,63
Lucerne,1898,3,13,9,10,42,43,-1,48
St Gallen,1898,4,14,3,15,43,55,-12,45
FC Zürich,1898,5,11,10,11,43,36,7,43
Grasshoppers,1898,6,10,7,15,43,50,-7,37
FC Lugano,1898,7,9,7,16,29,52,-23,34
FC Thun,1898,8,9,6,17,42,57,-15,33
FC Sion,1898,9,6,8,18,38,54,-16,26
Young Boys,1899,1,23,6,3,74,34,40,75
FC Basel,1899,2,18,8,6,57,24,33,62
Lucerne,1899,3,11,10,11,40,47,-7,43
St Gallen,1899,4,13,4,15,41,57,-16,43
FC Lugano,1899,5,11,7,14,36,47,-11,40
FC Thun,1899,6,11,5,16,44,58,-14,38
FC Zürich,1899,7,9,10,13,38,41,-3,37
Grasshoppers,1899,8,9,7,16,39,50,-11,34
FC Sion,1899,9,7,7,18,40,51,-11,28
Young Boys,1900,1,21,9,2,71,32,39,72
FC Basel,1900,2,17,8,7,52,30,22,59
Lucerne,1900,3,11,11,10,43,46,-3,44
FC Zürich,1900,4,11,10,11,44,37,7,43
St Gallen,1900,5,13,4,15,41,54,-13,43
FC Lugano,1900,6,11,6,15,33,47,-14,39
FC Thun,1900,7,11,5,16,43,55,-12,38
Grasshoppers,1900,8,9,8,15,43,49,-6,35
FC Sion,1900,9,5,9,18,36,56,-20,24
Young Boys,1901,1,23,6,3,75,34,41,75
FC Basel,1901,2,18,8,6,54,25,29,62
Lucerne,1901,3,13,9,10,46,45,1,48
St Gallen,1901,4,14,2,16,41,56,-15,44
FC Zürich,1901,5,11,9,12,40,36,4,42
Grasshoppers,1901,6,9,8,15,40,48,-8,35
FC Thun,1901,7,9,7,16,41,57,-16,34
FC Lugano,1901,8,9,5,18,31,52,-21,32
FC Sion,1901,9,7,8,17,37,52,-15,29
Young Boys,1902,1,20,8,4,70,36,34,68
FC Basel,1902,2,18,8,6,53,24,29,62
FC Zürich,1902,3,12,10,10,42,34,8,46
St Gallen,1902,4,14,3,15,41,54,-13,45
Lucerne,1902,5,11,10,11,40,45,-5,43
Grasshoppers,1902,6,11,6,15,43,48,-5,39
FC Lugano,1902,7,10,5,17,31,49,-18,35
FC Thun,1902,8,9,7,16,42,57,-15,34
FC Sion,1902,9,6,9,17,39,54,-15,27
Young Boys,1903,1,23,7,2,75,37,38,76
FC Basel,1903,2,17,7,8,55,29,26,58
St Gallen,1903,3,15,3,14,41,51,-10,48
Lucerne,1903,4,12,9,11,41,45,-4,45
FC Zürich,1903,5,10,11,11,41,36,5,41
FC Thun,1903,6,10,6,16,45,58,-13,36
FC Lugano,1903,7,10,6,16,31,47,-16,36
Grasshoppers,1903,8,9,8,15,43,51,-8,35
FC Sion,1903,9,6,7,19,37,55,-18,25
Young Boys,1904,1,21,7,4,72,38,34,70
FC Basel,1904,2,17,9,6,53,26,27,60
Lucerne,1904,3,14,9,9,44,42,2,51
St Gallen,1904,4,14,5,13,42,52,-10,47
FC Zürich,1904,5,10,9,13,39,40,-1,39
Grasshoppers,1904,6,10,6,16,41,48,-7,36
FC Lugano,1904,7,10,6,16,30,46,-16,36
FC Thun,1904,8,10,5,17,49,58,-9,35
FC Sion,1904,9,6,8,18,40,60,-20,26
Young Boys,1905,1,23,7,2,81,37,44,76
FC Basel,1905,2,16,9,7,55,29,26,57
Lucerne,1905,3,13,8,11,43,51,-8,47
St Gallen,1905,4,14,2,16,39,55,-16,44
FC Zürich,1905,5,11,10,11,43,39,4,43
FC Lugano,1905,6,10,7,15,34,48,-14,37
Grasshoppers,1905,7,9,7,16,41,52,-11,34
FC Thun,1905,8,9,7,16,43,55,-12,34
FC Sion,1905,9,7,7,18,41,54,-13,28
Young Boys,1906,1,22,7,3,69,34,35,73
FC Basel,1906,2,17,10,5,53,24,29,61
St Gallen,1906,3,15,3,14,47,55,-8,48
Lucerne,1906,4,12,9,11,42,44,-2,45
FC Zürich,1906,5,11,9,12,44,38,6,42
FC Lugano,1906,6,11,6,15,30,45,-15,39
FC Thun,1906,7,10,6,16,43,58,-15,36
Grasshoppers,1906,8,8,7,17,37,48,-11,31
FC Sion,1906,9,6,7,19,39,58,-19,25
Young Boys,1907,1,23,6,3,73,30,43,75
FC Basel,1907,2,18,8,6,53,27,26,62
Lucerne,1907,3,13,7,12,43,43,0,46
St Gallen,1907,4,14,4,14,46,57,-11,46
FC Zürich,1907,5,11,10,11,44,39,5,43
Grasshoppers,1907,6,10,6,16,40,49,-9,36
FC Lugano,1907,7,10,6,16,30,48,-18,36
FC Thun,1907,8,10,5,17,43,58,-15,35
FC Sion,1907,9,5,8,19,40,61,-21,23
Young Boys,1908,1,22,6,4,73,36,37,72
FC Basel,1908,2,19,7,6,58,25,33,64
St Gallen,1908,3,15,3,14,44,53,-9,48
Lucerne,1908,4,12,8,12,43,46,-3,44
FC Thun,1908,5,11,5,16,47,60,-13,38
FC Lugano,1908,6,11,5,16,32,48,-16,38
FC Zürich,1908,7,9,9,14,39,42,-3,36
FC Sion,1908,8,9,7,16,44,53,-9,34
Grasshoppers,1908,9,8,6,18,36,53,-17,30
Young Boys,1909,1,22,6,4,74,38,36,72
FC Basel,1909,2,16,10,6,50,25,25,58
Lucerne,1909,3,13,9,10,41,42,-1,48
St Gallen,1909,4,14,4,14,44,55,-11,46
FC Zürich,1909,5,11,10,11,42,34,8,43
FC Thun,1909,6,10,6,16,41,55,-14,36
FC Lugano,1909,7,10,5,17,32,50,-18,35
Grasshoppers,1909,8,9,7,16,38,47,-9,34
FC Sion,1909,9,7,7,18,39,55,-16,28
Young Boys,1910,1,23,6,3,71,34,37,75
FC Basel,1910,2,17,9,6,52,25,27,60
St Gallen,1910,3,16,2,14,45,53,-8,50
Lucerne,1910,4,13,8,11,42,42,0,47
FC Zürich,1910,5,10,10,12,40,37,3,40
FC Thun,1910,6,10,5,17,46,60,-14,35
Grasshoppers,1910,7,9,6,17,40,54,-14,33
FC Lugano,1910,8,9,5,18,31,50,-19,32
FC Sion,1910,9,8,7,17,40,52,-12,31
Young Boys,1911,1,23,6,3,72,34,38,75
FC Basel,1911,2,16,9,7,51,27,24,57
Lucerne,1911,3,14,8,10,45,42,3,50
FC Zürich,1911,4,10,11,11,41,38,3,41
St Gallen,1911,5,13,2,17,40,61,-21,41
FC Thun,1911,6,10,7,15,45,57,-12,37
FC Lugano,1911,7,10,5,17,31,48,-17,35
Grasshoppers,1911,8,9,7,16,42,52,-10,34
FC Sion,1911,9,8,7,17,46,54,-8,31
Young Boys,1912,1,21,7,4,73,39,34,70
FC Basel,1912,2,17,10,5,54,24,30,61
St Gallen,1912,3,14,3,15,42,55,-13,45
Lucerne,1912,4,11,10,11,42,47,-5,43
FC Zürich,1912,5,10,12,10,41,36,5,42
Grasshoppers,1912,6,11,7,14,47,49,-2,40
FC Lugano,1912,7,9,7,16,28,50,-22,34
FC Thun,1912,8,9,6,17,44,58,-14,33
FC Sion,1912,9,7,8,17,42,55,-13,29
Young Boys,1913,1,23,7,2,70,31,39,76
FC Basel,1913,2,16,8,8,52,25,27,56
Lucerne,1913,3,13,9,10,40,40,0,48
St Gallen,1913,4,14,2,16,40,56,-16,44
FC Zürich,1913,5,11,10,11,40,37,3,43
FC Lugano,1913,6,11,5,16,37,46,-9,38
Grasshoppers,1913,7,9,9,14,40,46,-6,36
FC Thun,1913,8,8,8,16,40,60,-20,32
FC Sion,1913,9,6,8,18,36,54,-18,26
Young Boys,1914,1,20,7,5,65,36,29,67
FC Basel,1914,2,17,10,5,53,23,30,61
St Gallen,1914,3,16,3,13,47,53,-6,51
Lucerne,1914,4,12,8,12,40,47,-7,44
FC Zürich,1914,5,10,10,12,38,37,1,40
FC Thun,1914,6,11,5,16,48,57,-9,38
FC Lugano,1914,7,11,5,16,32,45,-13,38
Grasshoppers,1914,8,10,7,15,43,50,-7,37
FC Sion,1914,9,6,7,19,38,56,-18,25
Young Boys,1915,1,22,7,3,70,32,38,73
FC Basel,1915,2,18,7,7,58,29,29,61
Lucerne,1915,3,14,7,11,44,44,0,49
St Gallen,1915,4,14,2,16,42,55,-13,44
FC Zürich,1915,5,10,10,12,38,35,3,40
FC Lugano,1915,6,11,6,15,30,44,-14,39
Grasshoppers,1915,7,9,7,16,40,51,-11,34
FC Thun,1915,8,9,6,17,45,63,-18,33
FC Sion,1915,9,7,8,17,42,56,-14,29
Young Boys,1916,1,22,6,4,77,36,41,72
FC Basel,1916,2,17,8,7,53,27,26,59
St Gallen,1916,3,17,2,13,45,52,-7,53
Lucerne,1916,4,12,8,12,40,44,-4,44
FC Zürich,1916,5,11,9,12,43,38,5,42
FC Lugano,1916,6,11,5,16,32,53,-21,38
Grasshoppers,1916,7,10,6,16,42,49,-7,36
FC Thun,1916,8,10,5,17,43,59,-16,35
FC Sion,1916,9,6,7,19,42,59,-17,25
Young Boys,1917,1,21,9,2,69,31,38,72
FC Basel,1917,2,17,9,6,51,24,27,60
Lucerne,1917,3,12,11,9,41,40,1,47
St Gallen,1917,4,14,3,15,41,59,-18,45
FC Zürich,1917,5,11,10,11,43,36,7,43
FC Lugano,1917,6,10,8,14,31,44,-13,38
Grasshoppers,1917,7,9,7,16,38,47,-9,34
FC Thun,1917,8,8,6,18,39,60,-21,30
FC Sion,1917,9,7,7,18,44,56,-12,28
Young Boys,1918,1,21,6,5,69,36,33,69
FC Basel,1918,2,16,10,6,54,28,26,58
Lucerne,1918,3,13,9,10,41,41,0,48
St Gallen,1918,4,14,4,14,45,55,-10,46
FC Zürich,1918,5,10,12,10,43,37,6,42
FC Lugano,1918,6,10,6,16,32,49,-17,36
Grasshoppers,1918,7,9,7,16,40,49,-9,34
FC Thun,1918,8,9,6,17,41,59,-18,33
FC Sion,1918,9,8,8,16,41,52,-11,32
Young Boys,1919,1,23,6,3,73,35,38,75
FC Basel,1919,2,19,7,6,57,25,32,64
St Gallen,1919,3,16,2,14,46,54,-8,50
FC Zürich,1919,4,12,9,11,44,37,7,45
Lucerne,1919,5,12,8,12,39,43,-4,44
FC Lugano,1919,6,10,6,16,31,47,-16,36
FC Thun,1919,7,9,6,17,46,61,-15,33
Grasshoppers,1919,8,8,7,17,38,54,-16,31
FC Sion,1919,9,5,9,18,41,59,-18,24
Young Boys,1920,1,21,6,5,72,38,34,69
FC Basel,1920,2,18,7,7,55,27,28,61
Lucerne,1920,3,14,7,11,40,43,-3,49
St Gallen,1920,4,15,2,15,46,61,-15,47
FC Zürich,1920,5,10,10,12,37,35,2,40
FC Lugano,1920,6,11,5,16,36,46,-10,38
Grasshoppers,1920,7,9,7,16,40,51,-11,34
FC Thun,1920,8,9,6,17,42,60,-18,33
FC Sion,1920,9,8,8,16,46,53,-7,32
Young Boys,1921,1,22,8,2,75,35,40,74
FC Basel,1921,2,16,10,6,53,27,26,58
St Gallen,1921,3,15,3,14,45,55,-10,48
Lucerne,1921,4,12,8,12,39,46,-7,44
FC Zürich,1921,5,11,10,11,45,39,6,43
FC Lugano,1921,6,10,6,16,34,51,-17,36
Grasshoppers,1921,7,8,8,16,39,49,-10,32
FC Thun,1921,8,8,8,16,41,59,-18,32
FC Sion,1921,9,6,11,15,41,51,-10,29
Young Boys,1922,1,21,9,2,70,33,37,72
FC Basel,1922,2,16,10,6,54,27,27,58
Lucerne,1922,3,14,8,10,42,41,1,50
FC Zürich,1922,4,11,10,11,43,38,5,43
St Gallen,1922,5,13,2,17,42,62,-20,41
FC Lugano,1922,6,10,7,15,32,47,-15,37
Grasshoppers,1922,7,9,7,16,43,51,-8,34
FC Thun,1922,8,9,6,17,44,61,-17,33
FC Sion,1922,9,8,7,17,44,54,-10,31
Young Boys,1923,1,19,8,5,71,42,29,65
FC Basel,1923,2,17,8,7,56,31,25,59
Lucerne,1923,3,15,8,9,47,43,4,53
St Gallen,1923,4,14,3,15,47,59,-12,45
FC Zürich,1923,5,11,9,12,40,35,5,42
Grasshoppers,1923,6,11,7,14,45,49,-4,40
FC Lugano,1923,7,10,6,16,33,50,-17,36
FC Thun,1923,8,9,6,17,43,57,-14,33
FC Sion,1923,9,6,9,17,39,55,-16,27
Young Boys,1924,1,22,6,4,71,35,36,72
FC Basel,1924,2,17,10,5,54,23,31,61
Lucerne,1924,3,13,7,12,42,47,-5,46
St Gallen,1924,4,14,3,15,41,55,-14,45
FC Zürich,1924,5,10,10,12,37,35,2,40
FC Lugano,1924,6,11,5,16,33,47,-14,38
FC Thun,1924,7,10,7,15,44,57,-13,37
Grasshoppers,1924,8,10,6,16,43,51,-8,36
FC Sion,1924,9,6,8,18,39,54,-15,26
Young Boys,1925,1,23,6,3,75,35,40,75
FC Basel,1925,2,17,7,8,54,27,27,58
Lucerne,1925,3,15,7,10,49,42,7,52
St Gallen,1925,4,13,3,16,41,58,-17,42
FC Zürich,1925,5,10,11,11,39,35,4,41
FC Thun,1925,6,10,6,16,44,59,-15,36
FC Lugano,1925,7,9,7,16,31,49,-18,34
Grasshoppers,1925,8,9,6,17,41,57,-16,33
FC Sion,1925,9,8,7,17,44,56,-12,31
Young Boys,1926,1,22,7,3,70,34,36,73
FC Basel,1926,2,17,7,8,56,30,26,58
Lucerne,1926,3,13,9,10,43,41,2,48
FC Zürich,1926,4,12,9,11,39,34,5,45
St Gallen,1926,5,14,3,15,41,57,-16,45
FC Lugano,1926,6,12,5,15,33,44,-11,41
Grasshoppers,1926,7,10,6,16,41,48,-7,36
FC Thun,1926,8,9,5,18,43,60,-17,32
FC Sion,1926,9,6,7,19,36,54,-18,25
Young Boys,1927,1,20,7,5,72,39,33,67
FC Basel,1927,2,17,8,7,54,27,27,59
Lucerne,1927,3,13,8,11,42,47,-5,47
St Gallen,1927,4,13,4,15,41,58,-17,43
FC Lugano,1927,5,12,6,14,38,48,-10,42
FC Zürich,1927,6,10,9,13,41,39,2,39
FC Thun,1927,7,11,5,16,48,57,-9,38
FC Sion,1927,8,9,7,16,45,53,-8,34
Grasshoppers,1927,9,9,6,17,40,53,-13,33
Young Boys,1928,1,23,6,3,74,32,42,75
FC Basel,1928,2,20,7,5,60,26,34,67
Lucerne,1928,3,12,9,11,42,44,-2,45
St Gallen,1928,4,14,3,15,44,56,-12,45
FC Zürich,1928,5,9,10,13,39,39,0,37
Grasshoppers,1928,6,9,8,15,39,46,-7,35
FC Thun,1928,7,9,7,16,42,61,-19,34
FC Lugano,1928,8,9,6,17,30,51,-21,33
FC Sion,1928,9,7,8,17,39,54,-15,29
Young Boys,1929,1,22,7,3,76,39,37,73
FC Basel,1929,2,17,8,7,52,25,27,59
St Gallen,1929,3,16,3,13,46,52,-6,51
FC Zürich,1929,4,11,11,10,41,34,7,44
Lucerne,1929,5,11,8,13,41,49,-8,41
FC Thun,1929,6,10,5,17,46,61,-15,35
FC Lugano,1929,7,9,8,15,33,50,-17,35
Grasshoppers,1929,8,9,7,16,44,52,-8,34
FC Sion,1929,9,7,7,18,43,60,-17,28
Young Boys,1930,1,23,6,3,79,37,42,75
FC Basel,1930,2,19,7,6,55,26,29,64
St Gallen,1930,3,16,2,14,48,56,-8,50
Lucerne,1930,4,13,8,11,42,42,0,47
FC Zürich,1930,5,9,12,11,36,33,3,39
FC Thun,1930,6,10,6,16,42,55,-13,36
FC Lugano,1930,7,9,7,16,31,51,-20,34
Grasshoppers,1930,8,9,6,17,38,54,-16,33
FC Sion,1930,9,5,8,19,40,57,-17,23
Young Boys,1931,1,22,6,4,72,34,38,72
FC Basel,1931,2,18,8,6,55,24,31,62
Lucerne,1931,3,12,8,12,42,49,-7,44
FC Zürich,1931,4,11,10,11,42,37,5,43
St Gallen,1931,5,13,4,15,42,57,-15,43
Grasshoppers,1931,6,10,6,16,43,49,-6,36
FC Lugano,1931,7,10,6,16,32,47,-15,36
FC Thun,1931,8,9,6,17,42,60,-18,33
FC Sion,1931,9,8,8,16,41,54,-13,32
Young Boys,1932,1,21,8,3,71,36,35,71
FC Basel,1932,2,19,8,5,55,24,31,65
St Gallen,1932,3,14,3,15,42,53,-11,45
FC Zürich,1932,4,11,10,11,43,36,7,43
Lucerne,1932,5,11,8,13,40,48,-8,41
Grasshoppers,1932,6,10,7,15,45,49,-4,37
FC Lugano,1932,7,10,6,16,30,49,-19,36
FC Thun,1932,8,9,6,17,43,59,-16,33
FC Sion,1932,9,7,8,17,42,57,-15,29
Young Boys,1933,1,21,6,5,70,36,34,69
FC Basel,1933,2,16,10,6,52,26,26,58
Lucerne,1933,3,12,9,11,40,46,-6,45
St Gallen,1933,4,14,3,15,43,54,-11,45
FC Zürich,1933,5,10,12,10,41,36,5,42
FC Lugano,1933,6,11,7,14,33,46,-13,40
FC Thun,1933,7,10,6,16,43,57,-14,36
Grasshoppers,1933,8,8,8,16,39,49,-10,32
FC Sion,1933,9,7,9,16,45,56,-11,30
Young Boys,1934,1,22,8,2,78,37,41,74
FC Basel,1934,2,17,10,5,54,26,28,61
St Gallen,1934,3,15,4,13,46,53,-7,49
Lucerne,1934,4,11,10,11,38,42,-4,43
FC Zürich,1934,5,10,12,10,40,35,5,42
FC Lugano,1934,6,9,7,16,29,49,-20,34
Grasshoppers,1934,7,8,8,16,39,52,-13,32
FC Thun,1934,8,9,5,18,44,64,-20,32
FC Sion,1934,9,6,10,16,45,55,-10,28
Young Boys,1935,1,21,7,4,70,37,33,70
FC Basel,1935,2,19,7,6,55,24,31,64
St Gallen,1935,3,16,2,14,46,52,-6,50
FC Zürich,1935,4,11,10,11,43,39,4,43
Lucerne,1935,5,11,9,12,43,48,-5,42
Grasshoppers,1935,6,10,8,14,44,50,-6,38
FC Thun,1935,7,9,7,16,44,60,-16,34
FC Lugano,1935,8,9,6,17,30,50,-20,33
FC Sion,1935,9,6,8,18,44,59,-15,26
Young Boys,1936,1,22,7,3,71,33,38,73
FC Basel,1936,2,18,9,5,53,23,30,63
St Gallen,1936,3,14,4,14,43,57,-14,46
Lucerne,1936,4,12,8,12,43,46,-3,44
FC Zürich,1936,5,10,12,10,39,33,6,42
FC Lugano,1936,6,9,8,15,29,46,-17,35
Grasshoppers,1936,7,9,7,16,42,52,-10,34
FC Thun,1936,8,9,7,16,46,61,-15,34
FC Sion,1936,9,6,8,18,40,55,-15,26
Young Boys,1937,1,22,7,3,79,38,41,73
FC Basel,1937,2,17,9,6,54,25,29,60
Lucerne,1937,3,13,9,10,42,47,-5,48
St Gallen,1937,4,13,5,14,40,52,-12,44
FC Zürich,1937,5,11,10,11,42,35,7,43
Grasshoppers,1937,6,8,9,15,42,52,-10,33
FC Lugano,1937,7,9,6,17,29,49,-20,33
FC Thun,1937,8,8,8,16,44,61,-17,32
FC Sion,1937,9,7,9,16,44,57,-13,30
Young Boys,1938,1,21,8,3,74,36,38,71
FC Basel,1938,2,16,8,8,52,30,22,56
Lucerne,1938,3,14,7,11,49,47,2,49
St Gallen,1938,4,15,3,14,45,55,-10,48
FC Zürich,1938,5,12,9,11,43,36,7,45
Grasshoppers,1938,6,9,8,15,41,53,-12,35
FC Thun,1938,7,9,7,16,43,57,-14,34
FC Lugano,1938,8,9,7,16,31,51,-20,34
FC Sion,1938,9,6,9,17,42,55,-13,27
Young Boys,1939,1,20,8,4,70,38,32,68
FC Basel,1939,2,18,9,5,58,23,35,63
Lucerne,1939,3,13,8,11,40,43,-3,47
FC Zürich,1939,4,12,10,10,44,35,9,46
St Gallen,1939,5,14,3,15,41,54,-13,45
Grasshoppers,1939,6,10,7,15,40,47,-7,37
FC Thun,1939,7,9,7,16,43,57,-14,34
FC Lugano,1939,8,9,6,17,28,49,-21,33
FC Sion,1939,9,6,8,18,41,59,-18,26
Young Boys,1940,1,20,7,5,70,40,30,67
FC Basel,1940,2,17,9,6,54,27,27,60
Lucerne,1940,3,14,9,9,46,41,5,51
FC Zürich,1940,4,11,11,10,39,33,6,44
St Gallen,1940,5,14,2,16,43,57,-14,44
FC Thun,1940,6,11,5,16,46,54,-8,38
FC Lugano,1940,7,10,7,15,32,47,-15,37
Grasshoppers,1940,8,10,6,16,42,54,-12,36
FC Sion,1940,9,5,8,19,37,56,-19,23
Young Boys,1941,1,20,9,3,69,35,34,69
FC Basel,1941,2,18,9,5,53,24,29,63
Lucerne,1941,3,12,11,9,41,41,0,47
St Gallen,1941,4,13,5,14,44,59,-15,44
FC Zürich,1941,5,10,11,11,41,37,4,41
Grasshoppers,1941,6,10,7,15,42,49,-7,37
FC Lugano,1941,7,9,8,15,33,49,-16,35
FC Sion,1941,8,7,9,16,47,56,-9,30
FC Thun,1941,9,8,5,19,42,62,-20,29
Young Boys,1942,1,22,7,3,75,37,38,73
FC Basel,1942,2,18,8,6,54,27,27,62
Lucerne,1942,3,14,8,10,45,44,1,50
St Gallen,1942,4,13,5,14,44,59,-15,44
FC Zürich,1942,5,11,9,12,48,38,10,42
FC Thun,1942,6,10,6,16,45,58,-13,36
FC Lugano,1942,7,9,7,16,33,54,-21,34
Grasshoppers,1942,8,8,8,16,45,56,-11,32
FC Sion,1942,9,6,8,18,43,59,-16,26
Young Boys,1943,1,21,7,4,72,39,33,70
FC Basel,1943,2,19,7,6,59,27,32,64
Lucerne,1943,3,13,9,10,42,43,-1,48
St Gallen,1943,4,14,3,15,42,55,-13,45
FC Zürich,1943,5,10,9,13,41,39,2,39
FC Thun,1943,6,11,5,16,45,55,-10,38
FC Lugano,1943,7,10,5,17,29,49,-20,35
Grasshoppers,1943,8,9,7,16,42,49,-7,34
FC Sion,1943,9,7,8,17,41,57,-16,29
Young Boys,1944,1,23,6,3,73,34,39,75
FC Basel,1944,2,19,7,6,60,28,32,64
St Gallen,1944,3,14,3,15,45,57,-12,45
Lucerne,1944,4,12,7,13,39,46,-7,43
FC Zürich,1944,5,10,11,11,42,37,5,41
FC Thun,1944,6,11,5,16,45,59,-14,38
FC Lugano,1944,7,10,6,16,30,46,-16,36
Grasshoppers,1944,8,9,6,17,37,48,-11,33
FC Sion,1944,9,6,9,17,39,55,-16,27
Young Boys,1945,1,23,6,3,77,35,42,75
FC Basel,1945,2,19,8,5,55,25,30,65
Lucerne,1945,3,13,7,12,46,47,-1,46
St Gallen,1945,4,14,3,15,44,54,-10,45
FC Lugano,1945,5,12,5,15,33,46,-13,41
FC Zürich,1945,6,10,10,12,40,36,4,40
Grasshoppers,1945,7,10,6,16,39,50,-11,36
FC Thun,1945,8,8,5,19,39,62,-23,29
FC Sion,1945,9,6,8,18,38,56,-18,26
Young Boys,1946,1,20,7,5,72,39,33,67
FC Basel,1946,2,17,9,6,59,28,31,60
St Gallen,1946,3,14,4,14,41,52,-11,46
FC Zürich,1946,4,12,9,11,42,35,7,45
Lucerne,1946,5,12,9,11,38,44,-6,45
FC Lugano,1946,6,11,6,15,32,45,-13,39
Grasshoppers,1946,7,10,7,15,41,48,-7,37
FC Thun,1946,8,9,5,18,41,61,-20,32
FC Sion,1946,9,7,8,17,40,54,-14,29
Young Boys,1947,1,21,9,2,71,34,37,72
FC Basel,1947,2,17,9,6,53,26,27,60
FC Zürich,1947,3,11,11,10,42,36,6,44
Lucerne,1947,4,11,10,11,41,45,-4,43
St Gallen,1947,5,13,3,16,42,56,-14,42
FC Lugano,1947,6,10,7,15,30,46,-16,37
Grasshoppers,1947,7,9,8,15,42,50,-8,35
FC Thun,1947,8,9,7,16,42,57,-15,34
FC Sion,1947,9,7,8,17,40,53,-13,29
Young Boys,1948,1,20,8,4,73,39,34,68
FC Basel,1948,2,17,9,6,54,26,28,60
Lucerne,1948,3,12,9,11,41,45,-4,45
St Gallen,1948,4,14,2,16,43,59,-16,44
FC Zürich,1948,5,11,9,12,40,36,4,42
FC Lugano,1948,6,11,6,15,32,49,-17,39
FC Sion,1948,7,9,7,16,46,51,-5,34
Grasshoppers,1948,8,9,7,16,40,49,-9,34
FC Thun,1948,9,9,7,16,40,55,-15,34
Young Boys,1949,1,22,7,3,75,37,38,73
FC Basel,1949,2,17,9,6,53,26,27,60
St Gallen,1949,3,14,3,15,42,54,-12,45
FC Zürich,1949,4,11,11,10,39,33,6,44
Lucerne,1949,5,12,8,12,39,44,-5,44
FC Thun,1949,6,10,6,16,43,55,-12,36
FC Lugano,1949,7,10,5,17,31,49,-18,35
Grasshoppers,1949,8,9,7,16,38,50,-12,34
FC Sion,1949,9,7,8,17,39,51,-12,29
Young Boys,1950,1,23,7,2,78,37,41,76
FC Basel,1950,2,17,9,6,57,28,29,60
St Gallen,1950,3,14,3,15,44,57,-13,45
Lucerne,1950,4,12,8,12,46,48,-2,44
FC Zürich,1950,5,10,11,11,41,37,4,41
Grasshoppers,1950,6,10,7,15,42,49,-7,37
FC Thun,1950,7,10,6,16,43,60,-17,36
FC Lugano,1950,8,9,6,17,30,53,-23,33
FC Sion,1950,9,6,9,17,46,58,-12,27
Young Boys,1951,1,21,8,3,68,33,35,71
FC Basel,1951,2,17,9,6,55,27,28,60
St Gallen,1951,3,15,4,13,44,52,-8,49
Lucerne,1951,4,13,8,11,41,42,-1,47
FC Zürich,1951,5,11,10,11,41,36,5,43
FC Lugano,1951,6,10,6,16,29,45,-16,36
Grasshoppers,1951,7,9,8,15,39,49,-10,35
FC Thun,1951,8,9,5,18,40,58,-18,32
FC Sion,1951,9,5,10,17,35,50,-15,25
Young Boys,1952,1,22,8,2,72,33,39,74
FC Basel,1952,2,17,8,7,53,27,26,59
Lucerne,1952,3,14,7,11,47,43,4,49
St Gallen,1952,4,14,3,15,44,55,-11,45
FC Zürich,1952,5,10,10,12,39,37,2,40
FC Thun,1952,6,11,5,16,45,58,-13,38
FC Lugano,1952,7,10,6,16,28,44,-16,36
Grasshoppers,1952,8,9,7,16,41,56,-15,34
FC Sion,1952,9,6,8,18,42,58,-16,26
Young Boys,1953,1,21,8,3,70,33,37,71
FC Basel,1953,2,17,8,7,54,30,24,59
St Gallen,1953,3,16,2,14,47,52,-5,50
Lucerne,1953,4,12,7,13,40,48,-8,43
FC Lugano,1953,5,12,6,14,34,44,-10,42
FC Zürich,1953,6,10,10,12,41,40,1,40
FC Thun,1953,7,10,6,16,45,58,-13,36
Grasshoppers,1953,8,9,7,16,42,53,-11,34
FC Sion,1953,9,6,8,18,39,54,-15,26
Young Boys,1954,1,23,6,3,77,32,45,75
FC Basel,1954,2,19,7,6,65,31,34,64
Lucerne,1954,3,13,8,11,42,46,-4,47
FC Zürich,1954,4,12,10,10,46,39,7,46
St Gallen,1954,5,14,3,15,43,57,-14,45
FC Lugano,1954,6,10,5,17,31,51,-20,35
FC Thun,1954,7,9,7,16,43,61,-18,34
Grasshoppers,1954,8,8,6,18,38,54,-16,30
FC Sion,1954,9,6,8,18,42,56,-14,26
Young Boys,1955,1,21,8,3,70,35,35,71
FC Basel,1955,2,18,9,5,61,25,36,63
Lucerne,1955,3,12,8,12,40,49,-9,44
St Gallen,1955,4,13,4,15,40,58,-18,43
FC Zürich,1955,5,10,12,10,45,40,5,42
Grasshoppers,1955,6,10,8,14,41,46,-5,38
FC Lugano,1955,7,10,6,16,34,49,-15,36
FC Thun,1955,8,8,6,18,44,63,-19,30
FC Sion,1955,9,6,11,15,44,54,-10,29
Young Boys,1956,1,21,8,3,72,36,36,71
FC Basel,1956,2,19,8,5,55,24,31,65
St Gallen,1956,3,15,3,14,42,53,-11,48
Lucerne,1956,4,11,7,14,38,45,-7,40
FC Zürich,1956,5,9,11,12,40,39,1,38
FC Lugano,1956,6,11,5,16,31,47,-16,38
Grasshoppers,1956,7,10,7,15,42,49,-7,37
FC Thun,1956,8,9,7,16,44,59,-15,34
FC Sion,1956,9,6,10,16,44,56,-12,28
Young Boys,1957,1,21,6,5,69,34,35,69
FC Basel,1957,2,17,9,6,52,28,24,60
Lucerne,1957,3,14,8,10,46,40,6,50
St Gallen,1957,4,13,4,15,41,56,-15,43
FC Zürich,1957,5,10,11,11,39,35,4,41
FC Lugano,1957,6,10,7,15,29,44,-15,37
FC Sion,1957,7,9,7,16,46,53,-7,34
Grasshoppers,1957,8,9,6,17,39,54,-15,33
FC Thun,1957,9,9,6,17,42,59,-17,33
Young Boys,1958,1,22,7,3,70,32,38,73
FC Basel,1958,2,17,10,5,51,23,28,61
St Gallen,1958,3,15,3,14,44,53,-9,48
Lucerne,1958,4,12,9,11,39,42,-3,45
FC Zürich,1958,5,10,10,12,39,36,3,40
FC Thun,1958,6,11,6,15,46,56,-10,39
FC Lugano,1958,7,9,8,15,28,45,-17,35
Grasshoppers,1958,8,8,6,18,39,53,-14,30
FC Sion,1958,9,7,7,18,38,54,-16,28
Young Boys,1959,1,22,6,4,74,38,36,72
FC Basel,1959,2,18,8,6,59,27,32,62
St Gallen,1959,3,15,3,14,42,53,-11,48
Lucerne,1959,4,11,10,11,39,43,-4,43
FC Zürich,1959,5,10,10,12,41,40,1,40
Grasshoppers,1959,6,10,7,15,47,50,-3,37
FC Thun,1959,7,10,5,17,45,60,-15,35
FC Lugano,1959,8,9,7,16,27,46,-19,34
FC Sion,1959,9,7,8,17,41,58,-17,29
Young Boys,1960,1,22,6,4,74,35,39,72
FC Basel,1960,2,19,7,6,55,25,30,64
St Gallen,1960,3,16,3,13,46,52,-6,51
Lucerne,1960,4,12,9,11,40,43,-3,45
FC Thun,1960,5,11,5,16,47,55,-8,38
FC Zürich,1960,6,9,10,13,36,38,-2,37
FC Lugano,1960,7,10,6,16,31,49,-18,36
Grasshoppers,1960,8,9,6,17,39,50,-11,33
FC Sion,1960,9,6,8,18,39,60,-21,26
Young Boys,1961,1,19,10,3,70,37,33,67
FC Basel,1961,2,18,7,7,51,24,27,61
St Gallen,1961,3,16,2,14,44,53,-9,50
FC Zürich,1961,4,12,9,11,40,33,7,45
Lucerne,1961,5,12,8,12,42,44,-2,44
Grasshoppers,1961,6,11,7,14,48,49,-1,40
FC Lugano,1961,7,11,6,15,31,46,-15,39
FC Thun,1961,8,8,5,19,40,63,-23,29
FC Sion,1961,9,6,8,18,40,57,-17,26
Young Boys,1962,1,21,9,2,71,35,36,72
FC Basel,1962,2,17,9,6,55,23,32,60
St Gallen,1962,3,15,3,14,44,54,-10,48
Lucerne,1962,4,12,8,12,38,46,-8,44
FC Zürich,1962,5,9,11,12,37,35,2,38
FC Thun,1962,6,10,6,16,45,59,-14,36
Grasshoppers,1962,7,9,8,15,39,47,-8,35
FC Lugano,1962,8,9,8,15,32,48,-16,35
FC Sion,1962,9,7,8,17,43,57,-14,29
Young Boys,1963,1,21,7,4,69,36,33,70
FC Basel,1963,2,16,8,8,52,27,25,56
Lucerne,1963,3,14,9,9,43,41,2,51
St Gallen,1963,4,15,2,15,45,55,-10,47
FC Zürich,1963,5,11,9,12,42,40,2,42
FC Lugano,1963,6,10,6,16,34,48,-14,36
FC Thun,1963,7,10,6,16,41,56,-15,36
FC Sion,1963,8,8,8,16,42,54,-12,32
Grasshoppers,1963,9,8,7,17,38,49,-11,31
Young Boys,1964,1,22,7,3,74,34,40,73
FC Basel,1964,2,17,8,7,54,26,28,59
FC Zürich,1964,3,13,9,10,42,33,9,48
Lucerne,1964,4,13,9,10,49,45,4,48
St Gallen,1964,5,15,3,14,47,55,-8,48
FC Thun,1964,6,10,5,17,43,60,-17,35
Grasshoppers,1964,7,9,6,17,37,49,-12,33
FC Lugano,1964,8,9,6,17,28,54,-26,33
FC Sion,1964,9,6,7,19,41,59,-18,25
Young Boys,1965,1,22,7,3,74,37,37,73
FC Basel,1965,2,17,9,6,52,24,28,60
St Gallen,1965,3,15,3,14,45,51,-6,48
Lucerne,1965,4,13,8,11,41,45,-4,47
FC Zürich,1965,5,11,11,10,42,36,6,44
FC Thun,1965,6,10,5,17,44,59,-15,35
FC Lugano,1965,7,10,5,17,33,52,-19,35
Grasshoppers,1965,8,8,7,17,38,53,-15,31
FC Sion,1965,9,6,9,17,41,53,-12,27
Young Boys,1966,1,23,7,2,73,31,42,76
FC Basel,1966,2,17,9,6,52,25,27,60
Lucerne,1966,3,14,7,11,43,41,2,49
FC Zürich,1966,4,12,9,11,44,39,5,45
St Gallen,1966,5,14,3,15,41,53,-12,45
FC Thun,1966,6,10,5,17,46,59,-13,35
Grasshoppers,1966,7,9,6,17,41,52,-11,33
FC Lugano,1966,8,9,5,18,30,52,-22,32
FC Sion,1966,9,7,7,18,41,59,-18,28
Young Boys,1967,1,21,8,3,74,36,38,71
FC Basel,1967,2,16,8,8,50,25,25,56
Lucerne,1967,3,13,8,11,46,49,-3,47
St Gallen,1967,4,15,2,15,43,54,-11,47
FC Zürich,1967,5,11,11,10,40,34,6,44
FC Lugano,1967,6,10,7,15,31,47,-16,37
Grasshoppers,1967,7,9,7,16,44,55,-11,34
FC Thun,1967,8,9,7,16,44,59,-15,34
FC Sion,1967,9,7,8,17,43,56,-13,29
Young Boys,1968,1,22,7,3,76,39,37,73
FC Basel,1968,2,18,9,5,51,23,28,63
St Gallen,1968,3,13,6,13,40,51,-11,45
Lucerne,1968,4,12,8,12,41,43,-2,44
FC Zürich,1968,5,11,10,11,40,35,5,43
Grasshoppers,1968,6,10,6,16,40,50,-10,36
FC Lugano,1968,7,9,6,17,31,50,-19,33
FC Thun,1968,8,9,5,18,41,58,-17,32
FC Sion,1968,9,7,9,16,43,54,-11,30
Young Boys,1969,1,21,6,5,74,43,31,69
FC Basel,1969,2,19,7,6,53,23,30,64
FC Zürich,1969,3,13,9,10,45,36,9,48
St Gallen,1969,4,15,2,15,43,53,-10,47
Lucerne,1969,5,12,8,12,42,45,-3,44
FC Lugano,1969,6,11,6,15,32,46,-14,39
Grasshoppers,1969,7,10,7,15,46,51,-5,37
FC Thun,1969,8,9,6,17,46,60,-14,33
FC Sion,1969,9,5,7,20,37,61,-24,22
Young Boys,1970,1,21,7,4,70,35,35,70
FC Basel,1970,2,18,7,7,55,28,27,61
Lucerne,1970,3,15,7,10,44,40,4,52
St Gallen,1970,4,14,3,15,42,54,-12,45
FC Thun,1970,5,11,6,15,46,58,-12,39
FC Zürich,1970,6,9,11,12,39,38,1,38
FC Lugano,1970,7,10,6,16,31,47,-16,36
FC Sion,1970,8,7,9,16,41,53,-12,30
Grasshoppers,1970,9,8,6,18,38,53,-15,30
Young Boys,1971,1,22,7,3,72,33,39,73
FC Basel,1971,2,17,8,7,52,27,25,59
Lucerne,1971,3,15,7,10,43,41,2,52
St Gallen,1971,4,13,4,15,43,56,-13,43
FC Zürich,1971,5,10,11,11,43,39,4,41
FC Thun,1971,6,11,5,16,44,56,-12,38
FC Lugano,1971,7,9,7,16,30,51,-21,34
Grasshoppers,1971,8,9,6,17,37,47,-10,33
FC Sion,1971,9,6,9,17,41,55,-14,27
Young Boys,1972,1,21,6,5,74,34,40,69
FC Basel,1972,2,17,7,8,51,26,25,58
Lucerne,1972,3,14,8,10,42,41,1,50
St Gallen,1972,4,14,5,13,41,51,-10,47
FC Zürich,1972,5,12,10,10,44,33,11,46
Grasshoppers,1972,6,10,7,15,40,47,-7,37
FC Thun,1972,7,10,6,16,43,58,-15,36
FC Lugano,1972,8,9,7,16,29,52,-23,34
FC Sion,1972,9,5,8,19,37,59,-22,23
Young Boys,1973,1,20,9,3,69,34,35,69
FC Basel,1973,2,19,8,5,55,26,29,65
Lucerne,1973,3,13,9,10,40,39,1,48
FC Zürich,1973,4,12,9,11,47,34,13,45
St Gallen,1973,5,14,2,16,43,56,-13,44
Grasshoppers,1973,6,10,6,16,44,51,-7,36
FC Lugano,1973,7,10,6,16,31,49,-18,36
FC Thun,1973,8,9,6,17,44,63,-19,33
FC Sion,1973,9,5,9,18,39,60,-21,24
Young Boys,1974,1,23,6,3,76,35,41,75
FC Basel,1974,2,17,8,7,57,29,28,59
Lucerne,1974,3,13,7,12,44,45,-1,46
St Gallen,1974,4,14,4,14,43,54,-11,46
FC Zürich,1974,5,11,10,11,43,37,6,43
FC Lugano,1974,6,10,6,16,30,50,-20,36
FC Thun,1974,7,10,5,17,45,60,-15,35
Grasshoppers,1974,8,9,7,16,41,52,-11,34
FC Sion,1974,9,6,9,17,41,58,-17,27
Young Boys,1975,1,20,9,3,68,35,33,69
FC Basel,1975,2,18,9,5,55,25,30,63
Lucerne,1975,3,14,8,10,48,44,4,50
St Gallen,1975,4,13,3,16,41,56,-15,42
FC Zürich,1975,5,10,11,11,42,39,3,41
FC Thun,1975,6,10,7,15,47,57,-10,37
FC Lugano,1975,7,10,7,15,32,47,-15,37
Grasshoppers,1975,8,9,7,16,41,54,-13,34
FC Sion,1975,9,5,9,18,40,57,-17,24
Young Boys,1976,1,23,6,3,77,37,40,75
FC Basel,1976,2,19,8,5,61,26,35,65
St Gallen,1976,3,15,2,15,45,57,-12,47
Lucerne,1976,4,13,7,12,44,46,-2,46
FC Zürich,1976,5,10,12,10,43,36,7,42
FC Lugano,1976,6,9,6,17,29,52,-23,33
Grasshoppers,1976,7,8,8,16,39,50,-11,32
FC Thun,1976,8,8,7,17,42,61,-19,31
FC Sion,1976,9,7,8,17,41,56,-15,29
Young Boys,1977,1,21,9,2,78,37,41,72
FC Basel,1977,2,17,9,6,53,26,27,60
Lucerne,1977,3,13,9,10,43,43,0,48
FC Zürich,1977,4,12,9,11,42,35,7,45
St Gallen,1977,5,13,3,16,39,58,-19,42
Grasshoppers,1977,6,9,8,15,42,51,-9,35
FC Thun,1977,7,10,5,17,44,56,-12,35
FC Lugano,1977,8,9,8,15,31,48,-17,35
FC Sion,1977,9,6,8,18,42,60,-18,26
Young Boys,1978,1,23,6,3,76,33,43,75
FC Basel,1978,2,17,9,6,54,29,25,60
St Gallen,1978,3,16,3,13,44,50,-6,51
FC Zürich,1978,4,11,11,10,43,35,8,44
Lucerne,1978,5,12,7,13,40,46,-6,43
FC Thun,1978,6,10,7,15,49,59,-10,37
FC Lugano,1978,7,10,5,17,30,52,-22,35
Grasshoppers,1978,8,8,8,16,39,50,-11,32
FC Sion,1978,9,5,8,19,36,57,-21,23
Young Boys,1979,1,22,7,3,73,34,39,73
FC Basel,1979,2,17,10,5,53,26,27,61
Lucerne,1979,3,13,7,12,42,43,-1,46
St Gallen,1979,4,14,3,15,41,53,-12,45
FC Zürich,1979,5,10,11,11,40,36,4,41
FC Lugano,1979,6,11,5,16,30,46,-16,38
FC Thun,1979,7,9,6,17,42,59,-17,33
FC Sion,1979,8,8,8,16,40,50,-10,32
Grasshoppers,1979,9,8,7,17,36,50,-14,31
Young Boys,1980,1,19,8,5,66,35,31,65
FC Basel,1980,2,17,10,5,54,26,28,61
St Gallen,1980,3,15,3,14,44,55,-11,48
Lucerne,1980,4,12,10,10,42,44,-2,46
Grasshoppers,1980,5,11,6,15,42,46,-4,39
FC Zürich,1980,6,9,11,12,40,39,1,38
FC Lugano,1980,7,9,8,15,33,50,-17,35
FC Thun,1980,8,9,7,16,44,58,-14,34
FC Sion,1980,9,8,7,17,39,51,-12,31
Young Boys,1981,1,22,7,3,80,39,41,73
FC Basel,1981,2,17,9,6,60,31,29,60
Lucerne,1981,3,13,8,11,41,46,-5,47
St Gallen,1981,4,14,3,15,46,57,-11,45
FC Zürich,1981,5,10,11,11,41,37,4,41
FC Lugano,1981,6,10,6,16,30,49,-19,36
FC Sion,1981,7,9,7,16,50,58,-8,34
FC Thun,1981,8,9,6,17,41,58,-17,33
Grasshoppers,1981,9,8,7,17,41,55,-14,31
Young Boys,1982,1,21,7,4,68,35,33,70
FC Basel,1982,2,18,8,6,55,26,29,62
St Gallen,1982,3,16,2,14,47,52,-5,50
Lucerne,1982,4,12,9,11,40,44,-4,45
FC Zürich,1982,5,10,9,13,39,38,1,39
FC Thun,1982,6,11,5,16,44,57,-13,38
FC Lugano,1982,7,10,5,17,30,47,-17,35
Grasshoppers,1982,8,9,7,16,38,49,-11,34
FC Sion,1982,9,7,8,17,37,50,-13,29
Young Boys,1983,1,22,7,3,72,35,37,73
FC Basel,1983,2,19,7,6,56,26,30,64
Lucerne,1983,3,14,8,10,44,43,1,50
St Gallen,1983,4,14,2,16,43,57,-14,44
FC Lugano,1983,5,12,5,15,35,47,-12,41
FC Zürich,1983,6,10,9,13,40,39,1,39
FC Thun,1983,7,11,5,16,50,57,-7,38
Grasshoppers,1983,8,9,6,17,39,51,-12,33
FC Sion,1983,9,5,7,20,37,61,-24,22
Young Boys,1984,1,22,8,2,70,32,38,74
FC Basel,1984,2,18,8,6,54,24,30,62
St Gallen,1984,3,16,2,14,43,52,-9,50
Lucerne,1984,4,12,9,11,41,43,-2,45
FC Zürich,1984,5,11,9,12,40,36,4,42
Grasshoppers,1984,6,9,8,15,40,51,-11,35
FC Thun,1984,7,10,5,17,43,60,-17,35
FC Lugano,1984,8,9,6,17,27,45,-18,33
FC Sion,1984,9,6,7,19,40,55,-15,25
Young Boys,1985,1,21,8,3,71,34,37,71
FC Basel,1985,2,17,8,7,54,27,27,59
Lucerne,1985,3,13,9,10,41,42,-1,48
St Gallen,1985,4,15,2,15,43,53,-10,47
FC Zürich,1985,5,11,10,11,42,37,5,43
FC Thun,1985,6,10,6,16,44,57,-13,36
FC Lugano,1985,7,10,6,16,29,47,-18,36
Grasshoppers,1985,8,9,7,16,39,47,-8,34
FC Sion,1985,9,6,8,18,39,58,-19,26
Young Boys,1986,1,21,7,4,68,34,34,70
FC Basel,1986,2,19,8,5,58,26,32,65
St Gallen,1986,3,15,3,14,46,54,-8,48
Lucerne,1986,4,12,7,13,40,48,-8,43
FC Zürich,1986,5,10,10,12,39,35,4,40
FC Lugano,1986,6,11,5,16,32,48,-16,38
Grasshoppers,1986,7,9,8,15,43,51,-8,35
FC Thun,1986,8,9,7,16,42,57,-15,34
FC Sion,1986,9,7,7,18,39,54,-15,28
Young Boys,1987,1,21,6,5,71,36,35,69
FC Basel,1987,2,18,9,5,56,28,28,63
St Gallen,1987,3,15,3,14,43,53,-10,48
Lucerne,1987,4,12,9,11,44,47,-3,45
FC Zürich,1987,5,11,10,11,42,36,6,43
FC Thun,1987,6,11,5,16,47,57,-10,38
FC Lugano,1987,7,10,7,15,33,48,-15,37
Grasshoppers,1987,8,9,6,17,41,55,-14,33
FC Sion,1987,9,6,7,19,38,55,-17,25
Young Boys,1988,1,22,7,3,73,37,36,73
FC Basel,1988,2,18,7,7,56,28,28,61
St Gallen,1988,3,15,2,15,43,56,-13,47
Lucerne,1988,4,12,8,12,41,45,-4,44
FC Zürich,1988,5,11,10,11,43,38,5,43
FC Lugano,1988,6,11,7,14,36,47,-11,40
Grasshoppers,1988,7,8,8,16,40,51,-11,32
FC Thun,1988,8,8,7,17,46,64,-18,31
FC Sion,1988,9,6,10,16,43,55,-12,28
Young Boys,1989,1,23,6,3,75,33,42,75
FC Basel,1989,2,19,7,6,59,26,33,64
Lucerne,1989,3,13,8,11,40,42,-2,47
FC Zürich,1989,4,12,10,10,42,33,9,46
St Gallen,1989,5,14,3,15,47,61,-14,45
Grasshoppers,1989,6,10,6,16,40,48,-8,36
FC Lugano,1989,7,9,6,17,29,50,-21,33
FC Thun,1989,8,9,5,18,40,60,-20,32
FC Sion,1989,9,6,7,19,40,59,-19,25
Young Boys,1990,1,22,7,3,75,37,38,73
FC Basel,1990,2,16,11,5,55,29,26,59
St Gallen,1990,3,15,3,14,46,55,-9,48
FC Zürich,1990,4,11,11,10,44,38,6,44
Lucerne,1990,5,12,8,12,40,44,-4,44
Grasshoppers,1990,6,10,7,15,43,50,-7,37
FC Thun,1990,7,10,7,15,47,60,-13,37
FC Lugano,1990,8,9,5,18,30,52,-22,32
FC Sion,1990,9,6,7,19,43,58,-15,25
Young Boys,1991,1,23,6,3,74,35,39,75
FC Basel,1991,2,17,8,7,56,28,28,59
Lucerne,1991,3,14,7,11,43,44,-1,49
St Gallen,1991,4,14,3,15,43,56,-13,45
FC Zürich,1991,5,11,10,11,41,36,5,43
FC Lugano,1991,6,11,5,16,31,49,-18,38
Grasshoppers,1991,7,9,6,17,40,51,-11,33
FC Thun,1991,8,9,6,17,44,61,-17,33
FC Sion,1991,9,6,9,17,40,52,-12,27
Young Boys,1992,1,21,8,3,74,37,37,71
FC Basel,1992,2,16,10,6,52,27,25,58
St Gallen,1992,3,15,4,13,48,54,-6,49
Lucerne,1992,4,13,8,11,41,47,-6,47
FC Zürich,1992,5,10,11,11,42,37,5,41
Grasshoppers,1992,6,10,7,15,43,48,-5,37
FC Thun,1992,7,10,6,16,44,58,-14,36
FC Lugano,1992,8,10,5,17,32,50,-18,35
FC Sion,1992,9,5,9,18,40,58,-18,24
Young Boys,1993,1,22,6,4,79,41,38,72
FC Basel,1993,2,19,7,6,61,30,31,64
St Gallen,1993,3,16,2,14,47,53,-6,50
FC Zürich,1993,4,12,9,11,42,36,6,45
Lucerne,1993,5,11,8,13,43,50,-7,41
Grasshoppers,1993,6,10,7,15,42,49,-7,37
FC Lugano,1993,7,10,5,17,31,51,-20,35
FC Thun,1993,8,8,6,18,39,59,-20,30
FC Sion,1993,9,7,8,17,40,55,-15,29
Young Boys,1994,1,21,7,4,70,34,36,70
FC Basel,1994,2,18,9,5,60,28,32,63
Lucerne,1994,3,14,8,10,46,42,4,50
St Gallen,1994,4,14,5,13,47,57,-10,47
FC Zürich,1994,5,10,11,11,44,41,3,41
Grasshoppers,1994,6,10,7,15,44,53,-9,37
FC Lugano,1994,7,10,6,16,35,49,-14,36
FC Thun,1994,8,9,6,17,43,62,-19,33
FC Sion,1994,9,5,7,20,39,62,-23,22
Young Boys,1995,1,21,7,4,70,36,34,70
FC Basel,1995,2,18,7,7,53,25,28,61
Lucerne,1995,3,13,9,10,42,43,-1,48
St Gallen,1995,4,14,5,13,45,54,-9,47
FC Zürich,1995,5,10,11,11,39,36,3,41
FC Lugano,1995,6,9,8,15,30,46,-16,35
Grasshoppers,1995,7,9,6,17,41,53,-12,33
FC Thun,1995,8,9,6,17,43,59,-16,33
FC Sion,1995,9,7,9,16,43,54,-11,30
Young Boys,1996,1,22,6,4,73,36,37,72
FC Basel,1996,2,17,7,8,55,31,24,58
St Gallen,1996,3,15,4,13,44,52,-8,49
FC Zürich,1996,4,12,9,11,45,36,9,45
Lucerne,1996,5,12,9,11,42,46,-4,45
Grasshoppers,1996,6,10,7,15,44,48,-4,37
FC Thun,1996,7,10,6,16,45,58,-13,36
FC Lugano,1996,8,9,6,17,29,54,-25,33
FC Sion,1996,9,6,8,18,40,56,-16,26
Young Boys,1997,1,21,7,4,70,39,31,70
FC Basel,1997,2,18,8,6,55,24,31,62
Lucerne,1997,3,13,8,11,49,45,4,47
St Gallen,1997,4,15,2,15,46,53,-7,47
FC Zürich,1997,5,11,11,10,42,33,9,44
Grasshoppers,1997,6,10,6,16,42,51,-9,36
FC Lugano,1997,7,10,5,17,32,55,-23,35
FC Thun,1997,8,9,7,16,43,59,-16,34
FC Sion,1997,9,5,10,17,39,59,-20,25
Young Boys,1998,1,21,6,5,67,36,31,69
FC Basel,1998,2,18,9,5,54,22,32,63
Lucerne,1998,3,12,9,11,41,42,-1,45
St Gallen,1998,4,13,3,16,39,57,-18,42
FC Lugano,1998,5,12,5,15,37,48,-11,41
FC Zürich,1998,6,9,10,13,40,42,-2,37
Grasshoppers,1998,7,10,7,15,44,50,-6,37
FC Thun,1998,8,9,7,16,42,57,-15,34
FC Sion,1998,9,8,8,16,42,52,-10,32
Young Boys,1999,1,22,8,2,78,37,41,74
FC Basel,1999,2,17,10,5,56,28,28,61
St Gallen,1999,3,16,3,13,46,52,-6,51
Lucerne,1999,4,12,8,12,44,50,-6,44
FC Zürich,1999,5,10,12,10,43,36,7,42
Grasshoppers,1999,6,9,7,16,39,50,-11,34
FC Thun,1999,7,9,7,16,45,59,-14,34
FC Lugano,1999,8,9,7,16,30,49,-19,34
FC Sion,1999,9,5,8,19,39,59,-20,23
Young Boys,2000,1,23,6,3,78,35,43,75
FC Basel,2000,2,18,7,7,59,28,31,61
FC Zürich,2000,3,13,9,10,49,39,10,48
Lucerne,2000,4,13,7,12,44,49,-5,46
St Gallen,2000,5,14,3,15,42,54,-12,45
FC Lugano,2000,6,10,6,16,32,53,-21,36
FC Thun,2000,7,9,6,17,44,61,-17,33
Grasshoppers,2000,8,8,8,16,40,52,-12,32
FC Sion,2000,9,6,8,18,38,55,-17,26
Young Boys,2001,1,21,7,4,71,33,38,70
FC Basel,2001,2,18,7,7,54,29,25,61
Lucerne,2001,3,12,8,12,41,46,-5,44
St Gallen,2001,4,13,4,15,39,53,-14,43
FC Thun,2001,5,12,5,15,48,55,-7,41
FC Zürich,2001,6,10,9,13,43,41,2,39
FC Lugano,2001,7,11,5,16,34,53,-19,38
Grasshoppers,2001,8,9,7,16,39,49,-10,34
FC Sion,2001,9,8,8,16,40,50,-10,32
Young Boys,2002,1,21,7,4,71,38,33,70
FC Basel,2002,2,20,7,5,61,23,38,67
St Gallen,2002,3,15,2,15,45,56,-11,47
Lucerne,2002,4,12,8,12,43,51,-8,44
FC Zürich,2002,5,10,10,12,42,40,2,40
FC Lugano,2002,6,11,6,15,34,47,-13,39
Grasshoppers,2002,7,9,8,15,43,50,-7,35
FC Thun,2002,8,8,7,17,45,66,-21,31
FC Sion,2002,9,6,9,17,39,52,-13,27
Young Boys,2003,1,21,7,4,71,37,34,70
FC Basel,2003,2,17,8,7,51,27,24,59
Lucerne,2003,3,13,8,11,41,41,0,47
St Gallen,2003,4,13,5,14,41,53,-12,44
FC Zürich,2003,5,11,9,12,40,35,5,42
FC Thun,2003,6,11,5,16,44,56,-12,38
Grasshoppers,2003,7,9,7,16,42,50,-8,34
FC Lugano,2003,8,9,7,16,30,49,-19,34
FC Sion,2003,9,8,8,16,40,52,-12,32
Young Boys,2004,1,21,8,3,75,37,38,71
FC Basel,2004,2,19,7,6,54,25,29,64
St Gallen,2004,3,14,3,15,43,56,-13,45
Lucerne,2004,4,12,8,12,42,46,-4,44
FC Zürich,2004,5,11,9,12,40,37,3,42
FC Lugano,2004,6,12,5,15,35,47,-12,41
Grasshoppers,2004,7,9,7,16,43,51,-8,34
FC Thun,2004,8,9,5,18,42,59,-17,32
FC Sion,2004,9,7,8,17,40,56,-16,29
Young Boys,2005,1,21,8,3,69,34,35,71
FC Basel,2005,2,17,8,7,53,26,27,59
Lucerne,2005,3,14,9,9,42,38,4,51
FC Zürich,2005,4,12,10,10,42,32,10,46
St Gallen,2005,5,14,4,14,41,53,-12,46
Grasshoppers,2005,6,9,8,15,40,47,-7,35
FC Lugano,2005,7,9,6,17,28,48,-20,33
FC Thun,2005,8,8,7,17,40,59,-19,31
FC Sion,2005,9,5,10,17,35,53,-18,25
Young Boys,2006,1,21,7,4,72,36,36,70
FC Basel,2006,2,20,7,5,61,23,38,67
St Gallen,2006,3,16,2,14,46,55,-9,50
Lucerne,2006,4,13,8,11,48,45,3,47
FC Zürich,2006,5,10,11,11,39,36,3,41
FC Thun,2006,6,10,6,16,43,62,-19,36
Grasshoppers,2006,7,9,7,16,42,53,-11,34
FC Lugano,2006,8,9,6,17,29,50,-21,33
FC Sion,2006,9,5,8,19,41,61,-20,23
Young Boys,2007,1,20,8,4,67,35,32,68
FC Basel,2007,2,18,9,5,55,24,31,63
Lucerne,2007,3,12,9,11,40,44,-4,45
St Gallen,2007,4,13,4,15,39,55,-16,43
FC Zürich,2007,5,10,10,12,40,38,2,40
FC Lugano,2007,6,11,6,15,33,46,-13,39
Grasshoppers,2007,7,10,7,15,41,48,-7,37
FC Thun,2007,8,10,6,16,47,58,-11,36
FC Sion,2007,9,6,9,17,39,53,-14,27
Young Boys,2008,1,20,8,4,68,34,34,68
FC Basel,2008,2,19,7,6,57,26,31,64
Lucerne,2008,3,13,9,10,45,41,4,48
St Gallen,2008,4,14,3,15,41,56,-15,45
FC Zürich,2008,5,10,10,12,40,39,1,40
FC Lugano,2008,6,10,7,15,32,46,-14,37
FC Thun,2008,7,9,6,17,45,64,-19,33
FC Sion,2008,8,8,8,16,44,53,-9,32
Grasshoppers,2008,9,8,8,16,40,53,-13,32
Young Boys,2009,1,19,9,4,65,38,27,66
FC Basel,2009,2,17,9,6,56,26,30,60
St Gallen,2009,3,14,4,14,41,53,-12,46
Lucerne,2009,4,12,9,11,43,45,-2,45
FC Zürich,2009,5,10,11,11,40,36,4,41
Grasshoppers,2009,6,10,7,15,44,49,-5,37
FC Thun,2009,7,10,6,16,45,59,-14,36
FC Lugano,2009,8,9,8,15,31,48,-17,35
FC Sion,2009,9,7,9,16,40,51,-11,30
Young Boys,2010,1,22,8,2,71,34,37,74
FC Basel,2010,2,18,9,5,57,26,31,63
Lucerne,2010,3,13,9,10,49,48,1,48
St Gallen,2010,4,14,2,16,43,56,-13,44
FC Zürich,2010,5,10,11,11,39,35,4,41
FC Lugano,2010,6,10,6,16,31,46,-15,36
Grasshoppers,2010,7,9,6,17,40,55,-15,33
FC Thun,2010,8,9,5,18,42,61,-19,32
FC Sion,2010,9,7,8,17,40,51,-11,29
Young Boys,2011,1,21,7,4,68,36,32,70
FC Basel,2011,2,20,7,5,65,24,41,67
St Gallen,2011,3,14,2,16,45,60,-15,44
Lucerne,2011,4,12,7,13,43,49,-6,43
FC Zürich,2011,5,10,10,12,41,43,-2,40
FC Lugano,2011,6,11,6,15,35,48,-13,39
Grasshoppers,2011,7,10,7,15,42,48,-6,37
FC Thun,2011,8,10,5,17,45,62,-17,35
FC Sion,2011,9,6,9,17,41,55,-14,27
Young Boys,2012,1,21,6,5,72,39,33,69
FC Basel,2012,2,19,7,6,57,24,33,64
Lucerne,2012,3,15,7,10,43,41,2,52
FC Zürich,2012,4,12,10,10,43,35,8,46
St Gallen,2012,5,14,2,16,41,54,-13,44
Grasshoppers,2012,6,9,6,17,39,51,-12,33
FC Thun,2012,7,9,6,17,41,60,-19,33
FC Lugano,2012,8,9,5,18,29,49,-20,32
FC Sion,2012,9,8,7,17,44,56,-12,31
Young Boys,2013,1,20,7,5,69,40,29,67
FC Basel,2013,2,18,9,5,59,24,35,63
Lucerne,2013,3,13,7,12,43,48,-5,46
St Gallen,2013,4,14,3,15,41,54,-13,45
FC Zürich,2013,5,9,12,11,44,41,3,39
FC Sion,2013,6,10,7,15,48,52,-4,37
FC Lugano,2013,7,10,7,15,34,48,-14,37
Grasshoppers,2013,8,10,6,16,40,48,-8,36
FC Thun,2013,9,8,6,18,42,65,-23,30
Young Boys,2014,1,22,8,2,73,32,41,74
FC Basel,2014,2,19,8,5,55,24,31,65
St Gallen,2014,3,15,2,15,44,56,-12,47
Lucerne,2014,4,12,8,12,44,45,-1,44
FC Zürich,2014,5,11,9,12,39,36,3,42
Grasshoppers,2014,6,10,6,16,42,49,-7,36
FC Lugano,2014,7,10,6,16,31,50,-19,36
FC Thun,2014,8,10,5,17,45,59,-14,35
FC Sion,2014,9,5,8,19,37,59,-22,23
Young Boys,2015,1,22,7,3,70,33,37,73
FC Basel,2015,2,18,7,7,51,26,25,61
Lucerne,2015,3,12,8,12,42,46,-4,44
St Gallen,2015,4,13,3,16,38,53,-15,42
FC Zürich,2015,5,10,11,11,40,35,5,41
FC Thun,2015,6,12,5,15,48,59,-11,41
FC Lugano,2015,7,10,8,14,34,47,-13,38
Grasshoppers,2015,8,9,6,17,40,52,-12,33
FC Sion,2015,9,6,9,17,39,51,-12,27
Young Boys,2016,1,19,7,6,67,42,25,64
FC Basel,2016,2,18,8,6,54,25,29,62
Lucerne,2016,3,15,7,10,47,42,5,52
St Gallen,2016,4,15,3,14,45,55,-10,48
FC Zürich,2016,5,10,10,12,38,36,2,40
Grasshoppers,2016,6,11,6,15,45,46,-1,39
FC Thun,2016,7,9,6,17,41,59,-18,33
FC Lugano,2016,8,9,6,17,29,49,-20,33
FC Sion,2016,9,7,9,16,42,54,-12,30
Young Boys,2017,1,24,6,2,79,34,45,78
FC Basel,2017,2,17,7,8,50,29,21,58
St Gallen,2017,3,16,2,14,43,50,-7,50
FC Zürich,2017,4,12,10,10,43,34,9,46
Lucerne,2017,5,12,7,13,41,43,-2,43
Grasshoppers,2017,6,10,7,15,42,51,-9,37
FC Thun,2017,7,9,6,17,42,58,-16,33
FC Lugano,2017,8,9,5,18,28,51,-23,32
FC Sion,2017,9,6,8,18,39,57,-18,26
Young Boys,2018,1,21,8,3,69,32,37,71
FC Basel,2018,2,18,8,6,55,27,28,62
Lucerne,2018,3,13,8,11,43,43,0,47
FC Zürich,2018,4,10,11,11,39,35,4,41
St Gallen,2018,5,13,2,17,41,61,-20,41
FC Thun,2018,6,11,6,15,45,55,-10,39
Grasshoppers,2018,7,10,7,15,41,49,-8,37
FC Lugano,2018,8,10,6,16,31,48,-17,36
FC Sion,2018,9,6,8,18,38,52,-14,26
Young Boys,2019,1,21,7,4,74,41,33,70
FC Basel,2019,2,17,9,6,51,24,27,60
St Gallen,2019,3,15,4,13,47,54,-7,49
Lucerne,2019,4,13,9,10,44,43,1,48
FC Zürich,2019,5,11,10,11,42,37,5,43
FC Thun,2019,6,10,7,15,47,59,-12,37
Grasshoppers,2019,7,8,9,15,43,52,-9,33
FC Lugano,2019,8,9,6,17,30,51,-21,33
FC Sion,2019,9,5,9,18,42,59,-17,24
Young Boys,2020,1,22,6,4,75,37,38,72
FC Basel,2020,2,18,7,7,51,26,25,61
Lucerne,2020,3,14,7,11,50,48,2,49
St Gallen,2020,4,14,3,15,42,54,-12,45
FC Zürich,2020,5,10,12,10,42,36,6,42
Grasshoppers,2020,6,9,7,16,44,54,-10,34
FC Thun,2020,7,9,7,16,43,57,-14,34
FC Lugano,2020,8,9,7,16,29,50,-21,34
FC Sion,2020,9,7,8,17,41,55,-14,29
Young Boys,2021,1,21,8,3,71,31,40,71
FC Basel,2021,2,20,7,5,61,25,36,67
St Gallen,2021,3,14,3,15,42,54,-12,45
Lucerne,2021,4,12,7,13,38,45,-7,43
FC Zürich,2021,5,11,9,12,40,39,1,42
Grasshoppers,2021,6,10,8,14,41,47,-6,38
FC Thun,2021,7,9,6,17,43,61,-18,33
FC Lugano,2021,8,9,6,17,30,52,-22,33
FC Sion,2021,9,6,10,16,40,52,-12,28
Young Boys,2022,1,20,7,5,70,38,32,67
FC Basel,2022,2,19,7,6,60,28,32,64
St Gallen,2022,3,15,3,14,46,55,-9,48
Lucerne,2022,4,13,8,11,48,48,0,47
FC Zürich,2022,5,10,10,12,41,40,1,40
FC Lugano,2022,6,11,6,15,34,47,-13,39
Grasshoppers,2022,7,9,7,16,37,51,-14,34
FC Thun,2022,8,9,5,18,42,59,-17,32
FC Sion,2022,9,7,9,16,40,52,-12,30
Young Boys,2023,1,22,7,3,75,39,36,73
FC Basel,2023,2,16,9,7,53,31,22,57
FC Zürich,2023,3,13,9,10,44,33,11,48
Lucerne,2023,4,13,8,11,44,41,3,47
St Gallen,2023,5,14,4,14,41,52,-11,46
Grasshoppers,2023,6,9,8,15,41,49,-8,35
FC Lugano,2023,7,10,5,17,30,50,-20,35
FC Thun,2023,8,9,6,17,45,62,-17,33
FC Sion,2023,9,6,8,18,38,54,-16,26
Young Boys,2024,1,21,8,3,72,35,37,71
FC Basel,2024,2,17,9,6,57,28,29,60
Lucerne,2024,3,12,10,10,41,41,0,46
FC Zürich,2024,4,11,10,11,40,36,4,43
St Gallen,2024,5,13,4,15,42,57,-15,43
FC Lugano,2024,6,11,5,16,31,46,-15,38
Grasshoppers,2024,7,9,8,15,42,51,-9,35
FC Thun,2024,8,9,5,18,42,61,-19,32
FC Sion,2024,9,7,9,16,44,56,-12,30
Young Boys,2025,1,20,8,4,67,35,32,68
FC Basel,2025,2,18,8,6,53,24,29,62
Lucerne,2025,3,12,9,11,44,46,-2,45
FC Zürich,2025,4,11,11,10,44,37,7,44
St Gallen,2025,5,14,2,16,42,57,-15,44
Grasshoppers,2025,6,12,6,14,48,45,3,42
FC Lugano,2025,7,10,6,16,31,48,-17,36
FC Sion,2025,8,7,9,16,41,57,-16,30
FC Thun,2025,9,8,5,19,42,63,-21,29
Young Boys,2026,1,21,8,3,74,37,37,71
FC Basel,2026,2,15,10,7,51,30,21,55
St Gallen,2026,3,14,5,13,43,53,-10,47
Lucerne,2026,4,11,11,10,40,42,-2,44
FC Zürich,2026,5,10,11,11,43,38,5,41
Grasshoppers,2026,6,10,7,15,44,51,-7,37
FC Thun,2026,7,10,6,16,50,60,-10,36
FC Lugano,2026,8,10,6,16,29,47,-18,36
FC Sion,2026,9,7,8,17,42,58,-16,29
Young Boys,2027,1,21,8,3,71,34,37,71
FC Basel,2027,2,17,8,7,55,30,25,59
St Gallen,2027,3,17,2,13,45,50,-5,53
Lucerne,2027,4,13,7,12,43,46,-3,46
FC Zürich,2027,5,11,10,11,42,41,1,43
Grasshoppers,2027,6,10,8,14,44,48,-4,38
FC Thun,2027,7,10,6,16,48,59,-11,36
FC Lugano,2027,8,9,5,18,29,50,-21,32
FC Sion,2027,9,5,8,19,39,58,-19,23
Young Boys,2028,1,21,8,3,71,34,37,71
FC Basel,2028,2,16,11,5,50,23,27,59
Lucerne,2028,3,13,9,10,45,44,1,48
St Gallen,2028,4,14,3,15,45,58,-13,45
FC Zürich,2028,5,10,10,12,38,40,-2,40
FC Lugano,2028,6,10,7,15,35,47,-12,37
FC Thun,2028,7,10,5,17,44,59,-15,35
Grasshoppers,2028,8,9,6,17,38,51,-13,33
FC Sion,2028,9,8,7,17,43,53,-10,31
Young Boys,2029,1,23,7,2,78,35,43,76
FC Basel,2029,2,18,8,6,56,27,29,62
Lucerne,2029,3,13,8,11,42,46,-4,47
St Gallen,2029,4,13,4,15,44,60,-16,43
FC Zürich,2029,5,10,10,12,40,38,2,40
FC Thun,2029,6,11,5,16,52,59,-7,38
FC Lugano,2029,7,10,6,16,32,48,-16,36
Grasshoppers,2029,8,9,6,17,43,55,-12,33
FC Sion,2029,9,6,8,18,40,59,-19,26
Young Boys,2030,1,20,8,4,67,36,31,68
FC Basel,2030,2,16,9,7,51,28,23,57
Lucerne,2030,3,15,7,10,48,43,5,52
St Gallen,2030,4,14,3,15,44,56,-12,45
FC Zürich,2030,5,11,11,10,41,35,6,44
Grasshoppers,2030,6,10,7,15,42,50,-8,37
FC Lugano,2030,7,9,7,16,32,49,-17,34
FC Thun,2030,8,8,7,17,42,60,-18,31
FC Sion,2030,9,7,9,16,44,54,-10,30
Young Boys,2031,1,21,8,3,68,32,36,71
FC Basel,2031,2,17,8,7,61,27,34,59
Lucerne,2031,3,14,7,11,44,44,0,49
St Gallen,2031,4,14,4,14,42,53,-11,46
FC Zürich,2031,5,11,10,11,40,35,5,43
FC Lugano,2031,6,10,7,15,29,45,-16,37
Grasshoppers,2031,7,9,6,17,39,53,-14,33
FC Thun,2031,8,9,6,17,42,63,-21,33
FC Sion,2031,9,7,8,17,40,53,-13,29
Young Boys,2032,1,23,6,3,74,34,40,75
FC Basel,2032,2,18,7,7,54,26,28,61
St Gallen,2032,3,15,2,15,45,54,-9,47
FC Zürich,2032,4,12,9,11,46,35,11,45
Lucerne,2032,5,11,9,12,40,48,-8,42
Grasshoppers,2032,6,10,7,15,42,49,-7,37
FC Lugano,2032,7,10,6,16,31,52,-21,36
FC Thun,2032,8,9,5,18,42,59,-17,32
FC Sion,2032,9,7,7,18,40,57,-17,28
Young Boys,2033,1,21,8,3,68,33,35,71
FC Basel,2033,2,19,7,6,57,24,33,64
St Gallen,2033,3,15,2,15,41,54,-13,47
FC Zürich,2033,4,12,10,10,40,33,7,46
Lucerne,2033,5,11,8,13,40,51,-11,41
Grasshoppers,2033,6,10,7,15,44,48,-4,37
FC Lugano,2033,7,9,6,17,29,48,-19,33
FC Thun,2033,8,9,5,18,41,60,-19,32
FC Sion,2033,9,7,9,16,42,51,-9,30
Young Boys,2034,1,21,8,3,70,33,37,71
FC Basel,2034,2,19,8,5,59,23,36,65
Lucerne,2034,3,12,9,11,41,42,-1,45
St Gallen,2034,4,14,2,16,41,56,-15,44
FC Zürich,2034,5,10,10,12,37,35,2,40
FC Lugano,2034,6,11,7,14,33,46,-13,40
FC Thun,2034,7,10,5,17,41,61,-20,35
Grasshoppers,2034,8,8,7,17,38,51,-13,31
FC Sion,2034,9,7,8,17,37,50,-13,29
Young Boys,2035,1,20,7,5,67,37,30,67
FC Basel,2035,2,15,11,6,50,26,24,56
Lucerne,2035,3,15,7,10,44,42,2,52
St Gallen,2035,4,14,3,15,42,56,-14,45
FC Zürich,2035,5,10,11,11,43,38,5,41
FC Thun,2035,6,10,7,15,44,55,-11,37
Grasshoppers,2035,7,10,6,16,42,50,-8,36
FC Lugano,2035,8,10,6,16,32,47,-15,36
FC Sion,2035,9,7,8,17,42,55,-13,29
Young Boys,2036,1,21,7,4,75,34,41,70
FC Basel,2036,2,19,7,6,61,28,33,64
Lucerne,2036,3,12,9,11,40,44,-4,45
FC Zürich,2036,4,11,10,11,43,37,6,43
St Gallen,2036,5,13,3,16,41,56,-15,42
FC Thun,2036,6,11,5,16,45,57,-12,38
Grasshoppers,2036,7,10,7,15,38,47,-9,37
FC Lugano,2036,8,10,5,17,29,52,-23,35
FC Sion,2036,9,6,9,17,40,57,-17,27
Young Boys,2037,1,22,6,4,71,38,33,72
FC Basel,2037,2,17,9,6,55,25,30,60
Lucerne,2037,3,14,9,9,46,40,6,51
FC Zürich,2037,4,12,9,11,41,36,5,45
St Gallen,2037,5,13,5,14,43,57,-14,44
FC Thun,2037,6,10,5,17,45,61,-16,35
FC Lugano,2037,7,10,5,17,31,47,-16,35
Grasshoppers,2037,8,9,6,17,42,56,-14,33
FC Sion,2037,9,6,8,18,42,56,-14,26
Young Boys,2038,1,21,7,4,70,37,33,70
FC Basel,2038,2,19,7,6,58,26,32,64
Lucerne,2038,3,13,8,11,44,44,0,47
FC Zürich,2038,4,11,10,11,43,39,4,43
St Gallen,2038,5,13,3,16,40,57,-17,42
FC Lugano,2038,6,10,6,16,36,52,-16,36
Grasshoppers,2038,7,9,8,15,44,53,-9,35
FC Sion,2038,8,8,9,15,46,53,-7,33
FC Thun,2038,9,8,6,18,45,65,-20,30
Young Boys,2039,1,23,7,2,76,37,39,76
FC Basel,2039,2,18,8,6,55,24,31,62
St Gallen,2039,3,14,4,14,41,52,-11,46
Lucerne,2039,4,11,10,11,39,47,-8,43
FC Zürich,2039,5,10,10,12,41,37,4,40
FC Lugano,2039,6,11,6,15,34,46,-12,39
Grasshoppers,2039,7,9,7,16,42,51,-9,34
FC Thun,2039,8,9,7,16,44,58,-14,34
FC Sion,2039,9,6,7,19,40,60,-20,25
Young Boys,2040,1,22,7,3,73,36,37,73
FC Basel,2040,2,20,7,5,57,21,36,67
St Gallen,2040,3,13,4,15,40,53,-13,43
Lucerne,2040,4,11,9,12,41,48,-7,42
FC Lugano,2040,5,12,6,14,33,44,-11,42
FC Zürich,2040,6,10,9,13,39,39,0,39
Grasshoppers,2040,7,10,7,15,44,52,-8,37
FC Thun,2040,8,9,6,17,46,64,-18,33
FC Sion,2040,9,5,9,18,42,58,-16,24
Young Boys,2041,1,24,6,2,75,33,42,78
FC Basel,2041,2,16,7,9,52,30,22,55
St Gallen,2041,3,16,2,14,48,54,-6,50
FC Zürich,2041,4,11,10,11,44,38,6,43
Lucerne,2041,5,11,8,13,41,48,-7,41
FC Lugano,2041,6,11,6,15,35,51,-16,39
Grasshoppers,2041,7,10,7,15,41,49,-8,37
FC Thun,2041,8,10,7,15,47,58,-11,37
FC Sion,2041,9,5,7,20,36,58,-22,22
Young Boys,2042,1,21,6,5,67,35,32,69
FC Basel,2042,2,19,7,6,57,26,31,64
St Gallen,2042,3,15,2,15,43,53,-10,47
Lucerne,2042,4,12,9,11,41,43,-2,45
FC Zürich,2042,5,10,11,11,44,39,5,41
Grasshoppers,2042,6,10,7,15,40,46,-6,37
FC Lugano,2042,7,9,7,16,30,47,-17,34
FC Thun,2042,8,9,6,17,41,64,-23,33
FC Sion,2042,9,8,7,17,44,54,-10,31
Young Boys,2043,1,23,7,2,77,33,44,76
FC Basel,2043,2,19,7,6,54,28,26,64
Lucerne,2043,3,12,9,11,40,43,-3,45
St Gallen,2043,4,14,3,15,41,54,-13,45
FC Zürich,2043,5,10,10,12,39,36,3,40
FC Lugano,2043,6,10,6,16,30,48,-18,36
Grasshoppers,2043,7,9,7,16,39,46,-7,34
FC Thun,2043,8,8,7,17,40,58,-18,31
FC Sion,2043,9,6,10,16,38,52,-14,28
Young Boys,2044,1,22,7,3,75,36,39,73
FC Basel,2044,2,18,7,7,55,29,26,61
Lucerne,2044,3,14,8,10,46,44,2,50
FC Zürich,2044,4,12,9,11,43,36,7,45
St Gallen,2044,5,14,3,15,42,55,-13,45
FC Thun,2044,6,10,6,16,45,60,-15,36
Grasshoppers,2044,7,9,7,16,43,52,-9,34
FC Lugano,2044,8,9,6,17,29,48,-19,33
FC Sion,2044,9,5,9,18,41,59,-18,24
Young Boys,2045,1,21,7,4,68,35,33,70
FC Basel,2045,2,17,9,6,53,26,27,60
Lucerne,2045,3,14,8,10,45,40,5,50
St Gallen,2045,4,14,5,13,43,53,-10,47
FC Zürich,2045,5,11,11,10,42,35,7,44
FC Thun,2045,6,9,7,16,42,58,-16,34
FC Lugano,2045,7,9,6,17,28,49,-21,33
Grasshoppers,2045,8,8,8,16,38,49,-11,32
FC Sion,2045,9,6,9,17,38,52,-14,27
Young Boys,2046,1,24,6,2,80,31,49,78
FC Basel,2046,2,18,7,7,53,25,28,61
St Gallen,2046,3,15,3,14,43,52,-9,48
FC Zürich,2046,4,10,11,11,44,41,3,41
Lucerne,2046,5,11,7,14,39,54,-15,40
FC Lugano,2046,6,10,7,15,34,50,-16,37
FC Thun,2046,7,10,5,17,44,59,-15,35
Grasshoppers,2046,8,9,7,16,44,53,-9,34
FC Sion,2046,9,6,9,17,43,59,-16,27
Young Boys,2047,1,24,6,2,76,31,45,78
FC Basel,2047,2,16,8,8,48,26,22,56
Lucerne,2047,3,12,8,12,41,47,-6,44
St Gallen,2047,4,14,2,16,43,56,-13,44
FC Zürich,2047,5,11,10,11,43,36,7,43
FC Lugano,2047,6,10,6,16,33,49,-16,36
Grasshoppers,2047,7,9,8,15,42,53,-11,35
FC Thun,2047,8,9,6,17,42,60,-18,33
FC Sion,2047,9,8,8,16,44,54,-10,32
Young Boys,2048,1,20,10,2,71,36,35,70
FC Basel,2048,2,19,8,5,55,22,33,65
Lucerne,2048,3,13,8,11,42,42,0,47
St Gallen,2048,4,14,3,15,42,57,-15,45
FC Zürich,2048,5,11,9,12,39,36,3,42
FC Lugano,2048,6,10,6,16,31,49,-18,36
Grasshoppers,2048,7,9,7,16,43,53,-10,34
FC Thun,2048,8,8,6,18,39,57,-18,30
FC Sion,2048,9,6,11,15,42,52,-10,29
Young Boys,2049,1,23,6,3,74,37,37,75
FC Basel,2049,2,20,7,5,60,21,39,67
St Gallen,2049,3,15,3,14,44,56,-12,48
Lucerne,2049,4,13,7,12,46,50,-4,46
FC Zürich,2049,5,10,10,12,39,37,2,40
FC Lugano,2049,6,10,5,17,29,47,-18,35
Grasshoppers,2049,7,9,7,16,47,56,-9,34
FC Thun,2049,8,8,6,18,44,63,-19,30
FC Sion,2049,9,6,9,17,42,58,-16,27
Young Boys,2050,1,24,6,2,75,31,44,78
FC Basel,2050,2,18,7,7,56,28,28,61
St Gallen,2050,3,15,2,15,45,56,-11,47
Lucerne,2050,4,11,8,13,39,46,-7,41
FC Lugano,2050,5,11,6,15,33,48,-15,39
FC Zürich,2050,6,9,11,12,39,41,-2,38
Grasshoppers,2050,7,10,6,16,41,49,-8,36
FC Thun,2050,8,9,6,17,43,60,-17,33
FC Sion,2050,9,7,8,17,40,52,-12,29
Young Boys,2051,1,23,6,3,76,37,39,75
FC Basel,2051,2,18,8,6,54,24,30,62
Lucerne,2051,3,12,8,12,41,47,-6,44
FC Zürich,2051,4,11,10,11,42,37,5,43
St Gallen,2051,5,13,4,15,40,56,-16,43
Grasshoppers,2051,6,10,6,16,42,50,-8,36
FC Thun,2051,7,10,5,17,45,60,-15,35
FC Lugano,2051,8,9,6,17,30,49,-19,33
FC Sion,2051,9,8,7,17,47,57,-10,31
Young Boys,2052,1,21,8,3,71,35,36,71
FC Basel,2052,2,15,8,9,49,29,20,53
Lucerne,2052,3,14,8,10,40,41,-1,50
FC Zürich,2052,4,12,10,10,42,34,8,46
St Gallen,2052,5,14,3,15,41,53,-12,45
FC Thun,2052,6,11,6,15,48,56,-8,39
FC Lugano,2052,7,10,5,17,29,46,-17,35
Grasshoppers,2052,8,9,7,16,41,50,-9,34
FC Sion,2052,9,6,9,17,40,57,-17,27
Young Boys,2053,1,22,6,4,70,36,34,72
FC Basel,2053,2,18,8,6,55,25,30,62
FC Zürich,2053,3,11,10,11,41,36,5,43
Lucerne,2053,4,12,7,13,39,45,-6,43
St Gallen,2053,5,13,2,17,44,61,-17,41
FC Lugano,2053,6,11,5,16,32,48,-16,38
Grasshoppers,2053,7,10,7,15,42,49,-7,37
FC Thun,2053,8,9,8,15,43,57,-14,35
FC Sion,2053,9,8,7,17,47,56,-9,31
Young Boys,2054,1,22,7,3,77,34,43,73
FC Basel,2054,2,19,7,6,54,25,29,64
St Gallen,2054,3,14,3,15,43,56,-13,45
FC Zürich,2054,4,11,11,10,41,33,8,44
Lucerne,2054,5,12,8,12,45,47,-2,44
Grasshoppers,2054,6,9,8,15,39,48,-9,35
FC Thun,2054,7,9,7,16,43,58,-15,34
FC Lugano,2054,8,9,7,16,30,51,-21,34
FC Sion,2054,9,6,8,18,39,59,-20,26
Young Boys,2055,1,21,6,5,71,37,34,69
FC Basel,2055,2,17,8,7,53,25,28,59
St Gallen,2055,3,15,4,13,44,51,-7,49
Lucerne,2055,4,13,8,11,43,46,-3,47
FC Zürich,2055,5,10,9,13,40,41,-1,39
FC Lugano,2055,6,11,5,16,33,48,-15,38
Grasshoppers,2055,7,10,7,15,42,50,-8,37
FC Sion,2055,8,8,8,16,41,51,-10,32
FC Thun,2055,9,9,5,18,43,61,-18,32
Young Boys,2056,1,20,7,5,70,39,31,67
FC Basel,2056,2,16,8,8,52,28,24,56
St Gallen,2056,3,15,3,14,44,55,-11,48
Lucerne,2056,4,13,7,12,46,47,-1,46
FC Zürich,2056,5,10,11,11,42,37,5,41
Grasshoppers,2056,6,11,6,15,46,53,-7,39
FC Lugano,2056,7,10,8,14,32,46,-14,38
FC Thun,2056,8,10,5,17,44,59,-15,35
FC Sion,2056,9,8,7,17,43,55,-12,31
Young Boys,2057,1,21,7,4,69,34,35,70
FC Basel,2057,2,17,9,6,50,24,26,60
St Gallen,2057,3,14,4,14,42,55,-13,46
Lucerne,2057,4,12,8,12,39,44,-5,44
FC Lugano,2057,5,12,5,15,39,46,-7,41
Grasshoppers,2057,6,11,7,14,43,47,-4,40
FC Zürich,2057,7,9,11,12,37,37,0,38
FC Thun,2057,8,9,8,15,46,58,-12,35
FC Sion,2057,9,5,9,18,35,55,-20,24
Young Boys,2058,1,19,8,5,65,35,30,65
FC Basel,2058,2,18,8,6,56,25,31,62
St Gallen,2058,3,15,3,14,43,55,-12,48
Lucerne,2058,4,11,10,11,37,41,-4,43
Grasshoppers,2058,5,11,6,15,43,46,-3,39
FC Lugano,2058,6,10,8,14,35,49,-14,38
FC Zürich,2058,7,9,9,14,41,43,-2,36
FC Thun,2058,8,10,5,17,45,64,-19,35
FC Sion,2058,9,9,7,16,45,52,-7,34
Young Boys,2059,1,21,7,4,72,36,36,70
FC Basel,2059,2,18,9,5,57,27,30,63
Lucerne,2059,3,13,9,10,42,42,0,48
St Gallen,2059,4,15,2,15,46,56,-10,47
FC Zürich,2059,5,10,10,12,44,40,4,40
FC Lugano,2059,6,10,5,17,33,53,-20,35
Grasshoppers,2059,7,9,7,16,41,53,-12,34
FC Sion,2059,8,8,9,15,46,53,-7,33
FC Thun,2059,9,8,6,18,40,61,-21,30
Young Boys,2060,1,21,7,4,71,39,32,70
FC Basel,2060,2,18,8,6,55,28,27,62
Lucerne,2060,3,15,7,10,48,44,4,52
St Gallen,2060,4,13,3,16,44,59,-15,42
FC Zürich,2060,5,9,12,11,40,38,2,39
FC Thun,2060,6,11,6,15,45,54,-9,39
FC Lugano,2060,7,10,6,16,33,50,-17,36
Grasshoppers,2060,8,8,6,18,38,50,-12,30
FC Sion,2060,9,6,11,15,41,53,-12,29
Young Boys,2061,1,20,7,5,72,43,29,67
FC Basel,2061,2,19,7,6,58,26,32,64
FC Zürich,2061,3,12,9,11,44,34,10,45
St Gallen,2061,4,14,3,15,42,57,-15,45
Lucerne,2061,5,12,7,13,40,45,-5,43
FC Lugano,2061,6,12,5,15,36,48,-12,41
FC Thun,2061,7,10,6,16,46,58,-12,36
Grasshoppers,2061,8,9,7,16,41,51,-10,34
FC Sion,2061,9,6,9,17,40,57,-17,27
Young Boys,2062,1,21,6,5,66,34,32,69
FC Basel,2062,2,18,8,6,56,23,33,62
St Gallen,2062,3,17,2,13,46,50,-4,53
Lucerne,2062,4,14,8,10,43,41,2,50
FC Zürich,2062,5,11,9,12,41,40,1,42
Grasshoppers,2062,6,10,7,15,40,47,-7,37
FC Thun,2062,7,10,6,16,44,59,-15,36
FC Lugano,2062,8,9,5,18,29,51,-22,32
FC Sion,2062,9,5,7,20,37,57,-20,22
Young Boys,2063,1,21,6,5,71,40,31,69
FC Basel,2063,2,17,9,6,52,26,26,60
St Gallen,2063,3,15,4,13,46,55,-9,49
Lucerne,2063,4,12,10,10,44,44,0,46
FC Zürich,2063,5,9,12,11,40,37,3,39
FC Lugano,2063,6,10,7,15,35,50,-15,37
FC Thun,2063,7,10,6,16,42,55,-13,36
Grasshoppers,2063,8,9,7,16,43,52,-9,34
FC Sion,2063,9,6,9,17,39,53,-14,27
Young Boys,2064,1,22,8,2,70,31,39,74
FC Basel,2064,2,17,8,7,51,25,26,59
Lucerne,2064,3,14,8,10,47,40,7,50
St Gallen,2064,4,14,4,14,43,54,-11,46
FC Zürich,2064,5,9,12,11,39,36,3,39
FC Lugano,2064,6,10,7,15,31,51,-20,37
Grasshoppers,2064,7,9,7,16,42,53,-11,34
FC Thun,2064,8,9,7,16,41,57,-16,34
FC Sion,2064,9,5,9,18,38,55,-17,24
Young Boys,2065,1,22,7,3,73,32,41,73
FC Basel,2065,2,17,7,8,52,30,22,58
Lucerne,2065,3,13,8,11,40,43,-3,47
St Gallen,2065,4,15,2,15,49,57,-8,47
FC Zürich,2065,5,11,10,11,43,36,7,43
Grasshoppers,2065,6,9,9,14,41,47,-6,36
FC Thun,2065,7,10,6,16,43,57,-14,36
FC Lugano,2065,8,9,5,18,30,52,-22,32
FC Sion,2065,9,7,8,17,41,58,-17,29
Young Boys,2066,1,19,9,4,67,38,29,66
FC Basel,2066,2,19,8,5,55,23,32,65
St Gallen,2066,3,14,2,16,41,55,-14,44
FC Zürich,2066,4,11,9,12,40,39,1,42
FC Lugano,2066,5,12,6,14,38,46,-8,42
Lucerne,2066,6,11,8,13,38,45,-7,41
Grasshoppers,2066,7,11,7,14,45,47,-2,40
FC Thun,2066,8,9,5,18,41,62,-21,32
FC Sion,2066,9,7,8,17,41,51,-10,29
Young Boys,2067,1,23,6,3,75,34,41,75
FC Basel,2067,2,17,7,8,52,26,26,58
St Gallen,2067,3,15,3,14,45,58,-13,48
FC Zürich,2067,4,12,9,11,43,34,9,45
Lucerne,2067,5,12,8,12,45,50,-5,44
Grasshoppers,2067,6,10,7,15,46,53,-7,37
FC Thun,2067,7,9,6,17,41,58,-17,33
FC Lugano,2067,8,9,6,17,30,55,-25,33
FC Sion,2067,9,7,8,17,44,53,-9,29
Young Boys,2068,1,22,6,4,73,36,37,72
FC Basel,2068,2,18,8,6,59,26,33,62
St Gallen,2068,3,14,3,15,44,56,-12,45
FC Zürich,2068,4,11,10,11,43,36,7,43
Lucerne,2068,5,11,10,11,40,46,-6,43
FC Thun,2068,6,11,5,16,46,60,-14,38
FC Lugano,2068,7,10,6,16,32,52,-20,36
Grasshoppers,2068,8,9,7,16,40,51,-11,34
FC Sion,2068,9,7,7,18,41,55,-14,28
Young Boys,2069,1,22,7,3,73,32,41,73
FC Basel,2069,2,18,8,6,56,27,29,62
Lucerne,2069,3,12,10,10,44,46,-2,46
FC Zürich,2069,4,11,11,10,42,36,6,44
St Gallen,2069,5,13,5,14,45,58,-13,44
FC Lugano,2069,6,9,8,15,32,49,-17,35
Grasshoppers,2069,7,9,7,16,45,55,-10,34
FC Thun,2069,8,9,7,16,44,57,-13,34
FC Sion,2069,9,5,9,18,37,58,-21,24
Young Boys,2070,1,21,8,3,73,33,40,71
FC Basel,2070,2,17,9,6,56,30,26,60
Lucerne,2070,3,15,7,10,49,48,1,52
St Gallen,2070,4,15,2,15,47,55,-8,47
FC Zürich,2070,5,9,11,12,42,40,2,38
FC Lugano,2070,6,10,6,16,31,46,-15,36
Grasshoppers,2070,7,9,8,15,40,50,-10,35
FC Thun,2070,8,8,8,16,43,59,-16,32
FC Sion,2070,9,7,7,18,39,59,-20,28
Young Boys,2071,1,23,6,3,74,35,39,75
FC Basel,2071,2,17,9,6,55,26,29,60
St Gallen,2071,3,15,4,13,46,53,-7,49
Lucerne,2071,4,11,10,11,39,45,-6,43
FC Zürich,2071,5,9,12,11,38,35,3,39
Grasshoppers,2071,6,11,6,15,45,50,-5,39
FC Lugano,2071,7,9,7,16,29,47,-18,34
FC Thun,2071,8,8,6,18,42,63,-21,30
FC Sion,2071,9,7,8,17,43,57,-14,29
Young Boys,2072,1,20,9,3,69,33,36,69
FC Basel,2072,2,17,9,6,53,25,28,60
Lucerne,2072,3,14,8,10,46,41,5,50
St Gallen,2072,4,14,3,15,40,54,-14,45
FC Zürich,2072,5,10,12,10,41,35,6,42
FC Lugano,2072,6,10,6,16,28,48,-20,36
Grasshoppers,2072,7,9,8,15,42,51,-9,35
FC Thun,2072,8,8,7,17,43,61,-18,31
FC Sion,2072,9,7,8,17,40,54,-14,29
Young Boys,2073,1,21,7,4,70,38,32,70
FC Basel,2073,2,19,7,6,57,27,30,64
St Gallen,2073,3,15,3,14,44,53,-9,48
Lucerne,2073,4,12,7,13,43,48,-5,43
FC Zürich,2073,5,10,10,12,44,38,6,40
FC Lugano,2073,6,11,6,15,33,47,-14,39
Grasshoppers,2073,7,10,7,15,43,50,-7,37
FC Thun,2073,8,9,6,17,40,56,-16,33
FC Sion,2073,9,5,11,16,38,55,-17,26
Young Boys,2074,1,23,6,3,69,31,38,75
FC Basel,2074,2,17,7,8,53,32,21,58
St Gallen,2074,3,15,3,14,45,54,-9,48
FC Zürich,2074,4,11,10,11,40,35,5,43
Lucerne,2074,5,12,7,13,41,46,-5,43
FC Thun,2074,6,11,6,15,45,54,-9,39
FC Lugano,2074,7,10,5,17,31,48,-17,35
Grasshoppers,2074,8,9,6,17,40,51,-11,33
FC Sion,2074,9,6,10,16,40,53,-13,28
Young Boys,2075,1,20,9,3,71,35,36,69
FC Basel,2075,2,18,9,5,56,27,29,63
St Gallen,2075,3,15,4,13,48,53,-5,49
Lucerne,2075,4,12,9,11,43,45,-2,45
FC Zürich,2075,5,10,11,11,41,36,5,41
Grasshoppers,2075,6,9,9,14,43,49,-6,36
FC Thun,2075,7,10,6,16,46,58,-12,36
FC Lugano,2075,8,9,5,18,31,57,-26,32
FC Sion,2075,9,5,10,17,39,58,-19,25
Young Boys,2076,1,22,6,4,68,32,36,72
FC Basel,2076,2,18,8,6,51,24,27,62
Lucerne,2076,3,14,7,11,43,41,2,49
St Gallen,2076,4,14,4,14,42,53,-11,46
FC Zürich,2076,5,10,10,12,38,35,3,40
FC Thun,2076,6,10,6,16,44,55,-11,36
FC Lugano,2076,7,9,7,16,28,47,-19,34
Grasshoppers,2076,8,9,6,17,38,51,-13,33
FC Sion,2076,9,7,8,17,39,53,-14,29
Young Boys,2077,1,22,7,3,72,35,37,73
FC Basel,2077,2,15,9,8,49,28,21,54
Lucerne,2077,3,13,9,10,45,42,3,48
FC Zürich,2077,4,11,10,11,44,34,10,43
St Gallen,2077,5,13,4,15,42,61,-19,43
FC Lugano,2077,6,10,8,14,32,45,-13,38
FC Thun,2077,7,10,6,16,44,58,-14,36
Grasshoppers,2077,8,8,8,16,36,47,-11,32
FC Sion,2077,9,8,7,17,42,56,-14,31
Young Boys,2078,1,22,7,3,72,36,36,73
FC Basel,2078,2,17,8,7,54,27,27,59
St Gallen,2078,3,15,3,14,46,54,-8,48
Lucerne,2078,4,12,9,11,41,42,-1,45
FC Zürich,2078,5,10,12,10,40,35,5,42
Grasshoppers,2078,6,10,7,15,44,51,-7,37
FC Thun,2078,7,9,7,16,42,58,-16,34
FC Lugano,2078,8,9,6,17,30,51,-21,33
FC Sion,2078,9,7,7,18,40,55,-15,28
Young Boys,2079,1,22,8,2,70,33,37,74
FC Basel,2079,2,16,9,7,50,25,25,57
Lucerne,2079,3,12,10,10,41,43,-2,46
St Gallen,2079,4,14,2,16,43,58,-15,44
FC Zürich,2079,5,10,9,13,41,39,2,39
FC Lugano,2079,6,11,5,16,32,47,-15,38
Grasshoppers,2079,7,10,7,15,41,47,-6,37
FC Thun,2079,8,9,6,17,42,58,-16,33
FC Sion,2079,9,8,8,16,41,51,-10,32
Young Boys,2080,1,23,6,3,80,38,42,75
FC Basel,2080,2,18,8,6,55,28,27,62
St Gallen,2080,3,15,2,15,41,53,-12,47
Lucerne,2080,4,12,8,12,42,46,-4,44
FC Zürich,2080,5,11,10,11,44,37,7,43
Grasshoppers,2080,6,10,6,16,43,51,-8,36
FC Lugano,2080,7,10,6,16,32,50,-18,36
FC Thun,2080,8,9,6,17,42,57,-15,33
FC Sion,2080,9,6,8,18,40,59,-19,26
Young Boys,2081,1,20,9,3,69,36,33,69
FC Basel,2081,2,19,8,5,58,27,31,65
Lucerne,2081,3,13,8,11,40,42,-2,47
St Gallen,2081,4,13,3,16,42,56,-14,42
FC Zürich,2081,5,10,11,11,39,36,3,41
Grasshoppers,2081,6,9,8,15,42,50,-8,35
FC Lugano,2081,7,9,7,16,28,45,-17,34
FC Thun,2081,8,9,6,17,43,59,-16,33
FC Sion,2081,9,8,8,16,41,51,-10,32
Young Boys,2082,1,21,8,3,74,37,37,71
FC Basel,2082,2,17,10,5,53,26,27,61
St Gallen,2082,3,15,3,14,49,55,-6,48
Lucerne,2082,4,12,8,12,44,49,-5,44
FC Zürich,2082,5,9,11,12,37,36,1,38
Grasshoppers,2082,6,10,7,15,43,48,-5,37
FC Thun,2082,7,10,6,16,45,58,-13,36
FC Lugano,2082,8,10,6,16,31,49,-18,36
FC Sion,2082,9,7,7,18,39,57,-18,28
Young Boys,2083,1,21,7,4,67,35,32,70
FC Basel,2083,2,18,8,6,51,22,29,62
Lucerne,2083,3,14,7,11,42,42,0,49
FC Zürich,2083,4,11,11,10,44,38,6,44
St Gallen,2083,5,13,3,16,41,56,-15,42
Grasshoppers,2083,6,9,7,16,39,48,-9,34
FC Lugano,2083,7,9,7,16,31,50,-19,34
FC Thun,2083,8,9,6,17,42,58,-16,33
FC Sion,2083,9,8,8,16,45,53,-8,32
Young Boys,2084,1,21,7,4,69,37,32,70
FC Basel,2084,2,19,7,6,59,27,32,64
St Gallen,2084,3,15,3,14,44,52,-8,48
Lucerne,2084,4,12,7,13,42,48,-6,43
FC Zürich,2084,5,10,11,11,40,36,4,41
FC Lugano,2084,6,10,7,15,31,46,-15,37
Grasshoppers,2084,7,9,7,16,42,50,-8,34
FC Thun,2084,8,9,6,17,44,61,-17,33
FC Sion,2084,9,8,7,17,41,55,-14,31
Young Boys,2085,1,22,8,2,72,34,38,74
FC Basel,2085,2,18,7,7,53,26,27,61
St Gallen,2085,3,16,3,13,49,52,-3,51
Lucerne,2085,4,12,7,13,43,47,-4,43
FC Zürich,2085,5,9,11,12,38,37,1,38
Grasshoppers,2085,6,10,7,15,43,50,-7,37
FC Thun,2085,7,9,6,17,43,59,-16,33
FC Lugano,2085,8,9,6,17,29,54,-25,33
FC Sion,2085,9,7,9,16,41,52,-11,30
Young Boys,2086,1,21,7,4,70,35,35,70
FC Basel,2086,2,19,7,6,58,27,31,64
St Gallen,2086,3,15,3,14,43,51,-8,48
Lucerne,2086,4,13,8,11,38,40,-2,47
FC Zürich,2086,5,10,10,12,39,37,2,40
Grasshoppers,2086,6,9,8,15,41,49,-8,35
FC Lugano,2086,7,9,8,15,28,45,-17,35
FC Thun,2086,8,9,7,16,47,63,-16,34
FC Sion,2086,9,5,10,17,40,57,-17,25
Young Boys,2087,1,23,6,3,72,32,40,75
FC Basel,2087,2,17,9,6,57,27,30,60
Lucerne,2087,3,13,8,11,43,46,-3,47
St Gallen,2087,4,14,3,15,48,60,-12,45
FC Zürich,2087,5,10,11,11,39,35,4,41
Grasshoppers,2087,6,9,8,15,40,48,-8,35
FC Lugano,2087,7,10,5,17,33,49,-16,35
FC Thun,2087,8,9,7,16,42,61,-19,34
FC Sion,2087,9,6,9,17,38,54,-16,27
Young Boys,2088,1,22,7,3,70,32,38,73
FC Basel,2088,2,18,8,6,50,24,26,62
St Gallen,2088,3,15,2,15,47,57,-10,47
Lucerne,2088,4,12,8,12,41,45,-4,44
FC Thun,2088,5,11,5,16,45,55,-10,38
FC Lugano,2088,6,11,5,16,33,52,-19,38
Grasshoppers,2088,7,10,7,15,42,49,-7,37
FC Zürich,2088,8,9,9,14,37,38,-1,36
FC Sion,2088,9,7,7,18,43,56,-13,28
Young Boys,2089,1,21,6,5,70,36,34,69
FC Basel,2089,2,17,9,6,55,28,27,60
St Gallen,2089,3,15,3,14,47,57,-10,48
Lucerne,2089,4,13,8,11,42,44,-2,47
FC Lugano,2089,5,12,5,15,33,45,-12,41
Grasshoppers,2089,6,10,7,15,43,48,-5,37
FC Zürich,2089,7,9,9,14,37,38,-1,36
FC Thun,2089,8,10,6,16,44,58,-14,36
FC Sion,2089,9,7,7,18,41,58,-17,28
Young Boys,2090,1,22,7,3,74,30,44,73
FC Basel,2090,2,17,9,6,53,28,25,60
Lucerne,2090,3,13,9,10,44,44,0,48
St Gallen,2090,4,15,3,14,47,57,-10,48
FC Zürich,2090,5,11,10,11,41,36,5,43
Grasshoppers,2090,6,9,7,16,41,51,-10,34
FC Lugano,2090,7,9,7,16,30,52,-22,34
FC Thun,2090,8,9,6,17,42,57,-15,33
FC Sion,2090,9,6,8,18,38,55,-17,26
Young Boys,2091,1,20,8,4,68,37,31,68
FC Basel,2091,2,20,7,5,58,24,34,67
Lucerne,2091,3,14,7,11,43,43,0,49
St Gallen,2091,4,13,2,17,40,56,-16,41
FC Lugano,2091,5,11,6,15,33,47,-14,39
FC Zürich,2091,6,9,10,13,39,40,-1,37
Grasshoppers,2091,7,10,7,15,43,49,-6,37
FC Thun,2091,8,9,5,18,43,60,-17,32
FC Sion,2091,9,7,10,15,39,50,-11,31
Young Boys,2092,1,20,9,3,69,36,33,69
FC Basel,2092,2,19,8,5,54,22,32,65
FC Zürich,2092,3,11,11,10,40,33,7,44
Lucerne,2092,4,12,8,12,44,46,-2,44
St Gallen,2092,5,13,3,16,42,57,-15,42
FC Thun,2092,6,10,6,16,42,57,-15,36
FC Lugano,2092,7,10,6,16,32,50,-18,36
Grasshoppers,2092,8,9,8,15,43,51,-8,35
FC Sion,2092,9,6,9,17,39,53,-14,27
Young Boys,2093,1,21,6,5,71,39,32,69
FC Basel,2093,2,17,10,5,56,27,29,61
St Gallen,2093,3,15,4,13,49,55,-6,49
Lucerne,2093,4,12,7,13,39,45,-6,43
FC Lugano,2093,5,12,5,15,32,46,-14,41
FC Zürich,2093,6,9,11,12,38,36,2,38
FC Thun,2093,7,10,7,15,46,57,-11,37
FC Sion,2093,8,8,8,16,44,54,-10,32
Grasshoppers,2093,9,8,6,18,39,55,-16,30
Young Boys,2094,1,22,7,3,78,37,41,73
FC Basel,2094,2,19,8,5,58,23,35,65
Lucerne,2094,3,13,7,12,43,47,-4,46
St Gallen,2094,4,14,2,16,41,56,-15,44
FC Zürich,2094,5,10,10,12,40,38,2,40
FC Thun,2094,6,11,5,16,49,59,-10,38
FC Lugano,2094,7,11,5,16,33,49,-16,38
Grasshoppers,2094,8,10,6,16,39,53,-14,36
FC Sion,2094,9,5,8,19,39,58,-19,23
Young Boys,2095,1,21,6,5,76,43,33,69
FC Basel,2095,2,17,10,5,56,26,30,61
St Gallen,2095,3,16,3,13,45,50,-5,51
Lucerne,2095,4,13,9,10,45,45,0,48
FC Lugano,2095,5,11,6,15,34,46,-12,39
FC Thun,2095,6,11,5,16,42,56,-14,38
FC Zürich,2095,7,9,10,13,38,42,-4,37
Grasshoppers,2095,8,8,6,18,38,56,-18,30
FC Sion,2095,9,7,7,18,45,55,-10,28
Young Boys,2096,1,23,6,3,75,31,44,75
FC Basel,2096,2,17,9,6,52,25,27,60
St Gallen,2096,3,14,3,15,41,54,-13,45
FC Zürich,2096,4,10,11,11,43,36,7,41
Lucerne,2096,5,11,8,13,38,51,-13,41
Grasshoppers,2096,6,11,6,15,43,47,-4,39
FC Lugano,2096,7,10,7,15,31,45,-14,37
FC Thun,2096,8,9,7,16,42,59,-17,34
FC Sion,2096,9,6,9,17,38,55,-17,27
Young Boys,2097,1,21,7,4,67,32,35,70
FC Basel,2097,2,19,7,6,53,23,30,64
St Gallen,2097,3,15,3,14,44,57,-13,48
Lucerne,2097,4,13,8,11,44,43,1,47
FC Zürich,2097,5,10,11,11,40,36,4,41
FC Lugano,2097,6,10,7,15,33,47,-14,37
Grasshoppers,2097,7,10,6,16,39,50,-11,36
FC Thun,2097,8,9,6,17,42,62,-20,33
FC Sion,2097,9,6,7,19,43,55,-12,25
Young Boys,2098,1,21,7,4,73,39,34,70
FC Basel,2098,2,18,8,6,60,25,35,62
Lucerne,2098,3,13,9,10,42,40,2,48
St Gallen,2098,4,14,3,15,41,55,-14,45
FC Zürich,2098,5,11,10,11,42,35,7,43
FC Lugano,2098,6,11,5,16,32,48,-16,38
Grasshoppers,2098,7,10,7,15,40,48,-8,37
FC Sion,2098,8,7,8,17,40,57,-17,29
FC Thun,2098,9,8,5,19,40,63,-23,29
Young Boys,2099,1,21,7,4,73,36,37,70
FC Basel,2099,2,19,7,6,56,24,32,64
Lucerne,2099,3,14,8,10,44,41,3,50
FC Zürich,2099,4,12,9,11,43,36,7,45
St Gallen,2099,5,13,3,16,42,58,-16,42
FC Lugano,2099,6,9,8,15,30,48,-18,35
FC Thun,2099,7,9,6,17,41,58,-17,33
Grasshoppers,2099,8,8,7,17,38,54,-16,31
FC Sion,2099,9,7,9,16,42,54,-12,30
Young Boys,2100,1,23,6,3,75,39,36,75
FC Basel,2100,2,18,8,6,57,26,31,62
Lucerne,2100,3,14,7,11,48,45,3,49
St Gallen,2100,4,13,4,15,43,61,-18,43
FC Zürich,2100,5,11,9,12,40,35,5,42
FC Lugano,2100,6,11,6,15,34,47,-13,39
Grasshoppers,2100,7,10,6,16,44,51,-7,36
FC Thun,2100,8,9,6,17,42,58,-16,33
FC Sion,2100,9,5,8,19,38,59,-21,23
Young Boys,2101,1,24,6,2,77,33,44,78
FC Basel,2101,2,18,7,7,53,26,27,61
St Gallen,2101,3,14,2,16,41,56,-15,44
Lucerne,2101,4,11,8,13,37,43,-6,41
FC Zürich,2101,5,10,10,12,39,35,4,40
FC Thun,2101,6,11,6,15,46,56,-10,39
FC Lugano,2101,7,11,6,15,33,46,-13,39
Grasshoppers,2101,8,9,7,16,41,50,-9,34
FC Sion,2101,9,6,8,18,40,62,-22,26
Young Boys,2102,1,22,7,3,71,35,36,73
FC Basel,2102,2,17,7,8,51,27,24,58
Lucerne,2102,3,14,7,11,42,39,3,49
St Gallen,2102,4,14,3,15,42,55,-13,45
FC Zürich,2102,5,10,9,13,41,41,0,39
FC Lugano,2102,6,11,6,15,32,46,-14,39
FC Thun,2102,7,10,6,16,46,59,-13,36
Grasshoppers,2102,8,8,8,16,39,50,-11,32
FC Sion,2102,9,7,9,16,42,54,-12,30
Young Boys,2103,1,23,6,3,74,37,37,75
FC Basel,2103,2,17,9,6,53,24,29,60
St Gallen,2103,3,15,3,14,43,53,-10,48
Lucerne,2103,4,13,7,12,39,44,-5,46
FC Zürich,2103,5,10,10,12,40,36,4,40
Grasshoppers,2103,6,11,6,15,44,46,-2,39
FC Thun,2103,7,10,5,17,41,59,-18,35
FC Lugano,2103,8,9,5,18,30,51,-21,32
FC Sion,2103,9,7,7,18,38,52,-14,28
Young Boys,2104,1,22,6,4,72,35,37,72
FC Basel,2104,2,18,9,5,55,25,30,63
Lucerne,2104,3,14,8,10,43,41,2,50
St Gallen,2104,4,15,3,14,44,54,-10,48
FC Zürich,2104,5,9,11,12,41,41,0,38
Grasshoppers,2104,6,9,6,17,42,53,-11,33
FC Lugano,2104,7,9,6,17,30,49,-19,33
FC Sion,2104,8,8,8,16,45,54,-9,32
FC Thun,2104,9,9,5,18,43,63,-20,32
Young Boys,2105,1,21,8,3,73,35,38,71
FC Basel,2105,2,18,9,5,57,27,30,63
Lucerne,2105,3,12,10,10,43,42,1,46
FC Zürich,2105,4,11,9,12,41,35,6,42
St Gallen,2105,5,13,3,16,40,57,-17,42
FC Lugano,2105,6,11,5,16,31,47,-16,38
Grasshoppers,2105,7,9,7,16,40,52,-12,34
FC Sion,2105,8,8,8,16,42,52,-10,32
FC Thun,2105,9,9,5,18,42,62,-20,32
Young Boys,2106,1,21,6,5,72,38,34,69
FC Basel,2106,2,18,9,5,55,24,31,63
Lucerne,2106,3,14,7,11,43,44,-1,49
St Gallen,2106,4,13,3,16,42,62,-20,42
FC Zürich,2106,5,10,10,12,44,41,3,40
FC Thun,2106,6,10,7,15,49,60,-11,37
FC Lugano,2106,7,10,6,16,36,50,-14,36
Grasshoppers,2106,8,9,7,16,40,51,-11,34
FC Sion,2106,9,7,9,16,45,56,-11,30
Young Boys,2107,1,22,6,4,72,34,38,72
FC Basel,2107,2,19,7,6,55,26,29,64
St Gallen,2107,3,15,3,14,47,55,-8,48
FC Zürich,2107,4,12,9,11,47,37,10,45
Lucerne,2107,5,11,7,14,40,49,-9,40
FC Lugano,2107,6,10,6,16,33,54,-21,36
Grasshoppers,2107,7,9,7,16,40,52,-12,34
FC Thun,2107,8,9,6,17,42,58,-16,33
FC Sion,2107,9,8,7,17,43,54,-11,31
Young Boys,2108,1,23,7,2,74,29,45,76
FC Basel,2108,2,17,9,6,53,27,26,60
FC Zürich,2108,3,12,10,10,41,33,8,46
Lucerne,2108,4,12,9,11,43,45,-2,45
St Gallen,2108,5,14,3,15,41,54,-13,45
Grasshoppers,2108,6,10,7,15,40,50,-10,37
FC Thun,2108,7,9,6,17,41,57,-16,33
FC Lugano,2108,8,9,6,17,28,48,-20,33
FC Sion,2108,9,6,7,19,36,54,-18,25
Young Boys,2109,1,22,7,3,75,35,40,73
FC Basel,2109,2,19,7,6,56,26,30,64
St Gallen,2109,3,16,2,14,45,53,-8,50
FC Zürich,2109,4,12,10,10,40,33,7,46
Lucerne,2109,5,12,8,12,42,45,-3,44
Grasshoppers,2109,6,9,8,15,38,47,-9,35
FC Lugano,2109,7,9,6,17,31,55,-24,33
FC Thun,2109,8,8,6,18,42,60,-18,30
FC Sion,2109,9,5,10,17,37,52,-15,25
Young Boys,2110,1,23,7,2,80,33,47,76
FC Basel,2110,2,17,9,6,54,25,29,60
Lucerne,2110,3,14,7,11,46,50,-4,49
St Gallen,2110,4,15,3,14,49,58,-9,48
FC Zürich,2110,5,10,10,12,39,38,1,40
FC Thun,2110,6,10,6,16,46,60,-14,36
FC Lugano,2110,7,9,6,17,27,51,-24,33
Grasshoppers,2110,8,8,7,17,39,54,-15,31
FC Sion,2110,9,7,7,18,47,58,-11,28
Young Boys,2111,1,20,8,4,69,34,35,68
FC Basel,2111,2,19,8,5,55,22,33,65
St Gallen,2111,3,15,2,15,43,55,-12,47
Lucerne,2111,4,13,7,12,43,44,-1,46
FC Zürich,2111,5,10,10,12,41,37,4,40
FC Sion,2111,6,9,8,15,44,51,-7,35
Grasshoppers,2111,7,9,8,15,39,47,-8,35
FC Lugano,2111,8,10,5,17,30,52,-22,35
FC Thun,2111,9,8,6,18,39,61,-22,30
Young Boys,2112,1,21,7,4,73,37,36,70
FC Basel,2112,2,17,9,6,53,25,28,60
St Gallen,2112,3,15,4,13,42,51,-9,49
Lucerne,2112,4,13,9,10,44,43,1,48
FC Zürich,2112,5,10,10,12,40,38,2,40
Grasshoppers,2112,6,10,7,15,44,53,-9,37
FC Lugano,2112,7,9,7,16,30,48,-18,34
FC Thun,2112,8,8,7,17,42,60,-18,31
FC Sion,2112,9,7,8,17,40,53,-13,29
Young Boys,2113,1,20,8,4,70,39,31,68
FC Basel,2113,2,20,7,5,63,26,37,67
Lucerne,2113,3,14,7,11,43,43,0,49
St Gallen,2113,4,15,2,15,45,60,-15,47
FC Zürich,2113,5,10,9,13,42,38,4,39
FC Lugano,2113,6,11,6,15,34,46,-12,39
FC Thun,2113,7,10,6,16,46,59,-13,36
Grasshoppers,2113,8,8,8,16,40,50,-10,32
FC Sion,2113,9,6,7,19,38,60,-22,25
Young Boys,2114,1,21,9,2,72,35,37,72
FC Basel,2114,2,19,8,5,53,22,31,65
St Gallen,2114,3,15,3,14,44,53,-9,48
FC Zürich,2114,4,12,9,11,46,34,12,45
Lucerne,2114,5,12,8,12,42,46,-4,44
Grasshoppers,2114,6,10,6,16,42,50,-8,36
FC Thun,2114,7,10,5,17,45,57,-12,35
FC Lugano,2114,8,9,7,16,32,51,-19,34
FC Sion,2114,9,5,7,20,37,65,-28,22
Young Boys,2115,1,21,8,3,72,33,39,71
FC Basel,2115,2,18,8,6,58,26,32,62
Lucerne,2115,3,14,9,9,43,41,2,51
St Gallen,2115,4,13,4,15,41,57,-16,43
FC Zürich,2115,5,10,10,12,41,40,1,40
FC Thun,2115,6,10,7,15,44,55,-11,37
FC Lugano,2115,7,10,6,16,32,49,-17,36
Grasshoppers,2115,8,9,7,16,40,51,-11,34
FC Sion,2115,9,5,9,18,35,54,-19,24
Young Boys,2116,1,22,6,4,77,38,39,72
FC Basel,2116,2,18,8,6,57,24,33,62
St Gallen,2116,3,14,4,14,41,53,-12,46
Lucerne,2116,4,12,9,11,46,44,2,45
FC Zürich,2116,5,10,11,11,40,38,2,41
Grasshoppers,2116,6,10,8,14,46,50,-4,38
FC Thun,2116,7,10,6,16,45,61,-16,36
FC Lugano,2116,8,10,5,17,30,52,-22,35
FC Sion,2116,9,5,9,18,35,57,-22,24
Young Boys,2117,1,23,6,3,72,35,37,75
FC Basel,2117,2,17,9,6,60,27,33,60
St Gallen,2117,3,15,3,14,44,55,-11,48
Lucerne,2117,4,11,8,13,40,48,-8,41
FC Lugano,2117,5,12,5,15,33,44,-11,41
FC Zürich,2117,6,9,11,12,38,37,1,38
FC Thun,2117,7,11,5,16,43,58,-15,38
Grasshoppers,2117,8,8,8,16,42,54,-12,32
FC Sion,2117,9,6,9,17,38,52,-14,27
Young Boys,2118,1,21,7,4,70,35,35,70
FC Basel,2118,2,19,7,6,56,28,28,64
St Gallen,2118,3,15,4,13,46,52,-6,49
Lucerne,2118,4,11,9,12,39,45,-6,42
FC Zürich,2118,5,10,9,13,42,39,3,39
FC Lugano,2118,6,10,7,15,30,46,-16,37
FC Thun,2118,7,10,5,17,45,61,-16,35
Grasshoppers,2118,8,8,9,15,42,51,-9,33
FC Sion,2118,9,7,9,16,41,54,-13,30
Young Boys,2119,1,23,7,2,79,35,44,76
FC Basel,2119,2,17,9,6,56,28,28,60
St Gallen,2119,3,16,2,14,45,52,-7,50
Lucerne,2119,4,12,9,11,42,46,-4,45
FC Zürich,2119,5,10,9,13,39,39,0,39
FC Lugano,2119,6,11,6,15,34,47,-13,39
Grasshoppers,2119,7,10,6,16,41,53,-12,36
FC Thun,2119,8,9,5,18,44,60,-16,32
FC Sion,2119,9,6,7,19,37,57,-20,25
Young Boys,2120,1,21,7,4,70,35,35,70
FC Basel,2120,2,19,7,6,55,25,30,64
St Gallen,2120,3,15,3,14,42,54,-12,48
Lucerne,2120,4,12,9,11,44,45,-1,45
FC Zürich,2120,5,11,10,11,43,36,7,43
Grasshoppers,2120,6,11,6,15,46,49,-3,39
FC Thun,2120,7,11,5,16,46,58,-12,38
FC Lugano,2120,8,9,6,17,29,49,-20,33
FC Sion,2120,9,5,7,20,35,59,-24,22
FC Basel,2121,1,20,7,5,60,24,36,67
Young Boys,2121,2,20,7,5,66,34,32,67
Lucerne,2121,3,13,8,11,39,40,-1,47
St Gallen,2121,4,15,2,15,42,54,-12,47
FC Zürich,2121,5,10,10,12,41,41,0,40
Grasshoppers,2121,6,10,7,15,38,47,-9,37
FC Thun,2121,7,10,5,17,51,61,-10,35
FC Lugano,2121,8,9,6,17,28,50,-22,33
FC Sion,2121,9,7,8,17,40,54,-14,29
Young Boys,2122,1,21,8,3,69,34,35,71
FC Basel,2122,2,17,10,5,53,25,28,61
St Gallen,2122,3,15,3,14,44,52,-8,48
Lucerne,2122,4,13,7,12,45,46,-1,46
FC Lugano,2122,5,12,5,15,30,44,-14,41
FC Zürich,2122,6,9,10,13,38,37,1,37
FC Thun,2122,7,10,6,16,44,58,-14,36
Grasshoppers,2122,8,8,7,17,39,53,-14,31
FC Sion,2122,9,7,8,17,40,53,-13,29
Young Boys,2123,1,22,8,2,76,35,41,74
FC Basel,2123,2,17,8,7,51,26,25,59
St Gallen,2123,3,16,2,14,49,56,-7,50
FC Zürich,2123,4,13,9,10,45,33,12,48
Lucerne,2123,5,13,8,11,44,46,-2,47
Grasshoppers,2123,6,9,6,17,40,50,-10,33
FC Lugano,2123,7,9,6,17,31,50,-19,33
FC Thun,2123,8,8,6,18,40,64,-24,30
FC Sion,2123,9,6,9,17,40,56,-16,27
Young Boys,2124,1,21,7,4,72,36,36,70
FC Basel,2124,2,16,10,6,51,26,25,58
FC Zürich,2124,3,12,10,10,41,33,8,46
St Gallen,2124,4,14,3,15,41,54,-13,45
Lucerne,2124,5,12,8,12,39,43,-4,44
Grasshoppers,2124,6,12,6,14,46,47,-1,42
FC Lugano,2124,7,10,5,17,30,49,-19,35
FC Thun,2124,8,8,7,17,41,59,-18,31
FC Sion,2124,9,7,8,17,42,56,-14,29
Young Boys,2125,1,21,6,5,70,36,34,69
FC Basel,2125,2,18,8,6,51,25,26,62
Lucerne,2125,3,12,9,11,41,43,-2,45
St Gallen,2125,4,14,3,15,44,57,-13,45
FC Zürich,2125,5,11,11,10,43,34,9,44
Grasshoppers,2125,6,11,7,14,45,48,-3,40
FC Lugano,2125,7,11,5,16,34,49,-15,38
FC Thun,2125,8,8,6,18,42,63,-21,30
FC Sion,2125,9,7,7,18,42,57,-15,28
Young Boys,2126,1,21,7,4,75,39,36,70
FC Basel,2126,2,18,8,6,57,29,28,62
St Gallen,2126,3,16,2,14,46,54,-8,50
FC Zürich,2126,4,12,9,11,42,35,7,45
Lucerne,2126,5,12,7,13,41,49,-8,43
FC Lugano,2126,6,11,5,16,31,47,-16,38
FC Thun,2126,7,10,6,16,48,59,-11,36
Grasshoppers,2126,8,9,6,17,41,52,-11,33
FC Sion,2126,9,6,8,18,39,56,-17,26
Young Boys,2127,1,23,7,2,77,35,42,76
FC Basel,2127,2,17,8,7,52,28,24,59
Lucerne,2127,3,15,7,10,47,44,3,52
St Gallen,2127,4,15,2,15,45,56,-11,47
FC Zürich,2127,5,11,10,11,41,35,6,43
FC Thun,2127,6,10,6,16,45,58,-13,36
Grasshoppers,2127,7,9,6,17,42,54,-12,33
FC Lugano,2127,8,9,5,18,32,53,-21,32
FC Sion,2127,9,6,7,19,41,59,-18,25
Young Boys,2128,1,20,8,4,68,36,32,68
FC Basel,2128,2,18,7,7,58,31,27,61
Lucerne,2128,3,14,8,10,42,41,1,50
St Gallen,2128,4,15,3,14,43,54,-11,48
FC Zürich,2128,5,11,9,12,45,42,3,42
FC Lugano,2128,6,11,6,15,32,44,-12,39
FC Thun,2128,7,10,5,17,46,59,-13,35
Grasshoppers,2128,8,8,6,18,39,53,-14,30
FC Sion,2128,9,7,8,17,45,58,-13,29
Young Boys,2129,1,24,6,2,77,31,46,78
FC Basel,2129,2,16,8,8,50,27,23,56
Lucerne,2129,3,13,9,10,42,42,0,48
St Gallen,2129,4,15,3,14,45,54,-9,48
FC Zürich,2129,5,12,9,11,40,34,6,45
FC Lugano,2129,6,11,5,16,31,50,-19,38
Grasshoppers,2129,7,8,8,16,39,50,-11,32
FC Thun,2129,8,8,7,17,41,58,-17,31
FC Sion,2129,9,5,9,18,39,58,-19,24
Young Boys,2130,1,22,6,4,72,34,38,72
FC Basel,2130,2,19,7,6,54,26,28,64
St Gallen,2130,3,15,2,15,42,55,-13,47
Lucerne,2130,4,12,7,13,40,49,-9,43
FC Lugano,2130,5,12,5,15,33,45,-12,41
FC Zürich,2130,6,10,9,13,45,40,5,39
FC Thun,2130,7,11,5,16,51,61,-10,38
Grasshoppers,2130,8,9,7,16,43,54,-11,34
FC Sion,2130,9,6,8,18,45,61,-16,26
Young Boys,2131,1,20,6,6,69,42,27,66
FC Basel,2131,2,19,8,5,53,22,31,65
Lucerne,2131,3,14,7,11,45,44,1,49
St Gallen,2131,4,15,3,14,45,53,-8,48
FC Zürich,2131,5,9,11,12,38,39,-1,38
Grasshoppers,2131,6,10,7,15,42,50,-8,37
FC Thun,2131,7,10,6,16,47,57,-10,36
FC Lugano,2131,8,10,6,16,31,48,-17,36
FC Sion,2131,9,6,8,18,42,57,-15,26
Young Boys,2132,1,20,7,5,69,38,31,67
FC Basel,2132,2,18,8,6,53,25,28,62
St Gallen,2132,3,16,3,13,45,53,-8,51
Lucerne,2132,4,13,9,10,44,45,-1,48
FC Zürich,2132,5,10,10,12,42,35,7,40
Grasshoppers,2132,6,11,7,14,48,47,1,40
FC Lugano,2132,7,9,6,17,28,49,-21,33
FC Thun,2132,8,9,5,18,43,63,-20,32
FC Sion,2132,9,7,7,18,39,56,-17,28
Young Boys,2133,1,23,6,3,76,35,41,75
FC Basel,2133,2,18,7,7,55,26,29,61
St Gallen,2133,3,15,3,14,46,53,-7,48
Lucerne,2133,4,12,7,13,38,45,-7,43
FC Zürich,2133,5,10,10,12,38,35,3,40
FC Lugano,2133,6,11,6,15,30,47,-17,39
Grasshoppers,2133,7,10,6,16,42,49,-7,36
FC Thun,2133,8,9,6,17,40,60,-20,33
FC Sion,2133,9,6,9,17,39,54,-15,27
Young Boys,2134,1,21,7,4,70,35,35,70
FC Basel,2134,2,17,8,7,52,26,26,59
Lucerne,2134,3,14,8,10,40,40,0,50
FC Zürich,2134,4,11,11,10,39,33,6,44
St Gallen,2134,5,13,4,15,43,58,-15,43
FC Lugano,2134,6,11,5,16,36,49,-13,38
Grasshoppers,2134,7,9,7,16,40,51,-11,34
FC Sion,2134,8,7,10,15,41,51,-10,31
FC Thun,2134,9,8,6,18,42,60,-18,30
Young Boys,2135,1,20,8,4,70,37,33,68
FC Basel,2135,2,17,9,6,55,28,27,60
St Gallen,2135,3,15,3,14,44,55,-11,48
Lucerne,2135,4,12,8,12,39,44,-5,44
FC Zürich,2135,5,11,10,11,44,39,5,43
Grasshoppers,2135,6,10,8,14,46,48,-2,38
FC Lugano,2135,7,10,6,16,32,49,-17,36
FC Thun,2135,8,8,8,16,42,59,-17,32
FC Sion,2135,9,7,8,17,41,54,-13,29
Young Boys,2136,1,23,7,2,80,35,45,76
FC Basel,2136,2,18,7,7,56,26,30,61
St Gallen,2136,3,14,3,15,45,58,-13,45
FC Zürich,2136,4,11,11,10,42,35,7,44
Lucerne,2136,5,11,8,13,42,53,-11,41
Grasshoppers,2136,6,10,7,15,42,49,-7,37
FC Lugano,2136,7,10,6,16,36,55,-19,36
FC Sion,2136,8,7,9,16,43,55,-12,30
FC Thun,2136,9,8,6,18,44,64,-20,30
Young Boys,2137,1,23,7,2,74,35,39,76
FC Basel,2137,2,17,8,7,51,27,24,59
St Gallen,2137,3,14,4,14,41,53,-12,46
Lucerne,2137,4,12,8,12,39,42,-3,44
FC Zürich,2137,5,10,10,12,41,41,0,40
FC Lugano,2137,6,11,5,16,36,47,-11,38
FC Thun,2137,7,10,5,17,45,59,-14,35
Grasshoppers,2137,8,9,6,17,39,50,-11,33
FC Sion,2137,9,7,9,16,43,55,-12,30
Young Boys,2138,1,22,8,2,71,34,37,74
FC Basel,2138,2,18,9,5,55,26,29,63
St Gallen,2138,3,14,3,15,41,55,-14,45
Lucerne,2138,4,12,7,13,40,44,-4,43
FC Lugano,2138,5,12,5,15,32,45,-13,41
FC Zürich,2138,6,10,10,12,42,38,4,40
FC Sion,2138,7,8,8,16,44,52,-8,32
FC Thun,2138,8,9,5,18,42,60,-18,32
Grasshoppers,2138,9,8,7,17,40,53,-13,31
Young Boys,2139,1,24,6,2,77,30,47,78
FC Basel,2139,2,18,8,6,56,24,32,62
FC Zürich,2139,3,11,11,10,39,33,6,44
Lucerne,2139,4,12,8,12,42,51,-9,44
St Gallen,2139,5,13,2,17,40,64,-24,41
FC Lugano,2139,6,11,6,15,33,45,-12,39
Grasshoppers,2139,7,10,7,15,42,49,-7,37
FC Thun,2139,8,9,5,18,41,59,-18,32
FC Sion,2139,9,6,7,19,41,56,-15,25
Young Boys,2140,1,21,8,3,71,35,36,71
FC Basel,2140,2,17,8,7,54,28,26,59
FC Zürich,2140,3,13,9,10,44,33,11,48
Lucerne,2140,4,12,10,10,44,44,0,46
St Gallen,2140,5,13,4,15,41,56,-15,43
Grasshoppers,2140,6,10,6,16,40,49,-9,36
FC Lugano,2140,7,10,6,16,31,50,-19,36
FC Thun,2140,8,10,5,17,46,58,-12,35
FC Sion,2140,9,6,8,18,41,59,-18,26
Young Boys,2141,1,22,8,2,75,32,43,74
FC Basel,2141,2,17,9,6,53,26,27,60
St Gallen,2141,3,16,2,14,46,53,-7,50
FC Zürich,2141,4,11,10,11,43,36,7,43
Lucerne,2141,5,11,9,12,39,44,-5,42
Grasshoppers,2141,6,11,6,15,42,48,-6,39
FC Lugano,2141,7,10,6,16,31,50,-19,36
FC Thun,2141,8,9,5,18,41,60,-19,32
FC Sion,2141,9,6,7,19,38,59,-21,25
Young Boys,2142,1,23,6,3,74,35,39,75
FC Basel,2142,2,17,9,6,54,28,26,60
St Gallen,2142,3,15,2,15,47,57,-10,47
Lucerne,2142,4,12,8,12,40,42,-2,44
FC Zürich,2142,5,10,10,12,39,37,2,40
Grasshoppers,2142,6,11,6,15,43,47,-4,39
FC Lugano,2142,7,11,5,16,32,49,-17,38
FC Thun,2142,8,8,6,18,40,60,-20,30
FC Sion,2142,9,7,8,17,41,55,-14,29
Young Boys,2143,1,22,7,3,72,35,37,73
FC Basel,2143,2,18,8,6,54,25,29,62
St Gallen,2143,3,15,4,13,44,52,-8,49
FC Zürich,2143,4,12,10,10,41,33,8,46
Lucerne,2143,5,12,8,12,41,45,-4,44
FC Lugano,2143,6,9,8,15,30,47,-17,35
FC Thun,2143,7,9,5,18,40,57,-17,32
Grasshoppers,2143,8,8,6,18,42,57,-15,30
FC Sion,2143,9,7,8,17,41,54,-13,29
Young Boys,2144,1,20,8,4,67,34,33,68
FC Basel,2144,2,19,7,6,54,24,30,64
St Gallen,2144,3,16,2,14,46,54,-8,50
Lucerne,2144,4,13,9,10,40,40,0,48
FC Zürich,2144,5,10,9,13,38,37,1,39
FC Thun,2144,6,11,5,16,47,59,-12,38
FC Lugano,2144,7,10,6,16,32,48,-16,36
Grasshoppers,2144,8,8,6,18,39,52,-13,30
FC Sion,2144,9,7,8,17,37,52,-15,29
Young Boys,2145,1,19,9,4,71,39,32,66
FC Basel,2145,2,19,8,5,60,23,37,65
Lucerne,2145,3,13,7,12,43,44,-1,46
St Gallen,2145,4,14,4,14,41,53,-12,46
FC Zürich,2145,5,10,10,12,41,36,5,40
Grasshoppers,2145,6,10,7,15,44,50,-6,37
FC Lugano,2145,7,10,7,15,30,47,-17,37
FC Thun,2145,8,9,5,18,42,68,-26,32
FC Sion,2145,9,7,9,16,41,53,-12,30
Young Boys,2146,1,20,8,4,70,38,32,68
FC Basel,2146,2,19,7,6,54,24,30,64
St Gallen,2146,3,16,2,14,48,56,-8,50
Lucerne,2146,4,13,7,12,47,47,0,46
FC Zürich,2146,5,10,10,12,39,35,4,40
FC Lugano,2146,6,11,6,15,32,49,-17,39
Grasshoppers,2146,7,9,8,15,41,49,-8,35
FC Thun,2146,8,8,6,18,41,61,-20,30
FC Sion,2146,9,7,8,17,40,53,-13,29
Young Boys,2147,1,21,7,4,76,40,36,70
FC Basel,2147,2,17,8,7,55,28,27,59
Lucerne,2147,3,13,8,11,42,42,0,47
St Gallen,2147,4,15,2,15,41,54,-13,47
FC Zürich,2147,5,11,10,11,46,38,8,43
Grasshoppers,2147,6,11,7,14,47,50,-3,40
FC Lugano,2147,7,10,5,17,31,52,-21,35
FC Thun,2147,8,9,7,16,44,58,-14,34
FC Sion,2147,9,6,8,18,40,60,-20,26
Young Boys,2148,1,22,6,4,76,36,40,72
FC Basel,2148,2,18,8,6,53,27,26,62
Lucerne,2148,3,13,9,10,46,47,-1,48
FC Zürich,2148,4,12,9,11,44,35,9,45
St Gallen,2148,5,13,2,17,45,61,-16,41
FC Lugano,2148,6,11,6,15,32,47,-15,39
Grasshoppers,2148,7,10,7,15,44,51,-7,37
FC Thun,2148,8,8,6,18,41,61,-20,30
FC Sion,2148,9,7,7,18,41,57,-16,28
Young Boys,2149,1,21,8,3,75,38,37,71
FC Basel,2149,2,16,10,6,53,26,27,58
St Gallen,2149,3,16,3,13,49,56,-7,51
Lucerne,2149,4,13,8,11,45,46,-1,47
FC Zürich,2149,5,10,10,12,39,36,3,40
FC Thun,2149,6,10,5,17,46,63,-17,35
Grasshoppers,2149,7,9,7,16,43,53,-10,34
FC Lugano,2149,8,9,6,17,33,52,-19,33
FC Sion,2149,9,8,7,17,44,57,-13,31
Young Boys,2150,1,23,7,2,76,33,43,76
FC Basel,2150,2,18,8,6,50,23,27,62
Lucerne,2150,3,13,8,11,44,44,0,47
St Gallen,2150,4,14,2,16,41,57,-16,44
FC Zürich,2150,5,10,10,12,37,34,3,40
FC Thun,2150,6,10,6,16,41,55,-14,36
FC Lugano,2150,7,10,6,16,29,47,-18,36
Grasshoppers,2150,8,9,6,17,41,51,-10,33
FC Sion,2150,9,6,9,17,39,54,-15,27
Young Boys,2151,1,21,8,3,68,31,37,71
FC Basel,2151,2,16,10,6,47,23,24,58
Lucerne,2151,3,13,8,11,42,45,-3,47
St Gallen,2151,4,14,3,15,43,57,-14,45
FC Zürich,2151,5,11,9,12,41,37,4,42
Grasshoppers,2151,6,10,6,16,40,49,-9,36
FC Lugano,2151,7,10,6,16,31,45,-14,36
FC Sion,2151,8,9,7,16,46,55,-9,34
FC Thun,2151,9,9,5,18,45,61,-16,32
Young Boys,2152,1,21,7,4,68,36,32,70
FC Basel,2152,2,15,11,6,49,25,24,56
St Gallen,2152,3,15,4,13,44,50,-6,49
Lucerne,2152,4,12,9,11,38,42,-4,45
FC Lugano,2152,5,11,6,15,30,44,-14,39
FC Zürich,2152,6,9,11,12,39,39,0,38
Grasshoppers,2152,7,9,8,15,43,48,-5,35
FC Thun,2152,8,9,7,16,44,57,-13,34
FC Sion,2152,9,7,9,16,40,54,-14,30
Young Boys,2153,1,23,6,3,77,37,40,75
FC Basel,2153,2,19,7,6,53,22,31,64
FC Zürich,2153,3,12,9,11,45,37,8,45
St Gallen,2153,4,14,2,16,43,55,-12,44
Lucerne,2153,5,12,7,13,42,49,-7,43
FC Lugano,2153,6,11,5,16,35,49,-14,38
FC Thun,2153,7,10,5,17,44,60,-16,35
Grasshoppers,2153,8,8,7,17,40,53,-13,31
FC Sion,2153,9,7,8,17,41,58,-17,29
Young Boys,2154,1,20,8,4,72,38,34,68
FC Basel,2154,2,19,7,6,56,24,32,64
Lucerne,2154,3,13,9,10,44,47,-3,48
St Gallen,2154,4,15,2,15,44,58,-14,47
FC Zürich,2154,5,10,10,12,40,38,2,40
FC Lugano,2154,6,11,5,16,39,50,-11,38
Grasshoppers,2154,7,10,7,15,43,50,-7,37
FC Thun,2154,8,9,6,17,43,60,-17,33
FC Sion,2154,9,6,8,18,40,56,-16,26
Young Boys,2155,1,22,8,2,73,36,37,74
FC Basel,2155,2,17,9,6,55,26,29,60
St Gallen,2155,3,16,2,14,41,51,-10,50
Lucerne,2155,4,11,9,12,39,43,-4,42
FC Zürich,2155,5,10,10,12,42,41,1,40
FC Thun,2155,6,10,5,17,46,61,-15,35
FC Lugano,2155,7,9,8,15,31,47,-16,35
Grasshoppers,2155,8,9,7,16,41,51,-10,34
FC Sion,2155,9,7,8,17,45,57,-12,29
Young Boys,2156,1,22,8,2,72,33,39,74
FC Basel,2156,2,16,9,7,48,24,24,57
St Gallen,2156,3,15,2,15,43,54,-11,47
Lucerne,2156,4,13,7,12,41,46,-5,46
FC Zürich,2156,5,11,9,12,42,39,3,42
Grasshoppers,2156,6,11,6,15,46,49,-3,39
FC Thun,2156,7,10,6,16,43,57,-14,36
FC Lugano,2156,8,10,5,17,32,47,-15,35
FC Sion,2156,9,6,8,18,39,57,-18,26
Young Boys,2157,1,24,6,2,71,30,41,78
FC Basel,2157,2,19,7,6,54,23,31,64
St Gallen,2157,3,16,2,14,47,53,-6,50
Lucerne,2157,4,13,7,12,42,44,-2,46
FC Zürich,2157,5,10,10,12,40,37,3,40
Grasshoppers,2157,6,10,6,16,43,51,-8,36
FC Thun,2157,7,9,6,17,42,60,-18,33
FC Lugano,2157,8,9,5,18,31,51,-20,32
FC Sion,2157,9,5,9,18,36,57,-21,24
Young Boys,2158,1,22,7,3,67,31,36,73
FC Basel,2158,2,15,10,7,50,28,22,55
Lucerne,2158,3,13,9,10,45,44,1,48
St Gallen,2158,4,14,3,15,41,52,-11,45
FC Zürich,2158,5,11,11,10,43,35,8,44
FC Lugano,2158,6,10,7,15,32,47,-15,37
FC Sion,2158,7,9,7,16,39,49,-10,34
Grasshoppers,2158,8,9,6,17,39,50,-11,33
FC Thun,2158,9,8,6,18,40,60,-20,30
Young Boys,2159,1,19,8,5,67,39,28,65
FC Basel,2159,2,17,10,5,55,24,31,61
Lucerne,2159,3,14,8,10,42,39,3,50
St Gallen,2159,4,14,4,14,41,52,-11,46
FC Zürich,2159,5,12,9,11,42,35,7,45
Grasshoppers,2159,6,11,7,14,42,47,-5,40
FC Lugano,2159,7,9,7,16,30,48,-18,34
FC Thun,2159,8,9,6,17,42,62,-20,33
FC Sion,2159,9,6,7,19,39,54,-15,25
Young Boys,2160,1,22,7,3,72,33,39,73
FC Basel,2160,2,16,9,7,51,28,23,57
St Gallen,2160,3,16,2,14,47,56,-9,50
Lucerne,2160,4,12,8,12,43,46,-3,44
FC Zürich,2160,5,10,11,11,41,37,4,41
FC Thun,2160,6,10,7,15,46,58,-12,37
FC Lugano,2160,7,10,6,16,34,51,-17,36
Grasshoppers,2160,8,9,6,17,42,53,-11,33
FC Sion,2160,9,7,8,17,39,53,-14,29
Young Boys,2161,1,20,8,4,71,38,33,68
FC Basel,2161,2,19,7,6,52,24,28,64
St Gallen,2161,3,16,2,14,45,51,-6,50
Lucerne,2161,4,13,7,12,41,45,-4,46
FC Zürich,2161,5,10,9,13,39,39,0,39
FC Thun,2161,6,11,5,16,42,55,-13,38
FC Lugano,2161,7,10,6,16,31,46,-15,36
Grasshoppers,2161,8,9,6,17,40,51,-11,33
FC Sion,2161,9,7,8,17,44,56,-12,29
Young Boys,2162,1,21,7,4,68,35,33,70
FC Basel,2162,2,17,8,7,53,25,28,59
St Gallen,2162,3,15,3,14,42,53,-11,48
Lucerne,2162,4,13,8,11,40,42,-2,47
FC Zürich,2162,5,11,10,11,43,35,8,43
Grasshoppers,2162,6,10,8,14,41,45,-4,38
FC Thun,2162,7,10,7,15,43,56,-13,37
FC Lugano,2162,8,9,5,18,28,50,-22,32
FC Sion,2162,9,5,10,17,41,58,-17,25
Young Boys,2163,1,21,7,4,71,36,35,70
FC Basel,2163,2,17,7,8,53,30,23,58
Lucerne,2163,3,13,9,10,43,41,2,48
St Gallen,2163,4,15,2,15,45,55,-10,47
FC Zürich,2163,5,11,10,11,43,38,5,43
FC Thun,2163,6,10,6,16,47,60,-13,36
FC Lugano,2163,7,10,6,16,29,46,-17,36
Grasshoppers,2163,8,8,8,16,40,53,-13,32
FC Sion,2163,9,6,11,15,42,54,-12,29
Young Boys,2164,1,20,9,3,72,37,35,69
FC Basel,2164,2,15,11,6,51,27,24,56
St Gallen,2164,3,15,4,13,43,51,-8,49
Lucerne,2164,4,12,9,11,44,46,-2,45
FC Zürich,2164,5,11,11,10,39,33,6,44
Grasshoppers,2164,6,10,8,14,45,50,-5,38
FC Lugano,2164,7,10,6,16,31,48,-17,36
FC Thun,2164,8,8,7,17,43,61,-18,31
FC Sion,2164,9,7,7,18,38,53,-15,28
Young Boys,2165,1,21,8,3,71,36,35,71
FC Basel,2165,2,16,9,7,52,31,21,57
St Gallen,2165,3,15,3,14,46,54,-8,48
Lucerne,2165,4,12,9,11,44,48,-4,45
FC Zürich,2165,5,11,10,11,45,37,8,43
Grasshoppers,2165,6,11,7,14,44,49,-5,40
FC Lugano,2165,7,10,6,16,31,47,-16,36
FC Thun,2165,8,8,6,18,41,62,-21,30
FC Sion,2165,9,7,8,17,44,54,-10,29
Young Boys,2166,1,21,8,3,71,32,39,71
FC Basel,2166,2,17,9,6,51,24,27,60
St Gallen,2166,3,15,3,14,44,54,-10,48
Lucerne,2166,4,11,11,10,41,44,-3,44
FC Zürich,2166,5,10,10,12,40,36,4,40
FC Thun,2166,6,11,6,15,46,57,-11,39
FC Lugano,2166,7,9,9,14,30,45,-15,36
Grasshoppers,2166,8,8,7,17,40,53,-13,31
FC Sion,2166,9,7,7,18,41,59,-18,28
FC Basel,2167,1,19,8,5,56,21,35,65
Young Boys,2167,2,19,8,5,68,41,27,65
Lucerne,2167,3,13,9,10,43,42,1,48
St Gallen,2167,4,15,2,15,42,55,-13,47
FC Zürich,2167,5,11,9,12,40,40,0,42
Grasshoppers,2167,6,10,7,15,43,49,-6,37
FC Thun,2167,7,9,6,17,44,59,-15,33
FC Lugano,2167,8,9,6,17,34,53,-19,33
FC Sion,2167,9,8,7,17,44,54,-10,31
Young Boys,2168,1,22,6,4,71,37,34,72
FC Basel,2168,2,18,9,5,55,26,29,63
Lucerne,2168,3,13,9,10,47,43,4,48
St Gallen,2168,4,14,5,13,45,54,-9,47
FC Zürich,2168,5,11,11,10,43,35,8,44
Grasshoppers,2168,6,9,8,15,49,55,-6,35
FC Thun,2168,7,9,6,17,43,59,-16,33
FC Lugano,2168,8,9,6,17,32,53,-21,33
FC Sion,2168,9,5,8,19,38,61,-23,23
Young Boys,2169,1,21,8,3,72,34,38,71
FC Basel,2169,2,16,10,6,52,24,28,58
Lucerne,2169,3,12,8,12,39,46,-7,44
St Gallen,2169,4,13,4,15,40,53,-13,43
FC Zürich,2169,5,10,10,12,39,36,3,40
Grasshoppers,2169,6,10,8,14,44,48,-4,38
FC Lugano,2169,7,11,5,16,31,48,-17,38
FC Thun,2169,8,9,7,16,42,57,-15,34
FC Sion,2169,9,8,8,16,43,56,-13,32
Young Boys,2170,1,24,6,2,73,30,43,78
FC Basel,2170,2,16,8,8,50,28,22,56
St Gallen,2170,3,14,4,14,41,52,-11,46
FC Zürich,2170,4,12,9,11,45,37,8,45
Lucerne,2170,5,12,8,12,39,44,-5,44
FC Lugano,2170,6,11,5,16,33,49,-16,38
FC Thun,2170,7,10,6,16,46,58,-12,36
Grasshoppers,2170,8,8,7,17,39,54,-15,31
FC Sion,2170,9,6,9,17,39,53,-14,27
Young Boys,2171,1,20,9,3,70,38,32,69
FC Basel,2171,2,18,8,6,54,25,29,62
St Gallen,2171,3,16,2,14,44,52,-8,50
Lucerne,2171,4,13,7,12,41,41,0,46
FC Zürich,2171,5,11,10,11,43,35,8,43
FC Thun,2171,6,9,7,16,46,58,-12,34
Grasshoppers,2171,7,9,7,16,39,53,-14,34
FC Lugano,2171,8,9,6,17,28,50,-22,33
FC Sion,2171,9,6,10,16,40,53,-13,28
Young Boys,2172,1,20,6,6,70,43,27,66
FC Basel,2172,2,18,8,6,55,24,31,62
St Gallen,2172,3,15,3,14,43,52,-9,48
Lucerne,2172,4,12,8,12,42,47,-5,44
FC Zürich,2172,5,10,11,11,40,36,4,41
Grasshoppers,2172,6,11,6,15,45,50,-5,39
FC Lugano,2172,7,10,8,14,33,47,-14,38
FC Thun,2172,8,10,5,17,42,58,-16,35
FC Sion,2172,9,7,7,18,41,54,-13,28
Young Boys,2173,1,21,6,5,71,38,33,69
FC Basel,2173,2,19,8,5,61,24,37,65
Lucerne,2173,3,14,7,11,41,47,-6,49
St Gallen,2173,4,15,4,13,43,51,-8,49
FC Zürich,2173,5,10,10,12,43,42,1,40
FC Lugano,2173,6,10,6,16,33,49,-16,36
FC Thun,2173,7,10,5,17,44,60,-16,35
Grasshoppers,2173,8,9,6,17,40,49,-9,33
FC Sion,2173,9,6,8,18,38,54,-16,26
Young Boys,2174,1,21,7,4,71,38,33,70
FC Basel,2174,2,16,9,7,49,26,23,57
Lucerne,2174,3,14,9,9,43,38,5,51
St Gallen,2174,4,14,4,14,45,55,-10,46
FC Zürich,2174,5,11,10,11,41,36,5,43
FC Lugano,2174,6,10,6,16,33,51,-18,36
Grasshoppers,2174,7,9,8,15,42,48,-6,35
FC Thun,2174,8,10,5,17,43,57,-14,35
FC Sion,2174,9,6,8,18,41,59,-18,26
Young Boys,2175,1,22,6,4,73,35,38,72
FC Basel,2175,2,19,8,5,58,24,34,65
St Gallen,2175,3,16,2,14,44,53,-9,50
FC Zürich,2175,4,11,9,12,39,37,2,42
Lucerne,2175,5,11,9,12,42,46,-4,42
FC Thun,2175,6,11,5,16,45,58,-13,38
Grasshoppers,2175,7,10,6,16,42,51,-9,36
FC Lugano,2175,8,9,6,17,31,50,-19,33
FC Sion,2175,9,6,7,19,37,57,-20,25
Young Boys,2176,1,21,7,4,72,36,36,70
FC Basel,2176,2,17,8,7,53,26,27,59
St Gallen,2176,3,15,3,14,43,53,-10,48
Lucerne,2176,4,12,11,9,42,41,1,47
FC Zürich,2176,5,11,9,12,41,38,3,42
FC Thun,2176,6,11,5,16,46,59,-13,38
FC Lugano,2176,7,10,5,17,30,49,-19,35
Grasshoppers,2176,8,9,7,16,39,50,-11,34
FC Sion,2176,9,7,7,18,42,56,-14,28
Young Boys,2177,1,21,6,5,71,35,36,69
FC Basel,2177,2,18,8,6,55,25,30,62
St Gallen,2177,3,16,3,13,45,51,-6,51
Lucerne,2177,4,12,9,11,39,45,-6,45
FC Zürich,2177,5,11,10,11,41,38,3,43
Grasshoppers,2177,6,10,7,15,43,50,-7,37
FC Lugano,2177,7,10,6,16,30,46,-16,36
FC Thun,2177,8,9,6,17,44,61,-17,33
FC Sion,2177,9,5,9,18,40,57,-17,24
Young Boys,2178,1,20,8,4,72,39,33,68
FC Basel,2178,2,19,8,5,55,23,32,65
St Gallen,2178,3,14,4,14,44,56,-12,46
Lucerne,2178,4,12,8,12,39,44,-5,44
FC Zürich,2178,5,9,11,12,41,40,1,38
Grasshoppers,2178,6,10,8,14,46,48,-2,38
FC Lugano,2178,7,9,8,15,33,49,-16,35
FC Thun,2178,8,9,6,17,45,61,-16,33
FC Sion,2178,9,7,9,16,43,58,-15,30
Young Boys,2179,1,21,7,4,70,35,35,70
FC Basel,2179,2,16,8,8,47,28,19,56
Lucerne,2179,3,14,7,11,47,45,2,49
St Gallen,2179,4,15,2,15,44,55,-11,47
FC Zürich,2179,5,11,9,12,44,37,7,42
FC Thun,2179,6,11,6,15,43,54,-11,39
FC Lugano,2179,7,11,5,16,36,53,-17,38
Grasshoppers,2179,8,10,6,16,42,47,-5,36
FC Sion,2179,9,6,8,18,38,57,-19,26
Young Boys,2180,1,23,7,2,77,31,46,76
FC Basel,2180,2,16,9,7,50,27,23,57
St Gallen,2180,3,15,2,15,43,55,-12,47
Lucerne,2180,4,13,7,12,45,51,-6,46
FC Zürich,2180,5,11,11,10,43,36,7,44
FC Lugano,2180,6,11,6,15,34,45,-11,39
FC Thun,2180,7,10,5,17,46,61,-15,35
Grasshoppers,2180,8,9,6,17,42,56,-14,33
FC Sion,2180,9,6,7,19,42,60,-18,25
Young Boys,2181,1,22,6,4,72,36,36,72
FC Basel,2181,2,19,7,6,57,27,30,64
Lucerne,2181,3,13,9,10,42,41,1,48
St Gallen,2181,4,13,4,15,45,59,-14,43
Grasshoppers,2181,5,11,7,14,44,49,-5,40
FC Zürich,2181,6,9,11,12,38,36,2,38
FC Lugano,2181,7,10,6,16,30,47,-17,36
FC Thun,2181,8,10,5,17,44,60,-16,35
FC Sion,2181,9,5,9,18,39,56,-17,24
Young Boys,2182,1,23,6,3,75,33,42,75
FC Basel,2182,2,19,8,5,55,25,30,65
St Gallen,2182,3,16,2,14,47,54,-7,50
Lucerne,2182,4,12,8,12,41,47,-6,44
FC Zürich,2182,5,10,9,13,40,40,0,39
FC Thun,2182,6,11,5,16,48,56,-8,38
Grasshoppers,2182,7,10,6,16,41,50,-9,36
FC Lugano,2182,8,9,5,18,29,52,-23,32
FC Sion,2182,9,6,7,19,41,60,-19,25
Young Boys,2183,1,22,7,3,69,31,38,73
FC Basel,2183,2,19,7,6,55,25,30,64
Lucerne,2183,3,14,8,10,42,40,2,50
St Gallen,2183,4,14,2,16,42,57,-15,44
FC Zürich,2183,5,10,11,11,41,38,3,41
FC Lugano,2183,6,10,6,16,30,46,-16,36
Grasshoppers,2183,7,9,7,16,40,50,-10,34
FC Thun,2183,8,8,6,18,41,60,-19,30
FC Sion,2183,9,6,10,16,41,54,-13,28
Young Boys,2184,1,21,7,4,68,35,33,70
FC Basel,2184,2,18,8,6,54,25,29,62
FC Zürich,2184,3,11,11,10,43,37,6,44
Lucerne,2184,4,11,10,11,39,43,-4,43
St Gallen,2184,5,13,4,15,41,56,-15,43
Grasshoppers,2184,6,11,7,14,44,46,-2,40
FC Lugano,2184,7,10,7,15,32,48,-16,37
FC Thun,2184,8,9,5,18,42,59,-17,32
FC Sion,2184,9,6,9,17,40,54,-14,27
Young Boys,2185,1,23,6,3,78,35,43,75
FC Basel,2185,2,17,7,8,52,31,21,58
St Gallen,2185,3,14,4,14,45,54,-9,46
FC Zürich,2185,4,12,9,11,43,33,10,45
Lucerne,2185,5,11,10,11,39,43,-4,43
Grasshoppers,2185,6,10,7,15,43,49,-6,37
FC Thun,2185,7,10,6,16,42,56,-14,36
FC Lugano,2185,8,10,6,16,31,51,-20,36
FC Sion,2185,9,5,9,18,38,59,-21,24
Young Boys,2186,1,21,8,3,70,34,36,71
FC Basel,2186,2,18,8,6,59,27,32,62
St Gallen,2186,3,15,4,13,44,53,-9,49
Lucerne,2186,4,12,10,10,42,44,-2,46
FC Zürich,2186,5,10,11,11,39,37,2,41
Grasshoppers,2186,6,10,7,15,45,49,-4,37
FC Lugano,2186,7,9,6,17,29,48,-19,33
FC Thun,2186,8,9,5,18,45,63,-18,32
FC Sion,2186,9,6,9,17,38,56,-18,27
Young Boys,2187,1,21,7,4,69,40,29,70
FC Basel,2187,2,16,8,8,54,28,26,56
St Gallen,2187,3,15,4,13,46,55,-9,49
Lucerne,2187,4,12,8,12,39,46,-7,44
FC Zürich,2187,5,10,10,12,42,40,2,40
FC Lugano,2187,6,11,6,15,38,49,-11,39
FC Thun,2187,7,10,6,16,46,59,-13,36
Grasshoppers,2187,8,9,7,16,41,49,-8,34
FC Sion,2187,9,8,8,16,45,54,-9,32
Young Boys,2188,1,22,6,4,74,38,36,72
FC Basel,2188,2,18,8,6,58,28,30,62
St Gallen,2188,3,14,3,15,43,54,-11,45
Lucerne,2188,4,12,7,13,39,49,-10,43
FC Zürich,2188,5,11,9,12,44,40,4,42
Grasshoppers,2188,6,11,7,14,44,47,-3,40
FC Lugano,2188,7,11,5,16,31,46,-15,38
FC Thun,2188,8,10,5,17,47,59,-12,35
FC Sion,2188,9,6,8,18,40,59,-19,26
Young Boys,2189,1,23,6,3,78,36,42,75
FC Basel,2189,2,18,7,7,57,29,28,61
FC Zürich,2189,3,12,10,10,39,32,7,46
St Gallen,2189,4,14,3,15,44,56,-12,45
Lucerne,2189,5,12,8,12,41,48,-7,44
Grasshoppers,2189,6,10,8,14,41,47,-6,38
FC Lugano,2189,7,9,6,17,31,49,-18,33
FC Thun,2189,8,9,5,18,43,61,-18,32
FC Sion,2189,9,6,9,17,40,56,-16,27
Young Boys,2190,1,24,6,2,74,31,43,78
FC Basel,2190,2,19,7,6,55,25,30,64
St Gallen,2190,3,14,3,15,42,53,-11,45
Lucerne,2190,4,12,7,13,42,48,-6,43
FC Zürich,2190,5,10,10,12,39,36,3,40
Grasshoppers,2190,6,11,6,15,43,51,-8,39
FC Lugano,2190,7,10,6,16,29,46,-17,36
FC Thun,2190,8,9,6,17,43,61,-18,33
FC Sion,2190,9,6,7,19,39,55,-16,25
Young Boys,2191,1,22,8,2,72,32,40,74
FC Basel,2191,2,17,8,7,51,26,25,59
St Gallen,2191,3,15,2,15,40,54,-14,47
Lucerne,2191,4,12,8,12,39,43,-4,44
FC Zürich,2191,5,10,10,12,39,36,3,40
FC Thun,2191,6,11,6,15,50,57,-7,39
FC Lugano,2191,7,11,6,15,30,44,-14,39
Grasshoppers,2191,8,8,7,17,38,54,-16,31
FC Sion,2191,9,7,7,18,42,55,-13,28
Young Boys,2192,1,20,7,5,71,41,30,67
FC Basel,2192,2,17,8,7,53,26,27,59
St Gallen,2192,3,15,2,15,44,58,-14,47
Lucerne,2192,4,13,7,12,42,43,-1,46
FC Zürich,2192,5,11,9,12,40,35,5,42
FC Lugano,2192,6,12,5,15,34,46,-12,41
Grasshoppers,2192,7,10,7,15,43,48,-5,37
FC Thun,2192,8,9,7,16,42,57,-15,34
FC Sion,2192,9,7,8,17,40,55,-15,29
Young Boys,2193,1,22,7,3,72,38,34,73
FC Basel,2193,2,20,7,5,63,27,36,67
Lucerne,2193,3,13,8,11,47,45,2,47
St Gallen,2193,4,15,2,15,44,59,-15,47
FC Zürich,2193,5,11,9,12,41,38,3,42
Grasshoppers,2193,6,9,7,16,39,49,-10,34
FC Sion,2193,7,8,8,16,43,50,-7,32
FC Lugano,2193,8,9,5,18,30,52,-22,32
FC Thun,2193,9,8,5,19,41,62,-21,29
Young Boys,2194,1,23,6,3,78,40,38,75
FC Basel,2194,2,18,7,7,56,28,28,61
St Gallen,2194,3,15,2,15,44,54,-10,47
Lucerne,2194,4,12,8,12,46,49,-3,44
FC Zürich,2194,5,11,9,12,41,35,6,42
FC Thun,2194,6,10,6,16,46,61,-15,36
FC Lugano,2194,7,10,5,17,31,52,-21,35
Grasshoppers,2194,8,8,8,16,45,56,-11,32
FC Sion,2194,9,8,7,17,43,55,-12,31
Young Boys,2195,1,22,7,3,73,33,40,73
FC Basel,2195,2,17,9,6,56,31,25,60
St Gallen,2195,3,15,3,14,48,55,-7,48
FC Zürich,2195,4,11,10,11,42,36,6,43
Lucerne,2195,5,11,10,11,41,47,-6,43
FC Lugano,2195,6,10,7,15,30,46,-16,37
Grasshoppers,2195,7,10,6,16,40,53,-13,36
FC Thun,2195,8,10,5,17,47,61,-14,35
FC Sion,2195,9,6,7,19,40,55,-15,25
Young Boys,2196,1,23,6,3,69,30,39,75
FC Basel,2196,2,15,8,9,48,28,20,53
St Gallen,2196,3,15,2,15,44,54,-10,47
Lucerne,2196,4,13,7,12,41,44,-3,46
FC Zürich,2196,5,10,10,12,38,38,0,40
FC Lugano,2196,6,11,5,16,33,46,-13,38
Grasshoppers,2196,7,10,7,15,41,48,-7,37
FC Thun,2196,8,9,7,16,42,57,-15,34
FC Sion,2196,9,7,10,15,40,51,-11,31
Young Boys,2197,1,21,9,2,72,35,37,72
FC Basel,2197,2,17,9,6,53,26,27,60
St Gallen,2197,3,15,3,14,45,56,-11,48
Lucerne,2197,4,11,10,11,37,41,-4,43
FC Zürich,2197,5,10,11,11,41,36,5,41
FC Lugano,2197,6,10,7,15,32,47,-15,37
Grasshoppers,2197,7,9,8,15,39,48,-9,35
FC Sion,2197,8,7,9,16,44,54,-10,30
FC Thun,2197,9,8,6,18,41,61,-20,30
Young Boys,2198,1,21,8,3,70,33,37,71
FC Basel,2198,2,19,8,5,56,24,32,65
Lucerne,2198,3,13,8,11,42,42,0,47
St Gallen,2198,4,15,2,15,43,56,-13,47
FC Zürich,2198,5,10,11,11,41,38,3,41
FC Thun,2198,6,10,6,16,46,57,-11,36
Grasshoppers,2198,7,9,6,17,42,55,-13,33
FC Lugano,2198,8,9,6,17,28,50,-22,33
FC Sion,2198,9,6,9,17,42,55,-13,27
Young Boys,2199,1,21,7,4,72,38,34,70
FC Basel,2199,2,16,8,8,49,26,23,56
St Gallen,2199,3,16,2,14,44,54,-10,50
Lucerne,2199,4,13,8,11,40,42,-2,47
FC Zürich,2199,5,11,9,12,42,38,4,42
FC Thun,2199,6,10,7,15,44,55,-11,37
FC Sion,2199,7,8,9,15,46,53,-7,33
Grasshoppers,2199,8,9,6,17,42,54,-12,33
FC Lugano,2199,9,9,6,17,31,50,-19,33
Young Boys,2200,1,21,8,3,71,36,35,71
FC Basel,2200,2,17,8,7,52,27,25,59
Lucerne,2200,3,13,9,10,44,44,0,48
FC Zürich,2200,4,11,10,11,42,35,7,43
St Gallen,2200,5,13,4,15,43,58,-15,43
FC Thun,2200,6,10,6,16,45,57,-12,36
FC Lugano,2200,7,10,6,16,32,46,-14,36
Grasshoppers,2200,8,8,8,16,40,50,-10,32
FC Sion,2200,9,8,7,17,39,55,-16,31
Young Boys,2201,1,20,9,3,70,38,32,69
FC Basel,2201,2,19,8,5,58,24,34,65
St Gallen,2201,3,15,2,15,46,58,-12,47
Lucerne,2201,4,12,8,12,41,45,-4,44
FC Zürich,2201,5,11,10,11,41,36,5,43
FC Lugano,2201,6,11,5,16,37,49,-12,38
FC Thun,2201,7,10,5,17,42,59,-17,35
Grasshoppers,2201,8,9,7,16,42,52,-10,34
FC Sion,2201,9,6,8,18,41,57,-16,26
Young Boys,2202,1,24,6,2,73,31,42,78
FC Basel,2202,2,17,9,6,51,25,26,60
St Gallen,2202,3,15,2,15,43,53,-10,47
Lucerne,2202,4,12,8,12,40,43,-3,44
FC Lugano,2202,5,12,5,15,33,48,-15,41
FC Zürich,2202,6,9,10,13,39,41,-2,37
Grasshoppers,2202,7,9,6,17,43,55,-12,33
FC Thun,2202,8,9,6,17,44,58,-14,33
FC Sion,2202,9,7,8,17,40,52,-12,29
Young Boys,2203,1,21,6,5,70,38,32,69
FC Basel,2203,2,19,8,5,60,25,35,65
St Gallen,2203,3,15,3,14,42,53,-11,48
Lucerne,2203,4,11,9,12,41,48,-7,42
FC Zürich,2203,5,9,11,12,42,40,2,38
Grasshoppers,2203,6,10,7,15,41,46,-5,37
FC Thun,2203,7,10,6,16,44,61,-17,36
FC Lugano,2203,8,9,8,15,31,47,-16,35
FC Sion,2203,9,6,10,16,37,50,-13,28
Young Boys,2204,1,24,6,2,73,34,39,78
FC Basel,2204,2,15,10,7,52,30,22,55
St Gallen,2204,3,17,2,13,45,50,-5,53
Lucerne,2204,4,13,8,11,40,41,-1,47
FC Zürich,2204,5,11,10,11,42,36,6,43
FC Thun,2204,6,10,6,16,43,57,-14,36
FC Lugano,2204,7,10,5,17,29,47,-18,35
Grasshoppers,2204,8,8,6,18,39,52,-13,30
FC Sion,2204,9,6,7,19,43,59,-16,25
FC Basel,2205,1,20,7,5,58,24,34,67
Young Boys,2205,2,19,8,5,68,41,27,65
Lucerne,2205,3,13,9,10,45,46,-1,48
St Gallen,2205,4,13,2,17,42,60,-18,41
FC Lugano,2205,5,11,7,14,34,46,-12,40
FC Zürich,2205,6,10,9,13,39,38,1,39
Grasshoppers,2205,7,10,7,15,45,51,-6,37
FC Sion,2205,8,8,8,16,46,52,-6,32
FC Thun,2205,9,9,5,18,40,59,-19,32
Young Boys,2206,1,23,6,3,71,32,39,75
FC Basel,2206,2,18,8,6,54,27,27,62
St Gallen,2206,3,16,2,14,46,55,-9,50
FC Zürich,2206,4,11,10,11,43,35,8,43
Lucerne,2206,5,12,7,13,40,45,-5,43
Grasshoppers,2206,6,10,6,16,44,50,-6,36
FC Lugano,2206,7,9,5,18,27,52,-25,32
FC Thun,2206,8,8,7,17,44,64,-20,31
FC Sion,2206,9,7,9,16,43,52,-9,30
Young Boys,2207,1,20,10,2,74,34,40,70
FC Basel,2207,2,18,8,6,59,27,32,62
Lucerne,2207,3,13,8,11,46,48,-2,47
FC Zürich,2207,4,11,10,11,40,36,4,43
St Gallen,2207,5,13,4,15,42,57,-15,43
FC Lugano,2207,6,10,7,15,32,50,-18,37
FC Thun,2207,7,10,5,17,44,60,-16,35
Grasshoppers,2207,8,9,7,16,40,52,-12,34
FC Sion,2207,9,6,9,17,38,51,-13,27
Young Boys,2208,1,19,8,5,65,36,29,65
FC Basel,2208,2,18,9,5,51,22,29,63
Lucerne,2208,3,15,7,10,47,44,3,52
St Gallen,2208,4,13,4,15,40,53,-13,43
FC Zürich,2208,5,10,10,12,39,36,3,40
FC Lugano,2208,6,11,5,16,33,47,-14,38
Grasshoppers,2208,7,9,8,15,43,51,-8,35
FC Thun,2208,8,9,6,17,42,58,-16,33
FC Sion,2208,9,7,9,16,41,54,-13,30
Young Boys,2209,1,21,7,4,71,39,32,70
FC Basel,2209,2,19,8,5,55,24,31,65
St Gallen,2209,3,14,3,15,43,55,-12,45
Lucerne,2209,4,11,9,12,40,46,-6,42
FC Zürich,2209,5,10,11,11,38,35,3,41
Grasshoppers,2209,6,11,6,15,44,49,-5,39
FC Lugano,2209,7,10,7,15,35,49,-14,37
FC Thun,2209,8,8,7,17,42,60,-18,31
FC Sion,2209,9,7,8,17,39,50,-11,29
Young Boys,2210,1,22,7,3,73,37,36,73
FC Basel,2210,2,18,8,6,55,24,31,62
FC Zürich,2210,3,13,9,10,46,34,12,48
St Gallen,2210,4,15,3,14,45,54,-9,48
Lucerne,2210,5,12,7,13,40,45,-5,43
Grasshoppers,2210,6,10,6,16,42,49,-7,36
FC Lugano,2210,7,10,6,16,33,52,-19,36
FC Thun,2210,8,8,6,18,40,62,-22,30
FC Sion,2210,9,6,8,18,38,55,-17,26
Young Boys,2211,1,22,6,4,73,35,38,72
FC Basel,2211,2,18,8,6,58,28,30,62
Lucerne,2211,3,12,8,12,42,46,-4,44
St Gallen,2211,4,13,4,15,41,55,-14,43
FC Zürich,2211,5,10,11,11,42,39,3,41
Grasshoppers,2211,6,11,6,15,42,47,-5,39
FC Lugano,2211,7,10,6,16,32,51,-19,36
FC Thun,2211,8,9,7,16,45,60,-15,34
FC Sion,2211,9,7,8,17,41,55,-14,29
Young Boys,2212,1,20,8,4,66,33,33,68
FC Basel,2212,2,19,8,5,54,23,31,65
Lucerne,2212,3,11,11,10,37,41,-4,44
St Gallen,2212,4,13,4,15,40,54,-14,43
FC Zürich,2212,5,10,11,11,44,37,7,41
FC Lugano,2212,6,11,7,14,35,45,-10,40
Grasshoppers,2212,7,10,7,15,40,48,-8,37
FC Thun,2212,8,10,5,17,43,62,-19,35
FC Sion,2212,9,5,9,18,38,54,-16,24
Young Boys,2213,1,22,7,3,75,33,42,73
FC Basel,2213,2,15,8,9,49,29,20,53
St Gallen,2213,3,16,2,14,44,55,-11,50
Lucerne,2213,4,12,9,11,41,48,-7,45
FC Zürich,2213,5,10,11,11,41,39,2,41
Grasshoppers,2213,6,10,7,15,44,51,-7,37
FC Lugano,2213,7,10,7,15,36,49,-13,37
FC Thun,2213,8,10,5,17,44,58,-14,35
FC Sion,2213,9,7,8,17,42,54,-12,29
Young Boys,2214,1,22,6,4,70,35,35,72
FC Basel,2214,2,20,7,5,54,23,31,67
Lucerne,2214,3,13,8,11,45,44,1,47
FC Zürich,2214,4,12,9,11,41,35,6,45
St Gallen,2214,5,13,3,16,41,55,-14,42
FC Lugano,2214,6,10,5,17,30,49,-19,35
Grasshoppers,2214,7,9,6,17,40,53,-13,33
FC Thun,2214,8,9,5,18,41,58,-17,32
FC Sion,2214,9,8,7,17,43,53,-10,31
Young Boys,2215,1,22,6,4,77,35,42,72
FC Basel,2215,2,19,7,6,59,25,34,64
Lucerne,2215,3,13,8,11,43,48,-5,47
St Gallen,2215,4,14,2,16,44,56,-12,44
FC Zürich,2215,5,10,9,13,41,39,2,39
FC Thun,2215,6,11,5,16,47,57,-10,38
FC Lugano,2215,7,11,5,16,33,52,-19,38
Grasshoppers,2215,8,9,7,16,42,55,-13,34
FC Sion,2215,9,7,7,18,40,59,-19,28
Young Boys,2216,1,22,6,4,73,33,40,72
FC Basel,2216,2,18,8,6,54,24,30,62
FC Zürich,2216,3,12,10,10,42,33,9,46
St Gallen,2216,4,13,5,14,44,58,-14,44
Lucerne,2216,5,11,10,11,38,44,-6,43
Grasshoppers,2216,6,10,7,15,41,49,-8,37
FC Lugano,2216,7,10,6,16,30,48,-18,36
FC Thun,2216,8,9,5,18,40,60,-20,32
FC Sion,2216,9,6,9,17,42,55,-13,27
Young Boys,2217,1,22,7,3,71,36,35,73
FC Basel,2217,2,19,8,5,62,25,37,65
Lucerne,2217,3,12,9,11,43,46,-3,45
St Gallen,2217,4,14,3,15,46,60,-14,45
FC Lugano,2217,5,11,5,16,31,47,-16,38
FC Thun,2217,6,10,7,15,48,59,-11,37
FC Zürich,2217,7,9,9,14,41,42,-1,36
Grasshoppers,2217,8,9,8,15,44,54,-10,35
FC Sion,2217,9,6,8,18,38,55,-17,26
Young Boys,2218,1,23,6,3,72,33,39,75
FC Basel,2218,2,20,7,5,58,23,35,67
Lucerne,2218,3,14,7,11,45,46,-1,49
FC Zürich,2218,4,11,10,11,39,34,5,43
St Gallen,2218,5,13,3,16,45,59,-14,42
Grasshoppers,2218,6,9,7,16,42,50,-8,34
FC Thun,2218,7,9,6,17,43,61,-18,33
FC Lugano,2218,8,9,6,17,32,50,-18,33
FC Sion,2218,9,6,8,18,39,59,-20,26
Young Boys,2219,1,23,7,2,76,31,45,76
FC Basel,2219,2,16,8,8,50,28,22,56
St Gallen,2219,3,15,4,13,44,52,-8,49
Lucerne,2219,4,13,8,11,39,41,-2,47
FC Zürich,2219,5,11,10,11,43,36,7,43
FC Lugano,2219,6,10,6,16,30,48,-18,36
FC Thun,2219,7,9,6,17,40,58,-18,33
FC Sion,2219,8,7,9,16,39,51,-12,30
Grasshoppers,2219,9,8,6,18,37,53,-16,30
Young Boys,2220,1,20,8,4,67,34,33,68
FC Basel,2220,2,18,9,5,53,22,31,63
Lucerne,2220,3,13,9,10,40,39,1,48
St Gallen,2220,4,14,3,15,40,52,-12,45
FC Zürich,2220,5,11,11,10,43,34,9,44
FC Lugano,2220,6,10,6,16,30,47,-17,36
Grasshoppers,2220,7,9,7,16,40,50,-10,34
FC Thun,2220,8,8,7,17,41,60,-19,31
FC Sion,2220,9,7,8,17,40,56,-16,29
Young Boys,2221,1,20,8,4,69,35,34,68
FC Basel,2221,2,19,7,6,58,27,31,64
St Gallen,2221,3,14,3,15,43,55,-12,45
Lucerne,2221,4,12,8,12,44,49,-5,44
FC Zürich,2221,5,10,10,12,41,39,2,40
FC Lugano,2221,6,11,6,15,34,48,-14,39
FC Thun,2221,7,9,7,16,45,61,-16,34
FC Sion,2221,8,8,9,15,41,50,-9,33
Grasshoppers,2221,9,8,8,16,39,50,-11,32
Young Boys,2222,1,22,6,4,71,35,36,72
FC Basel,2222,2,18,9,5,54,25,29,63
Lucerne,2222,3,13,7,12,41,44,-3,46
St Gallen,2222,4,14,3,15,45,56,-11,45
FC Zürich,2222,5,10,11,11,41,37,4,41
Grasshoppers,2222,6,10,7,15,43,50,-7,37
FC Lugano,2222,7,10,5,17,32,50,-18,35
FC Thun,2222,8,9,7,16,43,58,-15,34
FC Sion,2222,9,6,9,17,41,56,-15,27
Young Boys,2223,1,21,7,4,70,38,32,70
FC Basel,2223,2,19,7,6,55,24,31,64
St Gallen,2223,3,16,3,13,45,49,-4,51
Lucerne,2223,4,13,8,11,43,47,-4,47
FC Zürich,2223,5,9,10,13,36,36,0,37
FC Sion,2223,6,9,8,15,47,51,-4,35
FC Thun,2223,7,9,6,17,40,60,-20,33
FC Lugano,2223,8,9,6,17,27,47,-20,33
Grasshoppers,2223,9,8,7,17,38,49,-11,31
Young Boys,2224,1,22,7,3,74,36,38,73
FC Basel,2224,2,17,7,8,54,30,24,58
FC Zürich,2224,3,13,9,10,45,33,12,48
St Gallen,2224,4,15,3,14,45,54,-9,48
Lucerne,2224,5,11,11,10,42,44,-2,44
FC Thun,2224,6,10,5,17,43,61,-18,35
Grasshoppers,2224,7,9,7,16,41,49,-8,34
FC Lugano,2224,8,9,6,17,30,50,-20,33
FC Sion,2224,9,7,7,18,39,56,-17,28
Young Boys,2225,1,21,9,2,70,33,37,72
FC Basel,2225,2,15,10,7,49,26,23,55
Lucerne,2225,3,13,9,10,41,40,1,48
St Gallen,2225,4,14,3,15,42,55,-13,45
FC Zürich,2225,5,10,11,11,40,36,4,41
Grasshoppers,2225,6,9,9,14,42,49,-7,36
FC Thun,2225,7,10,6,16,43,57,-14,36
FC Lugano,2225,8,10,6,16,30,47,-17,36
FC Sion,2225,9,5,11,16,39,53,-14,26
Young Boys,2226,1,21,6,5,71,39,32,69
FC Basel,2226,2,18,8,6,54,24,30,62
Lucerne,2226,3,14,9,9,42,40,2,51
St Gallen,2226,4,13,2,17,41,60,-19,41
FC Zürich,2226,5,10,10,12,40,36,4,40
FC Lugano,2226,6,10,6,16,29,48,-19,36
FC Sion,2226,7,9,8,15,49,53,-4,35
Grasshoppers,2226,8,9,8,15,42,50,-8,35
FC Thun,2226,9,9,5,18,41,59,-18,32
Young Boys,2227,1,21,8,3,72,35,37,71
FC Basel,2227,2,19,8,5,61,25,36,65
FC Zürich,2227,3,12,10,10,44,36,8,46
St Gallen,2227,4,14,4,14,41,55,-14,46
Lucerne,2227,5,12,9,11,45,49,-4,45
Grasshoppers,2227,6,9,8,15,41,49,-8,35
FC Lugano,2227,7,9,6,17,28,47,-19,33
FC Thun,2227,8,8,6,18,40,62,-22,30
FC Sion,2227,9,5,11,16,38,52,-14,26
Young Boys,2228,1,20,7,5,68,38,30,67
FC Basel,2228,2,18,8,6,58,27,31,62
Lucerne,2228,3,16,7,9,45,39,6,55
St Gallen,2228,4,15,2,15,44,54,-10,47
FC Zürich,2228,5,10,10,12,40,37,3,40
Grasshoppers,2228,6,10,7,15,42,49,-7,37
FC Thun,2228,7,9,7,16,43,60,-17,34
FC Lugano,2228,8,9,6,17,27,47,-20,33
FC Sion,2228,9,6,8,18,40,56,-16,26
Young Boys,2229,1,20,8,4,72,41,31,68
FC Basel,2229,2,16,10,6,51,26,25,58
Lucerne,2229,3,13,9,10,49,45,4,48
St Gallen,2229,4,15,3,14,47,56,-9,48
FC Zürich,2229,5,12,10,10,42,35,7,46
Grasshoppers,2229,6,9,8,15,41,51,-10,35
FC Lugano,2229,7,10,5,17,31,49,-18,35
FC Thun,2229,8,9,6,17,42,58,-16,33
FC Sion,2229,9,6,9,17,41,55,-14,27
Young Boys,2230,1,20,7,5,66,39,27,67
FC Basel,2230,2,19,8,5,58,24,34,65
Lucerne,2230,3,13,9,10,43,41,2,48
St Gallen,2230,4,14,2,16,41,57,-16,44
FC Zürich,2230,5,10,11,11,40,37,3,41
Grasshoppers,2230,6,10,8,14,45,46,-1,38
FC Lugano,2230,7,10,6,16,30,46,-16,36
FC Thun,2230,8,9,6,17,41,60,-19,33
FC Sion,2230,9,6,9,17,44,58,-14,27
Young Boys,2231,1,23,7,2,76,31,45,76
FC Basel,2231,2,16,10,6,59,29,30,58
St Gallen,2231,3,14,4,14,48,59,-11,46
Lucerne,2231,4,11,10,11,40,50,-10,43
FC Zürich,2231,5,10,11,11,39,35,4,41
FC Lugano,2231,6,10,6,16,32,49,-17,36
Grasshoppers,2231,7,9,8,15,40,50,-10,35
FC Thun,2231,8,9,8,15,42,56,-14,35
FC Sion,2231,9,6,8,18,40,57,-17,26
Young Boys,2232,1,21,7,4,68,35,33,70
FC Basel,2232,2,19,7,6,57,25,32,64
St Gallen,2232,3,15,3,14,43,53,-10,48
Lucerne,2232,4,12,10,10,41,44,-3,46
FC Zürich,2232,5,11,10,11,43,37,6,43
FC Thun,2232,6,10,5,17,44,59,-15,35
FC Lugano,2232,7,9,7,16,32,50,-18,34
Grasshoppers,2232,8,8,7,17,40,52,-12,31
FC Sion,2232,9,7,8,17,41,54,-13,29
Young Boys,2233,1,22,6,4,72,39,33,72
FC Basel,2233,2,18,7,7,58,27,31,61
Lucerne,2233,3,12,9,11,42,46,-4,45
St Gallen,2233,4,13,3,16,44,59,-15,42
FC Lugano,2233,5,12,5,15,34,46,-12,41
FC Zürich,2233,6,10,10,12,39,38,1,40
Grasshoppers,2233,7,10,7,15,41,48,-7,37
FC Thun,2233,8,10,5,17,43,59,-16,35
FC Sion,2233,9,7,8,17,44,55,-11,29
Young Boys,2234,1,22,6,4,72,39,33,72
FC Basel,2234,2,19,8,5,59,26,33,65
St Gallen,2234,3,15,2,15,44,54,-10,47
Lucerne,2234,4,12,8,12,45,47,-2,44
FC Lugano,2234,5,12,5,15,34,46,-12,41
FC Zürich,2234,6,10,10,12,40,39,1,40
Grasshoppers,2234,7,10,7,15,44,52,-8,37
FC Thun,2234,8,9,5,18,46,62,-16,32
FC Sion,2234,9,5,9,18,37,56,-19,24
Young Boys,2235,1,21,8,3,68,32,36,71
FC Basel,2235,2,17,8,7,51,26,25,59
St Gallen,2235,3,15,3,14,44,53,-9,48
FC Zürich,2235,4,12,10,10,41,34,7,46
Lucerne,2235,5,12,8,12,42,45,-3,44
FC Lugano,2235,6,11,6,15,33,47,-14,39
FC Thun,2235,7,10,6,16,48,58,-10,36
Grasshoppers,2235,8,8,7,17,39,55,-16,31
FC Sion,2235,9,5,10,17,37,53,-16,25
Young Boys,2236,1,23,6,3,78,33,45,75
FC Basel,2236,2,18,8,6,56,29,27,62
St Gallen,2236,3,14,4,14,43,54,-11,46
Lucerne,2236,4,11,10,11,42,49,-7,43
FC Zürich,2236,5,10,12,10,43,38,5,42
Grasshoppers,2236,6,9,8,15,45,50,-5,35
FC Thun,2236,7,9,8,15,45,59,-14,35
FC Lugano,2236,8,9,7,16,32,51,-19,34
FC Sion,2236,9,5,9,18,38,59,-21,24
Young Boys,2237,1,22,7,3,74,36,38,73
FC Basel,2237,2,15,8,9,48,27,21,53
St Gallen,2237,3,16,2,14,42,51,-9,50
Lucerne,2237,4,13,8,11,45,46,-1,47
FC Zürich,2237,5,11,10,11,40,34,6,43
Grasshoppers,2237,6,10,8,14,44,48,-4,38
FC Thun,2237,7,10,7,15,42,55,-13,37
FC Lugano,2237,8,10,5,17,30,48,-18,35
FC Sion,2237,9,6,7,19,37,57,-20,25
Young Boys,2238,1,22,7,3,75,34,41,73
FC Basel,2238,2,18,7,7,53,26,27,61
St Gallen,2238,3,15,4,13,46,52,-6,49
Lucerne,2238,4,11,8,13,42,53,-11,41
FC Zürich,2238,5,10,10,12,41,38,3,40
Grasshoppers,2238,6,10,7,15,44,50,-6,37
FC Lugano,2238,7,10,7,15,31,46,-15,37
FC Thun,2238,8,10,6,16,44,59,-15,36
FC Sion,2238,9,6,8,18,38,56,-18,26
Young Boys,2239,1,22,6,4,75,38,37,72
FC Basel,2239,2,20,7,5,58,23,35,67
Lucerne,2239,3,13,7,12,44,45,-1,46
St Gallen,2239,4,14,3,15,40,53,-13,45
FC Zürich,2239,5,10,9,13,41,40,1,39
FC Lugano,2239,6,11,6,15,35,48,-13,39
FC Thun,2239,7,9,7,16,42,58,-16,34
Grasshoppers,2239,8,8,8,16,37,52,-15,32
FC Sion,2239,9,6,9,17,39,54,-15,27
Young Boys,2240,1,21,8,3,66,31,35,71
FC Basel,2240,2,16,11,5,50,24,26,59
Lucerne,2240,3,12,9,11,43,43,0,45
St Gallen,2240,4,14,3,15,42,55,-13,45
FC Zürich,2240,5,9,13,10,38,34,4,40
FC Lugano,2240,6,10,6,16,28,45,-17,36
Grasshoppers,2240,7,8,10,14,43,51,-8,34
FC Thun,2240,8,9,7,16,44,57,-13,34
FC Sion,2240,9,7,9,16,42,56,-14,30
Young Boys,2241,1,21,7,4,71,35,36,70
FC Basel,2241,2,18,8,6,62,28,34,62
Lucerne,2241,3,13,8,11,45,49,-4,47
FC Zürich,2241,4,12,10,10,44,35,9,46
St Gallen,2241,5,13,3,16,42,61,-19,42
Grasshoppers,2241,6,11,6,15,45,49,-4,39
FC Lugano,2241,7,10,6,16,33,48,-15,36
FC Thun,2241,8,9,6,17,46,64,-18,33
FC Sion,2241,9,6,8,18,36,55,-19,26
Young Boys,2242,1,22,8,2,76,34,42,74
FC Basel,2242,2,16,7,9,51,28,23,55
Lucerne,2242,3,14,7,11,44,46,-2,49
FC Zürich,2242,4,12,10,10,43,34,9,46
St Gallen,2242,5,14,2,16,46,62,-16,44
FC Thun,2242,6,9,8,15,42,55,-13,35
FC Lugano,2242,7,10,5,17,31,50,-19,35
Grasshoppers,2242,8,8,8,16,40,54,-14,32
FC Sion,2242,9,7,9,16,44,54,-10,30
Young Boys,2243,1,22,7,3,73,33,40,73
FC Basel,2243,2,18,7,7,55,26,29,61
Lucerne,2243,3,12,10,10,43,46,-3,46
St Gallen,2243,4,14,3,15,42,56,-14,45
FC Zürich,2243,5,11,10,11,41,37,4,43
FC Lugano,2243,6,10,6,16,30,48,-18,36
Grasshoppers,2243,7,8,9,15,40,49,-9,33
FC Thun,2243,8,9,5,18,39,57,-18,32
FC Sion,2243,9,7,9,16,43,54,-11,30
Young Boys,2244,1,22,7,3,72,34,38,73
FC Basel,2244,2,19,8,5,51,21,30,65
St Gallen,2244,3,16,2,14,46,53,-7,50
Lucerne,2244,4,12,8,12,43,47,-4,44
FC Zürich,2244,5,11,10,11,44,35,9,43
Grasshoppers,2244,6,10,6,16,45,51,-6,36
FC Lugano,2244,7,9,7,16,30,51,-21,34
FC Thun,2244,8,9,5,18,42,64,-22,32
FC Sion,2244,9,6,7,19,41,58,-17,25
Young Boys,2245,1,21,7,4,70,36,34,70
FC Basel,2245,2,16,9,7,52,27,25,57
FC Zürich,2245,3,13,9,10,45,35,10,48
Lucerne,2245,4,12,9,11,44,49,-5,45
St Gallen,2245,5,14,3,15,42,55,-13,45
FC Lugano,2245,6,11,6,15,35,47,-12,39
Grasshoppers,2245,7,9,8,15,44,50,-6,35
FC Thun,2245,8,8,8,16,42,59,-17,32
FC Sion,2245,9,6,9,17,40,56,-16,27
Young Boys,2246,1,22,7,3,75,34,41,73
FC Basel,2246,2,17,9,6,55,28,27,60
Lucerne,2246,3,13,9,10,44,43,1,48
St Gallen,2246,4,14,2,16,48,62,-14,44
FC Zürich,2246,5,11,9,12,43,38,5,42
FC Lugano,2246,6,11,5,16,31,50,-19,38
Grasshoppers,2246,7,10,7,15,46,49,-3,37
FC Thun,2246,8,9,6,17,43,62,-19,33
FC Sion,2246,9,6,8,18,42,61,-19,26
Young Boys,2247,1,20,9,3,72,38,34,69
FC Basel,2247,2,18,9,5,54,24,30,63
St Gallen,2247,3,15,2,15,44,58,-14,47
Lucerne,2247,4,12,10,10,44,44,0,46
FC Zürich,2247,5,11,10,11,45,38,7,43
FC Lugano,2247,6,10,7,15,36,49,-13,37
Grasshoppers,2247,7,9,7,16,43,53,-10,34
FC Thun,2247,8,9,6,17,43,62,-19,33
FC Sion,2247,9,6,8,18,39,54,-15,26
Young Boys,2248,1,22,8,2,71,33,38,74
FC Basel,2248,2,15,9,8,46,26,20,54
Lucerne,2248,3,14,9,9,46,41,5,51
FC Zürich,2248,4,11,11,10,43,35,8,44
St Gallen,2248,5,14,2,16,39,54,-15,44
FC Lugano,2248,6,10,6,16,29,46,-17,36
Grasshoppers,2248,7,9,7,16,42,52,-10,34
FC Thun,2248,8,8,7,17,41,59,-18,31
FC Sion,2248,9,7,9,16,41,52,-11,30
Young Boys,2249,1,21,6,5,70,34,36,69
FC Basel,2249,2,18,9,5,56,24,32,63
Lucerne,2249,3,13,8,11,43,46,-3,47
St Gallen,2249,4,15,2,15,43,56,-13,47
FC Zürich,2249,5,10,10,12,42,40,2,40
FC Thun,2249,6,10,7,15,46,56,-10,37
FC Sion,2249,7,8,9,15,40,49,-9,33
FC Lugano,2249,8,9,6,17,31,53,-22,33
Grasshoppers,2249,9,8,7,17,38,51,-13,31
Young Boys,2250,1,20,6,6,70,41,29,66
FC Basel,2250,2,18,8,6,54,22,32,62
St Gallen,2250,3,16,3,13,47,51,-4,51
Lucerne,2250,4,12,8,12,42,44,-2,44
FC Zürich,2250,5,10,12,10,40,35,5,42
Grasshoppers,2250,6,11,6,15,47,53,-6,39
FC Lugano,2250,7,10,5,17,29,52,-23,35
FC Thun,2250,8,8,7,17,41,61,-20,31
FC Sion,2250,9,7,9,16,44,55,-11,30
Young Boys,2251,1,23,6,3,72,33,39,75
FC Basel,2251,2,18,8,6,56,26,30,62
Lucerne,2251,3,13,8,11,46,47,-1,47
FC Zürich,2251,4,11,11,10,41,33,8,44
St Gallen,2251,5,14,2,16,42,56,-14,44
Grasshoppers,2251,6,10,7,15,44,50,-6,37
FC Lugano,2251,7,10,6,16,32,50,-18,36
FC Thun,2251,8,8,5,19,41,64,-23,29
FC Sion,2251,9,7,7,18,39,54,-15,28
Young Boys,2252,1,23,6,3,72,31,41,75
FC Basel,2252,2,17,8,7,53,27,26,59
St Gallen,2252,3,15,3,14,45,56,-11,48
FC Zürich,2252,4,11,10,11,38,34,4,43
Lucerne,2252,5,11,8,13,40,48,-8,41
FC Lugano,2252,6,11,5,16,33,47,-14,38
FC Thun,2252,7,10,6,16,42,56,-14,36
Grasshoppers,2252,8,8,8,16,39,51,-12,32
FC Sion,2252,9,7,8,17,40,52,-12,29
Young Boys,2253,1,20,8,4,66,32,34,68
FC Basel,2253,2,18,7,7,54,25,29,61
St Gallen,2253,3,14,5,13,44,54,-10,47
Lucerne,2253,4,12,9,11,41,43,-2,45
FC Zürich,2253,5,10,11,11,39,36,3,41
FC Thun,2253,6,10,6,16,44,59,-15,36
FC Lugano,2253,7,9,9,14,31,46,-15,36
Grasshoppers,2253,8,9,8,15,40,49,-9,35
FC Sion,2253,9,5,11,16,38,53,-15,26
Young Boys,2254,1,21,8,3,70,34,36,71
FC Basel,2254,2,17,7,8,52,32,20,58
Lucerne,2254,3,14,7,11,44,43,1,49
FC Zürich,2254,4,13,9,10,42,34,8,48
St Gallen,2254,5,15,2,15,45,55,-10,47
FC Thun,2254,6,10,6,16,44,54,-10,36
FC Lugano,2254,7,9,6,17,29,48,-19,33
Grasshoppers,2254,8,8,8,16,38,50,-12,32
FC Sion,2254,9,6,9,17,38,52,-14,27
Young Boys,2255,1,20,8,4,72,40,32,68
FC Basel,2255,2,19,8,5,57,23,34,65
Lucerne,2255,3,13,8,11,45,48,-3,47
St Gallen,2255,4,15,2,15,42,53,-11,47
FC Zürich,2255,5,10,11,11,41,36,5,41
FC Lugano,2255,6,11,5,16,30,46,-16,38
Grasshoppers,2255,7,10,7,15,44,51,-7,37
FC Thun,2255,8,9,6,17,45,60,-15,33
FC Sion,2255,9,6,7,19,38,57,-19,25
Young Boys,2256,1,21,6,5,71,37,34,69
FC Basel,2256,2,18,9,5,58,30,28,63
Lucerne,2256,3,13,9,10,47,43,4,48
St Gallen,2256,4,14,3,15,40,52,-12,45
FC Zürich,2256,5,9,11,12,41,41,0,38
FC Thun,2256,6,11,5,16,48,58,-10,38
FC Lugano,2256,7,10,6,16,31,51,-20,36
Grasshoppers,2256,8,9,7,16,42,52,-10,34
FC Sion,2256,9,7,8,17,39,53,-14,29
Young Boys,2257,1,22,7,3,74,37,37,73
FC Basel,2257,2,18,9,5,60,25,35,63
St Gallen,2257,3,14,5,13,44,54,-10,47
Lucerne,2257,4,11,10,11,39,44,-5,43
FC Zürich,2257,5,11,9,12,42,44,-2,42
Grasshoppers,2257,6,10,6,16,46,55,-9,36
FC Lugano,2257,7,10,6,16,33,49,-16,36
FC Thun,2257,8,9,5,18,45,61,-16,32
FC Sion,2257,9,6,9,17,40,54,-14,27
Young Boys,2258,1,22,6,4,74,40,34,72
FC Basel,2258,2,20,7,5,57,22,35,67
Lucerne,2258,3,12,9,11,42,45,-3,45
St Gallen,2258,4,14,3,15,45,58,-13,45
FC Zürich,2258,5,11,10,11,41,38,3,43
Grasshoppers,2258,6,9,8,15,45,52,-7,35
FC Thun,2258,7,9,7,16,46,58,-12,34
FC Lugano,2258,8,9,5,18,30,51,-21,32
FC Sion,2258,9,7,7,18,45,61,-16,28
Young Boys,2259,1,22,6,4,73,39,34,72
FC Basel,2259,2,18,8,6,52,23,29,62
FC Zürich,2259,3,12,10,10,40,33,7,46
Lucerne,2259,4,13,7,12,41,42,-1,46
St Gallen,2259,5,13,4,15,39,53,-14,43
FC Lugano,2259,6,11,6,15,33,45,-12,39
Grasshoppers,2259,7,8,8,16,41,51,-10,32
FC Thun,2259,8,8,7,17,41,60,-19,31
FC Sion,2259,9,7,8,17,41,55,-14,29
Young Boys,2260,1,22,6,4,74,34,40,72
FC Basel,2260,2,18,8,6,53,24,29,62
Lucerne,2260,3,15,8,9,49,40,9,53
FC Zürich,2260,4,11,9,12,42,38,4,42
St Gallen,2260,5,13,2,17,40,57,-17,41
FC Thun,2260,6,10,5,17,41,57,-16,35
FC Lugano,2260,7,10,5,17,31,53,-22,35
Grasshoppers,2260,8,9,6,17,39,53,-14,33
FC Sion,2260,9,8,7,17,40,53,-13,31
Young Boys,2261,1,20,8,4,71,37,34,68
FC Basel,2261,2,19,7,6,55,24,31,64
Lucerne,2261,3,13,8,11,44,44,0,47
St Gallen,2261,4,14,2,16,40,56,-16,44
FC Zürich,2261,5,10,9,13,38,39,-1,39
FC Lugano,2261,6,11,5,16,35,50,-15,38
FC Sion,2261,7,10,7,15,47,50,-3,37
FC Thun,2261,8,10,5,17,45,60,-15,35
Grasshoppers,2261,9,8,7,17,39,54,-15,31
Young Boys,2262,1,22,8,2,73,32,41,74
FC Basel,2262,2,19,8,5,55,24,31,65
Lucerne,2262,3,12,8,12,41,44,-3,44
FC Zürich,2262,4,11,10,11,44,38,6,43
St Gallen,2262,5,13,3,16,39,55,-16,42
FC Lugano,2262,6,10,6,16,31,51,-20,36
Grasshoppers,2262,7,9,6,17,39,51,-12,33
FC Thun,2262,8,9,6,17,43,60,-17,33
FC Sion,2262,9,7,9,16,40,50,-10,30
Young Boys,2263,1,22,7,3,73,37,36,73
FC Basel,2263,2,17,8,7,50,25,25,59
Lucerne,2263,3,13,9,10,45,44,1,48
St Gallen,2263,4,14,3,15,43,56,-13,45
FC Zürich,2263,5,10,10,12,40,38,2,40
FC Lugano,2263,6,11,7,14,34,46,-12,40
FC Thun,2263,7,9,6,17,43,61,-18,33
FC Sion,2263,8,8,7,17,43,53,-10,31
Grasshoppers,2263,9,8,7,17,41,52,-11,31
Young Boys,2264,1,22,7,3,73,34,39,73
FC Basel,2264,2,17,9,6,53,30,23,60
Lucerne,2264,3,13,8,11,45,43,2,47
St Gallen,2264,4,15,2,15,49,57,-8,47
FC Zürich,2264,5,10,11,11,42,39,3,41
FC Lugano,2264,6,11,6,15,32,48,-16,39
FC Thun,2264,7,10,5,17,45,58,-13,35
Grasshoppers,2264,8,9,6,17,39,55,-16,33
FC Sion,2264,9,6,8,18,41,55,-14,26
Young Boys,2265,1,21,8,3,72,36,36,71
FC Basel,2265,2,17,9,6,57,25,32,60
Lucerne,2265,3,13,8,11,41,49,-8,47
St Gallen,2265,4,14,3,15,45,56,-11,45
FC Zürich,2265,5,10,11,11,39,36,3,41
FC Sion,2265,6,9,7,16,40,48,-8,34
Grasshoppers,2265,7,9,7,16,41,50,-9,34
FC Thun,2265,8,9,7,16,42,57,-15,34
FC Lugano,2265,9,9,6,17,32,52,-20,33
Young Boys,2266,1,22,7,3,77,31,46,73
FC Basel,2266,2,18,9,5,52,24,28,63
Lucerne,2266,3,12,9,11,39,41,-2,45
St Gallen,2266,4,13,4,15,45,58,-13,43
FC Zürich,2266,5,9,12,11,38,35,3,39
FC Lugano,2266,6,10,7,15,30,49,-19,37
Grasshoppers,2266,7,9,7,16,44,53,-9,34
FC Thun,2266,8,9,7,16,45,61,-16,34
FC Sion,2266,9,7,8,17,45,63,-18,29
Young Boys,2267,1,22,8,2,77,36,41,74
FC Basel,2267,2,15,11,6,53,30,23,56
Lucerne,2267,3,13,9,10,46,46,0,48
FC Zürich,2267,4,11,10,11,45,40,5,43
St Gallen,2267,5,13,3,16,42,57,-15,42
Grasshoppers,2267,6,9,9,14,42,49,-7,36
FC Thun,2267,7,9,8,15,46,59,-13,35
FC Lugano,2267,8,10,5,17,31,51,-20,35
FC Sion,2267,9,6,9,17,43,57,-14,27
Young Boys,2268,1,22,6,4,71,35,36,72
FC Basel,2268,2,18,9,5,57,21,36,63
St Gallen,2268,3,14,3,15,42,58,-16,45
Lucerne,2268,4,12,8,12,41,43,-2,44
FC Zürich,2268,5,11,10,11,41,35,6,43
Grasshoppers,2268,6,11,6,15,42,48,-6,39
FC Thun,2268,7,10,5,17,43,62,-19,35
FC Lugano,2268,8,9,6,17,28,50,-22,33
FC Sion,2268,9,7,7,18,45,58,-13,28
Young Boys,2269,1,21,6,5,69,36,33,69
FC Basel,2269,2,18,7,7,52,26,26,61
FC Zürich,2269,3,13,9,10,46,34,12,48
St Gallen,2269,4,15,2,15,46,55,-9,47
Lucerne,2269,5,12,8,12,43,48,-5,44
FC Thun,2269,6,11,5,16,44,56,-12,38
FC Lugano,2269,7,11,5,16,29,46,-17,38
Grasshoppers,2269,8,9,7,16,40,49,-9,34
FC Sion,2269,9,6,7,19,40,59,-19,25
Young Boys,2270,1,21,7,4,75,38,37,70
FC Basel,2270,2,19,8,5,55,25,30,65
Lucerne,2270,3,14,8,10,43,43,0,50
St Gallen,2270,4,14,3,15,44,57,-13,45
FC Zürich,2270,5,11,11,10,40,33,7,44
FC Lugano,2270,6,10,6,16,33,49,-16,36
Grasshoppers,2270,7,9,8,15,42,48,-6,35
FC Thun,2270,8,8,5,19,42,65,-23,29
FC Sion,2270,9,6,8,18,40,56,-16,26
Young Boys,2271,1,20,7,5,69,36,33,67
FC Basel,2271,2,20,7,5,51,21,30,67
Lucerne,2271,3,13,8,11,44,44,0,47
St Gallen,2271,4,14,3,15,42,54,-12,45
FC Zürich,2271,5,11,10,11,44,36,8,43
Grasshoppers,2271,6,10,6,16,43,52,-9,36
FC Lugano,2271,7,10,6,16,28,46,-18,36
FC Thun,2271,8,9,6,17,42,59,-17,33
FC Sion,2271,9,7,7,18,44,59,-15,28
Young Boys,2272,1,20,9,3,69,38,31,69
FC Basel,2272,2,20,7,5,63,25,38,67
Lucerne,2272,3,13,9,10,41,45,-4,48
St Gallen,2272,4,13,3,16,42,56,-14,42
FC Zürich,2272,5,10,10,12,40,36,4,40
FC Lugano,2272,6,10,8,14,29,43,-14,38
FC Thun,2272,7,10,6,16,45,57,-12,36
Grasshoppers,2272,8,8,6,18,42,58,-16,30
FC Sion,2272,9,7,8,17,43,56,-13,29
Young Boys,2273,1,22,7,3,73,33,40,73
FC Basel,2273,2,17,8,7,57,29,28,59
St Gallen,2273,3,16,2,14,48,56,-8,50
FC Zürich,2273,4,12,10,10,46,37,9,46
Lucerne,2273,5,11,8,13,41,54,-13,41
Grasshoppers,2273,6,11,6,15,46,49,-3,39
FC Lugano,2273,7,10,7,15,36,50,-14,37
FC Thun,2273,8,10,5,17,45,63,-18,35
FC Sion,2273,9,5,7,20,39,60,-21,22
Young Boys,2274,1,23,6,3,73,34,39,75
FC Basel,2274,2,16,9,7,48,24,24,57
Lucerne,2274,3,13,8,11,43,45,-2,47
FC Zürich,2274,4,11,10,11,40,34,6,43
St Gallen,2274,5,13,4,15,40,54,-14,43
FC Lugano,2274,6,11,5,16,33,49,-16,38
FC Thun,2274,7,10,7,15,42,55,-13,37
Grasshoppers,2274,8,9,8,15,39,46,-7,35
FC Sion,2274,9,5,9,18,38,55,-17,24
Young Boys,2275,1,20,8,4,70,38,32,68
FC Basel,2275,2,19,8,5,62,28,34,65
Lucerne,2275,3,13,8,11,41,46,-5,47
St Gallen,2275,4,14,2,16,42,53,-11,44
FC Zürich,2275,5,9,11,12,41,40,1,38
FC Thun,2275,6,10,7,15,46,58,-12,37
FC Lugano,2275,7,10,7,15,31,47,-16,37
Grasshoppers,2275,8,9,8,15,38,45,-7,35
FC Sion,2275,9,5,11,16,34,50,-16,26
Young Boys,2276,1,21,7,4,68,35,33,70
FC Basel,2276,2,19,8,5,58,26,32,65
Lucerne,2276,3,13,8,11,44,43,1,47
FC Lugano,2276,4,12,5,15,36,48,-12,41
St Gallen,2276,5,13,2,17,41,59,-18,41
FC Zürich,2276,6,10,9,13,38,39,-1,39
FC Thun,2276,7,9,8,15,44,57,-13,35
FC Sion,2276,8,8,8,16,39,50,-11,32
Grasshoppers,2276,9,8,7,17,38,49,-11,31
Young Boys,2277,1,21,6,5,72,38,34,69
FC Basel,2277,2,17,9,6,52,26,26,60
Lucerne,2277,3,12,9,11,44,47,-3,45
St Gallen,2277,4,14,3,15,41,53,-12,45
FC Zürich,2277,5,11,10,11,40,37,3,43
Grasshoppers,2277,6,11,6,15,41,47,-6,39
FC Thun,2277,7,10,6,16,42,54,-12,36
FC Lugano,2277,8,10,6,16,31,47,-16,36
FC Sion,2277,9,6,9,17,39,53,-14,27
Young Boys,2278,1,22,7,3,76,36,40,73
FC Basel,2278,2,17,10,5,56,29,27,61
St Gallen,2278,3,14,4,14,48,58,-10,46
Lucerne,2278,4,11,9,12,43,52,-9,42
FC Zürich,2278,5,10,10,12,41,40,1,40
FC Lugano,2278,6,11,6,15,36,47,-11,39
Grasshoppers,2278,7,9,8,15,43,51,-8,35
FC Sion,2278,8,8,8,16,42,53,-11,32
FC Thun,2278,9,8,6,18,40,59,-19,30
Young Boys,2279,1,21,8,3,73,37,36,71
FC Basel,2279,2,16,10,6,53,29,24,58
Lucerne,2279,3,13,9,10,46,43,3,48
FC Zürich,2279,4,12,10,10,44,34,10,46
St Gallen,2279,5,13,4,15,44,57,-13,43
Grasshoppers,2279,6,10,8,14,40,46,-6,38
FC Lugano,2279,7,10,5,17,32,53,-21,35
FC Thun,2279,8,8,6,18,41,60,-19,30
FC Sion,2279,9,7,8,17,43,57,-14,29
Young Boys,2280,1,21,8,3,71,33,38,71
FC Basel,2280,2,18,8,6,54,23,31,62
St Gallen,2280,3,14,4,14,40,53,-13,46
FC Thun,2280,4,12,5,15,50,55,-5,41
Lucerne,2280,5,11,8,13,38,45,-7,41
FC Lugano,2280,6,11,6,15,33,50,-17,39
FC Zürich,2280,7,9,9,14,41,42,-1,36
Grasshoppers,2280,8,10,6,16,39,50,-11,36
FC Sion,2280,9,7,8,17,41,56,-15,29
Young Boys,2281,1,22,6,4,71,34,37,72
FC Basel,2281,2,18,9,5,55,26,29,63
Lucerne,2281,3,13,9,10,47,45,2,48
St Gallen,2281,4,13,5,14,42,54,-12,44
FC Zürich,2281,5,10,11,11,43,38,5,41
FC Lugano,2281,6,10,7,15,34,50,-16,37
FC Thun,2281,7,9,7,16,41,55,-14,34
Grasshoppers,2281,8,9,6,17,40,52,-12,33
FC Sion,2281,9,6,8,18,37,56,-19,26
Young Boys,2282,1,23,6,3,74,32,42,75
FC Basel,2282,2,16,8,8,50,29,21,56
St Gallen,2282,3,14,3,15,45,57,-12,45
Lucerne,2282,4,11,10,11,41,46,-5,43
FC Zürich,2282,5,10,12,10,43,36,7,42
Grasshoppers,2282,6,10,7,15,42,47,-5,37
FC Lugano,2282,7,10,7,15,29,46,-17,37
FC Thun,2282,8,10,6,16,45,59,-14,36
FC Sion,2282,9,6,9,17,41,58,-17,27
Young Boys,2283,1,22,7,3,73,35,38,73
FC Basel,2283,2,19,8,5,58,28,30,65
St Gallen,2283,3,14,4,14,49,59,-10,46
Lucerne,2283,4,12,8,12,44,48,-4,44
FC Zürich,2283,5,11,10,11,44,36,8,43
Grasshoppers,2283,6,9,7,16,39,50,-11,34
FC Lugano,2283,7,9,7,16,31,48,-17,34
FC Thun,2283,8,8,7,17,43,61,-18,31
FC Sion,2283,9,7,8,17,42,58,-16,29
Young Boys,2284,1,21,8,3,72,35,37,71
FC Basel,2284,2,17,8,7,53,29,24,59
St Gallen,2284,3,16,2,14,45,56,-11,50
Lucerne,2284,4,14,7,11,49,44,5,49
FC Zürich,2284,5,11,9,12,44,38,6,42
FC Lugano,2284,6,11,5,16,31,47,-16,38
FC Thun,2284,7,10,6,16,43,60,-17,36
Grasshoppers,2284,8,8,8,16,40,51,-11,32
FC Sion,2284,9,5,9,18,40,57,-17,24
Young Boys,2285,1,21,7,4,75,38,37,70
FC Basel,2285,2,17,8,7,53,28,25,59
St Gallen,2285,3,16,3,13,45,52,-7,51
Lucerne,2285,4,12,8,12,39,41,-2,44
FC Zürich,2285,5,11,10,11,42,34,8,43
Grasshoppers,2285,6,11,6,15,40,50,-10,39
FC Lugano,2285,7,10,7,15,31,47,-16,37
FC Thun,2285,8,9,7,16,42,56,-14,34
FC Sion,2285,9,5,8,19,38,59,-21,23
Young Boys,2286,1,22,7,3,76,37,39,73
FC Basel,2286,2,16,9,7,50,26,24,57
Lucerne,2286,3,14,8,10,45,43,2,50
St Gallen,2286,4,13,4,15,41,55,-14,43
FC Thun,2286,5,12,5,15,46,55,-9,41
FC Zürich,2286,6,10,10,12,40,38,2,40
FC Lugano,2286,7,11,6,15,35,48,-13,39
Grasshoppers,2286,8,8,6,18,37,55,-18,30
FC Sion,2286,9,6,9,17,42,55,-13,27
Young Boys,2287,1,22,7,3,73,35,38,73
FC Basel,2287,2,17,9,6,51,27,24,60
Lucerne,2287,3,15,7,10,47,42,5,52
St Gallen,2287,4,14,3,15,43,58,-15,45
FC Zürich,2287,5,11,9,12,45,36,9,42
FC Lugano,2287,6,10,6,16,33,50,-17,36
Grasshoppers,2287,7,9,7,16,41,51,-10,34
FC Thun,2287,8,9,7,16,44,60,-16,34
FC Sion,2287,9,6,7,19,42,60,-18,25
Young Boys,2288,1,21,9,2,71,33,38,72
FC Basel,2288,2,18,7,7,52,26,26,61
Lucerne,2288,3,14,7,11,47,46,1,49
St Gallen,2288,4,15,2,15,43,56,-13,47
FC Zürich,2288,5,11,9,12,39,37,2,42
FC Lugano,2288,6,11,6,15,36,47,-11,39
Grasshoppers,2288,7,9,8,15,45,54,-9,35
FC Thun,2288,8,8,5,19,43,63,-20,29
FC Sion,2288,9,6,9,17,41,55,-14,27
Young Boys,2289,1,22,7,3,71,34,37,73
FC Basel,2289,2,17,9,6,50,25,25,60
St Gallen,2289,3,13,6,13,43,54,-11,45
Lucerne,2289,4,12,8,12,41,45,-4,44
FC Zürich,2289,5,10,10,12,39,36,3,40
Grasshoppers,2289,6,11,7,14,45,49,-4,40
FC Lugano,2289,7,9,8,15,30,46,-16,35
FC Thun,2289,8,9,7,16,43,59,-16,34
FC Sion,2289,9,6,8,18,43,57,-14,26
Young Boys,2290,1,22,7,3,73,32,41,73
FC Basel,2290,2,17,9,6,51,26,25,60
Lucerne,2290,3,12,10,10,40,42,-2,46
FC Lugano,2290,4,12,6,14,31,43,-12,42
St Gallen,2290,5,13,3,16,39,54,-15,42
FC Zürich,2290,6,10,10,12,41,38,3,40
FC Thun,2290,7,9,6,17,43,59,-16,33
Grasshoppers,2290,8,8,8,16,38,49,-11,32
FC Sion,2290,9,8,7,17,41,54,-13,31
Young Boys,2291,1,20,8,4,72,39,33,68
FC Basel,2291,2,18,9,5,55,27,28,63
Lucerne,2291,3,12,9,11,42,43,-1,45
St Gallen,2291,4,14,3,15,41,54,-13,45
FC Zürich,2291,5,9,12,11,38,38,0,39
FC Lugano,2291,6,10,8,14,31,45,-14,38
Grasshoppers,2291,7,10,6,16,44,49,-5,36
FC Thun,2291,8,9,6,17,44,60,-16,33
FC Sion,2291,9,8,7,17,41,53,-12,31
Young Boys,2292,1,23,6,3,75,33,42,75
FC Basel,2292,2,19,8,5,60,26,34,65
St Gallen,2292,3,14,3,15,40,53,-13,45
FC Zürich,2292,4,11,10,11,41,35,6,43
Lucerne,2292,5,12,7,13,40,48,-8,43
FC Lugano,2292,6,12,5,15,30,44,-14,41
Grasshoppers,2292,7,10,6,16,42,51,-9,36
FC Thun,2292,8,8,5,19,40,63,-23,29
FC Sion,2292,9,6,8,18,38,53,-15,26
Young Boys,2293,1,21,8,3,69,33,36,71
FC Basel,2293,2,18,7,7,51,26,25,61
Lucerne,2293,3,13,9,10,45,44,1,48
St Gallen,2293,4,14,4,14,42,52,-10,46
Grasshoppers,2293,5,11,7,14,47,49,-2,40
FC Zürich,2293,6,10,9,13,42,40,2,39
FC Lugano,2293,7,11,5,16,36,51,-15,38
FC Thun,2293,8,9,6,17,42,59,-17,33
FC Sion,2293,9,5,9,18,38,58,-20,24
Young Boys,2294,1,22,7,3,70,33,37,73
FC Basel,2294,2,17,9,6,51,24,27,60
St Gallen,2294,3,15,3,14,43,55,-12,48
Lucerne,2294,4,13,7,12,42,43,-1,46
FC Zürich,2294,5,11,10,11,41,35,6,43
Grasshoppers,2294,6,10,7,15,43,49,-6,37
FC Lugano,2294,7,10,5,17,29,47,-18,35
FC Thun,2294,8,9,5,18,41,59,-18,32
FC Sion,2294,9,7,7,18,41,56,-15,28
Young Boys,2295,1,21,7,4,78,37,41,70
FC Basel,2295,2,19,8,5,60,27,33,65
St Gallen,2295,3,14,3,15,43,56,-13,45
Lucerne,2295,4,12,8,12,41,52,-11,44
FC Zürich,2295,5,10,10,12,43,38,5,40
Grasshoppers,2295,6,11,7,14,42,47,-5,40
FC Lugano,2295,7,11,6,15,35,49,-14,39
FC Thun,2295,8,9,5,18,42,61,-19,32
FC Sion,2295,9,6,8,18,38,55,-17,26
Young Boys,2296,1,21,7,4,69,36,33,70
FC Basel,2296,2,17,8,7,53,28,25,59
Lucerne,2296,3,15,7,10,51,42,9,52
St Gallen,2296,4,14,4,14,44,56,-12,46
FC Zürich,2296,5,11,10,11,43,37,6,43
FC Lugano,2296,6,10,6,16,33,52,-19,36
Grasshoppers,2296,7,9,7,16,39,49,-10,34
FC Thun,2296,8,9,6,17,42,59,-17,33
FC Sion,2296,9,6,9,17,37,52,-15,27
Young Boys,2297,1,22,6,4,75,38,37,72
FC Basel,2297,2,19,8,5,56,23,33,65
Lucerne,2297,3,14,8,10,44,46,-2,50
St Gallen,2297,4,15,2,15,42,53,-11,47
FC Zürich,2297,5,9,11,12,36,34,2,38
Grasshoppers,2297,6,10,7,15,42,48,-6,37
FC Lugano,2297,7,10,5,17,31,49,-18,35
FC Thun,2297,8,9,7,16,43,57,-14,34
FC Sion,2297,9,5,8,19,36,57,-21,23
Young Boys,2298,1,21,8,3,73,36,37,71
FC Basel,2298,2,16,10,6,50,25,25,58
St Gallen,2298,3,15,3,14,46,54,-8,48
Lucerne,2298,4,11,9,12,40,47,-7,42
FC Zürich,2298,5,10,10,12,39,36,3,40
FC Lugano,2298,6,11,6,15,31,47,-16,39
Grasshoppers,2298,7,10,8,14,46,51,-5,38
FC Thun,2298,8,8,8,16,44,60,-16,32
FC Sion,2298,9,7,8,17,46,59,-13,29
Young Boys,2299,1,22,6,4,67,31,36,72
FC Basel,2299,2,17,8,7,52,25,27,59
Lucerne,2299,3,13,8,11,42,42,0,47
St Gallen,2299,4,13,2,17,42,59,-17,41
FC Zürich,2299,5,10,10,12,41,39,2,40
FC Lugano,2299,6,11,5,16,32,47,-15,38
Grasshoppers,2299,7,10,6,16,41,50,-9,36
FC Thun,2299,8,10,6,16,46,60,-14,36
FC Sion,2299,9,8,9,15,43,53,-10,33
Young Boys,2300,1,21,9,2,72,34,38,72
FC Basel,2300,2,17,8,7,51,27,24,59
Lucerne,2300,3,12,10,10,43,43,0,46
St Gallen,2300,4,14,3,15,41,53,-12,45
FC Zürich,2300,5,10,10,12,41,36,5,40
FC Lugano,2300,6,10,8,14,30,44,-14,38
FC Thun,2300,7,9,7,16,45,60,-15,34
FC Sion,2300,8,8,8,16,41,53,-12,32
Grasshoppers,2300,9,8,7,17,41,55,-14,31
Young Boys,2301,1,19,6,7,69,42,27,63
FC Basel,2301,2,17,8,7,57,29,28,59
Lucerne,2301,3,14,8,10,44,43,1,50
FC Zürich,2301,4,13,9,10,47,34,13,48
St Gallen,2301,5,14,3,15,43,55,-12,45
Grasshoppers,2301,6,10,8,14,45,50,-5,38
FC Lugano,2301,7,11,5,16,31,47,-16,38
FC Thun,2301,8,9,6,17,45,63,-18,33
FC Sion,2301,9,7,7,18,40,58,-18,28
Young Boys,2302,1,22,7,3,72,35,37,73
FC Basel,2302,2,18,8,6,56,27,29,62
Lucerne,2302,3,13,8,11,46,48,-2,47
St Gallen,2302,4,14,4,14,43,55,-12,46
FC Zürich,2302,5,11,9,12,44,38,6,42
FC Thun,2302,6,10,6,16,48,59,-11,36
Grasshoppers,2302,7,9,7,16,40,52,-12,34
FC Lugano,2302,8,9,6,17,29,48,-19,33
FC Sion,2302,9,7,7,18,42,58,-16,28
Young Boys,2303,1,22,8,2,76,34,42,74
FC Basel,2303,2,16,10,6,53,28,25,58
Lucerne,2303,3,13,9,10,46,45,1,48
St Gallen,2303,4,13,4,15,41,55,-14,43
FC Zürich,2303,5,10,10,12,39,37,2,40
FC Lugano,2303,6,11,5,16,33,51,-18,38
Grasshoppers,2303,7,9,9,14,42,48,-6,36
FC Thun,2303,8,9,8,15,41,55,-14,35
FC Sion,2303,9,5,9,18,39,57,-18,24
Young Boys,2304,1,22,6,4,72,40,32,72
FC Basel,2304,2,19,8,5,57,22,35,65
St Gallen,2304,3,15,2,15,44,56,-12,47
Lucerne,2304,4,13,7,12,46,44,2,46
FC Zürich,2304,5,10,10,12,42,39,3,40
FC Thun,2304,6,11,5,16,45,58,-13,38
FC Lugano,2304,7,10,5,17,30,50,-20,35
Grasshoppers,2304,8,8,7,17,41,56,-15,31
FC Sion,2304,9,7,8,17,45,57,-12,29
Young Boys,2305,1,22,7,3,75,38,37,73
FC Basel,2305,2,18,7,7,56,30,26,61
St Gallen,2305,3,15,2,15,44,53,-9,47
FC Lugano,2305,4,13,5,14,35,45,-10,44
Lucerne,2305,5,12,7,13,42,51,-9,43
FC Zürich,2305,6,10,10,12,42,38,4,40
Grasshoppers,2305,7,10,7,15,44,50,-6,37
FC Thun,2305,8,9,6,17,46,62,-16,33
FC Sion,2305,9,6,7,19,40,57,-17,25
Young Boys,2306,1,22,6,4,73,37,36,72
FC Basel,2306,2,17,9,6,58,30,28,60
St Gallen,2306,3,14,4,14,44,55,-11,46
FC Zürich,2306,4,11,10,11,43,38,5,43
Lucerne,2306,5,11,9,12,43,50,-7,42
FC Lugano,2306,6,11,6,15,33,46,-13,39
FC Thun,2306,7,11,5,16,50,59,-9,38
Grasshoppers,2306,8,9,6,17,40,53,-13,33
FC Sion,2306,9,7,7,18,38,54,-16,28
Young Boys,2307,1,20,8,4,71,38,33,68
FC Basel,2307,2,17,9,6,56,27,29,60
St Gallen,2307,3,15,2,15,47,54,-7,47
FC Zürich,2307,4,12,9,11,43,35,8,45
Lucerne,2307,5,12,8,12,40,45,-5,44
FC Lugano,2307,6,11,5,16,31,49,-18,38
Grasshoppers,2307,7,10,7,15,40,51,-11,37
FC Thun,2307,8,10,5,17,48,61,-13,35
FC Sion,2307,9,6,9,17,42,58,-16,27
Young Boys,2308,1,20,8,4,68,35,33,68
FC Basel,2308,2,18,9,5,55,25,30,63
Lucerne,2308,3,13,10,9,43,42,1,49
St Gallen,2308,4,14,2,16,41,57,-16,44
FC Lugano,2308,5,12,6,14,36,45,-9,42
FC Zürich,2308,6,10,9,13,38,38,0,39
Grasshoppers,2308,7,11,6,15,43,48,-5,39
FC Thun,2308,8,8,6,18,43,62,-19,30
FC Sion,2308,9,6,8,18,39,54,-15,26
Young Boys,2309,1,24,6,2,75,34,41,78
FC Basel,2309,2,18,8,6,54,23,31,62
St Gallen,2309,3,15,3,14,44,55,-11,48
Lucerne,2309,4,12,7,13,39,46,-7,43
FC Zürich,2309,5,10,11,11,38,34,4,41
FC Thun,2309,6,11,5,16,44,55,-11,38
Grasshoppers,2309,7,9,6,17,39,47,-8,33
FC Lugano,2309,8,9,6,17,30,52,-22,33
FC Sion,2309,9,6,8,18,38,55,-17,26
Young Boys,2310,1,22,7,3,73,38,35,73
FC Basel,2310,2,17,9,6,57,27,30,60
St Gallen,2310,3,15,2,15,42,54,-12,47
Lucerne,2310,4,12,10,10,42,43,-1,46
FC Zürich,2310,5,11,11,10,43,36,7,44
FC Lugano,2310,6,10,6,16,30,47,-17,36
Grasshoppers,2310,7,9,8,15,44,52,-8,35
FC Thun,2310,8,8,7,17,45,64,-19,31
FC Sion,2310,9,6,8,18,41,56,-15,26
Young Boys,2311,1,23,6,3,74,33,41,75
FC Basel,2311,2,17,8,7,54,27,27,59
Lucerne,2311,3,14,7,11,42,43,-1,49
St Gallen,2311,4,15,2,15,41,56,-15,47
FC Zürich,2311,5,11,10,11,44,35,9,43
Grasshoppers,2311,6,11,7,14,44,48,-4,40
FC Thun,2311,7,9,7,16,44,59,-15,34
FC Lugano,2311,8,9,6,17,31,51,-20,33
FC Sion,2311,9,5,7,20,35,57,-22,22
Young Boys,2312,1,21,7,4,71,39,32,70
FC Basel,2312,2,19,8,5,55,22,33,65
St Gallen,2312,3,15,2,15,41,53,-12,47
FC Zürich,2312,4,11,10,11,44,37,7,43
Lucerne,2312,5,12,7,13,39,45,-6,43
Grasshoppers,2312,6,11,7,14,50,50,0,40
FC Lugano,2312,7,10,5,17,30,49,-19,35
FC Thun,2312,8,9,5,18,41,62,-21,32
FC Sion,2312,9,6,9,17,40,54,-14,27
Young Boys,2313,1,21,7,4,73,34,39,70
FC Basel,2313,2,18,7,7,56,30,26,61
St Gallen,2313,3,16,2,14,47,56,-9,50
Lucerne,2313,4,13,7,12,43,47,-4,46
FC Zürich,2313,5,11,10,11,46,37,9,43
Grasshoppers,2313,6,8,9,15,40,49,-9,33
FC Thun,2313,7,9,6,17,42,58,-16,33
FC Lugano,2313,8,9,6,17,29,50,-21,33
FC Sion,2313,9,8,8,16,42,57,-15,32
Young Boys,2314,1,24,6,2,72,30,42,78
FC Basel,2314,2,17,8,7,57,26,31,59
Lucerne,2314,3,12,9,11,44,49,-5,45
FC Zürich,2314,4,11,9,12,40,38,2,42
St Gallen,2314,5,13,3,16,42,58,-16,42
FC Lugano,2314,6,11,6,15,34,46,-12,39
FC Thun,2314,7,10,5,17,45,63,-18,35
Grasshoppers,2314,8,8,8,16,40,50,-10,32
FC Sion,2314,9,7,8,17,42,56,-14,29
Young Boys,2315,1,21,8,3,72,36,36,71
FC Basel,2315,2,20,7,5,57,24,33,67
St Gallen,2315,3,15,2,15,46,55,-9,47
FC Zürich,2315,4,12,9,11,42,34,8,45
Lucerne,2315,5,11,9,12,39,47,-8,42
Grasshoppers,2315,6,9,8,15,44,51,-7,35
FC Lugano,2315,7,9,6,17,29,49,-20,33
FC Thun,2315,8,9,5,18,40,61,-21,32
FC Sion,2315,9,7,8,17,41,53,-12,29
Young Boys,2316,1,19,8,5,65,35,30,65
FC Basel,2316,2,16,8,8,51,30,21,56
Lucerne,2316,3,13,9,10,42,43,-1,48
St Gallen,2316,4,15,3,14,43,51,-8,48
FC Zürich,2316,5,11,9,12,44,37,7,42
FC Thun,2316,6,12,5,15,46,56,-10,41
FC Lugano,2316,7,10,7,15,31,46,-15,37
Grasshoppers,2316,8,10,6,16,43,49,-6,36
FC Sion,2316,9,7,7,18,41,59,-18,28
Young Boys,2317,1,21,6,5,72,37,35,69
FC Basel,2317,2,17,7,8,52,27,25,58
St Gallen,2317,3,16,2,14,43,53,-10,50
Lucerne,2317,4,13,7,12,39,42,-3,46
FC Thun,2317,5,12,5,15,47,56,-9,41
FC Zürich,2317,6,10,10,12,40,37,3,40
Grasshoppers,2317,7,11,6,15,41,47,-6,39
FC Lugano,2317,8,10,5,17,29,49,-20,35
FC Sion,2317,9,6,8,18,41,56,-15,26
Young Boys,2318,1,22,8,2,72,32,40,74
FC Basel,2318,2,17,8,7,51,26,25,59
Lucerne,2318,3,12,10,10,42,43,-1,46
FC Zürich,2318,4,11,9,12,43,39,4,42
St Gallen,2318,5,13,3,16,42,56,-14,42
FC Lugano,2318,6,11,6,15,33,48,-15,39
Grasshoppers,2318,7,10,6,16,41,48,-7,36
FC Thun,2318,8,10,6,16,44,57,-13,36
FC Sion,2318,9,6,8,18,40,59,-19,26
Young Boys,2319,1,22,7,3,72,32,40,73
FC Basel,2319,2,18,7,7,53,26,27,61
Lucerne,2319,3,14,7,11,43,44,-1,49
St Gallen,2319,4,14,2,16,42,54,-12,44
FC Zürich,2319,5,11,10,11,43,35,8,43
Grasshoppers,2319,6,10,6,16,40,49,-9,36
FC Lugano,2319,7,10,5,17,28,51,-23,35
FC Thun,2319,8,9,5,18,44,61,-17,32
FC Sion,2319,9,7,9,16,42,55,-13,30
Young Boys,2320,1,21,7,4,69,35,34,70
FC Basel,2320,2,16,7,9,50,28,22,55
Lucerne,2320,3,15,8,9,52,46,6,53
FC Zürich,2320,4,11,10,11,40,40,0,43
St Gallen,2320,5,13,3,16,44,58,-14,42
FC Thun,2320,6,10,7,15,48,56,-8,37
FC Lugano,2320,7,10,6,16,32,50,-18,36
Grasshoppers,2320,8,9,7,16,40,50,-10,34
FC Sion,2320,9,7,9,16,38,50,-12,30
Young Boys,2321,1,22,7,3,77,37,40,73
FC Basel,2321,2,19,8,5,58,25,33,65
Lucerne,2321,3,13,8,11,46,43,3,47
St Gallen,2321,4,14,3,15,41,59,-18,45
FC Zürich,2321,5,10,11,11,38,35,3,41
Grasshoppers,2321,6,9,7,16,41,54,-13,34
FC Thun,2321,7,9,7,16,45,61,-16,34
FC Lugano,2321,8,9,5,18,30,51,-21,32
FC Sion,2321,9,6,10,16,45,56,-11,28
Young Boys,2322,1,19,9,4,66,35,31,66
FC Basel,2322,2,18,8,6,55,25,30,62
St Gallen,2322,3,16,3,13,48,51,-3,51
Lucerne,2322,4,13,8,11,43,43,0,47
FC Zürich,2322,5,11,9,12,42,37,5,42
FC Lugano,2322,6,10,6,16,31,50,-19,36
FC Thun,2322,7,10,5,17,41,62,-21,35
Grasshoppers,2322,8,9,6,17,39,49,-10,33
FC Sion,2322,9,7,8,17,41,54,-13,29
Young Boys,2323,1,20,6,6,67,36,31,66
FC Basel,2323,2,19,8,5,56,25,31,65
St Gallen,2323,3,16,2,14,46,53,-7,50
Lucerne,2323,4,12,8,12,43,47,-4,44
FC Zürich,2323,5,10,11,11,41,38,3,41
Grasshoppers,2323,6,11,7,14,42,47,-5,40
FC Lugano,2323,7,11,5,16,33,50,-17,38
FC Thun,2323,8,8,6,18,41,59,-18,30
FC Sion,2323,9,6,9,17,39,53,-14,27
Young Boys,2324,1,19,9,4,66,37,29,66
FC Basel,2324,2,19,8,5,61,26,35,65
Lucerne,2324,3,14,8,10,44,43,1,50
St Gallen,2324,4,14,2,16,44,59,-15,44
FC Zürich,2324,5,11,10,11,44,38,6,43
Grasshoppers,2324,6,10,7,15,44,49,-5,37
FC Lugano,2324,7,9,6,17,31,51,-20,33
FC Thun,2324,8,9,5,18,45,62,-17,32
FC Sion,2324,9,8,7,17,40,54,-14,31
Young Boys,2325,1,23,6,3,74,32,42,75
FC Basel,2325,2,16,9,7,50,26,24,57
St Gallen,2325,3,15,3,14,42,51,-9,48
Lucerne,2325,4,13,7,12,43,49,-6,46
FC Zürich,2325,5,12,9,11,43,34,9,45
Grasshoppers,2325,6,10,6,16,41,50,-9,36
FC Lugano,2325,7,10,5,17,30,49,-19,35
FC Thun,2325,8,9,7,16,39,56,-17,34
FC Sion,2325,9,6,8,18,37,52,-15,26
Young Boys,2326,1,22,6,4,69,35,34,72
FC Basel,2326,2,18,7,7,55,28,27,61
Lucerne,2326,3,13,8,11,43,44,-1,47
St Gallen,2326,4,15,2,15,44,55,-11,47
FC Zürich,2326,5,10,10,12,43,41,2,40
FC Lugano,2326,6,11,5,16,34,48,-14,38
FC Thun,2326,7,10,6,16,46,60,-14,36
Grasshoppers,2326,8,9,7,16,38,47,-9,34
FC Sion,2326,9,6,9,17,41,55,-14,27
Young Boys,2327,1,20,9,3,71,35,36,69
FC Basel,2327,2,16,9,7,51,27,24,57
Lucerne,2327,3,12,10,10,44,43,1,46
FC Zürich,2327,4,12,9,11,42,34,8,45
St Gallen,2327,5,14,2,16,41,54,-13,44
FC Lugano,2327,6,11,6,15,31,47,-16,39
Grasshoppers,2327,7,9,8,15,42,53,-11,35
FC Thun,2327,8,9,6,17,43,59,-16,33
FC Sion,2327,9,8,7,17,42,55,-13,31
Young Boys,2328,1,22,7,3,71,35,36,73
FC Basel,2328,2,18,8,6,55,26,29,62
St Gallen,2328,3,14,4,14,43,54,-11,46
FC Zürich,2328,4,11,11,10,46,35,11,44
Lucerne,2328,5,12,8,12,42,46,-4,44
Grasshoppers,2328,6,10,7,15,43,50,-7,37
FC Lugano,2328,7,9,6,17,30,49,-19,33
FC Thun,2328,8,8,7,17,43,61,-18,31
FC Sion,2328,9,6,10,16,40,57,-17,28
Young Boys,2329,1,21,7,4,73,40,33,70
FC Basel,2329,2,19,7,6,60,25,35,64
Lucerne,2329,3,13,9,10,44,43,1,48
FC Zürich,2329,4,12,9,11,42,34,8,45
St Gallen,2329,5,13,2,17,38,61,-23,41
FC Thun,2329,6,11,5,16,46,55,-9,38
FC Lugano,2329,7,10,5,17,32,49,-17,35
Grasshoppers,2329,8,9,7,16,39,51,-12,34
FC Sion,2329,9,7,7,18,40,56,-16,28
Young Boys,2330,1,21,9,2,76,31,45,72
FC Basel,2330,2,19,8,5,59,25,34,65
St Gallen,2330,3,14,4,14,43,55,-12,46
Lucerne,2330,4,12,9,11,39,46,-7,45
FC Zürich,2330,5,10,9,13,44,38,6,39
FC Lugano,2330,6,10,6,16,30,52,-22,36
FC Thun,2330,7,10,5,17,42,58,-16,35
Grasshoppers,2330,8,9,7,16,39,48,-9,34
FC Sion,2330,9,6,9,17,36,55,-19,27
Young Boys,2331,1,22,7,3,68,32,36,73
FC Basel,2331,2,18,8,6,55,26,29,62
St Gallen,2331,3,15,3,14,42,52,-10,48
FC Zürich,2331,4,12,10,10,47,40,7,46
Lucerne,2331,5,11,8,13,38,43,-5,41
Grasshoppers,2331,6,10,7,15,44,49,-5,37
FC Lugano,2331,7,10,7,15,30,45,-15,37
FC Thun,2331,8,9,5,18,43,64,-21,32
FC Sion,2331,9,5,9,18,42,58,-16,24
Young Boys,2332,1,21,8,3,69,35,34,71
FC Basel,2332,2,17,9,6,52,24,28,60
Lucerne,2332,3,13,9,10,41,41,0,48
St Gallen,2332,4,14,3,15,42,53,-11,45
FC Zürich,2332,5,9,12,11,40,37,3,39
FC Lugano,2332,6,9,9,14,29,44,-15,36
Grasshoppers,2332,7,9,7,16,39,50,-11,34
FC Thun,2332,8,9,7,16,41,57,-16,34
FC Sion,2332,9,7,8,17,39,51,-12,29
Young Boys,2333,1,22,7,3,71,33,38,73
FC Basel,2333,2,18,7,7,50,24,26,61
St Gallen,2333,3,14,3,15,42,57,-15,45
FC Zürich,2333,4,11,10,11,43,34,9,43
Lucerne,2333,5,11,9,12,40,44,-4,42
FC Lugano,2333,6,11,6,15,33,47,-14,39
FC Thun,2333,7,11,5,16,47,58,-11,38
Grasshoppers,2333,8,8,7,17,36,49,-13,31
FC Sion,2333,9,7,8,17,40,56,-16,29
Young Boys,2334,1,20,7,5,72,37,35,67
FC Basel,2334,2,17,9,6,55,28,27,60
Lucerne,2334,3,16,7,9,49,42,7,55
St Gallen,2334,4,13,3,16,42,60,-18,42
FC Zürich,2334,5,10,10,12,41,39,2,40
FC Lugano,2334,6,10,6,16,31,52,-21,36
FC Thun,2334,7,10,5,17,46,60,-14,35
Grasshoppers,2334,8,9,7,16,41,52,-11,34
FC Sion,2334,9,8,8,16,43,50,-7,32
Young Boys,2335,1,20,7,5,69,36,33,67
FC Basel,2335,2,19,7,6,55,26,29,64
St Gallen,2335,3,16,2,14,48,57,-9,50
Lucerne,2335,4,12,8,12,40,44,-4,44
Grasshoppers,2335,5,11,7,14,45,47,-2,40
FC Zürich,2335,6,9,12,11,41,38,3,39
FC Lugano,2335,7,9,7,16,33,52,-19,34
FC Thun,2335,8,8,7,17,44,62,-18,31
FC Sion,2335,9,7,9,16,43,56,-13,30
Young Boys,2336,1,21,7,4,72,33,39,70
FC Basel,2336,2,19,8,5,55,25,30,65
St Gallen,2336,3,15,3,14,45,55,-10,48
Lucerne,2336,4,13,7,12,43,49,-6,46
FC Zürich,2336,5,10,11,11,40,36,4,41
Grasshoppers,2336,6,9,7,16,40,48,-8,34
FC Thun,2336,7,9,7,16,43,58,-15,34
FC Lugano,2336,8,9,7,16,30,50,-20,34
FC Sion,2336,9,6,9,17,40,54,-14,27
Young Boys,2337,1,23,6,3,73,34,39,75
FC Basel,2337,2,17,9,6,53,24,29,60
St Gallen,2337,3,15,3,14,45,55,-10,48
Lucerne,2337,4,12,8,12,42,49,-7,44
FC Zürich,2337,5,10,12,10,41,33,8,42
FC Lugano,2337,6,11,6,15,32,47,-15,39
Grasshoppers,2337,7,10,6,16,48,53,-5,36
FC Thun,2337,8,8,8,16,42,60,-18,32
FC Sion,2337,9,5,8,19,39,60,-21,23
Young Boys,2338,1,22,7,3,70,33,37,73
FC Basel,2338,2,17,10,5,54,26,28,61
Lucerne,2338,3,13,10,9,44,38,6,49
St Gallen,2338,4,14,4,14,45,56,-11,46
FC Zürich,2338,5,11,10,11,44,37,7,43
Grasshoppers,2338,6,8,9,15,42,51,-9,33
FC Thun,2338,7,8,8,16,45,61,-16,32
FC Lugano,2338,8,9,5,18,29,56,-27,32
FC Sion,2338,9,6,9,17,40,55,-15,27
Young Boys,2339,1,23,6,3,78,36,42,75
FC Basel,2339,2,17,8,7,58,29,29,59
Lucerne,2339,3,14,8,10,47,44,3,50
St Gallen,2339,4,15,3,14,46,59,-13,48
FC Zürich,2339,5,11,11,10,41,35,6,44
FC Thun,2339,6,10,5,17,44,60,-16,35
Grasshoppers,2339,7,9,6,17,42,56,-14,33
FC Lugano,2339,8,9,6,17,29,50,-21,33
FC Sion,2339,9,6,7,19,40,56,-16,25
Young Boys,2340,1,23,6,3,79,32,47,75
FC Basel,2340,2,18,7,7,55,27,28,61
St Gallen,2340,3,14,4,14,44,55,-11,46
FC Zürich,2340,4,12,9,11,44,36,8,45
Lucerne,2340,5,12,8,12,41,45,-4,44
Grasshoppers,2340,6,10,7,15,45,51,-6,37
FC Thun,2340,7,10,6,16,43,59,-16,36
FC Lugano,2340,8,10,5,17,30,52,-22,35
FC Sion,2340,9,5,8,19,39,63,-24,23
Young Boys,2341,1,21,7,4,70,35,35,70
FC Basel,2341,2,19,8,5,52,22,30,65
St Gallen,2341,3,15,2,15,44,57,-13,47
Lucerne,2341,4,13,7,12,41,43,-2,46
FC Zürich,2341,5,10,10,12,44,38,6,40
FC Thun,2341,6,11,5,16,43,57,-14,38
FC Lugano,2341,7,10,6,16,33,48,-15,36
Grasshoppers,2341,8,9,6,17,45,54,-9,33
FC Sion,2341,9,7,7,18,42,60,-18,28
Young Boys,2342,1,21,6,5,70,35,35,69
FC Basel,2342,2,18,8,6,55,24,31,62
FC Zürich,2342,3,12,10,10,48,35,13,46
Lucerne,2342,4,12,8,12,40,46,-6,44
St Gallen,2342,5,13,4,15,41,58,-17,43
FC Lugano,2342,6,11,5,16,30,49,-19,38
FC Thun,2342,7,10,6,16,49,57,-8,36
Grasshoppers,2342,8,9,6,17,40,55,-15,33
FC Sion,2342,9,7,9,16,40,54,-14,30
Young Boys,2343,1,20,9,3,68,34,34,69
FC Basel,2343,2,17,8,7,53,26,27,59
St Gallen,2343,3,15,2,15,45,56,-11,47
Lucerne,2343,4,12,9,11,43,45,-2,45
FC Zürich,2343,5,10,11,11,38,34,4,41
FC Lugano,2343,6,11,6,15,30,44,-14,39
FC Thun,2343,7,10,5,17,43,59,-16,35
Grasshoppers,2343,8,8,8,16,39,50,-11,32
FC Sion,2343,9,7,10,15,41,52,-11,31
Young Boys,2344,1,21,7,4,69,35,34,70
FC Basel,2344,2,18,7,7,52,26,26,61
Lucerne,2344,3,14,8,10,42,41,1,50
St Gallen,2344,4,14,2,16,41,54,-13,44
FC Zürich,2344,5,11,9,12,40,36,4,42
Grasshoppers,2344,6,11,6,15,46,47,-1,39
FC Lugano,2344,7,10,5,17,28,46,-18,35
FC Thun,2344,8,9,5,18,41,59,-18,32
FC Sion,2344,9,8,7,17,42,57,-15,31
Young Boys,2345,1,21,9,2,70,34,36,72
FC Basel,2345,2,19,7,6,55,26,29,64
Lucerne,2345,3,11,10,11,40,44,-4,43
St Gallen,2345,4,13,3,16,43,57,-14,42
FC Zürich,2345,5,10,10,12,42,41,1,40
FC Lugano,2345,6,10,8,14,33,47,-14,38
Grasshoppers,2345,7,10,7,15,44,48,-4,37
FC Thun,2345,8,9,6,17,42,58,-16,33
FC Sion,2345,9,7,8,17,45,59,-14,29
Young Boys,2346,1,23,6,3,74,33,41,75
FC Basel,2346,2,18,8,6,53,28,25,62
St Gallen,2346,3,14,3,15,42,55,-13,45
Lucerne,2346,4,11,8,13,38,45,-7,41
FC Lugano,2346,5,11,6,15,32,44,-12,39
FC Zürich,2346,6,9,10,13,38,39,-1,37
Grasshoppers,2346,7,10,6,16,41,51,-10,36
FC Thun,2346,8,10,5,17,47,59,-12,35
FC Sion,2346,9,8,8,16,41,52,-11,32
Young Boys,2347,1,20,6,6,66,35,31,66
FC Basel,2347,2,19,8,5,54,23,31,65
Lucerne,2347,3,14,8,10,40,39,1,50
St Gallen,2347,4,14,2,16,42,57,-15,44
FC Zürich,2347,5,10,9,13,44,39,5,39
FC Lugano,2347,6,11,5,16,32,47,-15,38
Grasshoppers,2347,7,10,6,16,41,52,-11,36
FC Thun,2347,8,10,5,17,45,58,-13,35
FC Sion,2347,9,8,7,17,41,55,-14,31
Young Boys,2348,1,21,8,3,72,33,39,71
FC Basel,2348,2,19,7,6,61,25,36,64
St Gallen,2348,3,14,3,15,44,57,-13,45
Lucerne,2348,4,12,7,13,39,50,-11,43
FC Zürich,2348,5,10,11,11,41,40,1,41
Grasshoppers,2348,6,11,7,14,41,45,-4,40
FC Lugano,2348,7,10,7,15,31,46,-15,37
FC Thun,2348,8,9,5,18,42,59,-17,32
FC Sion,2348,9,6,9,17,38,54,-16,27
Young Boys,2349,1,21,7,4,72,38,34,70
FC Basel,2349,2,19,7,6,55,26,29,64
St Gallen,2349,3,16,2,14,45,51,-6,50
FC Zürich,2349,4,12,10,10,45,34,11,46
Lucerne,2349,5,11,9,12,41,46,-5,42
Grasshoppers,2349,6,9,8,15,41,51,-10,35
FC Lugano,2349,7,9,6,17,28,54,-26,33
FC Thun,2349,8,9,5,18,45,60,-15,32
FC Sion,2349,9,7,8,17,43,55,-12,29
Young Boys,2350,1,22,8,2,74,35,39,74
FC Basel,2350,2,17,8,7,54,27,27,59
St Gallen,2350,3,15,3,14,46,55,-9,48
Lucerne,2350,4,12,7,13,41,50,-9,43
FC Lugano,2350,5,12,6,14,33,44,-11,42
FC Zürich,2350,6,10,9,13,38,37,1,39
Grasshoppers,2350,7,10,6,16,43,50,-7,36
FC Thun,2350,8,9,5,18,44,61,-17,32
FC Sion,2350,9,7,8,17,42,56,-14,29
Young Boys,2351,1,22,7,3,72,34,38,73
FC Basel,2351,2,17,9,6,54,24,30,60
St Gallen,2351,3,14,3,15,42,54,-12,45
FC Zürich,2351,4,11,10,11,41,36,5,43
Lucerne,2351,5,11,9,12,42,48,-6,42
FC Lugano,2351,6,11,6,15,32,48,-16,39
Grasshoppers,2351,7,10,6,16,42,50,-8,36
FC Thun,2351,8,10,5,17,45,59,-14,35
FC Sion,2351,9,7,7,18,38,55,-17,28
Young Boys,2352,1,21,7,4,69,36,33,70
FC Basel,2352,2,18,8,6,56,29,27,62
Lucerne,2352,3,14,7,11,46,43,3,49
St Gallen,2352,4,14,2,16,43,60,-17,44
FC Zürich,2352,5,10,10,12,39,37,2,40
FC Lugano,2352,6,11,5,16,34,46,-12,38
Grasshoppers,2352,7,10,6,16,42,48,-6,36
FC Thun,2352,8,10,6,16,45,60,-15,36
FC Sion,2352,9,6,9,17,39,54,-15,27
Young Boys,2353,1,21,7,4,71,37,34,70
FC Basel,2353,2,17,10,5,48,21,27,61
Lucerne,2353,3,12,9,11,41,42,-1,45
St Gallen,2353,4,14,3,15,42,54,-12,45
FC Zürich,2353,5,10,10,12,43,35,8,40
FC Lugano,2353,6,11,7,14,33,44,-11,40
Grasshoppers,2353,7,10,7,15,44,50,-6,37
FC Thun,2353,8,9,7,16,42,57,-15,34
FC Sion,2353,9,6,8,18,41,65,-24,26
Young Boys,2354,1,22,6,4,75,39,36,72
FC Basel,2354,2,18,8,6,58,27,31,62
Lucerne,2354,3,14,7,11,48,48,0,49
St Gallen,2354,4,14,3,15,41,56,-15,45
FC Zürich,2354,5,10,10,12,40,38,2,40
FC Thun,2354,6,11,6,15,45,55,-10,39
Grasshoppers,2354,7,10,7,15,44,49,-5,37
FC Lugano,2354,8,9,6,17,29,50,-21,33
FC Sion,2354,9,6,7,19,43,61,-18,25
Young Boys,2355,1,21,7,4,69,35,34,70
FC Basel,2355,2,18,8,6,53,25,28,62
St Gallen,2355,3,14,3,15,43,59,-16,45
Lucerne,2355,4,12,8,12,40,44,-4,44
FC Lugano,2355,5,13,5,14,37,45,-8,44
FC Zürich,2355,6,10,10,12,42,38,4,40
FC Thun,2355,7,11,5,16,47,57,-10,38
Grasshoppers,2355,8,8,6,18,39,54,-15,30
FC Sion,2355,9,7,8,17,44,57,-13,29
Young Boys,2356,1,23,7,2,76,35,41,76
FC Basel,2356,2,18,9,5,55,26,29,63
St Gallen,2356,3,14,4,14,42,52,-10,46
Lucerne,2356,4,12,8,12,40,46,-6,44
FC Lugano,2356,5,11,5,16,30,46,-16,38
FC Zürich,2356,6,9,10,13,38,37,1,37
Grasshoppers,2356,7,9,7,16,44,51,-7,34
FC Thun,2356,8,9,6,17,43,65,-22,33
FC Sion,2356,9,6,10,16,41,51,-10,28
Young Boys,2357,1,19,9,4,65,35,30,66
FC Basel,2357,2,18,8,6,58,28,30,62
Lucerne,2357,3,15,7,10,46,43,3,52
FC Zürich,2357,4,12,10,10,44,35,9,46
St Gallen,2357,5,13,4,15,42,56,-14,43
FC Thun,2357,6,10,5,17,44,61,-17,35
FC Lugano,2357,7,9,7,16,29,47,-18,34
Grasshoppers,2357,8,8,7,17,40,52,-12,31
FC Sion,2357,9,7,9,16,40,51,-11,30
Young Boys,2358,1,20,7,5,71,41,30,67
FC Basel,2358,2,16,11,5,53,27,26,59
Lucerne,2358,3,13,10,9,43,39,4,49
St Gallen,2358,4,14,4,14,41,53,-12,46
FC Zürich,2358,5,10,9,13,39,38,1,39
FC Thun,2358,6,11,6,15,46,55,-9,39
FC Lugano,2358,7,10,7,15,34,48,-14,37
Grasshoppers,2358,8,9,7,16,40,52,-12,34
FC Sion,2358,9,7,7,18,39,53,-14,28
Young Boys,2359,1,20,7,5,68,38,30,67
FC Basel,2359,2,19,7,6,58,24,34,64
Lucerne,2359,3,14,8,10,47,44,3,50
St Gallen,2359,4,15,3,14,48,58,-10,48
FC Zürich,2359,5,11,11,10,44,35,9,44
Grasshoppers,2359,6,10,7,15,42,49,-7,37
FC Lugano,2359,7,9,6,17,30,50,-20,33
FC Thun,2359,8,8,6,18,43,66,-23,30
FC Sion,2359,9,6,9,17,44,60,-16,27
Young Boys,2360,1,22,7,3,72,36,36,73
FC Basel,2360,2,17,9,6,57,28,29,60
FC Zürich,2360,3,13,9,10,44,35,9,48
St Gallen,2360,4,14,4,14,41,53,-12,46
Lucerne,2360,5,12,7,13,44,48,-4,43
Grasshoppers,2360,6,10,6,16,42,51,-9,36
FC Lugano,2360,7,10,5,17,29,47,-18,35
FC Thun,2360,8,9,6,17,45,61,-16,33
FC Sion,2360,9,6,9,17,40,55,-15,27
Young Boys,2361,1,20,8,4,68,34,34,68
FC Basel,2361,2,18,9,5,61,27,34,63
St Gallen,2361,3,15,4,13,43,50,-7,49
Lucerne,2361,4,12,9,11,40,44,-4,45
FC Zürich,2361,5,10,9,13,39,36,3,39
Grasshoppers,2361,6,11,6,15,43,46,-3,39
FC Lugano,2361,7,10,5,17,28,47,-19,35
FC Thun,2361,8,10,5,17,41,63,-22,35
FC Sion,2361,9,7,7,18,39,55,-16,28
Young Boys,2362,1,20,6,6,70,37,33,66
FC Basel,2362,2,17,9,6,57,29,28,60
Lucerne,2362,3,13,10,9,44,41,3,49
St Gallen,2362,4,15,4,13,47,54,-7,49
FC Zürich,2362,5,11,10,11,42,36,6,43
Grasshoppers,2362,6,11,7,14,47,48,-1,40
FC Lugano,2362,7,10,5,17,30,53,-23,35
FC Thun,2362,8,9,5,18,45,63,-18,32
FC Sion,2362,9,6,8,18,40,61,-21,26
Young Boys,2363,1,21,8,3,73,36,37,71
FC Basel,2363,2,16,9,7,53,31,22,57
St Gallen,2363,3,16,3,13,45,52,-7,51
Lucerne,2363,4,12,8,12,40,46,-6,44
FC Zürich,2363,5,11,10,11,41,35,6,43
FC Lugano,2363,6,11,6,15,34,46,-12,39
Grasshoppers,2363,7,9,6,17,39,51,-12,33
FC Thun,2363,8,9,5,18,43,59,-16,32
FC Sion,2363,9,7,9,16,41,53,-12,30
Young Boys,2364,1,22,7,3,76,37,39,73
FC Basel,2364,2,19,7,6,64,29,35,64
Lucerne,2364,3,14,8,10,45,43,2,50
St Gallen,2364,4,15,3,14,44,54,-10,48
FC Zürich,2364,5,12,9,11,45,38,7,45
Grasshoppers,2364,6,10,6,16,43,49,-6,36
FC Lugano,2364,7,9,6,17,29,49,-20,33
FC Thun,2364,8,8,6,18,42,65,-23,30
FC Sion,2364,9,5,8,19,38,62,-24,23
Young Boys,2365,1,22,7,3,74,31,43,73
FC Basel,2365,2,19,8,5,58,26,32,65
St Gallen,2365,3,15,3,14,46,56,-10,48
FC Zürich,2365,4,12,9,11,43,37,6,45
Lucerne,2365,5,12,8,12,41,46,-5,44
Grasshoppers,2365,6,9,7,16,40,52,-12,34
FC Thun,2365,7,9,6,17,47,60,-13,33
FC Lugano,2365,8,9,5,18,30,55,-25,32
FC Sion,2365,9,6,9,17,39,55,-16,27
Young Boys,2366,1,23,7,2,75,32,43,76
FC Basel,2366,2,17,9,6,52,24,28,60
Lucerne,2366,3,13,8,11,42,45,-3,47
St Gallen,2366,4,13,4,15,42,58,-16,43
FC Zürich,2366,5,11,9,12,41,37,4,42
FC Thun,2366,6,10,6,16,48,59,-11,36
FC Lugano,2366,7,10,5,17,29,48,-19,35
Grasshoppers,2366,8,9,7,16,41,50,-9,34
FC Sion,2366,9,7,7,18,42,59,-17,28
Young Boys,2367,1,20,9,3,70,35,35,69
FC Basel,2367,2,17,8,7,58,28,30,59
Lucerne,2367,3,14,8,10,49,44,5,50
St Gallen,2367,4,15,2,15,44,55,-11,47
FC Zürich,2367,5,11,10,11,44,37,7,43
Grasshoppers,2367,6,11,6,15,46,50,-4,39
FC Lugano,2367,7,10,5,17,30,53,-23,35
FC Thun,2367,8,8,7,17,43,63,-20,31
FC Sion,2367,9,6,9,17,40,59,-19,27
Young Boys,2368,1,21,7,4,70,36,34,70
FC Basel,2368,2,18,9,5,54,23,31,63
FC Zürich,2368,3,12,10,10,48,35,13,46
Lucerne,2368,4,13,7,12,45,44,1,46
St Gallen,2368,5,13,3,16,42,59,-17,42
FC Lugano,2368,6,12,5,15,36,50,-14,41
FC Thun,2368,7,9,5,18,43,63,-20,32
Grasshoppers,2368,8,8,7,17,38,55,-17,31
FC Sion,2368,9,7,9,16,42,53,-11,30
Young Boys,2369,1,22,7,3,71,33,38,73
FC Basel,2369,2,20,7,5,57,23,34,67
Lucerne,2369,3,13,9,10,47,41,6,48
FC Zürich,2369,4,12,9,11,43,37,6,45
St Gallen,2369,5,14,2,16,42,63,-21,44
FC Lugano,2369,6,9,6,17,33,52,-19,33
FC Thun,2369,7,9,5,18,50,66,-16,32
FC Sion,2369,8,8,7,17,44,54,-10,31
Grasshoppers,2369,9,8,6,18,41,59,-18,30
Young Boys,2370,1,23,7,2,73,33,40,76
FC Basel,2370,2,17,7,8,52,28,24,58
St Gallen,2370,3,15,2,15,44,56,-12,47
Lucerne,2370,4,12,7,13,41,47,-6,43
FC Zürich,2370,5,10,10,12,43,38,5,40
FC Lugano,2370,6,11,6,15,33,46,-13,39
Grasshoppers,2370,7,9,8,15,42,50,-8,35
FC Thun,2370,8,9,6,17,42,59,-17,33
FC Sion,2370,9,8,7,17,44,57,-13,31
Young Boys,2371,1,23,6,3,77,35,42,75
FC Basel,2371,2,18,8,6,57,29,28,62
St Gallen,2371,3,15,3,14,45,54,-9,48
Lucerne,2371,4,12,8,12,44,50,-6,44
FC Zürich,2371,5,9,11,12,40,38,2,38
FC Thun,2371,6,10,6,16,45,59,-14,36
FC Lugano,2371,7,9,7,16,29,48,-19,34
FC Sion,2371,8,8,8,16,43,55,-12,32
Grasshoppers,2371,9,8,7,17,42,54,-12,31
Young Boys,2372,1,21,7,4,73,36,37,70
FC Basel,2372,2,18,9,5,56,26,30,63
Lucerne,2372,3,14,8,10,48,43,5,50
FC Zürich,2372,4,10,12,10,41,36,5,42
St Gallen,2372,5,13,2,17,40,59,-19,41
Grasshoppers,2372,6,10,6,16,42,53,-11,36
FC Lugano,2372,7,10,6,16,29,49,-20,36
FC Thun,2372,8,9,6,17,44,59,-15,33
FC Sion,2372,9,6,10,16,41,53,-12,28
Young Boys,2373,1,22,7,3,72,37,35,73
FC Basel,2373,2,17,8,7,55,26,29,59
Lucerne,2373,3,13,9,10,45,43,2,48
St Gallen,2373,4,15,2,15,44,55,-11,47
FC Zürich,2373,5,11,10,11,43,38,5,43
FC Thun,2373,6,11,6,15,47,59,-12,39
FC Lugano,2373,7,10,6,16,31,47,-16,36
Grasshoppers,2373,8,8,6,18,42,59,-17,30
FC Sion,2373,9,6,8,18,40,55,-15,26
Young Boys,2374,1,22,7,3,73,36,37,73
FC Basel,2374,2,19,7,6,57,27,30,64
FC Zürich,2374,3,13,9,10,43,34,9,48
Lucerne,2374,4,13,7,12,42,45,-3,46
St Gallen,2374,5,14,3,15,43,55,-12,45
Grasshoppers,2374,6,9,8,15,43,51,-8,35
FC Lugano,2374,7,9,6,17,30,49,-19,33
FC Thun,2374,8,8,6,18,40,60,-20,30
FC Sion,2374,9,7,7,18,38,52,-14,28
Young Boys,2375,1,21,7,4,74,37,37,70
FC Basel,2375,2,20,7,5,61,24,37,67
Lucerne,2375,3,12,8,12,41,46,-5,44
St Gallen,2375,4,13,2,17,41,59,-18,41
FC Zürich,2375,5,10,9,13,39,42,-3,39
Grasshoppers,2375,6,10,7,15,43,52,-9,37
FC Lugano,2375,7,10,6,16,31,49,-18,36
FC Thun,2375,8,9,7,16,44,59,-15,34
FC Sion,2375,9,8,9,15,43,49,-6,33
Young Boys,2376,1,22,7,3,69,32,37,73
FC Basel,2376,2,16,8,8,49,28,21,56
Lucerne,2376,3,13,9,10,43,41,2,48
FC Zürich,2376,4,12,10,10,46,36,10,46
St Gallen,2376,5,14,3,15,42,54,-12,45
FC Thun,2376,6,10,7,15,43,56,-13,37
Grasshoppers,2376,7,9,7,16,39,48,-9,34
FC Lugano,2376,8,9,6,17,29,47,-18,33
FC Sion,2376,9,6,9,17,40,58,-18,27
Young Boys,2377,1,21,8,3,74,38,36,71
FC Basel,2377,2,19,8,5,59,24,35,65
St Gallen,2377,3,14,3,15,42,55,-13,45
Lucerne,2377,4,12,8,12,41,48,-7,44
FC Thun,2377,5,11,5,16,43,56,-13,38
Grasshoppers,2377,6,10,7,15,43,47,-4,37
FC Zürich,2377,7,9,9,14,38,41,-3,36
FC Lugano,2377,8,10,5,17,29,48,-19,35
FC Sion,2377,9,7,9,16,41,53,-12,30
Young Boys,2378,1,20,7,5,68,36,32,67
FC Basel,2378,2,19,7,6,58,28,30,64
St Gallen,2378,3,14,4,14,47,57,-10,46
FC Zürich,2378,4,11,10,11,40,39,1,43
Lucerne,2378,5,11,10,11,40,47,-7,43
FC Thun,2378,6,11,5,16,53,55,-2,38
Grasshoppers,2378,7,10,7,15,40,50,-10,37
FC Lugano,2378,8,9,7,16,31,48,-17,34
FC Sion,2378,9,6,9,17,38,55,-17,27
Young Boys,2379,1,23,6,3,72,34,38,75
FC Basel,2379,2,18,7,7,56,27,29,61
Lucerne,2379,3,14,7,11,41,41,0,49
FC Zürich,2379,4,12,9,11,43,34,9,45
St Gallen,2379,5,14,2,16,44,57,-13,44
FC Lugano,2379,6,10,5,17,30,48,-18,35
FC Thun,2379,7,9,6,17,43,62,-19,33
Grasshoppers,2379,8,8,8,16,41,51,-10,32
FC Sion,2379,9,7,8,17,41,57,-16,29
Young Boys,2380,1,22,6,4,76,39,37,72
FC Basel,2380,2,16,11,5,54,27,27,59
St Gallen,2380,3,16,3,13,47,52,-5,51
FC Zürich,2380,4,10,11,11,41,36,5,41
Lucerne,2380,5,11,8,13,37,48,-11,41
FC Lugano,2380,6,12,5,15,34,45,-11,41
FC Thun,2380,7,10,7,15,44,56,-12,37
Grasshoppers,2380,8,9,6,17,42,52,-10,33
FC Sion,2380,9,6,7,19,39,59,-20,25
Young Boys,2381,1,22,8,2,72,32,40,74
FC Basel,2381,2,18,9,5,64,27,37,63
Lucerne,2381,3,12,9,11,37,42,-5,45
St Gallen,2381,4,13,4,15,41,55,-14,43
FC Lugano,2381,5,11,7,14,30,42,-12,40
FC Zürich,2381,6,9,10,13,37,40,-3,37
Grasshoppers,2381,7,10,6,16,40,49,-9,36
FC Thun,2381,8,10,5,17,43,61,-18,35
FC Sion,2381,9,6,8,18,38,54,-16,26
Young Boys,2382,1,22,7,3,71,34,37,73
FC Basel,2382,2,18,8,6,58,28,30,62
Lucerne,2382,3,12,8,12,42,47,-5,44
St Gallen,2382,4,13,3,16,41,56,-15,42
FC Zürich,2382,5,10,9,13,38,38,0,39
FC Lugano,2382,6,11,6,15,31,45,-14,39
Grasshoppers,2382,7,10,7,15,41,49,-8,37
FC Thun,2382,8,10,6,16,48,59,-11,36
FC Sion,2382,9,7,8,17,39,53,-14,29
Young Boys,2383,1,21,7,4,71,37,34,70
FC Basel,2383,2,18,8,6,53,26,27,62
Lucerne,2383,3,13,8,11,45,45,0,47
St Gallen,2383,4,14,3,15,42,55,-13,45
FC Lugano,2383,5,11,7,14,35,46,-11,40
FC Zürich,2383,6,9,10,13,40,42,-2,37
Grasshoppers,2383,7,10,6,16,44,50,-6,36
FC Thun,2383,8,10,5,17,42,57,-15,35
FC Sion,2383,9,7,8,17,43,57,-14,29
Young Boys,2384,1,22,6,4,69,37,32,72
FC Basel,2384,2,18,8,6,56,25,31,62
St Gallen,2384,3,14,4,14,45,55,-10,46
Lucerne,2384,4,12,9,11,42,46,-4,45
FC Zürich,2384,5,10,10,12,38,35,3,40
Grasshoppers,2384,6,11,7,14,44,47,-3,40
FC Lugano,2384,7,10,6,16,31,49,-18,36
FC Thun,2384,8,10,5,17,44,58,-14,35
FC Sion,2384,9,5,9,18,36,53,-17,24
Young Boys,2385,1,22,6,4,68,33,35,72
FC Basel,2385,2,20,7,5,54,24,30,67
Lucerne,2385,3,13,7,12,40,43,-3,46
St Gallen,2385,4,14,2,16,42,54,-12,44
FC Lugano,2385,5,12,5,15,32,44,-12,41
FC Zürich,2385,6,10,9,13,42,40,2,39
FC Thun,2385,7,10,5,17,41,58,-17,35
Grasshoppers,2385,8,9,6,17,40,49,-9,33
FC Sion,2385,9,7,7,18,43,57,-14,28
Young Boys,2386,1,21,9,2,71,34,37,72
FC Basel,2386,2,18,8,6,53,26,27,62
St Gallen,2386,3,13,4,15,43,58,-15,43
Lucerne,2386,4,11,9,12,42,47,-5,42
FC Zürich,2386,5,10,11,11,38,36,2,41
FC Thun,2386,6,11,5,16,44,55,-11,38
FC Lugano,2386,7,10,8,14,31,43,-12,38
Grasshoppers,2386,8,9,7,16,41,50,-9,34
FC Sion,2386,9,6,9,17,38,52,-14,27
Young Boys,2387,1,23,7,2,75,32,43,76
FC Basel,2387,2,17,8,7,55,29,26,59
St Gallen,2387,3,16,2,14,45,54,-9,50
Lucerne,2387,4,12,8,12,42,46,-4,44
FC Zürich,2387,5,10,11,11,42,37,5,41
FC Lugano,2387,6,10,6,16,29,47,-18,36
FC Thun,2387,7,10,5,17,43,60,-17,35
Grasshoppers,2387,8,8,7,17,41,53,-12,31
FC Sion,2387,9,7,8,17,40,54,-14,29
Young Boys,2388,1,20,8,4,71,38,33,68
FC Basel,2388,2,19,7,6,60,24,36,64
St Gallen,2388,3,16,2,14,43,55,-12,50
Lucerne,2388,4,13,7,12,42,47,-5,46
FC Zürich,2388,5,10,11,11,42,37,5,41
Grasshoppers,2388,6,10,6,16,45,54,-9,36
FC Thun,2388,7,9,7,16,46,62,-16,34
FC Lugano,2388,8,9,7,16,30,48,-18,34
FC Sion,2388,9,6,9,17,44,58,-14,27
Young Boys,2389,1,22,7,3,73,34,39,73
FC Basel,2389,2,19,7,6,56,25,31,64
St Gallen,2389,3,15,3,14,49,55,-6,48
FC Zürich,2389,4,12,9,11,44,34,10,45
Lucerne,2389,5,12,7,13,41,47,-6,43
Grasshoppers,2389,6,11,6,15,41,47,-6,39
FC Lugano,2389,7,10,7,15,32,48,-16,37
FC Thun,2389,8,8,6,18,40,62,-22,30
FC Sion,2389,9,5,8,19,38,62,-24,23
Young Boys,2390,1,22,6,4,73,40,33,72
FC Basel,2390,2,18,7,7,59,27,32,61
Lucerne,2390,3,13,7,12,43,44,-1,46
St Gallen,2390,4,14,2,16,43,56,-13,44
FC Zürich,2390,5,11,10,11,41,37,4,43
FC Lugano,2390,6,11,5,16,31,47,-16,38
Grasshoppers,2390,7,9,7,16,43,53,-10,34
FC Sion,2390,8,8,9,15,49,57,-8,33
FC Thun,2390,9,9,5,18,44,65,-21,32
Young Boys,2391,1,21,8,3,74,36,38,71
FC Basel,2391,2,17,9,6,51,24,27,60
Lucerne,2391,3,14,8,10,44,46,-2,50
FC Zürich,2391,4,13,9,10,43,33,10,48
St Gallen,2391,5,13,2,17,39,58,-19,41
FC Lugano,2391,6,10,5,17,32,49,-17,35
Grasshoppers,2391,7,9,6,17,43,51,-8,33
FC Thun,2391,8,9,6,17,42,59,-17,33
FC Sion,2391,9,7,9,16,40,52,-12,30
Young Boys,2392,1,23,7,2,75,31,44,76
FC Basel,2392,2,17,8,7,53,28,25,59
St Gallen,2392,3,15,2,15,44,55,-11,47
FC Zürich,2392,4,12,9,11,46,38,8,45
Lucerne,2392,5,12,8,12,39,44,-5,44
FC Lugano,2392,6,10,6,16,32,48,-16,36
FC Thun,2392,7,9,6,17,43,61,-18,33
Grasshoppers,2392,8,8,8,16,37,49,-12,32
FC Sion,2392,9,7,8,17,40,55,-15,29
Young Boys,2393,1,21,8,3,71,35,36,71
FC Basel,2393,2,15,10,7,51,33,18,55
St Gallen,2393,3,16,3,13,50,56,-6,51
Lucerne,2393,4,13,8,11,47,45,2,47
FC Zürich,2393,5,11,10,11,42,34,8,43
FC Thun,2393,6,10,6,16,45,58,-13,36
FC Lugano,2393,7,10,6,16,33,50,-17,36
Grasshoppers,2393,8,9,7,16,41,54,-13,34
FC Sion,2393,9,6,8,18,39,54,-15,26
Young Boys,2394,1,20,7,5,72,38,34,67
FC Basel,2394,2,19,7,6,56,26,30,64
St Gallen,2394,3,15,2,15,46,55,-9,47
FC Zürich,2394,4,11,10,11,41,35,6,43
Lucerne,2394,5,11,8,13,39,51,-12,41
FC Lugano,2394,6,11,6,15,30,44,-14,39
FC Thun,2394,7,10,6,16,43,57,-14,36
Grasshoppers,2394,8,9,8,15,42,50,-8,35
FC Sion,2394,9,7,8,17,41,54,-13,29
Young Boys,2395,1,23,6,3,73,34,39,75
FC Basel,2395,2,18,7,7,53,27,26,61
Lucerne,2395,3,13,8,11,40,41,-1,47
St Gallen,2395,4,14,2,16,42,56,-14,44
FC Zürich,2395,5,11,9,12,44,39,5,42
FC Thun,2395,6,11,6,15,47,56,-9,39
Grasshoppers,2395,7,9,8,15,44,47,-3,35
FC Lugano,2395,8,10,5,17,33,52,-19,35
FC Sion,2395,9,6,7,19,37,61,-24,25
Young Boys,2396,1,22,6,4,75,35,40,72
FC Basel,2396,2,16,9,7,52,29,23,57
Lucerne,2396,3,14,9,9,44,42,2,51
St Gallen,2396,4,15,4,13,46,54,-8,49
FC Zürich,2396,5,12,9,11,48,40,8,45
FC Thun,2396,6,10,6,16,47,58,-11,36
Grasshoppers,2396,7,9,6,17,43,56,-13,33
FC Lugano,2396,8,9,5,18,32,55,-23,32
FC Sion,2396,9,6,8,18,41,59,-18,26
Young Boys,2397,1,22,6,4,77,36,41,72
FC Basel,2397,2,15,10,7,46,25,21,55
Lucerne,2397,3,13,8,11,41,42,-1,47
St Gallen,2397,4,15,2,15,41,52,-11,47
FC Zürich,2397,5,12,10,10,42,33,9,46
FC Lugano,2397,6,11,5,16,31,49,-18,38
FC Thun,2397,7,10,6,16,46,56,-10,36
Grasshoppers,2397,8,9,7,16,40,52,-12,34
FC Sion,2397,9,6,8,18,37,56,-19,26
Young Boys,2398,1,22,6,4,74,37,37,72
FC Basel,2398,2,18,7,7,55,27,28,61
Lucerne,2398,3,14,8,10,45,44,1,50
St Gallen,2398,4,15,2,15,48,56,-8,47
FC Zürich,2398,5,11,10,11,42,36,6,43
FC Lugano,2398,6,11,6,15,31,44,-13,39
FC Thun,2398,7,10,6,16,44,58,-14,36
Grasshoppers,2398,8,9,6,17,43,54,-11,33
FC Sion,2398,9,5,7,20,38,64,-26,22
Young Boys,2399,1,21,8,3,74,35,39,71
FC Basel,2399,2,19,7,6,58,27,31,64
Lucerne,2399,3,13,8,11,45,46,-1,47
St Gallen,2399,4,14,4,14,42,53,-11,46
FC Zürich,2399,5,11,10,11,42,37,5,43
FC Lugano,2399,6,10,6,16,30,51,-21,36
FC Thun,2399,7,9,7,16,42,57,-15,34
Grasshoppers,2399,8,8,7,17,38,50,-12,31
FC Sion,2399,9,6,9,17,39,54,-15,27
Young Boys,2400,1,23,6,3,78,37,41,75
FC Basel,2400,2,18,8,6,57,27,30,62
Lucerne,2400,3,14,7,11,44,45,-1,49
FC Lugano,2400,4,12,5,15,32,45,-13,41
St Gallen,2400,5,13,2,17,40,57,-17,41
FC Zürich,2400,6,9,10,13,42,43,-1,37
Grasshoppers,2400,7,9,7,16,40,50,-10,34
FC Thun,2400,8,9,7,16,43,58,-15,34
FC Sion,2400,9,7,8,17,43,57,-14,29
Young Boys,2401,1,22,6,4,74,34,40,72
FC Basel,2401,2,18,9,5,58,26,32,63
Lucerne,2401,3,13,8,11,46,48,-2,47
St Gallen,2401,4,14,4,14,47,57,-10,46
FC Zürich,2401,5,10,11,11,42,42,0,41
FC Sion,2401,6,8,9,15,42,50,-8,33
Grasshoppers,2401,7,9,6,17,42,52,-10,33
FC Thun,2401,8,9,6,17,46,62,-16,33
FC Lugano,2401,9,9,5,18,32,58,-26,32
Young Boys,2402,1,23,7,2,70,30,40,76
FC Basel,2402,2,18,7,7,52,25,27,61
St Gallen,2402,3,17,2,13,44,50,-6,53
Lucerne,2402,4,12,8,12,39,44,-5,44
FC Zürich,2402,5,10,9,13,42,41,1,39
Grasshoppers,2402,6,10,7,15,42,50,-8,37
FC Lugano,2402,7,10,5,17,30,48,-18,35
FC Thun,2402,8,9,5,18,45,61,-16,32
FC Sion,2402,9,6,8,18,41,56,-15,26
Young Boys,2403,1,21,8,3,74,35,39,71
FC Basel,2403,2,19,8,5,58,24,34,65
Lucerne,2403,3,12,9,11,40,47,-7,45
St Gallen,2403,4,13,4,15,39,52,-13,43
FC Zürich,2403,5,11,9,12,39,37,2,42
Grasshoppers,2403,6,11,6,15,45,47,-2,39
FC Lugano,2403,7,9,7,16,30,49,-19,34
FC Thun,2403,8,9,5,18,44,62,-18,32
FC Sion,2403,9,7,8,17,40,56,-16,29
Young Boys,2404,1,21,7,4,66,32,34,70
FC Basel,2404,2,17,8,7,55,26,29,59
Lucerne,2404,3,14,8,10,46,42,4,50
FC Zürich,2404,4,12,9,11,45,37,8,45
St Gallen,2404,5,14,3,15,43,56,-13,45
FC Thun,2404,6,11,5,16,44,60,-16,38
FC Lugano,2404,7,10,5,17,29,49,-20,35
Grasshoppers,2404,8,9,7,16,40,50,-10,34
FC Sion,2404,9,6,8,18,39,55,-16,26
Young Boys,2405,1,20,8,4,69,36,33,68
FC Basel,2405,2,19,7,6,56,27,29,64
Lucerne,2405,3,14,8,10,40,39,1,50
St Gallen,2405,4,15,2,15,45,53,-8,47
FC Zürich,2405,5,10,10,12,39,36,3,40
Grasshoppers,2405,6,9,8,15,38,46,-8,35
FC Lugano,2405,7,10,5,17,29,46,-17,35
FC Thun,2405,8,9,6,17,40,60,-20,33
FC Sion,2405,9,6,10,16,38,51,-13,28
Young Boys,2406,1,21,6,5,71,39,32,69
FC Basel,2406,2,19,8,5,56,24,32,65
Lucerne,2406,3,13,8,11,44,45,-1,47
St Gallen,2406,4,13,2,17,39,54,-15,41
FC Zürich,2406,5,10,10,12,38,35,3,40
FC Lugano,2406,6,11,5,16,30,51,-21,38
FC Sion,2406,7,10,7,15,44,50,-6,37
Grasshoppers,2406,8,9,8,15,45,50,-5,35
FC Thun,2406,9,8,6,18,40,59,-19,30
Young Boys,2407,1,23,6,3,72,33,39,75
FC Basel,2407,2,17,7,8,54,27,27,58
St Gallen,2407,3,16,2,14,46,51,-5,50
Lucerne,2407,4,13,7,12,42,47,-5,46
FC Zürich,2407,5,11,11,10,45,37,8,44
FC Lugano,2407,6,10,6,16,31,49,-18,36
Grasshoppers,2407,7,9,7,16,40,51,-11,34
FC Thun,2407,8,9,7,16,42,59,-17,34
FC Sion,2407,9,6,7,19,37,55,-18,25
Young Boys,2408,1,21,7,4,70,34,36,70
FC Basel,2408,2,19,8,5,58,24,34,65
St Gallen,2408,3,15,3,14,46,56,-10,48
Lucerne,2408,4,13,8,11,43,46,-3,47
FC Zürich,2408,5,12,9,11,43,34,9,45
Grasshoppers,2408,6,11,6,15,47,49,-2,39
FC Thun,2408,7,9,6,17,45,65,-20,33
FC Lugano,2408,8,9,5,18,29,52,-23,32
FC Sion,2408,9,5,8,19,40,61,-21,23
Young Boys,2409,1,21,9,2,70,34,36,72
FC Basel,2409,2,16,9,7,51,28,23,57
Lucerne,2409,3,13,9,10,41,41,0,48
St Gallen,2409,4,14,4,14,43,55,-12,46
FC Zürich,2409,5,11,10,11,43,37,6,43
FC Lugano,2409,6,10,6,16,32,46,-14,36
Grasshoppers,2409,7,9,8,15,43,51,-8,35
FC Thun,2409,8,10,5,17,44,59,-15,35
FC Sion,2409,9,5,10,17,40,56,-16,25
Young Boys,2410,1,21,8,3,73,36,37,71
FC Basel,2410,2,17,9,6,53,26,27,60
Lucerne,2410,3,12,10,10,43,46,-3,46
St Gallen,2410,4,13,4,15,45,58,-13,43
FC Lugano,2410,5,10,8,14,37,51,-14,38
FC Zürich,2410,6,9,10,13,40,39,1,37
FC Thun,2410,7,10,7,15,45,58,-13,37
Grasshoppers,2410,8,8,8,16,37,50,-13,32
FC Sion,2410,9,7,10,15,45,54,-9,31
Young Boys,2411,1,21,7,4,73,38,35,70
FC Basel,2411,2,18,8,6,55,27,28,62
St Gallen,2411,3,16,3,13,46,52,-6,51
Lucerne,2411,4,12,7,13,42,48,-6,43
FC Zürich,2411,5,10,11,11,41,37,4,41
FC Lugano,2411,6,10,7,15,32,48,-16,37
FC Thun,2411,7,10,6,16,47,58,-11,36
Grasshoppers,2411,8,10,6,16,40,52,-12,36
FC Sion,2411,9,6,7,19,36,52,-16,25
Young Boys,2412,1,22,8,2,70,31,39,74
FC Basel,2412,2,17,8,7,54,26,28,59
Lucerne,2412,3,12,10,10,42,46,-4,46
St Gallen,2412,4,13,4,15,42,56,-14,43
FC Zürich,2412,5,11,9,12,40,37,3,42
FC Thun,2412,6,10,7,15,47,59,-12,37
Grasshoppers,2412,7,9,9,14,44,49,-5,36
FC Lugano,2412,8,10,6,16,31,47,-16,36
FC Sion,2412,9,6,7,19,39,58,-19,25
Young Boys,2413,1,20,9,3,71,38,33,69
FC Basel,2413,2,17,8,7,53,27,26,59
Lucerne,2413,3,14,9,9,42,40,2,51
FC Zürich,2413,4,11,10,11,39,34,5,43
St Gallen,2413,5,13,3,16,40,54,-14,42
FC Thun,2413,6,10,6,16,43,54,-11,36
Grasshoppers,2413,7,9,8,15,42,50,-8,35
FC Lugano,2413,8,9,7,16,29,46,-17,34
FC Sion,2413,9,7,8,17,40,56,-16,29
Young Boys,2414,1,22,6,4,72,35,37,72
FC Basel,2414,2,17,8,7,52,29,23,59
Lucerne,2414,3,15,7,10,46,39,7,52
St Gallen,2414,4,15,3,14,46,55,-9,48
FC Zürich,2414,5,12,10,10,40,32,8,46
FC Lugano,2414,6,10,6,16,30,48,-18,36
FC Thun,2414,7,9,5,18,42,61,-19,32
Grasshoppers,2414,8,8,7,17,39,53,-14,31
FC Sion,2414,9,6,8,18,40,55,-15,26
Young Boys,2415,1,21,8,3,70,34,36,71
FC Basel,2415,2,17,9,6,55,25,30,60
St Gallen,2415,3,14,3,15,42,57,-15,45
Lucerne,2415,4,11,10,11,41,48,-7,43
FC Zürich,2415,5,10,10,12,41,38,3,40
FC Lugano,2415,6,11,6,15,34,47,-13,39
FC Thun,2415,7,10,7,15,46,55,-9,37
Grasshoppers,2415,8,9,8,15,42,49,-7,35
FC Sion,2415,9,6,9,17,40,58,-18,27
Young Boys,2416,1,20,7,5,67,37,30,67
FC Basel,2416,2,19,8,5,61,25,36,65
Lucerne,2416,3,13,8,11,40,47,-7,47
St Gallen,2416,4,14,3,15,45,57,-12,45
FC Zürich,2416,5,10,12,10,42,37,5,42
Grasshoppers,2416,6,11,6,15,43,47,-4,39
FC Thun,2416,7,10,6,16,43,57,-14,36
FC Lugano,2416,8,10,6,16,32,48,-16,36
FC Sion,2416,9,5,8,19,36,54,-18,23
Young Boys,2417,1,21,8,3,70,36,34,71
FC Basel,2417,2,18,9,5,60,25,35,63
Lucerne,2417,3,12,9,11,39,48,-9,45
St Gallen,2417,4,14,3,15,44,55,-11,45
FC Zürich,2417,5,10,11,11,39,35,4,41
Grasshoppers,2417,6,10,7,15,43,51,-8,37
FC Lugano,2417,7,10,6,16,30,46,-16,36
FC Thun,2417,8,8,7,17,45,62,-17,31
FC Sion,2417,9,6,10,16,45,57,-12,28
Young Boys,2418,1,21,7,4,71,37,34,70
FC Basel,2418,2,19,7,6,59,25,34,64
Lucerne,2418,3,13,7,12,44,45,-1,46
St Gallen,2418,4,14,2,16,45,59,-14,44
FC Zürich,2418,5,11,10,11,41,35,6,43
FC Lugano,2418,6,11,5,16,31,50,-19,38
Grasshoppers,2418,7,10,7,15,43,53,-10,37
FC Sion,2418,8,8,7,17,45,55,-10,31
FC Thun,2418,9,8,6,18,39,59,-20,30
Young Boys,2419,1,22,8,2,71,30,41,74
FC Basel,2419,2,16,10,6,51,26,25,58
Lucerne,2419,3,13,8,11,43,42,1,47
St Gallen,2419,4,14,3,15,41,55,-14,45
FC Zürich,2419,5,10,11,11,41,37,4,41
FC Lugano,2419,6,11,5,16,34,50,-16,38
Grasshoppers,2419,7,9,8,15,42,52,-10,35
FC Thun,2419,8,8,9,15,42,57,-15,33
FC Sion,2419,9,5,10,17,39,55,-16,25
Young Boys,2420,1,24,6,2,69,30,39,78
FC Basel,2420,2,18,7,7,52,25,27,61
St Gallen,2420,3,15,4,13,43,52,-9,49
Lucerne,2420,4,11,9,12,40,46,-6,42
FC Zürich,2420,5,10,11,11,39,35,4,41
Grasshoppers,2420,6,10,6,16,47,47,0,36
FC Lugano,2420,7,9,7,16,29,46,-17,34
FC Thun,2420,8,9,6,17,42,60,-18,33
FC Sion,2420,9,6,8,18,40,60,-20,26
Young Boys,2421,1,20,6,6,71,45,26,66
FC Basel,2421,2,19,7,6,54,24,30,64
Lucerne,2421,3,13,9,10,42,41,1,48
St Gallen,2421,4,15,3,14,42,51,-9,48
FC Zürich,2421,5,11,10,11,39,35,4,43
Grasshoppers,2421,6,10,7,15,42,49,-7,37
FC Lugano,2421,7,10,5,17,31,47,-16,35
FC Thun,2421,8,9,7,16,42,56,-14,34
FC Sion,2421,9,6,8,18,42,57,-15,26
Young Boys,2422,1,22,7,3,73,38,35,73
FC Basel,2422,2,19,7,6,55,26,29,64
St Gallen,2422,3,16,2,14,46,52,-6,50
Lucerne,2422,4,13,7,12,41,45,-4,46
Grasshoppers,2422,5,10,7,15,45,50,-5,37
FC Zürich,2422,6,9,9,14,38,40,-2,36
FC Thun,2422,7,10,6,16,45,57,-12,36
FC Lugano,2422,8,10,5,17,30,47,-17,35
FC Sion,2422,9,6,8,18,42,60,-18,26
Young Boys,2423,1,20,8,4,69,37,32,68
FC Basel,2423,2,20,7,5,58,24,34,67
St Gallen,2423,3,15,2,15,44,56,-12,47
Lucerne,2423,4,12,9,11,40,43,-3,45
FC Zürich,2423,5,10,10,12,38,36,2,40
FC Thun,2423,6,11,5,16,44,57,-13,38
Grasshoppers,2423,7,10,6,16,41,49,-8,36
FC Lugano,2423,8,9,7,16,29,47,-18,34
FC Sion,2423,9,6,8,18,43,57,-14,26
Young Boys,2424,1,23,6,3,76,36,40,75
FC Basel,2424,2,16,8,8,51,27,24,56
Lucerne,2424,3,14,7,11,44,49,-5,49
FC Zürich,2424,4,12,10,10,43,35,8,46
St Gallen,2424,5,14,3,15,44,58,-14,45
Grasshoppers,2424,6,10,6,16,45,49,-4,36
FC Thun,2424,7,10,5,17,42,59,-17,35
FC Lugano,2424,8,9,6,17,27,46,-19,33
FC Sion,2424,9,7,7,18,47,60,-13,28
Young Boys,2425,1,22,6,4,72,37,35,72
FC Basel,2425,2,18,9,5,61,26,35,63
St Gallen,2425,3,15,3,14,46,54,-8,48
FC Zürich,2425,4,10,11,11,41,38,3,41
Lucerne,2425,5,11,8,13,36,46,-10,41
FC Lugano,2425,6,11,6,15,32,47,-15,39
Grasshoppers,2425,7,10,7,15,39,45,-6,37
FC Thun,2425,8,9,5,18,43,64,-21,32
FC Sion,2425,9,7,7,18,39,52,-13,28
Young Boys,2426,1,22,6,4,73,37,36,72
FC Basel,2426,2,20,7,5,65,26,39,67
Lucerne,2426,3,12,8,12,40,44,-4,44
St Gallen,2426,4,14,2,16,43,59,-16,44
FC Zürich,2426,5,10,10,12,38,41,-3,40
FC Thun,2426,6,11,5,16,48,60,-12,38
FC Lugano,2426,7,10,7,15,33,47,-14,37
Grasshoppers,2426,8,10,6,16,43,51,-8,36
FC Sion,2426,9,6,7,19,39,57,-18,25
Young Boys,2427,1,21,9,2,70,34,36,72
FC Basel,2427,2,18,8,6,54,24,30,62
St Gallen,2427,3,16,2,14,46,54,-8,50
Lucerne,2427,4,13,8,11,43,41,2,47
FC Zürich,2427,5,9,11,12,38,37,1,38
Grasshoppers,2427,6,9,8,15,43,51,-8,35
FC Thun,2427,7,9,8,15,42,56,-14,35
FC Lugano,2427,8,9,6,17,29,50,-21,33
FC Sion,2427,9,5,10,17,37,55,-18,25
Young Boys,2428,1,22,7,3,70,31,39,73
FC Basel,2428,2,19,7,6,57,23,34,64
St Gallen,2428,3,15,2,15,43,56,-13,47
Lucerne,2428,4,13,7,12,42,44,-2,46
FC Zürich,2428,5,9,10,13,37,40,-3,37
FC Thun,2428,6,10,6,16,44,59,-15,36
FC Lugano,2428,7,10,6,16,31,49,-18,36
Grasshoppers,2428,8,9,8,15,44,51,-7,35
FC Sion,2428,9,6,9,17,41,56,-15,27
Young Boys,2429,1,22,7,3,74,37,37,73
FC Basel,2429,2,18,8,6,52,24,28,62
St Gallen,2429,3,16,3,13,48,53,-5,51
Lucerne,2429,4,12,7,13,43,51,-8,43
FC Zürich,2429,5,10,10,12,38,35,3,40
Grasshoppers,2429,6,10,8,14,47,50,-3,38
FC Thun,2429,7,10,6,16,43,55,-12,36
FC Lugano,2429,8,9,5,18,29,51,-22,32
FC Sion,2429,9,6,8,18,38,56,-18,26
Young Boys,2430,1,22,7,3,74,35,39,73
FC Basel,2430,2,19,8,5,56,23,33,65
Lucerne,2430,3,12,9,11,41,46,-5,45
St Gallen,2430,4,13,4,15,43,56,-13,43
FC Zürich,2430,5,10,9,13,39,41,-2,39
FC Lugano,2430,6,11,6,15,32,50,-18,39
Grasshoppers,2430,7,10,6,16,41,48,-7,36
FC Thun,2430,8,10,5,17,46,56,-10,35
FC Sion,2430,9,6,8,18,39,56,-17,26
Young Boys,2431,1,21,8,3,70,34,36,71
FC Basel,2431,2,16,10,6,50,24,26,58
Lucerne,2431,3,12,9,11,40,43,-3,45
St Gallen,2431,4,13,6,13,40,51,-11,45
FC Zürich,2431,5,11,10,11,41,36,5,43
Grasshoppers,2431,6,10,8,14,40,44,-4,38
FC Thun,2431,7,10,6,16,41,56,-15,36
FC Lugano,2431,8,10,6,16,31,48,-17,36
FC Sion,2431,9,5,9,18,37,54,-17,24
Young Boys,2432,1,21,6,5,70,38,32,69
FC Basel,2432,2,20,7,5,66,26,40,67
St Gallen,2432,3,16,2,14,45,52,-7,50
Lucerne,2432,4,12,7,13,41,50,-9,43
FC Zürich,2432,5,10,11,11,40,41,-1,41
FC Lugano,2432,6,10,6,16,30,48,-18,36
Grasshoppers,2432,7,9,8,15,44,51,-7,35
FC Thun,2432,8,8,7,17,45,63,-18,31
FC Sion,2432,9,7,8,17,43,55,-12,29
Young Boys,2433,1,22,6,4,74,38,36,72
FC Basel,2433,2,17,8,7,52,23,29,59
Lucerne,2433,3,13,9,10,43,43,0,48
FC Zürich,2433,4,12,10,10,46,37,9,46
St Gallen,2433,5,13,5,14,41,55,-14,44
Grasshoppers,2433,6,10,8,14,43,49,-6,38
FC Lugano,2433,7,10,5,17,31,50,-19,35
FC Thun,2433,8,8,6,18,42,63,-21,30
FC Sion,2433,9,5,11,16,45,59,-14,26
Young Boys,2434,1,23,6,3,79,33,46,75
FC Basel,2434,2,18,9,5,53,24,29,63
St Gallen,2434,3,14,5,13,44,53,-9,47
Lucerne,2434,4,12,9,11,42,46,-4,45
FC Zürich,2434,5,11,10,11,40,34,6,43
FC Lugano,2434,6,10,7,15,34,54,-20,37
Grasshoppers,2434,7,9,6,17,41,53,-12,33
FC Thun,2434,8,8,6,18,44,64,-20,30
FC Sion,2434,9,6,8,18,43,59,-16,26
Young Boys,2435,1,21,9,2,71,32,39,72
FC Basel,2435,2,15,10,7,51,28,23,55
St Gallen,2435,3,15,4,13,43,51,-8,49
Lucerne,2435,4,12,9,11,46,47,-1,45
FC Zürich,2435,5,11,10,11,43,37,6,43
FC Thun,2435,6,10,7,15,47,59,-12,37
Grasshoppers,2435,7,9,8,15,42,50,-8,35
FC Lugano,2435,8,9,6,17,29,51,-22,33
FC Sion,2435,9,6,9,17,37,54,-17,27
Young Boys,2436,1,19,8,5,69,40,29,65
FC Basel,2436,2,19,7,6,56,28,28,64
Lucerne,2436,3,12,10,10,42,42,0,46
St Gallen,2436,4,14,3,15,43,56,-13,45
FC Zürich,2436,5,10,11,11,43,39,4,41
FC Lugano,2436,6,10,7,15,33,47,-14,37
Grasshoppers,2436,7,8,10,14,40,48,-8,34
FC Thun,2436,8,9,7,16,43,58,-15,34
FC Sion,2436,9,7,9,16,43,54,-11,30
Young Boys,2437,1,21,7,4,75,39,36,70
FC Basel,2437,2,19,8,5,59,25,34,65
Lucerne,2437,3,13,9,10,44,44,0,48
FC Zürich,2437,4,11,10,11,41,36,5,43
St Gallen,2437,5,13,3,16,43,57,-14,42
FC Lugano,2437,6,11,7,14,32,45,-13,40
FC Thun,2437,7,10,5,17,45,60,-15,35
Grasshoppers,2437,8,9,6,17,41,53,-12,33
FC Sion,2437,9,5,9,18,40,61,-21,24
Young Boys,2438,1,22,6,4,73,35,38,72
FC Basel,2438,2,20,7,5,58,25,33,67
St Gallen,2438,3,14,3,15,43,54,-11,45
Lucerne,2438,4,12,7,13,43,50,-7,43
FC Lugano,2438,5,11,7,14,35,48,-13,40
FC Zürich,2438,6,9,11,12,39,37,2,38
FC Thun,2438,7,10,6,16,45,59,-14,36
Grasshoppers,2438,8,9,7,16,43,52,-9,34
FC Sion,2438,9,6,8,18,38,57,-19,26
Young Boys,2439,1,21,7,4,74,39,35,70
FC Basel,2439,2,18,8,6,52,24,28,62
Lucerne,2439,3,13,8,11,45,47,-2,47
FC Zürich,2439,4,11,9,12,42,36,6,42
St Gallen,2439,5,13,3,16,41,59,-18,42
Grasshoppers,2439,6,10,8,14,44,48,-4,38
FC Lugano,2439,7,11,5,16,32,48,-16,38
FC Thun,2439,8,10,6,16,41,55,-14,36
FC Sion,2439,9,6,8,18,42,57,-15,26
Young Boys,2440,1,21,8,3,71,34,37,71
FC Basel,2440,2,19,8,5,57,24,33,65
St Gallen,2440,3,14,4,14,41,52,-11,46
Lucerne,2440,4,12,8,12,39,45,-6,44
FC Zürich,2440,5,11,9,12,43,38,5,42
FC Thun,2440,6,11,5,16,50,59,-9,38
FC Lugano,2440,7,10,7,15,30,47,-17,37
Grasshoppers,2440,8,9,7,16,41,54,-13,34
FC Sion,2440,9,5,8,19,38,57,-19,23
Young Boys,2441,1,21,7,4,71,38,33,70
FC Basel,2441,2,16,8,8,55,34,21,56
Lucerne,2441,3,15,7,10,47,46,1,52
St Gallen,2441,4,16,2,14,46,55,-9,50
FC Zürich,2441,5,11,10,11,44,40,4,43
FC Lugano,2441,6,10,6,16,35,48,-13,36
Grasshoppers,2441,7,9,8,15,40,48,-8,35
FC Thun,2441,8,9,7,16,44,56,-12,34
FC Sion,2441,9,6,7,19,40,57,-17,25
Young Boys,2442,1,21,8,3,74,36,38,71
FC Basel,2442,2,17,9,6,56,25,31,60
St Gallen,2442,3,15,3,14,43,54,-11,48
Lucerne,2442,4,12,8,12,41,46,-5,44
Grasshoppers,2442,5,12,6,14,47,49,-2,42
FC Zürich,2442,6,9,13,10,39,35,4,40
FC Lugano,2442,7,9,7,16,30,48,-18,34
FC Thun,2442,8,9,6,17,46,66,-20,33
FC Sion,2442,9,6,8,18,43,60,-17,26
Young Boys,2443,1,21,7,4,72,36,36,70
FC Basel,2443,2,17,8,7,52,28,24,59
Lucerne,2443,3,14,7,11,43,42,1,49
St Gallen,2443,4,15,4,13,44,52,-8,49
FC Zürich,2443,5,11,10,11,43,36,7,43
FC Lugano,2443,6,11,6,15,33,47,-14,39
Grasshoppers,2443,7,10,6,16,40,51,-11,36
FC Thun,2443,8,9,5,18,41,58,-17,32
FC Sion,2443,9,5,9,18,36,54,-18,24
Young Boys,2444,1,21,7,4,73,39,34,70
FC Basel,2444,2,18,9,5,56,23,33,63
Lucerne,2444,3,13,10,9,44,43,1,49
St Gallen,2444,4,14,3,15,44,56,-12,45
FC Zürich,2444,5,11,10,11,43,37,6,43
Grasshoppers,2444,6,9,8,15,44,54,-10,35
FC Lugano,2444,7,9,6,17,30,49,-19,33
FC Sion,2444,8,7,9,16,42,55,-13,30
FC Thun,2444,9,8,6,18,39,59,-20,30
Young Boys,2445,1,21,9,2,71,35,36,72
FC Basel,2445,2,17,10,5,54,27,27,61
Lucerne,2445,3,14,8,10,50,48,2,50
St Gallen,2445,4,14,3,15,45,56,-11,45
FC Zürich,2445,5,10,10,12,39,36,3,40
FC Thun,2445,6,9,7,16,40,54,-14,34
Grasshoppers,2445,7,9,6,17,41,52,-11,33
FC Sion,2445,8,8,8,16,42,54,-12,32
FC Lugano,2445,9,9,5,18,32,52,-20,32
Young Boys,2446,1,20,8,4,70,36,34,68
FC Basel,2446,2,16,9,7,48,24,24,57
Lucerne,2446,3,13,8,11,41,43,-2,47
St Gallen,2446,4,13,3,16,40,56,-16,42
FC Lugano,2446,5,12,5,15,34,45,-11,41
FC Zürich,2446,6,10,10,12,38,38,0,40
FC Sion,2446,7,9,8,15,46,51,-5,35
FC Thun,2446,8,9,8,15,42,56,-14,35
Grasshoppers,2446,9,8,9,15,41,51,-10,33
Young Boys,2447,1,21,8,3,72,35,37,71
FC Basel,2447,2,16,8,8,51,27,24,56
St Gallen,2447,3,15,3,14,45,55,-10,48
Lucerne,2447,4,12,9,11,39,44,-5,45
FC Zürich,2447,5,11,10,11,40,35,5,43
FC Thun,2447,6,11,5,16,43,58,-15,38
FC Lugano,2447,7,9,9,14,33,48,-15,36
Grasshoppers,2447,8,8,8,16,40,50,-10,32
FC Sion,2447,9,7,8,17,41,52,-11,29
Young Boys,2448,1,22,7,3,73,36,37,73
FC Basel,2448,2,17,8,7,52,24,28,59
FC Zürich,2448,3,12,10,10,44,34,10,46
Lucerne,2448,4,11,10,11,39,43,-4,43
St Gallen,2448,5,13,3,16,39,57,-18,42
FC Lugano,2448,6,11,5,16,30,48,-18,38
Grasshoppers,2448,7,9,9,14,40,47,-7,36
FC Thun,2448,8,9,6,17,41,57,-16,33
FC Sion,2448,9,7,8,17,42,54,-12,29
Young Boys,2449,1,21,7,4,69,33,36,70
FC Basel,2449,2,18,9,5,56,25,31,63
Lucerne,2449,3,13,8,11,41,44,-3,47
St Gallen,2449,4,14,5,13,41,51,-10,47
FC Zürich,2449,5,10,10,12,40,40,0,40
Grasshoppers,2449,6,10,6,16,42,49,-7,36
FC Lugano,2449,7,10,6,16,32,47,-15,36
FC Thun,2449,8,10,5,17,45,60,-15,35
FC Sion,2449,9,6,8,18,37,54,-17,26
Young Boys,2450,1,21,7,4,73,35,38,70
FC Basel,2450,2,18,9,5,55,25,30,63
Lucerne,2450,3,14,8,10,45,40,5,50
St Gallen,2450,4,14,3,15,44,59,-15,45
FC Zürich,2450,5,10,9,13,38,36,2,39
FC Lugano,2450,6,11,5,16,33,50,-17,38
Grasshoppers,2450,7,10,7,15,46,49,-3,37
FC Thun,2450,8,9,5,18,45,65,-20,32
FC Sion,2450,9,7,7,18,40,60,-20,28
Young Boys,2451,1,21,8,3,72,34,38,71
FC Basel,2451,2,17,9,6,52,25,27,60
Lucerne,2451,3,14,7,11,42,47,-5,49
St Gallen,2451,4,14,2,16,43,56,-13,44
FC Zürich,2451,5,10,12,10,40,34,6,42
Grasshoppers,2451,6,11,7,14,51,50,1,40
FC Lugano,2451,7,10,6,16,30,49,-19,36
FC Thun,2451,8,9,6,17,41,59,-18,33
FC Sion,2451,9,5,9,18,39,56,-17,24
Young Boys,2452,1,23,6,3,73,32,41,75
FC Basel,2452,2,16,7,9,50,29,21,55
Lucerne,2452,3,14,7,11,42,42,0,49
St Gallen,2452,4,15,3,14,45,55,-10,48
FC Zürich,2452,5,12,10,10,42,33,9,46
FC Lugano,2452,6,10,6,16,31,49,-18,36
FC Thun,2452,7,10,5,17,42,58,-16,35
Grasshoppers,2452,8,8,6,18,38,53,-15,30
FC Sion,2452,9,7,8,17,40,52,-12,29
Young Boys,2453,1,21,7,4,69,34,35,70
FC Basel,2453,2,18,7,7,53,26,27,61
St Gallen,2453,3,16,2,14,48,56,-8,50
Lucerne,2453,4,12,8,12,42,48,-6,44
FC Zürich,2453,5,11,10,11,43,36,7,43
Grasshoppers,2453,6,9,9,14,41,48,-7,36
FC Thun,2453,7,9,6,17,40,59,-19,33
FC Lugano,2453,8,9,6,17,30,49,-19,33
FC Sion,2453,9,8,7,17,42,52,-10,31
Young Boys,2454,1,22,6,4,70,35,35,72
FC Basel,2454,2,17,7,8,52,27,25,58
Lucerne,2454,3,12,9,11,39,43,-4,45
FC Zürich,2454,4,11,11,10,41,34,7,44
St Gallen,2454,5,13,4,15,41,55,-14,43
FC Lugano,2454,6,10,7,15,31,45,-14,37
FC Sion,2454,7,9,7,16,44,51,-7,34
Grasshoppers,2454,8,9,7,16,45,54,-9,34
FC Thun,2454,9,9,6,17,43,62,-19,33
Young Boys,2455,1,23,6,3,79,34,45,75
FC Basel,2455,2,19,7,6,59,27,32,64
St Gallen,2455,3,15,3,14,46,55,-9,48
Lucerne,2455,4,13,8,11,49,53,-4,47
FC Zürich,2455,5,10,9,13,40,41,-1,39
FC Lugano,2455,6,10,5,17,32,53,-21,35
Grasshoppers,2455,7,9,7,16,41,52,-11,34
FC Thun,2455,8,9,6,17,43,61,-18,33
FC Sion,2455,9,7,7,18,40,53,-13,28
Young Boys,2456,1,21,7,4,74,38,36,70
FC Basel,2456,2,18,8,6,53,24,29,62
Lucerne,2456,3,15,7,10,47,43,4,52
St Gallen,2456,4,15,2,15,42,53,-11,47
FC Zürich,2456,5,11,10,11,40,36,4,43
Grasshoppers,2456,6,10,7,15,40,48,-8,37
FC Thun,2456,7,10,5,17,43,58,-15,35
FC Lugano,2456,8,9,5,18,30,53,-23,32
FC Sion,2456,9,5,9,18,38,54,-16,24
Young Boys,2457,1,23,7,2,77,34,43,76
FC Basel,2457,2,17,7,8,55,28,27,58
St Gallen,2457,3,17,2,13,47,53,-6,53
FC Zürich,2457,4,12,9,11,43,39,4,45
Lucerne,2457,5,11,7,14,39,49,-10,40
FC Thun,2457,6,10,6,16,43,56,-13,36
Grasshoppers,2457,7,9,8,15,42,50,-8,35
FC Lugano,2457,8,10,5,17,31,52,-21,35
FC Sion,2457,9,5,9,18,39,55,-16,24
Young Boys,2458,1,22,7,3,73,35,38,73
FC Basel,2458,2,16,9,7,52,28,24,57
Lucerne,2458,3,13,9,10,45,44,1,48
FC Zürich,2458,4,12,10,10,44,36,8,46
St Gallen,2458,5,13,4,15,42,56,-14,43
Grasshoppers,2458,6,11,6,15,48,49,-1,39
FC Lugano,2458,7,10,6,16,28,46,-18,36
FC Thun,2458,8,9,6,17,52,66,-14,33
FC Sion,2458,9,6,7,19,43,67,-24,25
Young Boys,2459,1,21,7,4,72,36,36,70
FC Basel,2459,2,19,7,6,58,28,30,64
Lucerne,2459,3,13,8,11,46,48,-2,47
St Gallen,2459,4,13,3,16,42,58,-16,42
FC Zürich,2459,5,10,10,12,38,37,1,40
FC Lugano,2459,6,11,6,15,35,48,-13,39
FC Thun,2459,7,11,5,16,45,55,-10,38
Grasshoppers,2459,8,9,7,16,38,53,-15,34
FC Sion,2459,9,7,7,18,42,53,-11,28
Young Boys,2460,1,20,8,4,69,36,33,68
FC Basel,2460,2,19,7,6,60,28,32,64
Lucerne,2460,3,14,8,10,44,42,2,50
St Gallen,2460,4,15,3,14,45,55,-10,48
FC Zürich,2460,5,10,10,12,38,39,-1,40
FC Lugano,2460,6,10,6,16,30,46,-16,36
Grasshoppers,2460,7,9,7,16,39,49,-10,34
FC Thun,2460,8,9,7,16,43,58,-15,34
FC Sion,2460,9,5,10,17,35,50,-15,25
Young Boys,2461,1,21,9,2,74,37,37,72
FC Basel,2461,2,17,9,6,51,25,26,60
St Gallen,2461,3,16,2,14,46,52,-6,50
Lucerne,2461,4,12,8,12,41,43,-2,44
FC Zürich,2461,5,10,11,11,39,36,3,41
FC Thun,2461,6,11,6,15,46,56,-10,39
FC Lugano,2461,7,9,7,16,30,50,-20,34
Grasshoppers,2461,8,8,9,15,43,53,-10,33
FC Sion,2461,9,5,9,18,42,60,-18,24
Young Boys,2462,1,21,8,3,71,36,35,71
FC Basel,2462,2,15,10,7,50,28,22,55
St Gallen,2462,3,15,2,15,43,53,-10,47
Lucerne,2462,4,12,9,11,42,44,-2,45
FC Zürich,2462,5,11,10,11,41,38,3,43
FC Lugano,2462,6,12,5,15,33,46,-13,41
Grasshoppers,2462,7,10,6,16,45,52,-7,36
FC Thun,2462,8,9,7,16,45,61,-16,34
FC Sion,2462,9,7,7,18,41,53,-12,28
Young Boys,2463,1,20,7,5,70,42,28,67
FC Basel,2463,2,18,9,5,52,23,29,63
Lucerne,2463,3,13,9,10,49,47,2,48
St Gallen,2463,4,13,3,16,44,60,-16,42
FC Zürich,2463,5,10,11,11,40,34,6,41
Grasshoppers,2463,6,11,6,15,44,46,-2,39
FC Thun,2463,7,10,6,16,43,57,-14,36
FC Lugano,2463,8,10,6,16,31,47,-16,36
FC Sion,2463,9,7,7,18,41,58,-17,28
Young Boys,2464,1,21,9,2,72,34,38,72
FC Basel,2464,2,18,9,5,52,23,29,63
St Gallen,2464,3,15,3,14,44,53,-9,48
FC Zürich,2464,4,12,10,10,46,36,10,46
Lucerne,2464,5,12,9,11,41,45,-4,45
FC Thun,2464,6,10,5,17,43,56,-13,35
FC Lugano,2464,7,9,8,15,32,49,-17,35
Grasshoppers,2464,8,9,6,17,38,49,-11,33
FC Sion,2464,9,5,7,20,38,61,-23,22
Young Boys,2465,1,23,7,2,76,31,45,76
FC Basel,2465,2,18,9,5,56,25,31,63
Lucerne,2465,3,12,8,12,42,47,-5,44
St Gallen,2465,4,13,4,15,41,54,-13,43
FC Zürich,2465,5,9,11,12,41,40,1,38
FC Lugano,2465,6,10,7,15,31,49,-18,37
FC Thun,2465,7,9,6,17,43,60,-17,33
FC Sion,2465,8,8,8,16,43,54,-11,32
Grasshoppers,2465,9,8,8,16,41,54,-13,32
Young Boys,2466,1,23,6,3,74,34,40,75
FC Basel,2466,2,17,8,7,51,25,26,59
Lucerne,2466,3,13,8,11,45,43,2,47
St Gallen,2466,4,13,5,14,42,57,-15,44
FC Zürich,2466,5,11,10,11,42,34,8,43
Grasshoppers,2466,6,10,6,16,43,53,-10,36
FC Lugano,2466,7,10,6,16,30,50,-20,36
FC Thun,2466,8,9,7,16,43,58,-15,34
FC Sion,2466,9,6,8,18,39,55,-16,26
Young Boys,2467,1,23,6,3,71,34,37,75
FC Basel,2467,2,19,7,6,54,27,27,64
Lucerne,2467,3,12,8,12,43,44,-1,44
St Gallen,2467,4,13,2,17,42,59,-17,41
FC Zürich,2467,5,10,10,12,43,41,2,40
Grasshoppers,2467,6,11,7,14,46,50,-4,40
FC Lugano,2467,7,10,7,15,31,46,-15,37
FC Thun,2467,8,9,7,16,48,61,-13,34
FC Sion,2467,9,6,8,18,43,59,-16,26
Young Boys,2468,1,22,8,2,75,32,43,74
FC Basel,2468,2,18,8,6,55,30,25,62
St Gallen,2468,3,16,3,13,48,51,-3,51
Lucerne,2468,4,11,9,12,41,47,-6,42
FC Zürich,2468,5,10,9,13,41,39,2,39
Grasshoppers,2468,6,11,6,15,43,48,-5,39
FC Lugano,2468,7,10,7,15,31,46,-15,37
FC Thun,2468,8,10,5,17,45,57,-12,35
FC Sion,2468,9,5,7,20,35,64,-29,22
Young Boys,2469,1,22,7,3,73,34,39,73
FC Basel,2469,2,18,8,6,53,24,29,62
Lucerne,2469,3,13,8,11,42,42,0,47
St Gallen,2469,4,14,4,14,43,56,-13,46
FC Zürich,2469,5,11,9,12,42,37,5,42
Grasshoppers,2469,6,10,7,15,41,49,-8,37
FC Lugano,2469,7,10,5,17,30,48,-18,35
FC Sion,2469,8,7,9,16,44,53,-9,30
FC Thun,2469,9,8,5,19,39,64,-25,29
Young Boys,2470,1,22,8,2,72,31,41,74
FC Basel,2470,2,18,7,7,55,27,28,61
St Gallen,2470,3,15,2,15,42,56,-14,47
FC Zürich,2470,4,12,9,11,40,33,7,45
Lucerne,2470,5,12,9,11,42,44,-2,45
FC Lugano,2470,6,10,6,16,32,46,-14,36
FC Thun,2470,7,10,5,17,45,58,-13,35
Grasshoppers,2470,8,9,6,17,40,57,-17,33
FC Sion,2470,9,6,8,18,39,55,-16,26
Young Boys,2471,1,21,7,4,72,34,38,70
FC Basel,2471,2,17,9,6,53,24,29,60
St Gallen,2471,3,15,4,13,42,51,-9,49
Lucerne,2471,4,13,7,12,43,47,-4,46
FC Zürich,2471,5,12,9,11,42,39,3,45
FC Thun,2471,6,10,6,16,48,60,-12,36
Grasshoppers,2471,7,9,7,16,43,53,-10,34
FC Lugano,2471,8,9,6,17,30,52,-22,33
FC Sion,2471,9,7,7,18,39,52,-13,28
Young Boys,2472,1,22,7,3,74,36,38,73
FC Basel,2472,2,20,7,5,58,25,33,67
St Gallen,2472,3,16,2,14,45,52,-7,50
Lucerne,2472,4,13,7,12,41,45,-4,46
FC Zürich,2472,5,9,11,12,40,39,1,38
FC Thun,2472,6,9,7,16,47,59,-12,34
FC Lugano,2472,7,9,6,17,33,51,-18,33
Grasshoppers,2472,8,8,8,16,41,56,-15,32
FC Sion,2472,9,6,9,17,39,55,-16,27
Young Boys,2473,1,21,8,3,68,33,35,71
FC Basel,2473,2,19,8,5,59,25,34,65
St Gallen,2473,3,15,3,14,47,58,-11,48
Lucerne,2473,4,13,8,11,46,45,1,47
FC Zürich,2473,5,11,10,11,45,39,6,43
Grasshoppers,2473,6,9,6,17,38,49,-11,33
FC Lugano,2473,7,9,6,17,31,52,-21,33
FC Thun,2473,8,9,5,18,42,62,-20,32
FC Sion,2473,9,7,8,17,42,55,-13,29
Young Boys,2474,1,22,6,4,73,35,38,72
FC Basel,2474,2,18,8,6,52,22,30,62
Lucerne,2474,3,13,8,11,42,41,1,47
St Gallen,2474,4,14,3,15,40,54,-14,45
FC Zürich,2474,5,10,12,10,42,34,8,42
FC Lugano,2474,6,10,6,16,29,47,-18,36
Grasshoppers,2474,7,9,7,16,42,52,-10,34
FC Thun,2474,8,9,7,16,43,60,-17,34
FC Sion,2474,9,5,11,16,39,57,-18,26
Young Boys,2475,1,21,7,4,71,38,33,70
FC Basel,2475,2,18,9,5,51,22,29,63
Lucerne,2475,3,12,9,11,41,43,-2,45
FC Lugano,2475,4,12,6,14,36,46,-10,42
FC Zürich,2475,5,10,11,11,41,36,5,41
St Gallen,2475,6,13,2,17,41,61,-20,41
FC Thun,2475,7,9,7,16,42,56,-14,34
Grasshoppers,2475,8,8,8,16,40,51,-11,32
FC Sion,2475,9,8,7,17,43,53,-10,31
Young Boys,2476,1,24,6,2,74,31,43,78
FC Basel,2476,2,18,7,7,57,27,30,61
St Gallen,2476,3,16,3,13,46,53,-7,51
Lucerne,2476,4,12,9,11,42,46,-4,45
FC Zürich,2476,5,11,10,11,41,37,4,43
FC Thun,2476,6,9,6,17,46,63,-17,33
FC Lugano,2476,7,9,5,18,30,51,-21,32
Grasshoppers,2476,8,8,7,17,41,52,-11,31
FC Sion,2476,9,6,9,17,42,59,-17,27
Young Boys,2477,1,22,6,4,72,34,38,72
FC Basel,2477,2,19,7,6,56,26,30,64
Lucerne,2477,3,14,7,11,46,45,1,49
St Gallen,2477,4,15,3,14,43,53,-10,48
FC Zürich,2477,5,10,9,13,41,39,2,39
FC Thun,2477,6,10,6,16,44,58,-14,36
FC Lugano,2477,7,9,5,18,30,53,-23,32
FC Sion,2477,8,7,10,15,40,51,-11,31
Grasshoppers,2477,9,8,7,17,39,52,-13,31
Young Boys,2478,1,22,6,4,71,35,36,72
FC Basel,2478,2,18,8,6,55,26,29,62
St Gallen,2478,3,15,3,14,42,52,-10,48
Lucerne,2478,4,13,8,11,44,45,-1,47
FC Zürich,2478,5,10,10,12,41,40,1,40
FC Thun,2478,6,10,6,16,45,58,-13,36
Grasshoppers,2478,7,9,8,15,41,49,-8,35
FC Lugano,2478,8,10,5,17,30,49,-19,35
FC Sion,2478,9,6,8,18,38,53,-15,26
Young Boys,2479,1,21,8,3,71,36,35,71
FC Basel,2479,2,18,9,5,53,25,28,63
Lucerne,2479,3,12,9,11,41,42,-1,45
St Gallen,2479,4,14,2,16,41,57,-16,44
FC Thun,2479,5,11,5,16,44,57,-13,38
FC Lugano,2479,6,11,5,16,33,48,-15,38
FC Zürich,2479,7,9,9,14,38,38,0,36
Grasshoppers,2479,8,8,9,15,39,48,-9,33
FC Sion,2479,9,8,8,16,41,50,-9,32
Young Boys,2480,1,21,7,4,68,34,34,70
FC Basel,2480,2,17,8,7,50,25,25,59
St Gallen,2480,3,16,2,14,42,50,-8,50
Lucerne,2480,4,12,9,11,38,40,-2,45
FC Zürich,2480,5,10,10,12,37,35,2,40
FC Lugano,2480,6,11,6,15,31,44,-13,39
Grasshoppers,2480,7,10,7,15,40,48,-8,37
FC Thun,2480,8,10,6,16,44,56,-12,36
FC Sion,2480,9,5,9,18,37,55,-18,24
Young Boys,2481,1,22,7,3,71,32,39,73
FC Basel,2481,2,16,9,7,52,29,23,57
Lucerne,2481,3,14,8,10,42,41,1,50
St Gallen,2481,4,15,4,13,46,53,-7,49
FC Zürich,2481,5,11,9,12,41,36,5,42
FC Thun,2481,6,10,6,16,46,60,-14,36
FC Lugano,2481,7,9,6,17,28,48,-20,33
Grasshoppers,2481,8,8,7,17,41,53,-12,31
FC Sion,2481,9,7,8,17,44,59,-15,29
Young Boys,2482,1,21,7,4,68,34,34,70
FC Basel,2482,2,20,7,5,56,23,33,67
Lucerne,2482,3,12,9,11,42,44,-2,45
St Gallen,2482,4,13,3,16,43,57,-14,42
FC Zürich,2482,5,10,10,12,42,42,0,40
FC Lugano,2482,6,11,5,16,34,52,-18,38
Grasshoppers,2482,7,10,7,15,42,48,-6,37
FC Thun,2482,8,10,5,17,47,59,-12,35
FC Sion,2482,9,6,9,17,37,52,-15,27
Young Boys,2483,1,21,7,4,72,40,32,70
FC Basel,2483,2,17,8,7,56,27,29,59
Lucerne,2483,3,14,9,9,46,40,6,51
St Gallen,2483,4,14,5,13,41,51,-10,47
FC Zrich,2483,5,10,10,12,39,36,3,40
FC Thun,2483,6,11,5,16,42,57,-15,38
FC Lugano,2483,7,9,7,16,30,51,-21,34
Grasshoppers,2483,8,8,7,17,41,53,-12,31
FC Sion,2483,9,7,8,17,39,51,-12,29
Young Boys,2484,1,21,7,4,70,35,35,70
FC Basel,2484,2,16,8,8,51,29,22,56
Lucerne,2484,3,13,8,11,44,44,0,47
St Gallen,2484,4,15,2,15,45,56,-11,47
FC Zürich,2484,5,11,10,11,42,37,5,43
FC Lugano,2484,6,11,5,16,31,48,-17,38
Grasshoppers,2484,7,10,6,16,43,50,-7,36
FC Thun,2484,8,9,7,16,41,57,-16,34
FC Sion,2484,9,8,7,17,42,53,-11,31
Young Boys,2485,1,20,9,3,72,36,36,69
FC Basel,2485,2,20,7,5,55,24,31,67
Lucerne,2485,3,13,7,12,41,45,-4,46
St Gallen,2485,4,14,3,15,43,56,-13,45
FC Zürich,2485,5,9,11,12,40,38,2,38
FC Thun,2485,6,10,6,16,43,57,-14,36
FC Lugano,2485,7,9,8,15,33,49,-16,35
Grasshoppers,2485,8,8,8,16,36,46,-10,32
FC Sion,2485,9,6,11,15,38,50,-12,29
Young Boys,2486,1,21,8,3,76,37,39,71
FC Basel,2486,2,16,8,8,50,28,22,56
Lucerne,2486,3,13,8,11,44,46,-2,47
St Gallen,2486,4,15,2,15,41,55,-14,47
FC Zürich,2486,5,11,10,11,39,34,5,43
FC Lugano,2486,6,11,6,15,33,46,-13,39
Grasshoppers,2486,7,9,9,14,41,48,-7,36
FC Thun,2486,8,10,6,16,45,57,-12,36
FC Sion,2486,9,5,9,18,39,57,-18,24
Young Boys,2487,1,22,7,3,73,37,36,73
FC Basel,2487,2,17,8,7,56,28,28,59
Lucerne,2487,3,14,7,11,45,43,2,49
St Gallen,2487,4,14,4,14,42,53,-11,46
FC Zürich,2487,5,10,11,11,40,36,4,41
FC Thun,2487,6,11,5,16,48,60,-12,38
FC Lugano,2487,7,10,7,15,30,47,-17,37
Grasshoppers,2487,8,8,8,16,44,57,-13,32
FC Sion,2487,9,5,9,18,36,53,-17,24
Young Boys,2488,1,21,9,2,75,38,37,72
FC Basel,2488,2,18,9,5,56,27,29,63
Lucerne,2488,3,13,7,12,43,47,-4,46
FC Zürich,2488,4,11,11,10,41,34,7,44
St Gallen,2488,5,14,2,16,46,59,-13,44
FC Lugano,2488,6,11,5,16,39,51,-12,38
Grasshoppers,2488,7,9,7,16,41,53,-12,34
FC Thun,2488,8,9,5,18,43,61,-18,32
FC Sion,2488,9,6,9,17,38,52,-14,27
Young Boys,2489,1,20,7,5,71,36,35,67
FC Basel,2489,2,17,9,6,53,25,28,60
St Gallen,2489,3,16,3,13,49,50,-1,51
Lucerne,2489,4,13,8,11,43,49,-6,47
FC Zürich,2489,5,11,10,11,45,38,7,43
FC Thun,2489,6,10,6,16,44,59,-15,36
FC Lugano,2489,7,10,6,16,34,52,-18,36
Grasshoppers,2489,8,9,7,16,40,52,-12,34
FC Sion,2489,9,6,8,18,41,59,-18,26
Young Boys,2490,1,22,7,3,71,35,36,73
FC Basel,2490,2,17,9,6,54,27,27,60
St Gallen,2490,3,15,4,13,44,50,-6,49
Lucerne,2490,4,12,9,11,41,45,-4,45
FC Zürich,2490,5,11,10,11,40,36,4,43
Grasshoppers,2490,6,8,9,15,41,51,-10,33
FC Lugano,2490,7,9,6,17,29,47,-18,33
FC Thun,2490,8,8,8,16,41,58,-17,32
FC Sion,2490,9,6,10,16,40,52,-12,28
Young Boys,2491,1,21,9,2,72,33,39,72
FC Basel,2491,2,16,9,7,52,26,26,57
St Gallen,2491,3,16,3,13,44,51,-7,51
Lucerne,2491,4,13,9,10,41,42,-1,48
FC Zürich,2491,5,10,11,11,40,35,5,41
FC Thun,2491,6,11,5,16,43,58,-15,38
Grasshoppers,2491,7,9,8,15,43,50,-7,35
FC Lugano,2491,8,9,6,17,28,48,-20,33
FC Sion,2491,9,5,8,19,38,58,-20,23
Young Boys,2492,1,21,6,5,73,40,33,69
FC Basel,2492,2,18,8,6,53,26,27,62
St Gallen,2492,3,16,3,13,44,50,-6,51
Lucerne,2492,4,12,10,10,42,41,1,46
FC Zürich,2492,5,11,10,11,47,41,6,43
Grasshoppers,2492,6,10,7,15,41,50,-9,37
FC Lugano,2492,7,9,6,17,32,52,-20,33
FC Thun,2492,8,8,6,18,42,62,-20,30
FC Sion,2492,9,7,8,17,42,54,-12,29
Young Boys,2493,1,21,8,3,76,36,40,71
FC Basel,2493,2,19,7,6,55,24,31,64
Lucerne,2493,3,12,9,11,41,44,-3,45
St Gallen,2493,4,13,4,15,43,56,-13,43
Grasshoppers,2493,5,11,7,14,45,48,-3,40
FC Lugano,2493,6,11,6,15,31,49,-18,39
FC Zürich,2493,7,9,10,13,38,38,0,37
FC Thun,2493,8,10,5,17,44,62,-18,35
FC Sion,2493,9,5,10,17,41,57,-16,25
Young Boys,2494,1,20,9,3,69,35,34,69
FC Basel,2494,2,17,9,6,51,25,26,60
St Gallen,2494,3,16,3,13,48,52,-4,51
Lucerne,2494,4,13,7,12,40,44,-4,46
FC Zürich,2494,5,12,9,11,43,35,8,45
Grasshoppers,2494,6,10,7,15,43,49,-6,37
FC Lugano,2494,7,9,6,17,30,51,-21,33
FC Thun,2494,8,8,7,17,42,59,-17,31
FC Sion,2494,9,6,9,17,40,56,-16,27
Young Boys,2495,1,22,6,4,68,34,34,72
FC Basel,2495,2,17,8,7,52,28,24,59
Lucerne,2495,3,12,9,11,42,44,-2,45
St Gallen,2495,4,14,3,15,43,54,-11,45
FC Lugano,2495,5,12,5,15,35,47,-12,41
Grasshoppers,2495,6,10,8,14,45,49,-4,38
FC Zürich,2495,7,9,9,14,39,42,-3,36
FC Thun,2495,8,10,6,16,42,58,-16,36
FC Sion,2495,9,7,8,17,43,53,-10,29
Young Boys,2496,1,21,8,3,74,38,36,71
FC Basel,2496,2,17,9,6,55,25,30,60
Lucerne,2496,3,14,8,10,43,40,3,50
St Gallen,2496,4,14,3,15,42,57,-15,45
FC Zürich,2496,5,11,10,11,42,35,7,43
FC Lugano,2496,6,11,6,15,36,48,-12,39
FC Thun,2496,7,9,6,17,43,60,-17,33
Grasshoppers,2496,8,8,6,18,39,56,-17,30
FC Sion,2496,9,6,10,16,41,56,-15,28
Young Boys,2497,1,22,6,4,72,33,39,72
FC Basel,2497,2,16,9,7,56,29,27,57
Lucerne,2497,3,14,9,9,49,46,3,51
St Gallen,2497,4,13,4,15,43,56,-13,43
FC Zürich,2497,5,10,11,11,39,35,4,41
FC Thun,2497,6,11,5,16,47,62,-15,38
FC Lugano,2497,7,10,6,16,30,48,-18,36
Grasshoppers,2497,8,9,7,16,41,54,-13,34
FC Sion,2497,9,7,7,18,41,55,-14,28
Young Boys,2498,1,21,6,5,70,38,32,69
FC Basel,2498,2,18,9,5,54,22,32,63
St Gallen,2498,3,15,3,14,44,54,-10,48
Lucerne,2498,4,12,7,13,41,46,-5,43
FC Zürich,2498,5,10,10,12,41,37,4,40
FC Lugano,2498,6,11,5,16,31,49,-18,38
Grasshoppers,2498,7,10,6,16,40,47,-7,36
FC Thun,2498,8,10,6,16,42,56,-14,36
FC Sion,2498,9,7,8,17,41,55,-14,29
Young Boys,2499,1,21,9,2,72,36,36,72
FC Basel,2499,2,16,9,7,50,26,24,57
St Gallen,2499,3,15,4,13,46,53,-7,49
Lucerne,2499,4,12,9,11,41,42,-1,45
FC Zürich,2499,5,10,11,11,44,37,7,41
Grasshoppers,2499,6,10,7,15,42,50,-8,37
FC Lugano,2499,7,10,7,15,33,47,-14,37
FC Thun,2499,8,9,7,16,43,58,-15,34
FC Sion,2499,9,5,9,18,40,62,-22,24
Young Boys,2500,1,23,7,2,75,33,42,76
FC Basel,2500,2,19,8,5,53,24,29,65
St Gallen,2500,3,15,3,14,45,55,-10,48
Lucerne,2500,4,13,8,11,43,46,-3,47
FC Zürich,2500,5,10,10,12,43,38,5,40
FC Thun,2500,6,11,5,16,46,57,-11,38
Grasshoppers,2500,7,9,6,17,40,51,-11,33
FC Lugano,2500,8,9,5,18,31,54,-23,32
FC Sion,2500,9,5,8,19,38,56,-18,23
Young Boys,2501,1,22,6,4,72,35,37,72
FC Basel,2501,2,18,8,6,53,24,29,62
Lucerne,2501,3,15,7,10,42,41,1,52
FC Zürich,2501,4,11,10,11,43,35,8,43
St Gallen,2501,5,13,3,16,40,55,-15,42
FC Thun,2501,6,11,5,16,46,58,-12,38
FC Lugano,2501,7,10,5,17,29,49,-20,35
Grasshoppers,2501,8,8,7,17,37,50,-13,31
FC Sion,2501,9,6,9,17,39,54,-15,27
Young Boys,2502,1,20,9,3,69,33,36,69
FC Basel,2502,2,18,8,6,51,24,27,62
St Gallen,2502,3,14,3,15,42,56,-14,45
Lucerne,2502,4,11,10,11,40,45,-5,43
FC Zürich,2502,5,10,11,11,41,40,1,41
FC Lugano,2502,6,10,7,15,34,46,-12,37
Grasshoppers,2502,7,8,10,14,41,49,-8,34
FC Thun,2502,8,9,7,16,43,58,-15,34
FC Sion,2502,9,7,9,16,44,54,-10,30
Young Boys,2503,1,20,9,3,71,35,36,69
FC Basel,2503,2,18,9,5,53,24,29,63
Lucerne,2503,3,12,9,11,41,45,-4,45
St Gallen,2503,4,14,3,15,46,57,-11,45
FC Zürich,2503,5,10,10,12,41,41,0,40
Grasshoppers,2503,6,10,7,15,46,50,-4,37
FC Thun,2503,7,10,5,17,44,58,-14,35
FC Lugano,2503,8,10,5,17,33,51,-18,35
FC Sion,2503,9,8,7,17,44,58,-14,31
Young Boys,2504,1,23,6,3,74,37,37,75
FC Basel,2504,2,17,8,7,54,26,28,59
Lucerne,2504,3,13,8,11,42,46,-4,47
FC Zürich,2504,4,11,10,11,38,34,4,43
St Gallen,2504,5,13,3,16,40,56,-16,42
FC Lugano,2504,6,10,5,17,28,47,-19,35
FC Sion,2504,7,8,9,15,46,51,-5,33
Grasshoppers,2504,8,8,9,15,43,52,-9,33
FC Thun,2504,9,9,6,17,43,59,-16,33
Young Boys,2505,1,21,7,4,71,36,35,70
FC Basel,2505,2,18,9,5,54,22,32,63
Lucerne,2505,3,12,9,11,38,41,-3,45
St Gallen,2505,4,13,4,15,40,55,-15,43
FC Zürich,2505,5,10,10,12,40,37,3,40
FC Lugano,2505,6,11,6,15,32,44,-12,39
FC Sion,2505,7,9,8,15,46,53,-7,35
Grasshoppers,2505,8,9,8,15,41,48,-7,35
FC Thun,2505,9,8,5,19,39,65,-26,29
Young Boys,2506,1,23,6,3,73,34,39,75
FC Basel,2506,2,20,7,5,59,24,35,67
Lucerne,2506,3,13,8,11,43,44,-1,47
FC Zürich,2506,4,11,10,11,40,38,2,43
St Gallen,2506,5,13,4,15,41,55,-14,43
FC Lugano,2506,6,9,7,16,30,47,-17,34
FC Thun,2506,7,9,5,18,43,60,-17,32
Grasshoppers,2506,8,8,7,17,39,54,-15,31
FC Sion,2506,9,7,8,17,41,53,-12,29
Young Boys,2507,1,22,6,4,67,31,36,72
FC Basel,2507,2,18,9,5,53,25,28,63
Lucerne,2507,3,14,8,10,43,42,1,50
St Gallen,2507,4,14,3,15,43,57,-14,45
FC Zürich,2507,5,10,9,13,40,42,-2,39
FC Lugano,2507,6,11,5,16,33,45,-12,38
Grasshoppers,2507,7,10,6,16,41,48,-7,36
FC Thun,2507,8,9,5,18,46,60,-14,32
FC Sion,2507,9,7,7,18,40,56,-16,28
Young Boys,2508,1,20,9,3,68,35,33,69
FC Basel,2508,2,17,9,6,53,25,28,60
St Gallen,2508,3,16,2,14,43,54,-11,50
FC Zürich,2508,4,12,9,11,42,35,7,45
Lucerne,2508,5,12,8,12,41,44,-3,44
Grasshoppers,2508,6,9,8,15,44,52,-8,35
FC Thun,2508,7,9,7,16,44,61,-17,34
FC Lugano,2508,8,9,5,18,27,48,-21,32
FC Sion,2508,9,7,9,16,46,54,-8,30
Young Boys,2509,1,23,6,3,72,37,35,75
FC Basel,2509,2,17,8,7,53,28,25,59
St Gallen,2509,3,15,3,14,42,51,-9,48
Lucerne,2509,4,11,9,12,39,44,-5,42
FC Lugano,2509,5,12,5,15,36,47,-11,41
FC Zürich,2509,6,10,10,12,42,37,5,40
FC Thun,2509,7,11,5,16,43,58,-15,38
Grasshoppers,2509,8,9,7,16,41,49,-8,34
FC Sion,2509,9,5,9,18,36,53,-17,24
Young Boys,2510,1,20,7,5,70,37,33,67
FC Basel,2510,2,18,8,6,59,26,33,62
Lucerne,2510,3,13,8,11,42,45,-3,47
St Gallen,2510,4,15,2,15,43,55,-12,47
FC Zürich,2510,5,10,10,12,38,37,1,40
Grasshoppers,2510,6,11,6,15,42,48,-6,39
FC Thun,2510,7,11,5,16,45,60,-15,38
FC Lugano,2510,8,9,7,16,29,46,-17,34
FC Sion,2510,9,7,7,18,40,54,-14,28
Young Boys,2511,1,22,6,4,80,39,41,72
FC Basel,2511,2,18,8,6,58,28,30,62
FC Zürich,2511,3,12,9,11,41,36,5,45
Lucerne,2511,4,12,9,11,41,47,-6,45
St Gallen,2511,5,14,2,16,43,58,-15,44
FC Lugano,2511,6,10,5,17,33,50,-17,35
FC Thun,2511,7,9,7,16,41,56,-15,34
Grasshoppers,2511,8,8,9,15,41,52,-11,33
FC Sion,2511,9,7,9,16,42,54,-12,30
Young Boys,2512,1,20,8,4,71,39,32,68
FC Basel,2512,2,17,9,6,55,31,24,60
St Gallen,2512,3,15,3,14,47,53,-6,48
Lucerne,2512,4,13,7,12,43,46,-3,46
FC Zürich,2512,5,11,10,11,41,36,5,43
Grasshoppers,2512,6,10,7,15,42,50,-8,37
FC Lugano,2512,7,10,7,15,31,47,-16,37
FC Thun,2512,8,10,6,16,46,58,-12,36
FC Sion,2512,9,5,9,18,41,57,-16,24
Young Boys,2513,1,21,7,4,70,40,30,70
FC Basel,2513,2,19,7,6,63,27,36,64
Lucerne,2513,3,13,8,11,41,45,-4,47
St Gallen,2513,4,14,3,15,41,55,-14,45
FC Zürich,2513,5,11,10,11,44,36,8,43
Grasshoppers,2513,6,9,8,15,40,48,-8,35
FC Lugano,2513,7,10,5,17,32,48,-16,35
FC Thun,2513,8,9,7,16,44,59,-15,34
FC Sion,2513,9,6,9,17,37,54,-17,27
Young Boys,2514,1,20,9,3,70,37,33,69
FC Basel,2514,2,17,9,6,56,25,31,60
St Gallen,2514,3,15,3,14,45,56,-11,48
Lucerne,2514,4,12,8,12,44,49,-5,44
FC Zürich,2514,5,11,10,11,42,38,4,43
Grasshoppers,2514,6,12,6,14,45,45,0,42
FC Thun,2514,7,9,6,17,44,63,-19,33
FC Lugano,2514,8,9,6,17,32,53,-21,33
FC Sion,2514,9,6,9,17,45,57,-12,27
Young Boys,2515,1,20,9,3,67,33,34,69
FC Basel,2515,2,15,8,9,51,31,20,53
St Gallen,2515,3,16,2,14,47,54,-7,50
Lucerne,2515,4,13,8,11,43,45,-2,47
FC Zürich,2515,5,11,10,11,41,35,6,43
FC Lugano,2515,6,10,6,16,30,48,-18,36
FC Sion,2515,7,9,8,15,43,50,-7,35
Grasshoppers,2515,8,9,8,15,40,49,-9,35
FC Thun,2515,9,8,7,17,42,59,-17,31
Young Boys,2516,1,19,9,4,65,36,29,66
FC Basel,2516,2,19,8,5,54,22,32,65
Lucerne,2516,3,13,9,10,44,45,-1,48
St Gallen,2516,4,13,3,16,40,56,-16,42
FC Zürich,2516,5,9,11,12,39,39,0,38
FC Lugano,2516,6,10,8,14,33,46,-13,38
Grasshoppers,2516,7,10,7,15,42,47,-5,37
FC Sion,2516,8,8,9,15,44,50,-6,33
FC Thun,2516,9,8,6,18,40,60,-20,30
Young Boys,2517,1,22,7,3,73,35,38,73
FC Basel,2517,2,19,8,5,56,25,31,65
St Gallen,2517,3,14,3,15,42,54,-12,45
Lucerne,2517,4,12,8,12,37,41,-4,44
FC Zürich,2517,5,11,10,11,41,36,5,43
FC Lugano,2517,6,10,8,14,32,45,-13,38
Grasshoppers,2517,7,10,6,16,41,50,-9,36
FC Thun,2517,8,10,5,17,47,61,-14,35
FC Sion,2517,9,5,7,20,36,58,-22,22
Young Boys,2518,1,23,6,3,74,34,40,75
FC Basel,2518,2,17,9,6,55,24,31,60
FC Zürich,2518,3,11,11,10,42,34,8,44
St Gallen,2518,4,14,2,16,42,55,-13,44
Lucerne,2518,5,11,8,13,39,45,-6,41
FC Lugano,2518,6,11,5,16,33,50,-17,38
Grasshoppers,2518,7,10,7,15,43,50,-7,37
FC Thun,2518,8,9,7,16,47,65,-18,34
FC Sion,2518,9,7,7,18,41,59,-18,28
Young Boys,2519,1,19,9,4,70,41,29,66
FC Basel,2519,2,18,9,5,61,25,36,63
Lucerne,2519,3,12,9,11,45,48,-3,45
FC Lugano,2519,4,13,5,14,38,44,-6,44
St Gallen,2519,5,13,3,16,41,59,-18,42
FC Zürich,2519,6,10,11,11,43,40,3,41
Grasshoppers,2519,7,10,8,14,43,48,-5,38
FC Thun,2519,8,9,6,17,45,65,-20,33
FC Sion,2519,9,6,8,18,39,55,-16,26
Young Boys,2520,1,22,7,3,73,34,39,73
FC Basel,2520,2,19,8,5,54,24,30,65
St Gallen,2520,3,14,2,16,42,55,-13,44
FC Zürich,2520,4,10,11,11,38,34,4,41
Lucerne,2520,5,11,8,13,38,46,-8,41
FC Lugano,2520,6,11,5,16,32,47,-15,38
FC Sion,2520,7,9,7,16,44,51,-7,34
FC Thun,2520,8,9,6,17,40,58,-18,33
Grasshoppers,2520,9,8,8,16,38,50,-12,32
Young Boys,2521,1,20,9,3,70,36,34,69
FC Basel,2521,2,19,7,6,59,28,31,64
Lucerne,2521,3,13,8,11,43,44,-1,47
St Gallen,2521,4,14,2,16,41,53,-12,44
FC Zürich,2521,5,11,10,11,41,37,4,43
Grasshoppers,2521,6,10,8,14,41,46,-5,38
FC Thun,2521,7,9,6,17,41,59,-18,33
FC Lugano,2521,8,9,6,17,32,51,-19,33
FC Sion,2521,9,7,8,17,38,52,-14,29
Young Boys,2522,1,22,8,2,71,34,37,74
FC Basel,2522,2,16,7,9,53,27,26,55
Lucerne,2522,3,14,7,11,44,45,-1,49
St Gallen,2522,4,15,3,14,45,53,-8,48
FC Zürich,2522,5,11,10,11,40,34,6,43
FC Lugano,2522,6,11,6,15,30,44,-14,39
Grasshoppers,2522,7,9,8,15,44,50,-6,35
FC Thun,2522,8,8,6,18,40,63,-23,30
FC Sion,2522,9,6,9,17,41,58,-17,27
Young Boys,2523,1,19,9,4,67,36,31,66
FC Basel,2523,2,16,9,7,53,29,24,57
Lucerne,2523,3,13,9,10,42,44,-2,48
FC Zürich,2523,4,11,11,10,43,35,8,44
St Gallen,2523,5,13,4,15,42,57,-15,43
FC Lugano,2523,6,11,6,15,32,45,-13,39
FC Thun,2523,7,10,6,16,48,61,-13,36
Grasshoppers,2523,8,9,7,16,41,50,-9,34
FC Sion,2523,9,7,9,16,43,54,-11,30
Young Boys,2524,1,22,6,4,68,34,34,72
FC Basel,2524,2,18,8,6,53,25,28,62
Lucerne,2524,3,13,7,12,47,48,-1,46
St Gallen,2524,4,14,3,15,41,55,-14,45
FC Zürich,2524,5,10,10,12,46,42,4,40
FC Lugano,2524,6,11,5,16,31,48,-17,38
Grasshoppers,2524,7,10,6,16,42,51,-9,36
FC Thun,2524,8,9,7,16,45,60,-15,34
FC Sion,2524,9,7,8,17,43,53,-10,29
Young Boys,2525,1,23,7,2,73,30,43,76
FC Basel,2525,2,17,9,6,54,26,28,60
Lucerne,2525,3,13,8,11,42,43,-1,47
St Gallen,2525,4,15,2,15,44,56,-12,47
FC Zürich,2525,5,11,10,11,44,36,8,43
FC Thun,2525,6,10,6,16,47,59,-12,36
FC Lugano,2525,7,10,5,17,32,54,-22,35
Grasshoppers,2525,8,9,6,17,40,52,-12,33
FC Sion,2525,9,6,7,19,40,60,-20,25
Young Boys,2526,1,20,7,5,70,40,30,67
FC Basel,2526,2,18,9,5,59,25,34,63
St Gallen,2526,3,16,3,13,45,52,-7,51
Lucerne,2526,4,13,8,11,44,47,-3,47
FC Zürich,2526,5,11,10,11,45,35,10,43
FC Lugano,2526,6,10,7,15,31,45,-14,37
Grasshoppers,2526,7,9,8,15,40,50,-10,35
FC Thun,2526,8,9,6,17,41,60,-19,33
FC Sion,2526,9,5,8,19,38,59,-21,23
Young Boys,2527,1,20,7,5,68,39,29,67
FC Basel,2527,2,17,8,7,50,27,23,59
Lucerne,2527,3,15,8,9,47,39,8,53
St Gallen,2527,4,14,2,16,45,58,-13,44
FC Zürich,2527,5,10,10,12,41,38,3,40
Grasshoppers,2527,6,10,7,15,42,47,-5,37
FC Lugano,2527,7,10,6,16,33,51,-18,36
FC Thun,2527,8,9,8,15,45,59,-14,35
FC Sion,2527,9,6,10,16,41,54,-13,28
Young Boys,2528,1,22,8,2,77,35,42,74
FC Basel,2528,2,18,9,5,60,23,37,63
St Gallen,2528,3,14,3,15,40,53,-13,45
Lucerne,2528,4,12,8,12,40,48,-8,44
FC Zürich,2528,5,10,10,12,41,40,1,40
FC Lugano,2528,6,10,7,15,32,48,-16,37
Grasshoppers,2528,7,9,7,16,43,51,-8,34
FC Sion,2528,8,8,7,17,41,55,-14,31
FC Thun,2528,9,8,7,17,42,63,-21,31
Young Boys,2529,1,22,6,4,74,39,35,72
FC Basel,2529,2,19,7,6,56,26,30,64
St Gallen,2529,3,15,3,14,46,54,-8,48
Lucerne,2529,4,13,8,11,42,45,-3,47
FC Zürich,2529,5,11,10,11,39,34,5,43
Grasshoppers,2529,6,10,7,15,43,50,-7,37
FC Lugano,2529,7,10,5,17,32,48,-16,35
FC Thun,2529,8,9,6,17,40,57,-17,33
FC Sion,2529,9,5,8,19,39,58,-19,23
Young Boys,2530,1,22,7,3,73,31,42,73
FC Basel,2530,2,17,9,6,52,26,26,60
St Gallen,2530,3,15,4,13,44,53,-9,49
Lucerne,2530,4,13,9,10,43,44,-1,48
FC Zürich,2530,5,11,11,10,40,33,7,44
FC Thun,2530,6,9,7,16,47,58,-11,34
FC Lugano,2530,7,9,7,16,30,47,-17,34
Grasshoppers,2530,8,8,7,17,36,49,-13,31
FC Sion,2530,9,6,7,19,37,61,-24,25
Young Boys,2531,1,23,6,3,76,37,39,75
FC Basel,2531,2,18,7,7,56,31,25,61
Lucerne,2531,3,15,7,10,47,44,3,52
St Gallen,2531,4,16,2,14,46,53,-7,50
FC Zürich,2531,5,10,9,13,42,41,1,39
Grasshoppers,2531,6,10,6,16,41,50,-9,36
FC Thun,2531,7,10,5,17,47,59,-12,35
FC Lugano,2531,8,10,5,17,29,47,-18,35
FC Sion,2531,9,5,7,20,40,62,-22,22
Young Boys,2532,1,22,7,3,77,38,39,73
FC Basel,2532,2,17,7,8,55,30,25,58
St Gallen,2532,3,16,2,14,44,52,-8,50
FC Zürich,2532,4,11,10,11,43,37,6,43
Lucerne,2532,5,11,8,13,36,47,-11,41
Grasshoppers,2532,6,11,6,15,46,51,-5,39
FC Lugano,2532,7,10,8,14,32,46,-14,38
FC Thun,2532,8,9,6,17,45,61,-16,33
FC Sion,2532,9,6,8,18,39,55,-16,26
Young Boys,2533,1,22,7,3,70,35,35,73
FC Basel,2533,2,18,9,5,57,23,34,63
St Gallen,2533,3,14,3,15,42,57,-15,45
Lucerne,2533,4,11,8,13,41,48,-7,41
FC Lugano,2533,5,11,6,15,34,47,-13,39
FC Zürich,2533,6,9,11,12,38,39,-1,38
Grasshoppers,2533,7,10,6,16,41,51,-10,36
FC Thun,2533,8,10,5,17,47,58,-11,35
FC Sion,2533,9,8,7,17,43,55,-12,31
Young Boys,2534,1,23,7,2,72,32,40,76
FC Basel,2534,2,16,11,5,53,25,28,59
Lucerne,2534,3,12,10,10,39,40,-1,46
St Gallen,2534,4,14,4,14,42,54,-12,46
FC Zürich,2534,5,10,10,12,39,36,3,40
FC Lugano,2534,6,11,5,16,31,45,-14,38
Grasshoppers,2534,7,10,7,15,39,45,-6,37
FC Thun,2534,8,10,5,17,41,57,-16,35
FC Sion,2534,9,5,7,20,36,58,-22,22
Young Boys,2535,1,21,6,5,70,35,35,69
FC Basel,2535,2,19,7,6,59,26,33,64
St Gallen,2535,3,14,3,15,43,56,-13,45
FC Zürich,2535,4,11,9,12,40,37,3,42
Lucerne,2535,5,11,8,13,42,49,-7,41
Grasshoppers,2535,6,10,7,15,43,50,-7,37
FC Lugano,2535,7,10,7,15,31,47,-16,37
FC Thun,2535,8,10,6,16,46,62,-16,36
FC Sion,2535,9,7,9,16,42,54,-12,30
Young Boys,2536,1,20,7,5,72,38,34,67
FC Basel,2536,2,17,9,6,54,28,26,60
Lucerne,2536,3,14,8,10,42,43,-1,50
FC Zürich,2536,4,13,9,10,46,33,13,48
St Gallen,2536,5,13,4,15,39,53,-14,43
Grasshoppers,2536,6,11,6,15,42,47,-5,39
FC Lugano,2536,7,10,5,17,29,50,-21,35
FC Thun,2536,8,8,7,17,40,58,-18,31
FC Sion,2536,9,6,9,17,38,52,-14,27
Young Boys,2537,1,23,6,3,76,37,39,75
FC Basel,2537,2,17,9,6,52,24,28,60
St Gallen,2537,3,14,4,14,43,53,-10,46
FC Zürich,2537,4,10,11,11,39,35,4,41
Lucerne,2537,5,11,8,13,40,50,-10,41
FC Thun,2537,6,11,5,16,45,56,-11,38
FC Lugano,2537,7,11,5,16,31,47,-16,38
Grasshoppers,2537,8,9,8,15,41,50,-9,35
FC Sion,2537,9,5,10,17,37,52,-15,25
Young Boys,2538,1,21,8,3,70,33,37,71
FC Basel,2538,2,19,8,5,56,23,33,65
Lucerne,2538,3,12,11,9,44,43,1,47
St Gallen,2538,4,13,3,16,41,56,-15,42
FC Zürich,2538,5,9,11,12,36,35,1,38
FC Thun,2538,6,10,6,16,44,58,-14,36
FC Lugano,2538,7,9,9,14,28,43,-15,36
Grasshoppers,2538,8,9,7,16,40,51,-11,34
FC Sion,2538,9,7,7,18,41,58,-17,28
Young Boys,2539,1,21,7,4,69,34,35,70
FC Basel,2539,2,19,8,5,57,25,32,65
Lucerne,2539,3,14,8,10,46,44,2,50
St Gallen,2539,4,14,4,14,46,59,-13,46
FC Zürich,2539,5,9,9,14,36,38,-2,36
FC Sion,2539,6,9,8,15,46,50,-4,35
FC Lugano,2539,7,10,5,17,30,46,-16,35
FC Thun,2539,8,10,5,17,41,59,-18,35
Grasshoppers,2539,9,8,6,18,37,53,-16,30
Young Boys,2540,1,20,8,4,71,36,35,68
FC Basel,2540,2,18,7,7,54,26,28,61
St Gallen,2540,3,15,2,15,42,54,-12,47
Lucerne,2540,4,12,8,12,40,47,-7,44
FC Zürich,2540,5,11,10,11,40,36,4,43
FC Lugano,2540,6,11,6,15,33,45,-12,39
Grasshoppers,2540,7,9,8,15,42,48,-6,35
FC Thun,2540,8,10,5,17,44,59,-15,35
FC Sion,2540,9,7,8,17,41,56,-15,29
Young Boys,2541,1,21,7,4,70,36,34,70
FC Basel,2541,2,18,8,6,57,27,30,62
Lucerne,2541,3,13,8,11,43,44,-1,47
St Gallen,2541,4,14,3,15,44,57,-13,45
FC Zürich,2541,5,10,12,10,40,35,5,42
Grasshoppers,2541,6,10,7,15,43,49,-6,37
FC Lugano,2541,7,10,7,15,32,47,-15,37
FC Thun,2541,8,9,6,17,43,60,-17,33
FC Sion,2541,9,6,8,18,38,55,-17,26
Young Boys,2542,1,21,7,4,68,37,31,70
FC Basel,2542,2,17,9,6,56,29,27,60
Lucerne,2542,3,15,8,9,52,41,11,53
St Gallen,2542,4,14,4,14,42,53,-11,46
FC Zürich,2542,5,10,10,12,40,39,1,40
FC Lugano,2542,6,10,5,17,28,49,-21,35
Grasshoppers,2542,7,9,7,16,38,47,-9,34
FC Thun,2542,8,9,5,18,40,59,-19,32
FC Sion,2542,9,7,9,16,40,50,-10,30
Young Boys,2543,1,24,6,2,72,31,41,78
FC Basel,2543,2,17,9,6,53,28,25,60
St Gallen,2543,3,14,2,16,45,57,-12,44
Lucerne,2543,4,11,9,12,42,49,-7,42
FC Zürich,2543,5,9,13,10,44,40,4,40
FC Lugano,2543,6,10,7,15,36,50,-14,37
Grasshoppers,2543,7,10,6,16,39,49,-10,36
FC Thun,2543,8,9,7,16,42,55,-13,34
FC Sion,2543,9,6,9,17,41,55,-14,27
Young Boys,2544,1,22,7,3,79,36,43,73
FC Basel,2544,2,17,7,8,53,31,22,58
St Gallen,2544,3,16,2,14,48,55,-7,50
Lucerne,2544,4,13,7,12,44,49,-5,46
FC Zürich,2544,5,12,9,11,44,37,7,45
FC Lugano,2544,6,11,5,16,32,51,-19,38
FC Thun,2544,7,10,5,17,47,61,-14,35
Grasshoppers,2544,8,9,7,16,42,52,-10,34
FC Sion,2544,9,6,7,19,44,61,-17,25
Young Boys,2545,1,21,9,2,72,34,38,72
FC Basel,2545,2,18,9,5,58,23,35,63
Lucerne,2545,3,13,8,11,42,49,-7,47
St Gallen,2545,4,15,2,15,46,56,-10,47
FC Zürich,2545,5,11,11,10,42,34,8,44
FC Lugano,2545,6,10,5,17,30,50,-20,35
Grasshoppers,2545,7,8,8,16,39,49,-10,32
FC Thun,2545,8,8,8,16,41,59,-18,32
FC Sion,2545,9,5,10,17,39,55,-16,25
Young Boys,2546,1,22,6,4,70,36,34,72
FC Basel,2546,2,19,7,6,55,24,31,64
St Gallen,2546,3,14,4,14,43,52,-9,46
Lucerne,2546,4,12,9,11,41,42,-1,45
FC Zürich,2546,5,11,10,11,40,34,6,43
FC Thun,2546,6,10,6,16,43,59,-16,36
FC Lugano,2546,7,9,6,17,28,49,-21,33
FC Sion,2546,8,8,7,17,42,54,-12,31
Grasshoppers,2546,9,8,7,17,39,51,-12,31
Young Boys,2547,1,23,6,3,74,34,40,75
FC Basel,2547,2,18,7,7,59,30,29,61
St Gallen,2547,3,17,2,13,51,54,-3,53
FC Zürich,2547,4,11,10,11,41,35,6,43
Lucerne,2547,5,11,7,14,39,53,-14,40
Grasshoppers,2547,6,11,6,15,46,48,-2,39
FC Lugano,2547,7,11,5,16,32,48,-16,38
FC Thun,2547,8,8,7,17,41,60,-19,31
FC Sion,2547,9,5,8,19,38,59,-21,23
Young Boys,2548,1,23,6,3,71,34,37,75
FC Basel,2548,2,16,8,8,51,31,20,56
St Gallen,2548,3,16,2,14,46,54,-8,50
FC Zürich,2548,4,12,10,10,44,35,9,46
Lucerne,2548,5,12,8,12,41,42,-1,44
FC Thun,2548,6,10,6,16,47,57,-10,36
FC Lugano,2548,7,10,6,16,30,47,-17,36
Grasshoppers,2548,8,9,6,17,39,54,-15,33
FC Sion,2548,9,6,8,18,42,57,-15,26
Young Boys,2549,1,23,6,3,74,37,37,75
FC Basel,2549,2,18,8,6,56,25,31,62
St Gallen,2549,3,14,5,13,44,54,-10,47
FC Zürich,2549,4,11,11,10,46,36,10,44
Lucerne,2549,5,11,10,11,41,45,-4,43
Grasshoppers,2549,6,9,7,16,43,50,-7,34
FC Thun,2549,7,9,7,16,44,60,-16,34
FC Lugano,2549,8,9,7,16,32,53,-21,34
FC Sion,2549,9,5,9,18,41,61,-20,24
Young Boys,2550,1,22,8,2,76,34,42,74
FC Basel,2550,2,18,9,5,52,24,28,63
St Gallen,2550,3,15,3,14,47,56,-9,48
Lucerne,2550,4,12,7,13,38,45,-7,43
FC Zürich,2550,5,10,10,12,37,34,3,40
Grasshoppers,2550,6,10,7,15,43,51,-8,37
FC Thun,2550,7,10,6,16,43,56,-13,36
FC Lugano,2550,8,10,6,16,30,48,-18,36
FC Sion,2550,9,5,8,19,39,57,-18,23
Young Boys,2551,1,22,7,3,75,34,41,73
FC Basel,2551,2,18,8,6,51,26,25,62
Lucerne,2551,3,12,8,12,39,46,-7,44
St Gallen,2551,4,13,3,16,39,54,-15,42
FC Zürich,2551,5,10,11,11,41,37,4,41
FC Lugano,2551,6,12,5,15,35,46,-11,41
Grasshoppers,2551,7,10,6,16,40,48,-8,36
FC Sion,2551,8,8,9,15,45,51,-6,33
FC Thun,2551,9,8,5,19,39,62,-23,29
Young Boys,2552,1,22,7,3,69,31,38,73
FC Basel,2552,2,19,7,6,54,24,30,64
St Gallen,2552,3,15,2,15,44,55,-11,47
Lucerne,2552,4,12,7,13,39,44,-5,43
FC Zürich,2552,5,10,9,13,39,37,2,39
FC Thun,2552,6,11,5,16,45,56,-11,38
FC Lugano,2552,7,11,5,16,30,47,-17,38
Grasshoppers,2552,8,9,7,16,40,50,-10,34
FC Sion,2552,9,7,7,18,41,57,-16,28
Young Boys,2553,1,21,7,4,73,40,33,70
FC Basel,2553,2,17,9,6,55,28,27,60
St Gallen,2553,3,15,3,14,43,51,-8,48
FC Zürich,2553,4,12,10,10,42,35,7,46
Lucerne,2553,5,13,7,12,44,45,-1,46
FC Lugano,2553,6,11,6,15,34,49,-15,39
Grasshoppers,2553,7,9,6,17,41,53,-12,33
FC Thun,2553,8,9,5,18,44,62,-18,32
FC Sion,2553,9,7,7,18,41,54,-13,28
Young Boys,2554,1,22,8,2,71,32,39,74
FC Basel,2554,2,19,7,6,59,24,35,64
Lucerne,2554,3,12,8,12,41,46,-5,44
St Gallen,2554,4,14,2,16,41,62,-21,44
FC Zürich,2554,5,11,9,12,43,40,3,42
FC Lugano,2554,6,10,7,15,34,47,-13,37
Grasshoppers,2554,7,10,6,16,41,49,-8,36
FC Thun,2554,8,9,5,18,39,59,-20,32
FC Sion,2554,9,7,8,17,45,55,-10,29
Young Boys,2555,1,22,7,3,75,36,39,73
FC Basel,2555,2,18,9,5,55,27,28,63
St Gallen,2555,3,15,3,14,43,53,-10,48
FC Zürich,2555,4,12,9,11,45,38,7,45
Lucerne,2555,5,12,7,13,41,48,-7,43
FC Thun,2555,6,10,5,17,43,57,-14,35
FC Lugano,2555,7,10,5,17,33,51,-18,35
Grasshoppers,2555,8,9,6,17,40,50,-10,33
FC Sion,2555,9,7,7,18,41,56,-15,28
Young Boys,2556,1,22,6,4,76,38,38,72
FC Basel,2556,2,19,8,5,56,22,34,65
Lucerne,2556,3,12,9,11,44,45,-1,45
St Gallen,2556,4,14,3,15,43,56,-13,45
FC Zürich,2556,5,11,9,12,42,37,5,42
FC Thun,2556,6,11,5,16,46,57,-11,38
Grasshoppers,2556,7,10,6,16,43,53,-10,36
FC Lugano,2556,8,9,7,16,29,50,-21,34
FC Sion,2556,9,6,7,19,41,62,-21,25
Young Boys,2557,1,22,7,3,73,33,40,73
FC Basel,2557,2,18,8,6,55,26,29,62
St Gallen,2557,3,15,3,14,46,55,-9,48
Lucerne,2557,4,12,9,11,41,46,-5,45
FC Zürich,2557,5,11,9,12,39,36,3,42
FC Lugano,2557,6,10,7,15,31,45,-14,37
Grasshoppers,2557,7,9,7,16,42,51,-9,34
FC Sion,2557,8,8,7,17,41,57,-16,31
FC Thun,2557,9,8,5,19,40,59,-19,29
Young Boys,2558,1,20,10,2,67,32,35,70
FC Basel,2558,2,19,8,5,62,23,39,65
Lucerne,2558,3,13,8,11,47,45,2,47
St Gallen,2558,4,13,4,15,44,63,-19,43
FC Zürich,2558,5,10,10,12,41,40,1,40
FC Lugano,2558,6,10,7,15,33,48,-15,37
Grasshoppers,2558,7,9,7,16,42,52,-10,34
FC Thun,2558,8,9,6,17,43,62,-19,33
FC Sion,2558,9,6,10,16,40,54,-14,28
Young Boys,2559,1,22,7,3,75,32,43,73
FC Basel,2559,2,16,8,8,48,25,23,56
Lucerne,2559,3,13,8,11,47,50,-3,47
St Gallen,2559,4,15,2,15,43,53,-10,47
FC Zürich,2559,5,10,10,12,37,34,3,40
FC Thun,2559,6,10,6,16,43,58,-15,36
FC Lugano,2559,7,10,6,16,30,50,-20,36
Grasshoppers,2559,8,9,8,15,43,52,-9,35
FC Sion,2559,9,8,7,17,42,54,-12,31
Young Boys,2560,1,21,9,2,67,31,36,72
FC Basel,2560,2,18,9,5,53,23,30,63
Lucerne,2560,3,13,9,10,42,42,0,48
St Gallen,2560,4,14,2,16,41,57,-16,44
FC Zürich,2560,5,10,11,11,42,38,4,41
Grasshoppers,2560,6,9,9,14,40,47,-7,36
FC Thun,2560,7,10,6,16,43,57,-14,36
FC Lugano,2560,8,9,6,17,29,48,-19,33
FC Sion,2560,9,6,7,19,41,55,-14,25
Young Boys,2561,1,22,6,4,73,36,37,72
FC Basel,2561,2,19,8,5,53,22,31,65
Lucerne,2561,3,12,10,10,40,43,-3,46
St Gallen,2561,4,14,2,16,40,53,-13,44
FC Zürich,2561,5,10,10,12,44,40,4,40
Grasshoppers,2561,6,11,7,14,47,50,-3,40
FC Lugano,2561,7,9,7,16,29,47,-18,34
FC Thun,2561,8,9,6,17,44,61,-17,33
FC Sion,2561,9,6,8,18,38,56,-18,26
Young Boys,2562,1,21,7,4,78,38,40,70
FC Basel,2562,2,17,8,7,58,28,30,59
Lucerne,2562,3,15,7,10,49,45,4,52
FC Zürich,2562,4,12,10,10,44,36,8,46
St Gallen,2562,5,13,3,16,41,56,-15,42
Grasshoppers,2562,6,11,6,15,45,56,-11,39
FC Lugano,2562,7,10,6,16,32,49,-17,36
FC Thun,2562,8,9,5,18,43,62,-19,32
FC Sion,2562,9,6,8,18,39,59,-20,26
Young Boys,2563,1,21,7,4,72,37,35,70
FC Basel,2563,2,19,8,5,59,25,34,65
Lucerne,2563,3,15,7,10,46,41,5,52
FC Zürich,2563,4,12,10,10,43,34,9,46
St Gallen,2563,5,14,3,15,46,56,-10,45
FC Lugano,2563,6,9,6,17,28,52,-24,33
FC Thun,2563,7,9,5,18,43,60,-17,32
Grasshoppers,2563,8,8,6,18,37,54,-17,30
FC Sion,2563,9,7,8,17,40,55,-15,29
Young Boys,2564,1,24,6,2,72,31,41,78
FC Basel,2564,2,17,8,7,53,25,28,59
St Gallen,2564,3,16,3,13,47,53,-6,51
FC Zürich,2564,4,11,11,10,44,35,9,44
Lucerne,2564,5,11,7,14,39,50,-11,40
Grasshoppers,2564,6,10,7,15,39,46,-7,37
FC Lugano,2564,7,10,6,16,33,51,-18,36
FC Thun,2564,8,8,5,19,38,62,-24,29
FC Sion,2564,9,6,9,17,41,53,-12,27
Young Boys,2565,1,23,6,3,72,32,40,75
FC Basel,2565,2,19,7,6,57,24,33,64
St Gallen,2565,3,15,2,15,45,54,-9,47
Lucerne,2565,4,12,7,13,41,49,-8,43
FC Zürich,2565,5,10,10,12,40,40,0,40
Grasshoppers,2565,6,10,7,15,39,46,-7,37
FC Thun,2565,7,10,7,15,43,54,-11,37
FC Lugano,2565,8,10,5,17,32,52,-20,35
FC Sion,2565,9,6,7,19,37,55,-18,25
Young Boys,2566,1,23,6,3,77,36,41,75
FC Basel,2566,2,17,9,6,56,27,29,60
FC Zürich,2566,3,12,10,10,41,34,7,46
Lucerne,2566,4,13,7,12,45,48,-3,46
St Gallen,2566,5,14,3,15,41,55,-14,45
Grasshoppers,2566,6,9,6,17,42,55,-13,33
FC Thun,2566,7,9,6,17,43,57,-14,33
FC Lugano,2566,8,9,6,17,28,48,-20,33
FC Sion,2566,9,8,7,17,40,53,-13,31
Young Boys,2567,1,22,6,4,71,37,34,72
FC Basel,2567,2,16,9,7,52,28,24,57
Lucerne,2567,3,14,8,10,49,46,3,50
FC Zürich,2567,4,12,10,10,44,36,8,46
St Gallen,2567,5,13,2,17,41,56,-15,41
Grasshoppers,2567,6,10,6,16,45,53,-8,36
FC Thun,2567,7,10,6,16,42,57,-15,36
FC Lugano,2567,8,10,5,17,32,49,-17,35
FC Sion,2567,9,7,8,17,40,54,-14,29
Young Boys,2568,1,24,6,2,75,34,41,78
FC Basel,2568,2,18,7,7,57,25,32,61
Lucerne,2568,3,14,7,11,46,47,-1,49
St Gallen,2568,4,14,2,16,42,57,-15,44
FC Zürich,2568,5,11,10,11,41,38,3,43
FC Lugano,2568,6,10,5,17,33,51,-18,35
FC Thun,2568,7,9,7,16,49,65,-16,34
Grasshoppers,2568,8,8,8,16,39,49,-10,32
FC Sion,2568,9,5,10,17,41,57,-16,25
Young Boys,2569,1,20,8,4,73,39,34,68
FC Basel,2569,2,17,9,6,53,27,26,60
Lucerne,2569,3,13,9,10,43,44,-1,48
St Gallen,2569,4,13,4,15,41,54,-13,43
FC Zürich,2569,5,10,10,12,40,39,1,40
FC Lugano,2569,6,11,5,16,33,48,-15,38
Grasshoppers,2569,7,10,6,16,45,50,-5,36
FC Sion,2569,8,8,9,15,40,50,-10,33
FC Thun,2569,9,9,6,17,42,59,-17,33
Young Boys,2570,1,23,7,2,75,30,45,76
FC Basel,2570,2,17,9,6,53,27,26,60
Lucerne,2570,3,13,8,11,44,48,-4,47
St Gallen,2570,4,14,4,14,44,53,-9,46
FC Zürich,2570,5,10,9,13,42,40,2,39
FC Lugano,2570,6,10,7,15,32,49,-17,37
Grasshoppers,2570,7,9,7,16,43,53,-10,34
FC Thun,2570,8,8,7,17,44,62,-18,31
FC Sion,2570,9,7,8,17,42,57,-15,29
Young Boys,2571,1,20,8,4,68,35,33,68
FC Basel,2571,2,18,9,5,53,25,28,63
Lucerne,2571,3,13,9,10,44,44,0,48
St Gallen,2571,4,14,3,15,44,56,-12,45
FC Zürich,2571,5,10,9,13,38,37,1,39
FC Lugano,2571,6,11,6,15,32,47,-15,39
FC Thun,2571,7,10,7,15,43,55,-12,37
Grasshoppers,2571,8,9,8,15,40,48,-8,35
FC Sion,2571,9,6,7,19,39,54,-15,25
Young Boys,2572,1,22,6,4,72,36,36,72
FC Basel,2572,2,17,8,7,54,30,24,59
St Gallen,2572,3,15,3,14,45,58,-13,48
Lucerne,2572,4,12,8,12,42,45,-3,44
FC Lugano,2572,5,12,5,15,35,45,-10,41
Grasshoppers,2572,6,11,6,15,42,48,-6,39
FC Zürich,2572,7,9,10,13,37,38,-1,37
FC Thun,2572,8,10,6,16,45,57,-12,36
FC Sion,2572,9,5,10,17,42,57,-15,25
Young Boys,2573,1,22,7,3,72,34,38,73
FC Basel,2573,2,16,8,8,49,28,21,56
St Gallen,2573,3,15,3,14,45,53,-8,48
Lucerne,2573,4,12,10,10,40,41,-1,46
FC Zürich,2573,5,10,10,12,38,36,2,40
FC Lugano,2573,6,10,6,16,30,46,-16,36
Grasshoppers,2573,7,8,10,14,40,48,-8,34
FC Thun,2573,8,8,9,15,42,57,-15,33
FC Sion,2573,9,7,9,16,40,53,-13,30
Young Boys,2574,1,22,7,3,70,32,38,73
FC Basel,2574,2,18,8,6,55,25,30,62
St Gallen,2574,3,15,4,13,43,52,-9,49
FC Zürich,2574,4,12,9,11,41,35,6,45
Lucerne,2574,5,11,8,13,38,48,-10,41
FC Lugano,2574,6,10,6,16,30,45,-15,36
Grasshoppers,2574,7,9,8,15,40,47,-7,35
FC Thun,2574,8,9,7,16,41,57,-16,34
FC Sion,2574,9,5,9,18,37,54,-17,24
Young Boys,2575,1,22,7,3,76,35,41,73
FC Basel,2575,2,17,9,6,53,25,28,60
Lucerne,2575,3,13,9,10,47,45,2,48
FC Zürich,2575,4,11,10,11,41,35,6,43
St Gallen,2575,5,13,4,15,43,58,-15,43
FC Thun,2575,6,11,5,16,45,58,-13,38
FC Lugano,2575,7,10,6,16,31,52,-21,36
Grasshoppers,2575,8,9,6,17,41,54,-13,33
FC Sion,2575,9,6,8,18,39,54,-15,26
Young Boys,2576,1,21,8,3,71,36,35,71
FC Basel,2576,2,18,8,6,51,24,27,62
Lucerne,2576,3,13,7,12,43,45,-2,46
St Gallen,2576,4,14,2,16,41,56,-15,44
FC Lugano,2576,5,11,7,14,39,47,-8,40
FC Zürich,2576,6,9,12,11,38,35,3,39
Grasshoppers,2576,7,11,6,15,39,48,-9,39
FC Thun,2576,8,8,7,17,40,57,-17,31
FC Sion,2576,9,6,9,17,39,53,-14,27
Young Boys,2577,1,21,9,2,70,31,39,72
FC Basel,2577,2,17,8,7,53,29,24,59
St Gallen,2577,3,15,2,15,44,54,-10,47
Lucerne,2577,4,12,9,11,41,45,-4,45
FC Zürich,2577,5,10,11,11,40,36,4,41
FC Thun,2577,6,11,5,16,47,59,-12,38
FC Lugano,2577,7,10,7,15,31,47,-16,37
Grasshoppers,2577,8,9,8,15,41,50,-9,35
FC Sion,2577,9,5,9,18,39,55,-16,24
Young Boys,2578,1,21,9,2,72,34,38,72
FC Basel,2578,2,16,10,6,51,26,25,58
Lucerne,2578,3,12,9,11,41,47,-6,45
FC Zürich,2578,4,11,11,10,44,37,7,44
St Gallen,2578,5,13,5,14,43,55,-12,44
Grasshoppers,2578,6,10,8,14,47,50,-3,38
FC Thun,2578,7,9,6,17,43,59,-16,33
FC Lugano,2578,8,9,6,17,31,50,-19,33
FC Sion,2578,9,6,10,16,42,56,-14,28
Young Boys,2579,1,20,8,4,72,36,36,68
FC Basel,2579,2,18,9,5,54,24,30,63
Lucerne,2579,3,13,9,10,48,46,2,48
St Gallen,2579,4,13,3,16,40,55,-15,42
FC Zürich,2579,5,9,11,12,37,36,1,38
FC Lugano,2579,6,11,5,16,32,49,-17,38
FC Sion,2579,7,10,7,15,42,49,-7,37
Grasshoppers,2579,8,9,7,16,41,53,-12,34
FC Thun,2579,9,8,7,17,38,56,-18,31
Young Boys,2580,1,22,7,3,76,36,40,73
FC Basel,2580,2,17,9,6,53,25,28,60
St Gallen,2580,3,14,4,14,44,55,-11,46
Lucerne,2580,4,12,8,12,44,48,-4,44
FC Zürich,2580,5,10,12,10,40,35,5,42
Grasshoppers,2580,6,10,6,16,45,54,-9,36
FC Thun,2580,7,10,6,16,44,59,-15,36
FC Lugano,2580,8,10,6,16,30,48,-18,36
FC Sion,2580,9,5,10,17,43,59,-16,25
Young Boys,2581,1,22,6,4,70,34,36,72
FC Basel,2581,2,17,9,6,54,27,27,60
FC Zürich,2581,3,12,10,10,45,37,8,46
Lucerne,2581,4,12,10,10,41,42,-1,46
St Gallen,2581,5,13,3,16,38,54,-16,42
FC Sion,2581,6,9,7,16,41,50,-9,34
FC Lugano,2581,7,9,7,16,27,45,-18,34
Grasshoppers,2581,8,8,8,16,39,50,-11,32
FC Thun,2581,9,8,8,16,45,61,-16,32
Young Boys,2582,1,22,6,4,77,35,42,72
FC Basel,2582,2,18,8,6,54,24,30,62
FC Zürich,2582,3,12,9,11,42,35,7,45
Lucerne,2582,4,12,9,11,40,49,-9,45
St Gallen,2582,5,13,6,13,39,50,-11,45
FC Thun,2582,6,10,6,16,46,60,-14,36
Grasshoppers,2582,7,9,7,16,41,49,-8,34
FC Lugano,2582,8,9,6,17,28,49,-21,33
FC Sion,2582,9,6,9,17,40,56,-16,27
Young Boys,2583,1,22,7,3,70,32,38,73
FC Basel,2583,2,19,7,6,56,24,32,64
Lucerne,2583,3,13,8,11,41,46,-5,47
St Gallen,2583,4,15,2,15,47,58,-11,47
FC Zürich,2583,5,9,12,11,39,36,3,39
FC Thun,2583,6,10,6,16,44,61,-17,36
Grasshoppers,2583,7,9,7,16,42,48,-6,34
FC Lugano,2583,8,9,6,17,27,47,-20,33
FC Sion,2583,9,6,9,17,42,56,-14,27
Young Boys,2584,1,19,8,5,68,39,29,65
FC Basel,2584,2,19,7,6,56,24,32,64
St Gallen,2584,3,15,3,14,46,54,-8,48
Lucerne,2584,4,12,9,11,43,46,-3,45
Grasshoppers,2584,5,11,7,14,47,49,-2,40
FC Zürich,2584,6,9,11,12,42,41,1,38
FC Lugano,2584,7,10,8,14,34,45,-11,38
FC Thun,2584,8,9,7,16,44,60,-16,34
FC Sion,2584,9,6,8,18,39,61,-22,26
Young Boys,2585,1,20,8,4,70,41,29,68
FC Basel,2585,2,16,10,6,54,29,25,58
St Gallen,2585,3,16,3,13,45,51,-6,51
Lucerne,2585,4,12,9,11,41,42,-1,45
FC Zürich,2585,5,11,9,12,45,41,4,42
FC Lugano,2585,6,10,6,16,34,50,-16,36
Grasshoppers,2585,7,9,8,15,40,48,-8,35
FC Thun,2585,8,10,5,17,46,61,-15,35
FC Sion,2585,9,7,8,17,45,57,-12,29
Young Boys,2586,1,22,6,4,75,36,39,72
FC Basel,2586,2,19,7,6,56,24,32,64
Lucerne,2586,3,13,7,12,41,46,-5,46
St Gallen,2586,4,14,3,15,41,54,-13,45
FC Zürich,2586,5,10,9,13,39,39,0,39
FC Sion,2586,6,10,7,15,45,53,-8,37
FC Lugano,2586,7,10,6,16,32,48,-16,36
FC Thun,2586,8,10,5,17,46,59,-13,35
Grasshoppers,2586,9,8,6,18,39,55,-16,30
Young Boys,2587,1,23,7,2,79,32,47,76
FC Basel,2587,2,16,8,8,53,28,25,56
St Gallen,2587,3,16,3,13,44,50,-6,51
FC Zürich,2587,4,11,9,12,44,36,8,42
Lucerne,2587,5,11,9,12,38,48,-10,42
FC Thun,2587,6,12,5,15,49,59,-10,41
FC Lugano,2587,7,10,6,16,30,50,-20,36
Grasshoppers,2587,8,9,8,15,44,48,-4,35
FC Sion,2587,9,5,7,20,36,66,-30,22
Young Boys,2588,1,22,6,4,73,37,36,72
FC Basel,2588,2,18,7,7,52,28,24,61
St Gallen,2588,3,14,2,16,39,53,-14,44
Lucerne,2588,4,12,7,13,39,43,-4,43
FC Zürich,2588,5,11,9,12,45,38,7,42
FC Lugano,2588,6,12,5,15,30,43,-13,41
Grasshoppers,2588,7,10,6,16,42,50,-8,36
FC Thun,2588,8,10,6,16,46,58,-12,36
FC Sion,2588,9,7,8,17,44,60,-16,29
Young Boys,2589,1,21,8,3,78,37,41,71
FC Basel,2589,2,17,9,6,53,27,26,60
St Gallen,2589,3,14,4,14,40,50,-10,46
Lucerne,2589,4,12,8,12,40,49,-9,44
FC Zürich,2589,5,10,11,11,40,36,4,41
FC Thun,2589,6,11,6,15,49,60,-11,39
Grasshoppers,2589,7,10,7,15,42,48,-6,37
FC Lugano,2589,8,10,6,16,31,47,-16,36
FC Sion,2589,9,5,9,18,35,54,-19,24
Young Boys,2590,1,20,7,5,67,38,29,67
FC Basel,2590,2,19,7,6,57,24,33,64
St Gallen,2590,3,16,2,14,43,51,-8,50
Lucerne,2590,4,12,9,11,37,40,-3,45
FC Zürich,2590,5,11,10,11,40,35,5,43
Grasshoppers,2590,6,10,7,15,41,49,-8,37
FC Thun,2590,7,10,5,17,46,60,-14,35
FC Lugano,2590,8,9,7,16,29,46,-17,34
FC Sion,2590,9,6,8,18,39,56,-17,26
Young Boys,2591,1,22,6,4,70,33,37,72
FC Basel,2591,2,18,8,6,53,24,29,62
Lucerne,2591,3,12,9,11,43,46,-3,45
St Gallen,2591,4,14,3,15,41,54,-13,45
FC Zürich,2591,5,11,9,12,41,37,4,42
FC Lugano,2591,6,11,5,16,34,47,-13,38
FC Thun,2591,7,10,6,16,42,57,-15,36
Grasshoppers,2591,8,9,7,16,40,49,-9,34
FC Sion,2591,9,7,7,18,40,57,-17,28
Young Boys,2592,1,21,7,4,75,41,34,70
FC Basel,2592,2,17,10,5,55,28,27,61
St Gallen,2592,3,14,4,14,46,57,-11,46
FC Zürich,2592,4,12,9,11,43,35,8,45
Lucerne,2592,5,12,8,12,44,47,-3,44
Grasshoppers,2592,6,10,7,15,45,51,-6,37
FC Lugano,2592,7,10,7,15,32,48,-16,37
FC Thun,2592,8,9,6,17,44,60,-16,33
FC Sion,2592,9,6,8,18,39,56,-17,26
Young Boys,2593,1,22,7,3,74,33,41,73
FC Basel,2593,2,18,8,6,55,28,27,62
Lucerne,2593,3,13,8,11,43,43,0,47
St Gallen,2593,4,13,5,14,47,59,-12,44
FC Zürich,2593,5,9,11,12,36,35,1,38
Grasshoppers,2593,6,10,7,15,40,46,-6,37
FC Thun,2593,7,10,5,17,42,58,-16,35
FC Lugano,2593,8,9,7,16,30,51,-21,34
FC Sion,2593,9,6,10,16,39,53,-14,28
Young Boys,2594,1,19,8,5,67,38,29,65
FC Basel,2594,2,18,7,7,53,28,25,61
St Gallen,2594,3,15,2,15,45,54,-9,47
FC Zürich,2594,4,11,11,10,43,35,8,44
Lucerne,2594,5,12,8,12,41,44,-3,44
FC Thun,2594,6,10,7,15,45,56,-11,37
Grasshoppers,2594,7,9,8,15,41,49,-8,35
FC Lugano,2594,8,10,5,17,30,50,-20,35
FC Sion,2594,9,8,8,16,41,52,-11,32
Young Boys,2595,1,22,6,4,76,37,39,72
FC Basel,2595,2,17,8,7,53,27,26,59
St Gallen,2595,3,15,3,14,41,51,-10,48
Lucerne,2595,4,12,9,11,39,42,-3,45
FC Zürich,2595,5,10,10,12,42,40,2,40
Grasshoppers,2595,6,10,7,15,43,50,-7,37
FC Lugano,2595,7,10,6,16,33,50,-17,36
FC Thun,2595,8,10,5,17,43,58,-15,35
FC Sion,2595,9,7,8,17,44,59,-15,29
Young Boys,2596,1,22,8,2,71,32,39,74
FC Basel,2596,2,17,9,6,57,29,28,60
Lucerne,2596,3,14,7,11,42,41,1,49
St Gallen,2596,4,14,2,16,41,56,-15,44
FC Zürich,2596,5,10,10,12,42,40,2,40
FC Thun,2596,6,10,6,16,42,59,-17,36
FC Lugano,2596,7,10,5,17,31,49,-18,35
Grasshoppers,2596,8,8,8,16,38,48,-10,32
FC Sion,2596,9,8,7,17,41,51,-10,31
Young Boys,2597,1,21,7,4,72,34,38,70
FC Basel,2597,2,19,7,6,58,26,32,64
St Gallen,2597,3,15,2,15,47,59,-12,47
Lucerne,2597,4,13,7,12,44,49,-5,46
FC Zürich,2597,5,11,9,12,43,37,6,42
FC Lugano,2597,6,11,5,16,34,50,-16,38
FC Thun,2597,7,9,6,17,44,62,-18,33
Grasshoppers,2597,8,8,8,16,41,51,-10,32
FC Sion,2597,9,8,7,17,40,55,-15,31
Young Boys,2598,1,21,8,3,72,36,36,71
FC Basel,2598,2,15,10,7,52,29,23,55
Lucerne,2598,3,12,10,10,42,43,-1,46
FC Zürich,2598,4,11,11,10,43,36,7,44
St Gallen,2598,5,13,5,14,44,56,-12,44
Grasshoppers,2598,6,11,6,15,42,51,-9,39
FC Thun,2598,7,10,6,16,48,61,-13,36
FC Lugano,2598,8,9,7,16,32,50,-18,34
FC Sion,2598,9,6,9,17,43,56,-13,27
Young Boys,2599,1,22,8,2,75,36,39,74
FC Basel,2599,2,19,7,6,56,25,31,64
Lucerne,2599,3,12,9,11,42,43,-1,45
St Gallen,2599,4,13,3,16,41,56,-15,42
FC Zürich,2599,5,10,9,13,38,37,1,39
FC Lugano,2599,6,11,5,16,30,49,-19,38
Grasshoppers,2599,7,10,7,15,44,50,-6,37
FC Thun,2599,8,10,5,17,45,60,-15,35
FC Sion,2599,9,7,7,18,43,58,-15,28
Young Boys,2600,1,23,7,2,70,31,39,76
FC Basel,2600,2,16,9,7,52,25,27,57
St Gallen,2600,3,16,2,14,47,54,-7,50
Lucerne,2600,4,13,8,11,45,44,1,47
FC Zürich,2600,5,10,10,12,41,39,2,40
FC Lugano,2600,6,11,5,16,33,50,-17,38
Grasshoppers,2600,7,9,7,16,39,49,-10,34
FC Sion,2600,8,7,9,16,40,52,-12,30
FC Thun,2600,9,8,5,19,40,63,-23,29
Young Boys,2601,1,21,7,4,72,36,36,70
FC Basel,2601,2,18,9,5,56,25,31,63
St Gallen,2601,3,15,3,14,44,56,-12,48
Lucerne,2601,4,12,9,11,46,46,0,45
FC Zürich,2601,5,11,11,10,44,36,8,44
FC Lugano,2601,6,10,6,16,31,50,-19,36
Grasshoppers,2601,7,9,8,15,41,50,-9,35
FC Thun,2601,8,8,7,17,44,64,-20,31
FC Sion,2601,9,6,8,18,42,57,-15,26
Young Boys,2602,1,21,6,5,72,36,36,69
FC Basel,2602,2,18,7,7,54,26,28,61
Lucerne,2602,3,13,8,11,42,44,-2,47
St Gallen,2602,4,15,2,15,43,56,-13,47
FC Zürich,2602,5,12,10,10,43,34,9,46
FC Thun,2602,6,11,5,16,46,56,-10,38
FC Lugano,2602,7,10,6,16,30,47,-17,36
Grasshoppers,2602,8,9,7,16,41,53,-12,34
FC Sion,2602,9,6,7,19,39,58,-19,25
Young Boys,2603,1,21,8,3,69,34,35,71
FC Basel,2603,2,18,7,7,53,25,28,61
St Gallen,2603,3,14,5,13,46,55,-9,47
FC Zürich,2603,4,11,9,12,42,39,3,42
Lucerne,2603,5,11,9,12,41,47,-6,42
Grasshoppers,2603,6,11,6,15,43,48,-5,39
FC Lugano,2603,7,11,6,15,34,47,-13,39
FC Thun,2603,8,9,5,18,43,60,-17,32
FC Sion,2603,9,6,9,17,39,55,-16,27
Young Boys,2604,1,21,6,5,67,35,32,69
FC Basel,2604,2,17,7,8,52,27,25,58
Lucerne,2604,3,13,8,11,42,42,0,47
St Gallen,2604,4,14,3,15,42,57,-15,45
FC Zürich,2604,5,11,10,11,40,34,6,43
Grasshoppers,2604,6,10,7,15,41,49,-8,37
FC Thun,2604,7,10,7,15,43,56,-13,37
FC Lugano,2604,8,10,6,16,33,48,-15,36
FC Sion,2604,9,7,8,17,40,52,-12,29
Young Boys,2605,1,23,6,3,76,33,43,75
FC Basel,2605,2,17,7,8,54,28,26,58
Lucerne,2605,3,14,7,11,42,45,-3,49
St Gallen,2605,4,14,2,16,44,55,-11,44
FC Zürich,2605,5,11,9,12,41,40,1,42
FC Thun,2605,6,11,5,16,47,55,-8,38
FC Lugano,2605,7,11,5,16,32,47,-15,38
FC Sion,2605,8,8,7,17,41,56,-15,31
Grasshoppers,2605,9,8,6,18,37,55,-18,30
Young Boys,2606,1,22,7,3,67,31,36,73
FC Basel,2606,2,18,8,6,57,28,29,62
Lucerne,2606,3,14,7,11,43,42,1,49
FC Zürich,2606,4,13,9,10,44,34,10,48
St Gallen,2606,5,13,3,16,42,59,-17,42
Grasshoppers,2606,6,10,7,15,41,46,-5,37
FC Lugano,2606,7,10,5,17,30,48,-18,35
FC Thun,2606,8,8,6,18,41,62,-21,30
FC Sion,2606,9,6,8,18,39,54,-15,26
Young Boys,2607,1,20,7,5,71,40,31,67
FC Basel,2607,2,19,8,5,59,27,32,65
FC Lugano,2607,3,13,5,14,33,42,-9,44
St Gallen,2607,4,14,2,16,41,55,-14,44
Lucerne,2607,5,11,9,12,40,46,-6,42
Grasshoppers,2607,6,11,6,15,42,51,-9,39
FC Zürich,2607,7,9,9,14,40,41,-1,36
FC Sion,2607,8,9,7,16,44,51,-7,34
FC Thun,2607,9,9,5,18,45,62,-17,32
Young Boys,2608,1,23,7,2,75,31,44,76
FC Basel,2608,2,17,8,7,51,25,26,59
FC Zürich,2608,3,13,9,10,43,33,10,48
St Gallen,2608,4,15,3,14,44,55,-11,48
Lucerne,2608,5,12,7,13,39,48,-9,43
FC Lugano,2608,6,11,5,16,34,47,-13,38
Grasshoppers,2608,7,9,6,17,39,51,-12,33
FC Thun,2608,8,9,5,18,42,60,-18,32
FC Sion,2608,9,6,8,18,40,57,-17,26
Young Boys,2609,1,21,7,4,75,38,37,70
FC Basel,2609,2,17,9,6,54,26,28,60
Lucerne,2609,3,13,8,11,43,47,-4,47
St Gallen,2609,4,14,5,13,42,51,-9,47
FC Zürich,2609,5,11,11,10,41,34,7,44
Grasshoppers,2609,6,11,6,15,43,47,-4,39
FC Lugano,2609,7,9,8,15,36,53,-17,35
FC Thun,2609,8,9,5,18,43,62,-19,32
FC Sion,2609,9,5,9,18,35,54,-19,24
Young Boys,2610,1,21,8,3,73,38,35,71
FC Basel,2610,2,18,8,6,55,25,30,62
St Gallen,2610,3,15,4,13,45,53,-8,49
Lucerne,2610,4,12,8,12,44,46,-2,44
Grasshoppers,2610,5,11,6,15,45,50,-5,39
FC Lugano,2610,6,10,7,15,34,50,-16,37
FC Zürich,2610,7,9,9,14,38,40,-2,36
FC Thun,2610,8,9,6,17,42,60,-18,33
FC Sion,2610,9,6,10,16,37,51,-14,28
Young Boys,2611,1,20,7,5,66,38,28,67
FC Basel,2611,2,16,9,7,50,25,25,57
St Gallen,2611,3,17,2,13,46,50,-4,53
Lucerne,2611,4,12,9,11,45,45,0,45
FC Zürich,2611,5,11,9,12,43,39,4,42
Grasshoppers,2611,6,10,7,15,43,50,-7,37
FC Thun,2611,7,10,6,16,46,59,-13,36
FC Lugano,2611,8,10,6,16,33,51,-18,36
FC Sion,2611,9,6,9,17,39,54,-15,27
Young Boys,2612,1,20,8,4,72,38,34,68
FC Basel,2612,2,16,9,7,51,28,23,57
Lucerne,2612,3,14,9,9,46,40,6,51
St Gallen,2612,4,15,2,15,44,56,-12,47
FC Zürich,2612,5,10,11,11,39,35,4,41
FC Thun,2612,6,10,7,15,42,54,-12,37
Grasshoppers,2612,7,9,8,15,41,49,-8,35
FC Lugano,2612,8,9,6,17,30,52,-22,33
FC Sion,2612,9,7,8,17,42,55,-13,29
Young Boys,2613,1,23,7,2,75,30,45,76
FC Basel,2613,2,16,10,6,53,29,24,58
St Gallen,2613,3,15,3,14,44,54,-10,48
Lucerne,2613,4,13,7,12,44,47,-3,46
FC Zürich,2613,5,10,10,12,38,37,1,40
Grasshoppers,2613,6,10,6,16,40,51,-11,36
FC Thun,2613,7,9,8,15,43,56,-13,35
FC Lugano,2613,8,10,5,17,32,48,-16,35
FC Sion,2613,9,6,8,18,37,54,-17,26
Young Boys,2614,1,21,8,3,73,36,37,71
FC Basel,2614,2,18,9,5,58,24,34,63
St Gallen,2614,3,14,2,16,39,55,-16,44
Lucerne,2614,4,12,7,13,42,52,-10,43
FC Zürich,2614,5,9,13,10,37,33,4,40
Grasshoppers,2614,6,10,7,15,45,51,-6,37
FC Thun,2614,7,10,6,16,44,59,-15,36
FC Lugano,2614,8,10,6,16,30,46,-16,36
FC Sion,2614,9,7,8,17,40,52,-12,29
Young Boys,2615,1,21,6,5,68,37,31,69
FC Basel,2615,2,17,9,6,60,28,32,60
Lucerne,2615,3,14,7,11,47,44,3,49
St Gallen,2615,4,13,4,15,40,57,-17,43
FC Zürich,2615,5,10,10,12,42,41,1,40
Grasshoppers,2615,6,11,6,15,44,50,-6,39
FC Lugano,2615,7,10,6,16,30,48,-18,36
FC Thun,2615,8,10,5,17,47,63,-16,35
FC Sion,2615,9,8,7,17,43,53,-10,31
Young Boys,2616,1,19,8,5,66,41,25,65
FC Basel,2616,2,18,8,6,57,26,31,62
FC Zürich,2616,3,12,10,10,44,37,7,46
St Gallen,2616,4,14,4,14,43,56,-13,46
Lucerne,2616,5,12,7,13,43,43,0,43
Grasshoppers,2616,6,11,7,14,43,47,-4,40
FC Lugano,2616,7,11,6,15,34,46,-12,39
FC Thun,2616,8,8,6,18,43,64,-21,30
FC Sion,2616,9,5,12,15,40,53,-13,27
Young Boys,2617,1,21,7,4,69,35,34,70
FC Basel,2617,2,18,8,6,54,24,30,62
Lucerne,2617,3,12,9,11,44,43,1,45
St Gallen,2617,4,14,2,16,43,58,-15,44
FC Lugano,2617,5,12,5,15,31,46,-15,41
FC Zürich,2617,6,10,10,12,40,36,4,40
FC Thun,2617,7,10,6,16,44,59,-15,36
Grasshoppers,2617,8,9,7,16,44,54,-10,34
FC Sion,2617,9,7,8,17,38,52,-14,29
Young Boys,2618,1,22,6,4,75,36,39,72
FC Basel,2618,2,19,7,6,56,23,33,64
Lucerne,2618,3,13,7,12,43,45,-2,46
St Gallen,2618,4,14,3,15,43,57,-14,45
FC Zürich,2618,5,11,9,12,42,36,6,42
FC Lugano,2618,6,11,6,15,31,47,-16,39
Grasshoppers,2618,7,9,6,17,42,56,-14,33
FC Thun,2618,8,9,6,17,44,62,-18,33
FC Sion,2618,9,7,8,17,44,58,-14,29
Young Boys,2619,1,22,7,3,71,34,37,73
FC Basel,2619,2,18,8,6,52,25,27,62
Lucerne,2619,3,13,8,11,41,42,-1,47
St Gallen,2619,4,13,4,15,42,55,-13,43
FC Zürich,2619,5,10,11,11,38,36,2,41
Grasshoppers,2619,6,10,6,16,44,49,-5,36
FC Lugano,2619,7,9,8,15,27,44,-17,35
FC Thun,2619,8,9,6,17,42,59,-17,33
FC Sion,2619,9,7,8,17,39,52,-13,29
Young Boys,2620,1,23,7,2,76,34,42,76
FC Basel,2620,2,17,9,6,54,26,28,60
Lucerne,2620,3,14,7,11,43,46,-3,49
St Gallen,2620,4,14,4,14,44,53,-9,46
FC Zürich,2620,5,10,11,11,39,35,4,41
Grasshoppers,2620,6,9,7,16,43,50,-7,34
FC Lugano,2620,7,9,7,16,31,50,-19,34
FC Thun,2620,8,8,6,18,43,65,-22,30
FC Sion,2620,9,6,10,16,42,56,-14,28
Young Boys,2621,1,20,9,3,72,38,34,69
FC Basel,2621,2,17,9,6,51,25,26,60
Lucerne,2621,3,14,7,11,39,41,-2,49
St Gallen,2621,4,14,4,14,42,52,-10,46
FC Zürich,2621,5,9,10,13,37,40,-3,37
FC Thun,2621,6,10,7,15,45,56,-11,37
FC Lugano,2621,7,10,7,15,35,47,-12,37
Grasshoppers,2621,8,9,6,17,42,52,-10,33
FC Sion,2621,9,7,9,16,41,53,-12,30
Young Boys,2622,1,23,6,3,70,33,37,75
FC Basel,2622,2,17,7,8,52,27,25,58
St Gallen,2622,3,15,3,14,43,54,-11,48
Lucerne,2622,4,12,7,13,40,48,-8,43
FC Zürich,2622,5,11,9,12,40,39,1,42
Grasshoppers,2622,6,11,7,14,45,45,0,40
FC Lugano,2622,7,11,5,16,35,47,-12,38
FC Sion,2622,8,7,9,16,37,49,-12,30
FC Thun,2622,9,8,5,19,41,61,-20,29
Young Boys,2623,1,20,7,5,67,35,32,67
FC Basel,2623,2,16,9,7,50,27,23,57
Lucerne,2623,3,13,7,12,44,47,-3,46
St Gallen,2623,4,14,4,14,44,55,-11,46
FC Lugano,2623,5,11,7,14,33,46,-13,40
FC Zürich,2623,6,9,11,12,40,38,2,38
FC Thun,2623,7,11,5,16,44,56,-12,38
Grasshoppers,2623,8,10,6,16,42,50,-8,36
FC Sion,2623,9,8,8,16,42,52,-10,32
Young Boys,2624,1,22,7,3,76,36,40,73
FC Basel,2624,2,17,9,6,55,30,25,60
St Gallen,2624,3,15,3,14,42,53,-11,48
Lucerne,2624,4,12,7,13,44,51,-7,43
FC Zürich,2624,5,9,11,12,41,40,1,38
Grasshoppers,2624,6,10,6,16,42,52,-10,36
FC Lugano,2624,7,10,6,16,34,48,-14,36
FC Sion,2624,8,8,9,15,43,51,-8,33
FC Thun,2624,9,9,6,17,42,58,-16,33
Young Boys,2625,1,22,7,3,73,34,39,73
FC Basel,2625,2,18,8,6,57,27,30,62
Lucerne,2625,3,12,10,10,47,49,-2,46
St Gallen,2625,4,14,4,14,43,56,-13,46
FC Zürich,2625,5,11,9,12,42,38,4,42
FC Lugano,2625,6,9,8,15,32,49,-17,35
Grasshoppers,2625,7,9,7,16,41,53,-12,34
FC Thun,2625,8,8,7,17,43,61,-18,31
FC Sion,2625,9,7,8,17,42,53,-11,29
Young Boys,2626,1,23,6,3,72,34,38,75
FC Basel,2626,2,18,8,6,53,26,27,62
St Gallen,2626,3,15,2,15,44,56,-12,47
Lucerne,2626,4,11,9,12,39,45,-6,42
FC Lugano,2626,5,12,5,15,36,49,-13,41
FC Zürich,2626,6,10,10,12,40,37,3,40
Grasshoppers,2626,7,10,8,14,44,46,-2,38
FC Thun,2626,8,8,7,17,44,61,-17,31
FC Sion,2626,9,6,7,19,40,58,-18,25
Young Boys,2627,1,23,6,3,79,38,41,75
FC Basel,2627,2,16,9,7,51,29,22,57
St Gallen,2627,3,15,4,13,47,53,-6,49
FC Zürich,2627,4,13,9,10,46,33,13,48
Lucerne,2627,5,13,9,10,44,42,2,48
FC Thun,2627,6,11,5,16,46,57,-11,38
FC Lugano,2627,7,9,5,18,29,52,-23,32
Grasshoppers,2627,8,8,7,17,39,55,-16,31
FC Sion,2627,9,5,8,19,36,58,-22,23
Young Boys,2628,1,19,10,3,67,34,33,67
FC Basel,2628,2,18,7,7,52,26,26,61
St Gallen,2628,3,15,4,13,45,52,-7,49
Lucerne,2628,4,12,10,10,43,42,1,46
FC Zürich,2628,5,11,9,12,41,38,3,42
FC Lugano,2628,6,10,7,15,32,44,-12,37
FC Thun,2628,7,10,6,16,44,57,-13,36
Grasshoppers,2628,8,9,7,16,40,52,-12,34
FC Sion,2628,9,5,10,17,40,59,-19,25
Young Boys,2629,1,23,7,2,75,34,41,76
FC Basel,2629,2,17,9,6,51,25,26,60
Lucerne,2629,3,11,12,9,43,44,-1,45
St Gallen,2629,4,13,6,13,44,55,-11,45
FC Zürich,2629,5,10,10,12,40,36,4,40
FC Lugano,2629,6,10,7,15,32,48,-16,37
FC Thun,2629,7,10,6,16,44,57,-13,36
Grasshoppers,2629,8,9,7,16,41,51,-10,34
FC Sion,2629,9,5,8,19,34,54,-20,23
Young Boys,2630,1,21,8,3,69,33,36,71
FC Basel,2630,2,16,9,7,51,28,23,57
St Gallen,2630,3,14,4,14,44,54,-10,46
Lucerne,2630,4,12,9,11,40,42,-2,45
FC Thun,2630,5,12,5,15,45,56,-11,41
FC Zürich,2630,6,10,10,12,41,37,4,40
FC Lugano,2630,7,10,7,15,31,48,-17,37
Grasshoppers,2630,8,8,9,15,38,47,-9,33
FC Sion,2630,9,6,9,17,40,54,-14,27
Young Boys,2631,1,21,8,3,73,36,37,71
FC Basel,2631,2,17,9,6,53,27,26,60
Lucerne,2631,3,12,8,12,42,47,-5,44
St Gallen,2631,4,14,2,16,43,56,-13,44
FC Zürich,2631,5,10,11,11,40,35,5,41
Grasshoppers,2631,6,10,7,15,43,49,-6,37
FC Lugano,2631,7,10,7,15,32,48,-16,37
FC Thun,2631,8,9,7,16,44,59,-15,34
FC Sion,2631,9,7,9,16,42,55,-13,30
Young Boys,2632,1,21,7,4,69,38,31,70
FC Basel,2632,2,19,7,6,55,24,31,64
St Gallen,2632,3,15,2,15,41,52,-11,47
Lucerne,2632,4,11,8,13,40,48,-8,41
FC Zürich,2632,5,10,10,12,45,38,7,40
Grasshoppers,2632,6,10,7,15,44,47,-3,37
FC Lugano,2632,7,10,7,15,31,50,-19,37
FC Thun,2632,8,10,5,17,43,61,-18,35
FC Sion,2632,9,7,9,16,44,54,-10,30
Young Boys,2633,1,22,7,3,72,35,37,73
FC Basel,2633,2,19,8,5,58,26,32,65
St Gallen,2633,3,14,4,14,45,54,-9,46
Lucerne,2633,4,12,8,12,42,47,-5,44
FC Zürich,2633,5,11,9,12,41,36,5,42
Grasshoppers,2633,6,11,6,15,45,52,-7,39
FC Thun,2633,7,10,5,17,43,60,-17,35
FC Lugano,2633,8,9,6,17,31,51,-20,33
FC Sion,2633,9,6,7,19,38,54,-16,25
Young Boys,2634,1,23,7,2,79,33,46,76
FC Basel,2634,2,17,10,5,55,25,30,61
Lucerne,2634,3,13,7,12,44,48,-4,46
St Gallen,2634,4,14,3,15,40,53,-13,45
FC Zürich,2634,5,10,11,11,43,38,5,41
FC Lugano,2634,6,12,5,15,33,52,-19,41
FC Thun,2634,7,9,7,16,46,58,-12,34
Grasshoppers,2634,8,8,6,18,38,58,-20,30
FC Sion,2634,9,6,8,18,42,55,-13,26
Young Boys,2635,1,23,6,3,76,37,39,75
FC Basel,2635,2,18,8,6,55,27,28,62
Lucerne,2635,3,12,10,10,43,43,0,46
St Gallen,2635,4,14,4,14,43,56,-13,46
FC Zürich,2635,5,10,11,11,40,36,4,41
FC Lugano,2635,6,9,8,15,30,46,-16,35
Grasshoppers,2635,7,9,7,16,43,54,-11,34
FC Thun,2635,8,8,7,17,42,59,-17,31
FC Sion,2635,9,6,9,17,42,56,-14,27
Young Boys,2636,1,22,6,4,73,38,35,72
FC Basel,2636,2,18,8,6,52,25,27,62
Lucerne,2636,3,14,7,11,46,45,1,49
St Gallen,2636,4,14,3,15,41,53,-12,45
FC Zürich,2636,5,10,11,11,39,35,4,41
FC Thun,2636,6,10,5,17,43,57,-14,35
Grasshoppers,2636,7,9,7,16,42,49,-7,34
FC Lugano,2636,8,9,6,17,29,50,-21,33
FC Sion,2636,9,7,9,16,40,53,-13,30
Young Boys,2637,1,24,6,2,78,37,41,78
FC Basel,2637,2,17,7,8,56,29,27,58
St Gallen,2637,3,17,2,13,47,51,-4,53
Lucerne,2637,4,13,7,12,43,49,-6,46
FC Zürich,2637,5,11,10,11,42,36,6,43
FC Thun,2637,6,10,6,16,44,59,-15,36
FC Lugano,2637,7,9,5,18,30,50,-20,32
Grasshoppers,2637,8,8,7,17,40,53,-13,31
FC Sion,2637,9,6,8,18,38,54,-16,26
Young Boys,2638,1,21,9,2,72,33,39,72
FC Basel,2638,2,19,7,6,58,27,31,64
St Gallen,2638,3,15,2,15,42,54,-12,47
Lucerne,2638,4,13,7,12,48,51,-3,46
FC Zürich,2638,5,10,9,13,42,39,3,39
FC Lugano,2638,6,11,6,15,36,51,-15,39
FC Thun,2638,7,10,5,17,43,57,-14,35
Grasshoppers,2638,8,9,7,16,41,52,-11,34
FC Sion,2638,9,6,8,18,38,56,-18,26
Young Boys,2639,1,23,6,3,75,35,40,75
FC Basel,2639,2,19,7,6,57,22,35,64
St Gallen,2639,3,15,2,15,41,53,-12,47
Lucerne,2639,4,12,7,13,40,45,-5,43
FC Thun,2639,5,11,5,16,46,58,-12,38
FC Zürich,2639,6,9,10,13,40,40,0,37
FC Lugano,2639,7,10,6,16,30,47,-17,36
Grasshoppers,2639,8,9,6,17,38,51,-13,33
FC Sion,2639,9,8,7,17,43,59,-16,31
Young Boys,2640,1,21,7,4,71,37,34,70
FC Basel,2640,2,15,9,8,51,29,22,54
Lucerne,2640,3,13,9,10,39,39,0,48
FC Zürich,2640,4,12,10,10,44,36,8,46
St Gallen,2640,5,14,4,14,40,51,-11,46
FC Thun,2640,6,10,7,15,45,56,-11,37
FC Lugano,2640,7,10,6,16,31,47,-16,36
Grasshoppers,2640,8,9,7,16,41,52,-11,34
FC Sion,2640,9,6,9,17,41,56,-15,27
Young Boys,2641,1,22,6,4,73,39,34,72
FC Basel,2641,2,17,7,8,56,30,26,58
St Gallen,2641,3,15,3,14,44,53,-9,48
FC Zürich,2641,4,11,10,11,42,36,6,43
Lucerne,2641,5,11,8,13,40,49,-9,41
Grasshoppers,2641,6,11,7,14,47,48,-1,40
FC Lugano,2641,7,11,6,15,31,47,-16,39
FC Thun,2641,8,9,5,18,40,58,-18,32
FC Sion,2641,9,6,10,16,42,55,-13,28
Young Boys,2642,1,23,6,3,73,35,38,75
FC Basel,2642,2,20,7,5,63,25,38,67
Lucerne,2642,3,13,8,11,43,49,-6,47
St Gallen,2642,4,14,2,16,42,55,-13,44
FC Zürich,2642,5,10,11,11,41,37,4,41
FC Lugano,2642,6,10,6,16,30,47,-17,36
Grasshoppers,2642,7,9,8,15,40,49,-9,35
FC Thun,2642,8,8,6,18,43,62,-19,30
FC Sion,2642,9,6,8,18,39,55,-16,26
Young Boys,2643,1,20,8,4,65,33,32,68
FC Basel,2643,2,16,8,8,53,29,24,56
Lucerne,2643,3,14,8,10,45,42,3,50
St Gallen,2643,4,15,3,14,42,53,-11,48
FC Zürich,2643,5,12,10,10,43,35,8,46
Grasshoppers,2643,6,10,7,15,44,50,-6,37
FC Lugano,2643,7,9,7,16,29,48,-19,34
FC Thun,2643,8,9,5,18,43,62,-19,32
FC Sion,2643,9,7,8,17,41,53,-12,29
Young Boys,2644,1,21,6,5,69,35,34,69
FC Basel,2644,2,17,10,5,54,27,27,61
St Gallen,2644,3,15,4,13,45,54,-9,49
Lucerne,2644,4,12,9,11,42,44,-2,45
FC Zürich,2644,5,10,11,11,39,35,4,41
FC Thun,2644,6,10,5,17,45,60,-15,35
FC Lugano,2644,7,9,7,16,29,47,-18,34
Grasshoppers,2644,8,9,6,17,41,51,-10,33
FC Sion,2644,9,8,8,16,41,52,-11,32
Young Boys,2645,1,22,7,3,69,33,36,73
FC Basel,2645,2,18,9,5,54,25,29,63
St Gallen,2645,3,14,4,14,47,56,-9,46
Lucerne,2645,4,12,8,12,44,45,-1,44
FC Zürich,2645,5,9,12,11,39,36,3,39
Grasshoppers,2645,6,10,6,16,42,51,-9,36
FC Thun,2645,7,9,7,16,43,57,-14,34
FC Lugano,2645,8,9,7,16,31,51,-20,34
FC Sion,2645,9,7,8,17,42,57,-15,29
Young Boys,2646,1,22,6,4,73,35,38,72
FC Basel,2646,2,20,7,5,56,24,32,67
FC Zürich,2646,3,12,9,11,43,35,8,45
Lucerne,2646,4,12,7,13,42,44,-2,43
St Gallen,2646,5,13,2,17,40,58,-18,41
FC Lugano,2646,6,11,5,16,31,50,-19,38
Grasshoppers,2646,7,10,6,16,44,52,-8,36
FC Thun,2646,8,9,6,17,41,58,-17,33
FC Sion,2646,9,7,8,17,41,55,-14,29
Young Boys,2647,1,21,7,4,70,40,30,70
FC Basel,2647,2,18,8,6,60,24,36,62
Lucerne,2647,3,13,9,10,43,45,-2,48
St Gallen,2647,4,14,4,14,41,52,-11,46
FC Thun,2647,5,11,6,15,47,57,-10,39
FC Lugano,2647,6,11,5,16,32,48,-16,38
FC Zürich,2647,7,9,10,13,39,41,-2,37
Grasshoppers,2647,8,10,7,15,45,49,-4,37
FC Sion,2647,9,5,8,19,36,57,-21,23
Young Boys,2648,1,22,6,4,75,35,40,72
FC Basel,2648,2,18,8,6,55,28,27,62
Lucerne,2648,3,14,8,10,45,47,-2,50
FC Zürich,2648,4,11,11,10,41,34,7,44
St Gallen,2648,5,14,2,16,44,56,-12,44
Grasshoppers,2648,6,10,7,15,43,50,-7,37
FC Lugano,2648,7,10,6,16,31,48,-17,36
FC Thun,2648,8,8,6,18,40,59,-19,30
FC Sion,2648,9,6,8,18,40,57,-17,26
Young Boys,2649,1,22,8,2,71,34,37,74
FC Basel,2649,2,17,7,8,54,30,24,58
Lucerne,2649,3,14,7,11,42,44,-2,49
FC Zürich,2649,4,12,10,10,45,36,9,46
St Gallen,2649,5,14,2,16,43,55,-12,44
FC Lugano,2649,6,10,6,16,30,46,-16,36
Grasshoppers,2649,7,9,7,16,38,46,-8,34
FC Thun,2649,8,9,7,16,46,59,-13,34
FC Sion,2649,9,6,8,18,39,58,-19,26
Young Boys,2650,1,22,6,4,72,35,37,72
FC Basel,2650,2,19,8,5,58,24,34,65
St Gallen,2650,3,15,2,15,45,57,-12,47
Lucerne,2650,4,11,8,13,40,50,-10,41
FC Zürich,2650,5,10,9,13,37,37,0,39
Grasshoppers,2650,6,10,7,15,44,49,-5,37
FC Thun,2650,7,10,7,15,45,57,-12,37
FC Lugano,2650,8,10,6,16,32,48,-16,36
FC Sion,2650,9,7,7,18,39,55,-16,28
Young Boys,2651,1,22,8,2,70,32,38,74
FC Basel,2651,2,17,9,6,51,25,26,60
St Gallen,2651,3,15,2,15,43,54,-11,47
Lucerne,2651,4,12,10,10,37,40,-3,46
FC Zürich,2651,5,10,11,11,39,34,5,41
Grasshoppers,2651,6,9,9,14,41,48,-7,36
FC Thun,2651,7,10,5,17,43,57,-14,35
FC Lugano,2651,8,10,5,17,30,47,-17,35
FC Sion,2651,9,5,9,18,36,53,-17,24
Young Boys,2652,1,21,7,4,72,38,34,70
FC Basel,2652,2,18,8,6,53,27,26,62
St Gallen,2652,3,16,3,13,47,54,-7,51
Lucerne,2652,4,11,9,12,41,45,-4,42
FC Zürich,2652,5,10,10,12,43,38,5,40
Grasshoppers,2652,6,11,7,14,42,45,-3,40
FC Lugano,2652,7,10,6,16,32,50,-18,36
FC Thun,2652,8,9,7,16,43,58,-15,34
FC Sion,2652,9,5,9,18,39,57,-18,24
Young Boys,2653,1,20,8,4,68,35,33,68
FC Basel,2653,2,17,9,6,52,25,27,60
St Gallen,2653,3,16,3,13,47,52,-5,51
Lucerne,2653,4,13,8,11,41,45,-4,47
FC Zürich,2653,5,11,10,11,44,37,7,43
FC Lugano,2653,6,10,7,15,34,49,-15,37
Grasshoppers,2653,7,9,8,15,40,47,-7,35
FC Thun,2653,8,9,6,17,42,61,-19,33
FC Sion,2653,9,5,9,18,36,53,-17,24
Young Boys,2654,1,22,7,3,73,39,34,73
FC Basel,2654,2,16,8,8,54,31,23,56
St Gallen,2654,3,16,3,13,46,51,-5,51
Lucerne,2654,4,13,8,11,45,45,0,47
FC Thun,2654,5,11,6,15,50,58,-8,39
FC Zürich,2654,6,9,10,13,40,43,-3,37
Grasshoppers,2654,7,10,7,15,45,51,-6,37
FC Lugano,2654,8,10,6,16,29,47,-18,36
FC Sion,2654,9,6,7,19,41,58,-17,25
Young Boys,2655,1,22,6,4,73,37,36,72
FC Basel,2655,2,18,7,7,57,28,29,61
FC Zürich,2655,3,12,10,10,47,34,13,46
St Gallen,2655,4,14,2,16,45,60,-15,44
Lucerne,2655,5,11,7,14,41,51,-10,40
FC Lugano,2655,6,11,5,16,36,53,-17,38
Grasshoppers,2655,7,10,6,16,39,49,-10,36
FC Sion,2655,8,8,9,15,45,53,-8,33
FC Thun,2655,9,9,6,17,45,63,-18,33
Young Boys,2656,1,23,6,3,76,38,38,75
FC Basel,2656,2,18,7,7,55,28,27,61
Lucerne,2656,3,13,8,11,45,44,1,47
FC Zürich,2656,4,12,10,10,42,34,8,46
St Gallen,2656,5,13,3,16,40,57,-17,42
FC Lugano,2656,6,10,6,16,29,45,-16,36
FC Thun,2656,7,9,6,17,42,59,-17,33
Grasshoppers,2656,8,8,8,16,40,51,-11,32
FC Sion,2656,9,7,8,17,43,56,-13,29
Young Boys,2657,1,22,7,3,72,35,37,73
FC Basel,2657,2,19,7,6,55,25,30,64
St Gallen,2657,3,14,3,15,41,54,-13,45
Lucerne,2657,4,11,10,11,41,45,-4,43
FC Zürich,2657,5,11,9,12,39,35,4,42
FC Thun,2657,6,11,5,16,46,58,-12,38
FC Lugano,2657,7,11,5,16,32,47,-15,38
Grasshoppers,2657,8,8,8,16,37,48,-11,32
FC Sion,2657,9,6,8,18,39,55,-16,26
Young Boys,2658,1,22,6,4,76,38,38,72
FC Basel,2658,2,17,10,5,52,24,28,61
Lucerne,2658,3,14,8,10,46,43,3,50
St Gallen,2658,4,13,5,14,42,55,-13,44
FC Zürich,2658,5,10,11,11,42,38,4,41
FC Thun,2658,6,10,6,16,45,59,-14,36
FC Lugano,2658,7,10,6,16,29,48,-19,36
Grasshoppers,2658,8,9,7,16,46,56,-10,34
FC Sion,2658,9,5,9,18,44,61,-17,24
Young Boys,2659,1,22,6,4,73,33,40,72
FC Basel,2659,2,16,10,6,49,24,25,58
Lucerne,2659,3,13,7,12,40,44,-4,46
St Gallen,2659,4,14,3,15,43,53,-10,45
FC Zürich,2659,5,11,10,11,44,38,6,43
FC Lugano,2659,6,12,5,15,33,47,-14,41
Grasshoppers,2659,7,11,7,14,43,46,-3,40
FC Thun,2659,8,8,7,17,41,61,-20,31
FC Sion,2659,9,6,7,19,42,62,-20,25
Young Boys,2660,1,22,8,2,72,31,41,74
FC Basel,2660,2,16,10,6,50,25,25,58
St Gallen,2660,3,14,3,15,42,54,-12,45
FC Zürich,2660,4,10,11,11,39,37,2,41
FC Lugano,2660,5,12,5,15,36,48,-12,41
Lucerne,2660,6,11,7,14,39,50,-11,40
Grasshoppers,2660,7,9,7,16,43,50,-7,34
FC Thun,2660,8,8,9,15,44,59,-15,33
FC Sion,2660,9,7,10,15,44,55,-11,31
Young Boys,2661,1,20,7,5,71,41,30,67
FC Basel,2661,2,15,12,5,50,25,25,57
Lucerne,2661,3,14,9,9,43,38,5,51
St Gallen,2661,4,13,5,14,42,54,-12,44
FC Zürich,2661,5,9,12,11,38,35,3,39
FC Thun,2661,6,10,7,15,43,55,-12,37
Grasshoppers,2661,7,9,7,16,41,51,-10,34
FC Lugano,2661,8,9,7,16,30,48,-18,34
FC Sion,2661,9,7,10,15,40,51,-11,31
Young Boys,2662,1,21,7,4,74,38,36,70
FC Basel,2662,2,18,9,5,56,27,29,63
Lucerne,2662,3,13,8,11,45,47,-2,47
St Gallen,2662,4,14,3,15,45,56,-11,45
FC Zürich,2662,5,9,11,12,39,38,1,38
FC Thun,2662,6,11,5,16,44,55,-11,38
FC Lugano,2662,7,10,6,16,32,50,-18,36
FC Sion,2662,8,8,8,16,39,50,-11,32
Grasshoppers,2662,9,8,7,17,38,51,-13,31
Young Boys,2663,1,23,7,2,78,31,47,76
FC Basel,2663,2,17,8,7,52,28,24,59
St Gallen,2663,3,16,3,13,46,54,-8,51
Lucerne,2663,4,11,9,12,40,50,-10,42
FC Zürich,2663,5,10,11,11,39,35,4,41
FC Lugano,2663,6,10,7,15,34,47,-13,37
FC Thun,2663,7,10,6,16,43,57,-14,36
Grasshoppers,2663,8,9,7,16,38,48,-10,34
FC Sion,2663,9,5,8,19,39,59,-20,23
Young Boys,2664,1,22,6,4,72,36,36,72
FC Basel,2664,2,17,8,7,54,29,25,59
Lucerne,2664,3,12,10,10,41,42,-1,46
St Gallen,2664,4,14,4,14,45,57,-12,46
FC Zürich,2664,5,11,11,10,44,35,9,44
FC Lugano,2664,6,10,6,16,33,49,-16,36
Grasshoppers,2664,7,9,7,16,38,47,-9,34
FC Thun,2664,8,8,7,17,40,58,-18,31
FC Sion,2664,9,7,9,16,40,54,-14,30
Young Boys,2665,1,21,7,4,71,37,34,70
FC Basel,2665,2,17,8,7,53,27,26,59
St Gallen,2665,3,16,3,13,45,53,-8,51
Lucerne,2665,4,13,8,11,46,45,1,47
FC Zürich,2665,5,11,10,11,43,39,4,43
FC Lugano,2665,6,10,7,15,32,46,-14,37
Grasshoppers,2665,7,10,6,16,42,51,-9,36
FC Thun,2665,8,8,7,17,43,61,-18,31
FC Sion,2665,9,6,8,18,37,53,-16,26
Young Boys,2666,1,20,7,5,70,39,31,67
FC Basel,2666,2,19,8,5,55,24,31,65
Lucerne,2666,3,14,9,9,45,41,4,51
St Gallen,2666,4,14,2,16,43,59,-16,44
FC Zürich,2666,5,10,10,12,40,36,4,40
FC Lugano,2666,6,10,6,16,33,48,-15,36
FC Thun,2666,7,10,5,17,45,60,-15,35
Grasshoppers,2666,8,8,8,16,42,52,-10,32
FC Sion,2666,9,8,7,17,41,55,-14,31
Young Boys,2667,1,22,8,2,75,34,41,74
FC Basel,2667,2,18,8,6,56,29,27,62
Lucerne,2667,3,14,7,11,43,43,0,49
St Gallen,2667,4,14,3,15,45,58,-13,45
FC Zürich,2667,5,9,10,13,40,41,-1,37
FC Thun,2667,6,10,7,15,46,58,-12,37
FC Lugano,2667,7,10,5,17,31,50,-19,35
Grasshoppers,2667,8,8,7,17,37,49,-12,31
FC Sion,2667,9,7,9,16,44,55,-11,30
Young Boys,2668,1,20,8,4,67,37,30,68
FC Basel,2668,2,18,9,5,54,24,30,63
Lucerne,2668,3,14,8,10,41,42,-1,50
FC Zürich,2668,4,10,11,11,40,33,7,41
St Gallen,2668,5,13,2,17,41,60,-19,41
FC Lugano,2668,6,10,8,14,32,44,-12,38
Grasshoppers,2668,7,10,7,15,42,46,-4,37
FC Thun,2668,8,8,7,17,40,62,-22,31
FC Sion,2668,9,7,8,17,44,53,-9,29
Young Boys,2669,1,22,8,2,74,32,42,74
FC Basel,2669,2,18,7,7,53,25,28,61
St Gallen,2669,3,15,3,14,44,52,-8,48
FC Zürich,2669,4,12,9,11,40,34,6,45
Lucerne,2669,5,12,8,12,44,48,-4,44
Grasshoppers,2669,6,9,8,15,40,48,-8,35
FC Lugano,2669,7,10,5,17,30,53,-23,35
FC Thun,2669,8,9,5,18,41,61,-20,32
FC Sion,2669,9,6,9,17,39,52,-13,27
Young Boys,2670,1,22,7,3,75,34,41,73
FC Basel,2670,2,18,7,7,53,26,27,61
Lucerne,2670,3,13,8,11,40,42,-2,47
St Gallen,2670,4,15,2,15,42,56,-14,47
FC Zürich,2670,5,11,10,11,43,39,4,43
Grasshoppers,2670,6,9,8,15,44,50,-6,35
FC Thun,2670,7,9,6,17,44,60,-16,33
FC Lugano,2670,8,9,5,18,30,50,-20,32
FC Sion,2670,9,7,9,16,42,56,-14,30
Young Boys,2671,1,21,7,4,70,41,29,70
FC Basel,2671,2,17,9,6,54,25,29,60
Lucerne,2671,3,13,9,10,42,43,-1,48
FC Zürich,2671,4,12,10,10,43,35,8,46
St Gallen,2671,5,13,3,16,41,55,-14,42
FC Lugano,2671,6,11,5,16,35,50,-15,38
Grasshoppers,2671,7,10,7,15,48,51,-3,37
FC Thun,2671,8,10,5,17,45,60,-15,35
FC Sion,2671,9,6,7,19,39,57,-18,25
Young Boys,2672,1,23,6,3,72,35,37,75
FC Basel,2672,2,20,7,5,55,23,32,67
St Gallen,2672,3,15,3,14,47,52,-5,48
Lucerne,2672,4,12,8,12,42,50,-8,44
FC Zürich,2672,5,10,9,13,40,39,1,39
FC Thun,2672,6,11,5,16,44,57,-13,38
FC Lugano,2672,7,9,7,16,30,48,-18,34
Grasshoppers,2672,8,8,6,18,39,52,-13,30
FC Sion,2672,9,7,7,18,40,53,-13,28
Young Boys,2673,1,23,7,2,71,30,41,76
FC Basel,2673,2,17,8,7,52,25,27,59
St Gallen,2673,3,15,3,14,47,57,-10,48
Lucerne,2673,4,12,8,12,41,47,-6,44
FC Zürich,2673,5,10,10,12,40,39,1,40
FC Thun,2673,6,11,6,15,43,54,-11,39
FC Lugano,2673,7,9,8,15,30,46,-16,35
Grasshoppers,2673,8,9,6,17,39,51,-12,33
FC Sion,2673,9,6,8,18,43,57,-14,26
Young Boys,2674,1,22,7,3,71,35,36,73
FC Basel,2674,2,17,9,6,56,27,29,60
St Gallen,2674,3,13,5,14,44,56,-12,44
Lucerne,2674,4,11,10,11,41,46,-5,43
FC Zürich,2674,5,10,11,11,39,35,4,41
FC Lugano,2674,6,10,7,15,33,48,-15,37
FC Thun,2674,7,9,8,15,43,57,-14,35
Grasshoppers,2674,8,8,8,16,37,50,-13,32
FC Sion,2674,9,7,9,16,42,52,-10,30
Young Boys,2675,1,23,6,3,73,35,38,75
FC Basel,2675,2,18,7,7,53,27,26,61
St Gallen,2675,3,15,3,14,44,54,-10,48
Lucerne,2675,4,12,9,11,41,42,-1,45
FC Zürich,2675,5,11,9,12,41,41,0,42
FC Thun,2675,6,11,6,15,47,54,-7,39
Grasshoppers,2675,7,8,8,16,39,51,-12,32
FC Lugano,2675,8,9,5,18,30,51,-21,32
FC Sion,2675,9,6,9,17,40,53,-13,27
Young Boys,2676,1,20,8,4,68,35,33,68
FC Basel,2676,2,16,9,7,52,30,22,57
Lucerne,2676,3,12,9,11,40,43,-3,45
St Gallen,2676,4,14,3,15,41,53,-12,45
FC Zürich,2676,5,11,9,12,41,37,4,42
FC Lugano,2676,6,10,8,14,32,45,-13,38
Grasshoppers,2676,7,10,6,16,44,51,-7,36
FC Thun,2676,8,10,5,17,51,63,-12,35
FC Sion,2676,9,9,7,16,44,56,-12,34
Young Boys,2677,1,23,6,3,76,34,42,75
FC Basel,2677,2,18,8,6,59,27,32,62
St Gallen,2677,3,15,4,13,45,54,-9,49
Lucerne,2677,4,12,9,11,40,45,-5,45
FC Zürich,2677,5,10,9,13,39,41,-2,39
FC Lugano,2677,6,10,6,16,33,48,-15,36
FC Thun,2677,7,10,5,17,45,60,-15,35
Grasshoppers,2677,8,9,6,17,40,53,-13,33
FC Sion,2677,9,7,7,18,40,55,-15,28
Young Boys,2678,1,21,7,4,72,38,34,70
FC Basel,2678,2,18,8,6,53,26,27,62
Lucerne,2678,3,12,8,12,45,47,-2,44
FC Lugano,2678,4,12,6,14,37,44,-7,42
St Gallen,2678,5,13,3,16,42,60,-18,42
FC Zürich,2678,6,9,11,12,37,37,0,38
Grasshoppers,2678,7,10,7,15,43,47,-4,37
FC Thun,2678,8,10,5,17,42,60,-18,35
FC Sion,2678,9,7,9,16,40,52,-12,30
Young Boys,2679,1,21,8,3,71,36,35,71
FC Basel,2679,2,19,8,5,55,23,32,65
Lucerne,2679,3,13,7,12,42,44,-2,46
St Gallen,2679,4,14,3,15,42,55,-13,45
FC Zürich,2679,5,10,10,12,45,42,3,40
FC Thun,2679,6,10,6,16,46,60,-14,36
FC Lugano,2679,7,10,6,16,31,46,-15,36
Grasshoppers,2679,8,9,7,16,41,52,-11,34
FC Sion,2679,9,7,7,18,44,59,-15,28
Young Boys,2680,1,21,8,3,72,36,36,71
FC Basel,2680,2,19,7,6,54,25,29,64
St Gallen,2680,3,15,3,14,45,54,-9,48
Lucerne,2680,4,13,7,12,46,47,-1,46
FC Zürich,2680,5,12,9,11,43,34,9,45
FC Lugano,2680,6,10,7,15,30,45,-15,37
FC Thun,2680,7,9,6,17,43,61,-18,33
Grasshoppers,2680,8,8,8,16,42,55,-13,32
FC Sion,2680,9,5,9,18,40,58,-18,24
Young Boys,2681,1,21,6,5,68,35,33,69
FC Basel,2681,2,19,8,5,57,26,31,65
Lucerne,2681,3,14,7,11,42,41,1,49
St Gallen,2681,4,14,3,15,46,58,-12,45
FC Zürich,2681,5,10,10,12,40,38,2,40
FC Lugano,2681,6,11,6,15,32,48,-16,39
Grasshoppers,2681,7,10,6,16,40,48,-8,36
FC Thun,2681,8,9,6,17,43,57,-14,33
FC Sion,2681,9,6,8,18,42,59,-17,26
Young Boys,2682,1,21,7,4,71,37,34,70
FC Basel,2682,2,16,9,7,52,29,23,57
St Gallen,2682,3,15,4,13,46,54,-8,49
Lucerne,2682,4,12,10,10,46,46,0,46
FC Zürich,2682,5,11,10,11,39,34,5,43
Grasshoppers,2682,6,10,8,14,44,47,-3,38
FC Thun,2682,7,9,6,17,44,60,-16,33
FC Lugano,2682,8,9,6,17,29,49,-20,33
FC Sion,2682,9,7,8,17,42,57,-15,29
Young Boys,2683,1,22,7,3,77,33,44,73
FC Basel,2683,2,17,9,6,53,26,27,60
Lucerne,2683,3,14,8,10,47,42,5,50
St Gallen,2683,4,13,3,16,40,55,-15,42
FC Lugano,2683,5,11,6,15,31,47,-16,39
FC Zürich,2683,6,9,10,13,39,40,-1,37
Grasshoppers,2683,7,9,8,15,40,51,-11,35
FC Thun,2683,8,9,6,17,45,60,-15,33
FC Sion,2683,9,7,9,16,40,58,-18,30
Young Boys,2684,1,20,7,5,67,36,31,67
FC Basel,2684,2,17,9,6,50,26,24,60
Lucerne,2684,3,13,9,10,45,43,2,48
St Gallen,2684,4,14,4,14,43,54,-11,46
FC Zürich,2684,5,10,11,11,42,38,4,41
Grasshoppers,2684,6,11,7,14,45,49,-4,40
FC Lugano,2684,7,11,6,15,33,48,-15,39
FC Thun,2684,8,9,6,17,46,62,-16,33
FC Sion,2684,9,6,7,19,40,55,-15,25
Young Boys,2685,1,22,6,4,75,36,39,72
FC Basel,2685,2,18,8,6,53,24,29,62
St Gallen,2685,3,15,3,14,47,54,-7,48
Lucerne,2685,4,13,7,12,43,51,-8,46
FC Zürich,2685,5,10,10,12,39,37,2,40
Grasshoppers,2685,6,10,6,16,45,53,-8,36
FC Lugano,2685,7,10,6,16,33,49,-16,36
FC Thun,2685,8,10,5,17,42,58,-16,35
FC Sion,2685,9,7,7,18,43,58,-15,28
Young Boys,2686,1,22,7,3,72,33,39,73
FC Basel,2686,2,17,7,8,56,31,25,58
Lucerne,2686,3,14,8,10,42,41,1,50
St Gallen,2686,4,13,5,14,43,55,-12,44
FC Zürich,2686,5,11,10,11,43,38,5,43
Grasshoppers,2686,6,10,7,15,44,49,-5,37
FC Lugano,2686,7,10,6,16,32,48,-16,36
FC Thun,2686,8,8,7,17,46,67,-21,31
FC Sion,2686,9,6,9,17,42,58,-16,27
Young Boys,2687,1,21,8,3,73,36,37,71
FC Basel,2687,2,19,8,5,56,25,31,65
St Gallen,2687,3,14,2,16,42,59,-17,44
Lucerne,2687,4,12,7,13,42,50,-8,43
FC Zürich,2687,5,10,10,12,42,41,1,40
FC Lugano,2687,6,11,5,16,34,49,-15,38
FC Thun,2687,7,10,5,17,44,56,-12,35
Grasshoppers,2687,8,9,7,16,39,48,-9,34
FC Sion,2687,9,8,8,16,46,54,-8,32
Young Boys,2688,1,22,7,3,73,33,40,73
FC Basel,2688,2,18,8,6,52,24,28,62
St Gallen,2688,3,14,4,14,42,52,-10,46
FC Zürich,2688,4,11,11,10,44,36,8,44
Lucerne,2688,5,11,8,13,39,50,-11,41
FC Lugano,2688,6,11,5,16,32,47,-15,38
Grasshoppers,2688,7,8,10,14,42,50,-8,34
FC Thun,2688,8,9,7,16,45,59,-14,34
FC Sion,2688,9,5,10,17,41,59,-18,25
Young Boys,2689,1,23,7,2,73,33,40,76
FC Basel,2689,2,18,8,6,55,25,30,62
Lucerne,2689,3,12,8,12,43,46,-3,44
St Gallen,2689,4,14,2,16,43,56,-13,44
FC Zürich,2689,5,9,13,10,40,36,4,40
FC Lugano,2689,6,10,6,16,29,47,-18,36
Grasshoppers,2689,7,9,8,15,43,52,-9,35
FC Thun,2689,8,9,7,16,45,62,-17,34
FC Sion,2689,9,6,9,17,42,56,-14,27
Young Boys,2690,1,20,8,4,68,37,31,68
FC Basel,2690,2,19,8,5,58,27,31,65
St Gallen,2690,3,14,3,15,42,54,-12,45
Lucerne,2690,4,11,8,13,39,45,-6,41
FC Zürich,2690,5,10,9,13,40,38,2,39
FC Lugano,2690,6,11,6,15,32,46,-14,39
Grasshoppers,2690,7,10,7,15,42,47,-5,37
FC Sion,2690,8,9,8,15,45,51,-6,35
FC Thun,2690,9,9,5,18,41,62,-21,32
Young Boys,2691,1,22,7,3,77,39,38,73
FC Basel,2691,2,17,8,7,52,27,25,59
St Gallen,2691,3,14,4,14,42,52,-10,46
Lucerne,2691,4,12,9,11,41,43,-2,45
FC Zürich,2691,5,11,10,11,39,35,4,43
FC Lugano,2691,6,11,6,15,34,47,-13,39
Grasshoppers,2691,7,10,7,15,47,49,-2,37
FC Thun,2691,8,8,6,18,41,61,-20,30
FC Sion,2691,9,6,9,17,39,59,-20,27
Young Boys,2692,1,21,9,2,76,32,44,72
FC Basel,2692,2,15,9,8,48,27,21,54
Lucerne,2692,3,14,9,9,45,39,6,51
St Gallen,2692,4,15,2,15,44,55,-11,47
FC Zürich,2692,5,12,9,11,42,35,7,45
Grasshoppers,2692,6,9,8,15,42,53,-11,35
FC Thun,2692,7,9,7,16,43,59,-16,34
FC Lugano,2692,8,9,6,17,28,50,-22,33
FC Sion,2692,9,7,7,18,43,61,-18,28
Young Boys,2693,1,24,6,2,70,31,39,78
FC Basel,2693,2,15,7,10,49,31,18,52
St Gallen,2693,3,15,4,13,44,52,-8,49
Lucerne,2693,4,13,9,10,50,45,5,48
FC Zürich,2693,5,11,11,10,41,34,7,44
FC Thun,2693,6,11,6,15,47,58,-11,39
FC Lugano,2693,7,9,6,17,30,52,-22,33
Grasshoppers,2693,8,8,7,17,40,52,-12,31
FC Sion,2693,9,6,8,18,36,52,-16,26
Young Boys,2694,1,20,9,3,70,37,33,69
FC Basel,2694,2,16,10,6,53,26,27,58
Lucerne,2694,3,14,9,9,48,42,6,51
St Gallen,2694,4,13,4,15,42,56,-14,43
FC Zürich,2694,5,11,9,12,41,39,2,42
FC Lugano,2694,6,11,5,16,32,49,-17,38
FC Thun,2694,7,9,7,16,42,57,-15,34
Grasshoppers,2694,8,8,9,15,39,49,-10,33
FC Sion,2694,9,6,10,16,44,56,-12,28
Young Boys,2695,1,22,7,3,71,33,38,73
FC Basel,2695,2,19,8,5,57,23,34,65
FC Zürich,2695,3,12,9,11,42,35,7,45
St Gallen,2695,4,13,6,13,41,52,-11,45
Lucerne,2695,5,12,8,12,39,45,-6,44
FC Lugano,2695,6,10,6,16,30,46,-16,36
Grasshoppers,2695,7,9,8,15,40,47,-7,35
FC Thun,2695,8,8,5,19,38,64,-26,29
FC Sion,2695,9,6,9,17,41,54,-13,27
Young Boys,2696,1,22,6,4,71,34,37,72
FC Basel,2696,2,18,9,5,56,22,34,63
St Gallen,2696,3,14,4,14,47,58,-11,46
Lucerne,2696,4,12,9,11,41,47,-6,45
FC Zürich,2696,5,10,10,12,40,37,3,40
FC Lugano,2696,6,10,6,16,29,47,-18,36
FC Thun,2696,7,10,5,17,45,60,-15,35
Grasshoppers,2696,8,9,7,16,42,52,-10,34
FC Sion,2696,9,7,8,17,45,59,-14,29
Young Boys,2697,1,23,6,3,74,33,41,75
FC Basel,2697,2,19,7,6,57,28,29,64
St Gallen,2697,3,15,2,15,44,58,-14,47
FC Zürich,2697,4,12,10,10,42,34,8,46
Lucerne,2697,5,12,8,12,43,45,-2,44
Grasshoppers,2697,6,9,7,16,44,54,-10,34
FC Lugano,2697,7,9,6,17,29,50,-21,33
FC Thun,2697,8,8,6,18,44,63,-19,30
FC Sion,2697,9,7,8,17,43,55,-12,29
Young Boys,2698,1,21,8,3,68,32,36,71
FC Basel,2698,2,16,9,7,49,26,23,57
St Gallen,2698,3,15,4,13,46,52,-6,49
Lucerne,2698,4,12,8,12,39,44,-5,44
FC Zürich,2698,5,10,12,10,40,35,5,42
FC Lugano,2698,6,11,7,14,32,44,-12,40
FC Thun,2698,7,10,7,15,42,55,-13,37
Grasshoppers,2698,8,9,7,16,40,47,-7,34
FC Sion,2698,9,5,8,19,35,56,-21,23
Young Boys,2699,1,20,9,3,70,35,35,69
FC Basel,2699,2,20,7,5,56,23,33,67
St Gallen,2699,3,15,2,15,44,56,-12,47
Lucerne,2699,4,11,10,11,39,47,-8,43
FC Lugano,2699,5,11,6,15,36,48,-12,39
Grasshoppers,2699,6,10,8,14,44,49,-5,38
FC Zürich,2699,7,9,10,13,41,40,1,37
FC Thun,2699,8,9,6,17,46,61,-15,33
FC Sion,2699,9,6,8,18,40,57,-17,26
Young Boys,2700,1,21,7,4,71,35,36,70
FC Basel,2700,2,16,9,7,51,27,24,57
Lucerne,2700,3,12,10,10,43,45,-2,46
St Gallen,2700,4,14,4,14,44,58,-14,46
FC Zürich,2700,5,10,10,12,40,38,2,40
FC Thun,2700,6,11,5,16,49,60,-11,38
FC Lugano,2700,7,10,6,16,33,50,-17,36
Grasshoppers,2700,8,9,7,16,42,51,-9,34
FC Sion,2700,9,8,8,16,44,53,-9,32
Young Boys,2701,1,22,7,3,72,35,37,73
FC Basel,2701,2,18,9,5,56,26,30,63
St Gallen,2701,3,15,3,14,42,52,-10,48
Lucerne,2701,4,11,11,10,42,44,-2,44
FC Zürich,2701,5,10,11,11,39,35,4,41
Grasshoppers,2701,6,10,8,14,45,48,-3,38
FC Lugano,2701,7,9,6,17,29,48,-19,33
FC Thun,2701,8,8,6,18,41,63,-22,30
FC Sion,2701,9,7,7,18,40,55,-15,28
Young Boys,2702,1,24,6,2,73,32,41,78
FC Basel,2702,2,18,8,6,54,26,28,62
Lucerne,2702,3,13,8,11,44,43,1,47
St Gallen,2702,4,14,3,15,42,55,-13,45
FC Zürich,2702,5,11,10,11,40,35,5,43
FC Lugano,2702,6,10,5,17,29,47,-18,35
FC Thun,2702,7,9,6,17,40,58,-18,33
Grasshoppers,2702,8,8,8,16,39,49,-10,32
FC Sion,2702,9,6,8,18,37,53,-16,26
Young Boys,2703,1,22,7,3,72,34,38,73
FC Basel,2703,2,18,7,7,54,26,28,61
St Gallen,2703,3,15,2,15,46,56,-10,47
Lucerne,2703,4,13,7,12,46,47,-1,46
FC Zürich,2703,5,10,10,12,39,36,3,40
FC Lugano,2703,6,10,7,15,29,45,-16,37
FC Thun,2703,7,10,5,17,43,60,-17,35
Grasshoppers,2703,8,9,6,17,43,56,-13,33
FC Sion,2703,9,8,7,17,41,53,-12,31
Young Boys,2704,1,22,7,3,68,31,37,73
FC Basel,2704,2,17,9,6,52,24,28,60
Lucerne,2704,3,14,8,10,41,40,1,50
St Gallen,2704,4,13,2,17,39,59,-20,41
FC Zürich,2704,5,10,10,12,41,37,4,40
FC Lugano,2704,6,11,5,16,34,45,-11,38
Grasshoppers,2704,7,10,7,15,41,46,-5,37
FC Thun,2704,8,9,7,16,44,61,-17,34
FC Sion,2704,9,6,9,17,40,57,-17,27
Young Boys,2705,1,22,8,2,74,33,41,74
FC Basel,2705,2,18,7,7,55,28,27,61
St Gallen,2705,3,14,3,15,43,53,-10,45
Lucerne,2705,4,12,8,12,40,43,-3,44
FC Zürich,2705,5,10,11,11,39,35,4,41
Grasshoppers,2705,6,10,7,15,42,47,-5,37
FC Lugano,2705,7,10,7,15,31,46,-15,37
FC Thun,2705,8,9,6,17,44,62,-18,33
FC Sion,2705,9,7,7,18,39,60,-21,28
Young Boys,2706,1,22,7,3,73,33,40,73
FC Basel,2706,2,18,7,7,52,24,28,61
Lucerne,2706,3,14,7,11,45,44,1,49
St Gallen,2706,4,14,4,14,43,54,-11,46
FC Zürich,2706,5,11,10,11,39,34,5,43
FC Thun,2706,6,10,6,16,42,56,-14,36
Grasshoppers,2706,7,9,8,15,40,46,-6,35
FC Lugano,2706,8,9,7,16,32,55,-23,34
FC Sion,2706,9,5,8,19,36,56,-20,23
Young Boys,2707,1,20,7,5,72,40,32,67
FC Basel,2707,2,19,7,6,56,30,26,64
St Gallen,2707,3,14,2,16,43,55,-12,44
FC Zürich,2707,4,11,9,12,42,37,5,42
Lucerne,2707,5,11,9,12,39,46,-7,42
FC Lugano,2707,6,11,7,14,33,45,-12,40
Grasshoppers,2707,7,9,9,14,42,49,-7,36
FC Thun,2707,8,9,6,17,46,63,-17,33
FC Sion,2707,9,8,8,16,45,53,-8,32
Young Boys,2708,1,23,7,2,81,33,48,76
FC Basel,2708,2,18,9,5,58,26,32,63
St Gallen,2708,3,15,3,14,43,56,-13,48
Lucerne,2708,4,11,9,12,41,46,-5,42
FC Zürich,2708,5,10,11,11,43,39,4,41
FC Lugano,2708,6,10,6,16,30,50,-20,36
Grasshoppers,2708,7,9,8,15,40,51,-11,35
FC Thun,2708,8,8,7,17,42,60,-18,31
FC Sion,2708,9,6,8,18,39,56,-17,26
Young Boys,2709,1,23,7,2,83,38,45,76
FC Basel,2709,2,19,7,6,58,27,31,64
Lucerne,2709,3,13,8,11,45,48,-3,47
St Gallen,2709,4,14,2,16,44,59,-15,44
FC Zürich,2709,5,10,10,12,39,35,4,40
FC Thun,2709,6,11,5,16,48,58,-10,38
FC Lugano,2709,7,10,6,16,31,49,-18,36
Grasshoppers,2709,8,9,6,17,42,55,-13,33
FC Sion,2709,9,6,7,19,41,62,-21,25
Young Boys,2710,1,24,6,2,78,34,44,78
FC Basel,2710,2,17,8,7,51,27,24,59
FC Zürich,2710,3,12,10,10,44,35,9,46
Lucerne,2710,4,13,7,12,43,48,-5,46
St Gallen,2710,5,14,3,15,44,54,-10,45
Grasshoppers,2710,6,10,6,16,41,50,-9,36
FC Thun,2710,7,9,6,17,44,58,-14,33
FC Lugano,2710,8,9,5,18,31,52,-21,32
FC Sion,2710,9,7,7,18,38,56,-18,28
Young Boys,2711,1,21,7,4,70,33,37,70
FC Basel,2711,2,18,8,6,54,25,29,62
Lucerne,2711,3,13,8,11,41,44,-3,47
St Gallen,2711,4,15,2,15,44,55,-11,47
FC Zürich,2711,5,10,11,11,40,37,3,41
FC Lugano,2711,6,11,7,14,34,45,-11,40
Grasshoppers,2711,7,9,7,16,40,51,-11,34
FC Thun,2711,8,9,6,17,41,57,-16,33
FC Sion,2711,9,6,8,18,39,56,-17,26
Young Boys,2712,1,20,8,4,70,38,32,68
FC Basel,2712,2,17,10,5,51,24,27,61
Lucerne,2712,3,13,8,11,44,43,1,47
St Gallen,2712,4,13,4,15,43,60,-17,43
FC Zürich,2712,5,10,10,12,41,39,2,40
FC Lugano,2712,6,11,6,15,35,48,-13,39
FC Thun,2712,7,10,6,16,49,61,-12,36
Grasshoppers,2712,8,9,7,16,44,54,-10,34
FC Sion,2712,9,8,7,17,50,60,-10,31
Young Boys,2713,1,23,6,3,71,34,37,75
FC Basel,2713,2,17,7,8,53,28,25,58
Lucerne,2713,3,14,7,11,42,41,1,49
St Gallen,2713,4,15,2,15,47,59,-12,47
FC Zürich,2713,5,11,10,11,41,36,5,43
FC Thun,2713,6,11,5,16,47,57,-10,38
FC Lugano,2713,7,9,5,18,32,53,-21,32
Grasshoppers,2713,8,8,7,17,40,55,-15,31
FC Sion,2713,9,7,9,16,45,55,-10,30
Young Boys,2714,1,21,9,2,73,36,37,72
FC Basel,2714,2,17,9,6,52,25,27,60
St Gallen,2714,3,15,4,13,47,52,-5,49
Lucerne,2714,4,12,8,12,41,45,-4,44
FC Zürich,2714,5,11,9,12,42,36,6,42
FC Thun,2714,6,10,6,16,44,58,-14,36
FC Lugano,2714,7,10,6,16,30,47,-17,36
Grasshoppers,2714,8,9,6,17,40,54,-14,33
FC Sion,2714,9,6,9,17,40,56,-16,27
Young Boys,2715,1,22,7,3,77,38,39,73
FC Basel,2715,2,17,9,6,52,26,26,60
Lucerne,2715,3,13,8,11,46,49,-3,47
St Gallen,2715,4,14,3,15,43,54,-11,45
FC Zürich,2715,5,11,11,10,42,36,6,44
FC Lugano,2715,6,10,7,15,29,45,-16,37
Grasshoppers,2715,7,9,6,17,44,55,-11,33
FC Thun,2715,8,9,6,17,41,60,-19,33
FC Sion,2715,9,7,7,18,45,56,-11,28
Young Boys,2716,1,23,7,2,74,34,40,76
FC Basel,2716,2,18,8,6,55,27,28,62
St Gallen,2716,3,14,4,14,43,53,-10,46
FC Zürich,2716,4,12,9,11,42,34,8,45
Lucerne,2716,5,12,8,12,41,45,-4,44
Grasshoppers,2716,6,10,6,16,40,50,-10,36
FC Lugano,2716,7,9,8,15,32,49,-17,35
FC Thun,2716,8,8,6,18,42,61,-19,30
FC Sion,2716,9,6,8,18,38,54,-16,26
Young Boys,2717,1,21,8,3,68,32,36,71
FC Basel,2717,2,17,9,6,51,25,26,60
St Gallen,2717,3,16,3,13,48,51,-3,51
Lucerne,2717,4,14,7,11,44,47,-3,49
FC Zürich,2717,5,11,10,11,40,35,5,43
Grasshoppers,2717,6,8,9,15,40,49,-9,33
FC Thun,2717,7,9,6,17,42,58,-16,33
FC Lugano,2717,8,9,5,18,27,47,-20,32
FC Sion,2717,9,6,9,17,40,56,-16,27
Young Boys,2718,1,23,6,3,72,32,40,75
FC Basel,2718,2,17,7,8,52,27,25,58
FC Zürich,2718,3,12,10,10,44,37,7,46
Lucerne,2718,4,12,9,11,40,45,-5,45
St Gallen,2718,5,14,3,15,43,52,-9,45
FC Thun,2718,6,11,5,16,46,59,-13,38
Grasshoppers,2718,7,10,7,15,45,50,-5,37
FC Lugano,2718,8,9,5,18,29,51,-22,32
FC Sion,2718,9,6,8,18,41,59,-18,26
Young Boys,2719,1,21,8,3,74,34,40,71
FC Basel,2719,2,17,9,6,55,27,28,60
St Gallen,2719,3,16,2,14,47,55,-8,50
FC Zürich,2719,4,11,11,10,43,37,6,44
Grasshoppers,2719,5,12,6,14,47,46,1,42
Lucerne,2719,6,11,9,12,41,48,-7,42
FC Lugano,2719,7,9,7,16,30,52,-22,34
FC Thun,2719,8,9,5,18,49,67,-18,32
FC Sion,2719,9,5,9,18,43,63,-20,24
Young Boys,2720,1,23,6,3,74,37,37,75
FC Basel,2720,2,18,8,6,56,25,31,62
FC Zürich,2720,3,12,10,10,44,35,9,46
St Gallen,2720,4,14,4,14,42,55,-13,46
Lucerne,2720,5,12,9,11,42,45,-3,45
FC Lugano,2720,6,10,6,16,34,47,-13,36
FC Thun,2720,7,9,6,17,44,58,-14,33
Grasshoppers,2720,8,8,8,16,38,50,-12,32
FC Sion,2720,9,6,7,19,38,60,-22,25
Young Boys,2721,1,21,8,3,69,32,37,71
FC Basel,2721,2,17,9,6,52,25,27,60
Lucerne,2721,3,13,9,10,43,42,1,48
St Gallen,2721,4,14,5,13,43,53,-10,47
FC Zürich,2721,5,11,10,11,43,38,5,43
Grasshoppers,2721,6,10,7,15,41,48,-7,37
FC Lugano,2721,7,9,7,16,32,51,-19,34
FC Thun,2721,8,9,6,17,45,60,-15,33
FC Sion,2721,9,5,9,18,37,56,-19,24
Young Boys,2722,1,23,7,2,71,31,40,76
FC Basel,2722,2,17,8,7,54,26,28,59
FC Zürich,2722,3,12,10,10,41,33,8,46
St Gallen,2722,4,14,4,14,44,53,-9,46
Lucerne,2722,5,12,7,13,40,47,-7,43
FC Lugano,2722,6,10,6,16,30,47,-17,36
Grasshoppers,2722,7,9,7,16,41,53,-12,34
FC Thun,2722,8,9,7,16,45,59,-14,34
FC Sion,2722,9,6,8,18,38,55,-17,26
Young Boys,2723,1,20,8,4,69,37,32,68
FC Basel,2723,2,17,10,5,54,25,29,61
Lucerne,2723,3,14,8,10,46,42,4,50
St Gallen,2723,4,14,3,15,41,55,-14,45
FC Zürich,2723,5,9,11,12,39,39,0,38
FC Thun,2723,6,9,8,15,44,56,-12,35
FC Lugano,2723,7,10,5,17,32,49,-17,35
Grasshoppers,2723,8,8,9,15,41,50,-9,33
FC Sion,2723,9,8,8,16,43,56,-13,32
Young Boys,2724,1,21,7,4,67,34,33,70
FC Basel,2724,2,17,7,8,53,29,24,58
St Gallen,2724,3,16,2,14,45,54,-9,50
Lucerne,2724,4,13,7,12,44,45,-1,46
FC Zürich,2724,5,11,9,12,43,40,3,42
Grasshoppers,2724,6,11,7,14,44,48,-4,40
FC Thun,2724,7,10,6,16,46,56,-10,36
FC Lugano,2724,8,10,6,16,29,47,-18,36
FC Sion,2724,9,6,7,19,40,58,-18,25
Young Boys,2725,1,21,6,5,75,37,38,69
FC Basel,2725,2,18,8,6,58,28,30,62
Lucerne,2725,3,13,7,12,41,50,-9,46
St Gallen,2725,4,13,4,15,45,58,-13,43
FC Zürich,2725,5,11,9,12,43,39,4,42
FC Lugano,2725,6,12,5,15,35,49,-14,41
FC Thun,2725,7,11,5,16,45,59,-14,38
Grasshoppers,2725,8,10,6,16,43,49,-6,36
FC Sion,2725,9,6,8,18,43,59,-16,26
Young Boys,2726,1,20,9,3,75,41,34,69
FC Basel,2726,2,18,8,6,55,24,31,62
Lucerne,2726,3,13,10,9,45,44,1,49
FC Zürich,2726,4,12,9,11,40,34,6,45
St Gallen,2726,5,13,5,14,40,53,-13,44
FC Thun,2726,6,10,6,16,46,59,-13,36
FC Lugano,2726,7,9,6,17,30,51,-21,33
Grasshoppers,2726,8,8,8,16,44,54,-10,32
FC Sion,2726,9,6,9,17,39,54,-15,27
Young Boys,2727,1,20,9,3,71,38,33,69
FC Basel,2727,2,19,8,5,55,23,32,65
Lucerne,2727,3,13,10,9,41,38,3,49
St Gallen,2727,4,15,3,14,44,52,-8,48
FC Zürich,2727,5,11,10,11,44,36,8,43
FC Thun,2727,6,9,7,16,42,58,-16,34
Grasshoppers,2727,7,8,9,15,39,49,-10,33
FC Lugano,2727,8,9,6,17,31,55,-24,33
FC Sion,2727,9,5,8,19,40,58,-18,23
Young Boys,2728,1,20,7,5,71,39,32,67
FC Basel,2728,2,18,7,7,53,30,23,61
Lucerne,2728,3,14,7,11,49,47,2,49
St Gallen,2728,4,15,2,15,42,53,-11,47
FC Zürich,2728,5,11,11,10,44,35,9,44
Grasshoppers,2728,6,11,6,15,42,50,-8,39
FC Lugano,2728,7,10,7,15,33,49,-16,37
FC Thun,2728,8,9,6,17,43,58,-15,33
FC Sion,2728,9,6,7,19,38,54,-16,25
Young Boys,2729,1,21,8,3,71,36,35,71
FC Basel,2729,2,19,7,6,55,24,31,64
Lucerne,2729,3,11,10,11,40,44,-4,43
St Gallen,2729,4,13,3,16,41,55,-14,42
FC Lugano,2729,5,12,5,15,35,47,-12,41
FC Zürich,2729,6,10,9,13,39,39,0,39
Grasshoppers,2729,7,10,8,14,47,52,-5,38
FC Thun,2729,8,9,6,17,45,62,-17,33
FC Sion,2729,9,7,8,17,42,56,-14,29
Young Boys,2730,1,23,7,2,78,33,45,76
FC Basel,2730,2,16,8,8,51,26,25,56
Lucerne,2730,3,14,7,11,43,46,-3,49
St Gallen,2730,4,15,3,14,43,54,-11,48
FC Zürich,2730,5,11,9,12,39,39,0,42
FC Thun,2730,6,10,5,17,43,56,-13,35
FC Lugano,2730,7,10,5,17,30,48,-18,35
Grasshoppers,2730,8,9,7,16,41,50,-9,34
FC Sion,2730,9,7,7,18,40,56,-16,28
Young Boys,2731,1,20,7,5,70,35,35,67
FC Basel,2731,2,18,9,5,59,25,34,63
Lucerne,2731,3,13,8,11,41,47,-6,47
St Gallen,2731,4,14,4,14,44,55,-11,46
Grasshoppers,2731,5,12,6,14,45,47,-2,42
FC Zürich,2731,6,10,10,12,41,37,4,40
FC Lugano,2731,7,10,7,15,30,49,-19,37
FC Thun,2731,8,9,6,17,42,60,-18,33
FC Sion,2731,9,6,7,19,38,55,-17,25
Young Boys,2732,1,22,8,2,70,31,39,74
FC Basel,2732,2,17,9,6,54,28,26,60
Lucerne,2732,3,12,9,11,39,42,-3,45
St Gallen,2732,4,14,3,15,45,57,-12,45
FC Zürich,2732,5,10,11,11,45,40,5,41
FC Thun,2732,6,10,7,15,46,57,-11,37
FC Lugano,2732,7,10,5,17,34,51,-17,35
Grasshoppers,2732,8,9,7,16,39,50,-11,34
FC Sion,2732,9,6,9,17,39,55,-16,27
Young Boys,2733,1,21,8,3,72,41,31,71
FC Basel,2733,2,17,9,6,59,29,30,60
St Gallen,2733,3,15,4,13,46,53,-7,49
Lucerne,2733,4,12,10,10,46,46,0,46
FC Zürich,2733,5,11,9,12,44,40,4,42
FC Thun,2733,6,11,5,16,50,62,-12,38
Grasshoppers,2733,7,9,8,15,44,52,-8,35
FC Lugano,2733,8,9,6,17,30,50,-20,33
FC Sion,2733,9,6,7,19,39,57,-18,25
Young Boys,2734,1,21,6,5,71,34,37,69
FC Basel,2734,2,18,9,5,51,23,28,63
St Gallen,2734,3,15,3,14,43,53,-10,48
Lucerne,2734,4,11,11,10,41,43,-2,44
FC Zürich,2734,5,11,10,11,42,35,7,43
Grasshoppers,2734,6,10,7,15,42,49,-7,37
FC Thun,2734,7,9,6,17,43,58,-15,33
FC Lugano,2734,8,9,6,17,29,54,-25,33
FC Sion,2734,9,7,8,17,40,53,-13,29
Young Boys,2735,1,21,7,4,75,38,37,70
FC Basel,2735,2,19,7,6,56,25,31,64
St Gallen,2735,3,15,2,15,43,54,-11,47
FC Zürich,2735,4,12,10,10,46,35,11,46
Lucerne,2735,5,12,7,13,39,50,-11,43
Grasshoppers,2735,6,10,7,15,43,48,-5,37
FC Lugano,2735,7,10,7,15,33,49,-16,37
FC Thun,2735,8,10,5,17,42,60,-18,35
FC Sion,2735,9,5,8,19,40,58,-18,23
Young Boys,2736,1,19,6,7,68,44,24,63
FC Basel,2736,2,16,8,8,53,29,24,56
Lucerne,2736,3,14,8,10,46,44,2,50
St Gallen,2736,4,16,2,14,46,55,-9,50
FC Zürich,2736,5,11,10,11,41,36,5,43
FC Lugano,2736,6,11,6,15,34,47,-13,39
FC Thun,2736,7,10,7,15,43,55,-12,37
Grasshoppers,2736,8,9,8,15,41,50,-9,35
FC Sion,2736,9,6,9,17,44,56,-12,27
Young Boys,2737,1,21,8,3,69,33,36,71
FC Basel,2737,2,19,8,5,58,23,35,65
St Gallen,2737,3,15,2,15,43,54,-11,47
FC Zürich,2737,4,11,9,12,42,37,5,42
Lucerne,2737,5,11,9,12,38,47,-9,42
Grasshoppers,2737,6,11,7,14,43,46,-3,40
FC Lugano,2737,7,11,6,15,33,46,-13,39
FC Thun,2737,8,9,6,17,40,59,-19,33
FC Sion,2737,9,5,7,20,36,57,-21,22
Young Boys,2738,1,21,7,4,70,35,35,70
FC Basel,2738,2,18,8,6,55,26,29,62
FC Zürich,2738,3,13,9,10,44,34,10,48
Lucerne,2738,4,12,9,11,44,47,-3,45
St Gallen,2738,5,14,3,15,44,56,-12,45
FC Lugano,2738,6,10,6,16,34,52,-18,36
Grasshoppers,2738,7,9,8,15,41,51,-10,35
FC Thun,2738,8,10,5,17,49,61,-12,35
FC Sion,2738,9,5,9,18,38,57,-19,24
Young Boys,2739,1,23,7,2,73,31,42,76
FC Basel,2739,2,18,7,7,55,24,31,61
St Gallen,2739,3,15,2,15,44,58,-14,47
FC Zürich,2739,4,11,10,11,42,35,7,43
Lucerne,2739,5,12,7,13,45,49,-4,43
FC Lugano,2739,6,11,6,15,30,44,-14,39
FC Thun,2739,7,10,5,17,45,59,-14,35
Grasshoppers,2739,8,8,7,17,40,55,-15,31
FC Sion,2739,9,6,9,17,39,58,-19,27
FC Basel,2740,1,20,7,5,60,23,37,67
Young Boys,2740,2,20,7,5,69,38,31,67
Lucerne,2740,3,13,8,11,39,40,-1,47
St Gallen,2740,4,14,4,14,40,54,-14,46
FC Zürich,2740,5,11,10,11,45,38,7,43
FC Sion,2740,6,8,9,15,47,54,-7,33
Grasshoppers,2740,7,9,6,17,42,53,-11,33
FC Lugano,2740,8,9,6,17,28,49,-21,33
FC Thun,2740,9,9,5,18,47,68,-21,32
Young Boys,2741,1,20,8,4,73,39,34,68
FC Basel,2741,2,17,10,5,53,26,27,61
St Gallen,2741,3,15,3,14,44,54,-10,48
Lucerne,2741,4,12,10,10,41,42,-1,46
FC Zürich,2741,5,10,12,10,42,36,6,42
FC Lugano,2741,6,11,6,15,33,47,-14,39
FC Thun,2741,7,10,5,17,42,57,-15,35
Grasshoppers,2741,8,9,7,16,42,51,-9,34
FC Sion,2741,9,5,9,18,41,59,-18,24
Young Boys,2742,1,21,7,4,72,39,33,70
FC Basel,2742,2,19,8,5,55,23,32,65
St Gallen,2742,3,14,3,15,42,53,-11,45
Lucerne,2742,4,12,8,12,40,46,-6,44
FC Zürich,2742,5,11,9,12,40,36,4,42
FC Lugano,2742,6,10,6,16,31,48,-17,36
FC Thun,2742,7,10,5,17,46,60,-14,35
Grasshoppers,2742,8,9,7,16,41,50,-9,34
FC Sion,2742,9,7,9,16,40,52,-12,30
Young Boys,2743,1,21,6,5,71,38,33,69
FC Basel,2743,2,19,8,5,58,26,32,65
St Gallen,2743,3,14,4,14,47,57,-10,46
Lucerne,2743,4,11,10,11,41,44,-3,43
FC Lugano,2743,5,11,7,14,33,45,-12,40
FC Zürich,2743,6,9,10,13,38,40,-2,37
Grasshoppers,2743,7,9,9,14,39,46,-7,36
FC Thun,2743,8,9,6,17,40,57,-17,33
FC Sion,2743,9,7,8,17,41,55,-14,29
Young Boys,2744,1,22,6,4,71,34,37,72
FC Basel,2744,2,18,8,6,58,28,30,62
St Gallen,2744,3,14,4,14,42,53,-11,46
Lucerne,2744,4,12,7,13,43,47,-4,43
FC Zürich,2744,5,10,9,13,38,39,-1,39
FC Lugano,2744,6,11,6,15,32,45,-13,39
Grasshoppers,2744,7,10,6,16,42,50,-8,36
FC Sion,2744,8,9,7,16,41,51,-10,34
FC Thun,2744,9,9,5,18,40,60,-20,32
Young Boys,2745,1,23,7,2,77,31,46,76
FC Basel,2745,2,17,10,5,52,25,27,61
St Gallen,2745,3,14,4,14,43,56,-13,46
FC Zürich,2745,4,11,11,10,41,34,7,44
Lucerne,2745,5,11,9,12,40,48,-8,42
Grasshoppers,2745,6,10,6,16,44,51,-7,36
FC Thun,2745,7,10,6,16,46,59,-13,36
FC Lugano,2745,8,10,6,16,33,47,-14,36
FC Sion,2745,9,5,7,20,35,60,-25,22
Young Boys,2746,1,23,7,2,75,33,42,76
FC Basel,2746,2,17,9,6,55,26,29,60
Lucerne,2746,3,13,9,10,44,47,-3,48
St Gallen,2746,4,14,4,14,44,55,-11,46
FC Zürich,2746,5,11,11,10,45,35,10,44
FC Lugano,2746,6,9,7,16,29,49,-20,34
Grasshoppers,2746,7,9,6,17,42,52,-10,33
FC Thun,2746,8,9,5,18,41,63,-22,32
FC Sion,2746,9,6,8,18,41,56,-15,26
Young Boys,2747,1,22,6,4,76,40,36,72
FC Basel,2747,2,19,8,5,56,25,31,65
Lucerne,2747,3,12,8,12,43,48,-5,44
Grasshoppers,2747,4,12,6,14,51,49,2,42
St Gallen,2747,5,13,3,16,43,58,-15,42
FC Zürich,2747,6,9,11,12,39,38,1,38
FC Lugano,2747,7,11,5,16,32,48,-16,38
FC Thun,2747,8,9,6,17,43,59,-16,33
FC Sion,2747,9,6,9,17,40,58,-18,27
Young Boys,2748,1,20,8,4,70,39,31,68
FC Basel,2748,2,19,8,5,60,26,34,65
Lucerne,2748,3,12,9,11,42,44,-2,45
St Gallen,2748,4,13,4,15,42,56,-14,43
FC Lugano,2748,5,11,7,14,33,46,-13,40
Grasshoppers,2748,6,10,8,14,42,48,-6,38
FC Zürich,2748,7,9,10,13,38,37,1,37
FC Thun,2748,8,9,6,17,42,60,-18,33
FC Sion,2748,9,6,10,16,40,53,-13,28
Young Boys,2749,1,20,8,4,71,38,33,68
FC Basel,2749,2,17,8,7,55,27,28,59
St Gallen,2749,3,15,2,15,45,57,-12,47
Lucerne,2749,4,13,7,12,45,48,-3,46
FC Zürich,2749,5,11,10,11,41,35,6,43
FC Lugano,2749,6,12,5,15,32,47,-15,41
FC Thun,2749,7,10,6,16,43,58,-15,36
Grasshoppers,2749,8,8,9,15,43,52,-9,33
FC Sion,2749,9,6,9,17,44,57,-13,27
Young Boys,2750,1,20,8,4,71,39,32,68
FC Basel,2750,2,16,10,6,52,27,25,58
FC Zürich,2750,3,13,9,10,41,32,9,48
St Gallen,2750,4,15,3,14,42,52,-10,48
Lucerne,2750,5,13,8,11,43,45,-2,47
Grasshoppers,2750,6,9,8,15,41,48,-7,35
FC Lugano,2750,7,10,5,17,30,46,-16,35
FC Thun,2750,8,9,7,16,43,58,-15,34
FC Sion,2750,9,6,8,18,39,55,-16,26
Young Boys,2751,1,23,7,2,76,31,45,76
FC Basel,2751,2,18,8,6,56,27,29,62
St Gallen,2751,3,15,3,14,42,53,-11,48
Lucerne,2751,4,13,7,12,43,45,-2,46
FC Zürich,2751,5,10,10,12,40,38,2,40
FC Lugano,2751,6,11,5,16,33,50,-17,38
Grasshoppers,2751,7,9,6,17,40,54,-14,33
FC Thun,2751,8,9,6,17,42,59,-17,33
FC Sion,2751,9,6,8,18,40,55,-15,26
Young Boys,2752,1,22,8,2,73,36,37,74
FC Basel,2752,2,16,10,6,54,32,22,58
Lucerne,2752,3,13,8,11,48,45,3,47
St Gallen,2752,4,14,3,15,45,58,-13,45
FC Zürich,2752,5,10,11,11,45,39,6,41
FC Lugano,2752,6,10,5,17,31,54,-23,35
Grasshoppers,2752,7,9,7,16,42,52,-10,34
FC Thun,2752,8,9,7,16,45,59,-14,34
FC Sion,2752,9,7,9,16,44,52,-8,30
Young Boys,2753,1,22,7,3,71,36,35,73
FC Basel,2753,2,17,7,8,54,32,22,58
Lucerne,2753,3,13,8,11,43,44,-1,47
FC Zürich,2753,4,11,11,10,46,37,9,44
St Gallen,2753,5,13,3,16,41,56,-15,42
Grasshoppers,2753,6,10,7,15,43,49,-6,37
FC Lugano,2753,7,10,7,15,33,46,-13,37
FC Thun,2753,8,8,7,17,43,61,-18,31
FC Sion,2753,9,7,9,16,41,54,-13,30
Young Boys,2754,1,22,7,3,76,37,39,73
FC Basel,2754,2,17,8,7,56,26,30,59
St Gallen,2754,3,16,2,14,46,52,-6,50
FC Zürich,2754,4,12,10,10,44,35,9,46
Lucerne,2754,5,12,8,12,43,48,-5,44
Grasshoppers,2754,6,10,7,15,43,52,-9,37
FC Lugano,2754,7,10,5,17,30,51,-21,35
FC Thun,2754,8,8,7,17,43,63,-20,31
FC Sion,2754,9,6,8,18,43,60,-17,26
Young Boys,2755,1,22,8,2,72,33,39,74
FC Basel,2755,2,17,10,5,53,23,30,61
Lucerne,2755,3,13,9,10,44,43,1,48
St Gallen,2755,4,15,3,14,44,55,-11,48
FC Zürich,2755,5,10,9,13,39,39,0,39
FC Lugano,2755,6,10,5,17,34,50,-16,35
FC Thun,2755,7,10,5,17,42,60,-18,35
Grasshoppers,2755,8,8,8,16,41,53,-12,32
FC Sion,2755,9,6,9,17,40,53,-13,27
Young Boys,2756,1,22,6,4,72,36,36,72
FC Basel,2756,2,19,8,5,55,26,29,65
Lucerne,2756,3,12,9,11,43,44,-1,45
St Gallen,2756,4,13,4,15,42,58,-16,43
FC Zürich,2756,5,10,9,13,38,38,0,39
FC Thun,2756,6,11,5,16,46,56,-10,38
Grasshoppers,2756,7,10,7,15,40,47,-7,37
FC Lugano,2756,8,10,5,17,31,48,-17,35
FC Sion,2756,9,7,7,18,43,57,-14,28
Young Boys,2757,1,23,7,2,75,32,43,76
FC Basel,2757,2,18,9,5,54,24,30,63
St Gallen,2757,3,15,3,14,44,54,-10,48
Lucerne,2757,4,12,8,12,44,47,-3,44
FC Zürich,2757,5,10,10,12,38,35,3,40
Grasshoppers,2757,6,10,7,15,44,52,-8,37
FC Thun,2757,7,9,7,16,44,59,-15,34
FC Lugano,2757,8,9,6,17,28,49,-21,33
FC Sion,2757,9,5,9,18,35,54,-19,24
Young Boys,2758,1,22,7,3,76,39,37,73
FC Basel,2758,2,17,7,8,55,29,26,58
Lucerne,2758,3,14,8,10,46,43,3,50
FC Zürich,2758,4,12,9,11,46,36,10,45
St Gallen,2758,5,14,3,15,45,59,-14,45
FC Thun,2758,6,10,6,16,46,62,-16,36
Grasshoppers,2758,7,9,8,15,41,50,-9,35
FC Lugano,2758,8,10,5,17,36,54,-18,35
FC Sion,2758,9,5,9,18,38,57,-19,24
Young Boys,2759,1,23,7,2,72,33,39,76
FC Basel,2759,2,17,8,7,53,27,26,59
Lucerne,2759,3,11,10,11,39,43,-4,43
St Gallen,2759,4,13,4,15,42,56,-14,43
FC Zürich,2759,5,10,10,12,37,34,3,40
Grasshoppers,2759,6,10,7,15,40,47,-7,37
FC Lugano,2759,7,10,7,15,31,46,-15,37
FC Sion,2759,8,8,8,16,43,53,-10,32
FC Thun,2759,9,8,7,17,41,59,-18,31
Young Boys,2760,1,22,7,3,71,35,36,73
FC Basel,2760,2,17,8,7,54,25,29,59
St Gallen,2760,3,16,3,13,50,54,-4,51
Lucerne,2760,4,12,10,10,45,44,1,46
FC Zürich,2760,5,10,11,11,39,36,3,41
FC Thun,2760,6,11,5,16,46,57,-11,38
FC Lugano,2760,7,9,7,16,31,50,-19,34
Grasshoppers,2760,8,8,7,17,38,52,-14,31
FC Sion,2760,9,6,8,18,37,58,-21,26
Young Boys,2761,1,24,6,2,76,34,42,78
FC Basel,2761,2,17,7,8,55,28,27,58
FC Zürich,2761,3,12,10,10,44,36,8,46
St Gallen,2761,4,14,3,15,42,59,-17,45
Lucerne,2761,5,12,8,12,41,44,-3,44
FC Lugano,2761,6,10,5,17,32,51,-19,35
Grasshoppers,2761,7,8,9,15,40,49,-9,33
FC Thun,2761,8,9,6,17,44,60,-16,33
FC Sion,2761,9,6,10,16,41,54,-13,28
Young Boys,2762,1,20,9,3,71,36,35,69
FC Basel,2762,2,17,9,6,52,28,24,60
Lucerne,2762,3,13,9,10,41,42,-1,48
St Gallen,2762,4,14,2,16,42,55,-13,44
FC Zürich,2762,5,10,10,12,41,37,4,40
FC Sion,2762,6,9,8,15,47,51,-4,35
Grasshoppers,2762,7,9,8,15,40,49,-9,35
FC Lugano,2762,8,9,7,16,30,47,-17,34
FC Thun,2762,9,9,6,17,41,60,-19,33
Young Boys,2763,1,20,8,4,70,37,33,68
FC Basel,2763,2,17,9,6,54,26,28,60
Lucerne,2763,3,13,10,9,44,43,1,49
St Gallen,2763,4,14,3,15,43,57,-14,45
FC Zürich,2763,5,10,10,12,40,38,2,40
FC Thun,2763,6,11,6,15,46,55,-9,39
FC Lugano,2763,7,11,5,16,31,47,-16,38
Grasshoppers,2763,8,9,7,16,39,48,-9,34
FC Sion,2763,9,5,10,17,36,52,-16,25
Young Boys,2764,1,21,6,5,69,36,33,69
FC Basel,2764,2,18,9,5,54,24,30,63
St Gallen,2764,3,15,3,14,43,53,-10,48
Lucerne,2764,4,13,7,12,43,45,-2,46
FC Zürich,2764,5,11,11,10,44,36,8,44
Grasshoppers,2764,6,11,6,15,46,49,-3,39
FC Lugano,2764,7,10,5,17,32,51,-19,35
FC Thun,2764,8,9,6,17,45,62,-17,33
FC Sion,2764,9,6,7,19,40,60,-20,25
Young Boys,2765,1,21,8,3,70,31,39,71
FC Basel,2765,2,15,12,5,51,26,25,57
St Gallen,2765,3,14,4,14,45,58,-13,46
Lucerne,2765,4,11,9,12,39,45,-6,42
FC Zürich,2765,5,10,11,11,43,39,4,41
FC Thun,2765,6,11,6,15,46,56,-10,39
FC Lugano,2765,7,10,7,15,31,50,-19,37
Grasshoppers,2765,8,10,6,16,41,48,-7,36
FC Sion,2765,9,7,7,18,43,56,-13,28
Young Boys,2766,1,22,7,3,73,36,37,73
FC Basel,2766,2,17,9,6,55,26,29,60
Lucerne,2766,3,14,7,11,45,44,1,49
St Gallen,2766,4,14,4,14,40,51,-11,46
FC Zürich,2766,5,10,10,12,40,39,1,40
FC Thun,2766,6,11,5,16,45,57,-12,38
FC Lugano,2766,7,10,6,16,30,47,-17,36
Grasshoppers,2766,8,8,7,17,39,53,-14,31
FC Sion,2766,9,7,7,18,39,53,-14,28
Young Boys,2767,1,23,7,2,72,32,40,76
FC Basel,2767,2,18,9,5,57,26,31,63
Lucerne,2767,3,14,7,11,45,44,1,49
St Gallen,2767,4,15,2,15,43,53,-10,47
FC Zürich,2767,5,12,10,10,49,37,12,46
FC Thun,2767,6,10,5,17,44,60,-16,35
FC Lugano,2767,7,9,5,18,28,55,-27,32
Grasshoppers,2767,8,8,6,18,38,51,-13,30
FC Sion,2767,9,6,7,19,38,56,-18,25
Young Boys,2768,1,22,6,4,75,36,39,72
FC Basel,2768,2,19,8,5,51,21,30,65
Lucerne,2768,3,13,8,11,40,41,-1,47
St Gallen,2768,4,14,4,14,44,54,-10,46
FC Zürich,2768,5,10,11,11,41,37,4,41
Grasshoppers,2768,6,10,7,15,45,50,-5,37
FC Thun,2768,7,9,6,17,42,59,-17,33
FC Lugano,2768,8,9,6,17,32,52,-20,33
FC Sion,2768,9,6,8,18,39,59,-20,26
Young Boys,2769,1,23,6,3,74,33,41,75
FC Basel,2769,2,18,8,6,55,25,30,62
St Gallen,2769,3,14,4,14,40,52,-12,46
Lucerne,2769,4,12,8,12,41,45,-4,44
FC Zürich,2769,5,10,10,12,39,36,3,40
FC Lugano,2769,6,11,5,16,31,48,-17,38
Grasshoppers,2769,7,10,6,16,45,52,-7,36
FC Thun,2769,8,9,7,16,45,59,-14,34
FC Sion,2769,9,5,10,17,38,58,-20,25
Young Boys,2770,1,20,6,6,69,38,31,66
FC Basel,2770,2,18,9,5,56,28,28,63
St Gallen,2770,3,16,2,14,48,56,-8,50
Lucerne,2770,4,14,7,11,46,43,3,49
FC Thun,2770,5,11,6,15,48,57,-9,39
FC Zürich,2770,6,9,11,12,40,40,0,38
Grasshoppers,2770,7,10,6,16,39,48,-9,36
FC Lugano,2770,8,10,6,16,33,51,-18,36
FC Sion,2770,9,6,7,19,38,56,-18,25
Young Boys,2771,1,24,6,2,74,31,43,78
FC Basel,2771,2,19,7,6,54,22,32,64
St Gallen,2771,3,14,4,14,42,55,-13,46
Lucerne,2771,4,12,9,11,43,46,-3,45
FC Zürich,2771,5,11,9,12,42,41,1,42
FC Thun,2771,6,11,5,16,49,57,-8,38
Grasshoppers,2771,7,9,7,16,41,52,-11,34
FC Lugano,2771,8,9,5,18,30,52,-22,32
FC Sion,2771,9,5,8,19,39,58,-19,23
Young Boys,2772,1,20,6,6,69,40,29,66
FC Basel,2772,2,19,7,6,56,25,31,64
Lucerne,2772,3,12,9,11,43,45,-2,45
St Gallen,2772,4,13,4,15,40,54,-14,43
FC Zürich,2772,5,10,11,11,43,37,6,41
FC Lugano,2772,6,11,6,15,32,46,-14,39
Grasshoppers,2772,7,10,8,14,45,50,-5,38
FC Thun,2772,8,9,6,17,43,63,-20,33
FC Sion,2772,9,7,9,16,43,54,-11,30
Young Boys,2773,1,23,6,3,78,39,39,75
FC Basel,2773,2,19,7,6,55,23,32,64
St Gallen,2773,3,16,2,14,44,52,-8,50
Lucerne,2773,4,14,7,11,43,42,1,49
FC Zürich,2773,5,11,9,12,41,38,3,42
FC Thun,2773,6,10,6,16,46,60,-14,36
Grasshoppers,2773,7,8,8,16,44,58,-14,32
FC Lugano,2773,8,9,5,18,28,48,-20,32
FC Sion,2773,9,5,8,19,41,60,-19,23
Young Boys,2774,1,22,8,2,75,36,39,74
FC Basel,2774,2,17,8,7,54,31,23,59
Lucerne,2774,3,13,8,11,42,42,0,47
FC Zürich,2774,4,12,10,10,45,34,11,46
St Gallen,2774,5,14,2,16,42,57,-15,44
Grasshoppers,2774,6,9,9,14,43,48,-5,36
FC Lugano,2774,7,10,5,17,31,49,-18,35
FC Thun,2774,8,9,6,17,42,59,-17,33
FC Sion,2774,9,6,8,18,38,56,-18,26
Young Boys,2775,1,22,6,4,71,36,35,72
FC Basel,2775,2,18,8,6,53,24,29,62
Lucerne,2775,3,14,7,11,43,42,1,49
FC Zürich,2775,4,12,10,10,40,33,7,46
St Gallen,2775,5,13,3,16,43,58,-15,42
FC Lugano,2775,6,10,6,16,30,47,-17,36
Grasshoppers,2775,7,8,8,16,42,54,-12,32
FC Thun,2775,8,8,8,16,42,58,-16,32
FC Sion,2775,9,6,10,16,44,56,-12,28
Young Boys,2776,1,22,6,4,71,36,35,72
FC Basel,2776,2,18,8,6,54,26,28,62
Lucerne,2776,3,13,8,11,40,44,-4,47
St Gallen,2776,4,14,3,15,43,55,-12,45
FC Zürich,2776,5,11,10,11,40,34,6,43
Grasshoppers,2776,6,9,8,15,40,48,-8,35
FC Sion,2776,7,9,7,16,41,50,-9,34
FC Lugano,2776,8,9,5,18,28,47,-19,32
FC Thun,2776,9,8,7,17,41,58,-17,31
Young Boys,2777,1,23,7,2,73,30,43,76
FC Basel,2777,2,17,9,6,53,26,27,60
St Gallen,2777,3,14,3,15,43,54,-11,45
Lucerne,2777,4,12,8,12,39,46,-7,44
FC Zürich,2777,5,10,11,11,41,38,3,41
FC Lugano,2777,6,10,7,15,30,46,-16,37
Grasshoppers,2777,7,10,6,16,39,49,-10,36
FC Thun,2777,8,9,7,16,43,58,-15,34
FC Sion,2777,9,6,8,18,41,55,-14,26
Young Boys,2778,1,22,7,3,72,36,36,73
FC Basel,2778,2,16,11,5,54,28,26,59
St Gallen,2778,3,14,4,14,43,55,-12,46
Lucerne,2778,4,12,9,11,42,45,-3,45
FC Zürich,2778,5,10,11,11,40,36,4,41
Grasshoppers,2778,6,9,8,15,41,47,-6,35
FC Thun,2778,7,9,7,16,44,59,-15,34
FC Lugano,2778,8,9,7,16,29,47,-18,34
FC Sion,2778,9,7,8,17,43,55,-12,29
Young Boys,2779,1,20,9,3,76,43,33,69
FC Basel,2779,2,19,8,5,57,25,32,65
Lucerne,2779,3,12,10,10,41,42,-1,46
St Gallen,2779,4,14,2,16,40,55,-15,44
FC Zürich,2779,5,11,9,12,41,37,4,42
FC Lugano,2779,6,11,7,14,33,45,-12,40
Grasshoppers,2779,7,10,8,14,46,48,-2,38
FC Thun,2779,8,8,6,18,42,63,-21,30
FC Sion,2779,9,5,9,18,42,60,-18,24
Young Boys,2780,1,21,9,2,70,33,37,72
FC Basel,2780,2,17,10,5,54,23,31,61
Lucerne,2780,3,12,10,10,42,41,1,46
FC Zürich,2780,4,10,11,11,43,39,4,41
St Gallen,2780,5,13,2,17,38,63,-25,41
FC Lugano,2780,6,10,8,14,37,46,-9,38
Grasshoppers,2780,7,9,8,15,41,50,-9,35
FC Sion,2780,8,8,8,16,49,56,-7,32
FC Thun,2780,9,8,6,18,42,65,-23,30
Young Boys,2781,1,22,7,3,68,34,34,73
FC Basel,2781,2,17,9,6,53,26,27,60
Lucerne,2781,3,13,9,10,42,41,1,48
St Gallen,2781,4,14,2,16,42,57,-15,44
FC Zürich,2781,5,10,10,12,38,34,4,40
FC Thun,2781,6,10,6,16,44,57,-13,36
Grasshoppers,2781,7,9,8,15,40,49,-9,35
FC Lugano,2781,8,10,5,17,29,48,-19,35
FC Sion,2781,9,7,8,17,43,53,-10,29
Young Boys,2782,1,21,7,4,68,35,33,70
FC Basel,2782,2,18,7,7,55,27,28,61
Lucerne,2782,3,13,8,11,41,43,-2,47
FC Zürich,2782,4,12,9,11,44,36,8,45
St Gallen,2782,5,14,2,16,43,57,-14,44
FC Lugano,2782,6,11,7,14,35,44,-9,40
Grasshoppers,2782,7,9,6,17,39,51,-12,33
FC Thun,2782,8,9,5,18,42,60,-18,32
FC Sion,2782,9,8,7,17,42,56,-14,31
Young Boys,2783,1,22,7,3,68,31,37,73
FC Basel,2783,2,17,8,7,51,25,26,59
Lucerne,2783,3,14,8,10,45,39,6,50
St Gallen,2783,4,15,3,14,42,55,-13,48
FC Zürich,2783,5,11,10,11,43,35,8,43
FC Thun,2783,6,11,5,16,44,58,-14,38
FC Lugano,2783,7,9,6,17,28,48,-20,33
Grasshoppers,2783,8,8,6,18,38,51,-13,30
FC Sion,2783,9,6,9,17,41,58,-17,27
Young Boys,2784,1,22,8,2,74,32,42,74
FC Basel,2784,2,16,8,8,51,31,20,56
Lucerne,2784,3,14,7,11,42,43,-1,49
St Gallen,2784,4,14,4,14,46,56,-10,46
FC Zürich,2784,5,10,9,13,38,40,-2,39
FC Lugano,2784,6,11,5,16,34,48,-14,38
FC Thun,2784,7,10,7,15,43,54,-11,37
Grasshoppers,2784,8,8,9,15,37,47,-10,33
FC Sion,2784,9,5,11,16,40,54,-14,26
Young Boys,2785,1,20,7,5,69,38,31,67
FC Basel,2785,2,16,10,6,52,28,24,58
St Gallen,2785,3,14,3,15,46,60,-14,45
FC Lugano,2785,4,13,5,14,34,44,-10,44
FC Zürich,2785,5,11,10,11,43,35,8,43
Lucerne,2785,6,11,8,13,38,45,-7,41
Grasshoppers,2785,7,10,7,15,43,48,-5,37
FC Thun,2785,8,9,6,17,41,59,-18,33
FC Sion,2785,9,8,8,16,46,55,-9,32
Young Boys,2786,1,22,6,4,73,36,37,72
FC Basel,2786,2,19,8,5,63,28,35,65
St Gallen,2786,3,15,3,14,45,54,-9,48
Lucerne,2786,4,12,9,11,43,45,-2,45
FC Zürich,2786,5,11,9,12,40,37,3,42
FC Thun,2786,6,11,5,16,44,60,-16,38
Grasshoppers,2786,7,9,7,16,41,50,-9,34
FC Lugano,2786,8,9,5,18,28,52,-24,32
FC Sion,2786,9,6,8,18,40,55,-15,26
Young Boys,2787,1,22,6,4,71,34,37,72
FC Basel,2787,2,19,7,6,57,25,32,64
Lucerne,2787,3,14,7,11,46,42,4,49
St Gallen,2787,4,15,3,14,44,53,-9,48
FC Zürich,2787,5,12,9,11,43,37,6,45
FC Thun,2787,6,10,5,17,45,62,-17,35
Grasshoppers,2787,7,9,6,17,41,52,-11,33
FC Lugano,2787,8,9,6,17,29,51,-22,33
FC Sion,2787,9,6,7,19,41,61,-20,25
Young Boys,2788,1,21,7,4,75,40,35,70
FC Basel,2788,2,18,8,6,54,26,28,62
St Gallen,2788,3,16,2,14,43,53,-10,50
Lucerne,2788,4,12,8,12,40,45,-5,44
FC Zürich,2788,5,10,10,12,40,38,2,40
Grasshoppers,2788,6,9,9,14,41,47,-6,36
FC Lugano,2788,7,10,6,16,30,45,-15,36
FC Thun,2788,8,9,8,15,44,58,-14,35
FC Sion,2788,9,5,10,17,43,58,-15,25
Young Boys,2789,1,21,7,4,69,36,33,70
FC Basel,2789,2,20,7,5,61,27,34,67
St Gallen,2789,3,15,3,14,47,55,-8,48
Lucerne,2789,4,12,9,11,44,45,-1,45
FC Zürich,2789,5,11,9,12,43,39,4,42
FC Thun,2789,6,10,5,17,41,57,-16,35
FC Lugano,2789,7,9,7,16,31,51,-20,34
Grasshoppers,2789,8,8,9,15,40,49,-9,33
FC Sion,2789,9,6,8,18,39,56,-17,26
Young Boys,2790,1,22,6,4,75,37,38,72
FC Basel,2790,2,17,8,7,55,30,25,59
St Gallen,2790,3,16,3,13,42,50,-8,51
Lucerne,2790,4,14,8,10,45,43,2,50
FC Zürich,2790,5,10,11,11,41,36,5,41
Grasshoppers,2790,6,10,6,16,44,51,-7,36
FC Thun,2790,7,9,6,17,42,59,-17,33
FC Lugano,2790,8,9,5,18,30,51,-21,32
FC Sion,2790,9,6,9,17,39,56,-17,27
Young Boys,2791,1,21,7,4,68,34,34,70
FC Basel,2791,2,18,8,6,55,27,28,62
St Gallen,2791,3,15,3,14,43,53,-10,48
Lucerne,2791,4,13,7,12,45,45,0,46
FC Zürich,2791,5,11,10,11,42,37,5,43
FC Lugano,2791,6,11,5,16,31,47,-16,38
Grasshoppers,2791,7,9,7,16,38,49,-11,34
FC Thun,2791,8,8,7,17,43,61,-18,31
FC Sion,2791,9,6,10,16,39,51,-12,28
Young Boys,2792,1,22,6,4,71,38,33,72
FC Basel,2792,2,18,9,5,63,30,33,63
Lucerne,2792,3,13,10,9,45,43,2,49
St Gallen,2792,4,13,6,13,43,54,-11,45
FC Zürich,2792,5,9,12,11,44,42,2,39
Grasshoppers,2792,6,9,8,15,44,51,-7,35
FC Thun,2792,7,9,7,16,43,59,-16,34
FC Lugano,2792,8,9,7,16,29,47,-18,34
FC Sion,2792,9,5,9,18,38,56,-18,24
Young Boys,2793,1,22,8,2,75,36,39,74
FC Basel,2793,2,15,8,9,49,28,21,53
Lucerne,2793,3,14,7,11,42,45,-3,49
St Gallen,2793,4,15,4,13,47,51,-4,49
FC Zürich,2793,5,12,9,11,45,39,6,45
Grasshoppers,2793,6,10,7,15,43,50,-7,37
FC Thun,2793,7,10,6,16,49,61,-12,36
FC Lugano,2793,8,9,6,17,28,50,-22,33
FC Sion,2793,9,5,9,18,42,60,-18,24
Young Boys,2794,1,21,7,4,74,35,39,70
FC Basel,2794,2,20,7,5,59,25,34,67
Lucerne,2794,3,13,9,10,43,45,-2,48
St Gallen,2794,4,14,3,15,42,54,-12,45
Grasshoppers,2794,5,11,6,15,42,47,-5,39
FC Zürich,2794,6,9,10,13,41,42,-1,37
FC Lugano,2794,7,10,5,17,31,51,-20,35
FC Thun,2794,8,9,6,17,43,61,-18,33
FC Sion,2794,9,6,9,17,38,53,-15,27
Young Boys,2795,1,22,6,4,70,38,32,72
FC Basel,2795,2,17,7,8,51,29,22,58
Lucerne,2795,3,14,8,10,45,39,6,50
St Gallen,2795,4,15,2,15,41,55,-14,47
FC Zürich,2795,5,11,10,11,40,33,7,43
FC Thun,2795,6,11,5,16,45,56,-11,38
FC Lugano,2795,7,10,6,16,30,45,-15,36
Grasshoppers,2795,8,9,7,16,40,49,-9,34
FC Sion,2795,9,6,7,19,38,56,-18,25
Young Boys,2796,1,22,6,4,81,36,45,72
FC Basel,2796,2,16,11,5,49,23,26,59
Lucerne,2796,3,12,9,11,41,46,-5,45
St Gallen,2796,4,14,3,15,40,53,-13,45
FC Zürich,2796,5,11,11,10,43,35,8,44
Grasshoppers,2796,6,9,8,15,43,49,-6,35
FC Lugano,2796,7,10,5,17,30,53,-23,35
FC Thun,2796,8,8,8,16,39,57,-18,32
FC Sion,2796,9,7,9,16,40,54,-14,30
Young Boys,2797,1,22,6,4,76,40,36,72
FC Basel,2797,2,18,8,6,55,26,29,62
St Gallen,2797,3,15,2,15,43,56,-13,47
FC Zürich,2797,4,12,10,10,43,36,7,46
Lucerne,2797,5,11,8,13,39,48,-9,41
Grasshoppers,2797,6,10,6,16,41,50,-9,36
FC Lugano,2797,7,10,6,16,33,50,-17,36
FC Thun,2797,8,10,5,17,41,55,-14,35
FC Sion,2797,9,7,7,18,42,52,-10,28
Young Boys,2798,1,22,6,4,69,36,33,72
FC Basel,2798,2,18,8,6,54,25,29,62
St Gallen,2798,3,15,4,13,47,55,-8,49
FC Zürich,2798,4,11,10,11,43,36,7,43
Lucerne,2798,5,12,7,13,42,48,-6,43
Grasshoppers,2798,6,10,6,16,44,51,-7,36
FC Thun,2798,7,9,6,17,43,61,-18,33
FC Lugano,2798,8,9,5,18,29,49,-20,32
FC Sion,2798,9,7,10,15,44,54,-10,31
Young Boys,2799,1,21,6,5,73,40,33,69
FC Basel,2799,2,18,7,7,56,26,30,61
St Gallen,2799,3,15,4,13,48,56,-8,49
Lucerne,2799,4,12,9,11,45,49,-4,45
FC Zürich,2799,5,11,9,12,40,37,3,42
Grasshoppers,2799,6,10,8,14,44,50,-6,38
FC Lugano,2799,7,10,6,16,31,48,-17,36
FC Thun,2799,8,9,6,17,42,59,-17,33
FC Sion,2799,9,6,9,17,43,57,-14,27
Young Boys,2800,1,21,8,3,77,37,40,71
FC Basel,2800,2,17,7,8,51,31,20,58
Lucerne,2800,3,14,9,9,46,41,5,51
FC Zürich,2800,4,11,11,10,42,34,8,44
St Gallen,2800,5,13,3,16,42,57,-15,42
Grasshoppers,2800,6,11,6,15,44,48,-4,39
FC Lugano,2800,7,10,5,17,29,52,-23,35
FC Thun,2800,8,9,6,17,44,58,-14,33
FC Sion,2800,9,6,9,17,46,63,-17,27
Young Boys,2801,1,21,7,4,67,33,34,70
FC Basel,2801,2,17,8,7,51,24,27,59
FC Zürich,2801,3,13,9,10,42,32,10,48
Lucerne,2801,4,12,9,11,39,41,-2,45
St Gallen,2801,5,14,2,16,39,56,-17,44
FC Lugano,2801,6,12,5,15,33,44,-11,41
Grasshoppers,2801,7,9,8,15,40,49,-9,35
FC Thun,2801,8,8,7,17,40,59,-19,31
FC Sion,2801,9,6,9,17,38,51,-13,27
Young Boys,2802,1,22,7,3,75,38,37,73
FC Basel,2802,2,17,10,5,55,27,28,61
Lucerne,2802,3,15,7,10,46,40,6,52
St Gallen,2802,4,13,3,16,40,58,-18,42
FC Zürich,2802,5,9,11,12,40,40,0,38
FC Lugano,2802,6,11,5,16,34,49,-15,38
FC Thun,2802,7,9,7,16,45,57,-12,34
Grasshoppers,2802,8,9,6,17,41,56,-15,33
FC Sion,2802,9,7,8,17,39,50,-11,29
Young Boys,2803,1,21,8,3,72,32,40,71
FC Basel,2803,2,19,8,5,58,23,35,65
St Gallen,2803,3,15,3,14,42,52,-10,48
Lucerne,2803,4,11,9,12,37,44,-7,42
FC Zürich,2803,5,10,10,12,42,43,-1,40
Grasshoppers,2803,6,10,7,15,38,49,-11,37
FC Thun,2803,7,10,5,17,48,59,-11,35
FC Lugano,2803,8,9,8,15,30,48,-18,35
FC Sion,2803,9,6,8,18,38,55,-17,26
Young Boys,2804,1,22,8,2,74,33,41,74
FC Basel,2804,2,17,8,7,50,25,25,59
Lucerne,2804,3,13,7,12,40,43,-3,46
St Gallen,2804,4,14,3,15,42,54,-12,45
FC Zürich,2804,5,11,11,10,41,34,7,44
FC Thun,2804,6,9,8,15,41,55,-14,35
FC Lugano,2804,7,9,8,15,29,45,-16,35
Grasshoppers,2804,8,8,7,17,40,53,-13,31
FC Sion,2804,9,7,8,17,41,56,-15,29
Young Boys,2805,1,22,7,3,74,34,40,73
FC Basel,2805,2,17,9,6,55,26,29,60
Lucerne,2805,3,12,10,10,42,43,-1,46
St Gallen,2805,4,13,3,16,40,59,-19,42
FC Zürich,2805,5,10,11,11,43,38,5,41
FC Lugano,2805,6,10,8,14,32,45,-13,38
FC Thun,2805,7,10,7,15,45,57,-12,37
Grasshoppers,2805,8,8,7,17,38,51,-13,31
FC Sion,2805,9,7,8,17,43,59,-16,29
Young Boys,2806,1,22,8,2,74,32,42,74
FC Basel,2806,2,18,8,6,55,28,27,62
St Gallen,2806,3,16,2,14,50,54,-4,50
FC Zürich,2806,4,12,9,11,42,37,5,45
Lucerne,2806,5,12,7,13,41,48,-7,43
FC Thun,2806,6,10,6,16,47,59,-12,36
FC Lugano,2806,7,10,6,16,31,47,-16,36
Grasshoppers,2806,8,9,6,17,41,52,-11,33
FC Sion,2806,9,5,8,19,36,60,-24,23
Young Boys,2807,1,21,8,3,75,33,42,71
FC Basel,2807,2,18,8,6,54,24,30,62
FC Zürich,2807,3,12,9,11,46,38,8,45
Lucerne,2807,4,12,9,11,42,50,-8,45
St Gallen,2807,5,14,2,16,39,56,-17,44
FC Lugano,2807,6,11,5,16,36,51,-15,38
Grasshoppers,2807,7,8,9,15,40,50,-10,33
FC Thun,2807,8,9,6,17,45,63,-18,33
FC Sion,2807,9,6,10,16,40,52,-12,28
Young Boys,2808,1,22,7,3,71,34,37,73
FC Basel,2808,2,17,8,7,51,27,24,59
Lucerne,2808,3,12,7,13,41,48,-7,43
St Gallen,2808,4,13,3,16,42,57,-15,42
FC Thun,2808,5,12,5,15,48,57,-9,41
Grasshoppers,2808,6,11,6,15,46,52,-6,39
FC Zürich,2808,7,9,11,12,38,37,1,38
FC Lugano,2808,8,10,7,15,33,46,-13,37
FC Sion,2808,9,7,8,17,42,54,-12,29
Young Boys,2809,1,24,6,2,72,32,40,78
FC Basel,2809,2,18,8,6,56,26,30,62
St Gallen,2809,3,14,4,14,45,57,-12,46
Lucerne,2809,4,12,9,11,40,42,-2,45
FC Zürich,2809,5,11,9,12,38,38,0,42
FC Thun,2809,6,10,6,16,45,57,-12,36
FC Lugano,2809,7,10,5,17,32,49,-17,35
Grasshoppers,2809,8,9,7,16,39,49,-10,34
FC Sion,2809,9,5,8,19,36,53,-17,23
Young Boys,2810,1,22,7,3,77,38,39,73
FC Basel,2810,2,18,8,6,56,27,29,62
St Gallen,2810,3,14,3,15,40,52,-12,45
Lucerne,2810,4,12,8,12,42,43,-1,44
FC Zürich,2810,5,11,9,12,42,37,5,42
FC Thun,2810,6,11,5,16,45,57,-12,38
Grasshoppers,2810,7,9,8,15,42,51,-9,35
FC Lugano,2810,8,10,5,17,28,49,-21,35
FC Sion,2810,9,6,9,17,38,56,-18,27
Young Boys,2811,1,23,7,2,81,37,44,76
FC Basel,2811,2,16,8,8,51,28,23,56
St Gallen,2811,3,14,4,14,42,52,-10,46
Lucerne,2811,4,12,9,11,42,47,-5,45
FC Zürich,2811,5,10,10,12,40,37,3,40
FC Lugano,2811,6,11,5,16,32,46,-14,38
Grasshoppers,2811,7,9,8,15,44,56,-12,35
FC Thun,2811,8,10,5,17,45,60,-15,35
FC Sion,2811,9,6,10,16,39,53,-14,28
Young Boys,2812,1,20,7,5,71,38,33,67
FC Basel,2812,2,19,8,5,58,23,35,65
Lucerne,2812,3,14,8,10,45,42,3,50
St Gallen,2812,4,15,3,14,46,58,-12,48
FC Zürich,2812,5,10,10,12,39,37,2,40
FC Thun,2812,6,10,6,16,41,57,-16,36
FC Lugano,2812,7,10,5,17,32,52,-20,35
Grasshoppers,2812,8,9,7,16,42,54,-12,34
FC Sion,2812,9,6,8,18,43,56,-13,26
Young Boys,2813,1,22,7,3,78,40,38,73
FC Basel,2813,2,16,10,6,52,27,25,58
St Gallen,2813,3,14,4,14,41,52,-11,46
Lucerne,2813,4,12,9,11,40,43,-3,45
FC Zürich,2813,5,10,9,13,40,38,2,39
FC Thun,2813,6,10,7,15,46,59,-13,37
Grasshoppers,2813,7,9,8,15,44,52,-8,35
FC Lugano,2813,8,10,5,17,33,51,-18,35
FC Sion,2813,9,7,9,16,47,59,-12,30
Young Boys,2814,1,20,7,5,70,39,31,67
FC Basel,2814,2,17,8,7,52,26,26,59
St Gallen,2814,3,17,2,13,48,52,-4,53
Lucerne,2814,4,13,9,10,41,41,0,48
FC Zürich,2814,5,11,10,11,39,33,6,43
FC Lugano,2814,6,11,5,16,31,46,-15,38
Grasshoppers,2814,7,10,6,16,40,47,-7,36
FC Thun,2814,8,10,6,16,42,57,-15,36
FC Sion,2814,9,5,7,20,37,59,-22,22
Young Boys,2815,1,20,10,2,68,32,36,70
FC Basel,2815,2,18,8,6,54,25,29,62
St Gallen,2815,3,15,2,15,43,55,-12,47
Lucerne,2815,4,12,8,12,41,45,-4,44
FC Zürich,2815,5,10,11,11,40,38,2,41
Grasshoppers,2815,6,10,8,14,40,45,-5,38
FC Lugano,2815,7,10,6,16,34,49,-15,36
FC Thun,2815,8,9,6,17,41,58,-17,33
FC Sion,2815,9,6,9,17,39,53,-14,27
Young Boys,2816,1,22,7,3,73,34,39,73
FC Basel,2816,2,17,9,6,54,27,27,60
St Gallen,2816,3,16,2,14,46,53,-7,50
Lucerne,2816,4,13,9,10,43,42,1,48
FC Zürich,2816,5,11,9,12,42,39,3,42
Grasshoppers,2816,6,9,7,16,42,53,-11,34
FC Sion,2816,7,8,8,16,45,58,-13,32
FC Lugano,2816,8,9,5,18,32,53,-21,32
FC Thun,2816,9,8,6,18,45,63,-18,30
FC Basel,2817,1,20,7,5,57,24,33,67
Young Boys,2817,2,19,7,6,65,36,29,64
Lucerne,2817,3,13,9,10,46,46,0,48
St Gallen,2817,4,14,2,16,41,60,-19,44
FC Zürich,2817,5,11,10,11,41,35,6,43
Grasshoppers,2817,6,10,8,14,42,47,-5,38
FC Lugano,2817,7,10,5,17,28,46,-18,35
FC Sion,2817,8,8,8,16,47,53,-6,32
FC Thun,2817,9,8,6,18,43,63,-20,30
Young Boys,2818,1,21,8,3,71,35,36,71
FC Basel,2818,2,18,9,5,54,24,30,63
FC Zürich,2818,3,12,9,11,41,36,5,45
St Gallen,2818,4,14,3,15,43,56,-13,45
Lucerne,2818,5,12,7,13,41,45,-4,43
Grasshoppers,2818,6,11,7,14,45,48,-3,40
FC Lugano,2818,7,10,5,17,31,50,-19,35
FC Thun,2818,8,8,8,16,44,60,-16,32
FC Sion,2818,9,5,10,17,41,57,-16,25
Young Boys,2819,1,22,6,4,74,37,37,72
FC Basel,2819,2,17,10,5,56,24,32,61
FC Zürich,2819,3,11,11,10,45,37,8,44
Lucerne,2819,4,12,8,12,40,45,-5,44
FC Lugano,2819,5,12,6,14,35,46,-11,42
St Gallen,2819,6,13,2,17,41,59,-18,41
Grasshoppers,2819,7,9,7,16,41,51,-10,34
FC Thun,2819,8,9,7,16,43,59,-16,34
FC Sion,2819,9,7,7,18,39,56,-17,28
Young Boys,2820,1,21,7,4,70,41,29,70
FC Basel,2820,2,19,8,5,61,25,36,65
Lucerne,2820,3,14,7,11,44,43,1,49
St Gallen,2820,4,13,3,16,42,59,-17,42
FC Zürich,2820,5,10,10,12,40,38,2,40
FC Lugano,2820,6,11,6,15,34,46,-12,39
Grasshoppers,2820,7,9,6,17,39,52,-13,33
FC Sion,2820,8,8,8,16,43,52,-9,32
FC Thun,2820,9,9,5,18,44,61,-17,32
Young Boys,2821,1,22,6,4,73,37,36,72
FC Basel,2821,2,20,7,5,57,24,33,67
St Gallen,2821,3,15,3,14,45,54,-9,48
Lucerne,2821,4,12,8,12,43,49,-6,44
FC Zürich,2821,5,10,10,12,40,37,3,40
Grasshoppers,2821,6,11,6,15,44,49,-5,39
FC Lugano,2821,7,10,7,15,30,45,-15,37
FC Thun,2821,8,9,6,17,43,60,-17,33
FC Sion,2821,9,5,7,20,39,59,-20,22
Young Boys,2822,1,21,8,3,68,35,33,71
FC Basel,2822,2,19,8,5,57,22,35,65
Lucerne,2822,3,13,9,10,44,43,1,48
FC Zürich,2822,4,11,11,10,44,35,9,44
St Gallen,2822,5,14,2,16,42,56,-14,44
FC Lugano,2822,6,10,7,15,33,50,-17,37
Grasshoppers,2822,7,9,6,17,39,51,-12,33
FC Thun,2822,8,8,7,17,40,58,-18,31
FC Sion,2822,9,6,8,18,38,55,-17,26
Young Boys,2823,1,22,6,4,69,35,34,72
FC Basel,2823,2,18,8,6,56,25,31,62
Lucerne,2823,3,12,9,11,41,42,-1,45
St Gallen,2823,4,14,2,16,42,57,-15,44
FC Zürich,2823,5,11,9,12,41,36,5,42
FC Lugano,2823,6,12,5,15,33,45,-12,41
FC Thun,2823,7,10,5,17,47,62,-15,35
Grasshoppers,2823,8,9,7,16,41,49,-8,34
FC Sion,2823,9,7,7,18,41,60,-19,28
Young Boys,2824,1,22,7,3,72,33,39,73
FC Basel,2824,2,18,8,6,56,28,28,62
Lucerne,2824,3,14,8,10,46,45,1,50
St Gallen,2824,4,16,2,14,43,52,-9,50
FC Zürich,2824,5,11,9,12,42,36,6,42
FC Thun,2824,6,10,5,17,41,55,-14,35
Grasshoppers,2824,7,9,7,16,39,50,-11,34
FC Lugano,2824,8,9,5,18,28,51,-23,32
FC Sion,2824,9,6,7,19,35,52,-17,25
Young Boys,2825,1,23,6,3,75,37,38,75
FC Basel,2825,2,17,8,7,57,30,27,59
St Gallen,2825,3,15,2,15,44,55,-11,47
Lucerne,2825,4,12,8,12,42,44,-2,44
FC Zürich,2825,5,10,12,10,40,34,6,42
FC Thun,2825,6,10,6,16,48,61,-13,36
FC Lugano,2825,7,10,6,16,30,50,-20,36
Grasshoppers,2825,8,8,8,16,40,52,-12,32
FC Sion,2825,9,6,10,16,41,54,-13,28
Young Boys,2826,1,21,6,5,70,35,35,69
FC Basel,2826,2,18,8,6,53,24,29,62
Lucerne,2826,3,14,7,11,47,44,3,49
FC Zürich,2826,4,12,9,11,44,37,7,45
St Gallen,2826,5,13,3,16,41,58,-17,42
Grasshoppers,2826,6,10,6,16,40,50,-10,36
FC Lugano,2826,7,10,5,17,32,55,-23,35
FC Thun,2826,8,9,6,17,40,55,-15,33
FC Sion,2826,9,8,8,16,43,52,-9,32
Young Boys,2827,1,23,6,3,73,36,37,75
FC Basel,2827,2,17,8,7,53,26,27,59
St Gallen,2827,3,15,4,13,47,56,-9,49
Lucerne,2827,4,12,7,13,40,47,-7,43
FC Zürich,2827,5,10,11,11,40,38,2,41
FC Lugano,2827,6,11,6,15,38,47,-9,39
Grasshoppers,2827,7,9,7,16,41,49,-8,34
FC Thun,2827,8,9,7,16,44,59,-15,34
FC Sion,2827,9,6,8,18,41,59,-18,26
Young Boys,2828,1,22,7,3,70,33,37,73
FC Basel,2828,2,17,9,6,54,27,27,60
Lucerne,2828,3,14,8,10,41,39,2,50
St Gallen,2828,4,16,2,14,46,53,-7,50
FC Zürich,2828,5,9,13,10,41,37,4,40
FC Thun,2828,6,10,6,16,44,56,-12,36
Grasshoppers,2828,7,9,6,17,39,50,-11,33
FC Lugano,2828,8,9,6,17,28,48,-20,33
FC Sion,2828,9,5,9,18,37,57,-20,24
Young Boys,2829,1,22,8,2,73,34,39,74
FC Basel,2829,2,17,8,7,54,26,28,59
Lucerne,2829,3,13,9,10,44,43,1,48
St Gallen,2829,4,15,2,15,45,53,-8,47
FC Zürich,2829,5,11,9,12,42,37,5,42
FC Thun,2829,6,11,5,16,44,61,-17,38
Grasshoppers,2829,7,10,7,15,41,48,-7,37
FC Lugano,2829,8,10,5,17,32,52,-20,35
FC Sion,2829,9,5,7,20,37,58,-21,22
Young Boys,2830,1,22,6,4,69,33,36,72
FC Basel,2830,2,18,8,6,50,23,27,62
St Gallen,2830,3,16,3,13,44,51,-7,51
Lucerne,2830,4,12,7,13,43,48,-5,43
FC Zürich,2830,5,10,9,13,38,35,3,39
FC Lugano,2830,6,10,6,16,30,47,-17,36
Grasshoppers,2830,7,9,7,16,39,48,-9,34
FC Sion,2830,8,9,7,16,40,50,-10,34
FC Thun,2830,9,8,7,17,41,59,-18,31
Young Boys,2831,1,21,7,4,70,35,35,70
FC Basel,2831,2,17,8,7,53,28,25,59
Lucerne,2831,3,14,9,9,43,40,3,51
St Gallen,2831,4,15,3,14,43,54,-11,48
FC Zürich,2831,5,10,11,11,42,39,3,41
FC Lugano,2831,6,10,6,16,30,47,-17,36
Grasshoppers,2831,7,8,8,16,39,49,-10,32
FC Thun,2831,8,8,7,17,44,61,-17,31
FC Sion,2831,9,7,9,16,41,52,-11,30
Young Boys,2832,1,22,7,3,70,33,37,73
FC Basel,2832,2,18,8,6,55,24,31,62
St Gallen,2832,3,14,2,16,43,60,-17,44
FC Zürich,2832,4,11,10,11,43,38,5,43
Lucerne,2832,5,11,9,12,39,43,-4,42
Grasshoppers,2832,6,10,7,15,40,47,-7,37
FC Lugano,2832,7,10,6,16,31,46,-15,36
FC Thun,2832,8,10,5,17,46,61,-15,35
FC Sion,2832,9,7,8,17,41,56,-15,29
Young Boys,2833,1,21,7,4,73,38,35,70
FC Basel,2833,2,18,8,6,52,23,29,62
St Gallen,2833,3,14,3,15,42,56,-14,45
Lucerne,2833,4,11,9,12,38,48,-10,42
FC Lugano,2833,5,12,6,14,32,44,-12,42
FC Zürich,2833,6,10,10,12,40,37,3,40
Grasshoppers,2833,7,10,7,15,48,54,-6,37
FC Thun,2833,8,10,7,15,49,59,-10,37
FC Sion,2833,9,6,7,19,43,58,-15,25
Young Boys,2834,1,22,7,3,74,37,37,73
FC Basel,2834,2,19,8,5,57,24,33,65
FC Zürich,2834,3,12,10,10,41,32,9,46
St Gallen,2834,4,14,3,15,41,53,-12,45
Lucerne,2834,5,11,9,12,40,50,-10,42
FC Lugano,2834,6,10,6,16,29,47,-18,36
Grasshoppers,2834,7,9,7,16,41,52,-11,34
FC Thun,2834,8,9,6,17,46,59,-13,33
FC Sion,2834,9,5,10,17,38,53,-15,25
Young Boys,2835,1,21,6,5,68,38,30,69
FC Basel,2835,2,17,7,8,54,28,26,58
St Gallen,2835,3,16,2,14,43,51,-8,50
Lucerne,2835,4,14,7,11,41,42,-1,49
FC Zürich,2835,5,11,10,11,41,34,7,43
FC Lugano,2835,6,11,5,16,31,46,-15,38
FC Thun,2835,7,10,7,15,45,58,-13,37
Grasshoppers,2835,8,8,7,17,37,48,-11,31
FC Sion,2835,9,6,9,17,37,52,-15,27
Young Boys,2836,1,20,8,4,68,37,31,68
FC Basel,2836,2,17,8,7,52,27,25,59
St Gallen,2836,3,15,3,14,43,53,-10,48
Lucerne,2836,4,13,8,11,43,43,0,47
FC Zürich,2836,5,11,10,11,44,38,6,43
FC Lugano,2836,6,11,6,15,31,44,-13,39
FC Thun,2836,7,10,5,17,46,62,-16,35
FC Sion,2836,8,8,7,17,45,53,-8,31
Grasshoppers,2836,9,8,7,17,38,53,-15,31
Young Boys,2837,1,21,6,5,71,39,32,69
FC Basel,2837,2,18,7,7,52,25,27,61
Lucerne,2837,3,13,8,11,41,42,-1,47
St Gallen,2837,4,14,3,15,43,57,-14,45
FC Zürich,2837,5,11,10,11,43,37,6,43
FC Lugano,2837,6,11,5,16,37,51,-14,38
Grasshoppers,2837,7,10,7,15,45,50,-5,37
FC Thun,2837,8,10,5,17,45,59,-14,35
FC Sion,2837,9,6,9,17,42,59,-17,27
Young Boys,2838,1,23,6,3,76,33,43,75
FC Basel,2838,2,17,9,6,53,27,26,60
St Gallen,2838,3,15,2,15,45,54,-9,47
Lucerne,2838,4,12,8,12,41,46,-5,44
FC Zürich,2838,5,10,11,11,40,36,4,41
FC Lugano,2838,6,12,5,15,34,48,-14,41
Grasshoppers,2838,7,9,8,15,39,48,-9,35
FC Thun,2838,8,8,7,17,40,58,-18,31
FC Sion,2838,9,5,10,17,36,54,-18,25
Young Boys,2839,1,20,9,3,71,35,36,69
FC Basel,2839,2,18,7,7,53,26,27,61
St Gallen,2839,3,15,3,14,45,53,-8,48
Lucerne,2839,4,13,8,11,47,46,1,47
FC Zürich,2839,5,12,10,10,43,34,9,46
Grasshoppers,2839,6,9,7,16,43,51,-8,34
FC Lugano,2839,7,9,7,16,33,54,-21,34
FC Thun,2839,8,9,5,18,41,61,-20,32
FC Sion,2839,9,7,8,17,38,54,-16,29
Young Boys,2840,1,23,6,3,75,32,43,75
FC Basel,2840,2,17,9,6,52,27,25,60
Lucerne,2840,3,14,8,10,45,43,2,50
St Gallen,2840,4,14,3,15,43,57,-14,45
FC Zürich,2840,5,11,10,11,42,37,5,43
Grasshoppers,2840,6,10,6,16,42,51,-9,36
FC Lugano,2840,7,10,6,16,30,47,-17,36
FC Thun,2840,8,9,6,17,42,60,-18,33
FC Sion,2840,9,5,8,19,41,58,-17,23
Young Boys,2841,1,23,6,3,75,37,38,75
FC Basel,2841,2,16,9,7,53,27,26,57
Lucerne,2841,3,13,8,11,45,48,-3,47
St Gallen,2841,4,13,5,14,43,56,-13,44
FC Zürich,2841,5,10,11,11,41,36,5,41
Grasshoppers,2841,6,10,7,15,46,50,-4,37
FC Lugano,2841,7,10,6,16,33,50,-17,36
FC Thun,2841,8,10,5,17,43,61,-18,35
FC Sion,2841,9,6,9,17,40,54,-14,27
Young Boys,2842,1,20,8,4,65,31,34,68
FC Basel,2842,2,19,7,6,54,24,30,64
Lucerne,2842,3,14,8,10,44,41,3,50
FC Zürich,2842,4,12,10,10,41,34,7,46
St Gallen,2842,5,13,2,17,41,57,-16,41
Grasshoppers,2842,6,11,6,15,48,50,-2,39
FC Lugano,2842,7,10,7,15,31,45,-14,37
FC Thun,2842,8,9,5,18,41,63,-22,32
FC Sion,2842,9,6,7,19,40,60,-20,25
Young Boys,2843,1,21,6,5,67,37,30,69
FC Basel,2843,2,20,7,5,62,23,39,67
Lucerne,2843,3,12,9,11,41,47,-6,45
St Gallen,2843,4,13,3,16,42,58,-16,42
FC Zürich,2843,5,10,11,11,42,38,4,41
Grasshoppers,2843,6,11,6,15,44,50,-6,39
FC Thun,2843,7,10,6,16,47,59,-12,36
FC Lugano,2843,8,10,6,16,31,47,-16,36
FC Sion,2843,9,6,8,18,41,58,-17,26
Young Boys,2844,1,23,6,3,73,36,37,75
FC Basel,2844,2,17,10,5,57,29,28,61
Lucerne,2844,3,12,9,11,44,47,-3,45
St Gallen,2844,4,14,3,15,44,56,-12,45
FC Zürich,2844,5,11,9,12,41,37,4,42
FC Lugano,2844,6,11,6,15,32,45,-13,39
Grasshoppers,2844,7,9,6,17,40,52,-12,33
FC Thun,2844,8,9,6,17,45,60,-15,33
FC Sion,2844,9,7,7,18,40,54,-14,28
Young Boys,2845,1,23,7,2,82,35,47,76
FC Basel,2845,2,18,7,7,54,29,25,61
FC Zürich,2845,3,11,11,10,44,35,9,44
St Gallen,2845,4,13,4,15,43,56,-13,43
Lucerne,2845,5,11,9,12,41,47,-6,42
Grasshoppers,2845,6,9,8,15,44,51,-7,35
FC Thun,2845,7,9,7,16,46,59,-13,34
FC Lugano,2845,8,9,7,16,29,52,-23,34
FC Sion,2845,9,7,8,17,40,59,-19,29
Young Boys,2846,1,21,9,2,69,30,39,72
FC Basel,2846,2,18,9,5,55,25,30,63
Lucerne,2846,3,12,11,9,44,44,0,47
St Gallen,2846,4,13,5,14,41,54,-13,44
FC Zürich,2846,5,10,10,12,40,36,4,40
FC Lugano,2846,6,9,8,15,29,47,-18,35
Grasshoppers,2846,7,9,7,16,41,50,-9,34
FC Thun,2846,8,9,6,17,41,59,-18,33
FC Sion,2846,9,6,9,17,36,51,-15,27
Young Boys,2847,1,22,8,2,73,35,38,74
FC Basel,2847,2,17,9,6,51,26,25,60
Lucerne,2847,3,14,8,10,47,40,7,50
St Gallen,2847,4,13,3,16,38,53,-15,42
FC Zürich,2847,5,10,10,12,42,39,3,40
FC Lugano,2847,6,10,6,16,30,47,-17,36
Grasshoppers,2847,7,9,8,15,41,52,-11,35
FC Thun,2847,8,8,8,16,40,56,-16,32
FC Sion,2847,9,7,8,17,41,55,-14,29
FC Basel,2848,1,20,7,5,62,26,36,67
Young Boys,2848,2,20,7,5,70,40,30,67
Lucerne,2848,3,13,8,11,40,42,-2,47
St Gallen,2848,4,14,3,15,42,54,-12,45
FC Zürich,2848,5,10,10,12,39,39,0,40
FC Lugano,2848,6,11,6,15,32,46,-14,39
Grasshoppers,2848,7,9,8,15,42,49,-7,35
FC Thun,2848,8,9,6,17,44,60,-16,33
FC Sion,2848,9,7,7,18,39,54,-15,28
Young Boys,2849,1,22,7,3,74,36,38,73
FC Basel,2849,2,18,7,7,56,26,30,61
St Gallen,2849,3,15,3,14,46,55,-9,48
Lucerne,2849,4,12,8,12,43,47,-4,44
FC Zürich,2849,5,11,10,11,39,34,5,43
Grasshoppers,2849,6,9,7,16,41,50,-9,34
FC Thun,2849,7,9,7,16,41,59,-18,34
FC Lugano,2849,8,9,7,16,31,51,-20,34
FC Sion,2849,9,7,8,17,41,54,-13,29
Young Boys,2850,1,22,6,4,70,35,35,72
FC Basel,2850,2,18,7,7,56,28,28,61
Lucerne,2850,3,15,8,9,46,39,7,53
FC Zürich,2850,4,12,9,11,44,34,10,45
St Gallen,2850,5,13,3,16,40,58,-18,42
FC Lugano,2850,6,10,5,17,31,51,-20,35
Grasshoppers,2850,7,9,6,17,40,50,-10,33
FC Thun,2850,8,9,6,17,48,68,-20,33
FC Sion,2850,9,7,8,17,43,55,-12,29
Young Boys,2851,1,20,8,4,68,33,35,68
FC Basel,2851,2,19,8,5,60,26,34,65
Lucerne,2851,3,13,9,10,42,40,2,48
FC Zürich,2851,4,11,10,11,41,36,5,43
St Gallen,2851,5,13,3,16,41,57,-16,42
FC Lugano,2851,6,11,5,16,31,49,-18,38
Grasshoppers,2851,7,9,6,17,40,53,-13,33
FC Thun,2851,8,9,6,17,45,62,-17,33
FC Sion,2851,9,7,9,16,38,50,-12,30
Young Boys,2852,1,20,9,3,68,33,35,69
FC Basel,2852,2,17,9,6,54,27,27,60
Lucerne,2852,3,12,10,10,45,45,0,46
St Gallen,2852,4,14,3,15,44,57,-13,45
FC Zürich,2852,5,10,11,11,41,37,4,41
Grasshoppers,2852,6,11,6,15,43,48,-5,39
FC Thun,2852,7,9,6,17,42,59,-17,33
FC Lugano,2852,8,9,6,17,29,51,-22,33
FC Sion,2852,9,8,8,16,43,52,-9,32
Young Boys,2853,1,20,8,4,71,39,32,68
FC Basel,2853,2,18,8,6,57,28,29,62
St Gallen,2853,3,15,2,15,44,52,-8,47
Lucerne,2853,4,13,7,12,42,46,-4,46
FC Zürich,2853,5,10,11,11,43,39,4,41
FC Lugano,2853,6,10,6,16,30,47,-17,36
FC Thun,2853,7,9,7,16,45,60,-15,34
FC Sion,2853,8,8,9,15,45,54,-9,33
Grasshoppers,2853,9,9,6,17,43,55,-12,33
Young Boys,2854,1,21,6,5,70,37,33,69
FC Basel,2854,2,19,7,6,59,23,36,64
St Gallen,2854,3,14,3,15,40,53,-13,45
FC Zürich,2854,4,11,10,11,41,35,6,43
Lucerne,2854,5,11,9,12,40,48,-8,42
Grasshoppers,2854,6,11,7,14,42,47,-5,40
FC Lugano,2854,7,10,7,15,31,46,-15,37
FC Sion,2854,8,8,8,16,41,51,-10,32
FC Thun,2854,9,8,5,19,40,64,-24,29
Young Boys,2855,1,22,7,3,75,35,40,73
FC Basel,2855,2,18,8,6,57,28,29,62
Lucerne,2855,3,14,9,9,44,40,4,51
St Gallen,2855,4,14,3,15,45,55,-10,45
FC Zürich,2855,5,10,10,12,41,43,-2,40
Grasshoppers,2855,6,9,8,15,41,50,-9,35
FC Thun,2855,7,9,7,16,45,58,-13,34
FC Lugano,2855,8,9,5,18,30,55,-25,32
FC Sion,2855,9,6,9,17,41,55,-14,27
Young Boys,2856,1,21,6,5,68,37,31,69
FC Basel,2856,2,16,9,7,52,27,25,57
St Gallen,2856,3,14,4,14,47,56,-9,46
FC Zürich,2856,4,10,12,10,39,34,5,42
Lucerne,2856,5,11,9,12,39,47,-8,42
Grasshoppers,2856,6,11,6,15,44,49,-5,39
FC Thun,2856,7,10,7,15,44,56,-12,37
FC Lugano,2856,8,10,7,15,30,45,-15,37
FC Sion,2856,9,6,10,16,42,54,-12,28
Young Boys,2857,1,22,6,4,72,37,35,72
FC Basel,2857,2,18,7,7,58,26,32,61
St Gallen,2857,3,15,3,14,43,52,-9,48
Lucerne,2857,4,13,7,12,42,45,-3,46
FC Zürich,2857,5,12,9,11,43,37,6,45
Grasshoppers,2857,6,9,7,16,44,54,-10,34
FC Thun,2857,7,9,6,17,44,62,-18,33
FC Lugano,2857,8,9,6,17,28,47,-19,33
FC Sion,2857,9,8,7,17,44,58,-14,31
Young Boys,2858,1,22,8,2,73,33,40,74
FC Basel,2858,2,17,8,7,52,26,26,59
FC Zürich,2858,3,12,10,10,45,36,9,46
Lucerne,2858,4,12,8,12,42,50,-8,44
St Gallen,2858,5,14,2,16,41,57,-16,44
FC Lugano,2858,6,11,6,15,35,46,-11,39
FC Thun,2858,7,10,5,17,42,57,-15,35
Grasshoppers,2858,8,8,8,16,39,50,-11,32
FC Sion,2858,9,7,7,18,40,54,-14,28
Young Boys,2859,1,22,6,4,70,37,33,72
FC Basel,2859,2,16,8,8,52,29,23,56
St Gallen,2859,3,16,3,13,48,51,-3,51
Lucerne,2859,4,13,9,10,47,46,1,48
FC Zürich,2859,5,10,11,11,41,40,1,41
FC Thun,2859,6,11,5,16,48,58,-10,38
Grasshoppers,2859,7,10,7,15,41,47,-6,37
FC Lugano,2859,8,10,5,17,31,52,-21,35
FC Sion,2859,9,5,8,19,38,56,-18,23
Young Boys,2860,1,21,7,4,72,39,33,70
FC Basel,2860,2,17,9,6,55,28,27,60
Lucerne,2860,3,15,7,10,46,44,2,52
FC Zürich,2860,4,11,11,10,42,36,6,44
St Gallen,2860,5,14,2,16,44,58,-14,44
Grasshoppers,2860,6,10,7,15,45,52,-7,37
FC Thun,2860,7,9,7,16,46,58,-12,34
FC Lugano,2860,8,9,6,17,29,47,-18,33
FC Sion,2860,9,6,8,18,41,58,-17,26
Young Boys,2861,1,20,9,3,74,35,39,69
FC Basel,2861,2,15,9,8,49,28,21,54
St Gallen,2861,3,17,2,13,47,50,-3,53
Lucerne,2861,4,12,9,11,41,46,-5,45
FC Zürich,2861,5,11,9,12,44,37,7,42
FC Thun,2861,6,12,5,15,45,55,-10,41
Grasshoppers,2861,7,11,6,15,44,50,-6,39
FC Lugano,2861,8,10,5,17,30,53,-23,35
FC Sion,2861,9,5,8,19,37,57,-20,23
Young Boys,2862,1,21,8,3,74,36,38,71
FC Basel,2862,2,17,8,7,53,27,26,59
St Gallen,2862,3,14,5,13,47,55,-8,47
Lucerne,2862,4,12,10,10,44,45,-1,46
FC Zürich,2862,5,11,9,12,46,37,9,42
Grasshoppers,2862,6,9,8,15,40,49,-9,35
FC Thun,2862,7,10,5,17,45,60,-15,35
FC Lugano,2862,8,10,5,17,29,51,-22,35
FC Sion,2862,9,7,8,17,42,60,-18,29
Young Boys,2863,1,22,7,3,72,34,38,73
FC Basel,2863,2,18,7,7,53,27,26,61
St Gallen,2863,3,15,3,14,43,53,-10,48
FC Zürich,2863,4,12,10,10,42,35,7,46
Lucerne,2863,5,12,9,11,42,46,-4,45
FC Lugano,2863,6,10,5,17,30,47,-17,35
Grasshoppers,2863,7,9,7,16,42,51,-9,34
FC Thun,2863,8,8,6,18,39,57,-18,30
FC Sion,2863,9,7,8,17,42,55,-13,29
Young Boys,2864,1,22,7,3,71,34,37,73
FC Basel,2864,2,17,8,7,55,26,29,59
Lucerne,2864,3,12,10,10,43,44,-1,46
FC Zürich,2864,4,11,10,11,43,37,6,43
St Gallen,2864,5,13,3,16,40,58,-18,42
FC Lugano,2864,6,11,5,16,37,50,-13,38
FC Thun,2864,7,10,5,17,47,63,-16,35
Grasshoppers,2864,8,9,7,16,40,50,-10,34
FC Sion,2864,9,7,9,16,41,55,-14,30
Young Boys,2865,1,21,8,3,68,34,34,71
FC Basel,2865,2,16,8,8,50,26,24,56
Lucerne,2865,3,13,10,9,41,39,2,49
FC Zürich,2865,4,12,9,11,40,34,6,45
St Gallen,2865,5,14,3,15,42,55,-13,45
FC Thun,2865,6,10,5,17,46,62,-16,35
FC Sion,2865,7,9,7,16,49,55,-6,34
FC Lugano,2865,8,9,7,16,29,47,-18,34
Grasshoppers,2865,9,8,7,17,39,52,-13,31
Young Boys,2866,1,21,7,4,77,39,38,70
FC Basel,2866,2,18,8,6,58,27,31,62
St Gallen,2866,3,15,3,14,46,55,-9,48
Lucerne,2866,4,13,8,11,42,48,-6,47
FC Zürich,2866,5,12,10,10,45,37,8,46
FC Thun,2866,6,11,5,16,48,58,-10,38
Grasshoppers,2866,7,8,8,16,39,53,-14,32
FC Lugano,2866,8,9,5,18,30,54,-24,32
FC Sion,2866,9,6,8,18,43,57,-14,26
Young Boys,2867,1,22,7,3,70,35,35,73
FC Basel,2867,2,16,7,9,51,31,20,55
Lucerne,2867,3,14,7,11,45,42,3,49
St Gallen,2867,4,14,2,16,43,57,-14,44
FC Zürich,2867,5,10,11,11,41,38,3,41
FC Lugano,2867,6,12,5,15,34,46,-12,41
FC Thun,2867,7,10,6,16,48,59,-11,36
Grasshoppers,2867,8,9,6,17,40,51,-11,33
FC Sion,2867,9,7,9,16,41,54,-13,30
Young Boys,2868,1,23,7,2,73,31,42,76
FC Basel,2868,2,19,7,6,60,27,33,64
Lucerne,2868,3,13,9,10,44,46,-2,48
St Gallen,2868,4,13,4,15,45,58,-13,43
FC Zürich,2868,5,10,11,11,43,38,5,41
FC Lugano,2868,6,10,6,16,32,51,-19,36
Grasshoppers,2868,7,9,7,16,42,53,-11,34
FC Thun,2868,8,8,6,18,46,67,-21,30
FC Sion,2868,9,6,9,17,41,55,-14,27
Young Boys,2869,1,21,7,4,70,36,34,70
FC Basel,2869,2,19,8,5,57,22,35,65
St Gallen,2869,3,15,2,15,45,57,-12,47
Lucerne,2869,4,12,9,11,41,45,-4,45
Grasshoppers,2869,5,11,6,15,47,47,0,39
FC Zürich,2869,6,9,11,12,39,38,1,38
FC Lugano,2869,7,10,6,16,31,48,-17,36
FC Thun,2869,8,9,6,17,40,60,-20,33
FC Sion,2869,9,6,9,17,40,57,-17,27
Young Boys,2870,1,22,7,3,70,35,35,73
FC Basel,2870,2,18,8,6,54,26,28,62
St Gallen,2870,3,15,2,15,45,57,-12,47
Lucerne,2870,4,12,9,11,46,47,-1,45
FC Zürich,2870,5,11,11,10,42,35,7,44
FC Lugano,2870,6,10,7,15,33,47,-14,37
Grasshoppers,2870,7,9,8,15,42,50,-8,35
FC Thun,2870,8,9,6,17,42,58,-16,33
FC Sion,2870,9,5,8,19,38,57,-19,23
Young Boys,2871,1,21,8,3,74,39,35,71
FC Basel,2871,2,19,8,5,63,21,42,65
Lucerne,2871,3,12,9,11,44,51,-7,45
St Gallen,2871,4,14,3,15,44,58,-14,45
FC Zürich,2871,5,9,12,11,38,35,3,39
FC Lugano,2871,6,10,7,15,34,50,-16,37
FC Thun,2871,7,10,6,16,42,60,-18,36
Grasshoppers,2871,8,9,7,16,46,52,-6,34
FC Sion,2871,9,6,8,18,37,56,-19,26
Young Boys,2872,1,22,8,2,73,35,38,74
FC Basel,2872,2,18,8,6,57,26,31,62
Lucerne,2872,3,13,8,11,47,46,1,47
FC Zürich,2872,4,11,10,11,42,36,6,43
St Gallen,2872,5,13,3,16,39,55,-16,42
Grasshoppers,2872,6,11,6,15,44,48,-4,39
FC Lugano,2872,7,10,6,16,31,51,-20,36
FC Thun,2872,8,8,6,18,46,68,-22,30
FC Sion,2872,9,6,9,17,45,59,-14,27
Young Boys,2873,1,21,7,4,75,38,37,70
FC Basel,2873,2,18,8,6,55,28,27,62
St Gallen,2873,3,14,3,15,40,53,-13,45
Lucerne,2873,4,12,8,12,45,49,-4,44
FC Zürich,2873,5,11,9,12,43,37,6,42
Grasshoppers,2873,6,10,8,14,45,51,-6,38
FC Lugano,2873,7,11,5,16,31,48,-17,38
FC Thun,2873,8,9,5,18,41,60,-19,32
FC Sion,2873,9,8,7,17,48,59,-11,31
Young Boys,2874,1,22,8,2,79,37,42,74
FC Basel,2874,2,19,8,5,56,25,31,65
Lucerne,2874,3,12,10,10,42,44,-2,46
St Gallen,2874,4,13,4,15,38,51,-13,43
FC Zürich,2874,5,10,10,12,39,35,4,40
FC Lugano,2874,6,10,7,15,30,48,-18,37
FC Thun,2874,7,9,6,17,41,58,-17,33
Grasshoppers,2874,8,8,7,17,40,53,-13,31
FC Sion,2874,9,7,8,17,42,56,-14,29
Young Boys,2875,1,21,8,3,71,34,37,71
FC Basel,2875,2,19,8,5,56,24,32,65
Lucerne,2875,3,13,8,11,43,45,-2,47
St Gallen,2875,4,14,3,15,48,59,-11,45
FC Zürich,2875,5,10,10,12,39,37,2,40
FC Lugano,2875,6,10,7,15,35,49,-14,37
Grasshoppers,2875,7,9,8,15,41,48,-7,35
FC Thun,2875,8,9,7,16,43,60,-17,34
FC Sion,2875,9,6,7,19,41,61,-20,25
Young Boys,2876,1,22,7,3,71,35,36,73
FC Basel,2876,2,16,9,7,52,28,24,57
Lucerne,2876,3,15,8,9,43,38,5,53
St Gallen,2876,4,14,4,14,41,51,-10,46
FC Zürich,2876,5,9,12,11,41,39,2,39
Grasshoppers,2876,6,10,6,16,44,52,-8,36
FC Lugano,2876,7,10,5,17,31,50,-19,35
FC Thun,2876,8,8,7,17,42,61,-19,31
FC Sion,2876,9,6,10,16,44,55,-11,28
Young Boys,2877,1,23,7,2,75,33,42,76
FC Basel,2877,2,17,8,7,51,27,24,59
Lucerne,2877,3,14,7,11,45,43,2,49
FC Zürich,2877,4,12,9,11,47,36,11,45
St Gallen,2877,5,14,2,16,40,53,-13,44
Grasshoppers,2877,6,10,7,15,42,49,-7,37
FC Lugano,2877,7,10,5,17,29,52,-23,35
FC Thun,2877,8,8,6,18,40,61,-21,30
FC Sion,2877,9,7,7,18,41,56,-15,28
Young Boys,2878,1,22,8,2,73,33,40,74
FC Basel,2878,2,18,7,7,52,28,24,61
Lucerne,2878,3,14,7,11,42,43,-1,49
St Gallen,2878,4,14,3,15,42,52,-10,45
FC Zürich,2878,5,11,10,11,43,37,6,43
FC Thun,2878,6,11,5,16,50,57,-7,38
FC Lugano,2878,7,9,6,17,30,49,-19,33
Grasshoppers,2878,8,8,7,17,41,57,-16,31
FC Sion,2878,9,6,9,17,41,58,-17,27
Young Boys,2879,1,22,7,3,71,35,36,73
FC Basel,2879,2,15,10,7,53,30,23,55
St Gallen,2879,3,15,4,13,44,51,-7,49
Lucerne,2879,4,12,10,10,41,41,0,46
FC Zürich,2879,5,11,10,11,45,40,5,43
Grasshoppers,2879,6,11,6,15,42,47,-5,39
FC Thun,2879,7,10,5,17,44,59,-15,35
FC Lugano,2879,8,10,5,17,30,51,-21,35
FC Sion,2879,9,6,7,19,40,56,-16,25
Young Boys,2880,1,22,7,3,73,32,41,73
FC Basel,2880,2,16,8,8,53,31,22,56
Lucerne,2880,3,12,10,10,41,45,-4,46
St Gallen,2880,4,14,4,14,44,55,-11,46
FC Zürich,2880,5,12,9,11,46,37,9,45
FC Lugano,2880,6,11,7,14,34,46,-12,40
Grasshoppers,2880,7,9,8,15,44,49,-5,35
FC Thun,2880,8,8,6,18,44,62,-18,30
FC Sion,2880,9,7,7,18,38,60,-22,28
Young Boys,2881,1,21,7,4,71,36,35,70
FC Basel,2881,2,18,9,5,55,25,30,63
Lucerne,2881,3,12,9,11,40,43,-3,45
St Gallen,2881,4,13,5,14,41,53,-12,44
FC Zürich,2881,5,11,10,11,44,38,6,43
Grasshoppers,2881,6,10,8,14,46,49,-3,38
FC Thun,2881,7,9,7,16,45,61,-16,34
FC Lugano,2881,8,9,6,17,29,50,-21,33
FC Sion,2881,9,6,9,17,43,59,-16,27
Young Boys,2882,1,21,7,4,69,40,29,70
FC Basel,2882,2,16,10,6,57,30,27,58
FC Zürich,2882,3,13,9,10,45,35,10,48
St Gallen,2882,4,14,3,15,42,56,-14,45
Lucerne,2882,5,12,8,12,43,45,-2,44
Grasshoppers,2882,6,11,6,15,48,49,-1,39
FC Lugano,2882,7,11,5,16,36,49,-13,38
FC Thun,2882,8,9,6,17,44,62,-18,33
FC Sion,2882,9,6,8,18,37,55,-18,26
Young Boys,2883,1,23,6,3,72,34,38,75
FC Basel,2883,2,18,8,6,57,24,33,62
St Gallen,2883,3,14,3,15,41,58,-17,45
FC Zürich,2883,4,10,12,10,41,35,6,42
Lucerne,2883,5,11,9,12,38,46,-8,42
Grasshoppers,2883,6,10,7,15,46,49,-3,37
FC Lugano,2883,7,10,5,17,29,48,-19,35
FC Thun,2883,8,9,6,17,44,62,-18,33
FC Sion,2883,9,7,8,17,45,57,-12,29
Young Boys,2884,1,21,7,4,71,36,35,70
FC Basel,2884,2,18,8,6,53,22,31,62
St Gallen,2884,3,16,2,14,45,55,-10,50
Lucerne,2884,4,13,9,10,44,43,1,48
FC Zürich,2884,5,11,9,12,43,39,4,42
Grasshoppers,2884,6,10,6,16,42,49,-7,36
FC Lugano,2884,7,10,5,17,31,51,-20,35
FC Thun,2884,8,9,6,17,43,62,-19,33
FC Sion,2884,9,6,8,18,41,56,-15,26
Young Boys,2885,1,22,7,3,76,37,39,73
FC Basel,2885,2,17,7,8,53,27,26,58
Lucerne,2885,3,15,7,10,48,47,1,52
St Gallen,2885,4,15,2,15,46,57,-11,47
FC Zürich,2885,5,10,10,12,41,37,4,40
FC Thun,2885,6,11,5,16,48,63,-15,38
Grasshoppers,2885,7,10,6,16,47,55,-8,36
FC Lugano,2885,8,9,7,16,33,53,-20,34
FC Sion,2885,9,6,7,19,41,57,-16,25
Young Boys,2886,1,21,9,2,76,38,38,72
FC Basel,2886,2,17,9,6,49,23,26,60
Lucerne,2886,3,15,7,10,45,41,4,52
FC Zürich,2886,4,11,11,10,43,33,10,44
St Gallen,2886,5,13,3,16,41,55,-14,42
Grasshoppers,2886,6,10,6,16,41,50,-9,36
FC Lugano,2886,7,9,8,15,33,51,-18,35
FC Thun,2886,8,9,5,18,41,61,-20,32
FC Sion,2886,9,6,8,18,42,59,-17,26
Young Boys,2887,1,23,6,3,77,38,39,75
FC Basel,2887,2,17,10,5,54,25,29,61
Lucerne,2887,3,14,8,10,42,40,2,50
St Gallen,2887,4,14,4,14,42,52,-10,46
FC Zürich,2887,5,11,10,11,41,37,4,43
FC Thun,2887,6,10,7,15,47,57,-10,37
FC Lugano,2887,7,9,6,17,30,52,-22,33
Grasshoppers,2887,8,8,7,17,39,50,-11,31
FC Sion,2887,9,5,8,19,39,60,-21,23
Young Boys,2888,1,21,6,5,69,36,33,69
FC Basel,2888,2,18,8,6,53,26,27,62
St Gallen,2888,3,15,3,14,43,54,-11,48
FC Zürich,2888,4,11,9,12,42,37,5,42
Lucerne,2888,5,11,9,12,39,43,-4,42
FC Thun,2888,6,11,6,15,45,56,-11,39
Grasshoppers,2888,7,10,8,14,39,45,-6,38
FC Lugano,2888,8,9,6,17,28,48,-20,33
FC Sion,2888,9,7,7,18,41,54,-13,28
Young Boys,2889,1,21,8,3,74,35,39,71
FC Basel,2889,2,19,8,5,53,22,31,65
Lucerne,2889,3,12,9,11,42,43,-1,45
St Gallen,2889,4,13,4,15,40,54,-14,43
FC Zürich,2889,5,10,11,11,38,34,4,41
FC Lugano,2889,6,11,6,15,30,48,-18,39
FC Thun,2889,7,10,6,16,44,58,-14,36
Grasshoppers,2889,8,8,8,16,40,52,-12,32
FC Sion,2889,9,6,8,18,37,52,-15,26
Young Boys,2890,1,23,7,2,77,34,43,76
FC Basel,2890,2,16,8,8,51,28,23,56
Lucerne,2890,3,14,7,11,48,48,0,49
St Gallen,2890,4,15,2,15,46,55,-9,47
FC Zürich,2890,5,10,11,11,42,37,5,41
Grasshoppers,2890,6,10,7,15,45,50,-5,37
FC Thun,2890,7,10,6,16,43,60,-17,36
FC Lugano,2890,8,10,6,16,29,48,-19,36
FC Sion,2890,9,5,8,19,37,58,-21,23
Young Boys,2891,1,21,6,5,68,36,32,69
FC Basel,2891,2,18,8,6,52,23,29,62
St Gallen,2891,3,15,3,14,44,57,-13,48
Lucerne,2891,4,12,8,12,41,44,-3,44
FC Lugano,2891,5,11,6,15,36,46,-10,39
FC Zürich,2891,6,9,11,12,41,42,-1,38
FC Thun,2891,7,10,7,15,46,56,-10,37
Grasshoppers,2891,8,9,7,16,39,49,-10,34
FC Sion,2891,9,7,8,17,42,56,-14,29
Young Boys,2892,1,22,7,3,71,37,34,73
FC Basel,2892,2,18,7,7,53,26,27,61
St Gallen,2892,3,15,2,15,45,56,-11,47
FC Zürich,2892,4,12,9,11,40,34,6,45
Lucerne,2892,5,12,7,13,40,44,-4,43
FC Lugano,2892,6,11,6,15,35,48,-13,39
FC Thun,2892,7,9,6,17,44,61,-17,33
Grasshoppers,2892,8,8,8,16,41,53,-12,32
FC Sion,2892,9,7,8,17,43,53,-10,29
Young Boys,2893,1,21,8,3,71,37,34,71
FC Basel,2893,2,16,10,6,53,27,26,58
St Gallen,2893,3,15,4,13,43,51,-8,49
FC Zürich,2893,4,12,10,10,43,35,8,46
Lucerne,2893,5,12,9,11,40,43,-3,45
FC Thun,2893,6,9,7,16,40,57,-17,34
FC Lugano,2893,7,9,6,17,30,48,-18,33
Grasshoppers,2893,8,8,8,16,41,51,-10,32
FC Sion,2893,9,7,8,17,42,54,-12,29
Young Boys,2894,1,22,6,4,76,42,34,72
FC Basel,2894,2,18,9,5,54,24,30,63
Lucerne,2894,3,13,9,10,45,44,1,48
St Gallen,2894,4,14,3,15,43,56,-13,45
FC Zürich,2894,5,10,10,12,40,38,2,40
FC Thun,2894,6,10,7,15,43,55,-12,37
FC Lugano,2894,7,10,5,17,32,49,-17,35
Grasshoppers,2894,8,8,8,16,41,52,-11,32
FC Sion,2894,9,6,9,17,42,56,-14,27
Young Boys,2895,1,23,6,3,73,35,38,75
FC Basel,2895,2,18,7,7,52,25,27,61
St Gallen,2895,3,15,2,15,45,53,-8,47
Lucerne,2895,4,12,8,12,40,47,-7,44
FC Zürich,2895,5,11,10,11,42,38,4,43
FC Thun,2895,6,11,6,15,45,54,-9,39
FC Lugano,2895,7,11,6,15,36,49,-13,39
Grasshoppers,2895,8,9,6,17,43,53,-10,33
FC Sion,2895,9,5,7,20,37,59,-22,22
Young Boys,2896,1,21,7,4,73,36,37,70
FC Basel,2896,2,18,7,7,60,29,31,61
Lucerne,2896,3,12,8,12,40,50,-10,44
St Gallen,2896,4,14,2,16,43,59,-16,44
FC Zürich,2896,5,11,10,11,46,38,8,43
FC Lugano,2896,6,10,7,15,31,45,-14,37
FC Thun,2896,7,10,6,16,46,63,-17,36
FC Sion,2896,8,8,9,15,45,54,-9,33
Grasshoppers,2896,9,9,6,17,40,50,-10,33
Young Boys,2897,1,21,8,3,70,35,35,71
FC Basel,2897,2,17,8,7,57,28,29,59
FC Zürich,2897,3,12,10,10,43,34,9,46
St Gallen,2897,4,14,4,14,45,55,-10,46
Lucerne,2897,5,11,11,10,42,49,-7,44
Grasshoppers,2897,6,10,8,14,44,47,-3,38
FC Thun,2897,7,10,6,16,45,58,-13,36
FC Lugano,2897,8,10,6,16,31,48,-17,36
FC Sion,2897,9,5,7,20,38,61,-23,22
Young Boys,2898,1,21,7,4,70,35,35,70
FC Basel,2898,2,19,8,5,53,24,29,65
Lucerne,2898,3,13,9,10,40,39,1,48
St Gallen,2898,4,13,3,16,40,57,-17,42
FC Zürich,2898,5,9,12,11,39,36,3,39
Grasshoppers,2898,6,11,6,15,48,47,1,39
FC Lugano,2898,7,9,8,15,27,44,-17,35
FC Thun,2898,8,9,5,18,40,64,-24,32
FC Sion,2898,9,7,8,17,42,53,-11,29
Young Boys,2899,1,19,7,6,66,38,28,64
FC Basel,2899,2,18,7,7,54,27,27,61
Lucerne,2899,3,15,7,10,50,44,6,52
FC Zürich,2899,4,12,9,11,43,35,8,45
St Gallen,2899,5,14,3,15,43,58,-15,45
Grasshoppers,2899,6,10,7,15,43,49,-6,37
FC Thun,2899,7,10,5,17,44,62,-18,35
FC Lugano,2899,8,9,7,16,31,48,-17,34
FC Sion,2899,9,7,8,17,42,55,-13,29
Young Boys,2900,1,22,7,3,69,34,35,73
FC Basel,2900,2,17,9,6,52,25,27,60
Lucerne,2900,3,14,7,11,40,40,0,49
St Gallen,2900,4,15,3,14,48,57,-9,48
FC Zürich,2900,5,11,10,11,41,34,7,43
Grasshoppers,2900,6,10,6,16,43,49,-6,36
FC Lugano,2900,7,10,6,16,34,50,-16,36
FC Thun,2900,8,9,5,18,41,60,-19,32
FC Sion,2900,9,6,7,19,39,58,-19,25
Young Boys,2901,1,22,6,4,76,38,38,72
FC Basel,2901,2,18,8,6,55,23,32,62
Lucerne,2901,3,13,7,12,41,50,-9,46
St Gallen,2901,4,14,2,16,39,54,-15,44
FC Zürich,2901,5,10,12,10,39,34,5,42
FC Thun,2901,6,11,5,16,45,56,-11,38
FC Lugano,2901,7,10,6,16,32,48,-16,36
Grasshoppers,2901,8,8,7,17,39,51,-12,31
FC Sion,2901,9,7,9,16,40,52,-12,30
Young Boys,2902,1,22,6,4,72,35,37,72
FC Basel,2902,2,20,7,5,59,24,35,67
Lucerne,2902,3,13,7,12,42,45,-3,46
FC Lugano,2902,4,12,5,15,33,47,-14,41
St Gallen,2902,5,13,2,17,41,60,-19,41
FC Zürich,2902,6,10,10,12,39,38,1,40
Grasshoppers,2902,7,9,7,16,41,48,-7,34
FC Thun,2902,8,9,6,17,45,61,-16,33
FC Sion,2902,9,7,8,17,44,58,-14,29
Young Boys,2903,1,20,8,4,69,36,33,68
FC Basel,2903,2,19,8,5,57,25,32,65
Lucerne,2903,3,14,8,10,49,46,3,50
St Gallen,2903,4,14,3,15,41,56,-15,45
FC Lugano,2903,5,12,5,15,34,46,-12,41
FC Zürich,2903,6,9,10,13,38,37,1,37
Grasshoppers,2903,7,10,7,15,46,49,-3,37
FC Thun,2903,8,10,5,17,40,59,-19,35
FC Sion,2903,9,5,8,19,36,56,-20,23
Young Boys,2904,1,19,9,4,68,37,31,66
FC Basel,2904,2,18,8,6,51,26,25,62
Lucerne,2904,3,14,8,10,43,40,3,50
FC Zürich,2904,4,13,9,10,45,32,13,48
St Gallen,2904,5,14,4,14,43,53,-10,46
Grasshoppers,2904,6,10,7,15,42,50,-8,37
FC Lugano,2904,7,9,6,17,29,49,-20,33
FC Thun,2904,8,8,6,18,42,60,-18,30
FC Sion,2904,9,6,9,17,41,57,-16,27
Young Boys,2905,1,21,6,5,72,39,33,69
FC Basel,2905,2,18,8,6,53,24,29,62
Lucerne,2905,3,14,7,11,43,45,-2,49
FC Zürich,2905,4,12,10,10,43,35,8,46
St Gallen,2905,5,13,3,16,40,58,-18,42
Grasshoppers,2905,6,10,7,15,42,49,-7,37
FC Lugano,2905,7,10,6,16,35,50,-15,36
FC Thun,2905,8,9,6,17,42,58,-16,33
FC Sion,2905,9,7,7,18,42,54,-12,28
Young Boys,2906,1,22,7,3,78,37,41,73
FC Basel,2906,2,18,8,6,57,26,31,62
Lucerne,2906,3,14,7,11,44,42,2,49
St Gallen,2906,4,14,3,15,41,53,-12,45
FC Zürich,2906,5,11,9,12,39,38,1,42
FC Thun,2906,6,12,5,15,49,58,-9,41
Grasshoppers,2906,7,9,6,17,42,57,-15,33
FC Lugano,2906,8,9,6,17,30,52,-22,33
FC Sion,2906,9,6,7,19,40,57,-17,25
Young Boys,2907,1,22,7,3,74,30,44,73
FC Basel,2907,2,18,9,5,56,26,30,63
Lucerne,2907,3,13,7,12,44,49,-5,46
St Gallen,2907,4,14,4,14,46,56,-10,46
FC Zürich,2907,5,11,9,12,40,38,2,42
FC Thun,2907,6,10,5,17,46,60,-14,35
Grasshoppers,2907,7,9,7,16,41,49,-8,34
FC Lugano,2907,8,9,5,18,27,54,-27,32
FC Sion,2907,9,7,9,16,41,53,-12,30
Young Boys,2908,1,22,6,4,73,38,35,72
FC Basel,2908,2,17,8,7,52,30,22,59
Lucerne,2908,3,12,9,11,43,43,0,45
St Gallen,2908,4,14,3,15,44,59,-15,45
FC Zürich,2908,5,10,11,11,42,36,6,41
FC Lugano,2908,6,11,6,15,31,46,-15,39
Grasshoppers,2908,7,10,7,15,43,48,-5,37
FC Thun,2908,8,9,7,16,45,58,-13,34
FC Sion,2908,9,7,7,18,43,58,-15,28
Young Boys,2909,1,19,9,4,68,36,32,66
FC Basel,2909,2,19,8,5,57,23,34,65
Lucerne,2909,3,14,8,10,44,44,0,50
St Gallen,2909,4,13,3,16,42,60,-18,42
FC Zürich,2909,5,9,12,11,37,34,3,39
FC Lugano,2909,6,9,8,15,31,47,-16,35
FC Thun,2909,7,9,7,16,41,57,-16,34
FC Sion,2909,8,8,9,15,44,52,-8,33
Grasshoppers,2909,9,8,8,16,41,52,-11,32
Young Boys,2910,1,22,7,3,71,34,37,73
FC Basel,2910,2,18,8,6,53,26,27,62
St Gallen,2910,3,15,3,14,44,54,-10,48
Lucerne,2910,4,13,7,12,44,47,-3,46
FC Zürich,2910,5,11,9,12,41,36,5,42
Grasshoppers,2910,6,10,6,16,43,52,-9,36
FC Thun,2910,7,10,5,17,44,59,-15,35
FC Lugano,2910,8,10,5,17,32,49,-17,35
FC Sion,2910,9,6,8,18,40,55,-15,26
Young Boys,2911,1,20,7,5,67,37,30,67
FC Basel,2911,2,17,8,7,55,26,29,59
St Gallen,2911,3,15,3,14,45,55,-10,48
Lucerne,2911,4,13,8,11,43,46,-3,47
FC Zürich,2911,5,11,11,10,41,34,7,44
FC Lugano,2911,6,10,7,15,35,49,-14,37
Grasshoppers,2911,7,9,8,15,41,47,-6,35
FC Thun,2911,8,8,8,16,39,58,-19,32
FC Sion,2911,9,7,8,17,41,55,-14,29
Young Boys,2912,1,21,8,3,73,37,36,71
FC Basel,2912,2,18,8,6,57,30,27,62
Lucerne,2912,3,13,8,11,47,46,1,47
St Gallen,2912,4,13,5,14,44,56,-12,44
FC Zürich,2912,5,10,9,13,43,40,3,39
FC Lugano,2912,6,11,6,15,33,48,-15,39
FC Thun,2912,7,11,5,16,47,59,-12,38
Grasshoppers,2912,8,9,7,16,39,49,-10,34
FC Sion,2912,9,6,8,18,43,61,-18,26
Young Boys,2913,1,21,6,5,68,36,32,69
FC Basel,2913,2,19,8,5,58,25,33,65
St Gallen,2913,3,15,4,13,49,53,-4,49
Lucerne,2913,4,11,8,13,41,52,-11,41
FC Zürich,2913,5,9,12,11,39,38,1,39
FC Thun,2913,6,10,6,16,44,56,-12,36
FC Lugano,2913,7,10,6,16,31,48,-17,36
Grasshoppers,2913,8,9,7,16,42,54,-12,34
FC Sion,2913,9,7,9,16,45,55,-10,30
Young Boys,2914,1,21,9,2,73,35,38,72
FC Basel,2914,2,16,9,7,52,28,24,57
St Gallen,2914,3,16,3,13,47,51,-4,51
Lucerne,2914,4,13,7,12,43,44,-1,46
FC Zürich,2914,5,10,11,11,42,38,4,41
FC Lugano,2914,6,11,6,15,32,47,-15,39
FC Thun,2914,7,10,6,16,46,60,-14,36
Grasshoppers,2914,8,9,6,17,41,55,-14,33
FC Sion,2914,9,5,9,18,41,59,-18,24
Young Boys,2915,1,21,6,5,70,38,32,69
FC Basel,2915,2,17,8,7,51,23,28,59
St Gallen,2915,3,15,2,15,41,54,-13,47
Lucerne,2915,4,12,10,10,43,43,0,46
FC Zürich,2915,5,11,10,11,38,35,3,43
Grasshoppers,2915,6,10,7,15,43,49,-6,37
FC Lugano,2915,7,10,6,16,32,49,-17,36
FC Sion,2915,8,8,8,16,43,51,-8,32
FC Thun,2915,9,8,7,17,39,58,-19,31
Young Boys,2916,1,22,6,4,72,37,35,72
FC Basel,2916,2,17,9,6,53,24,29,60
St Gallen,2916,3,14,4,14,44,55,-11,46
Lucerne,2916,4,12,8,12,39,46,-7,44
FC Zürich,2916,5,11,10,11,41,36,5,43
FC Lugano,2916,6,10,7,15,32,46,-14,37
Grasshoppers,2916,7,10,6,16,44,48,-4,36
FC Thun,2916,8,10,5,17,44,58,-14,35
FC Sion,2916,9,7,7,18,42,61,-19,28
Young Boys,2917,1,22,7,3,72,36,36,73
FC Basel,2917,2,17,7,8,53,29,24,58
Lucerne,2917,3,13,7,12,41,45,-4,46
FC Zürich,2917,4,10,11,11,40,36,4,41
FC Lugano,2917,5,12,5,15,33,44,-11,41
St Gallen,2917,6,13,2,17,42,58,-16,41
Grasshoppers,2917,7,9,7,16,39,48,-9,34
FC Thun,2917,8,9,7,16,40,56,-16,34
FC Sion,2917,9,8,9,15,44,52,-8,33
Young Boys,2918,1,21,8,3,68,35,33,71
FC Basel,2918,2,18,8,6,59,27,32,62
St Gallen,2918,3,16,3,13,45,52,-7,51
Lucerne,2918,4,12,8,12,40,45,-5,44
FC Zürich,2918,5,10,10,12,40,37,3,40
FC Thun,2918,6,11,5,16,45,57,-12,38
FC Lugano,2918,7,10,5,17,29,48,-19,35
Grasshoppers,2918,8,9,7,16,41,50,-9,34
FC Sion,2918,9,5,10,17,38,54,-16,25
Young Boys,2919,1,22,7,3,71,34,37,73
FC Basel,2919,2,16,9,7,52,28,24,57
FC Zürich,2919,3,13,9,10,47,36,11,48
St Gallen,2919,4,14,5,13,48,54,-6,47
Lucerne,2919,5,12,8,12,39,48,-9,44
Grasshoppers,2919,6,10,7,15,42,48,-6,37
FC Thun,2919,7,9,6,17,47,65,-18,33
FC Lugano,2919,8,9,6,17,29,47,-18,33
FC Sion,2919,9,6,9,17,42,57,-15,27
Young Boys,2920,1,23,7,2,72,32,40,76
FC Basel,2920,2,18,8,6,60,28,32,62
St Gallen,2920,3,14,3,15,47,58,-11,45
Lucerne,2920,4,12,8,12,39,45,-6,44
FC Zürich,2920,5,10,10,12,40,40,0,40
FC Lugano,2920,6,11,5,16,33,50,-17,38
FC Thun,2920,7,10,6,16,46,56,-10,36
Grasshoppers,2920,8,9,8,15,40,47,-7,35
FC Sion,2920,9,5,9,18,35,56,-21,24
Young Boys,2921,1,22,6,4,72,40,32,72
FC Basel,2921,2,18,7,7,55,25,30,61
St Gallen,2921,3,16,2,14,43,52,-9,50
Lucerne,2921,4,14,7,11,49,43,6,49
FC Zürich,2921,5,12,9,11,43,35,8,45
FC Lugano,2921,6,10,5,17,31,54,-23,35
Grasshoppers,2921,7,8,7,17,39,53,-14,31
FC Thun,2921,8,8,7,17,40,58,-18,31
FC Sion,2921,9,7,8,17,42,54,-12,29
Young Boys,2922,1,22,7,3,75,35,40,73
FC Basel,2922,2,17,8,7,54,31,23,59
Lucerne,2922,3,15,7,10,44,42,2,52
FC Zürich,2922,4,12,10,10,44,34,10,46
St Gallen,2922,5,14,3,15,43,54,-11,45
Grasshoppers,2922,6,10,6,16,45,51,-6,36
FC Lugano,2922,7,9,6,17,29,49,-20,33
FC Thun,2922,8,8,6,18,43,64,-21,30
FC Sion,2922,9,6,9,17,40,57,-17,27
Young Boys,2923,1,23,6,3,74,34,40,75
FC Basel,2923,2,18,8,6,58,26,32,62
Lucerne,2923,3,13,8,11,45,45,0,47
St Gallen,2923,4,13,3,16,43,59,-16,42
FC Zürich,2923,5,10,10,12,38,37,1,40
FC Lugano,2923,6,11,6,15,32,47,-15,39
Grasshoppers,2923,7,9,6,17,40,52,-12,33
FC Thun,2923,8,9,6,17,42,61,-19,33
FC Sion,2923,9,8,7,17,42,53,-11,31
Young Boys,2924,1,20,8,4,67,34,33,68
FC Basel,2924,2,18,8,6,56,24,32,62
Lucerne,2924,3,12,9,11,43,47,-4,45
St Gallen,2924,4,14,3,15,43,56,-13,45
FC Zürich,2924,5,10,9,13,42,37,5,39
FC Sion,2924,6,10,7,15,42,48,-6,37
Grasshoppers,2924,7,10,7,15,40,47,-7,37
FC Lugano,2924,8,10,6,16,29,50,-21,36
FC Thun,2924,9,9,5,18,42,61,-19,32
Young Boys,2925,1,21,7,4,69,35,34,70
FC Basel,2925,2,18,7,7,55,26,29,61
St Gallen,2925,3,14,4,14,43,54,-11,46
FC Zürich,2925,4,12,9,11,44,38,6,45
Lucerne,2925,5,12,9,11,42,43,-1,45
Grasshoppers,2925,6,10,7,15,40,46,-6,37
FC Thun,2925,7,10,5,17,41,57,-16,35
FC Lugano,2925,8,10,5,17,31,51,-20,35
FC Sion,2925,9,6,9,17,40,55,-15,27
Young Boys,2926,1,21,9,2,73,35,38,72
FC Basel,2926,2,16,10,6,52,27,25,58
Lucerne,2926,3,13,8,11,42,44,-2,47
St Gallen,2926,4,14,4,14,45,54,-9,46
FC Zürich,2926,5,11,10,11,40,33,7,43
FC Lugano,2926,6,10,6,16,32,48,-16,36
FC Thun,2926,7,9,8,15,43,57,-14,35
Grasshoppers,2926,8,8,7,17,38,51,-13,31
FC Sion,2926,9,7,8,17,37,53,-16,29
Young Boys,2927,1,22,7,3,71,31,40,73
FC Basel,2927,2,18,7,7,54,25,29,61
Lucerne,2927,3,13,7,12,42,45,-3,46
St Gallen,2927,4,14,3,15,43,56,-13,45
FC Zürich,2927,5,10,11,11,41,35,6,41
FC Lugano,2927,6,11,7,14,33,46,-13,40
FC Thun,2927,7,9,8,15,42,56,-14,35
Grasshoppers,2927,8,9,7,16,39,52,-13,34
FC Sion,2927,9,5,9,18,36,55,-19,24
Young Boys,2928,1,22,6,4,76,35,41,72
FC Basel,2928,2,19,7,6,54,26,28,64
Lucerne,2928,3,14,7,11,45,49,-4,49
St Gallen,2928,4,14,2,16,42,57,-15,44
FC Zürich,2928,5,10,10,12,40,36,4,40
FC Lugano,2928,6,11,6,15,35,45,-10,39
Grasshoppers,2928,7,9,7,16,43,53,-10,34
FC Thun,2928,8,8,7,17,41,62,-21,31
FC Sion,2928,9,7,8,17,41,54,-13,29
Young Boys,2929,1,22,8,2,74,33,41,74
FC Basel,2929,2,17,7,8,56,34,22,58
Lucerne,2929,3,13,8,11,42,46,-4,47
St Gallen,2929,4,14,2,16,46,59,-13,44
FC Zürich,2929,5,10,11,11,42,38,4,41
Grasshoppers,2929,6,10,8,14,42,47,-5,38
FC Lugano,2929,7,10,7,15,33,48,-15,37
FC Sion,2929,8,8,7,17,46,56,-10,31
FC Thun,2929,9,8,6,18,45,65,-20,30
Young Boys,2930,1,21,7,4,70,36,34,70
FC Basel,2930,2,18,8,6,55,27,28,62
Lucerne,2930,3,14,7,11,45,44,1,49
FC Zürich,2930,4,11,10,11,44,38,6,43
St Gallen,2930,5,13,3,16,42,56,-14,42
FC Lugano,2930,6,11,7,14,33,46,-13,40
Grasshoppers,2930,7,10,7,15,42,48,-6,37
FC Thun,2930,8,9,6,17,44,61,-17,33
FC Sion,2930,9,6,7,19,39,58,-19,25
Young Boys,2931,1,19,6,7,66,44,22,63
FC Basel,2931,2,16,8,8,52,30,22,56
Lucerne,2931,3,15,8,9,47,41,6,53
St Gallen,2931,4,15,2,15,43,55,-12,47
FC Zürich,2931,5,11,9,12,43,36,7,42
FC Thun,2931,6,12,5,15,51,60,-9,41
FC Lugano,2931,7,11,5,16,35,47,-12,38
Grasshoppers,2931,8,10,6,16,45,53,-8,36
FC Sion,2931,9,7,7,18,42,58,-16,28
Young Boys,2932,1,21,8,3,73,36,37,71
FC Basel,2932,2,18,9,5,54,25,29,63
St Gallen,2932,3,16,2,14,47,53,-6,50
Lucerne,2932,4,13,7,12,45,48,-3,46
FC Zürich,2932,5,10,9,13,43,39,4,39
FC Lugano,2932,6,11,5,16,35,52,-17,38
Grasshoppers,2932,7,9,8,15,40,49,-9,35
FC Thun,2932,8,9,7,16,41,58,-17,34
FC Sion,2932,9,6,7,19,40,58,-18,25
Young Boys,2933,1,23,6,3,76,37,39,75
FC Basel,2933,2,16,9,7,52,28,24,57
St Gallen,2933,3,15,2,15,47,56,-9,47
FC Zürich,2933,4,11,11,10,43,34,9,44
Lucerne,2933,5,11,9,12,43,50,-7,42
Grasshoppers,2933,6,9,8,15,42,50,-8,35
FC Lugano,2933,7,10,5,17,34,55,-21,35
FC Thun,2933,8,9,7,16,46,62,-16,34
FC Sion,2933,9,8,7,17,43,54,-11,31
Young Boys,2934,1,20,8,4,72,37,35,68
FC Basel,2934,2,19,8,5,54,21,33,65
St Gallen,2934,3,15,4,13,46,54,-8,49
Lucerne,2934,4,12,8,12,46,47,-1,44
Grasshoppers,2934,5,11,7,14,49,48,1,40
FC Zürich,2934,6,10,9,13,39,38,1,39
FC Lugano,2934,7,10,6,16,33,57,-24,36
FC Thun,2934,8,9,5,18,42,63,-21,32
FC Sion,2934,9,7,7,18,45,61,-16,28
Young Boys,2935,1,20,8,4,68,35,33,68
FC Basel,2935,2,15,11,6,52,29,23,56
St Gallen,2935,3,15,4,13,43,51,-8,49
Lucerne,2935,4,12,8,12,43,47,-4,44
FC Zürich,2935,5,11,10,11,46,37,9,43
Grasshoppers,2935,6,11,7,14,44,46,-2,40
FC Lugano,2935,7,10,7,15,32,47,-15,37
FC Thun,2935,8,10,5,17,44,59,-15,35
FC Sion,2935,9,6,8,18,37,58,-21,26
Young Boys,2936,1,21,8,3,73,35,38,71
FC Basel,2936,2,18,8,6,53,28,25,62
St Gallen,2936,3,15,3,14,45,51,-6,48
Lucerne,2936,4,12,9,11,41,43,-2,45
FC Zürich,2936,5,11,10,11,39,34,5,43
Grasshoppers,2936,6,9,9,14,41,48,-7,36
FC Lugano,2936,7,10,5,17,29,50,-21,35
FC Thun,2936,8,9,7,16,42,57,-15,34
FC Sion,2936,9,5,9,18,37,54,-17,24
Young Boys,2937,1,21,7,4,69,36,33,70
FC Basel,2937,2,16,9,7,50,29,21,57
Lucerne,2937,3,13,8,11,47,45,2,47
FC Zürich,2937,4,12,9,11,45,37,8,45
St Gallen,2937,5,13,4,15,44,59,-15,43
FC Lugano,2937,6,11,5,16,32,46,-14,38
Grasshoppers,2937,7,10,7,15,42,52,-10,37
FC Thun,2937,8,9,7,16,45,60,-15,34
FC Sion,2937,9,7,8,17,45,55,-10,29
Young Boys,2938,1,21,8,3,75,37,38,71
FC Basel,2938,2,18,8,6,59,25,34,62
St Gallen,2938,3,14,2,16,41,58,-17,44
Lucerne,2938,4,12,7,13,40,48,-8,43
Grasshoppers,2938,5,11,7,14,42,46,-4,40
FC Lugano,2938,6,11,6,15,33,47,-14,39
FC Zürich,2938,7,9,11,12,37,35,2,38
FC Thun,2938,8,9,6,17,41,59,-18,33
FC Sion,2938,9,8,7,17,41,54,-13,31
Young Boys,2939,1,22,8,2,74,32,42,74
FC Basel,2939,2,16,9,7,52,26,26,57
St Gallen,2939,3,14,5,13,44,54,-10,47
Lucerne,2939,4,12,8,12,43,47,-4,44
FC Zürich,2939,5,10,9,13,40,42,-2,39
FC Thun,2939,6,11,5,16,48,60,-12,38
FC Lugano,2939,7,11,5,16,30,48,-18,38
Grasshoppers,2939,8,9,8,15,47,53,-6,35
FC Sion,2939,9,6,9,17,43,59,-16,27
Young Boys,2940,1,20,9,3,69,35,34,69
FC Basel,2940,2,18,9,5,53,24,29,63
Lucerne,2940,3,12,9,11,42,44,-2,45
St Gallen,2940,4,14,3,15,42,54,-12,45
FC Zürich,2940,5,9,11,12,37,36,1,38
Grasshoppers,2940,6,10,6,16,39,50,-11,36
FC Thun,2940,7,10,6,16,46,58,-12,36
FC Lugano,2940,8,9,9,14,31,46,-15,36
FC Sion,2940,9,7,8,17,38,50,-12,29
Young Boys,2941,1,21,7,4,72,39,33,70
FC Basel,2941,2,18,8,6,54,26,28,62
FC Zürich,2941,3,13,9,10,43,33,10,48
St Gallen,2941,4,15,3,14,46,55,-9,48
Lucerne,2941,5,13,8,11,43,42,1,47
Grasshoppers,2941,6,9,8,15,43,52,-9,35
FC Thun,2941,7,9,6,17,44,61,-17,33
FC Lugano,2941,8,9,5,18,29,50,-21,32
FC Sion,2941,9,6,8,18,43,59,-16,26
Young Boys,2942,1,21,7,4,71,32,39,70
FC Basel,2942,2,20,7,5,58,22,36,67
St Gallen,2942,3,14,2,16,45,59,-14,44
FC Zürich,2942,4,10,11,11,41,38,3,41
Lucerne,2942,5,11,8,13,39,51,-12,41
FC Lugano,2942,6,11,6,15,33,49,-16,39
Grasshoppers,2942,7,10,6,16,41,49,-8,36
FC Sion,2942,8,9,8,15,44,50,-6,35
FC Thun,2942,9,8,5,19,40,62,-22,29
Young Boys,2943,1,22,6,4,76,35,41,72
FC Basel,2943,2,19,8,5,57,25,32,65
Lucerne,2943,3,12,8,12,39,48,-9,44
St Gallen,2943,4,13,3,16,41,55,-14,42
FC Zürich,2943,5,10,11,11,42,36,6,41
FC Lugano,2943,6,11,6,15,31,45,-14,39
Grasshoppers,2943,7,9,8,15,40,49,-9,35
FC Thun,2943,8,9,6,17,41,59,-18,33
FC Sion,2943,9,6,10,16,40,55,-15,28
Young Boys,2944,1,20,8,4,70,37,33,68
FC Basel,2944,2,18,7,7,54,28,26,61
Lucerne,2944,3,15,8,9,46,42,4,53
FC Zürich,2944,4,12,10,10,45,35,10,46
St Gallen,2944,5,14,2,16,43,54,-11,44
Grasshoppers,2944,6,11,6,15,46,49,-3,39
FC Lugano,2944,7,10,6,16,29,46,-17,36
FC Thun,2944,8,9,5,18,42,61,-19,32
FC Sion,2944,9,5,8,19,38,61,-23,23
Young Boys,2945,1,23,6,3,79,35,44,75
FC Basel,2945,2,17,8,7,50,26,24,59
Lucerne,2945,3,13,8,11,43,45,-2,47
St Gallen,2945,4,14,3,15,41,57,-16,45
FC Zürich,2945,5,11,10,11,41,35,6,43
FC Lugano,2945,6,12,5,15,36,47,-11,41
Grasshoppers,2945,7,9,7,16,38,49,-11,34
FC Thun,2945,8,9,6,17,45,59,-14,33
FC Sion,2945,9,6,7,19,41,61,-20,25
Young Boys,2946,1,20,7,5,70,40,30,67
FC Basel,2946,2,18,8,6,55,26,29,62
Lucerne,2946,3,12,10,10,42,44,-2,46
St Gallen,2946,4,13,4,15,40,54,-14,43
FC Thun,2946,5,11,6,15,48,57,-9,39
FC Lugano,2946,6,11,6,15,34,47,-13,39
Grasshoppers,2946,7,10,7,15,46,53,-7,37
FC Zürich,2946,8,9,9,14,40,44,-4,36
FC Sion,2946,9,7,9,16,42,52,-10,30
Young Boys,2947,1,21,7,4,75,38,37,70
FC Basel,2947,2,17,8,7,50,25,25,59
Lucerne,2947,3,13,8,11,42,43,-1,47
St Gallen,2947,4,14,3,15,41,57,-16,45
FC Zürich,2947,5,10,10,12,39,38,1,40
FC Lugano,2947,6,11,5,16,34,50,-16,38
FC Sion,2947,7,9,8,15,47,50,-3,35
Grasshoppers,2947,8,9,7,16,37,48,-11,34
FC Thun,2947,9,9,6,17,40,56,-16,33
Young Boys,2948,1,21,8,3,73,34,39,71
FC Basel,2948,2,18,8,6,53,24,29,62
Lucerne,2948,3,12,8,12,38,46,-8,44
St Gallen,2948,4,13,5,14,41,55,-14,44
FC Zürich,2948,5,11,10,11,45,37,8,43
Grasshoppers,2948,6,11,6,15,41,47,-6,39
FC Lugano,2948,7,10,7,15,33,48,-15,37
FC Thun,2948,8,9,6,17,43,59,-16,33
FC Sion,2948,9,5,10,17,39,56,-17,25
Young Boys,2949,1,23,6,3,71,33,38,75
FC Basel,2949,2,17,9,6,54,23,31,60
FC Zürich,2949,3,12,10,10,40,32,8,46
Lucerne,2949,4,12,8,12,39,47,-8,44
St Gallen,2949,5,13,3,16,42,62,-20,42
Grasshoppers,2949,6,9,8,15,43,50,-7,35
FC Lugano,2949,7,10,5,17,30,46,-16,35
FC Sion,2949,8,8,8,16,44,52,-8,32
FC Thun,2949,9,8,7,17,41,59,-18,31
Young Boys,2950,1,21,7,4,74,37,37,70
FC Basel,2950,2,18,9,5,54,23,31,63
Lucerne,2950,3,14,7,11,44,48,-4,49
St Gallen,2950,4,14,2,16,42,55,-13,44
FC Zürich,2950,5,10,10,12,42,39,3,40
FC Lugano,2950,6,11,5,16,37,50,-13,38
FC Thun,2950,7,11,5,16,44,59,-15,38
Grasshoppers,2950,8,10,6,16,43,51,-8,36
FC Sion,2950,9,6,7,19,39,57,-18,25
Young Boys,2951,1,22,7,3,71,33,38,73
FC Basel,2951,2,18,8,6,59,26,33,62
Lucerne,2951,3,12,9,11,40,41,-1,45
St Gallen,2951,4,14,3,15,39,52,-13,45
FC Zürich,2951,5,10,11,11,44,40,4,41
Grasshoppers,2951,6,11,6,15,40,49,-9,39
FC Lugano,2951,7,10,6,16,29,46,-17,36
FC Thun,2951,8,9,6,17,43,63,-20,33
FC Sion,2951,9,6,8,18,38,53,-15,26
Young Boys,2952,1,21,8,3,73,34,39,71
FC Basel,2952,2,17,9,6,50,24,26,60
Lucerne,2952,3,13,9,10,45,44,1,48
St Gallen,2952,4,14,3,15,43,56,-13,45
FC Zürich,2952,5,10,11,11,39,36,3,41
Grasshoppers,2952,6,8,10,14,42,50,-8,34
FC Lugano,2952,7,9,7,16,31,53,-22,34
FC Thun,2952,8,9,6,17,42,57,-15,33
FC Sion,2952,9,7,9,16,42,53,-11,30
Young Boys,2953,1,23,7,2,72,33,39,76
FC Basel,2953,2,17,7,8,52,30,22,58
St Gallen,2953,3,16,2,14,45,53,-8,50
Lucerne,2953,4,12,8,12,40,44,-4,44
FC Zürich,2953,5,11,10,11,43,37,6,43
Grasshoppers,2953,6,11,6,15,47,49,-2,39
FC Lugano,2953,7,10,7,15,34,48,-14,37
FC Thun,2953,8,9,5,18,42,60,-18,32
FC Sion,2953,9,5,8,19,37,58,-21,23
Young Boys,2954,1,21,6,5,69,37,32,69
FC Basel,2954,2,18,8,6,57,29,28,62
St Gallen,2954,3,15,3,14,46,57,-11,48
Lucerne,2954,4,13,7,12,47,46,1,46
FC Zürich,2954,5,10,10,12,40,36,4,40
FC Lugano,2954,6,11,5,16,31,48,-17,38
Grasshoppers,2954,7,10,7,15,41,49,-8,37
FC Thun,2954,8,8,7,17,42,59,-17,31
FC Sion,2954,9,7,9,16,39,51,-12,30
Young Boys,2955,1,21,7,4,72,36,36,70
FC Basel,2955,2,17,9,6,54,26,28,60
St Gallen,2955,3,15,3,14,48,57,-9,48
Lucerne,2955,4,12,9,11,41,44,-3,45
FC Zürich,2955,5,10,10,12,40,36,4,40
FC Lugano,2955,6,10,6,16,31,50,-19,36
FC Sion,2955,7,9,8,15,43,52,-9,35
Grasshoppers,2955,8,9,6,17,39,49,-10,33
FC Thun,2955,9,9,6,17,40,58,-18,33
Young Boys,2956,1,22,7,3,70,34,36,73
FC Basel,2956,2,18,8,6,54,24,30,62
Lucerne,2956,3,12,10,10,42,41,1,46
St Gallen,2956,4,13,4,15,40,55,-15,43
FC Zürich,2956,5,9,11,12,37,37,0,38
Grasshoppers,2956,6,10,7,15,44,49,-5,37
FC Thun,2956,7,10,6,16,44,58,-14,36
FC Lugano,2956,8,9,7,16,28,47,-19,34
FC Sion,2956,9,7,8,17,42,56,-14,29
Young Boys,2957,1,21,6,5,67,36,31,69
FC Basel,2957,2,17,9,6,52,26,26,60
Lucerne,2957,3,14,7,11,48,46,2,49
FC Zürich,2957,4,11,9,12,42,37,5,42
St Gallen,2957,5,13,3,16,42,58,-16,42
FC Lugano,2957,6,12,5,15,34,45,-11,41
Grasshoppers,2957,7,9,7,16,42,53,-11,34
FC Thun,2957,8,9,7,16,45,61,-16,34
FC Sion,2957,9,8,7,17,45,55,-10,31
Young Boys,2958,1,21,8,3,73,38,35,71
FC Basel,2958,2,18,8,6,58,24,34,62
St Gallen,2958,3,15,4,13,47,52,-5,49
Lucerne,2958,4,12,9,11,41,50,-9,45
FC Zürich,2958,5,9,11,12,40,39,1,38
Grasshoppers,2958,6,10,7,15,43,53,-10,37
FC Thun,2958,7,10,6,16,47,60,-13,36
FC Lugano,2958,8,9,8,15,31,47,-16,35
FC Sion,2958,9,6,7,19,41,58,-17,25
Young Boys,2959,1,23,6,3,73,35,38,75
FC Basel,2959,2,18,7,7,59,26,33,61
FC Zürich,2959,3,12,10,10,41,34,7,46
Lucerne,2959,4,12,9,11,40,46,-6,45
St Gallen,2959,5,14,3,15,44,58,-14,45
Grasshoppers,2959,6,9,7,16,39,48,-9,34
FC Lugano,2959,7,9,6,17,28,49,-21,33
FC Thun,2959,8,9,5,18,40,60,-20,32
FC Sion,2959,9,8,7,17,43,51,-8,31
Young Boys,2960,1,21,9,2,72,35,37,72
FC Basel,2960,2,18,7,7,52,27,25,61
Lucerne,2960,3,13,7,12,41,42,-1,46
St Gallen,2960,4,14,3,15,41,55,-14,45
FC Zürich,2960,5,11,10,11,41,36,5,43
FC Lugano,2960,6,10,7,15,32,44,-12,37
Grasshoppers,2960,7,9,8,15,43,50,-7,35
FC Thun,2960,8,9,6,17,44,60,-16,33
FC Sion,2960,9,6,9,17,41,58,-17,27
Young Boys,2961,1,20,8,4,69,37,32,68
FC Basel,2961,2,16,9,7,52,30,22,57
FC Zürich,2961,3,12,10,10,45,35,10,46
Lucerne,2961,4,12,10,10,45,47,-2,46
St Gallen,2961,5,14,3,15,45,56,-11,45
FC Lugano,2961,6,11,7,14,32,45,-13,40
FC Thun,2961,7,10,5,17,44,59,-15,35
Grasshoppers,2961,8,8,7,17,41,52,-11,31
FC Sion,2961,9,8,7,17,44,56,-12,31
Young Boys,2962,1,21,6,5,72,39,33,69
FC Basel,2962,2,18,8,6,54,27,27,62
Lucerne,2962,3,14,8,10,45,43,2,50
St Gallen,2962,4,15,2,15,45,53,-8,47
FC Zürich,2962,5,10,10,12,39,38,1,40
FC Lugano,2962,6,11,6,15,35,49,-14,39
FC Thun,2962,7,10,5,17,47,59,-12,35
Grasshoppers,2962,8,9,7,16,41,51,-10,34
FC Sion,2962,9,6,8,18,38,57,-19,26
Young Boys,2963,1,22,7,3,71,33,38,73
FC Basel,2963,2,19,7,6,55,25,30,64
Lucerne,2963,3,14,7,11,42,42,0,49
FC Zürich,2963,4,11,10,11,43,35,8,43
St Gallen,2963,5,13,2,17,39,55,-16,41
FC Lugano,2963,6,11,6,15,30,44,-14,39
Grasshoppers,2963,7,9,7,16,39,51,-12,34
FC Thun,2963,8,9,5,18,44,57,-13,32
FC Sion,2963,9,7,7,18,37,58,-21,28
Young Boys,2964,1,22,6,4,70,36,34,72
FC Basel,2964,2,17,7,8,53,29,24,58
St Gallen,2964,3,14,4,14,44,54,-10,46
FC Zürich,2964,4,12,9,11,43,37,6,45
Lucerne,2964,5,12,7,13,39,45,-6,43
FC Thun,2964,6,11,6,15,45,56,-11,39
Grasshoppers,2964,7,10,7,15,42,49,-7,37
FC Lugano,2964,8,9,6,17,28,46,-18,33
FC Sion,2964,9,6,10,16,40,52,-12,28
Young Boys,2965,1,23,7,2,73,30,43,76
FC Basel,2965,2,17,8,7,53,28,25,59
St Gallen,2965,3,15,3,14,44,53,-9,48
FC Zürich,2965,4,12,10,10,47,36,11,46
Lucerne,2965,5,12,7,13,40,47,-7,43
FC Lugano,2965,6,11,5,16,31,51,-20,38
Grasshoppers,2965,7,9,7,16,42,51,-9,34
FC Thun,2965,8,9,7,16,46,60,-14,34
FC Sion,2965,9,5,8,19,40,60,-20,23
Young Boys,2966,1,22,7,3,71,34,37,73
FC Basel,2966,2,17,8,7,53,30,23,59
St Gallen,2966,3,16,3,13,50,55,-5,51
Lucerne,2966,4,13,7,12,39,42,-3,46
FC Zürich,2966,5,10,10,12,39,36,3,40
Grasshoppers,2966,6,10,6,16,42,47,-5,36
FC Thun,2966,7,9,7,16,42,57,-15,34
FC Lugano,2966,8,9,7,16,29,46,-17,34
FC Sion,2966,9,6,9,17,39,57,-18,27
Young Boys,2967,1,21,8,3,69,33,36,71
FC Basel,2967,2,17,9,6,53,24,29,60
Lucerne,2967,3,13,7,12,44,47,-3,46
St Gallen,2967,4,14,3,15,42,53,-11,45
FC Zürich,2967,5,11,11,10,40,34,6,44
Grasshoppers,2967,6,11,7,14,46,51,-5,40
FC Lugano,2967,7,10,6,16,29,47,-18,36
FC Thun,2967,8,9,6,17,42,59,-17,33
FC Sion,2967,9,6,7,19,39,56,-17,25
Young Boys,2968,1,22,7,3,71,34,37,73
FC Basel,2968,2,16,9,7,49,25,24,57
St Gallen,2968,3,16,2,14,44,52,-8,50
Lucerne,2968,4,13,9,10,43,43,0,48
FC Thun,2968,5,11,6,15,45,54,-9,39
FC Zürich,2968,6,9,11,12,39,39,0,38
Grasshoppers,2968,7,9,9,14,39,46,-7,36
FC Lugano,2968,8,10,5,17,29,49,-20,35
FC Sion,2968,9,5,8,19,37,54,-17,23
Young Boys,2969,1,23,6,3,79,38,41,75
FC Basel,2969,2,17,8,7,54,27,27,59
Lucerne,2969,3,14,7,11,49,47,2,49
St Gallen,2969,4,14,4,14,45,58,-13,46
FC Zürich,2969,5,10,10,12,40,39,1,40
Grasshoppers,2969,6,10,6,16,41,51,-10,36
FC Lugano,2969,7,10,6,16,33,51,-18,36
FC Sion,2969,8,7,9,16,43,53,-10,30
FC Thun,2969,9,8,6,18,40,60,-20,30
Young Boys,2970,1,22,6,4,78,37,41,72
FC Basel,2970,2,18,7,7,55,26,29,61
Lucerne,2970,3,14,7,11,43,46,-3,49
St Gallen,2970,4,15,2,15,47,56,-9,47
FC Zürich,2970,5,11,10,11,45,37,8,43
Grasshoppers,2970,6,10,6,16,41,48,-7,36
FC Thun,2970,7,10,6,16,46,60,-14,36
FC Lugano,2970,8,10,5,17,32,57,-25,35
FC Sion,2970,9,5,9,18,39,59,-20,24
Young Boys,2971,1,22,6,4,72,35,37,72
FC Basel,2971,2,18,8,6,52,25,27,62
St Gallen,2971,3,15,3,14,45,54,-9,48
Lucerne,2971,4,12,8,12,38,45,-7,44
FC Zürich,2971,5,10,10,12,39,37,2,40
Grasshoppers,2971,6,11,6,15,46,48,-2,39
FC Lugano,2971,7,10,5,17,29,47,-18,35
FC Thun,2971,8,9,6,17,44,59,-15,33
FC Sion,2971,9,7,8,17,41,56,-15,29
Young Boys,2972,1,20,6,6,66,37,29,66
FC Basel,2972,2,18,7,7,59,31,28,61
Lucerne,2972,3,15,7,10,45,41,4,52
St Gallen,2972,4,15,3,14,41,50,-9,48
FC Zürich,2972,5,9,11,12,41,41,0,38
FC Lugano,2972,6,10,6,16,31,48,-17,36
Grasshoppers,2972,7,9,8,15,41,50,-9,35
FC Thun,2972,8,9,7,16,48,62,-14,34
FC Sion,2972,9,6,11,15,40,52,-12,29
Young Boys,2973,1,22,8,2,72,34,38,74
FC Basel,2973,2,19,8,5,57,25,32,65
Lucerne,2973,3,13,8,11,44,44,0,47
FC Zürich,2973,4,11,9,12,43,38,5,42
St Gallen,2973,5,13,3,16,39,56,-17,42
FC Lugano,2973,6,11,5,16,32,47,-15,38
Grasshoppers,2973,7,9,8,15,43,50,-7,35
FC Thun,2973,8,8,6,18,45,67,-22,30
FC Sion,2973,9,6,9,17,38,52,-14,27
Young Boys,2974,1,23,7,2,78,34,44,76
FC Basel,2974,2,16,9,7,50,27,23,57
Lucerne,2974,3,15,7,10,48,46,2,52
FC Zürich,2974,4,12,10,10,43,34,9,46
St Gallen,2974,5,13,3,16,43,57,-14,42
Grasshoppers,2974,6,9,7,16,41,52,-11,34
FC Thun,2974,7,9,7,16,44,58,-14,34
FC Lugano,2974,8,9,6,17,30,51,-21,33
FC Sion,2974,9,6,8,18,41,59,-18,26
Young Boys,2975,1,22,8,2,75,36,39,74
FC Basel,2975,2,16,10,6,55,29,26,58
St Gallen,2975,3,15,2,15,44,55,-11,47
Lucerne,2975,4,12,8,12,45,49,-4,44
FC Zürich,2975,5,10,10,12,40,41,-1,40
FC Lugano,2975,6,11,5,16,35,49,-14,38
Grasshoppers,2975,7,10,7,15,43,50,-7,37
FC Thun,2975,8,10,5,17,47,59,-12,35
FC Sion,2975,9,6,9,17,40,56,-16,27
Young Boys,2976,1,23,7,2,76,31,45,76
FC Basel,2976,2,19,7,6,57,26,31,64
St Gallen,2976,3,15,3,14,45,56,-11,48
Lucerne,2976,4,12,7,13,42,46,-4,43
FC Zürich,2976,5,11,9,12,41,37,4,42
Grasshoppers,2976,6,10,6,16,42,50,-8,36
FC Thun,2976,7,9,5,18,43,65,-22,32
FC Lugano,2976,8,9,5,18,27,51,-24,32
FC Sion,2976,9,7,9,16,42,53,-11,30
Young Boys,2977,1,23,7,2,75,35,40,76
FC Basel,2977,2,15,9,8,50,30,20,54
Lucerne,2977,3,13,8,11,41,44,-3,47
FC Zürich,2977,4,11,10,11,40,35,5,43
St Gallen,2977,5,13,4,15,41,54,-13,43
Grasshoppers,2977,6,11,7,14,46,49,-3,40
FC Lugano,2977,7,10,6,16,32,48,-16,36
FC Thun,2977,8,9,7,16,46,59,-13,34
FC Sion,2977,9,6,8,18,41,58,-17,26
Young Boys,2978,1,21,6,5,76,42,34,69
FC Basel,2978,2,19,8,5,59,28,31,65
Lucerne,2978,3,13,8,11,41,42,-1,47
St Gallen,2978,4,13,4,15,43,56,-13,43
FC Zürich,2978,5,10,11,11,40,36,4,41
Grasshoppers,2978,6,10,6,16,45,52,-7,36
FC Lugano,2978,7,10,6,16,31,50,-19,36
FC Thun,2978,8,9,6,17,44,60,-16,33
FC Sion,2978,9,8,7,17,41,54,-13,31
Young Boys,2979,1,21,7,4,68,35,33,70
FC Basel,2979,2,20,7,5,57,23,34,67
St Gallen,2979,3,15,3,14,44,53,-9,48
Lucerne,2979,4,11,9,12,39,46,-7,42
FC Zürich,2979,5,10,9,13,38,38,0,39
FC Thun,2979,6,11,5,16,44,58,-14,38
FC Lugano,2979,7,10,5,17,32,48,-16,35
Grasshoppers,2979,8,9,7,16,39,48,-9,34
FC Sion,2979,9,7,8,17,43,55,-12,29
Young Boys,2980,1,20,7,5,69,34,35,67
FC Basel,2980,2,18,9,5,54,24,30,63
Lucerne,2980,3,14,7,11,45,44,1,49
St Gallen,2980,4,14,2,16,43,58,-15,44
FC Zürich,2980,5,11,10,11,42,37,5,43
FC Lugano,2980,6,10,6,16,28,49,-21,36
FC Sion,2980,7,9,7,16,47,55,-8,34
Grasshoppers,2980,8,9,6,17,39,50,-11,33
FC Thun,2980,9,9,6,17,44,60,-16,33
Young Boys,2981,1,21,7,4,69,37,32,70
FC Basel,2981,2,18,9,5,53,25,28,63
Lucerne,2981,3,13,8,11,45,42,3,47
St Gallen,2981,4,14,3,15,42,54,-12,45
FC Zürich,2981,5,11,10,11,41,37,4,43
FC Lugano,2981,6,11,5,16,33,50,-17,38
Grasshoppers,2981,7,10,6,16,44,50,-6,36
FC Thun,2981,8,10,6,16,44,58,-14,36
FC Sion,2981,9,5,8,19,38,56,-18,23
Young Boys,2982,1,20,6,6,70,38,32,66
FC Basel,2982,2,19,8,5,59,25,34,65
Lucerne,2982,3,13,8,11,42,44,-2,47
St Gallen,2982,4,13,4,15,44,58,-14,43
FC Lugano,2982,5,11,6,15,33,49,-16,39
FC Zürich,2982,6,9,11,12,40,39,1,38
FC Thun,2982,7,11,5,16,46,61,-15,38
Grasshoppers,2982,8,10,6,16,41,49,-8,36
FC Sion,2982,9,7,8,17,41,53,-12,29
Young Boys,2983,1,22,7,3,75,36,39,73
FC Basel,2983,2,16,10,6,52,26,26,58
Lucerne,2983,3,13,8,11,40,43,-3,47
St Gallen,2983,4,14,4,14,42,56,-14,46
FC Zürich,2983,5,11,10,11,42,36,6,43
Grasshoppers,2983,6,11,7,14,44,47,-3,40
FC Lugano,2983,7,9,6,17,29,50,-21,33
FC Thun,2983,8,9,5,18,40,58,-18,32
FC Sion,2983,9,7,7,18,42,54,-12,28
Young Boys,2984,1,20,8,4,71,37,34,68
FC Basel,2984,2,19,7,6,54,25,29,64
St Gallen,2984,3,15,2,15,46,53,-7,47
FC Zürich,2984,4,11,10,11,42,35,7,43
Lucerne,2984,5,11,8,13,40,46,-6,41
FC Lugano,2984,6,11,5,16,30,49,-19,38
Grasshoppers,2984,7,9,7,16,40,52,-12,34
FC Sion,2984,8,8,9,15,41,51,-10,33
FC Thun,2984,9,9,6,17,43,59,-16,33
Young Boys,2985,1,22,7,3,72,33,39,73
FC Basel,2985,2,19,7,6,57,26,31,64
Lucerne,2985,3,14,7,11,45,45,0,49
FC Zürich,2985,4,12,10,10,42,33,9,46
St Gallen,2985,5,14,3,15,42,55,-13,45
FC Thun,2985,6,9,7,16,43,60,-17,34
FC Lugano,2985,7,9,6,17,29,49,-20,33
Grasshoppers,2985,8,8,8,16,39,49,-10,32
FC Sion,2985,9,5,9,18,39,58,-19,24
Young Boys,2986,1,22,7,3,74,35,39,73
FC Basel,2986,2,19,7,6,54,23,31,64
Lucerne,2986,3,12,9,11,43,47,-4,45
St Gallen,2986,4,14,2,16,42,53,-11,44
FC Lugano,2986,5,11,5,16,32,51,-19,38
FC Zürich,2986,6,9,10,13,38,38,0,37
FC Thun,2986,7,10,5,17,45,60,-15,35
FC Sion,2986,8,8,9,15,41,49,-8,33
Grasshoppers,2986,9,8,8,16,40,53,-13,32
Young Boys,2987,1,24,6,2,74,33,41,78
FC Basel,2987,2,17,8,7,54,30,24,59
St Gallen,2987,3,14,3,15,43,59,-16,45
FC Zürich,2987,4,10,10,12,39,35,4,40
Lucerne,2987,5,11,7,14,43,51,-8,40
FC Lugano,2987,6,11,6,15,33,47,-14,39
FC Thun,2987,7,10,6,16,45,56,-11,36
Grasshoppers,2987,8,10,6,16,40,52,-12,36
FC Sion,2987,9,7,8,17,44,52,-8,29
Young Boys,2988,1,24,6,2,83,33,50,78
FC Basel,2988,2,18,8,6,54,25,29,62
Lucerne,2988,3,13,9,10,43,46,-3,48
St Gallen,2988,4,13,3,16,41,55,-14,42
FC Zürich,2988,5,9,10,13,38,37,1,37
FC Lugano,2988,6,10,7,15,32,51,-19,37
FC Thun,2988,7,10,5,17,43,59,-16,35
Grasshoppers,2988,8,8,7,17,40,54,-14,31
FC Sion,2988,9,7,9,16,39,53,-14,30
Young Boys,2989,1,20,8,4,71,41,30,68
FC Basel,2989,2,16,9,7,51,27,24,57
St Gallen,2989,3,15,3,14,43,53,-10,48
Lucerne,2989,4,12,8,12,45,47,-2,44
Grasshoppers,2989,5,11,7,14,47,47,0,40
FC Lugano,2989,6,11,6,15,33,47,-14,39
FC Zürich,2989,7,9,11,12,39,37,2,38
FC Sion,2989,8,8,9,15,42,52,-10,33
FC Thun,2989,9,8,7,17,41,61,-20,31
Young Boys,2990,1,21,7,4,67,32,35,70
FC Basel,2990,2,18,8,6,51,23,28,62
Lucerne,2990,3,14,8,10,46,40,6,50
St Gallen,2990,4,14,2,16,42,56,-14,44
FC Zürich,2990,5,10,10,12,40,40,0,40
FC Lugano,2990,6,11,6,15,33,49,-16,39
Grasshoppers,2990,7,10,7,15,42,50,-8,37
FC Thun,2990,8,9,6,17,45,59,-14,33
FC Sion,2990,9,6,8,18,38,55,-17,26
Young Boys,2991,1,23,7,2,77,35,42,76
FC Basel,2991,2,17,8,7,51,25,26,59
Lucerne,2991,3,14,8,10,45,42,3,50
FC Zürich,2991,4,12,10,10,45,34,11,46
St Gallen,2991,5,14,4,14,45,56,-11,46
Grasshoppers,2991,6,10,6,16,43,48,-5,36
FC Lugano,2991,7,9,6,17,30,53,-23,33
FC Thun,2991,8,9,5,18,43,63,-20,32
FC Sion,2991,9,5,8,19,42,65,-23,23
Young Boys,2992,1,23,6,3,78,33,45,75
FC Basel,2992,2,19,8,5,57,21,36,65
Lucerne,2992,3,12,8,12,41,46,-5,44
St Gallen,2992,4,14,2,16,39,57,-18,44
FC Zürich,2992,5,11,10,11,40,36,4,43
FC Thun,2992,6,11,5,16,47,59,-12,38
Grasshoppers,2992,7,10,6,16,40,50,-10,36
FC Lugano,2992,8,10,6,16,31,48,-17,36
FC Sion,2992,9,5,7,20,34,57,-23,22
Young Boys,2993,1,21,8,3,71,34,37,71
FC Basel,2993,2,16,10,6,50,25,25,58
Lucerne,2993,3,12,10,10,44,43,1,46
St Gallen,2993,4,14,2,16,41,56,-15,44
FC Zürich,2993,5,11,10,11,41,37,4,43
FC Thun,2993,6,10,7,15,48,56,-8,37
FC Lugano,2993,7,10,7,15,31,45,-14,37
Grasshoppers,2993,8,8,7,17,37,55,-18,31
FC Sion,2993,9,7,9,16,43,55,-12,30
Young Boys,2994,1,21,8,3,70,32,38,71
FC Basel,2994,2,18,8,6,54,22,32,62
Lucerne,2994,3,16,7,9,46,39,7,55
FC Zürich,2994,4,11,9,12,40,38,2,42
St Gallen,2994,5,13,3,16,42,60,-18,42
FC Lugano,2994,6,10,6,16,32,52,-20,36
Grasshoppers,2994,7,9,7,16,39,48,-9,34
FC Thun,2994,8,9,6,17,40,60,-20,33
FC Sion,2994,9,6,8,18,43,55,-12,26
Young Boys,2995,1,20,10,2,73,37,36,70
FC Basel,2995,2,18,8,6,54,25,29,62
Lucerne,2995,3,13,8,11,44,42,2,47
St Gallen,2995,4,14,3,15,39,54,-15,45
FC Zürich,2995,5,10,11,11,40,36,4,41
Grasshoppers,2995,6,10,7,15,45,51,-6,37
FC Lugano,2995,7,10,6,16,32,48,-16,36
FC Thun,2995,8,8,7,17,43,62,-19,31
FC Sion,2995,9,6,10,16,41,56,-15,28
Young Boys,2996,1,22,8,2,77,39,38,74
FC Basel,2996,2,17,8,7,53,26,27,59
Lucerne,2996,3,13,9,10,47,46,1,48
FC Zürich,2996,4,12,9,11,42,35,7,45
St Gallen,2996,5,13,3,16,39,55,-16,42
FC Lugano,2996,6,11,6,15,33,47,-14,39
Grasshoppers,2996,7,9,8,15,44,52,-8,35
FC Thun,2996,8,8,6,18,43,63,-20,30
FC Sion,2996,9,7,7,18,41,56,-15,28
Young Boys,2997,1,21,8,3,74,37,37,71
FC Basel,2997,2,16,8,8,55,32,23,56
St Gallen,2997,3,15,3,14,46,55,-9,48
FC Zürich,2997,4,11,10,11,43,37,6,43
Lucerne,2997,5,12,7,13,40,51,-11,43
FC Lugano,2997,6,12,6,14,37,43,-6,42
FC Thun,2997,7,10,7,15,46,56,-10,37
Grasshoppers,2997,8,9,7,16,40,50,-10,34
FC Sion,2997,9,5,10,17,38,58,-20,25
Young Boys,2998,1,22,6,4,73,35,38,72
FC Basel,2998,2,18,7,7,52,25,27,61
FC Zürich,2998,3,13,9,10,42,33,9,48
St Gallen,2998,4,14,3,15,42,53,-11,45
Lucerne,2998,5,12,7,13,40,46,-6,43
FC Lugano,2998,6,11,5,16,32,49,-17,38
Grasshoppers,2998,7,10,6,16,42,49,-7,36
FC Thun,2998,8,10,5,17,41,58,-17,35
FC Sion,2998,9,6,8,18,39,55,-16,26
Young Boys,2999,1,21,8,3,70,34,36,71
FC Basel,2999,2,18,8,6,56,28,28,62
Lucerne,2999,3,13,8,11,40,42,-2,47
St Gallen,2999,4,13,4,15,41,54,-13,43
FC Zürich,2999,5,10,10,12,39,38,1,40
FC Thun,2999,6,11,5,16,47,58,-11,38
FC Lugano,2999,7,10,6,16,29,45,-16,36
Grasshoppers,2999,8,9,8,15,38,46,-8,35
FC Sion,2999,9,6,9,17,39,54,-15,27
Young Boys,3000,1,21,8,3,71,36,35,71
FC Basel,3000,2,18,8,6,55,27,28,62
FC Zürich,3000,3,12,10,10,44,34,10,46
Lucerne,3000,4,13,7,12,44,46,-2,46
St Gallen,3000,5,14,2,16,41,56,-15,44
Grasshoppers,3000,6,10,6,16,41,52,-11,36
FC Lugano,3000,7,9,6,17,29,47,-18,33
FC Sion,3000,8,8,8,16,42,52,-10,32
FC Thun,3000,9,9,5,18,44,61,-17,32
Young Boys,3001,1,21,9,2,67,30,37,72
FC Basel,3001,2,16,7,9,50,29,21,55
St Gallen,3001,3,16,2,14,43,53,-10,50
Lucerne,3001,4,12,10,10,41,41,0,46
FC Zürich,3001,5,11,10,11,42,35,7,43
Grasshoppers,3001,6,9,8,15,41,48,-7,35
FC Lugano,3001,7,9,8,15,30,47,-17,35
FC Sion,3001,8,8,8,16,44,52,-8,32
FC Thun,3001,9,8,6,18,41,64,-23,30
Young Boys,3002,1,22,7,3,74,34,40,73
FC Basel,3002,2,18,9,5,54,24,30,63
Lucerne,3002,3,14,8,10,46,45,1,50
St Gallen,3002,4,14,4,14,44,56,-12,46
FC Zürich,3002,5,10,10,12,44,38,6,40
FC Thun,3002,6,11,5,16,49,58,-9,38
FC Lugano,3002,7,10,5,17,30,49,-19,35
Grasshoppers,3002,8,8,7,17,40,56,-16,31
FC Sion,3002,9,5,9,18,41,62,-21,24
Young Boys,3003,1,22,7,3,72,34,38,73
FC Basel,3003,2,19,8,5,58,24,34,65
Lucerne,3003,3,12,10,10,41,42,-1,46
St Gallen,3003,4,14,3,15,43,55,-12,45
FC Zürich,3003,5,10,10,12,42,36,6,40
Grasshoppers,3003,6,9,7,16,40,53,-13,34
FC Lugano,3003,7,9,6,17,29,48,-19,33
FC Thun,3003,8,9,6,17,41,62,-21,33
FC Sion,3003,9,7,9,16,42,54,-12,30
Young Boys,3004,1,21,7,4,73,35,38,70
FC Basel,3004,2,19,8,5,56,26,30,65
Lucerne,3004,3,12,9,11,44,45,-1,45
St Gallen,3004,4,14,2,16,41,62,-21,44
FC Zürich,3004,5,11,9,12,42,36,6,42
Grasshoppers,3004,6,10,7,15,43,49,-6,37
FC Lugano,3004,7,10,5,17,36,51,-15,35
FC Thun,3004,8,9,6,17,44,62,-18,33
FC Sion,3004,9,7,9,16,41,54,-13,30
Young Boys,3005,1,20,8,4,70,36,34,68
FC Basel,3005,2,18,9,5,52,23,29,63
Lucerne,3005,3,12,9,11,42,45,-3,45
St Gallen,3005,4,13,4,15,41,54,-13,43
FC Zürich,3005,5,10,10,12,42,39,3,40
Grasshoppers,3005,6,11,6,15,46,50,-4,39
FC Lugano,3005,7,10,8,14,32,46,-14,38
FC Sion,3005,8,8,8,16,41,54,-13,32
FC Thun,3005,9,8,6,18,42,61,-19,30
Young Boys,3006,1,22,7,3,73,36,37,73
FC Basel,3006,2,18,7,7,58,27,31,61
Lucerne,3006,3,14,7,11,42,45,-3,49
FC Zürich,3006,4,12,9,11,42,36,6,45
St Gallen,3006,5,14,2,16,41,55,-14,44
FC Lugano,3006,6,11,5,16,35,49,-14,38
FC Thun,3006,7,10,5,17,43,61,-18,35
Grasshoppers,3006,8,9,7,16,42,52,-10,34
FC Sion,3006,9,6,7,19,38,53,-15,25
Young Boys,3007,1,22,7,3,72,37,35,73
FC Basel,3007,2,17,10,5,53,24,29,61
Lucerne,3007,3,12,8,12,43,45,-2,44
St Gallen,3007,4,13,5,14,41,53,-12,44
FC Zürich,3007,5,10,11,11,42,38,4,41
Grasshoppers,3007,6,10,7,15,44,49,-5,37
FC Thun,3007,7,9,7,16,42,59,-17,34
FC Lugano,3007,8,9,7,16,30,49,-19,34
FC Sion,3007,9,7,8,17,43,56,-13,29
Young Boys,3008,1,24,6,2,75,34,41,78
FC Basel,3008,2,17,7,8,57,29,28,58
St Gallen,3008,3,17,2,13,47,54,-7,53
FC Zürich,3008,4,11,11,10,42,36,6,44
Lucerne,3008,5,11,7,14,42,51,-9,40
Grasshoppers,3008,6,10,6,16,42,50,-8,36
FC Lugano,3008,7,10,6,16,34,51,-17,36
FC Thun,3008,8,10,5,17,43,58,-15,35
FC Sion,3008,9,5,8,19,40,59,-19,23
Young Boys,3009,1,21,6,5,71,39,32,69
FC Basel,3009,2,18,7,7,57,28,29,61
Lucerne,3009,3,14,9,9,44,41,3,51
FC Zürich,3009,4,13,9,10,45,34,11,48
St Gallen,3009,5,13,4,15,41,55,-14,43
FC Lugano,3009,6,10,5,17,29,48,-19,35
Grasshoppers,3009,7,9,7,16,42,49,-7,34
FC Thun,3009,8,9,6,17,43,59,-16,33
FC Sion,3009,9,6,9,17,43,62,-19,27
Young Boys,3010,1,23,7,2,74,32,42,76
FC Basel,3010,2,17,7,8,53,27,26,58
Lucerne,3010,3,14,9,9,44,41,3,51
St Gallen,3010,4,16,3,13,45,53,-8,51
FC Zürich,3010,5,11,9,12,42,42,0,42
FC Lugano,3010,6,10,5,17,33,48,-15,35
Grasshoppers,3010,7,9,6,17,42,54,-12,33
FC Thun,3010,8,9,6,17,47,65,-18,33
FC Sion,3010,9,5,8,19,39,57,-18,23
Young Boys,3011,1,23,6,3,75,35,40,75
FC Basel,3011,2,17,9,6,50,25,25,60
Lucerne,3011,3,13,8,11,41,43,-2,47
FC Lugano,3011,4,12,5,15,41,47,-6,41
St Gallen,3011,5,13,2,17,41,59,-18,41
FC Zürich,3011,6,10,9,13,42,39,3,39
FC Thun,3011,7,11,6,15,48,55,-7,39
FC Sion,3011,8,8,7,17,42,60,-18,31
Grasshoppers,3011,9,8,6,18,40,57,-17,30
Young Boys,3012,1,22,7,3,74,35,39,73
FC Basel,3012,2,19,8,5,60,25,35,65
Lucerne,3012,3,13,9,10,47,44,3,48
St Gallen,3012,4,14,5,13,45,55,-10,47
FC Zürich,3012,5,11,9,12,42,40,2,42
FC Thun,3012,6,9,7,16,44,61,-17,34
FC Lugano,3012,7,9,5,18,29,51,-22,32
Grasshoppers,3012,8,8,7,17,39,54,-15,31
FC Sion,3012,9,6,9,17,41,56,-15,27
Young Boys,3013,1,22,7,3,78,36,42,73
FC Basel,3013,2,18,7,7,54,26,28,61
Lucerne,3013,3,14,8,10,41,40,1,50
St Gallen,3013,4,16,2,14,43,52,-9,50
FC Zürich,3013,5,11,9,12,40,36,4,42
FC Lugano,3013,6,10,6,16,32,49,-17,36
FC Thun,3013,7,9,6,17,46,59,-13,33
Grasshoppers,3013,8,8,8,16,40,53,-13,32
FC Sion,3013,9,6,7,19,37,60,-23,25
Young Boys,3014,1,22,7,3,71,35,36,73
FC Basel,3014,2,19,7,6,62,23,39,64
FC Zürich,3014,3,13,9,10,41,32,9,48
Lucerne,3014,4,13,8,11,40,44,-4,47
St Gallen,3014,5,14,3,15,39,53,-14,45
Grasshoppers,3014,6,9,7,16,38,47,-9,34
FC Lugano,3014,7,9,7,16,30,47,-17,34
FC Thun,3014,8,8,5,19,41,66,-25,29
FC Sion,3014,9,6,9,17,36,51,-15,27
Young Boys,3015,1,21,7,4,68,35,33,70
FC Basel,3015,2,19,7,6,61,28,33,64
Lucerne,3015,3,13,9,10,43,43,0,48
FC Zürich,3015,4,11,10,11,42,37,5,43
St Gallen,3015,5,13,4,15,44,61,-17,43
FC Lugano,3015,6,10,7,15,31,47,-16,37
Grasshoppers,3015,7,9,7,16,41,50,-9,34
FC Thun,3015,8,9,6,17,43,60,-17,33
FC Sion,3015,9,7,7,18,42,54,-12,28
Young Boys,3016,1,22,6,4,74,36,38,72
FC Basel,3016,2,18,8,6,58,27,31,62
Lucerne,3016,3,14,7,11,44,43,1,49
St Gallen,3016,4,14,4,14,44,54,-10,46
FC Zürich,3016,5,10,9,13,38,36,2,39
FC Thun,3016,6,11,5,16,45,59,-14,38
FC Lugano,3016,7,10,5,17,29,49,-20,35
Grasshoppers,3016,8,9,6,17,37,49,-12,33
FC Sion,3016,9,7,8,17,38,54,-16,29
Young Boys,3017,1,23,6,3,75,35,40,75
FC Basel,3017,2,16,8,8,49,26,23,56
St Gallen,3017,3,15,4,13,45,53,-8,49
Lucerne,3017,4,13,7,12,44,49,-5,46
FC Zürich,3017,5,12,9,11,41,34,7,45
Grasshoppers,3017,6,11,6,15,42,47,-5,39
FC Lugano,3017,7,10,6,16,34,51,-17,36
FC Thun,3017,8,9,5,18,42,60,-18,32
FC Sion,3017,9,6,7,19,39,56,-17,25
Young Boys,3018,1,21,7,4,70,34,36,70
FC Basel,3018,2,18,9,5,54,24,30,63
Lucerne,3018,3,14,7,11,43,41,2,49
St Gallen,3018,4,14,3,15,41,53,-12,45
FC Zürich,3018,5,10,11,11,40,37,3,41
FC Lugano,3018,6,11,5,16,33,50,-17,38
FC Thun,3018,7,10,6,16,44,58,-14,36
Grasshoppers,3018,8,9,6,17,44,57,-13,33
FC Sion,3018,9,6,8,18,42,57,-15,26
Young Boys,3019,1,20,7,5,70,41,29,67
FC Basel,3019,2,18,7,7,58,26,32,61
St Gallen,3019,3,14,3,15,42,54,-12,45
FC Lugano,3019,4,12,6,14,32,44,-12,42
FC Zürich,3019,5,10,11,11,42,37,5,41
Lucerne,3019,6,11,8,13,43,53,-10,41
Grasshoppers,3019,7,11,7,14,48,47,1,40
FC Thun,3019,8,9,6,17,43,63,-20,33
FC Sion,3019,9,7,9,16,42,55,-13,30
Young Boys,3020,1,21,8,3,71,35,36,71
FC Basel,3020,2,17,8,7,54,28,26,59
St Gallen,3020,3,15,4,13,45,52,-7,49
Lucerne,3020,4,13,9,10,39,40,-1,48
FC Zürich,3020,5,11,10,11,42,37,5,43
Grasshoppers,3020,6,9,8,15,44,50,-6,35
FC Lugano,3020,7,9,7,16,30,48,-18,34
FC Thun,3020,8,9,6,17,42,59,-17,33
FC Sion,3020,9,6,8,18,37,55,-18,26
Young Boys,3021,1,21,7,4,71,36,35,70
FC Basel,3021,2,17,9,6,54,28,26,60
St Gallen,3021,3,16,3,13,44,52,-8,51
Lucerne,3021,4,13,8,11,46,48,-2,47
FC Zürich,3021,5,10,11,11,45,40,5,41
Grasshoppers,3021,6,11,6,15,42,48,-6,39
FC Lugano,3021,7,10,5,17,33,49,-16,35
FC Thun,3021,8,9,5,18,42,60,-18,32
FC Sion,3021,9,6,8,18,42,58,-16,26
Young Boys,3022,1,24,6,2,80,36,44,78
FC Basel,3022,2,18,7,7,53,27,26,61
Lucerne,3022,3,12,9,11,44,47,-3,45
St Gallen,3022,4,14,2,16,42,56,-14,44
FC Zürich,3022,5,10,9,13,41,39,2,39
FC Lugano,3022,6,11,6,15,38,53,-15,39
FC Thun,3022,7,10,6,16,43,58,-15,36
Grasshoppers,3022,8,9,7,16,39,47,-8,34
FC Sion,3022,9,6,8,18,39,56,-17,26
Young Boys,3023,1,22,6,4,72,33,39,72
FC Basel,3023,2,20,7,5,57,24,33,67
Lucerne,3023,3,14,7,11,43,44,-1,49
FC Zürich,3023,4,11,9,12,41,35,6,42
FC Lugano,3023,5,12,5,15,32,44,-12,41
St Gallen,3023,6,13,2,17,43,61,-18,41
Grasshoppers,3023,7,9,6,17,39,51,-12,33
FC Thun,3023,8,9,6,17,44,58,-14,33
FC Sion,3023,9,6,8,18,38,59,-21,26
Young Boys,3024,1,22,6,4,68,36,32,72
FC Basel,3024,2,20,7,5,57,23,34,67
St Gallen,3024,3,15,2,15,45,57,-12,47
Lucerne,3024,4,12,8,12,42,43,-1,44
FC Zürich,3024,5,10,9,13,37,38,-1,39
FC Thun,3024,6,10,5,17,44,60,-16,35
FC Sion,3024,7,9,7,16,45,51,-6,34
Grasshoppers,3024,8,9,6,17,39,50,-11,33
FC Lugano,3024,9,9,6,17,30,49,-19,33
Young Boys,3025,1,21,8,3,70,36,34,71
FC Basel,3025,2,19,8,5,55,23,32,65
St Gallen,3025,3,15,2,15,45,52,-7,47
Lucerne,3025,4,11,9,12,36,43,-7,42
FC Zürich,3025,5,10,10,12,42,38,4,40
FC Thun,3025,6,11,5,16,44,55,-11,38
FC Lugano,3025,7,10,7,15,31,47,-16,37
Grasshoppers,3025,8,9,8,15,39,47,-8,35
FC Sion,3025,9,6,7,19,38,59,-21,25
Young Boys,3026,1,22,6,4,75,32,43,72
FC Basel,3026,2,18,8,6,55,28,27,62
St Gallen,3026,3,14,3,15,42,54,-12,45
Lucerne,3026,4,11,8,13,41,50,-9,41
FC Lugano,3026,5,11,6,15,34,51,-17,39
FC Zürich,3026,6,9,11,12,43,41,2,38
Grasshoppers,3026,7,10,7,15,39,47,-8,37
FC Thun,3026,8,9,7,16,41,56,-15,34
FC Sion,3026,9,7,10,15,42,53,-11,31
Young Boys,3027,1,23,7,2,73,31,42,76
FC Basel,3027,2,18,8,6,54,26,28,62
St Gallen,3027,3,14,4,14,42,54,-12,46
Lucerne,3027,4,12,8,12,44,47,-3,44
FC Zürich,3027,5,10,10,12,39,37,2,40
FC Lugano,3027,6,10,7,15,30,45,-15,37
FC Thun,3027,7,9,6,17,43,59,-16,33
Grasshoppers,3027,8,8,7,17,38,54,-16,31
FC Sion,3027,9,7,9,16,43,53,-10,30
Young Boys,3028,1,21,6,5,71,36,35,69
FC Basel,3028,2,19,7,6,53,23,30,64
Lucerne,3028,3,13,8,11,42,45,-3,47
FC Zürich,3028,4,11,10,11,42,36,6,43
St Gallen,3028,5,13,2,17,39,56,-17,41
FC Lugano,3028,6,11,6,15,33,47,-14,39
Grasshoppers,3028,7,10,7,15,44,51,-7,37
FC Thun,3028,8,10,5,17,43,58,-15,35
FC Sion,3028,9,7,7,18,41,56,-15,28
Young Boys,3029,1,22,6,4,79,38,41,72
FC Basel,3029,2,17,10,5,54,25,29,61
St Gallen,3029,3,16,3,13,48,53,-5,51
Lucerne,3029,4,13,9,10,44,45,-1,48
FC Zürich,3029,5,11,10,11,40,35,5,43
Grasshoppers,3029,6,10,6,16,49,53,-4,36
FC Lugano,3029,7,10,6,16,33,49,-16,36
FC Thun,3029,8,8,5,19,39,67,-28,29
FC Sion,3029,9,6,7,19,43,64,-21,25
Young Boys,3030,1,22,6,4,74,37,37,72
FC Basel,3030,2,18,8,6,58,26,32,62
FC Zürich,3030,3,11,11,10,44,34,10,44
Lucerne,3030,4,11,10,11,40,47,-7,43
St Gallen,3030,5,13,3,16,43,60,-17,42
Grasshoppers,3030,6,10,7,15,48,52,-4,37
FC Lugano,3030,7,10,7,15,31,46,-15,37
FC Thun,3030,8,9,5,18,42,64,-22,32
FC Sion,3030,9,8,7,17,42,56,-14,31
Young Boys,3031,1,22,8,2,73,33,40,74
FC Basel,3031,2,15,9,8,47,25,22,54
FC Zürich,3031,3,13,9,10,45,34,11,48
St Gallen,3031,4,15,3,14,43,54,-11,48
Lucerne,3031,5,13,8,11,41,44,-3,47
Grasshoppers,3031,6,9,8,15,41,50,-9,35
FC Lugano,3031,7,9,6,17,29,49,-20,33
FC Sion,3031,8,7,9,16,43,55,-12,30
FC Thun,3031,9,8,6,18,40,58,-18,30
Young Boys,3032,1,21,8,3,69,34,35,71
FC Basel,3032,2,19,8,5,59,26,33,65
FC Zürich,3032,3,12,9,11,46,39,7,45
Lucerne,3032,4,12,8,12,42,47,-5,44
St Gallen,3032,5,13,3,16,41,58,-17,42
FC Lugano,3032,6,11,5,16,33,49,-16,38
Grasshoppers,3032,7,10,6,16,39,50,-11,36
FC Thun,3032,8,10,5,17,51,62,-11,35
FC Sion,3032,9,6,8,18,42,57,-15,26
Young Boys,3033,1,21,6,5,72,39,33,69
FC Basel,3033,2,17,9,6,54,29,25,60
St Gallen,3033,3,16,2,14,46,56,-10,50
Lucerne,3033,4,12,9,11,44,47,-3,45
FC Zürich,3033,5,10,10,12,42,40,2,40
FC Lugano,3033,6,11,6,15,39,51,-12,39
FC Thun,3033,7,11,5,16,47,59,-12,38
Grasshoppers,3033,8,10,6,16,45,51,-6,36
FC Sion,3033,9,6,7,19,42,59,-17,25
Young Boys,3034,1,20,9,3,73,35,38,69
FC Basel,3034,2,18,8,6,52,25,27,62
Lucerne,3034,3,14,9,9,44,39,5,51
St Gallen,3034,4,15,2,15,43,54,-11,47
FC Zürich,3034,5,9,12,11,41,39,2,39
FC Lugano,3034,6,10,6,16,29,50,-21,36
Grasshoppers,3034,7,9,8,15,43,52,-9,35
FC Thun,3034,8,8,7,17,45,62,-17,31
FC Sion,3034,9,6,9,17,41,55,-14,27
Young Boys,3035,1,23,7,2,74,33,41,76
FC Basel,3035,2,16,9,7,50,27,23,57
Lucerne,3035,3,13,8,11,41,42,-1,47
St Gallen,3035,4,14,4,14,42,52,-10,46
FC Zürich,3035,5,10,11,11,45,38,7,41
Grasshoppers,3035,6,10,6,16,42,52,-10,36
FC Lugano,3035,7,10,6,16,31,49,-18,36
FC Thun,3035,8,10,5,17,47,59,-12,35
FC Sion,3035,9,6,8,18,41,61,-20,26
Young Boys,3036,1,20,8,4,73,37,36,68
FC Basel,3036,2,17,9,6,51,24,27,60
Lucerne,3036,3,13,8,11,48,44,4,47
St Gallen,3036,4,14,4,14,43,56,-13,46
FC Zürich,3036,5,10,10,12,40,40,0,40
FC Thun,3036,6,10,7,15,46,57,-11,37
FC Lugano,3036,7,10,6,16,35,53,-18,36
Grasshoppers,3036,8,9,8,15,42,54,-12,35
FC Sion,3036,9,7,8,17,44,57,-13,29
Young Boys,3037,1,20,8,4,66,37,29,68
FC Basel,3037,2,18,8,6,55,26,29,62
Lucerne,3037,3,14,8,10,43,39,4,50
St Gallen,3037,4,14,3,15,41,53,-12,45
FC Zürich,3037,5,11,9,12,44,39,5,42
FC Thun,3037,6,10,7,15,47,58,-11,37
Grasshoppers,3037,7,9,6,17,39,49,-10,33
FC Lugano,3037,8,9,6,17,29,49,-20,33
FC Sion,3037,9,7,9,16,40,54,-14,30
Young Boys,3038,1,21,7,4,72,37,35,70
FC Basel,3038,2,18,8,6,55,23,32,62
St Gallen,3038,3,15,3,14,44,55,-11,48
Lucerne,3038,4,12,10,10,47,43,4,46
FC Lugano,3038,5,12,5,15,32,46,-14,41
FC Zürich,3038,6,10,9,13,39,39,0,39
Grasshoppers,3038,7,11,6,15,45,54,-9,39
FC Thun,3038,8,8,6,18,44,65,-21,30
FC Sion,3038,9,6,8,18,42,58,-16,26
Young Boys,3039,1,21,6,5,67,38,29,69
FC Basel,3039,2,19,8,5,58,26,32,65
St Gallen,3039,3,15,3,14,42,51,-9,48
Lucerne,3039,4,12,9,11,40,44,-4,45
FC Zürich,3039,5,10,12,10,43,37,6,42
Grasshoppers,3039,6,10,7,15,41,47,-6,37
FC Thun,3039,7,9,6,17,42,58,-16,33
FC Lugano,3039,8,9,5,18,28,48,-20,32
FC Sion,3039,9,7,8,17,42,54,-12,29
Young Boys,3040,1,19,11,2,68,34,34,68
FC Basel,3040,2,18,8,6,61,27,34,62
Lucerne,3040,3,13,9,10,46,48,-2,48
St Gallen,3040,4,14,3,15,42,53,-11,45
FC Zürich,3040,5,10,9,13,42,43,-1,39
FC Lugano,3040,6,10,7,15,32,47,-15,37
FC Sion,3040,7,9,8,15,42,49,-7,35
Grasshoppers,3040,8,8,9,15,41,51,-10,33
FC Thun,3040,9,8,6,18,41,63,-22,30
Young Boys,3041,1,21,7,4,68,37,31,70
FC Basel,3041,2,20,7,5,60,23,37,67
Lucerne,3041,3,14,7,11,45,43,2,49
St Gallen,3041,4,13,3,16,43,59,-16,42
FC Zürich,3041,5,10,10,12,40,36,4,40
Grasshoppers,3041,6,10,7,15,44,47,-3,37
FC Lugano,3041,7,10,5,17,30,49,-19,35
FC Thun,3041,8,8,7,17,40,64,-24,31
FC Sion,3041,9,6,11,15,41,53,-12,29
Young Boys,3042,1,23,7,2,74,30,44,76
FC Basel,3042,2,16,9,7,51,28,23,57
St Gallen,3042,3,15,4,13,43,51,-8,49
FC Zürich,3042,4,11,10,11,43,38,5,43
Lucerne,3042,5,12,7,13,41,47,-6,43
Grasshoppers,3042,6,10,7,15,39,47,-8,37
FC Thun,3042,7,10,6,16,45,57,-12,36
FC Lugano,3042,8,10,6,16,32,49,-17,36
FC Sion,3042,9,5,8,19,35,56,-21,23
Young Boys,3043,1,22,7,3,73,33,40,73
FC Basel,3043,2,18,8,6,56,28,28,62
St Gallen,3043,3,15,3,14,43,52,-9,48
Lucerne,3043,4,13,7,12,42,47,-5,46
FC Zürich,3043,5,12,9,11,45,37,8,45
Grasshoppers,3043,6,10,6,16,48,51,-3,36
FC Thun,3043,7,10,5,17,45,59,-14,35
FC Lugano,3043,8,10,5,17,29,50,-21,35
FC Sion,3043,9,5,8,19,37,61,-24,23
Young Boys,3044,1,21,6,5,71,38,33,69
FC Basel,3044,2,18,7,7,58,31,27,61
St Gallen,3044,3,15,2,15,45,55,-10,47
Lucerne,3044,4,12,8,12,42,45,-3,44
Grasshoppers,3044,5,11,7,14,44,47,-3,40
FC Zürich,3044,6,10,9,13,40,38,2,39
FC Lugano,3044,7,11,5,16,31,48,-17,38
FC Thun,3044,8,10,5,17,47,64,-17,35
FC Sion,3044,9,8,7,17,45,57,-12,31
Young Boys,3045,1,22,6,4,68,32,36,72
FC Basel,3045,2,17,7,8,50,26,24,58
Lucerne,3045,3,14,7,11,42,42,0,49
St Gallen,3045,4,15,2,15,44,57,-13,47
FC Zürich,3045,5,12,10,10,44,36,8,46
Grasshoppers,3045,6,9,8,15,41,49,-8,35
FC Thun,3045,7,9,7,16,41,56,-15,34
FC Lugano,3045,8,9,5,18,30,50,-20,32
FC Sion,3045,9,6,10,16,42,54,-12,28
Young Boys,3046,1,21,9,2,67,31,36,72
FC Basel,3046,2,17,8,7,56,25,31,59
Lucerne,3046,3,14,9,9,43,40,3,51
St Gallen,3046,4,13,5,14,43,57,-14,44
FC Zürich,3046,5,11,10,11,42,37,5,43
FC Lugano,3046,6,9,7,16,32,49,-17,34
Grasshoppers,3046,7,9,6,17,40,50,-10,33
FC Thun,3046,8,9,5,18,40,62,-22,32
FC Sion,3046,9,7,9,16,40,52,-12,30
Young Boys,3047,1,21,7,4,70,36,34,70
FC Basel,3047,2,16,11,5,56,27,29,59
St Gallen,3047,3,14,4,14,46,55,-9,46
Lucerne,3047,4,11,8,13,39,47,-8,41
FC Lugano,3047,5,11,7,14,34,46,-12,40
FC Zürich,3047,6,9,12,11,41,38,3,39
Grasshoppers,3047,7,11,6,15,45,48,-3,39
FC Thun,3047,8,10,5,17,44,61,-17,35
FC Sion,3047,9,7,8,17,41,58,-17,29
Young Boys,3048,1,20,8,4,68,34,34,68
FC Basel,3048,2,19,8,5,57,25,32,65
Lucerne,3048,3,14,7,11,42,46,-4,49
St Gallen,3048,4,13,2,17,43,58,-15,41
Grasshoppers,3048,5,11,7,14,45,46,-1,40
FC Zürich,3048,6,10,9,13,40,39,1,39
FC Lugano,3048,7,11,5,16,34,50,-16,38
FC Thun,3048,8,10,6,16,43,56,-13,36
FC Sion,3048,9,6,8,18,36,54,-18,26
Young Boys,3049,1,21,6,5,70,35,35,69
FC Basel,3049,2,17,7,8,50,29,21,58
St Gallen,3049,3,15,2,15,46,57,-11,47
Lucerne,3049,4,13,7,12,45,47,-2,46
FC Lugano,3049,5,12,6,14,32,44,-12,42
FC Thun,3049,6,11,6,15,46,55,-9,39
FC Zürich,3049,7,9,11,12,37,35,2,38
Grasshoppers,3049,8,9,6,17,41,53,-12,33
FC Sion,3049,9,8,7,17,40,52,-12,31
Young Boys,3050,1,20,7,5,70,38,32,67
FC Basel,3050,2,18,9,5,59,24,35,63
Lucerne,3050,3,13,9,10,41,42,-1,48
St Gallen,3050,4,14,2,16,43,62,-19,44
FC Zürich,3050,5,10,10,12,42,37,5,40
FC Lugano,3050,6,10,6,16,31,47,-16,36
Grasshoppers,3050,7,9,8,15,39,46,-7,35
FC Sion,3050,8,9,7,16,42,50,-8,34
FC Thun,3050,9,9,6,17,42,63,-21,33
Young Boys,3051,1,21,7,4,70,38,32,70
FC Basel,3051,2,17,7,8,58,31,27,58
FC Zürich,3051,3,13,9,10,47,38,9,48
Lucerne,3051,4,13,9,10,42,43,-1,48
St Gallen,3051,5,14,3,15,45,57,-12,45
Grasshoppers,3051,6,10,7,15,44,48,-4,37
FC Thun,3051,7,10,6,16,47,60,-13,36
FC Lugano,3051,8,9,6,17,33,53,-20,33
FC Sion,3051,9,6,8,18,43,61,-18,26
Young Boys,3052,1,22,8,2,77,36,41,74
FC Basel,3052,2,17,7,8,55,33,22,58
Lucerne,3052,3,13,8,11,42,44,-2,47
FC Zürich,3052,4,10,12,10,40,34,6,42
St Gallen,3052,5,13,3,16,41,57,-16,42
Grasshoppers,3052,6,10,6,16,43,50,-7,36
FC Lugano,3052,7,9,9,14,31,46,-15,36
FC Thun,3052,8,9,7,16,45,61,-16,34
FC Sion,3052,9,6,10,16,39,52,-13,28
Young Boys,3053,1,23,7,2,77,31,46,76
FC Basel,3053,2,17,9,6,56,27,29,60
St Gallen,3053,3,14,5,13,45,54,-9,47
Lucerne,3053,4,12,8,12,39,45,-6,44
FC Zürich,3053,5,9,11,12,41,39,2,38
Grasshoppers,3053,6,9,9,14,43,50,-7,36
FC Lugano,3053,7,10,5,17,29,50,-21,35
FC Thun,3053,8,9,7,16,45,62,-17,34
FC Sion,3053,9,5,11,16,38,55,-17,26
Young Boys,3054,1,21,8,3,72,36,36,71
FC Basel,3054,2,15,8,9,50,35,15,53
Lucerne,3054,3,15,7,10,44,41,3,52
FC Zürich,3054,4,11,11,10,45,36,9,44
St Gallen,3054,5,14,2,16,44,58,-14,44
FC Thun,3054,6,10,6,16,50,58,-8,36
Grasshoppers,3054,7,10,6,16,43,51,-8,36
FC Lugano,3054,8,10,6,16,33,50,-17,36
FC Sion,3054,9,7,8,17,45,61,-16,29
Young Boys,3055,1,22,6,4,73,35,38,72
FC Basel,3055,2,16,9,7,49,25,24,57
Lucerne,3055,3,13,9,10,43,41,2,48
St Gallen,3055,4,14,4,14,41,53,-12,46
FC Zürich,3055,5,11,11,10,40,32,8,44
Grasshoppers,3055,6,10,7,15,42,49,-7,37
FC Lugano,3055,7,9,7,16,31,54,-23,34
FC Sion,3055,8,7,9,16,40,52,-12,30
FC Thun,3055,9,8,6,18,40,58,-18,30
Young Boys,3056,1,21,8,3,72,37,35,71
FC Basel,3056,2,17,10,5,52,25,27,61
Lucerne,3056,3,12,8,12,41,44,-3,44
St Gallen,3056,4,14,2,16,43,57,-14,44
FC Zürich,3056,5,11,10,11,41,35,6,43
FC Lugano,3056,6,11,5,16,35,49,-14,38
FC Thun,3056,7,10,6,16,44,59,-15,36
Grasshoppers,3056,8,9,7,16,40,50,-10,34
FC Sion,3056,9,7,8,17,42,54,-12,29
Young Boys,3057,1,21,7,4,71,38,33,70
FC Basel,3057,2,18,7,7,55,27,28,61
St Gallen,3057,3,15,2,15,43,55,-12,47
Lucerne,3057,4,12,9,11,39,42,-3,45
FC Zürich,3057,5,11,10,11,42,36,6,43
FC Thun,3057,6,10,6,16,43,55,-12,36
FC Lugano,3057,7,10,6,16,31,46,-15,36
Grasshoppers,3057,8,9,8,15,39,48,-9,35
FC Sion,3057,9,6,9,17,39,55,-16,27
Young Boys,3058,1,22,8,2,72,34,38,74
FC Basel,3058,2,16,10,6,54,27,27,58
Lucerne,3058,3,12,9,11,43,45,-2,45
FC Zürich,3058,4,11,10,11,42,37,5,43
St Gallen,3058,5,13,4,15,40,55,-15,43
FC Thun,3058,6,11,5,16,46,57,-11,38
FC Lugano,3058,7,10,6,16,33,48,-15,36
FC Sion,3058,8,8,7,17,40,52,-12,31
Grasshoppers,3058,9,8,7,17,37,52,-15,31
Young Boys,3059,1,21,8,3,70,37,33,71
FC Basel,3059,2,18,8,6,56,25,31,62
St Gallen,3059,3,17,2,13,44,49,-5,53
FC Zürich,3059,4,12,9,11,45,36,9,45
Lucerne,3059,5,12,9,11,41,42,-1,45
Grasshoppers,3059,6,9,8,15,40,49,-9,35
FC Lugano,3059,7,9,7,16,31,51,-20,34
FC Thun,3059,8,8,6,18,41,62,-21,30
FC Sion,3059,9,6,7,19,38,55,-17,25
Young Boys,3060,1,21,7,4,70,34,36,70
FC Basel,3060,2,18,8,6,54,25,29,62
St Gallen,3060,3,13,5,14,39,52,-13,44
Lucerne,3060,4,11,10,11,42,45,-3,43
FC Lugano,3060,5,12,6,14,34,44,-10,42
Grasshoppers,3060,6,11,6,15,43,48,-5,39
FC Zürich,3060,7,9,9,14,37,41,-4,36
FC Sion,3060,8,8,8,16,43,52,-9,32
FC Thun,3060,9,9,5,18,43,64,-21,32
Young Boys,3061,1,20,7,5,71,38,33,67
FC Basel,3061,2,18,8,6,55,26,29,62
St Gallen,3061,3,16,3,13,49,53,-4,51
Lucerne,3061,4,14,7,11,43,44,-1,49
FC Zürich,3061,5,10,11,11,42,40,2,41
Grasshoppers,3061,6,11,7,14,45,47,-2,40
FC Thun,3061,7,9,7,16,49,61,-12,34
FC Lugano,3061,8,9,6,17,28,51,-23,33
FC Sion,3061,9,5,8,19,41,63,-22,23
Young Boys,3062,1,23,6,3,71,32,39,75
FC Basel,3062,2,18,9,5,54,21,33,63
St Gallen,3062,3,14,4,14,44,55,-11,46
Lucerne,3062,4,12,8,12,40,48,-8,44
FC Thun,3062,5,11,5,16,48,60,-12,38
FC Zürich,3062,6,9,10,13,38,38,0,37
FC Lugano,3062,7,10,7,15,33,49,-16,37
Grasshoppers,3062,8,9,6,17,41,51,-10,33
FC Sion,3062,9,7,7,18,40,55,-15,28
Young Boys,3063,1,21,6,5,68,37,31,69
FC Basel,3063,2,17,8,7,53,26,27,59
St Gallen,3063,3,14,4,14,43,54,-11,46
Lucerne,3063,4,12,9,11,39,41,-2,45
FC Zürich,3063,5,11,10,11,44,37,7,43
Grasshoppers,3063,6,10,7,15,40,46,-6,37
FC Thun,3063,7,10,5,17,43,61,-18,35
FC Lugano,3063,8,9,7,16,28,47,-19,34
FC Sion,3063,9,8,8,16,46,55,-9,32
Young Boys,3064,1,21,7,4,73,37,36,70
FC Basel,3064,2,18,8,6,55,24,31,62
St Gallen,3064,3,15,3,14,42,53,-11,48
FC Zürich,3064,4,12,9,11,42,35,7,45
Lucerne,3064,5,12,9,11,42,45,-3,45
Grasshoppers,3064,6,10,7,15,42,48,-6,37
FC Lugano,3064,7,10,6,16,35,51,-16,36
FC Thun,3064,8,9,5,18,43,66,-23,32
FC Sion,3064,9,6,8,18,40,55,-15,26
Young Boys,3065,1,22,6,4,72,34,38,72
FC Basel,3065,2,17,8,7,49,25,24,59
Lucerne,3065,3,13,7,12,44,45,-1,46
FC Zürich,3065,4,11,10,11,44,38,6,43
St Gallen,3065,5,13,2,17,39,57,-18,41
Grasshoppers,3065,6,11,6,15,42,47,-5,39
FC Thun,3065,7,10,7,15,46,56,-10,37
FC Lugano,3065,8,10,5,17,32,54,-22,35
FC Sion,3065,9,8,7,17,40,52,-12,31
Young Boys,3066,1,22,6,4,72,38,34,72
FC Basel,3066,2,18,8,6,56,24,32,62
St Gallen,3066,3,15,4,13,43,52,-9,49
FC Zürich,3066,4,12,9,11,42,37,5,45
Lucerne,3066,5,11,7,14,39,49,-10,40
FC Thun,3066,6,11,5,16,46,59,-13,38
Grasshoppers,3066,7,10,7,15,43,49,-6,37
FC Lugano,3066,8,10,5,17,36,53,-17,35
FC Sion,3066,9,5,9,18,38,54,-16,24
Young Boys,3067,1,20,8,4,66,33,33,68
FC Basel,3067,2,16,8,8,49,27,22,56
St Gallen,3067,3,16,2,14,46,51,-5,50
Lucerne,3067,4,14,7,11,40,40,0,49
FC Zürich,3067,5,9,12,11,38,35,3,39
FC Thun,3067,6,11,6,15,50,62,-12,39
FC Lugano,3067,7,11,6,15,30,46,-16,39
Grasshoppers,3067,8,9,6,17,42,52,-10,33
FC Sion,3067,9,6,9,17,42,57,-15,27
Young Boys,3068,1,22,7,3,73,34,39,73
FC Basel,3068,2,17,8,7,53,28,25,59
St Gallen,3068,3,15,3,14,46,60,-14,48
Lucerne,3068,4,13,7,12,47,46,1,46
FC Zürich,3068,5,10,11,11,43,38,5,41
Grasshoppers,3068,6,11,6,15,43,49,-6,39
FC Lugano,3068,7,10,6,16,34,50,-16,36
FC Thun,3068,8,10,5,17,45,60,-15,35
FC Sion,3068,9,5,9,18,39,58,-19,24
Young Boys,3069,1,22,7,3,73,38,35,73
FC Basel,3069,2,18,9,5,61,25,36,63
St Gallen,3069,3,14,4,14,45,57,-12,46
Lucerne,3069,4,12,8,12,42,46,-4,44
FC Lugano,3069,5,12,5,15,36,47,-11,41
FC Zürich,3069,6,9,11,12,41,40,1,38
FC Thun,3069,7,10,6,16,43,61,-18,36
Grasshoppers,3069,8,9,6,17,41,51,-10,33
FC Sion,3069,9,5,10,17,42,59,-17,25
Young Boys,3070,1,23,7,2,78,34,44,76
FC Basel,3070,2,17,9,6,58,28,30,60
Lucerne,3070,3,11,11,10,41,43,-2,44
St Gallen,3070,4,13,3,16,39,62,-23,42
FC Zürich,3070,5,10,10,12,42,37,5,40
FC Lugano,3070,6,11,6,15,31,48,-17,39
FC Thun,3070,7,10,5,17,44,62,-18,35
Grasshoppers,3070,8,9,7,16,42,52,-10,34
FC Sion,3070,9,7,8,17,48,57,-9,29
Young Boys,3071,1,21,7,4,68,35,33,70
FC Basel,3071,2,19,8,5,58,24,34,65
Lucerne,3071,3,12,9,11,44,48,-4,45
St Gallen,3071,4,14,3,15,46,56,-10,45
FC Zürich,3071,5,11,10,11,44,39,5,43
FC Lugano,3071,6,10,7,15,34,48,-14,37
Grasshoppers,3071,7,9,6,17,40,51,-11,33
FC Thun,3071,8,9,6,17,41,61,-20,33
FC Sion,3071,9,7,8,17,41,54,-13,29
Young Boys,3072,1,19,8,5,67,40,27,65
FC Basel,3072,2,18,9,5,55,24,31,63
St Gallen,3072,3,15,3,14,47,56,-9,48
Lucerne,3072,4,12,8,12,39,46,-7,44
FC Zürich,3072,5,10,10,12,39,36,3,40
Grasshoppers,3072,6,10,8,14,42,46,-4,38
FC Thun,3072,7,10,6,16,41,56,-15,36
FC Lugano,3072,8,10,5,17,31,49,-18,35
FC Sion,3072,9,8,7,17,46,54,-8,31
Young Boys,3073,1,22,7,3,75,36,39,73
FC Basel,3073,2,17,7,8,49,27,22,58
St Gallen,3073,3,15,4,13,48,53,-5,49
Lucerne,3073,4,12,8,12,44,46,-2,44
FC Zürich,3073,5,11,9,12,43,39,4,42
Grasshoppers,3073,6,11,6,15,48,51,-3,39
FC Thun,3073,7,10,6,16,48,62,-14,36
FC Lugano,3073,8,10,6,16,31,52,-21,36
FC Sion,3073,9,5,9,18,43,63,-20,24
Young Boys,3074,1,22,8,2,72,31,41,74
FC Basel,3074,2,18,8,6,53,23,30,62
St Gallen,3074,3,15,3,14,46,56,-10,48
Lucerne,3074,4,11,10,11,42,48,-6,43
FC Lugano,3074,5,11,7,14,35,46,-11,40
FC Zürich,3074,6,10,9,13,40,38,2,39
Grasshoppers,3074,7,9,7,16,39,51,-12,34
FC Thun,3074,8,8,6,18,43,64,-21,30
FC Sion,3074,9,7,8,17,42,55,-13,29
Young Boys,3075,1,21,7,4,70,36,34,70
FC Basel,3075,2,19,7,6,58,27,31,64
St Gallen,3075,3,15,3,14,45,53,-8,48
Lucerne,3075,4,13,8,11,43,42,1,47
FC Zürich,3075,5,12,9,11,44,36,8,45
Grasshoppers,3075,6,10,7,15,41,49,-8,37
FC Lugano,3075,7,10,5,17,29,51,-22,35
FC Thun,3075,8,9,5,18,45,59,-14,32
FC Sion,3075,9,5,9,18,38,60,-22,24
Young Boys,3076,1,23,7,2,78,35,43,76
FC Basel,3076,2,18,8,6,56,27,29,62
St Gallen,3076,3,15,4,13,45,52,-7,49
FC Zürich,3076,4,12,9,11,42,35,7,45
Lucerne,3076,5,11,9,12,41,47,-6,42
Grasshoppers,3076,6,10,7,15,46,52,-6,37
FC Lugano,3076,7,9,7,16,32,50,-18,34
FC Thun,3076,8,9,6,17,44,62,-18,33
FC Sion,3076,9,5,7,20,37,61,-24,22
Young Boys,3077,1,23,6,3,74,34,40,75
FC Basel,3077,2,19,7,6,56,25,31,64
Lucerne,3077,3,14,7,11,43,43,0,49
FC Zürich,3077,4,12,9,11,44,35,9,45
St Gallen,3077,5,14,3,15,41,55,-14,45
FC Lugano,3077,6,10,6,16,31,47,-16,36
Grasshoppers,3077,7,9,6,17,40,52,-12,33
FC Thun,3077,8,8,5,19,38,60,-22,29
FC Sion,3077,9,7,7,18,39,55,-16,28
Young Boys,3078,1,23,6,3,74,33,41,75
FC Basel,3078,2,19,7,6,56,24,32,64
Lucerne,3078,3,13,7,12,42,47,-5,46
St Gallen,3078,4,13,3,16,43,60,-17,42
FC Zürich,3078,5,10,10,12,38,36,2,40
FC Lugano,3078,6,11,5,16,31,47,-16,38
FC Thun,3078,7,10,5,17,47,60,-13,35
Grasshoppers,3078,8,9,6,17,42,53,-11,33
FC Sion,3078,9,7,9,16,46,59,-13,30
Young Boys,3079,1,19,10,3,68,35,33,67
FC Basel,3079,2,18,9,5,57,26,31,63
St Gallen,3079,3,14,3,15,48,59,-11,45
Lucerne,3079,4,11,10,11,44,48,-4,43
FC Zürich,3079,5,10,10,12,40,38,2,40
FC Lugano,3079,6,11,7,14,31,43,-12,40
Grasshoppers,3079,7,10,7,15,44,53,-9,37
FC Thun,3079,8,9,6,17,43,59,-16,33
FC Sion,3079,9,6,10,16,38,52,-14,28
Young Boys,3080,1,22,6,4,72,34,38,72
FC Basel,3080,2,17,8,7,55,29,26,59
Lucerne,3080,3,14,8,10,46,43,3,50
St Gallen,3080,4,14,4,14,42,56,-14,46
FC Zürich,3080,5,10,10,12,40,38,2,40
FC Lugano,3080,6,10,6,16,31,47,-16,36
FC Thun,3080,7,9,8,15,44,58,-14,35
Grasshoppers,3080,8,8,8,16,39,51,-12,32
FC Sion,3080,9,7,8,17,40,53,-13,29
Young Boys,3081,1,22,7,3,71,34,37,73
FC Basel,3081,2,18,8,6,55,27,28,62
Lucerne,3081,3,14,7,11,45,42,3,49
FC Zürich,3081,4,11,9,12,39,36,3,42
St Gallen,3081,5,13,3,16,41,56,-15,42
FC Lugano,3081,6,11,5,16,29,45,-16,38
Grasshoppers,3081,7,9,6,17,42,54,-12,33
FC Sion,3081,8,8,8,16,44,54,-10,32
FC Thun,3081,9,9,5,18,41,59,-18,32
Young Boys,3082,1,22,7,3,72,34,38,73
FC Basel,3082,2,18,8,6,54,25,29,62
Lucerne,3082,3,15,7,10,45,41,4,52
St Gallen,3082,4,13,2,17,39,56,-17,41
FC Zürich,3082,5,10,10,12,43,38,5,40
FC Lugano,3082,6,11,5,16,31,48,-17,38
Grasshoppers,3082,7,9,6,17,39,52,-13,33
FC Thun,3082,8,9,6,17,44,60,-16,33
FC Sion,3082,9,7,9,16,43,56,-13,30
Young Boys,3083,1,22,6,4,71,35,36,72
FC Basel,3083,2,19,8,5,60,22,38,65
Lucerne,3083,3,12,9,11,42,48,-6,45
St Gallen,3083,4,13,3,16,41,59,-18,42
FC Zürich,3083,5,10,11,11,38,34,4,41
FC Lugano,3083,6,11,6,15,34,48,-14,39
Grasshoppers,3083,7,10,7,15,41,47,-6,37
FC Thun,3083,8,8,8,16,40,59,-19,32
FC Sion,3083,9,6,8,18,38,53,-15,26
Young Boys,3084,1,21,7,4,69,38,31,70
FC Basel,3084,2,19,7,6,56,22,34,64
St Gallen,3084,3,14,2,16,44,53,-9,44
Lucerne,3084,4,12,7,13,41,48,-7,43
Grasshoppers,3084,5,12,6,14,44,48,-4,42
FC Zürich,3084,6,10,11,11,39,35,4,41
FC Lugano,3084,7,10,6,16,30,48,-18,36
FC Thun,3084,8,9,6,17,42,59,-17,33
FC Sion,3084,9,7,8,17,38,52,-14,29
Young Boys,3085,1,21,6,5,69,35,34,69
FC Basel,3085,2,17,10,5,49,22,27,61
FC Zürich,3085,3,12,10,10,42,35,7,46
Lucerne,3085,4,12,10,10,41,42,-1,46
St Gallen,3085,5,13,4,15,40,56,-16,43
Grasshoppers,3085,6,10,8,14,43,48,-5,38
FC Lugano,3085,7,10,5,17,33,48,-15,35
FC Thun,3085,8,9,6,17,43,58,-15,33
FC Sion,3085,9,6,9,17,40,56,-16,27
Young Boys,3086,1,23,6,3,77,35,42,75
FC Basel,3086,2,17,8,7,54,28,26,59
Lucerne,3086,3,13,7,12,46,50,-4,46
St Gallen,3086,4,14,2,16,43,56,-13,44
Grasshoppers,3086,5,12,6,14,47,48,-1,42
FC Zürich,3086,6,10,11,11,43,38,5,41
FC Lugano,3086,7,11,5,16,36,54,-18,38
FC Thun,3086,8,9,6,17,44,60,-16,33
FC Sion,3086,9,6,7,19,36,57,-21,25
Young Boys,3087,1,21,7,4,70,39,31,70
FC Basel,3087,2,18,8,6,56,25,31,62
Lucerne,3087,3,12,11,9,40,40,0,47
St Gallen,3087,4,13,5,14,43,56,-13,44
FC Zürich,3087,5,11,9,12,40,35,5,42
Grasshoppers,3087,6,9,8,15,40,49,-9,35
FC Lugano,3087,7,9,7,16,31,48,-17,34
FC Sion,3087,8,8,8,16,44,53,-9,32
FC Thun,3087,9,9,5,18,42,61,-19,32
Young Boys,3088,1,22,6,4,69,34,35,72
FC Basel,3088,2,17,9,6,52,25,27,60
St Gallen,3088,3,14,3,15,41,54,-13,45
Lucerne,3088,4,11,10,11,39,43,-4,43
FC Zürich,3088,5,10,11,11,41,36,5,41
FC Lugano,3088,6,11,6,15,34,48,-14,39
FC Thun,3088,7,10,7,15,45,57,-12,37
Grasshoppers,3088,8,9,7,16,39,49,-10,34
FC Sion,3088,9,6,9,17,38,52,-14,27
Young Boys,3089,1,20,8,4,69,37,32,68
FC Basel,3089,2,17,8,7,53,27,26,59
Lucerne,3089,3,12,9,11,41,49,-8,45
St Gallen,3089,4,14,2,16,44,60,-16,44
FC Zürich,3089,5,11,10,11,39,34,5,43
FC Lugano,3089,6,12,6,14,35,44,-9,42
Grasshoppers,3089,7,10,7,15,45,49,-4,37
FC Thun,3089,8,9,7,16,43,57,-14,34
FC Sion,3089,9,6,9,17,43,55,-12,27
Young Boys,3090,1,24,6,2,76,33,43,78
FC Basel,3090,2,18,7,7,59,30,29,61
Lucerne,3090,3,14,7,11,43,44,-1,49
St Gallen,3090,4,15,2,15,41,54,-13,47
FC Zürich,3090,5,10,10,12,40,39,1,40
FC Thun,3090,6,10,6,16,43,57,-14,36
FC Lugano,3090,7,10,5,17,33,49,-16,35
Grasshoppers,3090,8,8,7,17,38,53,-15,31
FC Sion,3090,9,6,8,18,37,51,-14,26
Young Boys,3091,1,21,7,4,74,35,39,70
FC Basel,3091,2,17,9,6,50,25,25,60
Lucerne,3091,3,14,8,10,46,43,3,50
St Gallen,3091,4,14,3,15,40,55,-15,45
FC Zürich,3091,5,11,9,12,42,38,4,42
FC Lugano,3091,6,10,6,16,31,47,-16,36
FC Thun,3091,7,9,7,16,43,58,-15,34
Grasshoppers,3091,8,8,8,16,40,55,-15,32
FC Sion,3091,9,7,9,16,42,52,-10,30
Young Boys,3092,1,23,6,3,76,31,45,75
FC Basel,3092,2,16,9,7,52,30,22,57
Lucerne,3092,3,13,8,11,49,50,-1,47
St Gallen,3092,4,14,4,14,43,54,-11,46
FC Zürich,3092,5,11,10,11,41,35,6,43
FC Lugano,3092,6,11,5,16,32,51,-19,38
FC Thun,3092,7,9,8,15,43,57,-14,35
Grasshoppers,3092,8,9,6,17,41,54,-13,33
FC Sion,3092,9,6,8,18,38,53,-15,26
Young Boys,3093,1,22,6,4,73,36,37,72
FC Basel,3093,2,15,9,8,52,32,20,54
Lucerne,3093,3,14,9,9,44,39,5,51
FC Zürich,3093,4,11,10,11,41,35,6,43
St Gallen,3093,5,13,4,15,45,62,-17,43
Grasshoppers,3093,6,10,7,15,46,53,-7,37
FC Thun,3093,7,10,6,16,45,58,-13,36
FC Lugano,3093,8,9,8,15,32,48,-16,35
FC Sion,3093,9,7,7,18,44,59,-15,28
Young Boys,3094,1,21,8,3,67,35,32,71
FC Basel,3094,2,18,8,6,53,24,29,62
Lucerne,3094,3,13,9,10,42,41,1,48
FC Zürich,3094,4,11,10,11,46,35,11,43
St Gallen,3094,5,13,4,15,40,56,-16,43
FC Thun,3094,6,11,5,16,47,56,-9,38
FC Lugano,3094,7,9,7,16,29,52,-23,34
Grasshoppers,3094,8,8,7,17,38,54,-16,31
FC Sion,3094,9,7,8,17,43,52,-9,29
Young Boys,3095,1,23,6,3,71,33,38,75
FC Basel,3095,2,17,8,7,52,25,27,59
Lucerne,3095,3,12,8,12,42,46,-4,44
St Gallen,3095,4,14,2,16,41,58,-17,44
FC Zürich,3095,5,11,9,12,43,39,4,42
FC Lugano,3095,6,12,5,15,37,48,-11,41
Grasshoppers,3095,7,11,7,14,44,46,-2,40
FC Thun,3095,8,9,6,17,40,60,-20,33
FC Sion,3095,9,6,7,19,43,58,-15,25
Young Boys,3096,1,22,7,3,71,33,38,73
FC Basel,3096,2,18,7,7,56,27,29,61
St Gallen,3096,3,16,2,14,47,54,-7,50
Lucerne,3096,4,13,8,11,44,45,-1,47
FC Zürich,3096,5,11,9,12,42,38,4,42
Grasshoppers,3096,6,11,6,15,42,47,-5,39
FC Lugano,3096,7,11,5,16,32,49,-17,38
FC Thun,3096,8,8,6,18,43,64,-21,30
FC Sion,3096,9,5,8,19,39,59,-20,23
Young Boys,3097,1,22,7,3,69,32,37,73
FC Basel,3097,2,18,8,6,53,26,27,62
St Gallen,3097,3,15,3,14,43,53,-10,48
Lucerne,3097,4,13,7,12,41,43,-2,46
FC Zürich,3097,5,10,11,11,42,40,2,41
FC Thun,3097,6,10,6,16,44,56,-12,36
FC Lugano,3097,7,10,6,16,32,46,-14,36
Grasshoppers,3097,8,9,7,16,40,50,-10,34
FC Sion,3097,9,5,9,18,42,60,-18,24
Young Boys,3098,1,23,6,3,75,33,42,75
FC Basel,3098,2,18,8,6,51,24,27,62
Lucerne,3098,3,13,8,11,45,46,-1,47
St Gallen,3098,4,14,3,15,43,56,-13,45
FC Lugano,3098,5,11,5,16,31,48,-17,38
FC Zürich,3098,6,9,10,13,36,39,-3,37
FC Thun,3098,7,10,6,16,42,55,-13,36
FC Sion,3098,8,8,7,17,43,54,-11,31
Grasshoppers,3098,9,8,7,17,41,52,-11,31
Young Boys,3099,1,21,8,3,72,34,38,71
FC Basel,3099,2,17,9,6,54,25,29,60
Lucerne,3099,3,13,8,11,41,43,-2,47
FC Zürich,3099,4,12,9,11,42,34,8,45
St Gallen,3099,5,13,4,15,44,59,-15,43
FC Lugano,3099,6,11,6,15,32,50,-18,39
Grasshoppers,3099,7,9,7,16,39,48,-9,34
FC Sion,3099,8,7,9,16,41,52,-11,30
FC Thun,3099,9,8,6,18,40,60,-20,30
Young Boys,3100,1,21,8,3,70,35,35,71
FC Basel,3100,2,18,7,7,55,28,27,61
St Gallen,3100,3,15,3,14,44,54,-10,48
Lucerne,3100,4,13,8,11,44,44,0,47
FC Zürich,3100,5,11,9,12,42,38,4,42
Grasshoppers,3100,6,10,7,15,39,47,-8,37
FC Thun,3100,7,10,5,17,43,59,-16,35
FC Lugano,3100,8,9,5,18,30,50,-20,32
FC Sion,3100,9,7,8,17,40,52,-12,29
Young Boys,3101,1,19,9,4,66,35,31,66
FC Basel,3101,2,15,11,6,51,28,23,56
St Gallen,3101,3,15,4,13,44,52,-8,49
Lucerne,3101,4,13,9,10,41,41,0,48
FC Zürich,3101,5,10,10,12,42,40,2,40
Grasshoppers,3101,6,9,9,14,41,47,-6,36
FC Thun,3101,7,9,7,16,46,59,-13,34
FC Sion,3101,8,8,9,15,43,53,-10,33
FC Lugano,3101,9,9,6,17,28,47,-19,33
Young Boys,3102,1,22,7,3,74,35,39,73
FC Basel,3102,2,18,9,5,54,26,28,63
St Gallen,3102,3,14,4,14,42,54,-12,46
Lucerne,3102,4,12,7,13,38,43,-5,43
FC Lugano,3102,5,12,5,15,33,44,-11,41
FC Zürich,3102,6,10,9,13,43,44,-1,39
FC Thun,3102,7,10,6,16,47,58,-11,36
Grasshoppers,3102,8,9,7,16,43,54,-11,34
FC Sion,3102,9,6,8,18,41,57,-16,26
Young Boys,3103,1,22,7,3,75,35,40,73
FC Basel,3103,2,18,9,5,53,24,29,63
Lucerne,3103,3,14,8,10,45,42,3,50
St Gallen,3103,4,14,3,15,43,55,-12,45
FC Zürich,3103,5,11,9,12,43,36,7,42
Grasshoppers,3103,6,10,7,15,41,48,-7,37
FC Lugano,3103,7,10,5,17,30,51,-21,35
FC Thun,3103,8,9,5,18,43,59,-16,32
FC Sion,3103,9,6,7,19,38,61,-23,25
Young Boys,3104,1,21,8,3,69,33,36,71
FC Basel,3104,2,16,9,7,50,25,25,57
St Gallen,3104,3,14,4,14,39,50,-11,46
Lucerne,3104,4,12,8,12,41,45,-4,44
FC Zürich,3104,5,11,10,11,41,36,5,43
FC Lugano,3104,6,11,6,15,32,46,-14,39
FC Thun,3104,7,10,6,16,42,57,-15,36
Grasshoppers,3104,8,9,7,16,41,50,-9,34
FC Sion,3104,9,7,8,17,39,52,-13,29
Young Boys,3105,1,23,7,2,78,30,48,76
FC Basel,3105,2,17,9,6,54,28,26,60
St Gallen,3105,3,16,3,13,48,53,-5,51
Lucerne,3105,4,12,9,11,41,47,-6,45
FC Zürich,3105,5,9,10,13,37,38,-1,37
FC Lugano,3105,6,10,7,15,31,48,-17,37
FC Thun,3105,7,9,6,17,43,61,-18,33
Grasshoppers,3105,8,8,7,17,39,51,-12,31
FC Sion,3105,9,7,8,17,40,55,-15,29
Young Boys,3106,1,22,8,2,73,32,41,74
FC Basel,3106,2,17,10,5,53,24,29,61
Lucerne,3106,3,13,8,11,44,51,-7,47
St Gallen,3106,4,14,4,14,47,58,-11,46
FC Zürich,3106,5,11,11,10,40,34,6,44
FC Thun,3106,6,9,6,17,42,58,-16,33
FC Lugano,3106,7,9,6,17,29,47,-18,33
FC Sion,3106,8,7,9,16,43,55,-12,30
Grasshoppers,3106,9,8,6,18,42,54,-12,30
Young Boys,3107,1,20,7,5,70,37,33,67
FC Basel,3107,2,19,7,6,54,25,29,64
Lucerne,3107,3,14,7,11,43,42,1,49
St Gallen,3107,4,14,3,15,44,57,-13,45
FC Zürich,3107,5,10,10,12,42,40,2,40
FC Lugano,3107,6,11,7,14,33,45,-12,40
Grasshoppers,3107,7,9,6,17,41,53,-12,33
FC Thun,3107,8,9,6,17,41,59,-18,33
FC Sion,3107,9,8,7,17,45,55,-10,31
Young Boys,3108,1,22,6,4,69,38,31,72
FC Basel,3108,2,18,7,7,62,32,30,61
St Gallen,3108,3,16,2,14,44,52,-8,50
FC Zürich,3108,4,12,10,10,44,34,10,46
Lucerne,3108,5,12,8,12,41,44,-3,44
Grasshoppers,3108,6,10,7,15,45,49,-4,37
FC Thun,3108,7,10,6,16,50,63,-13,36
FC Lugano,3108,8,9,5,18,30,52,-22,32
FC Sion,3108,9,6,7,19,35,56,-21,25
Young Boys,3109,1,21,9,2,73,36,37,72
FC Basel,3109,2,17,9,6,53,26,27,60
Lucerne,3109,3,12,9,11,42,44,-2,45
FC Zürich,3109,4,11,9,12,42,38,4,42
St Gallen,3109,5,13,3,16,41,56,-15,42
Grasshoppers,3109,6,10,8,14,46,50,-4,38
FC Thun,3109,7,10,7,15,43,56,-13,37
FC Lugano,3109,8,9,7,16,30,49,-19,34
FC Sion,3109,9,6,9,17,42,57,-15,27
Young Boys,3110,1,21,6,5,70,35,35,69
FC Basel,3110,2,17,9,6,52,25,27,60
Lucerne,3110,3,13,8,11,42,44,-2,47
FC Zürich,3110,4,11,10,11,43,37,6,43
St Gallen,3110,5,13,4,15,41,55,-14,43
FC Lugano,3110,6,11,5,16,32,48,-16,38
Grasshoppers,3110,7,10,6,16,42,49,-7,36
FC Thun,3110,8,10,5,17,40,56,-16,35
FC Sion,3110,9,8,7,17,41,54,-13,31
Young Boys,3111,1,23,6,3,77,35,42,75
FC Basel,3111,2,18,7,7,56,32,24,61
St Gallen,3111,3,14,3,15,42,55,-13,45
Lucerne,3111,4,11,9,12,40,46,-6,42
FC Zürich,3111,5,10,11,11,47,42,5,41
FC Lugano,3111,6,10,7,15,34,50,-16,37
Grasshoppers,3111,7,10,6,16,44,52,-8,36
FC Thun,3111,8,10,5,17,49,63,-14,35
FC Sion,3111,9,7,8,17,43,57,-14,29
Young Boys,3112,1,20,8,4,73,41,32,68
FC Basel,3112,2,18,9,5,57,27,30,63
Lucerne,3112,3,12,9,11,42,47,-5,45
St Gallen,3112,4,13,5,14,41,53,-12,44
Grasshoppers,3112,5,11,7,14,48,51,-3,40
FC Zürich,3112,6,9,11,12,37,37,0,38
FC Lugano,3112,7,10,6,16,30,45,-15,36
FC Thun,3112,8,9,7,16,46,60,-14,34
FC Sion,3112,9,6,10,16,41,54,-13,28
Young Boys,3113,1,23,7,2,72,34,38,76
FC Basel,3113,2,16,8,8,53,30,23,56
Lucerne,3113,3,14,8,10,45,41,4,50
FC Zürich,3113,4,13,9,10,47,35,12,48
St Gallen,3113,5,14,4,14,46,57,-11,46
Grasshoppers,3113,6,10,7,15,44,49,-5,37
FC Lugano,3113,7,9,5,18,29,49,-20,32
FC Thun,3113,8,9,5,18,42,63,-21,32
FC Sion,3113,9,6,7,19,40,60,-20,25
Young Boys,3114,1,23,7,2,77,34,43,76
FC Basel,3114,2,19,7,6,56,23,33,64
Lucerne,3114,3,12,9,11,43,46,-3,45
St Gallen,3114,4,14,3,15,43,55,-12,45
FC Zürich,3114,5,11,9,12,43,38,5,42
FC Lugano,3114,6,11,7,14,34,47,-13,40
Grasshoppers,3114,7,10,6,16,43,52,-9,36
FC Thun,3114,8,8,5,19,41,67,-26,29
FC Sion,3114,9,6,7,19,39,57,-18,25
Young Boys,3115,1,19,8,5,66,35,31,65
FC Basel,3115,2,16,11,5,49,23,26,59
Lucerne,3115,3,12,10,10,43,44,-1,46
St Gallen,3115,4,14,3,15,41,53,-12,45
FC Zürich,3115,5,10,11,11,41,37,4,41
FC Lugano,3115,6,11,6,15,30,44,-14,39
Grasshoppers,3115,7,10,6,16,41,49,-8,36
FC Sion,3115,8,9,7,16,42,51,-9,34
FC Thun,3115,9,9,6,17,41,58,-17,33
Young Boys,3116,1,21,8,3,75,39,36,71
FC Basel,3116,2,17,8,7,56,26,30,59
Lucerne,3116,3,12,11,9,43,43,0,47
St Gallen,3116,4,13,4,15,41,54,-13,43
FC Zürich,3116,5,9,11,12,38,36,2,38
FC Lugano,3116,6,10,7,15,32,52,-20,37
FC Thun,3116,7,10,6,16,40,57,-17,36
Grasshoppers,3116,8,9,7,16,44,53,-9,34
FC Sion,3116,9,7,10,15,40,49,-9,31
Young Boys,3117,1,23,7,2,74,30,44,76
FC Basel,3117,2,17,7,8,52,27,25,58
Lucerne,3117,3,13,8,11,42,44,-2,47
St Gallen,3117,4,14,4,14,44,56,-12,46
FC Zürich,3117,5,11,9,12,38,35,3,42
FC Lugano,3117,6,10,7,15,31,45,-14,37
FC Thun,3117,7,10,6,16,43,60,-17,36
Grasshoppers,3117,8,8,6,18,40,52,-12,30
FC Sion,3117,9,7,8,17,41,56,-15,29
Young Boys,3118,1,23,6,3,79,36,43,75
FC Basel,3118,2,18,8,6,56,24,32,62
Lucerne,3118,3,13,8,11,44,47,-3,47
FC Zürich,3118,4,11,9,12,41,36,5,42
St Gallen,3118,5,13,2,17,39,56,-17,41
FC Lugano,3118,6,11,5,16,32,50,-18,38
FC Thun,3118,7,10,5,17,46,61,-15,35
Grasshoppers,3118,8,9,7,16,40,50,-10,34
FC Sion,3118,9,7,8,17,42,59,-17,29
Young Boys,3119,1,20,8,4,69,37,32,68
FC Basel,3119,2,18,9,5,60,26,34,63
Lucerne,3119,3,14,7,11,52,45,7,49
St Gallen,3119,4,15,3,14,46,55,-9,48
FC Zürich,3119,5,10,10,12,40,39,1,40
FC Sion,3119,6,9,8,15,46,53,-7,35
FC Thun,3119,7,10,5,17,46,64,-18,35
FC Lugano,3119,8,9,5,18,31,54,-23,32
Grasshoppers,3119,9,8,7,17,37,54,-17,31
Young Boys,3120,1,23,6,3,69,33,36,75
FC Basel,3120,2,18,7,7,55,27,28,61
Lucerne,3120,3,13,7,12,42,45,-3,46
St Gallen,3120,4,14,3,15,43,56,-13,45
FC Zürich,3120,5,11,10,11,43,37,6,43
FC Thun,3120,6,10,6,16,45,58,-13,36
FC Lugano,3120,7,10,6,16,30,46,-16,36
Grasshoppers,3120,8,9,7,16,43,49,-6,34
FC Sion,3120,9,6,8,18,40,59,-19,26
Young Boys,3121,1,21,8,3,72,35,37,71
FC Basel,3121,2,20,7,5,60,23,37,67
Lucerne,3121,3,14,8,10,45,43,2,50
St Gallen,3121,4,14,2,16,42,53,-11,44
FC Zürich,3121,5,11,10,11,42,39,3,43
FC Thun,3121,6,9,7,16,46,63,-17,34
Grasshoppers,3121,7,8,8,16,43,54,-11,32
FC Lugano,3121,8,9,5,18,28,53,-25,32
FC Sion,3121,9,6,9,17,44,59,-15,27
Young Boys,3122,1,23,7,2,73,32,41,76
FC Basel,3122,2,18,8,6,57,29,28,62
St Gallen,3122,3,15,3,14,49,57,-8,48
Lucerne,3122,4,12,9,11,41,44,-3,45
FC Zürich,3122,5,11,10,11,40,35,5,43
FC Thun,3122,6,11,5,16,44,55,-11,38
Grasshoppers,3122,7,9,7,16,42,54,-12,34
FC Lugano,3122,8,9,5,18,28,49,-21,32
FC Sion,3122,9,5,8,19,38,57,-19,23
Young Boys,3123,1,22,6,4,75,37,38,72
FC Basel,3123,2,16,9,7,51,27,24,57
FC Zürich,3123,3,12,10,10,45,32,13,46
St Gallen,3123,4,14,4,14,45,55,-10,46
Lucerne,3123,5,12,7,13,41,49,-8,43
FC Lugano,3123,6,12,6,14,34,44,-10,42
Grasshoppers,3123,7,9,7,16,41,51,-10,34
FC Thun,3123,8,9,6,17,41,59,-18,33
FC Sion,3123,9,6,9,17,37,56,-19,27
Young Boys,3124,1,22,7,3,76,36,40,73
FC Basel,3124,2,18,9,5,59,27,32,63
St Gallen,3124,3,14,4,14,40,53,-13,46
Lucerne,3124,4,12,8,12,41,46,-5,44
FC Zürich,3124,5,10,10,12,44,43,1,40
Grasshoppers,3124,6,11,6,15,45,48,-3,39
FC Lugano,3124,7,10,5,17,32,51,-19,35
FC Thun,3124,8,8,7,17,41,61,-20,31
FC Sion,3124,9,7,8,17,44,57,-13,29
Young Boys,3125,1,21,7,4,72,37,35,70
FC Basel,3125,2,16,9,7,48,25,23,57
Lucerne,3125,3,14,9,9,41,38,3,51
FC Zürich,3125,4,11,11,10,45,36,9,44
St Gallen,3125,5,13,5,14,41,55,-14,44
Grasshoppers,3125,6,10,6,16,45,51,-6,36
FC Thun,3125,7,10,6,16,43,57,-14,36
FC Lugano,3125,8,9,7,16,31,50,-19,34
FC Sion,3125,9,6,8,18,40,57,-17,26
Young Boys,3126,1,21,8,3,74,36,38,71
FC Basel,3126,2,18,8,6,55,25,30,62
Lucerne,3126,3,13,10,9,48,45,3,49
St Gallen,3126,4,14,4,14,44,56,-12,46
FC Zürich,3126,5,12,9,11,44,35,9,45
Grasshoppers,3126,6,10,6,16,41,52,-11,36
FC Thun,3126,7,9,6,17,46,60,-14,33
FC Lugano,3126,8,9,6,17,32,52,-20,33
FC Sion,3126,9,5,9,18,38,61,-23,24
Young Boys,3127,1,19,10,3,68,35,33,67
FC Basel,3127,2,17,10,5,57,26,31,61
Lucerne,3127,3,15,7,10,45,42,3,52
FC Zürich,3127,4,10,12,10,41,36,5,42
St Gallen,3127,5,13,2,17,43,63,-20,41
Grasshoppers,3127,6,10,7,15,42,47,-5,37
FC Lugano,3127,7,10,6,16,32,48,-16,36
FC Thun,3127,8,8,7,17,39,58,-19,31
FC Sion,3127,9,7,9,16,41,53,-12,30
Young Boys,3128,1,19,9,4,70,38,32,66
FC Basel,3128,2,17,8,7,54,29,25,59
Lucerne,3128,3,13,9,10,43,45,-2,48
St Gallen,3128,4,15,2,15,46,56,-10,47
FC Zürich,3128,5,11,10,11,42,35,7,43
Grasshoppers,3128,6,11,7,14,46,50,-4,40
FC Thun,3128,7,10,5,17,45,60,-15,35
FC Lugano,3128,8,9,7,16,33,54,-21,34
FC Sion,3128,9,6,9,17,42,54,-12,27
Young Boys,3129,1,21,7,4,69,33,36,70
FC Basel,3129,2,18,9,5,55,22,33,63
Lucerne,3129,3,14,8,10,46,42,4,50
FC Zürich,3129,4,11,9,12,42,39,3,42
St Gallen,3129,5,13,3,16,40,58,-18,42
FC Thun,3129,6,11,5,16,50,61,-11,38
FC Lugano,3129,7,10,6,16,32,49,-17,36
Grasshoppers,3129,8,9,7,16,38,52,-14,34
FC Sion,3129,9,6,8,18,37,53,-16,26
Young Boys,3130,1,22,7,3,71,34,37,73
FC Basel,3130,2,19,7,6,59,25,34,64
Lucerne,3130,3,13,8,11,42,42,0,47
St Gallen,3130,4,14,3,15,43,57,-14,45
FC Zürich,3130,5,11,11,10,41,33,8,44
Grasshoppers,3130,6,8,9,15,39,50,-11,33
FC Lugano,3130,7,9,6,17,29,49,-20,33
FC Thun,3130,8,8,8,16,39,59,-20,32
FC Sion,3130,9,5,11,16,40,54,-14,26
Young Boys,3131,1,21,8,3,69,33,36,71
FC Basel,3131,2,17,9,6,50,25,25,60
Lucerne,3131,3,13,7,12,43,42,1,46
St Gallen,3131,4,14,3,15,44,56,-12,45
FC Zürich,3131,5,11,11,10,47,36,11,44
FC Thun,3131,6,11,5,16,45,60,-15,38
Grasshoppers,3131,7,9,8,15,39,47,-8,35
FC Lugano,3131,8,9,5,18,30,55,-25,32
FC Sion,3131,9,6,10,16,41,54,-13,28
Young Boys,3132,1,21,8,3,69,33,36,71
FC Basel,3132,2,16,10,6,50,25,25,58
St Gallen,3132,3,14,4,14,43,55,-12,46
Lucerne,3132,4,11,11,10,42,44,-2,44
FC Zürich,3132,5,9,11,12,37,35,2,38
FC Lugano,3132,6,10,7,15,29,45,-16,37
Grasshoppers,3132,7,9,9,14,41,46,-5,36
FC Thun,3132,8,10,6,16,42,56,-14,36
FC Sion,3132,9,7,8,17,39,53,-14,29
Young Boys,3133,1,21,8,3,70,34,36,71
FC Basel,3133,2,17,9,6,51,24,27,60
Lucerne,3133,3,13,8,11,42,43,-1,47
St Gallen,3133,4,15,2,15,46,56,-10,47
FC Zürich,3133,5,9,11,12,37,37,0,38
FC Lugano,3133,6,10,7,15,30,45,-15,37
FC Thun,3133,7,10,6,16,43,56,-13,36
Grasshoppers,3133,8,9,7,16,39,46,-7,34
FC Sion,3133,9,7,8,17,40,57,-17,29
Young Boys,3134,1,22,8,2,76,35,41,74
FC Basel,3134,2,17,9,6,55,29,26,60
St Gallen,3134,3,14,4,14,42,55,-13,46
Lucerne,3134,4,12,9,11,45,45,0,45
FC Zürich,3134,5,10,11,11,41,35,6,41
FC Lugano,3134,6,11,6,15,35,51,-16,39
Grasshoppers,3134,7,10,6,16,45,50,-5,36
FC Thun,3134,8,9,6,17,42,64,-22,33
FC Sion,3134,9,5,9,18,35,52,-17,24
Young Boys,3135,1,22,7,3,70,34,36,73
FC Basel,3135,2,18,8,6,55,29,26,62
FC Zürich,3135,3,12,10,10,44,35,9,46
St Gallen,3135,4,14,4,14,45,56,-11,46
Lucerne,3135,5,12,8,12,45,48,-3,44
FC Thun,3135,6,10,6,16,49,60,-11,36
Grasshoppers,3135,7,9,8,15,40,51,-11,35
FC Lugano,3135,8,9,6,17,32,51,-19,33
FC Sion,3135,9,5,9,18,39,55,-16,24
Young Boys,3136,1,21,7,4,73,40,33,70
FC Basel,3136,2,18,8,6,56,26,30,62
St Gallen,3136,3,15,2,15,42,54,-12,47
FC Zürich,3136,4,12,10,10,43,35,8,46
Lucerne,3136,5,13,7,12,43,45,-2,46
Grasshoppers,3136,6,11,6,15,46,53,-7,39
FC Lugano,3136,7,9,6,17,29,49,-20,33
FC Thun,3136,8,8,6,18,43,62,-19,30
FC Sion,3136,9,7,8,17,44,55,-11,29
Young Boys,3137,1,21,7,4,68,34,34,70
FC Basel,3137,2,18,7,7,56,26,30,61
FC Zürich,3137,3,13,9,10,44,34,10,48
Lucerne,3137,4,12,8,12,43,45,-2,44
St Gallen,3137,5,14,2,16,43,62,-19,44
Grasshoppers,3137,6,10,7,15,41,49,-8,37
FC Lugano,3137,7,10,6,16,33,49,-16,36
FC Thun,3137,8,10,5,17,45,61,-16,35
FC Sion,3137,9,7,7,18,42,55,-13,28
Young Boys,3138,1,21,8,3,74,36,38,71
FC Basel,3138,2,18,8,6,57,29,28,62
St Gallen,3138,3,13,4,15,42,55,-13,43
Lucerne,3138,4,11,9,12,42,50,-8,42
FC Zürich,3138,5,10,10,12,42,38,4,40
FC Thun,3138,6,11,6,15,45,57,-12,39
FC Lugano,3138,7,10,7,15,32,47,-15,37
Grasshoppers,3138,8,9,9,14,41,48,-7,36
FC Sion,3138,9,6,9,17,39,54,-15,27
Young Boys,3139,1,21,8,3,70,35,35,71
FC Basel,3139,2,18,9,5,53,23,30,63
Lucerne,3139,3,14,8,10,47,44,3,50
FC Zürich,3139,4,12,10,10,42,33,9,46
St Gallen,3139,5,14,3,15,41,53,-12,45
FC Thun,3139,6,9,6,17,43,59,-16,33
FC Lugano,3139,7,9,5,18,29,51,-22,32
Grasshoppers,3139,8,8,7,17,39,53,-14,31
FC Sion,3139,9,6,10,16,40,53,-13,28
Young Boys,3140,1,22,7,3,71,34,37,73
FC Basel,3140,2,19,7,6,57,25,32,64
Lucerne,3140,3,14,8,10,49,43,6,50
St Gallen,3140,4,13,2,17,39,58,-19,41
FC Zürich,3140,5,10,9,13,41,39,2,39
FC Lugano,3140,6,11,5,16,31,48,-17,38
FC Thun,3140,7,10,6,16,45,60,-15,36
Grasshoppers,3140,8,9,7,16,43,56,-13,34
FC Sion,3140,9,7,7,18,39,52,-13,28
Young Boys,3141,1,21,7,4,67,36,31,70
FC Basel,3141,2,19,8,5,59,22,37,65
St Gallen,3141,3,16,2,14,48,55,-7,50
Lucerne,3141,4,12,8,12,39,45,-6,44
FC Zürich,3141,5,10,11,11,40,38,2,41
Grasshoppers,3141,6,10,8,14,46,50,-4,38
FC Thun,3141,7,10,6,16,47,59,-12,36
FC Lugano,3141,8,9,6,17,30,48,-18,33
FC Sion,3141,9,5,8,19,39,62,-23,23
Young Boys,3142,1,22,6,4,72,36,36,72
FC Basel,3142,2,19,7,6,55,28,27,64
Lucerne,3142,3,13,8,11,43,44,-1,47
FC Zürich,3142,4,11,10,11,44,35,9,43
St Gallen,3142,5,13,4,15,41,55,-14,43
FC Lugano,3142,6,11,6,15,32,48,-16,39
Grasshoppers,3142,7,10,6,16,44,49,-5,36
FC Thun,3142,8,9,5,18,44,65,-21,32
FC Sion,3142,9,6,8,18,38,53,-15,26
Young Boys,3143,1,22,6,4,74,38,36,72
FC Basel,3143,2,19,7,6,58,25,33,64
Lucerne,3143,3,14,7,11,44,44,0,49
St Gallen,3143,4,14,3,15,43,56,-13,45
FC Zürich,3143,5,11,11,10,39,32,7,44
FC Thun,3143,6,10,6,16,42,55,-13,36
FC Lugano,3143,7,9,6,17,28,50,-22,33
Grasshoppers,3143,8,8,6,18,39,54,-15,30
FC Sion,3143,9,7,8,17,43,56,-13,29
Young Boys,3144,1,21,8,3,72,36,36,71
FC Basel,3144,2,18,8,6,57,29,28,62
Lucerne,3144,3,12,9,11,42,44,-2,45
FC Zürich,3144,4,11,11,10,41,34,7,44
St Gallen,3144,5,14,2,16,42,57,-15,44
FC Lugano,3144,6,10,7,15,30,46,-16,37
FC Thun,3144,7,10,5,17,44,58,-14,35
Grasshoppers,3144,8,9,6,17,40,52,-12,33
FC Sion,3144,9,7,8,17,42,54,-12,29
Young Boys,3145,1,20,8,4,67,37,30,68
FC Basel,3145,2,16,10,6,51,26,25,58
St Gallen,3145,3,14,5,13,41,50,-9,47
Lucerne,3145,4,12,9,11,44,45,-1,45
FC Zürich,3145,5,10,12,10,39,34,5,42
FC Thun,3145,6,11,5,16,47,57,-10,38
FC Lugano,3145,7,10,6,16,31,48,-17,36
Grasshoppers,3145,8,8,9,15,40,49,-9,33
FC Sion,3145,9,6,10,16,37,51,-14,28
Young Boys,3146,1,20,9,3,70,35,35,69
FC Basel,3146,2,16,9,7,49,26,23,57
Lucerne,3146,3,14,9,9,50,46,4,51
FC Zürich,3146,4,12,9,11,41,34,7,45
St Gallen,3146,5,13,5,14,42,54,-12,44
Grasshoppers,3146,6,11,7,14,44,48,-4,40
FC Lugano,3146,7,9,6,17,33,54,-21,33
FC Thun,3146,8,9,5,18,40,59,-19,32
FC Sion,3146,9,6,9,17,37,50,-13,27
Young Boys,3147,1,22,6,4,73,35,38,72
FC Basel,3147,2,17,7,8,50,29,21,58
St Gallen,3147,3,15,2,15,47,59,-12,47
Lucerne,3147,4,12,7,13,41,44,-3,43
FC Thun,3147,5,12,5,15,49,59,-10,41
FC Lugano,3147,6,12,5,15,35,49,-14,41
FC Zürich,3147,7,10,9,13,43,39,4,39
Grasshoppers,3147,8,9,6,17,41,51,-10,33
FC Sion,3147,9,8,7,17,46,60,-14,31
Young Boys,3148,1,22,7,3,70,32,38,73
FC Basel,3148,2,17,9,6,52,24,28,60
Lucerne,3148,3,15,7,10,47,41,6,52
St Gallen,3148,4,14,3,15,42,56,-14,45
FC Zürich,3148,5,10,9,13,43,41,2,39
FC Thun,3148,6,11,6,15,48,56,-8,39
FC Lugano,3148,7,10,6,16,30,49,-19,36
Grasshoppers,3148,8,9,6,17,40,52,-12,33
FC Sion,3148,9,6,7,19,37,58,-21,25
Young Boys,3149,1,23,6,3,75,32,43,75
FC Basel,3149,2,16,7,9,53,33,20,55
Lucerne,3149,3,14,8,10,45,44,1,50
FC Zürich,3149,4,12,9,11,43,37,6,45
St Gallen,3149,5,13,3,16,41,58,-17,42
Grasshoppers,3149,6,10,7,15,42,49,-7,37
FC Lugano,3149,7,9,7,16,28,49,-21,34
FC Sion,3149,8,8,8,16,42,51,-9,32
FC Thun,3149,9,9,5,18,45,61,-16,32
Young Boys,3150,1,22,7,3,72,34,38,73
FC Basel,3150,2,17,8,7,52,25,27,59
St Gallen,3150,3,15,3,14,44,53,-9,48
FC Zürich,3150,4,11,11,10,40,34,6,44
Lucerne,3150,5,12,7,13,39,45,-6,43
Grasshoppers,3150,6,11,6,15,41,48,-7,39
FC Lugano,3150,7,9,7,16,31,50,-19,34
FC Thun,3150,8,8,7,17,42,59,-17,31
FC Sion,3150,9,7,8,17,39,52,-13,29
Young Boys,3151,1,23,6,3,76,35,41,75
FC Basel,3151,2,19,7,6,60,28,32,64
Lucerne,3151,3,14,7,11,47,43,4,49
St Gallen,3151,4,14,2,16,41,60,-19,44
FC Zürich,3151,5,11,9,12,41,38,3,42
Grasshoppers,3151,6,11,6,15,43,49,-6,39
FC Thun,3151,7,9,5,18,42,62,-20,32
FC Lugano,3151,8,9,5,18,29,53,-24,32
FC Sion,3151,9,7,7,18,42,53,-11,28
Young Boys,3152,1,22,7,3,74,35,39,73
FC Basel,3152,2,18,7,7,56,26,30,61
Lucerne,3152,3,13,7,12,41,49,-8,46
St Gallen,3152,4,14,2,16,43,58,-15,44
FC Zürich,3152,5,10,10,12,40,38,2,40
FC Lugano,3152,6,11,6,15,34,47,-13,39
Grasshoppers,3152,7,10,6,16,44,50,-6,36
FC Thun,3152,8,9,6,17,41,58,-17,33
FC Sion,3152,9,8,7,17,41,53,-12,31
Young Boys,3153,1,23,6,3,70,33,37,75
FC Basel,3153,2,19,7,6,58,22,36,64
Lucerne,3153,3,13,8,11,41,44,-3,47
St Gallen,3153,4,15,2,15,42,57,-15,47
FC Zürich,3153,5,10,10,12,42,36,6,40
Grasshoppers,3153,6,9,8,15,41,49,-8,35
FC Lugano,3153,7,10,5,17,32,49,-17,35
FC Thun,3153,8,9,6,17,41,58,-17,33
FC Sion,3153,9,6,8,18,38,57,-19,26
Young Boys,3154,1,22,6,4,76,40,36,72
FC Basel,3154,2,18,8,6,54,28,26,62
Lucerne,3154,3,12,9,11,44,47,-3,45
St Gallen,3154,4,14,2,16,43,56,-13,44
FC Lugano,3154,5,12,6,14,34,46,-12,42
FC Thun,3154,6,11,6,15,47,57,-10,39
FC Zürich,3154,7,9,9,14,39,42,-3,36
FC Sion,3154,8,8,7,17,44,54,-10,31
Grasshoppers,3154,9,8,7,17,39,50,-11,31
Young Boys,3155,1,22,8,2,76,33,43,74
FC Basel,3155,2,18,9,5,62,30,32,63
St Gallen,3155,3,15,2,15,45,57,-12,47
Lucerne,3155,4,13,7,12,44,52,-8,46
FC Zürich,3155,5,11,10,11,43,36,7,43
FC Thun,3155,6,11,5,16,46,60,-14,38
FC Lugano,3155,7,10,5,17,30,48,-18,35
Grasshoppers,3155,8,8,7,17,38,51,-13,31
FC Sion,3155,9,5,9,18,39,56,-17,24
Young Boys,3156,1,22,7,3,72,34,38,73
FC Basel,3156,2,18,9,5,57,26,31,63
Lucerne,3156,3,13,8,11,45,45,0,47
St Gallen,3156,4,15,2,15,47,54,-7,47
FC Zürich,3156,5,10,10,12,42,43,-1,40
FC Lugano,3156,6,11,5,16,33,48,-15,38
FC Thun,3156,7,10,5,17,47,62,-15,35
Grasshoppers,3156,8,8,8,16,41,53,-12,32
FC Sion,3156,9,6,8,18,39,58,-19,26
Young Boys,3157,1,22,6,4,69,33,36,72
FC Basel,3157,2,17,9,6,51,24,27,60
St Gallen,3157,3,15,4,13,50,54,-4,49
FC Zürich,3157,4,12,10,10,42,33,9,46
Lucerne,3157,5,13,7,12,44,47,-3,46
FC Thun,3157,6,10,6,16,49,62,-13,36
Grasshoppers,3157,7,9,7,16,42,52,-10,34
FC Lugano,3157,8,9,5,18,29,55,-26,32
FC Sion,3157,9,5,10,17,40,56,-16,25
Young Boys,3158,1,20,8,4,71,38,33,68
FC Basel,3158,2,17,10,5,53,24,29,61
Lucerne,3158,3,13,8,11,45,43,2,47
St Gallen,3158,4,14,4,14,42,53,-11,46
FC Zürich,3158,5,10,12,10,42,37,5,42
FC Lugano,3158,6,10,6,16,31,47,-16,36
Grasshoppers,3158,7,9,8,15,46,57,-11,35
FC Thun,3158,8,9,6,17,43,60,-17,33
FC Sion,3158,9,6,10,16,44,58,-14,28
Young Boys,3159,1,21,8,3,71,37,34,71
FC Basel,3159,2,17,8,7,57,30,27,59
Lucerne,3159,3,14,7,11,45,45,0,49
FC Zürich,3159,4,12,10,10,43,35,8,46
St Gallen,3159,5,14,3,15,42,55,-13,45
FC Lugano,3159,6,10,6,16,31,47,-16,36
Grasshoppers,3159,7,9,8,15,40,49,-9,35
FC Thun,3159,8,8,8,16,43,60,-17,32
FC Sion,3159,9,6,8,18,42,56,-14,26
Young Boys,3160,1,21,7,4,71,39,32,70
FC Basel,3160,2,19,8,5,62,25,37,65
Lucerne,3160,3,14,7,11,44,45,-1,49
St Gallen,3160,4,14,3,15,43,56,-13,45
FC Zürich,3160,5,11,10,11,44,37,7,43
Grasshoppers,3160,6,10,7,15,47,50,-3,37
FC Lugano,3160,7,10,7,15,31,47,-16,37
FC Thun,3160,8,9,5,18,41,64,-23,32
FC Sion,3160,9,5,8,19,38,58,-20,23
Young Boys,3161,1,20,6,6,67,41,26,66
FC Basel,3161,2,18,7,7,51,24,27,61
Lucerne,3161,3,13,8,11,43,42,1,47
St Gallen,3161,4,14,4,14,41,52,-11,46
Grasshoppers,3161,5,12,6,14,47,45,2,42
FC Lugano,3161,6,11,6,15,33,49,-16,39
FC Zürich,3161,7,9,10,13,39,40,-1,37
FC Thun,3161,8,10,5,17,46,60,-14,35
FC Sion,3161,9,7,8,17,42,56,-14,29
Young Boys,3162,1,21,7,4,70,37,33,70
FC Basel,3162,2,17,10,5,54,23,31,61
St Gallen,3162,3,14,3,15,42,58,-16,45
FC Zürich,3162,4,11,11,10,39,33,6,44
Lucerne,3162,5,12,7,13,40,47,-7,43
FC Sion,3162,6,9,8,15,46,48,-2,35
Grasshoppers,3162,7,9,8,15,40,49,-9,35
FC Lugano,3162,8,10,5,17,30,49,-19,35
FC Thun,3162,9,8,7,17,40,57,-17,31
Young Boys,3163,1,21,6,5,71,38,33,69
FC Basel,3163,2,19,8,5,54,25,29,65
Lucerne,3163,3,14,7,11,46,44,2,49
St Gallen,3163,4,14,3,15,43,55,-12,45
FC Zürich,3163,5,11,9,12,43,38,5,42
Grasshoppers,3163,6,10,7,15,42,48,-6,37
FC Lugano,3163,7,10,5,17,33,52,-19,35
FC Thun,3163,8,9,6,17,42,56,-14,33
FC Sion,3163,9,7,7,18,39,57,-18,28
Young Boys,3164,1,20,9,3,69,36,33,69
FC Basel,3164,2,17,9,6,54,27,27,60
Lucerne,3164,3,13,7,12,42,46,-4,46
St Gallen,3164,4,14,3,15,39,53,-14,45
FC Zürich,3164,5,11,10,11,45,36,9,43
Grasshoppers,3164,6,11,7,14,46,48,-2,40
FC Lugano,3164,7,11,6,15,32,45,-13,39
FC Sion,3164,8,7,8,17,43,59,-16,29
FC Thun,3164,9,8,5,19,44,64,-20,29
Young Boys,3165,1,23,7,2,77,33,44,76
FC Basel,3165,2,17,9,6,55,28,27,60
St Gallen,3165,3,16,2,14,50,56,-6,50
Lucerne,3165,4,13,7,12,44,50,-6,46
FC Zürich,3165,5,12,9,11,44,36,8,45
FC Lugano,3165,6,10,5,17,30,50,-20,35
FC Thun,3165,7,9,7,16,44,60,-16,34
Grasshoppers,3165,8,8,6,18,38,52,-14,30
FC Sion,3165,9,6,8,18,41,58,-17,26
Young Boys,3166,1,23,7,2,71,30,41,76
FC Basel,3166,2,18,7,7,56,25,31,61
Lucerne,3166,3,13,9,10,44,43,1,48
St Gallen,3166,4,13,3,16,45,60,-15,42
FC Lugano,3166,5,11,6,15,33,48,-15,39
FC Zürich,3166,6,9,9,14,38,42,-4,36
FC Thun,3166,7,10,5,17,42,61,-19,35
Grasshoppers,3166,8,9,7,16,41,50,-9,34
FC Sion,3166,9,7,9,16,41,52,-11,30
Young Boys,3167,1,23,7,2,74,32,42,76
FC Basel,3167,2,16,9,7,50,26,24,57
Lucerne,3167,3,13,8,11,40,42,-2,47
St Gallen,3167,4,14,2,16,42,59,-17,44
FC Zürich,3167,5,11,10,11,40,37,3,43
Grasshoppers,3167,6,10,7,15,41,48,-7,37
FC Thun,3167,7,10,5,17,44,58,-14,35
FC Lugano,3167,8,10,5,17,31,49,-18,35
FC Sion,3167,9,7,7,18,44,55,-11,28
Young Boys,3168,1,23,7,2,76,36,40,76
FC Basel,3168,2,17,9,6,55,25,30,60
Lucerne,3168,3,13,8,11,43,45,-2,47
St Gallen,3168,4,15,2,15,43,57,-14,47
FC Lugano,3168,5,11,6,15,35,48,-13,39
FC Zürich,3168,6,9,11,12,42,40,2,38
Grasshoppers,3168,7,10,6,16,42,51,-9,36
FC Thun,3168,8,9,6,17,45,61,-16,33
FC Sion,3168,9,6,7,19,41,59,-18,25
Young Boys,3169,1,21,8,3,73,36,37,71
FC Basel,3169,2,18,8,6,55,27,28,62
St Gallen,3169,3,14,3,15,42,53,-11,45
Lucerne,3169,4,12,8,12,41,45,-4,44
FC Zürich,3169,5,11,10,11,42,36,6,43
FC Lugano,3169,6,11,6,15,32,47,-15,39
Grasshoppers,3169,7,9,9,14,42,49,-7,36
FC Thun,3169,8,9,5,18,44,60,-16,32
FC Sion,3169,9,6,9,17,40,58,-18,27
Young Boys,3170,1,22,7,3,79,45,34,73
FC Basel,3170,2,17,9,6,56,24,32,60
St Gallen,3170,3,14,4,14,42,55,-13,46
Lucerne,3170,4,11,10,11,42,45,-3,43
Grasshoppers,3170,5,11,7,14,42,47,-5,40
FC Zürich,3170,6,9,11,12,39,38,1,38
FC Lugano,3170,7,10,7,15,33,47,-14,37
FC Thun,3170,8,9,5,18,42,64,-22,32
FC Sion,3170,9,7,8,17,46,56,-10,29
Young Boys,3171,1,21,7,4,72,35,37,70
FC Basel,3171,2,16,10,6,51,24,27,58
Lucerne,3171,3,14,8,10,46,44,2,50
St Gallen,3171,4,15,2,15,42,55,-13,47
FC Zürich,3171,5,12,10,10,48,37,11,46
FC Lugano,3171,6,10,5,17,30,50,-20,35
FC Thun,3171,7,9,6,17,45,62,-17,33
Grasshoppers,3171,8,8,7,17,40,52,-12,31
FC Sion,3171,9,8,7,17,42,57,-15,31
Young Boys,3172,1,20,8,4,70,38,32,68
FC Basel,3172,2,20,7,5,64,26,38,67
FC Zürich,3172,3,12,9,11,41,37,4,45
St Gallen,3172,4,14,3,15,42,55,-13,45
Lucerne,3172,5,11,9,12,38,43,-5,42
FC Lugano,3172,6,11,5,16,33,47,-14,38
Grasshoppers,3172,7,9,8,15,39,49,-10,35
FC Thun,3172,8,8,7,17,44,62,-18,31
FC Sion,3172,9,7,8,17,42,56,-14,29
Young Boys,3173,1,22,7,3,75,34,41,73
FC Basel,3173,2,16,10,6,51,26,25,58
Lucerne,3173,3,13,9,10,44,44,0,48
St Gallen,3173,4,14,3,15,41,53,-12,45
FC Zürich,3173,5,10,10,12,40,38,2,40
FC Lugano,3173,6,11,6,15,33,48,-15,39
FC Thun,3173,7,10,6,16,46,59,-13,36
Grasshoppers,3173,8,9,6,17,43,55,-12,33
FC Sion,3173,9,7,7,18,42,58,-16,28
Young Boys,3174,1,21,8,3,70,37,33,71
FC Basel,3174,2,18,9,5,57,24,33,63
Lucerne,3174,3,14,9,9,44,40,4,51
St Gallen,3174,4,14,3,15,43,58,-15,45
FC Zürich,3174,5,10,9,13,38,36,2,39
Grasshoppers,3174,6,10,6,16,41,49,-8,36
FC Lugano,3174,7,10,6,16,31,47,-16,36
FC Thun,3174,8,10,5,17,44,60,-16,35
FC Sion,3174,9,6,7,19,39,56,-17,25
Young Boys,3175,1,21,7,4,72,38,34,70
FC Basel,3175,2,18,9,5,56,24,32,63
Lucerne,3175,3,14,8,10,49,44,5,50
St Gallen,3175,4,14,3,15,45,56,-11,45
FC Zürich,3175,5,10,11,11,42,38,4,41
FC Sion,3175,6,8,9,15,45,54,-9,33
FC Thun,3175,7,9,6,17,43,61,-18,33
FC Lugano,3175,8,9,6,17,29,52,-23,33
Grasshoppers,3175,9,8,7,17,40,54,-14,31
Young Boys,3176,1,20,9,3,68,33,35,69
FC Basel,3176,2,18,9,5,58,26,32,63
Lucerne,3176,3,13,9,10,45,43,2,48
St Gallen,3176,4,14,2,16,42,60,-18,44
FC Zürich,3176,5,9,11,12,39,38,1,38
Grasshoppers,3176,6,10,8,14,44,47,-3,38
FC Lugano,3176,7,10,7,15,30,44,-14,37
FC Thun,3176,8,9,6,17,43,60,-17,33
FC Sion,3176,9,7,7,18,39,57,-18,28
Young Boys,3177,1,20,7,5,69,36,33,67
FC Basel,3177,2,19,8,5,55,23,32,65
St Gallen,3177,3,15,3,14,43,53,-10,48
Lucerne,3177,4,13,8,11,41,42,-1,47
FC Zürich,3177,5,11,9,12,45,39,6,42
Grasshoppers,3177,6,11,7,14,43,48,-5,40
FC Lugano,3177,7,11,5,16,34,50,-16,38
FC Thun,3177,8,8,5,19,40,62,-22,29
FC Sion,3177,9,6,8,18,39,56,-17,26
Young Boys,3178,1,21,8,3,73,36,37,71
FC Basel,3178,2,18,9,5,58,23,35,63
St Gallen,3178,3,14,4,14,40,53,-13,46
Lucerne,3178,4,12,8,12,39,41,-2,44
FC Zürich,3178,5,9,12,11,38,35,3,39
Grasshoppers,3178,6,9,8,15,38,47,-9,35
FC Lugano,3178,7,9,7,16,30,51,-21,34
FC Thun,3178,8,9,6,17,43,63,-20,33
FC Sion,3178,9,8,8,16,41,51,-10,32
Young Boys,3179,1,22,6,4,71,33,38,72
FC Basel,3179,2,17,7,8,54,27,27,58
St Gallen,3179,3,14,4,14,42,53,-11,46
Lucerne,3179,4,12,8,12,39,47,-8,44
FC Zürich,3179,5,11,10,11,43,35,8,43
FC Lugano,3179,6,12,6,14,33,43,-10,42
Grasshoppers,3179,7,10,7,15,44,52,-8,37
FC Thun,3179,8,9,6,17,43,60,-17,33
FC Sion,3179,9,6,8,18,36,55,-19,26
Young Boys,3180,1,22,6,4,74,35,39,72
FC Basel,3180,2,18,8,6,54,25,29,62
FC Zürich,3180,3,11,10,11,40,35,5,43
Grasshoppers,3180,4,12,6,14,45,48,-3,42
Lucerne,3180,5,11,9,12,40,46,-6,42
St Gallen,3180,6,13,3,16,40,55,-15,42
FC Lugano,3180,7,10,6,16,29,48,-19,36
FC Thun,3180,8,9,5,18,42,63,-21,32
FC Sion,3180,9,8,7,17,44,53,-9,31
Young Boys,3181,1,22,7,3,75,34,41,73
FC Basel,3181,2,19,8,5,60,24,36,65
St Gallen,3181,3,13,5,14,43,58,-15,44
Lucerne,3181,4,11,8,13,39,47,-8,41
FC Zürich,3181,5,9,12,11,39,36,3,39
FC Lugano,3181,6,11,6,15,31,49,-18,39
Grasshoppers,3181,7,10,7,15,40,47,-7,37
FC Thun,3181,8,8,7,17,39,58,-19,31
FC Sion,3181,9,5,12,15,39,52,-13,27
Young Boys,3182,1,22,7,3,77,36,41,73
FC Basel,3182,2,18,8,6,53,25,28,62
Lucerne,3182,3,14,7,11,45,47,-2,49
St Gallen,3182,4,14,2,16,42,55,-13,44
FC Zürich,3182,5,11,10,11,40,36,4,43
Grasshoppers,3182,6,10,6,16,41,48,-7,36
FC Lugano,3182,7,10,6,16,33,51,-18,36
FC Thun,3182,8,10,5,17,43,59,-16,35
FC Sion,3182,9,6,7,19,39,56,-17,25
Young Boys,3183,1,22,7,3,70,35,35,73
FC Basel,3183,2,17,8,7,57,31,26,59
Lucerne,3183,3,15,8,9,51,42,9,53
St Gallen,3183,4,15,2,15,44,55,-11,47
FC Zürich,3183,5,10,10,12,40,38,2,40
FC Thun,3183,6,10,6,16,46,60,-14,36
Grasshoppers,3183,7,9,7,16,42,51,-9,34
FC Lugano,3183,8,9,5,18,28,50,-22,32
FC Sion,3183,9,7,7,18,39,55,-16,28
Young Boys,3184,1,20,8,4,67,34,33,68
FC Basel,3184,2,17,8,7,53,26,27,59
Lucerne,3184,3,13,9,10,44,42,2,48
St Gallen,3184,4,13,5,14,42,54,-12,44
FC Zürich,3184,5,11,9,12,42,40,2,42
FC Lugano,3184,6,12,6,14,34,45,-11,42
Grasshoppers,3184,7,10,7,15,40,49,-9,37
FC Thun,3184,8,9,6,17,41,58,-17,33
FC Sion,3184,9,5,10,17,36,51,-15,25
Young Boys,3185,1,22,7,3,73,33,40,73
FC Basel,3185,2,17,9,6,53,27,26,60
Lucerne,3185,3,13,7,12,41,45,-4,46
St Gallen,3185,4,14,3,15,43,59,-16,45
FC Zürich,3185,5,10,11,11,41,37,4,41
FC Lugano,3185,6,12,5,15,35,45,-10,41
Grasshoppers,3185,7,9,7,16,40,53,-13,34
FC Thun,3185,8,9,6,17,46,57,-11,33
FC Sion,3185,9,6,9,17,41,57,-16,27
Young Boys,3186,1,22,6,4,72,36,36,72
FC Basel,3186,2,20,7,5,55,22,33,67
St Gallen,3186,3,14,3,15,42,55,-13,45
FC Zürich,3186,4,11,9,12,43,36,7,42
Lucerne,3186,5,11,9,12,39,44,-5,42
Grasshoppers,3186,6,10,8,14,43,48,-5,38
FC Lugano,3186,7,11,5,16,34,50,-16,38
FC Thun,3186,8,10,5,17,46,59,-13,35
FC Sion,3186,9,5,8,19,36,60,-24,23
Young Boys,3187,1,23,7,2,79,30,49,76
FC Basel,3187,2,18,8,6,56,35,21,62
Lucerne,3187,3,13,8,11,41,44,-3,47
St Gallen,3187,4,13,4,15,42,56,-14,43
FC Zürich,3187,5,10,11,11,40,36,4,41
FC Lugano,3187,6,10,6,16,29,47,-18,36
Grasshoppers,3187,7,9,6,17,37,48,-11,33
FC Sion,3187,8,8,8,16,41,50,-9,32
FC Thun,3187,9,8,6,18,43,62,-19,30
Young Boys,3188,1,21,8,3,71,37,34,71
FC Basel,3188,2,17,8,7,52,26,26,59
St Gallen,3188,3,16,3,13,45,51,-6,51
Lucerne,3188,4,13,7,12,42,43,-1,46
FC Zürich,3188,5,9,12,11,37,34,3,39
FC Lugano,3188,6,10,7,15,29,45,-16,37
Grasshoppers,3188,7,9,7,16,41,51,-10,34
FC Thun,3188,8,8,7,17,39,56,-17,31
FC Sion,3188,9,7,9,16,40,53,-13,30
Young Boys,3189,1,20,9,3,69,34,35,69
FC Basel,3189,2,16,10,6,53,26,27,58
St Gallen,3189,3,14,4,14,45,56,-11,46
Lucerne,3189,4,11,10,11,41,46,-5,43
FC Zürich,3189,5,10,10,12,41,40,1,40
Grasshoppers,3189,6,10,7,15,45,50,-5,37
FC Thun,3189,7,10,7,15,46,58,-12,37
FC Lugano,3189,8,10,6,16,32,49,-17,36
FC Sion,3189,9,7,9,16,44,57,-13,30
Young Boys,3190,1,20,9,3,69,34,35,69
FC Basel,3190,2,16,9,7,50,28,22,57
Lucerne,3190,3,14,7,11,45,44,1,49
St Gallen,3190,4,15,3,14,49,56,-7,48
FC Zürich,3190,5,10,12,10,41,36,5,42
Grasshoppers,3190,6,10,6,16,42,54,-12,36
FC Lugano,3190,7,9,8,15,32,49,-17,35
FC Thun,3190,8,9,7,16,45,58,-13,34
FC Sion,3190,9,6,9,17,41,55,-14,27
Young Boys,3191,1,20,9,3,68,34,34,69
FC Basel,3191,2,17,9,6,52,25,27,60
Lucerne,3191,3,12,10,10,41,43,-2,46
St Gallen,3191,4,14,3,15,41,53,-12,45
FC Zürich,3191,5,11,11,10,41,34,7,44
FC Lugano,3191,6,10,7,15,28,45,-17,37
Grasshoppers,3191,7,10,6,16,43,51,-8,36
FC Thun,3191,8,10,5,17,47,60,-13,35
FC Sion,3191,9,6,8,18,38,54,-16,26
Young Boys,3192,1,21,8,3,70,35,35,71
FC Basel,3192,2,17,8,7,55,29,26,59
Lucerne,3192,3,14,8,10,46,42,4,50
St Gallen,3192,4,15,4,13,44,53,-9,49
FC Zürich,3192,5,13,9,10,46,34,12,48
FC Thun,3192,6,10,5,17,46,63,-17,35
FC Lugano,3192,7,9,6,17,29,47,-18,33
Grasshoppers,3192,8,8,6,18,40,55,-15,30
FC Sion,3192,9,6,8,18,40,58,-18,26
Young Boys,3193,1,21,7,4,70,35,35,70
FC Basel,3193,2,18,8,6,55,24,31,62
St Gallen,3193,3,15,4,13,44,52,-8,49
Lucerne,3193,4,13,8,11,41,41,0,47
FC Zürich,3193,5,10,11,11,40,36,4,41
Grasshoppers,3193,6,9,7,16,42,50,-8,34
FC Thun,3193,7,9,7,16,41,59,-18,34
FC Lugano,3193,8,9,7,16,31,51,-20,34
FC Sion,3193,9,7,7,18,39,55,-16,28
Young Boys,3194,1,21,7,4,73,38,35,70
FC Basel,3194,2,20,7,5,61,24,37,67
Lucerne,3194,3,13,7,12,43,47,-4,46
FC Zürich,3194,4,12,9,11,43,38,5,45
St Gallen,3194,5,13,2,17,40,56,-16,41
Grasshoppers,3194,6,10,6,16,43,54,-11,36
FC Lugano,3194,7,10,6,16,31,48,-17,36
FC Thun,3194,8,9,6,17,45,59,-14,33
FC Sion,3194,9,7,8,17,38,53,-15,29
Young Boys,3195,1,20,7,5,67,37,30,67
FC Basel,3195,2,17,8,7,52,27,25,59
Lucerne,3195,3,14,9,9,44,41,3,51
St Gallen,3195,4,14,2,16,42,56,-14,44
FC Zürich,3195,5,11,10,11,41,36,5,43
FC Lugano,3195,6,11,6,15,32,47,-15,39
Grasshoppers,3195,7,10,7,15,45,48,-3,37
FC Thun,3195,8,9,6,17,42,58,-16,33
FC Sion,3195,9,7,7,18,40,55,-15,28
Young Boys,3196,1,23,6,3,77,33,44,75
FC Basel,3196,2,18,8,6,51,24,27,62
Lucerne,3196,3,14,7,11,46,46,0,49
St Gallen,3196,4,14,4,14,43,55,-12,46
FC Lugano,3196,5,11,5,16,35,50,-15,38
FC Zürich,3196,6,9,10,13,39,43,-4,37
FC Thun,3196,7,10,6,16,46,56,-10,36
Grasshoppers,3196,8,8,8,16,41,56,-15,32
FC Sion,3196,9,5,10,17,40,55,-15,25
Young Boys,3197,1,21,6,5,72,40,32,69
FC Basel,3197,2,18,7,7,53,25,28,61
Lucerne,3197,3,14,7,11,43,41,2,49
St Gallen,3197,4,15,3,14,43,54,-11,48
FC Zürich,3197,5,9,12,11,40,37,3,39
Grasshoppers,3197,6,10,6,16,45,52,-7,36
FC Thun,3197,7,10,6,16,45,62,-17,36
FC Lugano,3197,8,9,7,16,31,50,-19,34
FC Sion,3197,9,7,8,17,45,56,-11,29
Young Boys,3198,1,22,7,3,73,35,38,73
FC Basel,3198,2,15,9,8,49,30,19,54
Lucerne,3198,3,13,9,10,43,42,1,48
St Gallen,3198,4,14,4,14,42,53,-11,46
FC Zürich,3198,5,12,9,11,43,36,7,45
FC Thun,3198,6,12,5,15,47,55,-8,41
FC Lugano,3198,7,10,5,17,30,49,-19,35
Grasshoppers,3198,8,9,7,16,38,48,-10,34
FC Sion,3198,9,5,9,18,38,55,-17,24
Young Boys,3199,1,20,8,4,70,36,34,68
FC Basel,3199,2,18,9,5,54,25,29,63
St Gallen,3199,3,15,2,15,44,54,-10,47
Lucerne,3199,4,12,8,12,39,45,-6,44
FC Zürich,3199,5,10,11,11,41,36,5,41
Grasshoppers,3199,6,9,8,15,41,51,-10,35
FC Thun,3199,7,10,5,17,49,62,-13,35
FC Lugano,3199,8,9,7,16,31,49,-18,34
FC Sion,3199,9,8,8,16,42,53,-11,32
Young Boys,3200,1,22,6,4,72,35,37,72
FC Basel,3200,2,19,7,6,58,27,31,64
St Gallen,3200,3,14,2,16,43,59,-16,44
Lucerne,3200,4,12,7,13,41,48,-7,43
Grasshoppers,3200,5,11,6,15,43,47,-4,39
FC Lugano,3200,6,11,5,16,36,49,-13,38
FC Zürich,3200,7,9,10,13,39,40,-1,37
FC Thun,3200,8,10,6,16,43,60,-17,36
FC Sion,3200,9,8,7,17,43,53,-10,31
Young Boys,3201,1,21,6,5,71,41,30,69
FC Basel,3201,2,18,8,6,58,25,33,62
St Gallen,3201,3,14,3,15,43,57,-14,45
Lucerne,3201,4,11,9,12,40,49,-9,42
FC Zürich,3201,5,10,11,11,38,33,5,41
Grasshoppers,3201,6,11,7,14,44,45,-1,40
FC Lugano,3201,7,10,6,16,30,47,-17,36
FC Thun,3201,8,9,6,17,39,59,-20,33
FC Sion,3201,9,8,8,16,43,50,-7,32
Young Boys,3202,1,23,6,3,75,33,42,75
FC Basel,3202,2,16,10,6,48,23,25,58
Lucerne,3202,3,13,8,11,41,44,-3,47
St Gallen,3202,4,14,3,15,41,56,-15,45
FC Lugano,3202,5,12,5,15,36,47,-11,41
FC Zürich,3202,6,10,10,12,38,35,3,40
Grasshoppers,3202,7,9,7,16,40,49,-9,34
FC Thun,3202,8,8,8,16,42,58,-16,32
FC Sion,3202,9,6,9,17,39,55,-16,27
Young Boys,3203,1,24,6,2,77,35,42,78
FC Basel,3203,2,16,9,7,51,27,24,57
St Gallen,3203,3,15,4,13,44,51,-7,49
Lucerne,3203,4,13,8,11,42,45,-3,47
FC Zürich,3203,5,10,11,11,40,36,4,41
FC Lugano,3203,6,10,6,16,32,48,-16,36
Grasshoppers,3203,7,8,7,17,41,53,-12,31
FC Thun,3203,8,8,7,17,41,59,-18,31
FC Sion,3203,9,6,10,16,38,52,-14,28
Young Boys,3204,1,21,9,2,72,35,37,72
FC Basel,3204,2,17,7,8,54,28,26,58
Lucerne,3204,3,14,8,10,44,40,4,50
St Gallen,3204,4,15,2,15,45,58,-13,47
FC Zürich,3204,5,10,10,12,42,39,3,40
Grasshoppers,3204,6,10,7,15,40,49,-9,37
FC Thun,3204,7,10,5,17,44,59,-15,35
FC Lugano,3204,8,9,8,15,33,49,-16,35
FC Sion,3204,9,6,8,18,41,58,-17,26
Young Boys,3205,1,20,7,5,71,35,36,67
FC Basel,3205,2,18,9,5,54,25,29,63
St Gallen,3205,3,15,4,13,45,51,-6,49
Lucerne,3205,4,13,9,10,44,43,1,48
FC Zürich,3205,5,10,10,12,40,38,2,40
Grasshoppers,3205,6,10,7,15,43,51,-8,37
FC Thun,3205,7,10,5,17,45,60,-15,35
FC Lugano,3205,8,9,8,15,29,50,-21,35
FC Sion,3205,9,5,9,18,37,55,-18,24
Young Boys,3206,1,21,8,3,67,32,35,71
FC Basel,3206,2,15,10,7,50,28,22,55
Lucerne,3206,3,14,7,11,40,39,1,49
St Gallen,3206,4,15,3,14,44,53,-9,48
FC Zürich,3206,5,11,10,11,41,36,5,43
Grasshoppers,3206,6,11,7,14,41,46,-5,40
FC Thun,3206,7,9,7,16,46,58,-12,34
FC Lugano,3206,8,9,6,17,29,47,-18,33
FC Sion,3206,9,6,8,18,37,56,-19,26
Young Boys,3207,1,21,9,2,70,33,37,72
FC Basel,3207,2,16,9,7,50,28,22,57
FC Zürich,3207,3,12,9,11,45,36,9,45
Lucerne,3207,4,11,12,9,39,40,-1,45
St Gallen,3207,5,13,4,15,41,56,-15,43
FC Lugano,3207,6,11,6,15,33,46,-13,39
FC Thun,3207,7,10,5,17,47,59,-12,35
Grasshoppers,3207,8,8,8,16,38,52,-14,32
FC Sion,3207,9,7,8,17,44,57,-13,29
Young Boys,3208,1,22,8,2,77,34,43,74
FC Basel,3208,2,19,7,6,61,30,31,64
St Gallen,3208,3,15,2,15,42,55,-13,47
Lucerne,3208,4,12,9,11,41,43,-2,45
FC Zürich,3208,5,11,9,12,42,38,4,42
FC Thun,3208,6,11,5,16,46,61,-15,38
FC Lugano,3208,7,10,5,17,31,51,-20,35
Grasshoppers,3208,8,9,7,16,42,51,-9,34
FC Sion,3208,9,5,8,19,39,58,-19,23
Young Boys,3209,1,22,7,3,73,34,39,73
FC Basel,3209,2,19,7,6,59,23,36,64
St Gallen,3209,3,14,3,15,42,57,-15,45
Lucerne,3209,4,11,10,11,39,46,-7,43
FC Zürich,3209,5,11,9,12,40,36,4,42
Grasshoppers,3209,6,9,9,14,42,47,-5,36
FC Lugano,3209,7,10,6,16,31,52,-21,36
FC Thun,3209,8,8,7,17,41,58,-17,31
FC Sion,3209,9,7,8,17,42,56,-14,29
Young Boys,3210,1,21,9,2,72,35,37,72
FC Basel,3210,2,19,8,5,57,23,34,65
Lucerne,3210,3,13,7,12,42,46,-4,46
St Gallen,3210,4,14,2,16,44,58,-14,44
FC Zürich,3210,5,11,10,11,40,36,4,43
FC Lugano,3210,6,11,6,15,33,45,-12,39
Grasshoppers,3210,7,10,7,15,40,47,-7,37
FC Thun,3210,8,8,7,17,41,60,-19,31
FC Sion,3210,9,5,8,19,39,58,-19,23
Young Boys,3211,1,24,6,2,74,34,40,78
FC Basel,3211,2,17,9,6,53,24,29,60
Lucerne,3211,3,13,8,11,42,43,-1,47
St Gallen,3211,4,14,3,15,41,54,-13,45
FC Zürich,3211,5,10,9,13,38,38,0,39
Grasshoppers,3211,6,9,8,15,40,48,-8,35
FC Lugano,3211,7,10,5,17,32,48,-16,35
FC Thun,3211,8,9,7,16,42,59,-17,34
FC Sion,3211,9,6,9,17,40,54,-14,27
Young Boys,3212,1,23,6,3,72,34,38,75
FC Basel,3212,2,17,8,7,53,28,25,59
Lucerne,3212,3,14,8,10,43,45,-2,50
St Gallen,3212,4,14,2,16,42,56,-14,44
FC Zürich,3212,5,10,11,11,39,35,4,41
FC Thun,3212,6,10,6,16,45,58,-13,36
FC Lugano,3212,7,10,5,17,31,46,-15,35
Grasshoppers,3212,8,8,9,15,43,52,-9,33
FC Sion,3212,9,6,9,17,39,53,-14,27
Young Boys,3213,1,21,8,3,71,34,37,71
FC Basel,3213,2,17,8,7,52,25,27,59
St Gallen,3213,3,16,2,14,42,51,-9,50
FC Zürich,3213,4,12,10,10,41,32,9,46
Lucerne,3213,5,12,8,12,39,44,-5,44
Grasshoppers,3213,6,9,8,15,39,47,-8,35
FC Lugano,3213,7,10,5,17,30,48,-18,35
FC Thun,3213,8,9,5,18,40,62,-22,32
FC Sion,3213,9,7,8,17,40,51,-11,29
Young Boys,3214,1,22,7,3,72,35,37,73
FC Basel,3214,2,18,8,6,57,25,32,62
St Gallen,3214,3,15,2,15,42,54,-12,47
Lucerne,3214,4,12,7,13,40,46,-6,43
FC Zürich,3214,5,10,10,12,41,40,1,40
FC Thun,3214,6,11,5,16,49,62,-13,38
Grasshoppers,3214,7,10,7,15,41,48,-7,37
FC Lugano,3214,8,10,6,16,32,48,-16,36
FC Sion,3214,9,6,8,18,39,55,-16,26
Young Boys,3215,1,20,8,4,70,36,34,68
FC Basel,3215,2,16,8,8,49,29,20,56
St Gallen,3215,3,16,2,14,43,51,-8,50
Lucerne,3215,4,12,9,11,40,44,-4,45
FC Zürich,3215,5,11,9,12,41,38,3,42
FC Lugano,3215,6,12,6,14,34,44,-10,42
Grasshoppers,3215,7,9,9,14,44,51,-7,36
FC Thun,3215,8,9,7,16,48,61,-13,34
FC Sion,3215,9,6,8,18,38,53,-15,26
Young Boys,3216,1,21,6,5,71,35,36,69
FC Basel,3216,2,17,9,6,53,28,25,60
St Gallen,3216,3,15,3,14,43,53,-10,48
Lucerne,3216,4,12,8,12,40,46,-6,44
FC Zürich,3216,5,11,10,11,45,37,8,43
FC Thun,3216,6,11,5,16,47,59,-12,38
Grasshoppers,3216,7,10,7,15,43,49,-6,37
FC Lugano,3216,8,9,6,17,27,46,-19,33
FC Sion,3216,9,7,8,17,39,55,-16,29
Young Boys,3217,1,20,7,5,69,36,33,67
FC Basel,3217,2,17,9,6,54,27,27,60
St Gallen,3217,3,15,3,14,43,54,-11,48
Lucerne,3217,4,13,8,11,42,41,1,47
FC Zürich,3217,5,10,11,11,42,37,5,41
Grasshoppers,3217,6,10,6,16,40,50,-10,36
FC Lugano,3217,7,10,5,17,31,51,-20,35
FC Thun,3217,8,9,7,16,43,57,-14,34
FC Sion,3217,9,7,10,15,40,51,-11,31
Young Boys,3218,1,23,6,3,73,33,40,75
FC Basel,3218,2,18,9,5,52,21,31,63
Lucerne,3218,3,13,8,11,40,45,-5,47
St Gallen,3218,4,14,4,14,41,51,-10,46
FC Zürich,3218,5,10,11,11,41,37,4,41
FC Thun,3218,6,11,5,16,49,63,-14,38
Grasshoppers,3218,7,9,7,16,44,52,-8,34
FC Lugano,3218,8,9,6,17,28,47,-19,33
FC Sion,3218,9,5,8,19,37,56,-19,23
Young Boys,3219,1,22,7,3,75,36,39,73
FC Basel,3219,2,17,10,5,55,26,29,61
St Gallen,3219,3,15,3,14,43,53,-10,48
Lucerne,3219,4,12,8,12,40,46,-6,44
FC Zürich,3219,5,10,11,11,40,36,4,41
Grasshoppers,3219,6,10,7,15,41,47,-6,37
FC Lugano,3219,7,10,5,17,31,47,-16,35
FC Thun,3219,8,9,6,17,46,64,-18,33
FC Sion,3219,9,7,7,18,40,56,-16,28
Young Boys,3220,1,22,6,4,76,39,37,72
FC Basel,3220,2,19,7,6,60,28,32,64
Lucerne,3220,3,15,8,9,50,42,8,53
St Gallen,3220,4,13,4,15,40,53,-13,43
FC Zürich,3220,5,10,10,12,39,39,0,40
FC Lugano,3220,6,10,6,16,29,46,-17,36
FC Thun,3220,7,9,6,17,43,62,-19,33
Grasshoppers,3220,8,8,7,17,38,50,-12,31
FC Sion,3220,9,7,8,17,39,55,-16,29
Young Boys,3221,1,21,7,4,69,36,33,70
FC Basel,3221,2,18,9,5,55,23,32,63
St Gallen,3221,3,15,4,13,46,55,-9,49
Lucerne,3221,4,13,7,12,42,43,-1,46
FC Zürich,3221,5,11,11,10,43,35,8,44
FC Thun,3221,6,10,6,16,43,57,-14,36
FC Lugano,3221,7,10,6,16,33,51,-18,36
Grasshoppers,3221,8,8,8,16,41,53,-12,32
FC Sion,3221,9,5,8,19,40,59,-19,23
Young Boys,3222,1,22,6,4,74,42,32,72
FC Basel,3222,2,19,7,6,54,26,28,64
Lucerne,3222,3,13,9,10,49,46,3,48
St Gallen,3222,4,13,4,15,42,55,-13,43
FC Zürich,3222,5,11,9,12,39,35,4,42
FC Thun,3222,6,11,5,16,45,56,-11,38
Grasshoppers,3222,7,9,8,15,42,49,-7,35
FC Lugano,3222,8,10,5,17,32,50,-18,35
FC Sion,3222,9,5,9,18,37,55,-18,24
Young Boys,3223,1,22,7,3,73,34,39,73
FC Basel,3223,2,16,11,5,53,25,28,59
St Gallen,3223,3,15,3,14,43,54,-11,48
Lucerne,3223,4,13,8,11,41,41,0,47
FC Zürich,3223,5,12,10,10,41,33,8,46
Grasshoppers,3223,6,10,6,16,42,51,-9,36
FC Thun,3223,7,9,6,17,42,59,-17,33
FC Lugano,3223,8,9,5,18,28,49,-21,32
FC Sion,3223,9,6,8,18,37,54,-17,26
Young Boys,3224,1,22,7,3,72,35,37,73
FC Basel,3224,2,17,9,6,52,27,25,60
Lucerne,3224,3,13,7,12,48,49,-1,46
St Gallen,3224,4,14,4,14,43,53,-10,46
FC Zürich,3224,5,10,11,11,44,39,5,41
Grasshoppers,3224,6,11,7,14,44,46,-2,40
FC Thun,3224,7,10,5,17,45,59,-14,35
FC Lugano,3224,8,10,5,17,31,53,-22,35
FC Sion,3224,9,5,9,18,42,60,-18,24
Young Boys,3225,1,21,7,4,74,34,40,70
FC Basel,3225,2,17,8,7,52,27,25,59
Lucerne,3225,3,14,7,11,46,43,3,49
St Gallen,3225,4,14,3,15,40,53,-13,45
FC Zürich,3225,5,10,10,12,39,37,2,40
FC Lugano,3225,6,10,7,15,29,45,-16,37
Grasshoppers,3225,7,10,6,16,41,56,-15,36
FC Thun,3225,8,10,5,17,42,56,-14,35
FC Sion,3225,9,8,7,17,40,52,-12,31
Young Boys,3226,1,22,6,4,74,35,39,72
FC Basel,3226,2,18,9,5,56,27,29,63
Lucerne,3226,3,14,7,11,45,44,1,49
St Gallen,3226,4,14,4,14,50,60,-10,46
FC Zürich,3226,5,10,9,13,40,38,2,39
FC Thun,3226,6,10,6,16,44,56,-12,36
Grasshoppers,3226,7,9,6,17,39,52,-13,33
FC Sion,3226,8,8,8,16,43,54,-11,32
FC Lugano,3226,9,9,5,18,29,54,-25,32
Young Boys,3227,1,22,7,3,73,35,38,73
FC Basel,3227,2,17,9,6,54,24,30,60
St Gallen,3227,3,14,3,15,42,57,-15,45
Lucerne,3227,4,12,8,12,40,43,-3,44
FC Zürich,3227,5,10,11,11,38,34,4,41
Grasshoppers,3227,6,11,6,15,43,45,-2,39
FC Thun,3227,7,11,5,16,44,55,-11,38
FC Lugano,3227,8,10,5,17,29,52,-23,35
FC Sion,3227,9,6,8,18,40,58,-18,26
Young Boys,3228,1,23,7,2,72,31,41,76
FC Basel,3228,2,17,7,8,53,29,24,58
St Gallen,3228,3,14,3,15,43,56,-13,45
FC Zürich,3228,4,11,10,11,44,36,8,43
Lucerne,3228,5,11,9,12,42,48,-6,42
FC Lugano,3228,6,11,6,15,31,46,-15,39
Grasshoppers,3228,7,10,7,15,42,50,-8,37
FC Thun,3228,8,10,6,16,43,56,-13,36
FC Sion,3228,9,5,9,18,40,58,-18,24
Young Boys,3229,1,21,9,2,76,35,41,72
FC Basel,3229,2,18,8,6,56,26,30,62
St Gallen,3229,3,16,3,13,45,53,-8,51
Lucerne,3229,4,12,8,12,38,43,-5,44
FC Zürich,3229,5,10,10,12,38,37,1,40
FC Thun,3229,6,10,6,16,44,59,-15,36
FC Lugano,3229,7,10,6,16,29,48,-19,36
Grasshoppers,3229,8,8,7,17,40,51,-11,31
FC Sion,3229,9,6,9,17,42,56,-14,27
Young Boys,3230,1,23,7,2,72,33,39,76
FC Basel,3230,2,17,9,6,55,27,28,60
St Gallen,3230,3,15,2,15,40,53,-13,47
FC Zürich,3230,4,10,11,11,39,35,4,41
Lucerne,3230,5,11,7,14,39,50,-11,40
FC Thun,3230,6,11,6,15,49,57,-8,39
FC Lugano,3230,7,10,6,16,33,47,-14,36
Grasshoppers,3230,8,9,6,17,40,52,-12,33
FC Sion,3230,9,7,8,17,39,52,-13,29
Young Boys,3231,1,21,7,4,68,35,33,70
FC Basel,3231,2,18,8,6,52,24,28,62
St Gallen,3231,3,14,3,15,46,60,-14,45
FC Zürich,3231,4,11,9,12,40,34,6,42
Lucerne,3231,5,11,8,13,41,47,-6,41
FC Lugano,3231,6,11,6,15,34,47,-13,39
Grasshoppers,3231,7,10,8,14,43,49,-6,38
FC Thun,3231,8,10,5,17,42,56,-14,35
FC Sion,3231,9,7,8,17,38,52,-14,29
Young Boys,3232,1,20,9,3,69,34,35,69
FC Basel,3232,2,18,8,6,57,31,26,62
Lucerne,3232,3,12,9,11,41,43,-2,45
FC Zürich,3232,4,11,10,11,42,35,7,43
St Gallen,3232,5,13,3,16,39,55,-16,42
Grasshoppers,3232,6,11,6,15,43,49,-6,39
FC Lugano,3232,7,10,6,16,30,45,-15,36
FC Thun,3232,8,9,6,17,42,58,-16,33
FC Sion,3232,9,7,9,16,39,52,-13,30
Young Boys,3233,1,22,6,4,71,34,37,72
FC Basel,3233,2,19,7,6,60,28,32,64
Lucerne,3233,3,14,7,11,43,43,0,49
St Gallen,3233,4,15,2,15,45,58,-13,47
FC Zürich,3233,5,11,9,12,42,38,4,42
FC Lugano,3233,6,11,5,16,33,46,-13,38
FC Thun,3233,7,10,5,17,44,61,-17,35
Grasshoppers,3233,8,8,7,17,40,51,-11,31
FC Sion,3233,9,6,8,18,42,61,-19,26
Young Boys,3234,1,21,8,3,71,35,36,71
FC Basel,3234,2,18,8,6,52,23,29,62
Lucerne,3234,3,13,8,11,44,46,-2,47
St Gallen,3234,4,15,2,15,43,54,-11,47
FC Zürich,3234,5,10,10,12,40,36,4,40
Grasshoppers,3234,6,11,6,15,45,47,-2,39
FC Lugano,3234,7,11,5,16,35,51,-16,38
FC Thun,3234,8,9,5,18,43,63,-20,32
FC Sion,3234,9,6,8,18,39,57,-18,26
Young Boys,3235,1,21,8,3,73,34,39,71
FC Basel,3235,2,19,8,5,57,23,34,65
Lucerne,3235,3,12,8,12,41,51,-10,44
St Gallen,3235,4,13,3,16,39,55,-16,42
FC Zürich,3235,5,10,11,11,43,39,4,41
FC Lugano,3235,6,11,6,15,33,46,-13,39
FC Thun,3235,7,9,8,15,44,56,-12,35
Grasshoppers,3235,8,8,7,17,40,54,-14,31
FC Sion,3235,9,7,9,16,40,52,-12,30
Young Boys,3236,1,22,6,4,78,39,39,72
FC Basel,3236,2,18,9,5,57,27,30,63
Lucerne,3236,3,13,8,11,43,46,-3,47
St Gallen,3236,4,14,3,15,44,55,-11,45
FC Zürich,3236,5,9,11,12,40,41,-1,38
FC Sion,3236,6,9,8,15,49,57,-8,35
Grasshoppers,3236,7,9,7,16,43,53,-10,34
FC Lugano,3236,8,9,7,16,31,51,-20,34
FC Thun,3236,9,9,5,18,44,60,-16,32
Young Boys,3237,1,19,8,5,68,39,29,65
FC Basel,3237,2,17,8,7,54,28,26,59
Lucerne,3237,3,15,7,10,45,45,0,52
St Gallen,3237,4,15,2,15,43,56,-13,47
FC Zürich,3237,5,12,9,11,43,35,8,45
FC Thun,3237,6,10,5,17,44,58,-14,35
FC Sion,3237,7,9,7,16,44,54,-10,34
Grasshoppers,3237,8,9,6,17,43,51,-8,33
FC Lugano,3237,9,9,6,17,31,49,-18,33
Young Boys,3238,1,21,7,4,69,34,35,70
FC Basel,3238,2,16,9,7,53,29,24,57
Lucerne,3238,3,13,9,10,42,43,-1,48
FC Zürich,3238,4,11,10,11,41,36,5,43
St Gallen,3238,5,13,4,15,42,57,-15,43
Grasshoppers,3238,6,11,6,15,45,48,-3,39
FC Thun,3238,7,10,7,15,47,58,-11,37
FC Lugano,3238,8,10,6,16,31,47,-16,36
FC Sion,3238,9,5,10,17,39,57,-18,25
Young Boys,3239,1,23,6,3,74,38,36,75
FC Basel,3239,2,19,8,5,59,25,34,65
St Gallen,3239,3,14,4,14,44,53,-9,46
Lucerne,3239,4,12,7,13,40,44,-4,43
FC Zürich,3239,5,11,9,12,45,38,7,42
FC Lugano,3239,6,11,5,16,33,51,-18,38
Grasshoppers,3239,7,9,6,17,39,50,-11,33
FC Thun,3239,8,9,6,17,46,61,-15,33
FC Sion,3239,9,6,9,17,38,58,-20,27
Young Boys,3240,1,21,8,3,75,36,39,71
FC Basel,3240,2,18,8,6,57,28,29,62
Lucerne,3240,3,14,8,10,44,43,1,50
St Gallen,3240,4,15,2,15,42,55,-13,47
FC Zürich,3240,5,11,10,11,45,37,8,43
FC Thun,3240,6,10,6,16,49,58,-9,36
FC Lugano,3240,7,9,7,16,28,45,-17,34
Grasshoppers,3240,8,9,6,17,45,56,-11,33
FC Sion,3240,9,6,7,19,37,64,-27,25
Young Boys,3241,1,21,8,3,73,38,35,71
FC Basel,3241,2,16,9,7,53,30,23,57
Lucerne,3241,3,14,9,9,43,41,2,51
FC Zürich,3241,4,13,9,10,44,34,10,48
St Gallen,3241,5,14,4,14,43,55,-12,46
FC Lugano,3241,6,10,6,16,32,47,-15,36
Grasshoppers,3241,7,9,7,16,39,47,-8,34
FC Thun,3241,8,9,6,17,44,60,-16,33
FC Sion,3241,9,5,8,19,39,58,-19,23
Young Boys,3242,1,22,6,4,70,35,35,72
FC Basel,3242,2,17,8,7,55,28,27,59
Lucerne,3242,3,13,8,11,43,42,1,47
St Gallen,3242,4,14,3,15,42,56,-14,45
FC Zürich,3242,5,11,10,11,44,37,7,43
FC Lugano,3242,6,10,6,16,31,49,-18,36
FC Thun,3242,7,10,5,17,47,61,-14,35
Grasshoppers,3242,8,9,6,17,40,52,-12,33
FC Sion,3242,9,8,8,16,40,52,-12,32
Young Boys,3243,1,20,7,5,69,38,31,67
FC Basel,3243,2,16,10,6,56,31,25,58
Lucerne,3243,3,14,8,10,43,42,1,50
St Gallen,3243,4,15,4,13,46,54,-8,49
FC Zürich,3243,5,10,12,10,44,38,6,42
Grasshoppers,3243,6,9,7,16,40,50,-10,34
FC Thun,3243,7,9,7,16,49,61,-12,34
FC Lugano,3243,8,9,7,16,30,47,-17,34
FC Sion,3243,9,7,8,17,39,55,-16,29
Young Boys,3244,1,21,6,5,70,39,31,69
FC Basel,3244,2,18,8,6,57,25,32,62
FC Zürich,3244,3,12,10,10,41,33,8,46
St Gallen,3244,4,14,4,14,42,53,-11,46
Lucerne,3244,5,11,9,12,39,47,-8,42
Grasshoppers,3244,6,10,7,15,44,53,-9,37
FC Thun,3244,7,10,6,16,45,58,-13,36
FC Lugano,3244,8,10,6,16,28,44,-16,36
FC Sion,3244,9,6,8,18,43,57,-14,26
Young Boys,3245,1,22,8,2,74,34,40,74
FC Basel,3245,2,18,8,6,56,23,33,62
St Gallen,3245,3,15,2,15,42,55,-13,47
Lucerne,3245,4,12,8,12,41,49,-8,44
FC Zürich,3245,5,10,11,11,42,38,4,41
FC Thun,3245,6,10,6,16,44,57,-13,36
FC Lugano,3245,7,9,6,17,31,50,-19,33
Grasshoppers,3245,8,8,8,16,39,50,-11,32
FC Sion,3245,9,7,9,16,40,53,-13,30
Young Boys,3246,1,20,8,4,70,38,32,68
FC Basel,3246,2,17,8,7,56,29,27,59
St Gallen,3246,3,15,4,13,42,51,-9,49
FC Zürich,3246,4,12,10,10,43,34,9,46
Lucerne,3246,5,12,9,11,39,43,-4,45
Grasshoppers,3246,6,11,6,15,44,49,-5,39
FC Lugano,3246,7,10,7,15,31,44,-13,37
FC Thun,3246,8,8,5,19,43,66,-23,29
FC Sion,3246,9,6,9,17,44,58,-14,27
Young Boys,3247,1,21,8,3,73,33,40,71
FC Basel,3247,2,17,9,6,51,25,26,60
Lucerne,3247,3,15,7,10,43,41,2,52
St Gallen,3247,4,15,2,15,41,52,-11,47
FC Zürich,3247,5,10,9,13,38,38,0,39
FC Lugano,3247,6,11,5,16,33,49,-16,38
FC Thun,3247,7,9,7,16,43,58,-15,34
Grasshoppers,3247,8,8,9,15,40,49,-9,33
FC Sion,3247,9,6,8,18,37,54,-17,26
Young Boys,3248,1,22,8,2,82,38,44,74
FC Basel,3248,2,18,8,6,58,26,32,62
FC Zürich,3248,3,12,10,10,41,34,7,46
Lucerne,3248,4,13,7,12,42,46,-4,46
St Gallen,3248,5,14,2,16,42,56,-14,44
FC Lugano,3248,6,11,5,16,31,51,-20,38
Grasshoppers,3248,7,8,8,16,43,53,-10,32
FC Thun,3248,8,8,8,16,41,59,-18,32
FC Sion,3248,9,6,8,18,36,53,-17,26
Young Boys,3249,1,21,8,3,69,33,36,71
FC Basel,3249,2,17,9,6,50,23,27,60
St Gallen,3249,3,16,3,13,45,51,-6,51
FC Zürich,3249,4,11,11,10,42,36,6,44
Lucerne,3249,5,12,7,13,41,46,-5,43
Grasshoppers,3249,6,10,7,15,41,48,-7,37
FC Lugano,3249,7,10,6,16,30,47,-17,36
FC Thun,3249,8,9,6,17,41,57,-16,33
FC Sion,3249,9,5,9,18,36,54,-18,24
Young Boys,3250,1,22,6,4,72,32,40,72
FC Basel,3250,2,20,7,5,58,22,36,67
Lucerne,3250,3,12,9,11,42,46,-4,45
St Gallen,3250,4,13,5,14,42,57,-15,44
FC Zürich,3250,5,10,11,11,41,36,5,41
FC Thun,3250,6,10,6,16,42,55,-13,36
FC Lugano,3250,7,9,8,15,31,49,-18,35
Grasshoppers,3250,8,9,6,17,37,49,-12,33
FC Sion,3250,9,6,8,18,35,54,-19,26
Young Boys,3251,1,21,8,3,69,35,34,71
FC Basel,3251,2,17,9,6,61,31,30,60
Lucerne,3251,3,12,10,10,42,43,-1,46
FC Zürich,3251,4,12,9,11,43,35,8,45
St Gallen,3251,5,13,3,16,41,59,-18,42
FC Thun,3251,6,11,6,15,46,58,-12,39
FC Lugano,3251,7,11,5,16,30,46,-16,38
Grasshoppers,3251,8,8,7,17,39,50,-11,31
FC Sion,3251,9,7,7,18,43,57,-14,28
Young Boys,3252,1,21,6,5,71,38,33,69
FC Basel,3252,2,19,8,5,58,24,34,65
Lucerne,3252,3,14,7,11,44,48,-4,49
St Gallen,3252,4,15,2,15,44,53,-9,47
FC Zürich,3252,5,10,11,11,42,36,6,41
Grasshoppers,3252,6,10,6,16,46,52,-6,36
FC Lugano,3252,7,10,5,17,30,48,-18,35
FC Thun,3252,8,9,6,17,43,60,-17,33
FC Sion,3252,9,7,7,18,41,60,-19,28
Young Boys,3253,1,21,7,4,68,33,35,70
FC Basel,3253,2,18,9,5,54,26,28,63
St Gallen,3253,3,13,5,14,44,56,-12,44
FC Zürich,3253,4,11,9,12,41,35,6,42
Lucerne,3253,5,11,9,12,40,46,-6,42
Grasshoppers,3253,6,11,7,14,45,50,-5,40
FC Lugano,3253,7,10,7,15,31,45,-14,37
FC Thun,3253,8,10,6,16,43,57,-14,36
FC Sion,3253,9,6,7,19,38,56,-18,25
Young Boys,3254,1,24,6,2,78,33,45,78
FC Basel,3254,2,18,7,7,55,27,28,61
FC Zürich,3254,3,12,9,11,44,35,9,45
Lucerne,3254,4,12,9,11,44,47,-3,45
St Gallen,3254,5,14,3,15,44,56,-12,45
FC Lugano,3254,6,10,6,16,30,46,-16,36
Grasshoppers,3254,7,9,6,17,39,51,-12,33
FC Thun,3254,8,9,5,18,41,60,-19,32
FC Sion,3254,9,7,7,18,40,60,-20,28
Young Boys,3255,1,22,6,4,73,33,40,72
FC Basel,3255,2,19,7,6,60,26,34,64
Lucerne,3255,3,14,8,10,44,43,1,50
St Gallen,3255,4,14,2,16,42,56,-14,44
Grasshoppers,3255,5,11,7,14,42,46,-4,40
FC Zürich,3255,6,10,9,13,41,37,4,39
FC Lugano,3255,7,11,5,16,30,47,-17,38
FC Thun,3255,8,10,5,17,42,60,-18,35
FC Sion,3255,9,5,7,20,36,62,-26,22
Young Boys,3256,1,21,7,4,75,39,36,70
FC Basel,3256,2,19,8,5,58,26,32,65
St Gallen,3256,3,15,2,15,47,56,-9,47
FC Zürich,3256,4,10,12,10,41,36,5,42
Lucerne,3256,5,11,8,13,39,46,-7,41
FC Lugano,3256,6,11,6,15,32,48,-16,39
Grasshoppers,3256,7,10,8,14,46,47,-1,38
FC Thun,3256,8,8,6,18,40,66,-26,30
FC Sion,3256,9,6,9,17,40,54,-14,27
Young Boys,3257,1,20,8,4,71,40,31,68
FC Basel,3257,2,17,9,6,52,24,28,60
Lucerne,3257,3,13,9,10,41,40,1,48
St Gallen,3257,4,14,2,16,42,57,-15,44
FC Zürich,3257,5,10,9,13,41,41,0,39
FC Thun,3257,6,11,6,15,47,55,-8,39
FC Lugano,3257,7,10,7,15,32,46,-14,37
Grasshoppers,3257,8,9,7,16,40,52,-12,34
FC Sion,3257,9,8,7,17,46,57,-11,31
Young Boys,3258,1,20,9,3,70,37,33,69
FC Basel,3258,2,17,8,7,54,28,26,59
Lucerne,3258,3,14,9,9,49,41,8,51
St Gallen,3258,4,14,3,15,42,54,-12,45
FC Zürich,3258,5,10,9,13,40,39,1,39
FC Lugano,3258,6,11,6,15,32,49,-17,39
FC Thun,3258,7,10,6,16,45,57,-12,36
Grasshoppers,3258,8,9,8,15,41,50,-9,35
FC Sion,3258,9,6,8,18,39,57,-18,26
Young Boys,3259,1,21,7,4,70,35,35,70
FC Basel,3259,2,18,8,6,57,24,33,62
St Gallen,3259,3,14,3,15,42,56,-14,45
Lucerne,3259,4,12,8,12,41,46,-5,44
FC Zürich,3259,5,11,10,11,39,36,3,43
Grasshoppers,3259,6,11,6,15,41,47,-6,39
FC Lugano,3259,7,10,6,16,30,47,-17,36
FC Thun,3259,8,9,7,16,41,55,-14,34
FC Sion,3259,9,7,7,18,40,55,-15,28
Young Boys,3260,1,20,7,5,71,39,32,67
FC Basel,3260,2,17,8,7,55,27,28,59
Lucerne,3260,3,16,7,9,52,43,9,55
St Gallen,3260,4,15,2,15,50,60,-10,47
FC Zürich,3260,5,12,10,10,43,34,9,46
FC Lugano,3260,6,10,5,17,35,57,-22,35
FC Thun,3260,7,9,6,17,44,60,-16,33
Grasshoppers,3260,8,8,8,16,41,54,-13,32
FC Sion,3260,9,6,9,17,41,58,-17,27
Young Boys,3261,1,22,8,2,73,33,40,74
FC Basel,3261,2,18,8,6,56,26,30,62
Lucerne,3261,3,12,9,11,44,50,-6,45
St Gallen,3261,4,14,2,16,40,54,-14,44
FC Zürich,3261,5,11,10,11,45,35,10,43
FC Lugano,3261,6,10,6,16,32,50,-18,36
Grasshoppers,3261,7,9,8,15,43,51,-8,35
FC Sion,3261,8,7,9,16,41,52,-11,30
FC Thun,3261,9,8,6,18,41,64,-23,30
Young Boys,3262,1,22,6,4,72,37,35,72
FC Basel,3262,2,16,10,6,51,25,26,58
Lucerne,3262,3,13,8,11,42,43,-1,47
St Gallen,3262,4,14,4,14,44,54,-10,46
FC Zürich,3262,5,11,10,11,41,37,4,43
FC Lugano,3262,6,11,5,16,30,46,-16,38
Grasshoppers,3262,7,9,6,17,41,53,-12,33
FC Sion,3262,8,8,8,16,47,56,-9,32
FC Thun,3262,9,9,5,18,43,60,-17,32
Young Boys,3263,1,23,6,3,71,34,37,75
FC Basel,3263,2,17,9,6,55,27,28,60
St Gallen,3263,3,16,2,14,46,54,-8,50
Lucerne,3263,4,11,10,11,42,47,-5,43
FC Zürich,3263,5,9,11,12,40,41,-1,38
FC Lugano,3263,6,10,7,15,30,45,-15,37
Grasshoppers,3263,7,9,8,15,38,46,-8,35
FC Thun,3263,8,9,6,17,40,57,-17,33
FC Sion,3263,9,7,7,18,41,52,-11,28
Young Boys,3264,1,22,7,3,79,37,42,73
FC Basel,3264,2,18,8,6,54,23,31,62
St Gallen,3264,3,14,4,14,43,54,-11,46
Lucerne,3264,4,12,9,11,41,46,-5,45
FC Zürich,3264,5,9,13,10,40,36,4,40
FC Lugano,3264,6,10,7,15,32,48,-16,37
Grasshoppers,3264,7,9,8,15,45,52,-7,35
FC Thun,3264,8,9,6,17,43,62,-19,33
FC Sion,3264,9,5,10,17,41,60,-19,25
Young Boys,3265,1,20,8,4,70,36,34,68
FC Basel,3265,2,18,9,5,53,23,30,63
Lucerne,3265,3,14,7,11,43,45,-2,49
St Gallen,3265,4,15,3,14,43,52,-9,48
FC Zürich,3265,5,11,9,12,42,37,5,42
Grasshoppers,3265,6,11,6,15,44,50,-6,39
FC Lugano,3265,7,10,7,15,32,48,-16,37
FC Thun,3265,8,8,6,18,44,64,-20,30
FC Sion,3265,9,6,7,19,41,57,-16,25
Young Boys,3266,1,24,6,2,70,30,40,78
FC Basel,3266,2,17,8,7,55,29,26,59
St Gallen,3266,3,14,3,15,43,57,-14,45
Lucerne,3266,4,11,11,10,44,46,-2,44
FC Zürich,3266,5,10,11,11,41,37,4,41
FC Lugano,3266,6,10,7,15,34,49,-15,37
FC Thun,3266,7,10,6,16,45,59,-14,36
Grasshoppers,3266,8,9,7,16,41,51,-10,34
FC Sion,3266,9,6,7,19,42,57,-15,25
Young Boys,3267,1,20,9,3,72,42,30,69
FC Basel,3267,2,18,9,5,59,25,34,63
St Gallen,3267,3,16,2,14,44,52,-8,50
Lucerne,3267,4,12,9,11,44,48,-4,45
FC Zürich,3267,5,11,11,10,42,34,8,44
Grasshoppers,3267,6,10,7,15,42,50,-8,37
FC Thun,3267,7,9,6,17,44,58,-14,33
FC Lugano,3267,8,9,5,18,31,51,-20,32
FC Sion,3267,9,6,8,18,40,58,-18,26
Young Boys,3268,1,22,6,4,74,34,40,72
FC Basel,3268,2,18,8,6,56,23,33,62
St Gallen,3268,3,15,3,14,42,54,-12,48
FC Zürich,3268,4,12,9,11,40,34,6,45
Lucerne,3268,5,12,9,11,42,43,-1,45
Grasshoppers,3268,6,12,6,14,46,49,-3,42
FC Thun,3268,7,9,5,18,40,60,-20,32
FC Lugano,3268,8,9,5,18,27,53,-26,32
FC Sion,3268,9,6,7,19,38,55,-17,25
Young Boys,3269,1,22,6,4,67,34,33,72
FC Basel,3269,2,18,7,7,52,25,27,61
St Gallen,3269,3,15,3,14,43,53,-10,48
Lucerne,3269,4,12,8,12,39,42,-3,44
FC Zürich,3269,5,9,11,12,40,39,1,38
FC Thun,3269,6,10,6,16,46,58,-12,36
FC Sion,3269,7,9,7,16,41,49,-8,34
Grasshoppers,3269,8,9,7,16,38,49,-11,34
FC Lugano,3269,9,9,7,16,29,46,-17,34
Young Boys,3270,1,22,7,3,74,34,40,73
FC Basel,3270,2,17,9,6,53,25,28,60
St Gallen,3270,3,15,3,14,44,51,-7,48
Lucerne,3270,4,12,9,11,40,44,-4,45
FC Zürich,3270,5,10,11,11,40,36,4,41
FC Lugano,3270,6,11,5,16,30,46,-16,38
Grasshoppers,3270,7,10,6,16,41,53,-12,36
FC Thun,3270,8,10,5,17,43,59,-16,35
FC Sion,3270,9,5,9,18,39,56,-17,24
Young Boys,3271,1,22,6,4,78,40,38,72
FC Basel,3271,2,18,9,5,55,23,32,63
Lucerne,3271,3,13,9,10,48,45,3,48
St Gallen,3271,4,15,2,15,44,59,-15,47
FC Zürich,3271,5,9,11,12,38,37,1,38
FC Thun,3271,6,10,5,17,43,60,-17,35
FC Lugano,3271,7,9,7,16,31,49,-18,34
Grasshoppers,3271,8,9,6,17,39,53,-14,33
FC Sion,3271,9,8,7,17,43,53,-10,31
Young Boys,3272,1,20,8,4,67,34,33,68
FC Basel,3272,2,17,9,6,53,32,21,60
St Gallen,3272,3,14,3,15,43,55,-12,45
FC Zürich,3272,4,11,10,11,46,37,9,43
Lucerne,3272,5,11,10,11,40,44,-4,43
Grasshoppers,3272,6,11,7,14,43,48,-5,40
FC Lugano,3272,7,10,7,15,30,44,-14,37
FC Thun,3272,8,9,7,16,44,59,-15,34
FC Sion,3272,9,7,7,18,41,54,-13,28
Young Boys,3273,1,23,6,3,72,35,37,75
FC Basel,3273,2,19,7,6,54,23,31,64
St Gallen,3273,3,14,4,14,43,54,-11,46
Lucerne,3273,4,12,8,12,41,42,-1,44
FC Zürich,3273,5,10,10,12,40,39,1,40
FC Thun,3273,6,11,5,16,45,57,-12,38
FC Lugano,3273,7,9,7,16,29,47,-18,34
Grasshoppers,3273,8,9,6,17,40,52,-12,33
FC Sion,3273,9,6,9,17,42,57,-15,27
Young Boys,3274,1,22,8,2,72,33,39,74
FC Basel,3274,2,17,8,7,54,28,26,59
Lucerne,3274,3,12,10,10,42,41,1,46
FC Zürich,3274,4,12,9,11,44,38,6,45
St Gallen,3274,5,13,3,16,40,55,-15,42
FC Thun,3274,6,10,6,16,48,62,-14,36
FC Lugano,3274,7,10,6,16,32,51,-19,36
Grasshoppers,3274,8,9,7,16,42,52,-10,34
FC Sion,3274,9,6,9,17,40,54,-14,27
Young Boys,3275,1,22,7,3,73,36,37,73
FC Basel,3275,2,18,8,6,59,30,29,62
St Gallen,3275,3,14,4,14,41,53,-12,46
Lucerne,3275,4,11,8,13,42,49,-7,41
FC Zürich,3275,5,10,10,12,39,36,3,40
FC Lugano,3275,6,11,5,16,31,48,-17,38
Grasshoppers,3275,7,10,7,15,46,52,-6,37
FC Sion,3275,8,8,9,15,41,50,-9,33
FC Thun,3275,9,8,6,18,42,60,-18,30
Young Boys,3276,1,20,7,5,71,41,30,67
FC Basel,3276,2,18,7,7,57,27,30,61
St Gallen,3276,3,17,2,13,51,52,-1,53
FC Zürich,3276,4,12,9,11,41,34,7,45
Lucerne,3276,5,11,10,11,39,45,-6,43
FC Lugano,3276,6,11,6,15,33,49,-16,39
Grasshoppers,3276,7,10,7,15,42,48,-6,37
FC Thun,3276,8,9,5,18,42,62,-20,32
FC Sion,3276,9,6,7,19,40,58,-18,25
Young Boys,3277,1,21,8,3,69,31,38,71
FC Basel,3277,2,19,8,5,55,21,34,65
St Gallen,3277,3,15,2,15,45,54,-9,47
Lucerne,3277,4,13,7,12,41,44,-3,46
FC Zürich,3277,5,11,9,12,40,36,4,42
Grasshoppers,3277,6,10,7,15,42,48,-6,37
FC Lugano,3277,7,10,6,16,31,49,-18,36
FC Thun,3277,8,9,6,17,43,62,-19,33
FC Sion,3277,9,6,7,19,39,60,-21,25
Young Boys,3278,1,24,6,2,74,30,44,78
FC Basel,3278,2,18,7,7,54,27,27,61
St Gallen,3278,3,16,3,13,46,52,-6,51
Lucerne,3278,4,12,8,12,39,46,-7,44
FC Zürich,3278,5,10,9,13,39,36,3,39
FC Thun,3278,6,10,6,16,47,60,-13,36
FC Lugano,3278,7,10,6,16,30,47,-17,36
Grasshoppers,3278,8,8,7,17,41,53,-12,31
FC Sion,3278,9,6,8,18,38,57,-19,26
Young Boys,3279,1,22,7,3,71,32,39,73
FC Basel,3279,2,16,11,5,49,22,27,59
Lucerne,3279,3,12,10,10,44,42,2,46
St Gallen,3279,4,14,4,14,41,53,-12,46
FC Zürich,3279,5,11,10,11,43,38,5,43
FC Thun,3279,6,10,6,16,50,57,-7,36
Grasshoppers,3279,7,9,7,16,44,59,-15,34
FC Lugano,3279,8,9,6,17,29,54,-25,33
FC Sion,3279,9,7,7,18,41,55,-14,28
Young Boys,3280,1,21,6,5,71,38,33,69
FC Basel,3280,2,18,7,7,58,25,33,61
Lucerne,3280,3,14,7,11,44,43,1,49
St Gallen,3280,4,15,2,15,44,57,-13,47
FC Zürich,3280,5,10,10,12,39,40,-1,40
FC Lugano,3280,6,11,5,16,34,49,-15,38
FC Thun,3280,7,10,6,16,41,56,-15,36
FC Sion,3280,8,8,8,16,42,52,-10,32
Grasshoppers,3280,9,8,7,17,39,52,-13,31
Young Boys,3281,1,23,6,3,79,34,45,75
FC Basel,3281,2,17,9,6,54,28,26,60
Lucerne,3281,3,14,8,10,44,45,-1,50
St Gallen,3281,4,14,3,15,42,54,-12,45
FC Zürich,3281,5,9,12,11,40,37,3,39
Grasshoppers,3281,6,9,7,16,42,53,-11,34
FC Thun,3281,7,9,7,16,44,58,-14,34
FC Lugano,3281,8,9,6,17,32,51,-19,33
FC Sion,3281,9,7,8,17,41,58,-17,29
Young Boys,3282,1,21,7,4,71,37,34,70
FC Basel,3282,2,18,9,5,55,25,30,63
St Gallen,3282,3,15,3,14,42,52,-10,48
Lucerne,3282,4,11,8,13,38,46,-8,41
FC Lugano,3282,5,11,7,14,34,46,-12,40
FC Zürich,3282,6,9,11,12,42,41,1,38
FC Thun,3282,7,10,6,16,45,58,-13,36
Grasshoppers,3282,8,8,8,16,39,51,-12,32
FC Sion,3282,9,7,9,16,42,52,-10,30
Young Boys,3283,1,21,7,4,75,35,40,70
FC Basel,3283,2,17,7,8,51,30,21,58
Lucerne,3283,3,13,7,12,43,49,-6,46
St Gallen,3283,4,14,2,16,42,55,-13,44
FC Zürich,3283,5,11,9,12,42,39,3,42
Grasshoppers,3283,6,11,7,14,47,47,0,40
FC Lugano,3283,7,11,5,16,32,50,-18,38
FC Thun,3283,8,10,5,17,44,59,-15,35
FC Sion,3283,9,8,7,17,43,55,-12,31
Young Boys,3284,1,20,9,3,72,38,34,69
FC Basel,3284,2,19,8,5,55,23,32,65
St Gallen,3284,3,15,2,15,44,53,-9,47
Lucerne,3284,4,13,7,12,42,45,-3,46
FC Zürich,3284,5,11,10,11,40,36,4,43
FC Thun,3284,6,10,6,16,45,57,-12,36
FC Lugano,3284,7,10,6,16,32,48,-16,36
Grasshoppers,3284,8,9,8,15,43,50,-7,35
FC Sion,3284,9,5,8,19,37,60,-23,23
Young Boys,3285,1,21,7,4,74,38,36,70
FC Basel,3285,2,19,8,5,53,22,31,65
St Gallen,3285,3,14,3,15,44,54,-10,45
Lucerne,3285,4,11,9,12,38,47,-9,42
Grasshoppers,3285,5,11,7,14,46,46,0,40
FC Zürich,3285,6,9,11,12,37,36,1,38
FC Lugano,3285,7,10,7,15,35,50,-15,37
FC Thun,3285,8,9,5,18,40,64,-24,32
FC Sion,3285,9,7,9,16,45,55,-10,30
Young Boys,3286,1,21,7,4,72,39,33,70
FC Basel,3286,2,17,9,6,53,25,28,60
St Gallen,3286,3,17,2,13,46,51,-5,53
Lucerne,3286,4,12,9,11,43,45,-2,45
FC Zürich,3286,5,10,11,11,43,38,5,41
FC Thun,3286,6,10,6,16,45,58,-13,36
Grasshoppers,3286,7,9,8,15,44,51,-7,35
FC Lugano,3286,8,9,5,18,29,53,-24,32
FC Sion,3286,9,6,9,17,42,57,-15,27
Young Boys,3287,1,21,8,3,69,35,34,71
FC Basel,3287,2,17,8,7,52,28,24,59
St Gallen,3287,3,15,3,14,47,56,-9,48
Lucerne,3287,4,12,10,10,41,40,1,46
FC Zürich,3287,5,9,12,11,40,37,3,39
FC Thun,3287,6,10,7,15,47,58,-11,37
FC Lugano,3287,7,10,6,16,33,49,-16,36
Grasshoppers,3287,8,9,7,16,42,53,-11,34
FC Sion,3287,9,6,9,17,41,56,-15,27
Young Boys,3288,1,22,6,4,71,39,32,72
FC Basel,3288,2,19,7,6,56,24,32,64
Lucerne,3288,3,14,8,10,42,41,1,50
St Gallen,3288,4,15,2,15,42,54,-12,47
FC Zürich,3288,5,10,9,13,38,37,1,39
FC Lugano,3288,6,11,5,16,31,45,-14,38
FC Thun,3288,7,10,5,17,43,58,-15,35
Grasshoppers,3288,8,8,8,16,42,52,-10,32
FC Sion,3288,9,6,8,18,41,56,-15,26
Young Boys,3289,1,21,8,3,71,36,35,71
FC Basel,3289,2,17,9,6,53,26,27,60
St Gallen,3289,3,14,4,14,44,54,-10,46
Lucerne,3289,4,12,9,11,41,45,-4,45
FC Zürich,3289,5,9,11,12,40,38,2,38
FC Lugano,3289,6,10,7,15,33,48,-15,37
Grasshoppers,3289,7,10,6,16,45,53,-8,36
FC Thun,3289,8,10,6,16,47,61,-14,36
FC Sion,3289,9,6,10,16,45,58,-13,28
Young Boys,3290,1,21,7,4,71,36,35,70
FC Basel,3290,2,18,8,6,54,26,28,62
St Gallen,3290,3,16,3,13,47,53,-6,51
Lucerne,3290,4,13,8,11,40,41,-1,47
FC Zürich,3290,5,10,10,12,42,39,3,40
Grasshoppers,3290,6,10,8,14,42,47,-5,38
FC Lugano,3290,7,10,5,17,31,51,-20,35
FC Thun,3290,8,8,6,18,41,61,-20,30
FC Sion,3290,9,5,11,16,41,55,-14,26
Young Boys,3291,1,22,7,3,77,35,42,73
FC Basel,3291,2,18,8,6,50,23,27,62
St Gallen,3291,3,15,3,14,43,53,-10,48
Lucerne,3291,4,13,7,12,42,46,-4,46
FC Zürich,3291,5,9,11,12,37,36,1,38
FC Thun,3291,6,10,5,17,41,55,-14,35
Grasshoppers,3291,7,9,7,16,39,49,-10,34
FC Lugano,3291,8,9,7,16,29,49,-20,34
FC Sion,3291,9,7,9,16,42,54,-12,30
Young Boys,3292,1,21,8,3,71,37,34,71
FC Basel,3292,2,16,9,7,54,30,24,57
Lucerne,3292,3,13,8,11,45,45,0,47
St Gallen,3292,4,15,2,15,47,59,-12,47
FC Lugano,3292,5,12,6,14,36,43,-7,42
FC Zürich,3292,6,9,12,11,43,42,1,39
Grasshoppers,3292,7,9,7,16,39,49,-10,34
FC Thun,3292,8,9,6,17,45,62,-17,33
FC Sion,3292,9,6,10,16,45,58,-13,28
Young Boys,3293,1,23,6,3,74,34,40,75
FC Basel,3293,2,18,8,6,55,27,28,62
Lucerne,3293,3,14,7,11,44,42,2,49
St Gallen,3293,4,14,3,15,41,55,-14,45
FC Zürich,3293,5,11,11,10,42,34,8,44
Grasshoppers,3293,6,9,6,17,38,50,-12,33
FC Thun,3293,7,9,6,17,41,58,-17,33
FC Lugano,3293,8,9,6,17,29,49,-20,33
FC Sion,3293,9,7,7,18,40,55,-15,28
Young Boys,3294,1,21,9,2,70,34,36,72
FC Basel,3294,2,17,9,6,54,28,26,60
Lucerne,3294,3,14,8,10,44,41,3,50
St Gallen,3294,4,13,5,14,42,54,-12,44
FC Zürich,3294,5,9,13,10,39,35,4,40
FC Thun,3294,6,10,6,16,47,56,-9,36
Grasshoppers,3294,7,9,7,16,41,52,-11,34
FC Lugano,3294,8,9,7,16,30,48,-18,34
FC Sion,3294,9,5,10,17,37,56,-19,25
Young Boys,3295,1,24,6,2,74,34,40,78
FC Basel,3295,2,17,9,6,54,29,25,60
St Gallen,3295,3,14,3,15,44,55,-11,45
Lucerne,3295,4,11,9,12,40,46,-6,42
FC Lugano,3295,5,11,6,15,32,44,-12,39
FC Zürich,3295,6,9,10,13,38,41,-3,37
Grasshoppers,3295,7,10,6,16,40,46,-6,36
FC Thun,3295,8,10,6,16,44,56,-12,36
FC Sion,3295,9,7,7,18,38,53,-15,28
Young Boys,3296,1,22,7,3,72,36,36,73
FC Basel,3296,2,18,7,7,53,25,28,61
Lucerne,3296,3,13,8,11,42,44,-2,47
FC Zürich,3296,4,12,10,10,43,36,7,46
St Gallen,3296,5,14,3,15,40,53,-13,45
Grasshoppers,3296,6,10,8,14,46,49,-3,38
FC Lugano,3296,7,9,6,17,29,50,-21,33
FC Thun,3296,8,8,6,18,41,59,-18,30
FC Sion,3296,9,6,9,17,43,57,-14,27
Young Boys,3297,1,21,6,5,72,42,30,69
FC Basel,3297,2,18,9,5,60,25,35,63
Lucerne,3297,3,13,7,12,44,52,-8,46
FC Zürich,3297,4,11,10,11,41,35,6,43
St Gallen,3297,5,13,3,16,38,53,-15,42
Grasshoppers,3297,6,10,8,14,48,50,-2,38
FC Lugano,3297,7,11,5,16,33,48,-15,38
FC Thun,3297,8,9,6,17,43,61,-18,33
FC Sion,3297,9,7,8,17,42,55,-13,29
Young Boys,3298,1,20,9,3,71,39,32,69
FC Basel,3298,2,18,8,6,55,28,27,62
St Gallen,3298,3,15,2,15,43,54,-11,47
Lucerne,3298,4,12,7,13,43,46,-3,43
FC Zürich,3298,5,10,11,11,41,36,5,41
Grasshoppers,3298,6,10,7,15,45,52,-7,37
FC Thun,3298,7,10,6,16,45,56,-11,36
FC Lugano,3298,8,10,6,16,29,45,-16,36
FC Sion,3298,9,7,8,17,41,57,-16,29
Young Boys,3299,1,20,8,4,69,37,32,68
FC Basel,3299,2,19,8,5,58,26,32,65
St Gallen,3299,3,15,3,14,43,53,-10,48
Lucerne,3299,4,13,8,11,41,42,-1,47
FC Zürich,3299,5,9,11,12,39,38,1,38
Grasshoppers,3299,6,10,7,15,45,49,-4,37
FC Thun,3299,7,9,6,17,43,61,-18,33
FC Lugano,3299,8,9,6,17,29,49,-20,33
FC Sion,3299,9,7,9,16,41,53,-12,30
Young Boys,3300,1,21,8,3,73,34,39,71
FC Basel,3300,2,17,8,7,51,25,26,59
St Gallen,3300,3,16,3,13,43,50,-7,51
Lucerne,3300,4,13,7,12,43,47,-4,46
FC Zürich,3300,5,11,11,10,40,34,6,44
Grasshoppers,3300,6,9,8,15,46,54,-8,35
FC Thun,3300,7,9,7,16,46,59,-13,34
FC Lugano,3300,8,9,7,16,30,50,-20,34
FC Sion,3300,9,5,9,18,37,56,-19,24
Young Boys,3301,1,22,6,4,74,36,38,72
FC Basel,3301,2,18,9,5,57,27,30,63
Lucerne,3301,3,13,7,12,43,44,-1,46
St Gallen,3301,4,14,4,14,44,54,-10,46
FC Zürich,3301,5,10,10,12,38,36,2,40
FC Thun,3301,6,10,6,16,48,60,-12,36
FC Lugano,3301,7,10,6,16,30,46,-16,36
FC Sion,3301,8,8,7,17,42,57,-15,31
Grasshoppers,3301,9,8,7,17,40,56,-16,31
Young Boys,3302,1,20,6,6,69,40,29,66
FC Basel,3302,2,19,7,6,57,27,30,64
St Gallen,3302,3,15,3,14,41,52,-11,48
Lucerne,3302,4,13,8,11,43,46,-3,47
FC Zürich,3302,5,11,9,12,41,37,4,42
FC Thun,3302,6,11,5,16,44,56,-12,38
Grasshoppers,3302,7,9,8,15,42,48,-6,35
FC Lugano,3302,8,9,5,18,30,51,-21,32
FC Sion,3302,9,7,9,16,42,52,-10,30
Young Boys,3303,1,22,6,4,78,39,39,72
FC Basel,3303,2,19,7,6,59,25,34,64
Lucerne,3303,3,13,7,12,41,49,-8,46
St Gallen,3303,4,14,3,15,46,59,-13,45
FC Zürich,3303,5,10,9,13,37,36,1,39
Grasshoppers,3303,6,10,6,16,45,53,-8,36
FC Lugano,3303,7,10,6,16,35,52,-17,36
FC Thun,3303,8,10,5,17,45,59,-14,35
FC Sion,3303,9,8,7,17,41,55,-14,31
Young Boys,3304,1,20,8,4,74,44,30,68
FC Basel,3304,2,18,7,7,55,27,28,61
Lucerne,3304,3,15,8,9,48,42,6,53
St Gallen,3304,4,16,2,14,43,50,-7,50
FC Zürich,3304,5,10,9,13,39,38,1,39
Grasshoppers,3304,6,9,8,15,40,48,-8,35
FC Thun,3304,7,10,5,17,45,56,-11,35
FC Lugano,3304,8,10,5,17,29,49,-20,35
FC Sion,3304,9,6,8,18,41,60,-19,26
Young Boys,3305,1,21,6,5,73,40,33,69
FC Basel,3305,2,20,7,5,60,24,36,67
Lucerne,3305,3,13,7,12,41,45,-4,46
St Gallen,3305,4,14,3,15,46,57,-11,45
FC Lugano,3305,5,11,5,16,34,51,-17,38
FC Zürich,3305,6,9,10,13,39,40,-1,37
Grasshoppers,3305,7,10,7,15,42,48,-6,37
FC Thun,3305,8,9,7,16,44,61,-17,34
FC Sion,3305,9,6,10,16,45,58,-13,28
Young Boys,3306,1,19,8,5,67,39,28,65
FC Basel,3306,2,16,11,5,53,27,26,59
FC Zürich,3306,3,12,10,10,44,36,8,46
Lucerne,3306,4,11,10,11,41,44,-3,43
St Gallen,3306,5,13,4,15,42,56,-14,43
FC Lugano,3306,6,12,5,15,34,44,-10,41
Grasshoppers,3306,7,10,8,14,42,46,-4,38
FC Thun,3306,8,9,7,16,43,58,-15,34
FC Sion,3306,9,7,7,18,41,57,-16,28
Young Boys,3307,1,21,7,4,69,36,33,70
FC Basel,3307,2,18,9,5,53,22,31,63
St Gallen,3307,3,16,2,14,45,51,-6,50
Lucerne,3307,4,11,9,12,39,46,-7,42
FC Zürich,3307,5,10,10,12,38,36,2,40
Grasshoppers,3307,6,11,7,14,44,48,-4,40
FC Lugano,3307,7,11,5,16,29,45,-16,38
FC Thun,3307,8,9,6,17,42,57,-15,33
FC Sion,3307,9,5,9,18,39,57,-18,24
Young Boys,3308,1,21,7,4,71,36,35,70
FC Basel,3308,2,19,8,5,55,23,32,65
Lucerne,3308,3,13,8,11,45,48,-3,47
St Gallen,3308,4,15,2,15,47,57,-10,47
FC Zürich,3308,5,10,10,12,41,37,4,40
FC Thun,3308,6,10,7,15,41,54,-13,37
FC Lugano,3308,7,9,8,15,31,48,-17,35
Grasshoppers,3308,8,9,7,16,42,51,-9,34
FC Sion,3308,9,6,7,19,39,58,-19,25
Young Boys,3309,1,20,7,5,70,41,29,67
FC Basel,3309,2,18,9,5,56,26,30,63
Lucerne,3309,3,14,8,10,44,43,1,50
St Gallen,3309,4,13,4,15,41,55,-14,43
FC Zürich,3309,5,11,9,12,38,35,3,42
Grasshoppers,3309,6,11,6,15,47,50,-3,39
FC Lugano,3309,7,10,7,15,30,46,-16,37
FC Thun,3309,8,9,5,18,41,59,-18,32
FC Sion,3309,9,7,7,18,40,52,-12,28
Young Boys,3310,1,21,8,3,69,34,35,71
FC Basel,3310,2,19,8,5,59,23,36,65
Lucerne,3310,3,13,8,11,43,43,0,47
St Gallen,3310,4,14,3,15,42,57,-15,45
FC Zürich,3310,5,11,9,12,43,42,1,42
FC Thun,3310,6,11,5,16,48,60,-12,38
FC Lugano,3310,7,9,7,16,32,52,-20,34
Grasshoppers,3310,8,8,7,17,38,50,-12,31
FC Sion,3310,9,7,7,18,40,53,-13,28
Young Boys,3311,1,20,7,5,67,36,31,67
FC Basel,3311,2,19,7,6,56,25,31,64
Lucerne,3311,3,14,8,10,44,43,1,50
St Gallen,3311,4,15,2,15,47,57,-10,47
FC Zürich,3311,5,12,9,11,44,36,8,45
Grasshoppers,3311,6,9,7,16,37,46,-9,34
FC Sion,3311,7,8,8,16,40,50,-10,32
FC Lugano,3311,8,9,5,18,30,50,-20,32
FC Thun,3311,9,9,5,18,41,63,-22,32
Young Boys,3312,1,23,6,3,77,35,42,75
FC Basel,3312,2,17,7,8,53,29,24,58
St Gallen,3312,3,15,3,14,43,54,-11,48
FC Zürich,3312,4,11,9,12,40,35,5,42
FC Lugano,3312,5,12,6,14,34,45,-11,42
Lucerne,3312,6,11,8,13,41,48,-7,41
FC Thun,3312,7,11,5,16,46,57,-11,38
Grasshoppers,3312,8,10,6,16,45,52,-7,36
FC Sion,3312,9,5,8,19,36,60,-24,23
Young Boys,3313,1,22,6,4,70,36,34,72
FC Basel,3313,2,17,8,7,53,27,26,59
St Gallen,3313,3,15,4,13,45,52,-7,49
Lucerne,3313,4,12,10,10,42,41,1,46
FC Zürich,3313,5,11,10,11,43,38,5,43
FC Thun,3313,6,10,6,16,47,61,-14,36
Grasshoppers,3313,7,9,8,15,43,51,-8,35
FC Lugano,3313,8,9,5,18,30,53,-23,32
FC Sion,3313,9,5,11,16,38,52,-14,26
Young Boys,3314,1,22,6,4,75,39,36,72
FC Basel,3314,2,17,8,7,52,26,26,59
FC Zürich,3314,3,13,9,10,44,34,10,48
St Gallen,3314,4,15,2,15,43,57,-14,47
Lucerne,3314,5,12,8,12,41,43,-2,44
FC Lugano,3314,6,11,5,16,38,52,-14,38
Grasshoppers,3314,7,9,8,15,42,53,-11,35
FC Thun,3314,8,9,6,17,44,59,-15,33
FC Sion,3314,9,6,8,18,42,58,-16,26
Young Boys,3315,1,24,6,2,76,34,42,78
FC Basel,3315,2,17,7,8,54,29,25,58
Lucerne,3315,3,13,9,10,46,46,0,48
St Gallen,3315,4,14,3,15,43,57,-14,45
FC Zürich,3315,5,11,9,12,41,38,3,42
FC Lugano,3315,6,10,6,16,32,48,-16,36
FC Thun,3315,7,10,5,17,43,57,-14,35
Grasshoppers,3315,8,9,6,17,40,50,-10,33
FC Sion,3315,9,7,7,18,40,56,-16,28
Young Boys,3316,1,22,7,3,71,32,39,73
FC Basel,3316,2,17,7,8,53,25,28,58
Lucerne,3316,3,13,8,11,41,44,-3,47
St Gallen,3316,4,14,3,15,42,54,-12,45
FC Zürich,3316,5,10,10,12,44,42,2,40
Grasshoppers,3316,6,10,8,14,44,49,-5,38
FC Lugano,3316,7,10,6,16,31,50,-19,36
FC Sion,3316,8,7,10,15,40,51,-11,31
FC Thun,3316,9,8,7,17,45,64,-19,31
Young Boys,3317,1,22,8,2,76,35,41,74
FC Basel,3317,2,16,8,8,56,31,25,56
St Gallen,3317,3,16,2,14,46,53,-7,50
FC Zürich,3317,4,11,10,11,40,34,6,43
Lucerne,3317,5,11,9,12,41,47,-6,42
FC Lugano,3317,6,10,7,15,32,47,-15,37
Grasshoppers,3317,7,9,7,16,42,53,-11,34
FC Thun,3317,8,9,7,16,42,62,-20,34
FC Sion,3317,9,7,8,17,42,55,-13,29
Young Boys,3318,1,22,7,3,71,31,40,73
FC Basel,3318,2,18,7,7,59,29,30,61
Lucerne,3318,3,14,7,11,44,43,1,49
St Gallen,3318,4,15,2,15,43,54,-11,47
FC Zürich,3318,5,10,10,12,42,39,3,40
FC Thun,3318,6,11,5,16,45,61,-16,38
FC Lugano,3318,7,10,5,17,31,50,-19,35
Grasshoppers,3318,8,9,7,16,38,49,-11,34
FC Sion,3318,9,6,8,18,39,56,-17,26
Young Boys,3319,1,21,6,5,70,37,33,69
FC Basel,3319,2,17,9,6,55,27,28,60
Lucerne,3319,3,13,8,11,41,42,-1,47
St Gallen,3319,4,14,2,16,42,56,-14,44
FC Zürich,3319,5,11,9,12,41,38,3,42
FC Lugano,3319,6,12,5,15,31,43,-12,41
Grasshoppers,3319,7,11,6,15,42,47,-5,39
FC Thun,3319,8,9,7,16,46,61,-15,34
FC Sion,3319,9,6,8,18,42,59,-17,26
Young Boys,3320,1,21,8,3,71,35,36,71
FC Basel,3320,2,17,8,7,52,27,25,59
St Gallen,3320,3,16,3,13,47,52,-5,51
FC Zürich,3320,4,11,10,11,45,35,10,43
Lucerne,3320,5,11,9,12,38,47,-9,42
Grasshoppers,3320,6,10,7,15,40,48,-8,37
FC Lugano,3320,7,10,7,15,32,47,-15,37
FC Thun,3320,8,9,6,17,43,58,-15,33
FC Sion,3320,9,6,8,18,39,58,-19,26
Young Boys,3321,1,20,8,4,71,39,32,68
FC Basel,3321,2,18,8,6,54,25,29,62
Lucerne,3321,3,12,7,13,40,45,-5,43
FC Lugano,3321,4,12,6,14,33,44,-11,42
St Gallen,3321,5,13,3,16,38,53,-15,42
FC Zürich,3321,6,10,9,13,41,41,0,39
FC Thun,3321,7,11,5,16,45,57,-12,38
Grasshoppers,3321,8,10,6,16,41,52,-11,36
FC Sion,3321,9,8,8,16,45,52,-7,32
Young Boys,3322,1,23,6,3,76,35,41,75
FC Basel,3322,2,18,8,6,55,24,31,62
Lucerne,3322,3,13,8,11,44,50,-6,47
St Gallen,3322,4,13,4,15,41,56,-15,43
FC Zürich,3322,5,11,9,12,43,36,7,42
FC Lugano,3322,6,11,6,15,34,48,-14,39
Grasshoppers,3322,7,9,6,17,39,51,-12,33
FC Thun,3322,8,9,6,17,42,61,-19,33
FC Sion,3322,9,6,9,17,42,55,-13,27
Young Boys,3323,1,20,6,6,66,40,26,66
FC Basel,3323,2,17,10,5,54,24,30,61
St Gallen,3323,3,14,4,14,41,55,-14,46
FC Zürich,3323,4,11,10,11,40,34,6,43
Lucerne,3323,5,11,9,12,38,44,-6,42
Grasshoppers,3323,6,11,6,15,42,52,-10,39
FC Lugano,3323,7,11,5,16,34,47,-13,38
FC Thun,3323,8,9,8,15,47,56,-9,35
FC Sion,3323,9,7,8,17,41,51,-10,29
Young Boys,3324,1,23,6,3,75,36,39,75
FC Basel,3324,2,19,7,6,57,28,29,64
St Gallen,3324,3,15,3,14,45,54,-9,48
Lucerne,3324,4,13,7,12,39,43,-4,46
FC Zürich,3324,5,12,9,11,46,36,10,45
FC Lugano,3324,6,10,5,17,32,48,-16,35
FC Thun,3324,7,9,5,18,45,65,-20,32
Grasshoppers,3324,8,8,7,17,42,53,-11,31
FC Sion,3324,9,6,9,17,39,57,-18,27
Young Boys,3325,1,21,7,4,72,35,37,70
FC Basel,3325,2,18,8,6,56,27,29,62
Lucerne,3325,3,14,8,10,45,43,2,50
St Gallen,3325,4,14,3,15,42,55,-13,45
FC Zürich,3325,5,10,11,11,43,39,4,41
FC Thun,3325,6,10,6,16,42,58,-16,36
FC Lugano,3325,7,10,5,17,33,53,-20,35
Grasshoppers,3325,8,8,8,16,39,49,-10,32
FC Sion,3325,9,6,10,16,40,53,-13,28
Young Boys,3326,1,20,7,5,68,39,29,67
FC Basel,3326,2,18,9,5,54,25,29,63
St Gallen,3326,3,14,5,13,47,55,-8,47
Lucerne,3326,4,11,10,11,38,41,-3,43
FC Zürich,3326,5,9,12,11,38,36,2,39
Grasshoppers,3326,6,10,8,14,43,45,-2,38
FC Lugano,3326,7,10,8,14,32,45,-13,38
FC Thun,3326,8,8,8,16,39,56,-17,32
FC Sion,3326,9,6,9,17,40,57,-17,27
Young Boys,3327,1,23,6,3,74,36,38,75
FC Basel,3327,2,17,8,7,55,25,30,59
FC Zürich,3327,3,12,10,10,43,34,9,46
Lucerne,3327,4,12,10,10,40,41,-1,46
St Gallen,3327,5,13,5,14,42,56,-14,44
Grasshoppers,3327,6,9,7,16,41,49,-8,34
FC Lugano,3327,7,9,7,16,30,50,-20,34
FC Thun,3327,8,8,7,17,42,60,-18,31
FC Sion,3327,9,7,8,17,40,56,-16,29
Young Boys,3328,1,22,7,3,72,36,36,73
FC Basel,3328,2,19,8,5,58,24,34,65
Lucerne,3328,3,12,9,11,44,45,-1,45
St Gallen,3328,4,13,4,15,42,58,-16,43
FC Zürich,3328,5,10,10,12,38,35,3,40
Grasshoppers,3328,6,10,8,14,43,47,-4,38
FC Lugano,3328,7,10,6,16,30,46,-16,36
FC Thun,3328,8,10,5,17,42,59,-17,35
FC Sion,3328,9,5,9,18,37,56,-19,24
Young Boys,3329,1,23,7,2,73,34,39,76
FC Basel,3329,2,16,8,8,52,29,23,56
Lucerne,3329,3,14,9,9,49,43,6,51
St Gallen,3329,4,15,3,14,45,55,-10,48
FC Zürich,3329,5,12,9,11,43,35,8,45
FC Thun,3329,6,10,5,17,44,59,-15,35
Grasshoppers,3329,7,9,6,17,41,51,-10,33
FC Lugano,3329,8,9,5,18,28,52,-24,32
FC Sion,3329,9,6,8,18,39,56,-17,26
Young Boys,3330,1,21,6,5,71,40,31,69
FC Basel,3330,2,17,8,7,52,27,25,59
Lucerne,3330,3,14,9,9,49,45,4,51
St Gallen,3330,4,16,2,14,50,57,-7,50
FC Zürich,3330,5,10,10,12,39,37,2,40
FC Thun,3330,6,10,5,17,43,59,-16,35
FC Lugano,3330,7,10,5,17,31,49,-18,35
Grasshoppers,3330,8,8,8,16,41,52,-11,32
FC Sion,3330,9,7,9,16,45,55,-10,30
Young Boys,3331,1,20,7,5,72,39,33,67
FC Basel,3331,2,19,7,6,60,26,34,64
St Gallen,3331,3,16,2,14,43,52,-9,50
Lucerne,3331,4,12,9,11,45,50,-5,45
FC Zürich,3331,5,11,10,11,42,36,6,43
Grasshoppers,3331,6,10,7,15,45,50,-5,37
FC Lugano,3331,7,10,6,16,30,48,-18,36
FC Thun,3331,8,10,5,17,42,59,-17,35
FC Sion,3331,9,6,7,19,39,58,-19,25
Young Boys,3332,1,20,8,4,69,37,32,68
FC Basel,3332,2,17,9,6,54,24,30,60
Lucerne,3332,3,14,8,10,45,43,2,50
St Gallen,3332,4,15,4,13,44,51,-7,49
FC Zürich,3332,5,11,10,11,40,34,6,43
FC Lugano,3332,6,10,7,15,31,46,-15,37
Grasshoppers,3332,7,9,8,15,40,50,-10,35
FC Thun,3332,8,9,7,16,44,61,-17,34
FC Sion,3332,9,5,7,20,36,57,-21,22
Young Boys,3333,1,21,6,5,71,37,34,69
FC Basel,3333,2,18,7,7,53,25,28,61
St Gallen,3333,3,16,2,14,44,52,-8,50
Lucerne,3333,4,13,8,11,43,44,-1,47
Grasshoppers,3333,5,11,7,14,42,46,-4,40
FC Zürich,3333,6,9,11,12,40,39,1,38
FC Lugano,3333,7,11,5,16,35,52,-17,38
FC Thun,3333,8,9,6,17,43,60,-17,33
FC Sion,3333,9,6,8,18,39,55,-16,26
Young Boys,3334,1,21,6,5,71,36,35,69
FC Basel,3334,2,19,8,5,57,27,30,65
Lucerne,3334,3,13,7,12,41,44,-3,46
St Gallen,3334,4,14,3,15,44,57,-13,45
FC Zürich,3334,5,10,11,11,45,38,7,41
Grasshoppers,3334,6,10,7,15,43,48,-5,37
FC Lugano,3334,7,10,6,16,32,51,-19,36
FC Thun,3334,8,9,6,17,40,59,-19,33
FC Sion,3334,9,7,8,17,42,55,-13,29
Young Boys,3335,1,22,6,4,69,34,35,72
FC Basel,3335,2,19,8,5,51,22,29,65
St Gallen,3335,3,14,2,16,43,58,-15,44
Lucerne,3335,4,12,7,13,40,45,-5,43
FC Zürich,3335,5,10,12,10,42,36,6,42
Grasshoppers,3335,6,10,6,16,40,47,-7,36
FC Lugano,3335,7,10,6,16,33,48,-15,36
FC Sion,3335,8,8,8,16,43,52,-9,32
FC Thun,3335,9,9,5,18,40,59,-19,32
Young Boys,3336,1,21,7,4,73,39,34,70
FC Basel,3336,2,20,7,5,59,25,34,67
Lucerne,3336,3,13,7,12,45,45,0,46
St Gallen,3336,4,14,3,15,42,55,-13,45
FC Thun,3336,5,11,5,16,46,58,-12,38
FC Zürich,3336,6,9,10,13,38,42,-4,37
FC Lugano,3336,7,9,8,15,32,50,-18,35
FC Sion,3336,8,8,8,16,41,51,-10,32
Grasshoppers,3336,9,8,7,17,41,52,-11,31
Young Boys,3337,1,22,7,3,76,37,39,73
FC Basel,3337,2,17,8,7,56,29,27,59
Lucerne,3337,3,12,9,11,44,43,1,45
FC Zürich,3337,4,11,9,12,39,37,2,42
St Gallen,3337,5,13,3,16,41,59,-18,42
Grasshoppers,3337,6,11,6,15,44,48,-4,39
FC Lugano,3337,7,11,5,16,35,56,-21,38
FC Thun,3337,8,9,6,17,43,58,-15,33
FC Sion,3337,9,7,9,16,39,50,-11,30
Young Boys,3338,1,20,8,4,71,39,32,68
FC Basel,3338,2,19,8,5,55,22,33,65
Lucerne,3338,3,15,7,10,48,43,5,52
FC Zürich,3338,4,11,10,11,40,34,6,43
St Gallen,3338,5,13,2,17,40,57,-17,41
Grasshoppers,3338,6,10,6,16,39,47,-8,36
FC Lugano,3338,7,10,6,16,33,53,-20,36
FC Sion,3338,8,8,7,17,41,52,-11,31
FC Thun,3338,9,8,6,18,38,58,-20,30
Young Boys,3339,1,23,7,2,76,33,43,76
FC Basel,3339,2,17,8,7,52,26,26,59
Lucerne,3339,3,14,8,10,45,43,2,50
St Gallen,3339,4,13,5,14,40,54,-14,44
FC Thun,3339,5,11,5,16,47,57,-10,38
FC Zürich,3339,6,9,10,13,39,42,-3,37
Grasshoppers,3339,7,10,6,16,40,48,-8,36
FC Lugano,3339,8,9,7,16,30,49,-19,34
FC Sion,3339,9,6,8,18,39,56,-17,26
Young Boys,3340,1,23,7,2,76,32,44,76
FC Basel,3340,2,17,9,6,55,28,27,60
Lucerne,3340,3,13,8,11,45,46,-1,47
FC Zürich,3340,4,11,11,10,44,38,6,44
St Gallen,3340,5,13,4,15,42,58,-16,43
FC Lugano,3340,6,10,5,17,31,50,-19,35
Grasshoppers,3340,7,9,7,16,42,52,-10,34
FC Thun,3340,8,9,5,18,42,60,-18,32
FC Sion,3340,9,7,8,17,44,57,-13,29
Young Boys,3341,1,23,7,2,71,31,40,76
FC Basel,3341,2,18,7,7,55,26,29,61
Lucerne,3341,3,12,8,12,40,44,-4,44
St Gallen,3341,4,13,4,15,41,56,-15,43
FC Zürich,3341,5,9,12,11,39,37,2,39
FC Lugano,3341,6,10,8,14,31,44,-13,38
FC Thun,3341,7,10,7,15,44,56,-12,37
FC Sion,3341,8,7,9,16,40,52,-12,30
Grasshoppers,3341,9,8,6,18,38,53,-15,30
Young Boys,3342,1,23,7,2,78,32,46,76
FC Basel,3342,2,16,10,6,53,28,25,58
St Gallen,3342,3,15,3,14,43,53,-10,48
Lucerne,3342,4,13,8,11,43,46,-3,47
FC Zürich,3342,5,12,10,10,45,33,12,46
Grasshoppers,3342,6,10,6,16,39,49,-10,36
FC Lugano,3342,7,9,7,16,29,48,-19,34
FC Thun,3342,8,9,6,17,41,59,-18,33
FC Sion,3342,9,5,7,20,37,60,-23,22
Young Boys,3343,1,20,8,4,68,39,29,68
FC Basel,3343,2,18,7,7,58,29,29,61
Lucerne,3343,3,14,7,11,44,44,0,49
St Gallen,3343,4,14,3,15,44,55,-11,45
FC Zürich,3343,5,10,9,13,41,41,0,39
Grasshoppers,3343,6,10,7,15,41,47,-6,37
FC Lugano,3343,7,10,7,15,30,46,-16,37
FC Sion,3343,8,9,7,16,44,51,-7,34
FC Thun,3343,9,9,5,18,42,60,-18,32
Young Boys,3344,1,22,6,4,75,36,39,72
FC Basel,3344,2,18,8,6,56,26,30,62
St Gallen,3344,3,15,4,13,45,53,-8,49
Lucerne,3344,4,12,8,12,40,45,-5,44
FC Zürich,3344,5,11,10,11,42,37,5,43
Grasshoppers,3344,6,10,7,15,43,48,-5,37
FC Lugano,3344,7,9,6,17,31,53,-22,33
FC Thun,3344,8,9,5,18,41,64,-23,32
FC Sion,3344,9,7,8,17,42,53,-11,29
Young Boys,3345,1,20,7,5,68,39,29,67
FC Basel,3345,2,18,9,5,56,23,33,63
Lucerne,3345,3,13,9,10,42,40,2,48
FC Zürich,3345,4,10,12,10,42,35,7,42
St Gallen,3345,5,13,3,16,39,55,-16,42
Grasshoppers,3345,6,10,8,14,42,47,-5,38
FC Lugano,3345,7,10,5,17,30,51,-21,35
FC Sion,3345,8,7,10,15,41,50,-9,31
FC Thun,3345,9,8,7,17,44,64,-20,31
Young Boys,3346,1,22,6,4,77,39,38,72
FC Basel,3346,2,17,8,7,54,27,27,59
Lucerne,3346,3,15,7,10,49,44,5,52
St Gallen,3346,4,13,3,16,42,59,-17,42
FC Zürich,3346,5,10,10,12,39,36,3,40
Grasshoppers,3346,6,11,6,15,46,52,-6,39
FC Lugano,3346,7,11,6,15,34,50,-16,39
FC Thun,3346,8,10,5,17,45,63,-18,35
FC Sion,3346,9,6,7,19,44,60,-16,25
Young Boys,3347,1,21,7,4,70,37,33,70
FC Basel,3347,2,17,8,7,52,26,26,59
Lucerne,3347,3,13,8,11,46,44,2,47
St Gallen,3347,4,14,4,14,41,53,-12,46
FC Zürich,3347,5,10,10,12,38,36,2,40
FC Thun,3347,6,10,7,15,44,56,-12,37
Grasshoppers,3347,7,10,6,16,44,53,-9,36
FC Lugano,3347,8,10,6,16,30,47,-17,36
FC Sion,3347,9,7,8,17,41,54,-13,29
Young Boys,3348,1,22,7,3,74,34,40,73
FC Basel,3348,2,18,7,7,54,25,29,61
St Gallen,3348,3,16,2,14,45,52,-7,50
Lucerne,3348,4,12,8,12,42,47,-5,44
FC Zürich,3348,5,10,10,12,42,39,3,40
FC Lugano,3348,6,11,6,15,33,47,-14,39
FC Thun,3348,7,10,6,16,44,62,-18,36
Grasshoppers,3348,8,9,7,16,41,49,-8,34
FC Sion,3348,9,6,7,19,40,60,-20,25
Young Boys,3349,1,22,6,4,70,36,34,72
FC Basel,3349,2,19,7,6,58,27,31,64
Lucerne,3349,3,12,8,12,40,44,-4,44
FC Zürich,3349,4,11,9,12,43,37,6,42
St Gallen,3349,5,13,2,17,39,60,-21,41
FC Lugano,3349,6,11,6,15,32,44,-12,39
FC Thun,3349,7,11,5,16,44,59,-15,38
Grasshoppers,3349,8,9,6,17,41,51,-10,33
FC Sion,3349,9,8,7,17,43,52,-9,31
Young Boys,3350,1,23,6,3,82,32,50,75
FC Basel,3350,2,18,8,6,55,24,31,62
Lucerne,3350,3,14,8,10,46,43,3,50
FC Zürich,3350,4,11,9,12,40,38,2,42
St Gallen,3350,5,13,3,16,39,55,-16,42
FC Thun,3350,6,11,5,16,46,57,-11,38
FC Lugano,3350,7,10,6,16,31,56,-25,36
Grasshoppers,3350,8,8,6,18,38,55,-17,30
FC Sion,3350,9,7,7,18,37,54,-17,28
Young Boys,3351,1,22,8,2,73,34,39,74
FC Basel,3351,2,17,9,6,54,28,26,60
St Gallen,3351,3,14,3,15,43,56,-13,45
Lucerne,3351,4,12,8,12,43,47,-4,44
FC Zürich,3351,5,10,12,10,42,36,6,42
FC Lugano,3351,6,10,6,16,32,49,-17,36
Grasshoppers,3351,7,9,8,15,41,49,-8,35
FC Thun,3351,8,9,7,16,43,58,-15,34
FC Sion,3351,9,6,9,17,40,54,-14,27
Young Boys,3352,1,21,7,4,70,37,33,70
FC Basel,3352,2,17,8,7,52,26,26,59
St Gallen,3352,3,16,2,14,43,52,-9,50
FC Zürich,3352,4,13,9,10,42,32,10,48
Lucerne,3352,5,12,9,11,43,46,-3,45
Grasshoppers,3352,6,11,6,15,46,50,-4,39
FC Lugano,3352,7,10,6,16,29,45,-16,36
FC Thun,3352,8,8,5,19,39,63,-24,29
FC Sion,3352,9,6,8,18,39,52,-13,26
Young Boys,3353,1,21,7,4,69,36,33,70
FC Basel,3353,2,19,8,5,54,23,31,65
Lucerne,3353,3,14,8,10,41,40,1,50
FC Zürich,3353,4,11,9,12,42,39,3,42
St Gallen,3353,5,13,3,16,39,55,-16,42
FC Thun,3353,6,10,6,16,47,60,-13,36
FC Lugano,3353,7,10,5,17,31,48,-17,35
Grasshoppers,3353,8,8,8,16,41,51,-10,32
FC Sion,3353,9,6,10,16,41,53,-12,28
Young Boys,3354,1,21,7,4,71,35,36,70
FC Basel,3354,2,17,8,7,52,26,26,59
St Gallen,3354,3,16,3,13,45,52,-7,51
Lucerne,3354,4,12,8,12,42,48,-6,44
Grasshoppers,3354,5,12,6,14,46,46,0,42
FC Zürich,3354,6,10,10,12,39,38,1,40
FC Lugano,3354,7,10,6,16,29,46,-17,36
FC Thun,3354,8,10,5,17,47,61,-14,35
FC Sion,3354,9,6,7,19,39,58,-19,25
Young Boys,3355,1,23,7,2,79,33,46,76
FC Basel,3355,2,18,8,6,53,25,28,62
FC Zürich,3355,3,13,9,10,43,33,10,48
St Gallen,3355,4,14,2,16,44,57,-13,44
Lucerne,3355,5,12,7,13,42,48,-6,43
FC Lugano,3355,6,11,5,16,30,46,-16,38
FC Thun,3355,7,10,5,17,43,58,-15,35
Grasshoppers,3355,8,9,6,17,38,53,-15,33
FC Sion,3355,9,6,7,19,37,56,-19,25
Young Boys,3356,1,20,9,3,71,40,31,69
FC Basel,3356,2,18,8,6,58,26,32,62
Lucerne,3356,3,12,10,10,41,41,0,46
St Gallen,3356,4,14,3,15,40,55,-15,45
FC Zürich,3356,5,11,9,12,42,40,2,42
FC Thun,3356,6,10,6,16,44,57,-13,36
FC Lugano,3356,7,10,6,16,31,47,-16,36
Grasshoppers,3356,8,8,10,14,38,46,-8,34
FC Sion,3356,9,6,9,17,40,53,-13,27
Young Boys,3357,1,22,7,3,77,33,44,73
FC Basel,3357,2,16,9,7,51,27,24,57
St Gallen,3357,3,15,3,14,45,54,-9,48
Lucerne,3357,4,11,9,12,39,47,-8,42
FC Zürich,3357,5,10,11,11,40,36,4,41
FC Lugano,3357,6,11,6,15,34,49,-15,39
FC Thun,3357,7,10,6,16,45,59,-14,36
Grasshoppers,3357,8,8,8,16,39,53,-14,32
FC Sion,3357,9,7,9,16,42,54,-12,30
Young Boys,3358,1,23,6,3,73,32,41,75
FC Basel,3358,2,18,7,7,55,25,30,61
Lucerne,3358,3,13,8,11,43,43,0,47
St Gallen,3358,4,14,4,14,44,55,-11,46
FC Zürich,3358,5,10,10,12,39,39,0,40
Grasshoppers,3358,6,10,7,15,40,47,-7,37
FC Thun,3358,7,10,5,17,45,61,-16,35
FC Lugano,3358,8,9,7,16,30,49,-19,34
FC Sion,3358,9,6,8,18,37,55,-18,26
Young Boys,3359,1,21,8,3,73,37,36,71
FC Basel,3359,2,16,8,8,50,26,24,56
Lucerne,3359,3,14,7,11,42,43,-1,49
St Gallen,3359,4,15,2,15,41,53,-12,47
FC Zürich,3359,5,11,9,12,43,40,3,42
FC Lugano,3359,6,12,5,15,35,47,-12,41
FC Thun,3359,7,10,5,17,45,59,-14,35
FC Sion,3359,8,8,8,16,44,53,-9,32
Grasshoppers,3359,9,8,6,18,38,53,-15,30
Young Boys,3360,1,21,6,5,72,38,34,69
FC Basel,3360,2,20,7,5,55,23,32,67
Lucerne,3360,3,12,8,12,43,49,-6,44
St Gallen,3360,4,13,3,16,43,59,-16,42
FC Zürich,3360,5,10,10,12,41,36,5,40
FC Lugano,3360,6,11,6,15,34,46,-12,39
Grasshoppers,3360,7,10,7,15,45,51,-6,37
FC Thun,3360,8,9,7,16,41,56,-15,34
FC Sion,3360,9,7,8,17,39,55,-16,29
Young Boys,3361,1,21,8,3,68,33,35,71
FC Basel,3361,2,18,7,7,56,23,33,61
Lucerne,3361,3,13,9,10,42,40,2,48
FC Zürich,3361,4,12,10,10,44,36,8,46
St Gallen,3361,5,13,2,17,41,61,-20,41
Grasshoppers,3361,6,10,8,14,41,47,-6,38
FC Lugano,3361,7,10,7,15,32,47,-15,37
FC Sion,3361,8,7,8,17,42,55,-13,29
FC Thun,3361,9,8,5,19,44,68,-24,29
Young Boys,3362,1,22,6,4,71,33,38,72
FC Basel,3362,2,19,8,5,63,26,37,65
St Gallen,3362,3,14,4,14,44,56,-12,46
Lucerne,3362,4,12,8,12,41,47,-6,44
FC Zürich,3362,5,11,9,12,40,38,2,42
FC Lugano,3362,6,10,6,16,30,50,-20,36
FC Thun,3362,7,10,5,17,45,61,-16,35
Grasshoppers,3362,8,9,7,16,38,47,-9,34
FC Sion,3362,9,6,9,17,38,52,-14,27
Young Boys,3363,1,22,7,3,74,35,39,73
FC Basel,3363,2,16,9,7,49,24,25,57
St Gallen,3363,3,16,2,14,45,55,-10,50
FC Zürich,3363,4,12,9,11,39,34,5,45
Lucerne,3363,5,12,7,13,43,50,-7,43
FC Lugano,3363,6,10,5,17,30,47,-17,35
FC Sion,3363,7,9,7,16,46,55,-9,34
Grasshoppers,3363,7,9,7,16,46,55,-9,34
FC Thun,3363,9,8,7,17,42,59,-17,31
Young Boys,3364,1,20,9,3,69,38,31,69
FC Basel,3364,2,15,10,7,50,27,23,55
St Gallen,3364,3,15,3,14,41,51,-10,48
Lucerne,3364,4,12,11,9,42,42,0,47
FC Zürich,3364,5,12,9,11,41,34,7,45
Grasshoppers,3364,6,11,7,14,47,48,-1,40
FC Thun,3364,7,10,6,16,41,55,-14,36
FC Lugano,3364,8,9,6,17,28,47,-19,33
FC Sion,3364,9,5,9,18,38,55,-17,24
Young Boys,3365,1,21,7,4,72,38,34,70
FC Basel,3365,2,18,7,7,54,28,26,61
St Gallen,3365,3,15,3,14,44,53,-9,48
Lucerne,3365,4,12,9,11,44,47,-3,45
FC Zürich,3365,5,11,10,11,41,34,7,43
FC Lugano,3365,6,10,7,15,30,45,-15,37
Grasshoppers,3365,7,10,6,16,43,52,-9,36
FC Thun,3365,8,9,5,18,43,61,-18,32
FC Sion,3365,9,7,8,17,41,54,-13,29
Young Boys,3366,1,21,9,2,69,31,38,72
FC Basel,3366,2,17,9,6,51,25,26,60
FC Zürich,3366,3,12,9,11,42,34,8,45
St Gallen,3366,4,14,3,15,42,54,-12,45
Lucerne,3366,5,11,11,10,41,44,-3,44
FC Lugano,3366,6,11,6,15,32,46,-14,39
Grasshoppers,3366,7,9,9,14,42,48,-6,36
FC Thun,3366,8,8,7,17,41,58,-17,31
FC Sion,3366,9,5,9,18,34,54,-20,24
Young Boys,3367,1,21,9,2,71,33,38,72
FC Basel,3367,2,17,10,5,54,26,28,61
St Gallen,3367,3,15,3,14,42,51,-9,48
Lucerne,3367,4,12,9,11,41,42,-1,45
FC Zürich,3367,5,9,12,11,39,36,3,39
FC Lugano,3367,6,9,7,16,27,46,-19,34
Grasshoppers,3367,7,8,9,15,39,50,-11,33
FC Thun,3367,8,9,6,17,44,61,-17,33
FC Sion,3367,9,6,11,15,40,52,-12,29
Young Boys,3368,1,20,8,4,70,38,32,68
FC Basel,3368,2,18,8,6,53,23,30,62
Lucerne,3368,3,13,8,11,41,42,-1,47
St Gallen,3368,4,15,2,15,42,54,-12,47
FC Zürich,3368,5,11,10,11,43,36,7,43
Grasshoppers,3368,6,10,7,15,41,47,-6,37
FC Thun,3368,7,10,6,16,42,57,-15,36
FC Lugano,3368,8,10,6,16,31,47,-16,36
FC Sion,3368,9,6,7,19,39,58,-19,25
Young Boys,3369,1,22,7,3,68,33,35,73
FC Basel,3369,2,18,9,5,54,24,30,63
St Gallen,3369,3,14,5,13,45,53,-8,47
Lucerne,3369,4,12,8,12,39,45,-6,44
FC Zürich,3369,5,10,10,12,43,40,3,40
FC Lugano,3369,6,10,6,16,31,47,-16,36
Grasshoppers,3369,7,9,8,15,40,47,-7,35
FC Thun,3369,8,9,6,17,44,61,-17,33
FC Sion,3369,9,6,9,17,43,57,-14,27
Young Boys,3370,1,20,7,5,68,36,32,67
FC Basel,3370,2,18,8,6,53,25,28,62
St Gallen,3370,3,16,3,13,47,54,-7,51
Lucerne,3370,4,13,9,10,43,43,0,48
FC Zürich,3370,5,9,9,14,38,40,-2,36
FC Lugano,3370,6,10,6,16,33,49,-16,36
Grasshoppers,3370,7,8,10,14,40,48,-8,34
FC Thun,3370,8,9,6,17,42,60,-18,33
FC Sion,3370,9,8,8,16,44,53,-9,32
Young Boys,3371,1,22,7,3,73,36,37,73
FC Basel,3371,2,16,8,8,51,28,23,56
St Gallen,3371,3,15,2,15,45,58,-13,47
FC Zürich,3371,4,12,10,10,46,36,10,46
Lucerne,3371,5,13,7,12,41,46,-5,46
Grasshoppers,3371,6,11,6,15,43,48,-5,39
FC Lugano,3371,7,10,6,16,33,48,-15,36
FC Thun,3371,8,9,5,18,45,63,-18,32
FC Sion,3371,9,7,7,18,43,57,-14,28
Young Boys,3372,1,22,6,4,73,38,35,72
FC Basel,3372,2,18,9,5,56,27,29,63
St Gallen,3372,3,15,3,14,43,54,-11,48
Lucerne,3372,4,12,9,11,44,46,-2,45
FC Zürich,3372,5,10,10,12,40,37,3,40
FC Lugano,3372,6,10,6,16,34,49,-15,36
Grasshoppers,3372,7,9,8,15,41,48,-7,35
FC Thun,3372,8,9,8,15,43,57,-14,35
FC Sion,3372,9,5,9,18,39,57,-18,24
Young Boys,3373,1,22,6,4,69,32,37,72
FC Basel,3373,2,18,8,6,52,26,26,62
St Gallen,3373,3,16,3,13,47,52,-5,51
Lucerne,3373,4,11,9,12,39,44,-5,42
Grasshoppers,3373,5,11,7,14,43,46,-3,40
FC Zürich,3373,6,9,9,14,38,40,-2,36
FC Lugano,3373,7,10,6,16,30,48,-18,36
FC Thun,3373,8,10,5,17,43,59,-16,35
FC Sion,3373,9,7,7,18,39,53,-14,28
Young Boys,3374,1,22,8,2,70,31,39,74
FC Basel,3374,2,17,8,7,55,28,27,59
Lucerne,3374,3,13,9,10,41,40,1,48
St Gallen,3374,4,14,4,14,44,55,-11,46
FC Zürich,3374,5,10,11,11,45,42,3,41
FC Lugano,3374,6,10,6,16,31,50,-19,36
FC Thun,3374,7,9,8,15,46,59,-13,35
Grasshoppers,3374,8,9,7,16,40,50,-10,34
FC Sion,3374,9,5,9,18,39,56,-17,24
Young Boys,3375,1,22,6,4,75,36,39,72
FC Basel,3375,2,19,7,6,57,24,33,64
Lucerne,3375,3,13,8,11,42,48,-6,47
St Gallen,3375,4,14,3,15,41,54,-13,45
FC Zürich,3375,5,10,11,11,42,36,6,41
FC Lugano,3375,6,11,7,14,33,44,-11,40
Grasshoppers,3375,7,9,7,16,43,51,-8,34
FC Thun,3375,8,9,6,17,43,65,-22,33
FC Sion,3375,9,5,9,18,41,59,-18,24
Young Boys,3376,1,20,9,3,67,32,35,69
FC Basel,3376,2,17,9,6,53,26,27,60
Lucerne,3376,3,12,10,10,47,46,1,46
St Gallen,3376,4,14,3,15,44,60,-16,45
FC Lugano,3376,5,11,6,15,36,47,-11,39
FC Zürich,3376,6,9,11,12,37,38,-1,38
FC Thun,3376,7,10,5,17,47,61,-14,35
FC Sion,3376,8,8,9,15,43,51,-8,33
Grasshoppers,3376,9,8,8,16,39,52,-13,32
Young Boys,3377,1,20,7,5,69,38,31,67
FC Basel,3377,2,18,7,7,56,26,30,61
Lucerne,3377,3,14,7,11,44,42,2,49
St Gallen,3377,4,14,3,15,41,55,-14,45
FC Zürich,3377,5,11,10,11,40,36,4,43
FC Lugano,3377,6,10,8,14,30,44,-14,38
Grasshoppers,3377,7,9,8,15,40,49,-9,35
FC Thun,3377,8,9,6,17,39,57,-18,33
FC Sion,3377,9,7,8,17,39,51,-12,29
Young Boys,3378,1,22,6,4,73,36,37,72
FC Basel,3378,2,17,8,7,53,27,26,59
Lucerne,3378,3,13,8,11,43,48,-5,47
St Gallen,3378,4,14,3,15,43,58,-15,45
FC Zürich,3378,5,11,9,12,42,37,5,42
Grasshoppers,3378,6,10,7,15,43,49,-6,37
FC Lugano,3378,7,10,6,16,31,49,-18,36
FC Thun,3378,8,9,6,17,41,58,-17,33
FC Sion,3378,9,8,7,17,44,51,-7,31
Young Boys,3379,1,21,7,4,72,38,34,70
FC Basel,3379,2,16,9,7,52,28,24,57
Lucerne,3379,3,13,10,9,46,45,1,49
St Gallen,3379,4,14,4,14,43,52,-9,46
FC Zürich,3379,5,10,9,13,40,39,1,39
FC Lugano,3379,6,11,6,15,33,49,-16,39
FC Thun,3379,7,10,6,16,44,57,-13,36
Grasshoppers,3379,8,9,7,16,42,51,-9,34
FC Sion,3379,9,7,8,17,40,53,-13,29
Young Boys,3380,1,23,7,2,72,32,40,76
FC Basel,3380,2,18,9,5,56,26,30,63
St Gallen,3380,3,15,4,13,46,53,-7,49
Lucerne,3380,4,12,7,13,40,46,-6,43
FC Zürich,3380,5,10,9,13,41,40,1,39
FC Lugano,3380,6,10,6,16,33,47,-14,36
Grasshoppers,3380,7,9,7,16,41,53,-12,34
FC Thun,3380,8,9,7,16,47,63,-16,34
FC Sion,3380,9,6,8,18,42,58,-16,26
Young Boys,3381,1,19,9,4,69,38,31,66
FC Basel,3381,2,16,9,7,50,27,23,57
St Gallen,3381,3,16,2,14,46,52,-6,50
Lucerne,3381,4,13,9,10,41,39,2,48
FC Zürich,3381,5,10,11,11,40,35,5,41
FC Lugano,3381,6,10,7,15,30,47,-17,37
Grasshoppers,3381,7,10,6,16,42,52,-10,36
FC Thun,3381,8,9,7,16,42,57,-15,34
FC Sion,3381,9,7,8,17,44,57,-13,29
Young Boys,3382,1,23,7,2,75,32,43,76
FC Basel,3382,2,18,8,6,55,25,30,62
St Gallen,3382,3,15,3,14,44,54,-10,48
Lucerne,3382,4,12,8,12,39,44,-5,44
FC Zürich,3382,5,10,10,12,40,37,3,40
FC Lugano,3382,6,10,6,16,32,51,-19,36
Grasshoppers,3382,7,9,7,16,41,51,-10,34
FC Thun,3382,8,9,5,18,42,60,-18,32
FC Sion,3382,9,7,8,17,40,54,-14,29
Young Boys,3383,1,21,7,4,69,36,33,70
FC Basel,3383,2,17,7,8,54,30,24,58
Lucerne,3383,3,14,9,9,45,43,2,51
St Gallen,3383,4,15,2,15,44,57,-13,47
FC Zürich,3383,5,11,9,12,44,39,5,42
Grasshoppers,3383,6,10,6,16,43,50,-7,36
FC Sion,3383,7,9,7,16,44,50,-6,34
FC Lugano,3383,8,9,6,17,31,49,-18,33
FC Thun,3383,9,9,5,18,41,61,-20,32
Young Boys,3384,1,20,8,4,68,36,32,68
FC Basel,3384,2,18,8,6,52,27,25,62
St Gallen,3384,3,14,5,13,44,52,-8,47
Lucerne,3384,4,12,10,10,39,42,-3,46
FC Zürich,3384,5,9,11,12,37,35,2,38
Grasshoppers,3384,6,10,8,14,46,49,-3,38
FC Lugano,3384,7,9,8,15,28,44,-16,35
FC Thun,3384,8,9,6,17,43,61,-18,33
FC Sion,3384,9,6,10,16,44,55,-11,28
Young Boys,3385,1,22,6,4,71,33,38,72
FC Basel,3385,2,19,8,5,58,23,35,65
St Gallen,3385,3,15,2,15,44,58,-14,47
Lucerne,3385,4,12,8,12,43,48,-5,44
FC Zürich,3385,5,10,11,11,40,36,4,41
FC Thun,3385,6,10,6,16,41,57,-16,36
FC Lugano,3385,7,10,6,16,34,50,-16,36
Grasshoppers,3385,8,9,6,17,39,52,-13,33
FC Sion,3385,9,7,7,18,41,54,-13,28
Young Boys,3386,1,21,7,4,71,35,36,70
FC Basel,3386,2,19,7,6,59,23,36,64
St Gallen,3386,3,15,2,15,45,57,-12,47
Lucerne,3386,4,11,8,13,40,51,-11,41
FC Zürich,3386,5,10,9,13,39,38,1,39
FC Sion,3386,6,10,7,15,41,49,-8,37
FC Lugano,3386,7,10,7,15,31,47,-16,37
FC Thun,3386,8,10,5,17,42,58,-16,35
Grasshoppers,3386,9,9,6,17,40,50,-10,33
Young Boys,3387,1,21,6,5,74,40,34,69
FC Basel,3387,2,19,8,5,60,29,31,65
St Gallen,3387,3,14,2,16,41,56,-15,44
Lucerne,3387,4,11,10,11,41,46,-5,43
FC Zürich,3387,5,10,10,12,45,40,5,40
Grasshoppers,3387,6,10,7,15,47,53,-6,37
FC Lugano,3387,7,10,7,15,30,46,-16,37
FC Thun,3387,8,10,5,17,47,61,-14,35
FC Sion,3387,9,8,7,17,40,54,-14,31
Young Boys,3388,1,22,7,3,75,35,40,73
FC Basel,3388,2,17,7,8,54,31,23,58
St Gallen,3388,3,15,3,14,42,52,-10,48
Lucerne,3388,4,13,7,12,41,45,-4,46
FC Zürich,3388,5,11,10,11,41,36,5,43
FC Lugano,3388,6,11,5,16,31,46,-15,38
Grasshoppers,3388,7,10,6,16,42,52,-10,36
FC Thun,3388,8,10,6,16,44,56,-12,36
FC Sion,3388,9,5,9,18,37,54,-17,24
Young Boys,3389,1,23,6,3,78,34,44,75
FC Basel,3389,2,18,8,6,54,26,28,62
FC Zürich,3389,3,12,10,10,43,34,9,46
Lucerne,3389,4,12,8,12,40,46,-6,44
St Gallen,3389,5,14,2,16,45,59,-14,44
Grasshoppers,3389,6,10,6,16,40,50,-10,36
FC Lugano,3389,7,10,6,16,30,49,-19,36
FC Thun,3389,8,9,6,17,45,62,-17,33
FC Sion,3389,9,6,8,18,44,59,-15,26
Young Boys,3390,1,22,6,4,72,38,34,72
FC Basel,3390,2,18,7,7,61,33,28,61
Lucerne,3390,3,13,9,10,49,48,1,48
FC Zürich,3390,4,11,10,11,41,36,5,43
St Gallen,3390,5,13,4,15,44,58,-14,43
Grasshoppers,3390,6,10,7,15,39,46,-7,37
FC Lugano,3390,7,10,6,16,31,49,-18,36
FC Thun,3390,8,9,6,17,42,56,-14,33
FC Sion,3390,9,7,7,18,41,56,-15,28
Young Boys,3391,1,22,6,4,77,38,39,72
FC Basel,3391,2,18,8,6,58,26,32,62
St Gallen,3391,3,15,3,14,48,55,-7,48
Lucerne,3391,4,13,7,12,42,49,-7,46
FC Zürich,3391,5,12,9,11,44,37,7,45
FC Lugano,3391,6,11,5,16,35,49,-14,38
Grasshoppers,3391,7,9,6,17,40,50,-10,33
FC Thun,3391,8,9,5,18,41,64,-23,32
FC Sion,3391,9,7,7,18,42,59,-17,28
Young Boys,3392,1,22,6,4,72,34,38,72
FC Basel,3392,2,15,9,8,49,30,19,54
St Gallen,3392,3,14,4,14,44,54,-10,46
FC Zürich,3392,4,12,9,11,45,35,10,45
Lucerne,3392,5,12,9,11,47,53,-6,45
FC Lugano,3392,6,12,5,15,35,48,-13,41
Grasshoppers,3392,7,8,9,15,39,48,-9,33
FC Sion,3392,8,8,8,16,43,53,-10,32
FC Thun,3392,9,8,7,17,40,59,-19,31
Young Boys,3393,1,20,7,5,68,37,31,67
FC Basel,3393,2,19,7,6,56,24,32,64
Lucerne,3393,3,13,9,10,45,43,2,48
St Gallen,3393,4,14,3,15,41,55,-14,45
FC Zürich,3393,5,11,10,11,41,34,7,43
Grasshoppers,3393,6,10,6,16,45,51,-6,36
FC Thun,3393,7,10,6,16,43,59,-16,36
FC Lugano,3393,8,9,6,17,29,50,-21,33
FC Sion,3393,9,7,8,17,41,56,-15,29
Young Boys,3394,1,23,6,3,75,36,39,75
FC Basel,3394,2,17,8,7,55,29,26,59
St Gallen,3394,3,15,3,14,42,52,-10,48
Lucerne,3394,4,13,7,12,41,43,-2,46
FC Zürich,3394,5,10,11,11,41,37,4,41
Grasshoppers,3394,6,10,7,15,41,48,-7,37
FC Thun,3394,7,10,7,15,46,58,-12,37
FC Lugano,3394,8,9,6,17,30,52,-22,33
FC Sion,3394,9,5,9,18,40,56,-16,24
Young Boys,3395,1,21,6,5,73,41,32,69
FC Basel,3395,2,18,8,6,52,25,27,62
Lucerne,3395,3,14,7,11,46,46,0,49
St Gallen,3395,4,15,2,15,44,55,-11,47
FC Zürich,3395,5,12,10,10,44,34,10,46
Grasshoppers,3395,6,11,6,15,48,50,-2,39
FC Lugano,3395,7,9,5,18,29,52,-23,32
FC Thun,3395,8,8,6,18,41,60,-19,30
FC Sion,3395,9,7,8,17,44,58,-14,29
Young Boys,3396,1,21,6,5,71,40,31,69
FC Basel,3396,2,19,7,6,58,26,32,64
Lucerne,3396,3,13,7,12,45,46,-1,46
St Gallen,3396,4,14,4,14,47,59,-12,46
FC Zürich,3396,5,12,9,11,40,33,7,45
FC Lugano,3396,6,11,6,15,34,48,-14,39
FC Thun,3396,7,10,5,17,44,56,-12,35
Grasshoppers,3396,8,9,6,17,42,54,-12,33
FC Sion,3396,9,6,8,18,39,58,-19,26
Young Boys,3397,1,21,8,3,73,35,38,71
FC Basel,3397,2,18,8,6,53,25,28,62
Lucerne,3397,3,14,7,11,44,46,-2,49
St Gallen,3397,4,14,3,15,42,55,-13,45
FC Zürich,3397,5,10,11,11,41,36,5,41
FC Lugano,3397,6,10,7,15,36,52,-16,37
Grasshoppers,3397,7,9,8,15,43,49,-6,35
FC Thun,3397,8,8,7,17,41,60,-19,31
FC Sion,3397,9,6,9,17,38,53,-15,27
Young Boys,3398,1,23,6,3,77,33,44,75
FC Basel,3398,2,18,8,6,58,26,32,62
Lucerne,3398,3,13,7,12,45,54,-9,46
St Gallen,3398,4,13,4,15,44,59,-15,43
FC Lugano,3398,5,12,5,15,38,46,-8,41
Grasshoppers,3398,6,11,6,15,49,53,-4,39
FC Zürich,3398,7,9,10,13,39,44,-5,37
FC Thun,3398,8,9,6,17,44,62,-18,33
FC Sion,3398,9,6,8,18,42,59,-17,26
Young Boys,3399,1,23,6,3,70,37,33,75
FC Basel,3399,2,20,7,5,64,23,41,67
St Gallen,3399,3,14,3,15,40,55,-15,45
Lucerne,3399,4,12,8,12,40,44,-4,44
FC Zürich,3399,5,11,9,12,41,38,3,42
FC Lugano,3399,6,11,6,15,33,44,-11,39
Grasshoppers,3399,7,9,7,16,40,51,-11,34
FC Thun,3399,8,9,5,18,44,61,-17,32
FC Sion,3399,9,5,9,18,38,57,-19,24
Young Boys,3400,1,22,6,4,75,37,38,72
FC Basel,3400,2,17,8,7,56,26,30,59
St Gallen,3400,3,15,3,14,44,53,-9,48
Lucerne,3400,4,12,8,12,39,47,-8,44
FC Zürich,3400,5,10,11,11,40,37,3,41
FC Lugano,3400,6,10,7,15,30,45,-15,37
FC Thun,3400,7,10,6,16,43,61,-18,36
Grasshoppers,3400,8,9,8,15,41,50,-9,35
FC Sion,3400,9,7,7,18,44,56,-12,28
Young Boys,3401,1,20,10,2,68,32,36,70
FC Basel,3401,2,17,10,5,55,26,29,61
Lucerne,3401,3,12,10,10,42,44,-2,46
St Gallen,3401,4,14,2,16,41,55,-14,44
FC Zürich,3401,5,10,11,11,42,37,5,41
Grasshoppers,3401,6,11,7,14,45,48,-3,40
FC Lugano,3401,7,10,7,15,32,47,-15,37
FC Thun,3401,8,10,5,17,45,61,-16,35
FC Sion,3401,9,5,8,19,37,57,-20,23
Young Boys,3402,1,22,6,4,77,37,40,72
FC Basel,3402,2,18,9,5,58,26,32,63
Lucerne,3402,3,13,7,12,42,45,-3,46
St Gallen,3402,4,14,3,15,45,56,-11,45
FC Zürich,3402,5,11,10,11,42,39,3,43
FC Sion,3402,6,9,8,15,44,52,-8,35
FC Lugano,3402,7,10,5,17,33,54,-21,35
FC Thun,3402,8,9,6,17,44,61,-17,33
Grasshoppers,3402,9,8,6,18,40,55,-15,30
Young Boys,3403,1,21,8,3,69,34,35,71
FC Basel,3403,2,16,9,7,53,28,25,57
St Gallen,3403,3,16,3,13,45,53,-8,51
FC Zürich,3403,4,12,9,11,45,37,8,45
Lucerne,3403,5,12,8,12,44,47,-3,44
Grasshoppers,3403,6,11,6,15,45,49,-4,39
FC Lugano,3403,7,10,6,16,32,48,-16,36
FC Thun,3403,8,8,7,17,43,60,-17,31
FC Sion,3403,9,6,8,18,41,61,-20,26
Young Boys,3404,1,22,7,3,71,34,37,73
FC Basel,3404,2,20,7,5,56,22,34,67
Lucerne,3404,3,13,9,10,40,40,0,48
St Gallen,3404,4,14,3,15,41,53,-12,45
FC Zürich,3404,5,11,10,11,43,39,4,43
FC Thun,3404,6,10,5,17,42,58,-16,35
FC Lugano,3404,7,9,6,17,32,51,-19,33
Grasshoppers,3404,8,8,7,17,37,49,-12,31
FC Sion,3404,9,6,8,18,37,53,-16,26
Young Boys,3405,1,21,8,3,70,34,36,71
FC Basel,3405,2,16,10,6,51,27,24,58
Lucerne,3405,3,13,8,11,39,40,-1,47
St Gallen,3405,4,14,3,15,42,53,-11,45
FC Zürich,3405,5,11,11,10,43,36,7,44
FC Lugano,3405,6,11,5,16,31,48,-17,38
FC Thun,3405,7,10,6,16,42,56,-14,36
Grasshoppers,3405,8,9,8,15,40,48,-8,35
FC Sion,3405,9,5,9,18,38,54,-16,24
Young Boys,3406,1,21,6,5,70,39,31,69
FC Basel,3406,2,20,7,5,57,24,33,67
Lucerne,3406,3,14,7,11,41,41,0,49
St Gallen,3406,4,14,3,15,43,54,-11,45
FC Zürich,3406,5,10,9,13,37,36,1,39
Grasshoppers,3406,6,10,7,15,43,49,-6,37
FC Lugano,3406,7,10,6,16,30,46,-16,36
FC Thun,3406,8,8,7,17,42,60,-18,31
FC Sion,3406,9,7,8,17,39,53,-14,29
Young Boys,3407,1,21,8,3,69,33,36,71
FC Basel,3407,2,16,9,7,54,30,24,57
Lucerne,3407,3,13,8,11,45,47,-2,47
St Gallen,3407,4,15,2,15,41,54,-13,47
FC Zürich,3407,5,10,9,13,39,39,0,39
FC Thun,3407,6,10,6,16,44,57,-13,36
FC Lugano,3407,7,10,6,16,30,46,-16,36
Grasshoppers,3407,8,9,8,15,38,46,-8,35
FC Sion,3407,9,8,8,16,42,50,-8,32
Young Boys,3408,1,23,6,3,73,33,40,75
FC Basel,3408,2,17,8,7,57,29,28,59
St Gallen,3408,3,16,2,14,48,55,-7,50
Lucerne,3408,4,13,7,12,41,45,-4,46
FC Zürich,3408,5,10,11,11,44,39,5,41
FC Thun,3408,6,11,5,16,44,59,-15,38
FC Sion,3408,7,8,8,16,44,54,-10,32
FC Lugano,3408,8,9,5,18,28,50,-22,32
Grasshoppers,3408,9,8,6,18,38,53,-15,30
Young Boys,3409,1,22,7,3,73,33,40,73
FC Basel,3409,2,18,7,7,60,33,27,61
Lucerne,3409,3,15,7,10,43,40,3,52
St Gallen,3409,4,14,3,15,41,54,-13,45
FC Zürich,3409,5,10,10,12,42,40,2,40
Grasshoppers,3409,6,10,7,15,43,47,-4,37
FC Thun,3409,7,10,5,17,44,60,-16,35
FC Lugano,3409,8,9,5,18,27,50,-23,32
FC Sion,3409,9,6,9,17,37,53,-16,27
Young Boys,3410,1,22,8,2,76,32,44,74
FC Basel,3410,2,17,8,7,52,27,25,59
Lucerne,3410,3,14,8,10,45,44,1,50
St Gallen,3410,4,15,2,15,44,52,-8,47
FC Zürich,3410,5,12,10,10,43,35,8,46
FC Lugano,3410,6,10,5,17,30,50,-20,35
Grasshoppers,3410,7,9,6,17,42,53,-11,33
FC Thun,3410,8,9,6,17,43,59,-16,33
FC Sion,3410,9,6,7,19,38,61,-23,25
Young Boys,3411,1,22,6,4,70,38,32,72
FC Basel,3411,2,18,7,7,61,26,35,61
FC Zürich,3411,3,12,10,10,41,34,7,46
Lucerne,3411,4,13,7,12,38,43,-5,46
St Gallen,3411,5,14,3,15,42,58,-16,45
FC Thun,3411,6,10,6,16,44,58,-14,36
FC Lugano,3411,7,10,6,16,31,46,-15,36
Grasshoppers,3411,8,8,8,16,38,49,-11,32
FC Sion,3411,9,6,9,17,41,54,-13,27
Young Boys,3412,1,21,7,4,72,37,35,70
FC Basel,3412,2,18,9,5,58,25,33,63
St Gallen,3412,3,14,3,15,41,56,-15,45
FC Zürich,3412,4,11,11,10,43,35,8,44
Lucerne,3412,5,12,7,13,44,50,-6,43
FC Lugano,3412,6,11,5,16,31,45,-14,38
Grasshoppers,3412,7,9,8,15,43,53,-10,35
FC Thun,3412,8,9,7,16,44,61,-17,34
FC Sion,3412,9,7,7,18,39,53,-14,28
Young Boys,3413,1,21,7,4,68,35,33,70
FC Basel,3413,2,18,9,5,57,27,30,63
St Gallen,3413,3,15,2,15,45,56,-11,47
FC Zürich,3413,4,12,10,10,43,35,8,46
Lucerne,3413,5,12,10,10,41,42,-1,46
Grasshoppers,3413,6,10,7,15,42,47,-5,37
FC Thun,3413,7,9,6,17,44,59,-15,33
FC Lugano,3413,8,9,6,17,29,49,-20,33
FC Sion,3413,9,6,7,19,36,55,-19,25
Young Boys,3414,1,22,6,4,74,39,35,72
FC Basel,3414,2,18,8,6,52,24,28,62
Lucerne,3414,3,12,9,11,39,42,-3,45
FC Zürich,3414,4,11,10,11,40,36,4,43
St Gallen,3414,5,13,3,16,41,58,-17,42
FC Lugano,3414,6,11,5,16,33,46,-13,38
Grasshoppers,3414,7,10,7,15,45,49,-4,37
FC Thun,3414,8,9,6,17,43,58,-15,33
FC Sion,3414,9,7,8,17,44,59,-15,29
Young Boys,3415,1,22,6,4,70,35,35,72
FC Basel,3415,2,19,7,6,56,24,32,64
Lucerne,3415,3,13,8,11,41,42,-1,47
FC Zürich,3415,4,12,10,10,40,33,7,46
St Gallen,3415,5,14,3,15,41,55,-14,45
FC Thun,3415,6,10,5,17,45,60,-15,35
Grasshoppers,3415,7,9,7,16,43,52,-9,34
FC Lugano,3415,8,9,7,16,29,48,-19,34
FC Sion,3415,9,6,7,19,40,56,-16,25
Young Boys,3416,1,20,8,4,69,36,33,68
FC Basel,3416,2,17,9,6,51,25,26,60
Lucerne,3416,3,13,9,10,47,47,0,48
St Gallen,3416,4,14,4,14,41,52,-11,46
FC Zürich,3416,5,12,9,11,45,35,10,45
Grasshoppers,3416,6,10,6,16,39,48,-9,36
FC Lugano,3416,7,9,7,16,30,51,-21,34
FC Thun,3416,8,9,6,17,42,57,-15,33
FC Sion,3416,9,7,8,17,39,52,-13,29
Young Boys,3417,1,21,8,3,76,39,37,71
FC Basel,3417,2,17,9,6,56,28,28,60
Lucerne,3417,3,13,8,11,45,45,0,47
FC Zürich,3417,4,12,10,10,44,35,9,46
St Gallen,3417,5,14,2,16,41,57,-16,44
FC Lugano,3417,6,11,6,15,34,46,-12,39
Grasshoppers,3417,7,9,7,16,42,51,-9,34
FC Thun,3417,8,9,5,18,44,62,-18,32
FC Sion,3417,9,7,7,18,38,57,-19,28
Young Boys,3418,1,21,6,5,69,41,28,69
FC Basel,3418,2,17,8,7,51,24,27,59
Lucerne,3418,3,14,7,11,47,42,5,49
St Gallen,3418,4,15,4,13,42,51,-9,49
FC Zürich,3418,5,11,11,10,41,34,7,44
FC Thun,3418,6,11,5,16,44,56,-12,38
Grasshoppers,3418,7,9,6,17,42,56,-14,33
FC Lugano,3418,8,9,6,17,29,48,-19,33
FC Sion,3418,9,6,9,17,41,54,-13,27
Young Boys,3419,1,21,8,3,71,34,37,71
FC Basel,3419,2,17,10,5,54,26,28,61
Lucerne,3419,3,14,8,10,47,44,3,50
St Gallen,3419,4,15,3,14,47,55,-8,48
FC Zürich,3419,5,12,10,10,45,36,9,46
Grasshoppers,3419,6,9,7,16,40,49,-9,34
FC Thun,3419,7,9,6,17,45,62,-17,33
FC Lugano,3419,8,9,5,18,28,51,-23,32
FC Sion,3419,9,5,9,18,38,58,-20,24
Young Boys,3420,1,21,6,5,69,34,35,69
FC Basel,3420,2,18,8,6,52,23,29,62
Lucerne,3420,3,14,7,11,40,41,-1,49
St Gallen,3420,4,15,3,14,44,55,-11,48
FC Zürich,3420,5,10,10,12,39,37,2,40
FC Lugano,3420,6,11,6,15,34,46,-12,39
FC Thun,3420,7,10,6,16,41,56,-15,36
Grasshoppers,3420,8,9,6,17,37,49,-12,33
FC Sion,3420,9,6,8,18,37,52,-15,26
Young Boys,3421,1,22,8,2,70,31,39,74
FC Basel,3421,2,16,10,6,49,27,22,58
St Gallen,3421,3,15,2,15,45,56,-11,47
Lucerne,3421,4,13,7,12,43,42,1,46
FC Zürich,3421,5,9,12,11,39,37,2,39
FC Thun,3421,6,10,7,15,45,57,-12,37
FC Lugano,3421,7,10,6,16,29,48,-19,36
Grasshoppers,3421,8,9,6,17,39,49,-10,33
FC Sion,3421,9,6,10,16,43,55,-12,28
Young Boys,3422,1,22,7,3,72,35,37,73
FC Basel,3422,2,19,8,5,57,23,34,65
Lucerne,3422,3,14,7,11,43,44,-1,49
St Gallen,3422,4,13,2,17,41,60,-19,41
FC Zürich,3422,5,10,10,12,40,42,-2,40
FC Thun,3422,6,11,5,16,50,57,-7,38
Grasshoppers,3422,7,10,6,16,45,51,-6,36
FC Lugano,3422,8,10,6,16,31,47,-16,36
FC Sion,3422,9,6,7,19,39,59,-20,25
Young Boys,3423,1,22,8,2,72,32,40,74
FC Basel,3423,2,17,10,5,54,26,28,61
St Gallen,3423,3,15,2,15,41,52,-11,47
Lucerne,3423,4,12,8,12,40,44,-4,44
FC Zürich,3423,5,10,11,11,42,39,3,41
FC Lugano,3423,6,10,5,17,28,45,-17,35
FC Thun,3423,7,9,7,16,42,59,-17,34
Grasshoppers,3423,8,8,9,15,39,50,-11,33
FC Sion,3423,9,7,8,17,45,56,-11,29
Young Boys,3424,1,23,7,2,71,31,40,76
FC Basel,3424,2,18,9,5,56,24,32,63
St Gallen,3424,3,13,6,13,43,54,-11,45
Lucerne,3424,4,11,10,11,37,41,-4,43
FC Zürich,3424,5,10,10,12,41,38,3,40
FC Lugano,3424,6,10,7,15,31,46,-15,37
FC Thun,3424,7,10,6,16,45,58,-13,36
Grasshoppers,3424,8,8,8,16,39,51,-12,32
FC Sion,3424,9,5,9,18,40,60,-20,24
Young Boys,3425,1,22,7,3,72,36,36,73
FC Basel,3425,2,19,7,6,54,24,30,64
Lucerne,3425,3,13,7,12,42,45,-3,46
St Gallen,3425,4,13,2,17,42,60,-18,41
FC Zürich,3425,5,10,9,13,39,36,3,39
FC Lugano,3425,6,11,5,16,32,47,-15,38
Grasshoppers,3425,7,9,9,14,42,48,-6,36
FC Thun,3425,8,10,6,16,41,56,-15,36
FC Sion,3425,9,7,8,17,41,53,-12,29
Young Boys,3426,1,23,6,3,75,38,37,75
FC Basel,3426,2,18,8,6,60,26,34,62
St Gallen,3426,3,16,2,14,46,54,-8,50
Lucerne,3426,4,12,8,12,46,50,-4,44
FC Zürich,3426,5,9,11,12,38,36,2,38
FC Lugano,3426,6,11,5,16,31,49,-18,38
FC Thun,3426,7,10,5,17,46,62,-16,35
Grasshoppers,3426,8,8,8,16,45,57,-12,32
FC Sion,3426,9,6,9,17,41,56,-15,27
Young Boys,3427,1,22,6,4,74,37,37,72
FC Basel,3427,2,18,7,7,57,25,32,61
Lucerne,3427,3,14,7,11,42,44,-2,49
St Gallen,3427,4,15,3,14,47,56,-9,48
FC Zürich,3427,5,10,11,11,39,38,1,41
FC Lugano,3427,6,10,7,15,33,50,-17,37
Grasshoppers,3427,7,9,6,17,40,50,-10,33
FC Thun,3427,8,9,5,18,44,62,-18,32
FC Sion,3427,9,7,8,17,44,58,-14,29
Young Boys,3428,1,22,6,4,73,36,37,72
FC Basel,3428,2,18,7,7,58,28,30,61
St Gallen,3428,3,15,3,14,46,54,-8,48
Lucerne,3428,4,12,8,12,43,48,-5,44
FC Zürich,3428,5,10,10,12,41,37,4,40
FC Lugano,3428,6,10,7,15,34,50,-16,37
Grasshoppers,3428,7,9,8,15,41,52,-11,35
FC Thun,3428,8,9,6,17,42,61,-19,33
FC Sion,3428,9,7,9,16,41,53,-12,30
Young Boys,3429,1,22,8,2,72,35,37,74
FC Basel,3429,2,16,9,7,50,26,24,57
St Gallen,3429,3,15,2,15,41,55,-14,47
Lucerne,3429,4,11,8,13,39,44,-5,41
FC Lugano,3429,5,12,5,15,38,47,-9,41
FC Zürich,3429,6,10,10,12,41,39,2,40
Grasshoppers,3429,7,10,8,14,41,47,-6,38
FC Thun,3429,8,10,5,17,42,58,-16,35
FC Sion,3429,9,6,9,17,40,53,-13,27
Young Boys,3430,1,23,6,3,71,31,40,75
FC Basel,3430,2,18,8,6,56,27,29,62
St Gallen,3430,3,15,3,14,46,53,-7,48
FC Zürich,3430,4,12,9,11,43,35,8,45
Lucerne,3430,5,12,8,12,41,44,-3,44
Grasshoppers,3430,6,9,7,16,42,49,-7,34
FC Thun,3430,7,9,5,18,43,62,-19,32
FC Lugano,3430,8,9,5,18,27,52,-25,32
FC Sion,3430,9,8,7,17,41,57,-16,31
Young Boys,3431,1,21,7,4,76,36,40,70
FC Basel,3431,2,18,8,6,58,25,33,62
St Gallen,3431,3,16,2,14,44,54,-10,50
Lucerne,3431,4,12,8,12,42,50,-8,44
FC Thun,3431,5,12,5,15,44,55,-11,41
FC Zürich,3431,6,10,10,12,41,37,4,40
Grasshoppers,3431,7,10,6,16,42,52,-10,36
FC Lugano,3431,8,10,6,16,31,49,-18,36
FC Sion,3431,9,5,8,19,39,59,-20,23
Young Boys,3432,1,20,6,6,69,37,32,66
FC Basel,3432,2,18,8,6,53,25,28,62
FC Zürich,3432,3,12,9,11,45,36,9,45
Lucerne,3432,4,12,8,12,41,46,-5,44
St Gallen,3432,5,14,2,16,44,56,-12,44
FC Lugano,3432,6,12,6,14,35,45,-10,42
Grasshoppers,3432,7,11,6,15,43,50,-7,39
FC Thun,3432,8,8,7,17,41,60,-19,31
FC Sion,3432,9,7,8,17,41,57,-16,29
Young Boys,3433,1,21,8,3,71,32,39,71
FC Basel,3433,2,18,9,5,55,23,32,63
St Gallen,3433,3,16,2,14,45,53,-8,50
Lucerne,3433,4,11,10,11,37,40,-3,43
FC Zürich,3433,5,10,9,13,40,37,3,39
Grasshoppers,3433,6,11,6,15,44,48,-4,39
FC Lugano,3433,7,9,6,17,30,53,-23,33
FC Thun,3433,8,9,5,18,42,64,-22,32
FC Sion,3433,9,8,7,17,44,58,-14,31
Young Boys,3434,1,21,9,2,72,35,37,72
FC Basel,3434,2,17,8,7,50,25,25,59
St Gallen,3434,3,15,2,15,44,53,-9,47
Lucerne,3434,4,12,8,12,41,45,-4,44
FC Zürich,3434,5,11,9,12,41,37,4,42
FC Thun,3434,6,11,5,16,46,58,-12,38
FC Lugano,3434,7,10,5,17,30,51,-21,35
Grasshoppers,3434,8,9,7,16,40,49,-9,34
FC Sion,3434,9,8,7,17,42,53,-11,31
Young Boys,3435,1,23,6,3,75,34,41,75
FC Basel,3435,2,19,8,5,60,26,34,65
St Gallen,3435,3,13,4,15,45,60,-15,43
Lucerne,3435,4,11,9,12,42,49,-7,42
FC Zürich,3435,5,10,11,11,39,35,4,41
FC Lugano,3435,6,10,7,15,34,51,-17,37
Grasshoppers,3435,7,9,6,17,41,50,-9,33
FC Thun,3435,8,9,6,17,41,61,-20,33
FC Sion,3435,9,7,9,16,42,53,-11,30
Young Boys,3436,1,20,8,4,70,37,33,68
FC Basel,3436,2,18,9,5,55,22,33,63
St Gallen,3436,3,15,2,15,43,55,-12,47
Lucerne,3436,4,11,11,10,41,43,-2,44
FC Zürich,3436,5,10,10,12,40,36,4,40
FC Lugano,3436,6,10,7,15,31,47,-16,37
Grasshoppers,3436,7,9,9,14,42,49,-7,36
FC Thun,3436,8,9,7,16,42,59,-17,34
FC Sion,3436,9,6,9,17,41,57,-16,27
Young Boys,3437,1,21,8,3,71,38,33,71
FC Basel,3437,2,17,8,7,55,25,30,59
St Gallen,3437,3,16,3,13,44,52,-8,51
Lucerne,3437,4,12,10,10,42,45,-3,46
FC Zürich,3437,5,10,11,11,43,40,3,41
FC Lugano,3437,6,11,5,16,34,46,-12,38
Grasshoppers,3437,7,10,7,15,44,50,-6,37
FC Thun,3437,8,8,6,18,42,62,-20,30
FC Sion,3437,9,6,8,18,41,58,-17,26
Young Boys,3438,1,22,7,3,73,37,36,73
FC Basel,3438,2,19,7,6,55,24,31,64
St Gallen,3438,3,16,2,14,46,53,-7,50
Lucerne,3438,4,14,7,11,47,43,4,49
FC Zürich,3438,5,10,10,12,40,36,4,40
FC Thun,3438,6,10,5,17,44,60,-16,35
FC Lugano,3438,7,9,6,17,29,50,-21,33
Grasshoppers,3438,8,8,7,17,40,56,-16,31
FC Sion,3438,9,6,9,17,41,56,-15,27
Young Boys,3439,1,20,8,4,71,36,35,68
FC Basel,3439,2,18,9,5,55,26,29,63
Lucerne,3439,3,12,9,11,40,43,-3,45
St Gallen,3439,4,14,3,15,44,56,-12,45
FC Zürich,3439,5,11,11,10,42,36,6,44
Grasshoppers,3439,6,10,7,15,40,47,-7,37
FC Sion,3439,7,9,7,16,43,52,-9,34
FC Lugano,3439,8,9,6,17,32,53,-21,33
FC Thun,3439,9,8,6,18,40,58,-18,30
Young Boys,3440,1,22,8,2,73,34,39,74
FC Basel,3440,2,18,9,5,56,28,28,63
St Gallen,3440,3,15,3,14,45,56,-11,48
Lucerne,3440,4,12,9,11,42,43,-1,45
FC Zürich,3440,5,11,9,12,41,35,6,42
FC Lugano,3440,6,10,5,17,30,50,-20,35
Grasshoppers,3440,7,9,7,16,40,49,-9,34
FC Thun,3440,8,8,6,18,43,61,-18,30
FC Sion,3440,9,7,8,17,39,53,-14,29
Young Boys,3441,1,23,6,3,76,35,41,75
FC Basel,3441,2,18,7,7,53,25,28,61
Lucerne,3441,3,14,7,11,45,42,3,49
St Gallen,3441,4,15,2,15,44,59,-15,47
FC Zürich,3441,5,10,11,11,39,36,3,41
FC Lugano,3441,6,10,6,16,36,54,-18,36
Grasshoppers,3441,7,9,6,17,42,54,-12,33
FC Thun,3441,8,9,5,18,41,58,-17,32
FC Sion,3441,9,7,8,17,42,55,-13,29
Young Boys,3442,1,21,9,2,74,36,38,72
FC Basel,3442,2,15,10,7,49,27,22,55
Lucerne,3442,3,12,11,9,42,42,0,47
St Gallen,3442,4,13,4,15,42,58,-16,43
FC Zürich,3442,5,10,11,11,41,36,5,41
Grasshoppers,3442,6,10,8,14,42,48,-6,38
FC Lugano,3442,7,10,7,15,33,49,-16,37
FC Thun,3442,8,8,7,17,41,59,-18,31
FC Sion,3442,9,7,9,16,43,52,-9,30
Young Boys,3443,1,21,8,3,71,37,34,71
FC Basel,3443,2,18,9,5,57,25,32,63
Lucerne,3443,3,12,9,11,42,43,-1,45
St Gallen,3443,4,14,3,15,42,55,-13,45
FC Zürich,3443,5,10,10,12,39,36,3,40
FC Lugano,3443,6,11,6,15,32,47,-15,39
FC Thun,3443,7,10,5,17,43,59,-16,35
Grasshoppers,3443,8,9,6,17,41,51,-10,33
FC Sion,3443,9,7,8,17,41,55,-14,29
Young Boys,3444,1,21,7,4,72,39,33,70
FC Basel,3444,2,19,8,5,56,23,33,65
Lucerne,3444,3,14,7,11,44,43,1,49
St Gallen,3444,4,13,2,17,40,58,-18,41
FC Zürich,3444,5,9,12,11,39,36,3,39
FC Lugano,3444,6,10,6,16,31,47,-16,36
Grasshoppers,3444,7,9,8,15,43,51,-8,35
FC Thun,3444,8,9,7,16,42,57,-15,34
FC Sion,3444,9,8,7,17,38,51,-13,31
Young Boys,3445,1,22,7,3,76,35,41,73
FC Basel,3445,2,16,10,6,52,26,26,58
St Gallen,3445,3,16,3,13,44,51,-7,51
Lucerne,3445,4,12,8,12,40,48,-8,44
FC Zürich,3445,5,9,12,11,40,42,-2,39
FC Lugano,3445,6,11,6,15,32,46,-14,39
FC Thun,3445,7,10,5,17,47,58,-11,35
Grasshoppers,3445,8,9,6,17,40,49,-9,33
FC Sion,3445,9,6,9,17,40,56,-16,27
Young Boys,3446,1,22,7,3,73,33,40,73
FC Basel,3446,2,18,9,5,52,23,29,63
St Gallen,3446,3,15,2,15,44,54,-10,47
Lucerne,3446,4,11,11,10,40,42,-2,44
FC Zürich,3446,5,11,9,12,38,35,3,42
FC Lugano,3446,6,10,6,16,31,50,-19,36
Grasshoppers,3446,7,9,8,15,40,46,-6,35
FC Thun,3446,8,9,8,15,40,54,-14,35
FC Sion,3446,9,5,8,19,37,58,-21,23
Young Boys,3447,1,21,6,5,69,37,32,69
FC Basel,3447,2,19,8,5,59,24,35,65
St Gallen,3447,3,15,3,14,45,53,-8,48
Lucerne,3447,4,13,7,12,42,45,-3,46
FC Zürich,3447,5,10,10,12,39,38,1,40
FC Lugano,3447,6,11,6,15,34,46,-12,39
FC Thun,3447,7,11,5,16,44,59,-15,38
Grasshoppers,3447,8,10,6,16,42,51,-9,36
FC Sion,3447,9,5,7,20,39,60,-21,22
Young Boys,3448,1,22,6,4,73,35,38,72
FC Basel,3448,2,19,7,6,57,27,30,64
Lucerne,3448,3,14,7,11,46,45,1,49
St Gallen,3448,4,13,3,16,42,57,-15,42
FC Zürich,3448,5,10,10,12,39,36,3,40
Grasshoppers,3448,6,10,8,14,44,50,-6,38
FC Thun,3448,7,10,6,16,45,60,-15,36
FC Lugano,3448,8,10,6,16,31,49,-18,36
FC Sion,3448,9,5,9,18,38,56,-18,24
Young Boys,3449,1,22,6,4,71,34,37,72
FC Basel,3449,2,17,8,7,54,29,25,59
Lucerne,3449,3,14,7,11,44,44,0,49
St Gallen,3449,4,15,2,15,48,55,-7,47
FC Zürich,3449,5,9,12,11,41,39,2,39
FC Lugano,3449,6,10,6,16,32,51,-19,36
Grasshoppers,3449,7,9,7,16,41,52,-11,34
FC Sion,3449,8,8,8,16,46,55,-9,32
FC Thun,3449,9,8,8,16,43,61,-18,32
Young Boys,3450,1,21,7,4,73,38,35,70
FC Basel,3450,2,17,9,6,55,28,27,60
Lucerne,3450,3,13,8,11,44,45,-1,47
St Gallen,3450,4,14,2,16,43,57,-14,44
FC Zürich,3450,5,10,10,12,37,36,1,40
Grasshoppers,3450,6,11,6,15,41,45,-4,39
FC Thun,3450,7,10,5,17,42,57,-15,35
FC Lugano,3450,8,10,5,17,31,49,-18,35
FC Sion,3450,9,8,8,16,40,51,-11,32
Young Boys,3451,1,21,7,4,68,35,33,70
FC Basel,3451,2,19,8,5,54,23,31,65
Lucerne,3451,3,12,10,10,40,42,-2,46
St Gallen,3451,4,13,3,16,42,57,-15,42
FC Zürich,3451,5,10,10,12,39,36,3,40
FC Lugano,3451,6,11,5,16,32,46,-14,38
Grasshoppers,3451,7,10,7,15,43,47,-4,37
FC Thun,3451,8,9,6,17,41,60,-19,33
FC Sion,3451,9,6,10,16,39,52,-13,28
Young Boys,3452,1,23,6,3,78,36,42,75
FC Basel,3452,2,18,9,5,56,25,31,63
St Gallen,3452,3,14,3,15,41,59,-18,45
Lucerne,3452,4,12,8,12,44,46,-2,44
FC Zürich,3452,5,11,10,11,42,36,6,43
FC Thun,3452,6,11,6,15,45,56,-11,39
FC Lugano,3452,7,9,7,16,29,51,-22,34
Grasshoppers,3452,8,8,6,18,39,53,-14,30
FC Sion,3452,9,7,7,18,46,58,-12,28
Young Boys,3453,1,21,6,5,71,37,34,69
FC Basel,3453,2,18,8,6,58,23,35,62
FC Zürich,3453,3,13,9,10,41,33,8,48
St Gallen,3453,4,15,3,14,49,55,-6,48
Lucerne,3453,5,12,7,13,39,47,-8,43
Grasshoppers,3453,6,11,6,15,44,47,-3,39
FC Lugano,3453,7,10,5,17,30,50,-20,35
FC Thun,3453,8,9,5,18,41,64,-23,32
FC Sion,3453,9,7,7,18,42,59,-17,28
Young Boys,3454,1,22,7,3,74,35,39,73
FC Basel,3454,2,19,8,5,56,25,31,65
St Gallen,3454,3,15,3,14,45,56,-11,48
Lucerne,3454,4,13,7,12,43,47,-4,46
FC Zürich,3454,5,10,10,12,41,38,3,40
Grasshoppers,3454,6,10,7,15,43,49,-6,37
FC Thun,3454,7,10,5,17,42,57,-15,35
FC Lugano,3454,8,9,6,17,31,51,-20,33
FC Sion,3454,9,5,9,18,39,56,-17,24
Young Boys,3455,1,22,7,3,77,37,40,73
FC Basel,3455,2,17,9,6,57,29,28,60
St Gallen,3455,3,15,3,14,46,56,-10,48
Lucerne,3455,4,13,8,11,44,44,0,47
FC Zürich,3455,5,10,10,12,39,37,2,40
Grasshoppers,3455,6,11,6,15,41,46,-5,39
FC Thun,3455,7,10,5,17,42,58,-16,35
FC Lugano,3455,8,10,5,17,33,55,-22,35
FC Sion,3455,9,6,7,19,36,53,-17,25
Young Boys,3456,1,19,6,7,68,44,24,63
FC Basel,3456,2,17,9,6,56,26,30,60
Lucerne,3456,3,14,8,10,45,43,2,50
St Gallen,3456,4,15,3,14,44,54,-10,48
FC Zürich,3456,5,11,11,10,43,36,7,44
Grasshoppers,3456,6,10,6,16,46,54,-8,36
FC Thun,3456,7,10,6,16,43,58,-15,36
FC Lugano,3456,8,10,6,16,32,48,-16,36
FC Sion,3456,9,6,9,17,43,57,-14,27
Young Boys,3457,1,22,6,4,73,38,35,72
FC Basel,3457,2,16,8,8,49,26,23,56
St Gallen,3457,3,15,4,13,42,50,-8,49
Lucerne,3457,4,13,8,11,42,43,-1,47
FC Zürich,3457,5,11,11,10,41,32,9,44
FC Thun,3457,6,10,5,17,42,58,-16,35
FC Lugano,3457,7,9,8,15,30,46,-16,35
Grasshoppers,3457,8,9,6,17,39,50,-11,33
FC Sion,3457,9,7,8,17,40,55,-15,29
Young Boys,3458,1,22,6,4,74,37,37,72
FC Basel,3458,2,18,9,5,56,23,33,63
Lucerne,3458,3,12,8,12,40,44,-4,44
St Gallen,3458,4,13,3,16,41,58,-17,42
FC Zürich,3458,5,10,10,12,38,37,1,40
FC Thun,3458,6,11,6,15,45,55,-10,39
FC Lugano,3458,7,10,7,15,30,44,-14,37
Grasshoppers,3458,8,10,6,16,41,51,-10,36
FC Sion,3458,9,7,7,18,40,56,-16,28
Young Boys,3459,1,22,6,4,75,35,40,72
FC Basel,3459,2,18,9,5,55,24,31,63
Lucerne,3459,3,13,8,11,42,48,-6,47
St Gallen,3459,4,13,5,14,42,54,-12,44
FC Zürich,3459,5,9,11,12,40,38,2,38
FC Thun,3459,6,11,5,16,46,58,-12,38
FC Lugano,3459,7,10,6,16,31,52,-21,36
Grasshoppers,3459,8,9,6,17,41,53,-12,33
FC Sion,3459,9,7,8,17,44,54,-10,29
Young Boys,3460,1,23,6,3,73,37,36,75
FC Basel,3460,2,17,9,6,55,27,28,60
St Gallen,3460,3,14,3,15,42,56,-14,45
Lucerne,3460,4,12,8,12,40,42,-2,44
FC Zürich,3460,5,10,11,11,42,39,3,41
Grasshoppers,3460,6,10,7,15,42,50,-8,37
FC Thun,3460,7,10,7,15,45,55,-10,37
FC Lugano,3460,8,10,5,17,32,48,-16,35
FC Sion,3460,9,6,8,18,40,57,-17,26
Young Boys,3461,1,21,6,5,72,38,34,69
FC Basel,3461,2,17,8,7,52,28,24,59
FC Zürich,3461,3,12,10,10,46,36,10,46
St Gallen,3461,4,14,4,14,40,52,-12,46
Lucerne,3461,5,12,9,11,40,44,-4,45
FC Lugano,3461,6,10,7,15,33,48,-15,37
FC Thun,3461,7,9,7,16,50,62,-12,34
Grasshoppers,3461,8,9,6,17,40,53,-13,33
FC Sion,3461,9,7,9,16,41,53,-12,30
Young Boys,3462,1,20,8,4,71,36,35,68
FC Basel,3462,2,18,8,6,53,26,27,62
Lucerne,3462,3,13,9,10,44,43,1,48
St Gallen,3462,4,15,3,14,46,55,-9,48
FC Zürich,3462,5,10,10,12,42,36,6,40
FC Lugano,3462,6,10,8,14,34,47,-13,38
FC Thun,3462,7,10,6,16,43,59,-16,36
Grasshoppers,3462,8,8,6,18,41,60,-19,30
FC Sion,3462,9,7,8,17,42,54,-12,29
Young Boys,3463,1,23,7,2,74,32,42,76
FC Basel,3463,2,17,9,6,54,25,29,60
St Gallen,3463,3,15,3,14,46,54,-8,48
Lucerne,3463,4,13,7,12,38,42,-4,46
FC Zürich,3463,5,10,11,11,39,34,5,41
FC Lugano,3463,6,10,6,16,30,49,-19,36
FC Thun,3463,7,10,5,17,44,60,-16,35
Grasshoppers,3463,8,9,7,16,40,50,-10,34
FC Sion,3463,9,6,7,19,39,58,-19,25
Young Boys,3464,1,21,7,4,73,35,38,70
FC Basel,3464,2,19,7,6,56,27,29,64
FC Zürich,3464,3,12,9,11,44,36,8,45
St Gallen,3464,4,14,3,15,44,56,-12,45
Lucerne,3464,5,11,8,13,40,48,-8,41
FC Thun,3464,6,11,5,16,49,61,-12,38
Grasshoppers,3464,7,10,6,16,42,50,-8,36
FC Lugano,3464,8,9,7,16,32,54,-22,34
FC Sion,3464,9,7,8,17,40,53,-13,29
Young Boys,3465,1,23,7,2,78,35,43,76
FC Basel,3465,2,17,9,6,53,24,29,60
St Gallen,3465,3,15,3,14,43,55,-12,48
Lucerne,3465,4,11,10,11,42,46,-4,43
FC Zürich,3465,5,11,9,12,42,35,7,42
FC Lugano,3465,6,10,7,15,34,49,-15,37
FC Thun,3465,7,9,6,17,44,64,-20,33
Grasshoppers,3465,8,8,8,16,40,53,-13,32
FC Sion,3465,9,6,9,17,44,59,-15,27
Young Boys,3466,1,22,7,3,73,37,36,73
FC Basel,3466,2,17,9,6,55,27,28,60
St Gallen,3466,3,15,2,15,44,56,-12,47
FC Zürich,3466,4,10,11,11,43,37,6,41
Lucerne,3466,5,11,8,13,38,47,-9,41
FC Lugano,3466,6,11,6,15,38,50,-12,39
FC Thun,3466,7,10,6,16,46,58,-12,36
Grasshoppers,3466,8,9,7,16,44,54,-10,34
FC Sion,3466,9,7,8,17,43,58,-15,29
Young Boys,3467,1,21,6,5,71,36,35,69
FC Basel,3467,2,17,8,7,52,26,26,59
St Gallen,3467,3,16,2,14,44,52,-8,50
Lucerne,3467,4,14,7,11,43,42,1,49
FC Zürich,3467,5,10,11,11,40,36,4,41
FC Thun,3467,6,11,6,15,45,57,-12,39
FC Lugano,3467,7,10,5,17,30,51,-21,35
Grasshoppers,3467,8,9,6,17,41,52,-11,33
FC Sion,3467,9,7,7,18,41,55,-14,28
Young Boys,3468,1,21,7,4,71,35,36,70
FC Basel,3468,2,20,7,5,59,24,35,67
Lucerne,3468,3,12,9,11,41,46,-5,45
St Gallen,3468,4,13,4,15,39,54,-15,43
FC Zürich,3468,5,10,10,12,39,38,1,40
FC Lugano,3468,6,11,5,16,33,47,-14,38
FC Thun,3468,7,10,6,16,44,56,-12,36
Grasshoppers,3468,8,10,6,16,40,52,-12,36
FC Sion,3468,9,6,8,18,39,53,-14,26
Young Boys,3469,1,22,7,3,71,34,37,73
FC Basel,3469,2,18,8,6,53,26,27,62
FC Zürich,3469,3,13,9,10,47,36,11,48
Lucerne,3469,4,12,9,11,41,44,-3,45
St Gallen,3469,5,13,4,15,41,56,-15,43
Grasshoppers,3469,6,10,7,15,42,48,-6,37
FC Lugano,3469,7,10,5,17,33,49,-16,35
FC Sion,3469,8,7,8,17,40,53,-13,29
FC Thun,3469,9,8,5,19,40,62,-22,29
Young Boys,3470,1,22,8,2,75,34,41,74
FC Basel,3470,2,17,8,7,52,29,23,59
St Gallen,3470,3,15,3,14,44,53,-9,48
Lucerne,3470,4,12,9,11,42,46,-4,45
FC Zürich,3470,5,11,9,12,41,36,5,42
FC Lugano,3470,6,10,6,16,29,45,-16,36
Grasshoppers,3470,7,9,8,15,45,53,-8,35
FC Thun,3470,8,9,6,17,43,59,-16,33
FC Sion,3470,9,6,9,17,41,57,-16,27
Young Boys,3471,1,20,6,6,66,38,28,66
FC Basel,3471,2,19,7,6,54,23,31,64
Lucerne,3471,3,13,7,12,43,44,-1,46
St Gallen,3471,4,14,3,15,41,55,-14,45
FC Zürich,3471,5,11,9,12,40,36,4,42
Grasshoppers,3471,6,12,6,14,43,47,-4,42
FC Lugano,3471,7,10,6,16,30,45,-15,36
FC Thun,3471,8,9,6,17,40,56,-16,33
FC Sion,3471,9,7,8,17,40,53,-13,29
Young Boys,3472,1,20,8,4,71,37,34,68
FC Basel,3472,2,19,8,5,56,25,31,65
St Gallen,3472,3,15,4,13,44,52,-8,49
Lucerne,3472,4,12,7,13,41,46,-5,43
FC Zürich,3472,5,10,10,12,39,38,1,40
FC Lugano,3472,6,11,5,16,32,48,-16,38
FC Sion,3472,7,8,9,15,43,51,-8,33
Grasshoppers,3472,8,8,8,16,39,51,-12,32
FC Thun,3472,9,8,7,17,41,58,-17,31
Young Boys,3473,1,23,6,3,73,34,39,75
FC Basel,3473,2,17,8,7,53,28,25,59
St Gallen,3473,3,15,2,15,43,55,-12,47
Lucerne,3473,4,11,9,12,42,47,-5,42
Grasshoppers,3473,5,11,6,15,46,50,-4,39
FC Zürich,3473,6,9,11,12,38,37,1,38
FC Lugano,3473,7,10,7,15,30,45,-15,37
FC Thun,3473,8,10,6,16,44,58,-14,36
FC Sion,3473,9,7,7,18,39,54,-15,28
Young Boys,3474,1,23,6,3,73,34,39,75
FC Basel,3474,2,16,10,6,54,26,28,58
St Gallen,3474,3,15,3,14,41,50,-9,48
Lucerne,3474,4,12,9,11,40,44,-4,45
FC Zürich,3474,5,11,11,10,41,34,7,44
FC Thun,3474,6,10,7,15,46,58,-12,37
FC Lugano,3474,7,9,7,16,31,48,-17,34
Grasshoppers,3474,8,9,6,17,42,52,-10,33
FC Sion,3474,9,6,7,19,37,59,-22,25
Young Boys,3475,1,20,9,3,70,36,34,69
FC Basel,3475,2,19,8,5,56,26,30,65
St Gallen,3475,3,14,4,14,45,54,-9,46
Lucerne,3475,4,11,10,11,44,49,-5,43
FC Zürich,3475,5,10,10,12,42,40,2,40
Grasshoppers,3475,6,10,8,14,49,50,-1,38
FC Lugano,3475,7,10,8,14,32,46,-14,38
FC Thun,3475,8,9,6,17,44,61,-17,33
FC Sion,3475,9,5,9,18,39,59,-20,24
Young Boys,3476,1,21,8,3,70,33,37,71
FC Basel,3476,2,15,10,7,53,30,23,55
Lucerne,3476,3,12,9,11,39,43,-4,45
St Gallen,3476,4,14,3,15,41,54,-13,45
FC Zürich,3476,5,11,10,11,47,42,5,43
FC Lugano,3476,6,11,6,15,32,46,-14,39
Grasshoppers,3476,7,10,7,15,38,45,-7,37
FC Thun,3476,8,9,6,17,42,61,-19,33
FC Sion,3476,9,8,7,17,44,52,-8,31
Young Boys,3477,1,21,7,4,73,40,33,70
FC Basel,3477,2,17,10,5,53,23,30,61
St Gallen,3477,3,14,3,15,43,56,-13,45
Lucerne,3477,4,11,8,13,40,47,-7,41
FC Zürich,3477,5,10,10,12,41,36,5,40
Grasshoppers,3477,6,11,7,14,44,48,-4,40
FC Lugano,3477,7,11,5,16,33,51,-18,38
FC Thun,3477,8,10,5,17,46,60,-14,35
FC Sion,3477,9,8,7,17,41,53,-12,31
Young Boys,3478,1,21,9,2,72,36,36,72
FC Basel,3478,2,18,9,5,64,26,38,63
Lucerne,3478,3,13,9,10,45,43,2,48
St Gallen,3478,4,14,2,16,43,57,-14,44
FC Zürich,3478,5,9,11,12,39,42,-3,38
Grasshoppers,3478,6,10,7,15,42,48,-6,37
FC Lugano,3478,7,10,5,17,30,50,-20,35
FC Thun,3478,8,8,7,17,39,60,-21,31
FC Sion,3478,9,6,11,15,40,52,-12,29
Young Boys,3479,1,22,6,4,70,33,37,72
FC Basel,3479,2,17,7,8,52,28,24,58
Lucerne,3479,3,14,7,11,44,42,2,49
St Gallen,3479,4,14,3,15,41,54,-13,45
FC Zürich,3479,5,11,11,10,45,38,7,44
Grasshoppers,3479,6,10,7,15,43,49,-6,37
FC Thun,3479,7,10,6,16,45,59,-14,36
FC Lugano,3479,8,10,6,16,30,47,-17,36
FC Sion,3479,9,5,9,18,39,59,-20,24
Young Boys,3480,1,21,8,3,70,36,34,71
FC Basel,3480,2,18,9,5,54,25,29,63
St Gallen,3480,3,15,2,15,43,55,-12,47
Lucerne,3480,4,12,7,13,42,43,-1,43
FC Zürich,3480,5,11,9,12,43,38,5,42
FC Lugano,3480,6,12,6,14,33,44,-11,42
Grasshoppers,3480,7,10,6,16,42,50,-8,36
FC Thun,3480,8,9,6,17,41,58,-17,33
FC Sion,3480,9,6,7,19,41,60,-19,25
Young Boys,3481,1,23,7,2,72,32,40,76
FC Basel,3481,2,17,8,7,52,26,26,59
St Gallen,3481,3,15,2,15,46,54,-8,47
Lucerne,3481,4,12,9,11,40,43,-3,45
FC Zürich,3481,5,11,9,12,41,40,1,42
FC Lugano,3481,6,11,6,15,31,45,-14,39
FC Thun,3481,7,11,5,16,47,56,-9,38
Grasshoppers,3481,8,8,8,16,38,48,-10,32
FC Sion,3481,9,5,8,19,36,59,-23,23
Young Boys,3482,1,22,7,3,70,32,38,73
FC Basel,3482,2,19,7,6,56,25,31,64
St Gallen,3482,3,15,2,15,44,56,-12,47
Lucerne,3482,4,13,7,12,41,43,-2,46
FC Zürich,3482,5,9,11,12,38,38,0,38
FC Lugano,3482,6,10,7,15,33,48,-15,37
Grasshoppers,3482,7,9,7,16,41,50,-9,34
FC Sion,3482,8,8,8,16,43,51,-8,32
FC Thun,3482,9,8,6,18,39,62,-23,30
Young Boys,3483,1,20,6,6,68,40,28,66
FC Basel,3483,2,18,9,5,57,23,34,63
Lucerne,3483,3,15,7,10,44,42,2,52
FC Zürich,3483,4,12,10,10,44,36,8,46
St Gallen,3483,5,13,4,15,41,55,-14,43
Grasshoppers,3483,6,9,8,15,42,50,-8,35
FC Lugano,3483,7,10,5,17,32,50,-18,35
FC Thun,3483,8,8,7,17,39,58,-19,31
FC Sion,3483,9,6,10,16,43,56,-13,28
Young Boys,3484,1,19,9,4,69,38,31,66
FC Basel,3484,2,15,10,7,48,25,23,55
Lucerne,3484,3,13,10,9,43,41,2,49
St Gallen,3484,4,15,2,15,45,54,-9,47
FC Zürich,3484,5,11,10,11,41,36,5,43
FC Thun,3484,6,10,6,16,45,58,-13,36
FC Lugano,3484,7,10,6,16,33,51,-18,36
FC Sion,3484,8,9,7,16,41,51,-10,34
Grasshoppers,3484,9,8,8,16,40,51,-11,32
Young Boys,3485,1,21,7,4,71,37,34,70
FC Basel,3485,2,18,8,6,59,28,31,62
Lucerne,3485,3,14,7,11,42,43,-1,49
St Gallen,3485,4,15,2,15,45,56,-11,47
FC Zürich,3485,5,11,10,11,41,36,5,43
FC Lugano,3485,6,11,5,16,32,47,-15,38
Grasshoppers,3485,7,10,7,15,43,49,-6,37
FC Thun,3485,8,8,5,19,42,62,-20,29
FC Sion,3485,9,7,7,18,40,57,-17,28
Young Boys,3486,1,21,7,4,70,36,34,70
FC Basel,3486,2,18,8,6,53,25,28,62
Lucerne,3486,3,13,8,11,42,45,-3,47
St Gallen,3486,4,14,3,15,43,54,-11,45
FC Zürich,3486,5,10,10,12,42,37,5,40
FC Lugano,3486,6,11,6,15,33,47,-14,39
Grasshoppers,3486,7,10,7,15,42,48,-6,37
FC Thun,3486,8,10,6,16,44,59,-15,36
FC Sion,3486,9,6,7,19,40,58,-18,25
Young Boys,3487,1,22,7,3,76,35,41,73
FC Basel,3487,2,18,8,6,55,27,28,62
St Gallen,3487,3,15,3,14,46,55,-9,48
Lucerne,3487,4,13,7,12,38,46,-8,46
FC Zürich,3487,5,10,10,12,39,37,2,40
FC Thun,3487,6,10,6,16,44,56,-12,36
FC Lugano,3487,7,10,6,16,33,49,-16,36
Grasshoppers,3487,8,8,7,17,40,53,-13,31
FC Sion,3487,9,7,8,17,41,54,-13,29
Young Boys,3488,1,20,8,4,67,36,31,68
FC Basel,3488,2,18,8,6,57,25,32,62
Lucerne,3488,3,15,8,9,47,38,9,53
St Gallen,3488,4,13,3,16,39,57,-18,42
FC Zürich,3488,5,10,9,13,38,37,1,39
FC Lugano,3488,6,11,6,15,29,43,-14,39
FC Thun,3488,7,10,6,16,49,60,-11,36
Grasshoppers,3488,8,8,8,16,38,50,-12,32
FC Sion,3488,9,7,8,17,40,58,-18,29
Young Boys,3489,1,21,8,3,69,32,37,71
FC Basel,3489,2,18,9,5,55,25,30,63
Lucerne,3489,3,12,10,10,39,43,-4,46
St Gallen,3489,4,13,4,15,41,55,-14,43
FC Zürich,3489,5,10,10,12,40,36,4,40
FC Lugano,3489,6,11,5,16,30,45,-15,38
Grasshoppers,3489,7,9,9,14,41,47,-6,36
FC Thun,3489,8,8,7,17,42,60,-18,31
FC Sion,3489,9,7,8,17,41,55,-14,29
Young Boys,3490,1,22,7,3,74,34,40,73
FC Basel,3490,2,18,7,7,55,27,28,61
Lucerne,3490,3,13,9,10,43,41,2,48
FC Zürich,3490,4,11,10,11,44,35,9,43
St Gallen,3490,5,13,4,15,39,56,-17,43
FC Lugano,3490,6,11,6,15,32,46,-14,39
Grasshoppers,3490,7,9,8,15,43,53,-10,35
FC Thun,3490,8,9,6,17,46,63,-17,33
FC Sion,3490,9,5,9,18,38,59,-21,24
Young Boys,3491,1,22,7,3,74,37,37,73
FC Basel,3491,2,19,7,6,56,26,30,64
St Gallen,3491,3,15,2,15,48,55,-7,47
Lucerne,3491,4,12,8,12,42,45,-3,44
FC Zürich,3491,5,11,10,11,41,35,6,43
FC Lugano,3491,6,10,6,16,32,50,-18,36
Grasshoppers,3491,7,8,10,14,41,49,-8,34
FC Thun,3491,8,9,6,17,44,60,-16,33
FC Sion,3491,9,6,8,18,40,61,-21,26
Young Boys,3492,1,22,7,3,73,36,37,73
FC Basel,3492,2,19,8,5,56,25,31,65
Lucerne,3492,3,13,7,12,46,46,0,46
FC Zürich,3492,4,11,10,11,43,37,6,43
St Gallen,3492,5,13,2,17,41,58,-17,41
FC Lugano,3492,6,11,5,16,33,51,-18,38
FC Thun,3492,7,10,7,15,44,55,-11,37
Grasshoppers,3492,8,9,7,16,38,48,-10,34
FC Sion,3492,9,6,7,19,40,58,-18,25
Young Boys,3493,1,22,6,4,76,34,42,72
FC Basel,3493,2,17,10,5,51,23,28,61
Lucerne,3493,3,13,7,12,41,49,-8,46
St Gallen,3493,4,14,3,15,42,54,-12,45
FC Zürich,3493,5,10,10,12,39,38,1,40
FC Lugano,3493,6,11,5,16,33,47,-14,38
FC Thun,3493,7,10,6,16,42,55,-13,36
Grasshoppers,3493,8,9,6,17,40,51,-11,33
FC Sion,3493,9,8,7,17,43,56,-13,31
Young Boys,3494,1,22,6,4,72,35,37,72
FC Basel,3494,2,16,8,8,54,32,22,56
Lucerne,3494,3,13,9,10,42,43,-1,48
St Gallen,3494,4,14,3,15,44,58,-14,45
FC Zürich,3494,5,10,10,12,43,41,2,40
FC Thun,3494,6,11,6,15,54,63,-9,39
FC Lugano,3494,7,10,7,15,34,48,-14,37
Grasshoppers,3494,8,9,8,15,43,51,-8,35
FC Sion,3494,9,6,9,17,43,58,-15,27
Young Boys,3495,1,23,6,3,74,35,39,75
FC Basel,3495,2,17,8,7,55,32,23,59
FC Zürich,3495,3,12,10,10,44,35,9,46
Lucerne,3495,4,12,9,11,44,43,1,45
St Gallen,3495,5,13,3,16,40,58,-18,42
Grasshoppers,3495,6,10,7,15,44,51,-7,37
FC Lugano,3495,7,10,7,15,31,46,-15,37
FC Thun,3495,8,8,6,18,42,61,-19,30
FC Sion,3495,9,7,8,17,38,51,-13,29
Young Boys,3496,1,21,8,3,73,37,36,71
FC Basel,3496,2,19,7,6,58,25,33,64
Lucerne,3496,3,13,8,11,44,42,2,47
St Gallen,3496,4,14,2,16,44,59,-15,44
FC Zürich,3496,5,10,10,12,40,39,1,40
Grasshoppers,3496,6,10,6,16,44,53,-9,36
FC Lugano,3496,7,10,6,16,31,48,-17,36
FC Thun,3496,8,9,6,17,46,62,-16,33
FC Sion,3496,9,7,9,16,43,58,-15,30
Young Boys,3497,1,20,7,5,71,38,33,67
FC Basel,3497,2,17,8,7,53,27,26,59
FC Zürich,3497,3,13,9,10,45,33,12,48
St Gallen,3497,4,15,2,15,45,56,-11,47
Lucerne,3497,5,12,7,13,41,49,-8,43
FC Lugano,3497,6,11,5,16,33,49,-16,38
Grasshoppers,3497,7,10,7,15,40,47,-7,37
FC Sion,3497,8,8,8,16,44,55,-11,32
FC Thun,3497,9,8,7,17,42,60,-18,31
Young Boys,3498,1,20,7,5,72,41,31,67
FC Basel,3498,2,17,9,6,55,27,28,60
Lucerne,3498,3,14,8,10,46,43,3,50
St Gallen,3498,4,14,3,15,41,55,-14,45
FC Zürich,3498,5,10,11,11,43,37,6,41
FC Lugano,3498,6,12,5,15,35,46,-11,41
FC Thun,3498,7,9,7,16,42,58,-16,34
Grasshoppers,3498,8,8,7,17,37,52,-15,31
FC Sion,3498,9,7,9,16,41,53,-12,30
Young Boys,3499,1,20,7,5,73,40,33,67
FC Basel,3499,2,19,8,5,52,21,31,65
Lucerne,3499,3,12,10,10,44,46,-2,46
St Gallen,3499,4,14,3,15,42,54,-12,45
FC Zürich,3499,5,10,11,11,38,35,3,41
FC Lugano,3499,6,11,6,15,34,47,-13,39
Grasshoppers,3499,7,9,9,14,39,46,-7,36
FC Thun,3499,8,8,6,18,39,57,-18,30
FC Sion,3499,9,6,10,16,39,54,-15,28
Young Boys,3500,1,22,8,2,77,35,42,74
FC Basel,3500,2,18,9,5,54,24,30,63
St Gallen,3500,3,16,2,14,47,55,-8,50
Lucerne,3500,4,13,7,12,41,42,-1,46
FC Zürich,3500,5,9,11,12,41,40,1,38
Grasshoppers,3500,6,10,6,16,41,51,-10,36
FC Lugano,3500,7,10,5,17,29,52,-23,35
FC Thun,3500,8,9,7,16,45,58,-13,34
FC Sion,3500,9,5,9,18,41,59,-18,24
Young Boys,3501,1,22,7,3,73,32,41,73
FC Basel,3501,2,16,10,6,51,28,23,58
St Gallen,3501,3,15,4,13,48,53,-5,49
Lucerne,3501,4,12,9,11,40,45,-5,45
FC Thun,3501,5,11,6,15,47,56,-9,39
FC Lugano,3501,6,11,6,15,31,46,-15,39
FC Zürich,3501,7,9,11,12,39,38,1,38
Grasshoppers,3501,8,9,6,17,39,53,-14,33
FC Sion,3501,9,5,9,18,40,57,-17,24
Young Boys,3502,1,20,7,5,70,39,31,67
FC Basel,3502,2,18,8,6,57,26,31,62
FC Zürich,3502,3,13,9,10,47,34,13,48
Lucerne,3502,4,13,9,10,42,43,-1,48
St Gallen,3502,5,14,2,16,43,59,-16,44
Grasshoppers,3502,6,11,7,14,45,47,-2,40
FC Lugano,3502,7,9,7,16,29,49,-20,34
FC Thun,3502,8,8,7,17,40,59,-19,31
FC Sion,3502,9,6,8,18,40,57,-17,26
Young Boys,3503,1,20,8,4,72,39,33,68
FC Basel,3503,2,18,8,6,57,25,32,62
St Gallen,3503,3,14,5,13,44,54,-10,47
Lucerne,3503,4,11,9,12,41,48,-7,42
FC Zürich,3503,5,10,10,12,40,37,3,40
Grasshoppers,3503,6,10,8,14,42,48,-6,38
FC Lugano,3503,7,10,8,14,31,45,-14,38
FC Thun,3503,8,9,6,17,42,60,-18,33
FC Sion,3503,9,7,8,17,42,55,-13,29
Young Boys,3504,1,20,10,2,73,35,38,70
FC Basel,3504,2,18,9,5,53,25,28,63
St Gallen,3504,3,14,5,13,43,52,-9,47
Lucerne,3504,4,12,8,12,44,46,-2,44
FC Zürich,3504,5,11,9,12,41,37,4,42
FC Thun,3504,6,10,6,16,47,58,-11,36
FC Lugano,3504,7,10,6,16,31,50,-19,36
Grasshoppers,3504,8,9,8,15,40,49,-9,35
FC Sion,3504,9,5,9,18,36,56,-20,24
Young Boys,3505,1,23,6,3,76,35,41,75
FC Basel,3505,2,20,7,5,60,23,37,67
Lucerne,3505,3,12,8,12,46,49,-3,44
St Gallen,3505,4,14,2,16,42,55,-13,44
FC Zürich,3505,5,11,10,11,40,39,1,43
FC Lugano,3505,6,10,6,16,30,50,-20,36
Grasshoppers,3505,7,9,7,16,44,53,-9,34
FC Thun,3505,8,8,7,17,42,60,-18,31
FC Sion,3505,9,6,9,17,38,54,-16,27
Young Boys,3506,1,21,8,3,70,35,35,71
FC Basel,3506,2,17,10,5,50,23,27,61
St Gallen,3506,3,15,2,15,43,53,-10,47
Lucerne,3506,4,12,9,11,39,44,-5,45
FC Zürich,3506,5,10,12,10,39,34,5,42
Grasshoppers,3506,6,11,6,15,46,49,-3,39
FC Thun,3506,7,9,7,16,45,60,-15,34
FC Lugano,3506,8,9,6,17,29,47,-18,33
FC Sion,3506,9,6,8,18,40,56,-16,26
Young Boys,3507,1,20,8,4,71,37,34,68
FC Basel,3507,2,16,10,6,51,28,23,58
Lucerne,3507,3,14,8,10,42,41,1,50
St Gallen,3507,4,15,3,14,45,53,-8,48
FC Zürich,3507,5,10,11,11,40,35,5,41
FC Lugano,3507,6,11,5,16,29,45,-16,38
Grasshoppers,3507,7,10,7,15,42,49,-7,37
FC Thun,3507,8,8,8,16,41,57,-16,32
FC Sion,3507,9,5,10,17,39,55,-16,25
Young Boys,3508,1,20,9,3,69,35,34,69
FC Basel,3508,2,17,9,6,54,27,27,60
Lucerne,3508,3,13,9,10,43,43,0,48
St Gallen,3508,4,15,3,14,42,53,-11,48
FC Lugano,3508,5,11,6,15,33,47,-14,39
FC Zürich,3508,6,9,11,12,39,40,-1,38
FC Thun,3508,7,11,5,16,48,55,-7,38
Grasshoppers,3508,8,8,8,16,38,50,-12,32
FC Sion,3508,9,6,8,18,38,54,-16,26
Young Boys,3509,1,20,9,3,72,36,36,69
FC Basel,3509,2,16,9,7,54,29,25,57
St Gallen,3509,3,16,2,14,47,55,-8,50
Lucerne,3509,4,14,7,11,44,44,0,49
FC Zürich,3509,5,10,10,12,39,37,2,40
FC Lugano,3509,6,11,6,15,34,47,-13,39
FC Sion,3509,7,8,8,16,41,51,-10,32
FC Thun,3509,8,8,8,16,41,57,-16,32
Grasshoppers,3509,9,8,7,17,37,53,-16,31
Young Boys,3510,1,22,8,2,67,29,38,74
FC Basel,3510,2,16,8,8,52,30,22,56
St Gallen,3510,3,14,4,14,43,53,-10,46
FC Zürich,3510,4,11,10,11,41,37,4,43
Lucerne,3510,5,11,9,12,39,45,-6,42
FC Lugano,3510,6,11,6,15,32,45,-13,39
Grasshoppers,3510,7,9,8,15,43,50,-7,35
FC Thun,3510,8,9,6,17,46,60,-14,33
FC Sion,3510,9,7,9,16,40,54,-14,30
Young Boys,3511,1,21,8,3,74,35,39,71
FC Basel,3511,2,18,8,6,55,25,30,62
St Gallen,3511,3,14,4,14,45,56,-11,46
Lucerne,3511,4,12,8,12,42,47,-5,44
FC Zürich,3511,5,11,10,11,42,38,4,43
FC Lugano,3511,6,11,6,15,34,48,-14,39
Grasshoppers,3511,7,9,7,16,39,51,-12,34
FC Thun,3511,8,9,6,17,43,59,-16,33
FC Sion,3511,9,6,9,17,39,54,-15,27
Young Boys,3512,1,22,6,4,73,37,36,72
FC Basel,3512,2,19,8,5,63,25,38,65
St Gallen,3512,3,15,2,15,42,57,-15,47
Lucerne,3512,4,12,8,12,42,45,-3,44
FC Zrich,3512,5,10,9,13,41,40,1,39
FC Thun,3512,6,10,6,16,45,59,-14,36
FC Lugano,3512,7,10,6,16,30,50,-20,36
Grasshoppers,3512,8,9,7,16,39,50,-11,34
FC Sion,3512,9,7,8,17,42,54,-12,29
Young Boys,3513,1,21,8,3,71,36,35,71
FC Basel,3513,2,20,7,5,60,22,38,67
St Gallen,3513,3,15,2,15,42,52,-10,47
FC Zürich,3513,4,12,9,11,43,36,7,45
Lucerne,3513,5,12,8,12,41,44,-3,44
Grasshoppers,3513,6,9,8,15,43,54,-11,35
FC Lugano,3513,7,10,5,17,29,47,-18,35
FC Thun,3513,8,8,7,17,42,64,-22,31
FC Sion,3513,9,5,10,17,38,54,-16,25
Young Boys,3514,1,20,8,4,69,35,34,68
FC Basel,3514,2,17,8,7,52,27,25,59
Lucerne,3514,3,14,8,10,44,45,-1,50
St Gallen,3514,4,13,4,15,41,54,-13,43
FC Zürich,3514,5,10,10,12,40,37,3,40
Grasshoppers,3514,6,11,7,14,45,48,-3,40
FC Lugano,3514,7,10,7,15,30,47,-17,37
FC Thun,3514,8,9,6,17,41,59,-18,33
FC Sion,3514,9,7,8,17,43,53,-10,29
Young Boys,3515,1,22,7,3,72,33,39,73
FC Basel,3515,2,18,9,5,59,25,34,63
Lucerne,3515,3,14,7,11,43,47,-4,49
St Gallen,3515,4,13,3,16,45,61,-16,42
FC Zürich,3515,5,10,11,11,39,37,2,41
FC Lugano,3515,6,11,5,16,34,51,-17,38
FC Thun,3515,7,10,6,16,44,58,-14,36
Grasshoppers,3515,8,9,7,16,40,48,-8,34
FC Sion,3515,9,5,9,18,38,54,-16,24
Young Boys,3516,1,23,6,3,75,34,41,75
FC Basel,3516,2,18,8,6,53,26,27,62
St Gallen,3516,3,14,4,14,44,54,-10,46
Lucerne,3516,4,12,9,11,40,45,-5,45
FC Zürich,3516,5,11,11,10,41,35,6,44
FC Lugano,3516,6,10,6,16,31,48,-17,36
Grasshoppers,3516,7,9,6,17,41,51,-10,33
FC Thun,3516,8,9,6,17,47,64,-17,33
FC Sion,3516,9,6,8,18,42,57,-15,26
FC Basel,3517,1,20,7,5,61,26,35,67
Young Boys,3517,2,20,7,5,69,39,30,67
Lucerne,3517,3,13,8,11,43,43,0,47
St Gallen,3517,4,13,3,16,41,59,-18,42
FC Zürich,3517,5,10,10,12,43,40,3,40
Grasshoppers,3517,6,11,7,14,43,48,-5,40
FC Lugano,3517,7,10,6,16,30,47,-17,36
FC Sion,3517,8,8,8,16,47,54,-7,32
FC Thun,3517,9,8,6,18,42,63,-21,30
Young Boys,3518,1,20,6,6,68,36,32,66
FC Basel,3518,2,17,10,5,51,23,28,61
St Gallen,3518,3,14,4,14,43,54,-11,46
Lucerne,3518,4,12,8,12,40,44,-4,44
FC Zürich,3518,5,11,10,11,42,39,3,43
FC Lugano,3518,6,10,6,16,31,49,-18,36
FC Sion,3518,7,9,8,15,47,53,-6,35
Grasshoppers,3518,8,9,7,16,39,48,-9,34
FC Thun,3518,9,9,7,16,42,57,-15,34
Young Boys,3519,1,22,7,3,72,35,37,73
FC Basel,3519,2,18,8,6,57,24,33,62
St Gallen,3519,3,14,4,14,43,57,-14,46
Lucerne,3519,4,11,11,10,41,43,-2,44
FC Zürich,3519,5,10,9,13,40,38,2,39
Grasshoppers,3519,6,10,7,15,40,47,-7,37
FC Lugano,3519,7,10,7,15,32,46,-14,37
FC Thun,3519,8,9,5,18,41,61,-20,32
FC Sion,3519,9,7,8,17,41,56,-15,29
Young Boys,3520,1,20,8,4,71,37,34,68
FC Basel,3520,2,18,8,6,56,27,29,62
St Gallen,3520,3,15,2,15,43,55,-12,47
FC Zürich,3520,4,11,10,11,41,37,4,43
Lucerne,3520,5,11,10,11,41,45,-4,43
FC Lugano,3520,6,12,6,14,35,45,-10,42
Grasshoppers,3520,7,8,9,15,40,50,-10,33
FC Thun,3520,8,8,7,17,43,60,-17,31
FC Sion,3520,9,6,10,16,39,53,-14,28
Young Boys,3521,1,20,8,4,68,34,34,68
FC Basel,3521,2,17,8,7,51,28,23,59
St Gallen,3521,3,15,4,13,44,53,-9,49
Lucerne,3521,4,12,10,10,43,43,0,46
FC Zürich,3521,5,12,9,11,43,34,9,45
Grasshoppers,3521,6,9,9,14,40,46,-6,36
FC Lugano,3521,7,9,6,17,31,52,-21,33
FC Sion,3521,8,8,8,16,40,51,-11,32
FC Thun,3521,9,8,6,18,41,60,-19,30
Young Boys,3522,1,21,9,2,69,32,37,72
FC Basel,3522,2,19,8,5,55,22,33,65
St Gallen,3522,3,15,3,14,43,52,-9,48
Lucerne,3522,4,12,8,12,40,44,-4,44
FC Zürich,3522,5,10,10,12,39,37,2,40
FC Thun,3522,6,10,6,16,45,59,-14,36
Grasshoppers,3522,7,9,8,15,42,49,-7,35
FC Lugano,3522,8,9,8,15,31,48,-17,35
FC Sion,3522,9,5,8,19,37,58,-21,23
Young Boys,3523,1,20,7,5,68,38,30,67
FC Basel,3523,2,19,8,5,57,25,32,65
Lucerne,3523,3,13,7,12,43,44,-1,46
St Gallen,3523,4,14,4,14,45,55,-10,46
FC Zürich,3523,5,10,10,12,41,37,4,40
FC Lugano,3523,6,11,5,16,30,48,-18,38
Grasshoppers,3523,7,10,6,16,45,52,-7,36
FC Thun,3523,8,10,6,16,45,58,-13,36
FC Sion,3523,9,6,9,17,40,57,-17,27
Young Boys,3524,1,20,8,4,69,34,35,68
FC Basel,3524,2,17,9,6,54,28,26,60
Lucerne,3524,3,13,9,10,44,44,0,48
FC Zürich,3524,4,11,11,10,42,36,6,44
St Gallen,3524,5,14,2,16,45,60,-15,44
FC Lugano,3524,6,10,7,15,35,48,-13,37
FC Thun,3524,7,9,6,17,43,58,-15,33
FC Sion,3524,8,8,8,16,40,52,-12,32
Grasshoppers,3524,8,8,8,16,40,52,-12,32
Young Boys,3525,1,21,8,3,67,31,36,71
FC Basel,3525,2,15,9,8,49,28,21,54
FC Zürich,3525,3,12,10,10,43,33,10,46
Lucerne,3525,4,12,10,10,38,39,-1,46
St Gallen,3525,5,14,4,14,41,53,-12,46
FC Thun,3525,6,10,6,16,43,55,-12,36
Grasshoppers,3525,7,9,8,15,40,48,-8,35
FC Lugano,3525,8,9,8,15,28,45,-17,35
FC Sion,3525,9,7,7,18,40,57,-17,28
Young Boys,3526,1,20,8,4,69,37,32,68
FC Basel,3526,2,18,9,5,55,24,31,63
Lucerne,3526,3,14,8,10,48,44,4,50
FC Zürich,3526,4,11,9,12,42,40,2,42
St Gallen,3526,5,13,3,16,46,60,-14,42
Grasshoppers,3526,6,10,6,16,41,49,-8,36
FC Lugano,3526,7,10,5,17,31,50,-19,35
FC Thun,3526,8,9,6,17,45,62,-17,33
FC Sion,3526,9,8,8,16,45,56,-11,32
Young Boys,3527,1,21,6,5,78,38,40,69
FC Basel,3527,2,19,8,5,56,24,32,65
St Gallen,3527,3,15,2,15,43,53,-10,47
Lucerne,3527,4,12,7,13,40,50,-10,43
FC Lugano,3527,5,12,5,15,34,46,-12,41
FC Zürich,3527,6,9,12,11,38,35,3,39
Grasshoppers,3527,7,9,7,16,39,49,-10,34
FC Thun,3527,8,9,6,17,41,58,-17,33
FC Sion,3527,9,7,9,16,39,55,-16,30
Young Boys,3528,1,22,7,3,74,37,37,73
FC Basel,3528,2,20,7,5,63,24,39,67
Lucerne,3528,3,12,8,12,41,49,-8,44
St Gallen,3528,4,14,2,16,43,59,-16,44
FC Zürich,3528,5,10,10,12,39,37,2,40
FC Thun,3528,6,10,5,17,45,60,-15,35
FC Lugano,3528,7,10,5,17,32,51,-19,35
Grasshoppers,3528,8,9,7,16,41,52,-11,34
FC Sion,3528,9,7,9,16,45,54,-9,30
Young Boys,3529,1,23,6,3,74,33,41,75
FC Basel,3529,2,18,7,7,56,28,28,61
Lucerne,3529,3,13,8,11,43,42,1,47
St Gallen,3529,4,14,5,13,41,51,-10,47
FC Zürich,3529,5,10,9,13,43,40,3,39
Grasshoppers,3529,6,10,7,15,42,50,-8,37
FC Lugano,3529,7,10,6,16,31,50,-19,36
FC Thun,3529,8,10,5,17,47,64,-17,35
FC Sion,3529,9,5,9,18,36,55,-19,24
Young Boys,3530,1,21,8,3,71,35,36,71
FC Basel,3530,2,19,8,5,58,25,33,65
St Gallen,3530,3,14,4,14,44,54,-10,46
Lucerne,3530,4,12,8,12,44,48,-4,44
Grasshoppers,3530,5,11,7,14,47,50,-3,40
FC Zürich,3530,6,10,9,13,39,39,0,39
FC Lugano,3530,7,11,5,16,31,48,-17,38
FC Thun,3530,8,9,5,18,42,60,-18,32
FC Sion,3530,9,6,8,18,40,57,-17,26
Young Boys,3531,1,23,7,2,76,36,40,76
FC Basel,3531,2,17,9,6,55,30,25,60
St Gallen,3531,3,15,2,15,45,57,-12,47
Lucerne,3531,4,12,9,11,46,48,-2,45
FC Zürich,3531,5,10,10,12,39,39,0,40
FC Thun,3531,6,11,5,16,46,57,-11,38
FC Lugano,3531,7,10,6,16,34,50,-16,36
Grasshoppers,3531,8,8,7,17,42,53,-11,31
FC Sion,3531,9,7,7,18,41,54,-13,28
Young Boys,3532,1,21,7,4,73,32,41,70
FC Basel,3532,2,17,10,5,52,25,27,61
Lucerne,3532,3,12,9,11,39,49,-10,45
FC Zürich,3532,4,10,12,10,39,34,5,42
FC Lugano,3532,5,12,6,14,34,44,-10,42
St Gallen,3532,6,13,3,16,41,56,-15,42
FC Thun,3532,7,10,6,16,45,59,-14,36
Grasshoppers,3532,8,9,6,17,38,48,-10,33
FC Sion,3532,9,6,9,17,39,53,-14,27
Young Boys,3533,1,20,6,6,71,39,32,66
FC Basel,3533,2,18,8,6,58,25,33,62
Lucerne,3533,3,14,9,9,41,39,2,51
St Gallen,3533,4,14,4,14,41,55,-14,46
FC Zürich,3533,5,10,9,13,39,38,1,39
FC Lugano,3533,6,11,6,15,35,48,-13,39
Grasshoppers,3533,7,10,6,16,40,49,-9,36
FC Thun,3533,8,10,5,17,41,61,-20,35
FC Sion,3533,9,7,7,18,40,52,-12,28
Young Boys,3534,1,23,7,2,74,32,42,76
FC Basel,3534,2,19,7,6,57,24,33,64
Lucerne,3534,3,14,7,11,44,47,-3,49
St Gallen,3534,4,15,2,15,48,53,-5,47
FC Zürich,3534,5,9,11,12,38,37,1,38
FC Thun,3534,6,10,6,16,43,59,-16,36
FC Lugano,3534,7,9,6,17,27,53,-26,33
Grasshoppers,3534,8,8,8,16,40,50,-10,32
FC Sion,3534,9,5,10,17,38,54,-16,25
Young Boys,3535,1,21,6,5,68,36,32,69
FC Basel,3535,2,17,7,8,52,26,26,58
Lucerne,3535,3,14,8,10,43,41,2,50
St Gallen,3535,4,14,3,15,43,53,-10,45
FC Zürich,3535,5,10,11,11,42,38,4,41
Grasshoppers,3535,6,11,7,14,46,49,-3,40
FC Lugano,3535,7,10,5,17,32,51,-19,35
FC Sion,3535,8,8,8,16,41,52,-11,32
FC Thun,3535,9,8,7,17,44,65,-21,31
Young Boys,3536,1,22,7,3,70,33,37,73
FC Basel,3536,2,19,7,6,55,23,32,64
Lucerne,3536,3,14,7,11,44,42,2,49
St Gallen,3536,4,15,3,14,42,53,-11,48
FC Zürich,3536,5,10,10,12,37,34,3,40
FC Thun,3536,6,10,5,17,42,60,-18,35
FC Lugano,3536,7,9,5,18,29,50,-21,32
FC Sion,3536,8,7,10,15,39,49,-10,31
Grasshoppers,3536,9,8,6,18,39,53,-14,30
Young Boys,3537,1,23,6,3,75,35,40,75
FC Basel,3537,2,17,9,6,54,28,26,60
St Gallen,3537,3,14,4,14,40,52,-12,46
Lucerne,3537,4,12,8,12,41,43,-2,44
FC Zürich,3537,5,10,11,11,42,41,1,41
FC Thun,3537,6,10,6,16,46,58,-12,36
FC Lugano,3537,7,10,6,16,35,47,-12,36
Grasshoppers,3537,8,9,7,16,39,49,-10,34
FC Sion,3537,9,7,7,18,39,58,-19,28
Young Boys,3538,1,20,9,3,72,37,35,69
FC Basel,3538,2,16,9,7,51,25,26,57
Lucerne,3538,3,13,9,10,41,40,1,48
FC Zürich,3538,4,12,10,10,42,34,8,46
St Gallen,3538,5,14,3,15,41,56,-15,45
Grasshoppers,3538,6,9,8,15,40,50,-10,35
FC Lugano,3538,7,9,8,15,32,50,-18,35
FC Thun,3538,8,9,6,17,43,59,-16,33
FC Sion,3538,9,7,8,17,42,53,-11,29
Young Boys,3539,1,22,8,2,71,32,39,74
FC Basel,3539,2,18,9,5,53,25,28,63
St Gallen,3539,3,15,2,15,45,54,-9,47
FC Zürich,3539,4,11,11,10,44,37,7,44
Lucerne,3539,5,11,9,12,43,48,-5,42
FC Thun,3539,6,9,7,16,47,62,-15,34
FC Lugano,3539,7,9,6,17,30,52,-22,33
Grasshoppers,3539,8,8,7,17,40,52,-12,31
FC Sion,3539,9,7,9,16,43,54,-11,30
Young Boys,3540,1,21,6,5,72,38,34,69
FC Basel,3540,2,18,8,6,54,26,28,62
Lucerne,3540,3,13,8,11,43,44,-1,47
FC Zürich,3540,4,11,10,11,46,38,8,43
St Gallen,3540,5,13,3,16,43,59,-16,42
FC Lugano,3540,6,12,5,15,35,50,-15,41
Grasshoppers,3540,7,9,6,17,43,52,-9,33
FC Sion,3540,8,8,8,16,43,55,-12,32
FC Thun,3540,9,8,8,16,42,59,-17,32
Young Boys,3541,1,21,8,3,77,34,43,71
FC Basel,3541,2,18,8,6,54,27,27,62
St Gallen,3541,3,15,3,14,45,52,-7,48
Lucerne,3541,4,13,8,11,40,45,-5,47
FC Zürich,3541,5,11,10,11,44,37,7,43
FC Lugano,3541,6,9,8,15,28,50,-22,35
Grasshoppers,3541,7,9,7,16,40,50,-10,34
FC Thun,3541,8,9,5,18,43,59,-16,32
FC Sion,3541,9,7,7,18,41,58,-17,28
Young Boys,3542,1,21,8,3,72,36,36,71
FC Basel,3542,2,18,7,7,54,28,26,61
St Gallen,3542,3,15,3,14,49,54,-5,48
FC Zürich,3542,4,11,10,11,39,34,5,43
Lucerne,3542,5,11,9,12,38,44,-6,42
FC Lugano,3542,6,11,6,15,35,49,-14,39
Grasshoppers,3542,7,9,8,15,41,49,-8,35
FC Thun,3542,8,9,7,16,44,58,-14,34
FC Sion,3542,9,6,8,18,39,59,-20,26
Young Boys,3543,1,21,8,3,72,35,37,71
FC Basel,3543,2,18,7,7,54,27,27,61
St Gallen,3543,3,17,2,13,47,52,-5,53
FC Zürich,3543,4,13,9,10,43,32,11,48
Lucerne,3543,5,12,7,13,41,48,-7,43
Grasshoppers,3543,6,10,7,15,44,50,-6,37
FC Thun,3543,7,9,6,17,43,61,-18,33
FC Lugano,3543,8,9,5,18,29,51,-22,32
FC Sion,3543,9,5,9,18,38,55,-17,24
Young Boys,3544,1,20,8,4,68,35,33,68
FC Basel,3544,2,18,9,5,53,25,28,63
Lucerne,3544,3,13,9,10,44,41,3,48
St Gallen,3544,4,14,3,15,41,55,-14,45
FC Lugano,3544,5,12,5,15,33,44,-11,41
FC Zürich,3544,6,9,10,13,37,40,-3,37
FC Thun,3544,7,10,6,16,48,58,-10,36
Grasshoppers,3544,8,9,7,16,42,53,-11,34
FC Sion,3544,9,6,9,17,37,52,-15,27
Young Boys,3545,1,22,8,2,76,33,43,74
FC Basel,3545,2,17,8,7,54,28,26,59
Lucerne,3545,3,14,7,11,43,45,-2,49
FC Zürich,3545,4,12,9,11,41,34,7,45
St Gallen,3545,5,14,2,16,41,54,-13,44
FC Lugano,3545,6,10,5,17,28,49,-21,35
Grasshoppers,3545,7,9,7,16,41,50,-9,34
FC Thun,3545,8,9,5,18,42,62,-20,32
FC Sion,3545,9,7,9,16,41,52,-11,30
Young Boys,3546,1,21,8,3,69,33,36,71
FC Basel,3546,2,17,9,6,53,26,27,60
Lucerne,3546,3,14,7,11,45,46,-1,49
St Gallen,3546,4,14,3,15,45,57,-12,45
FC Zürich,3546,5,10,12,10,41,36,5,42
FC Lugano,3546,6,11,6,15,36,49,-13,39
FC Thun,3546,7,10,6,16,43,57,-14,36
Grasshoppers,3546,8,9,7,16,39,48,-9,34
FC Sion,3546,9,5,8,19,37,56,-19,23
Young Boys,3547,1,22,7,3,76,38,38,73
FC Basel,3547,2,19,8,5,57,25,32,65
Lucerne,3547,3,13,7,12,43,46,-3,46
St Gallen,3547,4,14,4,14,42,53,-11,46
FC Zürich,3547,5,10,9,13,39,39,0,39
FC Lugano,3547,6,11,6,15,36,49,-13,39
FC Thun,3547,7,9,6,17,45,58,-13,33
Grasshoppers,3547,8,9,6,17,43,57,-14,33
FC Sion,3547,9,6,9,17,39,55,-16,27
Young Boys,3548,1,21,7,4,70,34,36,70
FC Basel,3548,2,19,8,5,62,26,36,65
Lucerne,3548,3,14,7,11,45,47,-2,49
St Gallen,3548,4,14,3,15,45,57,-12,45
FC Zürich,3548,5,10,10,12,40,35,5,40
Grasshoppers,3548,6,10,7,15,43,49,-6,37
FC Thun,3548,7,10,6,16,43,61,-18,36
FC Lugano,3548,8,9,5,18,28,52,-24,32
FC Sion,3548,9,6,9,17,38,53,-15,27
Young Boys,3549,1,21,7,4,72,38,34,70
FC Basel,3549,2,16,9,7,51,26,25,57
Lucerne,3549,3,13,9,10,42,41,1,48
St Gallen,3549,4,14,2,16,43,56,-13,44
FC Zürich,3549,5,11,10,11,42,34,8,43
Grasshoppers,3549,6,11,7,14,46,49,-3,40
FC Lugano,3549,7,11,6,15,31,47,-16,39
FC Thun,3549,8,8,8,16,40,57,-17,32
FC Sion,3549,9,6,8,18,40,59,-19,26
Young Boys,3550,1,22,7,3,69,32,37,73
FC Basel,3550,2,19,8,5,54,23,31,65
St Gallen,3550,3,14,3,15,43,55,-12,45
Lucerne,3550,4,11,9,12,40,46,-6,42
FC Zürich,3550,5,10,10,12,41,39,2,40
FC Thun,3550,6,10,6,16,49,60,-11,36
FC Lugano,3550,7,9,7,16,31,48,-17,34
FC Sion,3550,8,8,8,16,44,55,-11,32
Grasshoppers,3550,9,8,8,16,40,53,-13,32
Young Boys,3551,1,22,7,3,71,33,38,73
FC Basel,3551,2,19,7,6,57,25,32,64
FC Zürich,3551,3,12,9,11,45,35,10,45
Lucerne,3551,4,12,9,11,45,43,2,45
St Gallen,3551,5,14,3,15,40,54,-14,45
Grasshoppers,3551,6,10,6,16,41,52,-11,36
FC Lugano,3551,7,10,6,16,30,49,-19,36
FC Thun,3551,8,10,5,17,42,57,-15,35
FC Sion,3551,9,5,8,19,36,59,-23,23
Young Boys,3552,1,21,7,4,72,36,36,70
FC Basel,3552,2,18,9,5,56,26,30,63
St Gallen,3552,3,15,3,14,44,54,-10,48
Lucerne,3552,4,12,9,11,43,46,-3,45
FC Zürich,3552,5,11,9,12,45,39,6,42
Grasshoppers,3552,6,11,7,14,46,50,-4,40
FC Lugano,3552,7,11,5,16,32,48,-16,38
FC Thun,3552,8,8,6,18,40,59,-19,30
FC Sion,3552,9,5,9,18,35,55,-20,24
Young Boys,3553,1,21,9,2,69,33,36,72
FC Basel,3553,2,16,11,5,48,22,26,59
FC Zürich,3553,3,11,11,10,41,33,8,44
Lucerne,3553,4,12,8,12,39,41,-2,44
St Gallen,3553,5,13,3,16,42,57,-15,42
Grasshoppers,3553,6,11,6,15,43,48,-5,39
FC Lugano,3553,7,11,6,15,32,46,-14,39
FC Thun,3553,8,8,6,18,42,61,-19,30
FC Sion,3553,9,7,8,17,41,56,-15,29
Young Boys,3554,1,21,7,4,68,35,33,70
FC Basel,3554,2,18,8,6,61,29,32,62
Lucerne,3554,3,13,8,11,47,45,2,47
St Gallen,3554,4,15,2,15,46,56,-10,47
FC Zürich,3554,5,9,12,11,41,38,3,39
FC Lugano,3554,6,11,6,15,32,47,-15,39
Grasshoppers,3554,7,10,7,15,43,51,-8,37
FC Thun,3554,8,8,7,17,41,63,-22,31
FC Sion,3554,9,6,9,17,38,53,-15,27
Young Boys,3555,1,22,7,3,73,35,38,73
FC Basel,3555,2,19,8,5,55,25,30,65
Lucerne,3555,3,13,9,10,46,45,1,48
St Gallen,3555,4,13,4,15,41,56,-15,43
FC Zürich,3555,5,10,10,12,41,37,4,40
FC Thun,3555,6,11,5,16,48,57,-9,38
FC Lugano,3555,7,10,5,17,31,52,-21,35
Grasshoppers,3555,8,8,6,18,40,57,-17,30
FC Sion,3555,9,7,8,17,41,52,-11,29
Young Boys,3556,1,21,7,4,70,35,35,70
FC Basel,3556,2,19,8,5,60,29,31,65
Lucerne,3556,3,13,8,11,42,44,-2,47
St Gallen,3556,4,15,2,15,43,54,-11,47
FC Lugano,3556,5,12,5,15,32,45,-13,41
FC Zürich,3556,6,10,9,13,39,39,0,39
FC Thun,3556,7,9,7,16,47,62,-15,34
Grasshoppers,3556,8,8,8,16,40,50,-10,32
FC Sion,3556,9,6,8,18,35,50,-15,26
Young Boys,3557,1,22,6,4,74,36,38,72
FC Basel,3557,2,19,7,6,59,28,31,64
Lucerne,3557,3,13,8,11,42,45,-3,47
St Gallen,3557,4,14,2,16,44,60,-16,44
FC Zürich,3557,5,10,11,11,42,37,5,41
Grasshoppers,3557,6,10,7,15,43,50,-7,37
FC Thun,3557,7,10,6,16,44,60,-16,36
FC Lugano,3557,8,10,5,17,31,51,-20,35
FC Sion,3557,9,6,8,18,44,56,-12,26
Young Boys,3558,1,23,6,3,73,36,37,75
FC Basel,3558,2,18,8,6,54,24,30,62
Lucerne,3558,3,13,8,11,45,48,-3,47
St Gallen,3558,4,15,2,15,45,55,-10,47
FC Zürich,3558,5,11,9,12,40,39,1,42
FC Lugano,3558,6,11,5,16,30,45,-15,38
FC Thun,3558,7,9,5,18,42,58,-16,32
Grasshoppers,3558,8,8,7,17,40,52,-12,31
FC Sion,3558,9,7,8,17,42,54,-12,29
Young Boys,3559,1,22,6,4,78,41,37,72
FC Basel,3559,2,19,7,6,61,27,34,64
FC Zürich,3559,3,12,9,11,46,36,10,45
St Gallen,3559,4,14,3,15,40,51,-11,45
Lucerne,3559,5,12,8,12,40,47,-7,44
FC Thun,3559,6,9,7,16,41,56,-15,34
FC Lugano,3559,7,9,7,16,29,49,-20,34
FC Sion,3559,8,8,8,16,42,56,-14,32
Grasshoppers,3559,9,8,7,17,38,52,-14,31
Young Boys,3560,1,23,7,2,78,33,45,76
FC Basel,3560,2,17,8,7,53,27,26,59
Lucerne,3560,3,15,7,10,45,46,-1,52
St Gallen,3560,4,15,2,15,45,54,-9,47
FC Zürich,3560,5,10,12,10,44,37,7,42
Grasshoppers,3560,6,9,7,16,41,52,-11,34
FC Lugano,3560,7,9,5,18,31,55,-24,32
FC Thun,3560,8,8,6,18,41,60,-19,30
FC Sion,3560,9,6,10,16,41,55,-14,28
Young Boys,3561,1,22,7,3,72,34,38,73
FC Basel,3561,2,18,7,7,56,29,27,61
Lucerne,3561,3,13,7,12,42,47,-5,46
St Gallen,3561,4,14,3,15,44,55,-11,45
FC Zürich,3561,5,11,9,12,43,39,4,42
FC Lugano,3561,6,11,6,15,33,46,-13,39
FC Thun,3561,7,10,6,16,47,62,-15,36
Grasshoppers,3561,8,8,7,17,38,53,-15,31
FC Sion,3561,9,7,8,17,42,52,-10,29
Young Boys,3562,1,22,7,3,73,35,38,73
FC Basel,3562,2,18,8,6,55,27,28,62
Lucerne,3562,3,13,8,11,46,47,-1,47
St Gallen,3562,4,14,2,16,45,59,-14,44
FC Zürich,3562,5,10,10,12,38,39,-1,40
Grasshoppers,3562,6,11,6,15,45,46,-1,39
FC Lugano,3562,7,11,6,15,35,47,-12,39
FC Thun,3562,8,10,6,16,43,59,-16,36
FC Sion,3562,9,5,7,20,37,58,-21,22
Young Boys,3563,1,22,6,4,69,34,35,72
FC Basel,3563,2,18,9,5,55,22,33,63
Lucerne,3563,3,13,8,11,42,44,-2,47
St Gallen,3563,4,13,4,15,38,55,-17,43
FC Zürich,3563,5,10,11,11,40,36,4,41
FC Lugano,3563,6,10,6,16,32,47,-15,36
Grasshoppers,3563,7,9,7,16,40,51,-11,34
FC Thun,3563,8,9,7,16,42,59,-17,34
FC Sion,3563,9,7,8,17,42,52,-10,29
Young Boys,3564,1,23,6,3,72,34,38,75
FC Basel,3564,2,18,8,6,54,25,29,62
St Gallen,3564,3,15,3,14,44,53,-9,48
Lucerne,3564,4,12,10,10,42,41,1,46
FC Zürich,3564,5,11,10,11,42,38,4,43
Grasshoppers,3564,6,10,7,15,44,49,-5,37
FC Lugano,3564,7,9,6,17,29,50,-21,33
FC Thun,3564,8,8,5,19,40,63,-23,29
FC Sion,3564,9,7,7,18,41,55,-14,28
Young Boys,3565,1,21,7,4,72,37,35,70
FC Basel,3565,2,18,7,7,55,28,27,61
St Gallen,3565,3,15,2,15,46,55,-9,47
FC Zürich,3565,4,12,10,10,46,37,9,46
Lucerne,3565,5,12,8,12,42,47,-5,44
Grasshoppers,3565,6,10,7,15,45,48,-3,37
FC Lugano,3565,7,10,6,16,30,48,-18,36
FC Sion,3565,8,7,9,16,44,56,-12,30
FC Thun,3565,9,8,6,18,43,67,-24,30
Young Boys,3566,1,23,7,2,77,37,40,76
FC Basel,3566,2,18,8,6,56,28,28,62
St Gallen,3566,3,15,3,14,43,53,-10,48
Lucerne,3566,4,12,9,11,43,46,-3,45
FC Zürich,3566,5,11,9,12,40,35,5,42
FC Lugano,3566,6,11,6,15,31,47,-16,39
Grasshoppers,3566,7,9,7,16,41,49,-8,34
FC Thun,3566,8,9,6,17,40,56,-16,33
FC Sion,3566,9,5,7,20,36,56,-20,22
Young Boys,3567,1,22,8,2,77,31,46,74
FC Basel,3567,2,17,8,7,54,26,28,59
St Gallen,3567,3,17,2,13,50,52,-2,53
FC Zürich,3567,4,11,10,11,43,38,5,43
Lucerne,3567,5,11,8,13,38,54,-16,41
FC Thun,3567,6,10,5,17,46,63,-17,35
FC Lugano,3567,7,10,5,17,30,50,-20,35
Grasshoppers,3567,8,8,8,16,39,49,-10,32
FC Sion,3567,9,7,8,17,42,56,-14,29
Young Boys,3568,1,22,8,2,71,33,38,74
FC Basel,3568,2,18,8,6,57,26,31,62
Lucerne,3568,3,13,7,12,42,44,-2,46
St Gallen,3568,4,14,3,15,42,56,-14,45
FC Zürich,3568,5,9,11,12,40,38,2,38
FC Lugano,3568,6,10,7,15,32,47,-15,37
Grasshoppers,3568,7,10,6,16,40,48,-8,36
FC Thun,3568,8,9,6,17,43,61,-18,33
FC Sion,3568,9,7,8,17,38,52,-14,29
Young Boys,3569,1,23,6,3,74,32,42,75
FC Basel,3569,2,16,7,9,51,28,23,55
St Gallen,3569,3,15,2,15,46,57,-11,47
Lucerne,3569,4,12,8,12,45,52,-7,44
FC Zürich,3569,5,11,10,11,44,36,8,43
FC Lugano,3569,6,12,5,15,33,45,-12,41
Grasshoppers,3569,7,10,8,14,48,49,-1,38
FC Thun,3569,8,9,6,17,44,62,-18,33
FC Sion,3569,9,6,8,18,39,63,-24,26
Young Boys,3570,1,20,7,5,67,37,30,67
FC Basel,3570,2,17,9,6,52,25,27,60
St Gallen,3570,3,15,3,14,46,57,-11,48
Lucerne,3570,4,12,8,12,42,47,-5,44
FC Zürich,3570,5,10,10,12,39,35,4,40
FC Lugano,3570,6,11,6,15,34,45,-11,39
FC Sion,3570,7,9,8,15,47,53,-6,35
Grasshoppers,3570,8,9,7,16,42,53,-11,34
FC Thun,3570,9,9,6,17,44,61,-17,33
Young Boys,3571,1,20,8,4,70,37,33,68
FC Basel,3571,2,18,9,5,61,25,36,63
St Gallen,3571,3,14,5,13,44,54,-10,47
Lucerne,3571,4,13,7,12,39,43,-4,46
FC Zürich,3571,5,11,9,12,45,38,7,42
FC Lugano,3571,6,11,6,15,32,48,-16,39
Grasshoppers,3571,7,9,8,15,43,49,-6,35
FC Thun,3571,8,8,6,18,41,65,-24,30
FC Sion,3571,9,7,8,17,41,57,-16,29
Young Boys,3572,1,20,8,4,67,36,31,68
FC Basel,3572,2,18,8,6,52,24,28,62
St Gallen,3572,3,15,3,14,46,53,-7,48
FC Zürich,3572,4,11,10,11,38,33,5,43
Lucerne,3572,5,11,10,11,41,47,-6,43
FC Lugano,3572,6,10,7,15,31,46,-15,37
Grasshoppers,3572,7,9,8,15,39,47,-8,35
FC Thun,3572,8,10,5,17,41,56,-15,35
FC Sion,3572,9,7,7,18,40,53,-13,28
Young Boys,3573,1,20,6,6,68,39,29,66
FC Basel,3573,2,18,8,6,59,25,34,62
Lucerne,3573,3,15,7,10,43,39,4,52
FC Zürich,3573,4,11,11,10,41,34,7,44
St Gallen,3573,5,13,3,16,40,56,-16,42
FC Lugano,3573,6,10,6,16,31,48,-17,36
FC Thun,3573,7,9,7,16,44,64,-20,34
Grasshoppers,3573,8,9,6,17,38,51,-13,33
FC Sion,3573,9,8,8,16,44,52,-8,32
Young Boys,3574,1,21,8,3,70,38,32,71
FC Basel,3574,2,16,9,7,56,31,25,57
St Gallen,3574,3,15,4,13,45,52,-7,49
FC Zürich,3574,4,13,9,10,46,36,10,48
Lucerne,3574,5,12,10,10,43,44,-1,46
FC Lugano,3574,6,10,7,15,32,47,-15,37
Grasshoppers,3574,7,9,7,16,43,51,-8,34
FC Thun,3574,8,9,7,16,43,58,-15,34
FC Sion,3574,9,5,7,20,39,60,-21,22
Young Boys,3575,1,21,7,4,69,32,37,70
FC Basel,3575,2,16,10,6,53,25,28,58
Lucerne,3575,3,13,9,10,44,46,-2,48
St Gallen,3575,4,15,3,14,46,52,-6,48
FC Zürich,3575,5,11,10,11,45,40,5,43
Grasshoppers,3575,6,10,7,15,47,52,-5,37
FC Thun,3575,7,9,7,16,47,64,-17,34
FC Lugano,3575,8,9,7,16,31,48,-17,34
FC Sion,3575,9,6,8,18,37,60,-23,26
Young Boys,3576,1,21,8,3,78,38,40,71
FC Basel,3576,2,19,8,5,56,27,29,65
Lucerne,3576,3,14,8,10,43,42,1,50
St Gallen,3576,4,13,3,16,40,55,-15,42
FC Thun,3576,5,11,5,16,44,57,-13,38
FC Zürich,3576,6,9,10,13,40,39,1,37
FC Lugano,3576,7,10,7,15,33,48,-15,37
Grasshoppers,3576,8,8,8,16,38,48,-10,32
FC Sion,3576,9,6,9,17,40,58,-18,27
Young Boys,3577,1,21,8,3,74,35,39,71
FC Basel,3577,2,17,9,6,50,23,27,60
St Gallen,3577,3,16,3,13,46,53,-7,51
Lucerne,3577,4,11,11,10,43,49,-6,44
FC Zürich,3577,5,11,10,11,44,36,8,43
Grasshoppers,3577,6,9,8,15,44,50,-6,35
FC Lugano,3577,7,9,7,16,30,48,-18,34
FC Thun,3577,8,9,6,17,43,60,-17,33
FC Sion,3577,9,6,8,18,41,61,-20,26
Young Boys,3578,1,23,6,3,72,32,40,75
FC Basel,3578,2,17,8,7,54,27,27,59
Lucerne,3578,3,13,8,11,43,46,-3,47
St Gallen,3578,4,14,2,16,43,58,-15,44
FC Zürich,3578,5,11,10,11,42,37,5,43
FC Lugano,3578,6,11,5,16,32,46,-14,38
Grasshoppers,3578,7,9,9,14,42,49,-7,36
FC Thun,3578,8,9,6,17,45,61,-16,33
FC Sion,3578,9,6,8,18,39,56,-17,26
Young Boys,3579,1,20,8,4,67,35,32,68
FC Basel,3579,2,18,7,7,55,25,30,61
Lucerne,3579,3,14,8,10,41,42,-1,50
FC Zürich,3579,4,13,9,10,40,32,8,48
St Gallen,3579,5,14,2,16,41,56,-15,44
FC Lugano,3579,6,11,5,16,31,45,-14,38
FC Thun,3579,7,9,6,17,41,57,-16,33
Grasshoppers,3579,8,8,8,16,38,48,-10,32
FC Sion,3579,9,7,7,18,39,53,-14,28
Young Boys,3580,1,23,7,2,72,31,41,76
FC Basel,3580,2,19,7,6,51,23,28,64
St Gallen,3580,3,15,3,14,44,53,-9,48
Lucerne,3580,4,12,9,11,41,42,-1,45
FC Zürich,3580,5,10,9,13,40,37,3,39
FC Lugano,3580,6,10,5,17,29,47,-18,35
FC Thun,3580,7,9,7,16,41,56,-15,34
Grasshoppers,3580,8,8,8,16,37,48,-11,32
FC Sion,3580,9,6,9,17,41,59,-18,27
Young Boys,3581,1,22,6,4,72,33,39,72
FC Basel,3581,2,17,9,6,51,25,26,60
Lucerne,3581,3,14,8,10,43,42,1,50
St Gallen,3581,4,14,3,15,44,57,-13,45
FC Zürich,3581,5,11,9,12,46,41,5,42
FC Thun,3581,6,10,7,15,46,56,-10,37
Grasshoppers,3581,7,9,6,17,40,52,-12,33
FC Lugano,3581,8,9,6,17,31,54,-23,33
FC Sion,3581,9,7,8,17,42,55,-13,29
Young Boys,3582,1,20,7,5,72,45,27,67
FC Basel,3582,2,17,10,5,54,24,30,61
St Gallen,3582,3,15,3,14,47,55,-8,48
Lucerne,3582,4,13,8,11,45,44,1,47
FC Zürich,3582,5,11,10,11,41,35,6,43
Grasshoppers,3582,6,10,6,16,42,51,-9,36
FC Thun,3582,7,10,6,16,45,58,-13,36
FC Lugano,3582,8,9,7,16,30,48,-18,34
FC Sion,3582,9,7,7,18,46,62,-16,28
Young Boys,3583,1,21,9,2,69,33,36,72
FC Basel,3583,2,18,9,5,55,25,30,63
Lucerne,3583,3,12,9,11,41,42,-1,45
St Gallen,3583,4,14,3,15,44,58,-14,45
FC Zürich,3583,5,10,9,13,41,41,0,39
FC Lugano,3583,6,11,5,16,35,47,-12,38
Grasshoppers,3583,7,9,7,16,38,49,-11,34
FC Thun,3583,8,9,6,17,44,60,-16,33
FC Sion,3583,9,6,11,15,43,55,-12,29
Young Boys,3584,1,22,7,3,72,35,37,73
FC Basel,3584,2,17,9,6,52,24,28,60
Lucerne,3584,3,12,9,11,43,44,-1,45
St Gallen,3584,4,13,3,16,40,57,-17,42
FC Lugano,3584,5,11,7,14,33,45,-12,40
FC Sion,3584,6,10,7,15,45,50,-5,37
FC Zürich,3584,7,9,9,14,36,38,-2,36
Grasshoppers,3584,8,10,6,16,41,50,-9,36
FC Thun,3584,9,9,5,18,41,60,-19,32
Young Boys,3585,1,21,8,3,74,37,37,71
FC Basel,3585,2,17,9,6,56,26,30,60
St Gallen,3585,3,15,3,14,45,55,-10,48
Lucerne,3585,4,11,11,10,42,49,-7,44
FC Zürich,3585,5,11,10,11,43,36,7,43
FC Sion,3585,6,8,9,15,43,50,-7,33
FC Lugano,3585,7,9,6,17,29,50,-21,33
Grasshoppers,3585,8,8,8,16,41,53,-12,32
FC Thun,3585,9,8,8,16,42,59,-17,32
Young Boys,3586,1,23,7,2,74,34,40,76
FC Basel,3586,2,15,9,8,52,32,20,54
Lucerne,3586,3,13,9,10,44,44,0,48
St Gallen,3586,4,15,2,15,45,56,-11,47
FC Zürich,3586,5,10,10,12,39,39,0,40
FC Thun,3586,6,11,5,16,50,59,-9,38
FC Lugano,3586,7,9,7,16,31,50,-19,34
Grasshoppers,3586,8,9,6,17,44,55,-11,33
FC Sion,3586,9,8,7,17,45,55,-10,31
Young Boys,3587,1,21,8,3,70,33,37,71
FC Basel,3587,2,19,8,5,56,23,33,65
Lucerne,3587,3,13,9,10,41,42,-1,48
St Gallen,3587,4,14,3,15,42,57,-15,45
FC Zürich,3587,5,11,10,11,42,38,4,43
FC Thun,3587,6,9,7,16,45,57,-12,34
FC Lugano,3587,7,9,6,17,28,47,-19,33
Grasshoppers,3587,8,8,7,17,40,56,-16,31
FC Sion,3587,9,6,10,16,44,55,-11,28
Young Boys,3588,1,22,6,4,75,35,40,72
FC Basel,3588,2,17,8,7,53,30,23,59
Lucerne,3588,3,14,8,10,44,40,4,50
St Gallen,3588,4,16,2,14,42,53,-11,50
FC Zürich,3588,5,11,10,11,46,38,8,43
FC Lugano,3588,6,10,6,16,34,48,-14,36
Grasshoppers,3588,7,9,7,16,41,56,-15,34
FC Sion,3588,8,7,8,17,43,57,-14,29
FC Thun,3588,9,8,5,19,42,63,-21,29
Young Boys,3589,1,21,9,2,71,35,36,72
FC Basel,3589,2,19,8,5,61,26,35,65
Lucerne,3589,3,13,8,11,44,47,-3,47
St Gallen,3589,4,13,3,16,44,59,-15,42
FC Zürich,3589,5,10,10,12,40,40,0,40
Grasshoppers,3589,6,9,8,15,44,52,-8,35
FC Lugano,3589,7,9,7,16,29,47,-18,34
FC Thun,3589,8,9,5,18,44,61,-17,32
FC Sion,3589,9,7,10,15,41,51,-10,31
Young Boys,3590,1,20,8,4,70,33,37,68
FC Basel,3590,2,16,11,5,52,26,26,59
Lucerne,3590,3,13,8,11,44,45,-1,47
St Gallen,3590,4,14,5,13,43,53,-10,47
FC Zürich,3590,5,10,11,11,38,33,5,41
Grasshoppers,3590,6,10,7,15,43,50,-7,37
FC Lugano,3590,7,10,7,15,32,50,-18,37
FC Thun,3590,8,8,6,18,43,63,-20,30
FC Sion,3590,9,6,11,15,43,55,-12,29
Young Boys,3591,1,21,7,4,68,34,34,70
FC Basel,3591,2,17,8,7,52,25,27,59
Lucerne,3591,3,15,7,10,45,43,2,52
St Gallen,3591,4,13,4,15,45,59,-14,43
FC Zürich,3591,5,10,10,12,38,35,3,40
Grasshoppers,3591,6,10,7,15,42,49,-7,37
FC Lugano,3591,7,10,6,16,31,48,-17,36
FC Thun,3591,8,9,8,15,44,58,-14,35
FC Sion,3591,9,6,9,17,39,53,-14,27
Young Boys,3592,1,21,7,4,77,37,40,70
FC Basel,3592,2,19,8,5,52,22,30,65
Lucerne,3592,3,12,8,12,43,49,-6,44
St Gallen,3592,4,14,2,16,40,55,-15,44
FC Zürich,3592,5,9,11,12,38,36,2,38
Grasshoppers,3592,6,10,7,15,43,48,-5,37
FC Lugano,3592,7,10,6,16,31,51,-20,36
FC Thun,3592,8,9,8,15,40,54,-14,35
FC Sion,3592,9,6,11,15,39,51,-12,29
Young Boys,3593,1,22,8,2,73,33,40,74
FC Basel,3593,2,18,7,7,51,25,26,61
Lucerne,3593,3,14,9,9,48,45,3,51
FC Zürich,3593,4,11,9,12,40,35,5,42
St Gallen,3593,5,13,2,17,41,56,-15,41
FC Thun,3593,6,11,5,16,44,55,-11,38
FC Lugano,3593,7,10,6,16,32,50,-18,36
Grasshoppers,3593,8,8,7,17,39,53,-14,31
FC Sion,3593,9,6,9,17,39,55,-16,27
Young Boys,3594,1,22,7,3,70,36,34,73
FC Basel,3594,2,19,7,6,56,24,32,64
Lucerne,3594,3,13,8,11,44,45,-1,47
St Gallen,3594,4,14,2,16,41,58,-17,44
FC Zürich,3594,5,11,9,12,42,36,6,42
FC Lugano,3594,6,11,5,16,35,47,-12,38
Grasshoppers,3594,7,9,7,16,41,50,-9,34
FC Thun,3594,8,9,6,17,44,64,-20,33
FC Sion,3594,9,7,7,18,45,58,-13,28
Young Boys,3595,1,21,8,3,77,35,42,71
FC Basel,3595,2,15,10,7,50,28,22,55
Lucerne,3595,3,12,9,11,42,49,-7,45
St Gallen,3595,4,14,3,15,41,53,-12,45
FC Zürich,3595,5,11,11,10,44,36,8,44
FC Lugano,3595,6,11,6,15,33,48,-15,39
Grasshoppers,3595,7,10,8,14,44,50,-6,38
FC Thun,3595,8,10,6,16,46,59,-13,36
FC Sion,3595,9,6,7,19,37,56,-19,25
Young Boys,3596,1,22,7,3,71,32,39,73
FC Basel,3596,2,16,9,7,53,30,23,57
St Gallen,3596,3,15,2,15,43,55,-12,47
Lucerne,3596,4,13,7,12,42,44,-2,46
FC Zürich,3596,5,11,9,12,44,38,6,42
FC Lugano,3596,6,11,5,16,33,50,-17,38
Grasshoppers,3596,7,10,6,16,43,48,-5,36
FC Thun,3596,8,9,6,17,46,64,-18,33
FC Sion,3596,9,8,7,17,39,53,-14,31
Young Boys,3597,1,20,8,4,66,34,32,68
FC Basel,3597,2,17,10,5,56,25,31,61
Lucerne,3597,3,13,8,11,43,44,-1,47
St Gallen,3597,4,14,4,14,43,54,-11,46
FC Zürich,3597,5,12,9,11,42,36,6,45
FC Lugano,3597,6,11,6,15,30,44,-14,39
Grasshoppers,3597,7,9,6,17,43,50,-7,33
FC Thun,3597,8,9,5,18,42,63,-21,32
FC Sion,3597,9,7,8,17,40,55,-15,29
Young Boys,3598,1,21,7,4,70,33,37,70
FC Basel,3598,2,18,8,6,53,25,28,62
St Gallen,3598,3,15,2,15,44,55,-11,47
Lucerne,3598,4,12,9,11,42,45,-3,45
Grasshoppers,3598,5,12,6,14,44,47,-3,42
FC Zürich,3598,6,9,10,13,39,39,0,37
FC Lugano,3598,7,10,6,16,31,50,-19,36
FC Thun,3598,8,10,5,17,42,56,-14,35
FC Sion,3598,9,7,7,18,39,54,-15,28
Young Boys,3599,1,23,6,3,73,34,39,75
FC Basel,3599,2,16,10,6,52,26,26,58
Lucerne,3599,3,12,9,11,39,43,-4,45
St Gallen,3599,4,14,3,15,42,55,-13,45
FC Zürich,3599,5,11,10,11,42,37,5,43
FC Thun,3599,6,10,6,16,43,56,-13,36
FC Lugano,3599,7,10,6,16,31,48,-17,36
Grasshoppers,3599,8,9,7,16,41,50,-9,34
FC Sion,3599,9,6,9,17,40,54,-14,27
Young Boys,3600,1,23,6,3,69,32,37,75
FC Basel,3600,2,16,9,7,54,30,24,57
Lucerne,3600,3,12,10,10,42,43,-1,46
FC Zürich,3600,4,12,9,11,44,36,8,45
St Gallen,3600,5,14,3,15,40,52,-12,45
FC Thun,3600,6,11,5,16,46,63,-17,38
FC Lugano,3600,7,10,6,16,30,46,-16,36
Grasshoppers,3600,8,8,8,16,40,51,-11,32
FC Sion,3600,9,6,8,18,42,54,-12,26
Young Boys,3601,1,22,6,4,74,34,40,72
FC Basel,3601,2,18,7,7,54,27,27,61
Lucerne,3601,3,13,7,12,39,43,-4,46
FC Zürich,3601,4,11,11,10,41,35,6,44
St Gallen,3601,5,14,2,16,43,54,-11,44
Grasshoppers,3601,6,10,7,15,45,50,-5,37
FC Lugano,3601,7,10,6,16,30,51,-21,36
FC Sion,3601,8,8,7,17,41,56,-15,31
FC Thun,3601,9,8,7,17,43,60,-17,31
Young Boys,3602,1,21,7,4,73,37,36,70
FC Basel,3602,2,17,8,7,54,28,26,59
St Gallen,3602,3,16,2,14,43,50,-7,50
Lucerne,3602,4,11,10,11,41,47,-6,43
FC Thun,3602,5,12,5,15,46,57,-11,41
FC Zürich,3602,6,9,11,12,37,35,2,38
FC Lugano,3602,7,10,7,15,31,46,-15,37
FC Sion,3602,8,8,7,17,41,53,-12,31
Grasshoppers,3602,9,8,7,17,39,52,-13,31
Young Boys,3603,1,23,7,2,72,33,39,76
FC Basel,3603,2,18,7,7,53,26,27,61
St Gallen,3603,3,14,2,16,42,56,-14,44
Lucerne,3603,4,11,9,12,40,47,-7,42
FC Zürich,3603,5,10,11,11,41,35,6,41
FC Thun,3603,6,11,6,15,42,54,-12,39
FC Lugano,3603,7,10,7,15,31,47,-16,37
Grasshoppers,3603,8,9,6,17,40,50,-10,33
FC Sion,3603,9,7,7,18,42,55,-13,28
Young Boys,3604,1,22,7,3,74,32,42,73
FC Basel,3604,2,19,8,5,54,23,31,65
Lucerne,3604,3,12,7,13,40,47,-7,43
FC Zürich,3604,4,11,9,12,40,37,3,42
St Gallen,3604,5,13,3,16,40,55,-15,42
Grasshoppers,3604,6,10,7,15,42,48,-6,37
FC Lugano,3604,7,10,6,16,30,48,-18,36
FC Thun,3604,8,10,5,17,46,60,-14,35
FC Sion,3604,9,7,8,17,42,58,-16,29
Young Boys,3605,1,21,6,5,70,41,29,69
FC Basel,3605,2,18,9,5,54,23,31,63
Lucerne,3605,3,14,8,10,46,43,3,50
St Gallen,3605,4,14,3,15,44,56,-12,45
FC Zürich,3605,5,11,10,11,42,36,6,43
FC Thun,3605,6,10,5,17,46,61,-15,35
FC Lugano,3605,7,10,5,17,32,51,-19,35
Grasshoppers,3605,8,9,7,16,41,50,-9,34
FC Sion,3605,9,7,7,18,45,59,-14,28
Young Boys,3606,1,23,7,2,74,34,40,76
FC Basel,3606,2,18,7,7,52,26,26,61
Lucerne,3606,3,14,7,11,44,44,0,49
St Gallen,3606,4,14,2,16,44,58,-14,44
FC Zürich,3606,5,11,10,11,41,38,3,43
FC Lugano,3606,6,10,7,15,30,45,-15,37
FC Thun,3606,7,10,5,17,46,60,-14,35
Grasshoppers,3606,8,8,6,18,41,54,-13,30
FC Sion,3606,9,7,7,18,44,57,-13,28
Young Boys,3607,1,22,8,2,79,37,42,74
FC Basel,3607,2,19,8,5,60,25,35,65
Lucerne,3607,3,13,8,11,41,45,-4,47
St Gallen,3607,4,13,3,16,42,57,-15,42
FC Zürich,3607,5,10,9,13,38,38,0,39
FC Lugano,3607,6,11,5,16,33,48,-15,38
FC Thun,3607,7,10,5,17,41,58,-17,35
Grasshoppers,3607,8,9,6,17,40,52,-12,33
FC Sion,3607,9,7,8,17,42,56,-14,29
Young Boys,3608,1,21,9,2,70,32,38,72
FC Basel,3608,2,18,9,5,54,23,31,63
St Gallen,3608,3,15,2,15,43,54,-11,47
Lucerne,3608,4,12,10,10,42,43,-1,46
FC Zürich,3608,5,10,11,11,41,38,3,41
FC Thun,3608,6,10,6,16,45,58,-13,36
Grasshoppers,3608,7,9,8,15,41,48,-7,35
FC Lugano,3608,8,9,6,17,30,50,-20,33
FC Sion,3608,9,5,9,18,39,59,-20,24
Young Boys,3609,1,23,6,3,72,33,39,75
FC Basel,3609,2,17,7,8,53,30,23,58
Lucerne,3609,3,13,9,10,45,40,5,48
St Gallen,3609,4,14,3,15,41,53,-12,45
FC Zürich,3609,5,11,10,11,42,36,6,43
Grasshoppers,3609,6,11,6,15,44,50,-6,39
FC Lugano,3609,7,11,6,15,29,46,-17,39
FC Thun,3609,8,8,7,17,45,62,-17,31
FC Sion,3609,9,5,8,19,38,59,-21,23
Young Boys,3610,1,23,7,2,72,31,41,76
FC Basel,3610,2,18,7,7,55,28,27,61
St Gallen,3610,3,15,3,14,49,59,-10,48
Lucerne,3610,4,13,8,11,40,41,-1,47
FC Zürich,3610,5,10,9,13,38,36,2,39
FC Thun,3610,6,10,6,16,43,58,-15,36
FC Lugano,3610,7,9,6,17,32,51,-19,33
Grasshoppers,3610,8,8,7,17,40,52,-12,31
FC Sion,3610,9,8,7,17,42,55,-13,31
Young Boys,3611,1,21,7,4,72,41,31,70
FC Basel,3611,2,18,9,5,57,25,32,63
Lucerne,3611,3,13,8,11,48,47,1,47
St Gallen,3611,4,14,2,16,43,61,-18,44
FC Zürich,3611,5,10,11,11,39,35,4,41
FC Lugano,3611,6,11,5,16,34,48,-14,38
Grasshoppers,3611,7,9,7,16,43,51,-8,34
FC Thun,3611,8,9,6,17,44,60,-16,33
FC Sion,3611,9,7,9,16,43,55,-12,30
Young Boys,3612,1,21,8,3,71,34,37,71
FC Basel,3612,2,15,11,6,47,23,24,56
St Gallen,3612,3,15,4,13,45,51,-6,49
Lucerne,3612,4,13,8,11,41,44,-3,47
FC Zürich,3612,5,12,10,10,39,32,7,46
Grasshoppers,3612,6,10,7,15,41,47,-6,37
FC Thun,3612,7,9,6,17,40,57,-17,33
FC Lugano,3612,8,9,6,17,30,51,-21,33
FC Sion,3612,9,5,10,17,38,53,-15,25
Young Boys,3613,1,23,6,3,72,35,37,75
FC Basel,3613,2,18,8,6,56,25,31,62
St Gallen,3613,3,16,3,13,45,52,-7,51
Lucerne,3613,4,13,7,12,42,45,-3,46
FC Zürich,3613,5,10,10,12,39,36,3,40
FC Thun,3613,6,10,6,16,45,59,-14,36
FC Lugano,3613,7,10,5,17,29,48,-19,35
Grasshoppers,3613,8,9,7,16,41,51,-10,34
FC Sion,3613,9,5,8,19,39,57,-18,23
Young Boys,3614,1,21,7,4,74,38,36,70
FC Basel,3614,2,19,8,5,56,24,32,65
Lucerne,3614,3,12,10,10,43,43,0,46
St Gallen,3614,4,14,2,16,43,57,-14,44
FC Zürich,3614,5,10,10,12,39,38,1,40
Grasshoppers,3614,6,11,7,14,44,48,-4,40
FC Lugano,3614,7,11,6,15,35,52,-17,39
FC Thun,3614,8,8,5,19,42,62,-20,29
FC Sion,3614,9,6,9,17,41,55,-14,27
Young Boys,3615,1,22,7,3,72,33,39,73
FC Basel,3615,2,19,8,5,55,22,33,65
St Gallen,3615,3,15,2,15,45,56,-11,47
Lucerne,3615,4,12,9,11,44,44,0,45
FC Zürich,3615,5,11,10,11,42,39,3,43
FC Thun,3615,6,9,6,17,43,59,-16,33
FC Lugano,3615,7,9,6,17,30,49,-19,33
Grasshoppers,3615,8,8,8,16,42,55,-13,32
FC Sion,3615,9,7,8,17,41,57,-16,29
Young Boys,3616,1,22,7,3,78,38,40,73
FC Basel,3616,2,17,9,6,57,27,30,60
St Gallen,3616,3,15,2,15,46,54,-8,47
Lucerne,3616,4,12,7,13,41,51,-10,43
FC Lugano,3616,5,11,6,15,35,48,-13,39
FC Zürich,3616,6,9,11,12,39,38,1,38
Grasshoppers,3616,7,10,6,16,39,49,-10,36
FC Thun,3616,8,10,6,16,45,59,-14,36
FC Sion,3616,9,7,8,17,38,54,-16,29
Young Boys,3617,1,21,7,4,74,39,35,70
FC Basel,3617,2,17,8,7,55,27,28,59
Lucerne,3617,3,14,8,10,47,43,4,50
FC Zürich,3617,4,12,9,11,43,36,7,45
St Gallen,3617,5,14,2,16,41,55,-14,44
FC Lugano,3617,6,12,5,15,34,45,-11,41
Grasshoppers,3617,7,9,8,15,41,51,-10,35
FC Thun,3617,8,9,5,18,44,64,-20,32
FC Sion,3617,9,6,8,18,43,62,-19,26
Young Boys,3618,1,21,8,3,71,34,37,71
FC Basel,3618,2,16,9,7,51,25,26,57
Lucerne,3618,3,15,8,9,44,40,4,53
St Gallen,3618,4,14,3,15,40,54,-14,45
FC Zürich,3618,5,10,11,11,40,36,4,41
FC Lugano,3618,6,10,6,16,30,48,-18,36
FC Thun,3618,7,9,8,15,42,56,-14,35
Grasshoppers,3618,8,8,8,16,40,51,-11,32
FC Sion,3618,9,5,11,16,38,52,-14,26
Young Boys,3619,1,22,8,2,71,33,38,74
FC Basel,3619,2,17,7,8,52,28,24,58
Lucerne,3619,3,14,7,11,45,44,1,49
St Gallen,3619,4,14,2,16,43,56,-13,44
FC Zürich,3619,5,10,11,11,40,36,4,41
FC Lugano,3619,6,11,6,15,33,49,-16,39
Grasshoppers,3619,7,10,6,16,44,51,-7,36
FC Thun,3619,8,9,6,17,45,61,-16,33
FC Sion,3619,9,6,9,17,41,56,-15,27
Young Boys,3620,1,24,6,2,73,31,42,78
FC Basel,3620,2,18,7,7,56,29,27,61
Lucerne,3620,3,13,7,12,41,43,-2,46
FC Zürich,3620,4,11,11,10,43,37,6,44
St Gallen,3620,5,14,2,16,41,55,-14,44
Grasshoppers,3620,6,10,7,15,43,47,-4,37
FC Lugano,3620,7,10,5,17,32,49,-17,35
FC Thun,3620,8,9,7,16,45,59,-14,34
FC Sion,3620,9,5,8,19,36,60,-24,23
Young Boys,3621,1,22,7,3,74,34,40,73
FC Basel,3621,2,16,11,5,50,24,26,59
Lucerne,3621,3,13,9,10,42,42,0,48
St Gallen,3621,4,13,4,15,39,55,-16,43
FC Zürich,3621,5,10,10,12,42,39,3,40
FC Lugano,3621,6,11,5,16,35,52,-17,38
Grasshoppers,3621,7,9,7,16,42,51,-9,34
FC Sion,3621,8,8,9,15,44,51,-7,33
FC Thun,3621,9,8,6,18,40,60,-20,30
Young Boys,3622,1,21,6,5,70,36,34,69
FC Basel,3622,2,17,8,7,55,28,27,59
FC Zürich,3622,3,13,9,10,41,32,9,48
St Gallen,3622,4,15,3,14,46,56,-10,48
Lucerne,3622,5,13,8,11,42,45,-3,47
Grasshoppers,3622,6,10,6,16,41,48,-7,36
FC Lugano,3622,7,10,5,17,29,47,-18,35
FC Thun,3622,8,9,6,17,40,56,-16,33
FC Sion,3622,9,7,7,18,39,55,-16,28
Young Boys,3623,1,22,7,3,74,36,38,73
FC Basel,3623,2,18,9,5,57,22,35,63
Lucerne,3623,3,12,8,12,42,50,-8,44
St Gallen,3623,4,13,4,15,41,57,-16,43
FC Zürich,3623,5,11,9,12,41,37,4,42
Grasshoppers,3623,6,11,7,14,43,47,-4,40
FC Lugano,3623,7,10,5,17,33,50,-17,35
FC Sion,3623,8,7,9,16,44,55,-11,30
FC Thun,3623,9,8,6,18,40,61,-21,30
Young Boys,3624,1,23,7,2,75,32,43,76
FC Basel,3624,2,17,9,6,59,29,30,60
St Gallen,3624,3,15,3,14,47,56,-9,48
Lucerne,3624,4,12,8,12,43,48,-5,44
FC Zürich,3624,5,10,11,11,40,38,2,41
Grasshoppers,3624,6,11,6,15,43,48,-5,39
FC Thun,3624,7,9,6,17,43,60,-17,33
FC Lugano,3624,8,9,5,18,29,51,-22,32
FC Sion,3624,9,6,9,17,38,55,-17,27
Young Boys,3625,1,21,6,5,73,37,36,69
FC Basel,3625,2,18,8,6,59,28,31,62
St Gallen,3625,3,16,3,13,43,51,-8,51
Lucerne,3625,4,13,7,12,41,45,-4,46
FC Zürich,3625,5,9,11,12,39,40,-1,38
Grasshoppers,3625,6,10,6,16,42,50,-8,36
FC Lugano,3625,7,10,5,17,30,49,-19,35
FC Sion,3625,8,8,9,15,44,53,-9,33
FC Thun,3625,9,9,5,18,44,62,-18,32
Young Boys,3626,1,21,8,3,68,32,36,71
FC Basel,3626,2,17,8,7,54,26,28,59
St Gallen,3626,3,14,5,13,45,55,-10,47
Lucerne,3626,4,12,10,10,39,41,-2,46
FC Zürich,3626,5,11,11,10,47,36,11,44
Grasshoppers,3626,6,9,8,15,42,50,-8,35
FC Lugano,3626,7,9,8,15,31,48,-17,35
FC Thun,3626,8,8,7,17,40,64,-24,31
FC Sion,3626,9,5,11,16,40,54,-14,26
Young Boys,3627,1,20,8,4,70,36,34,68
FC Basel,3627,2,18,7,7,52,24,28,61
Lucerne,3627,3,14,8,10,45,42,3,50
St Gallen,3627,4,15,2,15,44,54,-10,47
FC Zürich,3627,5,11,10,11,43,36,7,43
FC Lugano,3627,6,11,5,16,30,47,-17,38
FC Thun,3627,7,10,6,16,49,56,-7,36
Grasshoppers,3627,8,8,7,17,38,57,-19,31
FC Sion,3627,9,7,7,18,40,59,-19,28
Young Boys,3628,1,22,6,4,67,31,36,72
FC Basel,3628,2,18,7,7,54,24,30,61
Lucerne,3628,3,14,7,11,44,41,3,49
FC Zürich,3628,4,11,10,11,41,35,6,43
St Gallen,3628,5,13,2,17,38,59,-21,41
FC Thun,3628,6,11,5,16,47,57,-10,38
FC Lugano,3628,7,11,5,16,30,45,-15,38
Grasshoppers,3628,8,9,6,17,38,52,-14,33
FC Sion,3628,9,7,8,17,40,55,-15,29
Young Boys,3629,1,21,9,2,68,32,36,72
FC Basel,3629,2,19,8,5,57,25,32,65
St Gallen,3629,3,13,3,16,39,55,-16,42
Lucerne,3629,4,11,8,13,39,47,-8,41
FC Lugano,3629,5,11,6,15,30,43,-13,39
FC Zürich,3629,6,9,11,12,41,40,1,38
Grasshoppers,3629,7,10,8,14,44,49,-5,38
FC Sion,3629,8,8,8,16,43,51,-8,32
FC Thun,3629,9,8,7,17,44,63,-19,31
Young Boys,3630,1,23,6,3,72,34,38,75
FC Basel,3630,2,18,7,7,55,27,28,61
Lucerne,3630,3,13,8,11,42,44,-2,47
FC Zürich,3630,4,12,9,11,44,35,9,45
St Gallen,3630,5,14,3,15,43,53,-10,45
FC Lugano,3630,6,10,6,16,30,50,-20,36
Grasshoppers,3630,7,9,6,17,43,53,-10,33
FC Thun,3630,8,9,6,17,44,61,-17,33
FC Sion,3630,9,6,9,17,38,54,-16,27
Young Boys,3631,1,23,6,3,77,35,42,75
FC Basel,3631,2,19,7,6,58,26,32,64
St Gallen,3631,3,16,3,13,44,51,-7,51
FC Zürich,3631,4,11,10,11,42,36,6,43
Lucerne,3631,5,12,7,13,41,50,-9,43
Grasshoppers,3631,6,9,7,16,42,49,-7,34
FC Thun,3631,7,9,6,17,41,59,-18,33
FC Lugano,3631,8,9,6,17,29,53,-24,33
FC Sion,3631,9,5,10,17,39,54,-15,25
Young Boys,3632,1,22,8,2,73,34,39,74
FC Basel,3632,2,17,7,8,52,27,25,58
Lucerne,3632,3,14,7,11,47,46,1,49
St Gallen,3632,4,15,2,15,43,56,-13,47
FC Zürich,3632,5,12,10,10,43,35,8,46
FC Thun,3632,6,10,6,16,46,57,-11,36
FC Lugano,3632,7,10,6,16,32,48,-16,36
Grasshoppers,3632,8,8,6,18,42,60,-18,30
FC Sion,3632,9,6,8,18,40,55,-15,26
Young Boys,3633,1,22,6,4,71,34,37,72
FC Basel,3633,2,18,7,7,54,27,27,61
Lucerne,3633,3,14,7,11,44,42,2,49
St Gallen,3633,4,14,2,16,47,57,-10,44
FC Zürich,3633,5,11,10,11,42,36,6,43
FC Thun,3633,6,11,5,16,50,61,-11,38
Grasshoppers,3633,7,10,6,16,43,51,-8,36
FC Lugano,3633,8,9,6,17,30,55,-25,33
FC Sion,3633,9,7,7,18,40,58,-18,28
Young Boys,3634,1,23,6,3,74,33,41,75
FC Basel,3634,2,17,8,7,50,26,24,59
Lucerne,3634,3,12,8,12,39,43,-4,44
FC Lugano,3634,4,13,5,14,34,43,-9,44
St Gallen,3634,5,13,4,15,38,53,-15,43
FC Zürich,3634,6,10,10,12,40,36,4,40
FC Thun,3634,7,10,5,17,45,60,-15,35
Grasshoppers,3634,8,9,7,16,41,51,-10,34
FC Sion,3634,9,6,9,17,40,56,-16,27
Young Boys,3635,1,22,7,3,70,34,36,73
FC Basel,3635,2,17,9,6,53,25,28,60
Lucerne,3635,3,13,8,11,41,47,-6,47
St Gallen,3635,4,15,2,15,49,56,-7,47
FC Zürich,3635,5,10,11,11,46,38,8,41
FC Lugano,3635,6,11,5,16,33,47,-14,38
FC Thun,3635,7,10,5,17,42,62,-20,35
Grasshoppers,3635,8,9,6,17,40,51,-11,33
FC Sion,3635,9,6,9,17,41,55,-14,27
Young Boys,3636,1,23,7,2,73,32,41,76
FC Basel,3636,2,15,9,8,51,32,19,54
Lucerne,3636,3,13,8,11,40,43,-3,47
FC Zürich,3636,4,11,11,10,44,35,9,44
St Gallen,3636,5,13,5,14,43,55,-12,44
Grasshoppers,3636,6,10,6,16,43,52,-9,36
FC Lugano,3636,7,10,6,16,29,45,-16,36
FC Thun,3636,8,9,7,16,45,59,-14,34
FC Sion,3636,9,6,9,17,41,56,-15,27
Young Boys,3637,1,20,8,4,71,36,35,68
FC Basel,3637,2,19,7,6,56,23,33,64
Lucerne,3637,3,14,9,9,50,42,8,51
FC Zürich,3637,4,11,10,11,40,36,4,43
St Gallen,3637,5,13,3,16,41,57,-16,42
FC Thun,3637,6,10,6,16,45,59,-14,36
FC Lugano,3637,7,10,6,16,30,51,-21,36
Grasshoppers,3637,8,9,6,17,40,51,-11,33
FC Sion,3637,9,7,7,18,38,56,-18,28
Young Boys,3638,1,21,7,4,73,37,36,70
FC Basel,3638,2,18,7,7,54,30,24,61
Lucerne,3638,3,12,9,11,43,46,-3,45
St Gallen,3638,4,14,2,16,45,58,-13,44
FC Zürich,3638,5,11,9,12,44,38,6,42
Grasshoppers,3638,6,11,6,15,44,48,-4,39
FC Lugano,3638,7,11,6,15,33,49,-16,39
FC Thun,3638,8,11,5,16,45,55,-10,38
FC Sion,3638,9,6,7,19,38,58,-20,25
Young Boys,3639,1,20,7,5,71,39,32,67
FC Basel,3639,2,18,8,6,56,25,31,62
St Gallen,3639,3,15,2,15,45,57,-12,47
Lucerne,3639,4,12,9,11,43,48,-5,45
FC Zürich,3639,5,11,9,12,42,39,3,42
FC Lugano,3639,6,12,6,14,36,44,-8,42
Grasshoppers,3639,7,10,7,15,44,50,-6,37
FC Thun,3639,8,9,6,17,42,58,-16,33
FC Sion,3639,9,6,8,18,42,61,-19,26
Young Boys,3640,1,22,7,3,74,35,39,73
FC Basel,3640,2,16,9,7,49,27,22,57
St Gallen,3640,3,16,2,14,50,55,-5,50
Lucerne,3640,4,12,10,10,39,42,-3,46
FC Zürich,3640,5,10,11,11,41,36,5,41
FC Lugano,3640,6,10,7,15,32,50,-18,37
Grasshoppers,3640,7,10,6,16,40,47,-7,36
FC Thun,3640,8,10,5,17,45,60,-15,35
FC Sion,3640,9,6,7,19,40,58,-18,25
Young Boys,3641,1,20,8,4,67,35,32,68
FC Basel,3641,2,15,9,8,51,29,22,54
Lucerne,3641,3,12,10,10,41,43,-2,46
St Gallen,3641,4,14,3,15,46,57,-11,45
FC Zürich,3641,5,11,10,11,42,34,8,43
FC Lugano,3641,6,12,5,15,31,44,-13,41
Grasshoppers,3641,7,10,8,14,42,46,-4,38
FC Thun,3641,8,9,6,17,41,58,-17,33
FC Sion,3641,9,7,9,16,42,57,-15,30
Young Boys,3642,1,22,6,4,71,37,34,72
FC Basel,3642,2,19,8,5,54,21,33,65
Lucerne,3642,3,12,8,12,44,48,-4,44
St Gallen,3642,4,13,3,16,41,58,-17,42
FC Lugano,3642,5,12,5,15,37,51,-14,41
FC Zürich,3642,6,10,10,12,40,38,2,40
FC Thun,3642,7,10,6,16,45,57,-12,36
Grasshoppers,3642,8,9,7,16,40,49,-9,34
FC Sion,3642,9,7,7,18,43,56,-13,28
Young Boys,3643,1,22,8,2,71,34,37,74
FC Basel,3643,2,17,8,7,52,25,27,59
Lucerne,3643,3,14,7,11,45,43,2,49
St Gallen,3643,4,13,3,16,40,57,-17,42
FC Zürich,3643,5,10,11,11,40,36,4,41
FC Lugano,3643,6,11,7,14,34,45,-11,40
FC Thun,3643,7,9,5,18,43,63,-20,32
FC Sion,3643,8,7,10,15,42,51,-9,31
Grasshoppers,3643,9,8,7,17,40,53,-13,31
Young Boys,3644,1,22,7,3,70,33,37,73
FC Basel,3644,2,18,8,6,54,23,31,62
Lucerne,3644,3,13,9,10,42,42,0,48
FC Zürich,3644,4,11,10,11,41,34,7,43
St Gallen,3644,5,13,4,15,43,56,-13,43
Grasshoppers,3644,6,10,6,16,40,47,-7,36
FC Lugano,3644,7,10,6,16,30,47,-17,36
FC Thun,3644,8,8,6,18,40,62,-22,30
FC Sion,3644,9,6,10,16,39,55,-16,28
Young Boys,3645,1,23,6,3,75,33,42,75
FC Basel,3645,2,19,7,6,54,24,30,64
St Gallen,3645,3,14,3,15,40,53,-13,45
Lucerne,3645,4,12,7,13,40,45,-5,43
FC Zürich,3645,5,11,9,12,42,38,4,42
Grasshoppers,3645,6,10,6,16,41,52,-11,36
FC Lugano,3645,7,10,6,16,29,47,-18,36
FC Thun,3645,8,9,6,17,45,61,-16,33
FC Sion,3645,9,7,8,17,41,54,-13,29
Young Boys,3646,1,20,8,4,70,39,31,68
FC Basel,3646,2,19,7,6,59,27,32,64
Lucerne,3646,3,12,10,10,41,44,-3,46
St Gallen,3646,4,13,3,16,45,62,-17,42
FC Zürich,3646,5,10,11,11,39,34,5,41
Grasshoppers,3646,6,10,7,15,41,49,-8,37
FC Thun,3646,7,10,6,16,46,59,-13,36
FC Lugano,3646,8,9,8,15,31,48,-17,35
FC Sion,3646,9,7,8,17,44,54,-10,29
Young Boys,3647,1,21,6,5,72,39,33,69
FC Basel,3647,2,17,7,8,54,28,26,58
Lucerne,3647,3,15,8,9,45,39,6,53
FC Zürich,3647,4,13,9,10,43,32,11,48
St Gallen,3647,5,14,3,15,41,57,-16,45
FC Thun,3647,6,11,5,16,46,54,-8,38
Grasshoppers,3647,7,9,7,16,41,51,-10,34
FC Lugano,3647,8,9,6,17,29,51,-22,33
FC Sion,3647,9,6,7,19,40,60,-20,25
Young Boys,3648,1,23,7,2,72,32,40,76
FC Basel,3648,2,17,9,6,60,30,30,60
Lucerne,3648,3,13,8,11,44,44,0,47
FC Zürich,3648,4,12,9,11,42,33,9,45
St Gallen,3648,5,13,4,15,46,59,-13,43
FC Thun,3648,6,11,5,16,46,61,-15,38
FC Lugano,3648,7,9,7,16,32,49,-17,34
Grasshoppers,3648,8,8,7,17,38,54,-16,31
FC Sion,3648,9,6,8,18,38,56,-18,26
Young Boys,3649,1,22,7,3,73,32,41,73
FC Basel,3649,2,17,8,7,50,25,25,59
St Gallen,3649,3,17,2,13,43,49,-6,53
FC Zürich,3649,4,12,9,11,41,36,5,45
Lucerne,3649,5,12,9,11,41,45,-4,45
Grasshoppers,3649,6,10,7,15,43,49,-6,37
FC Lugano,3649,7,10,5,17,29,48,-19,35
FC Thun,3649,8,8,6,18,39,58,-19,30
FC Sion,3649,9,5,9,18,37,54,-17,24
Young Boys,3650,1,22,7,3,76,35,41,73
FC Basel,3650,2,16,10,6,54,30,24,58
St Gallen,3650,3,14,3,15,41,56,-15,45
FC Zürich,3650,4,10,11,11,42,38,4,41
Lucerne,3650,5,11,8,13,38,45,-7,41
FC Lugano,3650,6,11,7,14,33,44,-11,40
Grasshoppers,3650,7,10,7,15,45,53,-8,37
FC Thun,3650,8,9,7,16,48,62,-14,34
FC Sion,3650,9,7,8,17,45,59,-14,29
Young Boys,3651,1,22,6,4,73,37,36,72
FC Basel,3651,2,19,7,6,55,24,31,64
Lucerne,3651,3,15,7,10,48,42,6,52
FC Zürich,3651,4,11,10,11,42,38,4,43
St Gallen,3651,5,13,3,16,38,58,-20,42
FC Thun,3651,6,10,6,16,45,57,-12,36
FC Lugano,3651,7,10,5,17,31,48,-17,35
Grasshoppers,3651,8,8,7,17,38,53,-15,31
FC Sion,3651,9,6,9,17,42,55,-13,27
Young Boys,3652,1,22,6,4,73,35,38,72
FC Basel,3652,2,17,8,7,56,30,26,59
Lucerne,3652,3,13,9,10,46,45,1,48
FC Zürich,3652,4,11,10,11,40,34,6,43
St Gallen,3652,5,13,2,17,40,61,-21,41
FC Sion,3652,6,10,7,15,45,51,-6,37
FC Lugano,3652,7,10,7,15,34,49,-15,37
Grasshoppers,3652,8,9,7,16,41,51,-10,34
FC Thun,3652,9,8,6,18,42,61,-19,30
Young Boys,3653,1,20,9,3,71,34,37,69
FC Basel,3653,2,16,11,5,54,26,28,59
St Gallen,3653,3,14,5,13,46,56,-10,47
FC Zürich,3653,4,10,12,10,41,36,5,42
Lucerne,3653,5,11,9,12,42,50,-8,42
Grasshoppers,3653,6,10,7,15,44,52,-8,37
FC Lugano,3653,7,9,9,14,33,48,-15,36
FC Thun,3653,8,9,8,15,43,57,-14,35
FC Sion,3653,9,6,8,18,42,57,-15,26
Young Boys,3654,1,23,6,3,69,31,38,75
FC Basel,3654,2,17,8,7,54,26,28,59
FC Zürich,3654,3,13,9,10,45,35,10,48
St Gallen,3654,4,14,4,14,44,54,-10,46
Lucerne,3654,5,11,8,13,41,48,-7,41
FC Lugano,3654,6,11,6,15,32,47,-15,39
Grasshoppers,3654,7,10,6,16,42,49,-7,36
FC Thun,3654,8,10,5,17,46,59,-13,35
FC Sion,3654,9,5,8,19,38,62,-24,23
Young Boys,3655,1,21,7,4,71,34,37,70
FC Basel,3655,2,18,8,6,52,23,29,62
Lucerne,3655,3,15,7,10,47,41,6,52
FC Zürich,3655,4,11,11,10,42,35,7,44
St Gallen,3655,5,14,2,16,40,56,-16,44
FC Lugano,3655,6,10,6,16,31,48,-17,36
FC Thun,3655,7,10,5,17,47,60,-13,35
Grasshoppers,3655,8,8,8,16,44,58,-14,32
FC Sion,3655,9,6,8,18,41,60,-19,26
Young Boys,3656,1,23,7,2,71,32,39,76
FC Basel,3656,2,17,7,8,51,25,26,58
St Gallen,3656,3,16,2,14,43,52,-9,50
FC Zürich,3656,4,10,12,10,41,36,5,42
Lucerne,3656,5,11,7,14,39,48,-9,40
Grasshoppers,3656,6,10,6,16,43,50,-7,36
FC Lugano,3656,7,10,6,16,31,47,-16,36
FC Thun,3656,8,9,6,17,41,61,-20,33
FC Sion,3656,9,7,9,16,44,53,-9,30
Young Boys,3657,1,22,6,4,74,37,37,72
FC Basel,3657,2,17,8,7,51,25,26,59
St Gallen,3657,3,14,3,15,43,57,-14,45
FC Zürich,3657,4,11,11,10,41,34,7,44
Lucerne,3657,5,11,10,11,40,46,-6,43
Grasshoppers,3657,6,10,7,15,45,53,-8,37
FC Thun,3657,7,10,6,16,46,59,-13,36
FC Lugano,3657,8,10,6,16,33,47,-14,36
FC Sion,3657,9,7,7,18,43,58,-15,28
Young Boys,3658,1,20,6,6,64,35,29,66
FC Basel,3658,2,19,8,5,56,25,31,65
Lucerne,3658,3,14,7,11,43,44,-1,49
FC Zürich,3658,4,12,9,11,43,36,7,45
St Gallen,3658,5,13,5,14,45,58,-13,44
Grasshoppers,3658,6,11,6,15,41,47,-6,39
FC Lugano,3658,7,10,6,16,33,48,-15,36
FC Thun,3658,8,9,5,18,42,60,-18,32
FC Sion,3658,9,6,8,18,41,55,-14,26
Young Boys,3659,1,22,7,3,70,35,35,73
FC Basel,3659,2,18,7,7,51,25,26,61
Lucerne,3659,3,14,7,11,46,44,2,49
FC Zürich,3659,4,11,10,11,45,37,8,43
St Gallen,3659,5,13,3,16,40,56,-16,42
FC Lugano,3659,6,11,6,15,31,45,-14,39
Grasshoppers,3659,7,10,6,16,45,52,-7,36
FC Thun,3659,8,9,5,18,44,64,-20,32
FC Sion,3659,9,6,9,17,43,57,-14,27
Young Boys,3660,1,20,6,6,66,38,28,66
FC Basel,3660,2,16,10,6,52,25,27,58
Lucerne,3660,3,12,10,10,40,41,-1,46
FC Lugano,3660,4,13,5,14,40,45,-5,44
St Gallen,3660,5,13,4,15,44,61,-17,43
FC Zürich,3660,6,11,9,12,42,40,2,42
Grasshoppers,3660,7,9,9,14,44,51,-7,36
FC Thun,3660,8,9,7,16,44,59,-15,34
FC Sion,3660,9,7,8,17,44,56,-12,29
Young Boys,3661,1,22,6,4,70,34,36,72
FC Basel,3661,2,18,8,6,55,25,30,62
St Gallen,3661,3,16,2,14,47,53,-6,50
Lucerne,3661,4,12,8,12,41,46,-5,44
FC Zürich,3661,5,9,10,13,40,39,1,37
Grasshoppers,3661,6,10,7,15,42,50,-8,37
FC Thun,3661,7,10,5,17,43,59,-16,35
FC Lugano,3661,8,10,5,17,29,47,-18,35
FC Sion,3661,9,8,7,17,41,55,-14,31
Young Boys,3662,1,23,6,3,74,35,39,75
FC Basel,3662,2,17,9,6,56,24,32,60
St Gallen,3662,3,14,4,14,41,52,-11,46
Lucerne,3662,4,11,8,13,42,52,-10,41
Grasshoppers,3662,5,11,6,15,47,52,-5,39
FC Lugano,3662,6,11,6,15,32,45,-13,39
FC Zürich,3662,7,9,11,12,37,35,2,38
FC Thun,3662,8,10,5,17,44,61,-17,35
FC Sion,3662,9,6,9,17,39,56,-17,27
Young Boys,3663,1,22,7,3,73,36,37,73
FC Basel,3663,2,17,10,5,55,22,33,61
Lucerne,3663,3,13,8,11,42,43,-1,47
St Gallen,3663,4,15,2,15,43,56,-13,47
FC Zürich,3663,5,9,12,11,37,35,2,39
FC Lugano,3663,6,11,5,16,37,51,-14,38
Grasshoppers,3663,7,10,6,16,41,47,-6,36
FC Thun,3663,8,8,6,18,38,65,-27,30
FC Sion,3663,9,7,8,17,40,51,-11,29
Young Boys,3664,1,22,7,3,68,32,36,73
FC Basel,3664,2,17,9,6,54,29,25,60
FC Zürich,3664,3,12,9,11,45,34,11,45
St Gallen,3664,4,14,3,15,47,58,-11,45
Lucerne,3664,5,11,7,14,43,51,-8,40
Grasshoppers,3664,6,11,6,15,44,50,-6,39
FC Lugano,3664,7,11,5,16,35,49,-14,38
FC Thun,3664,8,9,5,18,40,59,-19,32
FC Sion,3664,9,8,7,17,39,53,-14,31
Young Boys,3665,1,22,7,3,70,34,36,73
FC Basel,3665,2,16,9,7,49,26,23,57
FC Zürich,3665,3,12,10,10,47,34,13,46
Lucerne,3665,4,12,9,11,39,42,-3,45
St Gallen,3665,5,14,3,15,44,55,-11,45
Grasshoppers,3665,6,8,10,14,40,48,-8,34
FC Lugano,3665,7,9,6,17,32,50,-18,33
FC Thun,3665,8,8,8,16,43,59,-16,32
FC Sion,3665,9,8,8,16,41,57,-16,32
Young Boys,3666,1,24,6,2,77,32,45,78
FC Basel,3666,2,17,7,8,53,29,24,58
Lucerne,3666,3,14,8,10,46,42,4,50
St Gallen,3666,4,15,3,14,43,51,-8,48
FC Zürich,3666,5,9,11,12,38,36,2,38
FC Lugano,3666,6,10,5,17,30,48,-18,35
Grasshoppers,3666,7,8,8,16,40,57,-17,32
FC Thun,3666,8,8,7,17,41,60,-19,31
FC Sion,3666,9,7,9,16,39,52,-13,30
Young Boys,3667,1,21,7,4,70,35,35,70
FC Basel,3667,2,16,8,8,49,31,18,56
Lucerne,3667,3,13,7,12,43,43,0,46
St Gallen,3667,4,14,4,14,44,54,-10,46
FC Zürich,3667,5,11,10,11,45,36,9,43
Grasshoppers,3667,6,12,6,14,48,48,0,42
FC Thun,3667,7,10,5,17,48,61,-13,35
FC Lugano,3667,8,9,7,16,34,54,-20,34
FC Sion,3667,9,7,8,17,40,59,-19,29
Young Boys,3668,1,24,6,2,79,33,46,78
FC Basel,3668,2,15,8,9,50,32,18,53
St Gallen,3668,3,15,4,13,46,55,-9,49
Lucerne,3668,4,13,8,11,42,43,-1,47
FC Zürich,3668,5,10,10,12,42,38,4,40
FC Thun,3668,6,10,7,15,44,56,-12,37
FC Lugano,3668,7,10,6,16,31,50,-19,36
Grasshoppers,3668,8,9,7,16,41,50,-9,34
FC Sion,3668,9,5,10,17,43,61,-18,25
Young Boys,3669,1,23,6,3,74,37,37,75
FC Basel,3669,2,19,7,6,56,24,32,64
St Gallen,3669,3,14,3,15,41,53,-12,45
FC Zürich,3669,4,11,10,11,39,34,5,43
Lucerne,3669,5,11,9,12,38,44,-6,42
FC Lugano,3669,6,11,5,16,32,47,-15,38
Grasshoppers,3669,7,9,8,15,38,47,-9,35
FC Thun,3669,8,9,6,17,39,57,-18,33
FC Sion,3669,9,6,8,18,40,54,-14,26
Young Boys,3670,1,21,6,5,70,40,30,69
FC Basel,3670,2,19,8,5,58,26,32,65
Lucerne,3670,3,14,8,10,47,41,6,50
St Gallen,3670,4,13,5,14,41,53,-12,44
FC Zürich,3670,5,11,10,11,44,38,6,43
Grasshoppers,3670,6,10,6,16,43,53,-10,36
FC Lugano,3670,7,10,6,16,35,50,-15,36
FC Thun,3670,8,8,7,17,46,65,-19,31
FC Sion,3670,9,6,8,18,40,58,-18,26
Young Boys,3671,1,21,8,3,77,38,39,71
FC Basel,3671,2,17,9,6,56,27,29,60
St Gallen,3671,3,15,3,14,43,53,-10,48
Lucerne,3671,4,13,7,12,46,51,-5,46
FC Zürich,3671,5,11,9,12,42,42,0,42
FC Thun,3671,6,11,5,16,49,61,-12,38
Grasshoppers,3671,7,10,6,16,43,52,-9,36
FC Lugano,3671,8,10,6,16,32,48,-16,36
FC Sion,3671,9,6,7,19,41,57,-16,25
Young Boys,3672,1,23,6,3,75,35,40,75
FC Basel,3672,2,17,8,7,54,27,27,59
St Gallen,3672,3,16,3,13,43,50,-7,51
Lucerne,3672,4,12,8,12,40,44,-4,44
FC Zürich,3672,5,11,10,11,39,34,5,43
FC Lugano,3672,6,10,6,16,29,46,-17,36
FC Thun,3672,7,9,7,16,42,58,-16,34
Grasshoppers,3672,8,8,7,17,37,49,-12,31
FC Sion,3672,9,7,7,18,38,54,-16,28
Young Boys,3673,1,21,7,4,69,34,35,70
FC Basel,3673,2,19,8,5,58,26,32,65
St Gallen,3673,3,15,2,15,47,57,-10,47
Lucerne,3673,4,11,10,11,38,43,-5,43
FC Zürich,3673,5,10,9,13,42,41,1,39
FC Lugano,3673,6,11,6,15,29,43,-14,39
Grasshoppers,3673,7,10,7,15,40,48,-8,37
FC Thun,3673,8,10,6,16,48,58,-10,36
FC Sion,3673,9,6,7,19,42,63,-21,25
Young Boys,3674,1,23,6,3,73,35,38,75
FC Basel,3674,2,18,8,6,54,24,30,62
Lucerne,3674,3,12,7,13,39,46,-7,43
St Gallen,3674,4,13,3,16,41,58,-17,42
FC Zürich,3674,5,10,10,12,40,39,1,40
Grasshoppers,3674,6,11,6,15,43,48,-5,39
FC Lugano,3674,7,11,5,16,35,48,-13,38
FC Thun,3674,8,10,6,16,45,58,-13,36
FC Sion,3674,9,6,9,17,39,53,-14,27
Young Boys,3675,1,19,7,6,66,37,29,64
FC Basel,3675,2,17,10,5,53,24,29,61
Lucerne,3675,3,14,9,9,45,41,4,51
St Gallen,3675,4,14,3,15,41,55,-14,45
FC Zürich,3675,5,9,13,10,39,35,4,40
FC Lugano,3675,6,11,6,15,33,47,-14,39
FC Thun,3675,7,9,8,15,44,57,-13,35
Grasshoppers,3675,8,9,7,16,40,50,-10,34
FC Sion,3675,9,6,9,17,38,53,-15,27
Young Boys,3676,1,23,7,2,74,31,43,76
FC Basel,3676,2,18,8,6,56,25,31,62
Lucerne,3676,3,14,7,11,42,46,-4,49
St Gallen,3676,4,13,4,15,41,54,-13,43
FC Zürich,3676,5,11,9,12,41,36,5,42
FC Lugano,3676,6,10,6,16,33,51,-18,36
Grasshoppers,3676,7,9,8,15,39,46,-7,35
FC Thun,3676,8,9,6,17,42,60,-18,33
FC Sion,3676,9,6,7,19,37,56,-19,25
Young Boys,3677,1,23,7,2,73,34,39,76
FC Basel,3677,2,17,10,5,56,28,28,61
Lucerne,3677,3,12,8,12,43,48,-5,44
St Gallen,3677,4,13,3,16,44,60,-16,42
FC Zürich,3677,5,10,11,11,41,37,4,41
FC Lugano,3677,6,12,5,15,34,46,-12,41
FC Thun,3677,7,10,6,16,45,58,-13,36
Grasshoppers,3677,8,9,6,17,41,51,-10,33
FC Sion,3677,9,6,8,18,45,60,-15,26
Young Boys,3678,1,20,6,6,67,39,28,66
FC Basel,3678,2,18,8,6,59,27,32,62
Lucerne,3678,3,12,10,10,44,44,0,46
St Gallen,3678,4,14,4,14,42,55,-13,46
FC Zürich,3678,5,11,10,11,44,40,4,43
FC Lugano,3678,6,10,8,14,30,44,-14,38
Grasshoppers,3678,7,9,8,15,39,47,-8,35
FC Thun,3678,8,9,6,17,45,61,-16,33
FC Sion,3678,9,7,8,17,41,54,-13,29
Young Boys,3679,1,23,6,3,74,35,39,75
FC Basel,3679,2,17,8,7,55,26,29,59
St Gallen,3679,3,15,3,14,43,54,-11,48
FC Zürich,3679,4,12,9,11,43,38,5,45
Lucerne,3679,5,11,9,12,40,45,-5,42
FC Lugano,3679,6,11,6,15,34,47,-13,39
Grasshoppers,3679,7,10,7,15,42,51,-9,37
FC Thun,3679,8,8,7,17,43,61,-18,31
FC Sion,3679,9,6,7,19,40,57,-17,25
Young Boys,3680,1,21,9,2,72,36,36,72
FC Basel,3680,2,16,9,7,49,25,24,57
St Gallen,3680,3,15,4,13,45,53,-8,49
FC Zürich,3680,4,11,9,12,39,38,1,42
Lucerne,3680,5,11,9,12,39,44,-5,42
FC Lugano,3680,6,11,6,15,36,47,-11,39
Grasshoppers,3680,7,10,6,16,43,51,-8,36
FC Thun,3680,8,10,5,17,42,57,-15,35
FC Sion,3680,9,6,9,17,43,57,-14,27
Young Boys,3681,1,22,7,3,72,34,38,73
FC Basel,3681,2,17,8,7,53,28,25,59
Lucerne,3681,3,14,7,11,45,43,2,49
St Gallen,3681,4,14,3,15,43,56,-13,45
FC Zürich,3681,5,11,9,12,41,36,5,42
Grasshoppers,3681,6,9,8,15,40,51,-11,35
FC Lugano,3681,7,10,5,17,32,49,-17,35
FC Thun,3681,8,9,6,17,41,59,-18,33
FC Sion,3681,9,7,9,16,41,52,-11,30
Young Boys,3682,1,19,10,3,66,33,33,67
FC Basel,3682,2,16,9,7,53,29,24,57
Lucerne,3682,3,12,9,11,42,44,-2,45
St Gallen,3682,4,14,3,15,42,54,-12,45
Grasshoppers,3682,5,11,6,15,47,47,0,39
FC Lugano,3682,6,11,6,15,33,49,-16,39
FC Thun,3682,7,11,5,16,46,58,-12,38
FC Zürich,3682,8,9,10,13,38,38,0,37
FC Sion,3682,9,8,8,16,40,55,-15,32
Young Boys,3683,1,22,7,3,75,33,42,73
FC Basel,3683,2,18,7,7,54,28,26,61
Lucerne,3683,3,14,9,9,44,40,4,51
FC Zürich,3683,4,12,10,10,43,34,9,46
St Gallen,3683,5,13,4,15,39,55,-16,43
FC Thun,3683,6,10,5,17,46,57,-11,35
FC Lugano,3683,7,9,8,15,29,46,-17,35
Grasshoppers,3683,8,9,6,17,39,52,-13,33
FC Sion,3683,9,5,8,19,34,58,-24,23
Young Boys,3684,1,20,7,5,69,37,32,67
FC Basel,3684,2,19,8,5,57,23,34,65
St Gallen,3684,3,15,2,15,43,54,-11,47
Lucerne,3684,4,12,9,11,42,45,-3,45
FC Zürich,3684,5,11,10,11,43,35,8,43
Grasshoppers,3684,6,10,7,15,41,47,-6,37
FC Thun,3684,7,9,8,15,44,57,-13,35
FC Lugano,3684,8,9,5,18,28,51,-23,32
FC Sion,3684,9,7,8,17,38,56,-18,29
Young Boys,3685,1,21,8,3,74,38,36,71
FC Basel,3685,2,17,8,7,53,27,26,59
Lucerne,3685,3,13,8,11,40,41,-1,47
St Gallen,3685,4,14,5,13,44,54,-10,47
FC Zürich,3685,5,10,10,12,40,39,1,40
Grasshoppers,3685,6,11,7,14,46,51,-5,40
FC Thun,3685,7,10,6,16,47,58,-11,36
FC Lugano,3685,8,9,7,16,31,48,-17,34
FC Sion,3685,9,5,9,18,40,59,-19,24
Young Boys,3686,1,23,6,3,70,32,38,75
FC Basel,3686,2,19,7,6,54,24,30,64
FC Zürich,3686,3,12,10,10,46,37,9,46
Lucerne,3686,4,13,7,12,41,44,-3,46
St Gallen,3686,5,14,2,16,43,56,-13,44
FC Lugano,3686,6,10,6,16,33,49,-16,36
FC Thun,3686,7,10,5,17,46,61,-15,35
Grasshoppers,3686,8,8,6,18,39,52,-13,30
FC Sion,3686,9,7,7,18,40,57,-17,28
Young Boys,3687,1,22,8,2,70,33,37,74
FC Basel,3687,2,17,7,8,50,26,24,58
Lucerne,3687,3,14,8,10,46,46,0,50
St Gallen,3687,4,16,2,14,48,55,-7,50
FC Zürich,3687,5,11,10,11,39,34,5,43
FC Thun,3687,6,9,6,17,43,56,-13,33
Grasshoppers,3687,7,9,6,17,42,56,-14,33
FC Lugano,3687,8,9,5,18,27,47,-20,32
FC Sion,3687,9,7,8,17,40,52,-12,29
Young Boys,3688,1,21,7,4,72,34,38,70
FC Basel,3688,2,16,8,8,52,29,23,56
Lucerne,3688,3,14,8,10,46,45,1,50
St Gallen,3688,4,15,4,13,47,51,-4,49
FC Zürich,3688,5,10,9,13,41,41,0,39
Grasshoppers,3688,6,11,6,15,45,48,-3,39
FC Thun,3688,7,11,5,16,45,58,-13,38
FC Lugano,3688,8,10,6,16,29,49,-20,36
FC Sion,3688,9,6,7,19,41,63,-22,25
Young Boys,3689,1,22,6,4,68,34,34,72
FC Basel,3689,2,18,9,5,53,24,29,63
Lucerne,3689,3,13,8,11,41,40,1,47
St Gallen,3689,4,14,4,14,41,53,-12,46
FC Zürich,3689,5,11,9,12,45,39,6,42
FC Lugano,3689,6,11,5,16,31,46,-15,38
Grasshoppers,3689,7,9,6,17,38,49,-11,33
FC Thun,3689,8,9,5,18,42,62,-20,32
FC Sion,3689,9,7,8,17,41,53,-12,29
Young Boys,3690,1,22,6,4,70,33,37,72
FC Basel,3690,2,19,8,5,54,23,31,65
St Gallen,3690,3,14,4,14,44,54,-10,46
Lucerne,3690,4,12,9,11,42,48,-6,45
FC Zürich,3690,5,11,9,12,44,39,5,42
Grasshoppers,3690,6,10,7,15,46,50,-4,37
FC Thun,3690,7,10,5,17,44,61,-17,35
FC Lugano,3690,8,10,5,17,29,48,-19,35
FC Sion,3690,9,6,7,19,39,56,-17,25
Young Boys,3691,1,22,7,3,76,33,43,73
FC Basel,3691,2,16,10,6,51,27,24,58
Lucerne,3691,3,12,9,11,43,47,-4,45
St Gallen,3691,4,13,3,16,41,57,-16,42
FC Zürich,3691,5,9,13,10,40,36,4,40
FC Lugano,3691,6,10,8,14,29,43,-14,38
Grasshoppers,3691,7,10,7,15,46,51,-5,37
FC Thun,3691,8,9,8,15,44,58,-14,35
FC Sion,3691,9,6,9,17,39,57,-18,27
Young Boys,3692,1,21,7,4,71,34,37,70
FC Basel,3692,2,18,7,7,50,27,23,61
St Gallen,3692,3,16,2,14,47,50,-3,50
FC Zürich,3692,4,12,10,10,44,34,10,46
Lucerne,3692,5,12,8,12,41,45,-4,44
FC Lugano,3692,6,11,6,15,31,47,-16,39
Grasshoppers,3692,7,9,8,15,43,49,-6,35
FC Thun,3692,8,8,5,19,39,62,-23,29
FC Sion,3692,9,7,7,18,40,58,-18,28
Young Boys,3693,1,22,7,3,73,34,39,73
FC Basel,3693,2,19,8,5,56,23,33,65
St Gallen,3693,3,14,5,13,43,53,-10,47
FC Zürich,3693,4,11,10,11,41,37,4,43
Lucerne,3693,5,11,9,12,39,47,-8,42
FC Thun,3693,6,10,6,16,44,56,-12,36
Grasshoppers,3693,7,9,7,16,42,51,-9,34
FC Lugano,3693,8,9,6,17,31,51,-20,33
FC Sion,3693,9,6,8,18,40,57,-17,26
Young Boys,3694,1,24,6,2,79,30,49,78
FC Basel,3694,2,18,8,6,58,26,32,62
Lucerne,3694,3,12,9,11,42,46,-4,45
St Gallen,3694,4,13,3,16,42,57,-15,42
FC Zürich,3694,5,9,11,12,39,38,1,38
FC Lugano,3694,6,11,5,16,31,51,-20,38
Grasshoppers,3694,7,10,6,16,40,48,-8,36
FC Thun,3694,8,10,6,16,45,65,-20,36
FC Sion,3694,9,6,8,18,42,57,-15,26
Young Boys,3695,1,21,6,5,71,37,34,69
FC Basel,3695,2,17,8,7,49,26,23,59
Lucerne,3695,3,13,8,11,45,45,0,47
St Gallen,3695,4,15,2,15,48,56,-8,47
FC Zürich,3695,5,11,9,12,40,36,4,42
Grasshoppers,3695,6,11,7,14,45,47,-2,40
FC Sion,3695,7,9,7,16,47,54,-7,34
FC Thun,3695,8,9,6,17,44,62,-18,33
FC Lugano,3695,9,9,5,18,29,55,-26,32
Young Boys,3696,1,20,7,5,68,38,30,67
FC Basel,3696,2,18,9,5,56,25,31,63
Lucerne,3696,3,12,8,12,40,44,-4,44
St Gallen,3696,4,14,2,16,39,57,-18,44
FC Lugano,3696,5,12,6,14,35,44,-9,42
FC Zürich,3696,6,10,11,11,43,36,7,41
FC Thun,3696,7,11,6,15,47,57,-10,39
FC Sion,3696,8,8,7,17,43,55,-12,31
Grasshoppers,3696,9,8,6,18,39,54,-15,30
Young Boys,3697,1,24,6,2,74,33,41,78
FC Basel,3697,2,19,7,6,57,25,32,64
Lucerne,3697,3,13,7,12,42,44,-2,46
St Gallen,3697,4,14,4,14,45,57,-12,46
FC Zürich,3697,5,11,9,12,43,40,3,42
FC Lugano,3697,6,10,6,16,33,52,-19,36
FC Thun,3697,7,9,6,17,45,61,-16,33
Grasshoppers,3697,8,8,6,18,39,54,-15,30
FC Sion,3697,9,6,9,17,45,57,-12,27
FC Basel,3698,1,19,8,5,58,22,36,65
Young Boys,3698,2,19,8,5,65,34,31,65
St Gallen,3698,3,14,4,14,42,52,-10,46
Lucerne,3698,4,12,8,12,40,45,-5,44
FC Zürich,3698,5,10,10,12,39,38,1,40
FC Lugano,3698,6,11,6,15,32,46,-14,39
Grasshoppers,3698,7,9,9,14,43,50,-7,36
FC Thun,3698,8,9,6,17,45,65,-20,33
FC Sion,3698,9,7,9,16,38,50,-12,30
Young Boys,3699,1,22,6,4,74,35,39,72
FC Basel,3699,2,17,8,7,55,28,27,59
St Gallen,3699,3,15,2,15,43,54,-11,47
FC Zürich,3699,4,11,11,10,43,36,7,44
Lucerne,3699,5,12,8,12,41,45,-4,44
Grasshoppers,3699,6,10,8,14,39,45,-6,38
FC Lugano,3699,7,10,6,16,34,54,-20,36
FC Thun,3699,8,8,8,16,43,60,-17,32
FC Sion,3699,9,7,7,18,40,55,-15,28
Young Boys,3700,1,21,7,4,67,35,32,70
FC Basel,3700,2,16,9,7,55,30,25,57
Lucerne,3700,3,15,7,10,44,39,5,52
St Gallen,3700,4,13,5,14,43,56,-13,44
FC Zürich,3700,5,11,10,11,46,41,5,43
Grasshoppers,3700,6,10,7,15,39,46,-7,37
FC Thun,3700,7,10,6,16,44,58,-14,36
FC Lugano,3700,8,9,6,17,30,49,-19,33
FC Sion,3700,9,6,9,17,41,55,-14,27
Young Boys,3701,1,21,7,4,71,37,34,70
FC Basel,3701,2,17,7,8,51,24,27,58
St Gallen,3701,3,15,4,13,42,50,-8,49
Lucerne,3701,4,13,9,10,45,43,2,48
FC Zürich,3701,5,11,10,11,41,36,5,43
Grasshoppers,3701,6,11,7,14,42,46,-4,40
FC Thun,3701,7,10,5,17,42,59,-17,35
FC Lugano,3701,8,9,6,17,31,53,-22,33
FC Sion,3701,9,5,9,18,40,57,-17,24
Young Boys,3702,1,21,9,2,71,33,38,72
FC Basel,3702,2,18,8,6,54,27,27,62
St Gallen,3702,3,15,2,15,43,54,-11,47
Lucerne,3702,4,13,7,12,46,45,1,46
FC Zürich,3702,5,11,9,12,40,36,4,42
FC Thun,3702,6,11,6,15,44,55,-11,39
Grasshoppers,3702,7,9,8,15,38,48,-10,35
FC Lugano,3702,8,9,5,18,27,51,-24,32
FC Sion,3702,9,6,8,18,38,52,-14,26
Young Boys,3703,1,22,7,3,71,36,35,73
FC Basel,3703,2,19,7,6,65,27,38,64
FC Zürich,3703,3,12,10,10,44,36,8,46
St Gallen,3703,4,14,2,16,46,58,-12,44
Lucerne,3703,5,11,8,13,38,50,-12,41
FC Lugano,3703,6,11,5,16,30,46,-16,38
FC Thun,3703,7,9,6,17,41,62,-21,33
Grasshoppers,3703,8,8,8,16,37,48,-11,32
FC Sion,3703,9,7,9,16,42,51,-9,30
Young Boys,3704,1,22,6,4,70,32,38,72
FC Basel,3704,2,17,8,7,55,24,31,59
Lucerne,3704,3,13,8,11,42,50,-8,47
St Gallen,3704,4,13,2,17,41,61,-20,41
FC Zürich,3704,5,9,12,11,38,35,3,39
Grasshoppers,3704,6,10,7,15,44,51,-7,37
FC Lugano,3704,7,10,7,15,31,45,-14,37
FC Sion,3704,8,9,8,15,45,51,-6,35
FC Thun,3704,9,9,6,17,42,59,-17,33
Young Boys,3705,1,20,7,5,66,35,31,67
FC Basel,3705,2,18,9,5,52,23,29,63
St Gallen,3705,3,15,2,15,43,53,-10,47
Lucerne,3705,4,12,10,10,43,44,-1,46
FC Zürich,3705,5,11,10,11,41,36,5,43
Grasshoppers,3705,6,9,8,15,40,48,-8,35
FC Sion,3705,7,9,7,16,42,50,-8,34
FC Lugano,3705,8,9,6,17,28,48,-20,33
FC Thun,3705,9,8,7,17,41,59,-18,31
Young Boys,3706,1,21,8,3,70,36,34,71
FC Basel,3706,2,18,7,7,58,26,32,61
St Gallen,3706,3,16,2,14,46,54,-8,50
Lucerne,3706,4,13,8,11,44,46,-2,47
FC Zürich,3706,5,10,10,12,44,40,4,40
FC Thun,3706,6,10,7,15,47,60,-13,37
FC Lugano,3706,7,10,6,16,32,48,-16,36
Grasshoppers,3706,8,9,6,17,42,52,-10,33
FC Sion,3706,9,6,8,18,42,63,-21,26
Young Boys,3707,1,22,6,4,71,33,38,72
FC Basel,3707,2,17,8,7,56,28,28,59
Lucerne,3707,3,13,8,11,41,45,-4,47
FC Zürich,3707,4,12,9,11,45,39,6,45
St Gallen,3707,5,13,4,15,40,53,-13,43
Grasshoppers,3707,6,10,6,16,39,47,-8,36
FC Lugano,3707,7,10,6,16,31,49,-18,36
FC Thun,3707,8,10,5,17,48,61,-13,35
FC Sion,3707,9,7,8,17,39,55,-16,29
Young Boys,3708,1,22,8,2,73,34,39,74
FC Basel,3708,2,18,8,6,55,25,30,62
St Gallen,3708,3,14,4,14,43,55,-12,46
FC Zürich,3708,4,12,9,11,42,34,8,45
Lucerne,3708,5,11,8,13,39,47,-8,41
Grasshoppers,3708,6,11,6,15,45,49,-4,39
FC Thun,3708,7,10,5,17,44,60,-16,35
FC Lugano,3708,8,9,7,16,29,47,-18,34
FC Sion,3708,9,5,9,18,36,55,-19,24
Young Boys,3709,1,22,7,3,73,34,39,73
FC Basel,3709,2,18,9,5,53,24,29,63
St Gallen,3709,3,15,3,14,45,54,-9,48
Lucerne,3709,4,13,7,12,44,44,0,46
FC Zürich,3709,5,10,12,10,39,34,5,42
Grasshoppers,3709,6,9,7,16,44,53,-9,34
FC Thun,3709,7,9,7,16,42,57,-15,34
FC Lugano,3709,8,9,7,16,31,49,-18,34
FC Sion,3709,9,5,9,18,37,59,-22,24
Young Boys,3710,1,20,8,4,68,35,33,68
FC Basel,3710,2,18,8,6,56,24,32,62
St Gallen,3710,3,15,3,14,43,55,-12,48
Lucerne,3710,4,12,7,13,45,50,-5,43
FC Zürich,3710,5,10,10,12,40,39,1,40
Grasshoppers,3710,6,10,7,15,42,49,-7,37
FC Lugano,3710,7,10,6,16,33,51,-18,36
FC Thun,3710,8,9,7,16,42,57,-15,34
FC Sion,3710,9,8,8,16,45,54,-9,32
Young Boys,3711,1,20,7,5,70,38,32,67
FC Basel,3711,2,18,7,7,55,31,24,61
St Gallen,3711,3,14,5,13,44,53,-9,47
Lucerne,3711,4,12,8,12,43,46,-3,44
FC Zürich,3711,5,11,10,11,42,34,8,43
FC Lugano,3711,6,12,6,14,31,43,-12,42
Grasshoppers,3711,7,11,6,15,45,52,-7,39
FC Thun,3711,8,8,6,18,40,60,-20,30
FC Sion,3711,9,6,9,17,40,53,-13,27
Young Boys,3712,1,20,8,4,69,35,34,68
FC Basel,3712,2,18,8,6,54,26,28,62
Lucerne,3712,3,14,8,10,42,40,2,50
FC Zürich,3712,4,13,9,10,46,33,13,48
St Gallen,3712,5,14,3,15,43,56,-13,45
FC Lugano,3712,6,10,5,17,34,51,-17,35
FC Thun,3712,7,9,6,17,41,60,-19,33
Grasshoppers,3712,8,8,7,17,39,54,-15,31
FC Sion,3712,9,7,8,17,41,54,-13,29
Young Boys,3713,1,21,7,4,70,34,36,70
FC Basel,3713,2,16,9,7,54,30,24,57
Lucerne,3713,3,13,9,10,45,45,0,48
St Gallen,3713,4,14,2,16,42,54,-12,44
FC Zürich,3713,5,11,9,12,40,38,2,42
FC Lugano,3713,6,12,5,15,31,45,-14,41
Grasshoppers,3713,7,9,8,15,39,48,-9,35
FC Thun,3713,8,9,7,16,43,57,-14,34
FC Sion,3713,9,6,10,16,37,50,-13,28
Young Boys,3714,1,21,7,4,73,40,33,70
FC Basel,3714,2,18,7,7,57,25,32,61
FC Zürich,3714,3,12,9,11,47,38,9,45
Lucerne,3714,4,12,9,11,41,44,-3,45
St Gallen,3714,5,13,3,16,40,59,-19,42
Grasshoppers,3714,6,11,6,15,44,46,-2,39
FC Thun,3714,7,11,5,16,44,58,-14,38
FC Lugano,3714,8,11,5,16,36,51,-15,38
FC Sion,3714,9,6,7,19,40,61,-21,25
Young Boys,3715,1,21,8,3,71,34,37,71
FC Basel,3715,2,18,8,6,54,27,27,62
Lucerne,3715,3,13,9,10,41,43,-2,48
St Gallen,3715,4,14,3,15,43,55,-12,45
Grasshoppers,3715,5,10,8,14,43,48,-5,38
FC Zürich,3715,6,9,10,13,38,38,0,37
FC Lugano,3715,7,10,6,16,31,48,-17,36
FC Thun,3715,8,9,6,17,43,59,-16,33
FC Sion,3715,9,7,8,17,39,51,-12,29
Young Boys,3716,1,20,7,5,68,38,30,67
FC Basel,3716,2,18,8,6,53,24,29,62
Lucerne,3716,3,13,7,12,40,44,-4,46
St Gallen,3716,4,14,2,16,43,58,-15,44
FC Lugano,3716,5,12,5,15,33,44,-11,41
Grasshoppers,3716,6,11,7,14,43,45,-2,40
FC Zürich,3716,7,9,10,13,41,41,0,37
FC Thun,3716,8,10,6,16,43,57,-14,36
FC Sion,3716,9,7,8,17,44,57,-13,29
Young Boys,3717,1,23,7,2,72,32,40,76
FC Basel,3717,2,16,9,7,52,27,25,57
St Gallen,3717,3,15,2,15,44,54,-10,47
FC Zürich,3717,4,11,11,10,45,39,6,44
Lucerne,3717,5,12,8,12,39,45,-6,44
FC Lugano,3717,6,10,7,15,32,47,-15,37
Grasshoppers,3717,7,10,6,16,43,50,-7,36
FC Thun,3717,8,8,7,17,43,61,-18,31
FC Sion,3717,9,6,9,17,42,57,-15,27
Young Boys,3718,1,21,7,4,69,34,35,70
FC Basel,3718,2,19,7,6,56,22,34,64
St Gallen,3718,3,15,4,13,44,53,-9,49
Lucerne,3718,4,13,7,12,41,42,-1,46
FC Zürich,3718,5,10,11,11,42,41,1,41
FC Thun,3718,6,9,7,16,50,60,-10,34
Grasshoppers,3718,7,9,7,16,41,54,-13,34
FC Lugano,3718,8,9,7,16,29,49,-20,34
FC Sion,3718,9,6,9,17,45,62,-17,27
Young Boys,3719,1,21,9,2,69,32,37,72
FC Basel,3719,2,17,8,7,52,27,25,59
St Gallen,3719,3,15,3,14,45,53,-8,48
Lucerne,3719,4,11,12,9,38,39,-1,45
FC Zürich,3719,5,9,11,12,40,40,0,38
FC Lugano,3719,6,10,7,15,32,46,-14,37
Grasshoppers,3719,7,9,9,14,43,47,-4,36
FC Thun,3719,8,10,6,16,44,60,-16,36
FC Sion,3719,9,5,9,18,38,57,-19,24
Young Boys,3720,1,22,6,4,71,35,36,72
FC Basel,3720,2,20,7,5,56,23,33,67
Lucerne,3720,3,13,8,11,40,43,-3,47
St Gallen,3720,4,13,4,15,42,56,-14,43
FC Zürich,3720,5,11,9,12,43,39,4,42
FC Thun,3720,6,10,6,16,49,58,-9,36
Grasshoppers,3720,7,9,7,16,39,52,-13,34
FC Lugano,3720,8,9,6,17,31,50,-19,33
FC Sion,3720,9,6,9,17,38,53,-15,27
Young Boys,3721,1,22,7,3,72,36,36,73
FC Basel,3721,2,20,7,5,58,22,36,67
Lucerne,3721,3,14,7,11,47,43,4,49
St Gallen,3721,4,14,2,16,43,58,-15,44
FC Zürich,3721,5,10,11,11,42,37,5,41
FC Lugano,3721,6,10,6,16,30,49,-19,36
Grasshoppers,3721,7,9,7,16,41,54,-13,34
FC Thun,3721,8,9,5,18,43,62,-19,32
FC Sion,3721,9,6,8,18,40,55,-15,26
Young Boys,3722,1,22,7,3,73,35,38,73
FC Basel,3722,2,19,8,5,56,26,30,65
St Gallen,3722,3,14,3,15,44,59,-15,45
Lucerne,3722,4,12,8,12,42,44,-2,44
FC Zürich,3722,5,11,9,12,41,37,4,42
FC Lugano,3722,6,10,7,15,33,48,-15,37
Grasshoppers,3722,7,9,6,17,45,57,-12,33
FC Thun,3722,8,9,6,17,48,64,-16,33
FC Sion,3722,9,7,8,17,42,54,-12,29
Young Boys,3723,1,22,7,3,75,35,40,73
FC Basel,3723,2,18,8,6,56,26,30,62
St Gallen,3723,3,16,3,13,47,50,-3,51
Lucerne,3723,4,12,8,12,42,47,-5,44
FC Zürich,3723,5,9,12,11,39,39,0,39
FC Thun,3723,6,11,5,16,47,59,-12,38
FC Lugano,3723,7,10,6,16,30,51,-21,36
Grasshoppers,3723,8,8,7,17,40,54,-14,31
FC Sion,3723,9,5,10,17,42,57,-15,25
Young Boys,3724,1,21,7,4,71,39,32,70
FC Basel,3724,2,20,7,5,59,25,34,67
St Gallen,3724,3,16,2,14,42,51,-9,50
Lucerne,3724,4,12,9,11,41,42,-1,45
FC Zürich,3724,5,10,10,12,41,36,5,40
Grasshoppers,3724,6,10,7,15,40,48,-8,37
FC Thun,3724,7,10,5,17,42,57,-15,35
FC Lugano,3724,8,9,7,16,30,47,-17,34
FC Sion,3724,9,5,8,19,39,60,-21,23
Young Boys,3725,1,20,6,6,70,40,30,66
FC Basel,3725,2,17,8,7,53,27,26,59
Lucerne,3725,3,14,7,11,43,44,-1,49
FC Zürich,3725,4,12,9,11,42,36,6,45
St Gallen,3725,5,14,3,15,42,54,-12,45
FC Thun,3725,6,11,6,15,45,56,-11,39
FC Lugano,3725,7,11,6,15,34,46,-12,39
Grasshoppers,3725,8,9,6,17,41,52,-11,33
FC Sion,3725,9,7,7,18,38,53,-15,28
Young Boys,3726,1,21,7,4,71,41,30,70
FC Basel,3726,2,18,8,6,57,24,33,62
St Gallen,3726,3,15,3,14,44,54,-10,48
Lucerne,3726,4,12,9,11,41,46,-5,45
FC Zürich,3726,5,9,12,11,41,38,3,39
FC Lugano,3726,6,11,6,15,34,48,-14,39
Grasshoppers,3726,7,10,6,16,44,49,-5,36
FC Thun,3726,8,9,5,18,41,62,-21,32
FC Sion,3726,9,7,8,17,45,56,-11,29
Young Boys,3727,1,24,6,2,81,36,45,78
FC Basel,3727,2,18,7,7,53,25,28,61
St Gallen,3727,3,16,2,14,44,52,-8,50
Lucerne,3727,4,13,8,11,43,46,-3,47
FC Zürich,3727,5,9,11,12,38,36,2,38
Grasshoppers,3727,6,10,6,16,44,50,-6,36
FC Thun,3727,7,10,5,17,43,60,-17,35
FC Lugano,3727,8,9,7,16,31,53,-22,34
FC Sion,3727,9,5,8,19,38,57,-19,23
Young Boys,3728,1,20,6,6,67,41,26,66
FC Basel,3728,2,18,9,5,58,23,35,63
Lucerne,3728,3,13,8,11,41,44,-3,47
St Gallen,3728,4,14,5,13,46,54,-8,47
FC Zürich,3728,5,10,9,13,38,38,0,39
FC Lugano,3728,6,11,6,15,35,48,-13,39
FC Thun,3728,7,10,6,16,42,58,-16,36
Grasshoppers,3728,8,9,6,17,38,49,-11,33
FC Sion,3728,9,7,9,16,42,52,-10,30
Young Boys,3729,1,21,7,4,71,35,36,70
FC Basel,3729,2,20,7,5,58,27,31,67
Lucerne,3729,3,13,7,12,41,42,-1,46
St Gallen,3729,4,14,2,16,42,55,-13,44
FC Zürich,3729,5,10,10,12,41,39,2,40
FC Lugano,3729,6,10,7,15,30,46,-16,37
FC Thun,3729,7,10,6,16,45,58,-13,36
FC Sion,3729,8,8,8,16,44,54,-10,32
Grasshoppers,3729,9,8,6,18,38,54,-16,30
Young Boys,3730,1,22,7,3,71,34,37,73
FC Basel,3730,2,18,9,5,56,23,33,63
Lucerne,3730,3,13,8,11,42,46,-4,47
FC Zürich,3730,4,11,11,10,41,34,7,44
St Gallen,3730,5,13,2,17,43,59,-16,41
FC Thun,3730,6,10,6,16,44,59,-15,36
FC Lugano,3730,7,10,5,17,32,50,-18,35
Grasshoppers,3730,8,8,8,16,40,51,-11,32
FC Sion,3730,9,7,8,17,43,56,-13,29
Young Boys,3731,1,21,7,4,71,36,35,70
FC Basel,3731,2,18,9,5,52,23,29,63
Lucerne,3731,3,14,8,10,45,43,2,50
St Gallen,3731,4,13,3,16,42,57,-15,42
FC Lugano,3731,5,12,5,15,32,45,-13,41
FC Zürich,3731,6,9,10,13,40,39,1,37
FC Sion,3731,7,9,7,16,44,54,-10,34
FC Thun,3731,8,9,6,17,48,62,-14,33
Grasshoppers,3731,9,8,7,17,40,55,-15,31
Young Boys,3732,1,21,7,4,71,35,36,70
FC Basel,3732,2,18,8,6,55,27,28,62
Lucerne,3732,3,12,10,10,44,45,-1,46
St Gallen,3732,4,14,4,14,43,54,-11,46
FC Zürich,3732,5,10,10,12,42,40,2,40
Grasshoppers,3732,6,11,7,14,43,48,-5,40
FC Lugano,3732,7,10,6,16,31,47,-16,36
FC Thun,3732,8,8,6,18,44,64,-20,30
FC Sion,3732,9,7,8,17,42,55,-13,29
Young Boys,3733,1,21,8,3,71,36,35,71
FC Basel,3733,2,16,10,6,56,29,27,58
St Gallen,3733,3,15,3,14,45,56,-11,48
Lucerne,3733,4,12,10,10,45,45,0,46
FC Zürich,3733,5,12,9,11,46,39,7,45
Grasshoppers,3733,6,10,8,14,46,49,-3,38
FC Lugano,3733,7,10,5,17,32,50,-18,35
FC Thun,3733,8,9,6,17,43,60,-17,33
FC Sion,3733,9,6,7,19,40,60,-20,25
Young Boys,3734,1,22,6,4,71,33,38,72
FC Basel,3734,2,17,8,7,50,27,23,59
Lucerne,3734,3,14,7,11,42,44,-2,49
St Gallen,3734,4,15,3,14,44,54,-10,48
FC Zürich,3734,5,11,11,10,43,34,9,44
Grasshoppers,3734,6,9,8,15,43,50,-7,35
FC Thun,3734,7,9,7,16,45,60,-15,34
FC Lugano,3734,8,9,6,17,29,49,-20,33
FC Sion,3734,9,5,10,17,36,52,-16,25
Young Boys,3735,1,20,8,4,74,39,35,68
FC Basel,3735,2,18,9,5,57,25,32,63
Lucerne,3735,3,14,9,9,48,44,4,51
St Gallen,3735,4,14,4,14,43,55,-12,46
FC Zürich,3735,5,12,9,11,45,35,10,45
Grasshoppers,3735,6,10,7,15,43,49,-6,37
FC Thun,3735,7,9,6,17,42,60,-18,33
FC Lugano,3735,8,9,6,17,30,54,-24,33
FC Sion,3735,9,5,8,19,37,58,-21,23
Young Boys,3736,1,23,7,2,77,33,44,76
FC Basel,3736,2,18,8,6,57,25,32,62
Lucerne,3736,3,13,8,11,43,47,-4,47
FC Zürich,3736,4,11,10,11,41,35,6,43
St Gallen,3736,5,13,3,16,41,57,-16,42
FC Lugano,3736,6,11,5,16,32,48,-16,38
FC Thun,3736,7,10,6,16,42,59,-17,36
Grasshoppers,3736,8,9,6,17,42,52,-10,33
FC Sion,3736,9,6,7,19,39,58,-19,25
Young Boys,3737,1,22,6,4,76,36,40,72
FC Basel,3737,2,19,8,5,53,22,31,65
St Gallen,3737,3,14,2,16,43,55,-12,44
FC Zürich,3737,4,11,10,11,45,35,10,43
Lucerne,3737,5,12,7,13,42,48,-6,43
FC Lugano,3737,6,11,5,16,34,53,-19,38
Grasshoppers,3737,7,9,8,15,44,54,-10,35
FC Thun,3737,8,9,6,17,47,64,-17,33
FC Sion,3737,9,7,8,17,43,60,-17,29
Young Boys,3738,1,23,7,2,71,32,39,76
FC Basel,3738,2,18,9,5,53,22,31,63
Lucerne,3738,3,12,9,11,39,41,-2,45
St Gallen,3738,4,14,3,15,40,54,-14,45
FC Zürich,3738,5,11,9,12,41,37,4,42
FC Thun,3738,6,11,5,16,47,60,-13,38
FC Lugano,3738,7,10,5,17,30,46,-16,35
Grasshoppers,3738,8,8,7,17,38,52,-14,31
FC Sion,3738,9,6,8,18,43,58,-15,26
Young Boys,3739,1,21,8,3,73,38,35,71
FC Basel,3739,2,17,7,8,55,31,24,58
St Gallen,3739,3,16,2,14,45,53,-8,50
Lucerne,3739,4,14,7,11,45,45,0,49
FC Zürich,3739,5,11,9,12,42,38,4,42
FC Lugano,3739,6,11,5,16,31,46,-15,38
FC Thun,3739,7,10,5,17,46,61,-15,35
Grasshoppers,3739,8,8,8,16,42,53,-11,32
FC Sion,3739,9,6,9,17,41,55,-14,27
Young Boys,3740,1,20,8,4,72,39,33,68
FC Basel,3740,2,18,8,6,54,28,26,62
Lucerne,3740,3,13,8,11,42,44,-2,47
St Gallen,3740,4,15,2,15,46,57,-11,47
FC Zürich,3740,5,9,10,13,39,41,-2,37
FC Lugano,3740,6,10,7,15,35,49,-14,37
FC Sion,3740,7,9,8,15,44,51,-7,35
FC Thun,3740,8,10,5,17,45,56,-11,35
Grasshoppers,3740,9,8,8,16,40,52,-12,32
Young Boys,3741,1,21,6,5,72,40,32,69
FC Basel,3741,2,19,8,5,65,25,40,65
St Gallen,3741,3,13,5,14,40,52,-12,44
Lucerne,3741,4,11,10,11,40,50,-10,43
FC Zürich,3741,5,9,11,12,38,38,0,38
Grasshoppers,3741,6,10,8,14,46,50,-4,38
FC Lugano,3741,7,10,7,15,31,46,-15,37
FC Thun,3741,8,9,6,17,47,66,-19,33
FC Sion,3741,9,7,9,16,39,51,-12,30
Young Boys,3742,1,20,10,2,70,35,35,70
FC Basel,3742,2,18,9,5,57,26,31,63
Lucerne,3742,3,13,9,10,45,42,3,48
St Gallen,3742,4,15,2,15,42,54,-12,47
FC Zürich,3742,5,10,10,12,42,39,3,40
Grasshoppers,3742,6,10,7,15,42,52,-10,37
FC Lugano,3742,7,10,7,15,31,47,-16,37
FC Thun,3742,8,9,6,17,45,60,-15,33
FC Sion,3742,9,5,8,19,39,58,-19,23
Young Boys,3743,1,20,8,4,73,39,34,68
FC Basel,3743,2,18,8,6,57,28,29,62
FC Zürich,3743,3,12,10,10,48,37,11,46
Lucerne,3743,4,12,10,10,41,40,1,46
St Gallen,3743,5,13,4,15,42,57,-15,43
FC Lugano,3743,6,10,6,16,34,55,-21,36
FC Sion,3743,7,9,7,16,44,52,-8,34
FC Thun,3743,8,9,6,17,43,61,-18,33
Grasshoppers,3743,9,8,7,17,37,50,-13,31
Young Boys,3744,1,21,8,3,70,34,36,71
FC Basel,3744,2,16,9,7,49,26,23,57
Lucerne,3744,3,13,10,9,44,41,3,49
FC Zürich,3744,4,11,10,11,40,35,5,43
St Gallen,3744,5,13,4,15,41,54,-13,43
FC Thun,3744,6,11,5,16,49,58,-9,38
Grasshoppers,3744,7,10,6,16,40,52,-12,36
FC Lugano,3744,8,10,5,17,30,49,-19,35
FC Sion,3744,9,6,9,17,42,56,-14,27
Young Boys,3745,1,21,8,3,72,35,37,71
FC Basel,3745,2,16,9,7,53,29,24,57
St Gallen,3745,3,17,2,13,46,50,-4,53
Lucerne,3745,4,12,10,10,42,44,-2,46
FC Zürich,3745,5,11,10,11,40,34,6,43
FC Thun,3745,6,10,5,17,42,58,-16,35
Grasshoppers,3745,7,8,9,15,42,52,-10,33
FC Lugano,3745,8,9,5,18,28,49,-21,32
FC Sion,3745,9,7,8,17,40,54,-14,29
Young Boys,3746,1,20,8,4,68,33,35,68
FC Basel,3746,2,19,8,5,55,22,33,65
Lucerne,3746,3,14,7,11,44,44,0,49
St Gallen,3746,4,15,3,14,45,57,-12,48
Grasshoppers,3746,5,11,6,15,44,48,-4,39
FC Zürich,3746,6,9,10,13,38,41,-3,37
FC Thun,3746,7,10,5,17,46,56,-10,35
FC Lugano,3746,8,10,5,17,30,51,-21,35
FC Sion,3746,9,5,10,17,40,58,-18,25
Young Boys,3747,1,21,7,4,68,35,33,70
FC Basel,3747,2,18,9,5,53,23,30,63
Lucerne,3747,3,12,9,11,43,43,0,45
St Gallen,3747,4,13,3,16,42,58,-16,42
FC Zürich,3747,5,10,10,12,41,39,2,40
FC Thun,3747,6,11,5,16,45,57,-12,38
FC Lugano,3747,7,11,5,16,32,48,-16,38
Grasshoppers,3747,8,9,7,16,41,52,-11,34
FC Sion,3747,9,7,9,16,42,52,-10,30
Young Boys,3748,1,22,7,3,72,35,37,73
FC Basel,3748,2,17,8,7,57,30,27,59
Lucerne,3748,3,13,9,10,44,44,0,48
St Gallen,3748,4,14,4,14,44,55,-11,46
FC Zürich,3748,5,10,10,12,41,39,2,40
FC Thun,3748,6,10,6,16,44,58,-14,36
FC Lugano,3748,7,10,6,16,32,50,-18,36
Grasshoppers,3748,8,9,7,16,39,47,-8,34
FC Sion,3748,9,5,11,16,41,56,-15,26
Young Boys,3749,1,21,8,3,71,36,35,71
FC Basel,3749,2,16,10,6,53,29,24,58
Lucerne,3749,3,13,9,10,44,43,1,48
St Gallen,3749,4,13,3,16,42,57,-15,42
FC Zürich,3749,5,10,9,13,40,39,1,39
FC Lugano,3749,6,11,6,15,35,47,-12,39
FC Thun,3749,7,10,7,15,42,55,-13,37
Grasshoppers,3749,8,9,9,14,46,50,-4,36
FC Sion,3749,9,7,7,18,37,54,-17,28
Young Boys,3750,1,20,9,3,70,39,31,69
FC Basel,3750,2,17,9,6,52,23,29,60
St Gallen,3750,3,17,2,13,45,50,-5,53
Lucerne,3750,4,13,9,10,42,40,2,48
FC Zürich,3750,5,10,11,11,41,39,2,41
Grasshoppers,3750,6,9,8,15,40,49,-9,35
FC Thun,3750,7,10,5,17,47,59,-12,35
FC Lugano,3750,8,9,6,17,31,51,-20,33
FC Sion,3750,9,5,9,18,37,55,-18,24
Young Boys,3751,1,23,6,3,78,34,44,75
FC Basel,3751,2,17,8,7,54,29,25,59
Lucerne,3751,3,12,8,12,42,50,-8,44
St Gallen,3751,4,14,2,16,43,56,-13,44
FC Zürich,3751,5,9,12,11,40,37,3,39
FC Thun,3751,6,11,6,15,48,56,-8,39
FC Lugano,3751,7,10,6,16,29,46,-17,36
Grasshoppers,3751,8,9,8,15,40,48,-8,35
FC Sion,3751,9,7,8,17,40,58,-18,29
Young Boys,3752,1,22,7,3,72,33,39,73
FC Basel,3752,2,17,8,7,52,28,24,59
Lucerne,3752,3,12,8,12,39,44,-5,44
St Gallen,3752,4,14,2,16,41,55,-14,44
Grasshoppers,3752,5,12,6,14,51,47,4,42
FC Zürich,3752,6,10,10,12,39,39,0,40
FC Lugano,3752,7,11,6,15,35,49,-14,39
FC Thun,3752,8,9,6,17,45,63,-18,33
FC Sion,3752,9,6,9,17,37,53,-16,27
Young Boys,3753,1,20,7,5,67,35,32,67
FC Basel,3753,2,18,9,5,54,22,32,63
Lucerne,3753,3,13,8,11,44,43,1,47
FC Lugano,3753,4,12,6,14,35,47,-12,42
St Gallen,3753,5,13,3,16,39,57,-18,42
FC Zürich,3753,6,10,11,11,38,34,4,41
FC Thun,3753,7,10,6,16,46,60,-14,36
Grasshoppers,3753,8,9,6,17,42,55,-13,33
FC Sion,3753,9,7,8,17,43,55,-12,29
Young Boys,3754,1,22,7,3,73,38,35,73
FC Basel,3754,2,18,8,6,58,26,32,62
St Gallen,3754,3,16,2,14,44,51,-7,50
FC Zürich,3754,4,12,9,11,46,36,10,45
Lucerne,3754,5,11,7,14,37,47,-10,40
FC Thun,3754,6,10,6,16,46,60,-14,36
FC Lugano,3754,7,10,6,16,29,46,-17,36
Grasshoppers,3754,8,9,7,16,41,50,-9,34
FC Sion,3754,9,6,8,18,38,58,-20,26
Young Boys,3755,1,23,6,3,73,32,41,75
FC Basel,3755,2,17,8,7,55,29,26,59
St Gallen,3755,3,16,3,13,46,53,-7,51
Lucerne,3755,4,14,7,11,47,47,0,49
FC Zürich,3755,5,12,10,10,46,37,9,46
FC Lugano,3755,6,9,5,18,29,51,-22,32
Grasshoppers,3755,7,8,7,17,39,52,-13,31
FC Thun,3755,8,8,7,17,43,63,-20,31
FC Sion,3755,9,6,9,17,39,53,-14,27
Young Boys,3756,1,21,7,4,67,34,33,70
FC Basel,3756,2,19,8,5,54,24,30,65
Lucerne,3756,3,12,9,11,42,44,-2,45
St Gallen,3756,4,14,3,15,43,54,-11,45
FC Zürich,3756,5,9,10,13,39,42,-3,37
FC Thun,3756,6,10,7,15,47,56,-9,37
FC Lugano,3756,7,10,6,16,30,47,-17,36
Grasshoppers,3756,8,8,8,16,40,52,-12,32
FC Sion,3756,9,7,10,15,43,52,-9,31
Young Boys,3757,1,22,8,2,72,31,41,74
FC Basel,3757,2,16,7,9,49,28,21,55
St Gallen,3757,3,17,2,13,45,50,-5,53
Lucerne,3757,4,14,7,11,40,44,-4,49
FC Zürich,3757,5,12,10,10,45,35,10,46
FC Thun,3757,6,9,7,16,42,58,-16,34
Grasshoppers,3757,7,8,9,15,38,47,-9,33
FC Lugano,3757,8,9,5,18,30,51,-21,32
FC Sion,3757,9,5,9,18,38,55,-17,24
Young Boys,3758,1,21,8,3,76,34,42,71
FC Basel,3758,2,18,9,5,53,25,28,63
St Gallen,3758,3,15,2,15,44,54,-10,47
Lucerne,3758,4,12,8,12,43,49,-6,44
FC Zürich,3758,5,10,11,11,42,36,6,41
Grasshoppers,3758,6,9,7,16,39,53,-14,34
FC Lugano,3758,7,9,7,16,30,50,-20,34
FC Sion,3758,8,8,9,15,42,51,-9,33
FC Thun,3758,9,8,7,17,43,60,-17,31
Young Boys,3759,1,22,6,4,72,38,34,72
FC Basel,3759,2,17,8,7,53,28,25,59
Lucerne,3759,3,14,8,10,43,39,4,50
St Gallen,3759,4,14,3,15,42,57,-15,45
FC Zürich,3759,5,11,10,11,42,37,5,43
FC Thun,3759,6,10,6,16,44,58,-14,36
Grasshoppers,3759,7,9,8,15,39,46,-7,35
FC Lugano,3759,8,9,6,17,32,50,-18,33
FC Sion,3759,9,6,9,17,38,52,-14,27
Young Boys,3760,1,22,7,3,76,36,40,73
FC Basel,3760,2,17,10,5,55,25,30,61
Lucerne,3760,3,13,8,11,44,46,-2,47
FC Zürich,3760,4,12,10,10,45,35,10,46
St Gallen,3760,5,13,3,16,42,60,-18,42
Grasshoppers,3760,6,10,7,15,42,48,-6,37
FC Thun,3760,7,10,5,17,42,55,-13,35
FC Lugano,3760,8,10,5,17,30,52,-22,35
FC Sion,3760,9,6,7,19,41,60,-19,25
Young Boys,3761,1,23,7,2,75,35,40,76
FC Basel,3761,2,17,8,7,56,30,26,59
Lucerne,3761,3,13,8,11,43,45,-2,47
St Gallen,3761,4,14,3,15,42,55,-13,45
FC Zürich,3761,5,10,12,10,42,36,6,42
Grasshoppers,3761,6,10,6,16,45,52,-7,36
FC Thun,3761,7,10,5,17,44,59,-15,35
FC Lugano,3761,8,9,7,16,30,48,-18,34
FC Sion,3761,9,6,8,18,38,55,-17,26
Young Boys,3762,1,22,8,2,72,34,38,74
FC Basel,3762,2,18,8,6,56,29,27,62
Lucerne,3762,3,12,9,11,43,45,-2,45
St Gallen,3762,4,13,3,16,40,55,-15,42
Grasshoppers,3762,5,11,7,14,46,46,0,40
FC Zürich,3762,6,9,11,12,39,37,2,38
FC Lugano,3762,7,11,5,16,31,45,-14,38
FC Thun,3762,8,9,7,16,43,59,-16,34
FC Sion,3762,9,6,8,18,38,58,-20,26
Young Boys,3763,1,20,9,3,66,32,34,69
FC Basel,3763,2,17,9,6,52,24,28,60
Lucerne,3763,3,13,8,11,42,42,0,47
FC Zürich,3763,4,11,11,10,41,34,7,44
St Gallen,3763,5,14,2,16,42,58,-16,44
Grasshoppers,3763,6,10,8,14,40,44,-4,38
FC Lugano,3763,7,10,5,17,33,49,-16,35
FC Thun,3763,8,9,7,16,41,57,-16,34
FC Sion,3763,9,6,9,17,37,54,-17,27
Young Boys,3764,1,21,7,4,69,35,34,70
FC Basel,3764,2,17,8,7,51,24,27,59
Lucerne,3764,3,13,7,12,38,41,-3,46
FC Zürich,3764,4,11,9,12,41,37,4,42
St Gallen,3764,5,13,3,16,38,54,-16,42
FC Lugano,3764,6,12,5,15,32,45,-13,41
FC Thun,3764,7,11,5,16,46,56,-10,38
Grasshoppers,3764,8,9,7,16,42,51,-9,34
FC Sion,3764,9,8,7,17,43,57,-14,31
Young Boys,3765,1,23,7,2,73,33,40,76
FC Basel,3765,2,15,10,7,47,26,21,55
Lucerne,3765,3,13,8,11,44,42,2,47
St Gallen,3765,4,14,4,14,40,55,-15,46
FC Zürich,3765,5,11,11,10,43,34,9,44
FC Lugano,3765,6,10,7,15,34,45,-11,37
FC Thun,3765,7,10,6,16,45,58,-13,36
Grasshoppers,3765,8,9,7,16,42,53,-11,34
FC Sion,3765,9,5,8,19,36,58,-22,23
Young Boys,3766,1,22,7,3,75,35,40,73
FC Basel,3766,2,17,7,8,56,29,27,58
Lucerne,3766,3,15,7,10,46,44,2,52
St Gallen,3766,4,15,2,15,44,57,-13,47
FC Zürich,3766,5,11,10,11,41,36,5,43
FC Thun,3766,6,10,6,16,46,61,-15,36
FC Lugano,3766,7,9,7,16,29,46,-17,34
Grasshoppers,3766,8,8,7,17,39,52,-13,31
FC Sion,3766,9,7,7,18,41,57,-16,28
Young Boys,3767,1,22,7,3,73,36,37,73
FC Basel,3767,2,18,8,6,52,25,27,62
Lucerne,3767,3,14,8,10,44,42,2,50
St Gallen,3767,4,14,4,14,43,53,-10,46
FC Zürich,3767,5,11,9,12,43,37,6,42
Grasshoppers,3767,6,10,6,16,42,48,-6,36
FC Thun,3767,7,10,5,17,45,56,-11,35
FC Lugano,3767,8,9,6,17,28,50,-22,33
FC Sion,3767,9,6,7,19,38,61,-23,25
Young Boys,3768,1,23,6,3,73,34,39,75
FC Basel,3768,2,16,9,7,51,28,23,57
Lucerne,3768,3,14,9,9,47,38,9,51
St Gallen,3768,4,13,4,15,41,56,-15,43
FC Zürich,3768,5,10,9,13,40,39,1,39
FC Lugano,3768,6,11,5,16,34,52,-18,38
Grasshoppers,3768,7,10,6,16,40,51,-11,36
FC Thun,3768,8,9,5,18,42,59,-17,32
FC Sion,3768,9,8,7,17,41,52,-11,31
Young Boys,3769,1,21,8,3,70,34,36,71
FC Basel,3769,2,20,7,5,60,24,36,67
Lucerne,3769,3,12,8,12,40,46,-6,44
St Gallen,3769,4,13,2,17,42,58,-16,41
FC Lugano,3769,5,11,7,14,33,44,-11,40
FC Zürich,3769,6,10,9,13,39,41,-2,39
Grasshoppers,3769,7,10,6,16,40,50,-10,36
FC Thun,3769,8,10,5,17,45,60,-15,35
FC Sion,3769,9,7,8,17,42,54,-12,29
Young Boys,3770,1,22,7,3,71,33,38,73
FC Basel,3770,2,18,8,6,52,22,30,62
St Gallen,3770,3,15,2,15,41,56,-15,47
Lucerne,3770,4,12,8,12,39,42,-3,44
FC Zürich,3770,5,10,9,13,42,37,5,39
FC Thun,3770,6,11,6,15,45,57,-12,39
FC Lugano,3770,7,10,6,16,31,47,-16,36
Grasshoppers,3770,8,9,7,16,38,50,-12,34
FC Sion,3770,9,7,7,18,45,60,-15,28
Young Boys,3771,1,23,6,3,75,33,42,75
FC Basel,3771,2,17,9,6,59,24,35,60
FC Zürich,3771,3,13,9,10,48,33,15,48
Lucerne,3771,4,13,7,12,43,50,-7,46
St Gallen,3771,5,13,4,15,42,55,-13,43
Grasshoppers,3771,6,11,6,15,42,50,-8,39
FC Lugano,3771,7,10,5,17,30,51,-21,35
FC Thun,3771,8,8,7,17,40,61,-21,31
FC Sion,3771,9,5,9,18,38,60,-22,24
Young Boys,3772,1,21,7,4,69,36,33,70
FC Basel,3772,2,17,8,7,53,27,26,59
Lucerne,3772,3,15,7,10,43,42,1,52
St Gallen,3772,4,16,2,14,43,52,-9,50
FC Zürich,3772,5,12,10,10,44,33,11,46
FC Lugano,3772,6,10,5,17,32,51,-19,35
Grasshoppers,3772,7,9,7,16,42,50,-8,34
FC Thun,3772,8,9,6,17,44,60,-16,33
FC Sion,3772,9,5,8,19,36,55,-19,23
Young Boys,3773,1,20,6,6,68,42,26,66
FC Basel,3773,2,19,8,5,62,24,38,65
St Gallen,3773,3,14,4,14,41,53,-12,46
Lucerne,3773,4,11,9,12,40,45,-5,42
FC Lugano,3773,5,12,6,14,36,45,-9,42
FC Zürich,3773,6,10,11,11,42,38,4,41
Grasshoppers,3773,7,10,7,15,39,47,-8,37
FC Thun,3773,8,9,7,16,43,61,-18,34
FC Sion,3773,9,6,8,18,42,58,-16,26
Young Boys,3774,1,21,8,3,73,36,37,71
FC Basel,3774,2,17,8,7,56,27,29,59
Lucerne,3774,3,14,7,11,46,50,-4,49
St Gallen,3774,4,14,3,15,45,57,-12,45
FC Zürich,3774,5,11,10,11,43,37,6,43
Grasshoppers,3774,6,9,8,15,41,50,-9,35
FC Sion,3774,7,8,9,15,45,53,-8,33
FC Lugano,3774,8,9,6,17,28,50,-22,33
FC Thun,3774,9,9,5,18,41,58,-17,32
Young Boys,3775,1,20,8,4,67,35,32,68
FC Basel,3775,2,18,8,6,56,26,30,62
Lucerne,3775,3,13,9,10,45,47,-2,48
St Gallen,3775,4,14,3,15,44,56,-12,45
FC Zürich,3775,5,10,11,11,41,35,6,41
Grasshoppers,3775,6,11,7,14,41,46,-5,40
FC Lugano,3775,7,11,5,16,30,45,-15,38
FC Thun,3775,8,9,6,17,43,58,-15,33
FC Sion,3775,9,5,9,18,37,56,-19,24
Young Boys,3776,1,23,7,2,74,32,42,76
FC Basel,3776,2,18,9,5,55,25,30,63
Lucerne,3776,3,13,8,11,43,43,0,47
St Gallen,3776,4,14,3,15,43,55,-12,45
FC Zürich,3776,5,10,12,10,39,33,6,42
FC Thun,3776,6,9,6,17,43,61,-18,33
FC Lugano,3776,7,9,6,17,29,49,-20,33
FC Sion,3776,8,8,7,17,43,53,-10,31
Grasshoppers,3776,9,8,6,18,38,56,-18,30
Young Boys,3777,1,20,7,5,69,36,33,67
FC Basel,3777,2,17,7,8,54,31,23,58
Lucerne,3777,3,14,8,10,48,48,0,50
FC Zürich,3777,4,13,9,10,44,35,9,48
St Gallen,3777,5,15,2,15,48,54,-6,47
FC Lugano,3777,6,11,6,15,31,46,-15,39
Grasshoppers,3777,7,10,7,15,42,50,-8,37
FC Thun,3777,8,8,6,18,42,63,-21,30
FC Sion,3777,9,6,8,18,43,58,-15,26
Young Boys,3778,1,22,7,3,70,34,36,73
FC Basel,3778,2,19,7,6,59,26,33,64
Lucerne,3778,3,12,10,10,44,45,-1,46
St Gallen,3778,4,14,3,15,45,58,-13,45
FC Zürich,3778,5,10,9,13,39,44,-5,39
FC Lugano,3778,6,11,5,16,35,49,-14,38
Grasshoppers,3778,7,9,7,16,40,50,-10,34
FC Thun,3778,8,9,6,17,42,60,-18,33
FC Sion,3778,9,7,8,17,46,54,-8,29
Young Boys,3779,1,23,6,3,75,34,41,75
FC Basel,3779,2,16,10,6,52,29,23,58
St Gallen,3779,3,17,2,13,49,52,-3,53
Lucerne,3779,4,12,9,11,42,44,-2,45
FC Zürich,3779,5,9,11,12,38,36,2,38
FC Thun,3779,6,10,7,15,42,55,-13,37
FC Lugano,3779,7,10,6,16,28,46,-18,36
Grasshoppers,3779,8,8,6,18,37,51,-14,30
FC Sion,3779,9,6,9,17,36,52,-16,27
Young Boys,3780,1,19,8,5,69,41,28,65
FC Basel,3780,2,17,9,6,53,25,28,60
Lucerne,3780,3,13,9,10,39,38,1,48
FC Zürich,3780,4,11,11,10,41,34,7,44
St Gallen,3780,5,13,4,15,41,56,-15,43
FC Lugano,3780,6,11,6,15,32,46,-14,39
FC Thun,3780,7,9,7,16,44,60,-16,34
Grasshoppers,3780,8,9,6,17,39,49,-10,33
FC Sion,3780,9,7,10,15,45,54,-9,31
Young Boys,3781,1,22,6,4,70,35,35,72
FC Basel,3781,2,18,8,6,52,24,28,62
St Gallen,3781,3,16,3,13,45,52,-7,51
Lucerne,3781,4,12,8,12,39,43,-4,44
FC Zürich,3781,5,10,10,12,37,35,2,40
FC Thun,3781,6,10,6,16,43,57,-14,36
FC Lugano,3781,7,9,7,16,28,45,-17,34
Grasshoppers,3781,8,9,6,17,40,51,-11,33
FC Sion,3781,9,7,8,17,44,56,-12,29
Young Boys,3782,1,21,8,3,74,35,39,71
FC Basel,3782,2,17,8,7,56,33,23,59
Lucerne,3782,3,14,8,10,45,41,4,50
St Gallen,3782,4,14,4,14,45,58,-13,46
FC Zürich,3782,5,10,9,13,41,42,-1,39
Grasshoppers,3782,6,10,6,16,41,49,-8,36
FC Lugano,3782,7,10,6,16,33,51,-18,36
FC Thun,3782,8,10,5,17,46,60,-14,35
FC Sion,3782,9,7,8,17,43,55,-12,29
Young Boys,3783,1,23,7,2,75,36,39,76
FC Basel,3783,2,17,8,7,56,27,29,59
St Gallen,3783,3,16,3,13,51,53,-2,51
Lucerne,3783,4,11,10,11,42,50,-8,43
FC Zürich,3783,5,10,9,13,39,44,-5,39
FC Lugano,3783,6,10,6,16,34,46,-12,36
FC Thun,3783,7,10,5,17,41,59,-18,35
Grasshoppers,3783,8,9,7,16,40,49,-9,34
FC Sion,3783,9,6,9,17,44,58,-14,27
Young Boys,3784,1,23,6,3,80,39,41,75
FC Basel,3784,2,17,10,5,57,28,29,61
Lucerne,3784,3,13,8,11,44,45,-1,47
St Gallen,3784,4,13,5,14,46,58,-12,44
FC Zürich,3784,5,10,10,12,40,38,2,40
FC Thun,3784,6,10,6,16,41,55,-14,36
FC Lugano,3784,7,10,6,16,36,53,-17,36
Grasshoppers,3784,8,9,6,17,39,52,-13,33
FC Sion,3784,9,7,7,18,40,55,-15,28
Young Boys,3785,1,22,7,3,75,39,36,73
FC Basel,3785,2,20,7,5,57,22,35,67
Lucerne,3785,3,13,8,11,44,41,3,47
St Gallen,3785,4,15,2,15,43,55,-12,47
FC Zürich,3785,5,9,11,12,39,38,1,38
Grasshoppers,3785,6,9,7,16,40,51,-11,34
FC Lugano,3785,7,9,7,16,28,49,-21,34
FC Thun,3785,8,8,7,17,43,61,-18,31
FC Sion,3785,9,6,10,16,42,55,-13,28
Young Boys,3786,1,22,8,2,76,35,41,74
FC Basel,3786,2,17,8,7,54,26,28,59
St Gallen,3786,3,16,2,14,48,55,-7,50
FC Zürich,3786,4,11,10,11,43,36,7,43
Lucerne,3786,5,11,9,12,41,50,-9,42
FC Lugano,3786,6,11,5,16,36,51,-15,38
Grasshoppers,3786,7,8,9,15,37,48,-11,33
FC Thun,3786,8,8,8,16,41,58,-17,32
FC Sion,3786,9,6,9,17,39,56,-17,27
Young Boys,3787,1,22,6,4,72,33,39,72
FC Basel,3787,2,17,9,6,54,28,26,60
Lucerne,3787,3,14,7,11,43,43,0,49
St Gallen,3787,4,14,3,15,41,53,-12,45
FC Zürich,3787,5,11,11,10,43,36,7,44
FC Thun,3787,6,10,6,16,47,58,-11,36
FC Lugano,3787,7,9,6,17,29,51,-22,33
FC Sion,3787,8,8,8,16,42,52,-10,32
Grasshoppers,3787,9,8,6,18,37,54,-17,30
Young Boys,3788,1,22,7,3,73,35,38,73
FC Basel,3788,2,18,8,6,55,25,30,62
Lucerne,3788,3,13,8,11,45,48,-3,47
St Gallen,3788,4,15,2,15,41,59,-18,47
FC Zürich,3788,5,9,10,13,41,42,-1,37
FC Thun,3788,6,10,6,16,47,58,-11,36
FC Lugano,3788,7,10,5,17,30,47,-17,35
Grasshoppers,3788,8,8,9,15,41,50,-9,33
FC Sion,3788,9,7,9,16,45,54,-9,30
FC Basel,3789,1,20,7,5,61,24,37,67
Young Boys,3789,2,20,7,5,69,41,28,67
Lucerne,3789,3,12,8,12,43,45,-2,44
FC Zürich,3789,4,11,10,11,41,34,7,43
St Gallen,3789,5,13,4,15,41,58,-17,43
Grasshoppers,3789,6,11,7,14,44,47,-3,40
FC Lugano,3789,7,9,8,15,31,50,-19,35
FC Thun,3789,8,9,6,17,42,58,-16,33
FC Sion,3789,9,7,7,18,41,56,-15,28
Young Boys,3790,1,22,7,3,71,34,37,73
FC Basel,3790,2,18,9,5,59,29,30,63
Lucerne,3790,3,13,9,10,42,44,-2,48
St Gallen,3790,4,13,3,16,44,59,-15,42
FC Lugano,3790,5,11,5,16,33,47,-14,38
FC Zürich,3790,6,9,10,13,39,40,-1,37
FC Thun,3790,7,10,6,16,46,61,-15,36
Grasshoppers,3790,8,8,8,16,39,49,-10,32
FC Sion,3790,9,7,9,16,42,52,-10,30
Young Boys,3791,1,21,7,4,72,38,34,70
FC Basel,3791,2,18,8,6,55,23,32,62
Lucerne,3791,3,13,8,11,41,42,-1,47
FC Zürich,3791,4,12,10,10,43,35,8,46
St Gallen,3791,5,13,2,17,40,62,-22,41
FC Lugano,3791,6,10,6,16,33,48,-15,36
Grasshoppers,3791,7,9,8,15,41,49,-8,35
FC Thun,3791,8,10,5,17,46,63,-17,35
FC Sion,3791,9,7,8,17,44,55,-11,29
Young Boys,3792,1,20,7,5,69,37,32,67
FC Basel,3792,2,19,8,5,56,23,33,65
St Gallen,3792,3,15,2,15,47,60,-13,47
Lucerne,3792,4,12,9,11,43,47,-4,45
FC Zürich,3792,5,10,10,12,42,41,1,40
FC Lugano,3792,6,11,6,15,38,47,-9,39
Grasshoppers,3792,7,10,7,15,44,48,-4,37
FC Thun,3792,8,9,6,17,42,60,-18,33
FC Sion,3792,9,7,7,18,41,59,-18,28
Young Boys,3793,1,23,6,3,79,38,41,75
FC Basel,3793,2,17,9,6,55,28,27,60
St Gallen,3793,3,16,3,13,48,54,-6,51
Lucerne,3793,4,14,7,11,41,44,-3,49
FC Thun,3793,5,11,6,15,51,58,-7,39
FC Zürich,3793,6,9,11,12,41,40,1,38
FC Lugano,3793,7,9,6,17,30,49,-19,33
Grasshoppers,3793,8,8,6,18,39,54,-15,30
FC Sion,3793,9,6,8,18,44,63,-19,26
Young Boys,3794,1,24,6,2,75,30,45,78
FC Basel,3794,2,16,8,8,48,26,22,56
Lucerne,3794,3,15,7,10,47,43,4,52
St Gallen,3794,4,14,3,15,44,57,-13,45
FC Zürich,3794,5,9,10,13,41,41,0,37
Grasshoppers,3794,6,10,6,16,43,49,-6,36
FC Thun,3794,7,10,6,16,47,61,-14,36
FC Lugano,3794,8,10,6,16,32,51,-19,36
FC Sion,3794,9,6,8,18,38,57,-19,26
Young Boys,3795,1,21,8,3,70,34,36,71
FC Basel,3795,2,19,8,5,57,26,31,65
Lucerne,3795,3,13,10,9,44,43,1,49
FC Zürich,3795,4,11,10,11,42,37,5,43
St Gallen,3795,5,13,3,16,41,55,-14,42
FC Lugano,3795,6,9,8,15,31,49,-18,35
Grasshoppers,3795,7,9,7,16,39,49,-10,34
FC Thun,3795,8,9,5,18,42,59,-17,32
FC Sion,3795,9,7,7,18,40,54,-14,28
Young Boys,3796,1,21,8,3,73,38,35,71
FC Basel,3796,2,16,10,6,53,28,25,58
FC Zürich,3796,3,13,9,10,43,34,9,48
Lucerne,3796,4,12,10,10,41,43,-2,46
St Gallen,3796,5,14,3,15,41,53,-12,45
Grasshoppers,3796,6,11,7,14,41,45,-4,40
FC Lugano,3796,7,9,6,17,29,47,-18,33
FC Thun,3796,8,8,7,17,40,60,-20,31
FC Sion,3796,9,6,8,18,40,53,-13,26
Young Boys,3797,1,22,6,4,74,37,37,72
FC Basel,3797,2,18,8,6,55,27,28,62
St Gallen,3797,3,17,2,13,50,50,0,53
FC Zürich,3797,4,12,9,11,47,34,13,45
Lucerne,3797,5,12,9,11,41,41,0,45
Grasshoppers,3797,6,9,7,16,41,55,-14,34
FC Lugano,3797,7,9,6,17,28,52,-24,33
FC Thun,3797,8,8,6,18,41,66,-25,30
FC Sion,3797,9,7,7,18,41,56,-15,28
Young Boys,3798,1,22,7,3,74,37,37,73
FC Basel,3798,2,18,8,6,55,25,30,62
Lucerne,3798,3,12,9,11,39,42,-3,45
St Gallen,3798,4,14,3,15,40,54,-14,45
FC Zürich,3798,5,10,9,13,39,37,2,39
Grasshoppers,3798,6,10,6,16,42,50,-8,36
FC Thun,3798,7,10,6,16,43,57,-14,36
FC Lugano,3798,8,10,6,16,31,47,-16,36
FC Sion,3798,9,7,8,17,40,54,-14,29
Young Boys,3799,1,23,7,2,72,31,41,76
FC Basel,3799,2,16,9,7,48,27,21,57
St Gallen,3799,3,16,3,13,44,51,-7,51
Lucerne,3799,4,12,8,12,40,42,-2,44
FC Zürich,3799,5,11,10,11,42,37,5,43
Grasshoppers,3799,6,9,9,14,42,49,-7,36
FC Thun,3799,7,10,5,17,47,60,-13,35
FC Lugano,3799,8,9,5,18,29,52,-23,32
FC Sion,3799,9,6,8,18,39,54,-15,26
Young Boys,3800,1,22,8,2,75,36,39,74
FC Basel,3800,2,18,8,6,58,29,29,62
St Gallen,3800,3,15,2,15,45,58,-13,47
Lucerne,3800,4,12,8,12,43,47,-4,44
FC Zürich,3800,5,10,9,13,42,42,0,39
FC Lugano,3800,6,11,5,16,38,51,-13,38
Grasshoppers,3800,7,9,7,16,40,51,-11,34
FC Sion,3800,8,8,9,15,45,52,-7,33
FC Thun,3800,9,8,6,18,43,63,-20,30
Young Boys,3801,1,22,8,2,74,33,41,74
FC Basel,3801,2,15,9,8,48,27,21,54
St Gallen,3801,3,15,2,15,45,55,-10,47
Lucerne,3801,4,12,9,11,40,44,-4,45
FC Zürich,3801,5,11,10,11,41,35,6,43
FC Lugano,3801,6,11,6,15,33,45,-12,39
FC Thun,3801,7,11,5,16,42,57,-15,38
Grasshoppers,3801,8,9,8,15,38,46,-8,35
FC Sion,3801,9,6,7,19,37,56,-19,25
Young Boys,3802,1,21,8,3,70,34,36,71
FC Basel,3802,2,17,10,5,53,24,29,61
Lucerne,3802,3,13,8,11,42,44,-2,47
St Gallen,3802,4,14,3,15,45,57,-12,45
FC Zürich,3802,5,10,11,11,41,37,4,41
Grasshoppers,3802,6,9,8,15,43,52,-9,35
FC Thun,3802,7,9,8,15,45,59,-14,35
FC Lugano,3802,8,9,6,17,28,49,-21,33
FC Sion,3802,9,7,8,17,45,56,-11,29
Young Boys,3803,1,22,6,4,73,36,37,72
FC Basel,3803,2,16,8,8,49,29,20,56
St Gallen,3803,3,15,3,14,44,54,-10,48
Lucerne,3803,4,12,9,11,43,45,-2,45
FC Zürich,3803,5,11,9,12,43,40,3,42
FC Lugano,3803,6,10,7,15,32,46,-14,37
Grasshoppers,3803,7,10,6,16,43,52,-9,36
FC Thun,3803,8,10,5,17,45,60,-15,35
FC Sion,3803,9,8,7,17,42,52,-10,31
Young Boys,3804,1,21,6,5,73,41,32,69
FC Basel,3804,2,19,8,5,67,27,40,65
Lucerne,3804,3,13,9,10,43,43,0,48
St Gallen,3804,4,15,3,14,46,56,-10,48
FC Zürich,3804,5,10,11,11,41,38,3,41
Grasshoppers,3804,6,10,6,16,43,51,-8,36
FC Thun,3804,7,9,6,17,45,66,-21,33
FC Lugano,3804,8,9,6,17,29,51,-22,33
FC Sion,3804,9,7,7,18,42,56,-14,28
Young Boys,3805,1,19,9,4,66,34,32,66
FC Basel,3805,2,17,8,7,53,26,27,59
Lucerne,3805,3,13,9,10,43,44,-1,48
St Gallen,3805,4,15,2,15,43,56,-13,47
FC Zürich,3805,5,12,10,10,45,34,11,46
FC Thun,3805,6,11,6,15,45,54,-9,39
Grasshoppers,3805,7,10,7,15,42,48,-6,37
FC Lugano,3805,8,9,6,17,31,51,-20,33
FC Sion,3805,9,6,7,19,37,58,-21,25
Young Boys,3806,1,19,7,6,71,46,25,64
FC Basel,3806,2,18,7,7,60,26,34,61
St Gallen,3806,3,15,2,15,45,56,-11,47
Lucerne,3806,4,13,7,12,47,53,-6,46
FC Zürich,3806,5,11,10,11,44,36,8,43
Grasshoppers,3806,6,12,6,14,45,48,-3,42
FC Lugano,3806,7,10,7,15,33,49,-16,37
FC Thun,3806,8,10,5,17,43,59,-16,35
FC Sion,3806,9,7,7,18,43,58,-15,28
Young Boys,3807,1,22,8,2,73,36,37,74
FC Basel,3807,2,19,8,5,54,22,32,65
St Gallen,3807,3,15,2,15,43,56,-13,47
Lucerne,3807,4,12,8,12,40,45,-5,44
FC Zürich,3807,5,10,10,12,38,38,0,40
FC Thun,3807,6,11,5,16,49,57,-8,38
FC Lugano,3807,7,10,6,16,33,46,-13,36
Grasshoppers,3807,8,9,7,16,39,51,-12,34
FC Sion,3807,9,5,8,19,40,58,-18,23
Young Boys,3808,1,21,7,4,73,36,37,70
FC Basel,3808,2,19,8,5,55,25,30,65
St Gallen,3808,3,14,3,15,41,55,-14,45
Lucerne,3808,4,12,8,12,42,46,-4,44
FC Lugano,3808,5,12,5,15,33,46,-13,41
FC Zürich,3808,6,10,10,12,41,38,3,40
FC Thun,3808,7,10,5,17,45,57,-12,35
Grasshoppers,3808,8,8,7,17,39,54,-15,31
FC Sion,3808,9,7,9,16,41,53,-12,30
Young Boys,3809,1,21,8,3,72,35,37,71
FC Basel,3809,2,17,9,6,51,24,27,60
St Gallen,3809,3,15,3,14,44,54,-10,48
Lucerne,3809,4,12,11,9,42,40,2,47
FC Zürich,3809,5,12,10,10,43,35,8,46
FC Lugano,3809,6,10,7,15,30,45,-15,37
FC Thun,3809,7,9,6,17,44,61,-17,33
Grasshoppers,3809,8,8,7,17,42,56,-14,31
FC Sion,3809,9,6,7,19,41,59,-18,25
Young Boys,3810,1,21,6,5,73,39,34,69
FC Basel,3810,2,18,8,6,57,26,31,62
St Gallen,3810,3,15,2,15,41,54,-13,47
FC Zürich,3810,4,11,10,11,44,39,5,43
Lucerne,3810,5,12,7,13,39,48,-9,43
FC Lugano,3810,6,11,5,16,33,48,-15,38
FC Thun,3810,7,10,5,17,44,60,-16,35
Grasshoppers,3810,8,9,7,16,39,49,-10,34
FC Sion,3810,9,8,8,16,44,51,-7,32
Young Boys,3811,1,21,6,5,69,36,33,69
FC Basel,3811,2,20,7,5,53,22,31,67
Lucerne,3811,3,12,8,12,41,46,-5,44
St Gallen,3811,4,14,2,16,43,55,-12,44
FC Zürich,3811,5,10,10,12,38,35,3,40
FC Lugano,3811,6,11,5,16,31,48,-17,38
Grasshoppers,3811,7,9,9,14,42,48,-6,36
FC Thun,3811,8,9,7,16,46,56,-10,34
FC Sion,3811,9,7,8,17,40,57,-17,29
Young Boys,3812,1,23,7,2,81,37,44,76
FC Basel,3812,2,17,7,8,53,28,25,58
Lucerne,3812,3,14,7,11,45,42,3,49
St Gallen,3812,4,15,3,14,47,55,-8,48
FC Zürich,3812,5,11,9,12,40,37,3,42
FC Thun,3812,6,11,5,16,45,56,-11,38
FC Lugano,3812,7,10,6,16,33,53,-20,36
Grasshoppers,3812,8,9,6,17,40,52,-12,33
FC Sion,3812,9,5,8,19,40,64,-24,23
Young Boys,3813,1,22,7,3,74,36,38,73
FC Basel,3813,2,17,9,6,54,26,28,60
St Gallen,3813,3,16,3,13,43,49,-6,51
Lucerne,3813,4,13,9,10,43,42,1,48
FC Zürich,3813,5,10,9,13,39,39,0,39
FC Thun,3813,6,10,6,16,45,61,-16,36
Grasshoppers,3813,7,9,6,17,41,53,-12,33
FC Lugano,3813,8,9,6,17,28,48,-20,33
FC Sion,3813,9,7,7,18,40,53,-13,28
Young Boys,3814,1,21,7,4,73,38,35,70
FC Basel,3814,2,17,8,7,51,25,26,59
Lucerne,3814,3,13,9,10,45,45,0,48
St Gallen,3814,4,15,3,14,43,53,-10,48
FC Zürich,3814,5,11,10,11,44,37,7,43
FC Thun,3814,6,11,5,16,45,57,-12,38
FC Lugano,3814,7,9,7,16,29,48,-19,34
Grasshoppers,3814,8,9,6,17,42,52,-10,33
FC Sion,3814,9,7,7,18,42,59,-17,28
Young Boys,3815,1,23,6,3,73,36,37,75
FC Basel,3815,2,17,9,6,53,25,28,60
Lucerne,3815,3,13,7,12,44,47,-3,46
St Gallen,3815,4,14,4,14,42,53,-11,46
FC Zürich,3815,5,11,11,10,41,33,8,44
Grasshoppers,3815,6,10,6,16,41,48,-7,36
FC Lugano,3815,7,9,7,16,28,46,-18,34
FC Thun,3815,8,9,5,18,42,62,-20,32
FC Sion,3815,9,7,7,18,41,55,-14,28
Young Boys,3816,1,22,8,2,71,33,38,74
FC Basel,3816,2,16,9,7,52,27,25,57
Lucerne,3816,3,12,10,10,44,45,-1,46
St Gallen,3816,4,14,4,14,45,54,-9,46
FC Zürich,3816,5,11,11,10,43,34,9,44
FC Lugano,3816,6,10,7,15,32,48,-16,37
FC Thun,3816,7,9,7,16,43,60,-17,34
Grasshoppers,3816,8,9,6,17,39,52,-13,33
FC Sion,3816,9,5,10,17,40,56,-16,25
Young Boys,3817,1,23,6,3,75,33,42,75
FC Basel,3817,2,16,9,7,51,29,22,57
St Gallen,3817,3,15,3,14,45,54,-9,48
FC Zürich,3817,4,12,10,10,48,38,10,46
Lucerne,3817,5,12,8,12,40,43,-3,44
Grasshoppers,3817,6,9,9,14,41,48,-7,36
FC Thun,3817,7,8,8,16,43,59,-16,32
FC Lugano,3817,8,9,5,18,30,51,-21,32
FC Sion,3817,9,7,8,17,40,58,-18,29
Young Boys,3818,1,21,6,5,69,39,30,69
FC Basel,3818,2,19,7,6,58,26,32,64
Lucerne,3818,3,14,8,10,43,41,2,50
St Gallen,3818,4,14,3,15,41,54,-13,45
FC Zürich,3818,5,10,10,12,38,36,2,40
Grasshoppers,3818,6,11,6,15,43,46,-3,39
FC Thun,3818,7,10,6,16,43,57,-14,36
FC Lugano,3818,8,10,5,17,31,48,-17,35
FC Sion,3818,9,6,7,19,39,58,-19,25
Young Boys,3819,1,23,6,3,71,31,40,75
FC Basel,3819,2,18,9,5,54,23,31,63
Lucerne,3819,3,12,8,12,41,45,-4,44
St Gallen,3819,4,14,2,16,40,58,-18,44
FC Zürich,3819,5,11,10,11,43,35,8,43
FC Lugano,3819,6,11,5,16,30,48,-18,38
FC Thun,3819,7,10,6,16,46,58,-12,36
Grasshoppers,3819,8,8,8,16,41,52,-11,32
FC Sion,3819,9,6,8,18,41,57,-16,26
Young Boys,3820,1,21,8,3,68,33,35,71
FC Basel,3820,2,16,10,6,52,29,23,58
Lucerne,3820,3,12,10,10,42,43,-1,46
St Gallen,3820,4,13,4,15,41,55,-14,43
FC Zürich,3820,5,10,11,11,42,38,4,41
FC Lugano,3820,6,11,6,15,32,44,-12,39
FC Thun,3820,7,10,6,16,46,58,-12,36
Grasshoppers,3820,8,9,7,16,39,48,-9,34
FC Sion,3820,9,7,8,17,39,53,-14,29
Young Boys,3821,1,24,6,2,76,33,43,78
FC Basel,3821,2,17,7,8,53,27,26,58
St Gallen,3821,3,15,3,14,44,54,-10,48
FC Zürich,3821,4,12,10,10,46,38,8,46
Lucerne,3821,5,12,9,11,42,44,-2,45
Grasshoppers,3821,6,9,8,15,41,50,-9,35
FC Lugano,3821,7,9,8,15,34,50,-16,35
FC Thun,3821,8,9,6,17,44,62,-18,33
FC Sion,3821,9,5,7,20,39,61,-22,22
Young Boys,3822,1,22,7,3,72,31,41,73
FC Basel,3822,2,18,9,5,52,22,30,63
St Gallen,3822,3,14,3,15,43,57,-14,45
Lucerne,3822,4,11,10,11,39,42,-3,43
FC Zürich,3822,5,10,11,11,40,36,4,41
FC Lugano,3822,6,11,6,15,33,48,-15,39
Grasshoppers,3822,7,9,7,16,42,49,-7,34
FC Sion,3822,8,8,7,17,43,56,-13,31
FC Thun,3822,9,8,6,18,40,63,-23,30
Young Boys,3823,1,21,7,4,77,40,37,70
FC Basel,3823,2,18,9,5,55,24,31,63
St Gallen,3823,3,14,4,14,42,53,-11,46
FC Zürich,3823,4,11,11,10,44,34,10,44
Lucerne,3823,5,11,9,12,40,47,-7,42
FC Lugano,3823,6,12,5,15,38,50,-12,41
Grasshoppers,3823,7,8,9,15,40,53,-13,33
FC Thun,3823,8,8,7,17,42,60,-18,31
FC Sion,3823,9,6,9,17,37,54,-17,27
Young Boys,3824,1,22,7,3,70,34,36,73
FC Basel,3824,2,19,7,6,60,24,36,64
Lucerne,3824,3,14,8,10,44,43,1,50
FC Zürich,3824,4,11,10,11,43,41,2,43
St Gallen,3824,5,13,4,15,45,58,-13,43
FC Thun,3824,6,10,5,17,42,59,-17,35
FC Lugano,3824,7,10,5,17,32,50,-18,35
Grasshoppers,3824,8,8,7,17,38,51,-13,31
FC Sion,3824,9,6,9,17,44,58,-14,27
Young Boys,3825,1,23,7,2,76,34,42,76
FC Basel,3825,2,17,9,6,53,26,27,60
Lucerne,3825,3,13,10,9,43,42,1,49
St Gallen,3825,4,15,3,14,45,55,-10,48
FC Zürich,3825,5,10,10,12,40,37,3,40
FC Thun,3825,6,10,6,16,42,55,-13,36
Grasshoppers,3825,7,9,7,16,38,49,-11,34
FC Lugano,3825,8,9,5,18,29,50,-21,32
FC Sion,3825,9,6,7,19,41,59,-18,25
Young Boys,3826,1,23,6,3,73,34,39,75
FC Basel,3826,2,18,7,7,58,33,25,61
Lucerne,3826,3,15,7,10,48,45,3,52
St Gallen,3826,4,15,3,14,43,52,-9,48
FC Zürich,3826,5,9,10,13,40,40,0,37
FC Thun,3826,6,10,6,16,44,57,-13,36
FC Lugano,3826,7,10,5,17,32,50,-18,35
Grasshoppers,3826,8,9,7,16,40,51,-11,34
FC Sion,3826,9,5,9,18,38,54,-16,24
Young Boys,3827,1,23,6,3,72,33,39,75
FC Basel,3827,2,17,9,6,51,25,26,60
Lucerne,3827,3,14,8,10,45,41,4,50
St Gallen,3827,4,14,2,16,42,59,-17,44
FC Zürich,3827,5,11,10,11,40,34,6,43
Grasshoppers,3827,6,10,7,15,42,49,-7,37
FC Lugano,3827,7,10,5,17,30,49,-19,35
FC Thun,3827,8,8,6,18,38,57,-19,30
FC Sion,3827,9,6,9,17,39,52,-13,27
Young Boys,3828,1,20,7,5,72,41,31,67
FC Basel,3828,2,17,8,7,52,27,25,59
Lucerne,3828,3,14,8,10,43,42,1,50
St Gallen,3828,4,15,3,14,43,52,-9,48
FC Thun,3828,5,12,5,15,45,54,-9,41
FC Zürich,3828,6,10,9,13,41,37,4,39
FC Lugano,3828,7,10,5,17,29,48,-19,35
Grasshoppers,3828,8,9,7,16,43,52,-9,34
FC Sion,3828,9,7,8,17,40,55,-15,29
Young Boys,3829,1,22,7,3,78,38,40,73
FC Basel,3829,2,19,7,6,54,26,28,64
Lucerne,3829,3,13,7,12,42,44,-2,46
St Gallen,3829,4,14,3,15,43,56,-13,45
FC Zürich,3829,5,10,9,13,39,38,1,39
FC Lugano,3829,6,10,6,16,31,48,-17,36
FC Thun,3829,7,10,5,17,42,60,-18,35
Grasshoppers,3829,8,9,6,17,42,52,-10,33
FC Sion,3829,9,8,8,16,46,55,-9,32
Young Boys,3830,1,21,7,4,76,41,35,70
FC Basel,3830,2,20,7,5,54,23,31,67
Lucerne,3830,3,14,7,11,47,44,3,49
St Gallen,3830,4,14,2,16,41,54,-13,44
FC Zürich,3830,5,10,10,12,42,38,4,40
FC Thun,3830,6,10,6,16,44,57,-13,36
FC Sion,3830,7,8,9,15,42,52,-10,33
FC Lugano,3830,8,9,5,18,29,51,-22,32
Grasshoppers,3830,9,8,7,17,40,55,-15,31
Young Boys,3831,1,23,7,2,76,36,40,76
FC Basel,3831,2,19,8,5,58,27,31,65
St Gallen,3831,3,15,2,15,44,55,-11,47
Lucerne,3831,4,13,7,12,43,47,-4,46
FC Zürich,3831,5,10,9,13,38,40,-2,39
FC Lugano,3831,6,11,5,16,35,46,-11,38
Grasshoppers,3831,7,9,7,16,41,51,-10,34
FC Thun,3831,8,9,5,18,43,59,-16,32
FC Sion,3831,9,6,8,18,40,57,-17,26
Young Boys,3832,1,22,7,3,70,34,36,73
FC Basel,3832,2,18,8,6,59,27,32,62
Lucerne,3832,3,14,8,10,44,46,-2,50
St Gallen,3832,4,14,4,14,43,54,-11,46
FC Zürich,3832,5,9,12,11,38,36,2,39
FC Lugano,3832,6,9,7,16,31,48,-17,34
Grasshoppers,3832,7,8,8,16,39,49,-10,32
FC Thun,3832,8,8,7,17,42,60,-18,31
FC Sion,3832,9,7,9,16,42,54,-12,30
Young Boys,3833,1,21,7,4,70,35,35,70
FC Basel,3833,2,18,8,6,51,24,27,62
Lucerne,3833,3,14,8,10,44,42,2,50
St Gallen,3833,4,14,2,16,41,54,-13,44
FC Zürich,3833,5,10,11,11,41,37,4,41
Grasshoppers,3833,6,11,6,15,50,49,1,39
FC Lugano,3833,7,11,6,15,29,46,-17,39
FC Thun,3833,8,9,6,17,46,60,-14,33
FC Sion,3833,9,5,8,19,39,64,-25,23
Young Boys,3834,1,22,7,3,70,32,38,73
FC Basel,3834,2,16,10,6,50,24,26,58
St Gallen,3834,3,16,2,14,42,54,-12,50
FC Zürich,3834,4,12,10,10,42,34,8,46
Lucerne,3834,5,13,7,12,40,42,-2,46
Grasshoppers,3834,6,10,7,15,40,47,-7,37
FC Lugano,3834,7,10,5,17,31,48,-17,35
FC Thun,3834,8,9,7,16,42,57,-15,34
FC Sion,3834,9,5,7,20,38,57,-19,22
Young Boys,3835,1,21,8,3,70,33,37,71
FC Basel,3835,2,16,7,9,49,28,21,55
St Gallen,3835,3,16,2,14,43,52,-9,50
Lucerne,3835,4,13,7,12,39,42,-3,46
FC Zürich,3835,5,11,10,11,44,40,4,43
FC Thun,3835,6,11,5,16,48,61,-13,38
Grasshoppers,3835,7,10,7,15,41,47,-6,37
FC Lugano,3835,8,9,7,16,32,49,-17,34
FC Sion,3835,9,7,7,18,41,55,-14,28
Young Boys,3836,1,22,7,3,75,36,39,73
FC Basel,3836,2,18,9,5,58,26,32,63
St Gallen,3836,3,15,3,14,46,55,-9,48
Lucerne,3836,4,13,8,11,44,48,-4,47
FC Zürich,3836,5,11,10,11,43,36,7,43
FC Lugano,3836,6,10,6,16,29,48,-19,36
Grasshoppers,3836,7,9,7,16,42,51,-9,34
FC Thun,3836,8,9,6,17,45,61,-16,33
FC Sion,3836,9,5,8,19,41,62,-21,23
Young Boys,3837,1,23,6,3,76,37,39,75
FC Basel,3837,2,19,7,6,60,24,36,64
St Gallen,3837,3,14,4,14,47,58,-11,46
Lucerne,3837,4,12,9,11,43,49,-6,45
FC Zürich,3837,5,9,11,12,39,38,1,38
FC Thun,3837,6,10,5,17,43,61,-18,35
FC Lugano,3837,7,9,8,15,37,55,-18,35
Grasshoppers,3837,8,9,7,16,43,52,-9,34
FC Sion,3837,9,6,9,17,41,55,-14,27
Young Boys,3838,1,22,8,2,72,30,42,74
FC Basel,3838,2,17,8,7,53,30,23,59
Lucerne,3838,3,13,8,11,42,46,-4,47
FC Zürich,3838,4,12,9,11,45,35,10,45
St Gallen,3838,5,14,3,15,42,53,-11,45
Grasshoppers,3838,6,10,6,16,43,49,-6,36
FC Lugano,3838,7,9,6,17,27,47,-20,33
FC Thun,3838,8,9,5,18,44,63,-19,32
FC Sion,3838,9,8,7,17,42,57,-15,31
Young Boys,3839,1,22,6,4,70,34,36,72
FC Basel,3839,2,18,7,7,55,27,28,61
FC Zürich,3839,3,13,9,10,45,34,11,48
St Gallen,3839,4,15,2,15,44,57,-13,47
Lucerne,3839,5,11,8,13,41,51,-10,41
Grasshoppers,3839,6,10,8,14,44,50,-6,38
FC Thun,3839,7,9,6,17,44,62,-18,33
FC Lugano,3839,8,9,6,17,30,49,-19,33
FC Sion,3839,9,7,8,17,45,54,-9,29
Young Boys,3840,1,21,7,4,70,36,34,70
FC Basel,3840,2,17,8,7,54,28,26,59
St Gallen,3840,3,16,3,13,49,56,-7,51
Lucerne,3840,4,12,10,10,46,47,-1,46
FC Zürich,3840,5,10,10,12,41,38,3,40
Grasshoppers,3840,6,10,6,16,40,48,-8,36
FC Thun,3840,7,10,5,17,46,59,-13,35
FC Lugano,3840,8,9,8,15,34,51,-17,35
FC Sion,3840,9,7,7,18,41,58,-17,28
Young Boys,3841,1,20,9,3,70,35,35,69
FC Basel,3841,2,18,8,6,55,25,30,62
St Gallen,3841,3,16,2,14,44,51,-7,50
Lucerne,3841,4,13,8,11,42,47,-5,47
FC Zürich,3841,5,11,9,12,42,38,4,42
FC Thun,3841,6,11,5,16,48,61,-13,38
FC Lugano,3841,7,11,5,16,32,48,-16,38
Grasshoppers,3841,8,8,6,18,38,52,-14,30
FC Sion,3841,9,6,8,18,41,55,-14,26
Young Boys,3842,1,22,6,4,73,41,32,72
FC Basel,3842,2,19,7,6,56,25,31,64
Lucerne,3842,3,14,7,11,47,44,3,49
FC Zürich,3842,4,12,9,11,47,36,11,45
St Gallen,3842,5,14,2,16,43,58,-15,44
FC Lugano,3842,6,11,5,16,32,46,-14,38
Grasshoppers,3842,7,10,6,16,44,51,-7,36
FC Thun,3842,8,9,6,17,45,64,-19,33
FC Sion,3842,9,5,8,19,41,63,-22,23
Young Boys,3843,1,19,8,5,69,41,28,65
FC Basel,3843,2,19,7,6,61,27,34,64
St Gallen,3843,3,15,2,15,44,56,-12,47
Lucerne,3843,4,12,9,11,44,46,-2,45
FC Lugano,3843,5,11,6,15,37,51,-14,39
Grasshoppers,3843,6,10,7,15,42,49,-7,37
FC Zürich,3843,7,9,9,14,41,42,-1,36
FC Thun,3843,8,10,5,17,44,62,-18,35
FC Sion,3843,9,9,7,16,47,55,-8,34
Young Boys,3844,1,23,6,3,71,33,38,75
FC Basel,3844,2,17,9,6,52,26,26,60
St Gallen,3844,3,14,5,13,43,53,-10,47
Lucerne,3844,4,12,9,11,40,43,-3,45
FC Zürich,3844,5,10,10,12,40,37,3,40
FC Lugano,3844,6,10,6,16,29,45,-16,36
Grasshoppers,3844,7,9,7,16,43,50,-7,34
FC Thun,3844,8,9,7,16,43,58,-15,34
FC Sion,3844,9,7,7,18,41,57,-16,28
Young Boys,3845,1,21,7,4,75,34,41,70
FC Basel,3845,2,18,9,5,57,24,33,63
St Gallen,3845,3,15,2,15,41,55,-14,47
Lucerne,3845,4,11,10,11,41,44,-3,43
FC Zürich,3845,5,11,9,12,40,36,4,42
FC Lugano,3845,6,12,5,15,30,43,-13,41
Grasshoppers,3845,7,10,7,15,42,50,-8,37
FC Thun,3845,8,9,6,17,43,58,-15,33
FC Sion,3845,9,6,7,19,36,61,-25,25
Young Boys,3846,1,21,6,5,74,35,39,69
FC Basel,3846,2,18,9,5,60,26,34,63
Lucerne,3846,3,14,8,10,44,46,-2,50
St Gallen,3846,4,15,4,13,43,52,-9,49
FC Zürich,3846,5,10,10,12,41,38,3,40
FC Thun,3846,6,11,5,16,46,60,-14,38
Grasshoppers,3846,7,10,6,16,43,50,-7,36
FC Lugano,3846,8,10,5,17,31,49,-18,35
FC Sion,3846,9,5,7,20,36,62,-26,22
Young Boys,3847,1,21,7,4,69,33,36,70
FC Basel,3847,2,18,8,6,52,25,27,62
Lucerne,3847,3,14,8,10,44,42,2,50
St Gallen,3847,4,14,3,15,42,54,-12,45
FC Zürich,3847,5,11,10,11,43,36,7,43
FC Lugano,3847,6,9,7,16,30,50,-20,34
Grasshoppers,3847,7,9,6,17,41,53,-12,33
FC Sion,3847,8,8,8,16,43,51,-8,32
FC Thun,3847,9,9,5,18,43,63,-20,32
Young Boys,3848,1,23,6,3,73,37,36,75
FC Basel,3848,2,18,8,6,55,24,31,62
Lucerne,3848,3,13,8,11,44,44,0,47
St Gallen,3848,4,14,2,16,42,55,-13,44
FC Zürich,3848,5,10,9,13,40,42,-2,39
FC Lugano,3848,6,11,5,16,33,48,-15,38
FC Thun,3848,7,10,6,16,46,56,-10,36
FC Sion,3848,8,8,8,16,41,53,-12,32
Grasshoppers,3848,9,8,6,18,40,55,-15,30
Young Boys,3849,1,22,6,4,73,36,37,72
FC Basel,3849,2,17,9,6,52,25,27,60
Lucerne,3849,3,13,7,12,44,47,-3,46
St Gallen,3849,4,14,3,15,46,60,-14,45
FC Zürich,3849,5,11,10,11,44,40,4,43
FC Lugano,3849,6,11,5,16,37,52,-15,38
FC Thun,3849,7,10,6,16,44,59,-15,36
Grasshoppers,3849,8,9,6,17,38,48,-10,33
FC Sion,3849,9,7,8,17,43,54,-11,29
Young Boys,3850,1,22,7,3,74,37,37,73
FC Basel,3850,2,17,9,6,54,25,29,60
Lucerne,3850,3,13,7,12,46,50,-4,46
St Gallen,3850,4,13,4,15,40,55,-15,43
FC Zürich,3850,5,10,10,12,42,41,1,40
FC Lugano,3850,6,11,6,15,32,45,-13,39
Grasshoppers,3850,7,10,7,15,45,50,-5,37
FC Thun,3850,8,9,6,17,43,61,-18,33
FC Sion,3850,9,6,10,16,43,55,-12,28
Young Boys,3851,1,23,7,2,75,34,41,76
FC Basel,3851,2,18,8,6,54,24,30,62
Lucerne,3851,3,13,8,11,40,39,1,47
St Gallen,3851,4,13,4,15,39,56,-17,43
FC Thun,3851,5,11,5,16,45,58,-13,38
FC Zürich,3851,6,9,10,13,39,38,1,37
FC Lugano,3851,7,10,6,16,30,48,-18,36
Grasshoppers,3851,8,9,7,16,40,50,-10,34
FC Sion,3851,9,5,11,16,40,55,-15,26
Young Boys,3852,1,22,8,2,73,33,40,74
FC Basel,3852,2,18,7,7,53,27,26,61
FC Zürich,3852,3,12,10,10,45,35,10,46
St Gallen,3852,4,14,3,15,43,55,-12,45
Lucerne,3852,5,11,7,14,39,46,-7,40
FC Lugano,3852,6,11,5,16,34,52,-18,38
Grasshoppers,3852,7,10,7,15,43,49,-6,37
FC Thun,3852,8,9,5,18,42,63,-21,32
FC Sion,3852,9,6,10,16,41,53,-12,28
Young Boys,3853,1,22,7,3,73,33,40,73
FC Basel,3853,2,18,9,5,57,25,32,63
St Gallen,3853,3,15,2,15,46,57,-11,47
Lucerne,3853,4,12,8,12,39,45,-6,44
FC Zürich,3853,5,9,12,11,39,39,0,39
FC Thun,3853,6,11,5,16,46,57,-11,38
FC Lugano,3853,7,9,6,17,29,51,-22,33
FC Sion,3853,8,8,8,16,44,51,-7,32
Grasshoppers,3853,9,8,7,17,38,53,-15,31
Young Boys,3854,1,21,7,4,70,37,33,70
FC Basel,3854,2,17,10,5,56,26,30,61
Lucerne,3854,3,13,8,11,44,44,0,47
St Gallen,3854,4,13,4,15,44,58,-14,43
FC Zürich,3854,5,10,10,12,39,38,1,40
FC Lugano,3854,6,10,7,15,31,47,-16,37
Grasshoppers,3854,7,10,6,16,41,50,-9,36
FC Thun,3854,8,10,6,16,44,57,-13,36
FC Sion,3854,9,7,8,17,40,52,-12,29
Young Boys,3855,1,23,7,2,71,33,38,76
FC Basel,3855,2,17,9,6,51,25,26,60
Lucerne,3855,3,13,9,10,41,40,1,48
St Gallen,3855,4,13,2,17,42,58,-16,41
FC Zürich,3855,5,10,10,12,39,39,0,40
FC Thun,3855,6,10,6,16,47,59,-12,36
FC Lugano,3855,7,10,6,16,30,47,-17,36
Grasshoppers,3855,8,8,9,15,40,49,-9,33
FC Sion,3855,9,7,8,17,42,53,-11,29
Young Boys,3856,1,20,9,3,72,37,35,69
FC Basel,3856,2,18,9,5,54,23,31,63
Lucerne,3856,3,14,8,10,44,41,3,50
St Gallen,3856,4,14,4,14,41,52,-11,46
FC Zürich,3856,5,11,9,12,43,39,4,42
Grasshoppers,3856,6,10,6,16,46,51,-5,36
FC Lugano,3856,7,9,7,16,31,51,-20,34
FC Thun,3856,8,9,5,18,43,65,-22,32
FC Sion,3856,9,7,7,18,43,58,-15,28
Young Boys,3857,1,23,7,2,76,35,41,76
FC Basel,3857,2,17,8,7,55,27,28,59
Lucerne,3857,3,13,9,10,46,45,1,48
St Gallen,3857,4,15,3,14,47,58,-11,48
FC Zürich,3857,5,9,10,13,38,39,-1,37
FC Thun,3857,6,10,6,16,43,56,-13,36
FC Lugano,3857,7,10,6,16,35,52,-17,36
Grasshoppers,3857,8,9,6,17,40,53,-13,33
FC Sion,3857,9,6,9,17,40,55,-15,27
Young Boys,3858,1,22,7,3,72,37,35,73
FC Basel,3858,2,17,7,8,55,30,25,58
St Gallen,3858,3,15,3,14,46,54,-8,48
FC Zürich,3858,4,11,10,11,42,37,5,43
Lucerne,3858,5,11,9,12,40,46,-6,42
FC Lugano,3858,6,10,6,16,28,46,-18,36
Grasshoppers,3858,7,9,8,15,41,49,-8,35
FC Thun,3858,8,10,5,17,43,58,-15,35
FC Sion,3858,9,8,7,17,44,54,-10,31
Young Boys,3859,1,24,6,2,74,34,40,78
FC Basel,3859,2,18,8,6,55,25,30,62
Lucerne,3859,3,13,8,11,39,41,-2,47
St Gallen,3859,4,13,3,16,39,57,-18,42
FC Zürich,3859,5,10,10,12,41,38,3,40
FC Lugano,3859,6,11,5,16,33,47,-14,38
FC Thun,3859,7,10,5,17,44,59,-15,35
Grasshoppers,3859,8,9,6,17,42,52,-10,33
FC Sion,3859,9,7,7,18,42,56,-14,28
Young Boys,3860,1,23,7,2,74,34,40,76
FC Basel,3860,2,17,8,7,57,29,28,59
St Gallen,3860,3,16,2,14,45,53,-8,50
FC Zürich,3860,4,11,11,10,40,34,6,44
Lucerne,3860,5,12,8,12,42,45,-3,44
Grasshoppers,3860,6,9,9,14,44,51,-7,36
FC Thun,3860,7,9,7,16,45,64,-19,34
FC Lugano,3860,8,9,6,17,28,47,-19,33
FC Sion,3860,9,5,8,19,37,55,-18,23
Young Boys,3861,1,23,6,3,75,33,42,75
FC Basel,3861,2,19,7,6,53,24,29,64
Lucerne,3861,3,14,7,11,44,45,-1,49
St Gallen,3861,4,15,2,15,42,54,-12,47
FC Zürich,3861,5,11,10,11,42,36,6,43
FC Thun,3861,6,9,6,17,44,60,-16,33
FC Lugano,3861,7,9,5,18,30,51,-21,32
Grasshoppers,3861,8,8,7,17,37,52,-15,31
FC Sion,3861,9,7,8,17,41,53,-12,29
Young Boys,3862,1,21,7,4,69,35,34,70
FC Basel,3862,2,19,7,6,59,27,32,64
Lucerne,3862,3,13,9,10,44,43,1,48
FC Zürich,3862,4,11,10,11,38,35,3,43
St Gallen,3862,5,13,3,16,41,56,-15,42
Grasshoppers,3862,6,10,8,14,40,46,-6,38
FC Lugano,3862,7,9,9,14,30,45,-15,36
FC Thun,3862,8,8,6,18,41,61,-20,30
FC Sion,3862,9,6,9,17,38,52,-14,27
Young Boys,3863,1,21,8,3,69,33,36,71
FC Basel,3863,2,17,8,7,54,30,24,59
FC Zürich,3863,3,12,9,11,41,34,7,45
St Gallen,3863,4,14,3,15,41,55,-14,45
Lucerne,3863,5,11,10,11,38,42,-4,43
FC Thun,3863,6,11,5,16,46,57,-11,38
Grasshoppers,3863,7,10,6,16,39,47,-8,36
FC Lugano,3863,8,10,6,16,31,46,-15,36
FC Sion,3863,9,7,7,18,39,54,-15,28
Young Boys,3864,1,20,7,5,69,36,33,67
FC Basel,3864,2,17,9,6,57,28,29,60
Lucerne,3864,3,14,9,9,46,42,4,51
St Gallen,3864,4,13,3,16,42,57,-15,42
FC Zürich,3864,5,10,11,11,44,36,8,41
FC Lugano,3864,6,11,6,15,31,46,-15,39
FC Sion,3864,7,9,7,16,43,55,-12,34
Grasshoppers,3864,8,9,6,17,38,50,-12,33
FC Thun,3864,9,9,6,17,41,61,-20,33
Young Boys,3865,1,21,7,4,71,38,33,70
FC Basel,3865,2,18,9,5,55,24,31,63
Lucerne,3865,3,12,8,12,42,45,-3,44
St Gallen,3865,4,14,2,16,44,58,-14,44
Grasshoppers,3865,5,12,6,14,46,49,-3,42
FC Zürich,3865,6,9,11,12,40,38,2,38
FC Thun,3865,7,10,6,16,44,57,-13,36
FC Lugano,3865,8,10,6,16,32,49,-17,36
FC Sion,3865,9,7,7,18,40,56,-16,28
Young Boys,3866,1,23,7,2,75,30,45,76
FC Basel,3866,2,18,8,6,51,28,23,62
Lucerne,3866,3,13,8,11,42,43,-1,47
FC Zürich,3866,4,12,9,11,47,35,12,45
St Gallen,3866,5,13,2,17,39,60,-21,41
FC Lugano,3866,6,11,5,16,33,46,-13,38
Grasshoppers,3866,7,9,8,15,39,52,-13,35
FC Thun,3866,8,8,7,17,42,60,-18,31
FC Sion,3866,9,6,8,18,39,53,-14,26
Young Boys,3867,1,23,6,3,82,37,45,75
FC Basel,3867,2,18,9,5,56,27,29,63
Lucerne,3867,3,13,7,12,43,46,-3,46
St Gallen,3867,4,14,3,15,44,55,-11,45
FC Zürich,3867,5,9,11,12,40,40,0,38
Grasshoppers,3867,6,10,6,16,43,52,-9,36
FC Lugano,3867,7,10,6,16,31,47,-16,36
FC Thun,3867,8,9,7,16,44,57,-13,34
FC Sion,3867,9,7,7,18,44,66,-22,28
Young Boys,3868,1,21,7,4,70,35,35,70
FC Basel,3868,2,17,8,7,53,30,23,59
St Gallen,3868,3,15,3,14,46,55,-9,48
FC Zürich,3868,4,12,9,11,44,35,9,45
Lucerne,3868,5,12,7,13,40,44,-4,43
FC Lugano,3868,6,11,6,15,32,46,-14,39
Grasshoppers,3868,7,10,6,16,42,50,-8,36
FC Thun,3868,8,10,5,17,42,57,-15,35
FC Sion,3868,9,7,7,18,39,56,-17,28
Young Boys,3869,1,22,6,4,73,36,37,72
FC Basel,3869,2,18,8,6,57,26,31,62
Lucerne,3869,3,15,7,10,47,40,7,52
St Gallen,3869,4,15,3,14,43,53,-10,48
FC Zürich,3869,5,11,10,11,43,40,3,43
FC Lugano,3869,6,10,6,16,31,49,-18,36
FC Thun,3869,7,10,5,17,43,59,-16,35
Grasshoppers,3869,8,9,6,17,41,53,-12,33
FC Sion,3869,9,5,7,20,37,59,-22,22
Young Boys,3870,1,21,8,3,70,33,37,71
FC Basel,3870,2,18,9,5,57,26,31,63
Lucerne,3870,3,13,7,12,43,42,1,46
St Gallen,3870,4,14,3,15,41,56,-15,45
FC Zürich,3870,5,10,10,12,39,36,3,40
FC Lugano,3870,6,11,6,15,33,49,-16,39
Grasshoppers,3870,7,10,6,16,41,49,-8,36
FC Thun,3870,8,9,6,17,42,61,-19,33
FC Sion,3870,9,7,7,18,40,54,-14,28
Young Boys,3871,1,20,7,5,68,35,33,67
FC Basel,3871,2,19,8,5,52,23,29,65
St Gallen,3871,3,14,4,14,43,55,-12,46
Lucerne,3871,4,12,7,13,39,45,-6,43
FC Zürich,3871,5,11,9,12,42,39,3,42
FC Lugano,3871,6,12,6,14,36,45,-9,42
Grasshoppers,3871,7,10,7,15,44,50,-6,37
FC Thun,3871,8,8,6,18,42,61,-19,30
FC Sion,3871,9,6,10,16,39,52,-13,28
Young Boys,3872,1,22,8,2,79,36,43,74
FC Basel,3872,2,18,9,5,56,27,29,63
St Gallen,3872,3,14,4,14,41,52,-11,46
Lucerne,3872,4,12,8,12,40,46,-6,44
FC Zürich,3872,5,11,9,12,41,35,6,42
FC Lugano,3872,6,10,7,15,30,45,-15,37
FC Thun,3872,7,10,5,17,43,57,-14,35
Grasshoppers,3872,8,8,8,16,40,51,-11,32
FC Sion,3872,9,6,8,18,38,59,-21,26
Young Boys,3873,1,21,9,2,67,30,37,72
FC Basel,3873,2,17,8,7,52,27,25,59
St Gallen,3873,3,16,2,14,47,52,-5,50
FC Zürich,3873,4,11,9,12,41,36,5,42
Lucerne,3873,5,11,9,12,38,46,-8,42
Grasshoppers,3873,6,10,8,14,43,49,-6,38
FC Lugano,3873,7,10,6,16,29,47,-18,36
FC Thun,3873,8,9,8,15,43,57,-14,35
FC Sion,3873,9,5,9,18,41,57,-16,24
Young Boys,3874,1,22,6,4,72,36,36,72
FC Basel,3874,2,17,9,6,52,27,25,60
St Gallen,3874,3,14,4,14,43,53,-10,46
Lucerne,3874,4,12,9,11,39,41,-2,45
Grasshoppers,3874,5,12,6,14,46,47,-1,42
FC Zürich,3874,6,10,10,12,42,39,3,40
FC Thun,3874,7,10,6,16,46,58,-12,36
FC Lugano,3874,8,10,6,16,30,47,-17,36
FC Sion,3874,9,5,8,19,39,61,-22,23
Young Boys,3875,1,22,6,4,75,39,36,72
FC Basel,3875,2,18,8,6,56,30,26,62
Lucerne,3875,3,14,7,11,50,48,2,49
St Gallen,3875,4,14,3,15,43,56,-13,45
FC Zürich,3875,5,11,11,10,44,36,8,44
FC Lugano,3875,6,11,5,16,34,49,-15,38
Grasshoppers,3875,7,9,7,16,43,53,-10,34
FC Thun,3875,8,8,8,16,43,59,-16,32
FC Sion,3875,9,5,9,18,36,54,-18,24
Young Boys,3876,1,21,8,3,68,33,35,71
FC Basel,3876,2,17,8,7,50,25,25,59
St Gallen,3876,3,16,2,14,46,55,-9,50
Lucerne,3876,4,12,8,12,42,45,-3,44
FC Zürich,3876,5,10,10,12,39,37,2,40
Grasshoppers,3876,6,10,7,15,42,49,-7,37
FC Thun,3876,7,10,6,16,46,58,-12,36
FC Lugano,3876,8,10,6,16,31,48,-17,36
FC Sion,3876,9,6,9,17,42,56,-14,27
Young Boys,3877,1,24,6,2,77,34,43,78
FC Basel,3877,2,17,9,6,51,25,26,60
Lucerne,3877,3,14,7,11,44,41,3,49
FC Zürich,3877,4,12,10,10,47,36,11,46
St Gallen,3877,5,14,3,15,43,57,-14,45
FC Thun,3877,6,10,5,17,44,61,-17,35
FC Lugano,3877,7,10,5,17,32,52,-20,35
Grasshoppers,3877,8,9,6,17,43,55,-12,33
FC Sion,3877,9,5,7,20,39,59,-20,22
Young Boys,3878,1,21,7,4,70,36,34,70
FC Basel,3878,2,17,9,6,52,26,26,60
Lucerne,3878,3,13,8,11,45,44,1,47
St Gallen,3878,4,15,2,15,45,56,-11,47
FC Zürich,3878,5,10,11,11,39,37,2,41
Grasshoppers,3878,6,10,7,15,46,50,-4,37
FC Thun,3878,7,10,6,16,42,55,-13,36
FC Lugano,3878,8,10,5,17,30,49,-19,35
FC Sion,3878,9,7,7,18,41,57,-16,28
Young Boys,3879,1,21,9,2,71,33,38,72
FC Basel,3879,2,19,8,5,57,24,33,65
St Gallen,3879,3,14,2,16,42,57,-15,44
FC Zürich,3879,4,11,10,11,40,36,4,43
Lucerne,3879,5,12,7,13,38,43,-5,43
FC Lugano,3879,6,10,5,17,29,48,-19,35
Grasshoppers,3879,7,9,7,16,41,51,-10,34
FC Thun,3879,8,9,6,17,44,61,-17,33
FC Sion,3879,9,8,8,16,45,54,-9,32
Young Boys,3880,1,21,8,3,71,37,34,71
FC Basel,3880,2,17,9,6,54,27,27,60
St Gallen,3880,3,14,5,13,42,52,-10,47
Lucerne,3880,4,12,10,10,45,45,0,46
FC Zürich,3880,5,9,12,11,40,38,2,39
Grasshoppers,3880,6,10,8,14,41,46,-5,38
FC Lugano,3880,7,9,8,15,32,49,-17,35
FC Thun,3880,8,8,7,17,43,60,-17,31
FC Sion,3880,9,5,11,16,41,55,-14,26
Young Boys,3881,1,21,8,3,73,36,37,71
FC Basel,3881,2,16,9,7,54,28,26,57
Lucerne,3881,3,13,8,11,44,48,-4,47
St Gallen,3881,4,15,2,15,46,58,-12,47
FC Zürich,3881,5,12,10,10,41,33,8,46
FC Lugano,3881,6,10,6,16,32,48,-16,36
FC Thun,3881,7,9,6,17,43,63,-20,33
FC Sion,3881,8,8,8,16,46,54,-8,32
Grasshoppers,3881,9,8,7,17,36,47,-11,31
Young Boys,3882,1,22,7,3,73,34,39,73
FC Basel,3882,2,16,10,6,50,25,25,58
St Gallen,3882,3,16,2,14,44,54,-10,50
Lucerne,3882,4,11,10,11,44,48,-4,43
FC Zürich,3882,5,10,10,12,38,36,2,40
FC Thun,3882,6,11,6,15,49,57,-8,39
FC Lugano,3882,7,10,6,16,32,47,-15,36
Grasshoppers,3882,8,9,7,16,43,54,-11,34
FC Sion,3882,9,6,8,18,40,58,-18,26
Young Boys,3883,1,22,7,3,73,34,39,73
FC Basel,3883,2,17,9,6,54,26,28,60
Lucerne,3883,3,13,8,11,41,44,-3,47
FC Zürich,3883,4,11,10,11,40,34,6,43
FC Lugano,3883,5,12,5,15,33,45,-12,41
St Gallen,3883,6,13,2,17,39,59,-20,41
Grasshoppers,3883,7,10,7,15,40,46,-6,37
FC Thun,3883,8,8,8,16,40,56,-16,32
FC Sion,3883,9,6,8,18,38,54,-16,26
Young Boys,3884,1,22,7,3,73,37,36,73
FC Basel,3884,2,19,7,6,60,28,32,64
St Gallen,3884,3,15,2,15,47,60,-13,47
FC Zürich,3884,4,11,10,11,42,36,6,43
Lucerne,3884,5,12,7,13,43,50,-7,43
FC Lugano,3884,6,11,6,15,34,46,-12,39
FC Thun,3884,7,11,5,16,46,57,-11,38
Grasshoppers,3884,8,9,6,17,40,52,-12,33
FC Sion,3884,9,5,8,19,41,60,-19,23
Young Boys,3885,1,22,7,3,74,34,40,73
FC Basel,3885,2,18,8,6,53,24,29,62
Lucerne,3885,3,13,8,11,41,44,-3,47
FC Zürich,3885,4,11,10,11,40,34,6,43
St Gallen,3885,5,13,4,15,39,53,-14,43
FC Lugano,3885,6,10,6,16,32,49,-17,36
Grasshoppers,3885,7,9,6,17,41,53,-12,33
FC Thun,3885,8,9,6,17,44,62,-18,33
FC Sion,3885,9,7,9,16,42,53,-11,30
Young Boys,3886,1,24,6,2,73,32,41,78
FC Basel,3886,2,18,7,7,53,29,24,61
St Gallen,3886,3,14,3,15,47,58,-11,45
Lucerne,3886,4,12,8,12,43,46,-3,44
FC Zürich,3886,5,11,9,12,40,35,5,42
Grasshoppers,3886,6,10,6,16,42,50,-8,36
FC Lugano,3886,7,10,6,16,32,48,-16,36
FC Thun,3886,8,9,6,17,44,60,-16,33
FC Sion,3886,9,6,9,17,41,57,-16,27
Young Boys,3887,1,22,8,2,74,33,41,74
FC Basel,3887,2,19,8,5,57,25,32,65
Lucerne,3887,3,12,8,12,38,41,-3,44
St Gallen,3887,4,14,2,16,41,55,-14,44
FC Zürich,3887,5,11,10,11,42,35,7,43
Grasshoppers,3887,6,10,7,15,45,52,-7,37
FC Lugano,3887,7,10,5,17,28,46,-18,35
FC Thun,3887,8,9,7,16,47,60,-13,34
FC Sion,3887,9,6,7,19,37,62,-25,25
Young Boys,3888,1,23,7,2,75,35,40,76
FC Basel,3888,2,18,7,7,56,26,30,61
Lucerne,3888,3,12,9,11,46,53,-7,45
St Gallen,3888,4,14,2,16,46,60,-14,44
FC Zürich,3888,5,11,9,12,42,38,4,42
FC Lugano,3888,6,11,7,14,33,44,-11,40
Grasshoppers,3888,7,9,8,15,45,51,-6,35
FC Thun,3888,8,9,6,17,43,58,-15,33
FC Sion,3888,9,6,7,19,41,62,-21,25
Young Boys,3889,1,20,7,5,72,36,36,67
FC Basel,3889,2,18,7,7,56,27,29,61
Lucerne,3889,3,13,8,11,43,48,-5,47
St Gallen,3889,4,15,2,15,45,55,-10,47
FC Zürich,3889,5,10,11,11,41,37,4,41
Grasshoppers,3889,6,10,7,15,45,50,-5,37
FC Lugano,3889,7,10,6,16,31,47,-16,36
FC Thun,3889,8,9,6,17,45,65,-20,33
FC Sion,3889,9,8,8,16,42,55,-13,32
Young Boys,3890,1,21,9,2,73,35,38,72
FC Basel,3890,2,16,10,6,58,27,31,58
Lucerne,3890,3,13,8,11,44,46,-2,47
St Gallen,3890,4,14,2,16,41,57,-16,44
FC Zürich,3890,5,11,10,11,44,39,5,43
Grasshoppers,3890,6,11,7,14,45,49,-4,40
FC Lugano,3890,7,11,5,16,32,47,-15,38
FC Thun,3890,8,8,6,18,41,65,-24,30
FC Sion,3890,9,6,9,17,41,54,-13,27
Young Boys,3891,1,21,8,3,68,34,34,71
FC Basel,3891,2,18,9,5,56,23,33,63
St Gallen,3891,3,15,3,14,45,53,-8,48
FC Zürich,3891,4,10,12,10,40,34,6,42
Lucerne,3891,5,11,8,13,41,50,-9,41
FC Lugano,3891,6,10,6,16,29,46,-17,36
Grasshoppers,3891,7,9,8,15,41,48,-7,35
FC Sion,3891,8,8,8,16,43,53,-10,32
FC Thun,3891,9,8,6,18,40,62,-22,30
Young Boys,3892,1,20,9,3,74,38,36,69
FC Basel,3892,2,19,8,5,55,23,32,65
Lucerne,3892,3,13,9,10,45,43,2,48
St Gallen,3892,4,13,2,17,43,60,-17,41
FC Lugano,3892,5,11,7,14,33,46,-13,40
FC Zürich,3892,6,9,10,13,37,36,1,37
FC Thun,3892,7,10,6,16,45,58,-13,36
Grasshoppers,3892,8,9,6,17,39,53,-14,33
FC Sion,3892,9,8,7,17,42,56,-14,31
Young Boys,3893,1,22,6,4,72,37,35,72
FC Basel,3893,2,18,7,7,56,29,27,61
St Gallen,3893,3,15,2,15,42,57,-15,47
FC Zürich,3893,4,12,9,11,44,37,7,45
Lucerne,3893,5,12,8,12,40,43,-3,44
Grasshoppers,3893,6,10,7,15,41,47,-6,37
FC Thun,3893,7,10,5,17,43,58,-15,35
FC Lugano,3893,8,10,5,17,31,49,-18,35
FC Sion,3893,9,7,7,18,42,54,-12,28
Young Boys,3894,1,22,7,3,75,34,41,73
FC Basel,3894,2,18,9,5,51,23,28,63
St Gallen,3894,3,14,4,14,44,54,-10,46
FC Zürich,3894,4,10,12,10,44,38,6,42
Lucerne,3894,5,11,9,12,39,48,-9,42
FC Lugano,3894,6,10,8,14,35,49,-14,38
Grasshoppers,3894,7,9,7,16,39,49,-10,34
FC Thun,3894,8,8,7,17,40,57,-17,31
FC Sion,3894,9,6,9,17,39,54,-15,27
Young Boys,3895,1,21,7,4,71,36,35,70
FC Basel,3895,2,19,8,5,55,21,34,65
Lucerne,3895,3,13,9,10,41,39,2,48
St Gallen,3895,4,14,3,15,40,53,-13,45
FC Zürich,3895,5,10,9,13,39,39,0,39
FC Lugano,3895,6,10,7,15,32,46,-14,37
FC Thun,3895,7,10,5,17,43,60,-17,35
Grasshoppers,3895,8,9,7,16,41,51,-10,34
FC Sion,3895,9,7,7,18,40,57,-17,28
Young Boys,3896,1,23,6,3,76,35,41,75
FC Basel,3896,2,18,7,7,56,28,28,61
FC Zürich,3896,3,13,9,10,45,35,10,48
St Gallen,3896,4,15,3,14,43,52,-9,48
Lucerne,3896,5,12,9,11,40,45,-5,45
Grasshoppers,3896,6,10,7,15,44,48,-4,37
FC Lugano,3896,7,9,6,17,29,48,-19,33
FC Thun,3896,8,8,6,18,43,64,-21,30
FC Sion,3896,9,5,9,18,39,60,-21,24
Young Boys,3897,1,20,8,4,67,34,33,68
FC Basel,3897,2,18,8,6,53,25,28,62
St Gallen,3897,3,15,3,14,43,54,-11,48
FC Zürich,3897,4,11,11,10,41,35,6,44
Lucerne,3897,5,12,8,12,40,44,-4,44
Grasshoppers,3897,6,10,7,15,40,47,-7,37
FC Lugano,3897,7,10,7,15,29,45,-16,37
FC Thun,3897,8,10,5,17,43,57,-14,35
FC Sion,3897,9,6,7,19,40,55,-15,25
Young Boys,3898,1,22,6,4,71,34,37,72
FC Basel,3898,2,16,9,7,54,28,26,57
St Gallen,3898,3,16,3,13,48,54,-6,51
Lucerne,3898,4,11,10,11,43,46,-3,43
FC Zürich,3898,5,10,12,10,43,34,9,42
Grasshoppers,3898,6,10,7,15,39,46,-7,37
FC Thun,3898,7,10,6,16,42,58,-16,36
FC Lugano,3898,8,10,6,16,30,51,-21,36
FC Sion,3898,9,6,7,19,40,59,-19,25
Young Boys,3899,1,21,7,4,73,38,35,70
FC Basel,3899,2,19,7,6,58,24,34,64
St Gallen,3899,3,15,2,15,45,54,-9,47
FC Zürich,3899,4,11,11,10,45,38,7,44
Lucerne,3899,5,11,8,13,37,49,-12,41
Grasshoppers,3899,6,10,8,14,41,47,-6,38
FC Lugano,3899,7,10,8,14,36,50,-14,38
FC Thun,3899,8,9,7,16,41,57,-16,34
FC Sion,3899,9,5,8,19,40,59,-19,23
Young Boys,3900,1,20,6,6,69,40,29,66
FC Basel,3900,2,18,9,5,56,26,30,63
Lucerne,3900,3,15,8,9,47,41,6,53
St Gallen,3900,4,13,4,15,42,55,-13,43
FC Zürich,3900,5,10,11,11,41,35,6,41
FC Lugano,3900,6,11,6,15,33,46,-13,39
Grasshoppers,3900,7,10,6,16,43,51,-8,36
FC Thun,3900,8,10,6,16,46,59,-13,36
FC Sion,3900,9,5,8,19,35,59,-24,23
Young Boys,3901,1,22,6,4,73,35,38,72
FC Basel,3901,2,17,8,7,55,27,28,59
St Gallen,3901,3,15,4,13,46,53,-7,49
Lucerne,3901,4,13,9,10,45,46,-1,48
FC Zürich,3901,5,10,10,12,42,40,2,40
Grasshoppers,3901,6,11,7,14,44,47,-3,40
FC Lugano,3901,7,9,7,16,32,51,-19,34
FC Thun,3901,8,8,6,18,40,61,-21,30
FC Sion,3901,9,7,7,18,39,56,-17,28
Young Boys,3902,1,21,8,3,70,32,38,71
FC Basel,3902,2,18,8,6,56,25,31,62
Lucerne,3902,3,14,7,11,44,41,3,49
St Gallen,3902,4,15,2,15,41,54,-13,47
FC Zürich,3902,5,12,10,10,46,37,9,46
Grasshoppers,3902,6,10,7,15,41,48,-7,37
FC Thun,3902,7,9,6,17,44,61,-17,33
FC Lugano,3902,8,9,5,18,29,52,-23,32
FC Sion,3902,9,6,7,19,39,60,-21,25
Young Boys,3903,1,22,6,4,75,37,38,72
FC Basel,3903,2,18,8,6,59,28,31,62
Lucerne,3903,3,14,7,11,48,43,5,49
St Gallen,3903,4,14,3,15,42,53,-11,45
FC Zürich,3903,5,11,10,11,41,35,6,43
FC Lugano,3903,6,11,5,16,30,53,-23,38
Grasshoppers,3903,7,10,7,15,42,47,-5,37
FC Thun,3903,8,8,6,18,40,61,-21,30
FC Sion,3903,9,6,8,18,36,56,-20,26
Young Boys,3904,1,21,7,4,69,37,32,70
FC Basel,3904,2,18,9,5,56,23,33,63
Lucerne,3904,3,14,9,9,44,39,5,51
FC Zürich,3904,4,10,12,10,41,35,6,42
St Gallen,3904,5,13,3,16,41,57,-16,42
FC Lugano,3904,6,10,7,15,32,46,-14,37
FC Thun,3904,7,9,5,18,41,64,-23,32
Grasshoppers,3904,8,8,7,17,40,52,-12,31
FC Sion,3904,9,6,11,15,39,50,-11,29
Young Boys,3905,1,23,6,3,72,33,39,75
FC Basel,3905,2,19,7,6,57,25,32,64
Lucerne,3905,3,13,8,11,42,43,-1,47
FC Zürich,3905,4,11,10,11,43,35,8,43
St Gallen,3905,5,13,3,16,40,56,-16,42
FC Lugano,3905,6,10,5,17,29,49,-20,35
FC Thun,3905,7,9,7,16,44,59,-15,34
Grasshoppers,3905,8,9,6,17,42,55,-13,33
FC Sion,3905,9,7,8,17,41,55,-14,29
Young Boys,3906,1,22,6,4,73,35,38,72
FC Basel,3906,2,18,8,6,56,27,29,62
St Gallen,3906,3,15,2,15,44,56,-12,47
Lucerne,3906,4,11,7,14,37,48,-11,40
FC Zürich,3906,5,10,9,13,42,41,1,39
Grasshoppers,3906,6,11,6,15,42,46,-4,39
FC Lugano,3906,7,11,5,16,35,47,-12,38
FC Thun,3906,8,10,7,15,42,55,-13,37
FC Sion,3906,9,7,8,17,41,57,-16,29
Young Boys,3907,1,21,6,5,68,37,31,69
FC Basel,3907,2,17,8,7,51,26,25,59
Lucerne,3907,3,13,8,11,43,46,-3,47
St Gallen,3907,4,14,4,14,46,56,-10,46
FC Zürich,3907,5,10,9,13,39,39,0,39
Grasshoppers,3907,6,10,7,15,41,48,-7,37
FC Thun,3907,7,10,6,16,45,58,-13,36
FC Lugano,3907,8,10,6,16,33,49,-16,36
FC Sion,3907,9,8,8,16,44,51,-7,32
Young Boys,3908,1,21,6,5,70,35,35,69
FC Basel,3908,2,19,7,6,55,23,32,64
St Gallen,3908,3,15,3,14,40,52,-12,48
Lucerne,3908,4,13,7,12,41,44,-3,46
FC Zürich,3908,5,10,10,12,42,39,3,40
Grasshoppers,3908,6,11,6,15,44,49,-5,39
FC Lugano,3908,7,11,6,15,30,46,-16,39
FC Thun,3908,8,9,6,17,46,62,-16,33
FC Sion,3908,9,6,7,19,40,58,-18,25
Young Boys,3909,1,21,7,4,68,34,34,70
FC Basel,3909,2,18,7,7,57,26,31,61
Lucerne,3909,3,14,7,11,41,42,-1,49
St Gallen,3909,4,15,3,14,44,51,-7,48
FC Zürich,3909,5,11,9,12,42,38,4,42
FC Thun,3909,6,10,6,16,45,58,-13,36
FC Lugano,3909,7,10,6,16,30,47,-17,36
Grasshoppers,3909,8,9,8,15,39,47,-8,35
FC Sion,3909,9,6,7,19,37,60,-23,25
Young Boys,3910,1,22,8,2,71,32,39,74
FC Basel,3910,2,18,8,6,54,23,31,62
St Gallen,3910,3,15,3,14,45,57,-12,48
FC Zürich,3910,4,11,11,10,40,34,6,44
Lucerne,3910,5,12,8,12,43,45,-2,44
Grasshoppers,3910,6,9,8,15,40,49,-9,35
FC Lugano,3910,7,9,7,16,32,52,-20,34
FC Thun,3910,8,8,6,18,41,60,-19,30
FC Sion,3910,9,5,11,16,38,52,-14,26
Young Boys,3911,1,20,7,5,70,40,30,67
FC Basel,3911,2,18,7,7,55,25,30,61
FC Zürich,3911,3,13,9,10,42,32,10,48
St Gallen,3911,4,15,2,15,44,55,-11,47
Lucerne,3911,5,12,7,13,40,46,-6,43
Grasshoppers,3911,6,11,6,15,46,51,-5,39
FC Lugano,3911,7,11,6,15,32,47,-15,39
FC Thun,3911,8,10,5,17,47,62,-15,35
FC Sion,3911,9,6,7,19,40,58,-18,25
Young Boys,3912,1,21,7,4,71,37,34,70
FC Basel,3912,2,17,9,6,59,28,31,60
Lucerne,3912,3,13,9,10,46,43,3,48
St Gallen,3912,4,14,2,16,42,58,-16,44
FC Zürich,3912,5,10,11,11,40,36,4,41
FC Lugano,3912,6,11,6,15,32,46,-14,39
Grasshoppers,3912,7,10,7,15,47,48,-1,37
FC Thun,3912,8,8,7,17,41,65,-24,31
FC Sion,3912,9,7,8,17,44,61,-17,29
Young Boys,3913,1,21,7,4,74,36,38,70
FC Basel,3913,2,16,11,5,52,26,26,59
St Gallen,3913,3,15,4,13,43,52,-9,49
Lucerne,3913,4,13,9,10,43,42,1,48
FC Zürich,3913,5,10,11,11,44,39,5,41
FC Lugano,3913,6,10,6,16,31,48,-17,36
FC Sion,3913,7,8,8,16,42,53,-11,32
FC Thun,3913,8,9,5,18,43,61,-18,32
Grasshoppers,3913,9,8,7,17,41,56,-15,31
Young Boys,3914,1,22,6,4,71,34,37,72
FC Basel,3914,2,19,8,5,56,23,33,65
Lucerne,3914,3,12,9,11,41,43,-2,45
St Gallen,3914,4,14,2,16,41,57,-16,44
FC Zürich,3914,5,11,10,11,44,38,6,43
Grasshoppers,3914,6,10,7,15,42,50,-8,37
FC Lugano,3914,7,10,6,16,31,47,-16,36
FC Thun,3914,8,9,7,16,43,59,-16,34
FC Sion,3914,9,5,9,18,38,56,-18,24
Young Boys,3915,1,21,8,3,75,38,37,71
FC Basel,3915,2,18,7,7,55,28,27,61
Lucerne,3915,3,14,7,11,46,46,0,49
St Gallen,3915,4,14,3,15,42,56,-14,45
FC Lugano,3915,5,11,6,15,32,46,-14,39
FC Thun,3915,6,11,5,16,45,56,-11,38
FC Zürich,3915,7,9,9,14,38,41,-3,36
Grasshoppers,3915,8,9,7,16,41,50,-9,34
FC Sion,3915,9,7,8,17,44,57,-13,29
Young Boys,3916,1,21,7,4,72,38,34,70
FC Basel,3916,2,17,10,5,56,27,29,61
St Gallen,3916,3,15,3,14,47,57,-10,48
Lucerne,3916,4,12,9,11,41,45,-4,45
FC Zürich,3916,5,9,11,12,38,37,1,38
Grasshoppers,3916,6,9,9,14,40,47,-7,36
FC Thun,3916,7,10,6,16,43,56,-13,36
FC Lugano,3916,8,9,6,17,29,48,-19,33
FC Sion,3916,9,7,9,16,44,55,-11,30
Young Boys,3917,1,22,8,2,77,35,42,74
FC Basel,3917,2,18,7,7,54,28,26,61
St Gallen,3917,3,15,3,14,44,51,-7,48
Lucerne,3917,4,12,8,12,40,48,-8,44
FC Zürich,3917,5,10,10,12,39,37,2,40
Grasshoppers,3917,6,11,7,14,45,47,-2,40
FC Lugano,3917,7,10,6,16,31,50,-19,36
FC Thun,3917,8,10,5,17,45,60,-15,35
FC Sion,3917,9,5,8,19,38,57,-19,23
Young Boys,3918,1,21,7,4,69,35,34,70
FC Basel,3918,2,17,8,7,55,26,29,59
Lucerne,3918,3,13,7,12,45,49,-4,46
St Gallen,3918,4,14,3,15,44,57,-13,45
FC Lugano,3918,5,12,5,15,34,46,-12,41
FC Zürich,3918,6,10,10,12,40,38,2,40
FC Thun,3918,7,11,6,15,46,57,-11,39
Grasshoppers,3918,8,9,6,17,38,51,-13,33
FC Sion,3918,9,6,10,16,40,52,-12,28
Young Boys,3919,1,23,7,2,72,34,38,76
FC Basel,3919,2,17,7,8,50,25,25,58
St Gallen,3919,3,16,2,14,44,52,-8,50
Lucerne,3919,4,13,8,11,45,43,2,47
FC Zürich,3919,5,10,11,11,43,37,6,41
Grasshoppers,3919,6,10,6,16,45,51,-6,36
FC Thun,3919,7,10,5,17,43,59,-16,35
FC Lugano,3919,8,9,6,17,29,53,-24,33
FC Sion,3919,9,6,8,18,37,54,-17,26
Young Boys,3920,1,21,9,2,72,36,36,72
FC Basel,3920,2,19,7,6,55,26,29,64
Lucerne,3920,3,13,9,10,43,43,0,48
St Gallen,3920,4,14,2,16,44,57,-13,44
Grasshoppers,3920,5,10,8,14,41,47,-6,38
FC Zürich,3920,6,9,9,14,39,40,-1,36
FC Thun,3920,7,10,5,17,44,58,-14,35
FC Lugano,3920,8,10,5,17,31,48,-17,35
FC Sion,3920,9,7,8,17,42,56,-14,29
Young Boys,3921,1,20,7,5,68,38,30,67
FC Basel,3921,2,19,7,6,55,26,29,64
St Gallen,3921,3,16,2,14,44,54,-10,50
Lucerne,3921,4,12,9,11,46,46,0,45
FC Lugano,3921,5,12,5,15,33,46,-13,41
FC Zürich,3921,6,9,9,14,37,37,0,36
Grasshoppers,3921,7,9,9,14,42,49,-7,36
FC Thun,3921,8,9,6,17,40,56,-16,33
FC Sion,3921,9,7,8,17,40,53,-13,29
Young Boys,3922,1,22,7,3,73,35,38,73
FC Basel,3922,2,17,10,5,55,24,31,61
St Gallen,3922,3,14,3,15,42,54,-12,45
FC Zürich,3922,4,11,11,10,42,35,7,44
Lucerne,3922,5,11,9,12,40,48,-8,42
FC Lugano,3922,6,11,5,16,35,50,-15,38
FC Thun,3922,7,10,7,15,44,56,-12,37
Grasshoppers,3922,8,8,7,17,39,55,-16,31
FC Sion,3922,9,7,7,18,40,53,-13,28
Young Boys,3923,1,22,7,3,77,35,42,73
FC Basel,3923,2,17,9,6,51,24,27,60
St Gallen,3923,3,16,2,14,42,51,-9,50
Lucerne,3923,4,12,8,12,39,49,-10,44
FC Lugano,3923,5,11,5,16,31,46,-15,38
FC Zürich,3923,6,9,10,13,37,38,-1,37
Grasshoppers,3923,7,9,9,14,45,52,-7,36
FC Thun,3923,8,9,7,16,44,61,-17,34
FC Sion,3923,9,7,7,18,43,53,-10,28
Young Boys,3924,1,20,9,3,71,40,31,69
FC Basel,3924,2,18,8,6,54,23,31,62
St Gallen,3924,3,15,4,13,41,49,-8,49
FC Zürich,3924,4,12,10,10,44,35,9,46
Lucerne,3924,5,11,9,12,40,47,-7,42
FC Lugano,3924,6,10,7,15,32,45,-13,37
Grasshoppers,3924,7,9,8,15,42,50,-8,35
FC Thun,3924,8,9,5,18,43,60,-17,32
FC Sion,3924,9,6,8,18,41,59,-18,26
Young Boys,3925,1,22,7,3,72,36,36,73
FC Basel,3925,2,16,9,7,51,27,24,57
St Gallen,3925,3,14,5,13,42,52,-10,47
Lucerne,3925,4,12,10,10,41,41,0,46
FC Zürich,3925,5,10,11,11,40,36,4,41
FC Lugano,3925,6,10,8,14,31,45,-14,38
FC Thun,3925,7,10,6,16,44,58,-14,36
Grasshoppers,3925,8,9,6,17,41,51,-10,33
FC Sion,3925,9,5,10,17,39,55,-16,25
Young Boys,3926,1,22,6,4,74,36,38,72
FC Basel,3926,2,16,8,8,48,26,22,56
St Gallen,3926,3,15,3,14,45,53,-8,48
Lucerne,3926,4,13,7,12,40,42,-2,46
FC Zürich,3926,5,9,13,10,37,33,4,40
Grasshoppers,3926,6,11,6,15,41,50,-9,39
FC Lugano,3926,7,10,6,16,29,50,-21,36
FC Thun,3926,8,9,6,17,45,58,-13,33
FC Sion,3926,9,7,9,16,41,52,-11,30
Young Boys,3927,1,23,6,3,74,35,39,75
FC Basel,3927,2,17,8,7,55,29,26,59
St Gallen,3927,3,15,3,14,44,53,-9,48
Lucerne,3927,4,12,9,11,40,43,-3,45
FC Zürich,3927,5,10,10,12,42,40,2,40
FC Lugano,3927,6,10,6,16,31,47,-16,36
FC Thun,3927,7,10,5,17,43,61,-18,35
Grasshoppers,3927,8,9,7,16,42,50,-8,34
FC Sion,3927,9,7,8,17,44,57,-13,29
Young Boys,3928,1,20,8,4,70,39,31,68
FC Basel,3928,2,17,9,6,53,25,28,60
Lucerne,3928,3,13,8,11,43,44,-1,47
FC Zürich,3928,4,12,10,10,43,33,10,46
St Gallen,3928,5,14,4,14,43,54,-11,46
Grasshoppers,3928,6,11,6,15,43,47,-4,39
FC Thun,3928,7,9,6,17,43,62,-19,33
FC Lugano,3928,8,9,6,17,33,53,-20,33
FC Sion,3928,9,6,9,17,40,54,-14,27
Young Boys,3929,1,21,8,3,71,34,37,71
FC Basel,3929,2,17,8,7,54,24,30,59
Lucerne,3929,3,13,8,11,40,41,-1,47
St Gallen,3929,4,13,5,14,41,53,-12,44
FC Zürich,3929,5,11,9,12,43,39,4,42
FC Thun,3929,6,12,5,15,47,58,-11,41
Grasshoppers,3929,7,10,6,16,39,47,-8,36
FC Lugano,3929,8,10,6,16,30,53,-23,36
FC Sion,3929,9,5,9,18,38,54,-16,24
Young Boys,3930,1,21,7,4,68,37,31,70
FC Basel,3930,2,19,7,6,58,26,32,64
Lucerne,3930,3,14,7,11,44,42,2,49
FC Zürich,3930,4,11,9,12,39,36,3,42
St Gallen,3930,5,13,2,17,41,61,-20,41
FC Lugano,3930,6,10,6,16,32,47,-15,36
FC Thun,3930,7,10,5,17,44,59,-15,35
FC Sion,3930,8,9,7,16,44,49,-5,34
Grasshoppers,3930,9,9,6,17,38,51,-13,33
Young Boys,3931,1,21,6,5,69,35,34,69
FC Basel,3931,2,16,9,7,49,25,24,57
St Gallen,3931,3,16,2,14,45,55,-10,50
Lucerne,3931,4,12,9,11,42,44,-2,45
FC Zürich,3931,5,11,10,11,41,36,5,43
FC Sion,3931,6,10,7,15,45,50,-5,37
FC Thun,3931,7,9,7,16,40,55,-15,34
Grasshoppers,3931,8,9,6,17,40,52,-12,33
FC Lugano,3931,9,9,6,17,27,46,-19,33
Young Boys,3932,1,21,8,3,67,33,34,71
FC Basel,3932,2,16,9,7,50,29,21,57
Lucerne,3932,3,14,8,10,46,40,6,50
St Gallen,3932,4,15,2,15,44,54,-10,47
FC Zürich,3932,5,10,10,12,40,38,2,40
FC Lugano,3932,6,11,5,16,31,50,-19,38
Grasshoppers,3932,7,9,7,16,39,48,-9,34
FC Sion,3932,8,8,8,16,39,48,-9,32
FC Thun,3932,9,9,5,18,43,59,-16,32
Young Boys,3933,1,22,7,3,75,35,40,73
FC Basel,3933,2,15,9,8,50,29,21,54
St Gallen,3933,3,15,3,14,44,53,-9,48
Lucerne,3933,4,13,8,11,43,43,0,47
FC Zürich,3933,5,10,11,11,38,34,4,41
Grasshoppers,3933,6,11,7,14,46,47,-1,40
FC Thun,3933,7,11,6,15,42,54,-12,39
FC Lugano,3933,8,9,7,16,30,50,-20,34
FC Sion,3933,9,5,8,19,36,59,-23,23
Young Boys,3934,1,23,6,3,73,33,40,75
FC Basel,3934,2,19,8,5,52,23,29,65
St Gallen,3934,3,15,4,13,45,52,-7,49
FC Zürich,3934,4,11,10,11,42,36,6,43
Lucerne,3934,5,12,7,13,41,47,-6,43
Grasshoppers,3934,6,10,6,16,40,48,-8,36
FC Thun,3934,7,9,7,16,41,56,-15,34
FC Lugano,3934,8,9,6,17,32,53,-21,33
FC Sion,3934,9,5,8,19,38,56,-18,23
Young Boys,3935,1,22,6,4,73,37,36,72
FC Basel,3935,2,19,7,6,57,27,30,64
Lucerne,3935,3,14,8,10,45,44,1,50
St Gallen,3935,4,14,3,15,45,56,-11,45
FC Zürich,3935,5,10,9,13,40,42,-2,39
FC Lugano,3935,6,11,5,16,32,48,-16,38
Grasshoppers,3935,7,10,6,16,45,50,-5,36
FC Thun,3935,8,9,6,17,47,64,-17,33
FC Sion,3935,9,6,8,18,45,61,-16,26
Young Boys,3936,1,23,6,3,74,34,40,75
FC Basel,3936,2,19,8,5,57,26,31,65
Lucerne,3936,3,13,7,12,43,45,-2,46
St Gallen,3936,4,14,2,16,42,58,-16,44
FC Zürich,3936,5,9,13,10,40,36,4,40
FC Lugano,3936,6,10,6,16,30,47,-17,36
Grasshoppers,3936,7,9,7,16,42,51,-9,34
FC Thun,3936,8,9,7,16,48,60,-12,34
FC Sion,3936,9,6,8,18,38,57,-19,26
Young Boys,3937,1,21,7,4,69,37,32,70
FC Basel,3937,2,17,8,7,55,26,29,59
Lucerne,3937,3,13,8,11,41,42,-1,47
St Gallen,3937,4,14,2,16,41,57,-16,44
FC Zürich,3937,5,11,10,11,41,35,6,43
Grasshoppers,3937,6,10,7,15,45,49,-4,37
FC Thun,3937,7,10,6,16,43,58,-15,36
FC Lugano,3937,8,10,5,17,32,51,-19,35
FC Sion,3937,9,8,7,17,43,55,-12,31
Young Boys,3938,1,20,9,3,72,34,38,69
FC Basel,3938,2,17,8,7,55,26,29,59
St Gallen,3938,3,15,3,14,44,55,-11,48
Lucerne,3938,4,11,10,11,41,44,-3,43
FC Zürich,3938,5,10,10,12,42,40,2,40
Grasshoppers,3938,6,10,8,14,43,48,-5,38
FC Lugano,3938,7,10,7,15,30,50,-20,37
FC Thun,3938,8,10,5,17,46,62,-16,35
FC Sion,3938,9,7,8,17,39,53,-14,29
Young Boys,3939,1,22,7,3,73,36,37,73
FC Basel,3939,2,17,9,6,51,24,27,60
Lucerne,3939,3,12,9,11,41,43,-2,45
St Gallen,3939,4,14,3,15,42,54,-12,45
FC Zürich,3939,5,10,10,12,39,37,2,40
FC Thun,3939,6,11,6,15,47,56,-9,39
FC Lugano,3939,7,11,6,15,34,50,-16,39
Grasshoppers,3939,8,9,6,17,41,52,-11,33
FC Sion,3939,9,6,8,18,42,58,-16,26
Young Boys,3940,1,22,7,3,74,38,36,73
FC Basel,3940,2,17,9,6,51,23,28,60
Lucerne,3940,3,12,9,11,42,45,-3,45
St Gallen,3940,4,14,3,15,43,57,-14,45
FC Zürich,3940,5,10,10,12,38,35,3,40
Grasshoppers,3940,6,11,6,15,44,49,-5,39
FC Lugano,3940,7,11,5,16,35,47,-12,38
FC Thun,3940,8,9,6,17,41,58,-17,33
FC Sion,3940,9,6,9,17,40,56,-16,27
Young Boys,3941,1,20,7,5,69,41,28,67
FC Basel,3941,2,18,9,5,58,26,32,63
St Gallen,3941,3,14,5,13,43,53,-10,47
Lucerne,3941,4,12,9,11,44,44,0,45
FC Zürich,3941,5,11,9,12,43,39,4,42
Grasshoppers,3941,6,10,6,16,40,50,-10,36
FC Lugano,3941,7,9,8,15,32,49,-17,35
FC Thun,3941,8,9,6,17,44,60,-16,33
FC Sion,3941,9,8,7,17,44,55,-11,31
Young Boys,3942,1,21,7,4,69,33,36,70
FC Basel,3942,2,18,7,7,56,28,28,61
St Gallen,3942,3,15,3,14,43,53,-10,48
Lucerne,3942,4,12,9,11,44,43,1,45
FC Zürich,3942,5,11,10,11,40,36,4,43
Grasshoppers,3942,6,10,6,16,41,53,-12,36
FC Thun,3942,7,10,6,16,48,61,-13,36
FC Lugano,3942,8,9,8,15,28,45,-17,35
FC Sion,3942,9,6,8,18,39,56,-17,26
Young Boys,3943,1,22,8,2,77,34,43,74
FC Basel,3943,2,19,7,6,57,27,30,64
St Gallen,3943,3,15,2,15,45,55,-10,47
Lucerne,3943,4,12,7,13,41,53,-12,43
FC Zürich,3943,5,10,10,12,40,38,2,40
Grasshoppers,3943,6,11,7,14,46,47,-1,40
FC Lugano,3943,7,9,6,17,30,49,-19,33
FC Thun,3943,8,9,5,18,43,61,-18,32
FC Sion,3943,9,7,8,17,41,56,-15,29
Young Boys,3944,1,19,8,5,70,39,31,65
FC Basel,3944,2,17,10,5,57,26,31,61
St Gallen,3944,3,15,3,14,45,56,-11,48
FC Zürich,3944,4,10,11,11,41,36,5,41
Lucerne,3944,5,11,8,13,38,45,-7,41
FC Lugano,3944,6,11,5,16,33,52,-19,38
FC Thun,3944,7,10,6,16,50,61,-11,36
Grasshoppers,3944,8,10,6,16,40,52,-12,36
FC Sion,3944,9,8,9,15,44,51,-7,33
Young Boys,3945,1,22,7,3,74,37,37,73
FC Basel,3945,2,19,8,5,61,24,37,65
St Gallen,3945,3,15,2,15,43,53,-10,47
Lucerne,3945,4,12,8,12,38,45,-7,44
FC Zürich,3945,5,10,10,12,41,40,1,40
FC Lugano,3945,6,11,6,15,33,46,-13,39
Grasshoppers,3945,7,9,7,16,39,48,-9,34
FC Thun,3945,8,9,5,18,43,63,-20,32
FC Sion,3945,9,6,9,17,39,55,-16,27
Young Boys,3946,1,23,7,2,74,35,39,76
FC Basel,3946,2,18,8,6,59,27,32,62
St Gallen,3946,3,16,3,13,50,54,-4,51
Lucerne,3946,4,12,8,12,41,50,-9,44
FC Zürich,3946,5,10,11,11,40,37,3,41
Grasshoppers,3946,6,9,8,15,41,49,-8,35
FC Lugano,3946,7,9,7,16,30,49,-19,34
FC Thun,3946,8,8,6,18,42,61,-19,30
FC Sion,3946,9,6,8,18,40,55,-15,26
Young Boys,3947,1,21,7,4,67,35,32,70
FC Basel,3947,2,17,10,5,53,24,29,61
Lucerne,3947,3,12,7,13,39,46,-7,43
FC Lugano,3947,4,12,6,14,36,44,-8,42
St Gallen,3947,5,13,3,16,41,58,-17,42
FC Zürich,3947,6,9,13,10,38,34,4,40
Grasshoppers,3947,7,10,6,16,42,50,-8,36
FC Thun,3947,8,9,7,16,42,57,-15,34
FC Sion,3947,9,7,9,16,43,53,-10,30
Young Boys,3948,1,22,6,4,76,42,34,72
FC Basel,3948,2,19,7,6,56,25,31,64
St Gallen,3948,3,16,2,14,45,52,-7,50
FC Zürich,3948,4,11,10,11,41,36,5,43
Lucerne,3948,5,12,7,13,39,47,-8,43
FC Lugano,3948,6,10,6,16,32,51,-19,36
Grasshoppers,3948,7,9,6,17,44,54,-10,33
FC Thun,3948,8,9,5,18,42,60,-18,32
FC Sion,3948,9,8,7,17,49,57,-8,31
Young Boys,3949,1,21,7,4,73,38,35,70
FC Basel,3949,2,18,7,7,53,27,26,61
Lucerne,3949,3,13,8,11,42,44,-2,47
St Gallen,3949,4,15,2,15,44,54,-10,47
FC Zürich,3949,5,12,9,11,45,35,10,45
Grasshoppers,3949,6,9,8,15,43,49,-6,35
FC Lugano,3949,7,10,5,17,30,48,-18,35
FC Sion,3949,8,8,8,16,42,54,-12,32
FC Thun,3949,9,8,6,18,41,64,-23,30
Young Boys,3950,1,21,7,4,72,39,33,70
FC Basel,3950,2,18,8,6,53,24,29,62
St Gallen,3950,3,15,4,13,45,52,-7,49
FC Zürich,3950,4,11,10,11,42,35,7,43
Lucerne,3950,5,12,7,13,40,45,-5,43
FC Lugano,3950,6,10,6,16,30,47,-17,36
Grasshoppers,3950,7,9,7,16,42,51,-9,34
FC Thun,3950,8,9,7,16,42,60,-18,34
FC Sion,3950,9,7,8,17,42,55,-13,29
Young Boys,3951,1,22,7,3,80,42,38,73
FC Basel,3951,2,17,8,7,55,30,25,59
Lucerne,3951,3,13,10,9,41,38,3,49
St Gallen,3951,4,13,2,17,44,60,-16,41
FC Zürich,3951,5,10,10,12,40,38,2,40
FC Thun,3951,6,10,6,16,44,59,-15,36
Grasshoppers,3951,7,9,8,15,41,46,-5,35
FC Lugano,3951,8,10,5,17,31,53,-22,35
FC Sion,3951,9,8,8,16,47,57,-10,32
Young Boys,3952,1,21,6,5,73,38,35,69
FC Basel,3952,2,19,8,5,58,25,33,65
Lucerne,3952,3,12,8,12,41,48,-7,44
St Gallen,3952,4,14,2,16,44,59,-15,44
FC Zürich,3952,5,10,11,11,40,34,6,41
FC Lugano,3952,6,10,7,15,35,47,-12,37
Grasshoppers,3952,7,10,6,16,42,56,-14,36
FC Thun,3952,8,9,6,17,43,62,-19,33
FC Sion,3952,9,8,8,16,46,53,-7,32
Young Boys,3953,1,21,8,3,70,34,36,71
FC Basel,3953,2,20,7,5,61,23,38,67
St Gallen,3953,3,14,3,15,44,57,-13,45
FC Zürich,3953,4,11,9,12,41,41,0,42
Lucerne,3953,5,11,8,13,40,50,-10,41
FC Lugano,3953,6,11,6,15,33,46,-13,39
Grasshoppers,3953,7,10,7,15,44,47,-3,37
FC Thun,3953,8,10,6,16,44,56,-12,36
FC Sion,3953,9,5,8,19,36,59,-23,23
Young Boys,3954,1,20,7,5,71,37,34,67
FC Basel,3954,2,19,7,6,54,24,30,64
St Gallen,3954,3,16,3,13,43,51,-8,51
Lucerne,3954,4,13,8,11,42,43,-1,47
FC Zürich,3954,5,10,11,11,38,35,3,41
Grasshoppers,3954,6,10,7,15,43,48,-5,37
FC Lugano,3954,7,9,6,17,28,49,-21,33
FC Sion,3954,8,7,9,16,40,52,-12,30
FC Thun,3954,9,8,6,18,43,63,-20,30
Young Boys,3955,1,22,6,4,75,38,37,72
FC Basel,3955,2,19,7,6,58,27,31,64
St Gallen,3955,3,15,2,15,43,56,-13,47
FC Zürich,3955,4,11,10,11,42,37,5,43
Lucerne,3955,5,12,7,13,41,48,-7,43
Grasshoppers,3955,6,11,7,14,45,48,-3,40
FC Thun,3955,7,10,5,17,46,58,-12,35
FC Lugano,3955,8,9,5,18,29,50,-21,32
FC Sion,3955,9,6,9,17,37,54,-17,27
Young Boys,3956,1,22,7,3,76,38,38,73
FC Basel,3956,2,18,9,5,59,26,33,63
Lucerne,3956,3,13,9,10,45,41,4,48
St Gallen,3956,4,15,3,14,45,54,-9,48
FC Zürich,3956,5,10,12,10,41,36,5,42
Grasshoppers,3956,6,10,6,16,46,54,-8,36
FC Thun,3956,7,9,6,17,46,62,-16,33
FC Lugano,3956,8,9,6,17,33,54,-21,33
FC Sion,3956,9,5,8,19,37,63,-26,23
Young Boys,3957,1,22,6,4,74,36,38,72
FC Basel,3957,2,18,7,7,57,27,30,61
St Gallen,3957,3,15,3,14,45,55,-10,48
Lucerne,3957,4,13,7,12,43,46,-3,46
FC Zürich,3957,5,9,9,14,36,39,-3,36
FC Thun,3957,6,10,6,16,43,56,-13,36
FC Lugano,3957,7,10,6,16,31,50,-19,36
Grasshoppers,3957,8,9,8,15,41,49,-8,35
FC Sion,3957,9,8,8,16,40,52,-12,32
Young Boys,3958,1,22,8,2,72,31,41,74
FC Basel,3958,2,18,8,6,52,26,26,62
St Gallen,3958,3,14,4,14,45,54,-9,46
Lucerne,3958,4,12,8,12,41,45,-4,44
FC Zürich,3958,5,10,11,11,40,35,5,41
FC Lugano,3958,6,10,7,15,29,45,-16,37
Grasshoppers,3958,7,9,8,15,42,52,-10,35
FC Thun,3958,8,8,6,18,41,61,-20,30
FC Sion,3958,9,5,12,15,39,52,-13,27
Young Boys,3959,1,20,9,3,70,34,36,69
FC Basel,3959,2,16,9,7,51,28,23,57
FC Zürich,3959,3,11,11,10,43,34,9,44
Lucerne,3959,4,12,8,12,41,47,-6,44
St Gallen,3959,5,13,4,15,41,56,-15,43
FC Lugano,3959,6,11,6,15,34,47,-13,39
Grasshoppers,3959,7,10,8,14,41,46,-5,38
FC Thun,3959,8,9,6,17,41,60,-19,33
FC Sion,3959,9,6,11,15,40,50,-10,29
Young Boys,3960,1,21,7,4,68,36,32,70
FC Basel,3960,2,17,10,5,54,26,28,61
Lucerne,3960,3,14,8,10,45,41,4,50
St Gallen,3960,4,15,3,14,44,52,-8,48
FC Zürich,3960,5,12,9,11,42,35,7,45
Grasshoppers,3960,6,9,7,16,40,51,-11,34
FC Lugano,3960,7,9,5,18,30,52,-22,32
FC Sion,3960,8,8,7,17,41,51,-10,31
FC Thun,3960,9,8,6,18,43,63,-20,30
Young Boys,3961,1,21,7,4,72,37,35,70
FC Basel,3961,2,17,8,7,50,26,24,59
St Gallen,3961,3,16,3,13,45,50,-5,51
FC Zürich,3961,4,12,10,10,42,33,9,46
Lucerne,3961,5,13,7,12,41,44,-3,46
Grasshoppers,3961,6,11,7,14,44,47,-3,40
FC Lugano,3961,7,9,5,18,28,48,-20,32
FC Thun,3961,8,9,5,18,41,63,-22,32
FC Sion,3961,9,6,8,18,41,56,-15,26
Young Boys,3962,1,22,8,2,70,33,37,74
FC Basel,3962,2,18,8,6,55,25,30,62
Lucerne,3962,3,13,8,11,46,45,1,47
St Gallen,3962,4,15,2,15,47,55,-8,47
FC Zürich,3962,5,11,9,12,41,35,6,42
Grasshoppers,3962,6,10,7,15,39,47,-8,37
FC Thun,3962,7,9,5,18,41,61,-20,32
FC Lugano,3962,8,9,5,18,29,54,-25,32
FC Sion,3962,9,7,8,17,39,52,-13,29
Young Boys,3963,1,23,7,2,72,33,39,76
FC Basel,3963,2,17,8,7,53,25,28,59
Lucerne,3963,3,15,7,10,46,41,5,52
St Gallen,3963,4,15,2,15,48,56,-8,47
FC Zürich,3963,5,9,10,13,39,39,0,37
Grasshoppers,3963,6,10,6,16,42,49,-7,36
FC Thun,3963,7,10,5,17,43,60,-17,35
FC Lugano,3963,8,10,5,17,31,51,-20,35
FC Sion,3963,9,6,8,18,39,59,-20,26
Young Boys,3964,1,23,7,2,77,33,44,76
FC Basel,3964,2,19,7,6,58,26,32,64
Lucerne,3964,3,13,8,11,45,44,1,47
St Gallen,3964,4,14,2,16,45,58,-13,44
FC Zürich,3964,5,11,9,12,42,36,6,42
FC Lugano,3964,6,11,5,16,30,52,-22,38
FC Thun,3964,7,10,5,17,43,60,-17,35
Grasshoppers,3964,8,8,8,16,40,53,-13,32
FC Sion,3964,9,6,7,19,42,60,-18,25
Young Boys,3965,1,23,7,2,74,34,40,76
FC Basel,3965,2,16,10,6,53,28,25,58
St Gallen,3965,3,14,4,14,42,53,-11,46
FC Zürich,3965,4,12,9,11,49,37,12,45
Lucerne,3965,5,11,9,12,39,44,-5,42
FC Lugano,3965,6,11,6,15,34,50,-16,39
Grasshoppers,3965,7,9,7,16,42,53,-11,34
FC Thun,3965,8,9,6,17,48,63,-15,33
FC Sion,3965,9,6,8,18,38,57,-19,26
Young Boys,3966,1,22,6,4,73,37,36,72
FC Basel,3966,2,17,10,5,56,26,30,61
Lucerne,3966,3,12,9,11,42,45,-3,45
St Gallen,3966,4,14,3,15,42,56,-14,45
FC Zürich,3966,5,10,11,11,40,37,3,41
FC Lugano,3966,6,10,6,16,30,48,-18,36
Grasshoppers,3966,7,9,7,16,41,51,-10,34
FC Thun,3966,8,8,8,16,41,57,-16,32
FC Sion,3966,9,7,10,15,44,52,-8,31
Young Boys,3967,1,21,7,4,69,34,35,70
FC Basel,3967,2,18,9,5,53,24,29,63
St Gallen,3967,3,16,2,14,46,51,-5,50
FC Zürich,3967,4,11,11,10,43,37,6,44
Lucerne,3967,5,12,7,13,42,44,-2,43
FC Lugano,3967,6,11,6,15,34,47,-13,39
Grasshoppers,3967,7,10,6,16,41,53,-12,36
FC Thun,3967,8,10,5,17,44,59,-15,35
FC Sion,3967,9,5,7,20,38,61,-23,22
Young Boys,3968,1,21,7,4,74,37,37,70
FC Basel,3968,2,19,8,5,60,25,35,65
St Gallen,3968,3,15,3,14,41,52,-11,48
Lucerne,3968,4,13,7,12,42,43,-1,46
FC Thun,3968,5,11,5,16,46,58,-12,38
FC Zürich,3968,6,9,9,14,39,41,-2,36
FC Lugano,3968,7,10,5,17,28,50,-22,35
Grasshoppers,3968,8,9,7,16,41,52,-11,34
FC Sion,3968,9,7,9,16,43,56,-13,30
Young Boys,3969,1,21,6,5,70,35,35,69
FC Basel,3969,2,18,9,5,55,26,29,63
Lucerne,3969,3,15,8,9,49,42,7,53
St Gallen,3969,4,14,2,16,40,55,-15,44
FC Zürich,3969,5,10,11,11,40,36,4,41
FC Lugano,3969,6,10,5,17,31,48,-17,35
FC Thun,3969,7,9,7,16,42,58,-16,34
Grasshoppers,3969,8,8,7,17,39,53,-14,31
FC Sion,3969,9,7,9,16,40,53,-13,30
Young Boys,3970,1,21,8,3,75,37,38,71
FC Basel,3970,2,18,9,5,55,25,30,63
Lucerne,3970,3,14,7,11,45,43,2,49
St Gallen,3970,4,14,4,14,43,53,-10,46
FC Zürich,3970,5,11,9,12,40,38,2,42
Grasshoppers,3970,6,9,8,15,42,50,-8,35
FC Thun,3970,7,9,6,17,43,58,-15,33
FC Lugano,3970,8,9,6,17,27,49,-22,33
FC Sion,3970,9,7,7,18,43,60,-17,28
Young Boys,3971,1,21,7,4,70,35,35,70
FC Basel,3971,2,17,10,5,55,26,29,61
FC Lugano,3971,3,13,5,14,35,43,-8,44
St Gallen,3971,4,13,4,15,42,57,-15,43
Lucerne,3971,5,11,9,12,38,46,-8,42
Grasshoppers,3971,6,11,7,14,47,47,0,40
FC Zürich,3971,7,9,11,12,36,36,0,38
FC Thun,3971,8,10,5,17,44,60,-16,35
FC Sion,3971,9,5,10,17,36,53,-17,25
Young Boys,3972,1,20,7,5,69,38,31,67
FC Basel,3972,2,18,9,5,58,27,31,63
St Gallen,3972,3,15,3,14,44,52,-8,48
FC Zürich,3972,4,12,10,10,46,36,10,46
Lucerne,3972,5,12,8,12,42,45,-3,44
Grasshoppers,3972,6,10,8,14,43,48,-5,38
FC Lugano,3972,7,10,5,17,29,50,-21,35
FC Thun,3972,8,9,6,17,46,62,-16,33
FC Sion,3972,9,6,8,18,39,58,-19,26
Young Boys,3973,1,24,6,2,79,33,46,78
FC Basel,3973,2,17,8,7,53,27,26,59
Lucerne,3973,3,13,7,12,42,48,-6,46
St Gallen,3973,4,14,4,14,46,55,-9,46
FC Zürich,3973,5,10,11,11,40,36,4,41
Grasshoppers,3973,6,9,8,15,41,48,-7,35
FC Lugano,3973,7,9,7,16,31,53,-22,34
FC Thun,3973,8,8,8,16,41,57,-16,32
FC Sion,3973,9,6,9,17,39,55,-16,27
Young Boys,3974,1,21,9,2,71,34,37,72
FC Basel,3974,2,18,9,5,56,25,31,63
Lucerne,3974,3,12,9,11,43,47,-4,45
St Gallen,3974,4,13,4,15,44,58,-14,43
FC Zürich,3974,5,10,11,11,41,37,4,41
Grasshoppers,3974,6,11,7,14,44,49,-5,40
FC Lugano,3974,7,10,5,17,32,49,-17,35
FC Thun,3974,8,9,6,17,46,60,-14,33
FC Sion,3974,9,6,8,18,42,60,-18,26
Young Boys,3975,1,22,8,2,73,34,39,74
FC Basel,3975,2,18,9,5,56,27,29,63
Lucerne,3975,3,13,7,12,45,47,-2,46
St Gallen,3975,4,13,3,16,43,58,-15,42
FC Zürich,3975,5,9,9,14,39,40,-1,36
Grasshoppers,3975,6,10,6,16,41,51,-10,36
FC Thun,3975,7,10,6,16,46,58,-12,36
FC Lugano,3975,8,10,6,16,32,49,-17,36
FC Sion,3975,9,8,8,16,41,52,-11,32
Young Boys,3976,1,22,7,3,72,35,37,73
FC Basel,3976,2,17,8,7,56,30,26,59
Lucerne,3976,3,14,9,9,43,41,2,51
St Gallen,3976,4,15,3,14,45,55,-10,48
FC Zürich,3976,5,12,9,11,43,36,7,45
FC Thun,3976,6,11,5,16,50,60,-10,38
Grasshoppers,3976,7,9,6,17,40,50,-10,33
FC Lugano,3976,8,9,5,18,32,53,-21,32
FC Sion,3976,9,5,8,19,36,57,-21,23
Young Boys,3977,1,23,6,3,77,35,42,75
FC Basel,3977,2,16,9,7,51,27,24,57
St Gallen,3977,3,14,3,15,42,55,-13,45
FC Zürich,3977,4,11,11,10,42,33,9,44
Lucerne,3977,5,12,7,13,41,48,-7,43
FC Thun,3977,6,11,6,15,45,57,-12,39
FC Lugano,3977,7,11,5,16,32,50,-18,38
Grasshoppers,3977,8,10,6,16,44,50,-6,36
FC Sion,3977,9,6,7,19,37,56,-19,25
Young Boys,3978,1,21,8,3,71,34,37,71
FC Basel,3978,2,19,8,5,57,24,33,65
Lucerne,3978,3,12,10,10,40,40,0,46
St Gallen,3978,4,14,3,15,41,58,-17,45
FC Zürich,3978,5,9,11,12,37,36,1,38
FC Lugano,3978,6,10,7,15,31,45,-14,37
FC Thun,3978,7,10,6,16,44,56,-12,36
Grasshoppers,3978,8,9,6,17,40,54,-14,33
FC Sion,3978,9,7,7,18,41,55,-14,28
Young Boys,3979,1,22,7,3,76,35,41,73
FC Basel,3979,2,18,7,7,56,28,28,61
Lucerne,3979,3,13,7,12,40,46,-6,46
FC Lugano,3979,4,12,6,14,34,45,-11,42
St Gallen,3979,5,13,2,17,39,58,-19,41
FC Thun,3979,6,11,5,16,48,56,-8,38
FC Zürich,3979,7,9,10,13,40,43,-3,37
Grasshoppers,3979,8,9,7,16,40,51,-11,34
FC Sion,3979,9,8,7,17,43,54,-11,31
Young Boys,3980,1,20,7,5,71,39,32,67
FC Basel,3980,2,17,9,6,57,27,30,60
Lucerne,3980,3,14,7,11,45,48,-3,49
St Gallen,3980,4,14,3,15,43,58,-15,45
FC Zürich,3980,5,11,10,11,42,36,6,43
FC Lugano,3980,6,11,6,15,38,49,-11,39
Grasshoppers,3980,7,10,6,16,42,50,-8,36
FC Thun,3980,8,10,6,16,44,57,-13,36
FC Sion,3980,9,6,8,18,39,57,-18,26
Young Boys,3981,1,22,6,4,76,38,38,72
FC Basel,3981,2,16,9,7,52,28,24,57
Lucerne,3981,3,13,9,10,45,46,-1,48
St Gallen,3981,4,14,4,14,43,55,-12,46
FC Zürich,3981,5,11,11,10,42,34,8,44
Grasshoppers,3981,6,10,6,16,42,51,-9,36
FC Lugano,3981,7,9,7,16,28,47,-19,34
FC Thun,3981,8,8,7,17,41,61,-20,31
FC Sion,3981,9,7,9,16,44,53,-9,30
Young Boys,3982,1,21,9,2,73,35,38,72
FC Basel,3982,2,16,9,7,56,31,25,57
Lucerne,3982,3,13,8,11,44,47,-3,47
St Gallen,3982,4,15,2,15,47,60,-13,47
FC Zürich,3982,5,12,10,10,44,35,9,46
FC Lugano,3982,6,10,7,15,34,48,-14,37
Grasshoppers,3982,7,9,6,17,41,51,-10,33
FC Thun,3982,8,9,6,17,44,62,-18,33
FC Sion,3982,9,7,7,18,42,56,-14,28
Young Boys,3983,1,19,7,6,67,41,26,64
FC Basel,3983,2,18,7,7,51,25,26,61
Lucerne,3983,3,13,9,10,42,42,0,48
St Gallen,3983,4,14,5,13,42,52,-10,47
FC Zürich,3983,5,10,10,12,41,38,3,40
Grasshoppers,3983,6,10,8,14,45,47,-2,38
FC Lugano,3983,7,10,6,16,34,46,-12,36
FC Thun,3983,8,10,6,16,44,61,-17,36
FC Sion,3983,9,7,8,17,40,54,-14,29
Young Boys,3984,1,23,6,3,74,35,39,75
FC Basel,3984,2,16,8,8,51,27,24,56
Lucerne,3984,3,13,9,10,46,45,1,48
St Gallen,3984,4,13,6,13,45,56,-11,45
FC Zürich,3984,5,11,10,11,39,34,5,43
Grasshoppers,3984,6,11,6,15,46,48,-2,39
FC Lugano,3984,7,9,7,16,33,51,-18,34
FC Thun,3984,8,9,6,17,42,62,-20,33
FC Sion,3984,9,5,10,17,38,56,-18,25
Young Boys,3985,1,20,8,4,71,37,34,68
FC Basel,3985,2,18,8,6,58,31,27,62
Lucerne,3985,3,14,7,11,43,43,0,49
St Gallen,3985,4,14,2,16,44,58,-14,44
Grasshoppers,3985,5,12,6,14,43,47,-4,42
FC Zürich,3985,6,10,9,13,39,39,0,39
FC Thun,3985,7,10,5,17,45,59,-14,35
FC Lugano,3985,8,10,5,17,31,49,-18,35
FC Sion,3985,9,7,8,17,42,53,-11,29
Young Boys,3986,1,24,6,2,78,30,48,78
FC Basel,3986,2,19,7,6,55,26,29,64
St Gallen,3986,3,15,2,15,43,53,-10,47
Lucerne,3986,4,12,8,12,43,49,-6,44
FC Zürich,3986,5,11,10,11,45,38,7,43
FC Lugano,3986,6,10,5,17,30,51,-21,35
Grasshoppers,3986,7,9,7,16,40,51,-11,34
FC Thun,3986,8,9,6,17,40,56,-16,33
FC Sion,3986,9,6,7,19,38,58,-20,25
Young Boys,3987,1,22,7,3,73,33,40,73
FC Basel,3987,2,18,8,6,55,27,28,62
Lucerne,3987,3,13,8,11,41,42,-1,47
St Gallen,3987,4,14,4,14,42,52,-10,46
FC Zürich,3987,5,10,10,12,41,38,3,40
FC Lugano,3987,6,11,5,16,29,48,-19,38
Grasshoppers,3987,7,9,8,15,41,49,-8,35
FC Thun,3987,8,9,6,17,43,60,-17,33
FC Sion,3987,9,5,10,17,39,55,-16,25
Young Boys,3988,1,22,7,3,71,34,37,73
FC Basel,3988,2,19,8,5,56,24,32,65
Lucerne,3988,3,13,7,12,41,43,-2,46
St Gallen,3988,4,14,2,16,42,56,-14,44
FC Zürich,3988,5,9,12,11,38,36,2,39
Grasshoppers,3988,6,10,7,15,43,49,-6,37
FC Thun,3988,7,10,6,16,46,59,-13,36
FC Lugano,3988,8,10,6,16,30,45,-15,36
FC Sion,3988,9,5,9,18,37,58,-21,24
Young Boys,3989,1,24,6,2,76,31,45,78
FC Basel,3989,2,18,7,7,52,25,27,61
St Gallen,3989,3,15,2,15,42,54,-12,47
Lucerne,3989,4,13,7,12,41,45,-4,46
FC Zürich,3989,5,10,9,13,39,38,1,39
FC Thun,3989,6,11,5,16,45,56,-11,38
FC Lugano,3989,7,11,5,16,31,46,-15,38
Grasshoppers,3989,8,8,6,18,41,57,-16,30
FC Sion,3989,9,7,7,18,39,54,-15,28
Young Boys,3990,1,21,7,4,70,34,36,70
FC Basel,3990,2,19,8,5,58,27,31,65
Lucerne,3990,3,12,10,10,41,43,-2,46
St Gallen,3990,4,14,4,14,45,57,-12,46
FC Zürich,3990,5,10,11,11,42,38,4,41
Grasshoppers,3990,6,10,8,14,41,47,-6,38
FC Thun,3990,7,10,5,17,44,57,-13,35
FC Lugano,3990,8,9,8,15,34,51,-17,35
FC Sion,3990,9,5,7,20,36,57,-21,22
Young Boys,3991,1,20,7,5,70,42,28,67
FC Basel,3991,2,19,8,5,57,21,36,65
St Gallen,3991,3,15,3,14,41,51,-10,48
Lucerne,3991,4,13,8,11,45,40,5,47
FC Zürich,3991,5,10,9,13,41,42,-1,39
FC Lugano,3991,6,11,6,15,33,45,-12,39
Grasshoppers,3991,7,10,7,15,46,53,-7,37
FC Thun,3991,8,10,6,16,45,56,-11,36
FC Sion,3991,9,5,8,19,36,64,-28,23
Young Boys,3992,1,21,9,2,74,37,37,72
FC Basel,3992,2,17,8,7,55,27,28,59
Lucerne,3992,3,12,10,10,47,48,-1,46
St Gallen,3992,4,13,5,14,42,56,-14,44
FC Zürich,3992,5,11,9,12,43,39,4,42
FC Lugano,3992,6,10,8,14,33,46,-13,38
FC Thun,3992,7,10,5,17,43,60,-17,35
Grasshoppers,3992,8,8,8,16,41,51,-10,32
FC Sion,3992,9,6,10,16,39,53,-14,28
Young Boys,3993,1,21,7,4,69,36,33,70
FC Basel,3993,2,17,7,8,54,30,24,58
St Gallen,3993,3,15,2,15,42,55,-13,47
FC Zürich,3993,4,12,9,11,42,34,8,45
Lucerne,3993,5,12,8,12,43,47,-4,44
FC Lugano,3993,6,11,5,16,32,48,-16,38
Grasshoppers,3993,7,9,9,14,42,49,-7,36
FC Sion,3993,8,8,8,16,40,51,-11,32
FC Thun,3993,9,9,5,18,45,59,-14,32
Young Boys,3994,1,21,7,4,72,37,35,70
FC Basel,3994,2,19,8,5,57,25,32,65
Lucerne,3994,3,12,9,11,40,45,-5,45
St Gallen,3994,4,13,3,16,43,60,-17,42
FC Zürich,3994,5,10,10,12,40,37,3,40
FC Lugano,3994,6,10,7,15,29,45,-16,37
Grasshoppers,3994,7,10,6,16,45,50,-5,36
FC Sion,3994,8,9,8,15,46,52,-6,35
FC Thun,3994,9,8,6,18,40,61,-21,30
Young Boys,3995,1,22,7,3,71,37,34,73
FC Basel,3995,2,18,8,6,56,26,30,62
St Gallen,3995,3,14,4,14,43,54,-11,46
FC Zürich,3995,4,12,9,11,47,37,10,45
Lucerne,3995,5,11,11,10,43,46,-3,44
Grasshoppers,3995,6,10,7,15,43,47,-4,37
FC Lugano,3995,7,10,6,16,29,46,-17,36
FC Thun,3995,8,9,6,17,43,61,-18,33
FC Sion,3995,9,5,8,19,40,61,-21,23
Young Boys,3996,1,22,7,3,72,35,37,73
FC Basel,3996,2,19,7,6,60,24,36,64
Lucerne,3996,3,13,8,11,41,45,-4,47
St Gallen,3996,4,14,5,13,41,51,-10,47
FC Zürich,3996,5,12,9,11,42,34,8,45
Grasshoppers,3996,6,9,6,17,41,51,-10,33
FC Thun,3996,7,9,6,17,41,60,-19,33
FC Lugano,3996,8,9,6,17,27,47,-20,33
FC Sion,3996,9,5,10,17,36,54,-18,25
Young Boys,3997,1,23,6,3,76,36,40,75
FC Basel,3997,2,18,7,7,54,27,27,61
Lucerne,3997,3,15,7,10,48,44,4,52
St Gallen,3997,4,15,2,15,45,59,-14,47
FC Lugano,3997,5,11,5,16,38,51,-13,38
FC Zürich,3997,6,9,10,13,39,38,1,37
Grasshoppers,3997,7,9,6,17,42,53,-11,33
FC Thun,3997,8,9,6,17,43,60,-17,33
FC Sion,3997,9,7,7,18,42,59,-17,28
Young Boys,3998,1,23,6,3,77,34,43,75
FC Basel,3998,2,17,9,6,56,28,28,60
Lucerne,3998,3,14,8,10,46,43,3,50
St Gallen,3998,4,13,3,16,40,57,-17,42
FC Zürich,3998,5,10,11,11,43,37,6,41
FC Lugano,3998,6,11,6,15,33,49,-16,39
FC Thun,3998,7,10,6,16,45,60,-15,36
Grasshoppers,3998,8,9,6,17,40,55,-15,33
FC Sion,3998,9,6,7,19,41,58,-17,25
Young Boys,3999,1,23,6,3,77,34,43,75
FC Basel,3999,2,17,8,7,56,30,26,59
FC Zürich,3999,3,12,10,10,44,35,9,46
Lucerne,3999,4,12,10,10,41,43,-2,46
St Gallen,3999,5,13,4,15,41,57,-16,43
FC Thun,3999,6,10,6,16,48,60,-12,36
FC Lugano,3999,7,10,5,17,31,48,-17,35
Grasshoppers,3999,8,9,7,16,41,50,-9,34
FC Sion,3999,9,6,8,18,37,59,-22,26
Young Boys,4000,1,23,7,2,73,31,42,76
FC Basel,4000,2,17,8,7,54,26,28,59
St Gallen,4000,3,15,2,15,43,57,-14,47
Lucerne,4000,4,12,8,12,43,46,-3,44
FC Zürich,4000,5,11,10,11,41,35,6,43
FC Lugano,4000,6,12,5,15,35,49,-14,41
Grasshoppers,4000,7,10,6,16,43,49,-6,36
FC Thun,4000,8,9,5,18,42,63,-21,32
FC Sion,4000,9,5,9,18,35,53,-18,24
Young Boys,4001,1,22,6,4,72,35,37,72
FC Basel,4001,2,17,9,6,53,27,26,60
Lucerne,4001,3,15,7,10,50,42,8,52
St Gallen,4001,4,14,2,16,39,55,-16,44
FC Zürich,4001,5,11,10,11,44,36,8,43
FC Thun,4001,6,10,6,16,42,55,-13,36
FC Lugano,4001,7,10,5,17,29,50,-21,35
Grasshoppers,4001,8,9,6,17,41,53,-12,33
FC Sion,4001,9,7,7,18,37,54,-17,28
Young Boys,4002,1,22,7,3,72,32,40,73
FC Basel,4002,2,16,9,7,49,26,23,57
Lucerne,4002,3,12,10,10,41,41,0,46
FC Zürich,4002,4,12,9,11,40,37,3,45
St Gallen,4002,5,13,6,13,39,50,-11,45
Grasshoppers,4002,6,11,7,14,43,47,-4,40
FC Thun,4002,7,9,6,17,44,58,-14,33
FC Lugano,4002,8,9,6,17,28,48,-20,33
FC Sion,4002,9,5,10,17,38,55,-17,25
Young Boys,4003,1,21,7,4,69,35,34,70
FC Basel,4003,2,19,8,5,58,26,32,65
St Gallen,4003,3,15,3,14,43,53,-10,48
Lucerne,4003,4,13,8,11,42,44,-2,47
FC Zürich,4003,5,10,10,12,40,39,1,40
FC Thun,4003,6,10,6,16,44,58,-14,36
FC Lugano,4003,7,9,8,15,31,47,-16,35
Grasshoppers,4003,8,9,6,17,44,54,-10,33
FC Sion,4003,9,6,8,18,39,54,-15,26
Young Boys,4004,1,21,6,5,67,38,29,69
FC Basel,4004,2,19,8,5,54,22,32,65
Lucerne,4004,3,14,7,11,45,43,2,49
St Gallen,4004,4,15,2,15,41,54,-13,47
FC Lugano,4004,5,11,5,16,34,48,-14,38
FC Thun,4004,6,11,5,16,46,61,-15,38
FC Zürich,4004,7,9,10,13,38,40,-2,37
Grasshoppers,4004,8,9,6,17,44,52,-8,33
FC Sion,4004,9,7,7,18,44,55,-11,28
Young Boys,4005,1,22,6,4,72,34,38,72
FC Basel,4005,2,17,7,8,51,27,24,58
Lucerne,4005,3,14,7,11,44,47,-3,49
St Gallen,4005,4,15,3,14,46,53,-7,48
FC Zürich,4005,5,10,10,12,39,37,2,40
FC Thun,4005,6,11,5,16,49,59,-10,38
FC Lugano,4005,7,10,7,15,30,45,-15,37
Grasshoppers,4005,8,9,7,16,40,52,-12,34
FC Sion,4005,9,6,8,18,38,55,-17,26
Young Boys,4006,1,22,7,3,72,36,36,73
FC Basel,4006,2,19,8,5,55,23,32,65
Lucerne,4006,3,12,8,12,42,44,-2,44
St Gallen,4006,4,13,4,15,40,55,-15,43
FC Zürich,4006,5,10,12,10,41,34,7,42
Grasshoppers,4006,6,9,9,14,42,49,-7,36
FC Lugano,4006,7,9,7,16,31,50,-19,34
FC Sion,4006,8,7,9,16,41,51,-10,30
FC Thun,4006,9,8,6,18,41,63,-22,30
Young Boys,4007,1,23,6,3,74,35,39,75
FC Basel,4007,2,18,9,5,60,26,34,63
St Gallen,4007,3,15,3,14,45,55,-10,48
Lucerne,4007,4,13,7,12,43,50,-7,46
FC Zürich,4007,5,10,11,11,41,37,4,41
Grasshoppers,4007,6,10,6,16,44,50,-6,36
FC Lugano,4007,7,10,5,17,31,49,-18,35
FC Thun,4007,8,9,5,18,42,62,-20,32
FC Sion,4007,9,6,8,18,44,60,-16,26
Young Boys,4008,1,21,8,3,70,37,33,71
FC Basel,4008,2,18,9,5,60,23,37,63
FC Zürich,4008,3,12,10,10,44,34,10,46
St Gallen,4008,4,14,4,14,43,54,-11,46
Lucerne,4008,5,12,7,13,39,48,-9,43
Grasshoppers,4008,6,10,7,15,41,48,-7,37
FC Lugano,4008,7,9,6,17,31,50,-19,33
FC Thun,4008,8,9,5,18,40,61,-21,32
FC Sion,4008,9,7,8,17,41,54,-13,29
Young Boys,4009,1,23,7,2,76,33,43,76
FC Basel,4009,2,19,7,6,53,25,28,64
St Gallen,4009,3,15,3,14,46,56,-10,48
Lucerne,4009,4,11,8,13,38,45,-7,41
FC Zürich,4009,5,10,9,13,39,37,2,39
FC Lugano,4009,6,10,7,15,33,49,-16,37
Grasshoppers,4009,7,10,6,16,43,52,-9,36
FC Thun,4009,8,9,5,18,42,60,-18,32
FC Sion,4009,9,7,8,17,45,58,-13,29
Young Boys,4010,1,21,6,5,69,38,31,69
FC Basel,4010,2,18,8,6,52,25,27,62
Lucerne,4010,3,13,8,11,41,41,0,47
St Gallen,4010,4,13,3,16,40,55,-15,42
FC Zürich,4010,5,10,11,11,40,36,4,41
Grasshoppers,4010,6,11,7,14,45,47,-2,40
FC Lugano,4010,7,11,6,15,31,46,-15,39
FC Thun,4010,8,9,6,17,42,57,-15,33
FC Sion,4010,9,6,9,17,39,54,-15,27
Young Boys,4011,1,22,7,3,75,34,41,73
FC Basel,4011,2,17,8,7,51,26,25,59
St Gallen,4011,3,16,2,14,46,52,-6,50
Lucerne,4011,4,13,7,12,42,46,-4,46
FC Zürich,4011,5,10,11,11,41,39,2,41
Grasshoppers,4011,6,10,7,15,43,49,-6,37
FC Lugano,4011,7,10,5,17,30,51,-21,35
FC Thun,4011,8,8,8,16,41,57,-16,32
FC Sion,4011,9,6,9,17,39,54,-15,27
Young Boys,4012,1,21,8,3,72,36,36,71
FC Basel,4012,2,19,8,5,59,22,37,65
St Gallen,4012,3,15,2,15,42,57,-15,47
Lucerne,4012,4,13,7,12,40,43,-3,46
FC Zürich,4012,5,11,10,11,41,37,4,43
Grasshoppers,4012,6,10,6,16,41,50,-9,36
FC Thun,4012,7,10,5,17,48,60,-12,35
FC Lugano,4012,8,9,7,16,31,48,-17,34
FC Sion,4012,9,6,7,19,39,60,-21,25
Young Boys,4013,1,20,8,4,72,42,30,68
FC Basel,4013,2,19,7,6,59,25,34,64
St Gallen,4013,3,15,2,15,44,58,-14,47
FC Zürich,4013,4,11,9,12,41,38,3,42
Lucerne,4013,5,11,9,12,37,43,-6,42
FC Lugano,4013,6,11,7,14,35,45,-10,40
Grasshoppers,4013,7,11,6,15,44,49,-5,39
FC Thun,4013,8,10,5,17,45,61,-16,35
FC Sion,4013,9,6,7,19,43,59,-16,25
Young Boys,4014,1,21,8,3,75,41,34,71
FC Basel,4014,2,19,7,6,64,25,39,64
Lucerne,4014,3,14,8,10,42,44,-2,50
FC Zürich,4014,4,12,10,10,40,32,8,46
St Gallen,4014,5,14,2,16,42,53,-11,44
Grasshoppers,4014,6,9,7,16,41,50,-9,34
FC Thun,4014,7,9,6,17,41,64,-23,33
FC Lugano,4014,8,9,5,18,28,49,-21,32
FC Sion,4014,9,7,7,18,42,57,-15,28
Young Boys,4015,1,21,8,3,77,40,37,71
FC Basel,4015,2,20,7,5,57,25,32,67
St Gallen,4015,3,14,2,16,43,56,-13,44
FC Zürich,4015,4,11,9,12,38,34,4,42
Lucerne,4015,5,11,8,13,43,51,-8,41
FC Thun,4015,6,11,5,16,44,56,-12,38
FC Lugano,4015,7,10,7,15,33,48,-15,37
Grasshoppers,4015,8,9,8,15,43,52,-9,35
FC Sion,4015,9,6,8,18,38,54,-16,26
Young Boys,4016,1,21,8,3,69,34,35,71
FC Basel,4016,2,18,8,6,52,24,28,62
Lucerne,4016,3,12,9,11,43,44,-1,45
St Gallen,4016,4,13,4,15,40,54,-14,43
FC Zürich,4016,5,10,10,12,39,36,3,40
FC Thun,4016,6,11,5,16,42,55,-13,38
FC Lugano,4016,7,10,8,14,33,47,-14,38
FC Sion,4016,8,8,7,17,41,53,-12,31
Grasshoppers,4016,9,8,7,17,39,51,-12,31
Young Boys,4017,1,21,6,5,69,37,32,69
FC Basel,4017,2,20,7,5,55,24,31,67
Lucerne,4017,3,13,7,12,42,45,-3,46
St Gallen,4017,4,13,3,16,41,58,-17,42
FC Lugano,4017,5,12,5,15,35,45,-10,41
FC Zürich,4017,6,10,10,12,41,37,4,40
Grasshoppers,4017,7,11,7,14,48,49,-1,40
FC Thun,4017,8,8,8,16,46,62,-16,32
FC Sion,4017,9,5,9,18,37,57,-20,24
Young Boys,4018,1,21,8,3,73,35,38,71
FC Basel,4018,2,17,8,7,52,26,26,59
Lucerne,4018,3,13,9,10,41,43,-2,48
St Gallen,4018,4,15,3,14,41,52,-11,48
FC Zürich,4018,5,9,12,11,42,39,3,39
FC Thun,4018,6,11,6,15,47,57,-10,39
FC Lugano,4018,7,10,6,16,33,50,-17,36
Grasshoppers,4018,8,8,8,16,38,48,-10,32
FC Sion,4018,9,5,10,17,39,56,-17,25
Young Boys,4019,1,21,7,4,73,38,35,70
FC Basel,4019,2,18,7,7,56,28,28,61
St Gallen,4019,3,15,2,15,43,56,-13,47
Lucerne,4019,4,13,7,12,43,54,-11,46
FC Zürich,4019,5,12,9,11,43,36,7,45
Grasshoppers,4019,6,12,6,14,50,46,4,42
FC Thun,4019,7,10,5,17,43,58,-15,35
FC Lugano,4019,8,9,6,17,34,53,-19,33
FC Sion,4019,9,6,7,19,40,56,-16,25
Young Boys,4020,1,21,6,5,68,37,31,69
FC Basel,4020,2,20,7,5,56,22,34,67
Lucerne,4020,3,13,8,11,43,46,-3,47
St Gallen,4020,4,15,2,15,43,54,-11,47
FC Zürich,4020,5,11,9,12,41,35,6,42
FC Lugano,4020,6,10,6,16,32,49,-17,36
Grasshoppers,4020,7,9,8,15,40,47,-7,35
FC Thun,4020,8,9,6,17,43,60,-17,33
FC Sion,4020,9,6,8,18,36,52,-16,26
Young Boys,4021,1,23,6,3,73,35,38,75
FC Basel,4021,2,19,7,6,53,24,29,64
FC Zürich,4021,3,12,9,11,42,35,7,45
St Gallen,4021,4,14,2,16,42,56,-14,44
Lucerne,4021,5,11,8,13,38,46,-8,41
Grasshoppers,4021,6,11,7,14,45,48,-3,40
FC Lugano,4021,7,11,5,16,32,46,-14,38
FC Thun,4021,8,9,5,18,43,60,-17,32
FC Sion,4021,9,6,7,19,40,58,-18,25
Young Boys,4022,1,22,6,4,70,34,36,72
FC Basel,4022,2,18,9,5,54,24,30,63
Lucerne,4022,3,13,9,10,44,42,2,48
St Gallen,4022,4,14,3,15,43,56,-13,45
FC Zürich,4022,5,10,11,11,39,36,3,41
FC Thun,4022,6,10,6,16,45,59,-14,36
Grasshoppers,4022,7,9,8,15,39,48,-9,35
FC Lugano,4022,8,9,7,16,29,48,-19,34
FC Sion,4022,9,6,7,19,38,54,-16,25
Young Boys,4023,1,22,7,3,71,32,39,73
FC Basel,4023,2,20,7,5,56,25,31,67
Lucerne,4023,3,13,7,12,40,45,-5,46
St Gallen,4023,4,14,3,15,46,58,-12,45
FC Zürich,4023,5,10,10,12,45,39,6,40
FC Thun,4023,6,11,5,16,50,61,-11,38
FC Lugano,4023,7,9,7,16,30,48,-18,34
Grasshoppers,4023,8,8,6,18,41,54,-13,30
FC Sion,4023,9,7,8,17,42,59,-17,29
Young Boys,4024,1,23,7,2,74,32,42,76
FC Basel,4024,2,16,9,7,52,25,27,57
Lucerne,4024,3,13,9,10,41,42,-1,48
FC Zürich,4024,4,11,11,10,39,32,7,44
St Gallen,4024,5,14,2,16,42,58,-16,44
Grasshoppers,4024,6,10,7,15,43,47,-4,37
FC Thun,4024,7,10,7,15,45,56,-11,37
FC Lugano,4024,8,10,5,17,30,48,-18,35
FC Sion,4024,9,5,7,20,40,66,-26,22
Young Boys,4025,1,23,6,3,71,34,37,75
FC Basel,4025,2,16,8,8,52,28,24,56
Lucerne,4025,3,13,9,10,43,43,0,48
St Gallen,4025,4,14,2,16,42,56,-14,44
FC Lugano,4025,5,12,5,15,33,45,-12,41
FC Zürich,4025,6,10,10,12,41,41,0,40
FC Thun,4025,7,11,6,15,44,55,-11,39
Grasshoppers,4025,8,9,7,16,44,52,-8,34
FC Sion,4025,9,6,7,19,39,55,-16,25
Young Boys,4026,1,21,8,3,73,35,38,71
FC Basel,4026,2,17,8,7,56,29,27,59
Lucerne,4026,3,12,9,11,40,43,-3,45
St Gallen,4026,4,14,3,15,42,54,-12,45
FC Zürich,4026,5,11,10,11,41,36,5,43
Grasshoppers,4026,6,10,8,14,39,44,-5,38
FC Lugano,4026,7,11,5,16,33,50,-17,38
FC Thun,4026,8,8,7,17,40,61,-21,31
FC Sion,4026,9,6,10,16,38,50,-12,28
Young Boys,4027,1,21,7,4,71,36,35,70
FC Basel,4027,2,19,8,5,56,25,31,65
St Gallen,4027,3,14,3,15,42,55,-13,45
Lucerne,4027,4,12,8,12,44,47,-3,44
FC Zürich,4027,5,10,10,12,44,36,8,40
Grasshoppers,4027,6,10,7,15,45,49,-4,37
FC Lugano,4027,7,9,9,14,31,46,-15,36
FC Thun,4027,8,9,7,16,42,61,-19,34
FC Sion,4027,9,6,9,17,40,60,-20,27
Young Boys,4028,1,22,7,3,74,38,36,73
FC Basel,4028,2,16,7,9,51,32,19,55
Lucerne,4028,3,14,8,10,42,39,3,50
FC Zürich,4028,4,13,9,10,44,36,8,48
St Gallen,4028,5,15,2,15,42,52,-10,47
Grasshoppers,4028,6,10,6,16,45,50,-5,36
FC Lugano,4028,7,10,6,16,30,47,-17,36
FC Thun,4028,8,10,5,17,45,57,-12,35
FC Sion,4028,9,5,8,19,36,58,-22,23
Young Boys,4029,1,23,6,3,74,34,40,75
FC Basel,4029,2,16,8,8,49,29,20,56
St Gallen,4029,3,15,4,13,45,50,-5,49
Lucerne,4029,4,12,9,11,40,43,-3,45
FC Zürich,4029,5,11,10,11,44,35,9,43
FC Thun,4029,6,10,6,16,45,56,-11,36
Grasshoppers,4029,7,9,6,17,41,54,-13,33
FC Lugano,4029,8,9,6,17,28,54,-26,33
FC Sion,4029,9,7,9,16,42,53,-11,30
Young Boys,4030,1,22,8,2,72,33,39,74
FC Basel,4030,2,18,8,6,59,25,34,62
Lucerne,4030,3,14,7,11,45,43,2,49
St Gallen,4030,4,15,2,15,46,59,-13,47
FC Zürich,4030,5,11,9,12,42,42,0,42
FC Lugano,4030,6,10,5,17,34,52,-18,35
FC Sion,4030,7,8,8,16,43,53,-10,32
FC Thun,4030,8,9,5,18,44,62,-18,32
Grasshoppers,4030,9,8,6,18,39,55,-16,30
Young Boys,4031,1,20,9,3,68,34,34,69
FC Basel,4031,2,19,7,6,55,24,31,64
St Gallen,4031,3,16,3,13,46,51,-5,51
Lucerne,4031,4,11,9,12,39,47,-8,42
FC Zürich,4031,5,10,10,12,39,38,1,40
FC Lugano,4031,6,10,6,16,28,44,-16,36
Grasshoppers,4031,7,9,7,16,40,51,-11,34
FC Thun,4031,8,9,5,18,42,59,-17,32
FC Sion,4031,9,7,10,15,42,51,-9,31
Young Boys,4032,1,23,6,3,72,37,35,75
FC Basel,4032,2,17,9,6,56,28,28,60
St Gallen,4032,3,15,4,13,44,53,-9,49
FC Zürich,4032,4,10,12,10,43,37,6,42
Lucerne,4032,5,11,8,13,38,44,-6,41
Grasshoppers,4032,6,11,6,15,45,47,-2,39
FC Thun,4032,7,9,7,16,42,59,-17,34
FC Lugano,4032,8,9,6,17,30,49,-19,33
FC Sion,4032,9,5,10,17,40,56,-16,25
Young Boys,4033,1,23,6,3,77,37,40,75
FC Basel,4033,2,18,7,7,52,25,27,61
FC Zürich,4033,3,12,9,11,43,36,7,45
St Gallen,4033,4,14,3,15,42,55,-13,45
Lucerne,4033,5,12,8,12,39,43,-4,44
FC Thun,4033,6,11,5,16,46,56,-10,38
FC Lugano,4033,7,11,5,16,33,48,-15,38
Grasshoppers,4033,8,10,6,16,42,51,-9,36
FC Sion,4033,9,5,7,20,39,62,-23,22
Young Boys,4034,1,21,8,3,70,33,37,71
FC Basel,4034,2,18,8,6,53,26,27,62
FC Zürich,4034,3,12,10,10,44,35,9,46
Lucerne,4034,4,12,8,12,40,45,-5,44
St Gallen,4034,5,14,2,16,45,57,-12,44
FC Thun,4034,6,10,6,16,46,56,-10,36
FC Lugano,4034,7,10,6,16,32,51,-19,36
Grasshoppers,4034,8,9,8,15,39,49,-10,35
FC Sion,4034,9,6,8,18,42,59,-17,26
Young Boys,4035,1,22,6,4,77,38,39,72
FC Basel,4035,2,19,7,6,56,25,31,64
St Gallen,4035,3,15,3,14,44,54,-10,48
Lucerne,4035,4,12,9,11,39,46,-7,45
FC Zürich,4035,5,10,10,12,41,39,2,40
FC Thun,4035,6,10,6,16,44,56,-12,36
FC Lugano,4035,7,10,6,16,35,52,-17,36
Grasshoppers,4035,8,8,7,17,38,51,-13,31
FC Sion,4035,9,6,10,16,42,55,-13,28
Young Boys,4036,1,20,10,2,72,36,36,70
FC Basel,4036,2,16,10,6,49,26,23,58
Lucerne,4036,3,12,9,11,43,46,-3,45
FC Zürich,4036,4,11,11,10,41,35,6,44
St Gallen,4036,5,13,5,14,42,55,-13,44
FC Thun,4036,6,10,7,15,47,58,-11,37
Grasshoppers,4036,7,9,9,14,41,48,-7,36
FC Lugano,4036,8,10,6,16,31,46,-15,36
FC Sion,4036,9,5,9,18,39,55,-16,24
Young Boys,4037,1,22,7,3,74,37,37,73
FC Basel,4037,2,17,9,6,56,30,26,60
Lucerne,4037,3,13,7,12,43,46,-3,46
St Gallen,4037,4,13,3,16,45,60,-15,42
FC Zürich,4037,5,10,11,11,43,37,6,41
Grasshoppers,4037,6,10,6,16,42,51,-9,36
FC Thun,4037,7,10,6,16,46,58,-12,36
FC Lugano,4037,8,10,6,16,33,49,-16,36
FC Sion,4037,9,8,7,17,43,57,-14,31
Young Boys,4038,1,21,6,5,68,40,28,69
FC Basel,4038,2,19,7,6,67,30,37,64
St Gallen,4038,3,15,3,14,48,56,-8,48
FC Zürich,4038,4,12,9,11,41,35,6,45
Lucerne,4038,5,12,8,12,45,51,-6,44
Grasshoppers,4038,6,11,7,14,45,47,-2,40
FC Lugano,4038,7,10,6,16,30,48,-18,36
FC Thun,4038,8,10,5,17,45,61,-16,35
FC Sion,4038,9,5,7,20,35,56,-21,22
Young Boys,4039,1,21,8,3,72,35,37,71
FC Basel,4039,2,18,8,6,57,25,32,62
St Gallen,4039,3,15,3,14,44,54,-10,48
Lucerne,4039,4,13,8,11,41,46,-5,47
FC Zürich,4039,5,10,10,12,46,42,4,40
Grasshoppers,4039,6,11,7,14,46,49,-3,40
FC Lugano,4039,7,10,6,16,33,50,-17,36
FC Thun,4039,8,10,5,17,44,62,-18,35
FC Sion,4039,9,5,7,20,37,57,-20,22
Young Boys,4040,1,22,7,3,72,34,38,73
FC Basel,4040,2,17,8,7,51,26,25,59
FC Zürich,4040,3,12,10,10,42,33,9,46
Lucerne,4040,4,12,8,12,38,42,-4,44
St Gallen,4040,5,13,3,16,41,56,-15,42
FC Lugano,4040,6,11,5,16,31,48,-17,38
Grasshoppers,4040,7,9,7,16,41,51,-10,34
FC Thun,4040,8,9,6,17,43,58,-15,33
FC Sion,4040,9,7,10,15,40,51,-11,31
Young Boys,4041,1,22,7,3,73,36,37,73
FC Basel,4041,2,19,7,6,55,27,28,64
St Gallen,4041,3,15,4,13,43,52,-9,49
Lucerne,4041,4,13,7,12,44,43,1,46
FC Zürich,4041,5,11,10,11,42,37,5,43
FC Thun,4041,6,10,6,16,50,58,-8,36
FC Lugano,4041,7,9,6,17,29,50,-21,33
Grasshoppers,4041,8,8,6,18,39,56,-17,30
FC Sion,4041,9,6,9,17,41,57,-16,27
Young Boys,4042,1,23,6,3,78,38,40,75
FC Basel,4042,2,19,7,6,56,24,32,64
St Gallen,4042,3,14,3,15,41,56,-15,45
Lucerne,4042,4,12,7,13,46,49,-3,43
FC Zürich,4042,5,9,11,12,39,38,1,38
FC Lugano,4042,6,10,7,15,31,48,-17,37
FC Thun,4042,7,10,5,17,42,59,-17,35
Grasshoppers,4042,8,9,6,17,39,49,-10,33
FC Sion,4042,9,8,8,16,41,52,-11,32
Young Boys,4043,1,21,8,3,70,32,38,71
FC Basel,4043,2,16,9,7,49,25,24,57
St Gallen,4043,3,14,5,13,42,52,-10,47
Lucerne,4043,4,11,11,10,41,45,-4,44
FC Zürich,4043,5,9,11,12,39,37,2,38
Grasshoppers,4043,6,10,8,14,44,47,-3,38
FC Lugano,4043,7,10,8,14,32,46,-14,38
FC Thun,4043,8,10,6,16,42,59,-17,36
FC Sion,4043,9,6,8,18,37,53,-16,26
Young Boys,4044,1,23,7,2,74,31,43,76
FC Basel,4044,2,17,9,6,52,25,27,60
Lucerne,4044,3,13,9,10,43,44,-1,48
St Gallen,4044,4,13,4,15,42,55,-13,43
FC Zürich,4044,5,10,9,13,42,40,2,39
FC Lugano,4044,6,11,5,16,33,48,-15,38
FC Thun,4044,7,10,5,17,46,60,-14,35
Grasshoppers,4044,8,9,7,16,42,50,-8,34
FC Sion,4044,9,7,7,18,37,58,-21,28
Young Boys,4045,1,22,7,3,75,34,41,73
FC Basel,4045,2,17,9,6,51,25,26,60
St Gallen,4045,3,15,3,14,47,54,-7,48
FC Zürich,4045,4,12,9,11,44,34,10,45
Lucerne,4045,5,12,9,11,43,46,-3,45
Grasshoppers,4045,6,10,8,14,41,45,-4,38
FC Lugano,4045,7,10,5,17,31,55,-24,35
FC Thun,4045,8,8,6,18,39,58,-19,30
FC Sion,4045,9,6,8,18,39,59,-20,26
Young Boys,4046,1,21,6,5,73,37,36,69
FC Basel,4046,2,17,7,8,54,31,23,58
Lucerne,4046,3,14,8,10,43,42,1,50
St Gallen,4046,4,16,2,14,46,56,-10,50
FC Zürich,4046,5,12,9,11,44,37,7,45
FC Thun,4046,6,11,5,16,47,58,-11,38
FC Lugano,4046,7,10,6,16,34,50,-16,36
Grasshoppers,4046,8,9,7,16,40,48,-8,34
FC Sion,4046,9,5,8,19,38,60,-22,23
Young Boys,4047,1,21,7,4,71,32,39,70
FC Basel,4047,2,19,8,5,54,24,30,65
Lucerne,4047,3,13,7,12,43,48,-5,46
St Gallen,4047,4,14,3,15,44,58,-14,45
FC Zürich,4047,5,10,10,12,43,40,3,40
FC Lugano,4047,6,11,6,15,34,48,-14,39
Grasshoppers,4047,7,9,7,16,40,52,-12,34
FC Thun,4047,8,9,5,18,45,61,-16,32
FC Sion,4047,9,8,7,17,41,52,-11,31
Young Boys,4048,1,22,7,3,71,35,36,73
FC Basel,4048,2,17,8,7,55,28,27,59
Lucerne,4048,3,14,8,10,46,40,6,50
FC Zürich,4048,4,12,9,11,44,37,7,45
St Gallen,4048,5,14,2,16,40,60,-20,44
FC Lugano,4048,6,11,5,16,32,47,-15,38
Grasshoppers,4048,7,9,7,16,40,52,-12,34
FC Thun,4048,8,9,5,18,43,60,-17,32
FC Sion,4048,9,7,7,18,44,56,-12,28
Young Boys,4049,1,21,7,4,73,37,36,70
FC Basel,4049,2,18,8,6,57,24,33,62
Lucerne,4049,3,13,8,11,42,45,-3,47
St Gallen,4049,4,14,4,14,41,53,-12,46
FC Zürich,4049,5,11,10,11,44,38,6,43
FC Lugano,4049,6,10,7,15,33,48,-15,37
FC Thun,4049,7,10,5,17,44,63,-19,35
Grasshoppers,4049,8,8,7,17,39,52,-13,31
FC Sion,4049,9,7,8,17,40,53,-13,29
Young Boys,4050,1,22,6,4,76,36,40,72
FC Basel,4050,2,18,7,7,57,30,27,61
Lucerne,4050,3,14,7,11,43,45,-2,49
St Gallen,4050,4,15,3,14,48,55,-7,48
FC Zürich,4050,5,10,10,12,40,37,3,40
Grasshoppers,4050,6,10,7,15,44,51,-7,37
FC Lugano,4050,7,10,6,16,30,49,-19,36
FC Sion,4050,8,7,9,16,40,53,-13,30
FC Thun,4050,9,8,5,19,44,66,-22,29
Young Boys,4051,1,22,6,4,77,35,42,72
FC Basel,4051,2,20,7,5,58,23,35,67
Lucerne,4051,3,13,7,12,42,46,-4,46
St Gallen,4051,4,13,4,15,40,54,-14,43
FC Zürich,4051,5,10,10,12,39,36,3,40
Grasshoppers,4051,6,11,7,14,46,51,-5,40
FC Thun,4051,7,10,6,16,44,59,-15,36
FC Lugano,4051,8,9,7,16,28,50,-22,34
FC Sion,4051,9,5,8,19,39,59,-20,23
Young Boys,4052,1,20,6,6,68,38,30,66
FC Basel,4052,2,18,8,6,54,25,29,62
St Gallen,4052,3,16,3,13,46,52,-6,51
Lucerne,4052,4,14,7,11,42,43,-1,49
FC Zürich,4052,5,11,11,10,46,36,10,44
Grasshoppers,4052,6,10,6,16,41,50,-9,36
FC Lugano,4052,7,9,7,16,29,48,-19,34
FC Thun,4052,8,8,6,18,40,60,-20,30
FC Sion,4052,9,7,8,17,41,55,-14,29
Young Boys,4053,1,23,6,3,73,32,41,75
FC Basel,4053,2,18,9,5,57,24,33,63
St Gallen,4053,3,16,3,13,46,51,-5,51
Lucerne,4053,4,11,9,12,40,47,-7,42
FC Zürich,4053,5,10,10,12,41,38,3,40
Grasshoppers,4053,6,10,6,16,42,50,-8,36
FC Lugano,4053,7,10,6,16,31,48,-17,36
FC Thun,4053,8,9,7,16,42,61,-19,34
FC Sion,4053,9,5,8,19,36,57,-21,23
Young Boys,4054,1,23,6,3,72,35,37,75
FC Basel,4054,2,18,8,6,56,26,30,62
St Gallen,4054,3,14,3,15,43,57,-14,45
Lucerne,4054,4,12,8,12,45,47,-2,44
FC Zürich,4054,5,10,11,11,43,39,4,41
Grasshoppers,4054,6,10,7,15,43,50,-7,37
FC Lugano,4054,7,10,5,17,32,50,-18,35
FC Thun,4054,8,8,9,15,46,61,-15,33
FC Sion,4054,9,6,9,17,43,58,-15,27
Young Boys,4055,1,21,7,4,72,40,32,70
FC Basel,4055,2,20,7,5,59,21,38,67
St Gallen,4055,3,14,3,15,43,57,-14,45
FC Zürich,4055,4,11,9,12,40,37,3,42
Lucerne,4055,5,11,9,12,40,46,-6,42
Grasshoppers,4055,6,10,7,15,42,47,-5,37
FC Thun,4055,7,10,6,16,46,59,-13,36
FC Lugano,4055,8,10,6,16,31,49,-18,36
FC Sion,4055,9,6,8,18,40,57,-17,26
Young Boys,4056,1,21,8,3,71,36,35,71
FC Basel,4056,2,17,10,5,55,26,29,61
Lucerne,4056,3,11,11,10,40,42,-2,44
St Gallen,4056,4,13,4,15,38,53,-15,43
FC Zürich,4056,5,10,11,11,39,36,3,41
FC Thun,4056,6,11,5,16,43,56,-13,38
FC Lugano,4056,7,10,8,14,29,43,-14,38
Grasshoppers,4056,8,9,7,16,39,48,-9,34
FC Sion,4056,9,6,8,18,41,55,-14,26
Young Boys,4057,1,22,8,2,73,34,39,74
FC Basel,4057,2,18,7,7,53,26,27,61
St Gallen,4057,3,16,2,14,47,54,-7,50
Lucerne,4057,4,12,9,11,42,46,-4,45
FC Zürich,4057,5,11,11,10,40,34,6,44
FC Lugano,4057,6,9,7,16,29,47,-18,34
FC Thun,4057,7,9,6,17,44,56,-12,33
Grasshoppers,4057,8,8,6,18,40,57,-17,30
FC Sion,4057,9,7,8,17,41,55,-14,29
Young Boys,4058,1,24,6,2,79,36,43,78
FC Basel,4058,2,18,7,7,55,28,27,61
St Gallen,4058,3,16,2,14,44,53,-9,50
Lucerne,4058,4,13,7,12,46,46,0,46
FC Zürich,4058,5,10,11,11,43,37,6,41
FC Lugano,4058,6,10,6,16,32,51,-19,36
Grasshoppers,4058,7,9,6,17,42,54,-12,33
FC Thun,4058,8,9,5,18,39,62,-23,32
FC Sion,4058,9,6,8,18,43,56,-13,26
Young Boys,4059,1,22,7,3,79,38,41,73
FC Basel,4059,2,19,7,6,60,29,31,64
Lucerne,4059,3,14,8,10,46,44,2,50
FC Zürich,4059,4,11,10,11,43,36,7,43
St Gallen,4059,5,13,3,16,39,56,-17,42
FC Lugano,4059,6,9,7,16,28,48,-20,34
Grasshoppers,4059,7,9,6,17,43,54,-11,33
FC Thun,4059,8,9,6,17,41,56,-15,33
FC Sion,4059,9,7,8,17,39,57,-18,29
Young Boys,4060,1,20,7,5,71,39,32,67
FC Basel,4060,2,18,9,5,54,25,29,63
St Gallen,4060,3,15,2,15,43,54,-11,47
Lucerne,4060,4,12,7,13,41,47,-6,43
Grasshoppers,4060,5,11,7,14,44,48,-4,40
FC Zürich,4060,6,9,11,12,41,40,1,38
FC Lugano,4060,7,11,5,16,34,48,-14,38
FC Thun,4060,8,9,8,15,43,57,-14,35
FC Sion,4060,9,6,10,16,41,54,-13,28
Young Boys,4061,1,23,7,2,72,33,39,76
FC Basel,4061,2,17,7,8,50,26,24,58
Lucerne,4061,3,14,7,11,45,43,2,49
St Gallen,4061,4,14,2,16,41,55,-14,44
FC Zürich,4061,5,11,10,11,42,36,6,43
FC Lugano,4061,6,10,7,15,33,50,-17,37
FC Thun,4061,7,10,6,16,42,56,-14,36
Grasshoppers,4061,8,9,7,16,42,51,-9,34
FC Sion,4061,9,6,7,19,40,57,-17,25
Young Boys,4062,1,21,8,3,72,38,34,71
FC Basel,4062,2,16,8,8,53,31,22,56
St Gallen,4062,3,15,4,13,44,50,-6,49
Lucerne,4062,4,12,8,12,43,46,-3,44
FC Zürich,4062,5,10,9,13,39,42,-3,39
FC Thun,4062,6,11,5,16,48,60,-12,38
Grasshoppers,4062,7,10,7,15,45,52,-7,37
FC Lugano,4062,8,10,7,15,34,47,-13,37
FC Sion,4062,9,6,10,16,40,52,-12,28
Young Boys,4063,1,21,8,3,70,32,38,71
FC Basel,4063,2,18,7,7,56,28,28,61
Lucerne,4063,3,13,8,11,44,44,0,47
FC Zürich,4063,4,11,10,11,42,36,6,43
St Gallen,4063,5,13,2,17,40,57,-17,41
FC Lugano,4063,6,11,5,16,32,49,-17,38
Grasshoppers,4063,7,9,8,15,41,49,-8,35
FC Thun,4063,8,9,6,17,43,62,-19,33
FC Sion,4063,9,7,10,15,41,52,-11,31
Young Boys,4064,1,20,9,3,73,38,35,69
FC Basel,4064,2,17,10,5,52,22,30,61
FC Zürich,4064,3,12,10,10,42,34,8,46
St Gallen,4064,4,14,3,15,42,56,-14,45
Lucerne,4064,5,11,9,12,38,44,-6,42
FC Lugano,4064,6,10,7,15,33,47,-14,37
FC Thun,4064,7,10,5,17,45,60,-15,35
Grasshoppers,4064,8,8,9,15,39,51,-12,33
FC Sion,4064,9,7,8,17,40,52,-12,29
Young Boys,4065,1,23,6,3,73,31,42,75
FC Basel,4065,2,16,9,7,54,30,24,57
St Gallen,4065,3,13,5,14,43,57,-14,44
Lucerne,4065,4,11,10,11,42,45,-3,43
FC Zürich,4065,5,11,9,12,39,37,2,42
FC Thun,4065,6,11,5,16,47,57,-10,38
Grasshoppers,4065,7,10,6,16,38,51,-13,36
FC Lugano,4065,8,9,7,16,33,50,-17,34
FC Sion,4065,9,8,7,17,42,53,-11,31
Young Boys,4066,1,22,8,2,72,33,39,74
FC Basel,4066,2,18,9,5,57,25,32,63
Lucerne,4066,3,12,8,12,39,43,-4,44
St Gallen,4066,4,13,5,14,42,55,-13,44
FC Zürich,4066,5,11,10,11,45,39,6,43
FC Thun,4066,6,10,6,16,44,59,-15,36
FC Lugano,4066,7,10,6,16,31,48,-17,36
Grasshoppers,4066,8,8,8,16,38,50,-12,32
FC Sion,4066,9,5,10,17,38,54,-16,25
Young Boys,4067,1,21,7,4,71,38,33,70
FC Basel,4067,2,17,8,7,51,27,24,59
St Gallen,4067,3,16,2,14,46,54,-8,50
FC Zürich,4067,4,12,9,11,45,36,9,45
Lucerne,4067,5,12,8,12,43,46,-3,44
Grasshoppers,4067,6,10,6,16,39,48,-9,36
FC Lugano,4067,7,10,5,17,32,51,-19,35
FC Thun,4067,8,9,6,17,42,57,-15,33
FC Sion,4067,9,8,7,17,41,53,-12,31
Young Boys,4068,1,20,6,6,69,37,32,66
FC Basel,4068,2,18,9,5,57,27,30,63
Lucerne,4068,3,13,9,10,44,44,0,48
St Gallen,4068,4,13,4,15,44,59,-15,43
Grasshoppers,4068,5,12,6,14,46,48,-2,42
FC Zürich,4068,6,10,9,13,41,40,1,39
FC Lugano,4068,7,11,6,15,33,45,-12,39
FC Thun,4068,8,9,6,17,44,61,-17,33
FC Sion,4068,9,6,9,17,43,60,-17,27
Young Boys,4069,1,21,8,3,72,33,39,71
FC Basel,4069,2,15,11,6,49,25,24,56
Lucerne,4069,3,14,9,9,43,40,3,51
St Gallen,4069,4,15,3,14,42,51,-9,48
FC Zürich,4069,5,11,11,10,44,36,8,44
Grasshoppers,4069,6,10,6,16,43,51,-8,36
FC Lugano,4069,7,9,7,16,30,50,-20,34
FC Thun,4069,8,8,7,17,41,60,-19,31
FC Sion,4069,9,6,8,18,38,56,-18,26
Young Boys,4070,1,24,6,2,75,31,44,78
FC Basel,4070,2,19,7,6,57,27,30,64
St Gallen,4070,3,15,3,14,43,52,-9,48
Lucerne,4070,4,12,9,11,38,40,-2,45
FC Zürich,4070,5,10,10,12,38,37,1,40
FC Lugano,4070,6,9,6,17,27,48,-21,33
FC Thun,4070,7,9,5,18,43,60,-17,32
FC Sion,4070,8,8,7,17,42,55,-13,31
Grasshoppers,4070,9,8,7,17,38,51,-13,31
Young Boys,4071,1,22,6,4,77,36,41,72
FC Basel,4071,2,18,8,6,53,24,29,62
Lucerne,4071,3,13,8,11,40,45,-5,47
St Gallen,4071,4,14,2,16,43,54,-11,44
FC Zürich,4071,5,11,9,12,44,39,5,42
FC Lugano,4071,6,11,6,15,32,49,-17,39
FC Sion,4071,7,9,7,16,45,55,-10,34
FC Thun,4071,8,9,6,17,43,59,-16,33
Grasshoppers,4071,9,8,6,18,39,55,-16,30
Young Boys,4072,1,22,7,3,75,38,37,73
FC Basel,4072,2,19,7,6,56,25,31,64
Lucerne,4072,3,14,7,11,41,41,0,49
St Gallen,4072,4,14,2,16,45,59,-14,44
FC Zürich,4072,5,10,10,12,40,39,1,40
FC Lugano,4072,6,10,7,15,35,48,-13,37
FC Thun,4072,7,10,6,16,43,57,-14,36
Grasshoppers,4072,8,8,6,18,40,54,-14,30
FC Sion,4072,9,7,8,17,44,58,-14,29
Young Boys,4073,1,21,7,4,68,33,35,70
FC Basel,4073,2,17,9,6,53,28,25,60
Lucerne,4073,3,13,8,11,43,45,-2,47
St Gallen,4073,4,14,3,15,48,58,-10,45
FC Zürich,4073,5,11,9,12,42,37,5,42
Grasshoppers,4073,6,10,7,15,41,48,-7,37
FC Lugano,4073,7,10,6,16,31,48,-17,36
FC Thun,4073,8,9,7,16,43,58,-15,34
FC Sion,4073,9,7,8,17,41,55,-14,29
Young Boys,4074,1,20,6,6,72,40,32,66
FC Basel,4074,2,18,8,6,53,25,28,62
Lucerne,4074,3,13,8,11,47,49,-2,47
St Gallen,4074,4,14,2,16,48,63,-15,44
FC Zürich,4074,5,11,10,11,41,33,8,43
FC Lugano,4074,6,10,7,15,33,49,-16,37
Grasshoppers,4074,7,10,6,16,40,48,-8,36
FC Thun,4074,8,9,7,16,41,57,-16,34
FC Sion,4074,9,8,8,16,42,53,-11,32
Young Boys,4075,1,21,7,4,70,34,36,70
FC Basel,4075,2,17,8,7,53,28,25,59
Lucerne,4075,3,14,7,11,46,42,4,49
St Gallen,4075,4,14,3,15,42,57,-15,45
FC Zürich,4075,5,10,9,13,40,38,2,39
Grasshoppers,4075,6,10,6,16,40,48,-8,36
FC Lugano,4075,7,10,6,16,32,52,-20,36
FC Thun,4075,8,10,5,17,43,59,-16,35
FC Sion,4075,9,9,7,16,41,49,-8,34
Young Boys,4076,1,20,8,4,69,38,31,68
FC Basel,4076,2,19,7,6,57,26,31,64
St Gallen,4076,3,16,3,13,47,55,-8,51
Lucerne,4076,4,13,8,11,47,47,0,47
FC Zürich,4076,5,10,10,12,40,37,3,40
FC Lugano,4076,6,10,7,15,33,48,-15,37
Grasshoppers,4076,7,8,9,15,39,50,-11,33
FC Thun,4076,8,8,8,16,41,57,-16,32
FC Sion,4076,9,5,10,17,38,53,-15,25
Young Boys,4077,1,21,6,5,70,34,36,69
FC Basel,4077,2,18,8,6,53,24,29,62
Lucerne,4077,3,13,8,11,43,45,-2,47
St Gallen,4077,4,13,3,16,40,55,-15,42
FC Zürich,4077,5,10,10,12,40,37,3,40
FC Thun,4077,6,11,6,15,46,58,-12,39
FC Lugano,4077,7,10,7,15,31,49,-18,37
Grasshoppers,4077,8,10,6,16,42,50,-8,36
FC Sion,4077,9,7,8,17,40,53,-13,29
Young Boys,4078,1,20,6,6,70,41,29,66
FC Basel,4078,2,17,9,6,53,25,28,60
St Gallen,4078,3,15,4,13,45,50,-5,49
Lucerne,4078,4,13,8,11,40,44,-4,47
FC Zürich,4078,5,11,10,11,44,36,8,43
FC Lugano,4078,6,11,5,16,30,48,-18,38
Grasshoppers,4078,7,10,6,16,42,51,-9,36
FC Thun,4078,8,9,7,16,41,57,-16,34
FC Sion,4078,9,6,9,17,42,55,-13,27
Young Boys,4079,1,24,6,2,78,34,44,78
FC Basel,4079,2,17,8,7,53,26,27,59
St Gallen,4079,3,15,2,15,43,55,-12,47
Lucerne,4079,4,12,8,12,41,48,-7,44
FC Zürich,4079,5,11,9,12,40,38,2,42
FC Thun,4079,6,10,7,15,46,58,-12,37
FC Lugano,4079,7,10,5,17,32,51,-19,35
Grasshoppers,4079,8,8,8,16,44,54,-10,32
FC Sion,4079,9,7,7,18,41,54,-13,28
Young Boys,4080,1,21,6,5,69,36,33,69
FC Basel,4080,2,17,9,6,54,28,26,60
Lucerne,4080,3,15,7,10,45,42,3,52
St Gallen,4080,4,14,4,14,41,52,-11,46
FC Zürich,4080,5,10,11,11,44,38,6,41
FC Thun,4080,6,11,5,16,47,56,-9,38
FC Lugano,4080,7,9,7,16,31,48,-17,34
Grasshoppers,4080,8,9,6,17,38,50,-12,33
FC Sion,4080,9,7,7,18,37,56,-19,28
Young Boys,4081,1,20,9,3,68,36,32,69
FC Basel,4081,2,17,9,6,57,29,28,60
Lucerne,4081,3,14,8,10,46,42,4,50
St Gallen,4081,4,14,4,14,41,55,-14,46
FC Thun,4081,5,11,5,16,46,58,-12,38
FC Zürich,4081,6,9,10,13,38,39,-1,37
FC Lugano,4081,7,10,6,16,29,46,-17,36
Grasshoppers,4081,8,8,8,16,42,52,-10,32
FC Sion,4081,9,7,9,16,42,52,-10,30
Young Boys,4082,1,21,6,5,73,35,38,69
FC Basel,4082,2,18,9,5,57,26,31,63
Lucerne,4082,3,13,7,12,39,47,-8,46
St Gallen,4082,4,13,4,15,42,57,-15,43
FC Zürich,4082,5,10,10,12,38,35,3,40
FC Lugano,4082,6,11,6,15,33,47,-14,39
Grasshoppers,4082,7,10,7,15,38,45,-7,37
FC Sion,4082,8,9,8,15,41,48,-7,35
FC Thun,4082,9,8,5,19,40,61,-21,29
Young Boys,4083,1,21,8,3,69,35,34,71
FC Basel,4083,2,17,9,6,55,26,29,60
St Gallen,4083,3,15,3,14,43,53,-10,48
Lucerne,4083,4,12,9,11,43,44,-1,45
FC Zürich,4083,5,10,11,11,41,38,3,41
FC Lugano,4083,6,10,6,16,34,50,-16,36
Grasshoppers,4083,7,9,7,16,39,51,-12,34
FC Sion,4083,8,8,9,15,42,50,-8,33
FC Thun,4083,9,8,6,18,39,58,-19,30
Young Boys,4084,1,23,6,3,74,33,41,75
FC Basel,4084,2,16,8,8,49,28,21,56
Lucerne,4084,3,13,8,11,40,44,-4,47
FC Zürich,4084,4,11,10,11,40,35,5,43
FC Lugano,4084,5,12,6,14,35,42,-7,42
St Gallen,4084,6,13,3,16,40,56,-16,42
Grasshoppers,4084,7,9,6,17,40,53,-13,33
FC Thun,4084,8,9,6,17,45,59,-14,33
FC Sion,4084,9,8,7,17,42,55,-13,31
Young Boys,4085,1,22,6,4,75,36,39,72
FC Basel,4085,2,17,7,8,56,32,24,58
St Gallen,4085,3,14,5,13,44,54,-10,47
FC Zürich,4085,4,12,9,11,41,34,7,45
Lucerne,4085,5,12,8,12,42,45,-3,44
Grasshoppers,4085,6,10,7,15,44,49,-5,37
FC Thun,4085,7,9,6,17,43,62,-19,33
FC Lugano,4085,8,9,6,17,30,55,-25,33
FC Sion,4085,9,8,8,16,44,52,-8,32
Young Boys,4086,1,20,9,3,71,37,34,69
FC Basel,4086,2,18,9,5,56,26,30,63
Lucerne,4086,3,13,8,11,42,43,-1,47
St Gallen,4086,4,13,5,14,44,56,-12,44
FC Zürich,4086,5,11,9,12,41,36,5,42
Grasshoppers,4086,6,10,7,15,43,48,-5,37
FC Lugano,4086,7,9,7,16,31,50,-19,34
FC Sion,4086,8,8,9,15,42,52,-10,33
FC Thun,4086,9,8,5,19,43,65,-22,29
Young Boys,4087,1,22,7,3,70,35,35,73
FC Basel,4087,2,18,8,6,55,24,31,62
FC Zürich,4087,3,12,10,10,43,34,9,46
St Gallen,4087,4,14,3,15,40,55,-15,45
Lucerne,4087,5,11,10,11,41,46,-5,43
Grasshoppers,4087,6,11,6,15,43,49,-6,39
FC Lugano,4087,7,10,6,16,32,46,-14,36
FC Thun,4087,8,9,5,18,41,60,-19,32
FC Sion,4087,9,6,7,19,40,56,-16,25
Young Boys,4088,1,20,8,4,73,40,33,68
FC Basel,4088,2,18,8,6,56,27,29,62
Lucerne,4088,3,14,8,10,42,40,2,50
FC Zürich,4088,4,12,9,11,46,38,8,45
St Gallen,4088,5,13,3,16,40,54,-14,42
FC Lugano,4088,6,11,5,16,34,47,-13,38
FC Thun,4088,7,11,5,16,47,61,-14,38
Grasshoppers,4088,8,9,6,17,39,53,-14,33
FC Sion,4088,9,6,8,18,44,61,-17,26
Young Boys,4089,1,22,6,4,71,32,39,72
FC Basel,4089,2,18,8,6,53,26,27,62
Lucerne,4089,3,13,7,12,41,42,-1,46
St Gallen,4089,4,14,3,15,42,55,-13,45
FC Lugano,4089,5,12,5,15,32,47,-15,41
FC Zürich,4089,6,10,10,12,39,38,1,40
Grasshoppers,4089,7,11,6,15,42,48,-6,39
FC Thun,4089,8,9,5,18,42,59,-17,32
FC Sion,4089,9,6,8,18,39,54,-15,26
Young Boys,4090,1,21,8,3,71,35,36,71
FC Basel,4090,2,18,8,6,53,27,26,62
St Gallen,4090,3,15,2,15,45,55,-10,47
Lucerne,4090,4,12,10,10,41,41,0,46
FC Zürich,4090,5,10,10,12,39,37,2,40
Grasshoppers,4090,6,10,6,16,43,50,-7,36
FC Thun,4090,7,9,6,17,44,62,-18,33
FC Lugano,4090,8,9,6,17,30,50,-20,33
FC Sion,4090,9,8,8,16,43,52,-9,32
Young Boys,4091,1,21,7,4,70,36,34,70
FC Basel,4091,2,19,7,6,57,23,34,64
Lucerne,4091,3,13,8,11,42,46,-4,47
FC Zürich,4091,4,12,9,11,46,39,7,45
St Gallen,4091,5,14,2,16,44,58,-14,44
FC Thun,4091,6,10,5,17,51,64,-13,35
FC Lugano,4091,7,10,5,17,30,47,-17,35
Grasshoppers,4091,8,9,7,16,40,50,-10,34
FC Sion,4091,9,7,8,17,43,60,-17,29
Young Boys,4092,1,23,7,2,76,33,43,76
FC Basel,4092,2,19,7,6,56,26,30,64
St Gallen,4092,3,15,2,15,43,54,-11,47
Lucerne,4092,4,13,7,12,40,44,-4,46
FC Thun,4092,5,11,5,16,46,58,-12,38
FC Lugano,4092,6,11,5,16,30,45,-15,38
FC Zürich,4092,7,9,9,14,40,41,-1,36
Grasshoppers,4092,8,9,7,16,40,50,-10,34
FC Sion,4092,9,6,7,19,41,61,-20,25
Young Boys,4093,1,20,9,3,73,37,36,69
FC Basel,4093,2,18,9,5,58,25,33,63
Lucerne,4093,3,14,9,9,44,41,3,51
St Gallen,4093,4,14,3,15,43,55,-12,45
FC Zürich,4093,5,10,10,12,39,37,2,40
FC Lugano,4093,6,9,7,16,27,47,-20,34
FC Thun,4093,7,9,6,17,42,63,-21,33
Grasshoppers,4093,8,8,8,16,39,51,-12,32
FC Sion,4093,9,8,7,17,42,51,-9,31
Young Boys,4094,1,22,7,3,70,33,37,73
FC Basel,4094,2,17,9,6,56,29,27,60
Lucerne,4094,3,13,9,10,40,40,0,48
St Gallen,4094,4,13,5,14,44,56,-12,44
FC Zürich,4094,5,9,11,12,42,42,0,38
Grasshoppers,4094,6,10,7,15,42,48,-6,37
FC Lugano,4094,7,10,6,16,33,47,-14,36
FC Thun,4094,8,9,6,17,44,61,-17,33
FC Sion,4094,9,7,8,17,44,59,-15,29
Young Boys,4095,1,22,6,4,72,35,37,72
FC Basel,4095,2,17,8,7,50,25,25,59
Lucerne,4095,3,15,8,9,43,40,3,53
St Gallen,4095,4,14,3,15,42,54,-12,45
FC Zürich,4095,5,10,10,12,41,38,3,40
Grasshoppers,4095,6,10,6,16,41,48,-7,36
FC Lugano,4095,7,10,6,16,29,46,-17,36
FC Sion,4095,8,8,7,17,44,56,-12,31
FC Thun,4095,9,8,6,18,41,61,-20,30
Young Boys,4096,1,21,7,4,71,37,34,70
FC Basel,4096,2,17,9,6,52,23,29,60
St Gallen,4096,3,14,4,14,43,53,-10,46
Lucerne,4096,4,12,9,11,39,45,-6,45
FC Zürich,4096,5,11,10,11,39,35,4,43
FC Lugano,4096,6,10,7,15,32,46,-14,37
FC Thun,4096,7,9,7,16,43,57,-14,34
FC Sion,4096,8,8,8,16,42,53,-11,32
Grasshoppers,4096,9,8,7,17,38,50,-12,31
Young Boys,4097,1,21,7,4,71,37,34,70
FC Basel,4097,2,19,7,6,57,26,31,64
Lucerne,4097,3,13,7,12,41,44,-3,46
FC Zürich,4097,4,11,10,11,42,37,5,43
St Gallen,4097,5,13,2,17,42,57,-15,41
Grasshoppers,4097,6,11,7,14,44,46,-2,40
FC Lugano,4097,7,11,5,16,32,47,-15,38
FC Sion,4097,8,8,7,17,40,55,-15,31
FC Thun,4097,9,8,6,18,40,60,-20,30
Young Boys,4098,1,22,6,4,72,37,35,72
FC Basel,4098,2,19,8,5,60,27,33,65
Lucerne,4098,3,14,8,10,43,44,-1,50
FC Zürich,4098,4,11,10,11,47,39,8,43
St Gallen,4098,5,13,3,16,41,55,-14,42
FC Lugano,4098,6,10,6,16,31,49,-18,36
FC Thun,4098,7,10,5,17,45,60,-15,35
Grasshoppers,4098,8,9,7,16,43,51,-8,34
FC Sion,4098,9,5,9,18,38,58,-20,24
Young Boys,4099,1,20,9,3,72,36,36,69
FC Basel,4099,2,17,9,6,57,30,27,60
Lucerne,4099,3,13,10,9,47,44,3,49
St Gallen,4099,4,14,4,14,45,56,-11,46
FC Zürich,4099,5,10,11,11,42,39,3,41
FC Thun,4099,6,10,7,15,47,58,-11,37
Grasshoppers,4099,7,9,7,16,39,51,-12,34
FC Lugano,4099,8,9,7,16,34,52,-18,34
FC Sion,4099,9,6,8,18,39,56,-17,26
Young Boys,4100,1,21,7,4,72,39,33,70
FC Basel,4100,2,18,9,5,56,25,31,63
Lucerne,4100,3,14,9,9,43,39,4,51
St Gallen,4100,4,13,2,17,39,59,-20,41
FC Zürich,4100,5,9,13,10,41,37,4,40
FC Lugano,4100,6,10,6,16,32,47,-15,36
Grasshoppers,4100,7,9,7,16,39,49,-10,34
FC Sion,4100,8,8,9,15,45,52,-7,33
FC Thun,4100,9,8,6,18,41,61,-20,30
Young Boys,4101,1,21,7,4,70,38,32,70
FC Basel,4101,2,17,9,6,57,27,30,60
St Gallen,4101,3,15,3,14,42,53,-11,48
Lucerne,4101,4,12,8,12,40,49,-9,44
Grasshoppers,4101,5,12,6,14,50,45,5,42
FC Zürich,4101,6,10,11,11,40,36,4,41
FC Lugano,4101,7,11,5,16,34,50,-16,38
FC Thun,4101,8,9,5,18,43,62,-19,32
FC Sion,4101,9,6,8,18,38,54,-16,26
Young Boys,4102,1,24,6,2,74,31,43,78
FC Basel,4102,2,17,7,8,53,28,25,58
Lucerne,4102,3,14,7,11,50,41,9,49
St Gallen,4102,4,15,3,14,41,50,-9,48
FC Lugano,4102,5,11,5,16,30,50,-20,38
FC Zürich,4102,6,9,10,13,38,40,-2,37
FC Thun,4102,7,10,6,16,44,58,-14,36
Grasshoppers,4102,8,8,6,18,38,55,-17,30
FC Sion,4102,9,6,10,16,37,52,-15,28
Young Boys,4103,1,22,7,3,70,33,37,73
FC Basel,4103,2,19,7,6,58,24,34,64
Lucerne,4103,3,15,8,9,45,41,4,53
St Gallen,4103,4,13,3,16,40,57,-17,42
FC Zürich,4103,5,10,9,13,41,41,0,39
FC Lugano,4103,6,11,5,16,32,47,-15,38
Grasshoppers,4103,7,9,7,16,41,50,-9,34
FC Thun,4103,8,8,6,18,42,64,-22,30
FC Sion,4103,9,6,10,16,40,52,-12,28
Young Boys,4104,1,21,8,3,71,35,36,71
FC Basel,4104,2,16,9,7,55,28,27,57
St Gallen,4104,3,14,4,14,42,54,-12,46
Lucerne,4104,4,12,9,11,40,45,-5,45
FC Zürich,4104,5,9,12,11,37,34,3,39
FC Lugano,4104,6,11,6,15,33,47,-14,39
Grasshoppers,4104,7,10,8,14,43,47,-4,38
FC Thun,4104,8,8,7,17,43,62,-19,31
FC Sion,4104,9,7,9,16,38,50,-12,30
Young Boys,4105,1,20,8,4,73,42,31,68
FC Basel,4105,2,17,10,5,54,24,30,61
Lucerne,4105,3,13,8,11,44,44,0,47
FC Zürich,4105,4,11,10,11,39,36,3,43
St Gallen,4105,5,13,3,16,41,60,-19,42
FC Lugano,4105,6,11,7,14,37,47,-10,40
FC Thun,4105,7,9,7,16,44,57,-13,34
FC Sion,4105,8,8,8,16,45,54,-9,32
Grasshoppers,4105,9,8,7,17,39,52,-13,31
Young Boys,4106,1,22,6,4,77,39,38,72
FC Basel,4106,2,17,8,7,54,29,25,59
St Gallen,4106,3,16,2,14,43,55,-12,50
Lucerne,4106,4,14,7,11,44,42,2,49
FC Zürich,4106,5,11,11,10,42,35,7,44
Grasshoppers,4106,6,9,6,17,42,53,-11,33
FC Lugano,4106,7,9,6,17,30,51,-21,33
FC Thun,4106,8,9,5,18,40,57,-17,32
FC Sion,4106,9,8,7,17,42,53,-11,31
Young Boys,4107,1,22,7,3,75,37,38,73
FC Basel,4107,2,16,10,6,51,26,25,58
Lucerne,4107,3,14,8,10,45,43,2,50
FC Zürich,4107,4,11,11,10,40,33,7,44
St Gallen,4107,5,13,3,16,41,56,-15,42
Grasshoppers,4107,6,10,6,16,39,51,-12,36
FC Thun,4107,7,9,7,16,40,55,-15,34
FC Lugano,4107,8,9,7,16,31,48,-17,34
FC Sion,4107,9,7,7,18,39,52,-13,28
Young Boys,4108,1,22,6,4,74,37,37,72
FC Basel,4108,2,17,8,7,55,31,24,59
Lucerne,4108,3,13,9,10,44,44,0,48
St Gallen,4108,4,15,3,14,47,56,-9,48
FC Zürich,4108,5,10,10,12,43,37,6,40
Grasshoppers,4108,6,11,7,14,47,48,-1,40
FC Lugano,4108,7,11,6,15,35,48,-13,39
FC Thun,4108,8,8,6,18,43,64,-21,30
FC Sion,4108,9,6,7,19,40,63,-23,25
Young Boys,4109,1,22,8,2,72,32,40,74
FC Basel,4109,2,17,10,5,56,27,29,61
Lucerne,4109,3,12,10,10,41,43,-2,46
St Gallen,4109,4,13,4,15,42,60,-18,43
FC Zürich,4109,5,9,10,13,38,37,1,37
Grasshoppers,4109,6,9,9,14,43,48,-5,36
FC Lugano,4109,7,10,6,16,29,46,-17,36
FC Thun,4109,8,10,5,17,41,58,-17,35
FC Sion,4109,9,7,8,17,44,55,-11,29
Young Boys,4110,1,22,7,3,72,33,39,73
FC Basel,4110,2,17,9,6,53,26,27,60
Lucerne,4110,3,13,9,10,46,41,5,48
St Gallen,4110,4,13,5,14,42,55,-13,44
FC Zürich,4110,5,10,9,13,41,38,3,39
FC Thun,4110,6,11,5,16,46,58,-12,38
FC Lugano,4110,7,10,7,15,30,48,-18,37
Grasshoppers,4110,8,8,7,17,38,56,-18,31
FC Sion,4110,9,7,8,17,41,54,-13,29
Young Boys,4111,1,21,6,5,69,37,32,69
FC Basel,4111,2,18,7,7,52,24,28,61
St Gallen,4111,3,16,2,14,45,51,-6,50
Lucerne,4111,4,13,8,11,44,45,-1,47
FC Zürich,4111,5,11,9,12,42,36,6,42
FC Thun,4111,6,11,5,16,42,57,-15,38
Grasshoppers,4111,7,10,7,15,44,50,-6,37
FC Lugano,4111,8,10,5,17,31,49,-18,35
FC Sion,4111,9,6,7,19,40,60,-20,25
Young Boys,4112,1,22,7,3,71,32,39,73
FC Basel,4112,2,17,10,5,53,25,28,61
St Gallen,4112,3,14,5,13,44,52,-8,47
Lucerne,4112,4,12,8,12,40,46,-6,44
FC Zürich,4112,5,10,10,12,42,40,2,40
FC Lugano,4112,6,10,7,15,31,45,-14,37
Grasshoppers,4112,7,9,7,16,41,53,-12,34
FC Thun,4112,8,9,5,18,43,60,-17,32
FC Sion,4112,9,7,9,16,44,56,-12,30
Young Boys,4113,1,21,7,4,68,39,29,70
FC Basel,4113,2,17,9,6,56,27,29,60
Lucerne,4113,3,14,7,11,44,42,2,49
St Gallen,4113,4,15,3,14,47,54,-7,48
FC Zürich,4113,5,11,10,11,44,37,7,43
Grasshoppers,4113,6,10,6,16,41,49,-8,36
FC Lugano,4113,7,10,6,16,31,50,-19,36
FC Thun,4113,8,10,5,17,46,58,-12,35
FC Sion,4113,9,6,7,19,39,60,-21,25
Young Boys,4114,1,21,7,4,70,37,33,70
FC Basel,4114,2,17,8,7,51,27,24,59
Lucerne,4114,3,14,7,11,45,41,4,49
FC Zürich,4114,4,11,10,11,41,36,5,43
St Gallen,4114,5,13,3,16,39,56,-17,42
FC Lugano,4114,6,11,5,16,32,47,-15,38
Grasshoppers,4114,7,10,6,16,47,50,-3,36
FC Thun,4114,8,9,6,17,42,63,-21,33
FC Sion,4114,9,8,8,16,46,56,-10,32
Young Boys,4115,1,22,7,3,71,33,38,73
FC Basel,4115,2,17,9,6,58,28,30,60
Lucerne,4115,3,12,10,10,42,43,-1,46
St Gallen,4115,4,14,3,15,43,55,-12,45
FC Zürich,4115,5,10,10,12,41,39,2,40
Grasshoppers,4115,6,11,7,14,41,46,-5,40
FC Lugano,4115,7,11,5,16,33,50,-17,38
FC Thun,4115,8,8,6,18,41,64,-23,30
FC Sion,4115,9,7,7,18,41,53,-12,28
Young Boys,4116,1,20,9,3,68,34,34,69
FC Basel,4116,2,16,11,5,55,29,26,59
Lucerne,4116,3,12,9,11,42,42,0,45
St Gallen,4116,4,14,3,15,44,58,-14,45
FC Zürich,4116,5,9,12,11,40,38,2,39
FC Thun,4116,6,10,7,15,46,57,-11,37
FC Lugano,4116,7,10,6,16,32,48,-16,36
Grasshoppers,4116,8,9,7,16,42,52,-10,34
FC Sion,4116,9,8,8,16,41,52,-11,32
Young Boys,4117,1,21,9,2,74,36,38,72
FC Basel,4117,2,15,11,6,51,28,23,56
Lucerne,4117,3,12,10,10,42,44,-2,46
St Gallen,4117,4,14,4,14,42,52,-10,46
FC Zürich,4117,5,11,11,10,45,37,8,44
FC Thun,4117,6,10,7,15,46,58,-12,37
FC Lugano,4117,7,10,6,16,29,45,-16,36
Grasshoppers,4117,8,8,7,17,39,50,-11,31
FC Sion,4117,9,6,9,17,40,58,-18,27
Young Boys,4118,1,21,7,4,71,38,33,70
FC Basel,4118,2,19,8,5,55,22,33,65
Lucerne,4118,3,12,9,11,39,42,-3,45
St Gallen,4118,4,13,4,15,42,58,-16,43
FC Zürich,4118,5,10,10,12,40,37,3,40
Grasshoppers,4118,6,11,7,14,43,47,-4,40
FC Lugano,4118,7,10,6,16,32,48,-16,36
FC Thun,4118,8,9,5,18,40,60,-20,32
FC Sion,4118,9,6,10,16,42,52,-10,28
Young Boys,4119,1,21,8,3,71,34,37,71
FC Basel,4119,2,16,8,8,51,28,23,56
St Gallen,4119,3,15,3,14,46,56,-10,48
FC Zürich,4119,4,12,9,11,43,36,7,45
Lucerne,4119,5,12,9,11,41,45,-4,45
Grasshoppers,4119,6,10,8,14,41,46,-5,38
FC Lugano,4119,7,11,5,16,31,46,-15,38
FC Thun,4119,8,10,5,17,50,63,-13,35
FC Sion,4119,9,6,7,19,42,62,-20,25
Young Boys,4120,1,22,6,4,74,41,33,72
FC Basel,4120,2,17,8,7,52,29,23,59
Lucerne,4120,3,13,8,11,49,48,1,47
St Gallen,4120,4,14,2,16,44,57,-13,44
FC Thun,4120,5,12,5,15,48,56,-8,41
FC Zürich,4120,6,10,10,12,44,40,4,40
Grasshoppers,4120,7,11,6,15,53,52,1,39
FC Lugano,4120,8,10,6,16,31,49,-18,36
FC Sion,4120,9,6,7,19,41,64,-23,25
Young Boys,4121,1,22,8,2,71,32,39,74
FC Basel,4121,2,17,10,5,53,24,29,61
Lucerne,4121,3,13,8,11,44,44,0,47
St Gallen,4121,4,14,4,14,41,54,-13,46
FC Zürich,4121,5,11,11,10,42,32,10,44
Grasshoppers,4121,6,10,6,16,42,49,-7,36
FC Lugano,4121,7,9,8,15,30,46,-16,35
FC Thun,4121,8,8,5,19,43,65,-22,29
FC Sion,4121,9,6,8,18,38,58,-20,26
Young Boys,4122,1,21,7,4,70,38,32,70
FC Basel,4122,2,18,9,5,55,26,29,63
Lucerne,4122,3,13,8,11,45,42,3,47
St Gallen,4122,4,15,2,15,44,56,-12,47
FC Zürich,4122,5,9,11,12,39,37,2,38
FC Thun,4122,6,10,7,15,50,59,-9,37
FC Lugano,4122,7,10,6,16,31,47,-16,36
Grasshoppers,4122,8,9,7,16,40,51,-11,34
FC Sion,4122,9,7,7,18,40,58,-18,28
Young Boys,4123,1,23,7,2,74,34,40,76
FC Basel,4123,2,16,8,8,54,27,27,56
FC Zürich,4123,3,13,9,10,40,32,8,48
St Gallen,4123,4,15,3,14,44,56,-12,48
Lucerne,4123,5,12,7,13,39,48,-9,43
Grasshoppers,4123,6,10,7,15,41,47,-6,37
FC Thun,4123,7,10,6,16,44,58,-14,36
FC Lugano,4123,8,10,5,17,32,49,-17,35
FC Sion,4123,9,5,8,19,40,57,-17,23
Young Boys,4124,1,22,7,3,75,37,38,73
FC Basel,4124,2,17,9,6,57,27,30,60
Lucerne,4124,3,14,7,11,45,45,0,49
St Gallen,4124,4,14,3,15,45,56,-11,45
FC Zürich,4124,5,10,11,11,41,34,7,41
FC Lugano,4124,6,11,6,15,34,49,-15,39
FC Thun,4124,7,10,6,16,44,61,-17,36
Grasshoppers,4124,8,8,7,17,40,52,-12,31
FC Sion,4124,9,6,8,18,39,59,-20,26
Young Boys,4125,1,22,7,3,75,36,39,73
FC Basel,4125,2,16,9,7,53,30,23,57
St Gallen,4125,3,16,2,14,48,54,-6,50
Lucerne,4125,4,13,8,11,40,46,-6,47
FC Zürich,4125,5,9,12,11,42,39,3,39
FC Lugano,4125,6,11,5,16,34,49,-15,38
Grasshoppers,4125,7,9,8,15,40,48,-8,35
FC Thun,4125,8,9,6,17,45,62,-17,33
FC Sion,4125,9,6,9,17,42,55,-13,27
Young Boys,4126,1,22,7,3,73,35,38,73
FC Basel,4126,2,18,8,6,52,24,28,62
Lucerne,4126,3,13,8,11,44,44,0,47
St Gallen,4126,4,15,2,15,47,59,-12,47
FC Zürich,4126,5,9,11,12,38,37,1,38
FC Lugano,4126,6,10,6,16,34,52,-18,36
Grasshoppers,4126,7,9,8,15,48,51,-3,35
FC Thun,4126,8,9,7,16,41,56,-15,34
FC Sion,4126,9,6,9,17,41,60,-19,27
Young Boys,4127,1,21,7,4,74,35,39,70
FC Basel,4127,2,18,8,6,55,26,29,62
Lucerne,4127,3,13,9,10,44,43,1,48
FC Zürich,4127,4,11,9,12,44,39,5,42
St Gallen,4127,5,13,2,17,40,60,-20,41
FC Lugano,4127,6,11,6,15,32,47,-15,39
Grasshoppers,4127,7,10,7,15,40,52,-12,37
FC Thun,4127,8,9,6,17,43,59,-16,33
FC Sion,4127,9,7,8,17,41,52,-11,29
Young Boys,4128,1,21,8,3,73,37,36,71
FC Basel,4128,2,17,8,7,53,27,26,59
St Gallen,4128,3,15,4,13,42,51,-9,49
Lucerne,4128,4,12,9,11,42,44,-2,45
FC Zürich,4128,5,10,11,11,42,38,4,41
FC Lugano,4128,6,11,7,14,31,44,-13,40
Grasshoppers,4128,7,10,7,15,45,49,-4,37
FC Thun,4128,8,9,6,17,45,61,-16,33
FC Sion,4128,9,5,8,19,39,61,-22,23
Young Boys,4129,1,22,7,3,73,36,37,73
FC Basel,4129,2,17,8,7,54,28,26,59
St Gallen,4129,3,15,3,14,41,51,-10,48
FC Zürich,4129,4,12,9,11,44,37,7,45
Lucerne,4129,5,12,9,11,40,40,0,45
Grasshoppers,4129,6,10,6,16,41,49,-8,36
FC Thun,4129,7,10,5,17,42,58,-16,35
FC Lugano,4129,8,9,6,17,31,51,-20,33
FC Sion,4129,9,7,7,18,38,54,-16,28
Young Boys,4130,1,21,7,4,72,36,36,70
FC Basel,4130,2,19,8,5,56,22,34,65
St Gallen,4130,3,15,3,14,47,52,-5,48
Lucerne,4130,4,12,8,12,39,51,-12,44
FC Zürich,4130,5,10,10,12,40,36,4,40
FC Lugano,4130,6,10,6,16,32,50,-18,36
FC Thun,4130,7,10,5,17,41,59,-18,35
Grasshoppers,4130,8,9,7,16,41,52,-11,34
FC Sion,4130,9,7,8,17,43,53,-10,29
Young Boys,4131,1,21,7,4,74,36,38,70
FC Basel,4131,2,19,7,6,57,26,31,64
St Gallen,4131,3,16,2,14,44,53,-9,50
Lucerne,4131,4,12,8,12,42,49,-7,44
FC Zürich,4131,5,9,9,14,40,42,-2,36
Grasshoppers,4131,6,10,6,16,43,53,-10,36
FC Lugano,4131,7,10,6,16,34,52,-18,36
FC Thun,4131,8,10,5,17,48,62,-14,35
FC Sion,4131,9,8,8,16,41,50,-9,32
Young Boys,4132,1,19,10,3,69,36,33,67
FC Basel,4132,2,18,8,6,61,30,31,62
Lucerne,4132,3,13,9,10,42,45,-3,48
FC Zürich,4132,4,12,10,10,45,34,11,46
St Gallen,4132,5,14,3,15,44,56,-12,45
FC Lugano,4132,6,10,8,14,29,43,-14,38
Grasshoppers,4132,7,8,8,16,40,50,-10,32
FC Thun,4132,8,8,7,17,40,62,-22,31
FC Sion,4132,9,6,9,17,38,52,-14,27
Young Boys,4133,1,23,6,3,77,34,43,75
FC Basel,4133,2,18,8,6,55,28,27,62
Lucerne,4133,3,14,7,11,43,41,2,49
St Gallen,4133,4,14,3,15,41,56,-15,45
FC Zürich,4133,5,10,10,12,42,36,6,40
FC Lugano,4133,6,10,6,16,29,50,-21,36
FC Thun,4133,7,10,5,17,46,63,-17,35
FC Sion,4133,8,8,7,17,44,56,-12,31
Grasshoppers,4133,9,8,6,18,42,55,-13,30
Young Boys,4134,1,21,7,4,70,35,35,70
FC Basel,4134,2,20,7,5,56,25,31,67
St Gallen,4134,3,15,3,14,45,54,-9,48
Lucerne,4134,4,13,8,11,42,43,-1,47
FC Zürich,4134,5,11,9,12,42,38,4,42
Grasshoppers,4134,6,10,6,16,43,52,-9,36
FC Lugano,4134,7,10,6,16,31,48,-17,36
FC Thun,4134,8,9,5,18,48,64,-16,32
FC Sion,4134,9,6,7,19,38,56,-18,25
Young Boys,4135,1,21,7,4,74,37,37,70
FC Basel,4135,2,18,7,7,55,29,26,61
St Gallen,4135,3,15,2,15,47,56,-9,47
Lucerne,4135,4,12,8,12,42,49,-7,44
FC Zürich,4135,5,10,10,12,40,39,1,40
FC Lugano,4135,6,11,7,14,33,45,-12,40
Grasshoppers,4135,7,10,6,16,41,49,-8,36
FC Thun,4135,8,10,5,17,44,59,-15,35
FC Sion,4135,9,7,8,17,41,54,-13,29
Young Boys,4136,1,20,6,6,70,41,29,66
FC Basel,4136,2,19,8,5,58,22,36,65
Lucerne,4136,3,13,7,12,42,46,-4,46
FC Zürich,4136,4,11,11,10,45,35,10,44
FC Lugano,4136,5,12,5,15,33,46,-13,41
St Gallen,4136,6,13,2,17,40,57,-17,41
Grasshoppers,4136,7,10,6,16,42,48,-6,36
FC Sion,4136,8,8,8,16,43,54,-11,32
FC Thun,4136,9,9,5,18,43,67,-24,32
Young Boys,4137,1,21,8,3,71,34,37,71
FC Basel,4137,2,18,9,5,55,24,31,63
St Gallen,4137,3,15,2,15,46,57,-11,47
Lucerne,4137,4,13,7,12,42,44,-2,46
FC Zürich,4137,5,10,11,11,42,39,3,41
Grasshoppers,4137,6,10,7,15,42,48,-6,37
FC Thun,4137,7,9,7,16,41,56,-15,34
FC Lugano,4137,8,9,6,17,29,52,-23,33
FC Sion,4137,9,6,9,17,40,54,-14,27
Young Boys,4138,1,24,6,2,76,30,46,78
FC Basel,4138,2,17,8,7,56,29,27,59
Lucerne,4138,3,13,9,10,41,43,-2,48
St Gallen,4138,4,14,2,16,42,55,-13,44
FC Zürich,4138,5,10,12,10,45,38,7,42
FC Lugano,4138,6,10,7,15,31,49,-18,37
FC Thun,4138,7,10,5,17,46,62,-16,35
Grasshoppers,4138,8,8,8,16,38,50,-12,32
FC Sion,4138,9,5,9,18,37,56,-19,24
Young Boys,4139,1,20,8,4,68,34,34,68
FC Basel,4139,2,18,9,5,53,24,29,63
Lucerne,4139,3,13,9,10,41,40,1,48
St Gallen,4139,4,14,2,16,43,57,-14,44
FC Zürich,4139,5,11,10,11,44,35,9,43
FC Lugano,4139,6,12,5,15,33,45,-12,41
Grasshoppers,4139,7,9,7,16,39,50,-11,34
FC Sion,4139,8,7,9,16,41,56,-15,30
FC Thun,4139,9,8,5,19,42,63,-21,29
Young Boys,4140,1,23,7,2,74,31,43,76
FC Basel,4140,2,18,8,6,58,28,30,62
Lucerne,4140,3,13,8,11,41,43,-2,47
St Gallen,4140,4,13,2,17,42,59,-17,41
FC Zürich,4140,5,10,10,12,41,41,0,40
FC Thun,4140,6,10,7,15,49,61,-12,37
FC Lugano,4140,7,10,6,16,32,50,-18,36
Grasshoppers,4140,8,8,10,14,41,49,-8,34
FC Sion,4140,9,6,8,18,41,57,-16,26
Young Boys,4141,1,20,9,3,72,38,34,69
FC Basel,4141,2,17,10,5,58,28,30,61
Lucerne,4141,3,12,9,11,39,44,-5,45
St Gallen,4141,4,13,4,15,42,58,-16,43
FC Zürich,4141,5,10,10,12,41,41,0,40
Grasshoppers,4141,6,11,6,15,42,45,-3,39
FC Thun,4141,7,11,5,16,49,63,-14,38
FC Lugano,4141,8,10,6,16,34,49,-15,36
FC Sion,4141,9,7,7,18,47,58,-11,28
Young Boys,4142,1,21,7,4,70,35,35,70
FC Basel,4142,2,19,7,6,55,24,31,64
St Gallen,4142,3,15,4,13,43,51,-8,49
Lucerne,4142,4,13,7,12,42,44,-2,46
FC Zürich,4142,5,11,10,11,41,35,6,43
FC Thun,4142,6,10,5,17,43,58,-15,35
FC Lugano,4142,7,9,7,16,28,50,-22,34
Grasshoppers,4142,8,8,7,17,41,55,-14,31
FC Sion,4142,9,7,8,17,42,53,-11,29
Young Boys,4143,1,22,8,2,74,33,41,74
FC Basel,4143,2,15,8,9,50,31,19,53
Lucerne,4143,3,14,7,11,43,43,0,49
St Gallen,4143,4,14,3,15,45,60,-15,45
FC Zürich,4143,5,11,9,12,42,38,4,42
Grasshoppers,4143,6,10,8,14,41,46,-5,38
FC Lugano,4143,7,10,6,16,35,51,-16,36
FC Thun,4143,8,9,6,17,39,55,-16,33
FC Sion,4143,9,7,9,16,40,52,-12,30
Young Boys,4144,1,21,6,5,72,38,34,69
FC Basel,4144,2,18,8,6,53,25,28,62
Lucerne,4144,3,15,7,10,46,44,2,52
St Gallen,4144,4,14,3,15,43,55,-12,45
FC Zürich,4144,5,10,9,13,39,38,1,39
FC Thun,4144,6,11,5,16,44,54,-10,38
FC Lugano,4144,7,11,5,16,33,48,-15,38
Grasshoppers,4144,8,10,6,16,41,49,-8,36
FC Sion,4144,9,6,7,19,37,57,-20,25
Young Boys,4145,1,22,6,4,71,33,38,72
FC Basel,4145,2,18,8,6,55,30,25,62
St Gallen,4145,3,15,2,15,47,58,-11,47
Lucerne,4145,4,13,7,12,45,45,0,46
FC Zürich,4145,5,11,11,10,47,39,8,44
FC Thun,4145,6,11,5,16,49,58,-9,38
Grasshoppers,4145,7,9,6,17,39,52,-13,33
FC Lugano,4145,8,9,5,18,33,54,-21,32
FC Sion,4145,9,7,8,17,40,57,-17,29
Young Boys,4146,1,23,7,2,73,34,39,76
FC Basel,4146,2,18,7,7,56,27,29,61
Lucerne,4146,3,13,8,11,39,41,-2,47
FC Zürich,4146,4,11,10,11,46,40,6,43
St Gallen,4146,5,13,3,16,41,56,-15,42
Grasshoppers,4146,6,10,7,15,43,48,-5,37
FC Lugano,4146,7,10,7,15,30,44,-14,37
FC Thun,4146,8,9,5,18,42,63,-21,32
FC Sion,4146,9,6,8,18,39,56,-17,26
Young Boys,4147,1,20,9,3,72,36,36,69
FC Basel,4147,2,18,7,7,49,25,24,61
Lucerne,4147,3,14,8,10,41,40,1,50
St Gallen,4147,4,14,3,15,41,52,-11,45
FC Zürich,4147,5,10,11,11,40,36,4,41
FC Lugano,4147,6,10,7,15,33,48,-15,37
Grasshoppers,4147,7,9,8,15,42,50,-8,35
FC Thun,4147,8,9,6,17,43,58,-15,33
FC Sion,4147,9,6,9,17,38,54,-16,27
Young Boys,4148,1,21,6,5,68,34,34,69
FC Basel,4148,2,17,8,7,51,25,26,59
Lucerne,4148,3,14,7,11,42,43,-1,49
St Gallen,4148,4,15,3,14,45,54,-9,48
FC Zürich,4148,5,9,12,11,41,38,3,39
Grasshoppers,4148,6,11,6,15,45,51,-6,39
FC Thun,4148,7,11,5,16,47,59,-12,38
FC Lugano,4148,8,10,6,16,30,48,-18,36
FC Sion,4148,9,5,9,18,39,56,-17,24
Young Boys,4149,1,24,6,2,75,32,43,78
FC Basel,4149,2,18,8,6,52,24,28,62
St Gallen,4149,3,15,3,14,45,52,-7,48
Lucerne,4149,4,13,7,12,43,46,-3,46
FC Zürich,4149,5,10,9,13,39,38,1,39
FC Thun,4149,6,11,5,16,43,57,-14,38
FC Lugano,4149,7,10,5,17,30,49,-19,35
Grasshoppers,4149,8,8,7,17,37,49,-12,31
FC Sion,4149,9,6,8,18,38,55,-17,26
Young Boys,4150,1,22,8,2,73,32,41,74
FC Basel,4150,2,19,8,5,57,25,32,65
Lucerne,4150,3,12,8,12,43,48,-5,44
St Gallen,4150,4,14,2,16,46,59,-13,44
FC Zürich,4150,5,11,10,11,43,39,4,43
FC Lugano,4150,6,10,6,16,33,52,-19,36
FC Thun,4150,7,10,5,17,45,60,-15,35
Grasshoppers,4150,8,8,8,16,39,51,-12,32
FC Sion,4150,9,7,7,18,44,57,-13,28
Young Boys,4151,1,21,7,4,68,37,31,70
FC Basel,4151,2,17,9,6,52,25,27,60
Lucerne,4151,3,14,9,9,46,42,4,51
St Gallen,4151,4,14,3,15,42,55,-13,45
FC Zürich,4151,5,11,10,11,43,39,4,43
FC Thun,4151,6,11,5,16,47,57,-10,38
FC Lugano,4151,7,9,6,17,31,50,-19,33
Grasshoppers,4151,8,8,7,17,38,52,-14,31
FC Sion,4151,9,6,10,16,43,53,-10,28
Young Boys,4152,1,21,8,3,72,35,37,71
FC Basel,4152,2,18,8,6,54,26,28,62
St Gallen,4152,3,15,2,15,42,57,-15,47
Lucerne,4152,4,12,8,12,42,45,-3,44
FC Lugano,4152,5,12,6,14,38,45,-7,42
FC Zürich,4152,6,10,9,13,43,43,0,39
Grasshoppers,4152,7,10,6,16,43,49,-6,36
FC Thun,4152,8,8,7,17,42,61,-19,31
FC Sion,4152,9,7,8,17,42,57,-15,29
Young Boys,4153,1,20,7,5,75,41,34,67
FC Basel,4153,2,18,7,7,58,28,30,61
St Gallen,4153,3,15,3,14,44,54,-10,48
Lucerne,4153,4,12,8,12,42,51,-9,44
FC Zürich,4153,5,10,10,12,41,39,2,40
FC Lugano,4153,6,11,7,14,35,46,-11,40
Grasshoppers,4153,7,10,6,16,46,53,-7,36
FC Thun,4153,8,10,6,16,46,61,-15,36
FC Sion,4153,9,7,8,17,43,57,-14,29
Young Boys,4154,1,21,7,4,73,36,37,70
FC Basel,4154,2,18,8,6,55,24,31,62
Lucerne,4154,3,13,7,12,43,47,-4,46
St Gallen,4154,4,14,4,14,42,51,-9,46
FC Zürich,4154,5,10,10,12,40,37,3,40
Grasshoppers,4154,6,10,7,15,44,54,-10,37
FC Thun,4154,7,10,6,16,45,60,-15,36
FC Lugano,4154,8,9,6,17,28,49,-21,33
FC Sion,4154,9,7,9,16,41,53,-12,30
Young Boys,4155,1,21,7,4,74,37,37,70
FC Basel,4155,2,18,9,5,55,24,31,63
Lucerne,4155,3,14,7,11,46,44,2,49
St Gallen,4155,4,14,3,15,42,53,-11,45
FC Zürich,4155,5,10,11,11,39,35,4,41
Grasshoppers,4155,6,11,7,14,44,48,-4,40
FC Lugano,4155,7,10,6,16,31,50,-19,36
FC Thun,4155,8,9,6,17,43,61,-18,33
FC Sion,4155,9,5,8,19,36,58,-22,23
Young Boys,4156,1,22,7,3,78,38,40,73
FC Basel,4156,2,17,9,6,53,24,29,60
Lucerne,4156,3,13,9,10,43,43,0,48
FC Zürich,4156,4,12,10,10,44,34,10,46
St Gallen,4156,5,14,4,14,41,52,-11,46
FC Thun,4156,6,9,8,15,45,58,-13,35
FC Lugano,4156,7,10,5,17,30,50,-20,35
Grasshoppers,4156,8,9,7,16,42,52,-10,34
FC Sion,4156,9,5,7,20,39,64,-25,22
Young Boys,4157,1,23,6,3,78,34,44,75
FC Basel,4157,2,16,8,8,48,26,22,56
Lucerne,4157,3,14,8,10,42,43,-1,50
St Gallen,4157,4,15,3,14,43,52,-9,48
FC Zürich,4157,5,12,9,11,41,33,8,45
FC Thun,4157,6,10,6,16,42,56,-14,36
Grasshoppers,4157,7,9,7,16,40,51,-11,34
FC Lugano,4157,8,9,5,18,31,53,-22,32
FC Sion,4157,9,6,8,18,37,54,-17,26
Young Boys,4158,1,24,6,2,74,31,43,78
FC Basel,4158,2,18,8,6,56,25,31,62
St Gallen,4158,3,14,4,14,46,57,-11,46
Lucerne,4158,4,11,9,12,38,48,-10,42
FC Zürich,4158,5,10,11,11,40,36,4,41
FC Thun,4158,6,9,8,15,40,54,-14,35
FC Lugano,4158,7,9,8,15,32,49,-17,35
Grasshoppers,4158,8,8,9,15,39,49,-10,33
FC Sion,4158,9,5,9,18,37,53,-16,24
Young Boys,4159,1,23,6,3,72,34,38,75
FC Basel,4159,2,19,8,5,57,25,32,65
FC Zürich,4159,3,12,9,11,44,35,9,45
St Gallen,4159,4,14,3,15,43,56,-13,45
Lucerne,4159,5,12,7,13,39,44,-5,43
FC Lugano,4159,6,10,5,17,29,47,-18,35
Grasshoppers,4159,7,9,6,17,39,51,-12,33
FC Thun,4159,8,9,6,17,41,58,-17,33
FC Sion,4159,9,7,8,17,42,56,-14,29
Young Boys,4160,1,22,7,3,73,36,37,73
FC Basel,4160,2,19,7,6,57,25,32,64
Lucerne,4160,3,11,10,11,42,47,-5,43
St Gallen,4160,4,13,4,15,42,56,-14,43
FC Zürich,4160,5,11,9,12,41,36,5,42
FC Lugano,4160,6,10,6,16,33,50,-17,36
FC Thun,4160,7,10,5,17,41,57,-16,35
FC Sion,4160,8,8,8,16,41,52,-11,32
Grasshoppers,4160,9,8,8,16,40,51,-11,32
Young Boys,4161,1,22,7,3,71,34,37,73
FC Basel,4161,2,17,9,6,54,26,28,60
St Gallen,4161,3,14,5,13,46,55,-9,47
Lucerne,4161,4,11,11,10,41,43,-2,44
FC Zürich,4161,5,10,10,12,40,39,1,40
FC Thun,4161,6,11,5,16,46,56,-10,38
FC Lugano,4161,7,11,5,16,34,49,-15,38
Grasshoppers,4161,8,8,8,16,38,50,-12,32
FC Sion,4161,9,5,10,17,38,56,-18,25
Young Boys,4162,1,20,9,3,77,42,35,69
FC Basel,4162,2,16,10,6,55,30,25,58
St Gallen,4162,3,15,2,15,44,56,-12,47
Lucerne,4162,4,13,7,12,46,45,1,46
FC Lugano,4162,5,11,7,14,34,46,-12,40
FC Zürich,4162,6,9,12,11,41,38,3,39
Grasshoppers,4162,7,9,7,16,44,60,-16,34
FC Thun,4162,8,8,9,15,46,61,-15,33
FC Sion,4162,9,7,9,16,46,55,-9,30
Young Boys,4163,1,22,7,3,73,39,34,73
FC Basel,4163,2,16,8,8,52,27,25,56
St Gallen,4163,3,16,2,14,46,54,-8,50
Lucerne,4163,4,12,9,11,44,46,-2,45
FC Zürich,4163,5,11,10,11,39,34,5,43
FC Lugano,4163,6,11,5,16,34,48,-14,38
Grasshoppers,4163,7,9,9,14,41,48,-7,36
FC Thun,4163,8,9,7,16,46,60,-14,34
FC Sion,4163,9,6,7,19,40,59,-19,25
Young Boys,4164,1,21,7,4,72,36,36,70
FC Basel,4164,2,18,8,6,55,27,28,62
Lucerne,4164,3,12,8,12,40,45,-5,44
St Gallen,4164,4,13,3,16,40,56,-16,42
FC Zürich,4164,5,10,11,11,44,40,4,41
FC Lugano,4164,6,12,5,15,33,45,-12,41
Grasshoppers,4164,7,9,9,14,43,49,-6,36
FC Thun,4164,8,10,6,16,44,58,-14,36
FC Sion,4164,9,6,9,17,41,56,-15,27
Young Boys,4165,1,22,6,4,68,33,35,72
FC Basel,4165,2,17,7,8,53,27,26,58
Lucerne,4165,3,14,7,11,44,43,1,49
St Gallen,4165,4,14,3,15,45,57,-12,45
FC Zürich,4165,5,10,10,12,43,40,3,40
Grasshoppers,4165,6,10,6,16,40,49,-9,36
FC Thun,4165,7,10,6,16,42,57,-15,36
FC Lugano,4165,8,10,6,16,32,48,-16,36
FC Sion,4165,9,7,9,16,39,52,-13,30
Young Boys,4166,1,23,7,2,75,33,42,76
FC Basel,4166,2,16,11,5,55,25,30,59
St Gallen,4166,3,14,5,13,43,53,-10,47
Lucerne,4166,4,11,11,10,42,44,-2,44
FC Zürich,4166,5,11,10,11,46,38,8,43
Grasshoppers,4166,6,10,7,15,43,52,-9,37
FC Lugano,4166,7,9,7,16,29,48,-19,34
FC Thun,4166,8,9,6,17,48,66,-18,33
FC Sion,4166,9,5,8,19,40,62,-22,23
Young Boys,4167,1,20,7,5,72,40,32,67
FC Basel,4167,2,19,7,6,59,26,33,64
Lucerne,4167,3,14,8,10,42,40,2,50
St Gallen,4167,4,15,3,14,43,54,-11,48
FC Zürich,4167,5,9,9,14,39,41,-2,36
Grasshoppers,4167,6,10,6,16,41,50,-9,36
FC Thun,4167,7,10,5,17,46,65,-19,35
FC Lugano,4167,8,10,5,17,30,49,-19,35
FC Sion,4167,9,8,8,16,46,53,-7,32
Young Boys,4168,1,22,7,3,70,32,38,73
FC Basel,4168,2,17,8,7,52,29,23,59
Lucerne,4168,3,13,8,11,44,47,-3,47
St Gallen,4168,4,14,2,16,44,57,-13,44
FC Zürich,4168,5,10,9,13,40,39,1,39
FC Thun,4168,6,11,5,16,46,56,-10,38
FC Lugano,4168,7,10,5,17,30,47,-17,35
FC Sion,4168,8,9,7,16,41,50,-9,34
Grasshoppers,4168,9,9,7,16,39,49,-10,34
Young Boys,4169,1,22,7,3,76,35,41,73
FC Basel,4169,2,19,8,5,63,26,37,65
St Gallen,4169,3,14,2,16,46,59,-13,44
FC Zürich,4169,4,10,12,10,42,35,7,42
Lucerne,4169,5,11,8,13,38,49,-11,41
FC Lugano,4169,6,11,6,15,31,48,-17,39
Grasshoppers,4169,7,10,8,14,44,49,-5,38
FC Thun,4169,8,9,6,17,43,62,-19,33
FC Sion,4169,9,6,7,19,40,60,-20,25
Young Boys,4170,1,22,6,4,71,34,37,72
FC Basel,4170,2,19,7,6,55,24,31,64
Lucerne,4170,3,12,9,11,41,44,-3,45
St Gallen,4170,4,14,3,15,43,58,-15,45
FC Zürich,4170,5,11,9,12,41,38,3,42
FC Lugano,4170,6,11,5,16,31,48,-17,38
FC Sion,4170,7,8,8,16,46,53,-7,32
Grasshoppers,4170,8,8,8,16,40,51,-11,32
FC Thun,4170,9,9,5,18,42,60,-18,32
Young Boys,4171,1,21,7,4,74,38,36,70
FC Basel,4171,2,17,9,6,54,28,26,60
St Gallen,4171,3,14,4,14,43,53,-10,46
FC Zürich,4171,4,11,10,11,43,39,4,43
Lucerne,4171,5,11,10,11,42,47,-5,43
FC Lugano,4171,6,11,7,14,36,48,-12,40
Grasshoppers,4171,7,10,6,16,41,49,-8,36
FC Thun,4171,8,9,6,17,42,59,-17,33
FC Sion,4171,9,7,7,18,39,53,-14,28
Young Boys,4172,1,22,8,2,72,33,39,74
FC Basel,4172,2,17,8,7,54,26,28,59
St Gallen,4172,3,15,2,15,42,55,-13,47
Lucerne,4172,4,12,9,11,40,45,-5,45
FC Zürich,4172,5,10,11,11,41,35,6,41
Grasshoppers,4172,6,10,6,16,45,51,-6,36
FC Lugano,4172,7,10,6,16,30,47,-17,36
FC Sion,4172,8,7,10,15,45,52,-7,31
FC Thun,4172,9,8,6,18,40,65,-25,30
Young Boys,4173,1,22,8,2,69,31,38,74
FC Basel,4173,2,17,8,7,57,31,26,59
Lucerne,4173,3,12,10,10,40,41,-1,46
St Gallen,4173,4,14,3,15,45,56,-11,45
FC Zürich,4173,5,11,10,11,45,39,6,43
FC Lugano,4173,6,10,7,15,31,46,-15,37
Grasshoppers,4173,7,9,9,14,40,47,-7,36
FC Thun,4173,8,9,6,17,43,61,-18,33
FC Sion,4173,9,6,7,19,38,56,-18,25
Young Boys,4174,1,22,7,3,69,34,35,73
FC Basel,4174,2,20,7,5,58,22,36,67
Lucerne,4174,3,13,8,11,41,41,0,47
St Gallen,4174,4,14,2,16,45,58,-13,44
FC Zürich,4174,5,10,10,12,39,39,0,40
FC Thun,4174,6,10,6,16,42,56,-14,36
FC Lugano,4174,7,10,6,16,32,48,-16,36
Grasshoppers,4174,8,8,8,16,40,51,-11,32
FC Sion,4174,9,5,10,17,40,57,-17,25
Young Boys,4175,1,22,6,4,76,37,39,72
FC Basel,4175,2,19,7,6,60,30,30,64
St Gallen,4175,3,16,2,14,44,53,-9,50
Lucerne,4175,4,13,7,12,41,42,-1,46
FC Zürich,4175,5,10,10,12,42,39,3,40
FC Thun,4175,6,10,6,16,49,63,-14,36
FC Lugano,4175,7,10,5,17,31,49,-18,35
Grasshoppers,4175,8,9,6,17,39,53,-14,33
FC Sion,4175,9,7,7,18,41,57,-16,28
Young Boys,4176,1,22,8,2,74,34,40,74
FC Basel,4176,2,17,8,7,50,27,23,59
Lucerne,4176,3,14,7,11,47,44,3,49
St Gallen,4176,4,14,3,15,43,56,-13,45
FC Zürich,4176,5,10,10,12,41,38,3,40
FC Thun,4176,6,10,6,16,46,58,-12,36
Grasshoppers,4176,7,9,7,16,43,56,-13,34
FC Lugano,4176,8,9,7,16,30,49,-19,34
FC Sion,4176,9,7,8,17,43,55,-12,29
Young Boys,4177,1,21,7,4,75,36,39,70
FC Basel,4177,2,19,8,5,57,24,33,65
St Gallen,4177,3,16,2,14,45,55,-10,50
Lucerne,4177,4,14,7,11,47,45,2,49
FC Zürich,4177,5,12,10,10,43,33,10,46
Grasshoppers,4177,6,9,6,17,42,54,-12,33
FC Lugano,4177,7,9,6,17,31,50,-19,33
FC Thun,4177,8,9,5,18,44,61,-17,32
FC Sion,4177,9,6,7,19,37,63,-26,25
Young Boys,4178,1,22,8,2,70,32,38,74
FC Basel,4178,2,16,9,7,52,26,26,57
Lucerne,4178,3,13,9,10,43,42,1,48
St Gallen,4178,4,15,2,15,43,54,-11,47
FC Zürich,4178,5,10,11,11,41,38,3,41
FC Lugano,4178,6,10,6,16,29,46,-17,36
Grasshoppers,4178,7,9,7,16,41,52,-11,34
FC Thun,4178,8,9,6,17,43,60,-17,33
FC Sion,4178,9,6,10,16,39,51,-12,28
Young Boys,4179,1,22,7,3,70,33,37,73
FC Basel,4179,2,16,8,8,48,27,21,56
St Gallen,4179,3,14,3,15,41,54,-13,45
Lucerne,4179,4,12,7,13,40,46,-6,43
FC Zürich,4179,5,11,9,12,41,36,5,42
FC Lugano,4179,6,12,5,15,32,44,-12,41
Grasshoppers,4179,7,11,6,15,46,48,-2,39
FC Thun,4179,8,11,5,16,46,57,-11,38
FC Sion,4179,9,6,8,18,39,58,-19,26
Young Boys,4180,1,20,9,3,69,35,34,69
FC Basel,4180,2,17,8,7,52,26,26,59
Lucerne,4180,3,13,8,11,45,46,-1,47
St Gallen,4180,4,15,2,15,46,55,-9,47
FC Zürich,4180,5,12,10,10,45,35,10,46
Grasshoppers,4180,6,11,6,15,44,48,-4,39
FC Lugano,4180,7,10,5,17,33,51,-18,35
FC Thun,4180,8,8,7,17,42,62,-20,31
FC Sion,4180,9,6,9,17,40,58,-18,27
Young Boys,4181,1,21,6,5,69,41,28,69
FC Basel,4181,2,18,8,6,55,26,29,62
Lucerne,4181,3,13,7,12,42,46,-4,46
St Gallen,4181,4,14,3,15,43,55,-12,45
FC Zürich,4181,5,10,11,11,42,37,5,41
Grasshoppers,4181,6,10,7,15,44,49,-5,37
FC Lugano,4181,7,10,6,16,31,47,-16,36
FC Thun,4181,8,9,7,16,47,62,-15,34
FC Sion,4181,9,7,9,16,46,56,-10,30
Young Boys,4182,1,20,7,5,69,37,32,67
FC Basel,4182,2,18,8,6,55,25,30,62
Lucerne,4182,3,12,11,9,43,43,0,47
FC Zürich,4182,4,11,9,12,39,36,3,42
St Gallen,4182,5,13,3,16,41,61,-20,42
FC Lugano,4182,6,12,5,15,36,47,-11,41
FC Thun,4182,7,11,5,16,49,57,-8,38
Grasshoppers,4182,8,8,8,16,37,52,-15,32
FC Sion,4182,9,7,8,17,44,55,-11,29
Young Boys,4183,1,24,6,2,74,32,42,78
FC Basel,4183,2,18,7,7,53,23,30,61
Lucerne,4183,3,13,8,11,43,44,-1,47
FC Zürich,4183,4,11,9,12,40,35,5,42
St Gallen,4183,5,13,3,16,39,56,-17,42
FC Lugano,4183,6,11,5,16,33,47,-14,38
Grasshoppers,4183,7,10,6,16,43,52,-9,36
FC Sion,4183,8,8,7,17,39,54,-15,31
FC Thun,4183,9,8,5,19,40,61,-21,29
Young Boys,4184,1,22,8,2,75,34,41,74
FC Basel,4184,2,17,9,6,53,24,29,60
St Gallen,4184,3,15,4,13,44,52,-8,49
Lucerne,4184,4,12,10,10,42,45,-3,46
FC Thun,4184,5,11,6,15,49,59,-10,39
FC Zürich,4184,6,9,10,13,42,43,-1,37
FC Lugano,4184,7,9,7,16,33,54,-21,34
Grasshoppers,4184,8,9,6,17,42,53,-11,33
FC Sion,4184,9,6,8,18,41,57,-16,26
Young Boys,4185,1,22,8,2,71,34,37,74
FC Basel,4185,2,17,8,7,55,27,28,59
Lucerne,4185,3,14,8,10,48,43,5,50
St Gallen,4185,4,14,3,15,42,55,-13,45
FC Zürich,4185,5,10,11,11,42,40,2,41
FC Lugano,4185,6,10,6,16,31,49,-18,36
FC Thun,4185,7,10,5,17,47,65,-18,35
FC Sion,4185,8,7,9,16,46,54,-8,30
Grasshoppers,4185,9,8,6,18,39,54,-15,30
Young Boys,4186,1,21,6,5,67,36,31,69
FC Basel,4186,2,17,9,6,57,28,29,60
Lucerne,4186,3,13,7,12,44,45,-1,46
St Gallen,4186,4,14,3,15,44,55,-11,45
FC Zürich,4186,5,10,11,11,43,38,5,41
FC Lugano,4186,6,12,5,15,32,44,-12,41
FC Thun,4186,7,11,5,16,43,57,-14,38
Grasshoppers,4186,8,10,6,16,40,50,-10,36
FC Sion,4186,9,6,8,18,38,55,-17,26
Young Boys,4187,1,21,6,5,70,38,32,69
FC Basel,4187,2,18,7,7,55,25,30,61
St Gallen,4187,3,15,2,15,45,53,-8,47
FC Zürich,4187,4,12,10,10,43,36,7,46
Lucerne,4187,5,12,7,13,41,51,-10,43
FC Lugano,4187,6,11,5,16,33,48,-15,38
Grasshoppers,4187,7,10,6,16,44,49,-5,36
FC Thun,4187,8,10,6,16,43,59,-16,36
FC Sion,4187,9,7,7,18,40,55,-15,28
Young Boys,4188,1,24,6,2,77,31,46,78
FC Basel,4188,2,16,9,7,53,28,25,57
FC Zürich,4188,3,12,10,10,48,35,13,46
Lucerne,4188,4,12,8,12,40,46,-6,44
St Gallen,4188,5,13,4,15,39,54,-15,43
Grasshoppers,4188,6,10,6,16,41,51,-10,36
FC Thun,4188,7,10,5,17,46,63,-17,35
FC Lugano,4188,8,10,5,17,30,48,-18,35
FC Sion,4188,9,7,7,18,39,57,-18,28
Young Boys,4189,1,22,7,3,75,37,38,73
FC Basel,4189,2,20,7,5,55,24,31,67
Lucerne,4189,3,13,7,12,42,43,-1,46
St Gallen,4189,4,13,3,16,39,54,-15,42
FC Zürich,4189,5,10,10,12,43,40,3,40
FC Thun,4189,6,11,5,16,47,60,-13,38
Grasshoppers,4189,7,10,6,16,43,50,-7,36
FC Lugano,4189,8,10,6,16,31,48,-17,36
FC Sion,4189,9,5,9,18,38,57,-19,24
Young Boys,4190,1,22,8,2,73,35,38,74
FC Basel,4190,2,18,8,6,57,26,31,62
Lucerne,4190,3,13,8,11,45,42,3,47
St Gallen,4190,4,15,2,15,42,54,-12,47
FC Zürich,4190,5,9,12,11,41,39,2,39
Grasshoppers,4190,6,10,7,15,42,48,-6,37
FC Lugano,4190,7,10,5,17,31,52,-21,35
FC Thun,4190,8,8,6,18,40,63,-23,30
FC Sion,4190,9,7,8,17,41,53,-12,29
Young Boys,4191,1,21,8,3,70,35,35,71
FC Basel,4191,2,17,8,7,53,25,28,59
Lucerne,4191,3,12,9,11,43,45,-2,45
FC Zürich,4191,4,11,10,11,41,36,5,43
St Gallen,4191,5,13,4,15,44,59,-15,43
Grasshoppers,4191,6,9,9,14,40,47,-7,36
FC Lugano,4191,7,10,6,16,32,50,-18,36
FC Thun,4191,8,10,5,17,43,58,-15,35
FC Sion,4191,9,7,9,16,39,50,-11,30
Young Boys,4192,1,22,7,3,74,35,39,73
FC Basel,4192,2,17,8,7,52,26,26,59
St Gallen,4192,3,15,2,15,41,52,-11,47
Lucerne,4192,4,13,7,12,42,47,-5,46
FC Zürich,4192,5,10,11,11,40,36,4,41
FC Lugano,4192,6,11,6,15,31,45,-14,39
Grasshoppers,4192,7,10,6,16,39,48,-9,36
FC Thun,4192,8,9,7,16,41,56,-15,34
FC Sion,4192,9,6,8,18,38,53,-15,26
Young Boys,4193,1,22,6,4,74,38,36,72
FC Basel,4193,2,16,8,8,53,30,23,56
Lucerne,4193,3,13,9,10,44,42,2,48
FC Zürich,4193,4,11,10,11,40,37,3,43
St Gallen,4193,5,13,3,16,40,59,-19,42
FC Lugano,4193,6,12,5,15,36,45,-9,41
Grasshoppers,4193,7,11,7,14,47,48,-1,40
FC Thun,4193,8,9,6,17,44,61,-17,33
FC Sion,4193,9,6,8,18,37,55,-18,26
Young Boys,4194,1,22,6,4,72,36,36,72
FC Basel,4194,2,18,9,5,53,25,28,63
Lucerne,4194,3,13,7,12,44,44,0,46
St Gallen,4194,4,14,3,15,44,58,-14,45
FC Zürich,4194,5,10,9,13,39,39,0,39
FC Lugano,4194,6,11,5,16,33,49,-16,38
FC Thun,4194,7,10,7,15,45,57,-12,37
Grasshoppers,4194,8,9,6,17,39,50,-11,33
FC Sion,4194,9,7,8,17,43,54,-11,29
Young Boys,4195,1,20,8,4,67,37,30,68
FC Basel,4195,2,18,7,7,53,26,27,61
Lucerne,4195,3,14,7,11,40,40,0,49
FC Zürich,4195,4,12,9,11,40,34,6,45
St Gallen,4195,5,14,3,15,43,57,-14,45
FC Thun,4195,6,11,5,16,48,56,-8,38
Grasshoppers,4195,7,9,8,15,40,52,-12,35
FC Lugano,4195,8,9,7,16,30,47,-17,34
FC Sion,4195,9,6,8,18,42,54,-12,26
Young Boys,4196,1,20,8,4,69,36,33,68
FC Basel,4196,2,18,9,5,52,23,29,63
Lucerne,4196,3,13,8,11,45,43,2,47
St Gallen,4196,4,14,3,15,41,53,-12,45
FC Zürich,4196,5,10,10,12,41,37,4,40
FC Thun,4196,6,11,5,16,45,59,-14,38
FC Sion,4196,7,9,7,16,43,52,-9,34
Grasshoppers,4196,8,9,7,16,44,54,-10,34
FC Lugano,4196,9,9,5,18,27,50,-23,32
Young Boys,4197,1,21,7,4,73,37,36,70
FC Basel,4197,2,19,8,5,52,22,30,65
FC Zürich,4197,3,12,10,10,46,33,13,46
Lucerne,4197,4,12,9,11,38,41,-3,45
St Gallen,4197,5,14,3,15,41,53,-12,45
FC Lugano,4197,6,9,8,15,29,48,-19,35
Grasshoppers,4197,7,9,7,16,40,48,-8,34
FC Thun,4197,8,9,5,18,40,59,-19,32
FC Sion,4197,9,7,7,18,40,58,-18,28
Young Boys,4198,1,20,8,4,66,33,33,68
FC Basel,4198,2,16,10,6,56,27,29,58
Lucerne,4198,3,14,8,10,43,41,2,50
St Gallen,4198,4,14,4,14,44,56,-12,46
FC Lugano,4198,5,11,6,15,34,47,-13,39
FC Thun,4198,6,11,5,16,47,63,-16,38
FC Zürich,4198,7,9,10,13,41,42,-1,37
Grasshoppers,4198,8,10,6,16,41,51,-10,36
FC Sion,4198,9,7,7,18,41,53,-12,28
Young Boys,4199,1,22,7,3,74,36,38,73
FC Basel,4199,2,15,11,6,49,25,24,56
Lucerne,4199,3,13,8,11,43,42,1,47
St Gallen,4199,4,14,3,15,42,54,-12,45
FC Zürich,4199,5,10,10,12,38,39,-1,40
FC Thun,4199,6,11,6,15,49,58,-9,39
FC Lugano,4199,7,11,5,16,35,49,-14,38
Grasshoppers,4199,8,9,6,17,43,57,-14,33
FC Sion,4199,9,7,8,17,44,57,-13,29
Young Boys,4200,1,22,7,3,67,31,36,73
FC Basel,4200,2,18,9,5,52,22,30,63
Lucerne,4200,3,13,8,11,41,43,-2,47
FC Zürich,4200,4,10,11,11,40,38,2,41
St Gallen,4200,5,13,2,17,39,56,-17,41
FC Lugano,4200,6,11,6,15,33,46,-13,39
Grasshoppers,4200,7,10,7,15,41,46,-5,37
FC Thun,4200,8,10,5,17,46,58,-12,35
FC Sion,4200,9,6,7,19,36,55,-19,25
Young Boys,4201,1,23,7,2,74,33,41,76
FC Basel,4201,2,18,7,7,55,27,28,61
Lucerne,4201,3,13,8,11,46,47,-1,47
St Gallen,4201,4,14,3,15,43,58,-15,45
FC Zürich,4201,5,11,9,12,42,38,4,42
Grasshoppers,4201,6,9,7,16,43,51,-8,34
FC Thun,4201,7,9,7,16,47,62,-15,34
FC Lugano,4201,8,9,6,17,30,51,-21,33
FC Sion,4201,9,7,8,17,46,59,-13,29
Young Boys,4202,1,22,6,4,75,40,35,72
FC Basel,4202,2,18,8,6,54,26,28,62
St Gallen,4202,3,15,3,14,44,53,-9,48
Lucerne,4202,4,13,7,12,44,46,-2,46
FC Zürich,4202,5,9,12,11,37,36,1,39
FC Lugano,4202,6,11,5,16,35,49,-14,38
FC Thun,4202,7,10,6,16,47,58,-11,36
Grasshoppers,4202,8,8,7,17,43,56,-13,31
FC Sion,4202,9,6,10,16,42,57,-15,28
Young Boys,4203,1,22,8,2,72,33,39,74
FC Basel,4203,2,18,9,5,57,27,30,63
St Gallen,4203,3,14,3,15,45,56,-11,45
Lucerne,4203,4,12,8,12,41,48,-7,44
FC Zürich,4203,5,11,10,11,41,35,6,43
FC Lugano,4203,6,10,6,16,30,46,-16,36
Grasshoppers,4203,7,9,6,17,38,50,-12,33
FC Thun,4203,8,9,6,17,43,58,-15,33
FC Sion,4203,9,7,8,17,40,54,-14,29
Young Boys,4204,1,22,7,3,70,33,37,73
FC Basel,4204,2,17,10,5,57,25,32,61
Lucerne,4204,3,12,10,10,43,42,1,46
FC Zürich,4204,4,12,9,11,42,34,8,45
St Gallen,4204,5,13,6,13,47,58,-11,45
Grasshoppers,4204,6,9,8,15,39,47,-8,35
FC Thun,4204,7,9,6,17,42,61,-19,33
FC Lugano,4204,8,9,6,17,31,52,-21,33
FC Sion,4204,9,6,8,18,39,58,-19,26
Young Boys,4205,1,21,7,4,71,37,34,70
FC Basel,4205,2,18,7,7,53,27,26,61
Lucerne,4205,3,12,9,11,42,43,-1,45
St Gallen,4205,4,13,4,15,43,57,-14,43
FC Zürich,4205,5,10,11,11,42,38,4,41
FC Lugano,4205,6,11,5,16,34,50,-16,38
Grasshoppers,4205,7,8,10,14,39,47,-8,34
FC Thun,4205,8,9,7,16,42,59,-17,34
FC Sion,4205,9,7,10,15,44,52,-8,31
Young Boys,4206,1,22,6,4,69,34,35,72
FC Basel,4206,2,19,8,5,59,24,35,65
St Gallen,4206,3,14,3,15,45,57,-12,45
FC Zürich,4206,4,11,10,11,39,37,2,43
Lucerne,4206,5,12,7,13,42,49,-7,43
Grasshoppers,4206,6,10,6,16,41,49,-8,36
FC Lugano,4206,7,10,6,16,34,49,-15,36
FC Thun,4206,8,9,5,18,46,63,-17,32
FC Sion,4206,9,8,7,17,39,52,-13,31
Young Boys,4207,1,21,7,4,71,39,32,70
FC Basel,4207,2,16,9,7,54,28,26,57
St Gallen,4207,3,16,2,14,44,54,-10,50
Lucerne,4207,4,12,8,12,40,43,-3,44
FC Zürich,4207,5,10,12,10,43,34,9,42
FC Lugano,4207,6,11,6,15,32,45,-13,39
Grasshoppers,4207,7,10,8,14,46,51,-5,38
FC Thun,4207,8,9,8,15,43,57,-14,35
FC Sion,4207,9,5,8,19,38,60,-22,23
Young Boys,4208,1,23,6,3,74,37,37,75
FC Basel,4208,2,18,8,6,56,29,27,62
Lucerne,4208,3,13,9,10,48,46,2,48
St Gallen,4208,4,15,3,14,46,52,-6,48
FC Zürich,4208,5,10,12,10,42,36,6,42
FC Thun,4208,6,10,6,16,46,57,-11,36
Grasshoppers,4208,7,9,6,17,42,56,-14,33
FC Lugano,4208,8,9,6,17,30,50,-20,33
FC Sion,4208,9,5,8,19,39,60,-21,23
Young Boys,4209,1,22,7,3,71,33,38,73
FC Basel,4209,2,16,9,7,52,29,23,57
St Gallen,4209,3,14,3,15,41,54,-13,45
FC Zürich,4209,4,11,9,12,44,38,6,42
Lucerne,4209,5,11,9,12,37,43,-6,42
FC Lugano,4209,6,12,5,15,35,46,-11,41
Grasshoppers,4209,7,10,8,14,42,46,-4,38
FC Thun,4209,8,9,5,18,40,59,-19,32
FC Sion,4209,9,8,7,17,42,56,-14,31
Young Boys,4210,1,22,7,3,73,34,39,73
FC Basel,4210,2,17,9,6,53,26,27,60
St Gallen,4210,3,16,3,13,46,52,-6,51
FC Zürich,4210,4,12,10,10,42,35,7,46
Lucerne,4210,5,12,9,11,44,46,-2,45
FC Thun,4210,6,10,5,17,47,58,-11,35
FC Lugano,4210,7,9,7,16,28,49,-21,34
Grasshoppers,4210,8,8,7,17,39,52,-13,31
FC Sion,4210,9,6,7,19,38,58,-20,25
Young Boys,4211,1,22,7,3,79,39,40,73
FC Basel,4211,2,17,10,5,58,30,28,61
St Gallen,4211,3,15,3,14,43,52,-9,48
Lucerne,4211,4,12,9,11,46,45,1,45
FC Zürich,4211,5,9,12,11,41,38,3,39
FC Lugano,4211,6,10,6,16,33,52,-19,36
Grasshoppers,4211,7,9,6,17,40,55,-15,33
FC Thun,4211,8,9,6,17,45,62,-17,33
FC Sion,4211,9,8,7,17,39,51,-12,31
Young Boys,4212,1,20,8,4,69,37,32,68
FC Basel,4212,2,17,9,6,50,23,27,60
Lucerne,4212,3,13,9,10,43,42,1,48
St Gallen,4212,4,13,3,16,43,57,-14,42
FC Lugano,4212,5,11,7,14,33,46,-13,40
FC Zürich,4212,6,9,11,12,41,39,2,38
Grasshoppers,4212,7,10,8,14,43,49,-6,38
FC Thun,4212,8,9,7,16,44,60,-16,34
FC Sion,4212,9,6,10,16,43,56,-13,28
Young Boys,4213,1,21,8,3,71,36,35,71
FC Basel,4213,2,17,9,6,56,28,28,60
Lucerne,4213,3,12,9,11,40,42,-2,45
St Gallen,4213,4,14,3,15,46,60,-14,45
FC Zürich,4213,5,10,11,11,41,38,3,41
FC Lugano,4213,6,11,7,14,34,45,-11,40
Grasshoppers,4213,7,9,7,16,44,51,-7,34
FC Thun,4213,8,9,7,16,45,61,-16,34
FC Sion,4213,9,7,7,18,44,60,-16,28
Young Boys,4214,1,23,7,2,77,33,44,76
FC Basel,4214,2,17,9,6,54,25,29,60
Lucerne,4214,3,13,7,12,41,46,-5,46
St Gallen,4214,4,14,3,15,40,52,-12,45
FC Zürich,4214,5,11,10,11,40,34,6,43
Grasshoppers,4214,6,10,7,15,41,50,-9,37
FC Thun,4214,7,10,6,16,42,59,-17,36
FC Lugano,4214,8,9,5,18,30,49,-19,32
FC Sion,4214,9,6,8,18,39,56,-17,26
Young Boys,4215,1,21,7,4,68,32,36,70
FC Basel,4215,2,18,8,6,52,26,26,62
Lucerne,4215,3,14,7,11,44,42,2,49
St Gallen,4215,4,15,3,14,45,55,-10,48
FC Zürich,4215,5,11,10,11,41,35,6,43
Grasshoppers,4215,6,10,6,16,40,48,-8,36
FC Lugano,4215,7,10,6,16,31,48,-17,36
FC Thun,4215,8,9,5,18,39,58,-19,32
FC Sion,4215,9,6,8,18,38,54,-16,26
Young Boys,4216,1,22,7,3,78,39,39,73
FC Basel,4216,2,18,7,7,54,24,30,61
St Gallen,4216,3,16,2,14,46,53,-7,50
FC Zürich,4216,4,11,10,11,42,35,7,43
Lucerne,4216,5,11,10,11,44,49,-5,43
FC Sion,4216,6,9,7,16,45,57,-12,34
FC Lugano,4216,7,9,7,16,28,50,-22,34
FC Thun,4216,8,9,5,18,42,61,-19,32
Grasshoppers,4216,9,8,7,17,44,55,-11,31
Young Boys,4217,1,23,7,2,72,32,40,76
FC Basel,4217,2,17,10,5,57,25,32,61
Lucerne,4217,3,13,7,12,38,43,-5,46
St Gallen,4217,4,14,3,15,42,58,-16,45
FC Zürich,4217,5,11,11,10,41,34,7,44
Grasshoppers,4217,6,11,6,15,44,49,-5,39
FC Lugano,4217,7,9,6,17,29,47,-18,33
FC Thun,4217,8,9,5,18,40,62,-22,32
FC Sion,4217,9,6,7,19,43,56,-13,25
Young Boys,4218,1,22,7,3,71,34,37,73
FC Basel,4218,2,19,7,6,54,26,28,64
Lucerne,4218,3,13,8,11,44,43,1,47
FC Zürich,4218,4,12,9,11,47,40,7,45
St Gallen,4218,5,13,2,17,38,57,-19,41
FC Thun,4218,6,11,5,16,49,59,-10,38
FC Lugano,4218,7,10,6,16,34,48,-14,36
Grasshoppers,4218,8,8,6,18,38,57,-19,30
FC Sion,4218,9,7,8,17,43,54,-11,29
Young Boys,4219,1,24,6,2,79,34,45,78
FC Basel,4219,2,17,9,6,52,26,26,60
St Gallen,4219,3,14,3,15,42,55,-13,45
Lucerne,4219,4,12,8,12,40,43,-3,44
FC Zürich,4219,5,11,10,11,43,35,8,43
Grasshoppers,4219,6,10,7,15,40,49,-9,37
FC Lugano,4219,7,10,5,17,31,50,-19,35
FC Thun,4219,8,8,6,18,40,62,-22,30
FC Sion,4219,9,7,8,17,41,54,-13,29
Young Boys,4220,1,20,7,5,66,34,32,67
FC Basel,4220,2,17,9,6,50,24,26,60
FC Zürich,4220,3,11,11,10,39,33,6,44
Lucerne,4220,4,11,11,10,41,43,-2,44
St Gallen,4220,5,13,5,14,41,53,-12,44
FC Lugano,4220,6,10,7,15,30,45,-15,37
FC Thun,4220,7,10,5,17,45,57,-12,35
Grasshoppers,4220,8,9,7,16,39,51,-12,34
FC Sion,4220,9,8,8,16,40,51,-11,32
Young Boys,4221,1,22,7,3,72,35,37,73
FC Basel,4221,2,18,9,5,56,25,31,63
Lucerne,4221,3,14,7,11,44,44,0,49
St Gallen,4221,4,14,3,15,44,57,-13,45
FC Zürich,4221,5,10,9,13,41,38,3,39
FC Thun,4221,6,11,5,16,48,56,-8,38
FC Lugano,4221,7,10,5,17,34,52,-18,35
Grasshoppers,4221,8,8,7,17,38,54,-16,31
FC Sion,4221,9,7,8,17,40,56,-16,29
Young Boys,4222,1,22,6,4,71,35,36,72
FC Basel,4222,2,19,8,5,60,24,36,65
St Gallen,4222,3,14,2,16,40,55,-15,44
FC Zürich,4222,4,11,10,11,43,38,5,43
Lucerne,4222,5,11,8,13,39,52,-13,41
Grasshoppers,4222,6,10,7,15,45,48,-3,37
FC Lugano,4222,7,10,6,16,31,48,-17,36
FC Sion,4222,8,9,7,16,47,53,-6,34
FC Thun,4222,9,8,6,18,43,66,-23,30
Young Boys,4223,1,22,7,3,71,34,37,73
FC Basel,4223,2,19,7,6,58,27,31,64
St Gallen,4223,3,15,2,15,44,57,-13,47
FC Zürich,4223,4,12,9,11,46,35,11,45
Lucerne,4223,5,12,7,13,41,44,-3,43
Grasshoppers,4223,6,10,7,15,40,47,-7,37
FC Thun,4223,7,9,6,17,41,60,-19,33
FC Lugano,4223,8,9,5,18,28,54,-26,32
FC Sion,4223,9,7,8,17,43,54,-11,29
Young Boys,4224,1,21,6,5,69,36,33,69
FC Basel,4224,2,18,7,7,54,26,28,61
Lucerne,4224,3,14,7,11,45,43,2,49
St Gallen,4224,4,15,2,15,41,53,-12,47
FC Zürich,4224,5,11,9,12,41,35,6,42
FC Lugano,4224,6,11,5,16,30,49,-19,38
Grasshoppers,4224,7,10,6,16,44,51,-7,36
FC Thun,4224,8,9,5,18,44,61,-17,32
FC Sion,4224,9,8,7,17,39,53,-14,31
Young Boys,4225,1,22,6,4,71,35,36,72
FC Basel,4225,2,17,7,8,54,28,26,58
Lucerne,4225,3,14,7,11,46,42,4,49
St Gallen,4225,4,14,4,14,42,56,-14,46
FC Zürich,4225,5,12,9,11,43,38,5,45
FC Lugano,4225,6,11,6,15,33,46,-13,39
Grasshoppers,4225,7,9,7,16,47,55,-8,34
FC Thun,4225,8,8,7,17,46,67,-21,31
FC Sion,4225,9,6,9,17,43,58,-15,27
Young Boys,4226,1,21,7,4,71,35,36,70
FC Basel,4226,2,18,8,6,55,27,28,62
St Gallen,4226,3,16,3,13,44,51,-7,51
Lucerne,4226,4,14,7,11,42,43,-1,49
FC Zürich,4226,5,11,9,12,44,37,7,42
FC Thun,4226,6,10,7,15,46,59,-13,37
Grasshoppers,4226,7,9,6,17,40,50,-10,33
FC Lugano,4226,8,9,5,18,27,50,-23,32
FC Sion,4226,9,5,10,17,42,59,-17,25
Young Boys,4227,1,21,7,4,72,38,34,70
FC Basel,4227,2,18,9,5,58,27,31,63
St Gallen,4227,3,15,3,14,47,56,-9,48
Lucerne,4227,4,13,8,11,43,45,-2,47
FC Zürich,4227,5,10,10,12,42,40,2,40
Grasshoppers,4227,6,10,6,16,42,51,-9,36
FC Thun,4227,7,10,5,17,47,60,-13,35
FC Lugano,4227,8,9,6,17,35,57,-22,33
FC Sion,4227,9,7,8,17,40,52,-12,29
Young Boys,4228,1,22,6,4,71,35,36,72
FC Basel,4228,2,17,10,5,53,26,27,61
Lucerne,4228,3,14,7,11,42,42,0,49
St Gallen,4228,4,14,3,15,42,57,-15,45
FC Zürich,4228,5,10,11,11,40,36,4,41
FC Thun,4228,6,10,7,15,46,59,-13,37
FC Lugano,4228,7,10,5,17,31,48,-17,35
Grasshoppers,4228,8,8,7,17,39,50,-11,31
FC Sion,4228,9,7,8,17,43,54,-11,29
Young Boys,4229,1,20,8,4,70,36,34,68
FC Basel,4229,2,17,8,7,53,28,25,59
Lucerne,4229,3,16,7,9,53,42,11,55
St Gallen,4229,4,13,4,15,41,60,-19,43
FC Thun,4229,5,12,5,15,45,55,-10,41
FC Zürich,4229,6,10,10,12,38,36,2,40
FC Lugano,4229,7,10,7,15,31,44,-13,37
Grasshoppers,4229,8,8,7,17,39,54,-15,31
FC Sion,4229,9,5,10,17,38,53,-15,25
Young Boys,4230,1,24,6,2,76,30,46,78
FC Basel,4230,2,18,7,7,52,28,24,61
St Gallen,4230,3,16,2,14,45,54,-9,50
Lucerne,4230,4,12,7,13,39,43,-4,43
FC Zürich,4230,5,11,9,12,41,37,4,42
FC Lugano,4230,6,12,5,15,33,47,-14,41
Grasshoppers,4230,7,9,6,17,38,48,-10,33
FC Thun,4230,8,9,6,17,43,58,-15,33
FC Sion,4230,9,5,8,19,39,61,-22,23
Young Boys,4231,1,22,6,4,71,35,36,72
FC Basel,4231,2,19,8,5,56,25,31,65
St Gallen,4231,3,14,3,15,43,58,-15,45
FC Zürich,4231,4,11,10,11,44,37,7,43
Lucerne,4231,5,11,8,13,37,44,-7,41
FC Lugano,4231,6,11,5,16,35,50,-15,38
Grasshoppers,4231,7,10,6,16,41,47,-6,36
FC Thun,4231,8,9,5,18,41,59,-18,32
FC Sion,4231,9,8,7,17,40,53,-13,31
Young Boys,4232,1,21,7,4,69,34,35,70
FC Basel,4232,2,18,9,5,53,24,29,63
Lucerne,4232,3,14,8,10,43,43,0,50
St Gallen,4232,4,14,3,15,43,56,-13,45
FC Zürich,4232,5,9,12,11,40,37,3,39
FC Lugano,4232,6,11,5,16,34,48,-14,38
FC Thun,4232,7,10,6,16,42,56,-14,36
Grasshoppers,4232,8,9,7,16,42,50,-8,34
FC Sion,4232,9,5,9,18,39,57,-18,24
Young Boys,4233,1,22,8,2,73,34,39,74
FC Basel,4233,2,17,8,7,54,28,26,59
St Gallen,4233,3,17,2,13,49,55,-6,53
Lucerne,4233,4,13,7,12,45,48,-3,46
FC Zürich,4233,5,12,9,11,41,35,6,45
Grasshoppers,4233,6,9,7,16,42,52,-10,34
FC Thun,4233,7,9,5,18,42,59,-17,32
FC Lugano,4233,8,9,5,18,30,50,-20,32
FC Sion,4233,9,7,7,18,38,53,-15,28
Young Boys,4234,1,21,7,4,72,37,35,70
FC Basel,4234,2,19,8,5,52,23,29,65
St Gallen,4234,3,15,3,14,43,52,-9,48
Lucerne,4234,4,12,9,11,47,47,0,45
FC Zürich,4234,5,11,9,12,39,36,3,42
FC Thun,4234,6,10,7,15,46,57,-11,37
FC Lugano,4234,7,9,6,17,33,51,-18,33
Grasshoppers,4234,8,8,8,16,40,53,-13,32
FC Sion,4234,9,7,7,18,39,55,-16,28
Young Boys,4235,1,21,7,4,71,33,38,70
FC Basel,4235,2,18,7,7,54,27,27,61
St Gallen,4235,3,15,3,14,45,52,-7,48
Lucerne,4235,4,12,8,12,42,46,-4,44
FC Zürich,4235,5,11,10,11,45,39,6,43
FC Lugano,4235,6,10,6,16,33,54,-21,36
FC Thun,4235,7,10,5,17,44,62,-18,35
Grasshoppers,4235,8,9,6,17,40,50,-10,33
FC Sion,4235,9,8,8,16,41,52,-11,32
Young Boys,4236,1,21,6,5,69,36,33,69
FC Basel,4236,2,17,9,6,52,27,25,60
St Gallen,4236,3,15,4,13,48,55,-7,49
Lucerne,4236,4,11,9,12,39,44,-5,42
FC Lugano,4236,5,12,6,14,35,46,-11,42
FC Zürich,4236,6,10,9,13,42,39,3,39
Grasshoppers,4236,7,11,6,15,43,49,-6,39
FC Thun,4236,8,10,6,16,45,59,-14,36
FC Sion,4236,9,6,7,19,42,60,-18,25
Young Boys,4237,1,22,8,2,69,32,37,74
FC Basel,4237,2,15,9,8,49,28,21,54
Lucerne,4237,3,13,8,11,44,42,2,47
St Gallen,4237,4,15,2,15,45,56,-11,47
FC Zürich,4237,5,11,10,11,39,33,6,43
FC Thun,4237,6,11,6,15,42,53,-11,39
FC Lugano,4237,7,10,5,17,30,50,-20,35
Grasshoppers,4237,8,9,7,16,42,49,-7,34
FC Sion,4237,9,6,9,17,38,55,-17,27
Young Boys,4238,1,23,6,3,80,32,48,75
FC Basel,4238,2,18,8,6,55,29,26,62
Lucerne,4238,3,12,10,10,44,52,-8,46
FC Zürich,4238,4,11,9,12,45,39,6,42
St Gallen,4238,5,13,3,16,40,54,-14,42
FC Thun,4238,6,11,5,16,50,57,-7,38
Grasshoppers,4238,7,9,8,15,41,49,-8,35
FC Lugano,4238,8,10,5,17,29,50,-21,35
FC Sion,4238,9,6,8,18,38,60,-22,26
Young Boys,4239,1,22,6,4,73,36,37,72
FC Basel,4239,2,18,9,5,56,24,32,63
St Gallen,4239,3,14,5,13,44,53,-9,47
Lucerne,4239,4,13,7,12,39,44,-5,46
FC Zürich,4239,5,11,11,10,44,37,7,44
Grasshoppers,4239,6,10,6,16,44,51,-7,36
FC Lugano,4239,7,9,6,17,30,52,-22,33
FC Thun,4239,8,9,5,18,49,67,-18,32
FC Sion,4239,9,6,9,17,41,56,-15,27
Young Boys,4240,1,23,7,2,71,32,39,76
FC Basel,4240,2,16,9,7,51,25,26,57
Lucerne,4240,3,13,10,9,41,39,2,49
St Gallen,4240,4,13,5,14,41,53,-12,44
FC Zürich,4240,5,11,10,11,44,36,8,43
Grasshoppers,4240,6,10,6,16,42,50,-8,36
FC Lugano,4240,7,9,7,16,29,49,-20,34
FC Thun,4240,8,8,6,18,40,61,-21,30
FC Sion,4240,9,7,8,17,41,55,-14,29
Young Boys,4241,1,21,7,4,71,36,35,70
FC Basel,4241,2,18,8,6,58,26,32,62
Lucerne,4241,3,13,9,10,40,43,-3,48
St Gallen,4241,4,15,3,14,42,51,-9,48
FC Zürich,4241,5,10,9,13,42,41,1,39
FC Lugano,4241,6,11,5,16,34,49,-15,38
FC Thun,4241,7,10,6,16,45,61,-16,36
Grasshoppers,4241,8,9,8,15,43,49,-6,35
FC Sion,4241,9,6,7,19,38,57,-19,25
Young Boys,4242,1,21,7,4,70,35,35,70
FC Basel,4242,2,18,9,5,58,26,32,63
Lucerne,4242,3,12,9,11,42,46,-4,45
FC Zürich,4242,4,10,12,10,41,35,6,42
St Gallen,4242,5,13,3,16,41,59,-18,42
FC Lugano,4242,6,11,5,16,35,50,-15,38
FC Thun,4242,7,10,6,16,45,59,-14,36
Grasshoppers,4242,8,9,7,16,40,52,-12,34
FC Sion,4242,9,7,8,17,43,53,-10,29
Young Boys,4243,1,21,7,4,68,36,32,70
FC Basel,4243,2,19,8,5,56,24,32,65
Lucerne,4243,3,14,7,11,43,45,-2,49
St Gallen,4243,4,15,3,14,47,56,-9,48
FC Zürich,4243,5,11,9,12,41,36,5,42
Grasshoppers,4243,6,10,6,16,42,50,-8,36
FC Lugano,4243,7,10,5,17,33,51,-18,35
FC Thun,4243,8,9,6,17,42,58,-16,33
FC Sion,4243,9,5,9,18,38,54,-16,24
Young Boys,4244,1,22,6,4,77,35,42,72
FC Basel,4244,2,19,8,5,58,25,33,65
Lucerne,4244,3,14,8,10,46,46,0,50
St Gallen,4244,4,13,2,17,40,58,-18,41
FC Zürich,4244,5,10,10,12,40,38,2,40
FC Lugano,4244,6,11,5,16,32,49,-17,38
Grasshoppers,4244,7,9,7,16,41,53,-12,34
FC Thun,4244,8,9,5,18,43,61,-18,32
FC Sion,4244,9,7,9,16,41,53,-12,30
Young Boys,4245,1,21,8,3,74,37,37,71
FC Basel,4245,2,18,9,5,53,22,31,63
St Gallen,4245,3,14,2,16,42,57,-15,44
FC Zürich,4245,4,11,10,11,40,35,5,43
Lucerne,4245,5,12,7,13,41,50,-9,43
Grasshoppers,4245,6,10,7,15,45,52,-7,37
FC Thun,4245,7,10,5,17,45,59,-14,35
FC Lugano,4245,8,10,5,17,33,52,-19,35
FC Sion,4245,9,8,7,17,45,54,-9,31
Young Boys,4246,1,21,8,3,72,34,38,71
FC Basel,4246,2,18,8,6,57,28,29,62
Lucerne,4246,3,14,8,10,41,42,-1,50
St Gallen,4246,4,14,3,15,45,55,-10,45
FC Zürich,4246,5,11,9,12,42,37,5,42
Grasshoppers,4246,6,10,6,16,39,47,-8,36
FC Lugano,4246,7,10,6,16,30,49,-19,36
FC Thun,4246,8,8,6,18,41,63,-22,30
FC Sion,4246,9,7,8,17,42,54,-12,29
Young Boys,4247,1,21,7,4,73,38,35,70
FC Basel,4247,2,17,7,8,54,29,25,58
Lucerne,4247,3,13,8,11,48,45,3,47
St Gallen,4247,4,15,2,15,44,57,-13,47
FC Zürich,4247,5,11,9,12,42,40,2,42
FC Lugano,4247,6,11,6,15,36,51,-15,39
FC Thun,4247,7,10,5,17,44,58,-14,35
FC Sion,4247,8,9,7,16,43,53,-10,34
Grasshoppers,4247,9,8,7,17,40,53,-13,31
Young Boys,4248,1,22,7,3,69,33,36,73
FC Basel,4248,2,17,8,7,53,28,25,59
St Gallen,4248,3,15,4,13,43,51,-8,49
Lucerne,4248,4,13,8,11,47,40,7,47
FC Zürich,4248,5,10,10,12,40,38,2,40
FC Lugano,4248,6,11,6,15,31,48,-17,39
FC Thun,4248,7,9,6,17,42,58,-16,33
Grasshoppers,4248,8,8,8,16,38,52,-14,32
FC Sion,4248,9,6,9,17,36,51,-15,27
Young Boys,4249,1,20,6,6,72,38,34,66
FC Basel,4249,2,18,7,7,56,28,28,61
Lucerne,4249,3,15,7,10,45,43,2,52
FC Zürich,4249,4,12,9,11,45,36,9,45
St Gallen,4249,5,14,2,16,43,60,-17,44
Grasshoppers,4249,6,11,6,15,45,51,-6,39
FC Lugano,4249,7,11,5,16,30,45,-15,38
FC Thun,4249,8,10,5,17,44,58,-14,35
FC Sion,4249,9,6,7,19,40,61,-21,25
Young Boys,4250,1,23,6,3,77,35,42,75
FC Basel,4250,2,18,9,5,56,25,31,63
Lucerne,4250,3,13,8,11,41,48,-7,47
St Gallen,4250,4,13,3,16,41,56,-15,42
FC Zürich,4250,5,9,11,12,39,38,1,38
FC Lugano,4250,6,11,5,16,31,46,-15,38
Grasshoppers,4250,7,10,7,15,42,50,-8,37
FC Thun,4250,8,10,5,17,43,58,-15,35
FC Sion,4250,9,6,8,18,41,55,-14,26
Young Boys,4251,1,23,6,3,74,33,41,75
FC Basel,4251,2,18,8,6,57,27,30,62
St Gallen,4251,3,14,3,15,44,56,-12,45
Lucerne,4251,4,12,7,13,39,47,-8,43
FC Zürich,4251,5,10,12,10,41,36,5,42
Grasshoppers,4251,6,11,7,14,43,47,-4,40
FC Lugano,4251,7,10,7,15,30,44,-14,37
FC Thun,4251,8,9,5,18,43,62,-19,32
FC Sion,4251,9,5,9,18,41,60,-19,24
Young Boys,4252,1,22,7,3,75,37,38,73
FC Basel,4252,2,17,9,6,51,26,25,60
St Gallen,4252,3,15,2,15,46,56,-10,47
Lucerne,4252,4,12,8,12,41,46,-5,44
FC Zürich,4252,5,11,9,12,42,36,6,42
FC Lugano,4252,6,11,5,16,35,50,-15,38
FC Thun,4252,7,10,6,16,44,57,-13,36
Grasshoppers,4252,8,9,7,16,39,48,-9,34
FC Sion,4252,9,7,7,18,39,56,-17,28
Young Boys,4253,1,23,7,2,71,31,40,76
FC Basel,4253,2,16,10,6,51,26,25,58
St Gallen,4253,3,15,3,14,42,51,-9,48
Lucerne,4253,4,12,9,11,42,42,0,45
FC Zürich,4253,5,10,10,12,38,41,-3,40
FC Thun,4253,6,10,6,16,46,56,-10,36
FC Lugano,4253,7,10,5,17,30,47,-17,35
FC Sion,4253,8,8,8,16,39,49,-10,32
Grasshoppers,4253,9,8,6,18,36,52,-16,30
Young Boys,4254,1,20,8,4,71,37,34,68
FC Basel,4254,2,18,7,7,55,27,28,61
St Gallen,4254,3,16,2,14,45,51,-6,50
Lucerne,4254,4,12,9,11,40,44,-4,45
FC Zürich,4254,5,11,11,10,41,34,7,44
FC Thun,4254,6,10,6,16,43,56,-13,36
Grasshoppers,4254,7,9,7,16,39,49,-10,34
FC Lugano,4254,8,9,6,17,29,52,-23,33
FC Sion,4254,9,7,8,17,40,53,-13,29
Young Boys,4255,1,23,7,2,81,36,45,76
FC Basel,4255,2,17,9,6,54,26,28,60
FC Zürich,4255,3,13,9,10,49,36,13,48
Lucerne,4255,4,12,8,12,45,53,-8,44
St Gallen,4255,5,13,3,16,40,54,-14,42
FC Lugano,4255,6,11,5,16,32,51,-19,38
Grasshoppers,4255,7,9,8,15,42,53,-11,35
FC Thun,4255,8,9,5,18,43,59,-16,32
FC Sion,4255,9,6,8,18,40,58,-18,26
Young Boys,4256,1,22,7,3,72,34,38,73
FC Basel,4256,2,18,9,5,54,24,30,63
Lucerne,4256,3,13,8,11,43,44,-1,47
St Gallen,4256,4,14,3,15,44,58,-14,45
FC Lugano,4256,5,11,6,15,34,48,-14,39
FC Zürich,4256,6,9,9,14,38,40,-2,36
FC Thun,4256,7,10,5,17,43,57,-14,35
Grasshoppers,4256,8,9,6,17,42,53,-11,33
FC Sion,4256,9,8,7,17,43,55,-12,31
Young Boys,4257,1,22,6,4,72,36,36,72
FC Basel,4257,2,20,7,5,61,23,38,67
Lucerne,4257,3,13,7,12,42,45,-3,46
FC Zürich,4257,4,11,10,11,42,39,3,43
FC Lugano,4257,5,12,5,15,37,48,-11,41
St Gallen,4257,6,13,2,17,43,60,-17,41
Grasshoppers,4257,7,10,6,16,45,52,-7,36
FC Thun,4257,8,8,6,18,41,61,-20,30
FC Sion,4257,9,7,7,18,41,60,-19,28
Young Boys,4258,1,21,8,3,69,34,35,71
FC Basel,4258,2,19,8,5,57,23,34,65
Lucerne,4258,3,13,7,12,46,49,-3,46
FC Zürich,4258,4,11,10,11,40,34,6,43
St Gallen,4258,5,13,3,16,40,56,-16,42
Grasshoppers,4258,6,10,7,15,43,51,-8,37
FC Lugano,4258,7,10,7,15,30,47,-17,37
FC Thun,4258,8,8,6,18,39,61,-22,30
FC Sion,4258,9,7,8,17,44,53,-9,29
Young Boys,4259,1,21,9,2,71,31,40,72
FC Basel,4259,2,16,9,7,50,27,23,57
St Gallen,4259,3,15,2,15,44,56,-12,47
Lucerne,4259,4,11,10,11,40,44,-4,43
FC Zürich,4259,5,11,9,12,41,36,5,42
FC Lugano,4259,6,11,6,15,32,49,-17,39
FC Thun,4259,7,10,5,17,44,58,-14,35
Grasshoppers,4259,8,9,6,17,37,49,-12,33
FC Sion,4259,9,8,8,16,41,50,-9,32
Young Boys,4260,1,24,6,2,72,30,42,78
FC Basel,4260,2,17,7,8,51,27,24,58
St Gallen,4260,3,17,2,13,45,51,-6,53
Lucerne,4260,4,12,8,12,39,43,-4,44
FC Zürich,4260,5,10,11,11,40,38,2,41
Grasshoppers,4260,6,10,7,15,46,49,-3,37
FC Lugano,4260,7,10,5,17,30,47,-17,35
FC Thun,4260,8,8,6,18,42,62,-20,30
FC Sion,4260,9,6,8,18,39,57,-18,26
Young Boys,4261,1,22,7,3,68,31,37,73
FC Basel,4261,2,17,8,7,53,28,25,59
Lucerne,4261,3,14,7,11,45,46,-1,49
St Gallen,4261,4,14,4,14,44,54,-10,46
FC Zürich,4261,5,10,10,12,42,39,3,40
FC Thun,4261,6,11,5,16,47,61,-14,38
FC Lugano,4261,7,10,7,15,37,51,-14,37
Grasshoppers,4261,8,9,6,17,39,50,-11,33
FC Sion,4261,9,6,8,18,40,55,-15,26
Young Boys,4262,1,22,7,3,73,37,36,73
FC Basel,4262,2,19,7,6,56,25,31,64
St Gallen,4262,3,16,2,14,46,55,-9,50
Lucerne,4262,4,14,7,11,44,45,-1,49
FC Zürich,4262,5,11,9,12,44,38,6,42
FC Lugano,4262,6,10,5,17,30,48,-18,35
FC Thun,4262,7,9,5,18,46,62,-16,32
Grasshoppers,4262,8,8,7,17,41,56,-15,31
FC Sion,4262,9,7,7,18,45,59,-14,28
Young Boys,4263,1,23,6,3,79,37,42,75
FC Basel,4263,2,18,8,6,56,26,30,62
St Gallen,4263,3,15,4,13,46,52,-6,49
Lucerne,4263,4,12,7,13,40,45,-5,43
FC Zürich,4263,5,10,9,13,41,38,3,39
Grasshoppers,4263,6,10,6,16,41,50,-9,36
FC Thun,4263,7,10,5,17,42,59,-17,35
FC Lugano,4263,8,10,5,17,31,56,-25,35
FC Sion,4263,9,7,8,17,40,53,-13,29
Young Boys,4264,1,22,7,3,76,39,37,73
FC Basel,4264,2,18,8,6,54,26,28,62
Lucerne,4264,3,13,8,11,39,41,-2,47
St Gallen,4264,4,14,2,16,41,53,-12,44
FC Zürich,4264,5,10,12,10,40,35,5,42
FC Lugano,4264,6,10,6,16,29,47,-18,36
FC Thun,4264,7,9,8,15,42,56,-14,35
Grasshoppers,4264,8,9,7,16,44,51,-7,34
FC Sion,4264,9,6,8,18,39,56,-17,26
Young Boys,4265,1,22,8,2,72,32,40,74
FC Basel,4265,2,17,8,7,53,27,26,59
FC Zürich,4265,3,11,11,10,44,36,8,44
Lucerne,4265,4,12,8,12,40,46,-6,44
St Gallen,4265,5,14,2,16,43,60,-17,44
FC Lugano,4265,6,11,6,15,31,46,-15,39
Grasshoppers,4265,7,10,7,15,41,48,-7,37
FC Thun,4265,8,9,6,17,41,57,-16,33
FC Sion,4265,9,6,8,18,44,57,-13,26
Young Boys,4266,1,20,7,5,67,36,31,67
FC Basel,4266,2,19,8,5,58,25,33,65
St Gallen,4266,3,16,2,14,45,52,-7,50
Lucerne,4266,4,12,7,13,41,46,-5,43
FC Zürich,4266,5,10,11,11,41,39,2,41
FC Lugano,4266,6,11,6,15,32,46,-14,39
Grasshoppers,4266,7,10,8,14,44,48,-4,38
FC Thun,4266,8,9,7,16,42,58,-16,34
FC Sion,4266,9,5,8,19,36,56,-20,23
Young Boys,4267,1,20,8,4,67,34,33,68
FC Basel,4267,2,17,10,5,51,24,27,61
St Gallen,4267,3,16,2,14,45,52,-7,50
FC Zürich,4267,4,12,10,10,41,34,7,46
Lucerne,4267,5,12,9,11,43,44,-1,45
Grasshoppers,4267,6,10,6,16,42,50,-8,36
FC Thun,4267,7,10,6,16,45,57,-12,36
FC Lugano,4267,8,10,6,16,30,46,-16,36
FC Sion,4267,9,5,7,20,37,60,-23,22
Young Boys,4268,1,21,7,4,73,38,35,70
FC Basel,4268,2,17,8,7,55,31,24,59
Lucerne,4268,3,13,9,10,45,44,1,48
St Gallen,4268,4,15,2,15,45,57,-12,47
FC Zürich,4268,5,11,9,12,42,39,3,42
Grasshoppers,4268,6,11,6,15,45,49,-4,39
FC Lugano,4268,7,10,6,16,31,48,-17,36
FC Thun,4268,8,9,5,18,44,60,-16,32
FC Sion,4268,9,7,8,17,44,58,-14,29
Young Boys,4269,1,22,6,4,72,35,37,72
FC Basel,4269,2,19,7,6,56,26,30,64
FC Zürich,4269,3,13,9,10,41,32,9,48
St Gallen,4269,4,15,2,15,47,59,-12,47
Lucerne,4269,5,12,8,12,39,46,-7,44
FC Lugano,4269,6,10,5,17,32,48,-16,35
Grasshoppers,4269,7,9,7,16,39,48,-9,34
FC Thun,4269,8,9,6,17,41,58,-17,33
FC Sion,4269,9,6,8,18,39,54,-15,26
Young Boys,4270,1,21,7,4,69,34,35,70
FC Basel,4270,2,18,8,6,56,25,31,62
Lucerne,4270,3,12,10,10,41,42,-1,46
St Gallen,4270,4,14,3,15,42,58,-16,45
FC Zürich,4270,5,11,9,12,39,36,3,42
Grasshoppers,4270,6,12,6,14,44,47,-3,42
FC Thun,4270,7,10,5,17,44,56,-12,35
FC Lugano,4270,8,9,5,18,28,50,-22,32
FC Sion,4270,9,7,7,18,39,54,-15,28
Young Boys,4271,1,20,7,5,67,36,31,67
FC Basel,4271,2,18,8,6,55,26,29,62
St Gallen,4271,3,16,2,14,44,54,-10,50
Lucerne,4271,4,14,7,11,43,42,1,49
FC Zürich,4271,5,11,11,10,42,35,7,44
Grasshoppers,4271,6,11,6,15,43,47,-4,39
FC Lugano,4271,7,9,6,17,30,49,-19,33
FC Sion,4271,8,7,8,17,43,54,-11,29
FC Thun,4271,9,8,5,19,40,64,-24,29
Young Boys,4272,1,22,7,3,75,35,40,73
FC Basel,4272,2,18,8,6,56,28,28,62
St Gallen,4272,3,14,4,14,45,56,-11,46
Lucerne,4272,4,11,9,12,39,46,-7,42
FC Thun,4272,5,11,6,15,49,56,-7,39
FC Zürich,4272,6,9,10,13,38,40,-2,37
FC Lugano,4272,7,10,7,15,32,50,-18,37
Grasshoppers,4272,8,9,8,15,41,50,-9,35
FC Sion,4272,9,6,9,17,39,53,-14,27
Young Boys,4273,1,22,6,4,73,34,39,72
FC Basel,4273,2,18,9,5,54,23,31,63
St Gallen,4273,3,14,4,14,44,56,-12,46
Lucerne,4273,4,12,8,12,41,45,-4,44
FC Lugano,4273,5,12,5,15,36,48,-12,41
FC Zürich,4273,6,10,9,13,39,39,0,39
Grasshoppers,4273,7,10,7,15,41,48,-7,37
FC Thun,4273,8,10,6,16,44,58,-14,36
FC Sion,4273,9,5,8,19,36,57,-21,23
Young Boys,4274,1,22,6,4,71,33,38,72
FC Basel,4274,2,16,7,9,51,32,19,55
Lucerne,4274,3,15,7,10,46,42,4,52
St Gallen,4274,4,15,3,14,46,55,-9,48
FC Zürich,4274,5,12,9,11,46,35,11,45
Grasshoppers,4274,6,10,7,15,40,49,-9,37
FC Lugano,4274,7,9,6,17,29,49,-20,33
FC Thun,4274,8,9,5,18,42,61,-19,32
FC Sion,4274,9,7,8,17,37,52,-15,29
Young Boys,4275,1,20,8,4,69,35,34,68
FC Basel,4275,2,19,8,5,53,21,32,65
St Gallen,4275,3,15,2,15,43,53,-10,47
FC Zürich,4275,4,12,9,11,45,38,7,45
Lucerne,4275,5,12,9,11,41,45,-4,45
Grasshoppers,4275,6,12,6,14,48,49,-1,42
FC Lugano,4275,7,10,6,16,32,47,-15,36
FC Thun,4275,8,9,5,18,44,64,-20,32
FC Sion,4275,9,5,7,20,37,60,-23,22
Young Boys,4276,1,21,8,3,70,34,36,71
FC Basel,4276,2,18,8,6,54,25,29,62
FC Zürich,4276,3,12,10,10,42,34,8,46
St Gallen,4276,4,14,4,14,47,58,-11,46
Lucerne,4276,5,12,9,11,46,45,1,45
FC Thun,4276,6,10,5,17,46,60,-14,35
FC Lugano,4276,7,9,8,15,29,48,-19,35
Grasshoppers,4276,8,8,7,17,40,54,-14,31
FC Sion,4276,9,7,7,18,40,56,-16,28
Young Boys,4277,1,22,7,3,72,33,39,73
FC Basel,4277,2,19,8,5,55,24,31,65
St Gallen,4277,3,15,3,14,43,52,-9,48
Lucerne,4277,4,12,8,12,40,46,-6,44
FC Zürich,4277,5,9,9,14,41,42,-1,36
FC Lugano,4277,6,10,6,16,30,45,-15,36
FC Thun,4277,7,10,6,16,43,59,-16,36
Grasshoppers,4277,8,9,6,17,42,51,-9,33
FC Sion,4277,9,7,9,16,44,58,-14,30
Young Boys,4278,1,22,7,3,74,33,41,73
FC Basel,4278,2,19,7,6,61,28,33,64
Lucerne,4278,3,13,8,11,44,49,-5,47
St Gallen,4278,4,14,2,16,40,57,-17,44
FC Zürich,4278,5,11,9,12,45,38,7,42
FC Thun,4278,6,10,6,16,43,58,-15,36
Grasshoppers,4278,7,9,8,15,43,48,-5,35
FC Lugano,4278,8,10,5,17,31,51,-20,35
FC Sion,4278,9,6,8,18,40,59,-19,26
Young Boys,4279,1,22,7,3,78,34,44,73
FC Basel,4279,2,17,9,6,54,27,27,60
St Gallen,4279,3,15,2,15,41,55,-14,47
Lucerne,4279,4,12,7,13,40,50,-10,43
FC Zürich,4279,5,10,10,12,42,40,2,40
FC Lugano,4279,6,11,5,16,34,48,-14,38
Grasshoppers,4279,7,10,6,16,42,50,-8,36
FC Thun,4279,8,10,5,17,44,58,-14,35
FC Sion,4279,9,8,7,17,42,55,-13,31
Young Boys,4280,1,23,6,3,77,34,43,75
FC Basel,4280,2,19,8,5,56,22,34,65
St Gallen,4280,3,14,4,14,39,50,-11,46
Lucerne,4280,4,12,9,11,41,47,-6,45
FC Zürich,4280,5,10,10,12,39,37,2,40
FC Lugano,4280,6,10,6,16,36,52,-16,36
Grasshoppers,4280,7,9,6,17,38,49,-11,33
FC Thun,4280,8,9,6,17,44,60,-16,33
FC Sion,4280,9,7,7,18,39,58,-19,28
Young Boys,4281,1,22,6,4,72,34,38,72
FC Basel,4281,2,18,7,7,53,24,29,61
Lucerne,4281,3,14,7,11,44,43,1,49
St Gallen,4281,4,15,3,14,41,53,-12,48
FC Zürich,4281,5,11,11,10,44,38,6,44
Grasshoppers,4281,6,10,6,16,40,51,-11,36
FC Thun,4281,7,9,6,17,43,58,-15,33
FC Lugano,4281,8,9,6,17,32,52,-20,33
FC Sion,4281,9,5,10,17,38,54,-16,25
Young Boys,4282,1,21,7,4,69,39,30,70
FC Basel,4282,2,17,8,7,53,28,25,59
Lucerne,4282,3,13,8,11,43,43,0,47
FC Zürich,4282,4,12,10,10,42,34,8,46
St Gallen,4282,5,14,2,16,43,56,-13,44
Grasshoppers,4282,6,10,7,15,48,49,-1,37
FC Lugano,4282,7,10,6,16,31,47,-16,36
FC Thun,4282,8,8,7,17,42,62,-20,31
FC Sion,4282,9,7,9,16,42,55,-13,30
Young Boys,4283,1,20,7,5,66,36,30,67
FC Basel,4283,2,18,8,6,55,25,30,62
St Gallen,4283,3,14,3,15,43,55,-12,45
Lucerne,4283,4,12,7,13,41,48,-7,43
FC Zürich,4283,5,9,12,11,39,36,3,39
Grasshoppers,4283,6,11,6,15,45,48,-3,39
FC Lugano,4283,7,11,6,15,31,45,-14,39
FC Sion,4283,8,8,9,15,43,51,-8,33
FC Thun,4283,9,9,6,17,42,61,-19,33
Young Boys,4284,1,23,7,2,78,35,43,76
FC Basel,4284,2,15,9,8,50,29,21,54
Lucerne,4284,3,15,7,10,42,41,1,52
St Gallen,4284,4,14,2,16,41,57,-16,44
FC Zürich,4284,5,10,10,12,43,42,1,40
Grasshoppers,4284,6,10,6,16,41,49,-8,36
FC Lugano,4284,7,10,5,17,35,53,-18,35
FC Thun,4284,8,9,6,17,46,62,-16,33
FC Sion,4284,9,8,8,16,47,55,-8,32
Young Boys,4285,1,21,7,4,73,38,35,70
FC Basel,4285,2,17,9,6,56,28,28,60
St Gallen,4285,3,14,4,14,46,57,-11,46
Lucerne,4285,4,12,9,11,43,45,-2,45
FC Zürich,4285,5,10,11,11,42,38,4,41
FC Lugano,4285,6,12,5,15,33,46,-13,41
Grasshoppers,4285,7,10,6,16,45,53,-8,36
FC Thun,4285,8,10,5,17,45,61,-16,35
FC Sion,4285,9,5,10,17,41,58,-17,25
Young Boys,4286,1,22,6,4,72,36,36,72
FC Basel,4286,2,17,7,8,51,27,24,58
Lucerne,4286,3,13,8,11,43,44,-1,47
FC Zürich,4286,4,11,9,12,39,37,2,42
St Gallen,4286,5,13,3,16,43,57,-14,42
FC Lugano,4286,6,12,5,15,33,46,-13,41
FC Thun,4286,7,11,5,16,46,58,-12,38
Grasshoppers,4286,8,10,6,16,42,50,-8,36
FC Sion,4286,9,7,7,18,44,58,-14,28
Young Boys,4287,1,21,7,4,71,34,37,70
FC Basel,4287,2,18,8,6,58,25,33,62
Lucerne,4287,3,13,9,10,44,42,2,48
St Gallen,4287,4,14,2,16,45,63,-18,44
FC Zürich,4287,5,10,10,12,39,37,2,40
Grasshoppers,4287,6,10,6,16,43,52,-9,36
FC Thun,4287,7,10,6,16,44,61,-17,36
FC Lugano,4287,8,10,5,17,30,49,-19,35
FC Sion,4287,9,8,7,17,43,54,-11,31
Young Boys,4288,1,21,7,4,73,36,37,70
FC Basel,4288,2,19,8,5,56,25,31,65
Lucerne,4288,3,13,8,11,42,44,-2,47
St Gallen,4288,4,13,3,16,40,58,-18,42
FC Zürich,4288,5,10,11,11,41,38,3,41
Grasshoppers,4288,6,10,8,14,42,47,-5,38
FC Lugano,4288,7,10,5,17,32,48,-16,35
FC Thun,4288,8,9,6,17,42,60,-18,33
FC Sion,4288,9,6,10,16,40,52,-12,28
Young Boys,4289,1,21,7,4,74,34,40,70
FC Basel,4289,2,20,7,5,58,26,32,67
St Gallen,4289,3,14,2,16,42,55,-13,44
FC Lugano,4289,4,12,6,14,35,43,-8,42
Lucerne,4289,5,11,8,13,42,55,-13,41
FC Zürich,4289,6,10,10,12,39,39,0,40
Grasshoppers,4289,7,9,9,14,45,52,-7,36
FC Thun,4289,8,10,5,17,44,58,-14,35
FC Sion,4289,9,6,8,18,40,57,-17,26
Young Boys,4290,1,21,8,3,69,33,36,71
FC Basel,4290,2,18,7,7,53,26,27,61
St Gallen,4290,3,15,3,14,44,53,-9,48
FC Zürich,4290,4,12,9,11,41,34,7,45
Lucerne,4290,5,12,8,12,39,45,-6,44
Grasshoppers,4290,6,11,7,14,44,46,-2,40
FC Thun,4290,7,10,5,17,44,60,-16,35
FC Lugano,4290,8,9,6,17,31,50,-19,33
FC Sion,4290,9,6,7,19,37,55,-18,25
Young Boys,4291,1,21,6,5,72,39,33,69
FC Basel,4291,2,18,8,6,58,27,31,62
St Gallen,4291,3,15,4,13,44,52,-8,49
Lucerne,4291,4,12,8,12,39,46,-7,44
FC Zürich,4291,5,11,9,12,40,37,3,42
Grasshoppers,4291,6,10,6,16,41,48,-7,36
FC Lugano,4291,7,10,6,16,30,46,-16,36
FC Thun,4291,8,10,5,17,42,56,-14,35
FC Sion,4291,9,7,8,17,39,54,-15,29
Young Boys,4292,1,21,8,3,76,38,38,71
FC Basel,4292,2,18,9,5,54,25,29,63
St Gallen,4292,3,14,4,14,43,54,-11,46
FC Zürich,4292,4,12,9,11,41,33,8,45
Lucerne,4292,5,12,9,11,43,47,-4,45
Grasshoppers,4292,6,9,8,15,41,49,-8,35
FC Lugano,4292,7,9,6,17,30,51,-21,33
FC Sion,4292,8,8,8,16,42,54,-12,32
FC Thun,4292,9,8,5,19,43,62,-19,29
Young Boys,4293,1,21,6,5,72,38,34,69
FC Basel,4293,2,17,9,6,54,25,29,60
Lucerne,4293,3,13,9,10,42,43,-1,48
FC Zürich,4293,4,12,9,11,41,34,7,45
St Gallen,4293,5,14,3,15,41,53,-12,45
Grasshoppers,4293,6,10,8,14,43,47,-4,38
FC Lugano,4293,7,10,5,17,29,48,-19,35
FC Sion,4293,8,8,7,17,41,53,-12,31
FC Thun,4293,9,8,6,18,41,63,-22,30
Young Boys,4294,1,22,6,4,71,35,36,72
FC Basel,4294,2,18,7,7,53,26,27,61
Lucerne,4294,3,13,7,12,39,44,-5,46
St Gallen,4294,4,14,3,15,40,52,-12,45
Grasshoppers,4294,5,11,7,14,43,46,-3,40
FC Zürich,4294,6,9,12,11,39,37,2,39
FC Thun,4294,7,10,6,16,45,58,-13,36
FC Lugano,4294,8,10,6,16,31,47,-16,36
FC Sion,4294,9,5,10,17,37,53,-16,25
Young Boys,4295,1,22,7,3,74,34,40,73
FC Basel,4295,2,17,10,5,56,27,29,61
Lucerne,4295,3,12,10,10,43,43,0,46
St Gallen,4295,4,14,3,15,42,54,-12,45
FC Zürich,4295,5,10,12,10,43,36,7,42
FC Lugano,4295,6,10,7,15,30,46,-16,37
Grasshoppers,4295,7,9,7,16,38,52,-14,34
FC Thun,4295,8,8,6,18,41,63,-22,30
FC Sion,4295,9,7,8,17,40,52,-12,29
Young Boys,4296,1,21,7,4,69,33,36,70
FC Basel,4296,2,18,9,5,54,24,30,63
Lucerne,4296,3,13,8,11,39,41,-2,47
St Gallen,4296,4,13,4,15,41,56,-15,43
FC Lugano,4296,5,12,6,14,33,43,-10,42
FC Zürich,4296,6,10,10,12,43,41,2,40
FC Sion,4296,7,8,9,15,43,52,-9,33
Grasshoppers,4296,8,9,6,17,37,49,-12,33
FC Thun,4296,9,8,5,19,42,62,-20,29
Young Boys,4297,1,20,7,5,66,39,27,67
FC Basel,4297,2,18,8,6,55,24,31,62
Lucerne,4297,3,15,8,9,46,41,5,53
St Gallen,4297,4,13,2,17,41,61,-20,41
FC Zürich,4297,5,10,10,12,38,37,1,40
FC Thun,4297,6,11,6,15,44,54,-10,39
FC Lugano,4297,7,10,6,16,33,47,-14,36
Grasshoppers,4297,8,8,9,15,39,48,-9,33
FC Sion,4297,9,7,8,17,44,55,-11,29
Young Boys,4298,1,21,7,4,73,37,36,70
FC Basel,4298,2,19,8,5,56,25,31,65
St Gallen,4298,3,14,3,15,42,54,-12,45
Lucerne,4298,4,12,7,13,41,46,-5,43
FC Lugano,4298,5,12,6,14,34,45,-11,42
FC Zürich,4298,6,10,11,11,40,37,3,41
Grasshoppers,4298,7,9,7,16,41,51,-10,34
FC Thun,4298,8,9,5,18,41,59,-18,32
FC Sion,4298,9,6,10,16,39,53,-14,28
Young Boys,4299,1,21,8,3,74,33,41,71
FC Basel,4299,2,17,10,5,56,27,29,61
St Gallen,4299,3,14,3,15,46,59,-13,45
FC Zürich,4299,4,11,10,11,47,40,7,43
Lucerne,4299,5,11,9,12,42,48,-6,42
Grasshoppers,4299,6,10,8,14,42,48,-6,38
FC Lugano,4299,7,9,7,16,33,63,-30,34
FC Thun,4299,8,9,6,17,46,59,-13,33
FC Sion,4299,9,8,7,17,42,51,-9,31
Young Boys,4300,1,22,7,3,74,35,39,73
FC Basel,4300,2,17,9,6,52,25,27,60
Lucerne,4300,3,14,8,10,46,42,4,50
St Gallen,4300,4,14,3,15,46,57,-11,45
FC Zürich,4300,5,10,10,12,37,36,1,40
Grasshoppers,4300,6,10,7,15,42,48,-6,37
FC Thun,4300,7,10,5,17,45,58,-13,35
FC Lugano,4300,8,9,6,17,28,52,-24,33
FC Sion,4300,9,7,7,18,41,58,-17,28
Young Boys,4301,1,21,7,4,70,37,33,70
FC Basel,4301,2,17,8,7,52,27,25,59
Lucerne,4301,3,14,7,11,42,42,0,49
St Gallen,4301,4,14,4,14,44,54,-10,46
FC Zürich,4301,5,12,9,11,44,36,8,45
FC Thun,4301,6,10,5,17,46,59,-13,35
FC Lugano,4301,7,10,5,17,32,51,-19,35
Grasshoppers,4301,8,9,7,16,41,52,-11,34
FC Sion,4301,9,7,8,17,45,58,-13,29
Young Boys,4302,1,21,8,3,72,34,38,71
FC Basel,4302,2,18,9,5,56,26,30,63
Lucerne,4302,3,13,8,11,44,47,-3,47
FC Zürich,4302,4,11,11,10,45,35,10,44
St Gallen,4302,5,13,2,17,43,59,-16,41
FC Lugano,4302,6,10,7,15,30,48,-18,37
Grasshoppers,4302,7,9,6,17,39,50,-11,33
FC Sion,4302,8,8,8,16,41,52,-11,32
FC Thun,4302,9,9,5,18,41,60,-19,32
Young Boys,4303,1,22,6,4,73,36,37,72
FC Basel,4303,2,17,7,8,55,28,27,58
Lucerne,4303,3,15,7,10,46,40,6,52
St Gallen,4303,4,14,2,16,41,56,-15,44
FC Zürich,4303,5,10,10,12,44,40,4,40
FC Thun,4303,6,11,5,16,46,61,-15,38
FC Lugano,4303,7,10,6,16,32,51,-19,36
Grasshoppers,4303,8,9,6,17,40,54,-14,33
FC Sion,4303,9,8,7,17,42,53,-11,31
Young Boys,4304,1,20,7,5,73,42,31,67
FC Basel,4304,2,19,7,6,59,28,31,64
FC Zürich,4304,3,13,9,10,44,35,9,48
Lucerne,4304,4,13,8,11,42,46,-4,47
St Gallen,4304,5,13,3,16,43,58,-15,42
FC Lugano,4304,6,11,5,16,38,50,-12,38
Grasshoppers,4304,7,10,6,16,43,53,-10,36
FC Thun,4304,8,9,5,18,45,62,-17,32
FC Sion,4304,9,7,8,17,46,59,-13,29
Young Boys,4305,1,23,6,3,74,33,41,75
FC Basel,4305,2,15,10,7,50,28,22,55
Lucerne,4305,3,14,8,10,45,45,0,50
St Gallen,4305,4,13,4,15,43,56,-13,43
FC Zürich,4305,5,10,11,11,43,39,4,41
FC Thun,4305,6,10,7,15,42,55,-13,37
Grasshoppers,4305,7,9,7,16,41,50,-9,34
FC Lugano,4305,8,9,7,16,30,48,-18,34
FC Sion,4305,9,7,8,17,44,58,-14,29
Young Boys,4306,1,22,6,4,71,35,36,72
FC Basel,4306,2,19,7,6,57,24,33,64
St Gallen,4306,3,15,2,15,45,55,-10,47
FC Zürich,4306,4,11,10,11,44,35,9,43
FC Lugano,4306,5,12,6,14,32,43,-11,42
Lucerne,4306,6,11,7,14,41,52,-11,40
FC Thun,4306,7,10,5,17,42,62,-20,35
Grasshoppers,4306,8,9,6,17,40,51,-11,33
FC Sion,4306,9,7,7,18,39,54,-15,28
Young Boys,4307,1,21,8,3,76,36,40,71
FC Basel,4307,2,17,9,6,52,26,26,60
Lucerne,4307,3,14,9,9,44,41,3,51
FC Zürich,4307,4,12,10,10,46,37,9,46
St Gallen,4307,5,13,4,15,41,57,-16,43
FC Lugano,4307,6,10,5,17,39,55,-16,35
FC Thun,4307,7,9,6,17,44,60,-16,33
FC Sion,4307,8,7,9,16,40,53,-13,30
Grasshoppers,4307,9,8,6,18,38,55,-17,30
Young Boys,4308,1,21,8,3,70,34,36,71
FC Basel,4308,2,16,10,6,56,29,27,58
St Gallen,4308,3,15,3,14,47,53,-6,48
FC Zürich,4308,4,10,11,11,41,38,3,41
Lucerne,4308,5,11,7,14,39,53,-14,40
FC Lugano,4308,6,11,5,16,35,50,-15,38
Grasshoppers,4308,7,10,7,15,42,49,-7,37
FC Thun,4308,8,9,7,16,46,61,-15,34
FC Sion,4308,9,8,8,16,45,54,-9,32
Young Boys,4309,1,23,6,3,74,31,43,75
FC Basel,4309,2,15,11,6,52,30,22,56
Lucerne,4309,3,12,10,10,42,42,0,46
St Gallen,4309,4,14,3,15,41,54,-13,45
FC Lugano,4309,5,11,6,15,32,47,-15,39
FC Zürich,4309,6,9,11,12,40,38,2,38
Grasshoppers,4309,7,10,8,14,41,46,-5,38
FC Thun,4309,8,9,7,16,43,59,-16,34
FC Sion,4309,9,5,10,17,38,56,-18,25
Young Boys,4310,1,21,8,3,70,35,35,71
FC Basel,4310,2,20,7,5,62,25,37,67
St Gallen,4310,3,16,2,14,45,52,-7,50
Lucerne,4310,4,11,9,12,40,47,-7,42
FC Zürich,4310,5,10,10,12,43,40,3,40
FC Lugano,4310,6,10,6,16,31,48,-17,36
Grasshoppers,4310,7,9,8,15,42,50,-8,35
FC Thun,4310,8,9,6,17,41,59,-18,33
FC Sion,4310,9,6,8,18,36,54,-18,26
Young Boys,4311,1,21,8,3,67,32,35,71
FC Basel,4311,2,17,9,6,54,28,26,60
St Gallen,4311,3,15,4,13,44,52,-8,49
Lucerne,4311,4,12,9,11,41,43,-2,45
FC Zürich,4311,5,10,12,10,41,35,6,42
FC Lugano,4311,6,10,6,16,32,49,-17,36
Grasshoppers,4311,7,9,7,16,39,47,-8,34
FC Thun,4311,8,8,7,17,42,60,-18,31
FC Sion,4311,9,6,10,16,39,53,-14,28
Young Boys,4312,1,24,6,2,79,32,47,78
FC Basel,4312,2,16,9,7,51,27,24,57
Lucerne,4312,3,13,8,11,43,47,-4,47
St Gallen,4312,4,13,5,14,42,54,-12,44
FC Zürich,4312,5,10,11,11,40,36,4,41
FC Lugano,4312,6,10,6,16,29,47,-18,36
FC Thun,4312,7,10,5,17,50,62,-12,35
Grasshoppers,4312,8,9,7,16,40,55,-15,34
FC Sion,4312,9,6,9,17,44,58,-14,27
Young Boys,4313,1,22,6,4,71,34,37,72
FC Basel,4313,2,19,7,6,56,24,32,64
St Gallen,4313,3,14,3,15,44,61,-17,45
Lucerne,4313,4,11,10,11,38,43,-5,43
FC Zürich,4313,5,10,9,13,39,42,-3,39
FC Lugano,4313,6,10,6,16,32,47,-15,36
FC Thun,4313,7,10,5,17,43,57,-14,35
FC Sion,4313,8,9,7,16,47,53,-6,34
Grasshoppers,4313,9,9,7,16,38,47,-9,34
Young Boys,4314,1,22,6,4,73,40,33,72
FC Basel,4314,2,19,7,6,58,29,29,64
St Gallen,4314,3,15,2,15,46,53,-7,47
Lucerne,4314,4,12,8,12,41,48,-7,44
FC Zürich,4314,5,10,11,11,39,34,5,41
Grasshoppers,4314,6,9,7,16,44,52,-8,34
FC Sion,4314,7,9,7,16,43,53,-10,34
FC Thun,4314,8,9,6,17,45,59,-14,33
FC Lugano,4314,9,9,6,17,29,50,-21,33
Young Boys,4315,1,22,8,2,76,31,45,74
FC Basel,4315,2,17,9,6,51,24,27,60
St Gallen,4315,3,14,5,13,44,52,-8,47
Lucerne,4315,4,11,10,11,39,43,-4,43
FC Zürich,4315,5,10,10,12,42,40,2,40
FC Thun,4315,6,11,6,15,46,56,-10,39
FC Lugano,4315,7,10,7,15,32,50,-18,37
Grasshoppers,4315,8,10,6,16,40,51,-11,36
FC Sion,4315,9,5,7,20,37,60,-23,22
Young Boys,4316,1,21,7,4,73,39,34,70
FC Basel,4316,2,17,8,7,56,30,26,59
Lucerne,4316,3,14,7,11,46,43,3,49
Grasshoppers,4316,4,12,6,14,43,47,-4,42
St Gallen,4316,5,13,3,16,41,60,-19,42
FC Zürich,4316,6,10,11,11,38,34,4,41
FC Thun,4316,7,10,6,16,45,58,-13,36
FC Lugano,4316,8,9,7,16,29,49,-20,34
FC Sion,4316,9,6,9,17,45,56,-11,27
Young Boys,4317,1,22,7,3,74,33,41,73
FC Basel,4317,2,18,8,6,55,27,28,62
Lucerne,4317,3,13,9,10,45,44,1,48
St Gallen,4317,4,13,3,16,41,59,-18,42
FC Zürich,4317,5,10,9,13,40,39,1,39
FC Thun,4317,6,11,5,16,45,58,-13,38
FC Lugano,4317,7,11,5,16,33,48,-15,38
FC Sion,4317,8,8,7,17,44,56,-12,31
Grasshoppers,4317,9,8,7,17,41,54,-13,31
Young Boys,4318,1,19,8,5,68,37,31,65
FC Basel,4318,2,17,8,7,50,28,22,59
St Gallen,4318,3,16,2,14,45,52,-7,50
Lucerne,4318,4,14,7,11,42,40,2,49
FC Zürich,4318,5,13,9,10,46,35,11,48
Grasshoppers,4318,6,10,6,16,38,49,-11,36
FC Thun,4318,7,9,7,16,42,55,-13,34
FC Lugano,4318,8,9,6,17,30,50,-20,33
FC Sion,4318,9,6,9,17,40,55,-15,27
Young Boys,4319,1,21,8,3,77,39,38,71
FC Basel,4319,2,18,8,6,58,28,30,62
St Gallen,4319,3,15,3,14,43,53,-10,48
Lucerne,4319,4,13,8,11,43,44,-1,47
FC Zürich,4319,5,11,9,12,42,38,4,42
FC Thun,4319,6,11,5,16,46,59,-13,38
FC Lugano,4319,7,11,5,16,32,50,-18,38
Grasshoppers,4319,8,8,8,16,41,52,-11,32
FC Sion,4319,9,5,8,19,40,59,-19,23
Young Boys,4320,1,21,7,4,74,39,35,70
FC Basel,4320,2,17,10,5,60,30,30,61
St Gallen,4320,3,16,3,13,47,51,-4,51
Lucerne,4320,4,12,8,12,42,50,-8,44
FC Zürich,4320,5,10,10,12,41,40,1,40
Grasshoppers,4320,6,10,6,16,48,55,-7,36
FC Lugano,4320,7,10,6,16,33,46,-13,36
FC Thun,4320,8,10,5,17,50,62,-12,35
FC Sion,4320,9,7,7,18,42,64,-22,28
Young Boys,4321,1,21,8,3,72,36,36,71
FC Basel,4321,2,17,7,8,52,27,25,58
St Gallen,4321,3,15,2,15,44,55,-11,47
Lucerne,4321,4,12,9,11,40,43,-3,45
FC Zürich,4321,5,11,9,12,42,39,3,42
Grasshoppers,4321,6,10,7,15,43,49,-6,37
FC Lugano,4321,7,10,7,15,31,48,-17,37
FC Sion,4321,8,8,8,16,40,51,-11,32
FC Thun,4321,9,9,5,18,45,61,-16,32
Young Boys,4322,1,20,8,4,71,36,35,68
FC Basel,4322,2,18,9,5,56,24,32,63
Lucerne,4322,3,13,8,11,46,45,1,47
St Gallen,4322,4,13,4,15,40,55,-15,43
FC Zürich,4322,5,10,10,12,43,39,4,40
FC Thun,4322,6,11,5,16,45,62,-17,38
FC Lugano,4322,7,10,7,15,30,48,-18,37
Grasshoppers,4322,8,10,6,16,46,56,-10,36
FC Sion,4322,9,7,7,18,43,55,-12,28
Young Boys,4323,1,22,7,3,76,36,40,73
FC Basel,4323,2,19,8,5,59,26,33,65
St Gallen,4323,3,15,3,14,46,55,-9,48
Lucerne,4323,4,12,8,12,42,48,-6,44
FC Zürich,4323,5,11,9,12,44,37,7,42
Grasshoppers,4323,6,10,6,16,46,52,-6,36
FC Lugano,4323,7,10,5,17,30,50,-20,35
FC Thun,4323,8,9,5,18,42,63,-21,32
FC Sion,4323,9,7,7,18,42,60,-18,28
Young Boys,4324,1,22,6,4,69,38,31,72
FC Basel,4324,2,17,9,6,59,27,32,60
FC Zürich,4324,3,12,10,10,43,33,10,46
St Gallen,4324,4,14,3,15,42,54,-12,45
Lucerne,4324,5,11,11,10,41,43,-2,44
FC Thun,4324,6,10,6,16,44,60,-16,36
FC Lugano,4324,7,9,6,17,29,47,-18,33
Grasshoppers,4324,8,8,8,16,38,51,-13,32
FC Sion,4324,9,7,9,16,40,52,-12,30
Young Boys,4325,1,21,7,4,68,34,34,70
FC Basel,4325,2,20,7,5,59,26,33,67
FC Zürich,4325,3,12,9,11,44,37,7,45
St Gallen,4325,4,14,3,15,42,55,-13,45
Lucerne,4325,5,12,7,13,38,44,-6,43
Grasshoppers,4325,6,11,6,15,44,47,-3,39
FC Lugano,4325,7,11,5,16,31,47,-16,38
FC Thun,4325,8,9,5,18,42,59,-17,32
FC Sion,4325,9,5,9,18,38,57,-19,24
Young Boys,4326,1,21,8,3,71,34,37,71
FC Basel,4326,2,18,7,7,52,24,28,61
Lucerne,4326,3,14,7,11,44,43,1,49
FC Zürich,4326,4,11,10,11,39,35,4,43
St Gallen,4326,5,13,3,16,41,56,-15,42
FC Lugano,4326,6,11,6,15,33,46,-13,39
Grasshoppers,4326,7,10,7,15,41,49,-8,37
FC Sion,4326,8,7,9,16,42,54,-12,30
FC Thun,4326,9,8,5,19,40,62,-22,29
Young Boys,4327,1,22,7,3,70,32,38,73
FC Basel,4327,2,18,9,5,59,28,31,63
Lucerne,4327,3,13,9,10,44,44,0,48
St Gallen,4327,4,14,3,15,41,54,-13,45
FC Zürich,4327,5,10,11,11,42,38,4,41
FC Thun,4327,6,11,5,16,44,57,-13,38
FC Lugano,4327,7,10,6,16,30,47,-17,36
Grasshoppers,4327,8,8,7,17,39,51,-12,31
FC Sion,4327,9,5,9,18,37,55,-18,24
Young Boys,4328,1,21,8,3,71,34,37,71
FC Basel,4328,2,19,7,6,61,24,37,64
St Gallen,4328,3,15,2,15,44,54,-10,47
Lucerne,4328,4,12,8,12,42,49,-7,44
FC Zürich,4328,5,10,10,12,40,38,2,40
Grasshoppers,4328,6,10,7,15,45,49,-4,37
FC Lugano,4328,7,10,6,16,29,47,-18,36
FC Thun,4328,8,9,6,17,40,62,-22,33
FC Sion,4328,9,7,8,17,39,54,-15,29
Young Boys,4329,1,21,7,4,69,34,35,70
FC Basel,4329,2,17,10,5,55,24,31,61
St Gallen,4329,3,15,3,14,49,59,-10,48
Lucerne,4329,4,12,9,11,41,46,-5,45
FC Zürich,4329,5,10,12,10,39,34,5,42
FC Lugano,4329,6,10,7,15,30,47,-17,37
FC Thun,4329,7,9,6,17,42,56,-14,33
FC Sion,4329,8,8,8,16,39,50,-11,32
Grasshoppers,4329,9,8,6,18,37,51,-14,30
Young Boys,4330,1,21,8,3,69,36,33,71
FC Basel,4330,2,17,9,6,53,25,28,60
St Gallen,4330,3,15,2,15,43,54,-11,47
Lucerne,4330,4,12,9,11,42,43,-1,45
FC Zürich,4330,5,11,10,11,41,38,3,43
FC Lugano,4330,6,11,6,15,32,43,-11,39
FC Thun,4330,7,10,5,17,43,60,-17,35
Grasshoppers,4330,8,8,8,16,40,50,-10,32
FC Sion,4330,9,7,7,18,40,54,-14,28
Young Boys,4331,1,22,7,3,71,33,38,73
FC Basel,4331,2,17,7,8,50,29,21,58
Lucerne,4331,3,12,10,10,43,43,0,46
FC Zürich,4331,4,11,11,10,41,33,8,44
St Gallen,4331,5,13,3,16,40,56,-16,42
FC Lugano,4331,6,10,7,15,29,46,-17,37
Grasshoppers,4331,7,9,7,16,39,49,-10,34
FC Thun,4331,8,9,7,16,41,55,-14,34
FC Sion,4331,9,7,9,16,41,51,-10,30
Young Boys,4332,1,21,7,4,73,36,37,70
FC Basel,4332,2,19,8,5,62,26,36,65
Lucerne,4332,3,13,8,11,44,45,-1,47
FC Zürich,4332,4,11,11,10,44,37,7,44
St Gallen,4332,5,13,3,16,42,58,-16,42
FC Lugano,4332,6,10,6,16,32,52,-20,36
Grasshoppers,4332,7,9,6,17,40,52,-12,33
FC Thun,4332,8,9,6,17,43,63,-20,33
FC Sion,4332,9,7,9,16,46,57,-11,30
Young Boys,4333,1,22,7,3,76,36,40,73
FC Basel,4333,2,18,8,6,57,24,33,62
St Gallen,4333,3,15,4,13,48,54,-6,49
Lucerne,4333,4,12,8,12,43,47,-4,44
FC Zürich,4333,5,11,9,12,39,35,4,42
Grasshoppers,4333,6,9,8,15,39,46,-7,35
FC Thun,4333,7,10,5,17,41,65,-24,35
FC Lugano,4333,8,9,6,17,31,55,-24,33
FC Sion,4333,9,7,7,18,42,54,-12,28
Young Boys,4334,1,22,7,3,72,36,36,73
FC Basel,4334,2,18,8,6,58,25,33,62
St Gallen,4334,3,15,3,14,46,56,-10,48
Lucerne,4334,4,12,9,11,41,44,-3,45
FC Zürich,4334,5,10,9,13,39,42,-3,39
FC Lugano,4334,6,11,6,15,35,48,-13,39
FC Thun,4334,7,10,6,16,45,57,-12,36
Grasshoppers,4334,8,8,6,18,38,55,-17,30
FC Sion,4334,9,7,8,17,42,53,-11,29
Young Boys,4335,1,22,7,3,70,32,38,73
FC Basel,4335,2,18,8,6,57,30,27,62
St Gallen,4335,3,16,2,14,44,52,-8,50
Lucerne,4335,4,12,8,12,42,45,-3,44
FC Zürich,4335,5,10,9,13,38,37,1,39
FC Thun,4335,6,10,7,15,44,57,-13,37
FC Lugano,4335,7,10,6,16,30,48,-18,36
Grasshoppers,4335,8,9,7,16,40,50,-10,34
FC Sion,4335,9,6,8,18,37,51,-14,26
Young Boys,4336,1,23,6,3,75,33,42,75
FC Basel,4336,2,20,7,5,63,23,40,67
Lucerne,4336,3,13,8,11,46,47,-1,47
FC Zürich,4336,4,11,10,11,40,36,4,43
St Gallen,4336,5,13,3,16,39,58,-19,42
Grasshoppers,4336,6,10,7,15,41,50,-9,37
FC Lugano,4336,7,10,5,17,30,51,-21,35
FC Thun,4336,8,9,5,18,43,60,-17,32
FC Sion,4336,9,5,9,18,37,56,-19,24
Young Boys,4337,1,20,7,5,70,35,35,67
FC Basel,4337,2,18,9,5,56,25,31,63
St Gallen,4337,3,15,4,13,47,55,-8,49
Lucerne,4337,4,13,8,11,45,48,-3,47
FC Zürich,4337,5,10,11,11,43,38,5,41
FC Lugano,4337,6,10,5,17,32,51,-19,35
FC Sion,4337,7,9,7,16,42,51,-9,34
FC Thun,4337,8,9,6,17,41,60,-19,33
Grasshoppers,4337,9,8,7,17,39,52,-13,31
Young Boys,4338,1,23,6,3,75,34,41,75
FC Basel,4338,2,16,7,9,51,30,21,55
Lucerne,4338,3,13,9,10,41,41,0,48
St Gallen,4338,4,14,4,14,42,52,-10,46
FC Zürich,4338,5,11,10,11,45,39,6,43
FC Thun,4338,6,10,6,16,44,59,-15,36
FC Lugano,4338,7,9,7,16,30,48,-18,34
Grasshoppers,4338,8,8,8,16,41,53,-12,32
FC Sion,4338,9,7,9,16,42,55,-13,30
Young Boys,4339,1,22,7,3,73,34,39,73
FC Basel,4339,2,18,8,6,56,23,33,62
Lucerne,4339,3,13,9,10,43,43,0,48
St Gallen,4339,4,13,4,15,42,57,-15,43
FC Zürich,4339,5,11,9,12,42,38,4,42
Grasshoppers,4339,6,11,6,15,44,51,-7,39
FC Lugano,4339,7,10,6,16,34,51,-17,36
FC Thun,4339,8,9,5,18,41,63,-22,32
FC Sion,4339,9,6,8,18,42,57,-15,26
Young Boys,4340,1,24,6,2,76,35,41,78
FC Basel,4340,2,18,7,7,55,25,30,61
Lucerne,4340,3,13,7,12,40,46,-6,46
St Gallen,4340,4,14,2,16,40,54,-14,44
FC Zürich,4340,5,11,10,11,44,39,5,43
FC Lugano,4340,6,11,5,16,31,47,-16,38
FC Thun,4340,7,10,6,16,46,59,-13,36
Grasshoppers,4340,8,9,6,17,41,50,-9,33
FC Sion,4340,9,6,7,19,42,60,-18,25
Young Boys,4341,1,21,7,4,70,35,35,70
FC Basel,4341,2,18,8,6,50,24,26,62
St Gallen,4341,3,14,2,16,44,58,-14,44
Lucerne,4341,4,12,7,13,43,48,-5,43
FC Zürich,4341,5,10,11,11,38,34,4,41
Grasshoppers,4341,6,10,8,14,43,48,-5,38
FC Thun,4341,7,10,6,16,43,56,-13,36
FC Lugano,4341,8,10,6,16,30,46,-16,36
FC Sion,4341,9,8,7,17,42,54,-12,31
Young Boys,4342,1,22,7,3,77,35,42,73
FC Basel,4342,2,18,8,6,57,25,32,62
Lucerne,4342,3,13,8,11,41,48,-7,47
FC Zürich,4342,4,11,11,10,40,33,7,44
St Gallen,4342,5,14,2,16,44,60,-16,44
Grasshoppers,4342,6,10,7,15,43,50,-7,37
FC Lugano,4342,7,10,5,17,29,46,-17,35
FC Thun,4342,8,9,6,17,43,61,-18,33
FC Sion,4342,9,6,8,18,44,60,-16,26
Young Boys,4343,1,23,7,2,71,31,40,76
FC Basel,4343,2,17,9,6,57,25,32,60
St Gallen,4343,3,16,3,13,44,51,-7,51
Lucerne,4343,4,12,9,11,43,45,-2,45
FC Zürich,4343,5,10,10,12,40,36,4,40
FC Lugano,4343,6,10,5,17,31,49,-18,35
Grasshoppers,4343,7,9,6,17,39,49,-10,33
FC Thun,4343,8,9,5,18,42,67,-25,32
FC Sion,4343,9,7,8,17,39,53,-14,29
Young Boys,4344,1,20,7,5,68,37,31,67
FC Basel,4344,2,17,9,6,53,25,28,60
St Gallen,4344,3,14,5,13,44,53,-9,47
Lucerne,4344,4,12,9,11,38,42,-4,45
FC Zürich,4344,5,10,11,11,44,38,6,41
FC Thun,4344,6,10,6,16,42,58,-16,36
Grasshoppers,4344,7,9,8,15,42,51,-9,35
FC Lugano,4344,8,9,8,15,32,48,-16,35
FC Sion,4344,9,8,7,17,44,55,-11,31
Young Boys,4345,1,21,7,4,70,34,36,70
FC Basel,4345,2,17,9,6,57,31,26,60
Lucerne,4345,3,14,7,11,46,45,1,49
St Gallen,4345,4,14,3,15,43,58,-15,45
FC Zürich,4345,5,10,11,11,43,38,5,41
FC Lugano,4345,6,11,5,16,34,50,-16,38
Grasshoppers,4345,7,9,7,16,41,51,-10,34
FC Thun,4345,8,9,7,16,43,57,-14,34
FC Sion,4345,9,7,8,17,40,53,-13,29
Young Boys,4346,1,22,7,3,72,35,37,73
FC Basel,4346,2,19,8,5,57,24,33,65
St Gallen,4346,3,13,4,15,42,57,-15,43
Lucerne,4346,4,11,8,13,37,44,-7,41
FC Lugano,4346,5,11,6,15,30,45,-15,39
FC Zürich,4346,6,9,10,13,38,42,-4,37
FC Thun,4346,7,10,6,16,46,58,-12,36
Grasshoppers,4346,8,9,7,16,42,51,-9,34
FC Sion,4346,9,8,8,16,43,51,-8,32
Young Boys,4347,1,24,6,2,78,33,45,78
FC Basel,4347,2,17,8,7,51,26,25,59
St Gallen,4347,3,15,3,14,43,53,-10,48
Lucerne,4347,4,13,7,12,42,48,-6,46
FC Zürich,4347,5,10,10,12,40,37,3,40
FC Lugano,4347,6,11,6,15,34,46,-12,39
Grasshoppers,4347,7,10,6,16,46,53,-7,36
FC Thun,4347,8,9,5,18,41,60,-19,32
FC Sion,4347,9,6,7,19,39,58,-19,25
Young Boys,4348,1,20,9,3,68,32,36,69
FC Basel,4348,2,19,7,6,59,29,30,64
Lucerne,4348,3,12,10,10,44,45,-1,46
St Gallen,4348,4,13,4,15,44,61,-17,43
FC Zürich,4348,5,10,10,12,40,39,1,40
FC Lugano,4348,6,11,6,15,34,49,-15,39
Grasshoppers,4348,7,9,9,14,46,53,-7,36
FC Thun,4348,8,8,7,17,43,60,-17,31
FC Sion,4348,9,7,8,17,46,56,-10,29
Young Boys,4349,1,20,7,5,67,39,28,67
FC Basel,4349,2,18,9,5,58,26,32,63
St Gallen,4349,3,15,3,14,47,55,-8,48
Grasshoppers,4349,4,12,6,14,46,49,-3,42
Lucerne,4349,5,11,9,12,40,45,-5,42
FC Zürich,4349,6,10,11,11,45,40,5,41
FC Thun,4349,7,9,6,17,46,62,-16,33
FC Lugano,4349,8,9,6,17,32,53,-21,33
FC Sion,4349,9,8,7,17,48,60,-12,31
Young Boys,4350,1,21,8,3,70,33,37,71
FC Basel,4350,2,19,7,6,56,25,31,64
St Gallen,4350,3,15,3,14,40,50,-10,48
Lucerne,4350,4,13,8,11,41,41,0,47
FC Zürich,4350,5,10,9,13,39,42,-3,39
FC Thun,4350,6,10,5,17,47,61,-14,35
FC Lugano,4350,7,10,5,17,30,50,-20,35
FC Sion,4350,8,8,8,16,43,52,-9,32
Grasshoppers,4350,9,8,7,17,37,49,-12,31
Young Boys,4351,1,22,6,4,76,39,37,72
FC Basel,4351,2,18,9,5,54,25,29,63
Lucerne,4351,3,14,8,10,42,39,3,50
St Gallen,4351,4,14,3,15,43,55,-12,45
FC Zürich,4351,5,10,11,11,39,36,3,41
FC Thun,4351,6,10,6,16,46,58,-12,36
FC Lugano,4351,7,10,6,16,34,50,-16,36
Grasshoppers,4351,8,8,7,17,41,55,-14,31
FC Sion,4351,9,6,8,18,39,57,-18,26
Young Boys,4352,1,23,7,2,77,35,42,76
FC Basel,4352,2,17,8,7,52,26,26,59
Lucerne,4352,3,13,9,10,46,45,1,48
St Gallen,4352,4,15,2,15,45,56,-11,47
FC Zürich,4352,5,11,9,12,40,36,4,42
FC Lugano,4352,6,11,5,16,34,51,-17,38
Grasshoppers,4352,7,9,7,16,45,55,-10,34
FC Sion,4352,8,7,8,17,40,54,-14,29
FC Thun,4352,9,8,5,19,41,62,-21,29
Young Boys,4353,1,21,7,4,73,39,34,70
FC Basel,4353,2,17,9,6,54,25,29,60
Lucerne,4353,3,12,9,11,41,43,-2,45
St Gallen,4353,4,14,3,15,41,53,-12,45
FC Zürich,4353,5,11,9,12,44,38,6,42
FC Lugano,4353,6,12,5,15,35,49,-14,41
Grasshoppers,4353,7,11,6,15,47,48,-1,39
FC Thun,4353,8,8,7,17,39,59,-20,31
FC Sion,4353,9,6,9,17,38,58,-20,27
Young Boys,4354,1,21,6,5,74,42,32,69
FC Basel,4354,2,19,7,6,52,24,28,64
Lucerne,4354,3,13,7,12,45,46,-1,46
St Gallen,4354,4,14,2,16,40,53,-13,44
FC Zürich,4354,5,10,11,11,40,35,5,41
FC Lugano,4354,6,12,5,15,35,48,-13,41
FC Thun,4354,7,10,6,16,45,56,-11,36
Grasshoppers,4354,8,10,6,16,44,55,-11,36
FC Sion,4354,9,6,8,18,39,55,-16,26
Young Boys,4355,1,24,6,2,75,31,44,78
FC Basel,4355,2,18,8,6,55,24,31,62
Lucerne,4355,3,14,7,11,43,43,0,49
St Gallen,4355,4,13,2,17,40,58,-18,41
FC Zürich,4355,5,10,9,13,43,43,0,39
FC Lugano,4355,6,11,5,16,36,50,-14,38
FC Thun,4355,7,10,7,15,46,57,-11,37
Grasshoppers,4355,8,8,7,17,39,54,-15,31
FC Sion,4355,9,6,9,17,40,57,-17,27
Young Boys,4356,1,23,6,3,76,36,40,75
FC Basel,4356,2,18,8,6,54,26,28,62
St Gallen,4356,3,15,2,15,44,55,-11,47
Lucerne,4356,4,12,7,13,44,49,-5,43
FC Zürich,4356,5,11,9,12,39,36,3,42
FC Lugano,4356,6,11,5,16,34,49,-15,38
FC Thun,4356,7,9,7,16,43,58,-15,34
FC Sion,4356,8,8,7,17,41,53,-12,31
Grasshoppers,4356,9,8,7,17,43,56,-13,31
Young Boys,4357,1,20,8,4,68,36,32,68
FC Basel,4357,2,17,9,6,51,23,28,60
St Gallen,4357,3,16,3,13,47,52,-5,51
Lucerne,4357,4,12,7,13,40,48,-8,43
FC Zürich,4357,5,10,11,11,38,36,2,41
FC Lugano,4357,6,11,7,14,31,44,-13,40
FC Thun,4357,7,10,6,16,45,57,-12,36
Grasshoppers,4357,8,8,7,17,40,52,-12,31
FC Sion,4357,9,7,8,17,39,51,-12,29
Young Boys,4358,1,21,7,4,73,39,34,70
FC Basel,4358,2,19,8,5,60,25,35,65
St Gallen,4358,3,14,3,15,43,54,-11,45
Lucerne,4358,4,12,8,12,38,45,-7,44
FC Zürich,4358,5,10,10,12,39,37,2,40
FC Lugano,4358,6,11,7,14,34,45,-11,40
FC Thun,4358,7,10,5,17,45,61,-16,35
Grasshoppers,4358,8,8,7,17,39,51,-12,31
FC Sion,4358,9,8,7,17,41,55,-14,31
Young Boys,4359,1,22,7,3,72,30,42,73
FC Basel,4359,2,17,9,6,52,25,27,60
FC Zürich,4359,3,13,9,10,46,35,11,48
Lucerne,4359,4,12,10,10,42,45,-3,46
St Gallen,4359,5,13,2,17,39,59,-20,41
FC Lugano,4359,6,10,6,16,34,50,-16,36
Grasshoppers,4359,7,8,9,15,39,50,-11,33
FC Thun,4359,8,8,7,17,42,61,-19,31
FC Sion,4359,9,7,9,16,40,51,-11,30
Young Boys,4360,1,21,6,5,71,36,35,69
FC Basel,4360,2,19,7,6,55,25,30,64
Lucerne,4360,3,14,8,10,43,41,2,50
St Gallen,4360,4,15,2,15,45,56,-11,47
FC Zürich,4360,5,10,11,11,41,38,3,41
Grasshoppers,4360,6,9,7,16,41,52,-11,34
FC Lugano,4360,7,9,6,17,32,51,-19,33
FC Sion,4360,8,8,8,16,46,52,-6,32
FC Thun,4360,9,9,5,18,40,63,-23,32
Young Boys,4361,1,20,9,3,69,34,35,69
FC Basel,4361,2,18,9,5,55,23,32,63
Lucerne,4361,3,12,10,10,45,45,0,46
St Gallen,4361,4,13,3,16,42,58,-16,42
FC Zürich,4361,5,10,11,11,42,37,5,41
FC Lugano,4361,6,10,7,15,30,47,-17,37
FC Thun,4361,7,10,6,16,45,57,-12,36
Grasshoppers,4361,8,8,8,16,38,51,-13,32
FC Sion,4361,9,7,9,16,39,53,-14,30
Young Boys,4362,1,20,8,4,69,35,34,68
FC Basel,4362,2,18,8,6,57,28,29,62
St Gallen,4362,3,14,5,13,46,54,-8,47
FC Zürich,4362,4,12,10,10,48,36,12,46
Lucerne,4362,5,12,10,10,39,41,-2,46
Grasshoppers,4362,6,10,8,14,43,47,-4,38
FC Lugano,4362,7,9,7,16,31,51,-20,34
FC Thun,4362,8,8,5,19,42,66,-24,29
FC Sion,4362,9,6,9,17,43,60,-17,27
Young Boys,4363,1,21,7,4,68,37,31,70
FC Basel,4363,2,18,8,6,55,26,29,62
Lucerne,4363,3,13,8,11,45,43,2,47
FC Zürich,4363,4,11,11,10,41,34,7,44
St Gallen,4363,5,14,2,16,42,59,-17,44
FC Lugano,4363,6,10,6,16,32,47,-15,36
Grasshoppers,4363,7,9,8,15,40,48,-8,35
FC Thun,4363,8,9,5,18,44,61,-17,32
FC Sion,4363,9,7,9,16,40,52,-12,30
Young Boys,4364,1,21,6,5,69,36,33,69
FC Basel,4364,2,18,8,6,55,25,30,62
St Gallen,4364,3,16,2,14,47,55,-8,50
Lucerne,4364,4,13,7,12,43,46,-3,46
FC Zürich,4364,5,10,11,11,41,36,5,41
Grasshoppers,4364,6,9,8,15,41,49,-8,35
FC Lugano,4364,7,10,5,17,30,50,-20,35
FC Thun,4364,8,8,8,16,43,60,-17,32
FC Sion,4364,9,7,9,16,42,54,-12,30
Young Boys,4365,1,21,7,4,71,37,34,70
FC Basel,4365,2,20,7,5,59,24,35,67
Lucerne,4365,3,13,7,12,42,43,-1,46
St Gallen,4365,4,14,2,16,42,55,-13,44
FC Zürich,4365,5,10,10,12,41,39,2,40
FC Lugano,4365,6,10,6,16,31,48,-17,36
FC Thun,4365,7,10,5,17,43,60,-17,35
Grasshoppers,4365,8,9,7,16,41,51,-10,34
FC Sion,4365,9,7,9,16,40,53,-13,30
Young Boys,4366,1,21,9,2,72,33,39,72
FC Basel,4366,2,19,8,5,59,24,35,65
Lucerne,4366,3,13,8,11,41,48,-7,47
St Gallen,4366,4,15,2,15,44,54,-10,47
FC Zürich,4366,5,12,9,11,42,35,7,45
FC Thun,4366,6,10,5,17,44,58,-14,35
FC Lugano,4366,7,10,5,17,32,50,-18,35
Grasshoppers,4366,8,9,7,16,41,51,-10,34
FC Sion,4366,9,5,7,20,41,63,-22,22
Young Boys,4367,1,22,8,2,73,34,39,74
FC Basel,4367,2,17,9,6,54,27,27,60
St Gallen,4367,3,15,2,15,43,55,-12,47
FC Zürich,4367,4,12,10,10,48,36,12,46
Lucerne,4367,5,11,8,13,39,45,-6,41
Grasshoppers,4367,6,9,8,15,42,50,-8,35
FC Lugano,4367,7,10,5,17,30,49,-19,35
FC Thun,4367,8,9,7,16,44,60,-16,34
FC Sion,4367,9,6,9,17,41,58,-17,27
Young Boys,4368,1,21,7,4,70,39,31,70
FC Basel,4368,2,16,10,6,51,25,26,58
St Gallen,4368,3,15,2,15,45,57,-12,47
FC Zürich,4368,4,11,11,10,41,35,6,44
Lucerne,4368,5,12,8,12,40,44,-4,44
Grasshoppers,4368,6,10,6,16,43,52,-9,36
FC Lugano,4368,7,10,6,16,30,46,-16,36
FC Sion,4368,8,8,9,15,49,54,-5,33
FC Thun,4368,9,8,7,17,46,63,-17,31
Young Boys,4369,1,23,6,3,72,35,37,75
FC Basel,4369,2,16,9,7,53,29,24,57
Lucerne,4369,3,12,9,11,40,42,-2,45
St Gallen,4369,4,14,3,15,43,55,-12,45
FC Zürich,4369,5,11,10,11,42,38,4,43
FC Thun,4369,6,10,6,16,49,62,-13,36
FC Lugano,4369,7,10,5,17,32,49,-17,35
Grasshoppers,4369,8,9,7,16,41,51,-10,34
FC Sion,4369,9,8,7,17,44,55,-11,31
Young Boys,4370,1,23,6,3,77,32,45,75
FC Basel,4370,2,18,7,7,52,26,26,61
St Gallen,4370,3,17,2,13,45,50,-5,53
FC Zürich,4370,4,12,10,10,43,34,9,46
Lucerne,4370,5,11,8,13,38,46,-8,41
FC Lugano,4370,6,10,6,16,28,46,-18,36
Grasshoppers,4370,7,9,8,15,42,49,-7,35
FC Thun,4370,8,8,6,18,42,61,-19,30
FC Sion,4370,9,6,7,19,37,60,-23,25
Young Boys,4371,1,21,7,4,68,32,36,70
FC Basel,4371,2,19,8,5,56,24,32,65
St Gallen,4371,3,16,3,13,48,54,-6,51
Lucerne,4371,4,12,8,12,42,49,-7,44
FC Zürich,4371,5,10,9,13,41,41,0,39
FC Thun,4371,6,11,5,16,48,58,-10,38
Grasshoppers,4371,7,8,8,16,39,50,-11,32
FC Lugano,4371,8,9,5,18,28,50,-22,32
FC Sion,4371,9,8,7,17,44,56,-12,31
Young Boys,4372,1,22,8,2,74,34,40,74
FC Basel,4372,2,19,7,6,56,25,31,64
St Gallen,4372,3,14,2,16,41,59,-18,44
Lucerne,4372,4,11,8,13,40,46,-6,41
FC Zürich,4372,5,10,10,12,40,37,3,40
FC Lugano,4372,6,11,6,15,33,45,-12,39
Grasshoppers,4372,7,10,7,15,42,51,-9,37
FC Thun,4372,8,10,5,17,43,56,-13,35
FC Sion,4372,9,6,9,17,40,56,-16,27
Young Boys,4373,1,19,9,4,69,37,32,66
FC Basel,4373,2,18,9,5,55,24,31,63
St Gallen,4373,3,16,2,14,45,53,-8,50
Lucerne,4373,4,13,9,10,40,40,0,48
FC Zürich,4373,5,10,11,11,42,39,3,41
Grasshoppers,4373,6,10,6,16,45,53,-8,36
FC Thun,4373,7,10,5,17,43,56,-13,35
FC Lugano,4373,8,9,7,16,30,48,-18,34
FC Sion,4373,9,6,8,18,38,57,-19,26
Young Boys,4374,1,23,6,3,73,36,37,75
FC Basel,4374,2,18,8,6,56,28,28,62
Lucerne,4374,3,12,8,12,44,44,0,44
St Gallen,4374,4,14,2,16,41,60,-19,44
FC Zürich,4374,5,11,10,11,45,37,8,43
FC Lugano,4374,6,11,5,16,33,49,-16,38
FC Thun,4374,7,10,7,15,46,56,-10,37
Grasshoppers,4374,8,9,8,15,41,51,-10,35
FC Sion,4374,9,5,8,19,39,57,-18,23
Young Boys,4375,1,21,8,3,74,35,39,71
FC Basel,4375,2,17,8,7,55,30,25,59
St Gallen,4375,3,17,2,13,44,51,-7,53
FC Zürich,4375,4,12,9,11,46,36,10,45
Lucerne,4375,5,12,9,11,39,41,-2,45
Grasshoppers,4375,6,10,7,15,43,50,-7,37
FC Lugano,4375,7,9,6,17,29,49,-20,33
FC Thun,4375,8,9,5,18,42,64,-22,32
FC Sion,4375,9,6,8,18,40,56,-16,26
Young Boys,4376,1,20,8,4,68,35,33,68
FC Basel,4376,2,16,10,6,52,27,25,58
Lucerne,4376,3,14,9,9,42,40,2,51
St Gallen,4376,4,14,4,14,44,55,-11,46
FC Zürich,4376,5,10,12,10,40,35,5,42
Grasshoppers,4376,6,10,6,16,44,48,-4,36
FC Lugano,4376,7,10,5,17,30,47,-17,35
FC Thun,4376,8,9,6,17,45,64,-19,33
FC Sion,4376,9,6,10,16,42,56,-14,28
Young Boys,4377,1,22,8,2,78,33,45,74
FC Basel,4377,2,15,8,9,51,30,21,53
St Gallen,4377,3,16,2,14,43,55,-12,50
Lucerne,4377,4,14,7,11,43,44,-1,49
FC Zürich,4377,5,10,10,12,41,40,1,40
FC Thun,4377,6,11,6,15,49,57,-8,39
FC Lugano,4377,7,10,5,17,30,51,-21,35
Grasshoppers,4377,8,9,6,17,40,54,-14,33
FC Sion,4377,9,7,8,17,45,56,-11,29
Young Boys,4378,1,21,8,3,71,36,35,71
FC Basel,4378,2,17,10,5,53,24,29,61
St Gallen,4378,3,15,3,14,47,54,-7,48
Lucerne,4378,4,12,9,11,42,46,-4,45
FC Zürich,4378,5,9,12,11,40,39,1,39
Grasshoppers,4378,6,10,7,15,46,52,-6,37
FC Lugano,4378,7,9,8,15,31,48,-17,35
FC Thun,4378,8,9,6,17,46,62,-16,33
FC Sion,4378,9,5,11,16,40,55,-15,26
Young Boys,4379,1,24,6,2,75,32,43,78
FC Basel,4379,2,16,10,6,51,26,25,58
St Gallen,4379,3,15,4,13,44,51,-7,49
FC Zürich,4379,4,11,11,10,42,33,9,44
Lucerne,4379,5,12,8,12,40,44,-4,44
Grasshoppers,4379,6,9,8,15,40,49,-9,35
FC Lugano,4379,7,9,7,16,30,49,-19,34
FC Thun,4379,8,8,7,17,39,60,-21,31
FC Sion,4379,9,5,9,18,35,52,-17,24
Young Boys,4380,1,21,8,3,70,36,34,71
FC Basel,4380,2,17,10,5,57,27,30,61
St Gallen,4380,3,14,4,14,43,56,-13,46
Lucerne,4380,4,11,10,11,42,46,-4,43
FC Lugano,4380,5,12,5,15,38,46,-8,41
FC Zürich,4380,6,10,10,12,40,40,0,40
Grasshoppers,4380,7,10,8,14,42,47,-5,38
FC Thun,4380,8,9,7,16,44,60,-16,34
FC Sion,4380,9,5,8,19,37,55,-18,23
Young Boys,4381,1,22,6,4,78,40,38,72
FC Basel,4381,2,17,8,7,50,24,26,59
Lucerne,4381,3,15,8,9,53,45,8,53
FC Zürich,4381,4,12,10,10,41,33,8,46
St Gallen,4381,5,13,4,15,44,62,-18,43
Grasshoppers,4381,6,9,7,16,41,50,-9,34
FC Lugano,4381,7,9,6,17,30,52,-22,33
FC Thun,4381,8,9,5,18,42,61,-19,32
FC Sion,4381,9,7,8,17,44,56,-12,29
Young Boys,4382,1,21,7,4,71,35,36,70
FC Basel,4382,2,18,8,6,58,25,33,62
Lucerne,4382,3,13,9,10,41,44,-3,48
St Gallen,4382,4,14,3,15,43,55,-12,45
FC Zürich,4382,5,11,11,10,39,33,6,44
Grasshoppers,4382,6,10,7,15,42,50,-8,37
FC Thun,4382,7,9,6,17,46,62,-16,33
FC Lugano,4382,8,9,6,17,31,52,-21,33
FC Sion,4382,9,6,9,17,39,54,-15,27
Young Boys,4383,1,21,8,3,70,36,34,71
FC Basel,4383,2,17,10,5,54,26,28,61
Lucerne,4383,3,13,8,11,43,43,0,47
FC Zürich,4383,4,12,10,10,44,34,10,46
St Gallen,4383,5,14,3,15,42,55,-13,45
Grasshoppers,4383,6,9,8,15,41,49,-8,35
FC Thun,4383,7,9,7,16,41,57,-16,34
FC Lugano,4383,8,9,7,16,30,47,-17,34
FC Sion,4383,9,6,7,19,37,55,-18,25
Young Boys,4384,1,21,7,4,70,36,34,70
FC Basel,4384,2,20,7,5,61,24,37,67
St Gallen,4384,3,15,2,15,45,56,-11,47
Lucerne,4384,4,13,7,12,48,48,0,46
FC Zürich,4384,5,12,9,11,44,38,6,45
FC Lugano,4384,6,10,5,17,30,49,-19,35
Grasshoppers,4384,7,8,8,16,40,56,-16,32
FC Thun,4384,8,9,5,18,43,62,-19,32
FC Sion,4384,9,7,8,17,42,54,-12,29
Young Boys,4385,1,22,7,3,72,34,38,73
FC Basel,4385,2,17,8,7,54,28,26,59
St Gallen,4385,3,15,3,14,46,53,-7,48
Lucerne,4385,4,12,8,12,41,46,-5,44
FC Zürich,4385,5,11,10,11,47,39,8,43
Grasshoppers,4385,6,10,7,15,41,49,-8,37
FC Lugano,4385,7,10,6,16,32,49,-17,36
FC Thun,4385,8,9,5,18,42,62,-20,32
FC Sion,4385,9,7,8,17,42,57,-15,29
Young Boys,4386,1,22,7,3,74,36,38,73
FC Basel,4386,2,19,8,5,59,22,37,65
Lucerne,4386,3,13,8,11,43,48,-5,47
St Gallen,4386,4,13,4,15,45,60,-15,43
FC Zürich,4386,5,10,11,11,40,36,4,41
FC Lugano,4386,6,11,5,16,33,51,-18,38
Grasshoppers,4386,7,8,9,15,40,50,-10,33
FC Thun,4386,8,8,7,17,42,59,-17,31
FC Sion,4386,9,5,11,16,43,57,-14,26
Young Boys,4387,1,21,9,2,77,38,39,72
FC Basel,4387,2,17,9,6,59,30,29,60
Lucerne,4387,3,13,8,11,46,49,-3,47
St Gallen,4387,4,14,3,15,44,58,-14,45
FC Zürich,4387,5,11,10,11,49,38,11,43
FC Thun,4387,6,10,6,16,48,60,-12,36
FC Lugano,4387,7,10,6,16,33,49,-16,36
Grasshoppers,4387,8,8,7,17,41,54,-13,31
FC Sion,4387,9,7,8,17,41,62,-21,29
Young Boys,4388,1,22,6,4,70,32,38,72
FC Basel,4388,2,17,8,7,57,28,29,59
FC Zürich,4388,3,12,9,11,44,37,7,45
St Gallen,4388,4,14,3,15,43,56,-13,45
Lucerne,4388,5,12,8,12,38,49,-11,44
FC Lugano,4388,6,12,5,15,31,44,-13,41
Grasshoppers,4388,7,9,7,16,38,47,-9,34
FC Thun,4388,8,9,7,16,46,62,-16,34
FC Sion,4388,9,7,7,18,42,54,-12,28
Young Boys,4389,1,22,7,3,72,34,38,73
FC Basel,4389,2,18,7,7,56,26,30,61
St Gallen,4389,3,16,2,14,46,53,-7,50
Lucerne,4389,4,13,8,11,40,43,-3,47
FC Zürich,4389,5,9,12,11,39,36,3,39
Grasshoppers,4389,6,10,6,16,44,53,-9,36
FC Thun,4389,7,10,6,16,45,59,-14,36
FC Lugano,4389,8,9,6,17,30,50,-20,33
FC Sion,4389,9,6,8,18,38,56,-18,26
Young Boys,4390,1,22,6,4,78,38,40,72
FC Basel,4390,2,19,7,6,54,24,30,64
FC Zürich,4390,3,12,9,11,42,34,8,45
Lucerne,4390,4,12,9,11,41,45,-4,45
St Gallen,4390,5,13,3,16,39,53,-14,42
FC Lugano,4390,6,11,5,16,33,49,-16,38
Grasshoppers,4390,7,9,8,15,41,51,-10,35
FC Thun,4390,8,9,6,17,42,57,-15,33
FC Sion,4390,9,7,7,18,39,58,-19,28
Young Boys,4391,1,22,6,4,71,34,37,72
FC Basel,4391,2,19,7,6,58,26,32,64
Lucerne,4391,3,13,8,11,48,45,3,47
St Gallen,4391,4,14,3,15,43,59,-16,45
FC Zürich,4391,5,10,11,11,40,36,4,41
Grasshoppers,4391,6,9,7,16,43,51,-8,34
FC Thun,4391,7,9,7,16,43,61,-18,34
FC Lugano,4391,8,9,7,16,29,47,-18,34
FC Sion,4391,9,6,10,16,43,59,-16,28
Young Boys,4392,1,20,6,6,66,40,26,66
FC Basel,4392,2,19,8,5,60,25,35,65
Lucerne,4392,3,14,8,10,45,41,4,50
St Gallen,4392,4,14,2,16,44,58,-14,44
FC Zürich,4392,5,10,11,11,43,40,3,41
FC Lugano,4392,6,11,6,15,32,47,-15,39
FC Thun,4392,7,11,5,16,47,57,-10,38
Grasshoppers,4392,8,10,7,15,40,46,-6,37
FC Sion,4392,9,5,7,20,36,59,-23,22
Young Boys,4393,1,23,6,3,72,33,39,75
FC Basel,4393,2,17,7,8,57,28,29,58
St Gallen,4393,3,16,2,14,45,52,-7,50
Lucerne,4393,4,13,7,12,39,44,-5,46
FC Zürich,4393,5,11,10,11,43,38,5,43
FC Lugano,4393,6,11,5,16,32,47,-15,38
Grasshoppers,4393,7,9,8,15,42,49,-7,35
FC Thun,4393,8,9,6,17,43,64,-21,33
FC Sion,4393,9,5,9,18,40,58,-18,24
Young Boys,4394,1,20,9,3,73,40,33,69
FC Basel,4394,2,18,8,6,52,26,26,62
Lucerne,4394,3,15,8,9,50,41,9,53
St Gallen,4394,4,14,2,16,45,62,-17,44
FC Zürich,4394,5,11,9,12,42,37,5,42
FC Thun,4394,6,11,5,16,48,57,-9,38
FC Lugano,4394,7,10,5,17,36,55,-19,35
Grasshoppers,4394,8,9,6,17,43,53,-10,33
FC Sion,4394,9,6,8,18,41,59,-18,26
Young Boys,4395,1,22,6,4,70,34,36,72
FC Basel,4395,2,20,7,5,57,23,34,67
Lucerne,4395,3,13,7,12,43,48,-5,46
St Gallen,4395,4,14,3,15,43,56,-13,45
FC Zürich,4395,5,11,9,12,43,38,5,42
Grasshoppers,4395,6,10,7,15,42,49,-7,37
FC Lugano,4395,7,10,5,17,33,50,-17,35
FC Thun,4395,8,9,5,18,42,61,-19,32
FC Sion,4395,9,6,9,17,40,54,-14,27
Young Boys,4396,1,22,7,3,72,34,38,73
FC Basel,4396,2,16,11,5,51,24,27,59
Lucerne,4396,3,12,8,12,41,44,-3,44
St Gallen,4396,4,14,2,16,41,57,-16,44
FC Zürich,4396,5,10,11,11,40,36,4,41
Grasshoppers,4396,6,10,6,16,42,50,-8,36
FC Thun,4396,7,10,6,16,47,60,-13,36
FC Lugano,4396,8,10,6,16,30,48,-18,36
FC Sion,4396,9,8,7,17,45,56,-11,31
Young Boys,4397,1,23,6,3,73,33,40,75
FC Basel,4397,2,19,8,5,61,25,36,65
Lucerne,4397,3,12,10,10,41,40,1,46
St Gallen,4397,4,13,4,15,42,56,-14,43
FC Zürich,4397,5,11,9,12,40,38,2,42
FC Lugano,4397,6,11,6,15,33,48,-15,39
Grasshoppers,4397,7,9,7,16,42,51,-9,34
FC Thun,4397,8,8,6,18,41,62,-21,30
FC Sion,4397,9,6,8,18,37,57,-20,26
Young Boys,4398,1,20,7,5,69,40,29,67
FC Basel,4398,2,18,9,5,57,25,32,63
Lucerne,4398,3,13,7,12,45,48,-3,46
St Gallen,4398,4,14,3,15,44,59,-15,45
FC Lugano,4398,5,12,6,14,39,44,-5,42
FC Zürich,4398,6,9,10,13,38,41,-3,37
Grasshoppers,4398,7,10,6,16,41,48,-7,36
FC Thun,4398,8,10,5,17,45,57,-12,35
FC Sion,4398,9,8,7,17,40,56,-16,31
Young Boys,4399,1,23,7,2,73,33,40,76
FC Basel,4399,2,16,8,8,49,29,20,56
FC Zürich,4399,3,12,10,10,41,33,8,46
Lucerne,4399,4,12,9,11,42,45,-3,45
St Gallen,4399,5,14,3,15,43,55,-12,45
FC Lugano,4399,6,10,7,15,33,48,-15,37
FC Thun,4399,7,9,7,16,42,56,-14,34
Grasshoppers,4399,8,8,8,16,38,50,-12,32
FC Sion,4399,9,6,9,17,40,52,-12,27
Young Boys,4400,1,20,7,5,68,38,30,67
FC Basel,4400,2,18,7,7,53,24,29,61
Lucerne,4400,3,15,8,9,45,40,5,53
St Gallen,4400,4,14,3,15,45,58,-13,45
FC Zürich,4400,5,10,9,13,40,37,3,39
FC Thun,4400,6,11,5,16,43,56,-13,38
FC Lugano,4400,7,11,5,16,34,50,-16,38
Grasshoppers,4400,8,9,6,17,38,49,-11,33
FC Sion,4400,9,7,8,17,39,53,-14,29
Young Boys,4401,1,23,6,3,75,35,40,75
FC Basel,4401,2,17,7,8,51,27,24,58
St Gallen,4401,3,16,2,14,47,52,-5,50
Lucerne,4401,4,13,8,11,41,43,-2,47
FC Zürich,4401,5,12,10,10,41,33,8,46
FC Lugano,4401,6,10,6,16,29,45,-16,36
FC Thun,4401,7,8,8,16,40,56,-16,32
Grasshoppers,4401,8,8,7,17,39,52,-13,31
FC Sion,4401,9,6,8,18,39,59,-20,26
Young Boys,4402,1,21,7,4,69,34,35,70
FC Basel,4402,2,17,8,7,50,25,25,59
St Gallen,4402,3,16,3,13,49,53,-4,51
Lucerne,4402,4,13,8,11,44,45,-1,47
FC Zürich,4402,5,12,9,11,43,35,8,45
FC Thun,4402,6,11,6,15,46,55,-9,39
FC Lugano,4402,7,9,7,16,29,49,-20,34
Grasshoppers,4402,8,9,6,17,38,51,-13,33
FC Sion,4402,9,5,8,19,37,58,-21,23
Young Boys,4403,1,22,6,4,76,39,37,72
FC Basel,4403,2,17,7,8,50,30,20,58
Lucerne,4403,3,12,10,10,45,44,1,46
St Gallen,4403,4,14,4,14,42,53,-11,46
FC Zürich,4403,5,12,9,11,43,37,6,45
Grasshoppers,4403,6,11,7,14,45,49,-4,40
FC Lugano,4403,7,11,6,15,35,46,-11,39
FC Thun,4403,8,9,5,18,41,60,-19,32
FC Sion,4403,9,5,8,19,38,57,-19,23
Young Boys,4404,1,23,6,3,74,33,41,75
FC Basel,4404,2,18,7,7,56,25,31,61
Lucerne,4404,3,13,8,11,43,47,-4,47
FC Zürich,4404,4,11,9,12,40,36,4,42
FC Lugano,4404,5,12,5,15,31,46,-15,41
St Gallen,4404,6,13,2,17,42,58,-16,41
FC Thun,4404,7,10,5,17,46,60,-14,35
Grasshoppers,4404,8,8,8,16,40,53,-13,32
FC Sion,4404,9,7,8,17,43,57,-14,29
Young Boys,4405,1,23,6,3,80,37,43,75
FC Basel,4405,2,18,9,5,53,25,28,63
Lucerne,4405,3,12,8,12,41,45,-4,44
St Gallen,4405,4,13,4,15,40,55,-15,43
FC Zürich,4405,5,10,11,11,41,37,4,41
FC Lugano,4405,6,10,7,15,30,47,-17,37
FC Thun,4405,7,10,6,16,45,59,-14,36
Grasshoppers,4405,8,8,7,17,41,54,-13,31
FC Sion,4405,9,7,8,17,45,57,-12,29
Young Boys,4406,1,23,6,3,78,35,43,75
FC Basel,4406,2,17,9,6,51,25,26,60
Lucerne,4406,3,12,10,10,40,40,0,46
St Gallen,4406,4,14,4,14,40,52,-12,46
FC Zürich,4406,5,10,9,13,39,37,2,39
FC Thun,4406,6,10,6,16,45,56,-11,36
FC Lugano,4406,7,10,6,16,29,49,-20,36
FC Sion,4406,8,8,7,17,43,57,-14,31
Grasshoppers,4406,9,8,7,17,42,56,-14,31
Young Boys,4407,1,21,9,2,69,33,36,72
FC Basel,4407,2,16,9,7,54,28,26,57
St Gallen,4407,3,14,4,14,43,53,-10,46
Lucerne,4407,4,11,11,10,42,44,-2,44
FC Zürich,4407,5,10,10,12,42,39,3,40
FC Lugano,4407,6,10,7,15,32,47,-15,37
Grasshoppers,4407,7,9,8,15,40,47,-7,35
FC Thun,4407,8,10,5,17,45,63,-18,35
FC Sion,4407,9,7,9,16,40,53,-13,30
Young Boys,4408,1,21,6,5,68,37,31,69
FC Basel,4408,2,19,8,5,59,24,35,65
St Gallen,4408,3,15,3,14,45,53,-8,48
Lucerne,4408,4,12,8,12,40,48,-8,44
FC Zürich,4408,5,11,9,12,42,38,4,42
FC Thun,4408,6,11,6,15,53,57,-4,39
FC Lugano,4408,7,10,6,16,31,48,-17,36
Grasshoppers,4408,8,8,7,17,38,54,-16,31
FC Sion,4408,9,7,7,18,41,58,-17,28
Young Boys,4409,1,22,6,4,72,35,37,72
FC Basel,4409,2,17,8,7,51,26,25,59
Lucerne,4409,3,14,9,9,42,40,2,51
St Gallen,4409,4,15,3,14,43,53,-10,48
FC Zürich,4409,5,10,9,13,39,38,1,39
FC Lugano,4409,6,11,5,16,33,46,-13,38
FC Thun,4409,7,10,5,17,42,55,-13,35
Grasshoppers,4409,8,9,6,17,38,50,-12,33
FC Sion,4409,9,7,7,18,38,55,-17,28
Young Boys,4410,1,21,6,5,74,37,37,69
FC Basel,4410,2,19,7,6,52,24,28,64
St Gallen,4410,3,15,3,14,43,52,-9,48
Lucerne,4410,4,11,9,12,38,46,-8,42
FC Zürich,4410,5,10,11,11,39,36,3,41
FC Thun,4410,6,10,6,16,47,56,-9,36
FC Lugano,4410,7,10,6,16,30,46,-16,36
Grasshoppers,4410,8,9,7,16,38,50,-12,34
FC Sion,4410,9,7,9,16,42,56,-14,30
Young Boys,4411,1,22,6,4,69,35,34,72
FC Basel,4411,2,19,7,6,59,28,31,64
FC Zürich,4411,3,12,10,10,45,38,7,46
St Gallen,4411,4,14,2,16,44,57,-13,44
FC Lugano,4411,5,12,5,15,34,46,-12,41
Lucerne,4411,6,11,7,14,38,47,-9,40
Grasshoppers,4411,7,10,7,15,40,46,-6,37
FC Thun,4411,8,8,7,17,46,64,-18,31
FC Sion,4411,9,7,7,18,42,56,-14,28
Young Boys,4412,1,21,8,3,71,33,38,71
FC Basel,4412,2,17,9,6,56,25,31,60
Lucerne,4412,3,14,8,10,44,40,4,50
St Gallen,4412,4,14,4,14,47,58,-11,46
FC Zürich,4412,5,10,10,12,37,36,1,40
Grasshoppers,4412,6,9,8,15,39,48,-9,35
FC Thun,4412,7,9,6,17,41,61,-20,33
FC Lugano,4412,8,9,6,17,30,53,-23,33
FC Sion,4412,9,7,9,16,40,51,-11,30
Young Boys,4413,1,22,7,3,75,36,39,73
FC Basel,4413,2,18,9,5,55,24,31,63
Lucerne,4413,3,14,7,11,44,43,1,49
St Gallen,4413,4,14,4,14,43,53,-10,46
FC Zürich,4413,5,10,10,12,42,42,0,40
FC Thun,4413,6,9,7,16,45,62,-17,34
FC Lugano,4413,7,9,7,16,31,48,-17,34
Grasshoppers,4413,8,8,7,17,38,51,-13,31
FC Sion,4413,9,7,8,17,44,58,-14,29
Young Boys,4414,1,20,8,4,72,39,33,68
FC Basel,4414,2,20,7,5,56,25,31,67
Lucerne,4414,3,13,8,11,44,44,0,47
St Gallen,4414,4,14,4,14,42,53,-11,46
Grasshoppers,4414,5,11,6,15,48,53,-5,39
FC Zürich,4414,6,9,10,13,38,39,-1,37
FC Thun,4414,7,10,5,17,45,60,-15,35
FC Lugano,4414,8,9,7,16,29,46,-17,34
FC Sion,4414,9,6,9,17,40,55,-15,27
Young Boys,4415,1,21,6,5,72,36,36,69
FC Basel,4415,2,17,8,7,54,27,27,59
St Gallen,4415,3,15,3,14,45,53,-8,48
Lucerne,4415,4,12,9,11,43,48,-5,45
FC Zürich,4415,5,11,9,12,41,36,5,42
Grasshoppers,4415,6,11,7,14,43,47,-4,40
FC Lugano,4415,7,11,6,15,32,47,-15,39
FC Thun,4415,8,10,5,17,42,59,-17,35
FC Sion,4415,9,6,7,19,37,56,-19,25
Young Boys,4416,1,21,8,3,68,32,36,71
FC Basel,4416,2,16,8,8,50,27,23,56
Lucerne,4416,3,13,9,10,44,39,5,48
St Gallen,4416,4,15,2,15,41,52,-11,47
FC Zürich,4416,5,10,12,10,41,36,5,42
FC Thun,4416,6,11,6,15,45,55,-10,39
Grasshoppers,4416,7,8,9,15,38,47,-9,33
FC Lugano,4416,8,9,6,17,29,54,-25,33
FC Sion,4416,9,7,8,17,41,55,-14,29
Young Boys,4417,1,21,7,4,69,35,34,70
FC Basel,4417,2,18,8,6,55,25,30,62
St Gallen,4417,3,14,4,14,40,52,-12,46
Lucerne,4417,4,12,8,12,42,46,-4,44
FC Zürich,4417,5,10,11,11,40,35,5,41
Grasshoppers,4417,6,10,7,15,40,48,-8,37
FC Lugano,4417,7,10,7,15,30,45,-15,37
FC Thun,4417,8,9,5,18,42,62,-20,32
FC Sion,4417,9,7,9,16,41,51,-10,30
Young Boys,4418,1,20,7,5,69,38,31,67
FC Basel,4418,2,15,10,7,50,29,21,55
Lucerne,4418,3,14,9,9,45,42,3,51
St Gallen,4418,4,15,2,15,50,59,-9,47
FC Zürich,4418,5,11,11,10,43,37,6,44
Grasshoppers,4418,6,11,7,14,45,49,-4,40
FC Lugano,4418,7,10,6,16,33,49,-16,36
FC Thun,4418,8,8,7,17,42,59,-17,31
FC Sion,4418,9,7,7,18,45,60,-15,28
Young Boys,4419,1,22,6,4,73,35,38,72
FC Basel,4419,2,17,8,7,52,28,24,59
Lucerne,4419,3,14,7,11,43,43,0,49
St Gallen,4419,4,15,2,15,41,52,-11,47
FC Zürich,4419,5,11,10,11,41,35,6,43
FC Lugano,4419,6,11,5,16,32,47,-15,38
FC Thun,4419,7,9,6,17,45,61,-16,33
Grasshoppers,4419,8,8,8,16,41,54,-13,32
FC Sion,4419,9,7,8,17,40,53,-13,29
Young Boys,4420,1,23,7,2,72,30,42,76
FC Basel,4420,2,19,7,6,55,26,29,64
FC Zürich,4420,3,12,9,11,44,36,8,45
Lucerne,4420,4,12,8,12,41,48,-7,44
St Gallen,4420,5,13,4,15,43,56,-13,43
FC Lugano,4420,6,10,6,16,32,48,-16,36
FC Thun,4420,7,10,5,17,47,57,-10,35
Grasshoppers,4420,8,9,7,16,41,53,-12,34
FC Sion,4420,9,6,7,19,39,60,-21,25
Young Boys,4421,1,21,7,4,74,41,33,70
FC Basel,4421,2,19,7,6,60,25,35,64
Lucerne,4421,3,15,7,10,46,40,6,52
St Gallen,4421,4,14,2,16,44,59,-15,44
FC Zürich,4421,5,10,9,13,38,36,2,39
FC Thun,4421,6,11,5,16,44,58,-14,38
Grasshoppers,4421,7,9,6,17,41,53,-12,33
FC Lugano,4421,8,9,6,17,29,50,-21,33
FC Sion,4421,9,8,7,17,43,57,-14,31
Young Boys,4422,1,22,7,3,79,35,44,73
FC Basel,4422,2,18,8,6,56,27,29,62
Lucerne,4422,3,13,8,11,39,44,-5,47
St Gallen,4422,4,13,4,15,41,55,-14,43
FC Zürich,4422,5,10,12,10,42,35,7,42
FC Lugano,4422,6,9,8,15,29,49,-20,35
FC Thun,4422,7,9,7,16,43,58,-15,34
Grasshoppers,4422,8,8,8,16,42,54,-12,32
FC Sion,4422,9,6,10,16,42,56,-14,28
Young Boys,4423,1,22,7,3,70,33,37,73
FC Basel,4423,2,18,8,6,53,26,27,62
Lucerne,4423,3,14,7,11,46,44,2,49
St Gallen,4423,4,14,3,15,43,55,-12,45
FC Zürich,4423,5,11,10,11,41,35,6,43
Grasshoppers,4423,6,10,7,15,43,51,-8,37
FC Lugano,4423,7,10,6,16,30,48,-18,36
FC Thun,4423,8,9,5,18,44,59,-15,32
FC Sion,4423,9,5,9,18,39,58,-19,24
Young Boys,4424,1,22,7,3,72,35,37,73
FC Basel,4424,2,17,10,5,53,25,28,61
Lucerne,4424,3,13,8,11,44,44,0,47
St Gallen,4424,4,14,2,16,42,57,-15,44
FC Lugano,4424,5,12,6,14,32,44,-12,42
FC Zürich,4424,6,9,11,12,40,38,2,38
FC Thun,4424,7,9,8,15,45,59,-14,35
Grasshoppers,4424,8,9,7,16,43,49,-6,34
FC Sion,4424,9,5,9,18,36,56,-20,24
Young Boys,4425,1,22,7,3,75,37,38,73
FC Basel,4425,2,18,8,6,55,29,26,62
St Gallen,4425,3,15,2,15,47,58,-11,47
Lucerne,4425,4,12,8,12,42,49,-7,44
FC Zürich,4425,5,10,9,13,43,39,4,39
Grasshoppers,4425,6,11,6,15,43,47,-4,39
FC Lugano,4425,7,11,6,15,37,49,-12,39
FC Thun,4425,8,10,6,16,46,59,-13,36
FC Sion,4425,9,5,8,19,37,58,-21,23
Young Boys,4426,1,20,8,4,70,38,32,68
FC Basel,4426,2,18,7,7,54,27,27,61
Lucerne,4426,3,13,9,10,45,46,-1,48
St Gallen,4426,4,14,3,15,43,58,-15,45
FC Zürich,4426,5,11,9,12,42,40,2,42
FC Lugano,4426,6,11,6,15,35,45,-10,39
Grasshoppers,4426,7,10,7,15,44,50,-6,37
FC Sion,4426,8,8,7,17,44,53,-9,31
FC Thun,4426,9,8,6,18,42,62,-20,30
Young Boys,4427,1,22,7,3,74,38,36,73
FC Basel,4427,2,18,9,5,57,26,31,63
St Gallen,4427,3,14,3,15,42,53,-11,45
FC Zürich,4427,4,11,11,10,43,34,9,44
Lucerne,4427,5,11,10,11,43,50,-7,43
Grasshoppers,4427,6,8,10,14,42,50,-8,34
FC Thun,4427,7,9,7,16,40,56,-16,34
FC Lugano,4427,8,9,7,16,29,47,-18,34
FC Sion,4427,9,6,8,18,38,54,-16,26
Young Boys,4428,1,22,6,4,72,33,39,72
FC Basel,4428,2,18,7,7,53,25,28,61
Lucerne,4428,3,15,7,10,44,41,3,52
St Gallen,4428,4,14,3,15,44,54,-10,45
FC Zürich,4428,5,11,11,10,40,34,6,44
FC Lugano,4428,6,10,7,15,32,47,-15,37
FC Thun,4428,7,9,5,18,43,57,-14,32
Grasshoppers,4428,8,8,7,17,39,55,-16,31
FC Sion,4428,9,6,9,17,37,58,-21,27
Young Boys,4429,1,20,9,3,70,34,36,69
FC Basel,4429,2,16,9,7,50,25,25,57
St Gallen,4429,3,15,3,14,43,54,-11,48
Lucerne,4429,4,13,8,11,46,47,-1,47
FC Lugano,4429,5,12,5,15,34,46,-12,41
FC Zürich,4429,6,10,10,12,39,36,3,40
FC Thun,4429,7,10,5,17,42,58,-16,35
Grasshoppers,4429,8,9,7,16,39,49,-10,34
FC Sion,4429,9,7,8,17,40,54,-14,29
Young Boys,4430,1,22,6,4,72,35,37,72
FC Basel,4430,2,19,7,6,55,26,29,64
Lucerne,4430,3,13,8,11,40,41,-1,47
St Gallen,4430,4,14,2,16,43,57,-14,44
FC Zürich,4430,5,11,9,12,40,36,4,42
FC Lugano,4430,6,11,6,15,32,46,-14,39
Grasshoppers,4430,7,10,7,15,40,48,-8,37
FC Sion,4430,8,7,8,17,46,56,-10,29
FC Thun,4430,9,8,5,19,40,63,-23,29
Young Boys,4431,1,21,9,2,70,34,36,72
FC Basel,4431,2,17,9,6,55,28,27,60
St Gallen,4431,3,16,2,14,46,56,-10,50
Lucerne,4431,4,12,10,10,41,43,-2,46
FC Zürich,4431,5,11,9,12,40,35,5,42
FC Thun,4431,6,10,6,16,46,59,-13,36
FC Lugano,4431,7,10,6,16,31,47,-16,36
Grasshoppers,4431,8,8,7,17,40,53,-13,31
FC Sion,4431,9,6,8,18,42,56,-14,26
Young Boys,4432,1,23,6,3,73,33,40,75
FC Basel,4432,2,18,7,7,53,27,26,61
St Gallen,4432,3,15,2,15,46,56,-10,47
FC Zürich,4432,4,11,10,11,40,34,6,43
Lucerne,4432,5,11,8,13,37,47,-10,41
FC Lugano,4432,6,11,6,15,30,43,-13,39
FC Thun,4432,7,10,6,16,45,54,-9,36
Grasshoppers,4432,8,9,8,15,38,46,-8,35
FC Sion,4432,9,6,7,19,39,61,-22,25
Young Boys,4433,1,21,8,3,74,37,37,71
FC Basel,4433,2,16,9,7,50,25,25,57
Lucerne,4433,3,14,9,9,45,43,2,51
St Gallen,4433,4,14,4,14,43,56,-13,46
FC Zürich,4433,5,10,11,11,42,38,4,41
FC Sion,4433,6,9,8,15,45,51,-6,35
FC Lugano,4433,7,10,5,17,31,49,-18,35
Grasshoppers,4433,8,8,7,17,39,52,-13,31
FC Thun,4433,9,8,7,17,42,60,-18,31
Young Boys,4434,1,20,7,5,70,39,31,67
FC Basel,4434,2,19,8,5,56,25,31,65
Lucerne,4434,3,15,7,10,46,44,2,52
St Gallen,4434,4,14,2,16,42,57,-15,44
FC Zürich,4434,5,10,10,12,42,39,3,40
FC Sion,4434,6,9,8,15,46,52,-6,35
FC Lugano,4434,7,10,5,17,33,50,-17,35
Grasshoppers,4434,8,8,8,16,41,51,-10,32
FC Thun,4434,9,8,7,17,45,64,-19,31
Young Boys,4435,1,21,7,4,73,38,35,70
FC Basel,4435,2,17,8,7,52,27,25,59
St Gallen,4435,3,16,2,14,44,53,-9,50
FC Zürich,4435,4,12,10,10,41,34,7,46
Lucerne,4435,5,11,7,14,42,49,-7,40
FC Lugano,4435,6,11,6,15,34,48,-14,39
FC Thun,4435,7,10,6,16,42,56,-14,36
Grasshoppers,4435,8,9,8,15,41,49,-8,35
FC Sion,4435,9,6,8,18,40,55,-15,26
Young Boys,4436,1,20,7,5,72,41,31,67
FC Basel,4436,2,15,9,8,51,29,22,54
Lucerne,4436,3,15,8,9,45,42,3,53
St Gallen,4436,4,14,2,16,44,58,-14,44
FC Zürich,4436,5,11,9,12,42,39,3,42
FC Thun,4436,6,11,6,15,47,55,-8,39
FC Lugano,4436,7,11,5,16,36,51,-15,38
FC Sion,4436,8,9,7,16,46,57,-11,34
Grasshoppers,4436,9,8,7,17,42,53,-11,31
Young Boys,4437,1,22,7,3,79,36,43,73
FC Basel,4437,2,17,8,7,58,28,30,59
St Gallen,4437,3,16,3,13,46,52,-6,51
Lucerne,4437,4,12,8,12,42,52,-10,44
FC Zürich,4437,5,11,10,11,47,38,9,43
FC Thun,4437,6,11,5,16,48,60,-12,38
Grasshoppers,4437,7,10,6,16,43,51,-8,36
FC Lugano,4437,8,10,6,16,33,48,-15,36
FC Sion,4437,9,5,7,20,38,69,-31,22
Young Boys,4438,1,20,8,4,70,38,32,68
FC Basel,4438,2,16,10,6,54,29,25,58
Lucerne,4438,3,14,8,10,43,40,3,50
St Gallen,4438,4,14,3,15,42,54,-12,45
FC Zürich,4438,5,10,11,11,41,38,3,41
Grasshoppers,4438,6,10,8,14,41,46,-5,38
FC Lugano,4438,7,10,7,15,33,48,-15,37
FC Thun,4438,8,10,6,16,44,57,-13,36
FC Sion,4438,9,5,9,18,35,53,-18,24
Young Boys,4439,1,22,7,3,70,32,38,73
FC Basel,4439,2,17,8,7,53,27,26,59
Lucerne,4439,3,13,8,11,41,45,-4,47
St Gallen,4439,4,14,3,15,46,57,-11,45
FC Thun,4439,5,11,6,15,44,56,-12,39
FC Lugano,4439,6,11,6,15,32,45,-13,39
FC Zürich,4439,7,9,11,12,40,40,0,38
Grasshoppers,4439,8,9,6,17,39,50,-11,33
FC Sion,4439,9,6,9,17,42,55,-13,27
Young Boys,4440,1,20,7,5,66,36,30,67
FC Basel,4440,2,18,8,6,54,25,29,62
St Gallen,4440,3,16,2,14,42,51,-9,50
Lucerne,4440,4,14,7,11,44,41,3,49
FC Lugano,4440,5,11,6,15,33,46,-13,39
FC Thun,4440,6,10,7,15,43,55,-12,37
FC Zürich,4440,7,9,9,14,38,41,-3,36
FC Sion,4440,8,8,7,17,40,50,-10,31
Grasshoppers,4440,9,8,7,17,38,53,-15,31
Young Boys,4441,1,21,8,3,74,37,37,71
FC Basel,4441,2,18,8,6,57,26,31,62
FC Zürich,4441,3,13,9,10,44,34,10,48
St Gallen,4441,4,14,4,14,43,54,-11,46
Lucerne,4441,5,12,7,13,40,45,-5,43
Grasshoppers,4441,6,9,8,15,39,49,-10,35
FC Lugano,4441,7,9,7,16,32,50,-18,34
FC Thun,4441,8,9,6,17,42,60,-18,33
FC Sion,4441,9,6,9,17,39,55,-16,27
Young Boys,4442,1,22,7,3,75,36,39,73
FC Basel,4442,2,16,7,9,51,28,23,55
Lucerne,4442,3,15,7,10,46,43,3,52
St Gallen,4442,4,13,4,15,40,55,-15,43
FC Zürich,4442,5,11,9,12,39,34,5,42
FC Lugano,4442,6,11,6,15,32,47,-15,39
FC Thun,4442,7,11,5,16,43,56,-13,38
Grasshoppers,4442,8,10,6,16,43,52,-9,36
FC Sion,4442,9,5,9,18,39,57,-18,24
Young Boys,4443,1,21,8,3,71,33,38,71
FC Basel,4443,2,19,7,6,56,25,31,64
Lucerne,4443,3,13,9,10,43,43,0,48
FC Zürich,4443,4,12,9,11,41,34,7,45
St Gallen,4443,5,14,2,16,40,60,-20,44
Grasshoppers,4443,6,9,7,16,41,53,-12,34
FC Lugano,4443,7,9,6,17,29,50,-21,33
FC Thun,4443,8,9,5,18,45,61,-16,32
FC Sion,4443,9,8,7,17,49,56,-7,31
Young Boys,4444,1,22,8,2,71,34,37,74
FC Basel,4444,2,17,8,7,54,26,28,59
FC Zürich,4444,3,13,9,10,42,34,8,48
Lucerne,4444,4,11,10,11,40,45,-5,43
St Gallen,4444,5,13,4,15,45,60,-15,43
Grasshoppers,4444,6,11,6,15,46,49,-3,39
FC Lugano,4444,7,10,6,16,33,49,-16,36
FC Thun,4444,8,9,5,18,42,60,-18,32
FC Sion,4444,9,6,8,18,41,57,-16,26
Young Boys,4445,1,20,9,3,71,36,35,69
FC Basel,4445,2,17,9,6,53,26,27,60
St Gallen,4445,3,16,2,14,45,53,-8,50
Lucerne,4445,4,12,8,12,39,44,-5,44
FC Zürich,4445,5,10,12,10,40,35,5,42
FC Thun,4445,6,9,8,15,46,60,-14,35
FC Lugano,4445,7,10,5,17,31,49,-18,35
Grasshoppers,4445,8,8,8,16,43,53,-10,32
FC Sion,4445,9,6,11,15,41,53,-12,29
Young Boys,4446,1,22,7,3,76,35,41,73
FC Basel,4446,2,18,7,7,57,27,30,61
Lucerne,4446,3,13,8,11,40,43,-3,47
St Gallen,4446,4,14,2,16,43,61,-18,44
FC Zürich,4446,5,11,10,11,40,34,6,43
FC Thun,4446,6,11,6,15,45,55,-10,39
FC Lugano,4446,7,11,5,16,34,50,-16,38
Grasshoppers,4446,8,9,6,17,41,53,-12,33
FC Sion,4446,9,6,7,19,42,60,-18,25
Young Boys,4447,1,21,7,4,69,38,31,70
FC Basel,4447,2,19,7,6,59,25,34,64
Lucerne,4447,3,14,7,11,44,44,0,49
St Gallen,4447,4,14,3,15,42,55,-13,45
FC Zürich,4447,5,11,11,10,43,35,8,44
FC Thun,4447,6,10,6,16,43,59,-16,36
FC Lugano,4447,7,10,6,16,32,48,-16,36
Grasshoppers,4447,8,8,8,16,39,49,-10,32
FC Sion,4447,9,5,9,18,39,57,-18,24
Young Boys,4448,1,23,7,2,73,31,42,76
FC Basel,4448,2,19,7,6,58,25,33,64
Lucerne,4448,3,13,9,10,43,47,-4,48
St Gallen,4448,4,14,3,15,43,54,-11,45
FC Zürich,4448,5,9,11,12,38,37,1,38
FC Lugano,4448,6,10,6,16,29,47,-18,36
FC Thun,4448,7,9,7,16,43,59,-16,34
Grasshoppers,4448,8,8,8,16,42,52,-10,32
FC Sion,4448,9,6,8,18,40,57,-17,26
Young Boys,4449,1,20,7,5,69,37,32,67
FC Basel,4449,2,20,7,5,55,24,31,67
St Gallen,4449,3,14,2,16,42,56,-14,44
Lucerne,4449,4,12,7,13,40,46,-6,43
FC Lugano,4449,5,12,6,14,35,47,-12,42
FC Zürich,4449,6,9,11,12,40,38,2,38
Grasshoppers,4449,7,9,8,15,41,48,-7,35
FC Thun,4449,8,9,7,16,46,61,-15,34
FC Sion,4449,9,7,9,16,43,54,-11,30
Young Boys,4450,1,21,7,4,70,35,35,70
FC Basel,4450,2,17,9,6,55,28,27,60
St Gallen,4450,3,16,2,14,46,53,-7,50
Lucerne,4450,4,14,7,11,46,43,3,49
FC Zürich,4450,5,11,9,12,40,35,5,42
FC Lugano,4450,6,11,5,16,29,46,-17,38
FC Thun,4450,7,10,7,15,46,59,-13,37
Grasshoppers,4450,8,9,6,17,41,53,-12,33
FC Sion,4450,9,5,8,19,37,58,-21,23
Young Boys,4451,1,22,7,3,77,38,39,73
FC Basel,4451,2,17,8,7,52,29,23,59
Lucerne,4451,3,12,10,10,39,38,1,46
St Gallen,4451,4,14,4,14,43,55,-12,46
FC Zürich,4451,5,10,11,11,42,37,5,41
Grasshoppers,4451,6,10,7,15,43,48,-5,37
FC Thun,4451,7,9,6,17,43,60,-17,33
FC Lugano,4451,8,9,6,17,31,53,-22,33
FC Sion,4451,9,6,11,15,41,53,-12,29
Young Boys,4452,1,22,6,4,76,37,39,72
FC Basel,4452,2,17,7,8,51,27,24,58
St Gallen,4452,3,15,2,15,44,54,-10,47
Lucerne,4452,4,13,7,12,44,46,-2,46
FC Zürich,4452,5,12,9,11,41,36,5,45
FC Lugano,4452,6,11,5,16,34,48,-14,38
Grasshoppers,4452,7,10,6,16,40,52,-12,36
FC Thun,4452,8,10,5,17,44,58,-14,35
FC Sion,4452,9,7,7,18,40,56,-16,28
Young Boys,4453,1,20,8,4,71,37,34,68
FC Basel,4453,2,17,9,6,55,28,27,60
Lucerne,4453,3,14,7,11,47,46,1,49
FC Zürich,4453,4,12,10,10,43,35,8,46
St Gallen,4453,5,13,3,16,42,61,-19,42
FC Lugano,4453,6,11,6,15,34,47,-13,39
Grasshoppers,4453,7,9,8,15,41,50,-9,35
FC Thun,4453,8,8,7,17,41,60,-19,31
FC Sion,4453,9,7,8,17,45,55,-10,29
Young Boys,4454,1,22,7,3,72,32,40,73
FC Basel,4454,2,17,7,8,50,28,22,58
St Gallen,4454,3,15,2,15,44,57,-13,47
Lucerne,4454,4,13,7,12,42,46,-4,46
FC Zürich,4454,5,11,9,12,38,36,2,42
FC Thun,4454,6,11,5,16,49,56,-7,38
FC Lugano,4454,7,11,5,16,35,49,-14,38
Grasshoppers,4454,8,10,7,15,40,47,-7,37
FC Sion,4454,9,6,7,19,40,59,-19,25
Young Boys,4455,1,23,6,3,74,32,42,75
FC Basel,4455,2,17,8,7,55,29,26,59
St Gallen,4455,3,15,2,15,46,56,-10,47
FC Zürich,4455,4,10,12,10,39,34,5,42
Lucerne,4455,5,11,8,13,40,49,-9,41
FC Lugano,4455,6,11,5,16,31,48,-17,38
FC Thun,4455,7,10,6,16,42,56,-14,36
FC Sion,4455,8,8,8,16,39,51,-12,32
Grasshoppers,4455,9,8,7,17,38,49,-11,31
Young Boys,4456,1,21,9,2,68,32,36,72
FC Basel,4456,2,16,9,7,50,26,24,57
Lucerne,4456,3,14,8,10,43,43,0,50
St Gallen,4456,4,14,4,14,40,51,-11,46
FC Zürich,4456,5,10,11,11,40,36,4,41
FC Lugano,4456,6,10,7,15,32,46,-14,37
Grasshoppers,4456,7,9,7,16,41,49,-8,34
FC Thun,4456,8,9,5,18,43,61,-18,32
FC Sion,4456,9,7,8,17,39,52,-13,29
Young Boys,4457,1,22,6,4,72,37,35,72
FC Basel,4457,2,17,8,7,54,29,25,59
St Gallen,4457,3,17,2,13,43,49,-6,53
FC Zürich,4457,4,12,10,10,43,34,9,46
Lucerne,4457,5,11,10,11,41,45,-4,43
Grasshoppers,4457,6,10,7,15,46,53,-7,37
FC Lugano,4457,7,9,7,16,29,46,-17,34
FC Thun,4457,8,9,5,18,46,63,-17,32
FC Sion,4457,9,6,7,19,38,56,-18,25
Young Boys,4458,1,24,6,2,76,33,43,78
FC Basel,4458,2,16,8,8,52,29,23,56
St Gallen,4458,3,16,3,13,49,50,-1,51
FC Zürich,4458,4,12,10,10,43,34,9,46
Lucerne,4458,5,11,9,12,38,48,-10,42
Grasshoppers,4458,6,9,7,16,40,50,-10,34
FC Lugano,4458,7,9,7,16,29,46,-17,34
FC Thun,4458,8,9,5,18,40,58,-18,32
FC Sion,4458,9,7,7,18,41,60,-19,28
Young Boys,4459,1,21,7,4,71,39,32,70
FC Basel,4459,2,19,7,6,59,26,33,64
Lucerne,4459,3,13,8,11,46,47,-1,47
St Gallen,4459,4,15,2,15,44,56,-12,47
FC Zürich,4459,5,10,10,12,42,39,3,40
FC Lugano,4459,6,11,6,15,33,45,-12,39
Grasshoppers,4459,7,9,7,16,42,51,-9,34
FC Thun,4459,8,9,7,16,45,60,-15,34
FC Sion,4459,9,6,8,18,43,62,-19,26
Young Boys,4460,1,22,8,2,76,32,44,74
FC Basel,4460,2,18,8,6,52,25,27,62
St Gallen,4460,3,16,2,14,44,52,-8,50
Lucerne,4460,4,12,8,12,42,51,-9,44
FC Zürich,4460,5,11,9,12,43,38,5,42
FC Thun,4460,6,11,6,15,46,54,-8,39
Grasshoppers,4460,7,9,8,15,41,51,-10,35
FC Lugano,4460,8,9,5,18,30,51,-21,32
FC Sion,4460,9,5,8,19,39,59,-20,23
Young Boys,4461,1,22,7,3,77,35,42,73
FC Basel,4461,2,17,9,6,52,25,27,60
Lucerne,4461,3,13,8,11,44,46,-2,47
St Gallen,4461,4,13,5,14,44,57,-13,44
FC Zürich,4461,5,10,12,10,41,35,6,42
Grasshoppers,4461,6,11,6,15,43,50,-7,39
FC Lugano,4461,7,10,7,15,32,48,-16,37
FC Thun,4461,8,9,6,17,43,60,-17,33
FC Sion,4461,9,5,8,19,40,60,-20,23
Young Boys,4462,1,20,7,5,72,41,31,67
FC Basel,4462,2,18,8,6,54,27,27,62
St Gallen,4462,3,15,3,14,47,54,-7,48
Lucerne,4462,4,12,9,11,42,44,-2,45
FC Zürich,4462,5,11,10,11,40,38,2,43
FC Lugano,4462,6,12,5,15,36,45,-9,41
Grasshoppers,4462,7,9,7,16,40,49,-9,34
FC Thun,4462,8,9,5,18,40,59,-19,32
FC Sion,4462,9,7,8,17,40,54,-14,29
Young Boys,4463,1,22,7,3,74,33,41,73
FC Basel,4463,2,18,7,7,53,30,23,61
St Gallen,4463,3,15,2,15,45,54,-9,47
Lucerne,4463,4,12,8,12,40,45,-5,44
Grasshoppers,4463,5,11,7,14,45,47,-2,40
FC Thun,4463,6,11,5,16,50,59,-9,38
FC Zürich,4463,7,9,10,13,37,40,-3,37
FC Lugano,4463,8,9,7,16,29,50,-21,34
FC Sion,4463,9,7,7,18,40,55,-15,28
Young Boys,4464,1,23,7,2,81,35,46,76
FC Basel,4464,2,17,9,6,55,29,26,60
St Gallen,4464,3,16,2,14,47,57,-10,50
Lucerne,4464,4,12,9,11,43,48,-5,45
FC Zürich,4464,5,11,10,11,41,36,5,43
FC Thun,4464,6,10,5,17,45,58,-13,35
Grasshoppers,4464,7,9,7,16,45,53,-8,34
FC Lugano,4464,8,9,6,17,31,54,-23,33
FC Sion,4464,9,6,7,19,42,60,-18,25
Young Boys,4465,1,22,7,3,71,34,37,73
FC Basel,4465,2,18,9,5,54,26,28,63
Lucerne,4465,3,13,8,11,45,46,-1,47
St Gallen,4465,4,14,4,14,43,53,-10,46
FC Zürich,4465,5,10,10,12,40,37,3,40
FC Lugano,4465,6,11,6,15,31,45,-14,39
Grasshoppers,4465,7,9,7,16,41,49,-8,34
FC Thun,4465,8,9,7,16,44,59,-15,34
FC Sion,4465,9,5,8,19,36,56,-20,23
Young Boys,4466,1,21,7,4,72,35,37,70
FC Basel,4466,2,17,9,6,50,24,26,60
St Gallen,4466,3,15,4,13,44,52,-8,49
Lucerne,4466,4,11,8,13,39,49,-10,41
FC Zürich,4466,5,10,10,12,43,39,4,40
FC Thun,4466,6,11,6,15,43,55,-12,39
FC Lugano,4466,7,11,5,16,35,48,-13,38
Grasshoppers,4466,8,9,9,14,41,47,-6,36
FC Sion,4466,9,6,8,18,40,58,-18,26
Young Boys,4467,1,22,6,4,74,37,37,72
FC Basel,4467,2,17,8,7,52,26,26,59
St Gallen,4467,3,15,2,15,42,56,-14,47
FC Zürich,4467,4,11,10,11,45,36,9,43
Lucerne,4467,5,11,8,13,39,48,-9,41
FC Thun,4467,6,11,5,16,45,59,-14,38
FC Lugano,4467,7,11,5,16,33,49,-16,38
Grasshoppers,4467,8,9,8,15,41,48,-7,35
FC Sion,4467,9,7,8,17,47,59,-12,29
Young Boys,4468,1,20,9,3,68,37,31,69
FC Basel,4468,2,18,8,6,57,26,31,62
St Gallen,4468,3,14,5,13,43,52,-9,47
Lucerne,4468,4,13,7,12,43,46,-3,46
FC Zürich,4468,5,11,9,12,40,35,5,42
FC Lugano,4468,6,10,7,15,31,47,-16,37
Grasshoppers,4468,7,9,8,15,42,48,-6,35
FC Thun,4468,8,9,7,16,42,58,-16,34
FC Sion,4468,9,5,10,17,37,54,-17,25
Young Boys,4469,1,21,6,5,72,38,34,69
FC Basel,4469,2,18,7,7,54,30,24,61
St Gallen,4469,3,16,2,14,46,53,-7,50
FC Zürich,4469,4,11,10,11,43,36,7,43
Grasshoppers,4469,5,11,7,14,46,45,1,40
Lucerne,4469,6,11,7,14,36,46,-10,40
FC Lugano,4469,7,11,5,16,32,48,-16,38
FC Thun,4469,8,9,6,17,46,63,-17,33
FC Sion,4469,9,7,8,17,43,59,-16,29
Young Boys,4470,1,22,8,2,72,32,40,74
FC Basel,4470,2,17,10,5,61,29,32,61
Lucerne,4470,3,13,9,10,44,45,-1,48
St Gallen,4470,4,14,3,15,43,55,-12,45
FC Zürich,4470,5,10,11,11,45,41,4,41
Grasshoppers,4470,6,10,7,15,43,50,-7,37
FC Thun,4470,7,9,6,17,45,63,-18,33
FC Lugano,4470,8,9,6,17,30,53,-23,33
FC Sion,4470,9,6,8,18,42,57,-15,26
Young Boys,4471,1,21,7,4,69,34,35,70
FC Basel,4471,2,19,8,5,56,23,33,65
Lucerne,4471,3,13,9,10,40,41,-1,48
St Gallen,4471,4,13,3,16,39,53,-14,42
FC Zürich,4471,5,10,10,12,39,35,4,40
FC Lugano,4471,6,10,7,15,28,44,-16,37
FC Thun,4471,7,10,6,16,44,59,-15,36
Grasshoppers,4471,8,9,7,16,42,52,-10,34
FC Sion,4471,9,7,7,18,40,56,-16,28
Young Boys,4472,1,23,7,2,77,36,41,76
FC Basel,4472,2,16,7,9,55,30,25,55
St Gallen,4472,3,15,3,14,45,54,-9,48
Lucerne,4472,4,12,8,12,41,48,-7,44
FC Zürich,4472,5,11,9,12,38,36,2,42
FC Thun,4472,6,12,5,15,47,55,-8,41
FC Lugano,4472,7,10,6,16,33,50,-17,36
Grasshoppers,4472,8,8,8,16,41,51,-10,32
FC Sion,4472,9,6,9,17,40,57,-17,27
Young Boys,4473,1,21,7,4,67,33,34,70
FC Basel,4473,2,17,8,7,49,26,23,59
St Gallen,4473,3,15,3,14,46,56,-10,48
Lucerne,4473,4,12,9,11,43,45,-2,45
Grasshoppers,4473,5,11,7,14,44,46,-2,40
FC Lugano,4473,6,11,5,16,34,47,-13,38
FC Zürich,4473,7,9,10,13,38,39,-1,37
FC Thun,4473,8,10,6,16,44,59,-15,36
FC Sion,4473,9,6,9,17,39,53,-14,27
Young Boys,4474,1,23,7,2,75,36,39,76
FC Basel,4474,2,18,8,6,57,27,30,62
St Gallen,4474,3,14,4,14,42,54,-12,46
Lucerne,4474,4,11,9,12,40,46,-6,42
FC Lugano,4474,5,11,6,15,33,47,-14,39
FC Zürich,4474,6,9,10,13,38,38,0,37
FC Thun,4474,7,10,6,16,46,58,-12,36
Grasshoppers,4474,8,8,7,17,41,54,-13,31
FC Sion,4474,9,7,9,16,40,52,-12,30
Young Boys,4475,1,20,7,5,67,37,30,67
FC Basel,4475,2,17,9,6,51,25,26,60
Lucerne,4475,3,14,8,10,49,45,4,50
St Gallen,4475,4,15,3,14,47,55,-8,48
FC Zürich,4475,5,10,9,13,37,35,2,39
FC Lugano,4475,6,11,5,16,30,46,-16,38
Grasshoppers,4475,7,9,8,15,41,52,-11,35
FC Thun,4475,8,10,5,17,42,58,-16,35
FC Sion,4475,9,7,8,17,44,55,-11,29
Young Boys,4476,1,20,9,3,68,34,34,69
FC Basel,4476,2,16,8,8,54,31,23,56
Lucerne,4476,3,14,7,11,43,44,-1,49
St Gallen,4476,4,15,3,14,48,56,-8,48
FC Thun,4476,5,12,5,15,48,58,-10,41
FC Zürich,4476,6,10,10,12,42,41,1,40
Grasshoppers,4476,7,10,6,16,42,49,-7,36
FC Lugano,4476,8,9,7,16,30,47,-17,34
FC Sion,4476,9,6,9,17,41,56,-15,27
Young Boys,4477,1,21,6,5,70,38,32,69
FC Basel,4477,2,15,9,8,49,28,21,54
Lucerne,4477,3,13,7,12,43,43,0,46
St Gallen,4477,4,14,3,15,44,59,-15,45
FC Thun,4477,5,12,5,15,45,55,-10,41
FC Lugano,4477,6,12,5,15,38,49,-11,41
FC Zürich,4477,7,10,10,12,39,38,1,40
Grasshoppers,4477,8,10,6,16,42,50,-8,36
FC Sion,4477,9,8,7,17,45,55,-10,31
Young Boys,4478,1,20,7,5,68,36,32,67
FC Basel,4478,2,18,8,6,55,25,30,62
Lucerne,4478,3,15,8,9,43,39,4,53
St Gallen,4478,4,13,5,14,39,52,-13,44
FC Lugano,4478,5,11,6,15,29,43,-14,39
FC Zürich,4478,6,9,10,13,38,37,1,37
Grasshoppers,4478,7,10,6,16,42,50,-8,36
FC Thun,4478,8,10,5,17,44,61,-17,35
FC Sion,4478,9,6,9,17,38,53,-15,27
Young Boys,4479,1,20,7,5,65,36,29,67
FC Basel,4479,2,19,7,6,51,22,29,64
Lucerne,4479,3,12,9,11,42,44,-2,45
St Gallen,4479,4,14,3,15,44,56,-12,45
FC Lugano,4479,5,13,5,14,35,43,-8,44
FC Thun,4479,6,11,5,16,44,55,-11,38
FC Zürich,4479,7,9,10,13,38,38,0,37
Grasshoppers,4479,8,9,6,17,38,51,-13,33
FC Sion,4479,9,7,8,17,40,52,-12,29
Young Boys,4480,1,23,7,2,77,34,43,76
FC Basel,4480,2,15,8,9,51,30,21,53
St Gallen,4480,3,16,3,13,47,53,-6,51
Lucerne,4480,4,12,9,11,39,45,-6,45
FC Thun,4480,5,12,5,15,52,58,-6,41
FC Zürich,4480,6,10,10,12,42,36,6,40
FC Lugano,4480,7,10,6,16,31,48,-17,36
Grasshoppers,4480,8,9,8,15,41,51,-10,35
FC Sion,4480,9,5,8,19,39,64,-25,23
Young Boys,4481,1,21,7,4,72,39,33,70
FC Basel,4481,2,16,8,8,52,29,23,56
St Gallen,4481,3,16,3,13,44,51,-7,51
Lucerne,4481,4,12,9,11,43,46,-3,45
FC Zürich,4481,5,10,9,13,40,39,1,39
FC Thun,4481,6,11,6,15,45,56,-11,39
FC Lugano,4481,7,11,5,16,32,45,-13,38
Grasshoppers,4481,8,9,6,17,44,53,-9,33
FC Sion,4481,9,7,9,16,39,53,-14,30
Young Boys,4482,1,21,7,4,70,38,32,70
FC Basel,4482,2,19,8,5,60,25,35,65
Lucerne,4482,3,13,10,9,45,44,1,49
St Gallen,4482,4,14,2,16,44,57,-13,44
FC Zürich,4482,5,11,9,12,40,36,4,42
FC Lugano,4482,6,10,5,17,29,47,-18,35
FC Thun,4482,7,10,5,17,42,61,-19,35
Grasshoppers,4482,8,9,7,16,38,47,-9,34
FC Sion,4482,9,7,7,18,39,52,-13,28
Young Boys,4483,1,20,9,3,68,35,33,69
FC Basel,4483,2,17,9,6,56,29,27,60
Lucerne,4483,3,14,7,11,44,43,1,49
FC Zürich,4483,4,11,11,10,45,35,10,44
St Gallen,4483,5,13,3,16,39,57,-18,42
FC Thun,4483,6,10,7,15,47,59,-12,37
FC Lugano,4483,7,10,7,15,33,48,-15,37
Grasshoppers,4483,8,9,7,16,40,49,-9,34
FC Sion,4483,9,6,8,18,36,53,-17,26
Young Boys,4484,1,21,6,5,69,37,32,69
FC Basel,4484,2,17,9,6,52,26,26,60
St Gallen,4484,3,14,3,15,40,54,-14,45
Lucerne,4484,4,12,8,12,40,43,-3,44
FC Zürich,4484,5,11,10,11,41,36,5,43
FC Lugano,4484,6,11,6,15,32,47,-15,39
FC Thun,4484,7,10,7,15,44,55,-11,37
Grasshoppers,4484,8,9,6,17,42,52,-10,33
FC Sion,4484,9,7,9,16,42,52,-10,30
Young Boys,4485,1,22,6,4,69,35,34,72
FC Basel,4485,2,18,7,7,52,24,28,61
Lucerne,4485,3,14,7,11,43,44,-1,49
St Gallen,4485,4,15,2,15,44,53,-9,47
FC Zürich,4485,5,11,10,11,41,34,7,43
FC Thun,4485,6,10,6,16,45,60,-15,36
FC Lugano,4485,7,10,5,17,29,50,-21,35
Grasshoppers,4485,8,9,6,17,46,56,-10,33
FC Sion,4485,9,7,7,18,41,54,-13,28
Young Boys,4486,1,22,7,3,75,36,39,73
FC Basel,4486,2,17,9,6,58,27,31,60
St Gallen,4486,3,14,4,14,46,57,-11,46
Lucerne,4486,4,12,8,12,41,44,-3,44
FC Zürich,4486,5,11,10,11,43,37,6,43
Grasshoppers,4486,6,10,6,16,41,51,-10,36
FC Lugano,4486,7,10,6,16,31,50,-19,36
FC Thun,4486,8,9,6,17,43,62,-19,33
FC Sion,4486,9,6,10,16,38,52,-14,28
Young Boys,4487,1,22,7,3,73,37,36,73
FC Basel,4487,2,18,8,6,54,26,28,62
FC Zürich,4487,3,12,10,10,43,36,7,46
Lucerne,4487,4,13,7,12,44,46,-2,46
St Gallen,4487,5,13,3,16,43,63,-20,42
FC Lugano,4487,6,11,5,16,35,47,-12,38
Grasshoppers,4487,7,9,7,16,43,52,-9,34
FC Sion,4487,8,7,9,16,46,55,-9,30
FC Thun,4487,9,8,6,18,44,63,-19,30
Young Boys,4488,1,19,9,4,68,38,30,66
FC Basel,4488,2,17,10,5,53,23,30,61
Lucerne,4488,3,13,10,9,42,39,3,49
St Gallen,4488,4,13,4,15,41,54,-13,43
FC Zürich,4488,5,10,10,12,43,40,3,40
FC Lugano,4488,6,11,6,15,33,48,-15,39
FC Thun,4488,7,11,5,16,45,58,-13,38
Grasshoppers,4488,8,8,8,16,41,51,-10,32
FC Sion,4488,9,7,8,17,41,56,-15,29
Young Boys,4489,1,21,8,3,68,31,37,71
FC Basel,4489,2,16,8,8,51,30,21,56
Lucerne,4489,3,14,8,10,43,40,3,50
FC Zürich,4489,4,12,9,11,43,37,6,45
St Gallen,4489,5,13,3,16,40,56,-16,42
Grasshoppers,4489,6,11,6,15,43,47,-4,39
FC Sion,4489,7,9,7,16,43,52,-9,34
FC Lugano,4489,8,9,7,16,27,45,-18,34
FC Thun,4489,9,8,6,18,40,60,-20,30
Young Boys,4490,1,21,8,3,71,35,36,71
FC Basel,4490,2,18,8,6,58,30,28,62
Lucerne,4490,3,13,7,12,45,50,-5,46
St Gallen,4490,4,14,2,16,44,58,-14,44
FC Zürich,4490,5,10,11,11,42,34,8,41
FC Lugano,4490,6,11,6,15,33,46,-13,39
Grasshoppers,4490,7,10,7,15,47,52,-5,37
FC Thun,4490,8,8,7,17,46,64,-18,31
FC Sion,4490,9,6,10,16,40,57,-17,28
Young Boys,4491,1,21,9,2,70,33,37,72
FC Basel,4491,2,16,10,6,50,25,25,58
FC Zürich,4491,3,12,9,11,43,36,7,45
St Gallen,4491,4,14,3,15,45,56,-11,45
Lucerne,4491,5,11,9,12,42,50,-8,42
FC Thun,4491,6,11,6,15,46,57,-11,39
FC Lugano,4491,7,11,5,16,34,47,-13,38
Grasshoppers,4491,8,9,8,15,40,49,-9,35
FC Sion,4491,9,6,7,19,41,58,-17,25
Young Boys,4492,1,21,7,4,73,38,35,70
FC Basel,4492,2,18,8,6,53,27,26,62
Lucerne,4492,3,13,8,11,46,46,0,47
St Gallen,4492,4,14,3,15,45,58,-13,45
FC Lugano,4492,5,11,6,15,34,47,-13,39
FC Zürich,4492,6,9,11,12,38,38,0,38
FC Thun,4492,7,11,5,16,44,56,-12,38
Grasshoppers,4492,8,9,6,17,41,54,-13,33
FC Sion,4492,9,7,8,17,46,56,-10,29
Young Boys,4493,1,20,9,3,69,35,34,69
FC Basel,4493,2,18,9,5,53,22,31,63
St Gallen,4493,3,15,3,14,43,53,-10,48
Lucerne,4493,4,11,8,13,41,49,-8,41
FC Zürich,4493,5,10,10,12,39,36,3,40
FC Lugano,4493,6,11,6,15,31,45,-14,39
Grasshoppers,4493,7,10,8,14,45,49,-4,38
FC Thun,4493,8,8,7,17,40,58,-18,31
FC Sion,4493,9,6,10,16,42,56,-14,28
Young Boys,4494,1,21,8,3,72,36,36,71
FC Basel,4494,2,17,9,6,53,27,26,60
St Gallen,4494,3,16,3,13,47,53,-6,51
Lucerne,4494,4,12,10,10,42,42,0,46
FC Zürich,4494,5,12,9,11,42,35,7,45
FC Thun,4494,6,10,5,17,43,57,-14,35
FC Lugano,4494,7,10,5,17,30,51,-21,35
Grasshoppers,4494,8,9,7,16,41,51,-10,34
FC Sion,4494,9,5,8,19,42,60,-18,23
Young Boys,4495,1,23,7,2,74,35,39,76
FC Basel,4495,2,18,8,6,60,26,34,62
St Gallen,4495,3,15,2,15,44,55,-11,47
Lucerne,4495,4,12,7,13,40,51,-11,43
FC Zürich,4495,5,10,10,12,42,38,4,40
FC Lugano,4495,6,11,5,16,31,48,-17,38
FC Thun,4495,7,10,6,16,45,58,-13,36
Grasshoppers,4495,8,8,7,17,40,52,-12,31
FC Sion,4495,9,6,10,16,42,55,-13,28
Young Boys,4496,1,22,6,4,72,36,36,72
FC Basel,4496,2,19,7,6,57,26,31,64
St Gallen,4496,3,15,3,14,46,53,-7,48
Lucerne,4496,4,12,8,12,39,46,-7,44
FC Zürich,4496,5,10,10,12,41,38,3,40
FC Lugano,4496,6,11,6,15,34,47,-13,39
FC Thun,4496,7,10,5,17,46,64,-18,35
Grasshoppers,4496,8,9,7,16,42,51,-9,34
FC Sion,4496,9,6,8,18,37,53,-16,26
Young Boys,4497,1,22,7,3,70,31,39,73
FC Basel,4497,2,17,9,6,52,25,27,60
Lucerne,4497,3,12,9,11,42,44,-2,45
St Gallen,4497,4,14,3,15,43,56,-13,45
FC Zürich,4497,5,10,11,11,39,37,2,41
FC Lugano,4497,6,10,7,15,30,45,-15,37
Grasshoppers,4497,7,10,6,16,39,50,-11,36
FC Thun,4497,8,10,5,17,44,58,-14,35
FC Sion,4497,9,6,9,17,37,50,-13,27
Young Boys,4498,1,21,7,4,71,35,36,70
FC Basel,4498,2,17,9,6,55,28,27,60
St Gallen,4498,3,15,3,14,45,54,-9,48
Lucerne,4498,4,12,10,10,46,45,1,46
FC Zürich,4498,5,10,10,12,40,39,1,40
FC Thun,4498,6,10,7,15,45,55,-10,37
FC Lugano,4498,7,10,6,16,29,50,-21,36
Grasshoppers,4498,8,8,8,16,38,49,-11,32
FC Sion,4498,9,7,8,17,37,51,-14,29
FC Basel,4499,1,19,8,5,60,23,37,65
Young Boys,4499,2,19,6,7,64,41,23,63
Lucerne,4499,3,15,7,10,44,41,3,52
St Gallen,4499,4,13,3,16,40,56,-16,42
FC Zürich,4499,5,10,11,11,42,37,5,41
FC Lugano,4499,6,12,5,15,33,46,-13,41
FC Thun,4499,7,10,5,17,46,63,-17,35
Grasshoppers,4499,8,9,6,17,41,52,-11,33
FC Sion,4499,9,7,9,16,41,52,-11,30
Young Boys,4500,1,21,6,5,73,41,32,69
FC Basel,4500,2,17,10,5,54,25,29,61
Lucerne,4500,3,15,8,9,48,43,5,53
St Gallen,4500,4,14,2,16,45,59,-14,44
FC Zürich,4500,5,9,11,12,37,37,0,38
FC Lugano,4500,6,10,6,16,31,47,-16,36
FC Thun,4500,7,9,8,15,45,57,-12,35
Grasshoppers,4500,8,9,7,16,43,55,-12,34
FC Sion,4500,9,7,8,17,42,54,-12,29
Young Boys,4501,1,22,7,3,70,31,39,73
FC Basel,4501,2,16,10,6,50,26,24,58
Lucerne,4501,3,13,9,10,42,43,-1,48
FC Zürich,4501,4,12,10,10,46,35,11,46
St Gallen,4501,5,13,3,16,39,56,-17,42
Grasshoppers,4501,6,10,6,16,41,49,-8,36
FC Lugano,4501,7,10,5,17,33,48,-15,35
FC Sion,4501,8,8,7,17,40,55,-15,31
FC Thun,4501,9,8,7,17,43,61,-18,31
Young Boys,4502,1,20,7,5,68,34,34,67
FC Basel,4502,2,18,8,6,52,27,25,62
St Gallen,4502,3,16,3,13,45,49,-4,51
Lucerne,4502,4,12,7,13,40,46,-6,43
FC Zürich,4502,5,10,9,13,38,38,0,39
Grasshoppers,4502,6,11,6,15,43,48,-5,39
FC Lugano,4502,7,11,6,15,30,44,-14,39
FC Thun,4502,8,11,5,16,48,59,-11,38
FC Sion,4502,9,6,7,19,39,58,-19,25
Young Boys,4503,1,21,8,3,67,32,35,71
FC Basel,4503,2,17,8,7,51,25,26,59
Lucerne,4503,3,13,8,11,44,43,1,47
St Gallen,4503,4,15,2,15,42,54,-12,47
FC Zürich,4503,5,10,10,12,38,38,0,40
FC Lugano,4503,6,11,5,16,32,47,-15,38
FC Sion,4503,7,9,8,15,44,50,-6,35
Grasshoppers,4503,8,8,8,16,37,48,-11,32
FC Thun,4503,9,8,7,17,39,57,-18,31
Young Boys,4504,1,22,6,4,72,33,39,72
FC Basel,4504,2,17,8,7,54,26,28,59
Lucerne,4504,3,14,8,10,44,43,1,50
St Gallen,4504,4,14,5,13,42,52,-10,47
FC Zürich,4504,5,10,11,11,39,37,2,41
Grasshoppers,4504,6,9,8,15,41,50,-9,35
FC Thun,4504,7,9,7,16,45,61,-16,34
FC Lugano,4504,8,9,7,16,31,50,-19,34
FC Sion,4504,9,6,8,18,42,58,-16,26
Young Boys,4505,1,22,6,4,76,35,41,72
FC Basel,4505,2,17,10,5,52,24,28,61
Lucerne,4505,3,14,9,9,42,39,3,51
St Gallen,4505,4,14,3,15,41,53,-12,45
FC Zürich,4505,5,10,11,11,38,34,4,41
FC Lugano,4505,6,10,7,15,30,50,-20,37
FC Thun,4505,7,9,7,16,42,57,-15,34
Grasshoppers,4505,8,8,7,17,38,50,-12,31
FC Sion,4505,9,6,8,18,39,56,-17,26
Young Boys,4506,1,21,6,5,72,39,33,69
FC Basel,4506,2,16,9,7,52,27,25,57
St Gallen,4506,3,16,3,13,44,50,-6,51
Lucerne,4506,4,12,9,11,42,47,-5,45
FC Zürich,4506,5,10,11,11,40,38,2,41
FC Lugano,4506,6,11,5,16,35,48,-13,38
FC Thun,4506,7,10,6,16,47,61,-14,36
Grasshoppers,4506,8,9,7,16,41,50,-9,34
FC Sion,4506,9,7,8,17,40,53,-13,29
Young Boys,4507,1,21,6,5,69,37,32,69
FC Basel,4507,2,19,7,6,53,24,29,64
Lucerne,4507,3,14,8,10,45,43,2,50
St Gallen,4507,4,15,2,15,44,53,-9,47
FC Zürich,4507,5,11,10,11,43,36,7,43
Grasshoppers,4507,6,10,7,15,44,49,-5,37
FC Thun,4507,7,10,6,16,43,58,-15,36
FC Lugano,4507,8,9,6,17,29,50,-21,33
FC Sion,4507,9,5,8,19,36,56,-20,23
Young Boys,4508,1,21,8,3,71,32,39,71
FC Basel,4508,2,18,8,6,50,26,24,62
Lucerne,4508,3,12,9,11,41,45,-4,45
St Gallen,4508,4,13,4,15,40,55,-15,43
FC Zürich,4508,5,11,9,12,43,37,6,42
FC Lugano,4508,6,11,6,15,35,51,-16,39
Grasshoppers,4508,7,10,7,15,41,47,-6,37
FC Thun,4508,8,10,6,16,43,57,-14,36
FC Sion,4508,9,6,7,19,41,55,-14,25
Young Boys,4509,1,21,8,3,73,35,38,71
FC Basel,4509,2,19,8,5,54,24,30,65
Lucerne,4509,3,13,7,12,41,44,-3,46
St Gallen,4509,4,14,2,16,41,56,-15,44
FC Zürich,4509,5,10,11,11,39,35,4,41
Grasshoppers,4509,6,10,7,15,43,48,-5,37
FC Thun,4509,7,10,7,15,44,56,-12,37
FC Lugano,4509,8,10,6,16,30,47,-17,36
FC Sion,4509,9,5,8,19,37,57,-20,23
Young Boys,4510,1,21,7,4,69,36,33,70
FC Basel,4510,2,16,8,8,53,28,25,56
St Gallen,4510,3,16,2,14,46,55,-9,50
FC Zürich,4510,4,13,9,10,43,34,9,48
Lucerne,4510,5,11,8,13,42,48,-6,41
FC Lugano,4510,6,11,6,15,30,43,-13,39
Grasshoppers,4510,7,10,8,14,44,50,-6,38
FC Thun,4510,8,9,6,17,41,60,-19,33
FC Sion,4510,9,6,8,18,44,58,-14,26
Young Boys,4511,1,23,6,3,71,34,37,75
FC Basel,4511,2,17,8,7,52,24,28,59
Lucerne,4511,3,13,7,12,40,44,-4,46
St Gallen,4511,4,13,3,16,38,54,-16,42
FC Lugano,4511,5,12,5,15,33,44,-11,41
FC Thun,4511,6,11,6,15,44,55,-11,39
FC Zürich,4511,7,9,9,14,37,40,-3,36
Grasshoppers,4511,8,9,7,16,42,50,-8,34
FC Sion,4511,9,7,9,16,41,53,-12,30
Young Boys,4512,1,22,7,3,75,36,39,73
FC Basel,4512,2,17,7,8,55,31,24,58
FC Zürich,4512,3,13,9,10,41,32,9,48
Lucerne,4512,4,12,10,10,44,45,-1,46
St Gallen,4512,5,13,4,15,45,60,-15,43
Grasshoppers,4512,6,10,7,15,43,50,-7,37
FC Lugano,4512,7,10,6,16,31,49,-18,36
FC Thun,4512,8,9,6,17,43,59,-16,33
FC Sion,4512,9,5,10,17,39,54,-15,25
Young Boys,4513,1,20,7,5,71,37,34,67
FC Basel,4513,2,18,9,5,56,25,31,63
Lucerne,4513,3,13,8,11,43,44,-1,47
St Gallen,4513,4,14,3,15,41,55,-14,45
FC Zürich,4513,5,10,10,12,43,37,6,40
FC Lugano,4513,6,11,6,15,32,47,-15,39
Grasshoppers,4513,7,10,7,15,41,50,-9,37
FC Thun,4513,8,9,6,17,44,60,-16,33
FC Sion,4513,9,7,8,17,44,60,-16,29
Young Boys,4514,1,20,7,5,68,38,30,67
FC Basel,4514,2,19,8,5,55,22,33,65
Lucerne,4514,3,13,8,11,41,44,-3,47
St Gallen,4514,4,15,2,15,43,56,-13,47
FC Zürich,4514,5,9,12,11,38,35,3,39
FC Thun,4514,6,10,7,15,44,55,-11,37
FC Lugano,4514,7,9,8,15,31,47,-16,35
Grasshoppers,4514,8,9,6,17,39,50,-11,33
FC Sion,4514,9,7,8,17,40,52,-12,29
Young Boys,4515,1,22,6,4,74,36,38,72
FC Basel,4515,2,18,8,6,57,30,27,62
Lucerne,4515,3,14,7,11,46,44,2,49
St Gallen,4515,4,13,2,17,43,60,-17,41
FC Zürich,4515,5,9,12,11,41,38,3,39
FC Thun,4515,6,10,7,15,45,58,-13,37
FC Lugano,4515,7,10,6,16,31,49,-18,36
Grasshoppers,4515,8,9,8,15,41,50,-9,35
FC Sion,4515,9,6,10,16,42,55,-13,28
Young Boys,4516,1,23,6,3,74,33,41,75
FC Basel,4516,2,19,8,5,55,23,32,65
St Gallen,4516,3,15,4,13,45,52,-7,49
Lucerne,4516,4,13,8,11,42,43,-1,47
FC Zürich,4516,5,9,10,13,40,40,0,37
Grasshoppers,4516,6,9,7,16,42,52,-10,34
FC Thun,4516,7,9,6,17,42,60,-18,33
FC Lugano,4516,8,9,6,17,30,53,-23,33
FC Sion,4516,9,7,7,18,41,55,-14,28
Young Boys,4517,1,22,7,3,79,37,42,73
FC Basel,4517,2,18,8,6,58,25,33,62
Lucerne,4517,3,12,9,11,39,42,-3,45
St Gallen,4517,4,13,5,14,39,51,-12,44
FC Zürich,4517,5,11,9,12,44,39,5,42
FC Lugano,4517,6,11,6,15,32,49,-17,39
FC Thun,4517,7,10,6,16,42,59,-17,36
Grasshoppers,4517,8,8,8,16,40,53,-13,32
FC Sion,4517,9,6,8,18,38,56,-18,26
Young Boys,4518,1,22,6,4,71,35,36,72
FC Basel,4518,2,18,7,7,52,27,25,61
St Gallen,4518,3,16,3,13,46,51,-5,51
Lucerne,4518,4,12,9,11,42,44,-2,45
FC Thun,4518,5,11,6,15,46,53,-7,39
FC Zürich,4518,6,9,11,12,38,38,0,38
FC Lugano,4518,7,10,7,15,32,46,-14,37
Grasshoppers,4518,8,8,6,18,41,60,-19,30
FC Sion,4518,9,7,7,18,40,54,-14,28
Young Boys,4519,1,22,6,4,75,34,41,72
FC Basel,4519,2,17,9,6,53,28,25,60
St Gallen,4519,3,15,4,13,44,53,-9,49
FC Zürich,4519,4,12,10,10,45,36,9,46
Lucerne,4519,5,11,10,11,41,46,-5,43
FC Lugano,4519,6,9,6,17,30,52,-22,33
FC Sion,4519,7,8,8,16,45,53,-8,32
Grasshoppers,4519,8,8,8,16,39,52,-13,32
FC Thun,4519,9,8,7,17,41,59,-18,31
Young Boys,4520,1,23,7,2,72,32,40,76
FC Basel,4520,2,16,9,7,53,26,27,57
Lucerne,4520,3,14,8,10,42,40,2,50
St Gallen,4520,4,14,4,14,43,54,-11,46
FC Zürich,4520,5,10,10,12,37,36,1,40
FC Lugano,4520,6,10,6,16,30,47,-17,36
Grasshoppers,4520,7,9,8,15,41,50,-9,35
FC Thun,4520,8,10,5,17,44,60,-16,35
FC Sion,4520,9,5,9,18,39,56,-17,24
Young Boys,4521,1,21,8,3,71,32,39,71
FC Basel,4521,2,15,10,7,53,33,20,55
Lucerne,4521,3,13,9,10,48,47,1,48
St Gallen,4521,4,14,3,15,44,59,-15,45
FC Zürich,4521,5,11,11,10,44,38,6,44
FC Lugano,4521,6,11,6,15,39,50,-11,39
FC Thun,4521,7,9,6,17,43,59,-16,33
Grasshoppers,4521,8,8,8,16,38,49,-11,32
FC Sion,4521,9,8,7,17,40,53,-13,31
Young Boys,4522,1,23,6,3,71,32,39,75
FC Basel,4522,2,17,7,8,55,28,27,58
Lucerne,4522,3,14,7,11,45,45,0,49
St Gallen,4522,4,15,3,14,46,59,-13,48
FC Zürich,4522,5,12,10,10,46,33,13,46
FC Thun,4522,6,11,5,16,47,59,-12,38
FC Lugano,4522,7,9,7,16,31,48,-17,34
Grasshoppers,4522,8,9,6,17,39,53,-14,33
FC Sion,4522,9,5,7,20,41,64,-23,22
Young Boys,4523,1,23,6,3,77,37,40,75
FC Basel,4523,2,17,9,6,52,24,28,60
St Gallen,4523,3,15,2,15,43,54,-11,47
Lucerne,4523,4,12,8,12,40,46,-6,44
FC Zürich,4523,5,11,10,11,40,35,5,43
Grasshoppers,4523,6,11,6,15,49,52,-3,39
FC Thun,4523,7,10,6,16,44,62,-18,36
FC Lugano,4523,8,9,6,17,30,51,-21,33
FC Sion,4523,9,6,7,19,41,55,-14,25
Young Boys,4524,1,23,6,3,75,34,41,75
FC Basel,4524,2,17,8,7,58,29,29,59
St Gallen,4524,3,14,2,16,42,57,-15,44
Lucerne,4524,4,12,7,13,41,52,-11,43
Grasshoppers,4524,5,12,6,14,46,46,0,42
FC Zürich,4524,6,10,11,11,41,35,6,41
FC Thun,4524,7,10,6,16,46,61,-15,36
FC Lugano,4524,8,10,5,17,34,51,-17,35
FC Sion,4524,9,7,7,18,38,56,-18,28
Young Boys,4525,1,23,7,2,73,33,40,76
FC Basel,4525,2,17,8,7,52,28,24,59
FC Zürich,4525,3,12,9,11,41,35,6,45
St Gallen,4525,4,14,2,16,42,56,-14,44
Lucerne,4525,5,12,7,13,41,47,-6,43
FC Thun,4525,6,11,6,15,47,56,-9,39
FC Lugano,4525,7,11,5,16,32,44,-12,38
Grasshoppers,4525,8,8,8,16,39,51,-12,32
FC Sion,4525,9,6,8,18,38,55,-17,26
Young Boys,4526,1,22,6,4,71,35,36,72
FC Basel,4526,2,17,8,7,56,28,28,59
St Gallen,4526,3,15,2,15,42,53,-11,47
FC Zürich,4526,4,11,11,10,45,35,10,44
Lucerne,4526,5,11,8,13,37,47,-10,41
Grasshoppers,4526,6,11,6,15,46,47,-1,39
FC Lugano,4526,7,10,7,15,29,46,-17,37
FC Thun,4526,8,10,6,16,46,61,-15,36
FC Sion,4526,9,6,8,18,39,59,-20,26
Young Boys,4527,1,22,7,3,78,37,41,73
FC Basel,4527,2,19,7,6,59,28,31,64
Lucerne,4527,3,14,8,10,46,44,2,50
FC Zürich,4527,4,12,9,11,41,34,7,45
St Gallen,4527,5,13,3,16,42,56,-14,42
FC Lugano,4527,6,10,6,16,30,47,-17,36
FC Thun,4527,7,10,5,17,44,58,-14,35
Grasshoppers,4527,8,9,6,17,47,58,-11,33
FC Sion,4527,9,6,7,19,37,62,-25,25
Young Boys,4528,1,23,6,3,75,35,40,75
FC Basel,4528,2,16,9,7,53,30,23,57
Lucerne,4528,3,13,8,11,40,42,-2,47
St Gallen,4528,4,14,4,14,43,53,-10,46
FC Zürich,4528,5,11,11,10,45,36,9,44
FC Lugano,4528,6,11,6,15,33,47,-14,39
Grasshoppers,4528,7,9,7,16,41,51,-10,34
FC Sion,4528,8,7,8,17,40,55,-15,29
FC Thun,4528,9,8,5,19,41,62,-21,29
Young Boys,4529,1,21,6,5,70,41,29,69
FC Basel,4529,2,20,7,5,68,25,43,67
St Gallen,4529,3,15,3,14,45,55,-10,48
Lucerne,4529,4,13,8,11,45,47,-2,47
FC Zürich,4529,5,10,9,13,40,43,-3,39
FC Thun,4529,6,11,5,16,47,60,-13,38
FC Lugano,4529,7,10,6,16,36,51,-15,36
Grasshoppers,4529,8,8,6,18,38,56,-18,30
FC Sion,4529,9,7,8,17,43,54,-11,29
Young Boys,4530,1,22,7,3,76,36,40,73
FC Basel,4530,2,18,9,5,56,26,30,63
St Gallen,4530,3,15,3,14,43,54,-11,48
Lucerne,4530,4,11,9,12,42,49,-7,42
FC Zürich,4530,5,10,10,12,42,38,4,40
FC Lugano,4530,6,11,6,15,34,49,-15,39
Grasshoppers,4530,7,9,7,16,43,51,-8,34
FC Thun,4530,8,9,6,17,42,60,-18,33
FC Sion,4530,9,6,9,17,42,57,-15,27
Young Boys,4531,1,19,11,2,66,32,34,68
FC Basel,4531,2,17,9,6,57,27,30,60
Lucerne,4531,3,13,9,10,43,40,3,48
St Gallen,4531,4,13,5,14,40,54,-14,44
FC Zürich,4531,5,11,9,12,43,39,4,42
Grasshoppers,4531,6,10,7,15,40,51,-11,37
FC Lugano,4531,7,10,7,15,29,44,-15,37
FC Sion,4531,8,8,8,16,42,50,-8,32
FC Thun,4531,9,8,5,19,45,68,-23,29
Young Boys,4532,1,21,6,5,71,38,33,69
FC Basel,4532,2,19,8,5,58,25,33,65
Lucerne,4532,3,13,8,11,47,50,-3,47
St Gallen,4532,4,15,2,15,44,55,-11,47
FC Zürich,4532,5,9,11,12,37,35,2,38
Grasshoppers,4532,6,9,8,15,42,49,-7,35
FC Lugano,4532,7,10,5,17,31,50,-19,35
FC Thun,4532,8,9,7,16,41,56,-15,34
FC Sion,4532,9,7,9,16,39,52,-13,30
Young Boys,4533,1,20,10,2,68,33,35,70
FC Basel,4533,2,18,7,7,51,24,27,61
St Gallen,4533,3,15,3,14,43,55,-12,48
Lucerne,4533,4,12,8,12,40,47,-7,44
FC Zürich,4533,5,11,9,12,39,34,5,42
FC Lugano,4533,6,11,6,15,33,44,-11,39
Grasshoppers,4533,7,10,7,15,43,49,-6,37
FC Thun,4533,8,10,5,17,46,57,-11,35
FC Sion,4533,9,5,9,18,37,57,-20,24
Young Boys,4534,1,21,7,4,70,34,36,70
FC Basel,4534,2,17,8,7,56,29,27,59
Lucerne,4534,3,14,7,11,44,45,-1,49
St Gallen,4534,4,15,2,15,43,52,-9,47
FC Zürich,4534,5,9,11,12,39,40,-1,38
FC Thun,4534,6,10,6,16,46,57,-11,36
Grasshoppers,4534,7,10,6,16,40,51,-11,36
FC Lugano,4534,8,10,6,16,31,49,-18,36
FC Sion,4534,9,7,9,16,40,52,-12,30
Young Boys,4535,1,21,7,4,70,35,35,70
FC Basel,4535,2,18,9,5,60,26,34,63
Lucerne,4535,3,13,9,10,44,43,1,48
St Gallen,4535,4,15,3,14,42,55,-13,48
FC Zürich,4535,5,11,10,11,40,37,3,43
Grasshoppers,4535,6,10,6,16,42,52,-10,36
FC Thun,4535,7,9,6,17,43,57,-14,33
FC Lugano,4535,8,9,5,18,28,48,-20,32
FC Sion,4535,9,6,9,17,42,58,-16,27
Young Boys,4536,1,22,6,4,69,36,33,72
FC Basel,4536,2,19,7,6,56,24,32,64
Lucerne,4536,3,13,7,12,44,46,-2,46
FC Zürich,4536,4,12,9,11,42,36,6,45
St Gallen,4536,5,14,2,16,42,56,-14,44
Grasshoppers,4536,6,10,7,15,43,47,-4,37
FC Lugano,4536,7,10,5,17,31,48,-17,35
FC Thun,4536,8,9,6,17,41,60,-19,33
FC Sion,4536,9,7,7,18,41,56,-15,28
Young Boys,4537,1,23,6,3,74,35,39,75
FC Basel,4537,2,17,9,6,55,24,31,60
Lucerne,4537,3,12,8,12,43,49,-6,44
St Gallen,4537,4,14,2,16,43,57,-14,44
FC Lugano,4537,5,12,5,15,33,47,-14,41
FC Zürich,4537,6,10,10,12,40,35,5,40
Grasshoppers,4537,7,10,6,16,44,52,-8,36
FC Thun,4537,8,10,5,17,42,62,-20,35
FC Sion,4537,9,7,7,18,40,53,-13,28
Young Boys,4538,1,22,7,3,72,36,36,73
FC Basel,4538,2,17,10,5,52,25,27,61
Lucerne,4538,3,13,9,10,42,40,2,48
St Gallen,4538,4,13,3,16,39,56,-17,42
FC Zürich,4538,5,9,11,12,40,40,0,38
FC Lugano,4538,6,10,7,15,34,47,-13,37
FC Sion,4538,7,9,7,16,45,51,-6,34
FC Thun,4538,8,9,7,16,44,58,-14,34
Grasshoppers,4538,9,8,7,17,37,52,-15,31
Young Boys,4539,1,21,7,4,69,32,37,70
FC Basel,4539,2,16,10,6,53,29,24,58
St Gallen,4539,3,16,2,14,45,55,-10,50
Lucerne,4539,4,13,10,9,44,41,3,49
FC Zürich,4539,5,11,10,11,39,34,5,43
Grasshoppers,4539,6,10,7,15,38,47,-9,37
FC Thun,4539,7,10,7,15,46,56,-10,37
FC Lugano,4539,8,9,5,18,28,49,-21,32
FC Sion,4539,9,5,8,19,36,55,-19,23
Young Boys,4540,1,22,6,4,75,37,38,72
FC Basel,4540,2,19,7,6,60,27,33,64
Lucerne,4540,3,12,8,12,39,44,-5,44
FC Zürich,4540,4,11,10,11,42,37,5,43
St Gallen,4540,5,13,4,15,39,54,-15,43
FC Lugano,4540,6,11,5,16,32,48,-16,38
Grasshoppers,4540,7,10,7,15,42,48,-6,37
FC Thun,4540,8,8,7,17,41,61,-20,31
FC Sion,4540,9,6,10,16,39,53,-14,28
Young Boys,4541,1,23,6,3,72,31,41,75
FC Basel,4541,2,17,8,7,51,25,26,59
St Gallen,4541,3,16,2,14,47,55,-8,50
Lucerne,4541,4,13,9,10,43,42,1,48
FC Zürich,4541,5,11,11,10,42,35,7,44
Grasshoppers,4541,6,10,7,15,41,47,-6,37
FC Lugano,4541,7,9,6,17,28,48,-20,33
FC Thun,4541,8,8,5,19,40,64,-24,29
FC Sion,4541,9,6,8,18,39,56,-17,26
Young Boys,4542,1,21,6,5,71,35,36,69
FC Basel,4542,2,18,8,6,58,26,32,62
FC Zürich,4542,3,13,9,10,44,32,12,48
St Gallen,4542,4,14,4,14,44,56,-12,46
Lucerne,4542,5,12,7,13,41,49,-8,43
Grasshoppers,4542,6,11,7,14,46,50,-4,40
FC Lugano,4542,7,9,6,17,29,48,-19,33
FC Thun,4542,8,9,6,17,41,61,-20,33
FC Sion,4542,9,7,7,18,40,57,-17,28
Young Boys,4543,1,21,8,3,72,33,39,71
FC Basel,4543,2,17,8,7,54,26,28,59
Lucerne,4543,3,12,9,11,41,46,-5,45
St Gallen,4543,4,14,3,15,43,57,-14,45
FC Zürich,4543,5,10,9,13,38,36,2,39
FC Lugano,4543,6,11,5,16,34,51,-17,38
FC Thun,4543,7,10,7,15,43,55,-12,37
Grasshoppers,4543,8,9,7,16,39,50,-11,34
FC Sion,4543,9,7,10,15,41,51,-10,31
Young Boys,4544,1,20,9,3,69,35,34,69
FC Basel,4544,2,17,9,6,53,23,30,60
Lucerne,4544,3,12,11,9,40,40,0,47
St Gallen,4544,4,14,4,14,42,53,-11,46
FC Lugano,4544,5,11,6,15,32,46,-14,39
FC Zürich,4544,6,9,11,12,39,39,0,38
Grasshoppers,4544,7,9,8,15,43,51,-8,35
FC Thun,4544,8,9,7,16,44,61,-17,34
FC Sion,4544,9,5,11,16,37,51,-14,26
Young Boys,4545,1,20,8,4,69,36,33,68
FC Basel,4545,2,19,7,6,55,24,31,64
St Gallen,4545,3,15,4,13,43,51,-8,49
Lucerne,4545,4,12,9,11,42,47,-5,45
FC Zürich,4545,5,9,12,11,39,36,3,39
Grasshoppers,4545,6,10,7,15,46,51,-5,37
FC Lugano,4545,7,9,9,14,32,47,-15,36
FC Thun,4545,8,9,6,17,40,58,-18,33
FC Sion,4545,9,5,10,17,37,53,-16,25
Young Boys,4546,1,20,7,5,65,34,31,67
FC Basel,4546,2,17,8,7,54,27,27,59
St Gallen,4546,3,15,2,15,43,57,-14,47
FC Zürich,4546,4,12,9,11,42,36,6,45
Lucerne,4546,5,12,9,11,40,42,-2,45
FC Thun,4546,6,11,6,15,46,56,-10,39
FC Lugano,4546,7,11,5,16,31,46,-15,38
FC Sion,4546,8,8,7,17,42,52,-10,31
Grasshoppers,4546,9,8,7,17,39,52,-13,31
Young Boys,4547,1,22,7,3,72,35,37,73
FC Basel,4547,2,16,9,7,52,26,26,57
Lucerne,4547,3,14,8,10,42,42,0,50
St Gallen,4547,4,15,3,14,43,52,-9,48
FC Zürich,4547,5,9,11,12,41,42,-1,38
Grasshoppers,4547,6,10,7,15,42,48,-6,37
FC Thun,4547,7,10,6,16,46,59,-13,36
FC Lugano,4547,8,9,6,17,32,52,-20,33
FC Sion,4547,9,6,9,17,41,55,-14,27
Young Boys,4548,1,21,7,4,72,38,34,70
FC Basel,4548,2,19,8,5,64,27,37,65
Lucerne,4548,3,13,7,12,42,49,-7,46
St Gallen,4548,4,14,3,15,42,54,-12,45
FC Thun,4548,5,11,5,16,48,59,-11,38
FC Zürich,4548,6,9,10,13,39,39,0,37
Grasshoppers,4548,7,10,7,15,46,50,-4,37
FC Lugano,4548,8,10,6,16,29,48,-19,36
FC Sion,4548,9,6,9,17,40,58,-18,27
Young Boys,4549,1,21,8,3,69,33,36,71
FC Basel,4549,2,19,8,5,57,23,34,65
Lucerne,4549,3,13,8,11,42,46,-4,47
St Gallen,4549,4,14,4,14,42,55,-13,46
FC Zürich,4549,5,10,10,12,40,37,3,40
FC Lugano,4549,6,10,5,17,32,49,-17,35
FC Thun,4549,7,9,6,17,43,62,-19,33
Grasshoppers,4549,8,8,8,16,38,49,-11,32
FC Sion,4549,9,7,9,16,40,49,-9,30
Young Boys,4550,1,20,7,5,74,39,35,67
FC Basel,4550,2,18,8,6,55,25,30,62
Lucerne,4550,3,14,8,10,44,42,2,50
FC Zürich,4550,4,12,9,11,42,34,8,45
St Gallen,4550,5,13,2,17,39,56,-17,41
Grasshoppers,4550,6,11,6,15,44,53,-9,39
FC Lugano,4550,7,11,6,15,31,47,-16,39
FC Thun,4550,8,9,5,18,42,61,-19,32
FC Sion,4550,9,7,7,18,40,54,-14,28
Young Boys,4551,1,22,6,4,70,35,35,72
FC Basel,4551,2,17,8,7,54,25,29,59
St Gallen,4551,3,16,2,14,43,54,-11,50
Lucerne,4551,4,14,7,11,40,40,0,49
Grasshoppers,4551,5,12,6,14,47,49,-2,42
FC Zürich,4551,6,9,9,14,39,40,-1,36
FC Thun,4551,7,10,6,16,44,58,-14,36
FC Lugano,4551,8,10,5,17,29,47,-18,35
FC Sion,4551,9,6,7,19,38,56,-18,25
Young Boys,4552,1,21,7,4,69,34,35,70
FC Basel,4552,2,17,9,6,53,25,28,60
Lucerne,4552,3,14,8,10,45,43,2,50
St Gallen,4552,4,14,4,14,47,56,-9,46
FC Zürich,4552,5,11,10,11,41,36,5,43
FC Lugano,4552,6,10,6,16,33,50,-17,36
FC Thun,4552,7,10,5,17,44,59,-15,35
Grasshoppers,4552,8,8,7,17,36,49,-13,31
FC Sion,4552,9,7,8,17,37,53,-16,29
Young Boys,4553,1,21,6,5,71,38,33,69
FC Basel,4553,2,17,8,7,55,29,26,59
Lucerne,4553,3,14,7,11,43,44,-1,49
St Gallen,4553,4,15,3,14,44,55,-11,48
FC Zürich,4553,5,12,9,11,45,36,9,45
Grasshoppers,4553,6,10,7,15,42,49,-7,37
FC Thun,4553,7,9,6,17,45,61,-16,33
FC Lugano,4553,8,9,6,17,34,53,-19,33
FC Sion,4553,9,7,8,17,38,52,-14,29
Young Boys,4554,1,20,9,3,72,37,35,69
FC Basel,4554,2,17,10,5,55,27,28,61
Lucerne,4554,3,12,10,10,41,43,-2,46
St Gallen,4554,4,14,3,15,42,56,-14,45
FC Zürich,4554,5,10,10,12,39,36,3,40
FC Lugano,4554,6,9,8,15,32,48,-16,35
FC Sion,4554,7,9,7,16,45,53,-8,34
FC Thun,4554,8,9,7,16,45,59,-14,34
Grasshoppers,4554,9,8,8,16,42,54,-12,32
Young Boys,4555,1,22,7,3,71,32,39,73
FC Basel,4555,2,18,8,6,55,25,30,62
Lucerne,4555,3,12,9,11,40,43,-3,45
St Gallen,4555,4,13,3,16,41,59,-18,42
FC Zürich,4555,5,10,11,11,41,36,5,41
FC Lugano,4555,6,11,5,16,32,46,-14,38
Grasshoppers,4555,7,9,8,15,41,50,-9,35
FC Sion,4555,8,8,8,16,44,54,-10,32
FC Thun,4555,9,8,7,17,43,63,-20,31
Young Boys,4556,1,23,7,2,74,30,44,76
FC Basel,4556,2,16,9,7,54,28,26,57
St Gallen,4556,3,16,2,14,47,52,-5,50
FC Zürich,4556,4,12,10,10,42,34,8,46
Lucerne,4556,5,12,9,11,41,43,-2,45
FC Lugano,4556,6,10,7,15,32,48,-16,37
FC Thun,4556,7,10,5,17,43,62,-19,35
Grasshoppers,4556,8,8,6,18,38,52,-14,30
FC Sion,4556,9,6,7,19,38,60,-22,25
Young Boys,4557,1,23,6,3,71,32,39,75
FC Basel,4557,2,18,7,7,55,26,29,61
St Gallen,4557,3,16,2,14,44,52,-8,50
FC Zürich,4557,4,12,9,11,42,36,6,45
Lucerne,4557,5,11,8,13,39,49,-10,41
FC Lugano,4557,6,12,5,15,34,46,-12,41
FC Thun,4557,7,10,5,17,45,61,-16,35
Grasshoppers,4557,8,8,8,16,40,50,-10,32
FC Sion,4557,9,5,8,19,40,58,-18,23
Young Boys,4558,1,21,7,4,72,35,37,70
FC Basel,4558,2,18,8,6,55,26,29,62
St Gallen,4558,3,15,3,14,44,54,-10,48
Lucerne,4558,4,12,7,13,42,49,-7,43
FC Zürich,4558,5,10,11,11,42,37,5,41
FC Thun,4558,6,12,5,15,50,57,-7,41
Grasshoppers,4558,7,10,6,16,42,53,-11,36
FC Lugano,4558,8,10,5,17,31,49,-18,35
FC Sion,4558,9,5,10,17,37,55,-18,25
Young Boys,4559,1,23,6,3,77,36,41,75
FC Basel,4559,2,17,8,7,53,30,23,59
Lucerne,4559,3,13,9,10,47,45,2,48
St Gallen,4559,4,13,4,15,45,58,-13,43
FC Zürich,4559,5,11,9,12,39,36,3,42
FC Lugano,4559,6,11,6,15,34,49,-15,39
FC Thun,4559,7,9,7,16,44,59,-15,34
Grasshoppers,4559,8,9,6,17,42,54,-12,33
FC Sion,4559,9,6,9,17,44,58,-14,27
Young Boys,4560,1,22,6,4,74,34,40,72
FC Basel,4560,2,19,8,5,56,23,33,65
St Gallen,4560,3,14,4,14,42,56,-14,46
Lucerne,4560,4,12,8,12,39,43,-4,44
FC Zürich,4560,5,10,10,12,37,36,1,40
FC Lugano,4560,6,10,7,15,29,44,-15,37
FC Thun,4560,7,9,7,16,41,58,-17,34
FC Sion,4560,8,8,7,17,45,51,-6,31
Grasshoppers,4560,9,8,7,17,39,57,-18,31
Young Boys,4561,1,24,6,2,73,30,43,78
FC Basel,4561,2,17,8,7,53,29,24,59
Lucerne,4561,3,13,8,11,41,43,-2,47
St Gallen,4561,4,15,2,15,46,56,-10,47
FC Zürich,4561,5,10,11,11,40,36,4,41
FC Thun,4561,6,10,6,16,46,57,-11,36
FC Lugano,4561,7,10,6,16,30,48,-18,36
Grasshoppers,4561,8,8,8,16,39,49,-10,32
FC Sion,4561,9,5,9,18,37,57,-20,24
Young Boys,4562,1,23,6,3,71,33,38,75
FC Basel,4562,2,16,8,8,52,29,23,56
St Gallen,4562,3,15,3,14,45,57,-12,48
FC Zürich,4562,4,12,9,11,40,35,5,45
Lucerne,4562,5,12,9,11,41,43,-2,45
FC Thun,4562,6,12,5,15,46,56,-10,41
FC Lugano,4562,7,10,7,15,32,46,-14,37
Grasshoppers,4562,8,9,6,17,38,48,-10,33
FC Sion,4562,9,5,7,20,36,54,-18,22
Young Boys,4563,1,22,7,3,73,33,40,73
FC Basel,4563,2,18,7,7,54,26,28,61
Lucerne,4563,3,15,8,9,48,40,8,53
St Gallen,4563,4,15,2,15,41,56,-15,47
FC Zürich,4563,5,12,10,10,41,33,8,46
Grasshoppers,4563,6,9,7,16,39,49,-10,34
FC Thun,4563,7,9,6,17,40,56,-16,33
FC Lugano,4563,8,9,6,17,28,51,-23,33
FC Sion,4563,9,5,7,20,36,56,-20,22
Young Boys,4564,1,20,8,4,69,36,33,68
FC Basel,4564,2,17,9,6,52,23,29,60
Lucerne,4564,3,13,10,9,42,41,1,49
St Gallen,4564,4,13,4,15,41,58,-17,43
FC Zürich,4564,5,10,10,12,40,39,1,40
Grasshoppers,4564,6,10,7,15,41,49,-8,37
FC Thun,4564,7,10,5,17,43,58,-15,35
FC Lugano,4564,8,9,7,16,30,47,-17,34
FC Sion,4564,9,8,8,16,44,51,-7,32
Young Boys,4565,1,22,6,4,74,32,42,72
FC Basel,4565,2,20,7,5,58,25,33,67
Lucerne,4565,3,13,7,12,43,44,-1,46
FC Lugano,4565,4,13,5,14,32,43,-11,44
St Gallen,4565,5,14,2,16,43,56,-13,44
FC Zürich,4565,6,10,10,12,42,37,5,40
Grasshoppers,4565,7,9,6,17,39,57,-18,33
FC Thun,4565,8,8,7,17,43,62,-19,31
FC Sion,4565,9,6,8,18,41,59,-18,26
Young Boys,4566,1,20,8,4,68,35,33,68
FC Basel,4566,2,18,8,6,60,29,31,62
Lucerne,4566,3,14,8,10,45,42,3,50
St Gallen,4566,4,14,3,15,44,61,-17,45
FC Zürich,4566,5,11,10,11,42,38,4,43
FC Lugano,4566,6,10,7,15,31,45,-14,37
FC Thun,4566,7,9,7,16,42,60,-18,34
Grasshoppers,4566,8,8,9,15,44,55,-11,33
FC Sion,4566,9,6,8,18,44,55,-11,26
Young Boys,4567,1,23,7,2,73,35,38,76
FC Basel,4567,2,18,8,6,53,25,28,62
St Gallen,4567,3,14,2,16,41,55,-14,44
FC Zürich,4567,4,11,10,11,43,38,5,43
Lucerne,4567,5,11,9,12,41,45,-4,42
FC Lugano,4567,6,10,7,15,29,44,-15,37
FC Thun,4567,7,9,8,15,44,57,-13,35
Grasshoppers,4567,8,8,8,16,41,52,-11,32
FC Sion,4567,9,7,7,18,40,54,-14,28
Young Boys,4568,1,22,6,4,70,36,34,72
FC Basel,4568,2,18,7,7,57,27,30,61
Lucerne,4568,3,14,7,11,42,46,-4,49
St Gallen,4568,4,14,3,15,41,53,-12,45
FC Zürich,4568,5,10,10,12,42,37,5,40
FC Lugano,4568,6,11,6,15,33,47,-14,39
FC Thun,4568,7,10,6,16,43,56,-13,36
Grasshoppers,4568,8,9,6,17,38,50,-12,33
FC Sion,4568,9,7,7,18,38,52,-14,28
FC Basel,4569,1,19,8,5,61,27,34,65
Young Boys,4569,2,19,8,5,69,39,30,65
St Gallen,4569,3,14,4,14,44,57,-13,46
Lucerne,4569,4,12,9,11,44,47,-3,45
FC Zürich,4569,5,10,11,11,44,41,3,41
Grasshoppers,4569,6,10,8,14,39,44,-5,38
FC Thun,4569,7,9,7,16,45,60,-15,34
FC Lugano,4569,8,9,7,16,31,49,-18,34
FC Sion,4569,9,6,10,16,42,55,-13,28
Young Boys,4570,1,21,8,3,71,33,38,71
FC Basel,4570,2,20,7,5,56,23,33,67
Lucerne,4570,3,13,7,12,42,47,-5,46
St Gallen,4570,4,14,2,16,44,59,-15,44
FC Zürich,4570,5,10,11,11,40,36,4,41
FC Lugano,4570,6,10,7,15,31,48,-17,37
Grasshoppers,4570,7,9,7,16,39,48,-9,34
FC Sion,4570,8,7,9,16,40,50,-10,30
FC Thun,4570,9,8,6,18,39,58,-19,30
Young Boys,4571,1,23,6,3,74,34,40,75
FC Basel,4571,2,18,7,7,57,32,25,61
St Gallen,4571,3,15,4,13,47,52,-5,49
Lucerne,4571,4,11,10,11,41,46,-5,43
FC Zürich,4571,5,10,10,12,40,37,3,40
Grasshoppers,4571,6,10,7,15,43,49,-6,37
FC Lugano,4571,7,9,7,16,31,48,-17,34
FC Thun,4571,8,8,7,17,42,62,-20,31
FC Sion,4571,9,7,8,17,38,53,-15,29
Young Boys,4572,1,22,6,4,71,38,33,72
FC Basel,4572,2,17,9,6,54,27,27,60
St Gallen,4572,3,15,3,14,42,52,-10,48
Lucerne,4572,4,12,10,10,41,43,-2,46
FC Zürich,4572,5,10,11,11,41,38,3,41
FC Lugano,4572,6,10,6,16,32,48,-16,36
FC Thun,4572,7,9,7,16,41,56,-15,34
Grasshoppers,4572,8,8,8,16,38,48,-10,32
FC Sion,4572,9,6,10,16,41,51,-10,28
Young Boys,4573,1,21,8,3,69,34,35,71
FC Basel,4573,2,17,8,7,56,28,28,59
FC Zürich,4573,3,13,9,10,46,36,10,48
Lucerne,4573,4,13,9,10,46,45,1,48
St Gallen,4573,5,14,3,15,47,61,-14,45
FC Lugano,4573,6,10,6,16,32,48,-16,36
FC Sion,4573,7,8,8,16,44,54,-10,32
Grasshoppers,4573,8,8,7,17,41,54,-13,31
FC Thun,4573,9,8,6,18,45,66,-21,30
Young Boys,4574,1,21,9,2,70,33,37,72
FC Basel,4574,2,17,7,8,54,26,28,58
Lucerne,4574,3,13,9,10,44,44,0,48
St Gallen,4574,4,13,3,16,39,58,-19,42
FC Zürich,4574,5,10,11,11,40,35,5,41
FC Lugano,4574,6,10,7,15,33,49,-16,37
Grasshoppers,4574,7,9,7,16,45,52,-7,34
FC Thun,4574,8,9,7,16,44,61,-17,34
FC Sion,4574,9,8,8,16,43,54,-11,32
Young Boys,4575,1,22,6,4,71,38,33,72
FC Basel,4575,2,19,8,5,55,23,32,65
Lucerne,4575,3,12,8,12,40,44,-4,44
FC Zürich,4575,4,11,10,11,41,36,5,43
St Gallen,4575,5,13,2,17,40,56,-16,41
Grasshoppers,4575,6,10,7,15,40,48,-8,37
FC Lugano,4575,7,10,7,15,32,47,-15,37
FC Thun,4575,8,10,6,16,45,57,-12,36
FC Sion,4575,9,6,8,18,42,57,-15,26
Young Boys,4576,1,22,6,4,68,32,36,72
FC Basel,4576,2,19,7,6,56,25,31,64
Lucerne,4576,3,14,7,11,42,44,-2,49
St Gallen,4576,4,14,2,16,42,56,-14,44
Grasshoppers,4576,5,12,6,14,42,45,-3,42
FC Zürich,4576,6,10,11,11,37,34,3,41
FC Thun,4576,7,9,6,17,44,60,-16,33
FC Lugano,4576,8,9,6,17,30,50,-20,33
FC Sion,4576,9,6,7,19,38,53,-15,25
Young Boys,4577,1,22,7,3,71,33,38,73
FC Basel,4577,2,18,8,6,56,26,30,62
Lucerne,4577,3,12,10,10,43,44,-1,46
St Gallen,4577,4,14,3,15,43,58,-15,45
FC Zürich,4577,5,10,11,11,41,36,5,41
FC Lugano,4577,6,11,6,15,33,45,-12,39
Grasshoppers,4577,7,9,8,15,41,48,-7,35
FC Thun,4577,8,8,7,17,42,64,-22,31
FC Sion,4577,9,6,8,18,40,56,-16,26
Young Boys,4578,1,22,7,3,71,35,36,73
FC Basel,4578,2,19,7,6,54,25,29,64
Lucerne,4578,3,13,7,12,41,44,-3,46
FC Zürich,4578,4,12,9,11,43,37,6,45
St Gallen,4578,5,14,3,15,41,54,-13,45
Grasshoppers,4578,6,9,7,16,39,50,-11,34
FC Lugano,4578,7,9,6,17,31,49,-18,33
FC Sion,4578,8,8,8,16,42,50,-8,32
FC Thun,4578,9,8,6,18,45,63,-18,30
Young Boys,4579,1,23,7,2,76,32,44,76
FC Basel,4579,2,18,9,5,51,23,28,63
St Gallen,4579,3,15,2,15,42,55,-13,47
Lucerne,4579,4,12,8,12,41,44,-3,44
FC Zürich,4579,5,10,11,11,41,37,4,41
FC Thun,4579,6,10,6,16,46,58,-12,36
FC Lugano,4579,7,10,5,17,29,50,-21,35
Grasshoppers,4579,8,9,7,16,40,49,-9,34
FC Sion,4579,9,6,7,19,40,58,-18,25
Young Boys,4580,1,22,7,3,72,34,38,73
FC Basel,4580,2,18,9,5,53,25,28,63
St Gallen,4580,3,15,4,13,42,51,-9,49
Lucerne,4580,4,13,7,12,45,44,1,46
FC Zürich,4580,5,11,9,12,40,36,4,42
FC Thun,4580,6,10,5,17,44,58,-14,35
FC Lugano,4580,7,10,5,17,29,50,-21,35
Grasshoppers,4580,8,9,6,17,39,53,-14,33
FC Sion,4580,9,6,8,18,40,53,-13,26
Young Boys,4581,1,20,8,4,72,40,32,68
FC Basel,4581,2,16,8,8,54,30,24,56
Lucerne,4581,3,14,7,11,47,48,-1,49
St Gallen,4581,4,15,3,14,48,60,-12,48
FC Zürich,4581,5,10,11,11,44,41,3,41
FC Lugano,4581,6,11,6,15,39,49,-10,39
FC Thun,4581,7,10,6,16,46,58,-12,36
Grasshoppers,4581,8,9,8,15,42,50,-8,35
FC Sion,4581,9,6,9,17,43,59,-16,27
Young Boys,4582,1,19,9,4,66,35,31,66
FC Basel,4582,2,17,9,6,54,25,29,60
St Gallen,4582,3,16,2,14,48,54,-6,50
Lucerne,4582,4,12,8,12,39,43,-4,44
FC Zürich,4582,5,10,11,11,39,35,4,41
Grasshoppers,4582,6,11,7,14,42,47,-5,40
FC Lugano,4582,7,10,6,16,31,48,-17,36
FC Sion,4582,8,8,7,17,40,54,-14,31
FC Thun,4582,9,8,7,17,40,58,-18,31
Young Boys,4583,1,23,7,2,74,30,44,76
FC Basel,4583,2,17,8,7,51,27,24,59
FC Zürich,4583,3,12,10,10,44,35,9,46
St Gallen,4583,4,14,4,14,44,55,-11,46
Lucerne,4583,5,12,7,13,37,44,-7,43
Grasshoppers,4583,6,9,9,14,41,48,-7,36
FC Lugano,4583,7,10,5,17,31,48,-17,35
FC Thun,4583,8,8,8,16,42,58,-16,32
FC Sion,4583,9,5,10,17,38,57,-19,25
Young Boys,4584,1,22,7,3,74,36,38,73
FC Basel,4584,2,20,7,5,60,25,35,67
Lucerne,4584,3,12,8,12,42,47,-5,44
St Gallen,4584,4,13,3,16,43,58,-15,42
FC Zürich,4584,5,10,10,12,40,37,3,40
FC Lugano,4584,6,11,6,15,33,46,-13,39
Grasshoppers,4584,7,10,6,16,41,51,-10,36
FC Thun,4584,8,8,7,17,43,61,-18,31
FC Sion,4584,9,7,8,17,39,54,-15,29
Young Boys,4585,1,22,8,2,74,36,38,74
FC Basel,4585,2,18,8,6,54,26,28,62
St Gallen,4585,3,17,2,13,45,50,-5,53
Lucerne,4585,4,13,7,12,46,47,-1,46
FC Zürich,4585,5,11,9,12,41,38,3,42
FC Lugano,4585,6,10,5,17,31,47,-16,35
Grasshoppers,4585,7,9,7,16,41,53,-12,34
FC Thun,4585,8,9,5,18,41,59,-18,32
FC Sion,4585,9,6,7,19,40,57,-17,25
Young Boys,4586,1,21,8,3,71,36,35,71
FC Basel,4586,2,15,12,5,52,27,25,57
Lucerne,4586,3,14,9,9,49,41,8,51
St Gallen,4586,4,13,3,16,39,54,-15,42
FC Zürich,4586,5,10,11,11,41,38,3,41
FC Lugano,4586,6,10,6,16,31,53,-22,36
FC Sion,4586,7,9,7,16,43,51,-8,34
FC Thun,4586,8,9,7,16,46,61,-15,34
Grasshoppers,4586,9,8,7,17,39,50,-11,31
Young Boys,4587,1,22,6,4,73,36,37,72
FC Basel,4587,2,17,10,5,55,26,29,61
Lucerne,4587,3,13,8,11,43,47,-4,47
St Gallen,4587,4,13,3,16,44,59,-15,42
FC Zürich,4587,5,10,11,11,37,33,4,41
FC Thun,4587,6,10,7,15,44,57,-13,37
FC Lugano,4587,7,10,7,15,31,47,-16,37
Grasshoppers,4587,8,9,7,16,42,50,-8,34
FC Sion,4587,9,7,7,18,39,53,-14,28
Young Boys,4588,1,20,7,5,67,38,29,67
FC Basel,4588,2,19,7,6,59,23,36,64
Lucerne,4588,3,14,8,10,45,44,1,50
FC Zürich,4588,4,12,9,11,45,34,11,45
St Gallen,4588,5,14,3,15,43,57,-14,45
FC Lugano,4588,6,11,6,15,32,45,-13,39
Grasshoppers,4588,7,10,6,16,44,50,-6,36
FC Thun,4588,8,10,5,17,41,61,-20,35
FC Sion,4588,9,5,7,20,36,60,-24,22
Young Boys,4589,1,22,6,4,70,33,37,72
FC Basel,4589,2,18,8,6,54,27,27,62
Lucerne,4589,3,12,9,11,42,44,-2,45
St Gallen,4589,4,14,3,15,45,57,-12,45
FC Zürich,4589,5,11,10,11,40,34,6,43
FC Lugano,4589,6,10,6,16,31,47,-16,36
Grasshoppers,4589,7,9,7,16,41,50,-9,34
FC Sion,4589,8,8,8,16,41,53,-12,32
FC Thun,4589,9,8,7,17,42,61,-19,31
Young Boys,4590,1,22,8,2,74,32,42,74
FC Basel,4590,2,16,9,7,52,28,24,57
Lucerne,4590,3,14,7,11,42,43,-1,49
St Gallen,4590,4,14,3,15,42,56,-14,45
FC Zürich,4590,5,11,11,10,43,36,7,44
FC Lugano,4590,6,11,6,15,32,46,-14,39
Grasshoppers,4590,7,9,8,15,40,49,-9,35
FC Thun,4590,8,9,6,17,46,60,-14,33
FC Sion,4590,9,5,8,19,39,60,-21,23
Young Boys,4591,1,19,9,4,66,36,30,66
FC Basel,4591,2,17,9,6,51,25,26,60
St Gallen,4591,3,15,3,14,40,50,-10,48
Lucerne,4591,4,13,8,11,39,39,0,47
FC Zürich,4591,5,10,9,13,40,38,2,39
FC Lugano,4591,6,10,7,15,29,45,-16,37
FC Thun,4591,7,10,6,16,47,57,-10,36
Grasshoppers,4591,8,10,6,16,40,53,-13,36
FC Sion,4591,9,8,7,17,44,53,-9,31
Young Boys,4592,1,21,8,3,70,34,36,71
FC Basel,4592,2,19,8,5,58,28,30,65
Lucerne,4592,3,13,8,11,43,43,0,47
St Gallen,4592,4,14,2,16,41,57,-16,44
FC Zürich,4592,5,10,10,12,43,39,4,40
FC Thun,4592,6,11,5,16,46,57,-11,38
Grasshoppers,4592,7,8,9,15,40,50,-10,33
FC Lugano,4592,8,9,6,17,30,50,-20,33
FC Sion,4592,9,7,8,17,40,53,-13,29
Young Boys,4593,1,21,6,5,68,35,33,69
FC Basel,4593,2,19,7,6,58,23,35,64
Lucerne,4593,3,13,8,11,40,45,-5,47
St Gallen,4593,4,15,2,15,42,53,-11,47
FC Zürich,4593,5,12,10,10,43,36,7,46
Grasshoppers,4593,6,9,8,15,42,51,-9,35
FC Lugano,4593,7,9,6,17,31,50,-19,33
FC Thun,4593,8,8,7,17,43,62,-19,31
FC Sion,4593,9,7,8,17,40,52,-12,29
Young Boys,4594,1,21,6,5,67,37,30,69
FC Basel,4594,2,17,8,7,52,25,27,59
Lucerne,4594,3,14,7,11,42,43,-1,49
St Gallen,4594,4,13,3,16,44,58,-14,42
FC Zürich,4594,5,10,11,11,40,37,3,41
FC Lugano,4594,6,12,5,15,37,46,-9,41
FC Thun,4594,7,9,7,16,43,59,-16,34
FC Sion,4594,8,8,9,15,44,54,-10,33
Grasshoppers,4594,9,9,6,17,39,49,-10,33
Young Boys,4595,1,23,7,2,80,32,48,76
FC Basel,4595,2,18,7,7,51,28,23,61
Lucerne,4595,3,13,8,11,40,43,-3,47
St Gallen,4595,4,14,2,16,40,53,-13,44
FC Zürich,4595,5,10,11,11,47,40,7,41
Grasshoppers,4595,6,10,6,16,41,49,-8,36
FC Lugano,4595,7,10,6,16,31,50,-19,36
FC Thun,4595,8,9,7,16,46,61,-15,34
FC Sion,4595,9,6,8,18,39,59,-20,26
Young Boys,4596,1,22,7,3,71,33,38,73
FC Basel,4596,2,17,8,7,53,28,25,59
Lucerne,4596,3,14,8,10,47,42,5,50
St Gallen,4596,4,14,4,14,42,54,-12,46
FC Zürich,4596,5,11,10,11,41,36,5,43
FC Sion,4596,6,9,8,15,42,50,-8,35
FC Thun,4596,7,9,5,18,43,61,-18,32
FC Lugano,4596,8,9,5,18,27,49,-22,32
Grasshoppers,4596,9,8,7,17,40,53,-13,31
Young Boys,4597,1,22,6,4,72,35,37,72
FC Basel,4597,2,17,9,6,53,26,27,60
Lucerne,4597,3,14,8,10,44,41,3,50
St Gallen,4597,4,15,2,15,45,59,-14,47
FC Zürich,4597,5,12,9,11,45,38,7,45
FC Lugano,4597,6,10,5,17,32,50,-18,35
FC Thun,4597,7,8,8,16,43,60,-17,32
Grasshoppers,4597,8,8,7,17,40,53,-13,31
FC Sion,4597,9,7,8,17,44,56,-12,29
Young Boys,4598,1,21,6,5,69,37,32,69
FC Basel,4598,2,19,7,6,53,25,28,64
Lucerne,4598,3,14,7,11,40,41,-1,49
St Gallen,4598,4,14,4,14,42,52,-10,46
FC Zürich,4598,5,11,9,12,41,36,5,42
Grasshoppers,4598,6,10,7,15,46,49,-3,37
FC Thun,4598,7,9,7,16,42,57,-15,34
FC Lugano,4598,8,9,6,17,28,46,-18,33
FC Sion,4598,9,6,9,17,38,56,-18,27
Young Boys,4599,1,22,7,3,75,37,38,73
FC Basel,4599,2,19,8,5,57,26,31,65
Lucerne,4599,3,12,10,10,48,49,-1,46
St Gallen,4599,4,14,2,16,43,54,-11,44
FC Zürich,4599,5,11,10,11,42,35,7,43
FC Lugano,4599,6,10,5,17,31,51,-20,35
FC Thun,4599,7,9,6,17,42,59,-17,33
Grasshoppers,4599,8,8,8,16,43,55,-12,32
FC Sion,4599,9,7,8,17,39,54,-15,29
Young Boys,4600,1,23,6,3,78,38,40,75
FC Basel,4600,2,17,8,7,52,29,23,59
FC Zürich,4600,3,12,9,11,43,36,7,45
St Gallen,4600,4,14,3,15,46,55,-9,45
Lucerne,4600,5,12,8,12,40,48,-8,44
Grasshoppers,4600,6,10,7,15,46,49,-3,37
FC Lugano,4600,7,10,6,16,30,47,-17,36
FC Thun,4600,8,10,5,17,43,58,-15,35
FC Sion,4600,9,6,8,18,42,60,-18,26
Young Boys,4601,1,21,7,4,70,40,30,70
FC Basel,4601,2,18,7,7,56,26,30,61
St Gallen,4601,3,15,2,15,45,56,-11,47
FC Zürich,4601,4,12,10,10,43,34,9,46
Lucerne,4601,5,12,8,12,41,45,-4,44
Grasshoppers,4601,6,11,7,14,44,46,-2,40
FC Lugano,4601,7,10,6,16,31,47,-16,36
FC Sion,4601,8,7,8,17,42,56,-14,29
FC Thun,4601,9,8,5,19,38,60,-22,29
Young Boys,4602,1,22,6,4,71,33,38,72
FC Basel,4602,2,19,8,5,56,23,33,65
St Gallen,4602,3,15,3,14,43,52,-9,48
Lucerne,4602,4,12,9,11,41,46,-5,45
FC Zürich,4602,5,9,12,11,40,38,2,39
Grasshoppers,4602,6,10,7,15,45,51,-6,37
FC Thun,4602,7,10,7,15,44,56,-12,37
FC Lugano,4602,8,9,6,17,28,49,-21,33
FC Sion,4602,9,5,8,19,37,57,-20,23
Young Boys,4603,1,21,8,3,67,32,35,71
FC Basel,4603,2,20,7,5,55,23,32,67
Lucerne,4603,3,14,8,10,42,38,4,50
FC Zürich,4603,4,12,9,11,44,37,7,45
St Gallen,4603,5,14,2,16,41,56,-15,44
Grasshoppers,4603,6,10,6,16,40,48,-8,36
FC Lugano,4603,7,9,5,18,28,48,-20,32
FC Thun,4603,8,8,6,18,42,61,-19,30
FC Sion,4603,9,6,9,17,39,55,-16,27
Young Boys,4604,1,20,9,3,70,35,35,69
FC Basel,4604,2,16,9,7,49,27,22,57
St Gallen,4604,3,15,2,15,48,57,-9,47
FC Zürich,4604,4,12,10,10,46,34,12,46
Lucerne,4604,5,12,7,13,41,47,-6,43
Grasshoppers,4604,6,10,6,16,42,51,-9,36
FC Lugano,4604,7,10,6,16,30,50,-20,36
FC Thun,4604,8,9,7,16,41,56,-15,34
FC Sion,4604,9,7,10,15,43,53,-10,31
Young Boys,4605,1,21,9,2,70,33,37,72
FC Basel,4605,2,18,7,7,56,28,28,61
Lucerne,4605,3,11,10,11,41,46,-5,43
St Gallen,4605,4,13,3,16,42,57,-15,42
FC Lugano,4605,5,12,5,15,32,45,-13,41
FC Zürich,4605,6,10,10,12,38,35,3,40
Grasshoppers,4605,7,9,9,14,41,47,-6,36
FC Thun,4605,8,9,7,16,43,59,-16,34
FC Sion,4605,9,6,10,16,42,55,-13,28
Young Boys,4606,1,21,6,5,70,37,33,69
FC Basel,4606,2,19,8,5,54,23,31,65
St Gallen,4606,3,16,2,14,47,53,-6,50
FC Zürich,4606,4,12,10,10,42,34,8,46
Lucerne,4606,5,11,9,12,38,45,-7,42
Grasshoppers,4606,6,10,8,14,42,48,-6,38
FC Lugano,4606,7,9,6,17,29,48,-19,33
FC Thun,4606,8,8,7,17,39,57,-18,31
FC Sion,4606,9,6,8,18,41,57,-16,26
Young Boys,4607,1,20,7,5,72,39,33,67
FC Basel,4607,2,18,8,6,54,25,29,62
Lucerne,4607,3,13,8,11,41,44,-3,47
St Gallen,4607,4,14,4,14,45,56,-11,46
Grasshoppers,4607,5,10,8,14,48,52,-4,38
FC Zürich,4607,6,9,10,13,39,40,-1,37
FC Thun,4607,7,10,6,16,49,61,-12,36
FC Lugano,4607,8,9,8,15,31,48,-17,35
FC Sion,4607,9,7,9,16,44,58,-14,30
Young Boys,4608,1,21,7,4,67,36,31,70
FC Basel,4608,2,18,9,5,58,22,36,63
St Gallen,4608,3,14,4,14,44,52,-8,46
FC Zürich,4608,4,12,9,11,42,36,6,45
Lucerne,4608,5,11,8,13,38,47,-9,41
Grasshoppers,4608,6,11,7,14,41,45,-4,40
FC Lugano,4608,7,11,6,15,30,44,-14,39
FC Thun,4608,8,8,6,18,41,63,-22,30
FC Sion,4608,9,5,10,17,37,53,-16,25
Young Boys,4609,1,20,7,5,68,37,31,67
FC Basel,4609,2,19,7,6,55,26,29,64
St Gallen,4609,3,15,3,14,44,54,-10,48
FC Zürich,4609,4,11,11,10,43,36,7,44
Lucerne,4609,5,12,7,13,45,52,-7,43
Grasshoppers,4609,6,10,7,15,47,52,-5,37
FC Lugano,4609,7,10,6,16,37,51,-14,36
FC Thun,4609,8,9,6,17,45,62,-17,33
FC Sion,4609,9,6,10,16,41,55,-14,28
Young Boys,4610,1,21,8,3,69,32,37,71
FC Basel,4610,2,19,7,6,58,27,31,64
Lucerne,4610,3,14,7,11,47,48,-1,49
St Gallen,4610,4,15,2,15,45,55,-10,47
FC Zürich,4610,5,12,9,11,48,39,9,45
FC Lugano,4610,6,10,5,17,29,49,-20,35
Grasshoppers,4610,7,9,7,16,41,50,-9,34
FC Thun,4610,8,9,5,18,41,61,-20,32
FC Sion,4610,9,6,8,18,38,55,-17,26
Young Boys,4611,1,23,7,2,72,30,42,76
FC Basel,4611,2,16,9,7,51,27,24,57
St Gallen,4611,3,15,3,14,48,54,-6,48
FC Zürich,4611,4,11,11,10,42,34,8,44
Lucerne,4611,5,11,8,13,38,47,-9,41
FC Lugano,4611,6,11,6,15,32,47,-15,39
Grasshoppers,4611,7,10,7,15,40,48,-8,37
FC Thun,4611,8,10,5,17,46,58,-12,35
FC Sion,4611,9,5,8,19,38,62,-24,23
Young Boys,4612,1,22,7,3,72,33,39,73
FC Basel,4612,2,18,9,5,58,25,33,63
Lucerne,4612,3,14,8,10,45,46,-1,50
FC Zürich,4612,4,10,12,10,38,33,5,42
St Gallen,4612,5,13,2,17,42,61,-19,41
FC Lugano,4612,6,10,6,16,33,49,-16,36
Grasshoppers,4612,7,9,8,15,41,50,-9,35
FC Thun,4612,8,9,6,17,45,59,-14,33
FC Sion,4612,9,6,8,18,40,58,-18,26
Young Boys,4613,1,21,8,3,69,33,36,71
FC Basel,4613,2,18,9,5,56,24,32,63
Lucerne,4613,3,14,7,11,46,45,1,49
St Gallen,4613,4,14,3,15,44,57,-13,45
FC Zürich,4613,5,11,10,11,40,35,5,43
FC Lugano,4613,6,10,6,16,29,47,-18,36
Grasshoppers,4613,7,9,7,16,40,51,-11,34
FC Thun,4613,8,9,7,16,40,55,-15,34
FC Sion,4613,9,5,9,18,38,55,-17,24
Young Boys,4614,1,20,7,5,70,42,28,67
FC Basel,4614,2,17,9,6,54,29,25,60
Lucerne,4614,3,13,9,10,46,43,3,48
St Gallen,4614,4,15,3,14,43,52,-9,48
FC Zürich,4614,5,11,10,11,43,35,8,43
Grasshoppers,4614,6,11,6,15,44,49,-5,39
FC Lugano,4614,7,9,8,15,31,47,-16,35
FC Thun,4614,8,9,7,16,42,57,-15,34
FC Sion,4614,9,5,9,18,38,57,-19,24
Young Boys,4615,1,21,6,5,68,37,31,69
FC Basel,4615,2,20,7,5,62,27,35,67
Lucerne,4615,3,13,7,12,43,44,-1,46
St Gallen,4615,4,14,3,15,43,58,-15,45
FC Zürich,4615,5,11,9,12,44,39,5,42
Grasshoppers,4615,6,11,6,15,44,47,-3,39
FC Lugano,4615,7,11,5,16,32,48,-16,38
FC Thun,4615,8,9,5,18,44,63,-19,32
FC Sion,4615,9,6,8,18,39,56,-17,26
Young Boys,4616,1,21,7,4,72,36,36,70
FC Basel,4616,2,18,9,5,55,23,32,63
Lucerne,4616,3,14,7,11,46,44,2,49
St Gallen,4616,4,13,4,15,41,57,-16,43
FC Zürich,4616,5,10,10,12,39,39,0,40
FC Thun,4616,6,10,6,16,47,60,-13,36
FC Lugano,4616,7,10,6,16,32,48,-16,36
Grasshoppers,4616,8,9,7,16,41,55,-14,34
FC Sion,4616,9,7,8,17,42,53,-11,29
Young Boys,4617,1,20,8,4,68,36,32,68
FC Basel,4617,2,19,7,6,58,22,36,64
St Gallen,4617,3,15,2,15,42,61,-19,47
Lucerne,4617,4,12,8,12,40,43,-3,44
FC Zürich,4617,5,11,10,11,42,37,5,43
Grasshoppers,4617,6,10,6,16,41,50,-9,36
FC Lugano,4617,7,10,6,16,33,49,-16,36
FC Thun,4617,8,9,6,17,44,63,-19,33
FC Sion,4617,9,8,7,17,47,54,-7,31
Young Boys,4618,1,21,8,3,72,34,38,71
FC Basel,4618,2,18,7,7,56,29,27,61
FC Zürich,4618,3,12,10,10,42,35,7,46
Lucerne,4618,4,12,9,11,40,43,-3,45
St Gallen,4618,5,14,3,15,43,56,-13,45
Grasshoppers,4618,6,11,6,15,43,46,-3,39
FC Lugano,4618,7,10,8,14,34,48,-14,38
FC Thun,4618,8,9,5,18,44,60,-16,32
FC Sion,4618,9,5,8,19,37,60,-23,23
Young Boys,4619,1,21,7,4,68,34,34,70
FC Basel,4619,2,17,7,8,50,29,21,58
Lucerne,4619,3,14,8,10,43,39,4,50
St Gallen,4619,4,14,2,16,42,57,-15,44
FC Zürich,4619,5,11,10,11,40,34,6,43
FC Thun,4619,6,11,5,16,48,56,-8,38
FC Lugano,4619,7,10,7,15,30,45,-15,37
Grasshoppers,4619,8,9,6,17,41,53,-12,33
FC Sion,4619,9,7,8,17,40,55,-15,29
Young Boys,4620,1,22,8,2,70,33,37,74
FC Basel,4620,2,18,9,5,57,25,32,63
Lucerne,4620,3,13,9,10,44,45,-1,48
FC Zürich,4620,4,10,12,10,43,37,6,42
St Gallen,4620,5,13,3,16,39,55,-16,42
Grasshoppers,4620,6,10,7,15,44,51,-7,37
FC Lugano,4620,7,9,7,16,31,48,-17,34
FC Thun,4620,8,9,6,17,40,58,-18,33
FC Sion,4620,9,6,7,19,38,54,-16,25
Young Boys,4621,1,22,7,3,76,36,40,73
FC Basel,4621,2,16,9,7,50,25,25,57
Lucerne,4621,3,13,9,10,43,42,1,48
FC Zürich,4621,4,12,9,11,44,36,8,45
St Gallen,4621,5,13,3,16,41,57,-16,42
FC Lugano,4621,6,11,5,16,32,51,-19,38
Grasshoppers,4621,7,9,8,15,45,53,-8,35
FC Thun,4621,8,9,6,17,43,60,-17,33
FC Sion,4621,9,7,8,17,41,55,-14,29
Young Boys,4622,1,22,7,3,75,37,38,73
FC Basel,4622,2,16,9,7,51,27,24,57
FC Zürich,4622,3,12,10,10,41,33,8,46
Lucerne,4622,4,12,8,12,42,43,-1,44
St Gallen,4622,5,13,5,14,42,54,-12,44
Grasshoppers,4622,6,11,7,14,45,47,-2,40
FC Lugano,4622,7,10,6,16,31,52,-21,36
FC Thun,4622,8,9,7,16,41,57,-16,34
FC Sion,4622,9,5,9,18,40,58,-18,24
Young Boys,4623,1,22,7,3,77,36,41,73
FC Basel,4623,2,18,9,5,55,27,28,63
St Gallen,4623,3,14,4,14,42,53,-11,46
Lucerne,4623,4,12,9,11,43,44,-1,45
FC Zürich,4623,5,9,10,13,41,41,0,37
FC Thun,4623,6,10,6,16,45,59,-14,36
Grasshoppers,4623,7,9,7,16,42,51,-9,34
FC Lugano,4623,8,9,7,16,30,53,-23,34
FC Sion,4623,9,8,7,17,43,54,-11,31
Young Boys,4624,1,22,6,4,68,35,33,72
FC Basel,4624,2,17,9,6,54,28,26,60
Lucerne,4624,3,14,7,11,45,43,2,49
St Gallen,4624,4,14,4,14,47,56,-9,46
FC Zürich,4624,5,11,10,11,47,39,8,43
Grasshoppers,4624,6,10,6,16,41,47,-6,36
FC Thun,4624,7,10,5,17,44,58,-14,35
FC Lugano,4624,8,9,5,18,29,54,-25,32
FC Sion,4624,9,7,8,17,40,55,-15,29
Young Boys,4625,1,20,8,4,73,38,35,68
FC Basel,4625,2,18,8,6,55,27,28,62
Lucerne,4625,3,14,7,11,46,45,1,49
St Gallen,4625,4,14,2,16,43,57,-14,44
FC Zürich,4625,5,11,10,11,44,34,10,43
FC Lugano,4625,6,11,5,16,30,49,-19,38
Grasshoppers,4625,7,9,7,16,41,51,-10,34
FC Thun,4625,8,9,7,16,41,56,-15,34
FC Sion,4625,9,6,10,16,41,57,-16,28
Young Boys,4626,1,21,8,3,76,38,38,71
FC Basel,4626,2,16,7,9,52,32,20,55
St Gallen,4626,3,16,3,13,45,53,-8,51
FC Zürich,4626,4,12,9,11,42,36,6,45
Grasshoppers,4626,5,12,6,14,46,47,-1,42
Lucerne,4626,6,11,9,12,41,45,-4,42
FC Thun,4626,7,10,6,16,46,61,-15,36
FC Lugano,4626,8,10,6,16,32,48,-16,36
FC Sion,4626,9,5,8,19,39,59,-20,23
Young Boys,4627,1,21,9,2,74,36,38,72
FC Basel,4627,2,16,9,7,53,27,26,57
St Gallen,4627,3,16,3,13,43,51,-8,51
Lucerne,4627,4,13,7,12,41,43,-2,46
FC Zürich,4627,5,11,11,10,44,36,8,44
FC Lugano,4627,6,10,8,14,33,47,-14,38
FC Thun,4627,7,10,5,17,46,63,-17,35
Grasshoppers,4627,8,8,7,17,39,51,-12,31
FC Sion,4627,9,6,7,19,40,59,-19,25
Young Boys,4628,1,22,7,3,76,33,43,73
FC Basel,4628,2,18,9,5,57,27,30,63
Lucerne,4628,3,13,9,10,44,46,-2,48
St Gallen,4628,4,14,4,14,48,58,-10,46
FC Zürich,4628,5,9,10,13,40,43,-3,37
FC Thun,4628,6,10,6,16,46,56,-10,36
FC Lugano,4628,7,9,7,16,30,53,-23,34
Grasshoppers,4628,8,8,8,16,40,51,-11,32
FC Sion,4628,9,6,10,16,41,55,-14,28
Young Boys,4629,1,21,7,4,73,35,38,70
FC Basel,4629,2,19,8,5,60,25,35,65
Lucerne,4629,3,14,7,11,40,41,-1,49
St Gallen,4629,4,13,4,15,42,56,-14,43
FC Zürich,4629,5,11,9,12,43,39,4,42
FC Lugano,4629,6,12,6,14,32,43,-11,42
FC Thun,4629,7,9,5,18,43,63,-20,32
Grasshoppers,4629,8,8,6,18,38,54,-16,30
FC Sion,4629,9,7,8,17,42,57,-15,29
Young Boys,4630,1,24,6,2,78,31,47,78
FC Basel,4630,2,18,7,7,54,27,27,61
FC Zürich,4630,3,12,9,11,39,34,5,45
Lucerne,4630,4,12,8,12,40,48,-8,44
St Gallen,4630,5,13,4,15,39,56,-17,43
FC Lugano,4630,6,10,5,17,32,49,-17,35
Grasshoppers,4630,7,9,7,16,41,49,-8,34
FC Thun,4630,8,9,7,16,42,56,-14,34
FC Sion,4630,9,6,9,17,36,51,-15,27
Young Boys,4631,1,21,8,3,70,33,37,71
FC Basel,4631,2,17,9,6,49,22,27,60
Lucerne,4631,3,15,7,10,46,41,5,52
St Gallen,4631,4,14,3,15,41,52,-11,45
FC Zürich,4631,5,10,10,12,41,38,3,40
FC Thun,4631,6,11,6,15,44,55,-11,39
FC Lugano,4631,7,10,5,17,29,50,-21,35
Grasshoppers,4631,8,9,7,16,39,50,-11,34
FC Sion,4631,9,5,9,18,37,55,-18,24
Young Boys,4632,1,21,8,3,73,37,36,71
FC Basel,4632,2,19,7,6,61,28,33,64
Lucerne,4632,3,14,8,10,44,45,-1,50
St Gallen,4632,4,14,2,16,42,63,-21,44
FC Zürich,4632,5,11,10,11,43,37,6,43
FC Thun,4632,6,11,5,16,45,59,-14,38
FC Lugano,4632,7,9,7,16,31,48,-17,34
Grasshoppers,4632,8,9,6,17,42,53,-11,33
FC Sion,4632,9,6,7,19,45,56,-11,25
Young Boys,4633,1,23,7,2,76,35,41,76
FC Basel,4633,2,16,9,7,53,30,23,57
Lucerne,4633,3,14,8,10,46,41,5,50
St Gallen,4633,4,14,3,15,43,56,-13,45
FC Zürich,4633,5,10,12,10,43,37,6,42
FC Lugano,4633,6,10,7,15,30,45,-15,37
FC Thun,4633,7,10,6,16,47,58,-11,36
Grasshoppers,4633,8,9,6,17,42,56,-14,33
FC Sion,4633,9,5,8,19,41,63,-22,23
Young Boys,4634,1,24,6,2,78,32,46,78
FC Basel,4634,2,17,8,7,60,30,30,59
St Gallen,4634,3,15,3,14,44,52,-8,48
FC Zürich,4634,4,12,10,10,44,34,10,46
Lucerne,4634,5,13,7,12,40,48,-8,46
Grasshoppers,4634,6,10,6,16,41,51,-10,36
FC Lugano,4634,7,9,6,17,28,50,-22,33
FC Thun,4634,8,9,5,18,41,60,-19,32
FC Sion,4634,9,6,7,19,38,57,-19,25
Young Boys,4635,1,21,8,3,74,39,35,71
FC Basel,4635,2,15,10,7,52,31,21,55
Lucerne,4635,3,14,8,10,40,40,0,50
FC Zürich,4635,4,12,9,11,42,36,6,45
St Gallen,4635,5,14,3,15,42,55,-13,45
FC Thun,4635,6,12,5,15,50,56,-6,41
Grasshoppers,4635,7,8,8,16,38,49,-11,32
FC Lugano,4635,8,9,5,18,31,51,-20,32
FC Sion,4635,9,7,8,17,40,52,-12,29
Young Boys,4636,1,21,7,4,71,38,33,70
FC Basel,4636,2,18,7,7,52,25,27,61
St Gallen,4636,3,14,4,14,40,54,-14,46
Lucerne,4636,4,12,8,12,41,45,-4,44
FC Zürich,4636,5,11,10,11,42,36,6,43
FC Lugano,4636,6,12,6,14,33,43,-10,42
Grasshoppers,4636,7,9,8,15,42,50,-8,35
FC Thun,4636,8,8,6,18,43,62,-19,30
FC Sion,4636,9,6,10,16,42,53,-11,28
Young Boys,4637,1,22,6,4,70,33,37,72
FC Basel,4637,2,20,7,5,57,23,34,67
Lucerne,4637,3,13,8,11,44,45,-1,47
St Gallen,4637,4,13,3,16,42,58,-16,42
FC Zürich,4637,5,10,10,12,39,38,1,40
FC Lugano,4637,6,11,5,16,35,47,-12,38
Grasshoppers,4637,7,10,6,16,44,53,-9,36
FC Thun,4637,8,9,6,17,43,61,-18,33
FC Sion,4637,9,7,7,18,40,56,-16,28
Young Boys,4638,1,21,7,4,70,35,35,70
FC Basel,4638,2,16,10,6,51,25,26,58
St Gallen,4638,3,14,4,14,43,54,-11,46
Lucerne,4638,4,12,7,13,41,47,-6,43
FC Zürich,4638,5,10,11,11,42,37,5,41
FC Thun,4638,6,11,6,15,47,58,-11,39
Grasshoppers,4638,7,10,7,15,46,51,-5,37
FC Lugano,4638,8,10,6,16,31,48,-17,36
FC Sion,4638,9,7,8,17,40,56,-16,29
Young Boys,4639,1,21,6,5,69,40,29,69
FC Basel,4639,2,19,8,5,59,23,36,65
Lucerne,4639,3,13,8,11,44,47,-3,47
St Gallen,4639,4,14,3,15,44,56,-12,45
FC Zürich,4639,5,11,9,12,43,43,0,42
FC Lugano,4639,6,11,6,15,35,48,-13,39
Grasshoppers,4639,7,9,7,16,41,49,-8,34
FC Thun,4639,8,9,6,17,42,58,-16,33
FC Sion,4639,9,7,7,18,45,58,-13,28
Young Boys,4640,1,23,6,3,74,34,40,75
FC Basel,4640,2,19,8,5,59,26,33,65
St Gallen,4640,3,13,6,13,43,54,-11,45
Lucerne,4640,4,11,9,12,38,44,-6,42
FC Zürich,4640,5,10,9,13,40,40,0,39
FC Lugano,4640,6,11,6,15,34,47,-13,39
Grasshoppers,4640,7,10,7,15,42,49,-7,37
FC Thun,4640,8,9,5,18,44,63,-19,32
FC Sion,4640,9,6,8,18,40,57,-17,26
Young Boys,4641,1,22,7,3,71,34,37,73
FC Basel,4641,2,18,8,6,53,24,29,62
Lucerne,4641,3,13,9,10,40,41,-1,48
St Gallen,4641,4,13,2,17,42,57,-15,41
FC Lugano,4641,5,11,6,15,34,48,-14,39
FC Zürich,4641,6,9,11,12,36,35,1,38
FC Thun,4641,7,10,7,15,43,56,-13,37
Grasshoppers,4641,8,9,8,15,40,47,-7,35
FC Sion,4641,9,6,8,18,38,55,-17,26
Young Boys,4642,1,22,8,2,75,32,43,74
FC Basel,4642,2,18,9,5,57,26,31,63
St Gallen,4642,3,15,2,15,44,57,-13,47
Lucerne,4642,4,12,8,12,41,47,-6,44
FC Zürich,4642,5,9,9,14,38,41,-3,36
Grasshoppers,4642,6,9,8,15,42,54,-12,35
FC Lugano,4642,7,10,5,17,30,48,-18,35
FC Sion,4642,8,8,9,15,45,52,-7,33
FC Thun,4642,9,9,6,17,45,60,-15,33
Young Boys,4643,1,22,8,2,71,32,39,74
FC Basel,4643,2,17,8,7,52,27,25,59
St Gallen,4643,3,16,2,14,46,51,-5,50
Lucerne,4643,4,12,8,12,40,43,-3,44
FC Zürich,4643,5,10,12,10,40,35,5,42
FC Lugano,4643,6,10,6,16,29,48,-19,36
Grasshoppers,4643,7,9,8,15,39,48,-9,35
FC Thun,4643,8,8,7,17,42,61,-19,31
FC Sion,4643,9,7,7,18,38,52,-14,28
Young Boys,4644,1,22,6,4,73,37,36,72
FC Basel,4644,2,20,7,5,58,23,35,67
Lucerne,4644,3,13,7,12,40,41,-1,46
St Gallen,4644,4,14,2,16,44,59,-15,44
FC Zürich,4644,5,9,11,12,40,38,2,38
FC Lugano,4644,6,11,5,16,31,51,-20,38
FC Thun,4644,7,9,7,16,42,58,-16,34
Grasshoppers,4644,8,9,6,17,42,53,-11,33
FC Sion,4644,9,7,9,16,46,56,-10,30
Young Boys,4645,1,21,9,2,70,32,38,72
FC Basel,4645,2,19,8,5,54,23,31,65
Lucerne,4645,3,13,8,11,41,42,-1,47
St Gallen,4645,4,14,2,16,42,56,-14,44
FC Zürich,4645,5,11,9,12,41,37,4,42
FC Thun,4645,6,11,5,16,50,58,-8,38
FC Lugano,4645,7,10,6,16,34,50,-16,36
Grasshoppers,4645,8,8,6,18,39,55,-16,30
FC Sion,4645,9,7,7,18,42,60,-18,28
Young Boys,4646,1,19,9,4,69,38,31,66
FC Basel,4646,2,18,9,5,54,23,31,63
Lucerne,4646,3,13,8,11,45,42,3,47
FC Zürich,4646,4,11,11,10,40,33,7,44
St Gallen,4646,5,14,2,16,42,59,-17,44
FC Lugano,4646,6,11,5,16,31,46,-15,38
Grasshoppers,4646,7,10,7,15,41,47,-6,37
FC Thun,4646,8,9,6,17,40,58,-18,33
FC Sion,4646,9,6,9,17,41,57,-16,27
Young Boys,4647,1,21,8,3,69,32,37,71
FC Basel,4647,2,16,11,5,51,25,26,59
St Gallen,4647,3,14,5,13,45,55,-10,47
Lucerne,4647,4,12,10,10,41,42,-1,46
FC Zürich,4647,5,10,10,12,40,38,2,40
FC Lugano,4647,6,11,6,15,35,47,-12,39
FC Thun,4647,7,10,6,16,45,57,-12,36
Grasshoppers,4647,8,9,6,17,38,52,-14,33
FC Sion,4647,9,6,8,18,37,53,-16,26
Young Boys,4648,1,22,7,3,76,35,41,73
FC Basel,4648,2,17,9,6,54,25,29,60
St Gallen,4648,3,15,4,13,43,51,-8,49
Lucerne,4648,4,12,8,12,42,45,-3,44
FC Zürich,4648,5,11,9,12,40,39,1,42
FC Thun,4648,6,10,6,16,45,60,-15,36
Grasshoppers,4648,7,9,7,16,42,51,-9,34
FC Lugano,4648,8,9,7,16,31,51,-20,34
FC Sion,4648,9,7,7,18,41,57,-16,28
Young Boys,4649,1,22,7,3,70,34,36,73
FC Basel,4649,2,15,9,8,54,33,21,54
St Gallen,4649,3,16,2,14,44,53,-9,50
Lucerne,4649,4,13,8,11,44,45,-1,47
FC Zürich,4649,5,11,11,10,42,35,7,44
Grasshoppers,4649,6,10,6,16,40,49,-9,36
FC Lugano,4649,7,10,6,16,32,49,-17,36
FC Thun,4649,8,9,6,17,47,64,-17,33
FC Sion,4649,9,7,7,18,45,56,-11,28
Young Boys,4650,1,21,8,3,68,33,35,71
FC Basel,4650,2,18,8,6,56,25,31,62
Lucerne,4650,3,14,7,11,41,43,-2,49
St Gallen,4650,4,15,3,14,48,56,-8,48
FC Zürich,4650,5,11,10,11,42,35,7,43
Grasshoppers,4650,6,9,8,15,40,48,-8,35
FC Lugano,4650,7,9,7,16,31,48,-17,34
FC Thun,4650,8,9,6,17,44,64,-20,33
FC Sion,4650,9,6,7,19,39,57,-18,25
Young Boys,4651,1,22,6,4,71,35,36,72
FC Basel,4651,2,18,7,7,57,24,33,61
Lucerne,4651,3,13,9,10,42,44,-2,48
St Gallen,4651,4,15,3,14,47,57,-10,48
FC Zürich,4651,5,10,10,12,41,41,0,40
FC Thun,4651,6,11,5,16,45,60,-15,38
Grasshoppers,4651,7,10,6,16,41,48,-7,36
FC Lugano,4651,8,9,7,16,33,51,-18,34
FC Sion,4651,9,6,7,19,38,55,-17,25
Young Boys,4652,1,23,7,2,69,30,39,76
FC Basel,4652,2,18,7,7,55,28,27,61
St Gallen,4652,3,15,3,14,43,53,-10,48
FC Zürich,4652,4,12,9,11,45,38,7,45
Lucerne,4652,5,11,9,12,40,45,-5,42
FC Thun,4652,6,9,6,17,45,61,-16,33
FC Lugano,4652,7,9,6,17,28,47,-19,33
Grasshoppers,4652,8,8,8,16,41,53,-12,32
FC Sion,4652,9,7,9,16,44,55,-11,30
Young Boys,4653,1,21,7,4,69,33,36,70
FC Basel,4653,2,17,9,6,55,27,28,60
Lucerne,4653,3,15,7,10,46,42,4,52
St Gallen,4653,4,15,3,14,45,53,-8,48
FC Zürich,4653,5,12,10,10,42,32,10,46
FC Thun,4653,6,9,6,17,44,62,-18,33
FC Lugano,4653,7,9,5,18,27,53,-26,32
Grasshoppers,4653,8,8,7,17,41,54,-13,31
FC Sion,4653,9,7,8,17,41,54,-13,29
FC Basel,4654,1,20,7,5,61,28,33,67
Young Boys,4654,2,20,7,5,73,42,31,67
Lucerne,4654,3,14,8,10,45,43,2,50
St Gallen,4654,4,15,2,15,46,57,-11,47
FC Zürich,4654,5,12,9,11,41,35,6,45
FC Thun,4654,6,10,5,17,45,58,-13,35
Grasshoppers,4654,7,8,9,15,43,52,-9,33
FC Lugano,4654,8,9,5,18,31,53,-22,32
FC Sion,4654,9,6,8,18,42,59,-17,26
Young Boys,4655,1,20,7,5,68,37,31,67
FC Basel,4655,2,16,8,8,51,28,23,56
Lucerne,4655,3,13,8,11,41,42,-1,47
FC Zürich,4655,4,12,10,10,44,32,12,46
St Gallen,4655,5,14,3,15,42,54,-12,45
FC Lugano,4655,6,12,5,15,31,45,-14,41
Grasshoppers,4655,7,10,6,16,42,50,-8,36
FC Thun,4655,8,10,6,16,43,56,-13,36
FC Sion,4655,9,7,7,18,40,58,-18,28
Young Boys,4656,1,23,6,3,78,31,47,75
FC Basel,4656,2,17,8,7,50,25,25,59
Lucerne,4656,3,14,9,9,46,41,5,51
St Gallen,4656,4,14,3,15,44,58,-14,45
FC Lugano,4656,5,11,6,15,34,52,-18,39
FC Thun,4656,6,11,5,16,43,56,-13,38
FC Zürich,4656,7,9,9,14,39,44,-5,36
Grasshoppers,4656,8,8,8,16,40,54,-14,32
FC Sion,4656,9,6,8,18,45,58,-13,26
Young Boys,4657,1,20,7,5,68,36,32,67
FC Basel,4657,2,19,7,6,54,28,26,64
Lucerne,4657,3,15,7,10,45,43,2,52
St Gallen,4657,4,15,2,15,48,56,-8,47
FC Zürich,4657,5,11,9,12,45,39,6,42
Grasshoppers,4657,6,11,6,15,47,50,-3,39
FC Lugano,4657,7,10,5,17,33,50,-17,35
FC Thun,4657,8,9,5,18,44,62,-18,32
FC Sion,4657,9,6,8,18,42,62,-20,26
Young Boys,4658,1,22,7,3,73,35,38,73
FC Basel,4658,2,15,9,8,51,30,21,54
St Gallen,4658,3,16,3,13,43,50,-7,51
Lucerne,4658,4,14,8,10,43,42,1,50
FC Zürich,4658,5,10,9,13,40,37,3,39
FC Thun,4658,6,10,7,15,47,58,-11,37
FC Lugano,4658,7,10,6,16,29,47,-18,36
Grasshoppers,4658,8,8,7,17,39,51,-12,31
FC Sion,4658,9,7,8,17,39,54,-15,29
Young Boys,4659,1,22,7,3,73,39,34,73
FC Basel,4659,2,16,7,9,54,31,23,55
St Gallen,4659,3,14,4,14,44,55,-11,46
Lucerne,4659,4,11,9,12,42,50,-8,42
FC Zürich,4659,5,10,11,11,42,36,6,41
FC Lugano,4659,6,11,7,14,34,46,-12,40
FC Thun,4659,7,11,6,15,50,59,-9,39
Grasshoppers,4659,8,9,7,16,44,55,-11,34
FC Sion,4659,9,7,8,17,40,52,-12,29
Young Boys,4660,1,21,7,4,70,35,35,70
FC Basel,4660,2,17,8,7,52,29,23,59
St Gallen,4660,3,15,3,14,47,56,-9,48
FC Lugano,4660,4,13,5,14,36,44,-8,44
Lucerne,4660,5,12,7,13,44,49,-5,43
FC Zürich,4660,6,10,10,12,38,35,3,40
Grasshoppers,4660,7,10,7,15,42,50,-8,37
FC Thun,4660,8,8,6,18,43,68,-25,30
FC Sion,4660,9,6,11,15,45,51,-6,29
Young Boys,4661,1,22,6,4,69,35,34,72
FC Basel,4661,2,19,7,6,56,26,30,64
Lucerne,4661,3,14,7,11,42,43,-1,49
St Gallen,4661,4,13,3,16,40,56,-16,42
FC Zürich,4661,5,9,10,13,40,40,0,37
FC Thun,4661,6,10,6,16,44,55,-11,36
FC Sion,4661,7,9,8,15,42,48,-6,35
FC Lugano,4661,8,9,7,16,30,47,-17,34
Grasshoppers,4661,9,9,6,17,39,52,-13,33
Young Boys,4662,1,23,6,3,72,32,40,75
FC Basel,4662,2,18,8,6,54,25,29,62
FC Zürich,4662,3,12,9,11,41,34,7,45
Lucerne,4662,4,12,8,12,40,41,-1,44
St Gallen,4662,5,14,2,16,43,61,-18,44
FC Thun,4662,6,10,6,16,47,57,-10,36
Grasshoppers,4662,7,9,8,15,40,49,-9,35
FC Lugano,4662,8,10,5,17,31,49,-18,35
FC Sion,4662,9,6,8,18,40,60,-20,26
Young Boys,4663,1,22,7,3,76,36,40,73
FC Basel,4663,2,18,7,7,54,28,26,61
Lucerne,4663,3,14,7,11,47,43,4,49
St Gallen,4663,4,15,2,15,43,54,-11,47
FC Zürich,4663,5,12,9,11,45,38,7,45
FC Lugano,4663,6,10,5,17,32,51,-19,35
Grasshoppers,4663,7,9,6,17,39,55,-16,33
FC Sion,4663,8,8,8,16,44,52,-8,32
FC Thun,4663,9,8,5,19,40,63,-23,29
Young Boys,4664,1,22,6,4,71,39,32,72
FC Basel,4664,2,18,8,6,57,23,34,62
St Gallen,4664,3,15,3,14,45,53,-8,48
FC Zürich,4664,4,11,11,10,41,35,6,44
Lucerne,4664,5,12,8,12,42,51,-9,44
Grasshoppers,4664,6,10,7,15,44,50,-6,37
FC Lugano,4664,7,10,7,15,33,47,-14,37
FC Thun,4664,8,8,6,18,41,64,-23,30
FC Sion,4664,9,6,8,18,42,54,-12,26
Young Boys,4665,1,21,6,5,68,41,27,69
FC Basel,4665,2,17,8,7,52,26,26,59
Lucerne,4665,3,15,8,9,47,39,8,53
St Gallen,4665,4,14,4,14,41,52,-11,46
FC Zürich,4665,5,11,9,12,39,37,2,42
FC Lugano,4665,6,12,5,15,32,43,-11,41
FC Thun,4665,7,10,5,17,44,55,-11,35
Grasshoppers,4665,8,9,6,17,39,56,-17,33
FC Sion,4665,9,6,7,19,41,54,-13,25
Young Boys,4666,1,21,6,5,74,36,38,69
FC Basel,4666,2,19,8,5,58,28,30,65
FC Zürich,4666,3,12,9,11,42,35,7,45
St Gallen,4666,4,14,2,16,46,59,-13,44
Lucerne,4666,5,12,7,13,43,50,-7,43
FC Lugano,4666,6,12,5,15,36,48,-12,41
Grasshoppers,4666,7,10,6,16,40,50,-10,36
FC Thun,4666,8,10,6,16,49,63,-14,36
FC Sion,4666,9,6,7,19,41,60,-19,25
Young Boys,4667,1,23,7,2,76,32,44,76
FC Basel,4667,2,19,8,5,56,24,32,65
St Gallen,4667,3,15,3,14,45,54,-9,48
Lucerne,4667,4,12,7,13,42,50,-8,43
FC Zürich,4667,5,10,9,13,41,41,0,39
FC Thun,4667,6,11,5,16,45,55,-10,38
FC Lugano,4667,7,10,5,17,31,50,-19,35
Grasshoppers,4667,8,9,7,16,41,52,-11,34
FC Sion,4667,9,5,9,18,40,59,-19,24
Young Boys,4668,1,22,7,3,74,34,40,73
FC Basel,4668,2,17,10,5,53,24,29,61
St Gallen,4668,3,15,4,13,44,52,-8,49
Lucerne,4668,4,12,8,12,42,44,-2,44
FC Zürich,4668,5,9,12,11,39,37,2,39
Grasshoppers,4668,6,10,6,16,42,53,-11,36
FC Lugano,4668,7,10,6,16,32,50,-18,36
FC Thun,4668,8,9,6,17,41,58,-17,33
FC Sion,4668,9,6,9,17,40,55,-15,27
Young Boys,4669,1,21,7,4,72,36,36,70
FC Basel,4669,2,19,7,6,54,24,30,64
St Gallen,4669,3,16,3,13,44,51,-7,51
FC Zürich,4669,4,11,10,11,42,38,4,43
Lucerne,4669,5,11,9,12,38,44,-6,42
FC Thun,4669,6,10,6,16,44,58,-14,36
FC Lugano,4669,7,10,5,17,31,49,-18,35
Grasshoppers,4669,8,8,7,17,39,51,-12,31
FC Sion,4669,9,7,8,17,41,54,-13,29
Young Boys,4670,1,22,6,4,70,35,35,72
FC Basel,4670,2,20,7,5,58,21,37,67
St Gallen,4670,3,15,3,14,45,51,-6,48
Lucerne,4670,4,12,9,11,41,45,-4,45
FC Zürich,4670,5,11,10,11,39,38,1,43
Grasshoppers,4670,6,9,9,14,40,46,-6,36
FC Thun,4670,7,9,7,16,41,56,-15,34
FC Lugano,4670,8,9,5,18,28,51,-23,32
FC Sion,4670,9,5,8,19,36,55,-19,23
Young Boys,4671,1,22,7,3,71,33,38,73
FC Basel,4671,2,17,9,6,51,26,25,60
St Gallen,4671,3,14,4,14,40,51,-11,46
Lucerne,4671,4,12,9,11,38,40,-2,45
FC Zürich,4671,5,10,10,12,38,34,4,40
FC Lugano,4671,6,11,6,15,30,46,-16,39
Grasshoppers,4671,7,10,7,15,40,47,-7,37
FC Thun,4671,8,10,6,16,45,57,-12,36
FC Sion,4671,9,5,8,19,38,57,-19,23
Young Boys,4672,1,23,7,2,74,31,43,76
FC Basel,4672,2,18,9,5,56,24,32,63
Lucerne,4672,3,13,8,11,42,44,-2,47
St Gallen,4672,4,14,4,14,42,51,-9,46
FC Zürich,4672,5,10,11,11,40,37,3,41
FC Lugano,4672,6,9,7,16,27,50,-23,34
FC Thun,4672,7,9,6,17,42,60,-18,33
Grasshoppers,4672,8,8,6,18,39,51,-12,30
FC Sion,4672,9,6,10,16,37,51,-14,28
Young Boys,4673,1,23,6,3,76,37,39,75
FC Basel,4673,2,19,7,6,64,26,38,64
FC Zürich,4673,3,12,10,10,46,36,10,46
St Gallen,4673,4,14,2,16,40,57,-17,44
Lucerne,4673,5,12,7,13,41,47,-6,43
FC Lugano,4673,6,11,5,16,33,51,-18,38
FC Thun,4673,7,9,6,17,42,61,-19,33
Grasshoppers,4673,8,8,7,17,37,51,-14,31
FC Sion,4673,9,6,10,16,42,55,-13,28
Young Boys,4674,1,22,7,3,69,35,34,73
FC Basel,4674,2,16,8,8,50,27,23,56
Lucerne,4674,3,15,8,9,44,40,4,53
St Gallen,4674,4,14,2,16,40,55,-15,44
FC Zürich,4674,5,10,11,11,43,36,7,41
Grasshoppers,4674,6,11,6,15,45,48,-3,39
FC Lugano,4674,7,11,5,16,30,46,-16,38
FC Sion,4674,8,7,8,17,41,53,-12,29
FC Thun,4674,9,8,5,19,41,63,-22,29
Young Boys,4675,1,23,7,2,74,34,40,76
FC Basel,4675,2,17,10,5,53,24,29,61
Lucerne,4675,3,13,8,11,43,45,-2,47
St Gallen,4675,4,14,3,15,40,55,-15,45
FC Zürich,4675,5,9,13,10,39,35,4,40
Grasshoppers,4675,6,9,7,16,44,51,-7,34
FC Thun,4675,7,9,7,16,44,60,-16,34
FC Lugano,4675,8,9,7,16,30,48,-18,34
FC Sion,4675,9,6,8,18,40,55,-15,26
Young Boys,4676,1,21,7,4,69,35,34,70
FC Basel,4676,2,18,9,5,53,23,30,63
Lucerne,4676,3,14,9,9,42,40,2,51
St Gallen,4676,4,14,2,16,44,56,-12,44
FC Zürich,4676,5,11,10,11,42,36,6,43
Grasshoppers,4676,6,9,7,16,41,50,-9,34
FC Thun,4676,7,9,7,16,41,55,-14,34
FC Lugano,4676,8,9,6,17,31,51,-20,33
FC Sion,4676,9,7,7,18,37,54,-17,28
Young Boys,4677,1,20,8,4,68,37,31,68
FC Basel,4677,2,17,9,6,57,25,32,60
St Gallen,4677,3,16,2,14,44,52,-8,50
Lucerne,4677,4,13,8,11,40,41,-1,47
FC Zürich,4677,5,10,10,12,39,35,4,40
Grasshoppers,4677,6,10,6,16,40,47,-7,36
FC Lugano,4677,7,10,6,16,30,48,-18,36
FC Sion,4677,8,8,8,16,44,53,-9,32
FC Thun,4677,9,9,5,18,42,66,-24,32
Young Boys,4678,1,21,8,3,72,35,37,71
FC Basel,4678,2,19,8,5,58,26,32,65
St Gallen,4678,3,15,3,14,47,57,-10,48
Lucerne,4678,4,13,7,12,43,48,-5,46
FC Thun,4678,5,11,5,16,43,54,-11,38
FC Zürich,4678,6,9,10,13,38,37,1,37
Grasshoppers,4678,7,10,6,16,43,50,-7,36
FC Lugano,4678,8,9,7,16,30,47,-17,34
FC Sion,4678,9,6,8,18,40,60,-20,26
Young Boys,4679,1,21,8,3,73,35,38,71
FC Basel,4679,2,18,8,6,55,23,32,62
Lucerne,4679,3,14,7,11,45,44,1,49
St Gallen,4679,4,13,4,15,39,55,-16,43
FC Thun,4679,5,12,5,15,47,54,-7,41
FC Zürich,4679,6,9,9,14,37,38,-1,36
FC Lugano,4679,7,10,6,16,30,49,-19,36
Grasshoppers,4679,8,9,6,17,38,53,-15,33
FC Sion,4679,9,7,9,16,43,56,-13,30
Young Boys,4680,1,22,7,3,71,33,38,73
FC Basel,4680,2,18,7,7,56,30,26,61
St Gallen,4680,3,16,3,13,49,54,-5,51
Lucerne,4680,4,13,7,12,44,47,-3,46
FC Zürich,4680,5,12,9,11,46,38,8,45
FC Thun,4680,6,10,5,17,42,58,-16,35
FC Lugano,4680,7,9,5,18,28,49,-21,32
Grasshoppers,4680,8,8,7,17,38,50,-12,31
FC Sion,4680,9,7,8,17,43,58,-15,29
Young Boys,4681,1,23,6,3,75,33,42,75
FC Basel,4681,2,18,9,5,57,25,32,63
Lucerne,4681,3,12,9,11,46,48,-2,45
St Gallen,4681,4,13,5,14,43,56,-13,44
FC Lugano,4681,5,12,5,15,35,45,-10,41
FC Zürich,4681,6,10,9,13,37,40,-3,39
FC Thun,4681,7,10,5,17,45,58,-13,35
Grasshoppers,4681,8,9,6,17,39,52,-13,33
FC Sion,4681,9,6,8,18,38,58,-20,26
Young Boys,4682,1,23,6,3,70,34,36,75
FC Basel,4682,2,18,8,6,53,24,29,62
St Gallen,4682,3,14,5,13,43,53,-10,47
Lucerne,4682,4,12,9,11,42,44,-2,45
FC Zürich,4682,5,9,9,14,39,40,-1,36
FC Thun,4682,6,10,6,16,44,57,-13,36
FC Lugano,4682,7,10,5,17,30,48,-18,35
Grasshoppers,4682,8,9,7,16,40,50,-10,34
FC Sion,4682,9,7,9,16,41,52,-11,30
Young Boys,4683,1,22,7,3,73,34,39,73
FC Basel,4683,2,19,7,6,56,25,31,64
St Gallen,4683,3,17,2,13,50,54,-4,53
FC Zürich,4683,4,11,9,12,40,36,4,42
Lucerne,4683,5,11,8,13,40,51,-11,41
Grasshoppers,4683,6,10,7,15,43,50,-7,37
FC Lugano,4683,7,10,5,17,32,50,-18,35
FC Thun,4683,8,9,5,18,42,60,-18,32
FC Sion,4683,9,6,8,18,39,55,-16,26
Young Boys,4684,1,21,8,3,73,36,37,71
FC Basel,4684,2,16,8,8,52,33,19,56
Lucerne,4684,3,14,7,11,47,45,2,49
St Gallen,4684,4,14,4,14,41,53,-12,46
FC Zürich,4684,5,11,9,12,41,39,2,42
FC Lugano,4684,6,11,7,14,33,44,-11,40
FC Thun,4684,7,11,5,16,46,57,-11,38
Grasshoppers,4684,8,8,7,17,41,52,-11,31
FC Sion,4684,9,6,9,17,41,56,-15,27
Young Boys,4685,1,21,7,4,68,33,35,70
FC Basel,4685,2,17,7,8,52,27,25,58
St Gallen,4685,3,15,2,15,44,56,-12,47
FC Zürich,4685,4,12,10,10,47,34,13,46
Lucerne,4685,5,13,7,12,42,45,-3,46
FC Lugano,4685,6,11,5,16,31,48,-17,38
Grasshoppers,4685,7,10,6,16,41,52,-11,36
FC Thun,4685,8,10,6,16,44,57,-13,36
FC Sion,4685,9,6,8,18,41,58,-17,26
Young Boys,4686,1,22,6,4,77,40,37,72
FC Basel,4686,2,17,8,7,53,26,27,59
Lucerne,4686,3,13,10,9,41,40,1,49
FC Zürich,4686,4,12,9,11,42,35,7,45
St Gallen,4686,5,13,4,15,39,53,-14,43
FC Lugano,4686,6,11,6,15,32,47,-15,39
Grasshoppers,4686,7,9,8,15,45,54,-9,35
FC Thun,4686,8,9,6,17,44,58,-14,33
FC Sion,4686,9,6,7,19,42,62,-20,25
Young Boys,4687,1,21,8,3,72,35,37,71
FC Basel,4687,2,18,8,6,52,25,27,62
Lucerne,4687,3,13,7,12,44,45,-1,46
St Gallen,4687,4,14,3,15,39,51,-12,45
FC Lugano,4687,5,11,6,15,32,48,-16,39
FC Zürich,4687,6,9,11,12,38,37,1,38
Grasshoppers,4687,7,10,7,15,41,49,-8,37
FC Thun,4687,8,9,7,16,45,58,-13,34
FC Sion,4687,9,6,9,17,37,52,-15,27
Young Boys,4688,1,21,7,4,70,35,35,70
FC Basel,4688,2,20,7,5,54,23,31,67
Lucerne,4688,3,13,8,11,47,44,3,47
St Gallen,4688,4,13,3,16,42,59,-17,42
FC Zürich,4688,5,10,9,13,40,40,0,39
FC Lugano,4688,6,11,6,15,33,50,-17,39
Grasshoppers,4688,7,10,6,16,41,50,-9,36
FC Sion,4688,8,8,8,16,42,50,-8,32
FC Thun,4688,9,8,6,18,41,59,-18,30
Young Boys,4689,1,20,9,3,72,38,34,69
FC Basel,4689,2,19,8,5,55,22,33,65
Lucerne,4689,3,13,7,12,40,43,-3,46
St Gallen,4689,4,13,3,16,38,56,-18,42
FC Zürich,4689,5,10,10,12,42,41,1,40
FC Lugano,4689,6,11,6,15,33,45,-12,39
Grasshoppers,4689,7,10,7,15,43,49,-6,37
FC Thun,4689,8,10,5,17,46,59,-13,35
FC Sion,4689,9,6,9,17,44,60,-16,27
Young Boys,4690,1,20,9,3,67,34,33,69
FC Basel,4690,2,16,9,7,50,29,21,57
Lucerne,4690,3,13,8,11,41,41,0,47
FC Zürich,4690,4,12,10,10,43,34,9,46
St Gallen,4690,5,13,3,16,40,59,-19,42
FC Thun,4690,6,11,6,15,46,55,-9,39
FC Lugano,4690,7,11,6,15,37,47,-10,39
Grasshoppers,4690,8,9,6,17,39,50,-11,33
FC Sion,4690,9,7,7,18,39,53,-14,28
Young Boys,4691,1,20,9,3,67,34,33,69
FC Basel,4691,2,17,8,7,52,26,26,59
St Gallen,4691,3,16,2,14,44,53,-9,50
FC Zürich,4691,4,11,10,11,42,36,6,43
Lucerne,4691,5,11,8,13,38,44,-6,41
FC Lugano,4691,6,11,7,14,33,44,-11,40
FC Thun,4691,7,10,7,15,46,57,-11,37
Grasshoppers,4691,8,9,8,15,38,47,-9,35
FC Sion,4691,9,5,9,18,37,56,-19,24
Young Boys,4692,1,21,6,5,73,40,33,69
FC Basel,4692,2,18,8,6,58,28,30,62
Lucerne,4692,3,13,8,11,42,46,-4,47
St Gallen,4692,4,15,2,15,43,53,-10,47
FC Zürich,4692,5,11,10,11,43,38,5,43
Grasshoppers,4692,6,10,8,14,42,48,-6,38
FC Lugano,4692,7,10,5,17,30,48,-18,35
FC Thun,4692,8,9,7,16,39,55,-16,34
FC Sion,4692,9,6,8,18,41,55,-14,26
Young Boys,4693,1,22,6,4,71,38,33,72
FC Basel,4693,2,18,8,6,56,26,30,62
Lucerne,4693,3,13,8,11,44,44,0,47
St Gallen,4693,4,13,5,14,40,52,-12,44
FC Lugano,4693,5,11,6,15,30,44,-14,39
FC Zürich,4693,6,9,11,12,39,38,1,38
Grasshoppers,4693,7,10,6,16,43,50,-7,36
FC Thun,4693,8,9,6,17,41,59,-18,33
FC Sion,4693,9,7,8,17,41,54,-13,29
Young Boys,4694,1,20,8,4,69,38,31,68
FC Basel,4694,2,19,8,5,58,25,33,65
St Gallen,4694,3,15,3,14,45,54,-9,48
Lucerne,4694,4,13,8,11,45,42,3,47
FC Zürich,4694,5,11,9,12,41,38,3,42
FC Thun,4694,6,10,7,15,49,58,-9,37
FC Lugano,4694,7,9,6,17,30,52,-22,33
Grasshoppers,4694,8,8,8,16,39,51,-12,32
FC Sion,4694,9,7,7,18,39,57,-18,28
Young Boys,4695,1,21,7,4,71,38,33,70
FC Basel,4695,2,18,8,6,54,24,30,62
St Gallen,4695,3,16,2,14,45,52,-7,50
Lucerne,4695,4,12,8,12,40,45,-5,44
FC Zürich,4695,5,11,10,11,40,36,4,43
Grasshoppers,4695,6,11,7,14,44,45,-1,40
FC Lugano,4695,7,10,5,17,34,52,-18,35
FC Thun,4695,8,8,6,18,40,60,-20,30
FC Sion,4695,9,7,7,18,39,55,-16,28
Young Boys,4696,1,21,9,2,72,34,38,72
FC Basel,4696,2,17,10,5,55,28,27,61
St Gallen,4696,3,15,2,15,42,53,-11,47
Lucerne,4696,4,12,7,13,42,49,-7,43
FC Zürich,4696,5,10,10,12,38,36,2,40
FC Lugano,4696,6,11,6,15,32,44,-12,39
Grasshoppers,4696,7,10,7,15,45,48,-3,37
FC Thun,4696,8,10,6,16,47,60,-13,36
FC Sion,4696,9,6,7,19,41,62,-21,25
Young Boys,4697,1,21,7,4,73,40,33,70
FC Basel,4697,2,17,7,8,54,29,25,58
St Gallen,4697,3,16,2,14,49,54,-5,50
Lucerne,4697,4,13,8,11,45,47,-2,47
FC Zürich,4697,5,11,9,12,39,36,3,42
FC Thun,4697,6,12,5,15,47,54,-7,41
FC Lugano,4697,7,10,6,16,33,51,-18,36
Grasshoppers,4697,8,9,7,16,41,51,-10,34
FC Sion,4697,9,6,7,19,38,57,-19,25
Young Boys,4698,1,22,6,4,74,35,39,72
FC Basel,4698,2,18,8,6,53,26,27,62
St Gallen,4698,3,15,3,14,42,53,-11,48
Lucerne,4698,4,13,8,11,41,43,-2,47
FC Zürich,4698,5,12,10,10,43,33,10,46
Grasshoppers,4698,6,9,6,17,40,53,-13,33
FC Lugano,4698,7,9,6,17,28,48,-20,33
FC Thun,4698,8,9,5,18,44,59,-15,32
FC Sion,4698,9,7,8,17,40,55,-15,29
Young Boys,4699,1,22,8,2,73,34,39,74
FC Basel,4699,2,17,9,6,52,25,27,60
Lucerne,4699,3,13,9,10,45,44,1,48
St Gallen,4699,4,14,2,16,41,56,-15,44
FC Zürich,4699,5,11,9,12,40,35,5,42
FC Lugano,4699,6,11,5,16,32,48,-16,38
Grasshoppers,4699,7,9,7,16,42,50,-8,34
FC Thun,4699,8,9,5,18,41,61,-20,32
FC Sion,4699,9,7,8,17,41,54,-13,29
Young Boys,4700,1,22,7,3,72,37,35,73
FC Basel,4700,2,17,9,6,55,27,28,60
St Gallen,4700,3,14,3,15,41,53,-12,45
FC Zürich,4700,4,11,10,11,44,36,8,43
Lucerne,4700,5,11,8,13,40,47,-7,41
FC Lugano,4700,6,11,6,15,31,47,-16,39
FC Thun,4700,7,10,7,15,48,58,-10,37
Grasshoppers,4700,8,9,7,16,41,50,-9,34
FC Sion,4700,9,7,7,18,41,58,-17,28
Young Boys,4701,1,22,7,3,78,35,43,73
FC Basel,4701,2,17,8,7,52,26,26,59
St Gallen,4701,3,15,4,13,45,52,-7,49
Lucerne,4701,4,13,8,11,45,46,-1,47
FC Zürich,4701,5,10,10,12,41,40,1,40
FC Lugano,4701,6,10,6,16,31,50,-19,36
FC Thun,4701,7,10,5,17,44,61,-17,35
Grasshoppers,4701,8,9,7,16,40,50,-10,34
FC Sion,4701,9,6,9,17,41,57,-16,27
Young Boys,4702,1,21,7,4,72,36,36,70
FC Basel,4702,2,18,8,6,55,26,29,62
Lucerne,4702,3,13,8,11,41,44,-3,47
FC Zürich,4702,4,12,10,10,43,35,8,46
St Gallen,4702,5,14,4,14,42,54,-12,46
Grasshoppers,4702,6,9,9,14,42,49,-7,36
FC Lugano,4702,7,9,6,17,28,47,-19,33
FC Thun,4702,8,8,6,18,39,59,-20,30
FC Sion,4702,9,7,8,17,40,52,-12,29
Young Boys,4703,1,20,8,4,69,35,34,68
FC Basel,4703,2,16,10,6,53,27,26,58
Lucerne,4703,3,14,8,10,44,43,1,50
St Gallen,4703,4,14,4,14,45,55,-10,46
FC Zürich,4703,5,10,10,12,40,37,3,40
FC Lugano,4703,6,11,7,14,30,43,-13,40
Grasshoppers,4703,7,9,7,16,43,51,-8,34
FC Thun,4703,8,8,8,16,42,58,-16,32
FC Sion,4703,9,7,8,17,40,57,-17,29
Young Boys,4704,1,23,7,2,73,33,40,76
FC Basel,4704,2,15,8,9,50,31,19,53
St Gallen,4704,3,16,2,14,47,55,-8,50
FC Zürich,4704,4,11,11,10,41,34,7,44
Lucerne,4704,5,11,8,13,40,47,-7,41
FC Thun,4704,6,11,6,15,45,56,-11,39
FC Lugano,4704,7,11,6,15,35,48,-13,39
Grasshoppers,4704,8,9,6,17,42,52,-10,33
FC Sion,4704,9,6,8,18,40,57,-17,26
Young Boys,4705,1,22,7,3,72,37,35,73
FC Basel,4705,2,19,7,6,54,23,31,64
Lucerne,4705,3,13,7,12,41,45,-4,46
St Gallen,4705,4,13,2,17,39,57,-18,41
Grasshoppers,4705,5,11,6,15,45,50,-5,39
FC Lugano,4705,6,11,6,15,33,47,-14,39
FC Zürich,4705,7,9,11,12,37,35,2,38
FC Thun,4705,8,9,6,17,45,59,-14,33
FC Sion,4705,9,7,8,17,43,56,-13,29
Young Boys,4706,1,21,7,4,66,34,32,70
FC Basel,4706,2,18,9,5,52,22,30,63
Lucerne,4706,3,13,7,12,44,45,-1,46
FC Zürich,4706,4,11,11,10,45,36,9,44
St Gallen,4706,5,14,2,16,43,56,-13,44
FC Lugano,4706,6,10,6,16,30,47,-17,36
FC Thun,4706,7,10,5,17,44,59,-15,35
Grasshoppers,4706,8,9,7,16,41,50,-9,34
FC Sion,4706,9,7,8,17,41,57,-16,29
Young Boys,4707,1,22,6,4,71,37,34,72
FC Basel,4707,2,18,8,6,57,26,31,62
Lucerne,4707,3,12,9,11,41,43,-2,45
St Gallen,4707,4,13,5,14,42,55,-13,44
FC Zürich,4707,5,10,11,11,42,38,4,41
FC Lugano,4707,6,10,8,14,36,49,-13,38
FC Thun,4707,7,11,5,16,44,58,-14,38
Grasshoppers,4707,8,9,7,16,39,48,-9,34
FC Sion,4707,9,5,9,18,36,54,-18,24
Young Boys,4708,1,20,6,6,69,45,24,66
FC Basel,4708,2,17,8,7,51,26,25,59
St Gallen,4708,3,14,4,14,40,51,-11,46
FC Zürich,4708,4,11,11,10,38,32,6,44
Lucerne,4708,5,12,8,12,45,45,0,44
Grasshoppers,4708,6,12,6,14,46,47,-1,42
FC Lugano,4708,7,11,6,15,30,44,-14,39
FC Thun,4708,8,10,6,16,44,56,-12,36
FC Sion,4708,9,6,7,19,42,59,-17,25
Young Boys,4709,1,20,7,5,66,34,32,67
FC Basel,4709,2,19,8,5,56,26,30,65
St Gallen,4709,3,14,4,14,42,54,-12,46
FC Zürich,4709,4,10,11,11,41,38,3,41
Lucerne,4709,5,11,8,13,37,45,-8,41
FC Lugano,4709,6,11,6,15,32,46,-14,39
Grasshoppers,4709,7,10,7,15,40,45,-5,37
FC Thun,4709,8,10,5,17,45,57,-12,35
FC Sion,4709,9,7,8,17,38,52,-14,29
Young Boys,4710,1,20,8,4,69,38,31,68
FC Basel,4710,2,20,7,5,59,24,35,67
St Gallen,4710,3,15,2,15,45,55,-10,47
Lucerne,4710,4,12,9,11,43,46,-3,45
FC Zürich,4710,5,11,9,12,44,37,7,42
FC Thun,4710,6,10,5,17,46,60,-14,35
FC Lugano,4710,7,10,5,17,29,48,-19,35
Grasshoppers,4710,8,8,8,16,43,54,-11,32
FC Sion,4710,9,8,7,17,44,60,-16,31
Young Boys,4711,1,22,6,4,73,38,35,72
FC Basel,4711,2,19,7,6,57,27,30,64
St Gallen,4711,3,15,4,13,44,52,-8,49
Lucerne,4711,4,13,8,11,43,43,0,47
FC Zürich,4711,5,11,9,12,41,35,6,42
Grasshoppers,4711,6,10,6,16,40,52,-12,36
FC Lugano,4711,7,10,5,17,30,48,-18,35
FC Thun,4711,8,9,6,17,45,60,-15,33
FC Sion,4711,9,5,9,18,40,58,-18,24
Young Boys,4712,1,24,6,2,76,31,45,78
FC Basel,4712,2,18,7,7,53,27,26,61
St Gallen,4712,3,15,3,14,44,54,-10,48
Lucerne,4712,4,13,8,11,42,43,-1,47
FC Zürich,4712,5,9,10,13,39,39,0,37
FC Thun,4712,6,9,7,16,41,56,-15,34
FC Lugano,4712,7,9,6,17,29,48,-19,33
Grasshoppers,4712,8,8,8,16,39,53,-14,32
FC Sion,4712,9,7,9,16,39,51,-12,30
Young Boys,4713,1,21,6,5,73,37,36,69
FC Basel,4713,2,19,7,6,56,26,30,64
St Gallen,4713,3,15,3,14,43,52,-9,48
Lucerne,4713,4,13,8,11,39,41,-2,47
FC Zürich,4713,5,10,10,12,37,36,1,40
FC Lugano,4713,6,10,6,16,31,48,-17,36
FC Sion,4713,7,9,7,16,43,51,-8,34
FC Thun,4713,8,9,6,17,43,59,-16,33
Grasshoppers,4713,9,8,7,17,38,53,-15,31
Young Boys,4714,1,23,6,3,72,33,39,75
FC Basel,4714,2,18,9,5,56,25,31,63
Lucerne,4714,3,11,10,11,38,42,-4,43
St Gallen,4714,4,13,4,15,44,59,-15,43
FC Zürich,4714,5,10,10,12,39,37,2,40
FC Lugano,4714,6,11,6,15,33,49,-16,39
FC Thun,4714,7,10,6,16,46,55,-9,36
Grasshoppers,4714,8,9,7,16,39,52,-13,34
FC Sion,4714,9,6,8,18,40,55,-15,26
Young Boys,4715,1,22,8,2,77,37,40,74
FC Basel,4715,2,18,9,5,53,24,29,63
St Gallen,4715,3,15,2,15,42,57,-15,47
Lucerne,4715,4,12,8,12,40,44,-4,44
FC Zürich,4715,5,9,10,13,37,36,1,37
FC Thun,4715,6,10,6,16,47,59,-12,36
FC Lugano,4715,7,10,6,16,31,49,-18,36
Grasshoppers,4715,8,9,8,15,49,55,-6,35
FC Sion,4715,9,7,7,18,44,59,-15,28
Young Boys,4716,1,23,7,2,75,35,40,76
FC Basel,4716,2,17,8,7,53,28,25,59
St Gallen,4716,3,16,3,13,45,51,-6,51
Lucerne,4716,4,12,9,11,41,43,-2,45
FC Zürich,4716,5,11,10,11,41,37,4,43
FC Thun,4716,6,11,5,16,45,56,-11,38
Grasshoppers,4716,7,9,7,16,40,50,-10,34
FC Lugano,4716,8,9,6,17,30,48,-18,33
FC Sion,4716,9,5,7,20,37,59,-22,22
Young Boys,4717,1,22,7,3,76,37,39,73
FC Basel,4717,2,19,8,5,54,22,32,65
St Gallen,4717,3,15,3,14,45,53,-8,48
Lucerne,4717,4,13,7,12,42,44,-2,46
FC Zürich,4717,5,11,11,10,40,34,6,44
Grasshoppers,4717,6,10,7,15,42,50,-8,37
FC Lugano,4717,7,9,5,18,30,55,-25,32
FC Thun,4717,8,8,5,19,41,61,-20,29
FC Sion,4717,9,6,9,17,42,56,-14,27
Young Boys,4718,1,22,6,4,78,41,37,72
FC Basel,4718,2,18,8,6,58,30,28,62
St Gallen,4718,3,16,3,13,45,51,-6,51
Lucerne,4718,4,13,7,12,42,48,-6,46
FC Zürich,4718,5,10,9,13,43,41,2,39
Grasshoppers,4718,6,11,6,15,47,47,0,39
FC Thun,4718,7,10,5,17,47,61,-14,35
FC Lugano,4718,8,10,5,17,33,53,-20,35
FC Sion,4718,9,6,7,19,39,60,-21,25
Young Boys,4719,1,20,8,4,71,38,33,68
FC Basel,4719,2,18,8,6,58,28,30,62
St Gallen,4719,3,16,3,13,51,56,-5,51
FC Zürich,4719,4,11,10,11,41,34,7,43
Lucerne,4719,5,12,7,13,40,46,-6,43
FC Lugano,4719,6,10,7,15,31,49,-18,37
Grasshoppers,4719,7,9,6,17,40,51,-11,33
FC Sion,4719,8,8,8,16,44,53,-9,32
FC Thun,4719,9,9,5,18,40,61,-21,32
Young Boys,4720,1,21,8,3,75,41,34,71
FC Basel,4720,2,18,8,6,55,25,30,62
St Gallen,4720,3,14,3,15,41,53,-12,45
FC Zürich,4720,4,11,10,11,41,33,8,43
Grasshoppers,4720,5,11,7,14,43,47,-4,40
Lucerne,4720,6,11,7,14,38,46,-8,40
FC Lugano,4720,7,11,7,14,33,46,-13,40
FC Thun,4720,8,9,5,18,41,60,-19,32
FC Sion,4720,9,7,7,18,39,55,-16,28
Young Boys,4721,1,21,8,3,75,39,36,71
FC Basel,4721,2,19,7,6,63,27,36,64
Lucerne,4721,3,13,7,12,44,45,-1,46
FC Zürich,4721,4,11,10,11,41,34,7,43
St Gallen,4721,5,13,3,16,43,60,-17,42
FC Lugano,4721,6,12,5,15,34,47,-13,41
Grasshoppers,4721,7,9,8,15,44,52,-8,35
FC Thun,4721,8,8,6,18,38,63,-25,30
FC Sion,4721,9,6,10,16,42,57,-15,28
Young Boys,4722,1,20,7,5,69,46,23,67
FC Basel,4722,2,19,7,6,58,24,34,64
Lucerne,4722,3,13,9,10,45,45,0,48
St Gallen,4722,4,14,3,15,43,53,-10,45
FC Zürich,4722,5,11,9,12,41,36,5,42
FC Lugano,4722,6,11,7,14,33,46,-13,40
Grasshoppers,4722,7,10,6,16,44,47,-3,36
FC Thun,4722,8,10,5,17,44,59,-15,35
FC Sion,4722,9,6,7,19,38,59,-21,25
Young Boys,4723,1,20,8,4,72,41,31,68
FC Basel,4723,2,19,8,5,56,26,30,65
St Gallen,4723,3,15,3,14,44,54,-10,48
Lucerne,4723,4,13,8,11,44,45,-1,47
FC Zürich,4723,5,10,10,12,38,39,-1,40
FC Lugano,4723,6,10,7,15,35,48,-13,37
FC Thun,4723,7,10,6,16,44,57,-13,36
Grasshoppers,4723,8,9,8,15,42,48,-6,35
FC Sion,4723,9,5,8,19,39,56,-17,23
Young Boys,4724,1,23,6,3,73,34,39,75
FC Basel,4724,2,17,9,6,51,24,27,60
Lucerne,4724,3,14,8,10,44,42,2,50
FC Zürich,4724,4,12,10,10,42,35,7,46
St Gallen,4724,5,13,4,15,40,54,-14,43
Grasshoppers,4724,6,9,7,16,41,47,-6,34
FC Lugano,4724,7,9,6,17,30,50,-20,33
FC Thun,4724,8,8,8,16,42,58,-16,32
FC Sion,4724,9,6,8,18,40,59,-19,26
Young Boys,4725,1,20,9,3,67,33,34,69
FC Basel,4725,2,17,8,7,53,26,27,59
St Gallen,4725,3,15,3,14,48,58,-10,48
Lucerne,4725,4,13,8,11,46,49,-3,47
FC Zürich,4725,5,12,10,10,41,32,9,46
Grasshoppers,4725,6,10,7,15,48,53,-5,37
FC Thun,4725,7,10,5,17,45,62,-17,35
FC Lugano,4725,8,10,5,17,29,48,-19,35
FC Sion,4725,9,5,9,18,40,56,-16,24
Young Boys,4726,1,22,6,4,79,36,43,72
FC Basel,4726,2,19,7,6,57,28,29,64
St Gallen,4726,3,15,3,14,45,54,-9,48
Lucerne,4726,4,12,8,12,39,46,-7,44
FC Zürich,4726,5,11,10,11,43,37,6,43
FC Lugano,4726,6,11,6,15,31,48,-17,39
Grasshoppers,4726,7,10,6,16,41,49,-8,36
FC Thun,4726,8,8,5,19,40,60,-20,29
FC Sion,4726,9,7,7,18,39,56,-17,28
Young Boys,4727,1,21,8,3,70,34,36,71
FC Basel,4727,2,17,10,5,52,25,27,61
Lucerne,4727,3,13,9,10,44,45,-1,48
FC Zürich,4727,4,11,10,11,41,35,6,43
St Gallen,4727,5,13,4,15,42,56,-14,43
FC Lugano,4727,6,10,7,15,31,45,-14,37
Grasshoppers,4727,7,9,7,16,40,51,-11,34
FC Sion,4727,8,8,7,17,46,55,-9,31
FC Thun,4727,9,8,6,18,38,58,-20,30
Young Boys,4728,1,20,7,5,69,38,31,67
FC Basel,4728,2,17,8,7,56,32,24,59
St Gallen,4728,3,15,3,14,44,51,-7,48
FC Zürich,4728,4,12,9,11,46,38,8,45
Lucerne,4728,5,12,7,13,42,48,-6,43
Grasshoppers,4728,6,12,6,14,44,46,-2,42
FC Lugano,4728,7,10,6,16,30,49,-19,36
FC Thun,4728,8,9,5,18,43,60,-17,32
FC Sion,4728,9,8,7,17,42,54,-12,31
Young Boys,4729,1,22,8,2,70,32,38,74
FC Basel,4729,2,16,9,7,51,28,23,57
Lucerne,4729,3,13,8,11,42,41,1,47
St Gallen,4729,4,14,4,14,41,52,-11,46
FC Lugano,4729,5,12,5,15,32,45,-13,41
FC Zürich,4729,6,10,10,12,41,35,6,40
Grasshoppers,4729,7,9,6,17,39,52,-13,33
FC Thun,4729,8,9,5,18,43,63,-20,32
FC Sion,4729,9,7,9,16,42,53,-11,30
Young Boys,4730,1,22,8,2,77,32,45,74
FC Basel,4730,2,16,9,7,51,27,24,57
Lucerne,4730,3,13,9,10,42,43,-1,48
St Gallen,4730,4,15,2,15,45,56,-11,47
FC Zürich,4730,5,11,9,12,39,40,-1,42
FC Lugano,4730,6,11,6,15,33,51,-18,39
Grasshoppers,4730,7,9,8,15,41,50,-9,35
FC Sion,4730,8,7,8,17,47,56,-9,29
FC Thun,4730,9,8,5,19,41,61,-20,29
Young Boys,4731,1,21,8,3,67,32,35,71
FC Basel,4731,2,18,8,6,56,22,34,62
Lucerne,4731,3,12,10,10,41,42,-1,46
FC Zürich,4731,4,12,9,11,46,34,12,45
St Gallen,4731,5,13,3,16,40,57,-17,42
FC Lugano,4731,6,10,8,14,31,45,-14,38
Grasshoppers,4731,7,8,9,15,40,49,-9,33
FC Thun,4731,8,9,5,18,43,69,-26,32
FC Sion,4731,9,7,8,17,42,56,-14,29
Young Boys,4732,1,21,6,5,68,35,33,69
FC Basel,4732,2,18,8,6,60,29,31,62
Lucerne,4732,3,13,9,10,42,43,-1,48
St Gallen,4732,4,15,3,14,45,54,-9,48
Grasshoppers,4732,5,11,6,15,46,47,-1,39
FC Zürich,4732,6,10,9,13,38,42,-4,39
FC Lugano,4732,7,11,5,16,34,45,-11,38
FC Thun,4732,8,10,5,17,44,62,-18,35
FC Sion,4732,9,6,7,19,38,58,-20,25
Young Boys,4733,1,22,7,3,72,33,39,73
FC Basel,4733,2,19,7,6,57,26,31,64
St Gallen,4733,3,15,3,14,43,53,-10,48
Lucerne,4733,4,12,8,12,40,47,-7,44
FC Zürich,4733,5,10,10,12,39,37,2,40
Grasshoppers,4733,6,10,7,15,44,51,-7,37
FC Lugano,4733,7,9,7,16,30,47,-17,34
FC Thun,4733,8,9,6,17,46,61,-15,33
FC Sion,4733,9,7,7,18,41,57,-16,28
Young Boys,4734,1,22,7,3,72,34,38,73
FC Basel,4734,2,16,10,6,52,27,25,58
St Gallen,4734,3,14,3,15,42,55,-13,45
FC Zürich,4734,4,10,11,11,41,36,5,41
Lucerne,4734,5,11,8,13,37,46,-9,41
FC Lugano,4734,6,12,5,15,35,47,-12,41
Grasshoppers,4734,7,9,7,16,38,49,-11,34
FC Thun,4734,8,9,7,16,42,57,-15,34
FC Sion,4734,9,8,8,16,45,53,-8,32
Young Boys,4735,1,22,7,3,76,36,40,73
FC Basel,4735,2,18,8,6,55,26,29,62
Lucerne,4735,3,12,9,11,42,43,-1,45
St Gallen,4735,4,14,3,15,40,53,-13,45
FC Zürich,4735,5,10,11,11,40,36,4,41
FC Lugano,4735,6,11,6,15,32,51,-19,39
FC Thun,4735,7,10,6,16,44,58,-14,36
Grasshoppers,4735,8,8,7,17,38,50,-12,31
FC Sion,4735,9,6,9,17,38,52,-14,27
Young Boys,4736,1,20,6,6,69,40,29,66
FC Basel,4736,2,18,8,6,53,25,28,62
Lucerne,4736,3,13,8,11,45,46,-1,47
St Gallen,4736,4,13,2,17,39,58,-19,41
FC Lugano,4736,5,11,7,14,37,47,-10,40
FC Zürich,4736,6,9,11,12,36,37,-1,38
FC Thun,4736,7,11,5,16,46,57,-11,38
Grasshoppers,4736,8,10,6,16,42,50,-8,36
FC Sion,4736,9,9,7,16,44,51,-7,34
Young Boys,4737,1,22,7,3,75,32,43,73
FC Basel,4737,2,19,8,5,52,23,29,65
St Gallen,4737,3,15,3,14,44,54,-10,48
Lucerne,4737,4,13,7,12,44,44,0,46
FC Zürich,4737,5,10,12,10,38,33,5,42
FC Thun,4737,6,10,5,17,43,56,-13,35
FC Lugano,4737,7,9,7,16,28,49,-21,34
Grasshoppers,4737,8,8,7,17,36,52,-16,31
FC Sion,4737,9,5,10,17,38,55,-17,25
Young Boys,4738,1,21,7,4,75,37,38,70
FC Basel,4738,2,18,7,7,55,27,28,61
St Gallen,4738,3,14,3,15,43,57,-14,45
Lucerne,4738,4,11,11,10,43,46,-3,44
FC Zürich,4738,5,11,10,11,42,38,4,43
FC Lugano,4738,6,11,6,15,31,44,-13,39
Grasshoppers,4738,7,8,9,15,42,53,-11,33
FC Thun,4738,8,9,6,17,45,60,-15,33
FC Sion,4738,9,7,9,16,43,57,-14,30
Young Boys,4739,1,21,8,3,70,37,33,71
FC Basel,4739,2,18,7,7,55,29,26,61
St Gallen,4739,3,14,4,14,44,54,-10,46
Lucerne,4739,4,11,10,11,42,46,-4,43
FC Zürich,4739,5,11,9,12,42,38,4,42
FC Lugano,4739,6,11,6,15,32,45,-13,39
Grasshoppers,4739,7,9,7,16,40,51,-11,34
FC Thun,4739,8,9,6,17,41,56,-15,33
FC Sion,4739,9,7,9,16,42,52,-10,30
Young Boys,4740,1,22,7,3,72,37,35,73
FC Basel,4740,2,17,8,7,54,29,25,59
Lucerne,4740,3,15,7,10,46,42,4,52
St Gallen,4740,4,15,3,14,45,55,-10,48
FC Zürich,4740,5,11,10,11,42,36,6,43
FC Thun,4740,6,11,5,16,49,56,-7,38
FC Lugano,4740,7,9,6,17,30,48,-18,33
Grasshoppers,4740,8,8,8,16,40,55,-15,32
FC Sion,4740,9,5,8,19,40,60,-20,23
Young Boys,4741,1,22,7,3,75,35,40,73
FC Basel,4741,2,18,7,7,53,25,28,61
St Gallen,4741,3,14,3,15,44,54,-10,45
Lucerne,4741,4,12,8,12,38,45,-7,44
FC Zürich,4741,5,11,9,12,43,37,6,42
FC Thun,4741,6,11,5,16,44,58,-14,38
Grasshoppers,4741,7,10,7,15,40,47,-7,37
FC Lugano,4741,8,10,6,16,32,51,-19,36
FC Sion,4741,9,6,8,18,37,54,-17,26
Young Boys,4742,1,23,7,2,73,34,39,76
FC Basel,4742,2,18,7,7,55,27,28,61
Lucerne,4742,3,13,8,11,39,41,-2,47
St Gallen,4742,4,14,4,14,43,54,-11,46
FC Zürich,4742,5,10,9,13,39,38,1,39
FC Thun,4742,6,11,5,16,46,58,-12,38
FC Lugano,4742,7,10,5,17,30,49,-19,35
Grasshoppers,4742,8,8,7,17,41,52,-11,31
FC Sion,4742,9,6,10,16,41,54,-13,28
Young Boys,4743,1,22,7,3,72,34,38,73
FC Basel,4743,2,19,7,6,59,22,37,64
St Gallen,4743,3,15,3,14,45,54,-9,48
Lucerne,4743,4,12,8,12,41,43,-2,44
FC Zürich,4743,5,11,9,12,41,37,4,42
FC Thun,4743,6,10,6,16,46,61,-15,36
FC Lugano,4743,7,10,6,16,31,51,-20,36
Grasshoppers,4743,8,8,7,17,38,53,-15,31
FC Sion,4743,9,6,9,17,40,58,-18,27
Young Boys,4744,1,22,8,2,72,33,39,74
FC Basel,4744,2,18,8,6,56,23,33,62
Lucerne,4744,3,12,9,11,40,42,-2,45
St Gallen,4744,4,14,2,16,40,58,-18,44
FC Zürich,4744,5,10,10,12,40,37,3,40
FC Lugano,4744,6,11,6,15,35,46,-11,39
FC Thun,4744,7,11,5,16,46,63,-17,38
Grasshoppers,4744,8,8,8,16,40,51,-11,32
FC Sion,4744,9,6,8,18,40,56,-16,26
Young Boys,4745,1,21,7,4,69,33,36,70
FC Basel,4745,2,19,7,6,57,25,32,64
St Gallen,4745,3,14,2,16,43,59,-16,44
FC Zürich,4745,4,11,10,11,43,38,5,43
Lucerne,4745,5,12,7,13,41,48,-7,43
Grasshoppers,4745,6,10,8,14,41,46,-5,38
FC Lugano,4745,7,11,5,16,33,48,-15,38
FC Sion,4745,8,8,8,16,41,51,-10,32
FC Thun,4745,9,8,6,18,41,61,-20,30
Young Boys,4746,1,21,7,4,74,34,40,70
FC Basel,4746,2,18,8,6,56,25,31,62
Lucerne,4746,3,15,8,9,48,45,3,53
FC Zürich,4746,4,11,11,10,41,34,7,44
St Gallen,4746,5,13,4,15,46,61,-15,43
FC Thun,4746,6,9,6,17,43,58,-15,33
FC Lugano,4746,7,9,6,17,32,56,-24,33
Grasshoppers,4746,8,8,7,17,40,53,-13,31
FC Sion,4746,9,7,9,16,40,54,-14,30
Young Boys,4747,1,23,7,2,76,33,43,76
FC Basel,4747,2,19,7,6,55,25,30,64
St Gallen,4747,3,15,3,14,42,53,-11,48
Lucerne,4747,4,13,7,12,41,43,-2,46
FC Zürich,4747,5,10,10,12,40,36,4,40
FC Thun,4747,6,11,5,16,44,56,-12,38
FC Lugano,4747,7,9,8,15,31,47,-16,35
Grasshoppers,4747,8,9,6,17,40,51,-11,33
FC Sion,4747,9,5,7,20,36,61,-25,22
Young Boys,4748,1,21,8,3,72,37,35,71
FC Basel,4748,2,17,8,7,55,27,28,59
Lucerne,4748,3,14,8,10,44,43,1,50
St Gallen,4748,4,14,2,16,42,58,-16,44
FC Lugano,4748,5,11,6,15,33,46,-13,39
Grasshoppers,4748,6,10,7,15,43,49,-6,37
FC Zürich,4748,7,9,9,14,37,39,-2,36
FC Thun,4748,8,9,8,15,42,56,-14,35
FC Sion,4748,9,7,8,17,42,55,-13,29
Young Boys,4749,1,23,6,3,73,34,39,75
FC Basel,4749,2,18,8,6,56,27,29,62
FC Zürich,4749,3,11,11,10,41,35,6,44
Lucerne,4749,4,12,8,12,43,48,-5,44
St Gallen,4749,5,13,5,14,44,58,-14,44
Grasshoppers,4749,6,10,7,15,45,50,-5,37
FC Thun,4749,7,9,7,16,45,60,-15,34
FC Lugano,4749,8,9,7,16,33,51,-18,34
FC Sion,4749,9,5,9,18,39,56,-17,24
Young Boys,4750,1,21,7,4,70,38,32,70
FC Basel,4750,2,19,7,6,59,24,35,64
Lucerne,4750,3,14,8,10,45,39,6,50
St Gallen,4750,4,13,3,16,39,56,-17,42
Grasshoppers,4750,5,11,7,14,41,45,-4,40
FC Zürich,4750,6,9,11,12,39,40,-1,38
FC Lugano,4750,7,9,8,15,29,47,-18,35
FC Thun,4750,8,9,6,17,45,61,-16,33
FC Sion,4750,9,7,7,18,40,57,-17,28
Young Boys,4751,1,23,6,3,74,35,39,75
FC Basel,4751,2,17,8,7,55,29,26,59
Lucerne,4751,3,13,8,11,46,45,1,47
St Gallen,4751,4,15,2,15,46,58,-12,47
FC Zürich,4751,5,10,10,12,40,38,2,40
Grasshoppers,4751,6,10,7,15,44,49,-5,37
FC Thun,4751,7,10,5,17,44,60,-16,35
FC Lugano,4751,8,10,5,17,34,53,-19,35
FC Sion,4751,9,6,9,17,40,56,-16,27
Young Boys,4752,1,23,6,3,75,40,35,75
FC Basel,4752,2,19,7,6,61,28,33,64
FC Zürich,4752,3,11,10,11,42,34,8,43
Lucerne,4752,4,11,9,12,42,48,-6,42
St Gallen,4752,5,13,3,16,42,58,-16,42
Grasshoppers,4752,6,10,7,15,43,50,-7,37
FC Lugano,4752,7,10,7,15,33,47,-14,37
FC Thun,4752,8,9,5,18,43,63,-20,32
FC Sion,4752,9,7,8,17,43,56,-13,29
Young Boys,4753,1,22,8,2,73,32,41,74
FC Basel,4753,2,17,8,7,53,27,26,59
St Gallen,4753,3,16,3,13,55,62,-7,51
Lucerne,4753,4,12,7,13,41,46,-5,43
FC Zürich,4753,5,10,10,12,40,37,3,40
Grasshoppers,4753,6,11,6,15,43,46,-3,39
FC Thun,4753,7,11,5,16,44,59,-15,38
FC Lugano,4753,8,9,6,17,30,53,-23,33
FC Sion,4753,9,5,9,18,45,62,-17,24
Young Boys,4754,1,21,8,3,71,38,33,71
FC Basel,4754,2,18,8,6,54,26,28,62
FC Zürich,4754,3,12,9,11,41,33,8,45
Lucerne,4754,4,12,8,12,44,45,-1,44
St Gallen,4754,5,13,4,15,41,54,-13,43
FC Thun,4754,6,11,6,15,44,56,-12,39
FC Lugano,4754,7,10,5,17,30,49,-19,35
Grasshoppers,4754,8,9,7,16,46,55,-9,34
FC Sion,4754,9,6,9,17,40,55,-15,27
Young Boys,4755,1,21,7,4,70,35,35,70
FC Basel,4755,2,16,11,5,58,28,30,59
Lucerne,4755,3,14,9,9,44,40,4,51
FC Zürich,4755,4,11,11,10,44,38,6,44
St Gallen,4755,5,13,5,14,43,56,-13,44
FC Lugano,4755,6,10,6,16,31,49,-18,36
Grasshoppers,4755,7,9,6,17,39,51,-12,33
FC Sion,4755,8,8,8,16,46,53,-7,32
FC Thun,4755,9,8,5,19,39,64,-25,29
Young Boys,4756,1,21,8,3,69,34,35,71
FC Basel,4756,2,18,8,6,56,28,28,62
St Gallen,4756,3,15,4,13,47,55,-8,49
Lucerne,4756,4,12,10,10,42,44,-2,46
FC Zürich,4756,5,11,10,11,42,37,5,43
FC Thun,4756,6,9,7,16,44,59,-15,34
FC Lugano,4756,7,9,7,16,30,47,-17,34
Grasshoppers,4756,8,8,8,16,37,48,-11,32
FC Sion,4756,9,6,8,18,40,55,-15,26
Young Boys,4757,1,22,7,3,72,33,39,73
FC Basel,4757,2,18,9,5,53,21,32,63
St Gallen,4757,3,15,3,14,42,55,-13,48
FC Zürich,4757,4,11,11,10,43,36,7,44
Lucerne,4757,5,12,7,13,41,46,-5,43
FC Thun,4757,6,10,7,15,45,57,-12,37
Grasshoppers,4757,7,10,6,16,43,52,-9,36
FC Lugano,4757,8,9,6,17,28,50,-22,33
FC Sion,4757,9,5,8,19,42,59,-17,23
Young Boys,4758,1,22,8,2,76,36,40,74
FC Basel,4758,2,16,11,5,53,26,27,59
St Gallen,4758,3,14,4,14,46,59,-13,46
FC Zürich,4758,4,11,11,10,42,36,6,44
Lucerne,4758,5,11,10,11,39,44,-5,43
FC Thun,4758,6,9,7,16,43,58,-15,34
FC Lugano,4758,7,9,7,16,33,50,-17,34
Grasshoppers,4758,8,8,8,16,39,53,-14,32
FC Sion,4758,9,6,10,16,45,54,-9,28
Young Boys,4759,1,20,8,4,67,34,33,68
FC Basel,4759,2,17,8,7,52,28,24,59
Lucerne,4759,3,15,7,10,46,41,5,52
St Gallen,4759,4,15,2,15,43,56,-13,47
FC Zürich,4759,5,11,10,11,44,35,9,43
FC Lugano,4759,6,11,5,16,33,48,-15,38
FC Thun,4759,7,10,6,16,43,57,-14,36
Grasshoppers,4759,8,8,7,17,37,49,-12,31
FC Sion,4759,9,7,7,18,38,55,-17,28
Young Boys,4760,1,21,8,3,71,35,36,71
FC Basel,4760,2,17,10,5,54,23,31,61
Lucerne,4760,3,13,8,11,44,45,-1,47
St Gallen,4760,4,14,3,15,44,55,-11,45
FC Zürich,4760,5,10,12,10,41,33,8,42
FC Lugano,4760,6,10,6,16,28,47,-19,36
Grasshoppers,4760,7,9,8,15,41,50,-9,35
FC Thun,4760,8,9,6,17,41,63,-22,33
FC Sion,4760,9,6,9,17,39,52,-13,27
Young Boys,4761,1,22,8,2,73,32,41,74
FC Basel,4761,2,18,9,5,55,24,31,63
St Gallen,4761,3,14,3,15,43,55,-12,45
Lucerne,4761,4,12,8,12,41,46,-5,44
FC Zürich,4761,5,10,10,12,42,40,2,40
FC Thun,4761,6,10,7,15,47,57,-10,37
FC Lugano,4761,7,10,7,15,33,49,-16,37
Grasshoppers,4761,8,8,7,17,39,52,-13,31
FC Sion,4761,9,6,9,17,40,58,-18,27
Young Boys,4762,1,19,10,3,69,36,33,67
FC Basel,4762,2,17,9,6,53,26,27,60
Lucerne,4762,3,13,8,11,42,44,-2,47
FC Zürich,4762,4,12,9,11,43,36,7,45
St Gallen,4762,5,13,4,15,42,56,-14,43
Grasshoppers,4762,6,11,6,15,42,49,-7,39
FC Thun,4762,7,11,5,16,48,56,-8,38
FC Lugano,4762,8,9,7,16,30,47,-17,34
FC Sion,4762,9,6,8,18,38,57,-19,26
Young Boys,4763,1,20,8,4,69,37,32,68
FC Basel,4763,2,17,9,6,58,26,32,60
Lucerne,4763,3,12,9,11,43,48,-5,45
FC Zürich,4763,4,10,12,10,38,33,5,42
St Gallen,4763,5,13,3,16,41,57,-16,42
FC Lugano,4763,6,10,8,14,30,44,-14,38
Grasshoppers,4763,7,9,9,14,44,49,-5,36
FC Thun,4763,8,9,6,17,42,62,-20,33
FC Sion,4763,9,8,8,16,42,51,-9,32
Young Boys,4764,1,23,7,2,75,34,41,76
FC Basel,4764,2,17,10,5,55,27,28,61
St Gallen,4764,3,16,2,14,44,54,-10,50
Lucerne,4764,4,11,9,12,39,44,-5,42
FC Zürich,4764,5,10,10,12,39,38,1,40
Grasshoppers,4764,6,11,6,15,44,51,-7,39
FC Lugano,4764,7,10,6,16,32,48,-16,36
FC Thun,4764,8,9,5,18,45,62,-17,32
FC Sion,4764,9,6,7,19,40,55,-15,25
Young Boys,4765,1,23,6,3,76,37,39,75
FC Basel,4765,2,17,9,6,53,27,26,60
St Gallen,4765,3,14,2,16,41,58,-17,44
Lucerne,4765,4,11,9,12,41,46,-5,42
FC Zürich,4765,5,10,11,11,41,37,4,41
FC Lugano,4765,6,10,7,15,36,51,-15,37
Grasshoppers,4765,7,10,6,16,40,51,-11,36
FC Thun,4765,8,9,6,17,40,59,-19,33
FC Sion,4765,9,8,8,16,47,49,-2,32
Young Boys,4766,1,22,7,3,74,34,40,73
FC Basel,4766,2,18,9,5,58,27,31,63
St Gallen,4766,3,14,4,14,43,55,-12,46
Lucerne,4766,4,12,9,11,43,47,-4,45
FC Zürich,4766,5,10,12,10,42,34,8,42
FC Lugano,4766,6,9,7,16,28,48,-20,34
Grasshoppers,4766,7,8,8,16,40,52,-12,32
FC Thun,4766,8,8,8,16,42,59,-17,32
FC Sion,4766,9,7,8,17,42,56,-14,29
Young Boys,4767,1,22,7,3,75,33,42,73
FC Basel,4767,2,17,10,5,55,26,29,61
St Gallen,4767,3,14,2,16,43,58,-15,44
Lucerne,4767,4,11,10,11,42,47,-5,43
FC Zürich,4767,5,10,10,12,42,37,5,40
FC Lugano,4767,6,11,6,15,32,50,-18,39
FC Thun,4767,7,10,5,17,44,59,-15,35
FC Sion,4767,8,9,7,16,41,52,-11,34
Grasshoppers,4767,9,8,7,17,39,51,-12,31
Young Boys,4768,1,23,6,3,74,34,40,75
FC Basel,4768,2,18,8,6,56,28,28,62
Lucerne,4768,3,12,8,12,43,48,-5,44
St Gallen,4768,4,13,5,14,42,55,-13,44
FC Zürich,4768,5,10,9,13,42,40,2,39
FC Thun,4768,6,11,6,15,48,56,-8,39
FC Lugano,4768,7,11,6,15,31,45,-14,39
Grasshoppers,4768,8,8,6,18,40,57,-17,30
FC Sion,4768,9,7,8,17,44,57,-13,29
Young Boys,4769,1,22,6,4,72,36,36,72
FC Basel,4769,2,19,8,5,56,22,34,65
St Gallen,4769,3,15,2,15,43,58,-15,47
FC Zürich,4769,4,11,10,11,41,34,7,43
Lucerne,4769,5,12,7,13,41,46,-5,43
Grasshoppers,4769,6,11,6,15,46,49,-3,39
FC Lugano,4769,7,10,5,17,31,51,-20,35
FC Thun,4769,8,9,5,18,41,61,-20,32
FC Sion,4769,9,7,7,18,41,55,-14,28
Young Boys,4770,1,22,7,3,73,35,38,73
FC Basel,4770,2,18,8,6,56,28,28,62
Lucerne,4770,3,12,9,11,39,41,-2,45
St Gallen,4770,4,14,3,15,40,56,-16,45
FC Zürich,4770,5,11,9,12,42,39,3,42
FC Lugano,4770,6,12,5,15,37,47,-10,41
FC Thun,4770,7,9,7,16,44,58,-14,34
Grasshoppers,4770,8,8,7,17,38,49,-11,31
FC Sion,4770,9,6,9,17,37,53,-16,27
Young Boys,4771,1,21,8,3,73,37,36,71
FC Basel,4771,2,16,8,8,53,28,25,56
St Gallen,4771,3,15,3,14,41,51,-10,48
Lucerne,4771,4,12,7,13,42,48,-6,43
FC Zürich,4771,5,11,9,12,43,37,6,42
FC Lugano,4771,6,12,5,15,32,46,-14,41
FC Thun,4771,7,11,6,15,43,55,-12,39
Grasshoppers,4771,8,10,7,15,45,50,-5,37
FC Sion,4771,9,5,9,18,37,57,-20,24
Young Boys,4772,1,20,8,4,72,39,33,68
FC Basel,4772,2,19,8,5,59,26,33,65
Lucerne,4772,3,13,8,11,43,43,0,47
St Gallen,4772,4,14,5,13,42,52,-10,47
FC Zürich,4772,5,9,9,14,37,38,-1,36
FC Thun,4772,6,10,6,16,42,58,-16,36
FC Lugano,4772,7,10,6,16,30,49,-19,36
Grasshoppers,4772,8,9,6,17,40,51,-11,33
FC Sion,4772,9,7,10,15,40,49,-9,31
Young Boys,4773,1,22,7,3,80,36,44,73
FC Basel,4773,2,17,7,8,57,33,24,58
FC Zürich,4773,3,13,9,10,46,33,13,48
St Gallen,4773,4,14,4,14,42,53,-11,46
Lucerne,4773,5,12,9,11,41,47,-6,45
FC Lugano,4773,6,10,5,17,31,49,-18,35
FC Sion,4773,7,8,8,16,41,52,-11,32
Grasshoppers,4773,8,8,8,16,38,49,-11,32
FC Thun,4773,9,9,5,18,42,66,-24,32
Young Boys,4774,1,21,8,3,73,37,36,71
FC Basel,4774,2,18,8,6,61,27,34,62
Lucerne,4774,3,13,9,10,47,46,1,48
St Gallen,4774,4,13,3,16,44,59,-15,42
FC Zürich,4774,5,10,10,12,39,36,3,40
Grasshoppers,4774,6,10,8,14,47,46,1,38
FC Lugano,4774,7,10,6,16,31,51,-20,36
FC Thun,4774,8,10,5,17,47,62,-15,35
FC Sion,4774,9,7,7,18,39,64,-25,28
Young Boys,4775,1,22,8,2,76,32,44,74
FC Basel,4775,2,19,7,6,59,27,32,64
St Gallen,4775,3,16,2,14,43,54,-11,50
FC Zürich,4775,4,11,9,12,43,39,4,42
Lucerne,4775,5,11,9,12,40,49,-9,42
FC Lugano,4775,6,10,7,15,31,45,-14,37
Grasshoppers,4775,7,9,7,16,41,52,-11,34
FC Thun,4775,8,9,5,18,41,59,-18,32
FC Sion,4775,9,6,8,18,40,57,-17,26
Young Boys,4776,1,21,8,3,69,34,35,71
FC Basel,4776,2,16,9,7,54,31,23,57
Lucerne,4776,3,13,10,9,45,44,1,49
St Gallen,4776,4,14,3,15,42,53,-11,45
FC Zürich,4776,5,10,11,11,40,35,5,41
Grasshoppers,4776,6,9,8,15,42,50,-8,35
FC Thun,4776,7,9,7,16,43,58,-15,34
FC Lugano,4776,8,9,7,16,28,46,-18,34
FC Sion,4776,9,7,9,16,44,56,-12,30
Young Boys,4777,1,20,7,5,66,39,27,67
FC Basel,4777,2,18,8,6,56,25,31,62
St Gallen,4777,3,15,2,15,41,52,-11,47
Lucerne,4777,4,13,7,12,43,44,-1,46
FC Zürich,4777,5,10,11,11,42,35,7,41
Grasshoppers,4777,6,10,7,15,40,48,-8,37
FC Lugano,4777,7,10,7,15,28,44,-16,37
FC Thun,4777,8,9,6,17,41,59,-18,33
FC Sion,4777,9,8,7,17,43,54,-11,31
Young Boys,4778,1,22,6,4,70,33,37,72
FC Basel,4778,2,18,7,7,56,28,28,61
Lucerne,4778,3,13,8,11,47,47,0,47
St Gallen,4778,4,15,2,15,42,54,-12,47
FC Zürich,4778,5,11,9,12,45,39,6,42
FC Lugano,4778,6,11,6,15,32,46,-14,39
FC Thun,4778,7,11,5,16,46,60,-14,38
Grasshoppers,4778,8,9,6,17,42,54,-12,33
FC Sion,4778,9,6,7,19,37,56,-19,25
Young Boys,4779,1,22,8,2,76,34,42,74
FC Basel,4779,2,18,9,5,55,25,30,63
Lucerne,4779,3,13,7,12,43,50,-7,46
St Gallen,4779,4,14,3,15,43,54,-11,45
FC Zürich,4779,5,11,10,11,42,36,6,43
FC Thun,4779,6,10,5,17,43,61,-18,35
FC Lugano,4779,7,10,5,17,32,51,-19,35
Grasshoppers,4779,8,9,6,17,40,48,-8,33
FC Sion,4779,9,6,9,17,39,54,-15,27
Young Boys,4780,1,20,8,4,68,38,30,68
FC Basel,4780,2,18,8,6,57,26,31,62
Lucerne,4780,3,11,11,10,43,47,-4,44
St Gallen,4780,4,13,5,14,41,53,-12,44
FC Zürich,4780,5,10,11,11,41,36,5,41
FC Thun,4780,6,10,6,16,45,59,-14,36
FC Lugano,4780,7,9,9,14,29,44,-15,36
FC Sion,4780,8,9,7,16,42,52,-10,34
Grasshoppers,4780,9,8,7,17,41,52,-11,31
Young Boys,4781,1,22,8,2,77,32,45,74
FC Basel,4781,2,18,9,5,56,23,33,63
Lucerne,4781,3,13,8,11,43,42,1,47
St Gallen,4781,4,13,4,15,39,55,-16,43
FC Zürich,4781,5,10,9,13,39,36,3,39
FC Lugano,4781,6,11,6,15,31,51,-20,39
FC Thun,4781,7,10,6,16,42,57,-15,36
Grasshoppers,4781,8,9,8,15,43,50,-7,35
FC Sion,4781,9,5,8,19,36,60,-24,23
Young Boys,4782,1,24,6,2,77,33,44,78
FC Basel,4782,2,17,9,6,57,27,30,60
Lucerne,4782,3,14,8,10,43,44,-1,50
St Gallen,4782,4,14,2,16,41,56,-15,44
FC Zürich,4782,5,10,12,10,39,34,5,42
FC Thun,4782,6,10,6,16,46,60,-14,36
FC Lugano,4782,7,9,5,18,29,49,-20,32
Grasshoppers,4782,8,8,6,18,37,50,-13,30
FC Sion,4782,9,7,8,17,38,54,-16,29
Young Boys,4783,1,20,7,5,68,37,31,67
FC Basel,4783,2,18,8,6,54,24,30,62
Lucerne,4783,3,15,8,9,43,39,4,53
St Gallen,4783,4,13,4,15,41,56,-15,43
FC Zürich,4783,5,10,11,11,43,39,4,41
FC Thun,4783,6,10,6,16,43,58,-15,36
FC Lugano,4783,7,10,6,16,33,49,-16,36
Grasshoppers,4783,8,9,7,16,40,48,-8,34
FC Sion,4783,9,6,9,17,40,55,-15,27
Young Boys,4784,1,22,6,4,70,34,36,72
FC Basel,4784,2,18,7,7,54,24,30,61
Lucerne,4784,3,14,7,11,46,46,0,49
FC Zürich,4784,4,11,9,12,41,37,4,42
St Gallen,4784,5,13,3,16,41,56,-15,42
Grasshoppers,4784,6,11,6,15,43,49,-6,39
FC Lugano,4784,7,10,6,16,31,49,-18,36
FC Thun,4784,8,10,5,17,42,58,-16,35
FC Sion,4784,9,7,7,18,38,53,-15,28
Young Boys,4785,1,21,8,3,73,37,36,71
FC Basel,4785,2,16,9,7,53,27,26,57
St Gallen,4785,3,16,3,13,44,50,-6,51
FC Zürich,4785,4,11,10,11,39,34,5,43
Lucerne,4785,5,11,10,11,41,47,-6,43
FC Lugano,4785,6,10,6,16,31,47,-16,36
Grasshoppers,4785,7,9,8,15,42,51,-9,35
FC Thun,4785,8,9,6,17,42,58,-16,33
FC Sion,4785,9,7,8,17,40,54,-14,29
Young Boys,4786,1,21,7,4,66,32,34,70
FC Basel,4786,2,18,7,7,55,27,28,61
Lucerne,4786,3,14,7,11,46,46,0,49
St Gallen,4786,4,15,3,14,45,52,-7,48
FC Zürich,4786,5,11,10,11,43,37,6,43
Grasshoppers,4786,6,9,7,16,41,49,-8,34
FC Sion,4786,7,8,9,15,40,50,-10,33
FC Lugano,4786,8,9,5,18,30,53,-23,32
FC Thun,4786,9,8,7,17,42,62,-20,31
Young Boys,4787,1,24,6,2,75,36,39,78
FC Basel,4787,2,18,8,6,57,25,32,62
St Gallen,4787,3,14,3,15,43,55,-12,45
Lucerne,4787,4,11,9,12,39,45,-6,42
FC Zürich,4787,5,10,10,12,38,39,-1,40
FC Lugano,4787,6,11,6,15,33,45,-12,39
FC Thun,4787,7,11,5,16,49,59,-10,38
Grasshoppers,4787,8,8,7,17,42,54,-12,31
FC Sion,4787,9,6,8,18,39,57,-18,26
Young Boys,4788,1,23,6,3,72,34,38,75
FC Basel,4788,2,18,8,6,58,27,31,62
Lucerne,4788,3,13,8,11,43,46,-3,47
FC Zürich,4788,4,11,10,11,44,36,8,43
St Gallen,4788,5,13,3,16,41,56,-15,42
FC Lugano,4788,6,12,5,15,34,45,-11,41
Grasshoppers,4788,7,9,6,17,41,53,-12,33
FC Sion,4788,8,8,7,17,45,57,-12,31
FC Thun,4788,9,8,5,19,41,65,-24,29
Young Boys,4789,1,22,6,4,74,38,36,72
FC Basel,4789,2,17,9,6,54,26,28,60
Lucerne,4789,3,13,9,10,45,44,1,48
FC Zürich,4789,4,12,9,11,41,36,5,45
St Gallen,4789,5,13,4,15,40,54,-14,43
FC Lugano,4789,6,10,5,17,31,50,-19,35
Grasshoppers,4789,7,9,6,17,40,53,-13,33
FC Thun,4789,8,9,6,17,43,58,-15,33
FC Sion,4789,9,8,8,16,43,52,-9,32
Young Boys,4790,1,21,7,4,70,38,32,70
FC Basel,4790,2,18,8,6,57,27,30,62
Lucerne,4790,3,14,7,11,45,46,-1,49
St Gallen,4790,4,14,3,15,44,57,-13,45
Grasshoppers,4790,5,11,6,15,45,48,-3,39
FC Zürich,4790,6,10,9,13,39,42,-3,39
FC Lugano,4790,7,10,6,16,33,46,-13,36
FC Sion,4790,8,8,8,16,46,55,-9,32
FC Thun,4790,9,8,6,18,42,62,-20,30
Young Boys,4791,1,21,8,3,77,38,39,71
FC Basel,4791,2,16,11,5,50,24,26,59
St Gallen,4791,3,15,4,13,44,51,-7,49
Lucerne,4791,4,12,7,13,42,51,-9,43
FC Zürich,4791,5,10,10,12,39,39,0,40
Grasshoppers,4791,6,11,7,14,44,48,-4,40
FC Lugano,4791,7,11,5,16,33,47,-14,38
FC Thun,4791,8,9,6,17,46,59,-13,33
FC Sion,4791,9,6,8,18,44,62,-18,26
Young Boys,4792,1,24,6,2,74,33,41,78
FC Basel,4792,2,17,8,7,53,26,27,59
Lucerne,4792,3,14,7,11,46,46,0,49
St Gallen,4792,4,14,3,15,43,55,-12,45
FC Zürich,4792,5,9,11,12,37,35,2,38
FC Thun,4792,6,11,5,16,46,59,-13,38
FC Lugano,4792,7,11,5,16,32,48,-16,38
Grasshoppers,4792,8,9,6,17,42,54,-12,33
FC Sion,4792,9,5,9,18,39,56,-17,24
Young Boys,4793,1,20,7,5,72,41,31,67
FC Basel,4793,2,17,9,6,51,25,26,60
Lucerne,4793,3,14,7,11,45,44,1,49
St Gallen,4793,4,14,4,14,42,53,-11,46
FC Zürich,4793,5,10,11,11,38,35,3,41
FC Lugano,4793,6,11,5,16,32,46,-14,38
Grasshoppers,4793,7,9,8,15,42,51,-9,35
FC Sion,4793,8,7,10,15,43,53,-10,31
FC Thun,4793,9,8,7,17,41,58,-17,31
Young Boys,4794,1,22,6,4,73,40,33,72
FC Basel,4794,2,17,8,7,54,29,25,59
Lucerne,4794,3,14,7,11,40,41,-1,49
FC Zürich,4794,4,11,10,11,43,36,7,43
St Gallen,4794,5,13,4,15,39,53,-14,43
FC Thun,4794,6,11,6,15,45,56,-11,39
FC Lugano,4794,7,10,5,17,31,49,-18,35
Grasshoppers,4794,8,8,7,17,38,50,-12,31
FC Sion,4794,9,7,9,16,41,50,-9,30
Young Boys,4795,1,22,8,2,70,31,39,74
FC Basel,4795,2,16,9,7,52,29,23,57
Lucerne,4795,3,13,8,11,43,43,0,47
St Gallen,4795,4,14,3,15,42,52,-10,45
FC Zürich,4795,5,11,10,11,41,36,5,43
Grasshoppers,4795,6,10,6,16,41,49,-8,36
FC Lugano,4795,7,10,6,16,31,51,-20,36
FC Thun,4795,8,9,6,17,44,60,-16,33
FC Sion,4795,9,7,8,17,40,53,-13,29
Young Boys,4796,1,22,7,3,75,37,38,73
FC Basel,4796,2,19,7,6,55,27,28,64
FC Zürich,4796,3,12,9,11,42,37,5,45
Lucerne,4796,4,12,9,11,41,44,-3,45
St Gallen,4796,5,14,3,15,43,54,-11,45
FC Lugano,4796,6,11,6,15,34,46,-12,39
Grasshoppers,4796,7,10,7,15,45,49,-4,37
FC Thun,4796,8,8,6,18,43,64,-21,30
FC Sion,4796,9,5,8,19,40,60,-20,23
Young Boys,4797,1,22,7,3,70,32,38,73
FC Basel,4797,2,17,9,6,53,26,27,60
Lucerne,4797,3,14,8,10,44,41,3,50
FC Zürich,4797,4,13,9,10,47,37,10,48
St Gallen,4797,5,14,3,15,44,56,-12,45
FC Thun,4797,6,10,5,17,45,62,-17,35
FC Lugano,4797,7,9,5,18,30,52,-22,32
Grasshoppers,4797,8,8,7,17,38,50,-12,31
FC Sion,4797,9,7,7,18,42,57,-15,28
Young Boys,4798,1,21,7,4,69,37,32,70
FC Basel,4798,2,19,7,6,61,30,31,64
St Gallen,4798,3,16,3,13,47,53,-6,51
Lucerne,4798,4,11,8,13,41,48,-7,41
FC Zürich,4798,5,10,10,12,39,37,2,40
Grasshoppers,4798,6,11,6,15,45,48,-3,39
FC Lugano,4798,7,10,6,16,30,48,-18,36
FC Thun,4798,8,10,5,17,45,59,-14,35
FC Sion,4798,9,6,8,18,37,54,-17,26
Young Boys,4799,1,21,6,5,68,35,33,69
FC Basel,4799,2,19,8,5,55,23,32,65
Lucerne,4799,3,12,8,12,43,46,-3,44
St Gallen,4799,4,14,2,16,41,57,-16,44
FC Zürich,4799,5,11,9,12,41,39,2,42
FC Lugano,4799,6,11,6,15,33,45,-12,39
FC Thun,4799,7,10,6,16,45,56,-11,36
Grasshoppers,4799,8,9,6,17,39,51,-12,33
FC Sion,4799,9,8,7,17,42,55,-13,31
Young Boys,4800,1,20,7,5,71,41,30,67
FC Basel,4800,2,19,7,6,55,24,31,64
Lucerne,4800,3,16,7,9,49,41,8,55
St Gallen,4800,4,14,2,16,42,58,-16,44
FC Zürich,4800,5,11,9,12,41,36,5,42
FC Thun,4800,6,10,5,17,46,61,-15,35
FC Sion,4800,7,8,8,16,46,56,-10,32
Grasshoppers,4800,8,8,8,16,41,54,-13,32
FC Lugano,4800,9,9,5,18,30,50,-20,32
Young Boys,4801,1,23,6,3,76,38,38,75
FC Basel,4801,2,17,8,7,56,27,29,59
St Gallen,4801,3,15,3,14,44,54,-10,48
FC Zürich,4801,4,12,9,11,46,40,6,45
Lucerne,4801,5,12,7,13,41,48,-7,43
FC Lugano,4801,6,11,5,16,31,48,-17,38
Grasshoppers,4801,7,9,7,16,44,52,-8,34
FC Thun,4801,8,9,6,17,43,58,-15,33
FC Sion,4801,9,7,7,18,43,59,-16,28
Young Boys,4802,1,21,8,3,72,35,37,71
FC Basel,4802,2,17,9,6,53,26,27,60
St Gallen,4802,3,14,3,15,44,56,-12,45
Lucerne,4802,4,12,8,12,40,44,-4,44
FC Zürich,4802,5,10,12,10,42,35,7,42
Grasshoppers,4802,6,11,7,14,40,45,-5,40
FC Lugano,4802,7,10,6,16,30,48,-18,36
FC Thun,4802,8,10,5,17,46,62,-16,35
FC Sion,4802,9,5,10,17,42,58,-16,25
Young Boys,4803,1,22,7,3,70,31,39,73
FC Basel,4803,2,17,9,6,52,24,28,60
St Gallen,4803,3,15,3,14,42,51,-9,48
Lucerne,4803,4,13,8,11,41,43,-2,47
FC Zürich,4803,5,12,10,10,43,35,8,46
FC Lugano,4803,6,9,7,16,28,48,-20,34
Grasshoppers,4803,7,8,8,16,41,52,-11,32
FC Thun,4803,8,8,6,18,42,63,-21,30
FC Sion,4803,9,7,8,17,43,55,-12,29
Young Boys,4804,1,23,6,3,77,36,41,75
FC Basel,4804,2,18,7,7,53,27,26,61
St Gallen,4804,3,15,3,14,43,52,-9,48
Lucerne,4804,4,13,7,12,42,44,-2,46
FC Zürich,4804,5,10,9,13,38,39,-1,39
FC Lugano,4804,6,10,6,16,30,49,-19,36
FC Thun,4804,7,9,7,16,47,60,-13,34
FC Sion,4804,8,8,8,16,47,56,-9,32
Grasshoppers,4804,9,8,7,17,42,56,-14,31
Young Boys,4805,1,21,9,2,70,34,36,72
FC Basel,4805,2,17,9,6,59,29,30,60
St Gallen,4805,3,16,2,14,46,56,-10,50
Lucerne,4805,4,11,9,12,39,47,-8,42
FC Zürich,4805,5,9,12,11,41,38,3,39
FC Lugano,4805,6,10,6,16,31,47,-16,36
Grasshoppers,4805,7,9,8,15,42,51,-9,35
FC Thun,4805,8,10,5,17,46,57,-11,35
FC Sion,4805,9,7,8,17,43,58,-15,29
Young Boys,4806,1,24,6,2,77,29,48,78
FC Basel,4806,2,18,7,7,50,25,25,61
St Gallen,4806,3,14,3,15,44,54,-10,45
Lucerne,4806,4,12,8,12,40,46,-6,44
FC Zürich,4806,5,10,11,11,39,34,5,41
Grasshoppers,4806,6,10,7,15,43,50,-7,37
FC Thun,4806,7,10,6,16,43,56,-13,36
FC Lugano,4806,8,9,7,16,27,51,-24,34
FC Sion,4806,9,6,7,19,39,57,-18,25
Young Boys,4807,1,23,7,2,74,33,41,76
FC Basel,4807,2,17,7,8,53,27,26,58
St Gallen,4807,3,15,2,15,44,57,-13,47
Lucerne,4807,4,13,7,12,46,46,0,46
FC Zürich,4807,5,11,11,10,41,35,6,44
FC Lugano,4807,6,10,7,15,32,47,-15,37
FC Thun,4807,7,9,7,16,46,59,-13,34
Grasshoppers,4807,8,9,6,17,41,57,-16,33
FC Sion,4807,9,6,8,18,38,54,-16,26
Young Boys,4808,1,21,8,3,71,37,34,71
FC Basel,4808,2,16,9,7,52,28,24,57
St Gallen,4808,3,15,3,14,42,54,-12,48
Lucerne,4808,4,13,8,11,44,42,2,47
FC Zürich,4808,5,10,11,11,41,36,5,41
Grasshoppers,4808,6,10,6,16,43,50,-7,36
FC Thun,4808,7,9,7,16,44,59,-15,34
FC Sion,4808,8,8,9,15,43,53,-10,33
FC Lugano,4808,9,9,5,18,31,52,-21,32
Young Boys,4809,1,22,7,3,73,32,41,73
FC Basel,4809,2,20,7,5,54,23,31,67
Lucerne,4809,3,13,7,12,40,42,-2,46
St Gallen,4809,4,13,2,17,40,59,-19,41
FC Lugano,4809,5,11,5,16,33,48,-15,38
Grasshoppers,4809,6,10,7,15,41,47,-6,37
FC Zürich,4809,7,9,9,14,37,45,-8,36
FC Thun,4809,8,10,5,17,42,56,-14,35
FC Sion,4809,9,7,9,16,44,52,-8,30
Young Boys,4810,1,23,7,2,76,32,44,76
FC Basel,4810,2,17,9,6,57,29,28,60
St Gallen,4810,3,15,3,14,44,52,-8,48
FC Zürich,4810,4,11,10,11,43,37,6,43
Lucerne,4810,5,12,7,13,39,46,-7,43
Grasshoppers,4810,6,10,6,16,39,47,-8,36
FC Thun,4810,7,10,6,16,43,57,-14,36
FC Lugano,4810,8,10,5,17,29,47,-18,35
FC Sion,4810,9,6,7,19,38,61,-23,25
Young Boys,4811,1,22,7,3,71,36,35,73
FC Basel,4811,2,17,9,6,54,28,26,60
Lucerne,4811,3,13,8,11,45,43,2,47
St Gallen,4811,4,13,4,15,44,60,-16,43
FC Zürich,4811,5,10,10,12,41,38,3,40
FC Lugano,4811,6,11,5,16,36,51,-15,38
Grasshoppers,4811,7,10,6,16,41,50,-9,36
FC Thun,4811,8,9,6,17,44,60,-16,33
FC Sion,4811,9,8,7,17,41,51,-10,31
Young Boys,4812,1,23,6,3,78,37,41,75
FC Basel,4812,2,17,9,6,50,26,24,60
St Gallen,4812,3,14,4,14,42,53,-11,46
Lucerne,4812,4,12,7,13,44,48,-4,43
FC Zürich,4812,5,9,11,12,39,38,1,38
FC Thun,4812,6,10,7,15,46,58,-12,37
Grasshoppers,4812,7,9,7,16,43,51,-8,34
FC Lugano,4812,8,9,7,16,31,51,-20,34
FC Sion,4812,9,8,8,16,42,53,-11,32
Young Boys,4813,1,23,7,2,76,34,42,76
FC Basel,4813,2,16,10,6,59,31,28,58
Lucerne,4813,3,14,8,10,45,44,1,50
St Gallen,4813,4,14,3,15,44,56,-12,45
FC Zürich,4813,5,10,11,11,44,41,3,41
FC Lugano,4813,6,10,6,16,35,51,-16,36
Grasshoppers,4813,7,9,6,17,41,53,-12,33
FC Thun,4813,8,9,6,17,43,62,-19,33
FC Sion,4813,9,6,9,17,42,57,-15,27
Young Boys,4814,1,20,8,4,69,37,32,68
FC Basel,4814,2,18,9,5,59,29,30,63
St Gallen,4814,3,14,4,14,45,56,-11,46
Lucerne,4814,4,12,8,12,40,44,-4,44
FC Zürich,4814,5,10,10,12,40,38,2,40
FC Lugano,4814,6,11,6,15,32,46,-14,39
FC Thun,4814,7,11,5,16,43,55,-12,38
Grasshoppers,4814,8,8,8,16,38,49,-11,32
FC Sion,4814,9,7,8,17,41,53,-12,29
Young Boys,4815,1,21,7,4,69,37,32,70
FC Basel,4815,2,18,8,6,54,25,29,62
St Gallen,4815,3,16,3,13,51,54,-3,51
Lucerne,4815,4,13,8,11,45,47,-2,47
FC Zürich,4815,5,10,10,12,39,36,3,40
Grasshoppers,4815,6,10,6,16,42,49,-7,36
FC Thun,4815,7,10,6,16,44,55,-11,36
FC Lugano,4815,8,10,5,17,29,50,-21,35
FC Sion,4815,9,5,9,18,41,61,-20,24
Young Boys,4816,1,22,7,3,72,33,39,73
FC Basel,4816,2,18,9,5,59,25,34,63
St Gallen,4816,3,14,3,15,45,60,-15,45
Lucerne,4816,4,12,8,12,41,47,-6,44
FC Zürich,4816,5,10,10,12,42,41,1,40
Grasshoppers,4816,6,11,6,15,47,51,-4,39
FC Lugano,4816,7,10,7,15,33,48,-15,37
FC Thun,4816,8,9,5,18,43,64,-21,32
FC Sion,4816,9,7,7,18,45,58,-13,28
Young Boys,4817,1,21,7,4,74,37,37,70
FC Basel,4817,2,16,10,6,53,26,27,58
Lucerne,4817,3,13,9,10,42,44,-2,48
St Gallen,4817,4,14,4,14,43,55,-12,46
FC Zürich,4817,5,11,11,10,41,35,6,44
Grasshoppers,4817,6,10,7,15,42,48,-6,37
FC Thun,4817,7,9,6,17,45,61,-16,33
FC Lugano,4817,8,9,6,17,30,52,-22,33
FC Sion,4817,9,6,10,16,40,52,-12,28
Young Boys,4818,1,22,8,2,76,34,42,74
FC Basel,4818,2,17,9,6,50,24,26,60
Lucerne,4818,3,14,8,10,47,45,2,50
St Gallen,4818,4,15,3,14,44,54,-10,48
FC Zürich,4818,5,10,9,13,38,36,2,39
FC Thun,4818,6,11,6,15,44,54,-10,39
FC Lugano,4818,7,10,6,16,32,50,-18,36
Grasshoppers,4818,8,8,6,18,39,55,-16,30
FC Sion,4818,9,6,7,19,37,55,-18,25
Young Boys,4819,1,21,7,4,72,36,36,70
FC Basel,4819,2,20,7,5,54,21,33,67
St Gallen,4819,3,15,3,14,44,52,-8,48
FC Zürich,4819,4,11,9,12,40,36,4,42
Lucerne,4819,5,11,9,12,41,47,-6,42
Grasshoppers,4819,6,10,7,15,44,51,-7,37
FC Lugano,4819,7,9,7,16,29,48,-19,34
FC Sion,4819,8,8,8,16,42,52,-10,32
FC Thun,4819,9,8,5,19,41,64,-23,29
Young Boys,4820,1,23,6,3,73,31,42,75
FC Basel,4820,2,17,8,7,49,24,25,59
Lucerne,4820,3,14,7,11,45,43,2,49
St Gallen,4820,4,14,2,16,43,57,-14,44
FC Zürich,4820,5,10,12,10,38,33,5,42
FC Thun,4820,6,10,7,15,49,57,-8,37
FC Lugano,4820,7,10,6,16,29,49,-20,36
Grasshoppers,4820,8,9,7,16,39,50,-11,34
FC Sion,4820,9,6,7,19,37,58,-21,25
Young Boys,4821,1,21,8,3,70,33,37,71
FC Basel,4821,2,16,7,9,51,32,19,55
Lucerne,4821,3,14,7,11,45,45,0,49
FC Zürich,4821,4,12,9,11,39,34,5,45
St Gallen,4821,5,14,2,16,42,56,-14,44
Grasshoppers,4821,6,11,7,14,44,49,-5,40
FC Lugano,4821,7,11,6,15,34,45,-11,39
FC Thun,4821,8,9,6,17,43,58,-15,33
FC Sion,4821,9,6,8,18,38,54,-16,26
Young Boys,4822,1,21,8,3,72,36,36,71
FC Basel,4822,2,15,11,6,50,26,24,56
St Gallen,4822,3,15,3,14,42,53,-11,48
Lucerne,4822,4,12,9,11,41,43,-2,45
FC Zürich,4822,5,10,12,10,39,34,5,42
FC Lugano,4822,6,10,7,15,29,44,-15,37
FC Thun,4822,7,9,8,15,44,57,-13,35
Grasshoppers,4822,8,9,7,16,39,49,-10,34
FC Sion,4822,9,5,11,16,38,52,-14,26
Young Boys,4823,1,23,7,2,68,30,38,76
FC Basel,4823,2,18,7,7,53,26,27,61
St Gallen,4823,3,15,3,14,46,57,-11,48
Lucerne,4823,4,12,7,13,39,45,-6,43
FC Zürich,4823,5,9,11,12,41,39,2,38
FC Lugano,4823,6,11,5,16,33,46,-13,38
Grasshoppers,4823,7,10,7,15,45,51,-6,37
FC Thun,4823,8,9,7,16,44,60,-16,34
FC Sion,4823,9,5,10,17,42,57,-15,25
Young Boys,4824,1,20,7,5,68,36,32,67
FC Basel,4824,2,18,9,5,54,23,31,63
St Gallen,4824,3,16,3,13,48,53,-5,51
Lucerne,4824,4,13,8,11,40,46,-6,47
FC Zürich,4824,5,10,11,11,42,39,3,41
Grasshoppers,4824,6,10,6,16,43,50,-7,36
FC Lugano,4824,7,10,5,17,32,49,-17,35
FC Thun,4824,8,9,7,16,43,59,-16,34
FC Sion,4824,9,6,8,18,40,55,-15,26
Young Boys,4825,1,21,7,4,71,36,35,70
FC Basel,4825,2,18,8,6,57,23,34,62
St Gallen,4825,3,14,4,14,42,55,-13,46
Lucerne,4825,4,11,9,12,39,48,-9,42
FC Zürich,4825,5,10,11,11,39,33,6,41
FC Lugano,4825,6,11,7,14,34,45,-11,40
Grasshoppers,4825,7,10,7,15,41,49,-8,37
FC Thun,4825,8,9,6,17,44,63,-19,33
FC Sion,4825,9,6,9,17,41,56,-15,27
Young Boys,4826,1,21,6,5,68,37,31,69
FC Basel,4826,2,19,7,6,54,25,29,64
St Gallen,4826,3,15,2,15,44,55,-11,47
Lucerne,4826,4,12,7,13,41,47,-6,43
FC Zürich,4826,5,10,10,12,39,36,3,40
FC Lugano,4826,6,11,6,15,34,47,-13,39
FC Thun,4826,7,10,6,16,45,57,-12,36
Grasshoppers,4826,8,9,6,17,39,50,-11,33
FC Sion,4826,9,8,8,16,41,51,-10,32
Young Boys,4827,1,22,8,2,73,34,39,74
FC Basel,4827,2,15,9,8,49,28,21,54
Lucerne,4827,3,13,9,10,41,41,0,48
St Gallen,4827,4,14,2,16,44,57,-13,44
FC Zürich,4827,5,11,9,12,42,40,2,42
FC Thun,4827,6,11,6,15,47,56,-9,39
FC Lugano,4827,7,11,6,15,35,45,-10,39
Grasshoppers,4827,8,9,6,17,40,55,-15,33
FC Sion,4827,9,7,7,18,43,58,-15,28
Young Boys,4828,1,23,7,2,73,34,39,76
FC Basel,4828,2,16,11,5,53,27,26,59
Lucerne,4828,3,13,8,11,47,45,2,47
St Gallen,4828,4,14,3,15,47,62,-15,45
FC Zürich,4828,5,10,11,11,44,39,5,41
Grasshoppers,4828,6,10,6,16,46,49,-3,36
FC Thun,4828,7,9,7,16,47,59,-12,34
FC Lugano,4828,8,9,6,17,31,51,-20,33
FC Sion,4828,9,7,7,18,39,61,-22,28
Young Boys,4829,1,21,7,4,70,33,37,70
FC Basel,4829,2,18,9,5,57,27,30,63
Lucerne,4829,3,14,8,10,46,46,0,50
St Gallen,4829,4,14,3,15,45,56,-11,45
FC Zürich,4829,5,9,11,12,39,39,0,38
FC Lugano,4829,6,10,6,16,30,48,-18,36
Grasshoppers,4829,7,9,7,16,38,47,-9,34
FC Sion,4829,8,7,10,15,40,50,-10,31
FC Thun,4829,9,8,7,17,42,61,-19,31
Young Boys,4830,1,23,6,3,78,38,40,75
FC Basel,4830,2,19,7,6,59,27,32,64
FC Zürich,4830,3,12,9,11,43,37,6,45
Lucerne,4830,4,12,9,11,44,44,0,45
St Gallen,4830,5,13,4,15,40,57,-17,43
Grasshoppers,4830,6,10,7,15,43,50,-7,37
FC Lugano,4830,7,10,6,16,32,51,-19,36
FC Thun,4830,8,8,5,19,42,62,-20,29
FC Sion,4830,9,7,7,18,40,55,-15,28
Young Boys,4831,1,22,6,4,69,33,36,72
FC Basel,4831,2,18,7,7,54,25,29,61
St Gallen,4831,3,14,4,14,42,54,-12,46
Lucerne,4831,4,11,10,11,39,43,-4,43
FC Lugano,4831,5,10,8,14,31,45,-14,38
FC Zürich,4831,6,9,10,13,40,41,-1,37
Grasshoppers,4831,7,10,7,15,41,46,-5,37
FC Thun,4831,8,10,6,16,42,57,-15,36
FC Sion,4831,9,7,8,17,39,53,-14,29
Young Boys,4832,1,20,8,4,67,33,34,68
FC Basel,4832,2,19,7,6,53,22,31,64
Lucerne,4832,3,13,9,10,45,44,1,48
St Gallen,4832,4,14,2,16,43,57,-14,44
FC Zürich,4832,5,10,11,11,40,36,4,41
FC Lugano,4832,6,11,5,16,33,49,-16,38
Grasshoppers,4832,7,10,7,15,42,52,-10,37
FC Thun,4832,8,10,6,16,50,60,-10,36
FC Sion,4832,9,5,9,18,39,59,-20,24
Young Boys,4833,1,20,7,5,69,37,32,67
FC Basel,4833,2,17,10,5,50,22,28,61
Lucerne,4833,3,14,9,9,44,38,6,51
St Gallen,4833,4,14,4,14,48,53,-5,46
FC Zürich,4833,5,9,11,12,37,38,-1,38
FC Lugano,4833,6,10,7,15,30,46,-16,37
FC Thun,4833,7,9,8,15,48,59,-11,35
Grasshoppers,4833,8,9,7,16,39,52,-13,34
FC Sion,4833,9,6,9,17,44,64,-20,27
Young Boys,4834,1,22,8,2,72,34,38,74
FC Basel,4834,2,17,10,5,54,25,29,61
Lucerne,4834,3,12,9,11,45,46,-1,45
St Gallen,4834,4,14,2,16,40,53,-13,44
FC Zürich,4834,5,10,10,12,40,38,2,40
FC Lugano,4834,6,10,6,16,32,50,-18,36
Grasshoppers,4834,7,9,7,16,40,51,-11,34
FC Thun,4834,8,9,6,17,41,58,-17,33
FC Sion,4834,9,8,8,16,41,50,-9,32
Young Boys,4835,1,23,7,2,72,33,39,76
FC Basel,4835,2,16,9,7,55,31,24,57
St Gallen,4835,3,15,3,14,50,58,-8,48
Lucerne,4835,4,13,8,11,43,44,-1,47
FC Zürich,4835,5,10,12,10,41,36,5,42
FC Thun,4835,6,10,6,16,46,58,-12,36
FC Lugano,4835,7,9,6,17,28,49,-21,33
Grasshoppers,4835,8,8,6,18,39,51,-12,30
FC Sion,4835,9,7,9,16,43,57,-14,30
Young Boys,4836,1,21,8,3,68,34,34,71
FC Basel,4836,2,18,8,6,53,23,30,62
Lucerne,4836,3,13,8,11,43,42,1,47
FC Zürich,4836,4,12,10,10,44,35,9,46
St Gallen,4836,5,13,4,15,41,56,-15,43
FC Lugano,4836,6,9,8,15,32,48,-16,35
Grasshoppers,4836,7,9,7,16,42,52,-10,34
FC Thun,4836,8,9,6,17,42,60,-18,33
FC Sion,4836,9,6,9,17,38,53,-15,27
Young Boys,4837,1,22,8,2,77,34,43,74
FC Basel,4837,2,18,9,5,58,24,34,63
Lucerne,4837,3,12,11,9,44,44,0,47
St Gallen,4837,4,14,4,14,44,56,-12,46
FC Zürich,4837,5,9,11,12,39,37,2,38
FC Lugano,4837,6,10,6,16,29,48,-19,36
Grasshoppers,4837,7,9,7,16,41,52,-11,34
FC Thun,4837,8,9,7,16,43,61,-18,34
FC Sion,4837,9,5,9,18,41,60,-19,24
Young Boys,4838,1,23,7,2,76,33,43,76
FC Basel,4838,2,17,9,6,53,28,25,60
St Gallen,4838,3,16,2,14,51,56,-5,50
Lucerne,4838,4,12,7,13,41,48,-7,43
FC Zürich,4838,5,10,11,11,42,36,6,41
Grasshoppers,4838,6,9,9,14,40,47,-7,36
FC Lugano,4838,7,10,5,17,32,53,-21,35
FC Thun,4838,8,8,9,15,40,55,-15,33
FC Sion,4838,9,5,9,18,35,54,-19,24
Young Boys,4839,1,19,8,5,67,38,29,65
FC Basel,4839,2,18,9,5,53,24,29,63
St Gallen,4839,3,16,2,14,43,52,-9,50
Lucerne,4839,4,12,8,12,41,46,-5,44
FC Zürich,4839,5,10,11,11,40,35,5,41
FC Lugano,4839,6,11,6,15,33,44,-11,39
FC Thun,4839,7,10,5,17,48,63,-15,35
Grasshoppers,4839,8,8,8,16,42,55,-13,32
FC Sion,4839,9,8,7,17,44,54,-10,31
Young Boys,4840,1,22,8,2,69,31,38,74
FC Basel,4840,2,19,7,6,53,23,30,64
St Gallen,4840,3,15,2,15,44,55,-11,47
Lucerne,4840,4,13,7,12,45,44,1,46
FC Zürich,4840,5,11,10,11,45,37,8,43
Grasshoppers,4840,6,10,7,15,42,50,-8,37
FC Lugano,4840,7,9,6,17,30,52,-22,33
FC Sion,4840,8,7,8,17,41,53,-12,29
FC Thun,4840,9,8,5,19,40,64,-24,29
Young Boys,4841,1,22,7,3,73,32,41,73
FC Basel,4841,2,19,7,6,59,25,34,64
St Gallen,4841,3,15,2,15,43,55,-12,47
Lucerne,4841,4,12,9,11,40,44,-4,45
FC Zürich,4841,5,11,10,11,41,35,6,43
Grasshoppers,4841,6,9,8,15,40,51,-11,35
FC Lugano,4841,7,9,6,17,28,49,-21,33
FC Sion,4841,8,8,8,16,42,54,-12,32
FC Thun,4841,9,8,5,19,42,63,-21,29
Young Boys,4842,1,20,7,5,70,39,31,67
FC Basel,4842,2,17,9,6,52,24,28,60
St Gallen,4842,3,15,3,14,42,52,-10,48
Lucerne,4842,4,12,7,13,41,47,-6,43
FC Zürich,4842,5,11,9,12,43,38,5,42
FC Lugano,4842,6,12,5,15,33,46,-13,41
Grasshoppers,4842,7,11,7,14,46,49,-3,40
FC Thun,4842,8,9,7,16,43,57,-14,34
FC Sion,4842,9,6,8,18,43,61,-18,26
Young Boys,4843,1,22,6,4,75,37,38,72
FC Basel,4843,2,18,8,6,56,27,29,62
St Gallen,4843,3,16,2,14,45,53,-8,50
Lucerne,4843,4,12,8,12,42,48,-6,44
FC Zürich,4843,5,10,11,11,40,34,6,41
FC Thun,4843,6,11,6,15,47,58,-11,39
FC Lugano,4843,7,10,5,17,30,48,-18,35
Grasshoppers,4843,8,9,7,16,44,53,-9,34
FC Sion,4843,9,6,7,19,40,61,-21,25
Young Boys,4844,1,23,6,3,76,35,41,75
FC Basel,4844,2,19,8,5,58,26,32,65
Lucerne,4844,3,12,7,13,39,43,-4,43
St Gallen,4844,4,13,3,16,41,56,-15,42
FC Zürich,4844,5,10,10,12,42,40,2,40
Grasshoppers,4844,6,11,6,15,45,48,-3,39
FC Lugano,4844,7,11,5,16,33,51,-18,38
FC Thun,4844,8,9,6,17,42,59,-17,33
FC Sion,4844,9,6,9,17,39,57,-18,27
Young Boys,4845,1,22,7,3,68,30,38,73
FC Basel,4845,2,18,8,6,54,23,31,62
Lucerne,4845,3,12,9,11,40,46,-6,45
St Gallen,4845,4,13,5,14,40,52,-12,44
FC Zürich,4845,5,11,10,11,42,36,6,43
FC Thun,4845,6,11,5,16,43,58,-15,38
FC Lugano,4845,7,9,9,14,31,46,-15,36
Grasshoppers,4845,8,9,6,17,42,52,-10,33
FC Sion,4845,9,6,7,19,37,54,-17,25
Young Boys,4846,1,22,6,4,75,41,34,72
FC Basel,4846,2,17,9,6,52,27,25,60
St Gallen,4846,3,16,2,14,50,53,-3,50
Lucerne,4846,4,12,8,12,40,47,-7,44
FC Zürich,4846,5,10,12,10,42,35,7,42
FC Lugano,4846,6,10,6,16,31,49,-18,36
Grasshoppers,4846,7,9,7,16,41,50,-9,34
FC Thun,4846,8,9,6,17,46,61,-15,33
FC Sion,4846,9,7,8,17,45,59,-14,29
Young Boys,4847,1,23,6,3,73,33,40,75
FC Basel,4847,2,17,9,6,51,25,26,60
St Gallen,4847,3,15,3,14,46,54,-8,48
Lucerne,4847,4,13,8,11,40,42,-2,47
FC Zürich,4847,5,10,11,11,38,38,0,41
Grasshoppers,4847,6,9,7,16,44,51,-7,34
FC Lugano,4847,7,9,7,16,30,50,-20,34
FC Thun,4847,8,9,5,18,45,61,-16,32
FC Sion,4847,9,7,8,17,38,51,-13,29
Young Boys,4848,1,22,6,4,71,36,35,72
FC Basel,4848,2,17,9,6,54,28,26,60
Lucerne,4848,3,13,8,11,39,43,-4,47
St Gallen,4848,4,14,4,14,45,55,-10,46
FC Zürich,4848,5,10,12,10,43,37,6,42
FC Thun,4848,6,10,6,16,44,59,-15,36
FC Lugano,4848,7,10,6,16,33,48,-15,36
Grasshoppers,4848,8,9,6,17,40,51,-11,33
FC Sion,4848,9,6,9,17,42,54,-12,27
Young Boys,4849,1,21,7,4,74,36,38,70
FC Basel,4849,2,19,8,5,56,26,30,65
St Gallen,4849,3,15,3,14,45,55,-10,48
FC Zürich,4849,4,11,10,11,44,38,6,43
Lucerne,4849,5,11,9,12,42,47,-5,42
Grasshoppers,4849,6,11,6,15,49,51,-2,39
FC Lugano,4849,7,10,5,17,31,52,-21,35
FC Thun,4849,8,8,8,16,45,63,-18,32
FC Sion,4849,9,6,8,18,42,60,-18,26
Young Boys,4850,1,22,8,2,75,35,40,74
FC Basel,4850,2,18,9,5,55,26,29,63
St Gallen,4850,3,16,3,13,45,52,-7,51
Lucerne,4850,4,13,7,12,42,46,-4,46
FC Zürich,4850,5,9,11,12,39,38,1,38
FC Thun,4850,6,10,6,16,44,58,-14,36
FC Lugano,4850,7,10,6,16,33,51,-18,36
Grasshoppers,4850,8,8,6,18,40,52,-12,30
FC Sion,4850,9,6,8,18,38,53,-15,26
Young Boys,4851,1,22,8,2,72,32,40,74
FC Basel,4851,2,17,9,6,54,27,27,60
St Gallen,4851,3,16,2,14,46,54,-8,50
Lucerne,4851,4,12,8,12,43,46,-3,44
FC Zürich,4851,5,10,11,11,42,38,4,41
Grasshoppers,4851,6,10,7,15,43,50,-7,37
FC Thun,4851,7,9,6,17,44,60,-16,33
FC Lugano,4851,8,9,6,17,31,52,-21,33
FC Sion,4851,9,7,7,18,41,57,-16,28
Young Boys,4852,1,23,7,2,75,34,41,76
FC Basel,4852,2,16,8,8,53,29,24,56
St Gallen,4852,3,16,2,14,44,51,-7,50
Lucerne,4852,4,12,8,12,39,46,-7,44
FC Zürich,4852,5,11,10,11,42,37,5,43
FC Thun,4852,6,10,6,16,44,58,-14,36
FC Lugano,4852,7,10,5,17,31,50,-19,35
Grasshoppers,4852,8,8,7,17,40,51,-11,31
FC Sion,4852,9,7,9,16,42,54,-12,30
Young Boys,4853,1,20,8,4,69,35,34,68
FC Basel,4853,2,17,7,8,51,28,23,58
Lucerne,4853,3,13,10,9,44,40,4,49
St Gallen,4853,4,15,3,14,45,55,-10,48
FC Zürich,4853,5,11,10,11,43,36,7,43
FC Lugano,4853,6,10,7,15,35,51,-16,37
FC Thun,4853,7,9,7,16,44,58,-14,34
Grasshoppers,4853,8,8,8,16,38,53,-15,32
FC Sion,4853,9,7,8,17,44,57,-13,29
Young Boys,4854,1,21,8,3,76,39,37,71
FC Basel,4854,2,18,8,6,55,31,24,62
Lucerne,4854,3,14,7,11,47,45,2,49
St Gallen,4854,4,14,2,16,42,57,-15,44
FC Lugano,4854,5,12,5,15,33,46,-13,41
FC Zürich,4854,6,10,10,12,45,39,6,40
Grasshoppers,4854,7,10,7,15,43,48,-5,37
FC Thun,4854,8,9,6,17,43,60,-17,33
FC Sion,4854,9,5,9,18,38,57,-19,24
Young Boys,4855,1,24,6,2,73,30,43,78
FC Basel,4855,2,16,8,8,51,27,24,56
Lucerne,4855,3,12,9,11,39,43,-4,45
St Gallen,4855,4,13,5,14,41,55,-14,44
FC Zürich,4855,5,11,10,11,41,36,5,43
Grasshoppers,4855,6,10,6,16,40,49,-9,36
FC Lugano,4855,7,9,8,15,30,46,-16,35
FC Thun,4855,8,10,5,17,41,59,-18,35
FC Sion,4855,9,7,7,18,42,53,-11,28
Young Boys,4856,1,21,7,4,74,38,36,70
FC Basel,4856,2,18,9,5,58,29,29,63
St Gallen,4856,3,14,4,14,43,54,-11,46
Lucerne,4856,4,12,8,12,38,44,-6,44
Grasshoppers,4856,5,11,7,14,42,47,-5,40
FC Zürich,4856,6,10,9,13,41,38,3,39
FC Lugano,4856,7,11,6,15,31,45,-14,39
FC Thun,4856,8,8,6,18,41,62,-21,30
FC Sion,4856,9,7,8,17,43,54,-11,29
Young Boys,4857,1,23,6,3,72,33,39,75
FC Basel,4857,2,16,8,8,52,29,23,56
Lucerne,4857,3,15,7,10,44,40,4,52
St Gallen,4857,4,15,2,15,44,56,-12,47
FC Zürich,4857,5,10,10,12,41,39,2,40
FC Thun,4857,6,10,6,16,45,57,-12,36
FC Lugano,4857,7,10,5,17,31,50,-19,35
Grasshoppers,4857,8,9,6,17,37,48,-11,33
FC Sion,4857,9,7,8,17,44,58,-14,29
Young Boys,4858,1,22,6,4,75,39,36,72
FC Basel,4858,2,18,9,5,56,25,31,63
Lucerne,4858,3,12,10,10,44,47,-3,46
St Gallen,4858,4,13,5,14,43,56,-13,44
FC Lugano,4858,5,11,6,15,33,46,-13,39
FC Zürich,4858,6,9,10,13,37,38,-1,37
FC Thun,4858,7,10,7,15,46,57,-11,37
Grasshoppers,4858,8,8,7,17,39,53,-14,31
FC Sion,4858,9,7,8,17,45,57,-12,29
Young Boys,4859,1,21,6,5,71,38,33,69
FC Basel,4859,2,18,8,6,53,25,28,62
Lucerne,4859,3,13,8,11,43,45,-2,47
St Gallen,4859,4,14,2,16,46,57,-11,44
FC Lugano,4859,5,12,5,15,32,46,-14,41
FC Zürich,4859,6,10,10,12,38,35,3,40
Grasshoppers,4859,7,11,7,14,44,48,-4,40
FC Thun,4859,8,9,7,16,41,56,-15,34
FC Sion,4859,9,6,7,19,40,58,-18,25
Young Boys,4860,1,22,6,4,71,32,39,72
FC Basel,4860,2,17,7,8,52,28,24,58
Lucerne,4860,3,13,8,11,46,48,-2,47
St Gallen,4860,4,14,3,15,43,58,-15,45
FC Lugano,4860,5,12,5,15,33,46,-13,41
FC Zürich,4860,6,10,9,13,40,39,1,39
Grasshoppers,4860,7,10,6,16,43,50,-7,36
FC Thun,4860,8,10,5,17,45,59,-14,35
FC Sion,4860,9,8,7,17,44,57,-13,31
Young Boys,4861,1,22,8,2,72,32,40,74
FC Basel,4861,2,17,9,6,54,27,27,60
St Gallen,4861,3,15,3,14,43,53,-10,48
Lucerne,4861,4,12,9,11,40,43,-3,45
FC Lugano,4861,5,11,5,16,33,49,-16,38
FC Zürich,4861,6,9,10,13,42,42,0,37
Grasshoppers,4861,7,10,6,16,38,48,-10,36
FC Thun,4861,8,10,6,16,44,57,-13,36
FC Sion,4861,9,6,8,18,40,55,-15,26
Young Boys,4862,1,21,7,4,69,35,34,70
FC Basel,4862,2,16,8,8,50,28,22,56
Lucerne,4862,3,15,7,10,48,42,6,52
St Gallen,4862,4,13,4,15,42,59,-17,43
FC Zürich,4862,5,10,12,10,40,35,5,42
FC Lugano,4862,6,10,7,15,34,50,-16,37
Grasshoppers,4862,7,9,6,17,42,50,-8,33
FC Sion,4862,8,8,9,15,42,51,-9,33
FC Thun,4862,9,9,6,17,42,59,-17,33
Young Boys,4863,1,23,6,3,82,36,46,75
FC Basel,4863,2,16,10,6,53,26,27,58
St Gallen,4863,3,14,3,15,41,56,-15,45
Lucerne,4863,4,12,8,12,42,47,-5,44
FC Zürich,4863,5,10,11,11,42,37,5,41
FC Thun,4863,6,10,7,15,45,57,-12,37
FC Lugano,4863,7,10,5,17,31,54,-23,35
Grasshoppers,4863,8,9,7,16,47,59,-12,34
FC Sion,4863,9,7,9,16,43,54,-11,30
Young Boys,4864,1,21,7,4,68,38,30,70
FC Basel,4864,2,19,7,6,62,25,37,64
FC Zürich,4864,3,11,11,10,43,36,7,44
Lucerne,4864,4,11,9,12,43,47,-4,42
St Gallen,4864,5,13,3,16,43,63,-20,42
FC Lugano,4864,6,11,6,15,33,45,-12,39
Grasshoppers,4864,7,10,7,15,41,50,-9,37
FC Thun,4864,8,10,5,17,43,59,-16,35
FC Sion,4864,9,6,9,17,40,53,-13,27
Young Boys,4865,1,23,6,3,82,39,43,75
FC Basel,4865,2,17,9,6,51,27,24,60
St Gallen,4865,3,15,2,15,46,56,-10,47
FC Zürich,4865,4,12,10,10,44,33,11,46
Lucerne,4865,5,12,9,11,39,45,-6,45
FC Lugano,4865,6,10,6,16,33,52,-19,36
FC Thun,4865,7,9,7,16,45,59,-14,34
Grasshoppers,4865,8,9,6,17,42,57,-15,33
FC Sion,4865,9,6,7,19,46,60,-14,25
Young Boys,4866,1,22,8,2,73,32,41,74
FC Basel,4866,2,19,7,6,55,24,31,64
St Gallen,4866,3,14,4,14,43,53,-10,46
Lucerne,4866,4,11,10,11,41,48,-7,43
FC Lugano,4866,5,10,8,14,31,45,-14,38
FC Zürich,4866,6,9,10,13,40,39,1,37
Grasshoppers,4866,7,8,10,14,42,50,-8,34
FC Thun,4866,8,9,7,16,44,59,-15,34
FC Sion,4866,9,6,8,18,37,56,-19,26
Young Boys,4867,1,21,8,3,67,32,35,71
FC Basel,4867,2,16,9,7,51,26,25,57
Lucerne,4867,3,14,8,10,46,41,5,50
FC Zürich,4867,4,11,10,11,40,34,6,43
St Gallen,4867,5,13,4,15,43,57,-14,43
FC Thun,4867,6,11,5,16,47,59,-12,38
FC Lugano,4867,7,10,6,16,31,50,-19,36
Grasshoppers,4867,8,9,6,17,42,52,-10,33
FC Sion,4867,9,7,8,17,38,54,-16,29
Young Boys,4868,1,24,6,2,73,30,43,78
FC Basel,4868,2,17,8,7,52,25,27,59
St Gallen,4868,3,15,4,13,46,52,-6,49
Lucerne,4868,4,12,10,10,42,44,-2,46
FC Zürich,4868,5,12,9,11,41,37,4,45
FC Thun,4868,6,10,5,17,47,59,-12,35
Grasshoppers,4868,7,9,6,17,41,55,-14,33
FC Lugano,4868,8,9,6,17,28,50,-22,33
FC Sion,4868,9,5,8,19,39,57,-18,23
Young Boys,4869,1,21,7,4,70,38,32,70
FC Basel,4869,2,17,9,6,57,29,28,60
Lucerne,4869,3,14,9,9,44,40,4,51
St Gallen,4869,4,15,4,13,47,54,-7,49
FC Zürich,4869,5,12,10,10,42,34,8,46
Grasshoppers,4869,6,9,7,16,40,50,-10,34
FC Thun,4869,7,9,5,18,46,64,-18,32
FC Lugano,4869,8,9,5,18,31,52,-21,32
FC Sion,4869,9,6,8,18,38,54,-16,26
Young Boys,4870,1,21,8,3,72,36,36,71
FC Basel,4870,2,17,9,6,53,27,26,60
St Gallen,4870,3,15,2,15,43,54,-11,47
Lucerne,4870,4,12,10,10,40,43,-3,46
FC Zürich,4870,5,12,9,11,44,35,9,45
Grasshoppers,4870,6,11,7,14,42,45,-3,40
FC Lugano,4870,7,9,6,17,29,47,-18,33
FC Thun,4870,8,9,5,18,41,62,-21,32
FC Sion,4870,9,6,8,18,39,54,-15,26
Young Boys,4871,1,21,8,3,72,36,36,71
FC Basel,4871,2,17,7,8,52,28,24,58
St Gallen,4871,3,15,3,14,46,55,-9,48
Lucerne,4871,4,13,8,11,42,44,-2,47
FC Zürich,4871,5,12,10,10,43,34,9,46
Grasshoppers,4871,6,10,7,15,40,47,-7,37
FC Lugano,4871,7,10,5,17,34,51,-17,35
FC Thun,4871,8,9,6,17,42,60,-18,33
FC Sion,4871,9,6,8,18,38,54,-16,26
Young Boys,4872,1,20,7,5,70,35,35,67
FC Basel,4872,2,15,12,5,49,24,25,57
Lucerne,4872,3,14,8,10,41,41,0,50
St Gallen,4872,4,14,4,14,46,56,-10,46
FC Zürich,4872,5,11,11,10,44,35,9,44
Grasshoppers,4872,6,11,6,15,43,49,-6,39
FC Lugano,4872,7,10,6,16,31,48,-17,36
FC Thun,4872,8,9,6,17,43,60,-17,33
FC Sion,4872,9,6,8,18,38,57,-19,26
Young Boys,4873,1,21,8,3,72,33,39,71
FC Basel,4873,2,16,9,7,49,26,23,57
Lucerne,4873,3,14,7,11,42,42,0,49
St Gallen,4873,4,15,4,13,44,53,-9,49
FC Zürich,4873,5,10,10,12,43,37,6,40
FC Thun,4873,6,11,6,15,43,53,-10,39
Grasshoppers,4873,7,8,8,16,39,50,-11,32
FC Lugano,4873,8,9,5,18,28,54,-26,32
FC Sion,4873,9,6,11,15,40,52,-12,29
Young Boys,4874,1,21,6,5,68,35,33,69
FC Basel,4874,2,20,7,5,58,25,33,67
Lucerne,4874,3,14,7,11,44,43,1,49
St Gallen,4874,4,14,3,15,44,55,-11,45
FC Zürich,4874,5,11,9,12,41,39,2,42
Grasshoppers,4874,6,11,6,15,42,48,-6,39
FC Lugano,4874,7,10,6,16,29,45,-16,36
FC Thun,4874,8,9,6,17,46,62,-16,33
FC Sion,4874,9,5,8,19,38,58,-20,23
Young Boys,4875,1,22,6,4,73,33,40,72
FC Basel,4875,2,17,8,7,52,27,25,59
St Gallen,4875,3,15,3,14,45,51,-6,48
FC Zürich,4875,4,12,10,10,40,32,8,46
Lucerne,4875,5,11,8,13,42,50,-8,41
FC Lugano,4875,6,10,6,16,29,52,-23,36
FC Thun,4875,7,10,5,17,46,58,-12,35
Grasshoppers,4875,8,9,7,16,42,54,-12,34
FC Sion,4875,9,8,7,17,40,52,-12,31
Young Boys,4876,1,21,7,4,68,42,26,70
FC Basel,4876,2,16,8,8,55,32,23,56
Lucerne,4876,3,13,9,10,45,44,1,48
St Gallen,4876,4,13,5,14,44,56,-12,44
FC Zürich,4876,5,11,10,11,44,38,6,43
FC Thun,4876,6,11,6,15,46,56,-10,39
FC Lugano,4876,7,11,6,15,32,46,-14,39
Grasshoppers,4876,8,10,6,16,52,50,2,36
FC Sion,4876,9,5,9,18,37,59,-22,24
Young Boys,4877,1,23,6,3,75,35,40,75
FC Basel,4877,2,18,7,7,57,27,30,61
Lucerne,4877,3,13,7,12,44,47,-3,46
St Gallen,4877,4,14,3,15,43,55,-12,45
FC Zürich,4877,5,11,9,12,39,36,3,42
Grasshoppers,4877,6,10,7,15,45,49,-4,37
FC Thun,4877,7,10,5,17,43,62,-19,35
FC Lugano,4877,8,9,6,17,31,52,-21,33
FC Sion,4877,9,7,8,17,38,52,-14,29
Young Boys,4878,1,21,7,4,72,35,37,70
FC Basel,4878,2,18,8,6,53,26,27,62
St Gallen,4878,3,15,4,13,45,53,-8,49
FC Zürich,4878,4,11,9,12,42,37,5,42
Lucerne,4878,5,11,7,14,39,49,-10,40
FC Lugano,4878,6,11,6,15,34,47,-13,39
FC Thun,4878,7,11,5,16,45,57,-12,38
Grasshoppers,4878,8,9,7,16,40,50,-10,34
FC Sion,4878,9,7,7,18,39,55,-16,28
Young Boys,4879,1,23,7,2,72,31,41,76
FC Basel,4879,2,16,8,8,54,32,22,56
Lucerne,4879,3,13,8,11,41,46,-5,47
St Gallen,4879,4,14,3,15,43,55,-12,45
FC Zürich,4879,5,10,10,12,41,39,2,40
FC Thun,4879,6,11,5,16,47,56,-9,38
Grasshoppers,4879,7,9,9,14,38,45,-7,36
FC Lugano,4879,8,10,6,16,29,44,-15,36
FC Sion,4879,9,6,8,18,39,56,-17,26
Young Boys,4880,1,22,7,3,72,34,38,73
FC Basel,4880,2,19,8,5,61,25,36,65
Lucerne,4880,3,13,7,12,40,42,-2,46
St Gallen,4880,4,14,3,15,40,58,-18,45
FC Zürich,4880,5,11,10,11,45,38,7,43
FC Thun,4880,6,10,6,16,55,63,-8,36
Grasshoppers,4880,7,9,6,17,41,56,-15,33
FC Lugano,4880,8,9,6,17,30,51,-21,33
FC Sion,4880,9,6,9,17,41,58,-17,27
Young Boys,4881,1,20,9,3,69,36,33,69
FC Basel,4881,2,18,9,5,53,24,29,63
Lucerne,4881,3,13,9,10,41,41,0,48
St Gallen,4881,4,14,2,16,42,55,-13,44
FC Zürich,4881,5,11,10,11,38,33,5,43
Grasshoppers,4881,6,10,8,14,43,48,-5,38
FC Thun,4881,7,10,6,16,43,57,-14,36
FC Lugano,4881,8,9,5,18,28,48,-20,32
FC Sion,4881,9,6,8,18,42,57,-15,26
Young Boys,4882,1,20,8,4,70,39,31,68
FC Basel,4882,2,18,9,5,52,23,29,63
Lucerne,4882,3,13,9,10,44,45,-1,48
St Gallen,4882,4,13,4,15,41,54,-13,43
FC Zürich,4882,5,10,10,12,40,37,3,40
Grasshoppers,4882,6,11,6,15,44,46,-2,39
FC Thun,4882,7,11,5,16,46,54,-8,38
FC Lugano,4882,8,10,6,16,32,49,-17,36
FC Sion,4882,9,5,9,18,38,60,-22,24
Young Boys,4883,1,22,6,4,75,36,39,72
FC Basel,4883,2,18,8,6,53,25,28,62
FC Zürich,4883,3,12,10,10,40,33,7,46
Lucerne,4883,4,12,10,10,40,43,-3,46
St Gallen,4883,5,14,3,15,41,58,-17,45
Grasshoppers,4883,6,10,6,16,44,50,-6,36
FC Lugano,4883,7,10,6,16,34,45,-11,36
FC Thun,4883,8,9,5,18,44,62,-18,32
FC Sion,4883,9,6,8,18,40,59,-19,26
Young Boys,4884,1,21,6,5,72,39,33,69
FC Basel,4884,2,18,9,5,56,25,31,63
St Gallen,4884,3,14,4,14,42,53,-11,46
Lucerne,4884,4,12,9,11,45,46,-1,45
FC Zürich,4884,5,10,10,12,39,38,1,40
Grasshoppers,4884,6,10,7,15,41,47,-6,37
FC Lugano,4884,7,10,6,16,31,50,-19,36
FC Thun,4884,8,10,5,17,43,59,-16,35
FC Sion,4884,9,7,8,17,39,51,-12,29
Young Boys,4885,1,20,6,6,69,41,28,66
FC Basel,4885,2,19,7,6,56,26,30,64
St Gallen,4885,3,14,4,14,44,54,-10,46
Lucerne,4885,4,12,9,11,44,46,-2,45
FC Zürich,4885,5,11,9,12,41,37,4,42
Grasshoppers,4885,6,11,6,15,44,50,-6,39
FC Sion,4885,7,9,7,16,44,56,-12,34
FC Lugano,4885,8,9,7,16,30,47,-17,34
FC Thun,4885,9,9,5,18,47,62,-15,32
FC Basel,4886,1,19,7,6,55,27,28,64
Young Boys,4886,2,19,6,7,66,39,27,63
Lucerne,4886,3,15,7,10,44,40,4,52
St Gallen,4886,4,14,2,16,45,57,-12,44
FC Lugano,4886,5,12,5,15,34,45,-11,41
FC Zürich,4886,6,10,9,13,41,40,1,39
Grasshoppers,4886,7,10,6,16,43,50,-7,36
FC Thun,4886,8,10,5,17,45,60,-15,35
FC Sion,4886,9,8,7,17,42,57,-15,31
Young Boys,4887,1,21,7,4,68,35,33,70
FC Basel,4887,2,18,8,6,57,28,29,62
FC Zürich,4887,3,12,10,10,47,38,9,46
St Gallen,4887,4,14,3,15,43,58,-15,45
Lucerne,4887,5,12,8,12,40,44,-4,44
FC Lugano,4887,6,10,7,15,31,45,-14,37
FC Thun,4887,7,10,6,16,47,60,-13,36
Grasshoppers,4887,8,9,6,17,42,51,-9,33
FC Sion,4887,9,7,7,18,41,57,-16,28
Young Boys,4888,1,22,7,3,72,33,39,73
FC Basel,4888,2,16,7,9,50,30,20,55
St Gallen,4888,3,16,2,14,43,52,-9,50
Lucerne,4888,4,13,8,11,44,41,3,47
FC Zürich,4888,5,12,10,10,40,32,8,46
FC Thun,4888,6,10,6,16,43,57,-14,36
FC Lugano,4888,7,10,5,17,29,48,-19,35
Grasshoppers,4888,8,8,7,17,38,53,-15,31
FC Sion,4888,9,6,10,16,39,52,-13,28
Young Boys,4889,1,21,8,3,69,33,36,71
FC Basel,4889,2,16,9,7,49,29,20,57
St Gallen,4889,3,15,3,14,44,52,-8,48
Lucerne,4889,4,12,8,12,40,44,-4,44
FC Zürich,4889,5,9,12,11,43,40,3,39
FC Lugano,4889,6,10,7,15,31,47,-16,37
FC Thun,4889,7,10,6,16,45,56,-11,36
Grasshoppers,4889,8,9,8,15,38,46,-8,35
FC Sion,4889,9,7,9,16,38,50,-12,30
Young Boys,4890,1,22,7,3,74,35,39,73
FC Basel,4890,2,19,8,5,56,24,32,65
FC Zürich,4890,3,11,11,10,46,39,7,44
St Gallen,4890,4,14,2,16,41,57,-16,44
Lucerne,4890,5,12,7,13,46,49,-3,43
Grasshoppers,4890,6,9,9,14,44,51,-7,36
FC Lugano,4890,7,10,5,17,37,55,-18,35
FC Thun,4890,8,8,8,16,47,63,-16,32
FC Sion,4890,9,6,9,17,39,57,-18,27
Young Boys,4891,1,20,9,3,70,36,34,69
FC Basel,4891,2,19,8,5,52,21,31,65
Lucerne,4891,3,13,9,10,45,43,2,48
St Gallen,4891,4,13,3,16,39,54,-15,42
FC Zürich,4891,5,10,10,12,40,37,3,40
FC Lugano,4891,6,11,6,15,35,50,-15,39
FC Thun,4891,7,10,5,17,45,60,-15,35
Grasshoppers,4891,8,9,6,17,39,51,-12,33
FC Sion,4891,9,7,8,17,43,56,-13,29
Young Boys,4892,1,23,6,3,81,34,47,75
FC Basel,4892,2,20,7,5,60,24,36,67
Lucerne,4892,3,13,7,12,44,50,-6,46
FC Zürich,4892,4,12,9,11,42,34,8,45
St Gallen,4892,5,14,3,15,42,59,-17,45
FC Lugano,4892,6,10,5,17,30,53,-23,35
Grasshoppers,4892,7,9,7,16,41,51,-10,34
FC Thun,4892,8,9,6,17,43,59,-16,33
FC Sion,4892,9,5,8,19,39,58,-19,23
Young Boys,4893,1,22,7,3,73,35,38,73
FC Basel,4893,2,16,8,8,47,25,22,56
Lucerne,4893,3,13,7,12,38,40,-2,46
St Gallen,4893,4,14,4,14,42,54,-12,46
Grasshoppers,4893,5,11,7,14,45,47,-2,40
FC Zürich,4893,6,10,9,13,38,35,3,39
FC Lugano,4893,7,11,5,16,32,49,-17,38
FC Thun,4893,8,10,7,15,42,55,-13,37
FC Sion,4893,9,5,10,17,37,54,-17,25
Young Boys,4894,1,20,7,5,71,38,33,67
FC Basel,4894,2,18,9,5,56,25,31,63
Lucerne,4894,3,15,7,10,47,40,7,52
St Gallen,4894,4,15,2,15,46,55,-9,47
FC Zürich,4894,5,10,10,12,37,36,1,40
Grasshoppers,4894,6,11,6,15,44,51,-7,39
FC Lugano,4894,7,10,5,17,31,51,-20,35
FC Thun,4894,8,9,5,18,44,64,-20,32
FC Sion,4894,9,7,7,18,41,57,-16,28
Young Boys,4895,1,21,8,3,70,33,37,71
FC Basel,4895,2,17,9,6,54,27,27,60
Lucerne,4895,3,14,8,10,44,43,1,50
St Gallen,4895,4,13,2,17,42,59,-17,41
FC Zürich,4895,5,10,10,12,39,36,3,40
FC Lugano,4895,6,11,6,15,31,45,-14,39
Grasshoppers,4895,7,10,6,16,40,49,-9,36
FC Thun,4895,8,9,7,16,43,59,-16,34
FC Sion,4895,9,6,10,16,40,52,-12,28
Young Boys,4896,1,23,7,2,75,35,40,76
FC Basel,4896,2,17,10,5,56,27,29,61
St Gallen,4896,3,16,2,14,45,53,-8,50
Lucerne,4896,4,12,8,12,38,43,-5,44
FC Zürich,4896,5,9,12,11,39,36,3,39
FC Thun,4896,6,10,7,15,44,57,-13,37
FC Lugano,4896,7,9,7,16,28,46,-18,34
Grasshoppers,4896,8,9,6,17,41,49,-8,33
FC Sion,4896,9,6,7,19,39,59,-20,25
Young Boys,4897,1,21,7,4,69,35,34,70
FC Basel,4897,2,19,7,6,57,27,30,64
Lucerne,4897,3,13,10,9,45,43,2,49
St Gallen,4897,4,13,4,15,40,53,-13,43
FC Lugano,4897,5,11,6,15,33,47,-14,39
FC Zürich,4897,6,9,9,14,38,40,-2,36
Grasshoppers,4897,7,10,6,16,47,50,-3,36
FC Thun,4897,8,10,5,17,43,59,-16,35
FC Sion,4897,9,7,8,17,39,57,-18,29
Young Boys,4898,1,21,9,2,69,31,38,72
FC Basel,4898,2,17,8,7,53,29,24,59
Lucerne,4898,3,12,9,11,43,46,-3,45
St Gallen,4898,4,14,3,15,41,53,-12,45
FC Zürich,4898,5,10,12,10,40,35,5,42
FC Lugano,4898,6,10,8,14,32,45,-13,38
FC Thun,4898,7,10,6,16,46,56,-10,36
Grasshoppers,4898,8,9,7,16,40,51,-11,34
FC Sion,4898,9,5,10,17,36,54,-18,25
Young Boys,4899,1,20,8,4,72,37,35,68
FC Basel,4899,2,18,9,5,58,27,31,63
Lucerne,4899,3,13,8,11,46,46,0,47
St Gallen,4899,4,14,2,16,43,58,-15,44
FC Zürich,4899,5,11,10,11,42,35,7,43
Grasshoppers,4899,6,11,6,15,46,53,-7,39
FC Lugano,4899,7,11,5,16,33,49,-16,38
FC Thun,4899,8,9,5,18,44,60,-16,32
FC Sion,4899,9,7,7,18,40,59,-19,28
Young Boys,4900,1,24,6,2,74,31,43,78
FC Basel,4900,2,17,8,7,52,25,27,59
St Gallen,4900,3,16,3,13,44,50,-6,51
Lucerne,4900,4,13,8,11,41,43,-2,47
FC Zürich,4900,5,11,9,12,42,39,3,42
FC Thun,4900,6,11,5,16,44,56,-12,38
FC Lugano,4900,7,9,6,17,30,51,-21,33
Grasshoppers,4900,8,8,6,18,37,50,-13,30
FC Sion,4900,9,6,7,19,38,57,-19,25
Young Boys,4901,1,21,6,5,69,34,35,69
FC Basel,4901,2,18,7,7,53,27,26,61
St Gallen,4901,3,16,3,13,46,54,-8,51
FC Zürich,4901,4,12,9,11,42,34,8,45
Lucerne,4901,5,11,9,12,41,46,-5,42
Grasshoppers,4901,6,10,8,14,42,47,-5,38
FC Lugano,4901,7,10,5,17,30,49,-19,35
FC Sion,4901,8,8,7,17,43,55,-12,31
FC Thun,4901,9,8,6,18,41,61,-20,30
Young Boys,4902,1,21,8,3,74,34,40,71
FC Basel,4902,2,20,7,5,58,25,33,67
St Gallen,4902,3,16,2,14,45,54,-9,50
Lucerne,4902,4,12,7,13,39,50,-11,43
FC Zürich,4902,5,11,9,12,45,36,9,42
FC Lugano,4902,6,11,5,16,31,46,-15,38
FC Thun,4902,7,9,6,17,44,64,-20,33
Grasshoppers,4902,8,8,8,16,40,50,-10,32
FC Sion,4902,9,6,8,18,42,59,-17,26
Young Boys,4903,1,22,7,3,70,33,37,73
FC Basel,4903,2,18,9,5,60,26,34,63
Lucerne,4903,3,13,9,10,42,44,-2,48
St Gallen,4903,4,13,5,14,42,55,-13,44
FC Zürich,4903,5,10,11,11,42,37,5,41
FC Lugano,4903,6,10,7,15,31,46,-15,37
FC Thun,4903,7,9,7,16,44,61,-17,34
Grasshoppers,4903,8,8,7,17,40,54,-14,31
FC Sion,4903,9,6,8,18,38,53,-15,26
Young Boys,4904,1,22,8,2,78,34,44,74
FC Basel,4904,2,18,8,6,53,24,29,62
St Gallen,4904,3,15,3,14,43,54,-11,48
Lucerne,4904,4,13,7,12,44,45,-1,46
FC Zürich,4904,5,10,10,12,41,37,4,40
FC Thun,4904,6,10,7,15,48,59,-11,37
FC Lugano,4904,7,10,6,16,29,48,-19,36
Grasshoppers,4904,8,8,7,17,40,55,-15,31
FC Sion,4904,9,6,8,18,41,61,-20,26
Young Boys,4905,1,19,8,5,66,37,29,65
FC Basel,4905,2,18,8,6,54,26,28,62
Lucerne,4905,3,13,10,9,45,40,5,49
St Gallen,4905,4,13,4,15,42,59,-17,43
FC Zürich,4905,5,11,9,12,41,36,5,42
FC Lugano,4905,6,11,7,14,32,44,-12,40
Grasshoppers,4905,7,10,7,15,40,48,-8,37
FC Thun,4905,8,10,6,16,42,54,-12,36
FC Sion,4905,9,5,9,18,38,56,-18,24
Young Boys,4906,1,23,6,3,70,33,37,75
FC Basel,4906,2,17,9,6,53,26,27,60
Lucerne,4906,3,14,8,10,42,41,1,50
FC Zürich,4906,4,11,10,11,43,37,6,43
St Gallen,4906,5,13,4,15,40,54,-14,43
Grasshoppers,4906,6,10,6,16,40,48,-8,36
FC Thun,4906,7,10,5,17,43,57,-14,35
FC Lugano,4906,8,9,7,16,28,47,-19,34
FC Sion,4906,9,6,7,19,37,53,-16,25
Young Boys,4907,1,20,8,4,67,35,32,68
FC Basel,4907,2,19,7,6,56,25,31,64
Lucerne,4907,3,14,8,10,49,43,6,50
St Gallen,4907,4,14,4,14,45,57,-12,46
FC Zürich,4907,5,10,10,12,39,37,2,40
FC Lugano,4907,6,10,6,16,33,51,-18,36
Grasshoppers,4907,7,9,8,15,44,52,-8,35
FC Thun,4907,8,9,6,17,42,60,-18,33
FC Sion,4907,9,5,11,16,39,54,-15,26
Young Boys,4908,1,22,6,4,78,36,42,72
FC Basel,4908,2,19,8,5,61,23,38,65
Lucerne,4908,3,13,8,11,42,43,-1,47
St Gallen,4908,4,13,3,16,41,59,-18,42
Grasshoppers,4908,5,11,7,14,44,47,-3,40
FC Zürich,4908,6,10,9,13,39,41,-2,39
FC Lugano,4908,7,11,5,16,35,51,-16,38
FC Thun,4908,8,9,6,17,43,62,-19,33
FC Sion,4908,9,5,10,17,35,56,-21,25
Young Boys,4909,1,22,8,2,73,34,39,74
FC Basel,4909,2,17,9,6,51,24,27,60
Lucerne,4909,3,13,8,11,40,41,-1,47
St Gallen,4909,4,14,2,16,42,60,-18,44
FC Zürich,4909,5,9,11,12,40,38,2,38
FC Thun,4909,6,11,5,16,42,56,-14,38
FC Lugano,4909,7,10,6,16,36,49,-13,36
Grasshoppers,4909,8,8,8,16,44,54,-10,32
FC Sion,4909,9,8,7,17,44,56,-12,31
Young Boys,4910,1,21,7,4,71,34,37,70
FC Basel,4910,2,18,8,6,55,25,30,62
Lucerne,4910,3,13,10,9,45,41,4,49
St Gallen,4910,4,13,5,14,39,52,-13,44
FC Zürich,4910,5,10,9,13,41,40,1,39
FC Lugano,4910,6,11,6,15,32,45,-13,39
FC Thun,4910,7,10,6,16,48,62,-14,36
Grasshoppers,4910,8,9,6,17,39,56,-17,33
FC Sion,4910,9,6,9,17,38,53,-15,27
Young Boys,4911,1,21,6,5,76,35,41,69
FC Basel,4911,2,18,9,5,59,26,33,63
St Gallen,4911,3,15,3,14,45,56,-11,48
FC Zürich,4911,4,11,10,11,42,36,6,43
Lucerne,4911,5,11,9,12,36,48,-12,42
FC Thun,4911,6,11,6,15,45,56,-11,39
Grasshoppers,4911,7,10,7,15,39,46,-7,37
FC Lugano,4911,8,9,7,16,28,49,-21,34
FC Sion,4911,9,6,7,19,39,57,-18,25
Young Boys,4912,1,22,6,4,68,36,32,72
FC Basel,4912,2,19,7,6,55,23,32,64
Lucerne,4912,3,13,9,10,43,43,0,48
FC Zürich,4912,4,11,10,11,41,36,5,43
St Gallen,4912,5,13,4,15,40,53,-13,43
FC Lugano,4912,6,10,7,15,32,47,-15,37
Grasshoppers,4912,7,10,6,16,40,48,-8,36
FC Thun,4912,8,9,5,18,41,58,-17,32
FC Sion,4912,9,6,8,18,37,53,-16,26
Young Boys,4913,1,21,8,3,72,34,38,71
FC Basel,4913,2,18,9,5,53,24,29,63
St Gallen,4913,3,14,4,14,46,55,-9,46
Lucerne,4913,4,12,7,13,42,48,-6,43
FC Lugano,4913,5,11,6,15,34,49,-15,39
FC Zürich,4913,6,9,11,12,40,38,2,38
Grasshoppers,4913,7,10,7,15,42,51,-9,37
FC Thun,4913,8,9,6,17,44,61,-17,33
FC Sion,4913,9,6,10,16,39,52,-13,28
Young Boys,4914,1,22,7,3,74,34,40,73
FC Basel,4914,2,18,8,6,55,28,27,62
St Gallen,4914,3,15,4,13,43,52,-9,49
FC Zürich,4914,4,11,9,12,41,37,4,42
Lucerne,4914,5,11,9,12,40,46,-6,42
FC Thun,4914,6,10,6,16,48,59,-11,36
FC Lugano,4914,7,10,6,16,30,48,-18,36
Grasshoppers,4914,8,9,8,15,41,52,-11,35
FC Sion,4914,9,5,9,18,38,54,-16,24
Young Boys,4915,1,21,7,4,69,39,30,70
FC Basel,4915,2,17,8,7,53,26,27,59
Lucerne,4915,3,14,8,10,43,43,0,50
St Gallen,4915,4,14,2,16,42,60,-18,44
FC Zürich,4915,5,11,10,11,41,36,5,43
FC Lugano,4915,6,11,6,15,33,46,-13,39
Grasshoppers,4915,7,10,6,16,45,49,-4,36
FC Sion,4915,8,7,9,16,43,52,-9,30
FC Thun,4915,9,8,6,18,42,60,-18,30
Young Boys,4916,1,19,9,4,67,37,30,66
FC Basel,4916,2,18,9,5,55,24,31,63
Lucerne,4916,3,13,10,9,42,41,1,49
St Gallen,4916,4,14,3,15,42,55,-13,45
FC Zürich,4916,5,9,10,13,38,38,0,37
Grasshoppers,4916,6,10,7,15,40,50,-10,37
FC Lugano,4916,7,10,6,16,30,47,-17,36
FC Thun,4916,8,10,5,17,48,60,-12,35
FC Sion,4916,9,7,9,16,46,56,-10,30
Young Boys,4917,1,19,7,6,69,43,26,64
FC Basel,4917,2,17,8,7,54,28,26,59
Lucerne,4917,3,13,10,9,42,40,2,49
St Gallen,4917,4,15,2,15,43,54,-11,47
FC Zürich,4917,5,11,10,11,45,38,7,43
Grasshoppers,4917,6,10,7,15,41,46,-5,37
FC Lugano,4917,7,10,7,15,32,46,-14,37
FC Sion,4917,8,8,8,16,44,55,-11,32
FC Thun,4917,9,9,5,18,42,62,-20,32
Young Boys,4918,1,21,8,3,72,40,32,71
FC Basel,4918,2,18,8,6,59,25,34,62
St Gallen,4918,3,14,3,15,44,58,-14,45
FC Zürich,4918,4,11,10,11,44,37,7,43
Lucerne,4918,5,11,8,13,41,51,-10,41
FC Lugano,4918,6,11,6,15,39,52,-13,39
FC Thun,4918,7,10,7,15,49,56,-7,37
Grasshoppers,4918,8,9,9,14,42,48,-6,36
FC Sion,4918,9,6,7,19,40,63,-23,25
Young Boys,4919,1,22,7,3,69,32,37,73
FC Basel,4919,2,18,9,5,55,25,30,63
Lucerne,4919,3,14,8,10,43,42,1,50
St Gallen,4919,4,13,3,16,42,58,-16,42
FC Zürich,4919,5,10,10,12,41,39,2,40
FC Lugano,4919,6,10,6,16,31,47,-16,36
FC Thun,4919,7,10,5,17,42,59,-17,35
FC Sion,4919,8,8,7,17,45,52,-7,31
Grasshoppers,4919,9,8,7,17,37,51,-14,31
Young Boys,4920,1,21,8,3,72,38,34,71
FC Basel,4920,2,18,8,6,56,29,27,62
St Gallen,4920,3,15,3,14,45,53,-8,48
Lucerne,4920,4,13,8,11,48,48,0,47
FC Zürich,4920,5,11,10,11,43,36,7,43
Grasshoppers,4920,6,10,6,16,43,51,-8,36
FC Lugano,4920,7,9,7,16,33,50,-17,34
FC Thun,4920,8,9,6,17,40,57,-17,33
FC Sion,4920,9,6,8,18,37,55,-18,26
Young Boys,4921,1,20,8,4,69,35,34,68
FC Basel,4921,2,19,7,6,55,25,30,64
FC Zürich,4921,3,12,9,11,44,37,7,45
Lucerne,4921,4,12,9,11,41,44,-3,45
St Gallen,4921,5,13,4,15,42,56,-14,43
Grasshoppers,4921,6,10,8,14,43,48,-5,38
FC Lugano,4921,7,10,6,16,31,49,-18,36
FC Thun,4921,8,8,7,17,43,61,-18,31
FC Sion,4921,9,7,8,17,44,57,-13,29
Young Boys,4922,1,21,9,2,71,32,39,72
FC Basel,4922,2,18,9,5,51,22,29,63
Lucerne,4922,3,13,9,10,44,42,2,48
St Gallen,4922,4,14,3,15,42,54,-12,45
FC Zürich,4922,5,10,11,11,42,39,3,41
Grasshoppers,4922,6,9,7,16,42,51,-9,34
FC Lugano,4922,7,9,6,17,31,53,-22,33
FC Thun,4922,8,9,5,18,43,60,-17,32
FC Sion,4922,9,8,7,17,41,54,-13,31
Young Boys,4923,1,21,8,3,71,38,33,71
FC Basel,4923,2,17,8,7,57,27,30,59
Lucerne,4923,3,13,8,11,42,44,-2,47
St Gallen,4923,4,13,4,15,42,57,-15,43
FC Zürich,4923,5,10,11,11,44,42,2,41
Grasshoppers,4923,6,11,7,14,44,47,-3,40
FC Thun,4923,7,11,5,16,50,57,-7,38
FC Lugano,4923,8,10,5,17,33,50,-17,35
FC Sion,4923,9,5,10,17,41,62,-21,25
Young Boys,4924,1,23,6,3,80,36,44,75
FC Basel,4924,2,16,9,7,54,29,25,57
Lucerne,4924,3,14,8,10,44,45,-1,50
St Gallen,4924,4,14,3,15,42,56,-14,45
FC Zürich,4924,5,10,11,11,40,36,4,41
FC Lugano,4924,6,10,6,16,34,53,-19,36
Grasshoppers,4924,7,9,8,15,41,50,-9,35
FC Thun,4924,8,8,9,15,42,57,-15,33
FC Sion,4924,9,6,8,18,39,54,-15,26
Young Boys,4925,1,22,8,2,73,34,39,74
FC Basel,4925,2,18,8,6,62,28,34,62
Lucerne,4925,3,14,8,10,46,47,-1,50
St Gallen,4925,4,14,3,15,43,58,-15,45
FC Lugano,4925,5,11,5,16,34,47,-13,38
FC Zürich,4925,6,9,9,14,39,40,-1,36
FC Thun,4925,7,10,6,16,44,63,-19,36
Grasshoppers,4925,8,9,7,16,48,54,-6,34
FC Sion,4925,9,6,8,18,41,59,-18,26
Young Boys,4926,1,22,7,3,75,38,37,73
FC Basel,4926,2,18,9,5,56,23,33,63
Lucerne,4926,3,14,8,10,48,40,8,50
St Gallen,4926,4,14,2,16,40,56,-16,44
FC Zürich,4926,5,11,10,11,44,38,6,43
FC Thun,4926,6,11,5,16,46,61,-15,38
FC Lugano,4926,7,10,5,17,32,50,-18,35
Grasshoppers,4926,8,9,7,16,43,55,-12,34
FC Sion,4926,9,5,7,20,39,62,-23,22
Young Boys,4927,1,21,8,3,70,35,35,71
FC Basel,4927,2,19,8,5,58,24,34,65
Lucerne,4927,3,13,8,11,40,41,-1,47
St Gallen,4927,4,14,2,16,43,58,-15,44
FC Zürich,4927,5,11,9,12,43,38,5,42
FC Lugano,4927,6,11,6,15,34,48,-14,39
FC Thun,4927,7,10,5,17,43,63,-20,35
Grasshoppers,4927,8,8,7,17,37,49,-12,31
FC Sion,4927,9,7,7,18,43,55,-12,28
Young Boys,4928,1,20,7,5,74,45,29,67
FC Basel,4928,2,17,8,7,53,28,25,59
St Gallen,4928,3,16,2,14,44,51,-7,50
Lucerne,4928,4,14,7,11,45,45,0,49
FC Zürich,4928,5,10,10,12,44,39,5,40
FC Lugano,4928,6,11,5,16,32,47,-15,38
FC Thun,4928,7,9,7,16,44,60,-16,34
Grasshoppers,4928,8,9,6,17,44,55,-11,33
FC Sion,4928,9,8,8,16,45,55,-10,32
Young Boys,4929,1,21,9,2,75,36,39,72
FC Basel,4929,2,18,7,7,53,26,27,61
Lucerne,4929,3,13,9,10,42,44,-2,48
St Gallen,4929,4,14,3,15,45,57,-12,45
FC Zürich,4929,5,11,11,10,40,34,6,44
FC Thun,4929,6,10,5,17,42,58,-16,35
FC Lugano,4929,7,9,7,16,30,48,-18,34
Grasshoppers,4929,8,8,8,16,40,50,-10,32
FC Sion,4929,9,5,11,16,43,57,-14,26
Young Boys,4930,1,22,7,3,75,36,39,73
FC Basel,4930,2,17,9,6,55,27,28,60
St Gallen,4930,3,16,3,13,47,53,-6,51
Lucerne,4930,4,13,9,10,43,42,1,48
FC Zürich,4930,5,12,9,11,43,36,7,45
FC Thun,4930,6,9,5,18,44,64,-20,32
FC Lugano,4930,7,9,5,18,29,50,-21,32
FC Sion,4930,8,8,7,17,44,56,-12,31
Grasshoppers,4930,9,8,6,18,39,55,-16,30
FC Basel,4931,1,20,7,5,60,24,36,67
Young Boys,4931,2,20,6,6,71,41,30,66
Lucerne,4931,3,13,7,12,42,45,-3,46
St Gallen,4931,4,14,2,16,42,58,-16,44
Grasshoppers,4931,5,12,6,14,47,48,-1,42
FC Zürich,4931,6,10,9,13,41,44,-3,39
FC Lugano,4931,7,11,5,16,36,48,-12,38
FC Thun,4931,8,10,5,17,42,58,-16,35
FC Sion,4931,9,7,7,18,41,56,-15,28
Young Boys,4932,1,21,9,2,82,38,44,72
FC Basel,4932,2,17,8,7,53,28,25,59
St Gallen,4932,3,15,3,14,42,51,-9,48
Lucerne,4932,4,12,7,13,37,51,-14,43
FC Zürich,4932,5,11,9,12,42,38,4,42
FC Thun,4932,6,11,5,16,44,56,-12,38
FC Lugano,4932,7,10,7,15,31,46,-15,37
Grasshoppers,4932,8,10,6,16,47,52,-5,36
FC Sion,4932,9,6,8,18,39,57,-18,26
Young Boys,4933,1,21,7,4,73,36,37,70
FC Basel,4933,2,17,10,5,60,26,34,61
Lucerne,4933,3,14,8,10,42,40,2,50
FC Zürich,4933,4,12,10,10,45,35,10,46
St Gallen,4933,5,14,2,16,41,60,-19,44
Grasshoppers,4933,6,10,6,16,40,50,-10,36
FC Lugano,4933,7,10,5,17,31,50,-19,35
FC Thun,4933,8,9,5,18,43,63,-20,32
FC Sion,4933,9,7,7,18,43,58,-15,28
Young Boys,4934,1,22,6,4,71,36,35,72
FC Basel,4934,2,19,7,6,57,26,31,64
Lucerne,4934,3,15,7,10,45,41,4,52
FC Zürich,4934,4,11,10,11,43,35,8,43
St Gallen,4934,5,13,3,16,42,60,-18,42
FC Lugano,4934,6,10,6,16,34,49,-15,36
Grasshoppers,4934,7,9,7,16,40,53,-13,34
FC Thun,4934,8,9,5,18,44,61,-17,32
FC Sion,4934,9,6,9,17,38,53,-15,27
Young Boys,4935,1,22,6,4,74,41,33,72
FC Basel,4935,2,19,7,6,56,26,30,64
Lucerne,4935,3,13,8,11,45,48,-3,47
St Gallen,4935,4,15,2,15,49,57,-8,47
FC Zürich,4935,5,10,10,12,38,37,1,40
FC Thun,4935,6,10,5,17,46,58,-12,35
Grasshoppers,4935,7,9,7,16,45,55,-10,34
FC Lugano,4935,8,9,6,17,29,47,-18,33
FC Sion,4935,9,8,7,17,44,57,-13,31
Young Boys,4936,1,22,7,3,73,34,39,73
FC Basel,4936,2,18,9,5,55,24,31,63
Lucerne,4936,3,13,8,11,42,41,1,47
St Gallen,4936,4,13,4,15,42,58,-16,43
Grasshoppers,4936,5,11,6,15,44,48,-4,39
FC Zürich,4936,6,9,11,12,39,39,0,38
FC Lugano,4936,7,11,5,16,34,50,-16,38
FC Thun,4936,8,8,7,17,42,59,-17,31
FC Sion,4936,9,6,9,17,39,57,-18,27
Young Boys,4937,1,23,6,3,71,32,39,75
FC Basel,4937,2,19,7,6,54,24,30,64
St Gallen,4937,3,14,3,15,42,54,-12,45
Lucerne,4937,4,12,8,12,41,44,-3,44
FC Zürich,4937,5,11,9,12,42,40,2,42
FC Thun,4937,6,11,5,16,49,57,-8,38
FC Lugano,4937,7,10,5,17,31,50,-19,35
Grasshoppers,4937,8,9,6,17,40,52,-12,33
FC Sion,4937,9,7,7,18,39,56,-17,28
Young Boys,4938,1,20,7,5,69,37,32,67
FC Basel,4938,2,17,8,7,53,28,25,59
St Gallen,4938,3,15,2,15,43,52,-9,47
Lucerne,4938,4,13,7,12,40,43,-3,46
FC Zürich,4938,5,11,9,12,39,36,3,42
FC Lugano,4938,6,12,5,15,32,45,-13,41
Grasshoppers,4938,7,9,7,16,39,49,-10,34
FC Thun,4938,8,9,7,16,42,57,-15,34
FC Sion,4938,9,8,8,16,41,51,-10,32
Young Boys,4939,1,23,7,2,72,33,39,76
FC Basel,4939,2,18,9,5,56,26,30,63
Lucerne,4939,3,14,7,11,42,42,0,49
FC Zürich,4939,4,11,11,10,44,36,8,44
St Gallen,4939,5,14,2,16,40,54,-14,44
FC Thun,4939,6,10,6,16,45,59,-14,36
Grasshoppers,4939,7,9,6,17,41,49,-8,33
FC Lugano,4939,8,9,5,18,30,49,-19,32
FC Sion,4939,9,6,7,19,37,59,-22,25
Young Boys,4940,1,22,8,2,71,34,37,74
FC Basel,4940,2,16,9,7,51,27,24,57
Lucerne,4940,3,14,7,11,44,43,1,49
St Gallen,4940,4,15,2,15,47,57,-10,47
FC Zürich,4940,5,11,11,10,46,35,11,44
FC Lugano,4940,6,11,6,15,35,48,-13,39
Grasshoppers,4940,7,10,6,16,43,53,-10,36
FC Thun,4940,8,8,6,18,42,63,-21,30
FC Sion,4940,9,6,7,19,41,60,-19,25
Young Boys,4941,1,22,6,4,73,38,35,72
FC Basel,4941,2,18,9,5,55,25,30,63
FC Zürich,4941,3,11,11,10,45,37,8,44
Lucerne,4941,4,11,10,11,39,43,-4,43
St Gallen,4941,5,13,3,16,41,58,-17,42
FC Lugano,4941,6,11,6,15,35,49,-14,39
FC Thun,4941,7,9,7,16,46,59,-13,34
Grasshoppers,4941,8,8,8,16,41,55,-14,32
FC Sion,4941,9,6,10,16,42,53,-11,28
Young Boys,4942,1,22,8,2,72,32,40,74
FC Basel,4942,2,18,8,6,53,25,28,62
St Gallen,4942,3,16,2,14,43,52,-9,50
Lucerne,4942,4,12,7,13,41,46,-5,43
FC Zürich,4942,5,10,9,13,39,37,2,39
Grasshoppers,4942,6,11,6,15,43,48,-5,39
FC Lugano,4942,7,10,5,17,28,47,-19,35
FC Sion,4942,8,8,8,16,42,52,-10,32
FC Thun,4942,9,8,5,19,41,63,-22,29
Young Boys,4943,1,21,7,4,74,36,38,70
FC Basel,4943,2,18,9,5,60,27,33,63
St Gallen,4943,3,14,4,14,48,59,-11,46
Lucerne,4943,4,12,8,12,43,50,-7,44
FC Zürich,4943,5,11,10,11,45,37,8,43
FC Thun,4943,6,10,6,16,41,58,-17,36
FC Lugano,4943,7,10,5,17,35,56,-21,35
Grasshoppers,4943,8,9,7,16,39,48,-9,34
FC Sion,4943,9,7,8,17,40,54,-14,29
Young Boys,4944,1,22,7,3,75,35,40,73
FC Basel,4944,2,17,8,7,52,27,25,59
Lucerne,4944,3,14,7,11,46,47,-1,49
St Gallen,4944,4,13,5,14,43,56,-13,44
FC Zürich,4944,5,10,10,12,38,35,3,40
FC Lugano,4944,6,11,6,15,33,49,-16,39
Grasshoppers,4944,7,10,7,15,43,49,-6,37
FC Thun,4944,8,9,7,16,41,56,-15,34
FC Sion,4944,9,5,9,18,36,53,-17,24
Young Boys,4945,1,22,7,3,72,34,38,73
FC Basel,4945,2,17,8,7,54,27,27,59
St Gallen,4945,3,14,3,15,41,57,-16,45
FC Zürich,4945,4,11,10,11,43,37,6,43
Lucerne,4945,5,11,9,12,39,45,-6,42
FC Lugano,4945,6,10,6,16,31,46,-15,36
FC Sion,4945,7,9,7,16,42,51,-9,34
Grasshoppers,4945,8,9,7,16,41,53,-12,34
FC Thun,4945,9,9,7,16,45,58,-13,34
Young Boys,4946,1,23,6,3,77,35,42,75
FC Basel,4946,2,17,8,7,52,25,27,59
St Gallen,4946,3,14,3,15,42,52,-10,45
Lucerne,4946,4,11,10,11,40,45,-5,43
FC Zürich,4946,5,11,9,12,43,40,3,42
FC Thun,4946,6,11,6,15,46,56,-10,39
FC Lugano,4946,7,10,6,16,29,46,-17,36
Grasshoppers,4946,8,9,8,15,44,54,-10,35
FC Sion,4946,9,6,8,18,39,59,-20,26
Young Boys,4947,1,21,8,3,71,36,35,71
FC Basel,4947,2,18,7,7,56,27,29,61
St Gallen,4947,3,15,2,15,45,54,-9,47
Lucerne,4947,4,12,8,12,40,47,-7,44
FC Zürich,4947,5,10,10,12,40,38,2,40
FC Thun,4947,6,10,6,16,45,60,-15,36
FC Lugano,4947,7,10,6,16,31,47,-16,36
FC Sion,4947,8,8,9,15,42,50,-8,33
Grasshoppers,4947,9,8,8,16,39,50,-11,32
Young Boys,4948,1,21,8,3,74,34,40,71
FC Basel,4948,2,16,9,7,52,28,24,57
St Gallen,4948,3,15,3,14,44,54,-10,48
Lucerne,4948,4,12,9,11,40,43,-3,45
FC Zürich,4948,5,11,9,12,41,38,3,42
FC Thun,4948,6,12,5,15,48,56,-8,41
Grasshoppers,4948,7,10,6,16,41,48,-7,36
FC Lugano,4948,8,9,6,17,29,52,-23,33
FC Sion,4948,9,7,7,18,41,57,-16,28
Young Boys,4949,1,23,6,3,75,33,42,75
FC Basel,4949,2,18,8,6,59,27,32,62
Lucerne,4949,3,12,8,12,38,42,-4,44
St Gallen,4949,4,14,2,16,47,60,-13,44
FC Zürich,4949,5,10,10,12,40,37,3,40
FC Lugano,4949,6,11,6,15,32,49,-17,39
FC Thun,4949,7,10,6,16,41,60,-19,36
Grasshoppers,4949,8,9,7,16,39,48,-9,34
FC Sion,4949,9,7,7,18,43,58,-15,28
Young Boys,4950,1,24,6,2,76,33,43,78
FC Basel,4950,2,17,9,6,57,29,28,60
Lucerne,4950,3,13,9,10,44,43,1,48
FC Zürich,4950,4,11,10,11,40,37,3,43
St Gallen,4950,5,13,4,15,44,59,-15,43
FC Thun,4950,6,10,6,16,47,59,-12,36
FC Lugano,4950,7,10,5,17,30,48,-18,35
Grasshoppers,4950,8,9,6,17,39,50,-11,33
FC Sion,4950,9,5,9,18,38,57,-19,24
Young Boys,4951,1,20,7,5,64,32,32,67
FC Basel,4951,2,15,10,7,49,29,20,55
Lucerne,4951,3,13,10,9,44,40,4,49
St Gallen,4951,4,14,3,15,41,54,-13,45
FC Zürich,4951,5,10,11,11,42,37,5,41
FC Lugano,4951,6,10,7,15,31,44,-13,37
Grasshoppers,4951,7,10,6,16,45,57,-12,36
FC Thun,4951,8,9,8,15,50,63,-13,35
FC Sion,4951,9,8,8,16,44,54,-10,32
Young Boys,4952,1,23,7,2,71,29,42,76
FC Basel,4952,2,17,7,8,52,31,21,58
St Gallen,4952,3,17,2,13,51,53,-2,53
FC Zürich,4952,4,11,10,11,43,37,6,43
Lucerne,4952,5,12,7,13,41,48,-7,43
Grasshoppers,4952,6,10,6,16,40,51,-11,36
FC Lugano,4952,7,10,5,17,33,51,-18,35
FC Thun,4952,8,9,5,18,42,61,-19,32
FC Sion,4952,9,6,9,17,41,53,-12,27
Young Boys,4953,1,23,6,3,70,33,37,75
FC Basel,4953,2,18,8,6,56,28,28,62
St Gallen,4953,3,16,3,13,47,50,-3,51
FC Zürich,4953,4,11,11,10,42,36,6,44
Lucerne,4953,5,11,9,12,40,46,-6,42
FC Lugano,4953,6,10,5,17,32,49,-17,35
FC Thun,4953,7,9,7,16,46,61,-15,34
Grasshoppers,4953,8,8,9,15,40,50,-10,33
FC Sion,4953,9,5,8,19,38,58,-20,23
Young Boys,4954,1,22,6,4,74,36,38,72
FC Basel,4954,2,19,8,5,56,23,33,65
Lucerne,4954,3,13,7,12,42,45,-3,46
St Gallen,4954,4,14,3,15,41,55,-14,45
FC Zürich,4954,5,10,11,11,39,35,4,41
FC Thun,4954,6,10,7,15,45,55,-10,37
Grasshoppers,4954,7,10,6,16,46,52,-6,36
FC Lugano,4954,8,9,7,16,29,49,-20,34
FC Sion,4954,9,6,7,19,41,63,-22,25
Young Boys,4955,1,23,7,2,78,32,46,76
FC Basel,4955,2,17,8,7,53,30,23,59
Lucerne,4955,3,13,8,11,45,47,-2,47
St Gallen,4955,4,13,4,15,42,57,-15,43
FC Zürich,4955,5,9,13,10,40,36,4,40
Grasshoppers,4955,6,10,7,15,40,47,-7,37
FC Lugano,4955,7,10,7,15,31,49,-18,37
FC Thun,4955,8,9,6,17,44,59,-15,33
FC Sion,4955,9,6,8,18,39,55,-16,26
Young Boys,4956,1,23,6,3,75,34,41,75
FC Basel,4956,2,16,8,8,51,27,24,56
Lucerne,4956,3,14,8,10,43,42,1,50
FC Zürich,4956,4,13,9,10,43,35,8,48
St Gallen,4956,5,14,2,16,43,56,-13,44
FC Lugano,4956,6,10,5,17,29,48,-19,35
Grasshoppers,4956,7,9,7,16,43,51,-8,34
FC Thun,4956,8,9,7,16,43,58,-15,34
FC Sion,4956,9,6,8,18,39,58,-19,26
Young Boys,4957,1,21,6,5,71,38,33,69
FC Basel,4957,2,18,8,6,55,25,30,62
St Gallen,4957,3,14,4,14,41,52,-11,46
Lucerne,4957,4,12,8,12,43,45,-2,44
FC Zürich,4957,5,10,10,12,39,39,0,40
FC Lugano,4957,6,11,6,15,33,44,-11,39
FC Thun,4957,7,11,5,16,47,60,-13,38
Grasshoppers,4957,8,10,6,16,42,53,-11,36
FC Sion,4957,9,6,9,17,41,56,-15,27
Young Boys,4958,1,21,6,5,71,38,33,69
FC Basel,4958,2,18,8,6,55,26,29,62
Lucerne,4958,3,13,9,10,45,44,1,48
FC Zürich,4958,4,12,10,10,42,34,8,46
St Gallen,4958,5,13,3,16,41,55,-14,42
Grasshoppers,4958,6,10,7,15,42,50,-8,37
FC Lugano,4958,7,10,5,17,29,46,-17,35
FC Thun,4958,8,9,6,17,40,58,-18,33
FC Sion,4958,9,7,8,17,39,53,-14,29
Young Boys,4959,1,21,7,4,71,35,36,70
FC Basel,4959,2,18,9,5,56,25,31,63
St Gallen,4959,3,15,4,13,45,51,-6,49
Lucerne,4959,4,12,8,12,39,47,-8,44
FC Zürich,4959,5,10,11,11,43,39,4,41
FC Thun,4959,6,10,6,16,46,57,-11,36
FC Lugano,4959,7,9,8,15,29,47,-18,35
Grasshoppers,4959,8,8,9,15,39,48,-9,33
FC Sion,4959,9,6,8,18,41,60,-19,26
Young Boys,4960,1,23,7,2,74,33,41,76
FC Basel,4960,2,18,8,6,56,25,31,62
St Gallen,4960,3,15,2,15,48,60,-12,47
FC Zürich,4960,4,12,9,11,44,36,8,45
Lucerne,4960,5,12,7,13,39,48,-9,43
FC Lugano,4960,6,11,5,16,36,49,-13,38
FC Thun,4960,7,10,6,16,48,59,-11,36
Grasshoppers,4960,8,8,6,18,39,55,-16,30
FC Sion,4960,9,6,8,18,44,63,-19,26
Young Boys,4961,1,20,8,4,70,36,34,68
FC Basel,4961,2,17,8,7,56,29,27,59
Lucerne,4961,3,14,8,10,45,44,1,50
St Gallen,4961,4,14,5,13,46,56,-10,47
FC Zürich,4961,5,10,9,13,41,41,0,39
Grasshoppers,4961,6,10,7,15,42,48,-6,37
FC Lugano,4961,7,10,6,16,32,49,-17,36
FC Thun,4961,8,9,6,17,41,61,-20,33
FC Sion,4961,9,7,9,16,46,55,-9,30
Young Boys,4962,1,22,6,4,71,36,35,72
FC Basel,4962,2,19,8,5,59,25,34,65
Lucerne,4962,3,11,10,11,41,45,-4,43
St Gallen,4962,4,13,3,16,42,60,-18,42
FC Zürich,4962,5,9,11,12,42,42,0,38
Grasshoppers,4962,6,10,8,14,43,48,-5,38
FC Lugano,4962,7,10,7,15,33,46,-13,37
FC Thun,4962,8,10,5,17,47,62,-15,35
FC Sion,4962,9,7,8,17,43,57,-14,29
Young Boys,4963,1,22,8,2,75,34,41,74
FC Basel,4963,2,16,10,6,54,27,27,58
St Gallen,4963,3,16,2,14,47,56,-9,50
Lucerne,4963,4,12,8,12,42,46,-4,44
FC Zürich,4963,5,10,10,12,40,40,0,40
FC Thun,4963,6,9,8,15,45,58,-13,35
Grasshoppers,4963,7,8,9,15,41,50,-9,33
FC Sion,4963,8,8,8,16,45,54,-9,32
FC Lugano,4963,9,9,5,18,32,56,-24,32
Young Boys,4964,1,21,8,3,70,33,37,71
FC Basel,4964,2,18,7,7,55,29,26,61
Lucerne,4964,3,14,8,10,43,40,3,50
St Gallen,4964,4,15,2,15,47,57,-10,47
FC Zürich,4964,5,10,9,13,40,41,-1,39
Grasshoppers,4964,6,10,6,16,40,50,-10,36
FC Lugano,4964,7,10,6,16,33,49,-16,36
FC Thun,4964,8,10,5,17,47,61,-14,35
FC Sion,4964,9,7,7,18,40,55,-15,28
Young Boys,4965,1,22,7,3,75,32,43,73
FC Basel,4965,2,18,8,6,57,28,29,62
Lucerne,4965,3,13,8,11,44,51,-7,47
St Gallen,4965,4,14,3,15,44,53,-9,45
FC Zürich,4965,5,11,10,11,45,38,7,43
Grasshoppers,4965,6,10,7,15,44,49,-5,37
FC Lugano,4965,7,10,6,16,32,53,-21,36
FC Thun,4965,8,8,8,16,43,59,-16,32
FC Sion,4965,9,5,9,18,37,58,-21,24
Young Boys,4966,1,23,7,2,74,35,39,76
FC Basel,4966,2,16,9,7,52,28,24,57
Lucerne,4966,3,13,8,11,44,45,-1,47
St Gallen,4966,4,14,3,15,42,55,-13,45
FC Zürich,4966,5,10,10,12,39,38,1,40
FC Lugano,4966,6,10,8,14,34,46,-12,38
FC Thun,4966,7,10,6,16,44,57,-13,36
Grasshoppers,4966,8,9,6,17,40,51,-11,33
FC Sion,4966,9,7,7,18,41,55,-14,28
Young Boys,4967,1,22,6,4,72,35,37,72
FC Basel,4967,2,15,10,7,54,31,23,55
St Gallen,4967,3,15,3,14,45,57,-12,48
Lucerne,4967,4,13,8,11,43,45,-2,47
FC Zürich,4967,5,12,10,10,42,34,8,46
FC Thun,4967,6,10,6,16,43,58,-15,36
Grasshoppers,4967,7,9,6,17,40,50,-10,33
FC Lugano,4967,8,9,6,17,29,49,-20,33
FC Sion,4967,9,8,7,17,44,53,-9,31
Young Boys,4968,1,22,6,4,70,37,33,72
FC Basel,4968,2,18,7,7,58,26,32,61
St Gallen,4968,3,15,3,14,48,54,-6,48
Lucerne,4968,4,12,8,12,39,48,-9,44
FC Zürich,4968,5,10,11,11,42,40,2,41
Grasshoppers,4968,6,10,8,14,41,47,-6,38
FC Lugano,4968,7,10,5,17,32,48,-16,35
FC Thun,4968,8,9,7,16,44,59,-15,34
FC Sion,4968,9,6,9,17,38,53,-15,27
Young Boys,4969,1,20,9,3,68,35,33,69
FC Basel,4969,2,19,7,6,55,24,31,64
St Gallen,4969,3,16,2,14,49,56,-7,50
Lucerne,4969,4,14,7,11,43,42,1,49
FC Zürich,4969,5,11,9,12,41,38,3,42
FC Lugano,4969,6,10,6,16,31,50,-19,36
FC Thun,4969,7,10,5,17,43,56,-13,35
Grasshoppers,4969,8,9,7,16,39,48,-9,34
FC Sion,4969,9,5,8,19,36,56,-20,23
Young Boys,4970,1,22,6,4,74,34,40,72
FC Basel,4970,2,18,8,6,59,28,31,62
Lucerne,4970,3,12,8,12,40,46,-6,44
St Gallen,4970,4,13,5,14,43,55,-12,44
FC Zürich,4970,5,9,11,12,39,39,0,38
Grasshoppers,4970,6,10,7,15,40,46,-6,37
FC Lugano,4970,7,10,7,15,28,46,-18,37
FC Thun,4970,8,10,5,17,46,63,-17,35
FC Sion,4970,9,7,9,16,41,53,-12,30
Young Boys,4971,1,23,7,2,74,31,43,76
FC Basel,4971,2,19,7,6,61,28,33,64
Lucerne,4971,3,13,8,11,40,48,-8,47
FC Zürich,4971,4,11,9,12,42,36,6,42
St Gallen,4971,5,13,3,16,40,55,-15,42
FC Lugano,4971,6,10,8,14,31,44,-13,38
Grasshoppers,4971,7,9,7,16,37,47,-10,34
FC Thun,4971,8,8,6,18,42,62,-20,30
FC Sion,4971,9,6,9,17,39,55,-16,27
Young Boys,4972,1,21,6,5,72,37,35,69
FC Basel,4972,2,18,7,7,51,25,26,61
Lucerne,4972,3,13,8,11,46,46,0,47
St Gallen,4972,4,15,2,15,42,55,-13,47
FC Zürich,4972,5,11,10,11,40,35,5,43
Grasshoppers,4972,6,11,7,14,41,46,-5,40
FC Thun,4972,7,10,5,17,43,58,-15,35
FC Lugano,4972,8,10,5,17,31,49,-18,35
FC Sion,4972,9,6,8,18,40,55,-15,26
Young Boys,4973,1,21,7,4,72,35,37,70
FC Basel,4973,2,19,8,5,58,25,33,65
St Gallen,4973,3,16,2,14,46,55,-9,50
Lucerne,4973,4,13,7,12,44,49,-5,46
FC Zürich,4973,5,11,9,12,38,34,4,42
FC Thun,4973,6,10,5,17,46,62,-16,35
Grasshoppers,4973,7,9,6,17,40,51,-11,33
FC Lugano,4973,8,9,5,18,29,50,-21,32
FC Sion,4973,9,8,7,17,42,54,-12,31
Young Boys,4974,1,22,8,2,73,33,40,74
FC Basel,4974,2,16,8,8,50,30,20,56
St Gallen,4974,3,16,2,14,44,51,-7,50
Lucerne,4974,4,13,8,11,41,42,-1,47
FC Zürich,4974,5,11,9,12,45,40,5,42
FC Lugano,4974,6,11,5,16,33,49,-16,38
Grasshoppers,4974,7,9,7,16,42,51,-9,34
FC Thun,4974,8,9,6,17,45,60,-15,33
FC Sion,4974,9,7,7,18,39,56,-17,28
Young Boys,4975,1,23,7,2,72,33,39,76
FC Basel,4975,2,17,10,5,56,25,31,61
St Gallen,4975,3,15,4,13,46,54,-8,49
FC Zürich,4975,4,12,10,10,43,34,9,46
Lucerne,4975,5,11,7,14,38,49,-11,40
Grasshoppers,4975,6,10,7,15,45,50,-5,37
FC Lugano,4975,7,10,6,16,31,46,-15,36
FC Thun,4975,8,9,5,18,40,59,-19,32
FC Sion,4975,9,5,8,19,38,59,-21,23
Young Boys,4976,1,22,7,3,71,34,37,73
FC Basel,4976,2,18,7,7,51,25,26,61
St Gallen,4976,3,15,2,15,41,52,-11,47
Lucerne,4976,4,13,7,12,42,45,-3,46
FC Zürich,4976,5,11,9,12,42,40,2,42
Grasshoppers,4976,6,11,6,15,42,47,-5,39
FC Thun,4976,7,10,5,17,44,56,-12,35
FC Lugano,4976,8,10,5,17,32,50,-18,35
FC Sion,4976,9,6,8,18,39,55,-16,26
Young Boys,4977,1,22,6,4,74,36,38,72
FC Basel,4977,2,19,7,6,57,24,33,64
St Gallen,4977,3,14,3,15,43,56,-13,45
Lucerne,4977,4,12,8,12,40,46,-6,44
FC Zürich,4977,5,10,10,12,42,39,3,40
FC Lugano,4977,6,11,7,14,36,48,-12,40
Grasshoppers,4977,7,9,7,16,38,47,-9,34
FC Thun,4977,8,9,6,17,42,60,-18,33
FC Sion,4977,9,6,10,16,39,55,-16,28
Young Boys,4978,1,22,8,2,71,31,40,74
FC Basel,4978,2,18,9,5,55,23,32,63
Lucerne,4978,3,14,7,11,45,47,-2,49
FC Zürich,4978,4,11,9,12,41,41,0,42
St Gallen,4978,5,13,2,17,39,55,-16,41
FC Lugano,4978,6,10,5,17,28,46,-18,35
Grasshoppers,4978,7,9,7,16,44,55,-11,34
FC Thun,4978,8,9,6,17,49,66,-17,33
FC Sion,4978,9,8,7,17,45,53,-8,31
Young Boys,4979,1,20,8,4,68,36,32,68
FC Basel,4979,2,18,8,6,55,25,30,62
Lucerne,4979,3,13,9,10,47,43,4,48
St Gallen,4979,4,15,3,14,47,55,-8,48
FC Zürich,4979,5,11,10,11,42,35,7,43
FC Lugano,4979,6,10,6,16,28,49,-21,36
FC Thun,4979,7,9,7,16,47,61,-14,34
FC Sion,4979,8,7,9,16,42,55,-13,30
Grasshoppers,4979,9,8,6,18,36,53,-17,30
Young Boys,4980,1,21,7,4,72,36,36,70
FC Basel,4980,2,16,8,8,53,29,24,56
Lucerne,4980,3,14,8,10,43,41,2,50
St Gallen,4980,4,15,3,14,43,53,-10,48
FC Zürich,4980,5,10,11,11,42,36,6,41
Grasshoppers,4980,6,10,7,15,42,49,-7,37
FC Lugano,4980,7,9,7,16,32,50,-18,34
FC Thun,4980,8,8,8,16,45,65,-20,32
FC Sion,4980,9,7,9,16,41,54,-13,30
Young Boys,4981,1,21,6,5,70,34,36,69
FC Basel,4981,2,19,7,6,55,25,30,64
St Gallen,4981,3,16,2,14,44,51,-7,50
Lucerne,4981,4,13,7,12,42,51,-9,46
FC Zürich,4981,5,10,11,11,38,34,4,41
Grasshoppers,4981,6,10,7,15,44,51,-7,37
FC Lugano,4981,7,10,6,16,28,44,-16,36
FC Thun,4981,8,8,8,16,48,64,-16,32
FC Sion,4981,9,6,8,18,41,56,-15,26
Young Boys,4982,1,22,7,3,75,35,40,73
FC Basel,4982,2,17,7,8,51,28,23,58
FC Zürich,4982,3,13,9,10,44,33,11,48
St Gallen,4982,4,15,2,15,43,55,-12,47
Lucerne,4982,5,12,8,12,39,44,-5,44
FC Lugano,4982,6,10,6,16,31,48,-17,36
Grasshoppers,4982,7,9,8,15,43,51,-8,35
FC Sion,4982,8,8,7,17,43,54,-11,31
FC Thun,4982,9,8,6,18,42,63,-21,30
Young Boys,4983,1,22,6,4,76,33,43,72
FC Basel,4983,2,19,8,5,57,23,34,65
St Gallen,4983,3,14,3,15,40,53,-13,45
Lucerne,4983,4,12,8,12,40,46,-6,44
FC Zürich,4983,5,9,12,11,39,37,2,39
FC Lugano,4983,6,10,7,15,30,48,-18,37
FC Thun,4983,7,10,6,16,44,59,-15,36
Grasshoppers,4983,8,8,8,16,39,52,-13,32
FC Sion,4983,9,6,10,16,41,55,-14,28
Young Boys,4984,1,23,6,3,71,35,36,75
FC Basel,4984,2,17,8,7,57,29,28,59
Lucerne,4984,3,14,7,11,43,43,0,49
St Gallen,4984,4,15,2,15,49,58,-9,47
FC Zürich,4984,5,10,11,11,42,37,5,41
FC Lugano,4984,6,10,6,16,32,49,-17,36
Grasshoppers,4984,7,9,6,17,40,52,-12,33
FC Thun,4984,8,9,5,18,43,62,-19,32
FC Sion,4984,9,8,7,17,44,56,-12,31
Young Boys,4985,1,20,8,4,70,35,35,68
FC Basel,4985,2,15,10,7,48,26,22,55
Lucerne,4985,3,14,8,10,41,39,2,50
St Gallen,4985,4,15,3,14,40,52,-12,48
FC Zürich,4985,5,12,10,10,42,34,8,46
Grasshoppers,4985,6,10,6,16,40,50,-10,36
FC Lugano,4985,7,10,6,16,29,46,-17,36
FC Sion,4985,8,7,9,16,42,52,-10,30
FC Thun,4985,9,8,6,18,40,58,-18,30
Young Boys,4986,1,22,8,2,75,37,38,74
FC Basel,4986,2,16,10,6,54,29,25,58
St Gallen,4986,3,16,2,14,48,53,-5,50
Lucerne,4986,4,12,9,11,43,47,-4,45
FC Zürich,4986,5,10,11,11,40,39,1,41
FC Lugano,4986,6,10,6,16,35,49,-14,36
Grasshoppers,4986,7,9,7,16,40,50,-10,34
FC Thun,4986,8,9,6,17,47,63,-16,33
FC Sion,4986,9,7,7,18,40,55,-15,28
Young Boys,4987,1,22,6,4,73,36,37,72
FC Basel,4987,2,16,10,6,51,25,26,58
St Gallen,4987,3,15,3,14,43,54,-11,48
Lucerne,4987,4,11,10,11,42,48,-6,43
FC Zürich,4987,5,10,11,11,41,39,2,41
FC Lugano,4987,6,11,6,15,33,44,-11,39
Grasshoppers,4987,7,10,8,14,43,48,-5,38
FC Thun,4987,8,9,8,15,41,55,-14,35
FC Sion,4987,9,5,8,19,42,60,-18,23
Young Boys,4988,1,21,7,4,77,35,42,70
FC Basel,4988,2,18,8,6,52,26,26,62
St Gallen,4988,3,15,2,15,42,52,-10,47
Lucerne,4988,4,11,9,12,39,48,-9,42
FC Lugano,4988,5,11,6,15,32,50,-18,39
FC Zürich,4988,6,9,11,12,40,38,2,38
Grasshoppers,4988,7,10,8,14,43,47,-4,38
FC Thun,4988,8,9,6,17,41,59,-18,33
FC Sion,4988,9,7,9,16,41,52,-11,30
Young Boys,4989,1,22,7,3,78,39,39,73
FC Basel,4989,2,19,8,5,58,24,34,65
Lucerne,4989,3,13,9,10,43,40,3,48
FC Zürich,4989,4,11,10,11,42,36,6,43
St Gallen,4989,5,13,2,17,40,62,-22,41
FC Lugano,4989,6,10,6,16,30,47,-17,36
Grasshoppers,4989,7,9,7,16,41,52,-11,34
FC Thun,4989,8,9,5,18,40,61,-21,32
FC Sion,4989,9,7,8,17,47,58,-11,29
Young Boys,4990,1,21,8,3,71,36,35,71
FC Basel,4990,2,16,9,7,50,29,21,57
St Gallen,4990,3,16,3,13,46,54,-8,51
Lucerne,4990,4,13,8,11,47,42,5,47
Grasshoppers,4990,5,11,7,14,46,50,-4,40
FC Zürich,4990,6,9,10,13,37,36,1,37
FC Thun,4990,7,10,7,15,45,57,-12,37
FC Lugano,4990,8,9,6,17,30,52,-22,33
FC Sion,4990,9,6,8,18,39,55,-16,26
Young Boys,4991,1,21,9,2,70,34,36,72
FC Basel,4991,2,18,9,5,56,26,30,63
Lucerne,4991,3,12,10,10,49,46,3,46
St Gallen,4991,4,14,4,14,43,54,-11,46
FC Zürich,4991,5,9,12,11,39,36,3,39
Grasshoppers,4991,6,10,6,16,43,55,-12,36
FC Lugano,4991,7,9,8,15,34,50,-16,35
FC Thun,4991,8,9,6,17,42,60,-18,33
FC Sion,4991,9,5,10,17,36,51,-15,25
Young Boys,4992,1,22,7,3,75,37,38,73
FC Basel,4992,2,19,8,5,59,25,34,65
Lucerne,4992,3,13,8,11,44,44,0,47
St Gallen,4992,4,13,2,17,39,56,-17,41
FC Zürich,4992,5,10,9,13,38,40,-2,39
FC Lugano,4992,6,11,5,16,33,50,-17,38
FC Thun,4992,7,10,5,17,45,60,-15,35
Grasshoppers,4992,8,9,6,17,43,55,-12,33
FC Sion,4992,9,8,8,16,46,55,-9,32
Young Boys,4993,1,22,8,2,76,33,43,74
FC Basel,4993,2,15,9,8,49,30,19,54
Lucerne,4993,3,13,9,10,43,40,3,48
St Gallen,4993,4,13,3,16,41,58,-17,42
FC Zürich,4993,5,10,10,12,40,40,0,40
Grasshoppers,4993,6,11,6,15,40,48,-8,39
FC Thun,4993,7,11,5,16,46,58,-12,38
FC Lugano,4993,8,11,5,16,34,47,-13,38
FC Sion,4993,9,6,9,17,40,55,-15,27
Young Boys,4994,1,20,7,5,71,40,31,67
FC Basel,4994,2,18,7,7,57,29,28,61
Lucerne,4994,3,14,7,11,41,43,-2,49
FC Zürich,4994,4,11,10,11,42,37,5,43
St Gallen,4994,5,13,2,17,42,59,-17,41
Grasshoppers,4994,6,11,6,15,44,48,-4,39
FC Lugano,4994,7,11,5,16,34,50,-16,38
FC Thun,4994,8,10,7,15,45,56,-11,37
FC Sion,4994,9,6,9,17,39,53,-14,27
Young Boys,4995,1,22,8,2,74,34,40,74
FC Basel,4995,2,17,8,7,51,27,24,59
FC Zürich,4995,3,12,10,10,43,36,7,46
Lucerne,4995,4,12,10,10,44,43,1,46
St Gallen,4995,5,14,3,15,44,58,-14,45
Grasshoppers,4995,6,10,8,14,44,49,-5,38
FC Thun,4995,7,9,6,17,45,61,-16,33
FC Lugano,4995,8,9,6,17,30,50,-20,33
FC Sion,4995,9,6,7,19,40,57,-17,25
Young Boys,4996,1,23,6,3,73,33,40,75
FC Basel,4996,2,19,7,6,55,23,32,64
St Gallen,4996,3,15,3,14,43,52,-9,48
Lucerne,4996,4,11,9,12,39,46,-7,42
FC Lugano,4996,5,12,5,15,36,46,-10,41
FC Zürich,4996,6,10,9,13,41,41,0,39
Grasshoppers,4996,7,10,7,15,38,45,-7,37
FC Thun,4996,8,9,6,17,43,59,-16,33
FC Sion,4996,9,5,8,19,38,61,-23,23
Young Boys,4997,1,21,6,5,68,41,27,69
FC Basel,4997,2,18,8,6,56,26,30,62
Lucerne,4997,3,13,7,12,44,44,0,46
St Gallen,4997,4,14,2,16,39,56,-17,44
FC Zürich,4997,5,11,9,12,41,38,3,42
FC Lugano,4997,6,11,5,16,30,46,-16,38
Grasshoppers,4997,7,10,7,15,48,49,-1,37
FC Thun,4997,8,9,8,15,43,56,-13,35
FC Sion,4997,9,7,8,17,45,58,-13,29
Young Boys,4998,1,23,7,2,76,35,41,76
FC Basel,4998,2,18,7,7,54,27,27,61
FC Zürich,4998,3,13,9,10,43,33,10,48
St Gallen,4998,4,14,2,16,44,58,-14,44
Lucerne,4998,5,11,9,12,41,46,-5,42
Grasshoppers,4998,6,10,8,14,46,48,-2,38
FC Lugano,4998,7,10,6,16,32,49,-17,36
FC Thun,4998,8,8,5,19,39,60,-21,29
FC Sion,4998,9,7,7,18,39,58,-19,28
Young Boys,4999,1,22,7,3,77,37,40,73
FC Basel,4999,2,19,8,5,57,23,34,65
St Gallen,4999,3,14,4,14,42,54,-12,46
FC Zürich,4999,4,11,9,12,40,36,4,42
Lucerne,4999,5,11,7,14,38,46,-8,40
Grasshoppers,4999,6,11,6,15,46,49,-3,39
FC Lugano,4999,7,11,6,15,32,48,-16,39
FC Thun,4999,8,9,5,18,43,63,-20,32
FC Sion,4999,9,6,8,18,40,59,-19,26
Young Boys,5000,1,22,7,3,75,36,39,73
FC Basel,5000,2,17,8,7,51,25,26,59
FC Zürich,5000,3,12,10,10,43,33,10,46
Lucerne,5000,4,12,9,11,41,45,-4,45
St Gallen,5000,5,14,3,15,42,55,-13,45
Grasshoppers,5000,6,11,7,14,44,48,-4,40
FC Lugano,5000,7,11,6,15,33,47,-14,39
FC Thun,5000,8,8,6,18,38,61,-23,30
FC Sion,5000,9,5,8,19,39,56,-17,23
Young Boys,5001,1,22,7,3,72,36,36,73
FC Basel,5001,2,17,8,7,54,25,29,59
St Gallen,5001,3,15,2,15,41,54,-13,47
Lucerne,5001,4,13,7,12,40,42,-2,46
FC Zürich,5001,5,11,10,11,41,36,5,43
FC Thun,5001,6,10,7,15,44,57,-13,37
FC Lugano,5001,7,10,5,17,28,48,-20,35
Grasshoppers,5001,8,9,6,17,39,49,-10,33
FC Sion,5001,9,7,8,17,42,54,-12,29
Young Boys,5002,1,23,6,3,80,34,46,75
FC Basel,5002,2,19,8,5,55,25,30,65
St Gallen,5002,3,14,3,15,41,53,-12,45
Lucerne,5002,4,11,8,13,39,51,-12,41
FC Lugano,5002,5,11,6,15,34,48,-14,39
FC Zürich,5002,6,9,10,13,40,40,0,37
FC Thun,5002,7,10,6,16,41,55,-14,36
Grasshoppers,5002,8,9,8,15,39,48,-9,35
FC Sion,5002,9,6,9,17,37,52,-15,27
Young Boys,5003,1,22,7,3,70,34,36,73
FC Basel,5003,2,17,8,7,54,25,29,59
St Gallen,5003,3,16,3,13,47,55,-8,51
Lucerne,5003,4,12,8,12,39,43,-4,44
FC Zürich,5003,5,11,9,12,42,38,4,42
Grasshoppers,5003,6,10,7,15,44,49,-5,37
FC Lugano,5003,7,9,6,17,31,50,-19,33
FC Thun,5003,8,9,6,17,41,61,-20,33
FC Sion,5003,9,7,8,17,42,55,-13,29
Young Boys,5004,1,23,7,2,72,31,41,76
FC Basel,5004,2,16,9,7,58,30,28,57
St Gallen,5004,3,15,3,14,48,59,-11,48
FC Zürich,5004,4,10,10,12,39,36,3,40
Lucerne,5004,5,11,7,14,38,50,-12,40
Grasshoppers,5004,6,10,7,15,39,46,-7,37
FC Thun,5004,7,10,7,15,49,59,-10,37
FC Lugano,5004,8,10,7,15,31,46,-15,37
FC Sion,5004,9,7,7,18,40,57,-17,28
Young Boys,5005,1,21,9,2,77,35,42,72
FC Basel,5005,2,16,9,7,53,27,26,57
Lucerne,5005,3,14,8,10,45,42,3,50
St Gallen,5005,4,14,2,16,40,55,-15,44
FC Zürich,5005,5,10,11,11,41,37,4,41
FC Thun,5005,6,10,7,15,46,59,-13,37
Grasshoppers,5005,7,9,8,15,42,51,-9,35
FC Lugano,5005,8,10,5,17,31,52,-21,35
FC Sion,5005,9,7,7,18,40,57,-17,28
Young Boys,5006,1,23,6,3,78,40,38,75
FC Basel,5006,2,18,8,6,54,24,30,62
Lucerne,5006,3,13,7,12,40,42,-2,46
FC Zürich,5006,4,11,11,10,42,36,6,44
St Gallen,5006,5,14,2,16,41,60,-19,44
FC Lugano,5006,6,10,6,16,36,49,-13,36
Grasshoppers,5006,7,9,6,17,38,54,-16,33
FC Thun,5006,8,9,5,18,43,62,-19,32
FC Sion,5006,9,8,7,17,51,56,-5,31
Young Boys,5007,1,21,7,4,70,34,36,70
FC Basel,5007,2,17,9,6,56,27,29,60
Lucerne,5007,3,13,9,10,43,40,3,48
St Gallen,5007,4,14,5,13,43,53,-10,47
FC Lugano,5007,5,11,7,14,31,44,-13,40
FC Zürich,5007,6,9,10,13,38,38,0,37
Grasshoppers,5007,7,9,7,16,39,54,-15,34
FC Thun,5007,8,9,7,16,44,60,-16,34
FC Sion,5007,9,7,7,18,40,54,-14,28
Young Boys,5008,1,22,7,3,70,33,37,73
FC Basel,5008,2,16,10,6,53,30,23,58
St Gallen,5008,3,17,2,13,49,53,-4,53
Lucerne,5008,4,12,9,11,41,42,-1,45
FC Zürich,5008,5,11,10,11,45,35,10,43
FC Thun,5008,6,10,7,15,46,59,-13,37
FC Lugano,5008,7,9,6,17,30,51,-21,33
Grasshoppers,5008,8,8,7,17,38,51,-13,31
FC Sion,5008,9,6,8,18,42,60,-18,26
Young Boys,5009,1,20,7,5,69,39,30,67
FC Basel,5009,2,17,8,7,56,29,27,59
Lucerne,5009,3,14,9,9,42,40,2,51
FC Zürich,5009,4,13,9,10,47,36,11,48
St Gallen,5009,5,15,2,15,42,54,-12,47
FC Lugano,5009,6,10,5,17,30,47,-17,35
Grasshoppers,5009,7,9,7,16,40,49,-9,34
FC Sion,5009,8,8,7,17,41,53,-12,31
FC Thun,5009,9,8,6,18,43,63,-20,30
Young Boys,5010,1,20,9,3,68,34,34,69
FC Basel,5010,2,18,7,7,56,25,31,61
St Gallen,5010,3,14,3,15,42,55,-13,45
Lucerne,5010,4,11,9,12,38,47,-9,42
FC Lugano,5010,5,12,6,14,34,44,-10,42
FC Zürich,5010,6,10,9,13,38,41,-3,39
Grasshoppers,5010,7,10,7,15,41,48,-7,37
FC Thun,5010,8,10,5,17,46,60,-14,35
FC Sion,5010,9,7,9,16,44,53,-9,30
Young Boys,5011,1,23,6,3,71,35,36,75
FC Basel,5011,2,18,9,5,56,23,33,63
Lucerne,5011,3,14,7,11,42,43,-1,49
FC Zürich,5011,4,11,10,11,44,36,8,43
St Gallen,5011,5,13,3,16,43,57,-14,42
Grasshoppers,5011,6,10,6,16,44,52,-8,36
FC Lugano,5011,7,10,5,17,31,49,-18,35
FC Sion,5011,8,8,7,17,41,53,-12,31
FC Thun,5011,9,8,5,19,39,63,-24,29
Young Boys,5012,1,21,6,5,72,39,33,69
FC Basel,5012,2,17,7,8,55,26,29,58
Lucerne,5012,3,13,9,10,42,42,0,48
St Gallen,5012,4,15,2,15,44,55,-11,47
FC Zürich,5012,5,11,11,10,43,36,7,44
Grasshoppers,5012,6,11,7,14,46,50,-4,40
FC Lugano,5012,7,10,7,15,32,47,-15,37
FC Thun,5012,8,9,6,17,47,67,-20,33
FC Sion,5012,9,6,7,19,44,63,-19,25
Young Boys,5013,1,21,7,4,70,35,35,70
FC Basel,5013,2,18,9,5,56,25,31,63
FC Zürich,5013,3,12,10,10,44,35,9,46
Lucerne,5013,4,13,7,12,39,43,-4,46
St Gallen,5013,5,14,2,16,42,57,-15,44
Grasshoppers,5013,6,10,7,15,42,47,-5,37
FC Lugano,5013,7,10,5,17,30,48,-18,35
FC Thun,5013,8,8,7,17,43,61,-18,31
FC Sion,5013,9,7,8,17,40,55,-15,29
Young Boys,5014,1,22,7,3,69,33,36,73
FC Basel,5014,2,18,9,5,60,24,36,63
FC Zürich,5014,3,12,10,10,41,33,8,46
Lucerne,5014,4,12,9,11,42,45,-3,45
St Gallen,5014,5,14,2,16,42,61,-19,44
FC Lugano,5014,6,10,6,16,32,49,-17,36
FC Sion,5014,7,8,8,16,41,51,-10,32
FC Thun,5014,8,9,5,18,42,58,-16,32
Grasshoppers,5014,9,8,6,18,39,54,-15,30
Young Boys,5015,1,21,9,2,74,36,38,72
FC Basel,5015,2,16,10,6,52,27,25,58
Lucerne,5015,3,12,11,9,43,43,0,47
FC Zürich,5015,4,12,10,10,44,37,7,46
St Gallen,5015,5,14,3,15,40,53,-13,45
FC Lugano,5015,6,10,7,15,33,49,-16,37
FC Thun,5015,7,9,6,17,43,58,-15,33
Grasshoppers,5015,8,8,8,16,41,52,-11,32
FC Sion,5015,9,6,8,18,39,54,-15,26
Young Boys,5016,1,22,6,4,72,35,37,72
FC Basel,5016,2,16,10,6,52,23,29,58
St Gallen,5016,3,15,3,14,45,55,-10,48
Lucerne,5016,4,12,9,11,45,51,-6,45
FC Zürich,5016,5,9,12,11,38,35,3,39
FC Lugano,5016,6,10,6,16,32,48,-16,36
Grasshoppers,5016,7,9,8,15,44,52,-8,35
FC Thun,5016,8,9,8,15,44,58,-14,35
FC Sion,5016,9,7,8,17,40,55,-15,29
Young Boys,5017,1,22,6,4,73,37,36,72
FC Basel,5017,2,16,10,6,54,28,26,58
Lucerne,5017,3,13,9,10,42,42,0,48
FC Zürich,5017,4,12,10,10,47,35,12,46
St Gallen,5017,5,13,3,16,41,57,-16,42
FC Lugano,5017,6,10,6,16,31,48,-17,36
FC Thun,5017,7,9,7,16,41,58,-17,34
Grasshoppers,5017,8,8,8,16,39,52,-13,32
FC Sion,5017,9,7,9,16,45,56,-11,30
Young Boys,5018,1,22,7,3,79,36,43,73
FC Basel,5018,2,19,8,5,60,26,34,65
Lucerne,5018,3,13,8,11,43,45,-2,47
St Gallen,5018,4,15,2,15,46,59,-13,47
FC Zürich,5018,5,9,13,10,40,36,4,40
Grasshoppers,5018,6,10,8,14,43,48,-5,38
FC Lugano,5018,7,9,6,17,29,55,-26,33
FC Thun,5018,8,8,6,18,41,61,-20,30
FC Sion,5018,9,6,8,18,42,57,-15,26
Young Boys,5019,1,22,6,4,71,35,36,72
FC Basel,5019,2,17,7,8,50,28,22,58
Lucerne,5019,3,16,7,9,50,40,10,55
FC Zürich,5019,4,12,9,11,43,35,8,45
St Gallen,5019,5,14,3,15,44,56,-12,45
FC Lugano,5019,6,10,6,16,30,49,-19,36
FC Thun,5019,7,10,5,17,47,59,-12,35
Grasshoppers,5019,8,9,6,17,39,54,-15,33
FC Sion,5019,9,6,7,19,39,57,-18,25
Young Boys,5020,1,21,9,2,71,32,39,72
FC Basel,5020,2,17,10,5,60,29,31,61
Lucerne,5020,3,13,8,11,43,44,-1,47
St Gallen,5020,4,13,5,14,42,55,-13,44
FC Zürich,5020,5,11,9,12,42,39,3,42
FC Thun,5020,6,10,6,16,44,60,-16,36
Grasshoppers,5020,7,9,7,16,40,50,-10,34
FC Lugano,5020,8,9,6,17,30,50,-20,33
FC Sion,5020,9,6,10,16,39,52,-13,28
Young Boys,5021,1,22,7,3,74,35,39,73
FC Basel,5021,2,16,9,7,53,28,25,57
St Gallen,5021,3,16,2,14,43,53,-10,50
FC Zürich,5021,4,13,9,10,45,35,10,48
Lucerne,5021,5,12,8,12,38,44,-6,44
Grasshoppers,5021,6,10,6,16,43,47,-4,36
FC Lugano,5021,7,10,5,17,30,48,-18,35
FC Thun,5021,8,8,6,18,41,64,-23,30
FC Sion,5021,9,7,8,17,41,54,-13,29
Young Boys,5022,1,21,7,4,67,33,34,70
FC Basel,5022,2,17,8,7,54,24,30,59
Lucerne,5022,3,13,7,12,43,45,-2,46
FC Zürich,5022,4,12,9,11,47,39,8,45
FC Lugano,5022,5,12,5,15,32,45,-13,41
St Gallen,5022,6,13,2,17,39,61,-22,41
FC Thun,5022,7,11,5,16,46,59,-13,38
Grasshoppers,5022,8,10,7,15,41,47,-6,37
FC Sion,5022,9,6,8,18,41,57,-16,26
Young Boys,5023,1,22,7,3,72,36,36,73
FC Basel,5023,2,18,9,5,57,25,32,63
Lucerne,5023,3,13,8,11,43,44,-1,47
FC Zürich,5023,4,11,11,10,43,36,7,44
St Gallen,5023,5,13,4,15,39,53,-14,43
Grasshoppers,5023,6,10,6,16,42,49,-7,36
FC Lugano,5023,7,9,6,17,28,50,-22,33
FC Sion,5023,8,7,9,16,42,54,-12,30
FC Thun,5023,9,8,6,18,42,61,-19,30
Young Boys,5024,1,22,7,3,72,35,37,73
FC Basel,5024,2,16,9,7,50,27,23,57
St Gallen,5024,3,15,3,14,45,54,-9,48
Lucerne,5024,4,13,8,11,42,44,-2,47
FC Zürich,5024,5,10,10,12,40,39,1,40
FC Thun,5024,6,11,5,16,47,55,-8,38
FC Lugano,5024,7,9,7,16,31,50,-19,34
Grasshoppers,5024,8,9,6,17,39,49,-10,33
FC Sion,5024,9,8,7,17,41,54,-13,31
Young Boys,5025,1,21,7,4,72,36,36,70
FC Basel,5025,2,18,7,7,56,26,30,61
St Gallen,5025,3,15,3,14,45,55,-10,48
Lucerne,5025,4,12,9,11,41,45,-4,45
FC Zürich,5025,5,11,9,12,41,39,2,42
FC Lugano,5025,6,10,6,16,35,50,-15,36
FC Thun,5025,7,10,5,17,47,63,-16,35
Grasshoppers,5025,8,9,7,16,41,51,-10,34
FC Sion,5025,9,8,7,17,41,54,-13,31
Young Boys,5026,1,21,7,4,73,37,36,70
FC Basel,5026,2,17,9,6,55,28,27,60
Lucerne,5026,3,13,10,9,42,41,1,49
St Gallen,5026,4,14,3,15,42,53,-11,45
FC Zürich,5026,5,10,11,11,39,34,5,41
FC Lugano,5026,6,11,6,15,30,45,-15,39
Grasshoppers,5026,7,9,8,15,42,51,-9,35
FC Thun,5026,8,9,6,17,43,60,-17,33
FC Sion,5026,9,6,8,18,38,55,-17,26
Young Boys,5027,1,22,7,3,73,36,37,73
FC Basel,5027,2,16,9,7,52,26,26,57
St Gallen,5027,3,14,3,15,44,57,-13,45
Lucerne,5027,4,12,8,12,45,49,-4,44
FC Zürich,5027,5,11,10,11,41,37,4,43
FC Lugano,5027,6,11,6,15,36,49,-13,39
FC Thun,5027,7,10,7,15,49,59,-10,37
Grasshoppers,5027,8,9,8,15,42,50,-8,35
FC Sion,5027,9,6,8,18,39,58,-19,26
Young Boys,5028,1,22,7,3,74,35,39,73
FC Basel,5028,2,18,8,6,54,27,27,62
St Gallen,5028,3,14,2,16,41,56,-15,44
Lucerne,5028,4,11,9,12,39,45,-6,42
FC Zürich,5028,5,10,10,12,41,41,0,40
FC Thun,5028,6,10,7,15,45,57,-12,37
FC Lugano,5028,7,10,6,16,34,50,-16,36
Grasshoppers,5028,8,9,8,15,41,49,-8,35
FC Sion,5028,9,7,9,16,46,55,-9,30
Young Boys,5029,1,23,6,3,73,33,40,75
FC Basel,5029,2,19,8,5,54,24,30,65
Lucerne,5029,3,14,7,11,43,44,-1,49
St Gallen,5029,4,14,3,15,45,56,-11,45
FC Zürich,5029,5,10,9,13,40,37,3,39
FC Thun,5029,6,10,5,17,46,62,-16,35
FC Lugano,5029,7,10,5,17,32,50,-18,35
Grasshoppers,5029,8,9,6,17,42,53,-11,33
FC Sion,5029,9,7,7,18,43,59,-16,28
Young Boys,5030,1,21,8,3,73,35,38,71
FC Basel,5030,2,19,8,5,55,23,32,65
St Gallen,5030,3,14,2,16,45,58,-13,44
Lucerne,5030,4,11,9,12,39,48,-9,42
FC Zürich,5030,5,10,10,12,41,36,5,40
Grasshoppers,5030,6,10,7,15,43,49,-6,37
FC Lugano,5030,7,10,7,15,30,47,-17,37
FC Thun,5030,8,10,5,17,44,57,-13,35
FC Sion,5030,9,7,8,17,39,56,-17,29
Young Boys,5031,1,22,7,3,73,36,37,73
FC Basel,5031,2,17,9,6,57,28,29,60
St Gallen,5031,3,15,3,14,42,52,-10,48
FC Zürich,5031,4,10,11,11,41,36,5,41
Lucerne,5031,5,11,8,13,40,49,-9,41
FC Lugano,5031,6,11,5,16,32,48,-16,38
Grasshoppers,5031,7,9,8,15,40,48,-8,35
FC Thun,5031,8,8,8,16,44,60,-16,32
FC Sion,5031,9,7,9,16,39,51,-12,30
Young Boys,5032,1,22,7,3,72,34,38,73
FC Basel,5032,2,18,9,5,55,24,31,63
St Gallen,5032,3,14,4,14,42,53,-11,46
Lucerne,5032,4,12,9,11,42,43,-1,45
FC Zürich,5032,5,11,11,10,41,34,7,44
FC Lugano,5032,6,10,5,17,30,50,-20,35
Grasshoppers,5032,7,8,9,15,41,52,-11,33
FC Thun,5032,8,8,6,18,43,66,-23,30
FC Sion,5032,9,7,8,17,43,53,-10,29
Young Boys,5033,1,22,6,4,74,37,37,72
FC Basel,5033,2,17,9,6,53,27,26,60
St Gallen,5033,3,15,3,14,44,54,-10,48
Lucerne,5033,4,12,8,12,47,46,1,44
FC Zürich,5033,5,11,10,11,45,35,10,43
Grasshoppers,5033,6,10,7,15,43,49,-6,37
FC Lugano,5033,7,10,5,17,29,55,-26,35
FC Thun,5033,8,9,6,17,41,62,-21,33
FC Sion,5033,9,6,10,16,42,53,-11,28
Young Boys,5034,1,22,6,4,72,36,36,72
FC Basel,5034,2,17,10,5,51,24,27,61
Lucerne,5034,3,12,10,10,42,43,-1,46
FC Zürich,5034,4,11,11,10,41,35,6,44
St Gallen,5034,5,13,5,14,40,55,-15,44
FC Lugano,5034,6,9,7,16,31,49,-18,34
FC Thun,5034,7,9,6,17,41,57,-16,33
Grasshoppers,5034,8,8,8,16,41,53,-12,32
FC Sion,5034,9,8,7,17,44,51,-7,31
Young Boys,5035,1,22,7,3,72,36,36,73
FC Basel,5035,2,17,8,7,54,29,25,59
Lucerne,5035,3,14,7,11,42,42,0,49
FC Zürich,5035,4,12,9,11,41,35,6,45
St Gallen,5035,5,14,3,15,48,59,-11,45
FC Thun,5035,6,10,7,15,42,55,-13,37
Grasshoppers,5035,7,9,8,15,43,49,-6,35
FC Lugano,5035,8,10,5,17,31,49,-18,35
FC Sion,5035,9,5,8,19,40,59,-19,23
Young Boys,5036,1,22,7,3,70,32,38,73
FC Basel,5036,2,17,8,7,52,28,24,59
FC Zürich,5036,3,12,9,11,45,36,9,45
Lucerne,5036,4,12,9,11,41,43,-2,45
St Gallen,5036,5,13,4,15,42,57,-15,43
FC Lugano,5036,6,11,5,16,32,48,-16,38
FC Thun,5036,7,10,5,17,49,60,-11,35
Grasshoppers,5036,8,8,8,16,40,56,-16,32
FC Sion,5036,9,8,7,17,42,53,-11,31
Young Boys,5037,1,22,7,3,74,38,36,73
FC Basel,5037,2,18,9,5,57,23,34,63
St Gallen,5037,3,15,3,14,44,54,-10,48
Lucerne,5037,4,11,10,11,39,44,-5,43
FC Zürich,5037,5,10,11,11,41,34,7,41
FC Lugano,5037,6,10,7,15,31,48,-17,37
Grasshoppers,5037,7,9,8,15,45,53,-8,35
FC Thun,5037,8,8,8,16,45,62,-17,32
FC Sion,5037,9,6,7,19,37,57,-20,25
Young Boys,5038,1,22,6,4,75,35,40,72
FC Basel,5038,2,17,7,8,55,31,24,58
St Gallen,5038,3,15,2,15,42,54,-12,47
Lucerne,5038,4,13,7,12,41,47,-6,46
FC Zürich,5038,5,10,12,10,42,35,7,42
FC Lugano,5038,6,11,6,15,31,45,-14,39
FC Thun,5038,7,9,7,16,44,62,-18,34
FC Sion,5038,8,7,10,15,45,55,-10,31
Grasshoppers,5038,9,8,7,17,41,52,-11,31
Young Boys,5039,1,21,8,3,72,35,37,71
FC Basel,5039,2,17,8,7,55,29,26,59
St Gallen,5039,3,15,3,14,45,53,-8,48
Lucerne,5039,4,13,7,12,42,49,-7,46
FC Zürich,5039,5,9,13,10,38,34,4,40
FC Lugano,5039,6,10,7,15,30,45,-15,37
FC Thun,5039,7,9,7,16,46,62,-16,34
Grasshoppers,5039,8,8,9,15,43,52,-9,33
FC Sion,5039,9,6,10,16,41,53,-12,28
Young Boys,5040,1,21,9,2,69,33,36,72
FC Basel,5040,2,16,8,8,50,28,22,56
Lucerne,5040,3,15,7,10,43,38,5,52
St Gallen,5040,4,14,2,16,42,54,-12,44
FC Zürich,5040,5,11,9,12,42,37,5,42
FC Thun,5040,6,11,5,16,42,56,-14,38
FC Lugano,5040,7,10,6,16,28,47,-19,36
Grasshoppers,5040,8,9,7,16,40,50,-10,34
FC Sion,5040,9,7,7,18,42,55,-13,28
Young Boys,5041,1,21,9,2,69,31,38,72
FC Basel,5041,2,16,8,8,48,26,22,56
Lucerne,5041,3,14,8,10,43,41,2,50
St Gallen,5041,4,16,2,14,44,54,-10,50
FC Zürich,5041,5,11,11,10,43,35,8,44
FC Lugano,5041,6,10,6,16,30,46,-16,36
Grasshoppers,5041,7,8,8,16,40,52,-12,32
FC Thun,5041,8,8,8,16,43,60,-17,32
FC Sion,5041,9,5,10,17,40,55,-15,25
Young Boys,5042,1,22,6,4,70,33,37,72
FC Basel,5042,2,18,7,7,54,25,29,61
Lucerne,5042,3,14,7,11,45,49,-4,49
St Gallen,5042,4,15,2,15,47,58,-11,47
FC Zürich,5042,5,11,10,11,38,34,4,43
FC Lugano,5042,6,10,6,16,31,47,-16,36
FC Thun,5042,7,10,5,17,42,57,-15,35
Grasshoppers,5042,8,9,6,17,41,53,-12,33
FC Sion,5042,9,7,7,18,42,54,-12,28
Young Boys,5043,1,21,7,4,71,38,33,70
FC Basel,5043,2,18,7,7,55,29,26,61
FC Zürich,5043,3,12,10,10,45,34,11,46
Lucerne,5043,4,12,9,11,43,46,-3,45
St Gallen,5043,5,13,3,16,41,57,-16,42
FC Thun,5043,6,10,7,15,44,57,-13,37
FC Lugano,5043,7,10,6,16,33,47,-14,36
Grasshoppers,5043,8,9,7,16,44,51,-7,34
FC Sion,5043,9,7,8,17,43,60,-17,29
Young Boys,5044,1,21,7,4,72,35,37,70
FC Basel,5044,2,18,7,7,55,27,28,61
St Gallen,5044,3,14,3,15,45,60,-15,45
Lucerne,5044,4,12,8,12,41,49,-8,44
FC Zürich,5044,5,10,12,10,42,37,5,42
FC Thun,5044,6,10,7,15,46,56,-10,37
FC Lugano,5044,7,10,7,15,36,48,-12,37
Grasshoppers,5044,8,8,9,15,39,50,-11,33
FC Sion,5044,9,6,10,16,43,57,-14,28
Young Boys,5045,1,21,6,5,68,36,32,69
FC Basel,5045,2,18,7,7,52,26,26,61
Lucerne,5045,3,13,8,11,48,46,2,47
St Gallen,5045,4,15,2,15,44,57,-13,47
FC Zürich,5045,5,11,9,12,42,38,4,42
FC Lugano,5045,6,12,6,14,35,46,-11,42
FC Thun,5045,7,10,5,17,46,61,-15,35
Grasshoppers,5045,8,9,6,17,41,51,-10,33
FC Sion,5045,9,7,7,18,42,57,-15,28
Young Boys,5046,1,21,8,3,69,33,36,71
FC Basel,5046,2,18,9,5,60,28,32,63
FC Zürich,5046,3,12,10,10,46,35,11,46
St Gallen,5046,4,14,4,14,47,57,-10,46
Lucerne,5046,5,12,8,12,41,47,-6,44
Grasshoppers,5046,6,10,7,15,42,46,-4,37
FC Lugano,5046,7,10,5,17,30,49,-19,35
FC Thun,5046,8,8,7,17,42,61,-19,31
FC Sion,5046,9,5,10,17,39,60,-21,25
Young Boys,5047,1,21,7,4,76,39,37,70
FC Basel,5047,2,18,9,5,57,28,29,63
Lucerne,5047,3,15,7,10,49,43,6,52
St Gallen,5047,4,14,2,16,44,55,-11,44
FC Zürich,5047,5,10,10,12,39,38,1,40
FC Thun,5047,6,10,5,17,45,59,-14,35
FC Sion,5047,7,9,7,16,41,52,-11,34
Grasshoppers,5047,8,9,6,17,40,50,-10,33
FC Lugano,5047,9,9,5,18,30,57,-27,32
Young Boys,5048,1,23,6,3,74,35,39,75
FC Basel,5048,2,17,8,7,55,29,26,59
St Gallen,5048,3,15,3,14,44,53,-9,48
FC Zürich,5048,4,10,11,11,42,37,5,41
Lucerne,5048,5,11,7,14,39,46,-7,40
Grasshoppers,5048,6,10,7,15,46,52,-6,37
FC Thun,5048,7,10,6,16,43,60,-17,36
FC Lugano,5048,8,10,6,16,33,50,-17,36
FC Sion,5048,9,6,10,16,41,55,-14,28
Young Boys,5049,1,22,6,4,69,33,36,72
FC Basel,5049,2,17,7,8,51,27,24,58
St Gallen,5049,3,15,3,14,45,54,-9,48
Lucerne,5049,4,13,7,12,41,45,-4,46
FC Zürich,5049,5,11,11,10,40,33,7,44
Grasshoppers,5049,6,11,6,15,42,47,-5,39
FC Thun,5049,7,9,7,16,41,57,-16,34
FC Lugano,5049,8,9,6,17,32,50,-18,33
FC Sion,5049,9,6,9,17,40,55,-15,27
Young Boys,5050,1,21,7,4,69,34,35,70
FC Basel,5050,2,16,8,8,53,30,23,56
Lucerne,5050,3,13,9,10,45,45,0,48
St Gallen,5050,4,14,3,15,42,56,-14,45
FC Lugano,5050,5,13,5,14,35,43,-8,44
FC Zürich,5050,6,11,9,12,45,41,4,42
Grasshoppers,5050,7,10,6,16,42,50,-8,36
FC Thun,5050,8,10,5,17,41,57,-16,35
FC Sion,5050,9,6,8,18,41,57,-16,26
Young Boys,5051,1,22,8,2,73,32,41,74
FC Basel,5051,2,18,8,6,58,27,31,62
Lucerne,5051,3,12,8,12,39,45,-6,44
St Gallen,5051,4,13,5,14,42,55,-13,44
FC Zürich,5051,5,10,10,12,40,37,3,40
FC Lugano,5051,6,11,7,14,32,44,-12,40
Grasshoppers,5051,7,10,6,16,44,49,-5,36
FC Thun,5051,8,10,5,17,45,61,-16,35
FC Sion,5051,9,5,9,18,38,61,-23,24
Young Boys,5052,1,21,7,4,69,35,34,70
FC Basel,5052,2,19,7,6,57,24,33,64
St Gallen,5052,3,16,2,14,43,53,-10,50
Lucerne,5052,4,13,7,12,43,47,-4,46
FC Zürich,5052,5,10,10,12,40,36,4,40
FC Lugano,5052,6,11,6,15,33,47,-14,39
FC Thun,5052,7,11,5,16,44,57,-13,38
Grasshoppers,5052,8,9,7,16,44,49,-5,34
FC Sion,5052,9,5,7,20,34,59,-25,22
Young Boys,5053,1,21,7,4,74,37,37,70
FC Basel,5053,2,20,7,5,59,23,36,67
Lucerne,5053,3,12,9,11,42,46,-4,45
St Gallen,5053,4,14,2,16,43,61,-18,44
FC Zürich,5053,5,10,9,13,39,36,3,39
FC Lugano,5053,6,11,6,15,32,47,-15,39
FC Thun,5053,7,10,5,17,43,58,-15,35
Grasshoppers,5053,8,9,7,16,40,51,-11,34
FC Sion,5053,9,7,8,17,40,53,-13,29
Young Boys,5054,1,22,6,4,73,37,36,72
FC Basel,5054,2,18,7,7,59,28,31,61
Lucerne,5054,3,14,7,11,43,44,-1,49
FC Zürich,5054,4,12,10,10,43,33,10,46
St Gallen,5054,5,14,3,15,43,56,-13,45
Grasshoppers,5054,6,10,6,16,40,49,-9,36
FC Lugano,5054,7,9,7,16,31,49,-18,34
FC Thun,5054,8,9,5,18,41,64,-23,32
FC Sion,5054,9,7,7,18,39,52,-13,28
Young Boys,5055,1,22,7,3,71,34,37,73
FC Basel,5055,2,17,9,6,56,27,29,60
Lucerne,5055,3,12,10,10,41,42,-1,46
FC Zürich,5055,4,11,11,10,43,36,7,44
St Gallen,5055,5,13,3,16,38,56,-18,42
FC Lugano,5055,6,10,6,16,31,48,-17,36
Grasshoppers,5055,7,9,7,16,42,53,-11,34
FC Thun,5055,8,8,8,16,45,61,-16,32
FC Sion,5055,9,7,9,16,43,53,-10,30
Young Boys,5056,1,24,6,2,76,33,43,78
FC Basel,5056,2,17,7,8,51,27,24,58
FC Zürich,5056,3,12,9,11,40,34,6,45
Lucerne,5056,4,12,9,11,40,44,-4,45
St Gallen,5056,5,14,2,16,40,56,-16,44
FC Lugano,5056,6,10,6,16,29,48,-19,36
Grasshoppers,5056,7,9,8,15,45,52,-7,35
FC Sion,5056,8,7,9,16,44,52,-8,30
FC Thun,5056,9,8,6,18,42,61,-19,30
Young Boys,5057,1,23,6,3,73,34,39,75
FC Basel,5057,2,16,10,6,51,26,25,58
Lucerne,5057,3,12,9,11,42,44,-2,45
St Gallen,5057,4,14,3,15,44,55,-11,45
FC Zürich,5057,5,11,10,11,45,36,9,43
FC Lugano,5057,6,10,7,15,33,49,-16,37
Grasshoppers,5057,7,10,6,16,42,52,-10,36
FC Thun,5057,8,9,6,17,44,62,-18,33
FC Sion,5057,9,7,7,18,43,59,-16,28
Young Boys,5058,1,21,7,4,69,37,32,70
FC Basel,5058,2,19,7,6,58,25,33,64
FC Zürich,5058,3,13,9,10,45,34,11,48
Lucerne,5058,4,12,8,12,41,47,-6,44
St Gallen,5058,5,14,2,16,40,55,-15,44
FC Lugano,5058,6,11,6,15,36,48,-12,39
Grasshoppers,5058,7,9,6,17,40,52,-12,33
FC Thun,5058,8,9,5,18,46,65,-19,32
FC Sion,5058,9,7,8,17,41,53,-12,29
Young Boys,5059,1,21,7,4,71,34,37,70
FC Basel,5059,2,18,9,5,57,27,30,63
Lucerne,5059,3,13,8,11,43,45,-2,47
St Gallen,5059,4,14,2,16,46,61,-15,44
FC Zürich,5059,5,10,10,12,41,39,2,40
FC Thun,5059,6,11,6,15,47,57,-10,39
FC Lugano,5059,7,10,5,17,30,50,-20,35
Grasshoppers,5059,8,9,7,16,44,52,-8,34
FC Sion,5059,9,7,8,17,43,57,-14,29
Young Boys,5060,1,21,7,4,71,39,32,70
FC Basel,5060,2,19,8,5,57,22,35,65
Lucerne,5060,3,14,7,11,42,42,0,49
St Gallen,5060,4,14,2,16,41,56,-15,44
FC Zürich,5060,5,11,10,11,40,34,6,43
Grasshoppers,5060,6,10,6,16,45,48,-3,36
FC Lugano,5060,7,10,5,17,29,50,-21,35
FC Thun,5060,8,9,5,18,41,60,-19,32
FC Sion,5060,9,7,8,17,39,54,-15,29
Young Boys,5061,1,21,6,5,71,38,33,69
FC Basel,5061,2,17,9,6,50,24,26,60
St Gallen,5061,3,15,3,14,47,55,-8,48
Lucerne,5061,4,12,9,11,39,44,-5,45
FC Zürich,5061,5,11,9,12,40,36,4,42
Grasshoppers,5061,6,10,8,14,43,48,-5,38
FC Lugano,5061,7,11,5,16,32,47,-15,38
FC Thun,5061,8,9,6,17,40,56,-16,33
FC Sion,5061,9,7,7,18,43,57,-14,28
Young Boys,5062,1,21,6,5,72,40,32,69
FC Basel,5062,2,19,7,6,57,27,30,64
St Gallen,5062,3,16,3,13,51,52,-1,51
FC Zürich,5062,4,12,9,11,41,37,4,45
Lucerne,5062,5,12,7,13,42,49,-7,43
Grasshoppers,5062,6,12,6,14,47,48,-1,42
FC Lugano,5062,7,10,6,16,33,49,-16,36
FC Thun,5062,8,8,6,18,41,59,-18,30
FC Sion,5062,9,5,8,19,38,61,-23,23
FC Basel,5063,1,20,7,5,60,23,37,67
Young Boys,5063,2,19,9,4,66,38,28,66
Lucerne,5063,3,12,10,10,41,43,-2,46
St Gallen,5063,4,14,3,15,44,57,-13,45
FC Zürich,5063,5,10,10,12,39,37,2,40
FC Lugano,5063,6,10,6,16,29,46,-17,36
Grasshoppers,5063,7,9,8,15,37,45,-8,35
FC Thun,5063,8,10,5,17,43,59,-16,35
FC Sion,5063,9,7,8,17,42,53,-11,29
Young Boys,5064,1,21,8,3,75,35,40,71
FC Basel,5064,2,19,8,5,54,23,31,65
Lucerne,5064,3,13,8,11,42,46,-4,47
St Gallen,5064,4,14,2,16,42,56,-14,44
FC Zürich,5064,5,10,10,12,42,37,5,40
FC Lugano,5064,6,10,7,15,33,48,-15,37
FC Thun,5064,7,10,5,17,44,59,-15,35
Grasshoppers,5064,8,9,7,16,42,53,-11,34
FC Sion,5064,9,7,7,18,38,55,-17,28
Young Boys,5065,1,21,7,4,70,36,34,70
FC Basel,5065,2,16,8,8,53,28,25,56
FC Zürich,5065,3,12,9,11,42,37,5,45
Lucerne,5065,4,12,9,11,42,46,-4,45
St Gallen,5065,5,13,6,13,42,53,-11,45
Grasshoppers,5065,6,11,6,15,43,49,-6,39
FC Thun,5065,7,11,5,16,46,58,-12,38
FC Lugano,5065,8,9,7,16,30,48,-18,34
FC Sion,5065,9,6,9,17,43,56,-13,27
Young Boys,5066,1,22,7,3,71,34,37,73
FC Basel,5066,2,18,8,6,56,24,32,62
St Gallen,5066,3,17,2,13,46,52,-6,53
Lucerne,5066,4,12,7,13,40,48,-8,43
FC Zürich,5066,5,10,10,12,41,37,4,40
Grasshoppers,5066,6,10,6,16,44,52,-8,36
FC Thun,5066,7,10,6,16,47,57,-10,36
FC Lugano,5066,8,9,7,16,29,47,-18,34
FC Sion,5066,9,6,7,19,40,63,-23,25
Young Boys,5067,1,23,6,3,79,37,42,75
FC Basel,5067,2,20,7,5,57,25,32,67
St Gallen,5067,3,15,2,15,43,54,-11,47
Lucerne,5067,4,11,8,13,42,48,-6,41
FC Lugano,5067,5,11,5,16,32,48,-16,38
FC Zürich,5067,6,9,9,14,37,40,-3,36
FC Thun,5067,7,10,6,16,42,56,-14,36
Grasshoppers,5067,8,8,8,16,41,51,-10,32
FC Sion,5067,9,8,7,17,40,54,-14,31
Young Boys,5068,1,23,6,3,75,35,40,75
FC Basel,5068,2,19,7,6,59,29,30,64
Lucerne,5068,3,12,7,13,40,47,-7,43
St Gallen,5068,4,13,3,16,44,58,-14,42
FC Zürich,5068,5,10,10,12,40,37,3,40
FC Lugano,5068,6,11,6,15,30,44,-14,39
FC Thun,5068,7,11,5,16,46,60,-14,38
Grasshoppers,5068,8,10,6,16,47,55,-8,36
FC Sion,5068,9,6,8,18,42,58,-16,26
Young Boys,5069,1,21,7,4,70,35,35,70
FC Basel,5069,2,19,7,6,61,27,34,64
Lucerne,5069,3,13,9,10,43,42,1,48
St Gallen,5069,4,14,2,16,43,60,-17,44
FC Zürich,5069,5,11,10,11,42,34,8,43
Grasshoppers,5069,6,10,7,15,40,49,-9,37
FC Lugano,5069,7,9,6,17,30,50,-20,33
FC Thun,5069,8,8,7,17,39,60,-21,31
FC Sion,5069,9,7,9,16,43,54,-11,30
Young Boys,5070,1,22,7,3,75,36,39,73
FC Basel,5070,2,16,8,8,51,30,21,56
St Gallen,5070,3,15,2,15,42,53,-11,47
Lucerne,5070,4,11,10,11,41,44,-3,43
FC Lugano,5070,5,12,5,15,34,47,-13,41
FC Zürich,5070,6,10,10,12,39,36,3,40
Grasshoppers,5070,7,11,7,14,41,46,-5,40
FC Thun,5070,8,10,6,16,47,57,-10,36
FC Sion,5070,9,6,7,19,37,58,-21,25
Young Boys,5071,1,22,6,4,73,36,37,72
FC Basel,5071,2,18,8,6,56,23,33,62
Lucerne,5071,3,14,7,11,43,45,-2,49
FC Zürich,5071,4,12,9,11,42,39,3,45
St Gallen,5071,5,13,2,17,39,58,-19,41
Grasshoppers,5071,6,10,7,15,45,48,-3,37
FC Lugano,5071,7,10,5,17,31,50,-19,35
FC Thun,5071,8,9,7,16,44,58,-14,34
FC Sion,5071,9,7,7,18,40,56,-16,28
Young Boys,5072,1,20,7,5,68,38,30,67
FC Basel,5072,2,18,9,5,55,24,31,63
St Gallen,5072,3,15,4,13,44,52,-8,49
Lucerne,5072,4,12,8,12,44,49,-5,44
FC Zürich,5072,5,10,11,11,41,37,4,41
Grasshoppers,5072,6,11,6,15,43,47,-4,39
FC Lugano,5072,7,10,7,15,35,49,-14,37
FC Thun,5072,8,9,6,17,44,59,-15,33
FC Sion,5072,9,6,8,18,37,56,-19,26
Young Boys,5073,1,19,9,4,69,40,29,66
FC Basel,5073,2,17,9,6,52,26,26,60
Lucerne,5073,3,15,7,10,49,43,6,52
St Gallen,5073,4,13,4,15,40,55,-15,43
FC Zürich,5073,5,9,11,12,40,38,2,38
FC Lugano,5073,6,10,8,14,31,43,-12,38
Grasshoppers,5073,7,10,6,16,42,52,-10,36
FC Thun,5073,8,10,6,16,47,59,-12,36
FC Sion,5073,9,7,8,17,40,54,-14,29
Young Boys,5074,1,22,7,3,73,35,38,73
FC Basel,5074,2,17,7,8,53,30,23,58
FC Zürich,5074,3,12,10,10,44,34,10,46
St Gallen,5074,4,14,3,15,42,57,-15,45
Lucerne,5074,5,11,10,11,42,45,-3,43
Grasshoppers,5074,6,11,7,14,44,48,-4,40
FC Lugano,5074,7,10,7,15,32,48,-16,37
FC Thun,5074,8,9,5,18,45,62,-17,32
FC Sion,5074,9,6,8,18,40,56,-16,26
Young Boys,5075,1,21,7,4,69,33,36,70
FC Basel,5075,2,17,9,6,51,25,26,60
FC Zürich,5075,3,13,9,10,45,34,11,48
Lucerne,5075,4,13,8,11,43,44,-1,47
St Gallen,5075,5,14,4,14,42,54,-12,46
FC Lugano,5075,6,11,5,16,32,47,-15,38
Grasshoppers,5075,7,9,7,16,43,48,-5,34
FC Thun,5075,8,9,5,18,41,59,-18,32
FC Sion,5075,9,6,8,18,37,59,-22,26
Young Boys,5076,1,22,7,3,72,34,38,73
FC Basel,5076,2,17,9,6,54,26,28,60
Lucerne,5076,3,12,10,10,41,41,0,46
St Gallen,5076,4,14,4,14,45,56,-11,46
FC Zürich,5076,5,9,11,12,42,41,1,38
FC Thun,5076,6,11,5,16,46,60,-14,38
Grasshoppers,5076,7,9,7,16,42,50,-8,34
FC Lugano,5076,8,9,7,16,30,50,-20,34
FC Sion,5076,9,7,8,17,43,57,-14,29
Young Boys,5077,1,22,6,4,75,39,36,72
FC Basel,5077,2,17,9,6,55,28,27,60
Lucerne,5077,3,14,9,9,49,46,3,51
FC Zürich,5077,4,11,11,10,38,32,6,44
St Gallen,5077,5,13,3,16,43,58,-15,42
Grasshoppers,5077,6,10,7,15,44,50,-6,37
FC Lugano,5077,7,10,7,15,31,47,-16,37
FC Thun,5077,8,9,6,17,42,58,-16,33
FC Sion,5077,9,5,8,19,36,55,-19,23
Young Boys,5078,1,21,7,4,69,35,34,70
FC Basel,5078,2,19,8,5,56,22,34,65
Lucerne,5078,3,14,8,10,44,43,1,50
FC Zürich,5078,4,12,10,10,42,35,7,46
St Gallen,5078,5,13,3,16,40,55,-15,42
FC Lugano,5078,6,10,5,17,29,48,-19,35
Grasshoppers,5078,7,9,6,17,41,55,-14,33
FC Sion,5078,8,8,8,16,46,54,-8,32
FC Thun,5078,9,8,5,19,39,59,-20,29
Young Boys,5079,1,22,8,2,74,33,41,74
FC Basel,5079,2,16,8,8,52,28,24,56
St Gallen,5079,3,15,2,15,42,56,-14,47
FC Zürich,5079,4,12,10,10,40,32,8,46
Lucerne,5079,5,11,8,13,42,48,-6,41
Grasshoppers,5079,6,10,7,15,39,46,-7,37
FC Lugano,5079,7,10,6,16,32,51,-19,36
FC Thun,5079,8,10,5,17,42,56,-14,35
FC Sion,5079,9,6,10,16,38,51,-13,28
Young Boys,5080,1,21,8,3,74,38,36,71
FC Basel,5080,2,18,9,5,56,23,33,63
St Gallen,5080,3,15,2,15,42,56,-14,47
Lucerne,5080,4,12,8,12,41,47,-6,44
FC Lugano,5080,5,12,5,15,35,45,-10,41
FC Zürich,5080,6,9,10,13,37,36,1,37
FC Thun,5080,7,10,6,16,44,60,-16,36
Grasshoppers,5080,8,8,7,17,44,56,-12,31
FC Sion,5080,9,7,9,16,43,55,-12,30
Young Boys,5081,1,21,7,4,71,38,33,70
FC Basel,5081,2,18,8,6,52,25,27,62
Lucerne,5081,3,13,9,10,41,39,2,48
FC Zürich,5081,4,12,9,11,41,35,6,45
St Gallen,5081,5,14,3,15,42,56,-14,45
Grasshoppers,5081,6,10,7,15,41,48,-7,37
FC Lugano,5081,7,10,5,17,32,48,-16,35
FC Thun,5081,8,8,6,18,41,60,-19,30
FC Sion,5081,9,7,8,17,43,55,-12,29
Young Boys,5082,1,20,7,5,73,37,36,67
FC Basel,5082,2,20,7,5,60,26,34,67
Lucerne,5082,3,13,9,10,40,40,0,48
St Gallen,5082,4,15,2,15,43,54,-11,47
FC Zürich,5082,5,10,10,12,41,40,1,40
Grasshoppers,5082,6,10,8,14,43,46,-3,38
FC Thun,5082,7,9,6,17,41,58,-17,33
FC Lugano,5082,8,9,6,17,30,54,-24,33
FC Sion,5082,9,7,7,18,40,56,-16,28
Young Boys,5083,1,23,7,2,78,32,46,76
FC Basel,5083,2,17,9,6,49,24,25,60
Lucerne,5083,3,13,7,12,44,49,-5,46
FC Zürich,5083,4,11,11,10,41,35,6,44
St Gallen,5083,5,13,2,17,41,59,-18,41
Grasshoppers,5083,6,10,6,16,41,53,-12,36
FC Lugano,5083,7,10,6,16,31,47,-16,36
FC Thun,5083,8,9,7,16,43,57,-14,34
FC Sion,5083,9,7,7,18,42,54,-12,28
Young Boys,5084,1,21,7,4,70,41,29,70
FC Basel,5084,2,18,9,5,57,24,33,63
Lucerne,5084,3,12,10,10,42,43,-1,46
St Gallen,5084,4,14,2,16,40,56,-16,44
FC Zürich,5084,5,11,10,11,41,36,5,43
FC Lugano,5084,6,10,7,15,29,44,-15,37
Grasshoppers,5084,7,9,7,16,40,48,-8,34
FC Thun,5084,8,9,5,18,41,58,-17,32
FC Sion,5084,9,8,7,17,43,53,-10,31
Young Boys,5085,1,23,7,2,75,34,41,76
FC Basel,5085,2,17,8,7,53,26,27,59
Lucerne,5085,3,14,7,11,42,44,-2,49
St Gallen,5085,4,14,3,15,42,54,-12,45
FC Zürich,5085,5,11,10,11,41,33,8,43
FC Thun,5085,6,11,5,16,45,55,-10,38
FC Lugano,5085,7,10,5,17,28,47,-19,35
Grasshoppers,5085,8,8,7,17,38,51,-13,31
FC Sion,5085,9,6,8,18,39,59,-20,26
Young Boys,5086,1,22,7,3,74,38,36,73
FC Basel,5086,2,16,9,7,50,26,24,57
Lucerne,5086,3,15,7,10,48,42,6,52
St Gallen,5086,4,14,4,14,41,52,-11,46
FC Thun,5086,5,12,5,15,46,54,-8,41
FC Zürich,5086,6,10,10,12,42,41,1,40
FC Lugano,5086,7,10,6,16,31,51,-20,36
Grasshoppers,5086,8,8,6,18,37,49,-12,30
FC Sion,5086,9,6,8,18,39,55,-16,26
Young Boys,5087,1,20,8,4,70,40,30,68
FC Basel,5087,2,19,8,5,62,23,39,65
Lucerne,5087,3,14,7,11,44,45,-1,49
St Gallen,5087,4,15,3,14,42,52,-10,48
FC Zürich,5087,5,9,11,12,37,36,1,38
Grasshoppers,5087,6,10,7,15,41,48,-7,37
FC Lugano,5087,7,10,5,17,31,49,-18,35
FC Thun,5087,8,10,5,17,41,60,-19,35
FC Sion,5087,9,5,10,17,38,53,-15,25
Young Boys,5088,1,21,7,4,76,39,37,70
FC Basel,5088,2,16,9,7,50,28,22,57
St Gallen,5088,3,14,5,13,42,52,-10,47
Lucerne,5088,4,13,7,12,42,47,-5,46
FC Zürich,5088,5,10,10,12,43,37,6,40
Grasshoppers,5088,6,11,6,15,46,52,-6,39
FC Thun,5088,7,10,6,16,42,57,-15,36
FC Lugano,5088,8,9,7,16,31,49,-18,34
FC Sion,5088,9,7,9,16,45,56,-11,30
Young Boys,5089,1,22,8,2,77,36,41,74
FC Basel,5089,2,19,8,5,58,24,34,65
St Gallen,5089,3,14,3,15,42,56,-14,45
Lucerne,5089,4,12,7,13,43,47,-4,43
FC Zürich,5089,5,11,9,12,38,36,2,42
Grasshoppers,5089,6,10,7,15,45,53,-8,37
FC Lugano,5089,7,10,6,16,31,47,-16,36
FC Thun,5089,8,10,5,17,45,59,-14,35
FC Sion,5089,9,6,7,19,39,60,-21,25
Young Boys,5090,1,22,7,3,73,35,38,73
FC Basel,5090,2,19,7,6,57,23,34,64
Lucerne,5090,3,13,8,11,40,41,-1,47
FC Zürich,5090,4,10,12,10,38,33,5,42
St Gallen,5090,5,13,3,16,42,60,-18,42
FC Thun,5090,6,10,6,16,44,59,-15,36
Grasshoppers,5090,7,9,7,16,44,55,-11,34
FC Lugano,5090,8,9,7,16,29,49,-20,34
FC Sion,5090,9,6,9,17,44,56,-12,27
Young Boys,5091,1,22,7,3,69,35,34,73
FC Basel,5091,2,17,8,7,52,26,26,59
St Gallen,5091,3,15,4,13,46,54,-8,49
Lucerne,5091,4,13,8,11,44,44,0,47
FC Zürich,5091,5,11,10,11,43,37,6,43
Grasshoppers,5091,6,9,8,15,42,48,-6,35
FC Lugano,5091,7,10,5,17,31,48,-17,35
FC Thun,5091,8,8,8,16,42,60,-18,32
FC Sion,5091,9,5,10,17,41,58,-17,25
Young Boys,5092,1,23,7,2,77,34,43,76
FC Basel,5092,2,17,9,6,52,26,26,60
St Gallen,5092,3,15,3,14,44,53,-9,48
FC Zürich,5092,4,12,10,10,46,35,11,46
Lucerne,5092,5,11,8,13,38,45,-7,41
FC Lugano,5092,6,10,7,15,32,47,-15,37
Grasshoppers,5092,7,9,8,15,38,49,-11,35
FC Thun,5092,8,9,7,16,42,59,-17,34
FC Sion,5092,9,5,7,20,37,58,-21,22
Young Boys,5093,1,23,7,2,72,32,40,76
FC Basel,5093,2,18,9,5,53,25,28,63
St Gallen,5093,3,15,2,15,42,52,-10,47
FC Zürich,5093,4,11,9,12,43,37,6,42
Lucerne,5093,5,11,9,12,41,47,-6,42
FC Lugano,5093,6,12,5,15,35,46,-11,41
Grasshoppers,5093,7,10,7,15,41,48,-7,37
FC Thun,5093,8,8,5,19,41,63,-22,29
FC Sion,5093,9,6,7,19,38,56,-18,25
Young Boys,5094,1,22,6,4,75,39,36,72
FC Basel,5094,2,18,7,7,56,33,23,61
St Gallen,5094,3,16,2,14,46,51,-5,50
Lucerne,5094,4,14,7,11,50,44,6,49
FC Zürich,5094,5,9,10,13,40,41,-1,37
Grasshoppers,5094,6,10,7,15,43,52,-9,37
FC Lugano,5094,7,10,5,17,32,50,-18,35
FC Thun,5094,8,9,7,16,45,61,-16,34
FC Sion,5094,9,7,7,18,39,55,-16,28
Young Boys,5095,1,21,7,4,69,38,31,70
FC Basel,5095,2,18,7,7,55,28,27,61
St Gallen,5095,3,15,3,14,48,54,-6,48
Lucerne,5095,4,12,8,12,42,49,-7,44
FC Zürich,5095,5,11,10,11,41,34,7,43
Grasshoppers,5095,6,10,6,16,41,49,-8,36
FC Lugano,5095,7,10,6,16,33,49,-16,36
FC Sion,5095,8,8,8,16,41,49,-8,32
FC Thun,5095,9,9,5,18,40,60,-20,32
Young Boys,5096,1,21,7,4,71,36,35,70
FC Basel,5096,2,19,7,6,55,25,30,64
Lucerne,5096,3,14,7,11,43,43,0,49
St Gallen,5096,4,13,3,16,43,58,-15,42
FC Zürich,5096,5,10,10,12,40,38,2,40
FC Lugano,5096,6,11,5,16,33,49,-16,38
FC Thun,5096,7,9,7,16,46,61,-15,34
FC Sion,5096,8,8,9,15,45,54,-9,33
Grasshoppers,5096,9,8,7,17,40,52,-12,31
Young Boys,5097,1,21,8,3,76,37,39,71
FC Basel,5097,2,17,9,6,52,24,28,60
St Gallen,5097,3,15,3,14,45,52,-7,48
Lucerne,5097,4,12,8,12,42,47,-5,44
FC Zürich,5097,5,11,9,12,40,37,3,42
Grasshoppers,5097,6,10,8,14,42,48,-6,38
FC Lugano,5097,7,10,5,17,31,53,-22,35
FC Thun,5097,8,9,6,17,42,59,-17,33
FC Sion,5097,9,7,8,17,45,58,-13,29
Young Boys,5098,1,21,7,4,70,38,32,70
FC Basel,5098,2,19,8,5,53,21,32,65
St Gallen,5098,3,15,2,15,41,53,-12,47
Lucerne,5098,4,11,9,12,42,46,-4,42
FC Zürich,5098,5,10,11,11,37,35,2,41
Grasshoppers,5098,6,9,9,14,41,48,-7,36
FC Lugano,5098,7,10,6,16,29,45,-16,36
FC Thun,5098,8,9,7,16,43,56,-13,34
FC Sion,5098,9,6,9,17,38,52,-14,27
Young Boys,5099,1,21,8,3,75,37,38,71
FC Basel,5099,2,20,7,5,56,25,31,67
St Gallen,5099,3,15,3,14,46,54,-8,48
Lucerne,5099,4,13,8,11,48,47,1,47
FC Zürich,5099,5,9,12,11,41,38,3,39
Grasshoppers,5099,6,8,9,15,39,50,-11,33
FC Lugano,5099,7,9,6,17,31,54,-23,33
FC Thun,5099,8,8,8,16,41,58,-17,32
FC Sion,5099,9,5,11,16,40,54,-14,26
Young Boys,5100,1,23,6,3,74,34,40,75
FC Basel,5100,2,17,8,7,51,27,24,59
St Gallen,5100,3,15,4,13,46,52,-6,49
FC Zürich,5100,4,11,11,10,41,34,7,44
Lucerne,5100,5,12,7,13,39,46,-7,43
Grasshoppers,5100,6,11,7,14,42,45,-3,40
FC Thun,5100,7,9,6,17,39,57,-18,33
FC Lugano,5100,8,9,6,17,31,49,-18,33
FC Sion,5100,9,5,9,18,38,57,-19,24
Young Boys,5101,1,22,8,2,72,35,37,74
FC Basel,5101,2,17,10,5,52,23,29,61
St Gallen,5101,3,15,4,13,44,52,-8,49
Lucerne,5101,4,12,8,12,44,44,0,44
FC Zürich,5101,5,10,12,10,44,38,6,42
FC Lugano,5101,6,9,9,14,31,46,-15,36
Grasshoppers,5101,7,9,7,16,40,51,-11,34
FC Thun,5101,8,8,7,17,43,63,-20,31
FC Sion,5101,9,6,7,19,40,58,-18,25
Young Boys,5102,1,21,8,3,73,37,36,71
FC Basel,5102,2,16,9,7,52,30,22,57
St Gallen,5102,3,14,4,14,43,53,-10,46
Lucerne,5102,4,12,8,12,41,43,-2,44
Grasshoppers,5102,5,11,7,14,44,47,-3,40
FC Zürich,5102,6,10,9,13,38,39,-1,39
FC Lugano,5102,7,11,6,15,35,47,-12,39
FC Thun,5102,8,9,6,17,43,59,-16,33
FC Sion,5102,9,7,9,16,40,54,-14,30
Young Boys,5103,1,23,7,2,75,34,41,76
FC Basel,5103,2,16,8,8,50,28,22,56
St Gallen,5103,3,16,2,14,43,51,-8,50
FC Zürich,5103,4,13,9,10,44,32,12,48
Lucerne,5103,5,13,7,12,42,44,-2,46
Grasshoppers,5103,6,10,6,16,41,50,-9,36
FC Lugano,5103,7,10,5,17,30,49,-19,35
FC Thun,5103,8,8,7,17,41,59,-18,31
FC Sion,5103,9,5,9,18,38,57,-19,24
Young Boys,5104,1,20,8,4,68,37,31,68
FC Basel,5104,2,19,7,6,53,24,29,64
St Gallen,5104,3,15,2,15,42,51,-9,47
Lucerne,5104,4,12,9,11,44,46,-2,45
FC Zürich,5104,5,11,10,11,41,34,7,43
FC Thun,5104,6,11,6,15,46,58,-12,39
Grasshoppers,5104,7,8,9,15,40,49,-9,33
FC Lugano,5104,8,9,6,17,29,49,-20,33
FC Sion,5104,9,6,9,17,41,56,-15,27
Young Boys,5105,1,19,8,5,67,37,30,65
FC Basel,5105,2,18,9,5,54,24,30,63
Lucerne,5105,3,13,8,11,44,45,-1,47
St Gallen,5105,4,14,4,14,44,55,-11,46
FC Zürich,5105,5,11,11,10,46,35,11,44
Grasshoppers,5105,6,10,7,15,45,51,-6,37
FC Lugano,5105,7,9,7,16,30,52,-22,34
FC Thun,5105,8,9,6,17,44,62,-18,33
FC Sion,5105,9,6,10,16,41,54,-13,28
Young Boys,5106,1,20,9,3,70,35,35,69
FC Basel,5106,2,16,11,5,55,27,28,59
St Gallen,5106,3,15,4,13,45,54,-9,49
FC Zürich,5106,4,12,9,11,42,37,5,45
Lucerne,5106,5,11,11,10,43,45,-2,44
Grasshoppers,5106,6,9,9,14,40,47,-7,36
FC Lugano,5106,7,9,7,16,31,49,-18,34
FC Thun,5106,8,8,7,17,39,57,-18,31
FC Sion,5106,9,6,9,17,42,56,-14,27
Young Boys,5107,1,22,8,2,75,35,40,74
FC Basel,5107,2,17,9,6,56,28,28,60
Lucerne,5107,3,13,7,12,42,45,-3,46
St Gallen,5107,4,14,4,14,45,57,-12,46
FC Zürich,5107,5,11,9,12,42,41,1,42
FC Thun,5107,6,10,7,15,44,55,-11,37
Grasshoppers,5107,7,9,8,15,40,46,-6,35
FC Lugano,5107,8,9,6,17,30,49,-19,33
FC Sion,5107,9,6,8,18,41,59,-18,26
Young Boys,5108,1,22,7,3,76,38,38,73
FC Basel,5108,2,16,11,5,55,29,26,59
FC Zürich,5108,3,11,10,11,42,39,3,43
St Gallen,5108,4,13,4,15,44,60,-16,43
Lucerne,5108,5,11,9,12,42,49,-7,42
Grasshoppers,5108,6,11,6,15,45,48,-3,39
FC Lugano,5108,7,10,6,16,34,51,-17,36
FC Thun,5108,8,9,6,17,46,65,-19,33
FC Sion,5108,9,8,7,17,48,53,-5,31
Young Boys,5109,1,21,7,4,71,36,35,70
FC Basel,5109,2,17,8,7,50,24,26,59
Lucerne,5109,3,13,10,9,42,41,1,49
St Gallen,5109,4,14,2,16,41,54,-13,44
FC Zürich,5109,5,10,11,11,41,35,6,41
FC Lugano,5109,6,10,7,15,32,49,-17,37
FC Thun,5109,7,10,6,16,47,58,-11,36
Grasshoppers,5109,8,8,8,16,40,50,-10,32
FC Sion,5109,9,8,7,17,46,63,-17,31
Young Boys,5110,1,23,6,3,73,30,43,75
FC Basel,5110,2,17,8,7,51,26,25,59
St Gallen,5110,3,14,4,14,42,53,-11,46
Lucerne,5110,4,12,8,12,44,48,-4,44
FC Zürich,5110,5,11,10,11,42,34,8,43
Grasshoppers,5110,6,11,6,15,42,49,-7,39
FC Thun,5110,7,10,5,17,41,57,-16,35
FC Lugano,5110,8,9,8,15,32,50,-18,35
FC Sion,5110,9,6,7,19,38,58,-20,25
Young Boys,5111,1,20,8,4,73,39,34,68
FC Basel,5111,2,20,7,5,61,23,38,67
Lucerne,5111,3,13,8,11,46,47,-1,47
St Gallen,5111,4,15,2,15,45,58,-13,47
FC Zürich,5111,5,10,9,13,42,38,4,39
FC Lugano,5111,6,11,5,16,35,53,-18,38
FC Thun,5111,7,10,6,16,43,59,-16,36
Grasshoppers,5111,8,9,8,15,40,47,-7,35
FC Sion,5111,9,5,9,18,38,59,-21,24
Young Boys,5112,1,22,6,4,73,36,37,72
FC Basel,5112,2,18,8,6,57,29,28,62
St Gallen,5112,3,15,3,14,45,52,-7,48
Lucerne,5112,4,13,8,11,43,43,0,47
FC Zürich,5112,5,11,10,11,42,37,5,43
Grasshoppers,5112,6,10,8,14,43,49,-6,38
FC Lugano,5112,7,10,6,16,29,46,-17,36
FC Thun,5112,8,8,6,18,42,63,-21,30
FC Sion,5112,9,6,7,19,38,57,-19,25
Young Boys,5113,1,21,7,4,69,34,35,70
FC Basel,5113,2,20,7,5,59,22,37,67
Lucerne,5113,3,14,7,11,42,43,-1,49
St Gallen,5113,4,14,2,16,43,57,-14,44
FC Zürich,5113,5,10,11,11,38,37,1,41
FC Lugano,5113,6,10,6,16,30,46,-16,36
Grasshoppers,5113,7,8,8,16,39,50,-11,32
FC Thun,5113,8,8,7,17,43,60,-17,31
FC Sion,5113,9,7,9,16,42,56,-14,30
Young Boys,5114,1,20,7,5,64,35,29,67
FC Basel,5114,2,16,10,6,52,26,26,58
Lucerne,5114,3,13,8,11,43,45,-2,47
St Gallen,5114,4,14,4,14,44,56,-12,46
FC Lugano,5114,5,12,5,15,37,48,-11,41
FC Zürich,5114,6,9,11,12,42,40,2,38
FC Thun,5114,7,11,5,16,45,57,-12,38
Grasshoppers,5114,8,9,7,16,41,52,-11,34
FC Sion,5114,9,7,9,16,41,50,-9,30
Young Boys,5115,1,22,7,3,72,34,38,73
FC Basel,5115,2,18,9,5,54,23,31,63
FC Zürich,5115,3,11,11,10,41,35,6,44
St Gallen,5115,4,14,2,16,43,60,-17,44
Lucerne,5115,5,12,7,13,45,48,-3,43
Grasshoppers,5115,6,11,7,14,43,46,-3,40
FC Lugano,5115,7,10,6,16,30,52,-22,36
FC Thun,5115,8,9,6,17,42,59,-17,33
FC Sion,5115,9,6,7,19,45,58,-13,25
Young Boys,5116,1,21,7,4,72,36,36,70
FC Basel,5116,2,17,8,7,53,28,25,59
Lucerne,5116,3,13,8,11,41,43,-2,47
St Gallen,5116,4,15,2,15,45,54,-9,47
FC Zürich,5116,5,12,10,10,44,36,8,46
Grasshoppers,5116,6,10,7,15,41,50,-9,37
FC Sion,5116,7,8,8,16,44,51,-7,32
FC Lugano,5116,8,9,5,18,27,51,-24,32
FC Thun,5116,9,8,7,17,43,61,-18,31
Young Boys,5117,1,21,7,4,69,34,35,70
FC Basel,5117,2,19,8,5,55,25,30,65
St Gallen,5117,3,16,2,14,49,54,-5,50
Lucerne,5117,4,13,8,11,45,47,-2,47
FC Zürich,5117,5,9,10,13,39,38,1,37
FC Thun,5117,6,10,5,17,43,59,-16,35
FC Lugano,5117,7,10,5,17,30,49,-19,35
Grasshoppers,5117,8,9,7,16,42,52,-10,34
FC Sion,5117,9,7,8,17,43,57,-14,29
Young Boys,5118,1,22,8,2,71,34,37,74
FC Basel,5118,2,16,9,7,52,28,24,57
Lucerne,5118,3,14,7,11,40,39,1,49
St Gallen,5118,4,14,4,14,44,55,-11,46
FC Zürich,5118,5,11,9,12,41,36,5,42
FC Thun,5118,6,10,6,16,46,57,-11,36
FC Lugano,5118,7,10,5,17,30,48,-18,35
Grasshoppers,5118,8,9,7,16,41,52,-11,34
FC Sion,5118,9,6,9,17,41,57,-16,27
Young Boys,5119,1,20,7,5,72,37,35,67
FC Basel,5119,2,19,8,5,58,27,31,65
Lucerne,5119,3,13,9,10,42,42,0,48
St Gallen,5119,4,14,4,14,41,52,-11,46
FC Zürich,5119,5,10,12,10,43,38,5,42
Grasshoppers,5119,6,10,7,15,41,48,-7,37
FC Thun,5119,7,9,7,16,41,56,-15,34
FC Lugano,5119,8,9,6,17,31,53,-22,33
FC Sion,5119,9,5,10,17,39,55,-16,25
Young Boys,5120,1,21,6,5,68,36,32,69
FC Basel,5120,2,19,7,6,55,26,29,64
Lucerne,5120,3,13,8,11,42,43,-1,47
FC Zürich,5120,4,10,11,11,42,38,4,41
St Gallen,5120,5,13,2,17,39,56,-17,41
FC Lugano,5120,6,11,7,14,32,45,-13,40
Grasshoppers,5120,7,10,6,16,39,49,-10,36
FC Thun,5120,8,9,7,16,44,56,-12,34
FC Sion,5120,9,7,8,17,38,50,-12,29
Young Boys,5121,1,21,7,4,74,38,36,70
FC Basel,5121,2,19,7,6,58,28,30,64
Lucerne,5121,3,12,8,12,43,50,-7,44
St Gallen,5121,4,13,4,15,41,56,-15,43
FC Zürich,5121,5,10,11,11,43,37,6,41
FC Lugano,5121,6,11,7,14,36,47,-11,40
FC Thun,5121,7,11,5,16,47,59,-12,38
Grasshoppers,5121,8,9,6,17,40,54,-14,33
FC Sion,5121,9,6,9,17,46,59,-13,27
Young Boys,5122,1,22,8,2,74,34,40,74
FC Basel,5122,2,19,8,5,56,27,29,65
Lucerne,5122,3,13,7,12,46,47,-1,46
FC Zürich,5122,4,12,9,11,44,36,8,45
St Gallen,5122,5,14,2,16,44,57,-13,44
Grasshoppers,5122,6,10,7,15,41,47,-6,37
FC Lugano,5122,7,9,6,17,30,50,-20,33
FC Thun,5122,8,9,5,18,41,62,-21,32
FC Sion,5122,9,6,8,18,38,54,-16,26
Young Boys,5123,1,22,6,4,74,37,37,72
FC Basel,5123,2,18,8,6,53,28,25,62
Lucerne,5123,3,14,8,10,46,43,3,50
St Gallen,5123,4,13,5,14,43,55,-12,44
FC Zürich,5123,5,10,12,10,41,35,6,42
FC Thun,5123,6,10,6,16,44,56,-12,36
FC Lugano,5123,7,9,7,16,30,48,-18,34
Grasshoppers,5123,8,9,6,17,39,51,-12,33
FC Sion,5123,9,6,8,18,38,55,-17,26
Young Boys,5124,1,23,6,3,75,34,41,75
FC Basel,5124,2,17,8,7,53,26,27,59
St Gallen,5124,3,14,4,14,43,55,-12,46
FC Zürich,5124,4,11,10,11,40,35,5,43
Lucerne,5124,5,11,10,11,40,46,-6,43
FC Lugano,5124,6,10,7,15,31,49,-18,37
Grasshoppers,5124,7,9,8,15,44,52,-8,35
FC Thun,5124,8,9,7,16,45,61,-16,34
FC Sion,5124,9,6,8,18,37,50,-13,26
Young Boys,5125,1,21,7,4,71,36,35,70
FC Basel,5125,2,18,8,6,59,28,31,62
St Gallen,5125,3,15,3,14,46,56,-10,48
Lucerne,5125,4,13,8,11,41,46,-5,47
FC Zürich,5125,5,11,11,10,43,36,7,44
FC Thun,5125,6,11,5,16,47,59,-12,38
FC Lugano,5125,7,9,7,16,31,51,-20,34
Grasshoppers,5125,8,9,6,17,43,52,-9,33
FC Sion,5125,9,6,7,19,43,60,-17,25
Young Boys,5126,1,20,8,4,67,35,32,68
FC Basel,5126,2,18,9,5,55,23,32,63
St Gallen,5126,3,14,4,14,45,54,-9,46
Lucerne,5126,4,11,9,12,39,47,-8,42
FC Zürich,5126,5,10,10,12,39,37,2,40
FC Lugano,5126,6,11,7,14,31,44,-13,40
Grasshoppers,5126,7,9,8,15,42,49,-7,35
FC Sion,5126,8,9,7,16,43,53,-10,34
FC Thun,5126,9,8,6,18,39,58,-19,30
Young Boys,5127,1,21,6,5,73,35,38,69
FC Basel,5127,2,18,8,6,53,25,28,62
Lucerne,5127,3,13,8,11,44,46,-2,47
St Gallen,5127,4,14,3,15,44,56,-12,45
FC Zürich,5127,5,11,9,12,41,38,3,42
Grasshoppers,5127,6,10,7,15,45,54,-9,37
FC Lugano,5127,7,10,5,17,33,55,-22,35
FC Thun,5127,8,9,6,17,46,59,-13,33
FC Sion,5127,9,8,8,16,41,52,-11,32
Young Boys,5128,1,23,7,2,73,32,41,76
FC Basel,5128,2,18,8,6,53,23,30,62
Lucerne,5128,3,12,8,12,43,52,-9,44
St Gallen,5128,4,14,2,16,42,55,-13,44
FC Zürich,5128,5,10,11,11,39,35,4,41
FC Lugano,5128,6,11,6,15,32,48,-16,39
FC Thun,5128,7,10,5,17,44,58,-14,35
Grasshoppers,5128,8,8,8,16,42,53,-11,32
FC Sion,5128,9,6,9,17,40,52,-12,27
Young Boys,5129,1,22,7,3,74,34,40,73
FC Basel,5129,2,18,9,5,54,23,31,63
St Gallen,5129,3,16,2,14,44,54,-10,50
Lucerne,5129,4,12,7,13,39,45,-6,43
FC Zürich,5129,5,10,10,12,43,38,5,40
FC Thun,5129,6,10,7,15,44,55,-11,37
FC Lugano,5129,7,10,6,16,29,48,-19,36
Grasshoppers,5129,8,9,7,16,41,49,-8,34
FC Sion,5129,9,6,7,19,41,63,-22,25
Young Boys,5130,1,23,6,3,78,35,43,75
FC Basel,5130,2,18,7,7,55,24,31,61
Lucerne,5130,3,14,7,11,43,44,-1,49
St Gallen,5130,4,15,2,15,41,52,-11,47
FC Zürich,5130,5,12,10,10,49,33,16,46
Grasshoppers,5130,6,10,6,16,41,55,-14,36
FC Lugano,5130,7,9,6,17,32,50,-18,33
FC Thun,5130,8,8,6,18,40,66,-26,30
FC Sion,5130,9,6,8,18,40,60,-20,26
Young Boys,5131,1,22,7,3,72,34,38,73
FC Basel,5131,2,17,9,6,51,28,23,60
Lucerne,5131,3,13,9,10,42,41,1,48
FC Zürich,5131,4,11,10,11,42,36,6,43
St Gallen,5131,5,13,4,15,41,56,-15,43
Grasshoppers,5131,6,9,8,15,43,49,-6,35
FC Lugano,5131,7,9,7,16,30,50,-20,34
FC Thun,5131,8,9,6,17,43,59,-16,33
FC Sion,5131,9,7,8,17,43,54,-11,29
Young Boys,5132,1,20,10,2,73,35,38,70
FC Basel,5132,2,18,8,6,52,24,28,62
FC Zürich,5132,3,12,9,11,43,35,8,45
Lucerne,5132,4,12,9,11,40,45,-5,45
St Gallen,5132,5,13,3,16,40,56,-16,42
FC Lugano,5132,6,10,8,14,34,47,-13,38
Grasshoppers,5132,7,9,8,15,42,50,-8,35
FC Thun,5132,8,10,5,17,44,59,-15,35
FC Sion,5132,9,6,8,18,40,57,-17,26
Young Boys,5133,1,22,6,4,71,34,37,72
FC Basel,5133,2,17,10,5,50,22,28,61
St Gallen,5133,3,14,5,13,46,54,-8,47
FC Zürich,5133,4,12,10,10,39,32,7,46
Lucerne,5133,5,13,7,12,40,44,-4,46
Grasshoppers,5133,6,9,7,16,39,52,-13,34
FC Lugano,5133,7,9,6,17,28,47,-19,33
FC Thun,5133,8,8,7,17,39,59,-20,31
FC Sion,5133,9,7,8,17,46,54,-8,29
Young Boys,5134,1,20,6,6,69,41,28,66
FC Basel,5134,2,17,7,8,53,31,22,58
St Gallen,5134,3,16,2,14,44,54,-10,50
FC Zürich,5134,4,12,10,10,47,36,11,46
Lucerne,5134,5,13,7,12,40,41,-1,46
Grasshoppers,5134,6,11,7,14,43,44,-1,40
FC Thun,5134,7,10,6,16,45,58,-13,36
FC Lugano,5134,8,10,5,17,30,48,-18,35
FC Sion,5134,9,6,8,18,40,58,-18,26
Young Boys,5135,1,21,9,2,74,32,42,72
FC Basel,5135,2,17,9,6,54,29,25,60
Lucerne,5135,3,13,9,10,43,41,2,48
St Gallen,5135,4,13,3,16,40,54,-14,42
FC Zürich,5135,5,10,11,11,46,43,3,41
FC Lugano,5135,6,11,5,16,32,51,-19,38
Grasshoppers,5135,7,10,6,16,40,47,-7,36
FC Thun,5135,8,10,6,16,47,62,-15,36
FC Sion,5135,9,5,10,17,41,58,-17,25
Young Boys,5136,1,21,8,3,76,37,39,71
FC Basel,5136,2,18,8,6,60,26,34,62
Lucerne,5136,3,14,8,10,45,48,-3,50
FC Zürich,5136,4,11,10,11,43,37,6,43
St Gallen,5136,5,13,2,17,42,59,-17,41
FC Lugano,5136,6,11,5,16,34,48,-14,38
FC Thun,5136,7,10,6,16,46,59,-13,36
Grasshoppers,5136,8,9,6,17,40,54,-14,33
FC Sion,5136,9,7,7,18,43,61,-18,28
Young Boys,5137,1,21,6,5,69,39,30,69
FC Basel,5137,2,19,8,5,65,29,36,65
St Gallen,5137,3,15,3,14,47,57,-10,48
Lucerne,5137,4,13,7,12,42,46,-4,46
FC Lugano,5137,5,12,5,15,37,47,-10,41
FC Zürich,5137,6,10,9,13,43,42,1,39
Grasshoppers,5137,7,9,8,15,42,52,-10,35
FC Thun,5137,8,9,6,17,43,61,-18,33
FC Sion,5137,9,6,8,18,39,54,-15,26
Young Boys,5138,1,23,7,2,73,32,41,76
FC Basel,5138,2,16,10,6,53,27,26,58
Lucerne,5138,3,15,7,10,42,40,2,52
St Gallen,5138,4,14,4,14,43,52,-9,46
FC Zürich,5138,5,9,11,12,37,35,2,38
FC Thun,5138,6,10,6,16,44,58,-14,36
Grasshoppers,5138,7,9,7,16,43,54,-11,34
FC Lugano,5138,8,9,6,17,28,49,-21,33
FC Sion,5138,9,6,8,18,38,54,-16,26
Young Boys,5139,1,22,7,3,77,38,39,73
FC Basel,5139,2,17,9,6,57,28,29,60
Lucerne,5139,3,13,7,12,42,48,-6,46
St Gallen,5139,4,14,3,15,43,55,-12,45
FC Zürich,5139,5,11,11,10,43,34,9,44
Grasshoppers,5139,6,10,7,15,40,48,-8,37
FC Lugano,5139,7,10,6,16,35,50,-15,36
FC Thun,5139,8,8,6,18,41,62,-21,30
FC Sion,5139,9,7,8,17,40,55,-15,29
Young Boys,5140,1,21,6,5,70,38,32,69
FC Basel,5140,2,18,8,6,54,25,29,62
Lucerne,5140,3,12,8,12,40,44,-4,44
St Gallen,5140,4,13,5,14,42,55,-13,44
FC Zrich,5140,5,10,10,12,45,40,5,40
FC Lugano,5140,6,11,6,15,36,50,-14,39
Grasshoppers,5140,7,10,7,15,39,46,-7,37
FC Thun,5140,8,10,6,16,43,58,-15,36
FC Sion,5140,9,7,8,17,43,56,-13,29
Young Boys,5141,1,22,7,3,69,33,36,73
FC Basel,5141,2,16,9,7,50,25,25,57
Lucerne,5141,3,13,8,11,41,43,-2,47
St Gallen,5141,4,14,4,14,46,57,-11,46
FC Zürich,5141,5,12,9,11,45,35,10,45
FC Thun,5141,6,11,6,15,44,55,-11,39
Grasshoppers,5141,7,9,8,15,41,49,-8,35
FC Lugano,5141,8,9,5,18,30,51,-21,32
FC Sion,5141,9,6,8,18,42,60,-18,26
Young Boys,5142,1,23,7,2,78,36,42,76
FC Basel,5142,2,17,8,7,51,27,24,59
St Gallen,5142,3,15,3,14,44,53,-9,48
FC Zürich,5142,4,12,9,11,44,35,9,45
Lucerne,5142,5,12,9,11,45,48,-3,45
Grasshoppers,5142,6,10,6,16,44,50,-6,36
FC Lugano,5142,7,10,5,17,32,50,-18,35
FC Thun,5142,8,9,6,17,44,61,-17,33
FC Sion,5142,9,5,9,18,38,60,-22,24
Young Boys,5143,1,22,7,3,70,32,38,73
FC Basel,5143,2,18,8,6,54,25,29,62
Lucerne,5143,3,13,8,11,42,42,0,47
FC Zürich,5143,4,12,9,11,41,35,6,45
St Gallen,5143,5,14,2,16,43,56,-13,44
Grasshoppers,5143,6,10,6,16,39,49,-10,36
FC Lugano,5143,7,10,5,17,30,49,-19,35
FC Thun,5143,8,9,7,16,43,58,-15,34
FC Sion,5143,9,6,8,18,37,53,-16,26
Young Boys,5144,1,22,6,4,71,31,40,72
FC Basel,5144,2,19,8,5,55,24,31,65
St Gallen,5144,3,15,3,14,42,52,-10,48
Lucerne,5144,4,12,8,12,40,43,-3,44
FC Zürich,5144,5,11,10,11,42,35,7,43
FC Lugano,5144,6,10,6,16,28,47,-19,36
Grasshoppers,5144,7,9,8,15,40,50,-10,35
FC Thun,5144,8,9,6,17,41,59,-18,33
FC Sion,5144,9,6,7,19,37,55,-18,25
Young Boys,5145,1,22,6,4,71,34,37,72
FC Basel,5145,2,19,8,5,60,26,34,65
Lucerne,5145,3,14,7,11,43,43,0,49
St Gallen,5145,4,14,3,15,44,59,-15,45
FC Zürich,5145,5,9,13,10,39,35,4,40
FC Thun,5145,6,10,6,16,45,58,-13,36
FC Lugano,5145,7,10,6,16,29,46,-17,36
Grasshoppers,5145,8,8,7,17,37,49,-12,31
FC Sion,5145,9,5,10,17,39,57,-18,25
Young Boys,5146,1,24,6,2,79,34,45,78
FC Basel,5146,2,17,7,8,56,29,27,58
Lucerne,5146,3,14,7,11,45,44,1,49
FC Zürich,5146,4,11,10,11,42,35,7,43
St Gallen,5146,5,13,3,16,42,59,-17,42
FC Lugano,5146,6,10,7,15,32,48,-16,37
FC Thun,5146,7,10,5,17,42,61,-19,35
Grasshoppers,5146,8,9,6,17,43,53,-10,33
FC Sion,5146,9,7,7,18,39,57,-18,28
Young Boys,5147,1,21,6,5,72,38,34,69
FC Basel,5147,2,19,7,6,56,26,30,64
Lucerne,5147,3,14,7,11,43,42,1,49
St Gallen,5147,4,14,4,14,41,52,-11,46
FC Zürich,5147,5,12,9,11,42,39,3,45
Grasshoppers,5147,6,10,6,16,45,52,-7,36
FC Lugano,5147,7,10,6,16,33,48,-15,36
FC Thun,5147,8,10,5,17,48,60,-12,35
FC Sion,5147,9,5,8,19,36,59,-23,23
Young Boys,5148,1,21,7,4,70,35,35,70
FC Basel,5148,2,18,7,7,54,26,28,61
St Gallen,5148,3,15,2,15,44,57,-13,47
Lucerne,5148,4,12,9,11,40,45,-5,45
FC Zürich,5148,5,11,10,11,40,36,4,43
Grasshoppers,5148,6,10,8,14,44,47,-3,38
FC Lugano,5148,7,10,6,16,29,45,-16,36
FC Thun,5148,8,9,6,17,43,61,-18,33
FC Sion,5148,9,7,7,18,44,56,-12,28
Young Boys,5149,1,20,7,5,72,40,32,67
FC Basel,5149,2,18,8,6,52,22,30,62
Lucerne,5149,3,13,7,12,41,47,-6,46
St Gallen,5149,4,14,2,16,42,57,-15,44
FC Zürich,5149,5,10,12,10,40,34,6,42
FC Lugano,5149,6,11,6,15,33,48,-15,39
FC Thun,5149,7,10,7,15,43,56,-13,37
Grasshoppers,5149,8,9,7,16,42,49,-7,34
FC Sion,5149,9,7,8,17,43,55,-12,29
Young Boys,5150,1,21,7,4,69,32,37,70
FC Basel,5150,2,20,7,5,58,25,33,67
Lucerne,5150,3,14,7,11,44,45,-1,49
St Gallen,5150,4,14,3,15,45,56,-11,45
FC Zürich,5150,5,10,10,12,40,41,-1,40
FC Lugano,5150,6,9,7,16,29,46,-17,34
Grasshoppers,5150,7,9,6,17,40,53,-13,33
FC Thun,5150,8,9,6,17,44,59,-15,33
FC Sion,5150,9,7,9,16,41,53,-12,30
Young Boys,5151,1,19,9,4,67,35,32,66
FC Basel,5151,2,18,7,7,54,29,25,61
St Gallen,5151,3,15,4,13,47,55,-8,49
Lucerne,5151,4,13,9,10,46,43,3,48
FC Zürich,5151,5,12,10,10,43,35,8,46
Grasshoppers,5151,6,10,6,16,41,50,-9,36
FC Thun,5151,7,10,6,16,47,61,-14,36
FC Lugano,5151,8,9,6,17,30,51,-21,33
FC Sion,5151,9,5,9,18,38,54,-16,24
Young Boys,5152,1,21,7,4,74,37,37,70
FC Basel,5152,2,17,9,6,56,28,28,60
St Gallen,5152,3,14,4,14,42,54,-12,46
FC Zürich,5152,4,12,9,11,44,37,7,45
Lucerne,5152,5,12,9,11,40,42,-2,45
FC Lugano,5152,6,11,6,15,33,47,-14,39
Grasshoppers,5152,7,10,7,15,41,50,-9,37
FC Thun,5152,8,9,5,18,44,61,-17,32
FC Sion,5152,9,6,8,18,39,57,-18,26
Young Boys,5153,1,21,6,5,71,45,26,69
FC Basel,5153,2,18,7,7,52,25,27,61
Lucerne,5153,3,14,8,10,46,41,5,50
St Gallen,5153,4,14,3,15,42,54,-12,45
FC Zürich,5153,5,10,11,11,42,38,4,41
Grasshoppers,5153,6,11,6,15,48,49,-1,39
FC Lugano,5153,7,10,6,16,30,48,-18,36
FC Thun,5153,8,10,5,17,45,59,-14,35
FC Sion,5153,9,6,8,18,41,58,-17,26
Young Boys,5154,1,22,7,3,75,40,35,73
FC Basel,5154,2,17,9,6,58,28,30,60
St Gallen,5154,3,15,3,14,46,56,-10,48
Lucerne,5154,4,12,9,11,42,46,-4,45
FC Zürich,5154,5,11,10,11,42,33,9,43
FC Thun,5154,6,11,5,16,46,60,-14,38
Grasshoppers,5154,7,10,6,16,44,50,-6,36
FC Lugano,5154,8,9,6,17,31,52,-21,33
FC Sion,5154,9,6,7,19,42,61,-19,25
FC Basel,5155,1,20,7,5,61,21,40,67
Young Boys,5155,2,20,6,6,67,36,31,66
Lucerne,5155,3,13,8,11,42,48,-6,47
St Gallen,5155,4,13,4,15,41,57,-16,43
FC Zürich,5155,5,11,9,12,41,38,3,42
Grasshoppers,5155,6,11,6,15,47,47,0,39
FC Sion,5155,7,9,8,15,43,52,-9,35
FC Lugano,5155,8,10,5,17,31,48,-17,35
FC Thun,5155,9,8,5,19,41,67,-26,29
Young Boys,5156,1,23,7,2,73,32,41,76
FC Basel,5156,2,17,8,7,53,26,27,59
St Gallen,5156,3,15,2,15,47,58,-11,47
Lucerne,5156,4,13,7,12,42,44,-2,46
FC Thun,5156,5,12,5,15,46,54,-8,41
FC Zürich,5156,6,10,9,13,40,41,-1,39
FC Lugano,5156,7,11,5,16,37,50,-13,38
Grasshoppers,5156,8,8,6,18,39,57,-18,30
FC Sion,5156,9,7,7,18,43,58,-15,28
Young Boys,5157,1,21,7,4,70,35,35,70
FC Basel,5157,2,19,8,5,59,24,35,65
Lucerne,5157,3,13,8,11,42,47,-5,47
St Gallen,5157,4,13,4,15,46,60,-14,43
FC Zürich,5157,5,10,11,11,41,35,6,41
FC Lugano,5157,6,10,7,15,33,48,-15,37
FC Thun,5157,7,10,6,16,44,57,-13,36
Grasshoppers,5157,8,9,7,16,39,49,-10,34
FC Sion,5157,9,6,8,18,40,59,-19,26
Young Boys,5158,1,21,7,4,73,40,33,70
FC Basel,5158,2,16,10,6,55,27,28,58
St Gallen,5158,3,14,5,13,42,50,-8,47
FC Zürich,5158,4,12,9,11,48,40,8,45
Lucerne,5158,5,12,9,11,40,44,-4,45
Grasshoppers,5158,6,11,6,15,43,47,-4,39
FC Lugano,5158,7,11,6,15,35,47,-12,39
FC Thun,5158,8,8,7,17,41,59,-18,31
FC Sion,5158,9,5,9,18,37,60,-23,24
Young Boys,5159,1,21,6,5,68,37,31,69
FC Basel,5159,2,19,8,5,54,24,30,65
St Gallen,5159,3,14,3,15,46,57,-11,45
FC Zürich,5159,4,11,11,10,45,35,10,44
Lucerne,5159,5,11,9,12,38,45,-7,42
FC Lugano,5159,6,11,6,15,33,46,-13,39
Grasshoppers,5159,7,9,8,15,42,48,-6,35
FC Thun,5159,8,9,6,17,42,60,-18,33
FC Sion,5159,9,6,9,17,42,58,-16,27
Young Boys,5160,1,21,8,3,71,35,36,71
FC Basel,5160,2,19,7,6,59,25,34,64
Lucerne,5160,3,14,7,11,41,44,-3,49
St Gallen,5160,4,15,2,15,44,52,-8,47
FC Zürich,5160,5,11,10,11,43,39,4,43
Grasshoppers,5160,6,9,8,15,40,47,-7,35
FC Lugano,5160,7,10,5,17,30,48,-18,35
FC Thun,5160,8,9,6,17,44,59,-15,33
FC Sion,5160,9,5,9,18,37,60,-23,24
Young Boys,5161,1,21,8,3,69,31,38,71
FC Basel,5161,2,20,7,5,63,22,41,67
St Gallen,5161,3,15,2,15,44,55,-11,47
Lucerne,5161,4,12,9,11,41,49,-8,45
FC Zürich,5161,5,11,10,11,39,34,5,43
FC Thun,5161,6,9,7,16,40,58,-18,34
FC Lugano,5161,7,9,6,17,28,47,-19,33
Grasshoppers,5161,8,8,8,16,38,49,-11,32
FC Sion,5161,9,6,9,17,39,56,-17,27
Young Boys,5162,1,21,8,3,67,34,33,71
FC Basel,5162,2,19,7,6,59,26,33,64
Lucerne,5162,3,12,7,13,43,46,-3,43
St Gallen,5162,4,13,4,15,41,58,-17,43
FC Zürich,5162,5,11,9,12,42,37,5,42
FC Thun,5162,6,11,5,16,46,57,-11,38
Grasshoppers,5162,7,10,7,15,42,49,-7,37
FC Lugano,5162,8,10,7,15,30,46,-16,37
FC Sion,5162,9,5,10,17,36,53,-17,25
Young Boys,5163,1,21,7,4,68,33,35,70
FC Basel,5163,2,16,9,7,54,30,24,57
Lucerne,5163,3,14,9,9,41,39,2,51
St Gallen,5163,4,14,4,14,47,57,-10,46
FC Zürich,5163,5,10,11,11,45,39,6,41
Grasshoppers,5163,6,10,7,15,41,46,-5,37
FC Thun,5163,7,10,5,17,44,61,-17,35
FC Lugano,5163,8,9,6,17,28,48,-20,33
FC Sion,5163,9,7,8,17,40,55,-15,29
Young Boys,5164,1,22,7,3,73,33,40,73
FC Basel,5164,2,19,8,5,59,25,34,65
Lucerne,5164,3,13,8,11,43,46,-3,47
St Gallen,5164,4,14,2,16,43,60,-17,44
FC Zürich,5164,5,11,10,11,43,35,8,43
FC Lugano,5164,6,10,6,16,34,50,-16,36
FC Thun,5164,7,10,5,17,45,62,-17,35
Grasshoppers,5164,8,9,6,17,41,53,-12,33
FC Sion,5164,9,6,8,18,40,57,-17,26
Young Boys,5165,1,21,7,4,69,34,35,70
FC Basel,5165,2,18,8,6,57,25,32,62
St Gallen,5165,3,15,2,15,43,53,-10,47
Lucerne,5165,4,12,8,12,40,46,-6,44
FC Zürich,5165,5,9,12,11,42,40,2,39
FC Lugano,5165,6,11,6,15,31,44,-13,39
Grasshoppers,5165,7,10,6,16,41,49,-8,36
FC Thun,5165,8,9,6,17,43,63,-20,33
FC Sion,5165,9,7,9,16,45,57,-12,30
Young Boys,5166,1,23,6,3,72,35,37,75
FC Basel,5166,2,19,7,6,56,25,31,64
Lucerne,5166,3,12,8,12,40,45,-5,44
St Gallen,5166,4,13,4,15,38,55,-17,43
FC Zürich,5166,5,10,11,11,40,37,3,41
FC Lugano,5166,6,10,6,16,31,46,-15,36
Grasshoppers,5166,7,9,6,17,42,51,-9,33
FC Thun,5166,8,9,6,17,39,57,-18,33
FC Sion,5166,9,8,8,16,44,51,-7,32
Young Boys,5167,1,21,6,5,73,42,31,69
FC Basel,5167,2,18,8,6,57,27,30,62
Lucerne,5167,3,14,8,10,45,43,2,50
St Gallen,5167,4,15,2,15,45,58,-13,47
FC Zürich,5167,5,10,12,10,42,35,7,42
Grasshoppers,5167,6,10,6,16,44,53,-9,36
FC Lugano,5167,7,10,6,16,29,46,-17,36
FC Thun,5167,8,9,6,17,44,60,-16,33
FC Sion,5167,9,6,8,18,46,61,-15,26
Young Boys,5168,1,21,7,4,69,37,32,70
FC Basel,5168,2,17,9,6,54,26,28,60
Lucerne,5168,3,12,9,11,40,42,-2,45
FC Zürich,5168,4,11,10,11,42,35,7,43
St Gallen,5168,5,13,3,16,41,56,-15,42
FC Lugano,5168,6,12,5,15,33,46,-13,41
Grasshoppers,5168,7,10,7,15,42,48,-6,37
FC Thun,5168,8,10,7,15,43,55,-12,37
FC Sion,5168,9,6,7,19,38,57,-19,25
Young Boys,5169,1,22,6,4,74,36,38,72
FC Basel,5169,2,18,9,5,59,26,33,63
St Gallen,5169,3,15,4,13,48,53,-5,49
Lucerne,5169,4,12,8,12,43,48,-5,44
Grasshoppers,5169,5,11,6,15,40,47,-7,39
FC Zürich,5169,6,9,10,13,38,41,-3,37
FC Thun,5169,7,10,6,16,44,57,-13,36
FC Lugano,5169,8,10,5,17,32,55,-23,35
FC Sion,5169,9,5,10,17,35,50,-15,25
Young Boys,5170,1,22,7,3,73,37,36,73
FC Basel,5170,2,18,9,5,56,26,30,63
St Gallen,5170,3,15,4,13,43,52,-9,49
Lucerne,5170,4,13,8,11,46,48,-2,47
FC Zürich,5170,5,10,12,10,40,34,6,42
Grasshoppers,5170,6,9,7,16,48,55,-7,34
FC Lugano,5170,7,9,6,17,29,47,-18,33
FC Thun,5170,8,8,7,17,40,60,-20,31
FC Sion,5170,9,6,8,18,39,55,-16,26
Young Boys,5171,1,21,7,4,76,36,40,70
FC Basel,5171,2,19,8,5,63,26,37,65
St Gallen,5171,3,15,3,14,46,56,-10,48
Lucerne,5171,4,12,9,11,41,48,-7,45
FC Zürich,5171,5,11,9,12,41,38,3,42
Grasshoppers,5171,6,10,7,15,46,54,-8,37
FC Thun,5171,7,10,6,16,49,62,-13,36
FC Lugano,5171,8,10,5,17,30,47,-17,35
FC Sion,5171,9,5,8,19,41,66,-25,23
Young Boys,5172,1,21,6,5,69,38,31,69
FC Basel,5172,2,18,8,6,55,27,28,62
Lucerne,5172,3,14,8,10,44,42,2,50
St Gallen,5172,4,13,5,14,43,55,-12,44
FC Zürich,5172,5,10,10,12,39,37,2,40
Grasshoppers,5172,6,10,6,16,40,49,-9,36
FC Lugano,5172,7,10,6,16,32,48,-16,36
FC Sion,5172,8,8,8,16,46,53,-7,32
FC Thun,5172,9,9,5,18,44,63,-19,32
Young Boys,5173,1,21,8,3,74,39,35,71
FC Basel,5173,2,19,8,5,59,27,32,65
Lucerne,5173,3,13,8,11,46,49,-3,47
St Gallen,5173,4,13,3,16,43,60,-17,42
FC Zürich,5173,5,10,10,12,39,38,1,40
Grasshoppers,5173,6,11,6,15,45,47,-2,39
FC Thun,5173,7,10,6,16,44,58,-14,36
FC Lugano,5173,8,9,6,17,30,51,-21,33
FC Sion,5173,9,7,7,18,45,56,-11,28
Young Boys,5174,1,21,7,4,72,39,33,70
FC Basel,5174,2,18,8,6,54,23,31,62
St Gallen,5174,3,14,4,14,43,54,-11,46
FC Zürich,5174,4,10,11,11,38,35,3,41
Lucerne,5174,5,11,8,13,40,48,-8,41
FC Lugano,5174,6,11,7,14,32,44,-12,40
Grasshoppers,5174,7,10,6,16,39,50,-11,36
FC Thun,5174,8,9,6,17,42,57,-15,33
FC Sion,5174,9,8,7,17,43,53,-10,31
Young Boys,5175,1,20,8,4,69,38,31,68
FC Basel,5175,2,18,8,6,64,30,34,62
St Gallen,5175,3,15,3,14,44,54,-10,48
Lucerne,5175,4,12,7,13,41,47,-6,43
FC Zürich,5175,5,10,10,12,40,37,3,40
FC Lugano,5175,6,11,6,15,33,46,-13,39
FC Thun,5175,7,11,5,16,46,62,-16,38
Grasshoppers,5175,8,10,7,15,42,48,-6,37
FC Sion,5175,9,6,8,18,38,55,-17,26
Young Boys,5176,1,21,7,4,67,32,35,70
FC Basel,5176,2,17,7,8,53,28,25,58
St Gallen,5176,3,16,2,14,51,56,-5,50
Lucerne,5176,4,12,9,11,42,46,-4,45
FC Zürich,5176,5,11,9,12,42,37,5,42
FC Lugano,5176,6,11,6,15,30,45,-15,39
Grasshoppers,5176,7,9,9,14,42,49,-7,36
FC Thun,5176,8,10,5,17,45,60,-15,35
FC Sion,5176,9,6,8,18,39,58,-19,26
Young Boys,5177,1,22,6,4,74,36,38,72
FC Basel,5177,2,17,8,7,53,29,24,59
St Gallen,5177,3,14,3,15,43,54,-11,45
Lucerne,5177,4,12,8,12,42,47,-5,44
FC Zürich,5177,5,10,11,11,43,39,4,41
Grasshoppers,5177,6,11,6,15,46,51,-5,39
FC Lugano,5177,7,10,7,15,32,49,-17,37
FC Thun,5177,8,10,5,17,48,63,-15,35
FC Sion,5177,9,7,8,17,42,55,-13,29
Young Boys,5178,1,21,7,4,75,40,35,70
FC Basel,5178,2,15,10,7,51,30,21,55
Lucerne,5178,3,14,8,10,44,43,1,50
St Gallen,5178,4,14,3,15,45,56,-11,45
FC Zürich,5178,5,11,10,11,41,36,5,43
Grasshoppers,5178,6,11,6,15,43,47,-4,39
FC Lugano,5178,7,11,6,15,33,47,-14,39
FC Thun,5178,8,9,6,17,43,60,-17,33
FC Sion,5178,9,6,8,18,39,55,-16,26
Young Boys,5179,1,20,7,5,70,39,31,67
FC Basel,5179,2,19,8,5,65,27,38,65
Lucerne,5179,3,13,9,10,44,45,-1,48
St Gallen,5179,4,14,3,15,41,59,-18,45
Grasshoppers,5179,5,11,6,15,42,49,-7,39
FC Zürich,5179,6,9,11,12,40,38,2,38
FC Sion,5179,7,9,7,16,47,48,-1,34
FC Lugano,5179,8,9,6,17,32,50,-18,33
FC Thun,5179,9,9,5,18,40,66,-26,32
Young Boys,5180,1,21,6,5,69,36,33,69
FC Basel,5180,2,18,7,7,51,26,25,61
Lucerne,5180,3,15,7,10,42,42,0,52
St Gallen,5180,4,14,2,16,41,53,-12,44
FC Zürich,5180,5,11,9,12,43,37,6,42
FC Lugano,5180,6,11,5,16,33,47,-14,38
Grasshoppers,5180,7,10,6,16,41,48,-7,36
FC Thun,5180,8,9,6,17,42,60,-18,33
FC Sion,5180,9,7,8,17,42,55,-13,29
Young Boys,5181,1,24,6,2,76,34,42,78
FC Basel,5181,2,16,9,7,53,29,24,57
Lucerne,5181,3,13,7,12,42,45,-3,46
FC Zürich,5181,4,11,10,11,40,36,4,43
St Gallen,5181,5,13,3,16,42,56,-14,42
FC Lugano,5181,6,11,5,16,33,48,-15,38
Grasshoppers,5181,7,10,6,16,40,48,-8,36
FC Thun,5181,8,9,6,17,41,57,-16,33
FC Sion,5181,9,7,8,17,39,53,-14,29
Young Boys,5182,1,22,7,3,72,34,38,73
FC Basel,5182,2,19,8,5,56,25,31,65
Lucerne,5182,3,13,8,11,42,42,0,47
FC Zürich,5182,4,11,10,11,40,35,5,43
St Gallen,5182,5,13,4,15,39,57,-18,43
FC Thun,5182,6,10,6,16,45,57,-12,36
FC Lugano,5182,7,10,6,16,33,47,-14,36
Grasshoppers,5182,8,9,6,17,38,53,-15,33
FC Sion,5182,9,6,7,19,39,54,-15,25
Young Boys,5183,1,23,7,2,73,31,42,76
FC Basel,5183,2,16,9,7,51,28,23,57
FC Zürich,5183,3,11,11,10,44,36,8,44
Lucerne,5183,4,12,8,12,42,48,-6,44
St Gallen,5183,5,13,4,15,44,59,-15,43
FC Lugano,5183,6,11,6,15,33,47,-14,39
FC Thun,5183,7,10,6,16,44,55,-11,36
Grasshoppers,5183,8,8,7,17,38,51,-13,31
FC Sion,5183,9,6,10,16,40,54,-14,28
Young Boys,5184,1,20,7,5,68,37,31,67
FC Basel,5184,2,17,10,5,56,27,29,61
St Gallen,5184,3,14,3,15,42,54,-12,45
Lucerne,5184,4,12,8,12,42,46,-4,44
FC Lugano,5184,5,11,7,14,31,44,-13,40
FC Zürich,5184,6,9,11,12,39,39,0,38
FC Thun,5184,7,10,7,15,45,56,-11,37
Grasshoppers,5184,8,8,9,15,39,48,-9,33
FC Sion,5184,9,8,8,16,40,51,-11,32
Young Boys,5185,1,22,6,4,71,33,38,72
FC Basel,5185,2,18,8,6,55,26,29,62
Lucerne,5185,3,14,7,11,41,42,-1,49
St Gallen,5185,4,13,2,17,45,60,-15,41
FC Zürich,5185,5,10,10,12,41,40,1,40
FC Lugano,5185,6,11,5,16,36,51,-15,38
Grasshoppers,5185,7,10,6,16,39,50,-11,36
FC Thun,5185,8,10,6,16,43,57,-14,36
FC Sion,5185,9,7,8,17,42,54,-12,29
Young Boys,5186,1,22,7,3,69,33,36,73
FC Basel,5186,2,17,8,7,57,31,26,59
St Gallen,5186,3,15,3,14,42,51,-9,48
FC Zürich,5186,4,11,10,11,42,37,5,43
Lucerne,5186,5,11,9,12,40,46,-6,42
FC Thun,5186,6,11,6,15,50,60,-10,39
FC Lugano,5186,7,10,7,15,30,45,-15,37
Grasshoppers,5186,8,9,7,16,41,50,-9,34
FC Sion,5186,9,5,9,18,37,55,-18,24
Young Boys,5187,1,21,6,5,66,33,33,69
FC Basel,5187,2,17,9,6,52,24,28,60
Lucerne,5187,3,14,8,10,42,41,1,50
St Gallen,5187,4,14,3,15,40,55,-15,45
FC Zürich,5187,5,11,10,11,42,35,7,43
FC Lugano,5187,6,11,5,16,31,46,-15,38
FC Thun,5187,7,10,6,16,46,61,-15,36
FC Sion,5187,8,8,7,17,43,53,-10,31
Grasshoppers,5187,9,8,6,18,39,53,-14,30
Young Boys,5188,1,21,8,3,75,39,36,71
FC Basel,5188,2,18,8,6,57,27,30,62
St Gallen,5188,3,16,2,14,42,50,-8,50
Lucerne,5188,4,12,8,12,42,43,-1,44
FC Zürich,5188,5,10,10,12,44,41,3,40
FC Lugano,5188,6,10,6,16,32,50,-18,36
Grasshoppers,5188,7,9,7,16,41,51,-10,34
FC Thun,5188,8,9,6,17,42,60,-18,33
FC Sion,5188,9,7,9,16,43,57,-14,30
Young Boys,5189,1,21,7,4,75,39,36,70
FC Basel,5189,2,18,9,5,59,27,32,63
Lucerne,5189,3,13,8,11,46,47,-1,47
St Gallen,5189,4,14,3,15,42,56,-14,45
FC Zürich,5189,5,10,9,13,40,39,1,39
FC Lugano,5189,6,11,6,15,37,52,-15,39
FC Thun,5189,7,11,5,16,44,58,-14,38
Grasshoppers,5189,8,9,7,16,41,51,-10,34
FC Sion,5189,9,6,8,18,38,53,-15,26
Young Boys,5190,1,21,9,2,70,33,37,72
FC Basel,5190,2,17,9,6,56,27,29,60
St Gallen,5190,3,15,2,15,46,58,-12,47
Lucerne,5190,4,12,10,10,39,39,0,46
FC Zürich,5190,5,12,9,11,42,35,7,45
FC Lugano,5190,6,10,6,16,30,50,-20,36
Grasshoppers,5190,7,8,9,15,42,52,-10,33
FC Thun,5190,8,9,6,17,44,63,-19,33
FC Sion,5190,9,6,8,18,45,57,-12,26
Young Boys,5191,1,21,8,3,72,33,39,71
FC Basel,5191,2,19,8,5,53,24,29,65
Lucerne,5191,3,12,9,11,43,47,-4,45
St Gallen,5191,4,13,3,16,41,57,-16,42
FC Zürich,5191,5,10,10,12,38,36,2,40
Grasshoppers,5191,6,10,7,15,41,48,-7,37
FC Lugano,5191,7,10,6,16,34,50,-16,36
FC Thun,5191,8,8,8,16,40,56,-16,32
FC Sion,5191,9,7,9,16,40,51,-11,30
Young Boys,5192,1,21,7,4,72,38,34,70
FC Basel,5192,2,19,7,6,56,24,32,64
Lucerne,5192,3,13,8,11,44,46,-2,47
St Gallen,5192,4,13,3,16,40,56,-16,42
FC Zürich,5192,5,10,11,11,40,36,4,41
FC Lugano,5192,6,11,6,15,33,46,-13,39
Grasshoppers,5192,7,9,8,15,42,51,-9,35
FC Thun,5192,8,9,7,16,45,61,-16,34
FC Sion,5192,9,6,9,17,40,54,-14,27
Young Boys,5193,1,22,7,3,72,35,37,73
FC Basel,5193,2,18,7,7,51,25,26,61
St Gallen,5193,3,14,2,16,43,58,-15,44
FC Zürich,5193,4,11,10,11,40,36,4,43
Lucerne,5193,5,12,7,13,42,43,-1,43
FC Lugano,5193,6,12,6,14,33,44,-11,42
Grasshoppers,5193,7,11,7,14,46,50,-4,40
FC Thun,5193,8,9,7,16,42,57,-15,34
FC Sion,5193,9,5,7,20,35,56,-21,22
Young Boys,5194,1,21,7,4,69,36,33,70
FC Basel,5194,2,18,9,5,61,29,32,63
Lucerne,5194,3,13,8,11,43,43,0,47
St Gallen,5194,4,14,2,16,41,58,-17,44
FC Zürich,5194,5,9,11,12,42,40,2,38
Grasshoppers,5194,6,10,7,15,45,51,-6,37
FC Lugano,5194,7,10,6,16,32,48,-16,36
FC Thun,5194,8,9,6,17,48,66,-18,33
FC Sion,5194,9,8,8,16,44,54,-10,32
Young Boys,5195,1,22,6,4,71,36,35,72
FC Basel,5195,2,19,8,5,54,25,29,65
St Gallen,5195,3,14,3,15,45,56,-11,45
Lucerne,5195,4,12,7,13,42,48,-6,43
FC Zürich,5195,5,10,10,12,43,39,4,40
FC Thun,5195,6,11,6,15,50,59,-9,39
FC Lugano,5195,7,10,6,16,32,49,-17,36
Grasshoppers,5195,8,9,6,17,44,54,-10,33
FC Sion,5195,9,7,8,17,41,56,-15,29
Young Boys,5196,1,21,9,2,69,32,37,72
FC Basel,5196,2,18,9,5,56,24,32,63
St Gallen,5196,3,14,3,15,40,57,-17,45
Lucerne,5196,4,12,8,12,38,44,-6,44
FC Zürich,5196,5,10,12,10,45,40,5,42
FC Lugano,5196,6,10,6,16,34,46,-12,36
FC Thun,5196,7,9,7,16,44,60,-16,34
Grasshoppers,5196,8,8,9,15,40,50,-10,33
FC Sion,5196,9,6,9,17,40,53,-13,27
Young Boys,5197,1,20,9,3,68,33,35,69
FC Basel,5197,2,19,7,6,62,28,34,64
FC Zürich,5197,3,12,9,11,43,35,8,45
Lucerne,5197,4,12,9,11,40,44,-4,45
St Gallen,5197,5,14,2,16,42,57,-15,44
FC Lugano,5197,6,11,7,14,32,44,-12,40
FC Thun,5197,7,9,6,17,45,61,-16,33
FC Sion,5197,8,7,9,16,40,54,-14,30
Grasshoppers,5197,9,8,6,18,39,55,-16,30
Young Boys,5198,1,23,7,2,72,33,39,76
FC Basel,5198,2,18,8,6,54,24,30,62
FC Zürich,5198,3,13,9,10,45,36,9,48
St Gallen,5198,4,15,2,15,40,56,-16,47
Lucerne,5198,5,11,9,12,37,41,-4,42
Grasshoppers,5198,6,9,7,16,39,50,-11,34
FC Thun,5198,7,9,6,17,44,60,-16,33
FC Lugano,5198,8,9,6,17,28,46,-18,33
FC Sion,5198,9,6,8,18,44,57,-13,26
Young Boys,5199,1,19,9,4,69,37,32,66
FC Basel,5199,2,17,7,8,53,29,24,58
St Gallen,5199,3,16,2,14,46,52,-6,50
Lucerne,5199,4,13,9,10,40,42,-2,48
FC Zürich,5199,5,11,11,10,43,36,7,44
FC Thun,5199,6,10,6,16,43,57,-14,36
FC Lugano,5199,7,9,8,15,28,44,-16,35
Grasshoppers,5199,8,9,6,17,41,53,-12,33
FC Sion,5199,9,7,8,17,45,58,-13,29
Young Boys,5200,1,21,8,3,73,35,38,71
FC Basel,5200,2,18,8,6,54,25,29,62
Lucerne,5200,3,14,9,9,49,44,5,51
FC Zürich,5200,4,11,10,11,42,36,6,43
St Gallen,5200,5,13,3,16,40,56,-16,42
FC Lugano,5200,6,10,6,16,32,51,-19,36
Grasshoppers,5200,7,9,8,15,43,50,-7,35
FC Thun,5200,8,8,7,17,40,58,-18,31
FC Sion,5200,9,7,7,18,39,57,-18,28
Young Boys,5201,1,20,9,3,71,36,35,69
FC Basel,5201,2,18,8,6,54,24,30,62
Lucerne,5201,3,14,8,10,45,45,0,50
St Gallen,5201,4,16,2,14,45,53,-8,50
FC Zürich,5201,5,11,9,12,41,37,4,42
FC Thun,5201,6,10,6,16,44,58,-14,36
Grasshoppers,5201,7,9,7,16,44,51,-7,34
FC Lugano,5201,8,9,5,18,30,50,-20,32
FC Sion,5201,9,6,8,18,39,59,-20,26
Young Boys,5202,1,21,7,4,73,34,39,70
FC Basel,5202,2,19,7,6,55,25,30,64
FC Zürich,5202,3,12,9,11,43,39,4,45
St Gallen,5202,4,14,2,16,42,59,-17,44
Lucerne,5202,5,12,7,13,41,46,-5,43
FC Lugano,5202,6,11,5,16,32,48,-16,38
Grasshoppers,5202,7,9,7,16,39,50,-11,34
FC Thun,5202,8,9,6,17,41,58,-17,33
FC Sion,5202,9,7,10,15,43,50,-7,31
Young Boys,5203,1,22,6,4,74,33,41,72
FC Basel,5203,2,18,7,7,54,27,27,61
Lucerne,5203,3,14,7,11,46,46,0,49
St Gallen,5203,4,15,2,15,41,54,-13,47
FC Zürich,5203,5,10,11,11,43,39,4,41
FC Thun,5203,6,11,5,16,45,57,-12,38
Grasshoppers,5203,7,10,6,16,43,50,-7,36
FC Lugano,5203,8,9,6,17,31,52,-21,33
FC Sion,5203,9,6,8,18,40,59,-19,26
Young Boys,5204,1,22,8,2,75,33,42,74
FC Basel,5204,2,17,8,7,50,26,24,59
St Gallen,5204,3,17,2,13,48,49,-1,53
FC Zürich,5204,4,12,10,10,45,34,11,46
Lucerne,5204,5,13,7,12,41,46,-5,46
FC Thun,5204,6,10,5,17,44,60,-16,35
Grasshoppers,5204,7,9,7,16,40,51,-11,34
FC Lugano,5204,8,9,6,17,28,50,-22,33
FC Sion,5204,9,5,7,20,37,59,-22,22
Young Boys,5205,1,22,8,2,76,37,39,74
FC Basel,5205,2,17,8,7,54,31,23,59
Lucerne,5205,3,12,11,9,46,44,2,47
FC Zürich,5205,4,11,10,11,43,35,8,43
St Gallen,5205,5,13,4,15,44,57,-13,43
Grasshoppers,5205,6,10,8,14,43,48,-5,38
FC Lugano,5205,7,10,6,16,30,49,-19,36
FC Thun,5205,8,8,6,18,43,62,-19,30
FC Sion,5205,9,6,9,17,41,57,-16,27
Young Boys,5206,1,21,8,3,69,33,36,71
FC Basel,5206,2,16,10,6,51,25,26,58
Lucerne,5206,3,14,8,10,41,41,0,50
St Gallen,5206,4,14,4,14,45,55,-10,46
FC Zürich,5206,5,10,12,10,43,37,6,42
FC Lugano,5206,6,10,7,15,35,50,-15,37
Grasshoppers,5206,7,8,8,16,39,50,-11,32
FC Thun,5206,8,8,7,17,41,59,-18,31
FC Sion,5206,9,7,8,17,42,56,-14,29
Young Boys,5207,1,21,9,2,71,34,37,72
FC Basel,5207,2,16,11,5,52,25,27,59
St Gallen,5207,3,16,2,14,44,54,-10,50
Lucerne,5207,4,13,9,10,41,39,2,48
FC Zürich,5207,5,11,11,10,41,34,7,44
FC Lugano,5207,6,9,6,17,29,50,-21,33
Grasshoppers,5207,7,8,7,17,40,52,-12,31
FC Thun,5207,8,8,7,17,41,58,-17,31
FC Sion,5207,9,7,8,17,39,52,-13,29
Young Boys,5208,1,23,7,2,72,30,42,76
FC Basel,5208,2,17,8,7,53,27,26,59
St Gallen,5208,3,15,4,13,44,53,-9,49
FC Zürich,5208,4,12,10,10,40,33,7,46
Lucerne,5208,5,12,8,12,43,47,-4,44
Grasshoppers,5208,6,9,8,15,40,49,-9,35
FC Lugano,5208,7,9,6,17,29,49,-20,33
FC Thun,5208,8,8,7,17,39,59,-20,31
FC Sion,5208,9,6,8,18,39,52,-13,26
Young Boys,5209,1,21,6,5,69,37,32,69
FC Basel,5209,2,17,8,7,54,28,26,59
St Gallen,5209,3,16,2,14,48,56,-8,50
Lucerne,5209,4,12,10,10,44,44,0,46
FC Zürich,5209,5,11,9,12,45,39,6,42
FC Lugano,5209,6,11,6,15,35,50,-15,39
Grasshoppers,5209,7,10,7,15,41,48,-7,37
FC Thun,5209,8,10,6,16,45,58,-13,36
FC Sion,5209,9,5,8,19,41,62,-21,23
Young Boys,5210,1,21,7,4,69,37,32,70
FC Basel,5210,2,18,8,6,58,27,31,62
FC Zürich,5210,3,12,10,10,43,35,8,46
Lucerne,5210,4,13,7,12,48,48,0,46
St Gallen,5210,5,14,2,16,43,60,-17,44
Grasshoppers,5210,6,12,6,14,43,45,-2,42
FC Lugano,5210,7,10,5,17,32,49,-17,35
FC Thun,5210,8,9,5,18,44,64,-20,32
FC Sion,5210,9,6,8,18,43,58,-15,26
Young Boys,5211,1,21,7,4,69,35,34,70
FC Basel,5211,2,18,7,7,54,23,31,61
FC Zürich,5211,3,12,10,10,45,34,11,46
Lucerne,5211,4,11,9,12,40,45,-5,42
St Gallen,5211,5,13,3,16,40,55,-15,42
Grasshoppers,5211,6,11,7,14,45,49,-4,40
FC Lugano,5211,7,11,5,16,31,49,-18,38
FC Sion,5211,8,8,8,16,45,55,-10,32
FC Thun,5211,9,8,6,18,40,64,-24,30
Young Boys,5212,1,23,6,3,74,34,40,75
FC Basel,5212,2,16,10,6,50,25,25,58
Lucerne,5212,3,13,8,11,43,43,0,47
St Gallen,5212,4,13,3,16,41,56,-15,42
FC Lugano,5212,5,12,5,15,33,47,-14,41
FC Thun,5212,6,11,5,16,46,57,-11,38
FC Zürich,5212,7,9,10,13,39,39,0,37
Grasshoppers,5212,8,10,6,16,42,50,-8,36
FC Sion,5212,9,7,7,18,41,58,-17,28
Young Boys,5213,1,22,7,3,76,36,40,73
FC Basel,5213,2,18,8,6,59,26,33,62
Lucerne,5213,3,12,8,12,41,48,-7,44
St Gallen,5213,4,13,5,14,41,54,-13,44
FC Zürich,5213,5,10,10,12,37,36,1,40
FC Lugano,5213,6,11,5,16,31,49,-18,38
Grasshoppers,5213,7,9,8,15,41,50,-9,35
FC Thun,5213,8,9,7,16,44,59,-15,34
FC Sion,5213,9,6,10,16,42,54,-12,28
Young Boys,5214,1,21,7,4,75,40,35,70
FC Basel,5214,2,17,8,7,57,27,30,59
St Gallen,5214,3,17,2,13,45,51,-6,53
Lucerne,5214,4,11,9,12,40,48,-8,42
FC Zürich,5214,5,10,10,12,40,37,3,40
Grasshoppers,5214,6,11,7,14,48,51,-3,40
FC Lugano,5214,7,11,6,15,33,46,-13,39
FC Sion,5214,8,7,8,17,42,56,-14,29
FC Thun,5214,9,8,5,19,38,62,-24,29
Young Boys,5215,1,19,10,3,68,36,32,67
FC Basel,5215,2,18,8,6,54,25,29,62
St Gallen,5215,3,16,3,13,45,53,-8,51
Lucerne,5215,4,13,8,11,42,42,0,47
FC Zürich,5215,5,10,9,13,41,38,3,39
FC Thun,5215,6,10,7,15,47,59,-12,37
FC Lugano,5215,7,9,6,17,31,53,-22,33
Grasshoppers,5215,8,8,8,16,39,49,-10,32
FC Sion,5215,9,7,9,16,41,53,-12,30
Young Boys,5216,1,22,8,2,73,31,42,74
FC Basel,5216,2,18,8,6,61,24,37,62
Lucerne,5216,3,13,8,11,41,42,-1,47
St Gallen,5216,4,14,2,16,42,58,-16,44
FC Zürich,5216,5,11,10,11,42,40,2,43
Grasshoppers,5216,6,10,8,14,43,48,-5,38
FC Lugano,5216,7,9,6,17,29,50,-21,33
FC Thun,5216,8,8,6,18,41,65,-24,30
FC Sion,5216,9,7,8,17,43,57,-14,29
Young Boys,5217,1,21,6,5,71,37,34,69
FC Basel,5217,2,19,7,6,56,26,30,64
Lucerne,5217,3,13,9,10,42,42,0,48
St Gallen,5217,4,15,3,14,45,55,-10,48
FC Zürich,5217,5,11,10,11,43,38,5,43
Grasshoppers,5217,6,9,9,14,41,48,-7,36
FC Lugano,5217,7,10,6,16,31,48,-17,36
FC Thun,5217,8,8,7,17,41,58,-17,31
FC Sion,5217,9,5,9,18,39,57,-18,24
Young Boys,5218,1,24,6,2,79,37,42,78
FC Basel,5218,2,16,8,8,52,29,23,56
Lucerne,5218,3,14,7,11,44,44,0,49
FC Zürich,5218,4,11,10,11,39,34,5,43
St Gallen,5218,5,13,3,16,40,56,-16,42
Grasshoppers,5218,6,10,6,16,41,50,-9,36
FC Thun,5218,7,10,5,17,45,59,-14,35
FC Lugano,5218,8,10,5,17,32,49,-17,35
FC Sion,5218,9,7,8,17,40,54,-14,29
Young Boys,5219,1,22,7,3,75,34,41,73
FC Basel,5219,2,16,9,7,53,29,24,57
Lucerne,5219,3,13,8,11,42,43,-1,47
St Gallen,5219,4,13,4,15,44,57,-13,43
FC Zürich,5219,5,10,11,11,41,39,2,41
FC Lugano,5219,6,10,6,16,31,51,-20,36
Grasshoppers,5219,7,9,8,15,40,49,-9,35
FC Thun,5219,8,9,8,15,44,56,-12,35
FC Sion,5219,9,6,11,15,38,50,-12,29
Young Boys,5220,1,20,9,3,70,37,33,69
FC Basel,5220,2,18,8,6,57,24,33,62
Lucerne,5220,3,14,7,11,44,44,0,49
St Gallen,5220,4,15,3,14,43,56,-13,48
FC Zürich,5220,5,11,10,11,45,40,5,43
Grasshoppers,5220,6,9,6,17,42,52,-10,33
FC Thun,5220,7,9,6,17,45,61,-16,33
FC Lugano,5220,8,9,6,17,31,50,-19,33
FC Sion,5220,9,7,9,16,41,54,-13,30
Young Boys,5221,1,22,7,3,72,34,38,73
FC Basel,5221,2,17,10,5,55,27,28,61
Lucerne,5221,3,13,8,11,41,44,-3,47
St Gallen,5221,4,14,3,15,44,56,-12,45
FC Zürich,5221,5,10,12,10,41,35,6,42
FC Thun,5221,6,10,7,15,43,56,-13,37
Grasshoppers,5221,7,9,7,16,40,49,-9,34
FC Lugano,5221,8,9,5,18,28,50,-22,32
FC Sion,5221,9,6,9,17,41,54,-13,27
Young Boys,5222,1,20,8,4,69,34,35,68
FC Basel,5222,2,19,8,5,56,23,33,65
St Gallen,5222,3,15,3,14,45,53,-8,48
Lucerne,5222,4,12,9,11,41,42,-1,45
FC Zürich,5222,5,11,9,12,41,39,2,42
Grasshoppers,5222,6,10,6,16,39,49,-10,36
FC Lugano,5222,7,10,5,17,30,51,-21,35
FC Thun,5222,8,9,6,17,46,61,-15,33
FC Sion,5222,9,7,8,17,38,53,-15,29
Young Boys,5223,1,21,7,4,72,37,35,70
FC Basel,5223,2,17,8,7,54,28,26,59
Lucerne,5223,3,14,8,10,46,41,5,50
St Gallen,5223,4,15,3,14,46,57,-11,48
FC Zürich,5223,5,10,10,12,39,37,2,40
FC Lugano,5223,6,11,5,16,32,49,-17,38
FC Thun,5223,7,10,6,16,44,59,-15,36
Grasshoppers,5223,8,9,7,16,39,49,-10,34
FC Sion,5223,9,6,8,18,42,57,-15,26
Young Boys,5224,1,22,7,3,70,35,35,73
FC Basel,5224,2,20,7,5,54,23,31,67
St Gallen,5224,3,14,4,14,40,51,-11,46
Lucerne,5224,4,11,10,11,40,44,-4,43
FC Zürich,5224,5,10,11,11,41,36,5,41
Grasshoppers,5224,6,9,7,16,42,50,-8,34
FC Lugano,5224,7,9,6,17,28,47,-19,33
FC Thun,5224,8,8,8,16,42,58,-16,32
FC Sion,5224,9,6,10,16,40,53,-13,28
Young Boys,5225,1,21,7,4,67,33,34,70
FC Basel,5225,2,18,8,6,53,25,28,62
St Gallen,5225,3,16,2,14,48,56,-8,50
Lucerne,5225,4,12,7,13,42,46,-4,43
FC Zürich,5225,5,10,9,13,40,39,1,39
FC Lugano,5225,6,11,5,16,34,48,-14,38
FC Thun,5225,7,10,6,16,42,57,-15,36
Grasshoppers,5225,8,9,7,16,41,52,-11,34
FC Sion,5225,9,8,7,17,44,55,-11,31
Young Boys,5226,1,22,6,4,69,32,37,72
FC Basel,5226,2,20,7,5,59,26,33,67
Lucerne,5226,3,12,8,12,45,48,-3,44
St Gallen,5226,4,13,4,15,41,55,-14,43
FC Zürich,5226,5,9,12,11,38,36,2,39
FC Lugano,5226,6,10,7,15,33,49,-16,37
Grasshoppers,5226,7,9,7,16,40,50,-10,34
FC Thun,5226,8,9,7,16,42,57,-15,34
FC Sion,5226,9,6,10,16,38,52,-14,28
Young Boys,5227,1,21,6,5,66,35,31,69
FC Basel,5227,2,19,7,6,56,24,32,64
Lucerne,5227,3,13,9,10,45,45,0,48
St Gallen,5227,4,15,3,14,47,57,-10,48
FC Thun,5227,5,12,5,15,45,53,-8,41
FC Zürich,5227,6,9,10,13,38,38,0,37
FC Lugano,5227,7,10,6,16,30,46,-16,36
Grasshoppers,5227,8,8,6,18,38,52,-14,30
FC Sion,5227,9,7,8,17,40,55,-15,29
Young Boys,5228,1,20,7,5,69,37,32,67
FC Basel,5228,2,18,7,7,53,28,25,61
Lucerne,5228,3,13,7,12,40,42,-2,46
FC Zürich,5228,4,11,10,11,44,38,6,43
St Gallen,5228,5,13,3,16,39,56,-17,42
FC Lugano,5228,6,11,7,14,32,45,-13,40
Grasshoppers,5228,7,10,7,15,39,47,-8,37
FC Thun,5228,8,9,6,17,42,58,-16,33
FC Sion,5228,9,8,8,16,44,51,-7,32
Young Boys,5229,1,21,7,4,68,34,34,70
FC Basel,5229,2,17,8,7,52,25,27,59
Lucerne,5229,3,13,9,10,42,42,0,48
St Gallen,5229,4,14,3,15,41,53,-12,45
FC Lugano,5229,5,12,5,15,34,47,-13,41
FC Zürich,5229,6,9,11,12,41,41,0,38
FC Thun,5229,7,10,6,16,46,59,-13,36
Grasshoppers,5229,8,9,7,16,40,50,-10,34
FC Sion,5229,9,6,10,16,43,56,-13,28
Young Boys,5230,1,20,8,4,67,38,29,68
FC Basel,5230,2,17,8,7,53,28,25,59
Lucerne,5230,3,14,8,10,44,40,4,50
FC Zürich,5230,4,12,9,11,45,37,8,45
St Gallen,5230,5,13,2,17,41,58,-17,41
FC Lugano,5230,6,11,6,15,33,47,-14,39
Grasshoppers,5230,7,10,7,15,41,46,-5,37
FC Sion,5230,8,8,7,17,41,54,-13,31
FC Thun,5230,9,8,7,17,42,59,-17,31
Young Boys,5231,1,23,6,3,74,35,39,75
FC Basel,5231,2,16,9,7,50,27,23,57
Lucerne,5231,3,13,9,10,45,43,2,48
St Gallen,5231,4,13,3,16,40,56,-16,42
FC Zürich,5231,5,10,9,13,40,40,0,39
FC Lugano,5231,6,11,6,15,33,48,-15,39
Grasshoppers,5231,7,10,6,16,43,50,-7,36
FC Thun,5231,8,10,5,17,45,58,-13,35
FC Sion,5231,9,8,7,17,43,56,-13,31
Young Boys,5232,1,19,9,4,67,36,31,66
FC Basel,5232,2,18,8,6,52,25,27,62
Lucerne,5232,3,14,8,10,45,42,3,50
St Gallen,5232,4,13,4,15,41,56,-15,43
FC Zürich,5232,5,10,9,13,40,38,2,39
FC Lugano,5232,6,11,6,15,34,48,-14,39
Grasshoppers,5232,7,9,8,15,40,49,-9,35
FC Sion,5232,8,8,9,15,43,51,-8,33
FC Thun,5232,9,9,5,18,43,60,-17,32
Young Boys,5233,1,22,7,3,78,36,42,73
FC Basel,5233,2,17,9,6,51,25,26,60
St Gallen,5233,3,15,2,15,42,55,-13,47
FC Zürich,5233,4,12,10,10,44,36,8,46
Lucerne,5233,5,12,9,11,39,42,-3,45
Grasshoppers,5233,6,9,8,15,44,53,-9,35
FC Thun,5233,7,9,7,16,41,56,-15,34
FC Lugano,5233,8,9,6,17,29,51,-22,33
FC Sion,5233,9,6,8,18,42,56,-14,26
Young Boys,5234,1,22,7,3,72,33,39,73
FC Basel,5234,2,18,7,7,57,27,30,61
Lucerne,5234,3,14,9,9,45,41,4,51
FC Zürich,5234,4,10,11,11,39,36,3,41
St Gallen,5234,5,13,2,17,41,60,-19,41
Grasshoppers,5234,6,11,7,14,43,46,-3,40
FC Lugano,5234,7,10,6,16,30,47,-17,36
FC Thun,5234,8,9,5,18,42,63,-21,32
FC Sion,5234,9,6,8,18,39,55,-16,26
Young Boys,5235,1,21,6,5,67,35,32,69
FC Basel,5235,2,18,8,6,56,27,29,62
Lucerne,5235,3,14,8,10,50,43,7,50
FC Zürich,5235,4,11,10,11,42,37,5,43
St Gallen,5235,5,13,3,16,39,54,-15,42
FC Lugano,5235,6,10,6,16,30,50,-20,36
FC Sion,5235,7,8,9,15,44,51,-7,33
Grasshoppers,5235,8,9,6,17,41,54,-13,33
FC Thun,5235,9,9,6,17,44,62,-18,33
Young Boys,5236,1,22,7,3,71,34,37,73
FC Basel,5236,2,18,8,6,55,25,30,62
Lucerne,5236,3,13,8,11,42,43,-1,47
St Gallen,5236,4,14,2,16,42,57,-15,44
FC Zürich,5236,5,11,10,11,43,37,6,43
FC Lugano,5236,6,10,6,16,31,47,-16,36
FC Sion,5236,7,8,8,16,41,51,-10,32
FC Thun,5236,8,8,8,16,41,59,-18,32
Grasshoppers,5236,9,8,7,17,39,52,-13,31
Young Boys,5237,1,23,7,2,74,32,42,76
FC Basel,5237,2,17,7,8,51,28,23,58
St Gallen,5237,3,15,2,15,43,55,-12,47
Lucerne,5237,4,12,9,11,44,45,-1,45
FC Zürich,5237,5,11,11,10,44,34,10,44
Grasshoppers,5237,6,9,7,16,43,51,-8,34
FC Lugano,5237,7,9,7,16,27,48,-21,34
FC Thun,5237,8,9,6,17,46,62,-16,33
FC Sion,5237,9,7,8,17,43,60,-17,29
Young Boys,5238,1,22,7,3,73,34,39,73
FC Basel,5238,2,19,7,6,56,24,32,64
St Gallen,5238,3,14,2,16,40,55,-15,44
Lucerne,5238,4,12,7,13,38,48,-10,43
FC Lugano,5238,5,11,7,14,33,44,-11,40
FC Zürich,5238,6,9,11,12,39,38,1,38
Grasshoppers,5238,7,10,6,16,45,49,-4,36
FC Thun,5238,8,10,5,17,41,59,-18,35
FC Sion,5238,9,7,8,17,42,56,-14,29
Young Boys,5239,1,21,7,4,68,33,35,70
FC Basel,5239,2,19,7,6,53,24,29,64
Lucerne,5239,3,14,8,10,45,42,3,50
St Gallen,5239,4,14,3,15,41,54,-13,45
FC Zürich,5239,5,11,10,11,45,36,9,43
Grasshoppers,5239,6,10,6,16,43,49,-6,36
FC Thun,5239,7,10,5,17,45,58,-13,35
FC Lugano,5239,8,9,6,17,29,52,-23,33
FC Sion,5239,9,6,8,18,37,58,-21,26
Young Boys,5240,1,23,6,3,76,32,44,75
FC Basel,5240,2,16,8,8,51,27,24,56
St Gallen,5240,3,17,2,13,49,53,-4,53
Lucerne,5240,4,13,9,10,46,45,1,48
FC Zürich,5240,5,12,10,10,43,34,9,46
Grasshoppers,5240,6,10,7,15,46,53,-7,37
FC Lugano,5240,7,9,5,18,29,55,-26,32
FC Thun,5240,8,8,6,18,42,62,-20,30
FC Sion,5240,9,6,7,19,37,58,-21,25
Young Boys,5241,1,22,7,3,74,33,41,73
FC Basel,5241,2,18,8,6,54,26,28,62
Lucerne,5241,3,14,7,11,45,40,5,49
St Gallen,5241,4,14,3,15,41,58,-17,45
FC Zürich,5241,5,11,10,11,39,35,4,43
FC Thun,5241,6,10,6,16,45,59,-14,36
FC Lugano,5241,7,10,5,17,30,49,-19,35
Grasshoppers,5241,8,8,7,17,39,53,-14,31
FC Sion,5241,9,6,9,17,38,52,-14,27
Young Boys,5242,1,23,6,3,71,33,38,75
FC Basel,5242,2,17,8,7,52,27,25,59
Lucerne,5242,3,13,8,11,41,42,-1,47
FC Zürich,5242,4,11,10,11,41,36,5,43
St Gallen,5242,5,13,3,16,43,58,-15,42
FC Thun,5242,6,11,6,15,44,54,-10,39
FC Lugano,5242,7,10,6,16,29,47,-18,36
Grasshoppers,5242,8,9,6,17,41,52,-11,33
FC Sion,5242,9,7,7,18,39,52,-13,28
Young Boys,5243,1,20,9,3,73,35,38,69
FC Basel,5243,2,17,10,5,52,24,28,61
St Gallen,5243,3,15,3,14,45,53,-8,48
Lucerne,5243,4,11,9,12,38,43,-5,42
FC Lugano,5243,5,11,6,15,32,47,-15,39
FC Zürich,5243,6,9,10,13,37,38,-1,37
Grasshoppers,5243,7,9,9,14,44,51,-7,36
FC Thun,5243,8,10,6,16,46,58,-12,36
FC Sion,5243,9,7,8,17,42,60,-18,29
Young Boys,5244,1,22,7,3,70,33,37,73
FC Basel,5244,2,17,9,6,54,24,30,60
St Gallen,5244,3,16,3,13,44,51,-7,51
Lucerne,5244,4,13,7,12,42,45,-3,46
FC Zürich,5244,5,10,11,11,41,35,6,41
Grasshoppers,5244,6,10,6,16,42,50,-8,36
FC Lugano,5244,7,10,6,16,29,46,-17,36
FC Thun,5244,8,9,5,18,43,64,-21,32
FC Sion,5244,9,6,8,18,40,57,-17,26
Young Boys,5245,1,20,7,5,75,43,32,67
FC Basel,5245,2,18,8,6,56,27,29,62
Lucerne,5245,3,15,8,9,45,42,3,53
St Gallen,5245,4,13,4,15,41,55,-14,43
FC Zürich,5245,5,10,10,12,39,39,0,40
Grasshoppers,5245,6,10,7,15,43,54,-11,37
FC Thun,5245,7,10,5,17,49,58,-9,35
FC Lugano,5245,8,9,7,16,32,49,-17,34
FC Sion,5245,9,7,8,17,41,54,-13,29
Young Boys,5246,1,23,7,2,75,32,43,76
FC Basel,5246,2,16,10,6,50,25,25,58
Lucerne,5246,3,14,8,10,47,43,4,50
St Gallen,5246,4,14,3,15,42,55,-13,45
FC Zürich,5246,5,11,11,10,45,37,8,44
FC Thun,5246,6,10,7,15,44,57,-13,37
Grasshoppers,5246,7,9,6,17,40,53,-13,33
FC Lugano,5246,8,9,5,18,29,51,-22,32
FC Sion,5246,9,6,7,19,41,60,-19,25
Young Boys,5247,1,22,6,4,72,34,38,72
FC Basel,5247,2,18,8,6,53,23,30,62
Lucerne,5247,3,14,7,11,40,41,-1,49
St Gallen,5247,4,13,2,17,41,57,-16,41
FC Zürich,5247,5,10,10,12,39,36,3,40
FC Thun,5247,6,11,5,16,44,59,-15,38
FC Lugano,5247,7,11,5,16,31,47,-16,38
Grasshoppers,5247,8,9,7,16,40,52,-12,34
FC Sion,5247,9,7,8,17,42,53,-11,29
Young Boys,5248,1,21,7,4,67,38,29,70
FC Basel,5248,2,19,7,6,60,27,33,64
Lucerne,5248,3,13,7,12,44,44,0,46
FC Zürich,5248,4,12,9,11,42,36,6,45
St Gallen,5248,5,14,3,15,44,57,-13,45
FC Lugano,5248,6,11,5,16,36,51,-15,38
Grasshoppers,5248,7,10,6,16,43,49,-6,36
FC Thun,5248,8,9,6,17,43,61,-18,33
FC Sion,5248,9,5,10,17,37,53,-16,25
Young Boys,5249,1,20,6,6,73,44,29,66
FC Basel,5249,2,17,10,5,57,27,30,61
Lucerne,5249,3,13,7,12,44,50,-6,46
St Gallen,5249,4,14,4,14,47,55,-8,46
FC Zürich,5249,5,11,10,11,40,36,4,43
Grasshoppers,5249,6,12,6,14,49,49,0,42
FC Thun,5249,7,10,6,16,46,59,-13,36
FC Lugano,5249,8,9,6,17,28,49,-21,33
FC Sion,5249,9,7,7,18,44,59,-15,28
Young Boys,5250,1,21,8,3,72,36,36,71
FC Basel,5250,2,19,8,5,57,25,32,65
Lucerne,5250,3,12,9,11,41,44,-3,45
St Gallen,5250,4,14,2,16,43,57,-14,44
FC Zürich,5250,5,9,13,10,38,34,4,40
FC Lugano,5250,6,10,7,15,32,49,-17,37
FC Thun,5250,7,9,7,16,41,56,-15,34
Grasshoppers,5250,8,8,7,17,41,53,-12,31
FC Sion,5250,9,6,11,15,40,51,-11,29
Young Boys,5251,1,22,7,3,71,38,33,73
FC Basel,5251,2,19,7,6,56,22,34,64
St Gallen,5251,3,14,3,15,42,55,-13,45
Lucerne,5251,4,12,7,13,44,45,-1,43
FC Zürich,5251,5,10,10,12,42,39,3,40
FC Thun,5251,6,10,7,15,46,58,-12,37
Grasshoppers,5251,7,9,7,16,42,51,-9,34
FC Lugano,5251,8,9,7,16,30,52,-22,34
FC Sion,5251,9,7,9,16,46,59,-13,30
Young Boys,5252,1,20,9,3,71,37,34,69
FC Basel,5252,2,18,8,6,55,23,32,62
St Gallen,5252,3,15,4,13,43,52,-9,49
Lucerne,5252,4,13,8,11,44,44,0,47
FC Zürich,5252,5,10,10,12,38,35,3,40
FC Thun,5252,6,10,6,16,43,61,-18,36
FC Lugano,5252,7,9,8,15,30,48,-18,35
Grasshoppers,5252,8,8,7,17,41,52,-11,31
FC Sion,5252,9,7,8,17,45,58,-13,29
Young Boys,5253,1,23,7,2,71,32,39,76
FC Basel,5253,2,18,7,7,56,25,31,61
Lucerne,5253,3,12,9,11,43,46,-3,45
St Gallen,5253,4,14,3,15,42,54,-12,45
FC Zürich,5253,5,10,10,12,41,38,3,40
FC Lugano,5253,6,11,6,15,34,49,-15,39
FC Thun,5253,7,9,6,17,44,66,-22,33
Grasshoppers,5253,8,8,8,16,42,52,-10,32
FC Sion,5253,9,6,10,16,41,52,-11,28
Young Boys,5254,1,21,9,2,74,34,40,72
FC Basel,5254,2,18,8,6,56,25,31,62
Lucerne,5254,3,12,9,11,41,45,-4,45
FC Zürich,5254,4,11,10,11,41,35,6,43
St Gallen,5254,5,13,3,16,42,59,-17,42
Grasshoppers,5254,6,10,6,16,43,54,-11,36
FC Lugano,5254,7,9,9,14,31,46,-15,36
FC Thun,5254,8,9,5,18,42,61,-19,32
FC Sion,5254,9,8,7,17,42,53,-11,31
FC Basel,5255,1,20,7,5,60,23,37,67
Young Boys,5255,2,20,7,5,69,36,33,67
Lucerne,5255,3,14,8,10,44,42,2,50
St Gallen,5255,4,13,4,15,40,55,-15,43
FC Zürich,5255,5,10,9,13,39,37,2,39
Grasshoppers,5255,6,11,6,15,41,46,-5,39
FC Lugano,5255,7,10,6,16,30,47,-17,36
FC Thun,5255,8,9,6,17,41,62,-21,33
FC Sion,5255,9,6,9,17,38,54,-16,27
Young Boys,5256,1,23,7,2,76,33,43,76
FC Basel,5256,2,17,10,5,54,24,30,61
St Gallen,5256,3,15,3,14,42,55,-13,48
Lucerne,5256,4,11,9,12,40,49,-9,42
FC Zürich,5256,5,10,10,12,41,37,4,40
Grasshoppers,5256,6,9,7,16,42,51,-9,34
FC Lugano,5256,7,9,6,17,31,50,-19,33
FC Sion,5256,8,8,8,16,39,50,-11,32
FC Thun,5256,9,8,8,16,43,59,-16,32
Young Boys,5257,1,23,7,2,73,31,42,76
FC Basel,5257,2,17,9,6,52,25,27,60
Lucerne,5257,3,12,9,11,49,49,0,45
St Gallen,5257,4,14,3,15,46,62,-16,45
FC Zürich,5257,5,11,10,11,43,38,5,43
Grasshoppers,5257,6,10,6,16,44,54,-10,36
FC Lugano,5257,7,10,6,16,38,50,-12,36
FC Thun,5257,8,9,6,17,43,60,-17,33
FC Sion,5257,9,6,8,18,41,60,-19,26
Young Boys,5258,1,21,8,3,70,36,34,71
FC Basel,5258,2,19,8,5,55,23,32,65
St Gallen,5258,3,14,3,15,42,55,-13,45
Lucerne,5258,4,11,11,10,43,45,-2,44
FC Zürich,5258,5,11,10,11,40,33,7,43
Grasshoppers,5258,6,10,7,15,44,50,-6,37
FC Lugano,5258,7,10,7,15,33,49,-16,37
FC Thun,5258,8,9,5,18,42,62,-20,32
FC Sion,5258,9,6,7,19,40,56,-16,25
Young Boys,5259,1,22,6,4,79,35,44,72
FC Basel,5259,2,17,8,7,51,28,23,59
Lucerne,5259,3,15,7,10,44,41,3,52
St Gallen,5259,4,15,2,15,45,56,-11,47
FC Zürich,5259,5,11,11,10,44,34,10,44
FC Thun,5259,6,10,7,15,46,58,-12,37
Grasshoppers,5259,7,9,6,17,40,52,-12,33
FC Lugano,5259,8,9,5,18,29,56,-27,32
FC Sion,5259,9,6,8,18,40,58,-18,26
Young Boys,5260,1,23,6,3,70,33,37,75
FC Basel,5260,2,16,9,7,52,28,24,57
St Gallen,5260,3,15,2,15,44,55,-11,47
FC Zürich,5260,4,11,9,12,43,38,5,42
Lucerne,5260,5,11,9,12,38,43,-5,42
Grasshoppers,5260,6,11,6,15,43,47,-4,39
FC Thun,5260,7,10,6,16,46,57,-11,36
FC Lugano,5260,8,9,6,17,28,52,-24,33
FC Sion,5260,9,8,7,17,42,53,-11,31
Young Boys,5261,1,24,6,2,72,31,41,78
FC Basel,5261,2,17,8,7,56,31,25,59
St Gallen,5261,3,15,2,15,43,56,-13,47
Lucerne,5261,4,12,8,12,42,48,-6,44
FC Zürich,5261,5,11,9,12,42,36,6,42
FC Lugano,5261,6,10,6,16,31,49,-18,36
Grasshoppers,5261,7,9,7,16,41,49,-8,34
FC Thun,5261,8,9,7,16,45,61,-16,34
FC Sion,5261,9,7,7,18,42,53,-11,28
Young Boys,5262,1,21,9,2,73,36,37,72
FC Basel,5262,2,17,10,5,57,25,32,61
Lucerne,5262,3,12,9,11,43,45,-2,45
St Gallen,5262,4,14,3,15,42,57,-15,45
FC Lugano,5262,5,11,6,15,33,46,-13,39
FC Zürich,5262,6,9,10,13,39,40,-1,37
Grasshoppers,5262,7,9,7,16,42,53,-11,34
FC Thun,5262,8,9,7,16,46,62,-16,34
FC Sion,5262,9,7,9,16,42,53,-11,30
Young Boys,5263,1,21,7,4,71,37,34,70
FC Basel,5263,2,17,9,6,53,26,27,60
Lucerne,5263,3,13,9,10,45,43,2,48
St Gallen,5263,4,14,5,13,47,55,-8,47
FC Lugano,5263,5,11,5,16,30,47,-17,38
FC Zürich,5263,6,9,10,13,39,38,1,37
FC Thun,5263,7,10,6,16,45,60,-15,36
Grasshoppers,5263,8,9,7,16,40,51,-11,34
FC Sion,5263,9,7,8,17,45,58,-13,29
Young Boys,5264,1,21,7,4,73,38,35,70
FC Basel,5264,2,18,8,6,57,27,30,62
St Gallen,5264,3,16,2,14,49,53,-4,50
FC Zürich,5264,4,11,11,10,44,36,8,44
Lucerne,5264,5,12,7,13,42,53,-11,43
Grasshoppers,5264,6,10,7,15,42,48,-6,37
FC Lugano,5264,7,10,7,15,32,47,-15,37
FC Sion,5264,8,7,8,17,39,55,-16,29
FC Thun,5264,9,8,5,19,38,59,-21,29
Young Boys,5265,1,20,8,4,68,37,31,68
FC Basel,5265,2,20,7,5,62,25,37,67
Lucerne,5265,3,13,7,12,44,44,0,46
St Gallen,5265,4,14,3,15,44,57,-13,45
FC Zürich,5265,5,11,10,11,46,40,6,43
Grasshoppers,5265,6,11,7,14,45,48,-3,40
FC Lugano,5265,7,10,7,15,33,48,-15,37
FC Thun,5265,8,9,5,18,42,63,-21,32
FC Sion,5265,9,5,8,19,36,58,-22,23
Young Boys,5266,1,22,6,4,70,34,36,72
FC Basel,5266,2,18,7,7,57,26,31,61
St Gallen,5266,3,16,2,14,46,54,-8,50
Lucerne,5266,4,14,7,11,49,48,1,49
FC Zürich,5266,5,12,9,11,42,36,6,45
FC Lugano,5266,6,10,5,17,31,50,-19,35
Grasshoppers,5266,7,9,6,17,41,53,-12,33
FC Thun,5266,8,9,6,17,41,58,-17,33
FC Sion,5266,9,6,8,18,36,54,-18,26
Young Boys,5267,1,22,6,4,71,36,35,72
FC Basel,5267,2,17,9,6,54,26,28,60
St Gallen,5267,3,15,3,14,44,50,-6,48
Lucerne,5267,4,13,8,11,42,46,-4,47
FC Zürich,5267,5,9,12,11,38,35,3,39
FC Lugano,5267,6,11,5,16,30,46,-16,38
FC Thun,5267,7,9,6,17,42,59,-17,33
FC Sion,5267,8,7,10,15,37,48,-11,31
Grasshoppers,5267,9,8,7,17,40,52,-12,31
Young Boys,5268,1,21,8,3,71,34,37,71
FC Basel,5268,2,17,8,7,50,24,26,59
St Gallen,5268,3,14,4,14,42,52,-10,46
FC Zürich,5268,4,11,10,11,43,36,7,43
FC Lugano,5268,5,12,6,14,33,45,-12,42
Lucerne,5268,6,11,8,13,40,47,-7,41
FC Thun,5268,7,11,5,16,48,59,-11,38
Grasshoppers,5268,8,10,7,15,45,54,-9,37
FC Sion,5268,9,5,8,19,37,58,-21,23
Young Boys,5269,1,22,7,3,73,34,39,73
FC Basel,5269,2,18,8,6,54,25,29,62
St Gallen,5269,3,15,2,15,45,56,-11,47
FC Zürich,5269,4,12,10,10,42,34,8,46
Lucerne,5269,5,12,9,11,42,46,-4,45
FC Thun,5269,6,10,5,17,47,61,-14,35
Grasshoppers,5269,7,9,7,16,41,50,-9,34
FC Lugano,5269,8,9,7,16,30,47,-17,34
FC Sion,5269,9,6,7,19,39,60,-21,25
Young Boys,5270,1,22,7,3,71,32,39,73
FC Basel,5270,2,17,9,6,53,26,27,60
St Gallen,5270,3,15,3,14,48,56,-8,48
Lucerne,5270,4,13,8,11,43,45,-2,47
FC Zürich,5270,5,10,11,11,39,35,4,41
Grasshoppers,5270,6,10,7,15,41,50,-9,37
FC Thun,5270,7,9,8,15,45,57,-12,35
FC Lugano,5270,8,10,5,17,30,50,-20,35
FC Sion,5270,9,5,8,19,36,55,-19,23
Young Boys,5271,1,23,6,3,74,35,39,75
FC Basel,5271,2,17,10,5,56,27,29,61
St Gallen,5271,3,14,4,14,42,54,-12,46
Lucerne,5271,4,11,10,11,39,43,-4,43
FC Zürich,5271,5,10,10,12,43,43,0,40
FC Thun,5271,6,11,6,15,50,60,-10,39
Grasshoppers,5271,7,10,6,16,40,47,-7,36
FC Lugano,5271,8,10,6,16,33,47,-14,36
FC Sion,5271,9,5,8,19,41,62,-21,23
Young Boys,5272,1,22,7,3,74,33,41,73
FC Basel,5272,2,19,7,6,57,25,32,64
St Gallen,5272,3,16,2,14,45,54,-9,50
Lucerne,5272,4,14,7,11,43,42,1,49
FC Zürich,5272,5,11,10,11,47,39,8,43
Grasshoppers,5272,6,10,7,15,44,51,-7,37
FC Thun,5272,7,9,6,17,43,61,-18,33
FC Lugano,5272,8,9,5,18,30,53,-23,32
FC Sion,5272,9,5,7,20,36,61,-25,22
Young Boys,5273,1,22,7,3,75,37,38,73
FC Basel,5273,2,18,9,5,58,24,34,63
Lucerne,5273,3,13,9,10,46,45,1,48
St Gallen,5273,4,14,3,15,45,57,-12,45
FC Zürich,5273,5,10,12,10,42,34,8,42
Grasshoppers,5273,6,9,8,15,41,50,-9,35
FC Lugano,5273,7,9,6,17,30,52,-22,33
FC Thun,5273,8,8,6,18,40,62,-22,30
FC Sion,5273,9,7,8,17,42,58,-16,29
Young Boys,5274,1,23,6,3,78,37,41,75
FC Basel,5274,2,19,8,5,64,29,35,65
Lucerne,5274,3,12,9,11,42,46,-4,45
St Gallen,5274,4,13,5,14,46,58,-12,44
FC Zürich,5274,5,11,9,12,42,38,4,42
FC Lugano,5274,6,10,7,15,31,46,-15,37
Grasshoppers,5274,7,9,6,17,41,53,-12,33
FC Thun,5274,8,9,6,17,42,58,-16,33
FC Sion,5274,9,6,8,18,39,60,-21,26
Young Boys,5275,1,24,6,2,81,35,46,78
FC Basel,5275,2,18,8,6,56,28,28,62
St Gallen,5275,3,14,3,15,43,57,-14,45
FC Zürich,5275,4,11,10,11,42,35,7,43
Lucerne,5275,5,11,8,13,41,47,-6,41
Grasshoppers,5275,6,10,7,15,41,47,-6,37
FC Lugano,5275,7,10,7,15,31,50,-19,37
FC Thun,5275,8,8,6,18,39,60,-21,30
FC Sion,5275,9,7,7,18,44,59,-15,28
Young Boys,5276,1,22,7,3,73,34,39,73
FC Basel,5276,2,16,10,6,51,27,24,58
Lucerne,5276,3,13,8,11,41,42,-1,47
St Gallen,5276,4,13,4,15,42,56,-14,43
FC Zürich,5276,5,10,11,11,42,39,3,41
FC Lugano,5276,6,12,5,15,34,48,-14,41
FC Thun,5276,7,10,6,16,46,59,-13,36
Grasshoppers,5276,8,9,6,17,41,51,-10,33
FC Sion,5276,9,7,7,18,46,60,-14,28
Young Boys,5277,1,22,6,4,69,37,32,72
FC Basel,5277,2,17,9,6,54,24,30,60
St Gallen,5277,3,17,2,13,44,50,-6,53
FC Zürich,5277,4,11,10,11,43,37,6,43
Lucerne,5277,5,12,7,13,40,46,-6,43
FC Thun,5277,6,10,6,16,45,58,-13,36
Grasshoppers,5277,7,9,7,16,39,50,-11,34
FC Lugano,5277,8,9,5,18,29,50,-21,32
FC Sion,5277,9,7,8,17,39,50,-11,29
Young Boys,5278,1,20,7,5,68,39,29,67
FC Basel,5278,2,19,7,6,64,26,38,64
Lucerne,5278,3,13,7,12,43,46,-3,46
St Gallen,5278,4,14,3,15,43,63,-20,45
FC Zürich,5278,5,10,9,13,40,44,-4,39
FC Lugano,5278,6,11,6,15,34,47,-13,39
FC Thun,5278,7,10,6,16,45,58,-13,36
Grasshoppers,5278,8,9,8,15,44,50,-6,35
FC Sion,5278,9,7,9,16,43,51,-8,30
Young Boys,5279,1,23,6,3,79,34,45,75
FC Basel,5279,2,18,8,6,53,25,28,62
St Gallen,5279,3,15,2,15,43,58,-15,47
Lucerne,5279,4,12,8,12,43,48,-5,44
FC Zürich,5279,5,11,10,11,41,34,7,43
FC Lugano,5279,6,10,6,16,32,46,-14,36
Grasshoppers,5279,7,9,8,15,40,48,-8,35
FC Thun,5279,8,9,7,16,42,59,-17,34
FC Sion,5279,9,5,9,18,37,58,-21,24
Young Boys,5280,1,21,7,4,74,38,36,70
FC Basel,5280,2,19,8,5,55,22,33,65
St Gallen,5280,3,16,3,13,46,51,-5,51
Lucerne,5280,4,12,8,12,42,44,-2,44
FC Zürich,5280,5,9,12,11,39,36,3,39
Grasshoppers,5280,6,10,6,16,40,49,-9,36
FC Lugano,5280,7,9,6,17,28,52,-24,33
FC Thun,5280,8,8,7,17,40,59,-19,31
FC Sion,5280,9,7,9,16,41,54,-13,30
Young Boys,5281,1,21,8,3,70,35,35,71
FC Basel,5281,2,19,8,5,55,24,31,65
Lucerne,5281,3,13,8,11,43,45,-2,47
St Gallen,5281,4,14,4,14,42,53,-11,46
FC Zürich,5281,5,10,10,12,44,41,3,40
Grasshoppers,5281,6,9,7,16,42,50,-8,34
FC Lugano,5281,7,9,7,16,31,48,-17,34
FC Thun,5281,8,8,7,17,43,61,-18,31
FC Sion,5281,9,7,9,16,43,56,-13,30
Young Boys,5282,1,23,6,3,70,32,38,75
FC Basel,5282,2,19,7,6,56,23,33,64
Lucerne,5282,3,13,8,11,43,42,1,47
St Gallen,5282,4,14,4,14,43,55,-12,46
FC Zürich,5282,5,10,10,12,41,39,2,40
FC Lugano,5282,6,10,6,16,30,48,-18,36
Grasshoppers,5282,7,9,7,16,40,49,-9,34
FC Thun,5282,8,8,7,17,41,62,-21,31
FC Sion,5282,9,6,9,17,43,57,-14,27
Young Boys,5283,1,23,6,3,77,34,43,75
FC Basel,5283,2,17,7,8,53,29,24,58
St Gallen,5283,3,15,4,13,44,53,-9,49
Lucerne,5283,4,12,9,11,39,43,-4,45
FC Zürich,5283,5,11,11,10,44,36,8,44
FC Lugano,5283,6,10,7,15,32,49,-17,37
FC Thun,5283,7,9,6,17,43,60,-17,33
Grasshoppers,5283,8,8,6,18,37,52,-15,30
FC Sion,5283,9,7,8,17,41,54,-13,29
Young Boys,5284,1,21,7,4,70,36,34,70
FC Basel,5284,2,18,9,5,57,27,30,63
Lucerne,5284,3,12,9,11,40,44,-4,45
St Gallen,5284,4,13,3,16,42,57,-15,42
FC Zürich,5284,5,10,10,12,42,40,2,40
Grasshoppers,5284,6,10,8,14,46,48,-2,38
FC Thun,5284,7,10,5,17,44,60,-16,35
FC Lugano,5284,8,10,5,17,31,48,-17,35
FC Sion,5284,9,8,8,16,41,53,-12,32
Young Boys,5285,1,22,7,3,73,36,37,73
FC Basel,5285,2,17,7,8,56,31,25,58
St Gallen,5285,3,16,3,13,44,52,-8,51
FC Zürich,5285,4,13,9,10,45,35,10,48
Lucerne,5285,5,12,7,13,39,46,-7,43
FC Lugano,5285,6,10,7,15,31,45,-14,37
Grasshoppers,5285,7,10,6,16,42,49,-7,36
FC Thun,5285,8,9,5,18,46,65,-19,32
FC Sion,5285,9,6,7,19,42,59,-17,25
Young Boys,5286,1,21,7,4,67,33,34,70
FC Basel,5286,2,18,7,7,56,31,25,61
Lucerne,5286,3,13,8,11,45,44,1,47
St Gallen,5286,4,14,4,14,43,54,-11,46
Grasshoppers,5286,5,12,6,14,41,45,-4,42
FC Zürich,5286,6,10,10,12,42,41,1,40
FC Lugano,5286,7,9,7,16,31,49,-18,34
FC Thun,5286,8,9,6,17,45,60,-15,33
FC Sion,5286,9,6,9,17,40,53,-13,27
Young Boys,5287,1,19,8,5,67,40,27,65
FC Basel,5287,2,17,10,5,54,26,28,61
St Gallen,5287,3,15,3,14,45,55,-10,48
Lucerne,5287,4,12,9,11,42,45,-3,45
FC Zürich,5287,5,10,11,11,42,36,6,41
FC Lugano,5287,6,11,6,15,33,46,-13,39
Grasshoppers,5287,7,9,9,14,41,48,-7,36
FC Thun,5287,8,9,5,18,42,60,-18,32
FC Sion,5287,9,7,9,16,44,54,-10,30
Young Boys,5288,1,21,8,3,69,32,37,71
FC Basel,5288,2,17,8,7,51,28,23,59
Lucerne,5288,3,12,8,12,41,44,-3,44
FC Zürich,5288,4,11,10,11,42,35,7,43
St Gallen,5288,5,13,3,16,43,58,-15,42
FC Lugano,5288,6,11,6,15,34,49,-15,39
Grasshoppers,5288,7,10,7,15,41,47,-6,37
FC Thun,5288,8,9,7,16,44,57,-13,34
FC Sion,5288,9,7,9,16,40,55,-15,30
Young Boys,5289,1,20,8,4,70,37,33,68
FC Basel,5289,2,18,7,7,52,27,25,61
St Gallen,5289,3,16,2,14,44,52,-8,50
FC Zürich,5289,4,12,10,10,43,36,7,46
Lucerne,5289,5,12,8,12,42,45,-3,44
Grasshoppers,5289,6,10,7,15,43,50,-7,37
FC Lugano,5289,7,10,6,16,33,49,-16,36
FC Thun,5289,8,9,6,17,43,59,-16,33
FC Sion,5289,9,5,10,17,41,56,-15,25
Young Boys,5290,1,21,7,4,68,37,31,70
FC Basel,5290,2,18,9,5,56,26,30,63
St Gallen,5290,3,15,3,14,43,53,-10,48
Lucerne,5290,4,13,7,12,39,42,-3,46
FC Zürich,5290,5,11,10,11,47,36,11,43
FC Thun,5290,6,10,6,16,43,58,-15,36
FC Lugano,5290,7,10,6,16,30,46,-16,36
Grasshoppers,5290,8,9,7,16,39,49,-10,34
FC Sion,5290,9,6,7,19,40,58,-18,25
Young Boys,5291,1,22,7,3,72,35,37,73
FC Basel,5291,2,18,8,6,53,25,28,62
St Gallen,5291,3,15,3,14,42,51,-9,48
Lucerne,5291,4,13,8,11,43,40,3,47
FC Zürich,5291,5,12,10,10,45,35,10,46
Grasshoppers,5291,6,10,6,16,42,48,-6,36
FC Thun,5291,7,9,6,17,40,59,-19,33
FC Lugano,5291,8,9,5,18,28,53,-25,32
FC Sion,5291,9,5,9,18,38,57,-19,24
Young Boys,5292,1,24,6,2,74,30,44,78
FC Basel,5292,2,17,8,7,53,27,26,59
St Gallen,5292,3,14,4,14,44,54,-10,46
Lucerne,5292,4,12,8,12,39,44,-5,44
FC Zürich,5292,5,11,9,12,42,37,5,42
FC Lugano,5292,6,11,5,16,32,48,-16,38
FC Sion,5292,7,8,8,16,42,54,-12,32
FC Thun,5292,8,9,5,18,43,61,-18,32
Grasshoppers,5292,9,8,7,17,40,54,-14,31
Young Boys,5293,1,22,7,3,72,33,39,73
FC Basel,5293,2,17,8,7,49,24,25,59
Lucerne,5293,3,15,7,10,47,42,5,52
FC Zürich,5293,4,11,9,12,42,37,5,42
St Gallen,5293,5,13,3,16,39,57,-18,42
FC Lugano,5293,6,11,5,16,32,49,-17,38
FC Thun,5293,7,10,6,16,43,59,-16,36
FC Sion,5293,8,7,9,16,43,52,-9,30
Grasshoppers,5293,9,8,6,18,38,52,-14,30
Young Boys,5294,1,20,9,3,67,34,33,69
FC Basel,5294,2,18,9,5,56,25,31,63
St Gallen,5294,3,15,3,14,43,54,-11,48
Lucerne,5294,4,12,11,9,43,43,0,47
FC Zürich,5294,5,10,10,12,41,41,0,40
FC Thun,5294,6,11,5,16,47,59,-12,38
FC Lugano,5294,7,10,5,17,33,48,-15,35
Grasshoppers,5294,8,8,9,15,39,48,-9,33
FC Sion,5294,9,5,9,18,38,55,-17,24
Young Boys,5295,1,22,8,2,70,31,39,74
FC Basel,5295,2,16,9,7,52,30,22,57
Lucerne,5295,3,14,7,11,46,42,4,49
St Gallen,5295,4,14,2,16,41,56,-15,44
FC Zürich,5295,5,11,9,12,43,41,2,42
FC Thun,5295,6,10,7,15,47,59,-12,37
FC Lugano,5295,7,10,5,17,32,50,-18,35
FC Sion,5295,8,8,8,16,42,53,-11,32
Grasshoppers,5295,9,8,7,17,40,51,-11,31
Young Boys,5296,1,23,7,2,71,30,41,76
FC Basel,5296,2,17,8,7,53,27,26,59
Lucerne,5296,3,14,8,10,44,40,4,50
St Gallen,5296,4,14,3,15,40,56,-16,45
FC Zürich,5296,5,11,9,12,40,36,4,42
FC Lugano,5296,6,10,5,17,28,46,-18,35
Grasshoppers,5296,7,9,6,17,39,51,-12,33
FC Thun,5296,8,9,5,18,44,62,-18,32
FC Sion,5296,9,8,7,17,44,55,-11,31
Young Boys,5297,1,21,8,3,69,35,34,71
FC Basel,5297,2,19,7,6,56,27,29,64
St Gallen,5297,3,15,3,14,46,55,-9,48
Lucerne,5297,4,13,7,12,41,42,-1,46
FC Zürich,5297,5,11,10,11,40,35,5,43
FC Lugano,5297,6,10,7,15,32,47,-15,37
Grasshoppers,5297,7,9,6,17,39,49,-10,33
FC Thun,5297,8,9,5,18,42,60,-18,32
FC Sion,5297,9,6,9,17,36,51,-15,27
Young Boys,5298,1,20,6,6,70,40,30,66
FC Basel,5298,2,17,8,7,56,30,26,59
St Gallen,5298,3,15,4,13,48,55,-7,49
FC Zürich,5298,4,12,10,10,42,33,9,46
Lucerne,5298,5,12,9,11,40,43,-3,45
FC Thun,5298,6,10,7,15,47,57,-10,37
FC Lugano,5298,7,10,7,15,31,47,-16,37
Grasshoppers,5298,8,9,8,15,43,51,-8,35
FC Sion,5298,9,6,7,19,39,60,-21,25
Young Boys,5299,1,21,8,3,73,36,37,71
FC Basel,5299,2,17,8,7,55,26,29,59
Lucerne,5299,3,13,8,11,45,49,-4,47
St Gallen,5299,4,15,2,15,48,61,-13,47
FC Zürich,5299,5,11,11,10,44,34,10,44
FC Thun,5299,6,10,5,17,45,62,-17,35
FC Lugano,5299,7,10,5,17,32,54,-22,35
Grasshoppers,5299,8,8,9,15,41,50,-9,33
FC Sion,5299,9,6,10,16,46,57,-11,28
Young Boys,5300,1,20,9,3,70,36,34,69
FC Basel,5300,2,17,8,7,50,25,25,59
Lucerne,5300,3,13,10,9,43,41,2,49
St Gallen,5300,4,15,3,14,43,52,-9,48
FC Zürich,5300,5,11,10,11,41,36,5,43
FC Lugano,5300,6,10,8,14,33,46,-13,38
Grasshoppers,5300,7,9,7,16,44,54,-10,34
FC Thun,5300,8,9,5,18,46,63,-17,32
FC Sion,5300,9,6,8,18,41,58,-17,26
Young Boys,5301,1,23,6,3,76,32,44,75
FC Basel,5301,2,18,8,6,54,26,28,62
Lucerne,5301,3,13,7,12,43,46,-3,46
St Gallen,5301,4,14,4,14,46,57,-11,46
FC Zürich,5301,5,11,10,11,44,37,7,43
FC Thun,5301,6,10,6,16,45,57,-12,36
FC Lugano,5301,7,10,6,16,33,50,-17,36
Grasshoppers,5301,8,9,6,17,37,50,-13,33
FC Sion,5301,9,6,7,19,39,62,-23,25
Young Boys,5302,1,21,7,4,70,36,34,70
FC Basel,5302,2,16,8,8,50,25,25,56
Lucerne,5302,3,13,7,12,42,45,-3,46
St Gallen,5302,4,14,4,14,43,53,-10,46
FC Zürich,5302,5,11,9,12,40,41,-1,42
FC Lugano,5302,6,12,5,15,32,46,-14,41
FC Thun,5302,7,11,5,16,47,56,-9,38
FC Sion,5302,8,8,8,16,44,54,-10,32
Grasshoppers,5302,9,8,7,17,38,50,-12,31
Young Boys,5303,1,21,7,4,69,34,35,70
FC Basel,5303,2,17,8,7,53,25,28,59
St Gallen,5303,3,16,3,13,45,49,-4,51
Lucerne,5303,4,13,7,12,47,46,1,46
FC Zürich,5303,5,11,11,10,41,35,6,44
Grasshoppers,5303,6,10,7,15,42,53,-11,37
FC Lugano,5303,7,10,7,15,31,48,-17,37
FC Thun,5303,8,8,8,16,43,60,-17,32
FC Sion,5303,9,5,8,19,36,57,-21,23
Young Boys,5304,1,20,8,4,72,39,33,68
FC Basel,5304,2,19,7,6,53,25,28,64
Lucerne,5304,3,15,8,9,48,43,5,53
St Gallen,5304,4,15,3,14,43,51,-8,48
FC Zürich,5304,5,11,9,12,42,38,4,42
Grasshoppers,5304,6,9,8,15,41,49,-8,35
FC Thun,5304,7,9,6,17,43,58,-15,33
FC Lugano,5304,8,9,5,18,30,50,-20,32
FC Sion,5304,9,5,10,17,41,60,-19,25
Young Boys,5305,1,21,7,4,68,33,35,70
FC Basel,5305,2,20,7,5,53,22,31,67
St Gallen,5305,3,14,4,14,44,55,-11,46
FC Zürich,5305,4,11,10,11,40,34,6,43
Lucerne,5305,5,12,7,13,43,46,-3,43
FC Lugano,5305,6,10,7,15,31,46,-15,37
Grasshoppers,5305,7,9,7,16,42,53,-11,34
FC Thun,5305,8,9,5,18,40,62,-22,32
FC Sion,5305,9,6,10,16,43,53,-10,28
Young Boys,5306,1,22,6,4,74,34,40,72
FC Basel,5306,2,19,7,6,54,24,30,64
St Gallen,5306,3,15,2,15,43,53,-10,47
Lucerne,5306,4,12,7,13,38,43,-5,43
FC Zürich,5306,5,10,9,13,39,40,-1,39
FC Lugano,5306,6,11,5,16,31,49,-18,38
Grasshoppers,5306,7,10,7,15,39,47,-8,37
FC Thun,5306,8,10,6,16,42,56,-14,36
FC Sion,5306,9,7,7,18,39,53,-14,28
Young Boys,5307,1,23,7,2,79,35,44,76
FC Basel,5307,2,17,10,5,53,26,27,61
St Gallen,5307,3,15,3,14,43,52,-9,48
Lucerne,5307,4,12,8,12,44,47,-3,44
FC Zürich,5307,5,11,10,11,44,37,7,43
FC Thun,5307,6,11,5,16,45,55,-10,38
Grasshoppers,5307,7,9,6,17,41,52,-11,33
FC Lugano,5307,8,9,5,18,30,55,-25,32
FC Sion,5307,9,6,8,18,39,59,-20,26
Young Boys,5308,1,21,8,3,73,35,38,71
FC Basel,5308,2,15,10,7,50,27,23,55
St Gallen,5308,3,14,4,14,42,53,-11,46
FC Zürich,5308,4,11,10,11,40,35,5,43
Lucerne,5308,5,11,10,11,41,45,-4,43
Grasshoppers,5308,6,12,6,14,46,48,-2,42
FC Lugano,5308,7,9,8,15,31,47,-16,35
FC Thun,5308,8,9,6,17,42,60,-18,33
FC Sion,5308,9,7,8,17,39,54,-15,29
Young Boys,5309,1,22,6,4,71,35,36,72
FC Basel,5309,2,19,7,6,52,23,29,64
Lucerne,5309,3,14,8,10,43,41,2,50
St Gallen,5309,4,15,3,14,43,52,-9,48
FC Zürich,5309,5,10,9,13,41,39,2,39
FC Lugano,5309,6,10,6,16,30,47,-17,36
Grasshoppers,5309,7,9,7,16,43,53,-10,34
FC Thun,5309,8,9,6,17,43,60,-17,33
FC Sion,5309,9,6,8,18,39,55,-16,26
Young Boys,5310,1,22,6,4,73,40,33,72
FC Basel,5310,2,16,9,7,52,28,24,57
Lucerne,5310,3,14,7,11,44,44,0,49
St Gallen,5310,4,14,2,16,42,56,-14,44
FC Zürich,5310,5,11,10,11,43,36,7,43
FC Lugano,5310,6,11,5,16,33,46,-13,38
Grasshoppers,5310,7,9,7,16,42,53,-11,34
FC Thun,5310,8,9,6,17,43,62,-19,33
FC Sion,5310,9,8,8,16,44,51,-7,32
Young Boys,5311,1,20,8,4,68,36,32,68
FC Basel,5311,2,20,7,5,63,22,41,67
St Gallen,5311,3,14,2,16,40,58,-18,44
FC Zürich,5311,4,11,10,11,40,37,3,43
Lucerne,5311,5,12,7,13,40,45,-5,43
Grasshoppers,5311,6,11,7,14,43,48,-5,40
FC Lugano,5311,7,11,6,15,31,44,-13,39
FC Sion,5311,8,7,8,17,40,52,-12,29
FC Thun,5311,9,8,5,19,39,62,-23,29
Young Boys,5312,1,21,9,2,76,37,39,72
FC Basel,5312,2,16,10,6,54,27,27,58
Lucerne,5312,3,15,7,10,46,42,4,52
St Gallen,5312,4,15,2,15,45,58,-13,47
FC Zürich,5312,5,11,11,10,41,35,6,44
Grasshoppers,5312,6,9,8,15,43,51,-8,35
FC Lugano,5312,7,9,5,18,31,54,-23,32
FC Thun,5312,8,8,7,17,41,59,-18,31
FC Sion,5312,9,6,9,17,38,52,-14,27
Young Boys,5313,1,21,7,4,72,39,33,70
FC Basel,5313,2,18,7,7,56,25,31,61
St Gallen,5313,3,15,2,15,45,58,-13,47
Lucerne,5313,4,12,8,12,41,45,-4,44
FC Zürich,5313,5,10,12,10,41,36,5,42
Grasshoppers,5313,6,10,7,15,45,50,-5,37
FC Thun,5313,7,10,6,16,43,59,-16,36
FC Lugano,5313,8,9,8,15,29,45,-16,35
FC Sion,5313,9,6,9,17,45,60,-15,27
Young Boys,5314,1,20,7,5,70,39,31,67
FC Basel,5314,2,18,8,6,55,27,28,62
St Gallen,5314,3,16,2,14,42,50,-8,50
Lucerne,5314,4,13,7,12,48,45,3,46
FC Zürich,5314,5,12,9,11,42,36,6,45
FC Thun,5314,6,10,7,15,46,58,-12,37
FC Lugano,5314,7,10,5,17,29,48,-19,35
Grasshoppers,5314,8,8,9,15,41,54,-13,33
FC Sion,5314,9,6,8,18,38,54,-16,26
Young Boys,5315,1,21,7,4,72,36,36,70
FC Basel,5315,2,17,10,5,55,28,27,61
Lucerne,5315,3,13,9,10,46,46,0,48
St Gallen,5315,4,14,5,13,44,54,-10,47
FC Zürich,5315,5,10,11,11,41,36,5,41
FC Thun,5315,6,10,5,17,49,60,-11,35
Grasshoppers,5315,7,9,7,16,39,50,-11,34
FC Lugano,5315,8,9,7,16,32,50,-18,34
FC Sion,5315,9,7,7,18,39,57,-18,28
Young Boys,5316,1,21,8,3,69,32,37,71
FC Basel,5316,2,17,8,7,49,26,23,59
FC Zürich,5316,3,12,9,11,42,35,7,45
St Gallen,5316,4,14,3,15,44,56,-12,45
Lucerne,5316,5,12,8,12,41,46,-5,44
FC Lugano,5316,6,11,6,15,34,49,-15,39
Grasshoppers,5316,7,10,7,15,44,47,-3,37
FC Thun,5316,8,10,5,17,44,59,-15,35
FC Sion,5316,9,6,8,18,37,54,-17,26
Young Boys,5317,1,23,6,3,75,39,36,75
FC Basel,5317,2,18,7,7,50,25,25,61
Lucerne,5317,3,13,8,11,40,41,-1,47
FC Zürich,5317,4,12,9,11,43,35,8,45
St Gallen,5317,5,13,2,17,41,57,-16,41
FC Lugano,5317,6,11,6,15,35,46,-11,39
Grasshoppers,5317,7,10,6,16,43,51,-8,36
FC Thun,5317,8,9,5,18,41,59,-18,32
FC Sion,5317,9,7,7,18,39,54,-15,28
Young Boys,5318,1,21,7,4,72,37,35,70
FC Basel,5318,2,18,9,5,62,27,35,63
Lucerne,5318,3,12,9,11,38,47,-9,45
St Gallen,5318,4,13,5,14,41,54,-13,44
FC Zürich,5318,5,10,10,12,41,39,2,40
Grasshoppers,5318,6,10,7,15,43,48,-5,37
FC Lugano,5318,7,10,7,15,32,47,-15,37
FC Thun,5318,8,9,6,17,43,59,-16,33
FC Sion,5318,9,7,8,17,42,56,-14,29
Young Boys,5319,1,22,7,3,72,33,39,73
FC Basel,5319,2,16,8,8,51,29,22,56
Lucerne,5319,3,13,8,11,41,42,-1,47
St Gallen,5319,4,14,4,14,42,53,-11,46
FC Lugano,5319,5,12,5,15,31,47,-16,41
FC Thun,5319,6,11,5,16,47,59,-12,38
FC Zürich,5319,7,9,9,14,37,38,-1,36
Grasshoppers,5319,8,10,6,16,42,49,-7,36
FC Sion,5319,9,7,8,17,39,52,-13,29
Young Boys,5320,1,22,7,3,73,34,39,73
FC Basel,5320,2,18,8,6,57,25,32,62
Lucerne,5320,3,14,7,11,45,42,3,49
St Gallen,5320,4,13,3,16,39,57,-18,42
FC Zürich,5320,5,10,9,13,39,40,-1,39
FC Thun,5320,6,10,7,15,48,59,-11,37
FC Lugano,5320,7,10,6,16,30,52,-22,36
Grasshoppers,5320,8,9,7,16,43,51,-8,34
FC Sion,5320,9,6,10,16,39,53,-14,28
Young Boys,5321,1,21,7,4,70,36,34,70
FC Basel,5321,2,19,8,5,60,26,34,65
Lucerne,5321,3,15,7,10,44,41,3,52
FC Zürich,5321,4,12,10,10,47,35,12,46
St Gallen,5321,5,14,2,16,41,57,-16,44
FC Thun,5321,6,10,5,17,44,58,-14,35
FC Lugano,5321,7,9,5,18,32,57,-25,32
Grasshoppers,5321,8,8,6,18,37,52,-15,30
FC Sion,5321,9,7,8,17,41,54,-13,29
Young Boys,5322,1,20,8,4,73,39,34,68
FC Basel,5322,2,18,8,6,55,27,28,62
Lucerne,5322,3,12,10,10,44,42,2,46
St Gallen,5322,4,13,6,13,41,52,-11,45
FC Zürich,5322,5,11,9,12,41,38,3,42
Grasshoppers,5322,6,11,6,15,46,53,-7,39
FC Lugano,5322,7,10,8,14,35,47,-12,38
FC Thun,5322,8,9,5,18,44,64,-20,32
FC Sion,5322,9,6,8,18,42,59,-17,26
Young Boys,5323,1,23,6,3,72,33,39,75
FC Basel,5323,2,18,8,6,57,26,31,62
Lucerne,5323,3,14,7,11,43,45,-2,49
St Gallen,5323,4,15,2,15,45,58,-13,47
FC Zürich,5323,5,10,12,10,43,38,5,42
Grasshoppers,5323,6,10,6,16,41,48,-7,36
FC Lugano,5323,7,9,6,17,29,48,-19,33
FC Thun,5323,8,9,5,18,45,62,-17,32
FC Sion,5323,9,6,8,18,41,58,-17,26
Young Boys,5324,1,19,9,4,71,39,32,66
FC Basel,5324,2,19,7,6,56,26,30,64
St Gallen,5324,3,16,2,14,45,54,-9,50
FC Zürich,5324,4,12,9,11,43,38,5,45
Lucerne,5324,5,12,8,12,41,44,-3,44
FC Lugano,5324,6,11,5,16,33,48,-15,38
Grasshoppers,5324,7,10,7,15,46,52,-6,37
FC Thun,5324,8,9,5,18,46,62,-16,32
FC Sion,5324,9,6,8,18,41,59,-18,26
Young Boys,5325,1,22,6,4,73,35,38,72
FC Basel,5325,2,18,8,6,59,28,31,62
Lucerne,5325,3,13,8,11,44,46,-2,47
St Gallen,5325,4,15,2,15,44,58,-14,47
FC Zürich,5325,5,11,11,10,43,37,6,44
FC Lugano,5325,6,10,5,17,31,48,-17,35
Grasshoppers,5325,7,9,7,16,41,51,-10,34
FC Thun,5325,8,8,7,17,42,59,-17,31
FC Sion,5325,9,7,8,17,41,56,-15,29
Young Boys,5326,1,22,6,4,70,36,34,72
FC Basel,5326,2,18,8,6,57,25,32,62
St Gallen,5326,3,15,2,15,42,53,-11,47
FC Zürich,5326,4,11,10,11,40,34,6,43
Lucerne,5326,5,11,7,14,38,49,-11,40
FC Lugano,5326,6,11,5,16,32,47,-15,38
Grasshoppers,5326,7,9,8,15,43,49,-6,35
FC Sion,5326,8,8,9,15,46,53,-7,33
FC Thun,5326,9,8,7,17,43,65,-22,31
Young Boys,5327,1,21,7,4,69,34,35,70
FC Basel,5327,2,18,8,6,54,26,28,62
St Gallen,5327,3,15,2,15,43,53,-10,47
Lucerne,5327,4,12,8,12,47,47,0,44
FC Zürich,5327,5,11,10,11,41,36,5,43
FC Thun,5327,6,11,5,16,49,62,-13,38
Grasshoppers,5327,7,10,6,16,44,52,-8,36
FC Lugano,5327,8,10,5,17,29,50,-21,35
FC Sion,5327,9,7,7,18,40,56,-16,28
Young Boys,5328,1,21,7,4,67,33,34,70
FC Basel,5328,2,18,9,5,56,25,31,63
Lucerne,5328,3,13,7,12,40,44,-4,46
FC Zürich,5328,4,11,9,12,42,36,6,42
Grasshoppers,5328,5,12,6,14,45,49,-4,42
St Gallen,5328,6,13,3,16,41,56,-15,42
FC Thun,5328,7,10,6,16,42,56,-14,36
FC Lugano,5328,8,10,5,17,28,47,-19,35
FC Sion,5328,9,6,8,18,39,54,-15,26
Young Boys,5329,1,20,8,4,69,35,34,68
FC Basel,5329,2,17,10,5,58,24,34,61
Lucerne,5329,3,13,7,12,39,50,-11,46
St Gallen,5329,4,14,3,15,40,52,-12,45
FC Zürich,5329,5,11,10,11,42,36,6,43
FC Lugano,5329,6,11,6,15,32,46,-14,39
FC Sion,5329,7,9,7,16,46,51,-5,34
FC Thun,5329,8,9,6,17,42,61,-19,33
Grasshoppers,5329,9,8,7,17,38,51,-13,31
Young Boys,5330,1,20,6,6,68,40,28,66
FC Basel,5330,2,17,10,5,55,26,29,61
Lucerne,5330,3,13,8,11,42,44,-2,47
St Gallen,5330,4,14,3,15,41,56,-15,45
FC Zürich,5330,5,10,10,12,38,38,0,40
Grasshoppers,5330,6,11,7,14,45,47,-2,40
FC Lugano,5330,7,11,5,16,33,46,-13,38
FC Thun,5330,8,10,5,17,45,59,-14,35
FC Sion,5330,9,7,8,17,40,51,-11,29
Young Boys,5331,1,22,8,2,71,31,40,74
FC Basel,5331,2,19,7,6,57,26,31,64
Lucerne,5331,3,13,9,10,41,41,0,48
St Gallen,5331,4,13,5,14,42,56,-14,44
FC Zürich,5331,5,10,11,11,39,37,2,41
Grasshoppers,5331,6,9,8,15,40,48,-8,35
FC Lugano,5331,7,9,6,17,29,49,-20,33
FC Thun,5331,8,8,8,16,41,57,-16,32
FC Sion,5331,9,5,10,17,36,51,-15,25
Young Boys,5332,1,22,6,4,68,34,34,72
FC Basel,5332,2,18,8,6,57,25,32,62
St Gallen,5332,3,16,3,13,44,52,-8,51
FC Zürich,5332,4,12,10,10,44,33,11,46
Lucerne,5332,5,11,8,13,39,46,-7,41
Grasshoppers,5332,6,10,8,14,40,45,-5,38
FC Lugano,5332,7,9,6,17,30,50,-20,33
FC Thun,5332,8,8,6,18,42,64,-22,30
FC Sion,5332,9,6,9,17,38,53,-15,27
Young Boys,5333,1,22,8,2,74,35,39,74
FC Basel,5333,2,17,7,8,51,26,25,58
Lucerne,5333,3,13,9,10,41,41,0,48
St Gallen,5333,4,15,2,15,42,52,-10,47
FC Zürich,5333,5,11,10,11,40,34,6,43
FC Lugano,5333,6,11,7,14,31,44,-13,40
Grasshoppers,5333,7,10,6,16,42,51,-9,36
FC Thun,5333,8,8,5,19,39,61,-22,29
FC Sion,5333,9,6,8,18,38,54,-16,26
Young Boys,5334,1,22,7,3,71,36,35,73
FC Basel,5334,2,18,8,6,57,25,32,62
Lucerne,5334,3,11,9,12,41,46,-5,42
St Gallen,5334,4,13,3,16,41,58,-17,42
FC Lugano,5334,5,12,5,15,33,47,-14,41
FC Zürich,5334,6,10,9,13,40,42,-2,39
FC Thun,5334,7,10,6,16,48,57,-9,36
Grasshoppers,5334,8,9,7,16,45,54,-9,34
FC Sion,5334,9,8,8,16,43,54,-11,32
Young Boys,5335,1,23,6,3,74,35,39,75
FC Basel,5335,2,19,8,5,62,25,37,65
Lucerne,5335,3,13,7,12,44,50,-6,46
St Gallen,5335,4,14,3,15,44,57,-13,45
FC Zürich,5335,5,10,10,12,41,39,2,40
Grasshoppers,5335,6,10,6,16,41,48,-7,36
FC Lugano,5335,7,9,6,17,29,49,-20,33
FC Thun,5335,8,9,5,18,42,61,-19,32
FC Sion,5335,9,8,7,17,40,53,-13,31
Young Boys,5336,1,22,8,2,71,34,37,74
FC Basel,5336,2,17,9,6,55,27,28,60
Lucerne,5336,3,13,8,11,43,44,-1,47
St Gallen,5336,4,14,3,15,42,57,-15,45
FC Zürich,5336,5,11,11,10,45,37,8,44
FC Lugano,5336,6,10,6,16,33,47,-14,36
Grasshoppers,5336,7,9,8,15,45,50,-5,35
FC Thun,5336,8,8,6,18,41,61,-20,30
FC Sion,5336,9,7,7,18,39,57,-18,28
Young Boys,5337,1,20,9,3,69,39,30,69
FC Basel,5337,2,16,10,6,56,27,29,58
St Gallen,5337,3,15,3,14,47,54,-7,48
Lucerne,5337,4,13,8,11,41,48,-7,47
FC Zürich,5337,5,11,10,11,39,34,5,43
Grasshoppers,5337,6,11,6,15,47,47,0,39
FC Lugano,5337,7,10,5,17,31,50,-19,35
FC Thun,5337,8,9,7,16,45,59,-14,34
FC Sion,5337,9,5,10,17,38,55,-17,25
Young Boys,5338,1,24,6,2,72,29,43,78
FC Basel,5338,2,18,8,6,54,26,28,62
St Gallen,5338,3,15,2,15,45,58,-13,47
Lucerne,5338,4,12,9,11,41,44,-3,45
FC Zürich,5338,5,10,9,13,42,39,3,39
FC Lugano,5338,6,10,6,16,30,49,-19,36
Grasshoppers,5338,7,9,6,17,39,48,-9,33
FC Thun,5338,8,9,6,17,43,60,-17,33
FC Sion,5338,9,7,8,17,42,55,-13,29
Young Boys,5339,1,22,6,4,76,36,40,72
FC Basel,5339,2,17,8,7,50,24,26,59
Lucerne,5339,3,14,7,11,48,45,3,49
FC Zürich,5339,4,12,9,11,47,39,8,45
St Gallen,5339,5,14,3,15,42,55,-13,45
FC Thun,5339,6,11,6,15,48,58,-10,39
FC Lugano,5339,7,10,5,17,33,54,-21,35
Grasshoppers,5339,8,9,6,17,41,56,-15,33
FC Sion,5339,9,6,8,18,42,60,-18,26
Young Boys,5340,1,21,9,2,74,37,37,72
FC Basel,5340,2,16,8,8,50,31,19,56
St Gallen,5340,3,16,3,13,48,52,-4,51
FC Zürich,5340,4,12,10,10,44,35,9,46
Lucerne,5340,5,11,9,12,39,45,-6,42
Grasshoppers,5340,6,11,7,14,47,48,-1,40
FC Lugano,5340,7,9,7,16,32,50,-18,34
FC Thun,5340,8,9,6,17,42,59,-17,33
FC Sion,5340,9,5,9,18,40,59,-19,24
Young Boys,5341,1,21,8,3,67,32,35,71
FC Basel,5341,2,18,8,6,53,24,29,62
FC Zürich,5341,3,11,11,10,40,33,7,44
St Gallen,5341,4,14,2,16,42,58,-16,44
Lucerne,5341,5,12,7,13,40,48,-8,43
FC Thun,5341,6,10,7,15,45,56,-11,37
FC Lugano,5341,7,10,7,15,29,44,-15,37
Grasshoppers,5341,8,9,7,16,41,49,-8,34
FC Sion,5341,9,6,9,17,41,54,-13,27
Young Boys,5342,1,21,8,3,69,34,35,71
FC Basel,5342,2,19,7,6,59,24,35,64
Lucerne,5342,3,14,8,10,48,42,6,50
St Gallen,5342,4,13,4,15,41,61,-20,43
FC Lugano,5342,5,11,6,15,36,47,-11,39
FC Zürich,5342,6,9,10,13,39,41,-2,37
Grasshoppers,5342,7,9,7,16,42,54,-12,34
FC Thun,5342,8,9,6,17,43,60,-17,33
FC Sion,5342,9,6,10,16,41,55,-14,28
Young Boys,5343,1,22,7,3,75,34,41,73
FC Basel,5343,2,16,8,8,49,26,23,56
Lucerne,5343,3,14,8,10,42,41,1,50
St Gallen,5343,4,14,3,15,42,53,-11,45
FC Zürich,5343,5,11,10,11,41,34,7,43
Grasshoppers,5343,6,10,7,15,43,48,-5,37
FC Thun,5343,7,9,7,16,42,59,-17,34
FC Lugano,5343,8,9,6,17,30,51,-21,33
FC Sion,5343,9,7,8,17,39,57,-18,29
Young Boys,5344,1,21,7,4,72,36,36,70
FC Basel,5344,2,15,9,8,52,31,21,54
Lucerne,5344,3,13,9,10,44,44,0,48
FC Zürich,5344,4,12,10,10,45,36,9,46
St Gallen,5344,5,14,4,14,43,53,-10,46
Grasshoppers,5344,6,10,8,14,43,48,-5,38
FC Lugano,5344,7,10,7,15,31,46,-15,37
FC Thun,5344,8,8,8,16,42,58,-16,32
FC Sion,5344,9,6,8,18,38,58,-20,26
Young Boys,5345,1,22,7,3,72,38,34,73
FC Basel,5345,2,17,9,6,56,27,29,60
St Gallen,5345,3,14,4,14,44,55,-11,46
FC Zürich,5345,4,11,10,11,44,35,9,43
Lucerne,5345,5,11,7,14,40,49,-9,40
FC Thun,5345,6,11,6,15,49,58,-9,39
FC Lugano,5345,7,10,7,15,31,46,-15,37
Grasshoppers,5345,8,10,6,16,41,51,-10,36
FC Sion,5345,9,6,8,18,39,57,-18,26
Young Boys,5346,1,21,8,3,71,35,36,71
FC Basel,5346,2,16,8,8,51,32,19,56
St Gallen,5346,3,15,3,14,44,53,-9,48
Lucerne,5346,4,11,9,12,39,43,-4,42
FC Thun,5346,5,12,5,15,49,55,-6,41
FC Lugano,5346,6,11,7,14,34,47,-13,40
FC Zürich,5346,7,10,9,13,41,39,2,39
FC Sion,5346,8,8,8,16,40,52,-12,32
Grasshoppers,5346,9,8,7,17,38,51,-13,31
Young Boys,5347,1,21,7,4,70,35,35,70
FC Basel,5347,2,18,8,6,52,23,29,62
St Gallen,5347,3,15,2,15,45,55,-10,47
Lucerne,5347,4,12,8,12,40,43,-3,44
FC Zürich,5347,5,11,9,12,42,38,4,42
FC Lugano,5347,6,11,5,16,31,46,-15,38
FC Thun,5347,7,10,6,16,47,57,-10,36
Grasshoppers,5347,8,10,6,16,38,54,-16,36
FC Sion,5347,9,6,9,17,44,58,-14,27
Young Boys,5348,1,21,7,4,73,34,39,70
FC Basel,5348,2,16,8,8,54,29,25,56
St Gallen,5348,3,15,2,15,44,55,-11,47
Lucerne,5348,4,13,7,12,43,50,-7,46
FC Zürich,5348,5,11,10,11,41,35,6,43
FC Lugano,5348,6,12,5,15,32,44,-12,41
Grasshoppers,5348,7,10,7,15,43,49,-6,37
FC Thun,5348,8,9,6,17,42,59,-17,33
FC Sion,5348,9,7,8,17,39,56,-17,29
Young Boys,5349,1,23,6,3,75,36,39,75
FC Basel,5349,2,18,8,6,55,25,30,62
Lucerne,5349,3,12,8,12,42,48,-6,44
St Gallen,5349,4,14,2,16,43,55,-12,44
FC Zürich,5349,5,9,12,11,40,37,3,39
FC Thun,5349,6,11,5,16,49,59,-10,38
Grasshoppers,5349,7,10,6,16,44,55,-11,36
FC Lugano,5349,8,9,7,16,33,52,-19,34
FC Sion,5349,9,7,8,17,43,57,-14,29
Young Boys,5350,1,21,8,3,67,32,35,71
FC Basel,5350,2,17,7,8,53,29,24,58
St Gallen,5350,3,15,4,13,46,54,-8,49
FC Zürich,5350,4,13,9,10,46,34,12,48
Lucerne,5350,5,12,9,11,42,44,-2,45
FC Thun,5350,6,10,6,16,45,57,-12,36
FC Lugano,5350,7,10,6,16,31,49,-18,36
Grasshoppers,5350,8,8,7,17,39,54,-15,31
FC Sion,5350,9,5,10,17,37,53,-16,25
Young Boys,5351,1,22,8,2,72,32,40,74
FC Basel,5351,2,19,8,5,55,23,32,65
Lucerne,5351,3,14,7,11,43,43,0,49
St Gallen,5351,4,13,2,17,38,56,-18,41
FC Zürich,5351,5,10,9,13,37,37,0,39
FC Lugano,5351,6,11,6,15,29,43,-14,39
FC Thun,5351,7,10,5,17,42,57,-15,35
Grasshoppers,5351,8,9,6,17,41,49,-8,33
FC Sion,5351,9,7,7,18,39,56,-17,28
Young Boys,5352,1,20,7,5,71,40,31,67
FC Basel,5352,2,18,8,6,56,23,33,62
Lucerne,5352,3,14,7,11,42,45,-3,49
FC Zürich,5352,4,13,9,10,41,32,9,48
St Gallen,5352,5,14,3,15,44,56,-12,45
FC Lugano,5352,6,11,5,16,31,47,-16,38
Grasshoppers,5352,7,9,8,15,44,52,-8,35
FC Thun,5352,8,9,5,18,40,61,-21,32
FC Sion,5352,9,6,8,18,42,55,-13,26
Young Boys,5353,1,22,7,3,67,30,37,73
FC Basel,5353,2,17,7,8,54,32,22,58
Lucerne,5353,3,14,8,10,42,39,3,50
FC Zürich,5353,4,12,9,11,43,35,8,45
St Gallen,5353,5,13,2,17,41,59,-18,41
FC Lugano,5353,6,11,5,16,33,47,-14,38
FC Thun,5353,7,9,6,17,44,60,-16,33
FC Sion,5353,8,8,8,16,39,50,-11,32
Grasshoppers,5353,8,8,8,16,39,50,-11,32
FC Basel,5354,1,20,7,5,61,26,35,67
Young Boys,5354,2,19,6,7,66,39,27,63
Lucerne,5354,3,14,8,10,44,41,3,50
St Gallen,5354,4,13,4,15,44,57,-13,43
FC Zürich,5354,5,11,9,12,45,36,9,42
FC Lugano,5354,6,11,6,15,34,48,-14,39
Grasshoppers,5354,7,9,7,16,39,49,-10,34
FC Sion,5354,8,8,8,16,39,51,-12,32
FC Thun,5354,9,8,7,17,41,66,-25,31
Young Boys,5355,1,21,9,2,74,35,39,72
FC Basel,5355,2,17,8,7,56,31,25,59
St Gallen,5355,3,15,3,14,46,57,-11,48
Lucerne,5355,4,12,8,12,44,47,-3,44
Grasshoppers,5355,5,11,7,14,43,47,-4,40
FC Zürich,5355,6,9,11,12,38,38,0,38
FC Lugano,5355,7,10,6,16,33,52,-19,36
FC Thun,5355,8,9,6,17,45,59,-14,33
FC Sion,5355,9,6,10,16,41,54,-13,28
Young Boys,5356,1,22,6,4,77,37,40,72
FC Basel,5356,2,18,8,6,56,24,32,62
St Gallen,5356,3,16,2,14,41,51,-10,50
Lucerne,5356,4,13,7,12,45,50,-5,46
FC Zürich,5356,5,11,10,11,41,34,7,43
FC Lugano,5356,6,10,5,17,30,48,-18,35
FC Thun,5356,7,9,6,17,40,57,-17,33
FC Sion,5356,8,8,7,17,40,54,-14,31
Grasshoppers,5356,9,8,7,17,38,53,-15,31
Young Boys,5357,1,21,6,5,74,39,35,69
FC Basel,5357,2,17,10,5,54,24,30,61
Lucerne,5357,3,13,8,11,43,48,-5,47
St Gallen,5357,4,14,5,13,43,53,-10,47
FC Zürich,5357,5,10,11,11,39,35,4,41
FC Thun,5357,6,11,6,15,46,57,-11,39
Grasshoppers,5357,7,9,7,16,40,50,-10,34
FC Lugano,5357,8,9,7,16,31,49,-18,34
FC Sion,5357,9,6,8,18,39,54,-15,26
Young Boys,5358,1,23,7,2,77,36,41,76
FC Basel,5358,2,16,8,8,52,31,21,56
Lucerne,5358,3,13,9,10,41,42,-1,48
FC Zürich,5358,4,12,10,10,41,33,8,46
St Gallen,5358,5,13,4,15,43,57,-14,43
Grasshoppers,5358,6,9,7,16,39,49,-10,34
FC Thun,5358,7,9,7,16,43,57,-14,34
FC Lugano,5358,8,9,6,17,31,50,-19,33
FC Sion,5358,9,7,8,17,44,56,-12,29
Young Boys,5359,1,21,8,3,70,35,35,71
FC Basel,5359,2,17,9,6,55,29,26,60
Lucerne,5359,3,14,8,10,46,42,4,50
St Gallen,5359,4,14,2,16,43,55,-12,44
FC Zürich,5359,5,11,10,11,43,38,5,43
FC Thun,5359,6,11,5,16,47,57,-10,38
FC Lugano,5359,7,10,5,17,32,52,-20,35
Grasshoppers,5359,8,9,7,16,40,50,-10,34
FC Sion,5359,9,6,8,18,42,60,-18,26
Young Boys,5360,1,22,7,3,76,34,42,73
FC Basel,5360,2,18,8,6,55,25,30,62
St Gallen,5360,3,16,2,14,42,53,-11,50
Lucerne,5360,4,13,8,11,42,43,-1,47
FC Zürich,5360,5,11,9,12,42,37,5,42
FC Lugano,5360,6,10,6,16,30,46,-16,36
FC Thun,5360,7,10,5,17,44,59,-15,35
Grasshoppers,5360,8,9,6,17,40,53,-13,33
FC Sion,5360,9,6,7,19,39,60,-21,25
Young Boys,5361,1,20,8,4,70,37,33,68
FC Basel,5361,2,16,9,7,52,29,23,57
Lucerne,5361,3,15,7,10,46,43,3,52
St Gallen,5361,4,14,4,14,45,58,-13,46
FC Zürich,5361,5,10,11,11,39,35,4,41
FC Thun,5361,6,11,6,15,48,57,-9,39
Grasshoppers,5361,7,9,7,16,40,51,-11,34
FC Lugano,5361,8,9,6,17,32,50,-18,33
FC Sion,5361,9,6,10,16,40,52,-12,28
Young Boys,5362,1,21,6,5,74,38,36,69
FC Basel,5362,2,19,8,5,55,24,31,65
Lucerne,5362,3,13,7,12,41,42,-1,46
St Gallen,5362,4,14,3,15,40,54,-14,45
FC Zürich,5362,5,11,10,11,41,36,5,43
Grasshoppers,5362,6,12,6,14,43,46,-3,42
FC Lugano,5362,7,10,5,17,31,50,-19,35
FC Thun,5362,8,9,6,17,43,60,-17,33
FC Sion,5362,9,6,7,19,39,57,-18,25
Young Boys,5363,1,21,8,3,71,36,35,71
FC Basel,5363,2,19,8,5,57,23,34,65
Lucerne,5363,3,13,8,11,41,43,-2,47
St Gallen,5363,4,15,2,15,40,52,-12,47
FC Zürich,5363,5,10,10,12,40,35,5,40
FC Thun,5363,6,11,5,16,43,57,-14,38
FC Lugano,5363,7,9,7,16,30,48,-18,34
Grasshoppers,5363,8,9,6,17,38,48,-10,33
FC Sion,5363,9,6,8,18,38,56,-18,26
Young Boys,5364,1,21,7,4,72,36,36,70
FC Basel,5364,2,19,7,6,56,27,29,64
St Gallen,5364,3,15,3,14,42,51,-9,48
Lucerne,5364,4,13,8,11,43,46,-3,47
FC Zürich,5364,5,10,9,13,42,40,2,39
FC Lugano,5364,6,10,5,17,30,49,-19,35
FC Sion,5364,7,9,7,16,44,53,-9,34
FC Thun,5364,8,9,6,17,46,63,-17,33
Grasshoppers,5364,9,8,8,16,40,50,-10,32
Young Boys,5365,1,20,8,4,74,39,35,68
FC Basel,5365,2,16,9,7,50,27,23,57
Lucerne,5365,3,12,10,10,45,44,1,46
St Gallen,5365,4,13,4,15,42,59,-17,43
FC Lugano,5365,5,12,6,14,37,45,-8,42
FC Zürich,5365,6,10,10,12,39,36,3,40
FC Thun,5365,7,10,7,15,46,55,-9,37
Grasshoppers,5365,8,9,8,15,40,51,-11,35
FC Sion,5365,9,7,8,17,41,58,-17,29
Young Boys,5366,1,23,7,2,72,31,41,76
FC Basel,5366,2,18,8,6,54,26,28,62
St Gallen,5366,3,15,2,15,43,52,-9,47
Lucerne,5366,4,12,8,12,39,44,-5,44
FC Zürich,5366,5,10,11,11,45,40,5,41
FC Lugano,5366,6,10,7,15,29,43,-14,37
Grasshoppers,5366,7,10,6,16,40,47,-7,36
FC Thun,5366,8,8,7,17,41,58,-17,31
FC Sion,5366,9,6,8,18,40,62,-22,26
Young Boys,5367,1,22,7,3,71,35,36,73
FC Basel,5367,2,17,8,7,55,27,28,59
St Gallen,5367,3,15,3,14,46,52,-6,48
FC Zürich,5367,4,11,10,11,41,38,3,43
Lucerne,5367,5,11,9,12,39,46,-7,42
Grasshoppers,5367,6,10,8,14,41,47,-6,38
FC Lugano,5367,7,11,5,16,35,49,-14,38
FC Thun,5367,8,9,7,16,44,61,-17,34
FC Sion,5367,9,5,9,18,37,54,-17,24
Young Boys,5368,1,23,6,3,74,34,40,75
FC Basel,5368,2,18,7,7,54,29,25,61
St Gallen,5368,3,15,3,14,48,54,-6,48
Lucerne,5368,4,13,7,12,43,46,-3,46
FC Zürich,5368,5,12,9,11,41,33,8,45
Grasshoppers,5368,6,10,6,16,42,52,-10,36
FC Lugano,5368,7,10,5,17,29,48,-19,35
FC Thun,5368,8,8,6,18,40,59,-19,30
FC Sion,5368,9,6,9,17,37,53,-16,27
Young Boys,5369,1,22,6,4,74,39,35,72
FC Basel,5369,2,18,7,7,53,27,26,61
Lucerne,5369,3,13,8,11,47,46,1,47
FC Zürich,5369,4,12,9,11,39,33,6,45
St Gallen,5369,5,14,3,15,43,57,-14,45
FC Lugano,5369,6,10,5,17,32,54,-22,35
FC Sion,5369,7,9,7,16,45,50,-5,34
Grasshoppers,5369,8,9,6,17,39,49,-10,33
FC Thun,5369,9,9,5,18,42,59,-17,32
Young Boys,5370,1,22,7,3,74,40,34,73
FC Basel,5370,2,16,8,8,54,32,22,56
St Gallen,5370,3,15,3,14,43,51,-8,48
Lucerne,5370,4,12,9,11,47,46,1,45
FC Zürich,5370,5,11,11,10,42,36,6,44
FC Lugano,5370,6,10,8,14,36,48,-12,38
Grasshoppers,5370,7,9,7,16,41,53,-12,34
FC Thun,5370,8,8,7,17,45,65,-20,31
FC Sion,5370,9,7,8,17,43,54,-11,29
Young Boys,5371,1,22,6,4,73,39,34,72
FC Basel,5371,2,17,8,7,51,25,26,59
St Gallen,5371,3,16,2,14,44,52,-8,50
FC Zürich,5371,4,12,10,10,43,33,10,46
Lucerne,5371,5,12,7,13,41,46,-5,43
Grasshoppers,5371,6,11,7,14,49,48,1,40
FC Lugano,5371,7,10,5,17,30,50,-20,35
FC Thun,5371,8,9,7,16,43,59,-16,34
FC Sion,5371,9,5,8,19,38,60,-22,23
Young Boys,5372,1,21,8,3,70,35,35,71
FC Basel,5372,2,19,8,5,57,23,34,65
Lucerne,5372,3,13,8,11,43,44,-1,47
St Gallen,5372,4,14,2,16,42,55,-13,44
FC Zürich,5372,5,10,12,10,39,34,5,42
Grasshoppers,5372,6,10,7,15,42,49,-7,37
FC Lugano,5372,7,10,7,15,30,47,-17,37
FC Thun,5372,8,8,6,18,41,61,-20,30
FC Sion,5372,9,6,8,18,36,52,-16,26
Young Boys,5373,1,22,7,3,69,32,37,73
FC Basel,5373,2,17,8,7,52,27,25,59
Lucerne,5373,3,13,7,12,40,45,-5,46
St Gallen,5373,4,14,2,16,43,53,-10,44
FC Zürich,5373,5,10,11,11,42,34,8,41
Grasshoppers,5373,6,10,7,15,40,47,-7,37
FC Lugano,5373,7,10,5,17,28,50,-22,35
FC Thun,5373,8,9,7,16,41,56,-15,34
FC Sion,5373,9,7,10,15,38,49,-11,31
Young Boys,5374,1,20,7,5,69,39,30,67
FC Basel,5374,2,19,8,5,56,24,32,65
Lucerne,5374,3,15,7,10,48,41,7,52
St Gallen,5374,4,15,2,15,47,57,-10,47
FC Zürich,5374,5,9,11,12,41,41,0,38
Grasshoppers,5374,6,10,6,16,41,50,-9,36
FC Thun,5374,7,10,6,16,44,58,-14,36
FC Lugano,5374,8,10,5,17,34,55,-21,35
FC Sion,5374,9,6,8,18,39,54,-15,26
Young Boys,5375,1,20,8,4,69,38,31,68
FC Basel,5375,2,19,8,5,56,23,33,65
Lucerne,5375,3,13,8,11,44,43,1,47
St Gallen,5375,4,13,4,15,41,55,-14,43
FC Zürich,5375,5,10,11,11,42,39,3,41
FC Lugano,5375,6,10,7,15,32,47,-15,37
Grasshoppers,5375,7,10,6,16,42,51,-9,36
FC Thun,5375,8,10,6,16,42,57,-15,36
FC Sion,5375,9,5,10,17,38,53,-15,25
Young Boys,5376,1,21,7,4,69,37,32,70
FC Basel,5376,2,18,8,6,55,24,31,62
Lucerne,5376,3,13,7,12,41,43,-2,46
St Gallen,5376,4,14,3,15,43,55,-12,45
FC Zürich,5376,5,11,10,11,42,36,6,43
FC Lugano,5376,6,11,5,16,33,47,-14,38
FC Thun,5376,7,11,5,16,43,58,-15,38
Grasshoppers,5376,8,8,7,17,38,50,-12,31
FC Sion,5376,9,7,8,17,40,54,-14,29
Young Boys,5377,1,21,7,4,71,38,33,70
FC Basel,5377,2,17,7,8,53,29,24,58
Lucerne,5377,3,14,8,10,48,42,6,50
St Gallen,5377,4,14,2,16,41,55,-14,44
FC Zürich,5377,5,10,11,11,39,34,5,41
FC Lugano,5377,6,12,5,15,34,48,-14,41
Grasshoppers,5377,7,10,6,16,40,51,-11,36
FC Thun,5377,8,10,6,16,45,57,-12,36
FC Sion,5377,9,6,8,18,36,53,-17,26
Young Boys,5378,1,20,8,4,70,39,31,68
FC Basel,5378,2,19,7,6,59,27,32,64
St Gallen,5378,3,15,4,13,44,53,-9,49
Lucerne,5378,4,11,9,12,41,46,-5,42
FC Zürich,5378,5,10,10,12,42,39,3,40
FC Thun,5378,6,11,5,16,45,58,-13,38
FC Lugano,5378,7,10,6,16,29,47,-18,36
Grasshoppers,5378,8,8,9,15,38,47,-9,33
FC Sion,5378,9,6,10,16,41,53,-12,28
Young Boys,5379,1,21,8,3,74,33,41,71
FC Basel,5379,2,16,10,6,55,28,27,58
FC Zürich,5379,3,13,9,10,43,34,9,48
St Gallen,5379,4,15,3,14,43,52,-9,48
Lucerne,5379,5,13,7,12,40,47,-7,46
Grasshoppers,5379,6,10,7,15,42,51,-9,37
FC Lugano,5379,7,10,5,17,29,47,-18,35
FC Thun,5379,8,9,6,17,42,59,-17,33
FC Sion,5379,9,5,9,18,36,53,-17,24
Young Boys,5380,1,22,7,3,78,39,39,73
FC Basel,5380,2,16,10,6,57,31,26,58
Lucerne,5380,3,14,8,10,47,42,5,50
FC Zürich,5380,4,12,9,11,44,38,6,45
St Gallen,5380,5,13,4,15,39,56,-17,43
FC Lugano,5380,6,12,5,15,32,44,-12,41
FC Thun,5380,7,10,5,17,43,59,-16,35
Grasshoppers,5380,8,9,6,17,44,57,-13,33
FC Sion,5380,9,5,8,19,39,57,-18,23
Young Boys,5381,1,23,6,3,77,32,45,75
FC Basel,5381,2,19,8,5,58,25,33,65
St Gallen,5381,3,14,4,14,44,56,-12,46
FC Zürich,5381,4,11,10,11,43,37,6,43
Lucerne,5381,5,11,7,14,38,47,-9,40
Grasshoppers,5381,6,10,7,15,45,52,-7,37
FC Lugano,5381,7,10,6,16,29,50,-21,36
FC Thun,5381,8,9,6,17,43,61,-18,33
FC Sion,5381,9,6,8,18,42,59,-17,26
Young Boys,5382,1,22,6,4,71,39,32,72
FC Basel,5382,2,18,8,6,59,26,33,62
Lucerne,5382,3,13,8,11,46,47,-1,47
St Gallen,5382,4,15,2,15,44,55,-11,47
FC Zürich,5382,5,11,10,11,43,38,5,43
FC Lugano,5382,6,10,6,16,34,51,-17,36
FC Thun,5382,7,10,5,17,49,60,-11,35
FC Sion,5382,8,8,7,17,42,56,-14,31
Grasshoppers,5382,9,8,6,18,40,56,-16,30
Young Boys,5383,1,21,7,4,72,38,34,70
FC Basel,5383,2,18,9,5,55,25,30,63
St Gallen,5383,3,15,3,14,43,55,-12,48
Lucerne,5383,4,12,7,13,44,48,-4,43
FC Lugano,5383,5,11,7,14,34,45,-11,40
FC Zürich,5383,6,9,10,13,37,36,1,37
Grasshoppers,5383,7,9,7,16,41,51,-10,34
FC Thun,5383,8,9,7,16,44,62,-18,34
FC Sion,5383,9,8,7,17,41,51,-10,31
Young Boys,5384,1,20,8,4,72,38,34,68
FC Basel,5384,2,19,8,5,63,26,37,65
Lucerne,5384,3,14,7,11,45,46,-1,49
St Gallen,5384,4,14,4,14,45,54,-9,46
FC Zürich,5384,5,10,11,11,39,38,1,41
FC Lugano,5384,6,10,6,16,31,49,-18,36
FC Thun,5384,7,9,6,17,43,63,-20,33
Grasshoppers,5384,8,8,8,16,42,52,-10,32
FC Sion,5384,9,6,10,16,40,54,-14,28
Young Boys,5385,1,20,8,4,65,33,32,68
FC Basel,5385,2,18,8,6,54,25,29,62
Lucerne,5385,3,14,8,10,46,45,1,50
St Gallen,5385,4,14,3,15,40,53,-13,45
FC Zürich,5385,5,11,9,12,43,38,5,42
Grasshoppers,5385,6,10,7,15,46,51,-5,37
FC Lugano,5385,7,10,6,16,30,48,-18,36
FC Sion,5385,8,8,8,16,43,53,-10,32
FC Thun,5385,9,8,5,19,39,60,-21,29
Young Boys,5386,1,22,7,3,70,34,36,73
FC Basel,5386,2,18,8,6,54,26,28,62
Lucerne,5386,3,13,9,10,45,44,1,48
FC Zürich,5386,4,11,9,12,43,39,4,42
St Gallen,5386,5,13,3,16,43,58,-15,42
FC Lugano,5386,6,11,6,15,32,46,-14,39
FC Thun,5386,7,10,6,16,44,55,-11,36
Grasshoppers,5386,8,9,7,16,43,53,-10,34
FC Sion,5386,9,6,7,19,40,59,-19,25
Young Boys,5387,1,20,8,4,69,35,34,68
FC Basel,5387,2,16,9,7,53,32,21,57
St Gallen,5387,3,15,3,14,45,53,-8,48
Lucerne,5387,4,13,8,11,41,41,0,47
FC Zürich,5387,5,10,10,12,43,43,0,40
Grasshoppers,5387,6,11,7,14,45,48,-3,40
FC Lugano,5387,7,10,7,15,33,49,-16,37
FC Thun,5387,8,10,5,17,52,63,-11,35
FC Sion,5387,9,7,7,18,40,57,-17,28
Young Boys,5388,1,21,8,3,69,36,33,71
FC Basel,5388,2,19,7,6,58,25,33,64
St Gallen,5388,3,15,3,14,46,56,-10,48
FC Zürich,5388,4,11,10,11,44,39,5,43
Lucerne,5388,5,11,9,12,40,45,-5,42
Grasshoppers,5388,6,10,7,15,43,48,-5,37
FC Thun,5388,7,10,6,16,42,56,-14,36
FC Lugano,5388,8,9,8,15,33,49,-16,35
FC Sion,5388,9,5,8,19,42,63,-21,23
Young Boys,5389,1,21,7,4,73,35,38,70
FC Basel,5389,2,18,8,6,54,26,28,62
St Gallen,5389,3,15,3,14,46,56,-10,48
FC Zürich,5389,4,11,11,10,44,37,7,44
Lucerne,5389,5,12,7,13,43,49,-6,43
FC Lugano,5389,6,11,7,14,34,46,-12,40
Grasshoppers,5389,7,9,8,15,42,50,-8,35
FC Thun,5389,8,8,8,16,44,60,-16,32
FC Sion,5389,9,6,7,19,39,60,-21,25
Young Boys,5390,1,23,7,2,78,36,42,76
FC Basel,5390,2,18,8,6,54,25,29,62
Lucerne,5390,3,13,7,12,42,44,-2,46
St Gallen,5390,4,14,4,14,43,52,-9,46
FC Zürich,5390,5,12,9,11,41,36,5,45
Grasshoppers,5390,6,10,6,16,42,51,-9,36
FC Lugano,5390,7,9,7,16,30,49,-19,34
FC Thun,5390,8,8,5,19,38,58,-20,29
FC Sion,5390,9,7,7,18,39,56,-17,28
Young Boys,5391,1,23,6,3,73,34,39,75
FC Basel,5391,2,20,7,5,61,27,34,67
St Gallen,5391,3,15,3,14,47,54,-7,48
Lucerne,5391,4,13,7,12,43,48,-5,46
FC Zürich,5391,5,10,9,13,39,38,1,39
Grasshoppers,5391,6,10,6,16,42,52,-10,36
FC Lugano,5391,7,9,6,17,30,49,-19,33
FC Thun,5391,8,9,5,18,43,61,-18,32
FC Sion,5391,9,7,7,18,38,53,-15,28
Young Boys,5392,1,22,7,3,78,37,41,73
FC Basel,5392,2,17,10,5,60,27,33,61
St Gallen,5392,3,14,3,15,41,55,-14,45
Lucerne,5392,4,11,10,11,40,45,-5,43
Grasshoppers,5392,5,11,7,14,43,48,-5,40
FC Lugano,5392,6,11,6,15,33,45,-12,39
FC Zürich,5392,7,9,11,12,38,37,1,38
FC Thun,5392,8,9,5,18,41,65,-24,32
FC Sion,5392,9,6,9,17,42,57,-15,27
Young Boys,5393,1,22,7,3,75,35,40,73
FC Basel,5393,2,19,7,6,56,25,31,64
Lucerne,5393,3,12,9,11,42,46,-4,45
St Gallen,5393,4,14,3,15,40,52,-12,45
FC Lugano,5393,5,11,5,16,32,49,-17,38
FC Zürich,5393,6,9,10,13,39,41,-2,37
FC Thun,5393,7,10,5,17,44,59,-15,35
Grasshoppers,5393,8,9,7,16,42,51,-9,34
FC Sion,5393,9,7,9,16,40,52,-12,30
Young Boys,5394,1,24,6,2,72,30,42,78
FC Basel,5394,2,18,7,7,55,25,30,61
FC Zürich,5394,3,12,9,11,44,38,6,45
St Gallen,5394,4,14,3,15,40,55,-15,45
Lucerne,5394,5,12,8,12,39,44,-5,44
Grasshoppers,5394,6,10,7,15,42,46,-4,37
FC Lugano,5394,7,10,5,17,32,48,-16,35
FC Thun,5394,8,9,5,18,40,62,-22,32
FC Sion,5394,9,6,8,18,40,56,-16,26
Young Boys,5395,1,23,7,2,74,34,40,76
FC Basel,5395,2,18,8,6,57,27,30,62
FC Zürich,5395,3,12,9,11,41,36,5,45
St Gallen,5395,4,14,3,15,44,56,-12,45
Lucerne,5395,5,12,8,12,42,46,-4,44
FC Lugano,5395,6,10,6,16,30,45,-15,36
Grasshoppers,5395,7,9,8,15,45,51,-6,35
FC Sion,5395,8,7,8,17,40,54,-14,29
FC Thun,5395,9,8,5,19,42,66,-24,29
Young Boys,5396,1,23,7,2,72,32,40,76
FC Basel,5396,2,16,8,8,50,30,20,56
Lucerne,5396,3,15,7,10,46,42,4,52
St Gallen,5396,4,15,2,15,43,53,-10,47
FC Zürich,5396,5,11,9,12,41,38,3,42
FC Thun,5396,6,10,6,16,45,57,-12,36
FC Lugano,5396,7,10,6,16,32,48,-16,36
Grasshoppers,5396,8,9,6,17,39,50,-11,33
FC Sion,5396,9,6,7,19,38,56,-18,25
Young Boys,5397,1,20,8,4,69,34,35,68
FC Basel,5397,2,18,9,5,55,22,33,63
St Gallen,5397,3,14,5,13,42,52,-10,47
Lucerne,5397,4,12,10,10,41,43,-2,46
FC Zürich,5397,5,10,10,12,42,40,2,40
Grasshoppers,5397,6,9,8,15,41,48,-7,35
FC Thun,5397,7,9,7,16,43,61,-18,34
FC Lugano,5397,8,9,7,16,31,51,-20,34
FC Sion,5397,9,7,8,17,41,54,-13,29
Young Boys,5398,1,21,8,3,67,31,36,71
FC Basel,5398,2,17,8,7,53,26,27,59
Lucerne,5398,3,14,7,11,43,42,1,49
St Gallen,5398,4,14,4,14,42,55,-13,46
FC Zürich,5398,5,11,10,11,42,36,6,43
Grasshoppers,5398,6,10,6,16,40,50,-10,36
FC Lugano,5398,7,9,7,16,29,46,-17,34
FC Thun,5398,8,9,5,18,41,59,-18,32
FC Sion,5398,9,7,9,16,43,55,-12,30
Young Boys,5399,1,23,6,3,72,31,41,75
FC Basel,5399,2,17,8,7,49,25,24,59
Lucerne,5399,3,14,7,11,47,43,4,49
St Gallen,5399,4,14,3,15,43,57,-14,45
FC Zürich,5399,5,9,12,11,39,36,3,39
Grasshoppers,5399,6,10,6,16,40,52,-12,36
FC Lugano,5399,7,10,6,16,31,48,-17,36
FC Thun,5399,8,9,6,17,43,59,-16,33
FC Sion,5399,9,7,8,17,39,52,-13,29
Young Boys,5400,1,22,7,3,69,32,37,73
FC Basel,5400,2,20,7,5,63,24,39,67
Lucerne,5400,3,13,7,12,43,46,-3,46
St Gallen,5400,4,14,2,16,42,61,-19,44
FC Zürich,5400,5,9,11,12,38,37,1,38
Grasshoppers,5400,6,10,7,15,43,51,-8,37
FC Lugano,5400,7,10,6,16,34,48,-14,36
FC Thun,5400,8,10,5,17,44,64,-20,35
FC Sion,5400,9,6,8,18,41,54,-13,26
Young Boys,5401,1,22,6,4,74,37,37,72
FC Basel,5401,2,17,8,7,57,30,27,59
St Gallen,5401,3,16,2,14,46,54,-8,50
Lucerne,5401,4,13,7,12,46,47,-1,46
FC Zürich,5401,5,9,12,11,40,37,3,39
FC Lugano,5401,6,10,6,16,31,48,-17,36
FC Thun,5401,7,10,5,17,43,58,-15,35
FC Sion,5401,8,8,9,15,42,51,-9,33
Grasshoppers,5401,9,8,7,17,39,56,-17,31
Young Boys,5402,1,22,8,2,71,34,37,74
FC Basel,5402,2,17,9,6,54,26,28,60
Lucerne,5402,3,13,9,10,43,41,2,48
St Gallen,5402,4,13,5,14,41,54,-13,44
FC Zürich,5402,5,10,10,12,42,37,5,40
FC Lugano,5402,6,11,6,15,32,45,-13,39
Grasshoppers,5402,7,9,7,16,39,50,-11,34
FC Sion,5402,8,6,11,15,41,52,-11,29
FC Thun,5402,9,8,5,19,39,63,-24,29
Young Boys,5403,1,21,7,4,68,34,34,70
FC Basel,5403,2,19,7,6,58,28,30,64
Lucerne,5403,3,13,8,11,40,44,-4,47
FC Zürich,5403,4,12,9,11,44,37,7,45
St Gallen,5403,5,14,2,16,42,54,-12,44
FC Lugano,5403,6,11,6,15,31,45,-14,39
FC Thun,5403,7,9,6,17,48,60,-12,33
Grasshoppers,5403,8,8,8,16,38,49,-11,32
FC Sion,5403,9,7,7,18,41,59,-18,28
Young Boys,5404,1,20,9,3,74,36,38,69
FC Basel,5404,2,17,9,6,52,26,26,60
Lucerne,5404,3,14,8,10,47,43,4,50
St Gallen,5404,4,14,2,16,42,55,-13,44
FC Zürich,5404,5,10,11,11,40,36,4,41
FC Lugano,5404,6,11,7,14,32,45,-13,40
Grasshoppers,5404,7,9,8,15,41,51,-10,35
FC Thun,5404,8,9,6,17,43,58,-15,33
FC Sion,5404,9,6,8,18,38,59,-21,26
Young Boys,5405,1,23,6,3,80,35,45,75
FC Basel,5405,2,15,10,7,50,28,22,55
Lucerne,5405,3,12,10,10,41,43,-2,46
St Gallen,5405,4,13,5,14,40,53,-13,44
FC Zürich,5405,5,11,9,12,41,39,2,42
FC Thun,5405,6,11,6,15,45,56,-11,39
FC Lugano,5405,7,10,7,15,33,50,-17,37
Grasshoppers,5405,8,8,7,17,41,55,-14,31
FC Sion,5405,9,7,8,17,42,54,-12,29
Young Boys,5406,1,21,7,4,71,36,35,70
FC Basel,5406,2,17,8,7,54,30,24,59
St Gallen,5406,3,15,3,14,43,55,-12,48
FC Zürich,5406,4,12,9,11,43,35,8,45
Lucerne,5406,5,12,8,12,40,44,-4,44
FC Lugano,5406,6,12,5,15,36,48,-12,41
Grasshoppers,5406,7,10,6,16,42,50,-8,36
FC Thun,5406,8,9,5,18,44,60,-16,32
FC Sion,5406,9,7,7,18,39,54,-15,28
Young Boys,5407,1,23,7,2,73,33,40,76
FC Basel,5407,2,17,7,8,55,30,25,58
St Gallen,5407,3,15,2,15,50,54,-4,47
FC Zürich,5407,4,12,9,11,43,35,8,45
Lucerne,5407,5,12,8,12,41,49,-8,44
Grasshoppers,5407,6,11,6,15,43,49,-6,39
FC Lugano,5407,7,9,7,16,28,50,-22,34
FC Thun,5407,8,9,5,18,42,62,-20,32
FC Sion,5407,9,7,7,18,42,55,-13,28
Young Boys,5408,1,20,9,3,68,34,34,69
FC Basel,5408,2,19,7,6,58,25,33,64
St Gallen,5408,3,14,4,14,44,56,-12,46
Lucerne,5408,4,12,8,12,43,47,-4,44
FC Zürich,5408,5,10,10,12,40,40,0,40
Grasshoppers,5408,6,10,7,15,39,47,-8,37
FC Thun,5408,7,10,5,17,41,57,-16,35
FC Lugano,5408,8,9,7,16,31,49,-18,34
FC Sion,5408,9,7,9,16,42,51,-9,30
Young Boys,5409,1,21,7,4,70,38,32,70
FC Basel,5409,2,16,9,7,51,26,25,57
Lucerne,5409,3,11,11,10,42,44,-2,44
FC Zürich,5409,4,11,10,11,42,36,6,43
St Gallen,5409,5,13,4,15,42,56,-14,43
FC Thun,5409,6,11,5,16,47,59,-12,38
FC Lugano,5409,7,10,8,14,33,47,-14,38
Grasshoppers,5409,8,10,7,15,40,45,-5,37
FC Sion,5409,9,7,7,18,40,56,-16,28
Young Boys,5410,1,21,7,4,70,38,32,70
FC Basel,5410,2,19,8,5,54,22,32,65
Lucerne,5410,3,13,8,11,44,45,-1,47
St Gallen,5410,4,14,2,16,40,55,-15,44
FC Zürich,5410,5,11,10,11,41,34,7,43
Grasshoppers,5410,6,11,7,14,47,49,-2,40
FC Lugano,5410,7,11,6,15,33,47,-14,39
FC Thun,5410,8,9,5,18,44,61,-17,32
FC Sion,5410,9,5,7,20,38,60,-22,22
Young Boys,5411,1,20,7,5,71,39,32,67
FC Basel,5411,2,18,9,5,59,31,28,63
Lucerne,5411,3,12,8,12,40,43,-3,44
St Gallen,5411,4,13,5,14,44,56,-12,44
FC Zürich,5411,5,10,11,11,47,42,5,41
Grasshoppers,5411,6,11,7,14,47,49,-2,40
FC Lugano,5411,7,11,7,14,33,46,-13,40
FC Thun,5411,8,10,6,16,45,59,-14,36
FC Sion,5411,9,5,8,19,41,62,-21,23
Young Boys,5412,1,23,6,3,77,35,42,75
FC Basel,5412,2,17,8,7,55,27,28,59
Lucerne,5412,3,11,11,10,40,43,-3,44
FC Zürich,5412,4,11,9,12,38,35,3,42
St Gallen,5412,5,13,3,16,41,56,-15,42
FC Thun,5412,6,10,6,16,44,61,-17,36
FC Lugano,5412,7,10,6,16,29,48,-19,36
Grasshoppers,5412,8,9,8,15,45,52,-7,35
FC Sion,5412,9,8,7,17,42,54,-12,31
Young Boys,5413,1,23,7,2,74,31,43,76
FC Basel,5413,2,18,7,7,56,29,27,61
St Gallen,5413,3,15,2,15,49,56,-7,47
Lucerne,5413,4,12,9,11,42,47,-5,45
FC Zürich,5413,5,10,11,11,41,37,4,41
FC Thun,5413,6,10,5,17,41,56,-15,35
FC Lugano,5413,7,9,8,15,29,49,-20,35
Grasshoppers,5413,8,8,7,17,38,49,-11,31
FC Sion,5413,9,7,8,17,38,54,-16,29
Young Boys,5414,1,21,6,5,69,35,34,69
FC Basel,5414,2,17,8,7,54,27,27,59
Lucerne,5414,3,13,8,11,47,47,0,47
FC Lugano,5414,4,13,5,14,37,45,-8,44
St Gallen,5414,5,14,2,16,44,61,-17,44
FC Thun,5414,6,11,6,15,46,55,-9,39
FC Zürich,5414,7,9,11,12,37,36,1,38
Grasshoppers,5414,8,9,8,15,39,48,-9,35
FC Sion,5414,9,6,8,18,39,58,-19,26
Young Boys,5415,1,22,7,3,72,35,37,73
FC Basel,5415,2,18,7,7,54,26,28,61
St Gallen,5415,3,16,2,14,43,54,-11,50
Lucerne,5415,4,14,7,11,49,47,2,49
FC Zürich,5415,5,11,10,11,41,35,6,43
Grasshoppers,5415,6,10,7,15,43,48,-5,37
FC Lugano,5415,7,10,5,17,31,50,-19,35
FC Thun,5415,8,9,5,18,41,61,-20,32
FC Sion,5415,9,5,8,19,38,56,-18,23
Young Boys,5416,1,20,10,2,68,31,37,70
FC Basel,5416,2,15,9,8,49,28,21,54
St Gallen,5416,3,15,4,13,46,53,-7,49
Lucerne,5416,4,13,8,11,44,44,0,47
FC Zürich,5416,5,12,9,11,43,34,9,45
FC Lugano,5416,6,10,7,15,31,47,-16,37
Grasshoppers,5416,7,9,8,15,43,52,-9,35
FC Thun,5416,8,9,7,16,42,57,-15,34
FC Sion,5416,9,6,8,18,36,56,-20,26
Young Boys,5417,1,21,9,2,70,33,37,72
FC Basel,5417,2,16,9,7,53,29,24,57
Lucerne,5417,3,13,9,10,40,41,-1,48
St Gallen,5417,4,15,3,14,45,58,-13,48
FC Zürich,5417,5,11,10,11,44,38,6,43
FC Thun,5417,6,11,5,16,47,59,-12,38
FC Lugano,5417,7,10,5,17,32,50,-18,35
Grasshoppers,5417,8,8,8,16,40,50,-10,32
FC Sion,5417,9,6,8,18,44,57,-13,26
Young Boys,5418,1,24,6,2,82,34,48,78
FC Basel,5418,2,18,8,6,53,24,29,62
Lucerne,5418,3,13,9,10,40,45,-5,48
St Gallen,5418,4,14,3,15,41,54,-13,45
FC Zürich,5418,5,10,10,12,38,35,3,40
FC Thun,5418,6,10,6,16,45,59,-14,36
FC Lugano,5418,7,10,5,17,29,49,-20,35
Grasshoppers,5418,8,8,6,18,38,52,-14,30
FC Sion,5418,9,6,9,17,43,57,-14,27
Young Boys,5419,1,23,6,3,73,36,37,75
FC Basel,5419,2,19,7,6,57,23,34,64
Lucerne,5419,3,12,9,11,41,42,-1,45
St Gallen,5419,4,13,4,15,40,54,-14,43
FC Zürich,5419,5,10,10,12,39,37,2,40
FC Lugano,5419,6,10,7,15,32,46,-14,37
FC Thun,5419,7,9,7,16,42,60,-18,34
Grasshoppers,5419,8,8,7,17,40,54,-14,31
FC Sion,5419,9,7,9,16,41,53,-12,30
Young Boys,5420,1,22,7,3,74,34,40,73
FC Basel,5420,2,17,8,7,51,26,25,59
Lucerne,5420,3,14,7,11,45,43,2,49
St Gallen,5420,4,15,2,15,42,53,-11,47
FC Zürich,5420,5,10,12,10,39,34,5,42
Grasshoppers,5420,6,9,7,16,44,54,-10,34
FC Thun,5420,7,9,7,16,43,57,-14,34
FC Lugano,5420,8,9,6,17,30,52,-22,33
FC Sion,5420,9,7,8,17,40,55,-15,29
Young Boys,5421,1,20,7,5,68,37,31,67
FC Basel,5421,2,18,9,5,57,26,31,63
St Gallen,5421,3,13,5,14,42,55,-13,44
Lucerne,5421,4,11,10,11,41,47,-6,43
Grasshoppers,5421,5,12,6,14,43,46,-3,42
FC Zürich,5421,6,10,10,12,40,37,3,40
FC Lugano,5421,7,11,6,15,34,46,-12,39
FC Thun,5421,8,10,5,17,44,57,-13,35
FC Sion,5421,9,6,8,18,38,56,-18,26
Young Boys,5422,1,21,6,5,74,41,33,69
FC Basel,5422,2,18,9,5,55,23,32,63
Lucerne,5422,3,13,9,10,42,42,0,48
St Gallen,5422,4,14,5,13,43,53,-10,47
FC Zürich,5422,5,11,9,12,44,36,8,42
FC Lugano,5422,6,10,6,16,32,48,-16,36
Grasshoppers,5422,7,9,7,16,42,49,-7,34
FC Thun,5422,8,9,5,18,42,68,-26,32
FC Sion,5422,9,7,8,17,44,58,-14,29
Young Boys,5423,1,23,7,2,72,32,40,76
FC Basel,5423,2,16,9,7,50,25,25,57
St Gallen,5423,3,16,3,13,48,54,-6,51
Lucerne,5423,4,12,9,11,45,45,0,45
FC Zürich,5423,5,11,9,12,42,37,5,42
FC Thun,5423,6,11,5,16,45,56,-11,38
FC Lugano,5423,7,10,5,17,30,52,-22,35
Grasshoppers,5423,8,8,8,16,40,51,-11,32
FC Sion,5423,9,5,9,18,39,59,-20,24
Young Boys,5424,1,21,9,2,72,32,40,72
FC Basel,5424,2,19,8,5,55,23,32,65
Lucerne,5424,3,13,8,11,40,43,-3,47
St Gallen,5424,4,14,4,14,43,52,-9,46
FC Zürich,5424,5,11,10,11,41,35,6,43
Grasshoppers,5424,6,9,8,15,41,48,-7,35
FC Lugano,5424,7,9,6,17,27,49,-22,33
FC Thun,5424,8,8,6,18,40,62,-22,30
FC Sion,5424,9,6,9,17,38,53,-15,27
Young Boys,5425,1,21,9,2,72,32,40,72
FC Basel,5425,2,18,8,6,59,29,30,62
St Gallen,5425,3,15,2,15,45,58,-13,47
Lucerne,5425,4,12,7,13,40,49,-9,43
FC Zürich,5425,5,11,9,12,43,37,6,42
Grasshoppers,5425,6,10,8,14,43,47,-4,38
FC Lugano,5425,7,11,5,16,31,46,-15,38
FC Thun,5425,8,10,5,17,48,62,-14,35
FC Sion,5425,9,5,9,18,42,63,-21,24
Young Boys,5426,1,23,6,3,73,34,39,75
FC Basel,5426,2,16,9,7,51,27,24,57
Lucerne,5426,3,14,7,11,44,42,2,49
St Gallen,5426,4,15,3,14,44,54,-10,48
FC Zürich,5426,5,11,9,12,40,37,3,42
FC Thun,5426,6,10,7,15,43,56,-13,37
Grasshoppers,5426,7,9,7,16,40,49,-9,34
FC Lugano,5426,8,9,5,18,32,54,-22,32
FC Sion,5426,9,7,7,18,38,52,-14,28
Young Boys,5427,1,22,6,4,77,38,39,72
FC Basel,5427,2,20,7,5,59,23,36,67
St Gallen,5427,3,13,5,14,41,55,-14,44
Lucerne,5427,4,11,10,11,38,44,-6,43
FC Zürich,5427,5,11,9,12,39,36,3,42
Grasshoppers,5427,6,10,8,14,42,46,-4,38
FC Lugano,5427,7,9,7,16,29,49,-20,34
FC Thun,5427,8,9,5,18,43,62,-19,32
FC Sion,5427,9,6,9,17,39,54,-15,27
Young Boys,5428,1,21,6,5,73,41,32,69
FC Basel,5428,2,19,7,6,57,25,32,64
St Gallen,5428,3,14,3,15,42,57,-15,45
Lucerne,5428,4,12,8,12,38,42,-4,44
Grasshoppers,5428,5,11,6,15,45,51,-6,39
FC Zürich,5428,6,9,10,13,38,38,0,37
FC Sion,5428,7,10,7,15,48,51,-3,37
FC Lugano,5428,8,10,6,16,32,47,-15,36
FC Thun,5428,9,9,5,18,42,63,-21,32
Young Boys,5429,1,21,8,3,71,40,31,71
FC Basel,5429,2,19,8,5,58,23,35,65
Lucerne,5429,3,13,7,12,41,46,-5,46
St Gallen,5429,4,14,3,15,45,57,-12,45
FC Zürich,5429,5,10,11,11,41,37,4,41
FC Lugano,5429,6,9,7,16,30,47,-17,34
FC Sion,5429,7,8,9,15,45,53,-8,33
FC Thun,5429,8,9,6,17,44,60,-16,33
Grasshoppers,5429,9,8,7,17,43,55,-12,31
Young Boys,5430,1,22,6,4,69,31,38,72
FC Basel,5430,2,16,9,7,53,29,24,57
Lucerne,5430,3,14,9,9,43,40,3,51
St Gallen,5430,4,14,4,14,44,57,-13,46
FC Zürich,5430,5,9,13,10,41,37,4,40
FC Lugano,5430,6,10,7,15,32,47,-15,37
FC Thun,5430,7,9,7,16,45,61,-16,34
Grasshoppers,5430,8,8,8,16,38,49,-11,32
FC Sion,5430,9,6,9,17,41,55,-14,27
Young Boys,5431,1,20,9,3,69,35,34,69
FC Basel,5431,2,17,8,7,56,29,27,59
St Gallen,5431,3,16,2,14,44,53,-9,50
Lucerne,5431,4,14,7,11,42,41,1,49
FC Zürich,5431,5,11,11,10,39,33,6,44
FC Lugano,5431,6,9,6,17,30,49,-19,33
Grasshoppers,5431,7,8,8,16,41,53,-12,32
FC Sion,5431,8,7,10,15,41,51,-10,31
FC Thun,5431,9,8,7,17,43,61,-18,31
Young Boys,5432,1,21,7,4,75,39,36,70
FC Basel,5432,2,18,8,6,55,29,26,62
Lucerne,5432,3,13,8,11,45,44,1,47
FC Zürich,5432,4,11,11,10,42,36,6,44
St Gallen,5432,5,14,2,16,40,57,-17,44
FC Lugano,5432,6,10,8,14,34,47,-13,38
Grasshoppers,5432,7,10,6,16,45,53,-8,36
FC Thun,5432,8,10,6,16,48,57,-9,36
FC Sion,5432,9,5,8,19,35,57,-22,23
Young Boys,5433,1,22,7,3,74,36,38,73
FC Basel,5433,2,15,8,9,49,32,17,53
Lucerne,5433,3,14,7,11,44,42,2,49
St Gallen,5433,4,15,4,13,47,55,-8,49
FC Zürich,5433,5,10,10,12,41,37,4,40
FC Thun,5433,6,10,7,15,47,57,-10,37
FC Lugano,5433,7,9,8,15,31,48,-17,35
Grasshoppers,5433,8,9,7,16,44,52,-8,34
FC Sion,5433,9,7,8,17,42,60,-18,29
Young Boys,5434,1,21,7,4,67,33,34,70
FC Basel,5434,2,18,8,6,52,25,27,62
Lucerne,5434,3,15,7,10,44,40,4,52
St Gallen,5434,4,13,4,15,41,56,-15,43
FC Zürich,5434,5,11,9,12,40,36,4,42
FC Lugano,5434,6,11,6,15,33,47,-14,39
Grasshoppers,5434,7,9,7,16,42,51,-9,34
FC Thun,5434,8,8,6,18,43,62,-19,30
FC Sion,5434,9,7,8,17,39,51,-12,29
Young Boys,5435,1,21,7,4,73,35,38,70
FC Basel,5435,2,16,9,7,51,29,22,57
Lucerne,5435,3,14,7,11,44,42,2,49
St Gallen,5435,4,14,3,15,41,54,-13,45
FC Zürich,5435,5,11,10,11,42,36,6,43
Grasshoppers,5435,6,11,6,15,41,47,-6,39
FC Lugano,5435,7,11,6,15,33,48,-15,39
FC Thun,5435,8,8,6,18,42,60,-18,30
FC Sion,5435,9,7,8,17,38,54,-16,29
Young Boys,5436,1,20,8,4,68,35,33,68
FC Basel,5436,2,17,8,7,55,28,27,59
St Gallen,5436,3,15,3,14,45,53,-8,48
Lucerne,5436,4,13,8,11,45,45,0,47
FC Zürich,5436,5,12,10,10,43,36,7,46
Grasshoppers,5436,6,10,7,15,45,51,-6,37
FC Lugano,5436,7,10,5,17,30,50,-20,35
FC Thun,5436,8,9,5,18,42,60,-18,32
FC Sion,5436,9,7,8,17,41,56,-15,29
Young Boys,5437,1,23,7,2,72,30,42,76
FC Basel,5437,2,16,10,6,51,26,25,58
Lucerne,5437,3,15,7,10,46,42,4,52
St Gallen,5437,4,13,3,16,41,57,-16,42
FC Zürich,5437,5,10,11,11,40,36,4,41
FC Thun,5437,6,10,7,15,48,57,-9,37
FC Lugano,5437,7,9,6,17,29,47,-18,33
Grasshoppers,5437,8,8,7,17,39,53,-14,31
FC Sion,5437,9,7,8,17,39,57,-18,29
Young Boys,5438,1,22,8,2,72,34,38,74
FC Basel,5438,2,17,8,7,55,27,28,59
St Gallen,5438,3,15,4,13,42,51,-9,49
Lucerne,5438,4,12,8,12,44,48,-4,44
FC Zürich,5438,5,10,11,11,45,38,7,41
FC Thun,5438,6,11,5,16,46,57,-11,38
FC Lugano,5438,7,10,7,15,33,47,-14,37
Grasshoppers,5438,8,9,7,16,42,57,-15,34
FC Sion,5438,9,5,8,19,39,59,-20,23
Young Boys,5439,1,23,7,2,72,33,39,76
FC Basel,5439,2,16,10,6,56,25,31,58
St Gallen,5439,3,14,4,14,45,54,-9,46
Lucerne,5439,4,11,9,12,41,47,-6,42
FC Zürich,5439,5,10,11,11,42,41,1,41
FC Lugano,5439,6,11,7,14,35,47,-12,40
Grasshoppers,5439,7,11,6,15,47,49,-2,39
FC Thun,5439,8,10,5,17,45,66,-21,35
FC Sion,5439,9,5,7,20,36,57,-21,22
Young Boys,5440,1,22,7,3,74,32,42,73
FC Basel,5440,2,17,9,6,56,28,28,60
St Gallen,5440,3,15,4,13,41,50,-9,49
Lucerne,5440,4,13,9,10,45,41,4,48
FC Zürich,5440,5,11,10,11,44,38,6,43
Grasshoppers,5440,6,9,7,16,42,54,-12,34
FC Thun,5440,7,9,6,17,43,61,-18,33
FC Lugano,5440,8,9,6,17,28,48,-20,33
FC Sion,5440,9,6,8,18,38,59,-21,26
Young Boys,5441,1,24,6,2,77,35,42,78
FC Basel,5441,2,17,7,8,55,30,25,58
St Gallen,5441,3,16,2,14,47,57,-10,50
FC Zürich,5441,4,10,11,11,44,40,4,41
Lucerne,5441,5,11,8,13,40,46,-6,41
Grasshoppers,5441,6,10,7,15,45,47,-2,37
FC Lugano,5441,7,10,6,16,34,53,-19,36
FC Thun,5441,8,10,5,17,47,63,-16,35
FC Sion,5441,9,6,8,18,40,58,-18,26
Young Boys,5442,1,21,7,4,70,35,35,70
FC Basel,5442,2,18,7,7,55,27,28,61
Lucerne,5442,3,15,7,10,46,40,6,52
St Gallen,5442,4,14,3,15,42,55,-13,45
FC Zürich,5442,5,9,10,13,38,39,-1,37
FC Thun,5442,6,10,7,15,46,56,-10,37
FC Lugano,5442,7,10,6,16,29,51,-22,36
Grasshoppers,5442,8,8,8,16,39,50,-11,32
FC Sion,5442,9,8,7,17,41,53,-12,31
Young Boys,5443,1,22,6,4,72,34,38,72
FC Basel,5443,2,19,7,6,61,31,30,64
Lucerne,5443,3,14,7,11,44,43,1,49
FC Zürich,5443,4,12,10,10,44,34,10,46
St Gallen,5443,5,14,2,16,44,59,-15,44
Grasshoppers,5443,6,10,6,16,44,52,-8,36
FC Lugano,5443,7,10,5,17,31,49,-18,35
FC Thun,5443,8,9,6,17,45,63,-18,33
FC Sion,5443,9,6,7,19,41,61,-20,25
Young Boys,5444,1,23,7,2,76,34,42,76
FC Basel,5444,2,16,9,7,55,31,24,57
Lucerne,5444,3,13,8,11,42,44,-2,47
St Gallen,5444,4,15,2,15,46,57,-11,47
FC Zürich,5444,5,10,10,12,42,38,4,40
FC Lugano,5444,6,11,5,16,32,51,-19,38
Grasshoppers,5444,7,10,7,15,47,51,-4,37
FC Thun,5444,8,10,6,16,43,57,-14,36
FC Sion,5444,9,5,8,19,42,62,-20,23
Young Boys,5445,1,23,6,3,72,35,37,75
FC Basel,5445,2,19,7,6,56,24,32,64
Lucerne,5445,3,14,7,11,43,42,1,49
FC Zürich,5445,4,10,11,11,41,35,6,41
St Gallen,5445,5,13,2,17,41,60,-19,41
FC Thun,5445,6,10,6,16,49,58,-9,36
FC Lugano,5445,7,10,6,16,34,50,-16,36
Grasshoppers,5445,8,9,7,16,40,52,-12,34
FC Sion,5445,9,6,8,18,39,59,-20,26
Young Boys,5446,1,21,8,3,67,31,36,71
FC Basel,5446,2,16,10,6,51,25,26,58
Lucerne,5446,3,13,9,10,41,42,-1,48
St Gallen,5446,4,15,2,15,42,54,-12,47
FC Zürich,5446,5,10,9,13,40,39,1,39
FC Lugano,5446,6,10,6,16,29,46,-17,36
Grasshoppers,5446,7,9,8,15,42,49,-7,35
FC Sion,5446,8,9,7,16,46,54,-8,34
FC Thun,5446,9,8,7,17,41,59,-18,31
Young Boys,5447,1,21,8,3,70,36,34,71
FC Basel,5447,2,16,9,7,51,28,23,57
Lucerne,5447,3,14,7,11,46,44,2,49
St Gallen,5447,4,15,3,14,46,55,-9,48
FC Zürich,5447,5,11,9,12,40,37,3,42
FC Thun,5447,6,10,6,16,44,57,-13,36
FC Lugano,5447,7,10,6,16,29,44,-15,36
Grasshoppers,5447,8,9,7,16,39,51,-12,34
FC Sion,5447,9,7,7,18,42,55,-13,28
Young Boys,5448,1,21,9,2,76,35,41,72
FC Basel,5448,2,19,8,5,64,27,37,65
Lucerne,5448,3,12,9,11,40,44,-4,45
St Gallen,5448,4,14,3,15,43,56,-13,45
FC Zürich,5448,5,10,10,12,41,39,2,40
FC Lugano,5448,6,11,5,16,31,49,-18,38
Grasshoppers,5448,7,10,7,15,44,52,-8,37
FC Thun,5448,8,9,6,17,44,62,-18,33
FC Sion,5448,9,5,9,18,38,57,-19,24
Young Boys,5449,1,20,8,4,71,41,30,68
FC Basel,5449,2,18,8,6,56,27,29,62
Lucerne,5449,3,14,7,11,42,41,1,49
St Gallen,5449,4,14,2,16,42,57,-15,44
FC Zürich,5449,5,10,10,12,42,40,2,40
FC Lugano,5449,6,11,6,15,33,46,-13,39
FC Thun,5449,7,10,5,17,44,59,-15,35
FC Sion,5449,8,9,7,16,48,55,-7,34
Grasshoppers,5449,9,8,7,17,42,54,-12,31
Young Boys,5450,1,21,8,3,72,37,35,71
FC Basel,5450,2,18,8,6,56,24,32,62
FC Zürich,5450,3,11,10,11,40,36,4,43
Lucerne,5450,4,11,10,11,40,45,-5,43
FC Lugano,5450,5,12,6,14,32,44,-12,42
St Gallen,5450,6,13,3,16,41,59,-18,42
Grasshoppers,5450,7,9,9,14,39,45,-6,36
FC Thun,5450,8,9,7,16,42,57,-15,34
FC Sion,5450,9,6,7,19,43,58,-15,25
Young Boys,5451,1,20,8,4,68,36,32,68
FC Basel,5451,2,16,10,6,53,28,25,58
St Gallen,5451,3,16,3,13,44,51,-7,51
Lucerne,5451,4,12,7,13,42,44,-2,43
FC Zürich,5451,5,10,10,12,41,38,3,40
FC Lugano,5451,6,11,6,15,30,47,-17,39
FC Thun,5451,7,10,6,16,47,59,-12,36
Grasshoppers,5451,8,9,8,15,42,50,-8,35
FC Sion,5451,9,7,8,17,39,53,-14,29
Young Boys,5452,1,23,7,2,79,33,46,76
FC Basel,5452,2,17,8,7,54,28,26,59
FC Zürich,5452,3,12,10,10,43,34,9,46
Lucerne,5452,4,12,10,10,45,46,-1,46
St Gallen,5452,5,13,3,16,42,58,-16,42
FC Lugano,5452,6,10,5,17,33,53,-20,35
FC Thun,5452,7,9,7,16,42,59,-17,34
Grasshoppers,5452,8,8,8,16,37,49,-12,32
FC Sion,5452,9,7,8,17,40,55,-15,29
Young Boys,5453,1,23,7,2,72,32,40,76
FC Basel,5453,2,19,8,5,57,24,33,65
St Gallen,5453,3,15,2,15,45,55,-10,47
Lucerne,5453,4,13,7,12,45,44,1,46
FC Lugano,5453,5,11,5,16,33,48,-15,38
FC Zürich,5453,6,9,10,13,37,38,-1,37
Grasshoppers,5453,7,10,6,16,43,51,-8,36
FC Thun,5453,8,10,5,17,42,59,-17,35
FC Sion,5453,9,5,8,19,34,57,-23,23
Young Boys,5454,1,22,7,3,76,37,39,73
FC Basel,5454,2,19,7,6,58,23,35,64
St Gallen,5454,3,16,2,14,46,52,-6,50
Lucerne,5454,4,13,7,12,47,48,-1,46
FC Zürich,5454,5,11,9,12,41,35,6,42
FC Lugano,5454,6,10,5,17,29,51,-22,35
Grasshoppers,5454,7,9,7,16,41,53,-12,34
FC Thun,5454,8,9,5,18,43,64,-21,32
FC Sion,5454,9,7,7,18,39,57,-18,28
Young Boys,5455,1,22,8,2,69,31,38,74
FC Basel,5455,2,19,7,6,58,27,31,64
St Gallen,5455,3,14,4,14,44,56,-12,46
Lucerne,5455,4,12,9,11,44,42,2,45
FC Zürich,5455,5,9,12,11,40,39,1,39
Grasshoppers,5455,6,9,8,15,42,48,-6,35
FC Lugano,5455,7,9,7,16,29,51,-22,34
FC Sion,5455,8,7,9,16,41,51,-10,30
FC Thun,5455,9,8,6,18,42,64,-22,30
Young Boys,5456,1,21,8,3,69,35,34,71
FC Basel,5456,2,18,7,7,54,27,27,61
Lucerne,5456,3,13,8,11,43,43,0,47
St Gallen,5456,4,14,2,16,42,54,-12,44
FC Zürich,5456,5,10,11,11,39,35,4,41
FC Lugano,5456,6,11,6,15,30,44,-14,39
FC Thun,5456,7,9,7,16,45,61,-16,34
Grasshoppers,5456,8,8,9,15,46,56,-10,33
FC Sion,5456,9,6,10,16,41,54,-13,28
Young Boys,5457,1,23,7,2,72,29,43,76
FC Basel,5457,2,15,9,8,47,25,22,54
Lucerne,5457,3,13,8,11,43,46,-3,47
St Gallen,5457,4,14,5,13,48,53,-5,47
FC Zürich,5457,5,11,9,12,40,38,2,42
FC Thun,5457,6,12,5,15,48,53,-5,41
Grasshoppers,5457,7,9,7,16,38,48,-10,34
FC Lugano,5457,8,9,6,17,32,54,-22,33
FC Sion,5457,9,6,8,18,38,60,-22,26
Young Boys,5458,1,23,6,3,74,34,40,75
FC Basel,5458,2,19,8,5,61,27,34,65
Lucerne,5458,3,12,8,12,44,48,-4,44
St Gallen,5458,4,13,3,16,41,62,-21,42
FC Zürich,5458,5,10,9,13,41,41,0,39
FC Lugano,5458,6,11,6,15,37,50,-13,39
Grasshoppers,5458,7,10,6,16,43,47,-4,36
FC Sion,5458,8,9,7,16,43,52,-9,34
FC Thun,5458,9,8,5,19,40,63,-23,29
Young Boys,5459,1,23,6,3,73,32,41,75
FC Basel,5459,2,19,8,5,55,25,30,65
St Gallen,5459,3,16,2,14,44,51,-7,50
Lucerne,5459,4,12,7,13,39,45,-6,43
FC Zürich,5459,5,9,11,12,39,38,1,38
FC Thun,5459,6,11,5,16,48,59,-11,38
FC Lugano,5459,7,10,5,17,30,47,-17,35
Grasshoppers,5459,8,9,7,16,40,51,-11,34
FC Sion,5459,9,5,9,18,37,57,-20,24
Young Boys,5460,1,22,7,3,73,31,42,73
FC Basel,5460,2,17,8,7,52,28,24,59
Lucerne,5460,3,13,8,11,42,43,-1,47
FC Zürich,5460,4,12,10,10,46,37,9,46
St Gallen,5460,5,14,3,15,41,54,-13,45
Grasshoppers,5460,6,11,6,15,42,49,-7,39
FC Thun,5460,7,10,5,17,43,58,-15,35
FC Lugano,5460,8,9,6,17,31,53,-22,33
FC Sion,5460,9,5,9,18,38,55,-17,24
Young Boys,5461,1,21,6,5,73,39,34,69
FC Basel,5461,2,17,7,8,48,24,24,58
Lucerne,5461,3,13,9,10,40,41,-1,48
St Gallen,5461,4,14,4,14,44,55,-11,46
FC Zürich,5461,5,12,9,11,42,33,9,45
Grasshoppers,5461,6,9,8,15,41,51,-10,35
FC Lugano,5461,7,9,7,16,30,51,-21,34
FC Sion,5461,8,8,9,15,46,53,-7,33
FC Thun,5461,9,9,5,18,42,59,-17,32
Young Boys,5462,1,22,7,3,78,35,43,73
FC Basel,5462,2,18,8,6,55,28,27,62
Lucerne,5462,3,13,7,12,48,48,0,46
FC Zürich,5462,4,12,9,11,43,35,8,45
St Gallen,5462,5,14,3,15,42,53,-11,45
FC Lugano,5462,6,10,6,16,29,49,-20,36
Grasshoppers,5462,7,9,6,17,44,56,-12,33
FC Thun,5462,8,9,6,17,42,59,-17,33
FC Sion,5462,9,7,8,17,39,57,-18,29
Young Boys,5463,1,20,10,2,68,33,35,70
FC Basel,5463,2,17,8,7,52,28,24,59
Lucerne,5463,3,13,9,10,47,44,3,48
St Gallen,5463,4,13,2,17,42,60,-18,41
FC Zürich,5463,5,10,10,12,41,37,4,40
FC Lugano,5463,6,10,8,14,33,47,-14,38
Grasshoppers,5463,7,9,9,14,40,47,-7,36
FC Thun,5463,8,10,6,16,47,60,-13,36
FC Sion,5463,9,7,8,17,39,53,-14,29
Young Boys,5464,1,22,7,3,71,35,36,73
FC Basel,5464,2,19,8,5,56,24,32,65
St Gallen,5464,3,15,3,14,46,53,-7,48
Lucerne,5464,4,12,8,12,41,45,-4,44
FC Zürich,5464,5,10,9,13,38,37,1,39
FC Thun,5464,6,11,5,16,43,56,-13,38
FC Lugano,5464,7,10,6,16,31,49,-18,36
Grasshoppers,5464,8,9,7,16,37,48,-11,34
FC Sion,5464,9,6,7,19,39,55,-16,25
Young Boys,5465,1,22,6,4,70,37,33,72
FC Basel,5465,2,17,10,5,56,27,29,61
St Gallen,5465,3,15,4,13,43,51,-8,49
Lucerne,5465,4,12,9,11,43,45,-2,45
FC Zürich,5465,5,11,9,12,41,38,3,42
FC Thun,5465,6,11,6,15,44,55,-11,39
Grasshoppers,5465,7,10,7,15,42,49,-7,37
FC Lugano,5465,8,9,5,18,29,49,-20,32
FC Sion,5465,9,5,8,19,37,54,-17,23
Young Boys,5466,1,21,7,4,74,39,35,70
FC Basel,5466,2,17,9,6,54,28,26,60
Lucerne,5466,3,13,9,10,47,43,4,48
St Gallen,5466,4,13,6,13,44,55,-11,45
FC Zürich,5466,5,11,11,10,41,33,8,44
Grasshoppers,5466,6,10,6,16,42,53,-11,36
FC Thun,5466,7,10,6,16,43,59,-16,36
FC Lugano,5466,8,9,6,17,30,49,-19,33
FC Sion,5466,9,5,10,17,41,57,-16,25
Young Boys,5467,1,21,7,4,69,35,34,70
FC Basel,5467,2,18,7,7,54,27,27,61
Lucerne,5467,3,16,7,9,46,41,5,55
FC Zürich,5467,4,11,10,11,40,35,5,43
St Gallen,5467,5,13,3,16,42,57,-15,42
Grasshoppers,5467,6,9,7,16,43,52,-9,34
FC Thun,5467,7,9,7,16,45,59,-14,34
FC Lugano,5467,8,9,6,17,31,49,-18,33
FC Sion,5467,9,7,8,17,41,56,-15,29
Young Boys,5468,1,21,8,3,71,36,35,71
FC Basel,5468,2,19,8,5,56,25,31,65
Lucerne,5468,3,14,7,11,45,44,1,49
St Gallen,5468,4,14,2,16,42,55,-13,44
FC Zürich,5468,5,11,10,11,43,38,5,43
FC Lugano,5468,6,11,6,15,34,47,-13,39
Grasshoppers,5468,7,9,7,16,44,54,-10,34
FC Thun,5468,8,9,6,17,46,62,-16,33
FC Sion,5468,9,5,8,19,37,57,-20,23
Young Boys,5469,1,20,8,4,67,38,29,68
FC Basel,5469,2,17,7,8,54,30,24,58
Lucerne,5469,3,14,8,10,46,41,5,50
St Gallen,5469,4,14,3,15,43,55,-12,45
FC Zürich,5469,5,11,10,11,44,38,6,43
FC Lugano,5469,6,10,7,15,33,52,-19,37
Grasshoppers,5469,7,9,8,15,41,48,-7,35
FC Sion,5469,8,8,8,16,44,51,-7,32
FC Thun,5469,9,9,5,18,42,61,-19,32
Young Boys,5470,1,23,7,2,77,33,44,76
FC Basel,5470,2,16,8,8,48,26,22,56
St Gallen,5470,3,15,3,14,42,51,-9,48
Lucerne,5470,4,13,7,12,44,45,-1,46
FC Zürich,5470,5,11,9,12,40,37,3,42
Grasshoppers,5470,6,10,8,14,45,51,-6,38
FC Thun,5470,7,10,5,17,46,60,-14,35
FC Lugano,5470,8,10,5,17,29,52,-23,35
FC Sion,5470,9,6,8,18,43,59,-16,26
Young Boys,5471,1,22,6,4,70,32,38,72
FC Basel,5471,2,18,7,7,56,27,29,61
Lucerne,5471,3,13,8,11,40,46,-6,47
St Gallen,5471,4,14,3,15,41,52,-11,45
FC Zürich,5471,5,10,11,11,42,38,4,41
FC Lugano,5471,6,10,7,15,30,45,-15,37
Grasshoppers,5471,7,9,8,15,39,48,-9,35
FC Thun,5471,8,9,6,17,42,58,-16,33
FC Sion,5471,9,6,10,16,40,54,-14,28
Young Boys,5472,1,21,9,2,75,33,42,72
FC Basel,5472,2,18,8,6,54,25,29,62
Lucerne,5472,3,14,7,11,43,44,-1,49
St Gallen,5472,4,13,4,15,41,55,-14,43
FC Zürich,5472,5,10,11,11,42,39,3,41
FC Lugano,5472,6,10,6,16,31,49,-18,36
Grasshoppers,5472,7,9,7,16,41,51,-10,34
FC Thun,5472,8,8,7,17,43,62,-19,31
FC Sion,5472,9,6,11,15,41,53,-12,29
Young Boys,5473,1,20,8,4,66,34,32,68
FC Basel,5473,2,18,8,6,55,23,32,62
St Gallen,5473,3,14,3,15,42,54,-12,45
Lucerne,5473,4,12,8,12,38,43,-5,44
FC Zürich,5473,5,11,9,12,39,37,2,42
Grasshoppers,5473,6,11,6,15,44,48,-4,39
FC Lugano,5473,7,11,6,15,31,44,-13,39
FC Thun,5473,8,9,5,18,42,62,-20,32
FC Sion,5473,9,7,9,16,42,54,-12,30
Young Boys,5474,1,22,7,3,73,35,38,73
FC Basel,5474,2,18,8,6,58,29,29,62
St Gallen,5474,3,14,2,16,45,58,-13,44
Lucerne,5474,4,12,7,13,41,44,-3,43
FC Zürich,5474,5,10,10,12,41,38,3,40
FC Lugano,5474,6,11,6,15,30,45,-15,39
FC Sion,5474,7,9,7,16,45,53,-8,34
Grasshoppers,5474,8,9,7,16,40,52,-12,34
FC Thun,5474,9,9,6,17,41,60,-19,33
Young Boys,5475,1,21,8,3,69,33,36,71
FC Basel,5475,2,17,10,5,51,24,27,61
Lucerne,5475,3,12,10,10,45,42,3,46
St Gallen,5475,4,14,4,14,45,56,-11,46
FC Zürich,5475,5,9,12,11,40,37,3,39
FC Sion,5475,6,9,8,15,43,51,-8,35
FC Lugano,5475,7,9,8,15,30,47,-17,35
Grasshoppers,5475,8,8,7,17,38,54,-16,31
FC Thun,5475,9,8,7,17,41,58,-17,31
Young Boys,5476,1,19,9,4,66,35,31,66
FC Basel,5476,2,18,8,6,53,26,27,62
St Gallen,5476,3,15,3,14,45,54,-9,48
Lucerne,5476,4,13,8,11,41,43,-2,47
FC Zürich,5476,5,12,9,11,43,37,6,45
FC Thun,5476,6,11,5,16,47,58,-11,38
FC Lugano,5476,7,10,6,16,28,44,-16,36
Grasshoppers,5476,8,9,7,16,40,49,-9,34
FC Sion,5476,9,6,7,19,39,56,-17,25
FC Basel,5477,1,20,7,5,62,25,37,67
Young Boys,5477,2,20,7,5,69,42,27,67
Lucerne,5477,3,12,8,12,41,48,-7,44
FC Lugano,5477,4,12,6,14,37,43,-6,42
FC Zürich,5477,5,10,11,11,42,38,4,41
St Gallen,5477,6,13,2,17,42,60,-18,41
Grasshoppers,5477,7,9,8,15,39,48,-9,35
FC Thun,5477,8,9,7,16,42,59,-17,34
FC Sion,5477,9,7,8,17,42,53,-11,29
Young Boys,5478,1,22,7,3,72,34,38,73
FC Basel,5478,2,18,7,7,55,27,28,61
Lucerne,5478,3,13,8,11,43,42,1,47
St Gallen,5478,4,13,4,15,40,55,-15,43
FC Zürich,5478,5,11,9,12,40,36,4,42
FC Lugano,5478,6,10,6,16,30,49,-19,36
Grasshoppers,5478,7,9,8,15,40,49,-9,35
FC Thun,5478,8,9,6,17,44,60,-16,33
FC Sion,5478,9,7,9,16,42,54,-12,30
Young Boys,5479,1,23,7,2,76,34,42,76
FC Basel,5479,2,17,9,6,51,24,27,60
St Gallen,5479,3,15,4,13,43,52,-9,49
FC Zürich,5479,4,10,11,11,40,38,2,41
Lucerne,5479,5,11,8,13,40,46,-6,41
FC Lugano,5479,6,11,6,15,35,47,-12,39
Grasshoppers,5479,7,9,7,16,38,49,-11,34
FC Thun,5479,8,9,5,18,42,60,-18,32
FC Sion,5479,9,6,9,17,40,55,-15,27
Young Boys,5480,1,22,7,3,72,35,37,73
FC Basel,5480,2,18,8,6,54,27,27,62
Lucerne,5480,3,14,7,11,44,44,0,49
St Gallen,5480,4,14,3,15,44,59,-15,45
FC Zürich,5480,5,11,9,12,40,35,5,42
Grasshoppers,5480,6,10,7,15,42,49,-7,37
FC Thun,5480,7,9,6,17,43,58,-15,33
FC Lugano,5480,8,9,6,17,34,53,-19,33
FC Sion,5480,9,6,9,17,42,55,-13,27
Young Boys,5481,1,20,8,4,68,33,35,68
FC Basel,5481,2,19,8,5,54,22,32,65
St Gallen,5481,3,15,3,14,42,51,-9,48
Lucerne,5481,4,12,9,11,43,46,-3,45
FC Zürich,5481,5,10,9,13,44,41,3,39
Grasshoppers,5481,6,10,7,15,40,48,-8,37
FC Lugano,5481,7,10,7,15,29,45,-16,37
FC Thun,5481,8,10,6,16,44,57,-13,36
FC Sion,5481,9,5,9,18,38,59,-21,24
Young Boys,5482,1,20,7,5,72,41,31,67
FC Basel,5482,2,18,7,7,58,27,31,61
St Gallen,5482,3,17,2,13,47,51,-4,53
FC Zürich,5482,4,11,11,10,41,34,7,44
Lucerne,5482,5,12,8,12,41,49,-8,44
Grasshoppers,5482,6,10,6,16,43,50,-7,36
FC Thun,5482,7,9,6,17,42,59,-17,33
FC Lugano,5482,8,9,6,17,29,50,-21,33
FC Sion,5482,9,8,7,17,40,52,-12,31
Young Boys,5483,1,21,7,4,70,34,36,70
FC Basel,5483,2,16,9,7,51,27,24,57
St Gallen,5483,3,15,3,14,46,53,-7,48
Lucerne,5483,4,13,8,11,45,49,-4,47
FC Zürich,5483,5,10,11,11,39,36,3,41
FC Sion,5483,6,9,7,16,41,50,-9,34
Grasshoppers,5483,7,9,7,16,40,50,-10,34
FC Thun,5483,8,9,7,16,42,57,-15,34
FC Lugano,5483,9,9,7,16,31,49,-18,34
Young Boys,5484,1,23,6,3,72,33,39,75
FC Basel,5484,2,17,9,6,57,28,29,60
Lucerne,5484,3,13,9,10,46,43,3,48
St Gallen,5484,4,15,2,15,42,55,-13,47
FC Zürich,5484,5,10,11,11,39,36,3,41
Grasshoppers,5484,6,10,6,16,47,55,-8,36
FC Thun,5484,7,10,5,17,48,66,-18,35
FC Lugano,5484,8,9,7,16,31,50,-19,34
FC Sion,5484,9,6,7,19,39,55,-16,25
Young Boys,5485,1,22,6,4,71,33,38,72
FC Basel,5485,2,18,8,6,58,30,28,62
St Gallen,5485,3,14,3,15,48,58,-10,45
Lucerne,5485,4,12,8,12,44,49,-5,44
Grasshoppers,5485,5,11,6,15,44,49,-5,39
FC Zürich,5485,6,9,10,13,38,41,-3,37
FC Lugano,5485,7,10,6,16,33,52,-19,36
FC Thun,5485,8,10,5,17,48,63,-15,35
FC Sion,5485,9,8,8,16,44,53,-9,32
Young Boys,5486,1,23,7,2,77,36,41,76
FC Basel,5486,2,18,7,7,54,30,24,61
Lucerne,5486,3,13,7,12,42,45,-3,46
St Gallen,5486,4,14,3,15,43,55,-12,45
FC Zürich,5486,5,10,11,11,40,36,4,41
Grasshoppers,5486,6,10,6,16,41,48,-7,36
FC Sion,5486,7,8,9,15,42,51,-9,33
FC Lugano,5486,8,9,6,17,30,49,-19,33
FC Thun,5486,9,8,6,18,43,62,-19,30
Young Boys,5487,1,20,7,5,70,37,33,67
FC Basel,5487,2,17,8,7,53,27,26,59
Lucerne,5487,3,14,8,10,45,42,3,50
St Gallen,5487,4,16,2,14,47,54,-7,50
FC Zürich,5487,5,11,9,12,41,38,3,42
FC Lugano,5487,6,11,5,16,32,49,-17,38
Grasshoppers,5487,7,10,6,16,41,50,-9,36
FC Thun,5487,8,9,6,17,43,60,-17,33
FC Sion,5487,9,7,7,18,40,55,-15,28
Young Boys,5488,1,21,6,5,72,39,33,69
FC Basel,5488,2,18,8,6,55,27,28,62
St Gallen,5488,3,15,3,14,42,52,-10,48
Lucerne,5488,4,13,7,12,44,47,-3,46
FC Lugano,5488,5,12,5,15,33,46,-13,41
FC Zürich,5488,6,10,10,12,41,37,4,40
Grasshoppers,5488,7,10,7,15,42,48,-6,37
FC Thun,5488,8,10,6,16,43,56,-13,36
FC Sion,5488,9,5,8,19,36,56,-20,23
Young Boys,5489,1,23,7,2,78,37,41,76
FC Basel,5489,2,19,7,6,54,25,29,64
Lucerne,5489,3,13,9,10,45,43,2,48
St Gallen,5489,4,13,2,17,44,64,-20,41
FC Zürich,5489,5,10,10,12,44,36,8,40
FC Lugano,5489,6,11,6,15,33,50,-17,39
FC Thun,5489,7,9,6,17,42,61,-19,33
Grasshoppers,5489,8,8,7,17,41,52,-11,31
FC Sion,5489,9,7,8,17,49,62,-13,29
Young Boys,5490,1,21,6,5,72,39,33,69
FC Basel,5490,2,18,8,6,51,25,26,62
St Gallen,5490,3,15,4,13,44,52,-8,49
Lucerne,5490,4,13,7,12,40,42,-2,46
FC Zürich,5490,5,12,9,11,43,35,8,45
FC Thun,5490,6,10,6,16,44,57,-13,36
Grasshoppers,5490,7,9,7,16,41,50,-9,34
FC Lugano,5490,8,9,5,18,28,50,-22,32
FC Sion,5490,9,6,10,16,41,54,-13,28
Young Boys,5491,1,20,9,3,74,35,39,69
FC Basel,5491,2,17,9,6,54,26,28,60
Lucerne,5491,3,13,10,9,43,42,1,49
FC Zürich,5491,4,11,11,10,41,35,6,44
St Gallen,5491,5,13,3,16,40,57,-17,42
FC Lugano,5491,6,9,9,14,31,46,-15,36
FC Thun,5491,7,9,7,16,43,55,-12,34
Grasshoppers,5491,8,8,8,16,39,52,-13,32
FC Sion,5491,9,7,8,17,38,55,-17,29
Young Boys,5492,1,23,6,3,75,32,43,75
FC Basel,5492,2,17,8,7,55,28,27,59
Lucerne,5492,3,13,8,11,43,44,-1,47
St Gallen,5492,4,14,4,14,44,55,-11,46
FC Zürich,5492,5,10,9,13,40,41,-1,39
FC Lugano,5492,6,10,7,15,32,46,-14,37
FC Thun,5492,7,9,6,17,42,60,-18,33
FC Sion,5492,8,8,8,16,42,54,-12,32
Grasshoppers,5492,9,8,8,16,39,52,-13,32
Young Boys,5493,1,20,9,3,69,35,34,69
FC Basel,5493,2,17,10,5,51,23,28,61
Lucerne,5493,3,12,10,10,41,43,-2,46
St Gallen,5493,4,13,5,14,43,55,-12,44
FC Zürich,5493,5,10,10,12,38,35,3,40
FC Lugano,5493,6,10,7,15,31,45,-14,37
Grasshoppers,5493,7,9,9,14,43,49,-6,36
FC Thun,5493,8,9,7,16,40,55,-15,34
FC Sion,5493,9,6,9,17,39,55,-16,27
Young Boys,5494,1,20,7,5,71,40,31,67
FC Basel,5494,2,17,8,7,54,27,27,59
Lucerne,5494,3,13,9,10,45,42,3,48
St Gallen,5494,4,15,3,14,42,55,-13,48
FC Zürich,5494,5,11,9,12,43,40,3,42
FC Lugano,5494,6,11,5,16,35,52,-17,38
FC Thun,5494,7,10,5,17,49,63,-14,35
FC Sion,5494,8,8,8,16,46,53,-7,32
Grasshoppers,5494,9,8,8,16,40,53,-13,32
Young Boys,5495,1,22,7,3,74,35,39,73
FC Basel,5495,2,19,8,5,59,25,34,65
Lucerne,5495,3,13,8,11,43,45,-2,47
St Gallen,5495,4,14,4,14,42,55,-13,46
FC Zürich,5495,5,9,10,13,39,38,1,37
FC Lugano,5495,6,10,6,16,30,50,-20,36
FC Thun,5495,7,9,7,16,46,60,-14,34
Grasshoppers,5495,8,8,8,16,39,52,-13,32
FC Sion,5495,9,7,8,17,44,56,-12,29
Young Boys,5496,1,21,7,4,71,36,35,70
FC Basel,5496,2,17,7,8,51,26,25,58
St Gallen,5496,3,14,4,14,42,53,-11,46
FC Zürich,5496,4,11,11,10,41,35,6,44
Lucerne,5496,5,12,8,12,44,46,-2,44
Grasshoppers,5496,6,11,7,14,44,49,-5,40
FC Lugano,5496,7,10,7,15,31,49,-18,37
FC Thun,5496,8,9,5,18,42,60,-18,32
FC Sion,5496,9,7,8,17,43,55,-12,29
Young Boys,5497,1,21,7,4,70,35,35,70
FC Basel,5497,2,19,8,5,58,26,32,65
Lucerne,5497,3,13,7,12,41,45,-4,46
St Gallen,5497,4,13,5,14,40,53,-13,44
FC Zürich,5497,5,10,10,12,40,37,3,40
FC Lugano,5497,6,11,6,15,31,45,-14,39
Grasshoppers,5497,7,10,7,15,43,49,-6,37
FC Thun,5497,8,9,7,16,43,58,-15,34
FC Sion,5497,9,5,9,18,37,55,-18,24
Young Boys,5498,1,21,8,3,75,40,35,71
FC Basel,5498,2,18,8,6,55,24,31,62
St Gallen,5498,3,15,3,14,44,54,-10,48
Lucerne,5498,4,13,8,11,45,46,-1,47
FC Zürich,5498,5,11,10,11,40,33,7,43
Grasshoppers,5498,6,10,7,15,42,47,-5,37
FC Lugano,5498,7,10,5,17,32,50,-18,35
FC Thun,5498,8,8,6,18,39,61,-22,30
FC Sion,5498,9,7,7,18,40,57,-17,28
Young Boys,5499,1,21,8,3,72,33,39,71
FC Basel,5499,2,18,9,5,53,24,29,63
Lucerne,5499,3,12,8,12,39,44,-5,44
St Gallen,5499,4,14,2,16,41,57,-16,44
FC Lugano,5499,5,12,6,14,35,44,-9,42
FC Zürich,5499,6,10,10,12,40,38,2,40
FC Thun,5499,7,10,5,17,44,59,-15,35
Grasshoppers,5499,8,8,7,17,37,49,-12,31
FC Sion,5499,9,8,7,17,41,54,-13,31
Young Boys,5500,1,21,8,3,69,36,33,71
FC Basel,5500,2,18,9,5,54,24,30,63
Lucerne,5500,3,12,11,9,40,40,0,47
FC Zürich,5500,4,11,10,11,45,41,4,43
St Gallen,5500,5,13,2,17,40,57,-17,41
Grasshoppers,5500,6,11,7,14,42,45,-3,40
FC Lugano,5500,7,10,7,15,32,47,-15,37
FC Thun,5500,8,9,5,18,43,59,-16,32
FC Sion,5500,9,6,7,19,39,55,-16,25
FC Basel,5501,1,20,7,5,60,27,33,67
Young Boys,5501,2,20,7,5,68,37,31,67
Lucerne,5501,3,13,8,11,43,44,-1,47
St Gallen,5501,4,14,3,15,45,56,-11,45
FC Lugano,5501,5,12,5,15,32,46,-14,41
FC Zürich,5501,6,10,9,13,40,37,3,39
FC Thun,5501,7,10,6,16,45,58,-13,36
Grasshoppers,5501,8,9,7,16,39,50,-11,34
FC Sion,5501,9,6,8,18,41,58,-17,26
Young Boys,5502,1,21,7,4,70,37,33,70
FC Basel,5502,2,18,9,5,55,22,33,63
St Gallen,5502,3,13,5,14,42,55,-13,44
Lucerne,5502,4,11,9,12,41,47,-6,42
FC Lugano,5502,5,12,6,14,34,45,-11,42
Grasshoppers,5502,6,11,6,15,42,48,-6,39
FC Zürich,5502,7,9,10,13,38,38,0,37
FC Thun,5502,8,9,6,17,44,58,-14,33
FC Sion,5502,9,7,8,17,39,55,-16,29
Young Boys,5503,1,22,7,3,77,38,39,73
FC Basel,5503,2,19,8,5,53,22,31,65
St Gallen,5503,3,15,3,14,43,52,-9,48
Lucerne,5503,4,13,7,12,44,49,-5,46
FC Zürich,5503,5,10,10,12,39,36,3,40
FC Sion,5503,6,8,9,15,43,51,-8,33
Grasshoppers,5503,7,9,6,17,41,52,-11,33
FC Lugano,5503,8,9,6,17,30,49,-19,33
FC Thun,5503,9,8,6,18,41,62,-21,30
Young Boys,5504,1,22,7,3,75,36,39,73
FC Basel,5504,2,18,9,5,58,26,32,63
St Gallen,5504,3,14,3,15,42,56,-14,45
Lucerne,5504,4,11,9,12,40,46,-6,42
FC Zürich,5504,5,10,10,12,38,38,0,40
FC Lugano,5504,6,10,7,15,33,49,-16,37
FC Thun,5504,7,10,6,16,47,61,-14,36
Grasshoppers,5504,8,8,8,16,38,50,-12,32
FC Sion,5504,9,7,9,16,44,53,-9,30
Young Boys,5505,1,23,7,2,81,31,50,76
FC Basel,5505,2,18,8,6,54,24,30,62
St Gallen,5505,3,14,4,14,48,58,-10,46
FC Zürich,5505,4,11,9,12,40,35,5,42
Lucerne,5505,5,11,9,12,41,52,-11,42
FC Lugano,5505,6,10,7,15,34,54,-20,37
Grasshoppers,5505,7,9,7,16,42,50,-8,34
FC Thun,5505,8,9,5,18,42,62,-20,32
FC Sion,5505,9,7,8,17,41,57,-16,29
Young Boys,5506,1,23,6,3,73,36,37,75
FC Basel,5506,2,19,7,6,53,25,28,64
Lucerne,5506,3,13,7,12,42,44,-2,46
St Gallen,5506,4,14,3,15,45,60,-15,45
FC Zürich,5506,5,10,9,13,43,40,3,39
FC Thun,5506,6,10,7,15,46,58,-12,37
Grasshoppers,5506,7,9,7,16,45,49,-4,34
FC Lugano,5506,8,9,6,17,28,49,-21,33
FC Sion,5506,9,7,8,17,46,60,-14,29
Young Boys,5507,1,21,7,4,70,36,34,70
FC Basel,5507,2,18,7,7,52,27,25,61
St Gallen,5507,3,14,5,13,44,52,-8,47
FC Zürich,5507,4,11,11,10,39,33,6,44
Lucerne,5507,5,11,8,13,39,46,-7,41
FC Lugano,5507,6,11,7,14,32,44,-12,40
Grasshoppers,5507,7,10,7,15,43,50,-7,37
FC Thun,5507,8,9,7,16,46,60,-14,34
FC Sion,5507,9,5,9,18,39,56,-17,24
Young Boys,5508,1,22,8,2,72,35,37,74
FC Basel,5508,2,17,8,7,49,24,25,59
St Gallen,5508,3,16,2,14,44,53,-9,50
Lucerne,5508,4,12,10,10,40,41,-1,46
FC Zürich,5508,5,12,9,11,44,35,9,45
Grasshoppers,5508,6,9,8,15,40,47,-7,35
FC Thun,5508,7,9,6,17,42,59,-17,33
FC Lugano,5508,8,9,6,17,29,47,-18,33
FC Sion,5508,9,6,7,19,40,59,-19,25
Young Boys,5509,1,22,8,2,72,33,39,74
FC Basel,5509,2,18,8,6,58,25,33,62
Lucerne,5509,3,12,9,11,43,44,-1,45
St Gallen,5509,4,14,2,16,44,60,-16,44
FC Zürich,5509,5,10,11,11,43,35,8,41
FC Lugano,5509,6,10,7,15,34,49,-15,37
FC Thun,5509,7,10,6,16,40,59,-19,36
Grasshoppers,5509,8,9,8,15,40,48,-8,35
FC Sion,5509,9,6,7,19,38,59,-21,25
Young Boys,5510,1,21,9,2,72,32,40,72
FC Basel,5510,2,16,9,7,53,28,25,57
Lucerne,5510,3,15,7,10,50,41,9,52
St Gallen,5510,4,15,2,15,43,54,-11,47
FC Zürich,5510,5,9,11,12,42,40,2,38
FC Thun,5510,6,11,5,16,45,58,-13,38
FC Lugano,5510,7,10,6,16,30,56,-26,36
Grasshoppers,5510,8,9,7,16,40,50,-10,34
FC Sion,5510,9,6,8,18,39,55,-16,26
Young Boys,5511,1,22,8,2,77,38,39,74
FC Basel,5511,2,18,7,7,54,24,30,61
Lucerne,5511,3,13,8,11,43,46,-3,47
FC Zürich,5511,4,12,9,11,43,35,8,45
St Gallen,5511,5,14,3,15,41,54,-13,45
Grasshoppers,5511,6,9,9,14,41,48,-7,36
FC Lugano,5511,7,10,5,17,33,51,-18,35
FC Thun,5511,8,9,5,18,41,60,-19,32
FC Sion,5511,9,5,10,17,39,56,-17,25
Young Boys,5512,1,22,8,2,75,37,38,74
FC Basel,5512,2,18,8,6,55,26,29,62
Lucerne,5512,3,13,8,11,42,43,-1,47
St Gallen,5512,4,14,3,15,47,60,-13,45
FC Zürich,5512,5,11,9,12,41,37,4,42
FC Thun,5512,6,10,6,16,46,59,-13,36
Grasshoppers,5512,7,9,8,15,45,54,-9,35
FC Lugano,5512,8,9,6,17,31,49,-18,33
FC Sion,5512,9,6,8,18,41,58,-17,26
Young Boys,5513,1,21,7,4,74,36,38,70
FC Basel,5513,2,18,9,5,57,22,35,63
St Gallen,5513,3,15,3,14,43,53,-10,48
FC Zürich,5513,4,11,10,11,41,37,4,43
Lucerne,5513,5,12,7,13,38,51,-13,43
FC Lugano,5513,6,10,6,16,32,48,-16,36
Grasshoppers,5513,7,9,7,16,39,48,-9,34
FC Thun,5513,8,9,7,16,43,58,-15,34
FC Sion,5513,9,6,10,16,39,53,-14,28
Young Boys,5514,1,20,8,4,70,39,31,68
FC Basel,5514,2,17,9,6,51,24,27,60
St Gallen,5514,3,15,2,15,41,54,-13,47
Lucerne,5514,4,12,9,11,43,44,-1,45
FC Zürich,5514,5,10,11,11,41,36,5,41
FC Lugano,5514,6,11,6,15,32,47,-15,39
Grasshoppers,5514,7,10,7,15,43,51,-8,37
FC Thun,5514,8,9,5,18,45,61,-16,32
FC Sion,5514,9,7,9,16,45,55,-10,30
Young Boys,5515,1,21,8,3,77,37,40,71
FC Basel,5515,2,16,8,8,52,29,23,56
St Gallen,5515,3,15,2,15,43,52,-9,47
Lucerne,5515,4,12,9,11,43,46,-3,45
FC Zürich,5515,5,10,10,12,42,41,1,40
Grasshoppers,5515,6,10,7,15,42,48,-6,37
FC Lugano,5515,7,10,7,15,35,53,-18,37
FC Thun,5515,8,10,5,17,46,63,-17,35
FC Sion,5515,9,8,8,16,41,52,-11,32
Young Boys,5516,1,20,8,4,66,36,30,68
FC Basel,5516,2,18,8,6,52,24,28,62
St Gallen,5516,3,15,4,13,44,51,-7,49
Lucerne,5516,4,13,8,11,45,43,2,47
FC Zürich,5516,5,9,11,12,39,39,0,38
Grasshoppers,5516,6,10,7,15,41,49,-8,37
FC Thun,5516,7,10,5,17,46,60,-14,35
FC Lugano,5516,8,9,8,15,30,48,-18,35
FC Sion,5516,9,6,9,17,42,55,-13,27
Young Boys,5517,1,23,6,3,76,35,41,75
FC Basel,5517,2,16,9,7,51,27,24,57
St Gallen,5517,3,14,4,14,44,55,-11,46
Lucerne,5517,4,12,9,11,41,45,-4,45
FC Zürich,5517,5,11,10,11,39,34,5,43
FC Thun,5517,6,9,8,15,45,57,-12,35
Grasshoppers,5517,7,9,6,17,40,54,-14,33
FC Lugano,5517,8,9,6,17,27,46,-19,33
FC Sion,5517,9,8,8,16,45,55,-10,32
Young Boys,5518,1,22,6,4,72,33,39,72
FC Basel,5518,2,17,9,6,52,24,28,60
St Gallen,5518,3,15,2,15,42,54,-12,47
Grasshoppers,5518,4,12,6,14,43,46,-3,42
Lucerne,5518,5,11,8,13,39,50,-11,41
FC Zürich,5518,6,9,12,11,39,36,3,39
FC Lugano,5518,7,10,6,16,31,46,-15,36
FC Thun,5518,8,9,6,17,44,59,-15,33
FC Sion,5518,9,8,7,17,40,54,-14,31
Young Boys,5519,1,20,9,3,72,40,32,69
FC Basel,5519,2,19,7,6,61,25,36,64
Lucerne,5519,3,13,8,11,42,44,-2,47
St Gallen,5519,4,15,2,15,42,53,-11,47
FC Zürich,5519,5,11,10,11,44,38,6,43
FC Lugano,5519,6,10,6,16,32,49,-17,36
Grasshoppers,5519,7,8,9,15,40,49,-9,33
FC Thun,5519,8,9,6,17,43,62,-19,33
FC Sion,5519,9,6,9,17,40,56,-16,27
Young Boys,5520,1,21,7,4,71,39,32,70
FC Basel,5520,2,17,8,7,52,26,26,59
Lucerne,5520,3,14,8,10,44,42,2,50
FC Zürich,5520,4,13,9,10,41,33,8,48
St Gallen,5520,5,15,3,14,44,52,-8,48
Grasshoppers,5520,6,11,6,15,45,48,-3,39
FC Lugano,5520,7,9,5,18,27,49,-22,32
FC Thun,5520,8,8,5,19,39,62,-23,29
FC Sion,5520,9,7,7,18,41,53,-12,28
Young Boys,5521,1,20,9,3,73,38,35,69
FC Basel,5521,2,17,10,5,60,27,33,61
St Gallen,5521,3,14,5,13,45,53,-8,47
FC Zürich,5521,4,11,11,10,45,38,7,44
Lucerne,5521,5,12,8,12,46,53,-7,44
FC Lugano,5521,6,10,7,15,36,50,-14,37
FC Thun,5521,7,10,6,16,44,61,-17,36
Grasshoppers,5521,8,9,7,16,42,54,-12,34
FC Sion,5521,9,6,7,19,38,55,-17,25
Young Boys,5522,1,22,7,3,75,38,37,73
FC Basel,5522,2,20,7,5,59,25,34,67
Lucerne,5522,3,13,7,12,43,44,-1,46
FC Zürich,5522,4,12,9,11,40,35,5,45
St Gallen,5522,5,14,3,15,41,54,-13,45
Grasshoppers,5522,6,10,6,16,42,50,-8,36
FC Lugano,5522,7,10,5,17,30,49,-19,35
FC Thun,5522,8,9,5,18,43,62,-19,32
FC Sion,5522,9,5,9,18,40,56,-16,24
Young Boys,5523,1,22,7,3,70,33,37,73
FC Basel,5523,2,17,7,8,52,30,22,58
Lucerne,5523,3,15,7,10,48,40,8,52
St Gallen,5523,4,15,2,15,47,58,-11,47
FC Zürich,5523,5,12,9,11,41,35,6,45
FC Lugano,5523,6,10,6,16,34,51,-17,36
Grasshoppers,5523,7,9,7,16,38,48,-10,34
FC Thun,5523,8,8,6,18,42,63,-21,30
FC Sion,5523,9,6,9,17,41,55,-14,27
Young Boys,5524,1,22,6,4,73,35,38,72
FC Basel,5524,2,19,8,5,52,23,29,65
Lucerne,5524,3,13,7,12,41,43,-2,46
St Gallen,5524,4,14,2,16,41,56,-15,44
FC Zürich,5524,5,9,12,11,38,35,3,39
FC Lugano,5524,6,11,6,15,34,47,-13,39
FC Thun,5524,7,10,6,16,43,56,-13,36
Grasshoppers,5524,8,9,6,17,41,53,-12,33
FC Sion,5524,9,7,7,18,42,57,-15,28
Young Boys,5525,1,22,6,4,72,38,34,72
FC Basel,5525,2,17,7,8,55,28,27,58
St Gallen,5525,3,15,2,15,43,54,-11,47
Lucerne,5525,4,13,7,12,45,47,-2,46
FC Zürich,5525,5,10,10,12,39,37,2,40
FC Lugano,5525,6,11,5,16,31,47,-16,38
Grasshoppers,5525,7,10,7,15,43,49,-6,37
FC Thun,5525,8,10,6,16,43,59,-16,36
FC Sion,5525,9,7,8,17,41,53,-12,29
Young Boys,5526,1,21,7,4,74,39,35,70
FC Basel,5526,2,20,7,5,59,25,34,67
Lucerne,5526,3,14,7,11,46,47,-1,49
St Gallen,5526,4,14,2,16,44,55,-11,44
FC Zürich,5526,5,10,9,13,39,37,2,39
FC Lugano,5526,6,11,5,16,32,47,-15,38
FC Thun,5526,7,9,6,17,40,60,-20,33
FC Sion,5526,8,8,8,16,44,56,-12,32
Grasshoppers,5526,9,8,7,17,42,54,-12,31
Young Boys,5527,1,22,8,2,74,34,40,74
FC Basel,5527,2,18,7,7,54,25,29,61
Lucerne,5527,3,12,8,12,40,45,-5,44
St Gallen,5527,4,13,2,17,38,57,-19,41
FC Zürich,5527,5,10,10,12,40,38,2,40
FC Lugano,5527,6,11,6,15,32,47,-15,39
Grasshoppers,5527,7,10,8,14,44,50,-6,38
FC Thun,5527,8,10,5,17,44,61,-17,35
FC Sion,5527,9,7,8,17,44,53,-9,29
Young Boys,5528,1,21,6,5,75,43,32,69
FC Basel,5528,2,19,8,5,60,22,38,65
Lucerne,5528,3,13,9,10,45,44,1,48
St Gallen,5528,4,13,3,16,40,55,-15,42
FC Zürich,5528,5,10,10,12,39,40,-1,40
FC Lugano,5528,6,11,5,16,31,49,-18,38
Grasshoppers,5528,7,10,7,15,51,54,-3,37
FC Thun,5528,8,8,7,17,42,64,-22,31
FC Sion,5528,9,7,9,16,43,55,-12,30
Young Boys,5529,1,20,8,4,69,35,34,68
FC Basel,5529,2,17,7,8,50,29,21,58
FC Zürich,5529,3,13,9,10,43,32,11,48
St Gallen,5529,4,15,3,14,46,54,-8,48
Lucerne,5529,5,12,8,12,42,47,-5,44
Grasshoppers,5529,6,11,6,15,43,48,-5,39
FC Lugano,5529,7,11,6,15,33,45,-12,39
FC Thun,5529,8,9,5,18,42,62,-20,32
FC Sion,5529,9,6,8,18,36,52,-16,26
Young Boys,5530,1,22,7,3,71,34,37,73
FC Basel,5530,2,18,7,7,54,28,26,61
St Gallen,5530,3,15,2,15,45,58,-13,47
Lucerne,5530,4,12,8,12,39,44,-5,44
FC Zürich,5530,5,11,10,11,43,37,6,43
FC Lugano,5530,6,10,7,15,34,47,-13,37
FC Thun,5530,7,10,6,16,42,56,-14,36
Grasshoppers,5530,8,9,7,16,42,50,-8,34
FC Sion,5530,9,6,8,18,39,55,-16,26
Young Boys,5531,1,20,8,4,70,37,33,68
FC Basel,5531,2,18,9,5,53,25,28,63
St Gallen,5531,3,15,2,15,46,55,-9,47
Lucerne,5531,4,12,8,12,40,43,-3,44
FC Zürich,5531,5,10,12,10,42,37,5,42
Grasshoppers,5531,6,10,7,15,43,50,-7,37
FC Lugano,5531,7,10,5,17,30,50,-20,35
FC Thun,5531,8,9,7,16,45,59,-14,34
FC Sion,5531,9,6,10,16,42,55,-13,28
Young Boys,5532,1,21,8,3,72,33,39,71
FC Basel,5532,2,17,7,8,56,31,25,58
Lucerne,5532,3,14,8,10,43,42,1,50
FC Zürich,5532,4,11,9,12,41,41,0,42
FC Thun,5532,5,12,5,15,48,54,-6,41
St Gallen,5532,6,13,2,17,41,62,-21,41
FC Lugano,5532,7,11,5,16,36,50,-14,38
Grasshoppers,5532,8,9,7,16,41,51,-10,34
FC Sion,5532,9,6,9,17,40,54,-14,27
Young Boys,5533,1,21,7,4,71,36,35,70
FC Basel,5533,2,18,8,6,53,25,28,62
St Gallen,5533,3,17,2,13,46,50,-4,53
Lucerne,5533,4,12,8,12,43,44,-1,44
FC Zürich,5533,5,9,11,12,37,36,1,38
FC Lugano,5533,6,10,6,16,30,51,-21,36
FC Thun,5533,7,9,8,15,44,58,-14,35
Grasshoppers,5533,8,9,7,16,39,49,-10,34
FC Sion,5533,9,6,9,17,41,55,-14,27
Young Boys,5534,1,22,6,4,69,34,35,72
FC Basel,5534,2,16,9,7,51,27,24,57
Lucerne,5534,3,15,7,10,47,44,3,52
St Gallen,5534,4,13,4,15,42,56,-14,43
FC Zürich,5534,5,10,11,11,40,36,4,41
FC Thun,5534,6,10,7,15,44,56,-12,37
Grasshoppers,5534,7,9,6,17,44,52,-8,33
FC Lugano,5534,8,9,6,17,31,51,-20,33
FC Sion,5534,9,8,8,16,41,53,-12,32
Young Boys,5535,1,21,7,4,73,37,36,70
FC Basel,5535,2,18,7,7,55,25,30,61
Lucerne,5535,3,13,10,9,43,42,1,49
St Gallen,5535,4,14,3,15,42,54,-12,45
FC Zürich,5535,5,11,10,11,40,35,5,43
Grasshoppers,5535,6,10,8,14,44,49,-5,38
FC Lugano,5535,7,9,7,16,32,53,-21,34
FC Thun,5535,8,8,6,18,42,62,-20,30
FC Sion,5535,9,6,10,16,38,52,-14,28
Young Boys,5536,1,22,6,4,72,36,36,72
FC Basel,5536,2,19,7,6,55,24,31,64
Lucerne,5536,3,14,7,11,40,40,0,49
FC Zürich,5536,4,12,9,11,46,35,11,45
St Gallen,5536,5,14,2,16,39,53,-14,44
FC Thun,5536,6,10,5,17,43,60,-17,35
FC Lugano,5536,7,10,5,17,29,48,-19,35
Grasshoppers,5536,8,9,7,16,40,50,-10,34
FC Sion,5536,9,6,8,18,39,57,-18,26
Young Boys,5537,1,20,7,5,69,37,32,67
FC Basel,5537,2,18,9,5,52,24,28,63
St Gallen,5537,3,15,3,14,42,52,-10,48
Lucerne,5537,4,12,7,13,39,45,-6,43
FC Zürich,5537,5,10,10,12,39,36,3,40
FC Lugano,5537,6,11,5,16,30,45,-15,38
Grasshoppers,5537,7,10,7,15,42,49,-7,37
FC Thun,5537,8,9,6,17,42,58,-16,33
FC Sion,5537,9,8,8,16,42,51,-9,32
Young Boys,5538,1,19,9,4,68,36,32,66
FC Basel,5538,2,18,8,6,51,24,27,62
FC Zürich,5538,3,12,9,11,42,35,7,45
Lucerne,5538,4,12,9,11,38,42,-4,45
St Gallen,5538,5,14,3,15,43,58,-15,45
Grasshoppers,5538,6,10,8,14,43,47,-4,38
FC Thun,5538,7,10,6,16,43,55,-12,36
FC Lugano,5538,8,10,6,16,32,48,-16,36
FC Sion,5538,9,6,8,18,43,58,-15,26
Young Boys,5539,1,21,7,4,69,37,32,70
FC Basel,5539,2,20,7,5,61,26,35,67
St Gallen,5539,3,14,3,15,47,60,-13,45
Lucerne,5539,4,12,8,12,46,51,-5,44
FC Zürich,5539,5,10,9,13,40,36,4,39
FC Lugano,5539,6,11,6,15,34,47,-13,39
Grasshoppers,5539,7,10,6,16,42,49,-7,36
FC Thun,5539,8,10,5,17,42,59,-17,35
FC Sion,5539,9,6,9,17,39,55,-16,27
Young Boys,5540,1,22,7,3,73,33,40,73
FC Basel,5540,2,17,10,5,55,25,30,61
St Gallen,5540,3,14,4,14,43,53,-10,46
Lucerne,5540,4,12,9,11,44,47,-3,45
FC Zürich,5540,5,11,11,10,43,36,7,44
FC Lugano,5540,6,9,7,16,30,47,-17,34
Grasshoppers,5540,7,9,6,17,40,53,-13,33
FC Thun,5540,8,9,6,17,42,62,-20,33
FC Sion,5540,9,6,10,16,38,52,-14,28
Young Boys,5541,1,23,7,2,75,31,44,76
FC Basel,5541,2,17,8,7,56,30,26,59
Lucerne,5541,3,13,7,12,41,49,-8,46
St Gallen,5541,4,14,4,14,44,56,-12,46
FC Zürich,5541,5,12,9,11,44,35,9,45
FC Thun,5541,6,10,5,17,45,60,-15,35
Grasshoppers,5541,7,9,6,17,38,50,-12,33
FC Lugano,5541,8,9,6,17,29,49,-20,33
FC Sion,5541,9,7,8,17,41,53,-12,29
Young Boys,5542,1,21,9,2,71,34,37,72
FC Basel,5542,2,19,8,5,56,22,34,65
Lucerne,5542,3,12,9,11,44,49,-5,45
St Gallen,5542,4,13,4,15,40,55,-15,43
FC Lugano,5542,5,12,5,15,37,46,-9,41
FC Zürich,5542,6,10,9,13,40,37,3,39
FC Thun,5542,7,11,5,16,48,62,-14,38
Grasshoppers,5542,8,9,7,16,40,52,-12,34
FC Sion,5542,9,5,8,19,39,58,-19,23
Young Boys,5543,1,23,6,3,71,33,38,75
FC Basel,5543,2,18,8,6,51,24,27,62
St Gallen,5543,3,15,2,15,47,58,-11,47
Lucerne,5543,4,12,8,12,40,44,-4,44
FC Thun,5543,5,12,5,15,46,55,-9,41
FC Zürich,5543,6,10,9,13,39,41,-2,39
FC Lugano,5543,7,11,5,16,34,48,-14,38
Grasshoppers,5543,8,9,6,17,40,51,-11,33
FC Sion,5543,9,6,7,19,43,57,-14,25
Young Boys,5544,1,20,7,5,72,42,30,67
FC Basel,5544,2,18,8,6,55,24,31,62
Lucerne,5544,3,15,8,9,47,40,7,53
FC Zürich,5544,4,10,11,11,41,37,4,41
St Gallen,5544,5,13,2,17,39,58,-19,41
FC Lugano,5544,6,10,6,16,32,52,-20,36
FC Thun,5544,7,10,5,17,44,58,-14,35
Grasshoppers,5544,8,9,7,16,43,52,-9,34
FC Sion,5544,9,8,8,16,46,56,-10,32
Young Boys,5545,1,22,8,2,80,37,43,74
FC Basel,5545,2,17,9,6,55,30,25,60
St Gallen,5545,3,14,3,15,44,57,-13,45
Lucerne,5545,4,11,8,13,38,48,-10,41
FC Zürich,5545,5,10,10,12,43,43,0,40
FC Lugano,5545,6,11,6,15,35,47,-12,39
Grasshoppers,5545,7,10,8,14,43,45,-2,38
FC Thun,5545,8,9,8,15,41,54,-13,35
FC Sion,5545,9,5,10,17,41,59,-18,25
Young Boys,5546,1,22,8,2,73,32,41,74
FC Basel,5546,2,17,10,5,52,22,30,61
St Gallen,5546,3,15,3,14,45,55,-10,48
Lucerne,5546,4,13,8,11,46,48,-2,47
FC Zürich,5546,5,12,10,10,42,34,8,46
FC Lugano,5546,6,9,7,16,29,47,-18,34
FC Thun,5546,7,9,6,17,42,59,-17,33
Grasshoppers,5546,8,8,7,17,41,54,-13,31
FC Sion,5546,9,6,7,19,43,62,-19,25
Young Boys,5547,1,22,7,3,73,35,38,73
FC Basel,5547,2,18,7,7,54,28,26,61
Lucerne,5547,3,13,9,10,45,41,4,48
St Gallen,5547,4,14,3,15,42,57,-15,45
FC Zürich,5547,5,11,10,11,45,37,8,43
Grasshoppers,5547,6,10,7,15,39,48,-9,37
FC Lugano,5547,7,9,7,16,29,50,-21,34
FC Thun,5547,8,9,6,17,43,58,-15,33
FC Sion,5547,9,6,8,18,39,55,-16,26
Young Boys,5548,1,22,6,4,76,36,40,72
FC Basel,5548,2,17,9,6,54,23,31,60
St Gallen,5548,3,15,3,14,40,52,-12,48
Lucerne,5548,4,12,9,11,40,47,-7,45
FC Zürich,5548,5,10,10,12,39,37,2,40
FC Lugano,5548,6,11,6,15,36,49,-13,39
FC Thun,5548,7,9,7,16,41,55,-14,34
Grasshoppers,5548,8,8,7,17,38,51,-13,31
FC Sion,5548,9,8,7,17,41,55,-14,31
Young Boys,5549,1,20,8,4,69,34,35,68
FC Basel,5549,2,17,9,6,53,27,26,60
Lucerne,5549,3,12,9,11,41,43,-2,45
St Gallen,5549,4,14,3,15,44,55,-11,45
FC Zürich,5549,5,10,11,11,41,36,5,41
FC Thun,5549,6,11,6,15,45,56,-11,39
Grasshoppers,5549,7,10,7,15,42,49,-7,37
FC Lugano,5549,8,10,5,17,28,49,-21,35
FC Sion,5549,9,7,8,17,39,53,-14,29
Young Boys,5550,1,20,7,5,70,40,30,67
FC Basel,5550,2,17,8,7,51,26,25,59
Lucerne,5550,3,12,9,11,45,44,1,45
FC Zürich,5550,4,11,11,10,39,33,6,44
St Gallen,5550,5,14,2,16,42,57,-15,44
FC Thun,5550,6,10,7,15,43,56,-13,37
FC Lugano,5550,7,10,7,15,30,48,-18,37
Grasshoppers,5550,8,9,8,15,40,48,-8,35
FC Sion,5550,9,7,9,16,45,53,-8,30
Young Boys,5551,1,20,8,4,70,37,33,68
FC Basel,5551,2,17,9,6,56,28,28,60
Lucerne,5551,3,13,9,10,47,47,0,48
St Gallen,5551,4,13,5,14,43,57,-14,44
FC Zürich,5551,5,10,10,12,39,36,3,40
FC Thun,5551,6,11,5,16,43,57,-14,38
FC Sion,5551,7,9,7,16,44,52,-8,34
FC Lugano,5551,8,9,7,16,28,46,-18,34
Grasshoppers,5551,9,8,8,16,41,51,-10,32
Young Boys,5552,1,22,7,3,69,35,34,73
FC Basel,5552,2,19,7,6,58,24,34,64
Lucerne,5552,3,13,7,12,46,48,-2,46
St Gallen,5552,4,14,2,16,42,58,-16,44
FC Zürich,5552,5,10,10,12,40,37,3,40
FC Lugano,5552,6,11,5,16,33,46,-13,38
FC Thun,5552,7,9,7,16,42,58,-16,34
Grasshoppers,5552,8,9,6,17,39,51,-12,33
FC Sion,5552,9,7,9,16,40,52,-12,30
Young Boys,5553,1,23,6,3,75,31,44,75
FC Basel,5553,2,18,7,7,53,28,25,61
FC Zürich,5553,3,13,9,10,49,36,13,48
Lucerne,5553,4,13,7,12,41,44,-3,46
St Gallen,5553,5,14,3,15,46,59,-13,45
Grasshoppers,5553,6,10,6,16,41,53,-12,36
FC Thun,5553,7,10,5,17,46,61,-15,35
FC Lugano,5553,8,9,6,17,31,51,-20,33
FC Sion,5553,9,6,7,19,44,63,-19,25
Young Boys,5554,1,22,7,3,71,35,36,73
FC Basel,5554,2,17,9,6,52,25,27,60
FC Zürich,5554,3,12,10,10,42,33,9,46
St Gallen,5554,4,13,5,14,41,54,-13,44
Lucerne,5554,5,11,8,13,39,46,-7,41
FC Lugano,5554,6,11,5,16,31,47,-16,38
Grasshoppers,5554,7,9,7,16,39,48,-9,34
FC Thun,5554,8,9,7,16,43,58,-15,34
FC Sion,5554,9,6,10,16,41,53,-12,28
Young Boys,5555,1,20,8,4,71,36,35,68
FC Basel,5555,2,19,7,6,59,28,31,64
St Gallen,5555,3,16,2,14,49,55,-6,50
Lucerne,5555,4,13,7,12,46,47,-1,46
FC Zürich,5555,5,10,10,12,40,39,1,40
FC Lugano,5555,6,11,6,15,33,47,-14,39
Grasshoppers,5555,7,10,7,15,45,53,-8,37
FC Thun,5555,8,8,8,16,42,59,-17,32
FC Sion,5555,9,5,9,18,37,58,-21,24
Young Boys,5556,1,23,6,3,76,35,41,75
FC Basel,5556,2,18,9,5,54,25,29,63
St Gallen,5556,3,14,4,14,43,57,-14,46
Lucerne,5556,4,12,8,12,42,46,-4,44
FC Thun,5556,5,11,5,16,45,57,-12,38
FC Zürich,5556,6,9,10,13,38,37,1,37
FC Lugano,5556,7,10,7,15,33,48,-15,37
FC Sion,5556,8,8,7,17,42,51,-9,31
Grasshoppers,5556,9,8,6,18,39,56,-17,30
Young Boys,5557,1,21,7,4,71,32,39,70
FC Basel,5557,2,17,9,6,51,25,26,60
Lucerne,5557,3,14,7,11,44,47,-3,49
St Gallen,5557,4,15,3,14,45,56,-11,48
FC Zürich,5557,5,9,12,11,40,37,3,39
FC Lugano,5557,6,11,6,15,36,49,-13,39
FC Thun,5557,7,10,6,16,42,56,-14,36
Grasshoppers,5557,8,9,7,16,38,48,-10,34
FC Sion,5557,9,5,9,18,38,55,-17,24
Young Boys,5558,1,22,7,3,71,32,39,73
FC Basel,5558,2,17,8,7,49,26,23,59
St Gallen,5558,3,15,3,14,44,53,-9,48
Lucerne,5558,4,12,9,11,41,43,-2,45
FC Thun,5558,5,11,6,15,45,56,-11,39
FC Zürich,5558,6,9,11,12,40,39,1,38
Grasshoppers,5558,7,8,9,15,41,50,-9,33
FC Lugano,5558,8,9,6,17,31,52,-21,33
FC Sion,5558,9,7,9,16,40,51,-11,30
Young Boys,5559,1,21,6,5,69,36,33,69
FC Basel,5559,2,17,8,7,51,25,26,59
St Gallen,5559,3,14,4,14,47,57,-10,46
FC Zürich,5559,4,12,9,11,43,35,8,45
Lucerne,5559,5,12,7,13,41,48,-7,43
FC Lugano,5559,6,12,5,15,34,47,-13,41
FC Thun,5559,7,11,5,16,45,58,-13,38
Grasshoppers,5559,8,9,6,17,42,52,-10,33
FC Sion,5559,9,7,8,17,41,55,-14,29
Young Boys,5560,1,19,9,4,70,39,31,66
FC Basel,5560,2,18,9,5,57,29,28,63
St Gallen,5560,3,15,2,15,44,55,-11,47
Lucerne,5560,4,12,9,11,46,48,-2,45
FC Zürich,5560,5,10,10,12,40,39,1,40
Grasshoppers,5560,6,11,6,15,43,48,-5,39
FC Thun,5560,7,11,5,16,46,57,-11,38
FC Lugano,5560,8,9,7,16,30,47,-17,34
FC Sion,5560,9,7,7,18,41,55,-14,28
Young Boys,5561,1,22,7,3,73,32,41,73
FC Basel,5561,2,17,9,6,52,27,25,60
St Gallen,5561,3,16,3,13,47,51,-4,51
Lucerne,5561,4,12,7,13,42,48,-6,43
FC Zürich,5561,5,10,10,12,41,38,3,40
FC Thun,5561,6,11,6,15,44,56,-12,39
FC Lugano,5561,7,10,6,16,31,49,-18,36
Grasshoppers,5561,8,8,6,18,36,50,-14,30
FC Sion,5561,9,7,8,17,40,55,-15,29
Young Boys,5562,1,20,8,4,67,36,31,68
FC Basel,5562,2,17,9,6,52,25,27,60
Lucerne,5562,3,12,9,11,40,42,-2,45
FC Zürich,5562,4,11,10,11,40,34,6,43
FC Lugano,5562,5,12,6,14,32,43,-11,42
St Gallen,5562,6,13,3,16,40,56,-16,42
Grasshoppers,5562,7,10,8,14,47,49,-2,38
FC Thun,5562,8,8,8,16,42,58,-16,32
FC Sion,5562,9,7,7,18,42,59,-17,28
Young Boys,5563,1,21,8,3,71,31,40,71
FC Basel,5563,2,18,8,6,57,28,29,62
St Gallen,5563,3,15,3,14,44,56,-12,48
Lucerne,5563,4,12,9,11,43,47,-4,45
FC Zürich,5563,5,11,9,12,40,37,3,42
Grasshoppers,5563,6,10,7,15,40,48,-8,37
FC Lugano,5563,7,10,7,15,34,46,-12,37
FC Thun,5563,8,9,6,17,44,60,-16,33
FC Sion,5563,9,5,9,18,38,58,-20,24
Young Boys,5564,1,21,7,4,69,37,32,70
FC Basel,5564,2,17,8,7,54,25,29,59
St Gallen,5564,3,15,2,15,43,55,-12,47
Lucerne,5564,4,13,7,12,41,45,-4,46
FC Lugano,5564,5,13,5,14,38,44,-6,44
FC Zürich,5564,6,10,10,12,39,37,2,40
Grasshoppers,5564,7,10,7,15,41,48,-7,37
FC Thun,5564,8,9,5,18,41,61,-20,32
FC Sion,5564,9,6,9,17,40,54,-14,27
Young Boys,5565,1,23,6,3,72,32,40,75
FC Basel,5565,2,19,7,6,56,23,33,64
St Gallen,5565,3,16,2,14,44,52,-8,50
Lucerne,5565,4,12,7,13,39,46,-7,43
FC Zürich,5565,5,10,9,13,41,41,0,39
FC Lugano,5565,6,11,5,16,31,47,-16,38
Grasshoppers,5565,7,10,6,16,40,47,-7,36
FC Thun,5565,8,9,5,18,43,62,-19,32
FC Sion,5565,9,7,7,18,41,57,-16,28
Young Boys,5566,1,21,7,4,73,35,38,70
FC Basel,5566,2,18,7,7,55,28,27,61
St Gallen,5566,3,15,2,15,47,60,-13,47
Lucerne,5566,4,13,7,12,44,50,-6,46
FC Zürich,5566,5,10,11,11,41,37,4,41
FC Lugano,5566,6,11,6,15,31,45,-14,39
Grasshoppers,5566,7,10,6,16,45,53,-8,36
FC Thun,5566,8,10,6,16,46,60,-14,36
FC Sion,5566,9,6,8,18,45,59,-14,26
Young Boys,5567,1,22,7,3,73,32,41,73
FC Basel,5567,2,17,8,7,54,28,26,59
St Gallen,5567,3,15,4,13,44,53,-9,49
Lucerne,5567,4,12,9,11,42,42,0,45
FC Thun,5567,5,11,6,15,47,57,-10,39
FC Zürich,5567,6,9,10,13,36,40,-4,37
FC Lugano,5567,7,10,6,16,31,52,-21,36
Grasshoppers,5567,8,8,9,15,40,49,-9,33
FC Sion,5567,9,6,9,17,36,50,-14,27
Young Boys,5568,1,22,6,4,73,38,35,72
FC Basel,5568,2,18,7,7,51,25,26,61
St Gallen,5568,3,16,2,14,43,51,-8,50
Lucerne,5568,4,14,7,11,43,43,0,49
FC Lugano,5568,5,11,6,15,34,46,-12,39
FC Zürich,5568,6,9,10,13,38,38,0,37
Grasshoppers,5568,7,9,6,17,41,52,-11,33
FC Thun,5568,8,9,6,17,41,58,-17,33
FC Sion,5568,9,7,8,17,41,54,-13,29
Young Boys,5569,1,21,8,3,74,36,38,71
FC Basel,5569,2,19,8,5,56,21,35,65
St Gallen,5569,3,15,2,15,42,54,-12,47
Lucerne,5569,4,12,8,12,41,48,-7,44
FC Zürich,5569,5,10,10,12,42,36,6,40
FC Thun,5569,6,11,5,16,46,56,-10,38
FC Lugano,5569,7,11,5,16,32,47,-15,38
Grasshoppers,5569,8,8,7,17,37,51,-14,31
FC Sion,5569,9,6,9,17,38,59,-21,27
Young Boys,5570,1,22,7,3,73,37,36,73
FC Basel,5570,2,18,9,5,57,26,31,63
Lucerne,5570,3,13,7,12,45,47,-2,46
St Gallen,5570,4,14,4,14,44,56,-12,46
FC Zürich,5570,5,9,11,12,38,38,0,38
FC Lugano,5570,6,10,6,16,32,49,-17,36
Grasshoppers,5570,7,8,9,15,39,49,-10,33
FC Sion,5570,8,8,8,16,44,51,-7,32
FC Thun,5570,9,8,7,17,40,59,-19,31
Young Boys,5571,1,21,8,3,71,36,35,71
FC Basel,5571,2,16,11,5,51,25,26,59
St Gallen,5571,3,15,4,13,43,50,-7,49
Lucerne,5571,4,13,8,11,41,44,-3,47
FC Zürich,5571,5,12,10,10,42,34,8,46
FC Thun,5571,6,9,6,17,43,59,-16,33
FC Lugano,5571,7,9,6,17,28,47,-19,33
Grasshoppers,5571,8,8,7,17,40,51,-11,31
FC Sion,5571,9,6,10,16,40,53,-13,28
Young Boys,5572,1,21,8,3,73,36,37,71
FC Basel,5572,2,17,10,5,53,25,28,61
Lucerne,5572,3,13,10,9,41,38,3,49
St Gallen,5572,4,14,3,15,43,60,-17,45
FC Zürich,5572,5,11,10,11,43,34,9,43
FC Lugano,5572,6,11,6,15,35,47,-12,39
Grasshoppers,5572,7,10,6,16,43,50,-7,36
FC Thun,5572,8,9,5,18,43,59,-16,32
FC Sion,5572,9,5,8,19,37,62,-25,23
Young Boys,5573,1,22,6,4,78,40,38,72
FC Basel,5573,2,18,9,5,55,26,29,63
Lucerne,5573,3,12,9,11,43,44,-1,45
St Gallen,5573,4,13,4,15,43,56,-13,43
FC Zürich,5573,5,10,10,12,40,42,-2,40
FC Lugano,5573,6,11,7,14,40,46,-6,40
FC Thun,5573,7,9,7,16,42,58,-16,34
Grasshoppers,5573,8,8,8,16,39,52,-13,32
FC Sion,5573,9,7,8,17,40,56,-16,29
Young Boys,5574,1,23,6,3,76,37,39,75
FC Basel,5574,2,17,8,7,53,28,25,59
Lucerne,5574,3,13,8,11,45,45,0,47
St Gallen,5574,4,15,2,15,44,57,-13,47
FC Zürich,5574,5,10,12,10,40,35,5,42
Grasshoppers,5574,6,9,7,16,46,53,-7,34
FC Thun,5574,7,9,7,16,44,59,-15,34
FC Lugano,5574,8,9,7,16,32,50,-18,34
FC Sion,5574,9,6,9,17,44,60,-16,27
Young Boys,5575,1,22,7,3,73,35,38,73
FC Basel,5575,2,18,8,6,54,24,30,62
Lucerne,5575,3,15,7,10,50,43,7,52
FC Zürich,5575,4,11,9,12,46,37,9,42
St Gallen,5575,5,13,2,17,39,60,-21,41
FC Lugano,5575,6,11,5,16,34,51,-17,38
Grasshoppers,5575,7,10,7,15,45,53,-8,37
FC Thun,5575,8,9,6,17,45,63,-18,33
FC Sion,5575,9,6,7,19,40,60,-20,25
Young Boys,5576,1,22,7,3,72,37,35,73
FC Basel,5576,2,18,8,6,57,26,31,62
Lucerne,5576,3,13,9,10,43,42,1,48
St Gallen,5576,4,14,4,14,42,54,-12,46
FC Zürich,5576,5,11,9,12,43,39,4,42
FC Lugano,5576,6,10,6,16,33,50,-17,36
Grasshoppers,5576,7,9,8,15,43,51,-8,35
FC Thun,5576,8,9,6,17,44,60,-16,33
FC Sion,5576,9,6,7,19,40,58,-18,25
Young Boys,5577,1,20,8,4,68,36,32,68
FC Basel,5577,2,19,8,5,54,23,31,65
Lucerne,5577,3,14,7,11,42,42,0,49
St Gallen,5577,4,14,2,16,41,56,-15,44
FC Zürich,5577,5,10,10,12,39,37,2,40
FC Thun,5577,6,10,7,15,46,57,-11,37
FC Lugano,5577,7,10,5,17,30,47,-17,35
Grasshoppers,5577,8,9,7,16,43,50,-7,34
FC Sion,5577,9,7,8,17,41,56,-15,29
Young Boys,5578,1,21,6,5,69,35,34,69
FC Basel,5578,2,19,8,5,53,23,30,65
Lucerne,5578,3,14,7,11,42,43,-1,49
St Gallen,5578,4,13,4,15,41,56,-15,43
FC Thun,5578,5,11,5,16,45,56,-11,38
FC Zürich,5578,6,9,10,13,37,37,0,37
FC Sion,5578,7,9,7,16,42,50,-8,34
FC Lugano,5578,8,9,7,16,30,48,-18,34
Grasshoppers,5578,9,9,6,17,40,51,-11,33
Young Boys,5579,1,21,8,3,72,37,35,71
FC Basel,5579,2,15,10,7,52,30,22,55
Lucerne,5579,3,12,9,11,43,45,-2,45
St Gallen,5579,4,14,3,15,42,54,-12,45
Grasshoppers,5579,5,11,7,14,45,47,-2,40
FC Zürich,5579,6,10,9,13,40,39,1,39
FC Thun,5579,7,11,6,15,46,57,-11,39
FC Lugano,5579,8,11,5,16,30,46,-16,38
FC Sion,5579,9,7,7,18,39,54,-15,28
Young Boys,5580,1,21,7,4,73,41,32,70
FC Basel,5580,2,18,9,5,57,23,34,63
Lucerne,5580,3,13,8,11,43,44,-1,47
St Gallen,5580,4,15,2,15,43,55,-12,47
FC Zürich,5580,5,11,10,11,40,36,4,43
FC Lugano,5580,6,11,5,16,33,47,-14,38
Grasshoppers,5580,7,9,7,16,39,50,-11,34
FC Thun,5580,8,9,6,17,41,60,-19,33
FC Sion,5580,9,6,8,18,43,56,-13,26
Young Boys,5581,1,22,6,4,74,38,36,72
FC Basel,5581,2,19,7,6,53,23,30,64
St Gallen,5581,3,14,3,15,40,52,-12,45
Lucerne,5581,4,11,9,12,39,46,-7,42
FC Zürich,5581,5,10,10,12,39,35,4,40
FC Thun,5581,6,10,7,15,41,54,-13,37
FC Lugano,5581,7,9,7,16,30,51,-21,34
Grasshoppers,5581,8,8,9,15,39,48,-9,33
FC Sion,5581,9,7,10,15,41,49,-8,31
Young Boys,5582,1,22,7,3,72,38,34,73
FC Basel,5582,2,18,8,6,59,25,34,62
St Gallen,5582,3,14,4,14,45,56,-11,46
Lucerne,5582,4,12,8,12,40,47,-7,44
FC Zürich,5582,5,11,10,11,45,40,5,43
FC Thun,5582,6,10,6,16,45,57,-12,36
FC Lugano,5582,7,9,8,15,32,48,-16,35
Grasshoppers,5582,8,9,7,16,41,51,-10,34
FC Sion,5582,9,5,10,17,42,59,-17,25
Young Boys,5583,1,21,8,3,70,36,34,71
FC Basel,5583,2,17,8,7,54,25,29,59
St Gallen,5583,3,15,3,14,45,58,-13,48
Lucerne,5583,4,13,7,12,42,44,-2,46
FC Zürich,5583,5,10,11,11,41,37,4,41
Grasshoppers,5583,6,10,8,14,44,48,-4,38
FC Thun,5583,7,10,6,16,40,55,-15,36
FC Lugano,5583,8,9,7,16,32,50,-18,34
FC Sion,5583,9,5,10,17,41,56,-15,25
Young Boys,5584,1,23,6,3,69,31,38,75
FC Basel,5584,2,17,9,6,56,26,30,60
FC Zürich,5584,3,12,10,10,43,36,7,46
St Gallen,5584,4,13,6,13,40,51,-11,45
Lucerne,5584,5,11,9,12,38,44,-6,42
FC Lugano,5584,6,10,6,16,30,45,-15,36
Grasshoppers,5584,7,9,7,16,41,55,-14,34
FC Thun,5584,8,9,5,18,47,64,-17,32
FC Sion,5584,9,7,8,17,41,53,-12,29
Young Boys,5585,1,22,6,4,71,34,37,72
FC Basel,5585,2,19,8,5,56,23,33,65
St Gallen,5585,3,14,4,14,43,53,-10,46
Lucerne,5585,4,11,9,12,39,46,-7,42
FC Lugano,5585,5,12,5,15,32,46,-14,41
FC Zürich,5585,6,10,9,13,39,39,0,39
Grasshoppers,5585,7,9,8,15,43,52,-9,35
FC Sion,5585,8,8,8,16,45,54,-9,32
FC Thun,5585,9,8,5,19,41,62,-21,29
Young Boys,5586,1,22,6,4,69,36,33,72
FC Basel,5586,2,17,8,7,53,27,26,59
St Gallen,5586,3,15,4,13,44,53,-9,49
FC Zürich,5586,4,12,10,10,43,35,8,46
Lucerne,5586,5,13,7,12,42,43,-1,46
Grasshoppers,5586,6,10,6,16,41,50,-9,36
FC Lugano,5586,7,10,6,16,31,47,-16,36
FC Thun,5586,8,9,5,18,43,59,-16,32
FC Sion,5586,9,6,8,18,41,57,-16,26
Young Boys,5587,1,21,8,3,69,35,34,71
FC Basel,5587,2,18,8,6,57,23,34,62
Lucerne,5587,3,13,10,9,46,44,2,49
St Gallen,5587,4,14,3,15,45,59,-14,45
FC Zürich,5587,5,11,10,11,41,36,5,43
FC Thun,5587,6,10,6,16,42,60,-18,36
FC Lugano,5587,7,9,8,15,32,48,-16,35
Grasshoppers,5587,8,8,7,17,38,50,-12,31
FC Sion,5587,9,5,10,17,39,54,-15,25
Young Boys,5588,1,24,6,2,76,35,41,78
FC Basel,5588,2,18,8,6,59,32,27,62
St Gallen,5588,3,15,3,14,44,52,-8,48
FC Zürich,5588,4,11,9,12,41,38,3,42
Lucerne,5588,5,11,9,12,42,46,-4,42
Grasshoppers,5588,6,10,6,16,40,49,-9,36
FC Lugano,5588,7,9,7,16,31,48,-17,34
FC Thun,5588,8,9,5,18,47,63,-16,32
FC Sion,5588,9,7,7,18,40,57,-17,28
Young Boys,5589,1,22,6,4,71,36,35,72
FC Basel,5589,2,18,8,6,55,26,29,62
Lucerne,5589,3,13,7,12,42,44,-2,46
St Gallen,5589,4,14,3,15,44,57,-13,45
FC Zürich,5589,5,10,11,11,40,36,4,41
FC Lugano,5589,6,11,6,15,33,47,-14,39
Grasshoppers,5589,7,10,6,16,40,51,-11,36
FC Thun,5589,8,10,5,17,45,57,-12,35
FC Sion,5589,9,6,8,18,39,55,-16,26
Young Boys,5590,1,22,7,3,75,36,39,73
FC Basel,5590,2,16,9,7,56,29,27,57
Lucerne,5590,3,13,8,11,43,47,-4,47
FC Zürich,5590,4,11,10,11,41,35,6,43
St Gallen,5590,5,13,4,15,43,56,-13,43
Grasshoppers,5590,6,10,7,15,42,48,-6,37
FC Thun,5590,7,10,5,17,43,59,-16,35
FC Lugano,5590,8,9,6,17,31,54,-23,33
FC Sion,5590,9,8,8,16,40,50,-10,32
Young Boys,5591,1,21,6,5,70,38,32,69
FC Basel,5591,2,18,8,6,53,24,29,62
Lucerne,5591,3,13,8,11,41,41,0,47
FC Zürich,5591,4,12,9,11,42,38,4,45
St Gallen,5591,5,13,4,15,39,53,-14,43
FC Lugano,5591,6,11,5,16,32,47,-15,38
Grasshoppers,5591,7,9,8,15,42,47,-5,35
FC Thun,5591,8,9,6,17,45,61,-16,33
FC Sion,5591,9,7,8,17,42,57,-15,29
Young Boys,5592,1,20,8,4,68,34,34,68
FC Basel,5592,2,19,7,6,52,22,30,64
Lucerne,5592,3,14,7,11,45,44,1,49
FC Zürich,5592,4,11,10,11,41,34,7,43
St Gallen,5592,5,13,4,15,40,53,-13,43
Grasshoppers,5592,6,10,7,15,43,49,-6,37
FC Lugano,5592,7,10,6,16,29,49,-20,36
FC Thun,5592,8,9,7,16,43,57,-14,34
FC Sion,5592,9,5,10,17,37,56,-19,25
Young Boys,5593,1,23,6,3,73,34,39,75
FC Basel,5593,2,18,8,6,57,25,32,62
St Gallen,5593,3,15,4,13,46,53,-7,49
FC Zürich,5593,4,12,10,10,42,33,9,46
Lucerne,5593,5,11,9,12,41,47,-6,42
Grasshoppers,5593,6,10,6,16,41,49,-8,36
FC Lugano,5593,7,9,7,16,30,50,-20,34
FC Thun,5593,8,9,6,17,43,63,-20,33
FC Sion,5593,9,5,8,19,36,55,-19,23
Young Boys,5594,1,19,9,4,65,35,30,66
FC Basel,5594,2,19,8,5,63,24,39,65
St Gallen,5594,3,14,4,14,43,57,-14,46
FC Zürich,5594,4,11,10,11,39,35,4,43
Lucerne,5594,5,11,10,11,41,49,-8,43
FC Lugano,5594,6,11,6,15,31,44,-13,39
Grasshoppers,5594,7,10,7,15,40,48,-8,37
FC Sion,5594,8,7,9,16,43,51,-8,30
FC Thun,5594,9,8,5,19,41,63,-22,29
Young Boys,5595,1,22,7,3,74,34,40,73
FC Basel,5595,2,17,8,7,54,29,25,59
St Gallen,5595,3,15,2,15,46,56,-10,47
Lucerne,5595,4,13,7,12,43,49,-6,46
FC Zürich,5595,5,10,11,11,42,39,3,41
FC Lugano,5595,6,10,6,16,33,50,-17,36
Grasshoppers,5595,7,9,8,15,43,50,-7,35
FC Thun,5595,8,10,5,17,47,62,-15,35
FC Sion,5595,9,7,8,17,43,56,-13,29
Young Boys,5596,1,22,8,2,83,34,49,74
FC Basel,5596,2,17,8,7,50,29,21,59
St Gallen,5596,3,16,2,14,48,52,-4,50
Lucerne,5596,4,11,9,12,42,52,-10,42
FC Zürich,5596,5,10,11,11,38,34,4,41
FC Thun,5596,6,11,5,16,48,54,-6,38
Grasshoppers,5596,7,9,8,15,39,51,-12,35
FC Lugano,5596,8,9,7,16,30,54,-24,34
FC Sion,5596,9,6,8,18,38,56,-18,26
Young Boys,5597,1,21,9,2,73,36,37,72
FC Basel,5597,2,17,10,5,53,24,29,61
St Gallen,5597,3,14,3,15,44,54,-10,45
Lucerne,5597,4,12,8,12,45,47,-2,44
FC Zürich,5597,5,11,10,11,42,39,3,43
FC Lugano,5597,6,11,7,14,32,45,-13,40
FC Thun,5597,7,9,7,16,45,60,-15,34
Grasshoppers,5597,8,8,8,16,39,53,-14,32
FC Sion,5597,9,6,8,18,39,54,-15,26
Young Boys,5598,1,22,8,2,77,36,41,74
FC Basel,5598,2,18,9,5,56,25,31,63
St Gallen,5598,3,14,4,14,44,56,-12,46
Lucerne,5598,4,12,9,11,43,47,-4,45
FC Zürich,5598,5,9,10,13,40,41,-1,37
FC Thun,5598,6,10,6,16,47,61,-14,36
FC Lugano,5598,7,10,6,16,33,51,-18,36
Grasshoppers,5598,8,8,9,15,44,55,-11,33
FC Sion,5598,9,6,9,17,45,57,-12,27
Young Boys,5599,1,21,7,4,69,34,35,70
FC Basel,5599,2,17,8,7,55,30,25,59
St Gallen,5599,3,16,3,13,45,52,-7,51
Lucerne,5599,4,13,7,12,42,44,-2,46
FC Zürich,5599,5,11,10,11,44,37,7,43
FC Thun,5599,6,12,5,15,47,57,-10,41
Grasshoppers,5599,7,10,6,16,42,50,-8,36
FC Lugano,5599,8,9,7,16,28,46,-18,34
FC Sion,5599,9,5,7,20,37,59,-22,22
Young Boys,5600,1,19,10,3,68,36,32,67
FC Basel,5600,2,19,8,5,56,22,34,65
FC Zürich,5600,3,12,9,11,42,35,7,45
St Gallen,5600,4,14,3,15,44,57,-13,45
Lucerne,5600,5,11,11,10,38,41,-3,44
Grasshoppers,5600,6,10,8,14,43,48,-5,38
FC Lugano,5600,7,10,7,15,32,47,-15,37
FC Thun,5600,8,9,5,18,41,62,-21,32
FC Sion,5600,9,5,9,18,37,53,-16,24
Young Boys,5601,1,21,7,4,71,34,37,70
FC Basel,5601,2,19,7,6,53,24,29,64
St Gallen,5601,3,15,3,14,45,55,-10,48
Lucerne,5601,4,13,8,11,40,42,-2,47
FC Zürich,5601,5,10,10,12,41,38,3,40
Grasshoppers,5601,6,10,6,16,40,50,-10,36
FC Thun,5601,7,10,5,17,45,60,-15,35
FC Lugano,5601,8,10,5,17,31,49,-18,35
FC Sion,5601,9,6,9,17,43,57,-14,27
Young Boys,5602,1,23,6,3,77,40,37,75
FC Basel,5602,2,18,8,6,57,25,32,62
Lucerne,5602,3,13,9,10,47,42,5,48
FC Zürich,5602,4,11,10,11,39,34,5,43
St Gallen,5602,5,13,4,15,40,53,-13,43
FC Lugano,5602,6,10,6,16,31,51,-20,36
FC Thun,5602,7,10,5,17,44,62,-18,35
Grasshoppers,5602,8,9,6,17,44,55,-11,33
FC Sion,5602,9,6,8,18,41,58,-17,26
Young Boys,5603,1,23,6,3,77,34,43,75
FC Basel,5603,2,18,8,6,56,27,29,62
Lucerne,5603,3,13,8,11,47,48,-1,47
St Gallen,5603,4,15,2,15,45,56,-11,47
FC Lugano,5603,5,11,6,15,31,45,-14,39
FC Zürich,5603,6,9,11,12,37,36,1,38
FC Thun,5603,7,10,5,17,42,57,-15,35
Grasshoppers,5603,8,8,6,18,39,53,-14,30
FC Sion,5603,9,7,8,17,38,56,-18,29
Young Boys,5604,1,23,7,2,77,34,43,76
FC Basel,5604,2,17,9,6,54,28,26,60
Lucerne,5604,3,13,9,10,45,43,2,48
St Gallen,5604,4,14,3,15,42,55,-13,45
FC Lugano,5604,5,11,5,16,32,49,-17,38
FC Zürich,5604,6,9,10,13,37,37,0,37
FC Thun,5604,7,10,6,16,44,57,-13,36
Grasshoppers,5604,8,8,8,16,41,53,-12,32
FC Sion,5604,9,7,7,18,38,54,-16,28
Young Boys,5605,1,22,7,3,73,36,37,73
FC Basel,5605,2,18,9,5,55,25,30,63
FC Zürich,5605,3,12,10,10,45,36,9,46
Lucerne,5605,4,11,10,11,42,46,-4,43
St Gallen,5605,5,13,4,15,42,57,-15,43
FC Lugano,5605,6,11,5,16,32,48,-16,38
Grasshoppers,5605,7,9,8,15,44,53,-9,35
FC Thun,5605,8,9,5,18,45,61,-16,32
FC Sion,5605,9,6,8,18,42,58,-16,26
Young Boys,5606,1,23,6,3,72,33,39,75
FC Basel,5606,2,20,7,5,58,25,33,67
Lucerne,5606,3,13,7,12,45,48,-3,46
St Gallen,5606,4,14,2,16,44,58,-14,44
FC Zürich,5606,5,11,10,11,43,36,7,43
Grasshoppers,5606,6,10,6,16,41,49,-8,36
FC Thun,5606,7,10,5,17,44,61,-17,35
FC Lugano,5606,8,9,5,18,31,54,-23,32
FC Sion,5606,9,6,8,18,42,56,-14,26
Young Boys,5607,1,22,7,3,72,33,39,73
FC Basel,5607,2,19,8,5,57,22,35,65
St Gallen,5607,3,15,2,15,42,54,-12,47
FC Zürich,5607,4,12,10,10,46,37,9,46
Lucerne,5607,5,12,8,12,40,48,-8,44
Grasshoppers,5607,6,10,6,16,45,52,-7,36
FC Thun,5607,7,10,5,17,42,60,-18,35
FC Lugano,5607,8,9,6,17,27,48,-21,33
FC Sion,5607,9,5,8,19,44,61,-17,23
Young Boys,5608,1,23,6,3,70,33,37,75
FC Basel,5608,2,18,8,6,58,25,33,62
Lucerne,5608,3,15,7,10,49,43,6,52
St Gallen,5608,4,14,3,15,47,60,-13,45
FC Zürich,5608,5,10,9,13,40,38,2,39
Grasshoppers,5608,6,10,6,16,41,49,-8,36
FC Lugano,5608,7,10,5,17,30,50,-20,35
FC Thun,5608,8,9,5,18,43,65,-22,32
FC Sion,5608,9,7,7,18,43,58,-15,28
Young Boys,5609,1,23,6,3,74,34,40,75
FC Basel,5609,2,17,8,7,51,26,25,59
St Gallen,5609,3,16,2,14,43,53,-10,50
FC Zürich,5609,4,11,11,10,45,34,11,44
Lucerne,5609,5,11,10,11,42,45,-3,43
FC Lugano,5609,6,9,7,16,31,48,-17,34
FC Thun,5609,7,9,6,17,46,59,-13,33
Grasshoppers,5609,8,8,7,17,39,55,-16,31
FC Sion,5609,9,8,7,17,44,61,-17,31
Young Boys,5610,1,21,7,4,72,41,31,70
FC Basel,5610,2,17,8,7,52,26,26,59
St Gallen,5610,3,16,3,13,48,52,-4,51
Lucerne,5610,4,12,9,11,39,43,-4,45
FC Zürich,5610,5,9,11,12,39,38,1,38
Grasshoppers,5610,6,10,7,15,43,46,-3,37
FC Thun,5610,7,10,5,17,42,58,-16,35
FC Lugano,5610,8,9,8,15,33,50,-17,35
FC Sion,5610,9,7,8,17,41,55,-14,29
Young Boys,5611,1,20,7,5,69,39,30,67
FC Basel,5611,2,17,8,7,51,23,28,59
Lucerne,5611,3,14,8,10,41,41,0,50
FC Zürich,5611,4,12,9,11,44,36,8,45
St Gallen,5611,5,13,4,15,38,51,-13,43
Grasshoppers,5611,6,10,7,15,42,48,-6,37
FC Thun,5611,7,10,6,16,41,55,-14,36
FC Lugano,5611,8,10,6,16,30,49,-19,36
FC Sion,5611,9,7,7,18,43,57,-14,28
Young Boys,5612,1,22,8,2,72,33,39,74
FC Basel,5612,2,15,12,5,53,28,25,57
Lucerne,5612,3,12,11,9,42,40,2,47
FC Zürich,5612,4,12,10,10,46,35,11,46
St Gallen,5612,5,13,4,15,43,57,-14,43
Grasshoppers,5612,6,9,8,15,42,50,-8,35
FC Lugano,5612,7,10,5,17,31,53,-22,35
FC Thun,5612,8,8,8,16,41,58,-17,32
FC Sion,5612,9,6,8,18,41,57,-16,26
Young Boys,5613,1,23,6,3,81,40,41,75
FC Basel,5613,2,18,7,7,53,27,26,61
Lucerne,5613,3,14,7,11,46,45,1,49
St Gallen,5613,4,15,2,15,43,53,-10,47
FC Zürich,5613,5,12,9,11,45,36,9,45
FC Lugano,5613,6,10,5,17,32,54,-22,35
Grasshoppers,5613,7,9,7,16,42,53,-11,34
FC Thun,5613,8,9,7,16,40,56,-16,34
FC Sion,5613,9,5,8,19,38,56,-18,23
Young Boys,5614,1,22,7,3,72,32,40,73
FC Basel,5614,2,16,10,6,53,30,23,58
St Gallen,5614,3,14,3,15,42,54,-12,45
Lucerne,5614,4,12,8,12,40,43,-3,44
FC Lugano,5614,5,12,5,15,30,45,-15,41
FC Zürich,5614,6,9,10,13,36,36,0,37
FC Thun,5614,7,10,7,15,47,55,-8,37
Grasshoppers,5614,8,10,7,15,39,49,-10,37
FC Sion,5614,9,7,7,18,38,53,-15,28
Young Boys,5615,1,21,9,2,72,35,37,72
FC Basel,5615,2,18,9,5,55,25,30,63
St Gallen,5615,3,15,4,13,47,53,-6,49
Lucerne,5615,4,12,9,11,44,47,-3,45
FC Zürich,5615,5,10,11,11,40,35,5,41
Grasshoppers,5615,6,10,6,16,42,51,-9,36
FC Lugano,5615,7,9,8,15,32,48,-16,35
FC Thun,5615,8,9,6,17,44,60,-16,33
FC Sion,5615,9,5,8,19,37,59,-22,23
Young Boys,5616,1,22,7,3,69,32,37,73
FC Basel,5616,2,19,7,6,55,26,29,64
St Gallen,5616,3,16,2,14,45,53,-8,50
Lucerne,5616,4,12,7,13,41,47,-6,43
FC Zürich,5616,5,9,11,12,39,40,-1,38
FC Lugano,5616,6,10,6,16,34,50,-16,36
Grasshoppers,5616,7,9,7,16,40,49,-9,34
FC Thun,5616,8,8,8,16,41,57,-16,32
FC Sion,5616,9,7,9,16,44,54,-10,30
Young Boys,5617,1,22,7,3,75,38,37,73
FC Basel,5617,2,18,8,6,54,24,30,62
St Gallen,5617,3,15,3,14,42,54,-12,48
Lucerne,5617,4,13,7,12,44,44,0,46
FC Zürich,5617,5,11,10,11,46,38,8,43
Grasshoppers,5617,6,9,6,17,41,53,-12,33
FC Thun,5617,7,9,6,17,44,61,-17,33
FC Sion,5617,8,8,8,16,47,57,-10,32
FC Lugano,5617,9,9,5,18,28,52,-24,32
Young Boys,5618,1,20,8,4,70,36,34,68
FC Basel,5618,2,18,7,7,56,31,25,61
Lucerne,5618,3,13,8,11,44,44,0,47
FC Zürich,5618,4,11,10,11,43,36,7,43
St Gallen,5618,5,13,4,15,41,57,-16,43
FC Lugano,5618,6,10,7,15,31,47,-16,37
FC Thun,5618,7,10,6,16,48,61,-13,36
Grasshoppers,5618,8,9,6,17,41,55,-14,33
FC Sion,5618,9,8,8,16,45,52,-7,32
Young Boys,5619,1,23,7,2,71,33,38,76
FC Basel,5619,2,16,9,7,51,27,24,57
St Gallen,5619,3,15,3,14,47,54,-7,48
Lucerne,5619,4,12,8,12,42,48,-6,44
FC Lugano,5619,5,11,5,16,32,47,-15,38
FC Zürich,5619,6,9,10,13,38,38,0,37
FC Thun,5619,7,10,7,15,47,59,-12,37
Grasshoppers,5619,8,9,8,15,43,50,-7,35
FC Sion,5619,9,6,9,17,39,54,-15,27
Young Boys,5620,1,21,7,4,65,32,33,70
FC Basel,5620,2,17,8,7,57,27,30,59
St Gallen,5620,3,16,2,14,45,56,-11,50
Lucerne,5620,4,12,9,11,43,45,-2,45
FC Zürich,5620,5,9,12,11,43,41,2,39
FC Lugano,5620,6,10,6,16,35,48,-13,36
FC Thun,5620,7,10,6,16,49,64,-15,36
Grasshoppers,5620,8,9,8,15,41,48,-7,35
FC Sion,5620,9,7,8,17,37,54,-17,29
Young Boys,5621,1,22,6,4,75,40,35,72
FC Basel,5621,2,20,7,5,62,25,37,67
Lucerne,5621,3,15,7,10,48,48,0,52
St Gallen,5621,4,14,2,16,43,58,-15,44
FC Zürich,5621,5,9,11,12,42,42,0,38
FC Lugano,5621,6,11,5,16,38,50,-12,38
Grasshoppers,5621,7,9,6,17,42,56,-14,33
FC Thun,5621,8,9,6,17,43,61,-18,33
FC Sion,5621,9,6,8,18,42,55,-13,26
Young Boys,5622,1,20,7,5,72,36,36,67
FC Basel,5622,2,17,8,7,51,23,28,59
Lucerne,5622,3,14,9,9,44,40,4,51
St Gallen,5622,4,14,4,14,42,55,-13,46
FC Zürich,5622,5,11,10,11,39,34,5,43
FC Lugano,5622,6,10,6,16,29,51,-22,36
Grasshoppers,5622,7,9,6,17,40,52,-12,33
FC Thun,5622,8,9,6,17,44,61,-17,33
FC Sion,5622,9,7,10,15,42,51,-9,31
Young Boys,5623,1,23,7,2,74,33,41,76
FC Basel,5623,2,18,8,6,58,25,33,62
Lucerne,5623,3,14,8,10,43,41,2,50
St Gallen,5623,4,13,3,16,40,55,-15,42
FC Lugano,5623,5,11,5,16,32,49,-17,38
FC Zürich,5623,6,9,9,14,39,44,-5,36
Grasshoppers,5623,7,9,8,15,40,50,-10,35
FC Thun,5623,8,10,5,17,43,59,-16,35
FC Sion,5623,9,6,9,17,40,53,-13,27
Young Boys,5624,1,22,6,4,76,40,36,72
FC Basel,5624,2,17,8,7,54,29,25,59
St Gallen,5624,3,16,3,13,49,55,-6,51
Lucerne,5624,4,12,9,11,46,47,-1,45
FC Zürich,5624,5,11,9,12,43,39,4,42
FC Thun,5624,6,11,5,16,47,57,-10,38
FC Lugano,5624,7,10,5,17,32,53,-21,35
Grasshoppers,5624,8,8,7,17,40,55,-15,31
FC Sion,5624,9,7,8,17,48,60,-12,29
Young Boys,5625,1,20,8,4,71,42,29,68
FC Basel,5625,2,16,8,8,51,27,24,56
St Gallen,5625,3,16,2,14,44,53,-9,50
Lucerne,5625,4,13,9,10,43,41,2,48
FC Zürich,5625,5,11,11,10,45,37,8,44
FC Thun,5625,6,10,6,16,44,58,-14,36
Grasshoppers,5625,7,9,8,15,40,48,-8,35
FC Lugano,5625,8,9,6,17,33,55,-22,33
FC Sion,5625,9,7,8,17,43,53,-10,29
Young Boys,5626,1,20,8,4,67,34,33,68
FC Basel,5626,2,19,8,5,57,27,30,65
Lucerne,5626,3,14,7,11,45,45,0,49
St Gallen,5626,4,13,3,16,39,55,-16,42
FC Zürich,5626,5,10,11,11,42,39,3,41
FC Lugano,5626,6,11,5,16,30,46,-16,38
Grasshoppers,5626,7,10,7,15,42,47,-5,37
FC Sion,5626,8,7,9,16,43,51,-8,30
FC Thun,5626,9,8,6,18,43,64,-21,30
Young Boys,5627,1,21,8,3,73,37,36,71
FC Basel,5627,2,17,7,8,56,29,27,58
St Gallen,5627,3,16,2,14,45,56,-11,50
Lucerne,5627,4,13,8,11,42,45,-3,47
FC Zürich,5627,5,9,9,14,39,44,-5,36
FC Thun,5627,6,10,6,16,44,56,-12,36
Grasshoppers,5627,7,9,8,15,40,48,-8,35
FC Lugano,5627,8,10,5,17,34,52,-18,35
FC Sion,5627,9,8,9,15,43,49,-6,33
Young Boys,5628,1,23,6,3,74,37,37,75
FC Basel,5628,2,19,8,5,63,23,40,65
Lucerne,5628,3,13,7,12,40,42,-2,46
St Gallen,5628,4,13,3,16,41,56,-15,42
FC Zürich,5628,5,10,9,13,39,40,-1,39
FC Thun,5628,6,10,5,17,48,62,-14,35
FC Lugano,5628,7,10,5,17,32,52,-20,35
FC Sion,5628,8,9,7,16,44,55,-11,34
Grasshoppers,5628,9,9,6,17,40,54,-14,33
Young Boys,5629,1,21,7,4,72,35,37,70
FC Basel,5629,2,19,8,5,57,23,34,65
Lucerne,5629,3,12,10,10,46,43,3,46
St Gallen,5629,4,13,4,15,39,57,-18,43
FC Zürich,5629,5,11,9,12,45,41,4,42
FC Lugano,5629,6,11,6,15,32,47,-15,39
Grasshoppers,5629,7,9,6,17,38,53,-15,33
FC Thun,5629,8,9,6,17,46,63,-17,33
FC Sion,5629,9,7,8,17,43,56,-13,29
Young Boys,5630,1,21,8,3,74,40,34,71
FC Basel,5630,2,18,9,5,56,26,30,63
Lucerne,5630,3,14,8,10,48,43,5,50
St Gallen,5630,4,15,2,15,44,55,-11,47
FC Zürich,5630,5,10,10,12,44,41,3,40
FC Thun,5630,6,11,5,16,49,59,-10,38
FC Lugano,5630,7,9,7,16,30,51,-21,34
Grasshoppers,5630,8,8,6,18,42,56,-14,30
FC Sion,5630,9,7,7,18,41,57,-16,28
Young Boys,5631,1,19,8,5,65,35,30,65
FC Basel,5631,2,18,8,6,53,23,30,62
St Gallen,5631,3,16,3,13,45,51,-6,51
Lucerne,5631,4,12,9,11,42,44,-2,45
FC Zürich,5631,5,11,11,10,42,36,6,44
Grasshoppers,5631,6,11,6,15,43,51,-8,39
FC Lugano,5631,7,10,5,17,32,50,-18,35
FC Thun,5631,8,9,5,18,46,62,-16,32
FC Sion,5631,9,6,9,17,39,55,-16,27
Young Boys,5632,1,21,7,4,70,35,35,70
FC Basel,5632,2,18,8,6,52,24,28,62
FC Zürich,5632,3,13,9,10,41,33,8,48
St Gallen,5632,4,14,4,14,41,52,-11,46
Lucerne,5632,5,12,9,11,40,44,-4,45
FC Lugano,5632,6,11,6,15,31,45,-14,39
Grasshoppers,5632,7,8,8,16,37,48,-11,32
FC Thun,5632,8,9,5,18,42,58,-16,32
FC Sion,5632,9,6,8,18,39,54,-15,26
Young Boys,5633,1,23,6,3,75,35,40,75
FC Basel,5633,2,18,7,7,62,28,34,61
Lucerne,5633,3,14,8,10,47,47,0,50
FC Zürich,5633,4,12,9,11,43,34,9,45
St Gallen,5633,5,13,2,17,40,63,-23,41
FC Thun,5633,6,10,6,16,46,63,-17,36
Grasshoppers,5633,7,9,8,15,41,51,-10,35
FC Lugano,5633,8,10,5,17,32,49,-17,35
FC Sion,5633,9,6,7,19,39,55,-16,25
Young Boys,5634,1,22,7,3,74,35,39,73
FC Basel,5634,2,19,8,5,58,24,34,65
St Gallen,5634,3,14,3,15,40,54,-14,45
Lucerne,5634,4,12,8,12,43,48,-5,44
FC Zürich,5634,5,11,10,11,45,39,6,43
Grasshoppers,5634,6,10,7,15,41,48,-7,37
FC Lugano,5634,7,10,5,17,32,52,-20,35
FC Thun,5634,8,9,5,18,41,60,-19,32
FC Sion,5634,9,7,7,18,38,52,-14,28
Young Boys,5635,1,21,8,3,73,40,33,71
FC Basel,5635,2,19,7,6,59,28,31,64
St Gallen,5635,3,15,2,15,42,54,-12,47
Lucerne,5635,4,12,8,12,40,44,-4,44
FC Zürich,5635,5,10,10,12,41,38,3,40
FC Lugano,5635,6,11,5,16,30,45,-15,38
Grasshoppers,5635,7,10,7,15,43,48,-5,37
FC Thun,5635,8,9,6,17,42,58,-16,33
FC Sion,5635,9,6,9,17,40,55,-15,27
Young Boys,5636,1,21,7,4,69,35,34,70
FC Basel,5636,2,18,8,6,57,30,27,62
St Gallen,5636,3,15,2,15,46,56,-10,47
Lucerne,5636,4,12,8,12,41,47,-6,44
FC Lugano,5636,5,11,6,15,36,48,-12,39
Grasshoppers,5636,6,10,8,14,40,46,-6,38
FC Zürich,5636,7,9,10,13,41,40,1,37
FC Thun,5636,8,10,6,16,47,59,-12,36
FC Sion,5636,9,7,7,18,42,58,-16,28
Young Boys,5637,1,22,6,4,74,41,33,72
FC Basel,5637,2,16,9,7,51,27,24,57
Lucerne,5637,3,12,9,11,40,44,-4,45
St Gallen,5637,4,13,4,15,45,59,-14,43
Grasshoppers,5637,5,11,6,15,43,46,-3,39
FC Zürich,5637,6,9,11,12,39,38,1,38
FC Thun,5637,7,11,5,16,47,57,-10,38
FC Lugano,5637,8,10,6,16,36,51,-15,36
FC Sion,5637,9,8,8,16,43,55,-12,32
Young Boys,5638,1,22,8,2,78,33,45,74
FC Basel,5638,2,15,9,8,48,31,17,54
St Gallen,5638,3,16,3,13,48,51,-3,51
FC Zürich,5638,4,13,9,10,44,34,10,48
Lucerne,5638,5,12,8,12,42,49,-7,44
FC Thun,5638,6,11,5,16,43,56,-13,38
FC Lugano,5638,7,10,5,17,31,51,-20,35
Grasshoppers,5638,8,8,8,16,42,52,-10,32
FC Sion,5638,9,5,9,18,36,55,-19,24
Young Boys,5639,1,21,8,3,74,39,35,71
FC Basel,5639,2,17,9,6,54,27,27,60
Lucerne,5639,3,13,7,12,43,51,-8,46
St Gallen,5639,4,14,2,16,43,54,-11,44
FC Zürich,5639,5,10,11,11,40,36,4,41
FC Lugano,5639,6,11,6,15,35,47,-12,39
Grasshoppers,5639,7,9,7,16,41,50,-9,34
FC Sion,5639,8,8,8,16,42,52,-10,32
FC Thun,5639,9,8,8,16,42,58,-16,32
Young Boys,5640,1,22,8,2,70,31,39,74
FC Basel,5640,2,19,7,6,57,23,34,64
Lucerne,5640,3,13,7,12,43,43,0,46
FC Zürich,5640,4,11,10,11,42,35,7,43
St Gallen,5640,5,13,3,16,39,57,-18,42
FC Lugano,5640,6,10,8,14,31,45,-14,38
FC Thun,5640,7,10,5,17,44,58,-14,35
Grasshoppers,5640,8,9,6,17,39,56,-17,33
FC Sion,5640,9,6,8,18,39,56,-17,26
Young Boys,5641,1,21,6,5,69,41,28,69
FC Basel,5641,2,17,10,5,57,27,30,61
Lucerne,5641,3,13,9,10,47,46,1,48
St Gallen,5641,4,13,3,16,40,57,-17,42
FC Zürich,5641,5,10,10,12,40,36,4,40
FC Thun,5641,6,10,7,15,45,58,-13,37
FC Lugano,5641,7,10,6,16,33,49,-16,36
Grasshoppers,5641,8,9,7,16,42,49,-7,34
FC Sion,5641,9,8,8,16,40,50,-10,32
Young Boys,5642,1,21,8,3,78,35,43,71
FC Basel,5642,2,18,8,6,57,27,30,62
St Gallen,5642,3,14,3,15,45,59,-14,45
Lucerne,5642,4,11,9,12,43,51,-8,42
FC Zürich,5642,5,10,11,11,42,38,4,41
Grasshoppers,5642,6,10,7,15,42,50,-8,37
FC Thun,5642,7,10,7,15,45,57,-12,37
FC Lugano,5642,8,10,6,16,33,53,-20,36
FC Sion,5642,9,6,9,17,39,54,-15,27
Young Boys,5643,1,23,6,3,77,39,38,75
FC Basel,5643,2,19,7,6,59,26,33,64
St Gallen,5643,3,14,4,14,44,56,-12,46
Lucerne,5643,4,12,9,11,43,47,-4,45
FC Zürich,5643,5,11,11,10,44,36,8,44
FC Thun,5643,6,10,6,16,46,58,-12,36
Grasshoppers,5643,7,8,8,16,44,56,-12,32
FC Lugano,5643,8,9,5,18,31,53,-22,32
FC Sion,5643,9,5,10,17,38,55,-17,25
Young Boys,5644,1,22,6,4,72,35,37,72
FC Basel,5644,2,16,9,7,50,29,21,57
St Gallen,5644,3,15,4,13,46,53,-7,49
Lucerne,5644,4,12,8,12,41,45,-4,44
FC Zürich,5644,5,10,10,12,40,36,4,40
FC Thun,5644,6,11,5,16,46,56,-10,38
Grasshoppers,5644,7,10,6,16,41,51,-10,36
FC Lugano,5644,8,10,6,16,30,48,-18,36
FC Sion,5644,9,7,8,17,41,54,-13,29
Young Boys,5645,1,21,8,3,75,37,38,71
FC Basel,5645,2,17,10,5,50,23,27,61
Lucerne,5645,3,14,8,10,47,45,2,50
FC Zürich,5645,4,12,10,10,44,33,11,46
St Gallen,5645,5,13,3,16,41,57,-16,42
FC Lugano,5645,6,10,5,17,30,47,-17,35
Grasshoppers,5645,7,9,6,17,42,55,-13,33
FC Thun,5645,8,9,5,18,41,60,-19,32
FC Sion,5645,9,8,7,17,44,57,-13,31
Young Boys,5646,1,20,8,4,69,37,32,68
FC Basel,5646,2,18,8,6,52,25,27,62
Lucerne,5646,3,13,9,10,44,43,1,48
St Gallen,5646,4,14,3,15,42,55,-13,45
FC Zürich,5646,5,11,9,12,41,37,4,42
FC Lugano,5646,6,11,6,15,34,47,-13,39
Grasshoppers,5646,7,10,6,16,43,54,-11,36
FC Thun,5646,8,9,6,17,46,59,-13,33
FC Sion,5646,9,6,9,17,42,56,-14,27
Young Boys,5647,1,21,8,3,81,37,44,71
FC Basel,5647,2,18,9,5,56,26,30,63
Lucerne,5647,3,14,7,11,47,49,-2,49
St Gallen,5647,4,13,2,17,42,59,-17,41
FC Zürich,5647,5,9,12,11,41,40,1,39
FC Thun,5647,6,11,5,16,46,57,-11,38
FC Lugano,5647,7,10,6,16,34,55,-21,36
Grasshoppers,5647,8,9,7,16,39,50,-11,34
FC Sion,5647,9,6,10,16,38,51,-13,28
Young Boys,5648,1,22,7,3,76,35,41,73
FC Basel,5648,2,19,8,5,59,26,33,65
St Gallen,5648,3,15,4,13,48,56,-8,49
FC Zürich,5648,4,12,9,11,42,35,7,45
Lucerne,5648,5,12,7,13,40,50,-10,43
FC Lugano,5648,6,10,6,16,34,52,-18,36
FC Thun,5648,7,10,5,17,44,59,-15,35
Grasshoppers,5648,8,8,8,16,39,51,-12,32
FC Sion,5648,9,5,8,19,40,58,-18,23
Young Boys,5649,1,22,6,4,69,34,35,72
FC Basel,5649,2,18,8,6,54,23,31,62
Lucerne,5649,3,13,8,11,42,44,-2,47
St Gallen,5649,4,14,4,14,44,56,-12,46
FC Zürich,5649,5,10,10,12,39,39,0,40
FC Thun,5649,6,10,6,16,45,59,-14,36
FC Lugano,5649,7,10,5,17,33,51,-18,35
Grasshoppers,5649,8,9,6,17,41,52,-11,33
FC Sion,5649,9,7,9,16,43,52,-9,30
Young Boys,5650,1,21,8,3,72,34,38,71
FC Basel,5650,2,17,8,7,53,29,24,59
Lucerne,5650,3,13,9,10,46,45,1,48
St Gallen,5650,4,14,3,15,45,57,-12,45
FC Lugano,5650,5,11,6,15,35,49,-14,39
FC Zürich,5650,6,9,10,13,41,42,-1,37
FC Thun,5650,7,10,6,16,49,61,-12,36
Grasshoppers,5650,8,9,7,16,44,53,-9,34
FC Sion,5650,9,7,9,16,40,55,-15,30
Young Boys,5651,1,22,7,3,71,36,35,73
FC Basel,5651,2,18,8,6,53,23,30,62
Lucerne,5651,3,13,8,11,42,43,-1,47
St Gallen,5651,4,13,2,17,40,58,-18,41
FC Zürich,5651,5,10,10,12,39,38,1,40
Grasshoppers,5651,6,10,7,15,44,50,-6,37
FC Lugano,5651,7,10,6,16,29,46,-17,36
FC Thun,5651,8,8,9,15,40,55,-15,33
FC Sion,5651,9,7,9,16,44,53,-9,30
Young Boys,5652,1,21,8,3,71,35,36,71
FC Basel,5652,2,15,8,9,49,31,18,53
Lucerne,5652,3,14,8,10,46,44,2,50
St Gallen,5652,4,16,2,14,49,58,-9,50
FC Zürich,5652,5,11,9,12,45,39,6,42
FC Lugano,5652,6,12,5,15,39,47,-8,41
FC Thun,5652,7,11,5,16,46,58,-12,38
Grasshoppers,5652,8,9,6,17,40,53,-13,33
FC Sion,5652,9,6,7,19,38,58,-20,25
Young Boys,5653,1,22,8,2,76,35,41,74
FC Basel,5653,2,16,9,7,53,27,26,57
St Gallen,5653,3,14,4,14,45,52,-7,46
FC Zürich,5653,4,12,9,11,45,37,8,45
Lucerne,5653,5,11,9,12,39,54,-15,42
FC Thun,5653,6,12,5,15,47,56,-9,41
FC Lugano,5653,7,10,6,16,31,48,-17,36
Grasshoppers,5653,8,9,7,16,39,48,-9,34
FC Sion,5653,9,5,9,18,39,57,-18,24
Young Boys,5654,1,23,6,3,75,34,41,75
FC Basel,5654,2,17,9,6,53,26,27,60
Lucerne,5654,3,14,7,11,45,48,-3,49
St Gallen,5654,4,15,3,14,46,55,-9,48
FC Zürich,5654,5,10,11,11,39,36,3,41
FC Lugano,5654,6,10,5,17,32,50,-18,35
Grasshoppers,5654,7,9,6,17,41,52,-11,33
FC Thun,5654,8,8,7,17,40,58,-18,31
FC Sion,5654,9,6,10,16,38,50,-12,28
Young Boys,5655,1,21,8,3,71,35,36,71
FC Basel,5655,2,19,8,5,58,24,34,65
St Gallen,5655,3,15,3,14,45,56,-11,48
FC Zürich,5655,4,12,9,11,44,35,9,45
Lucerne,5655,5,12,8,12,40,44,-4,44
FC Lugano,5655,6,10,6,16,31,47,-16,36
Grasshoppers,5655,7,9,6,17,39,50,-11,33
FC Sion,5655,8,8,7,17,43,56,-13,31
FC Thun,5655,9,8,5,19,38,62,-24,29
Young Boys,5656,1,22,7,3,73,35,38,73
FC Basel,5656,2,17,8,7,53,27,26,59
St Gallen,5656,3,15,3,14,48,54,-6,48
Lucerne,5656,4,12,7,13,44,50,-6,43
FC Zürich,5656,5,11,9,12,42,37,5,42
FC Lugano,5656,6,11,6,15,33,48,-15,39
FC Thun,5656,7,11,5,16,45,56,-11,38
Grasshoppers,5656,8,10,6,16,40,50,-10,36
FC Sion,5656,9,6,7,19,43,64,-21,25
Young Boys,5657,1,21,7,4,75,38,37,70
FC Basel,5657,2,18,7,7,61,28,33,61
St Gallen,5657,3,16,3,13,47,51,-4,51
Lucerne,5657,4,12,8,12,38,51,-13,44
FC Zürich,5657,5,10,11,11,42,39,3,41
Grasshoppers,5657,6,10,8,14,41,47,-6,38
FC Lugano,5657,7,9,7,16,30,49,-19,34
FC Thun,5657,8,8,7,17,40,59,-19,31
FC Sion,5657,9,7,8,17,41,53,-12,29
Young Boys,5658,1,21,7,4,70,35,35,70
FC Basel,5658,2,19,7,6,55,24,31,64
St Gallen,5658,3,14,3,15,43,59,-16,45
Lucerne,5658,4,12,8,12,43,49,-6,44
FC Lugano,5658,5,12,5,15,36,46,-10,41
FC Zürich,5658,6,10,9,13,39,39,0,39
FC Thun,5658,7,11,5,16,46,56,-10,38
Grasshoppers,5658,8,9,7,16,40,50,-10,34
FC Sion,5658,9,6,9,17,41,55,-14,27
Young Boys,5659,1,23,6,3,75,36,39,75
FC Basel,5659,2,19,7,6,54,26,28,64
St Gallen,5659,3,15,2,15,42,53,-11,47
Lucerne,5659,4,13,7,12,39,42,-3,46
FC Zürich,5659,5,10,9,13,41,37,4,39
FC Lugano,5659,6,11,5,16,34,49,-15,38
Grasshoppers,5659,7,9,7,16,39,48,-9,34
FC Sion,5659,8,8,8,16,39,51,-12,32
FC Thun,5659,9,8,5,19,39,60,-21,29
Young Boys,5660,1,21,8,3,70,34,36,71
FC Basel,5660,2,17,9,6,55,27,28,60
Lucerne,5660,3,14,8,10,44,42,2,50
St Gallen,5660,4,13,3,16,39,56,-17,42
FC Thun,5660,5,11,6,15,49,60,-11,39
FC Zürich,5660,6,9,10,13,39,39,0,37
FC Lugano,5660,7,10,7,15,31,46,-15,37
Grasshoppers,5660,8,8,9,15,40,49,-9,33
FC Sion,5660,9,7,8,17,40,54,-14,29
Young Boys,5661,1,21,8,3,69,34,35,71
FC Basel,5661,2,17,8,7,52,27,25,59
Lucerne,5661,3,13,8,11,43,41,2,47
St Gallen,5661,4,13,4,15,39,53,-14,43
FC Zürich,5661,5,10,11,11,40,38,2,41
Grasshoppers,5661,6,10,8,14,44,49,-5,38
FC Lugano,5661,7,10,7,15,32,47,-15,37
FC Thun,5661,8,9,6,17,44,62,-18,33
FC Sion,5661,9,6,10,16,42,54,-12,28
Young Boys,5662,1,20,7,5,69,41,28,67
FC Basel,5662,2,18,8,6,55,28,27,62
Lucerne,5662,3,14,8,10,46,40,6,50
St Gallen,5662,4,16,2,14,43,54,-11,50
FC Zürich,5662,5,11,9,12,43,39,4,42
FC Thun,5662,6,10,6,16,45,58,-13,36
Grasshoppers,5662,7,9,7,16,39,49,-10,34
FC Lugano,5662,8,9,5,18,31,50,-19,32
FC Sion,5662,9,6,10,16,42,54,-12,28
Young Boys,5663,1,23,6,3,76,33,43,75
FC Basel,5663,2,19,8,5,56,25,31,65
St Gallen,5663,3,15,3,14,43,52,-9,48
FC Lugano,5663,4,12,5,15,34,47,-13,41
FC Zürich,5663,5,10,10,12,39,35,4,40
Lucerne,5663,6,11,7,14,39,51,-12,40
FC Thun,5663,7,10,6,16,48,56,-8,36
Grasshoppers,5663,8,10,6,16,39,53,-14,36
FC Sion,5663,9,5,7,20,37,59,-22,22
Young Boys,5664,1,23,6,3,73,34,39,75
FC Basel,5664,2,17,7,8,54,28,26,58
FC Zürich,5664,3,12,9,11,43,34,9,45
Lucerne,5664,4,12,9,11,41,46,-5,45
St Gallen,5664,5,13,3,16,39,56,-17,42
FC Lugano,5664,6,12,5,15,34,44,-10,41
Grasshoppers,5664,7,9,9,14,42,48,-6,36
FC Thun,5664,8,9,6,17,41,60,-19,33
FC Sion,5664,9,6,8,18,40,57,-17,26
Young Boys,5665,1,23,7,2,75,34,41,76
FC Basel,5665,2,18,9,5,54,24,30,63
Lucerne,5665,3,13,7,12,44,48,-4,46
St Gallen,5665,4,14,2,16,42,56,-14,44
FC Zürich,5665,5,11,9,12,41,34,7,42
FC Lugano,5665,6,10,5,17,32,50,-18,35
FC Thun,5665,7,9,7,16,42,57,-15,34
FC Sion,5665,8,8,7,17,40,53,-13,31
Grasshoppers,5665,9,8,7,17,37,51,-14,31
Young Boys,5666,1,23,7,2,72,31,41,76
FC Basel,5666,2,18,9,5,57,27,30,63
St Gallen,5666,3,15,3,14,44,53,-9,48
Lucerne,5666,4,12,7,13,37,43,-6,43
FC Zürich,5666,5,11,9,12,43,37,6,42
FC Lugano,5666,6,10,5,17,30,50,-20,35
Grasshoppers,5666,7,9,7,16,38,48,-10,34
FC Thun,5666,8,8,8,16,42,60,-18,32
FC Sion,5666,9,6,9,17,38,52,-14,27
Young Boys,5667,1,23,6,3,75,33,42,75
FC Basel,5667,2,18,9,5,55,25,30,63
St Gallen,5667,3,14,3,15,45,55,-10,45
FC Zürich,5667,4,11,11,10,40,33,7,44
Lucerne,5667,5,11,9,12,40,47,-7,42
Grasshoppers,5667,6,10,7,15,42,50,-8,37
FC Lugano,5667,7,10,6,16,31,50,-19,36
FC Thun,5667,8,9,6,17,40,58,-18,33
FC Sion,5667,9,6,7,19,38,55,-17,25
Young Boys,5668,1,22,6,4,70,32,38,72
FC Basel,5668,2,18,8,6,57,30,27,62
Lucerne,5668,3,13,7,12,43,49,-6,46
FC Zürich,5668,4,12,9,11,47,36,11,45
St Gallen,5668,5,13,3,16,43,59,-16,42
Grasshoppers,5668,6,11,6,15,46,47,-1,39
FC Lugano,5668,7,11,5,16,35,52,-17,38
FC Thun,5668,8,9,5,18,43,71,-28,32
FC Sion,5668,9,7,7,18,44,52,-8,28
Young Boys,5669,1,22,7,3,72,35,37,73
FC Basel,5669,2,18,7,7,56,29,27,61
St Gallen,5669,3,14,3,15,44,58,-14,45
FC Zürich,5669,4,11,11,10,43,37,6,44
Lucerne,5669,5,11,7,14,40,48,-8,40
FC Thun,5669,6,11,6,15,50,58,-8,39
FC Lugano,5669,7,10,8,14,32,46,-14,38
Grasshoppers,5669,8,9,7,16,40,51,-11,34
FC Sion,5669,9,6,8,18,41,56,-15,26
Young Boys,5670,1,22,8,2,78,33,45,74
FC Basel,5670,2,15,10,7,50,28,22,55
Lucerne,5670,3,13,8,11,43,47,-4,47
St Gallen,5670,4,14,3,15,44,57,-13,45
FC Zürich,5670,5,9,11,12,38,40,-2,38
FC Lugano,5670,6,11,5,16,34,47,-13,38
FC Thun,5670,7,10,6,16,44,58,-14,36
Grasshoppers,5670,8,9,8,15,42,52,-10,35
FC Sion,5670,9,7,9,16,42,53,-11,30
Young Boys,5671,1,22,6,4,70,35,35,72
FC Basel,5671,2,18,8,6,56,25,31,62
St Gallen,5671,3,15,2,15,44,58,-14,47
Lucerne,5671,4,12,9,11,41,45,-4,45
FC Zürich,5671,5,11,11,10,43,34,9,44
FC Lugano,5671,6,10,7,15,34,48,-14,37
FC Thun,5671,7,9,6,17,43,59,-16,33
Grasshoppers,5671,8,8,7,17,36,51,-15,31
FC Sion,5671,9,7,8,17,39,51,-12,29
Young Boys,5672,1,21,6,5,70,38,32,69
FC Basel,5672,2,18,8,6,50,23,27,62
St Gallen,5672,3,14,4,14,42,53,-11,46
Lucerne,5672,4,12,7,13,39,44,-5,43
FC Zürich,5672,5,10,10,12,40,36,4,40
FC Lugano,5672,6,11,6,15,33,48,-15,39
Grasshoppers,5672,7,10,6,16,41,49,-8,36
FC Sion,5672,8,9,7,16,42,53,-11,34
FC Thun,5672,9,9,6,17,45,58,-13,33
Young Boys,5673,1,21,6,5,72,40,32,69
FC Basel,5673,2,16,10,6,53,29,24,58
Lucerne,5673,3,13,7,12,46,44,2,46
St Gallen,5673,4,14,3,15,44,57,-13,45
FC Zürich,5673,5,11,10,11,40,37,3,43
Grasshoppers,5673,6,12,6,14,46,47,-1,42
FC Lugano,5673,7,12,5,15,36,50,-14,41
FC Thun,5673,8,8,6,18,43,61,-18,30
FC Sion,5673,9,7,7,18,39,54,-15,28
Young Boys,5674,1,22,6,4,75,37,38,72
FC Basel,5674,2,19,7,6,59,28,31,64
Lucerne,5674,3,14,7,11,44,48,-4,49
St Gallen,5674,4,15,2,15,48,58,-10,47
FC Zürich,5674,5,11,10,11,44,36,8,43
FC Thun,5674,6,9,6,17,44,61,-17,33
FC Lugano,5674,7,9,6,17,31,52,-21,33
FC Sion,5674,8,8,8,16,44,53,-9,32
Grasshoppers,5674,9,8,6,18,42,58,-16,30
Young Boys,5675,1,20,8,4,70,37,33,68
FC Basel,5675,2,18,8,6,57,26,31,62
Lucerne,5675,3,13,8,11,42,42,0,47
FC Zürich,5675,4,11,11,10,43,36,7,44
St Gallen,5675,5,14,2,16,41,59,-18,44
FC Lugano,5675,6,10,8,14,31,44,-13,38
FC Thun,5675,7,9,7,16,43,58,-15,34
Grasshoppers,5675,8,9,6,17,41,55,-14,33
FC Sion,5675,9,7,8,17,47,58,-11,29
Young Boys,5676,1,22,6,4,70,35,35,72
FC Basel,5676,2,19,7,6,58,27,31,64
Lucerne,5676,3,15,7,10,43,39,4,52
St Gallen,5676,4,13,2,17,43,60,-17,41
FC Zürich,5676,5,10,10,12,41,39,2,40
FC Lugano,5676,6,11,5,16,33,48,-15,38
Grasshoppers,5676,7,10,6,16,40,48,-8,36
FC Thun,5676,8,8,7,17,42,62,-20,31
FC Sion,5676,9,7,8,17,44,56,-12,29
Young Boys,5677,1,22,7,3,69,36,33,73
FC Basel,5677,2,17,8,7,56,28,28,59
St Gallen,5677,3,15,3,14,44,54,-10,48
FC Lugano,5677,4,12,5,15,38,45,-7,41
Lucerne,5677,5,11,8,13,40,48,-8,41
Grasshoppers,5677,6,11,6,15,46,49,-3,39
FC Zürich,5677,7,10,9,13,38,42,-4,39
FC Thun,5677,8,11,5,16,49,59,-10,38
FC Sion,5677,9,5,9,18,40,59,-19,24
Young Boys,5678,1,21,7,4,75,36,39,70
FC Basel,5678,2,19,7,6,55,25,30,64
St Gallen,5678,3,14,3,15,45,57,-12,45
Lucerne,5678,4,12,8,12,42,51,-9,44
FC Zürich,5678,5,11,10,11,41,35,6,43
FC Thun,5678,6,11,5,16,47,58,-11,38
FC Lugano,5678,7,10,5,17,30,51,-21,35
Grasshoppers,5678,8,8,8,16,41,52,-11,32
FC Sion,5678,9,7,9,16,44,55,-11,30
Young Boys,5679,1,19,6,7,66,39,27,63
FC Basel,5679,2,17,8,7,55,31,24,59
Lucerne,5679,3,13,8,11,45,45,0,47
St Gallen,5679,4,14,4,14,42,56,-14,46
FC Lugano,5679,5,11,7,14,31,44,-13,40
FC Zürich,5679,6,9,12,11,39,36,3,39
Grasshoppers,5679,7,11,6,15,44,50,-6,39
FC Thun,5679,8,10,5,17,48,61,-13,35
FC Sion,5679,9,8,8,16,46,54,-8,32
Young Boys,5680,1,22,6,4,71,36,35,72
FC Basel,5680,2,20,7,5,57,24,33,67
Lucerne,5680,3,13,7,12,43,45,-2,46
FC Zürich,5680,4,11,10,11,41,36,5,43
St Gallen,5680,5,13,2,17,40,55,-15,41
Grasshoppers,5680,6,10,6,16,42,52,-10,36
FC Thun,5680,7,10,6,16,44,58,-14,36
FC Lugano,5680,8,10,5,17,29,48,-19,35
FC Sion,5680,9,7,7,18,43,56,-13,28
Young Boys,5681,1,21,6,5,71,39,32,69
FC Basel,5681,2,17,8,7,52,28,24,59
Lucerne,5681,3,15,8,9,48,39,9,53
St Gallen,5681,4,14,2,16,42,55,-13,44
FC Zürich,5681,5,11,10,11,44,35,9,43
FC Lugano,5681,6,12,5,15,32,47,-15,41
FC Thun,5681,7,9,6,17,46,63,-17,33
Grasshoppers,5681,8,8,7,17,43,57,-14,31
FC Sion,5681,9,7,8,17,45,60,-15,29
Young Boys,5682,1,21,7,4,71,39,32,70
FC Basel,5682,2,18,9,5,58,26,32,63
Lucerne,5682,3,12,9,11,43,47,-4,45
St Gallen,5682,4,14,2,16,42,56,-14,44
FC Zürich,5682,5,11,10,11,42,38,4,43
Grasshoppers,5682,6,10,8,14,44,47,-3,38
FC Thun,5682,7,10,7,15,43,54,-11,37
FC Lugano,5682,8,9,6,17,29,49,-20,33
FC Sion,5682,9,6,8,18,39,55,-16,26
Young Boys,5683,1,21,8,3,73,35,38,71
FC Basel,5683,2,19,8,5,57,27,30,65
St Gallen,5683,3,14,3,15,43,55,-12,45
Lucerne,5683,4,12,7,13,43,47,-4,43
FC Zürich,5683,5,9,11,12,41,40,1,38
FC Lugano,5683,6,11,5,16,30,48,-18,38
Grasshoppers,5683,7,9,9,14,41,48,-7,36
FC Sion,5683,8,7,10,15,42,52,-10,31
FC Thun,5683,9,8,7,17,42,60,-18,31
Young Boys,5684,1,22,7,3,69,33,36,73
FC Basel,5684,2,17,8,7,51,26,25,59
Lucerne,5684,3,14,8,10,41,40,1,50
St Gallen,5684,4,15,2,15,43,55,-12,47
FC Zürich,5684,5,10,9,13,38,40,-2,39
FC Thun,5684,6,11,5,16,49,57,-8,38
FC Sion,5684,7,9,7,16,46,49,-3,34
FC Lugano,5684,8,9,5,18,29,49,-20,32
Grasshoppers,5684,9,8,7,17,37,54,-17,31
Young Boys,5685,1,22,8,2,75,35,40,74
FC Basel,5685,2,17,8,7,52,25,27,59
Lucerne,5685,3,14,7,11,43,44,-1,49
St Gallen,5685,4,14,4,14,42,53,-11,46
FC Zürich,5685,5,11,10,11,44,35,9,43
FC Thun,5685,6,10,5,17,43,60,-17,35
FC Lugano,5685,7,9,7,16,30,50,-20,34
Grasshoppers,5685,8,8,8,16,39,49,-10,32
FC Sion,5685,9,6,9,17,39,56,-17,27
Young Boys,5686,1,22,6,4,75,39,36,72
FC Basel,5686,2,17,8,7,50,26,24,59
St Gallen,5686,3,15,3,14,43,54,-11,48
Lucerne,5686,4,13,8,11,42,43,-1,47
FC Zürich,5686,5,11,9,12,40,35,5,42
FC Thun,5686,6,12,5,15,44,54,-10,41
FC Lugano,5686,7,11,5,16,31,45,-14,38
Grasshoppers,5686,8,8,8,16,43,53,-10,32
FC Sion,5686,9,5,8,19,42,61,-19,23
Young Boys,5687,1,21,7,4,68,33,35,70
FC Basel,5687,2,19,8,5,53,22,31,65
Lucerne,5687,3,15,7,10,43,41,2,52
St Gallen,5687,4,14,2,16,42,58,-16,44
FC Lugano,5687,5,11,5,16,33,48,-15,38
FC Zürich,5687,6,9,10,13,38,37,1,37
FC Thun,5687,7,10,6,16,42,56,-14,36
Grasshoppers,5687,8,8,7,17,36,50,-14,31
FC Sion,5687,9,7,8,17,43,53,-10,29
Young Boys,5688,1,24,6,2,72,30,42,78
FC Basel,5688,2,18,7,7,55,25,30,61
St Gallen,5688,3,15,2,15,48,58,-10,47
FC Zürich,5688,4,12,9,11,42,34,8,45
Lucerne,5688,5,12,7,13,43,48,-5,43
Grasshoppers,5688,6,10,6,16,43,50,-7,36
FC Lugano,5688,7,10,5,17,31,50,-19,35
FC Sion,5688,8,8,7,17,41,54,-13,31
FC Thun,5688,9,8,5,19,39,65,-26,29
Young Boys,5689,1,21,6,5,75,43,32,69
FC Basel,5689,2,18,8,6,56,27,29,62
St Gallen,5689,3,15,4,13,45,52,-7,49
FC Zürich,5689,4,13,9,10,50,37,13,48
Lucerne,5689,5,12,8,12,42,49,-7,44
Grasshoppers,5689,6,9,8,15,46,52,-6,35
FC Lugano,5689,7,10,5,17,34,50,-16,35
FC Thun,5689,8,8,6,18,43,63,-20,30
FC Sion,5689,9,7,8,17,43,61,-18,29
Young Boys,5690,1,22,7,3,69,34,35,73
FC Basel,5690,2,20,7,5,57,25,32,67
Lucerne,5690,3,14,8,10,44,43,1,50
St Gallen,5690,4,14,3,15,42,54,-12,45
FC Zürich,5690,5,10,11,11,40,35,5,41
Grasshoppers,5690,6,9,7,16,43,52,-9,34
FC Thun,5690,7,9,7,16,43,58,-15,34
FC Lugano,5690,8,9,6,17,29,47,-18,33
FC Sion,5690,9,5,8,19,38,57,-19,23
Young Boys,5691,1,21,8,3,77,36,41,71
FC Basel,5691,2,17,8,7,51,26,25,59
Lucerne,5691,3,13,8,11,45,49,-4,47
St Gallen,5691,4,14,2,16,46,57,-11,44
FC Zürich,5691,5,11,9,12,39,35,4,42
FC Lugano,5691,6,11,5,16,33,54,-21,38
Grasshoppers,5691,7,9,9,14,41,46,-5,36
FC Thun,5691,8,9,7,16,42,57,-15,34
FC Sion,5691,9,7,8,17,40,54,-14,29
Young Boys,5692,1,21,7,4,72,39,33,70
FC Basel,5692,2,17,8,7,54,27,27,59
Lucerne,5692,3,14,8,10,46,43,3,50
St Gallen,5692,4,14,3,15,40,53,-13,45
FC Zürich,5692,5,10,10,12,43,41,2,40
Grasshoppers,5692,6,10,7,15,43,48,-5,37
FC Lugano,5692,7,10,6,16,31,49,-18,36
FC Thun,5692,8,9,7,16,46,60,-14,34
FC Sion,5692,9,7,8,17,42,57,-15,29
Young Boys,5693,1,20,6,6,69,38,31,66
FC Basel,5693,2,17,9,6,51,22,29,60
St Gallen,5693,3,15,3,14,45,54,-9,48
Lucerne,5693,4,13,7,12,41,45,-4,46
Grasshoppers,5693,5,11,7,14,45,46,-1,40
FC Zürich,5693,6,9,11,12,36,36,0,38
FC Lugano,5693,7,11,5,16,31,49,-18,38
FC Sion,5693,8,8,9,15,43,52,-9,33
FC Thun,5693,9,9,5,18,40,59,-19,32
Young Boys,5694,1,23,7,2,82,32,50,76
FC Basel,5694,2,18,9,5,53,23,30,63
St Gallen,5694,3,14,4,14,44,56,-12,46
Lucerne,5694,4,12,8,12,39,47,-8,44
FC Zürich,5694,5,10,10,12,38,37,1,40
FC Thun,5694,6,10,6,16,45,57,-12,36
Grasshoppers,5694,7,9,7,16,42,54,-12,34
FC Lugano,5694,8,9,6,17,29,49,-20,33
FC Sion,5694,9,6,9,17,41,58,-17,27
Young Boys,5695,1,22,7,3,72,35,37,73
FC Basel,5695,2,18,7,7,53,28,25,61
Lucerne,5695,3,13,8,11,44,44,0,47
St Gallen,5695,4,14,4,14,44,55,-11,46
FC Zürich,5695,5,12,9,11,45,33,12,45
FC Lugano,5695,6,10,7,15,33,48,-15,37
Grasshoppers,5695,7,8,8,16,39,51,-12,32
FC Thun,5695,8,9,5,18,40,63,-23,32
FC Sion,5695,9,6,9,17,40,53,-13,27
Young Boys,5696,1,20,7,5,71,41,30,67
FC Basel,5696,2,18,9,5,56,23,33,63
Lucerne,5696,3,13,7,12,42,47,-5,46
St Gallen,5696,4,14,3,15,41,55,-14,45
FC Zürich,5696,5,11,10,11,46,36,10,43
FC Lugano,5696,6,12,5,15,32,44,-12,41
Grasshoppers,5696,7,9,6,17,42,53,-11,33
FC Thun,5696,8,9,6,17,41,62,-21,33
FC Sion,5696,9,7,9,16,44,54,-10,30
Young Boys,5697,1,21,7,4,70,36,34,70
FC Basel,5697,2,18,8,6,53,25,28,62
Lucerne,5697,3,14,8,10,45,41,4,50
FC Zürich,5697,4,12,9,11,41,34,7,45
St Gallen,5697,5,13,2,17,40,56,-16,41
Grasshoppers,5697,6,11,6,15,44,48,-4,39
FC Lugano,5697,7,11,6,15,31,45,-14,39
FC Thun,5697,8,8,5,19,40,60,-20,29
FC Sion,5697,9,7,7,18,40,59,-19,28
Young Boys,5698,1,21,7,4,73,35,38,70
FC Basel,5698,2,18,7,7,58,29,29,61
St Gallen,5698,3,15,3,14,43,51,-8,48
Lucerne,5698,4,12,8,12,41,45,-4,44
FC Zürich,5698,5,11,9,12,42,43,-1,42
FC Thun,5698,6,11,5,16,51,62,-11,38
Grasshoppers,5698,7,9,8,15,44,53,-9,35
FC Lugano,5698,8,10,5,17,30,52,-22,35
FC Sion,5698,9,7,8,17,42,54,-12,29
Young Boys,5699,1,20,8,4,69,38,31,68
FC Basel,5699,2,18,9,5,57,22,35,63
St Gallen,5699,3,14,3,15,41,54,-13,45
Lucerne,5699,4,12,8,12,43,46,-3,44
FC Zürich,5699,5,11,10,11,40,34,6,43
Grasshoppers,5699,6,10,7,15,43,50,-7,37
FC Lugano,5699,7,10,6,16,30,48,-18,36
FC Sion,5699,8,8,9,15,45,53,-8,33
FC Thun,5699,9,8,6,18,40,63,-23,30
Young Boys,5700,1,21,6,5,66,35,31,69
FC Basel,5700,2,17,7,8,51,29,22,58
St Gallen,5700,3,16,2,14,45,54,-9,50
FC Zürich,5700,4,13,9,10,46,35,11,48
Lucerne,5700,5,12,7,13,42,47,-5,43
Grasshoppers,5700,6,11,7,14,42,45,-3,40
FC Lugano,5700,7,11,5,16,34,47,-13,38
FC Thun,5700,8,8,7,17,43,61,-18,31
FC Sion,5700,9,6,8,18,39,55,-16,26
Young Boys,5701,1,23,6,3,71,33,38,75
FC Basel,5701,2,17,7,8,49,26,23,58
Lucerne,5701,3,13,9,10,39,42,-3,48
St Gallen,5701,4,15,2,15,45,53,-8,47
FC Thun,5701,5,12,5,15,47,55,-8,41
FC Lugano,5701,6,11,6,15,32,46,-14,39
FC Zürich,5701,7,9,10,13,38,39,-1,37
Grasshoppers,5701,8,8,7,17,36,49,-13,31
FC Sion,5701,9,6,8,18,42,56,-14,26
Young Boys,5702,1,21,8,3,70,35,35,71
FC Basel,5702,2,18,9,5,59,30,29,63
St Gallen,5702,3,14,4,14,46,56,-10,46
FC Zürich,5702,4,11,11,10,43,36,7,44
Lucerne,5702,5,12,7,13,42,46,-4,43
Grasshoppers,5702,6,10,7,15,42,49,-7,37
FC Lugano,5702,7,9,8,15,31,49,-18,35
FC Thun,5702,8,9,6,17,42,59,-17,33
FC Sion,5702,9,6,8,18,38,53,-15,26
Young Boys,5703,1,20,8,4,68,36,32,68
FC Basel,5703,2,16,10,6,53,28,25,58
Lucerne,5703,3,14,8,10,43,41,2,50
St Gallen,5703,4,14,3,15,43,56,-13,45
FC Zürich,5703,5,11,9,12,44,37,7,42
FC Lugano,5703,6,11,6,15,34,49,-15,39
FC Thun,5703,7,10,6,16,43,56,-13,36
Grasshoppers,5703,8,9,6,17,39,51,-12,33
FC Sion,5703,9,7,8,17,40,53,-13,29
Young Boys,5704,1,22,6,4,69,33,36,72
FC Basel,5704,2,16,10,6,51,26,25,58
Lucerne,5704,3,13,7,12,39,42,-3,46
St Gallen,5704,4,13,4,15,39,53,-14,43
FC Zürich,5704,5,10,11,11,42,38,4,41
Grasshoppers,5704,6,10,6,16,40,47,-7,36
FC Thun,5704,7,10,6,16,44,58,-14,36
FC Sion,5704,8,9,7,16,43,50,-7,34
FC Lugano,5704,9,9,7,16,28,48,-20,34
Young Boys,5705,1,21,7,4,75,39,36,70
FC Basel,5705,2,20,7,5,61,23,38,67
Lucerne,5705,3,12,9,11,42,48,-6,45
FC Zürich,5705,4,11,10,11,45,39,6,43
St Gallen,5705,5,13,4,15,42,60,-18,43
Grasshoppers,5705,6,10,7,15,41,46,-5,37
FC Lugano,5705,7,10,6,16,37,54,-17,36
FC Thun,5705,8,10,5,17,44,59,-15,35
FC Sion,5705,9,5,9,18,40,59,-19,24
Young Boys,5706,1,23,6,3,75,33,42,75
FC Basel,5706,2,17,8,7,50,27,23,59
Lucerne,5706,3,13,9,10,41,42,-1,48
St Gallen,5706,4,15,2,15,44,54,-10,47
FC Zürich,5706,5,11,10,11,40,35,5,43
Grasshoppers,5706,6,10,6,16,44,49,-5,36
FC Lugano,5706,7,10,6,16,31,51,-20,36
FC Thun,5706,8,9,5,18,43,63,-20,32
FC Sion,5706,9,6,8,18,40,54,-14,26
Young Boys,5707,1,22,7,3,76,40,36,73
FC Basel,5707,2,17,9,6,55,26,29,60
St Gallen,5707,3,17,2,13,49,51,-2,53
Lucerne,5707,4,12,8,12,45,52,-7,44
FC Zürich,5707,5,10,10,12,41,37,4,40
Grasshoppers,5707,6,10,7,15,45,50,-5,37
FC Thun,5707,7,10,6,16,42,57,-15,36
FC Lugano,5707,8,10,5,17,31,49,-18,35
FC Sion,5707,9,5,8,19,39,61,-22,23
Young Boys,5708,1,21,6,5,70,38,32,69
FC Basel,5708,2,19,8,5,56,24,32,65
St Gallen,5708,3,15,2,15,43,55,-12,47
Lucerne,5708,4,13,7,12,41,45,-4,46
FC Zürich,5708,5,10,10,12,42,40,2,40
FC Sion,5708,6,9,8,15,48,51,-3,35
FC Lugano,5708,7,10,5,17,29,48,-19,35
Grasshoppers,5708,8,9,7,16,40,49,-9,34
FC Thun,5708,9,8,7,17,39,58,-19,31
Young Boys,5709,1,21,6,5,72,42,30,69
FC Basel,5709,2,19,7,6,53,26,27,64
Lucerne,5709,3,13,9,10,43,41,2,48
St Gallen,5709,4,14,3,15,43,54,-11,45
FC Zürich,5709,5,10,10,12,39,38,1,40
FC Lugano,5709,6,10,6,16,29,45,-16,36
Grasshoppers,5709,7,9,7,16,45,55,-10,34
FC Thun,5709,8,9,6,17,43,60,-17,33
FC Sion,5709,9,8,8,16,46,52,-6,32
Young Boys,5710,1,21,8,3,71,35,36,71
FC Basel,5710,2,15,12,5,50,25,25,57
St Gallen,5710,3,15,4,13,44,53,-9,49
Lucerne,5710,4,13,9,10,43,43,0,48
FC Zürich,5710,5,10,10,12,41,40,1,40
FC Thun,5710,6,11,6,15,50,60,-10,39
Grasshoppers,5710,7,9,6,17,41,52,-11,33
FC Lugano,5710,8,9,6,17,30,49,-19,33
FC Sion,5710,9,7,7,18,43,56,-13,28
Young Boys,5711,1,21,7,4,72,33,39,70
FC Basel,5711,2,20,7,5,58,21,37,67
Lucerne,5711,3,14,8,10,44,42,2,50
St Gallen,5711,4,14,3,15,44,59,-15,45
FC Zürich,5711,5,11,10,11,43,38,5,43
Grasshoppers,5711,6,10,6,16,43,54,-11,36
FC Lugano,5711,7,9,6,17,28,51,-23,33
FC Thun,5711,8,8,7,17,43,62,-19,31
FC Sion,5711,9,5,10,17,40,55,-15,25
Young Boys,5712,1,23,6,3,76,35,41,75
FC Basel,5712,2,17,7,8,54,28,26,58
St Gallen,5712,3,16,2,14,44,56,-12,50
FC Zürich,5712,4,11,9,12,45,38,7,42
Lucerne,5712,5,11,8,13,41,51,-10,41
FC Thun,5712,6,10,6,16,46,60,-14,36
Grasshoppers,5712,7,9,8,15,44,52,-8,35
FC Lugano,5712,8,10,5,17,32,51,-19,35
FC Sion,5712,9,7,9,16,46,57,-11,30
Young Boys,5713,1,22,7,3,73,31,42,73
FC Basel,5713,2,19,8,5,52,21,31,65
St Gallen,5713,3,15,3,14,42,53,-11,48
Lucerne,5713,4,13,7,12,43,49,-6,46
FC Zürich,5713,5,12,9,11,43,36,7,45
FC Lugano,5713,6,10,5,17,31,50,-19,35
Grasshoppers,5713,7,8,9,15,39,49,-10,33
FC Thun,5713,8,9,6,17,44,60,-16,33
FC Sion,5713,9,5,8,19,40,58,-18,23
Young Boys,5714,1,22,6,4,73,37,36,72
FC Basel,5714,2,18,8,6,56,26,30,62
St Gallen,5714,3,15,3,14,46,59,-13,48
FC Zürich,5714,4,12,10,10,41,34,7,46
Lucerne,5714,5,11,9,12,42,48,-6,42
FC Lugano,5714,6,10,7,15,34,49,-15,37
FC Thun,5714,7,10,5,17,44,58,-14,35
Grasshoppers,5714,8,9,7,16,39,48,-9,34
FC Sion,5714,9,6,7,19,41,57,-16,25
Young Boys,5715,1,20,7,5,72,36,36,67
FC Basel,5715,2,18,8,6,60,27,33,62
Lucerne,5715,3,12,9,11,45,45,0,45
St Gallen,5715,4,13,4,15,44,60,-16,43
FC Zürich,5715,5,11,9,12,46,42,4,42
FC Lugano,5715,6,12,5,15,36,50,-14,41
Grasshoppers,5715,7,10,8,14,42,48,-6,38
FC Thun,5715,8,9,6,17,44,65,-21,33
FC Sion,5715,9,6,10,16,43,59,-16,28
Young Boys,5716,1,21,6,5,71,35,36,69
FC Basel,5716,2,18,8,6,53,24,29,62
Lucerne,5716,3,15,7,10,45,40,5,52
St Gallen,5716,4,15,3,14,44,51,-7,48
FC Zürich,5716,5,9,12,11,41,39,2,39
FC Thun,5716,6,11,5,16,48,62,-14,38
FC Lugano,5716,7,9,7,16,32,50,-18,34
Grasshoppers,5716,8,8,7,17,39,55,-16,31
FC Sion,5716,9,6,9,17,44,61,-17,27
Young Boys,5717,1,20,9,3,70,37,33,69
FC Basel,5717,2,18,7,7,52,25,27,61
St Gallen,5717,3,14,3,15,44,55,-11,45
FC Zürich,5717,4,11,10,11,40,35,5,43
Lucerne,5717,5,11,9,12,41,46,-5,42
FC Lugano,5717,6,11,6,15,31,47,-16,39
Grasshoppers,5717,7,9,9,14,41,48,-7,36
FC Thun,5717,8,9,7,16,41,56,-15,34
FC Sion,5717,9,7,8,17,42,53,-11,29
Young Boys,5718,1,23,6,3,75,35,40,75
FC Basel,5718,2,16,10,6,50,25,25,58
St Gallen,5718,3,16,3,13,46,53,-7,51
Lucerne,5718,4,12,9,11,42,44,-2,45
FC Zürich,5718,5,10,11,11,39,37,2,41
FC Thun,5718,6,11,6,15,47,56,-9,39
FC Lugano,5718,7,9,8,15,31,50,-19,35
Grasshoppers,5718,8,8,7,17,41,54,-13,31
FC Sion,5718,9,5,8,19,38,55,-17,23
Young Boys,5719,1,19,8,5,66,37,29,65
FC Basel,5719,2,17,10,5,51,22,29,61
Lucerne,5719,3,13,9,10,40,43,-3,48
St Gallen,5719,4,14,3,15,44,56,-12,45
FC Zürich,5719,5,10,10,12,39,36,3,40
Grasshoppers,5719,6,9,9,14,42,49,-7,36
FC Lugano,5719,7,10,6,16,32,46,-14,36
FC Thun,5719,8,9,7,16,45,60,-15,34
FC Sion,5719,9,7,10,15,45,55,-10,31
Young Boys,5720,1,23,7,2,74,33,41,76
FC Basel,5720,2,16,11,5,52,26,26,59
Lucerne,5720,3,13,8,11,45,45,0,47
St Gallen,5720,4,14,4,14,44,57,-13,46
FC Zürich,5720,5,10,10,12,40,36,4,40
FC Thun,5720,6,9,8,15,44,57,-13,35
FC Lugano,5720,7,10,5,17,29,51,-22,35
Grasshoppers,5720,8,8,8,16,40,50,-10,32
FC Sion,5720,9,6,9,17,41,54,-13,27
Young Boys,5721,1,23,6,3,73,31,42,75
FC Basel,5721,2,19,7,6,55,25,30,64
Lucerne,5721,3,14,7,11,42,40,2,49
St Gallen,5721,4,15,2,15,43,57,-14,47
FC Zürich,5721,5,10,9,13,39,39,0,39
FC Thun,5721,6,11,5,16,47,58,-11,38
FC Lugano,5721,7,10,5,17,30,47,-17,35
Grasshoppers,5721,8,9,6,17,38,53,-15,33
FC Sion,5721,9,6,7,19,40,57,-17,25
Young Boys,5722,1,21,7,4,71,35,36,70
FC Basel,5722,2,17,9,6,52,25,27,60
Lucerne,5722,3,12,9,11,40,43,-3,45
FC Zrich,5722,4,11,11,10,40,34,6,44
St Gallen,5722,5,13,5,14,39,52,-13,44
FC Lugano,5722,6,11,6,15,32,46,-14,39
Grasshoppers,5722,7,9,9,14,40,46,-6,36
FC Thun,5722,8,9,6,17,39,56,-17,33
FC Sion,5722,9,5,10,17,35,51,-16,25
Young Boys,5723,1,22,7,3,75,35,40,73
FC Basel,5723,2,17,8,7,55,28,27,59
Lucerne,5723,3,15,7,10,47,46,1,52
FC Zürich,5723,4,12,9,11,47,37,10,45
St Gallen,5723,5,13,4,15,40,54,-14,43
FC Lugano,5723,6,11,5,16,36,48,-12,38
Grasshoppers,5723,7,9,7,16,43,55,-12,34
FC Thun,5723,8,9,6,17,44,62,-18,33
FC Sion,5723,9,5,9,18,38,60,-22,24
Young Boys,5724,1,22,8,2,76,36,40,74
FC Basel,5724,2,17,8,7,54,28,26,59
St Gallen,5724,3,16,2,14,42,52,-10,50
Lucerne,5724,4,13,7,12,42,44,-2,46
FC Lugano,5724,5,11,6,15,33,47,-14,39
FC Thun,5724,6,11,5,16,46,56,-10,38
FC Zürich,5724,7,9,10,13,37,40,-3,37
Grasshoppers,5724,8,9,6,17,40,52,-12,33
FC Sion,5724,9,6,8,18,40,55,-15,26
Young Boys,5725,1,21,8,3,72,34,38,71
FC Basel,5725,2,19,7,6,57,26,31,64
St Gallen,5725,3,15,2,15,47,54,-7,47
FC Zürich,5725,4,12,10,10,46,35,11,46
Lucerne,5725,5,11,9,12,39,45,-6,42
FC Lugano,5725,6,11,5,16,32,50,-18,38
Grasshoppers,5725,7,8,8,16,41,53,-12,32
FC Thun,5725,8,8,8,16,43,64,-21,32
FC Sion,5725,9,6,9,17,40,56,-16,27
Young Boys,5726,1,19,8,5,67,38,29,65
FC Basel,5726,2,18,8,6,56,26,30,62
Lucerne,5726,3,14,8,10,44,42,2,50
FC Zürich,5726,4,13,9,10,46,36,10,48
St Gallen,5726,5,14,5,13,44,53,-9,47
Grasshoppers,5726,6,9,8,15,41,49,-8,35
FC Lugano,5726,7,10,5,17,33,50,-17,35
FC Thun,5726,8,8,6,18,45,67,-22,30
FC Sion,5726,9,5,11,16,39,54,-15,26
Young Boys,5727,1,20,9,3,70,35,35,69
FC Basel,5727,2,18,7,7,55,26,29,61
Lucerne,5727,3,13,8,11,44,43,1,47
St Gallen,5727,4,15,2,15,42,56,-14,47
FC Zürich,5727,5,10,9,13,38,37,1,39
FC Lugano,5727,6,11,5,16,32,49,-17,38
Grasshoppers,5727,7,10,7,15,42,46,-4,37
FC Thun,5727,8,9,6,17,41,62,-21,33
FC Sion,5727,9,7,9,16,40,50,-10,30
Young Boys,5728,1,21,8,3,73,34,39,71
FC Basel,5728,2,17,10,5,55,24,31,61
St Gallen,5728,3,14,5,13,42,52,-10,47
Lucerne,5728,4,12,9,11,40,46,-6,45
FC Zürich,5728,5,10,10,12,43,40,3,40
FC Thun,5728,6,11,5,16,47,63,-16,38
Grasshoppers,5728,7,10,6,16,42,53,-11,36
FC Lugano,5728,8,9,6,17,31,49,-18,33
FC Sion,5728,9,6,9,17,45,57,-12,27
Young Boys,5729,1,21,8,3,72,35,37,71
FC Basel,5729,2,16,10,6,54,28,26,58
St Gallen,5729,3,16,3,13,49,54,-5,51
Lucerne,5729,4,13,9,10,41,41,0,48
FC Zürich,5729,5,12,9,11,47,38,9,45
Grasshoppers,5729,6,10,7,15,45,52,-7,37
FC Lugano,5729,7,9,6,17,32,54,-22,33
FC Thun,5729,8,8,7,17,45,64,-19,31
FC Sion,5729,9,6,7,19,42,61,-19,25
Young Boys,5730,1,20,7,5,68,36,32,67
FC Basel,5730,2,17,7,8,54,27,27,58
Lucerne,5730,3,14,8,10,42,41,1,50
St Gallen,5730,4,15,3,14,45,57,-12,48
FC Zürich,5730,5,11,9,12,38,35,3,42
FC Thun,5730,6,11,5,16,43,54,-11,38
FC Lugano,5730,7,10,6,16,33,50,-17,36
Grasshoppers,5730,8,9,7,16,40,50,-10,34
FC Sion,5730,9,6,10,16,36,49,-13,28
Young Boys,5731,1,21,9,2,70,33,37,72
FC Basel,5731,2,18,9,5,55,22,33,63
St Gallen,5731,3,15,3,14,43,54,-11,48
Lucerne,5731,4,13,7,12,41,44,-3,46
FC Zürich,5731,5,11,9,12,40,39,1,42
Grasshoppers,5731,6,9,8,15,41,47,-6,35
FC Lugano,5731,7,10,5,17,31,50,-19,35
FC Sion,5731,8,7,9,16,41,51,-10,30
FC Thun,5731,9,8,5,19,40,62,-22,29
Young Boys,5732,1,20,8,4,71,40,31,68
FC Basel,5732,2,19,7,6,56,25,31,64
Lucerne,5732,3,13,8,11,43,40,3,47
FC Zürich,5732,4,12,9,11,42,34,8,45
St Gallen,5732,5,14,2,16,41,58,-17,44
FC Lugano,5732,6,11,6,15,34,49,-15,39
Grasshoppers,5732,7,10,6,16,41,49,-8,36
FC Thun,5732,8,9,5,18,41,59,-18,32
FC Sion,5732,9,7,7,18,41,56,-15,28
Young Boys,5733,1,23,7,2,75,35,40,76
FC Basel,5733,2,18,7,7,53,26,27,61
Lucerne,5733,3,13,8,11,46,47,-1,47
St Gallen,5733,4,15,2,15,44,56,-12,47
FC Zürich,5733,5,10,10,12,42,39,3,40
FC Thun,5733,6,11,5,16,44,56,-12,38
FC Lugano,5733,7,10,6,16,33,49,-16,36
Grasshoppers,5733,8,8,6,18,39,55,-16,30
FC Sion,5733,9,7,7,18,44,57,-13,28
Young Boys,5734,1,21,7,4,71,39,32,70
FC Basel,5734,2,18,8,6,56,25,31,62
St Gallen,5734,3,14,3,15,40,53,-13,45
FC Zürich,5734,4,11,10,11,43,40,3,43
Lucerne,5734,5,11,10,11,40,43,-3,43
Grasshoppers,5734,6,10,7,15,43,49,-6,37
FC Lugano,5734,7,10,6,16,36,53,-17,36
FC Thun,5734,8,9,7,16,43,59,-16,34
FC Sion,5734,9,6,10,16,43,54,-11,28
Young Boys,5735,1,22,7,3,72,34,38,73
FC Basel,5735,2,17,8,7,54,28,26,59
St Gallen,5735,3,15,3,14,45,55,-10,48
Lucerne,5735,4,12,11,9,40,40,0,47
FC Zürich,5735,5,12,9,11,42,36,6,45
Grasshoppers,5735,6,9,8,15,43,49,-6,35
FC Lugano,5735,7,9,7,16,32,53,-21,34
FC Thun,5735,8,8,7,17,42,60,-18,31
FC Sion,5735,9,6,8,18,40,55,-15,26
Young Boys,5736,1,23,6,3,75,35,40,75
FC Basel,5736,2,17,8,7,55,33,22,59
Lucerne,5736,3,13,8,11,41,42,-1,47
St Gallen,5736,4,13,4,15,42,55,-13,43
FC Zürich,5736,5,11,9,12,43,38,5,42
FC Thun,5736,6,12,5,15,50,57,-7,41
FC Lugano,5736,7,10,5,17,32,51,-19,35
Grasshoppers,5736,8,9,7,16,41,53,-12,34
FC Sion,5736,9,6,8,18,40,55,-15,26
Young Boys,5737,1,20,9,3,69,34,35,69
FC Basel,5737,2,18,8,6,55,25,30,62
Lucerne,5737,3,14,7,11,44,46,-2,49
St Gallen,5737,4,15,3,14,42,51,-9,48
FC Zürich,5737,5,11,9,12,44,38,6,42
Grasshoppers,5737,6,11,6,15,44,48,-4,39
FC Lugano,5737,7,9,6,17,30,49,-19,33
FC Sion,5737,8,7,9,16,39,52,-13,30
FC Thun,5737,9,8,5,19,40,64,-24,29
Young Boys,5738,1,21,7,4,66,38,28,70
FC Basel,5738,2,18,9,5,57,26,31,63
Lucerne,5738,3,13,7,12,42,42,0,46
St Gallen,5738,4,13,4,15,43,59,-16,43
Grasshoppers,5738,5,12,6,14,47,45,2,42
FC Zürich,5738,6,10,10,12,40,37,3,40
FC Thun,5738,7,9,7,16,42,57,-15,34
FC Lugano,5738,8,9,6,17,27,45,-18,33
FC Sion,5738,9,6,10,16,42,57,-15,28
Young Boys,5739,1,22,8,2,76,36,40,74
FC Basel,5739,2,18,7,7,51,25,26,61
St Gallen,5739,3,16,2,14,43,51,-8,50
Lucerne,5739,4,13,8,11,48,44,4,47
FC Zürich,5739,5,12,9,11,43,36,7,45
FC Thun,5739,6,11,5,16,44,55,-11,38
Grasshoppers,5739,7,9,6,17,41,54,-13,33
FC Lugano,5739,8,9,5,18,29,56,-27,32
FC Sion,5739,9,5,8,19,41,59,-18,23
Young Boys,5740,1,20,9,3,74,41,33,69
FC Basel,5740,2,18,8,6,57,28,29,62
Lucerne,5740,3,13,10,9,45,44,1,49
St Gallen,5740,4,14,2,16,45,57,-12,44
FC Zürich,5740,5,9,10,13,37,38,-1,37
FC Lugano,5740,6,10,7,15,31,45,-14,37
FC Thun,5740,7,10,5,17,45,60,-15,35
Grasshoppers,5740,8,9,7,16,41,51,-10,34
FC Sion,5740,9,8,8,16,43,54,-11,32
Young Boys,5741,1,22,7,3,73,35,38,73
FC Basel,5741,2,19,7,6,55,24,31,64
Lucerne,5741,3,15,7,10,42,40,2,52
St Gallen,5741,4,14,2,16,41,54,-13,44
FC Zürich,5741,5,10,10,12,39,37,2,40
Grasshoppers,5741,6,8,9,15,41,50,-9,33
FC Sion,5741,7,8,8,16,40,53,-13,32
FC Lugano,5741,8,9,5,18,29,50,-21,32
FC Thun,5741,9,8,7,17,41,58,-17,31
Young Boys,5742,1,22,7,3,70,32,38,73
FC Basel,5742,2,20,7,5,56,22,34,67
St Gallen,5742,3,14,2,16,41,57,-16,44
FC Zürich,5742,4,11,9,12,43,36,7,42
Lucerne,5742,5,11,9,12,40,45,-5,42
FC Lugano,5742,6,11,6,15,30,46,-16,39
FC Thun,5742,7,10,5,17,46,62,-16,35
Grasshoppers,5742,8,9,7,16,44,54,-10,34
FC Sion,5742,9,6,8,18,40,56,-16,26
Young Boys,5743,1,22,6,4,70,37,33,72
FC Basel,5743,2,19,8,5,58,23,35,65
St Gallen,5743,3,14,4,14,41,54,-13,46
Lucerne,5743,4,12,9,11,41,46,-5,45
FC Zürich,5743,5,11,9,12,39,35,4,42
Grasshoppers,5743,6,9,8,15,40,47,-7,35
FC Thun,5743,7,9,6,17,44,61,-17,33
FC Lugano,5743,8,9,6,17,32,50,-18,33
FC Sion,5743,9,7,8,17,42,54,-12,29
Young Boys,5744,1,22,7,3,75,34,41,73
FC Basel,5744,2,17,10,5,50,23,27,61
St Gallen,5744,3,16,2,14,44,50,-6,50
Lucerne,5744,4,12,8,12,39,44,-5,44
FC Zürich,5744,5,10,10,12,40,40,0,40
Grasshoppers,5744,6,10,6,16,41,48,-7,36
FC Lugano,5744,7,10,5,17,31,49,-18,35
FC Thun,5744,8,9,6,17,43,58,-15,33
FC Sion,5744,9,7,8,17,39,56,-17,29
Young Boys,5745,1,22,6,4,74,42,32,72
FC Basel,5745,2,18,8,6,57,28,29,62
FC Zürich,5745,3,11,10,11,41,35,6,43
St Gallen,5745,4,13,3,16,42,58,-16,42
Lucerne,5745,5,11,8,13,40,47,-7,41
FC Lugano,5745,6,11,5,16,33,48,-15,38
Grasshoppers,5745,7,10,7,15,43,47,-4,37
FC Thun,5745,8,10,6,16,45,58,-13,36
FC Sion,5745,9,7,9,16,43,55,-12,30
Young Boys,5746,1,20,7,5,68,38,30,67
FC Basel,5746,2,19,8,5,61,22,39,65
Lucerne,5746,3,12,10,10,40,43,-3,46
St Gallen,5746,4,13,4,15,42,59,-17,43
FC Lugano,5746,5,11,7,14,31,44,-13,40
FC Zürich,5746,6,10,9,13,38,35,3,39
Grasshoppers,5746,7,10,7,15,42,47,-5,37
FC Thun,5746,8,10,5,17,41,63,-22,35
FC Sion,5746,9,7,7,18,44,56,-12,28
Young Boys,5747,1,20,8,4,73,40,33,68
FC Basel,5747,2,17,10,5,55,26,29,61
St Gallen,5747,3,15,4,13,45,50,-5,49
Lucerne,5747,4,12,10,10,43,45,-2,46
FC Zürich,5747,5,9,12,11,39,36,3,39
FC Lugano,5747,6,10,6,16,30,49,-19,36
FC Thun,5747,7,10,5,17,46,60,-14,35
Grasshoppers,5747,8,8,9,15,39,49,-10,33
FC Sion,5747,9,6,10,16,39,54,-15,28
Young Boys,5748,1,22,7,3,74,38,36,73
FC Basel,5748,2,19,7,6,58,25,33,64
Lucerne,5748,3,13,8,11,44,46,-2,47
St Gallen,5748,4,15,2,15,44,56,-12,47
FC Lugano,5748,5,11,5,16,33,48,-15,38
FC Zürich,5748,6,9,10,13,39,39,0,37
FC Thun,5748,7,9,6,17,43,58,-15,33
Grasshoppers,5748,8,8,8,16,38,50,-12,32
FC Sion,5748,9,7,9,16,41,54,-13,30
Young Boys,5749,1,23,6,3,75,32,43,75
FC Basel,5749,2,18,7,7,58,29,29,61
Lucerne,5749,3,13,8,11,43,43,0,47
FC Zürich,5749,4,12,10,10,48,36,12,46
St Gallen,5749,5,14,3,15,43,56,-13,45
FC Lugano,5749,6,10,5,17,29,50,-21,35
FC Thun,5749,7,9,7,16,42,60,-18,34
Grasshoppers,5749,8,8,7,17,37,52,-15,31
FC Sion,5749,9,7,7,18,38,55,-17,28
Young Boys,5750,1,21,7,4,76,38,38,70
FC Basel,5750,2,19,8,5,56,25,31,65
Lucerne,5750,3,12,9,11,42,46,-4,45
St Gallen,5750,4,14,3,15,42,55,-13,45
FC Zürich,5750,5,11,10,11,42,34,8,43
FC Lugano,5750,6,11,6,15,32,48,-16,39
Grasshoppers,5750,7,10,7,15,45,52,-7,37
FC Thun,5750,8,8,7,17,41,58,-17,31
FC Sion,5750,9,6,7,19,39,59,-20,25
Young Boys,5751,1,22,6,4,72,34,38,72
FC Basel,5751,2,18,7,7,55,25,30,61
Lucerne,5751,3,13,8,11,42,45,-3,47
St Gallen,5751,4,14,2,16,42,57,-15,44
FC Zürich,5751,5,10,11,11,40,36,4,41
FC Lugano,5751,6,11,7,14,33,46,-13,40
Grasshoppers,5751,7,10,7,15,42,50,-8,37
FC Thun,5751,8,8,6,18,42,63,-21,30
FC Sion,5751,9,7,8,17,43,55,-12,29
Young Boys,5752,1,22,7,3,75,34,41,73
FC Basel,5752,2,18,7,7,58,27,31,61
Lucerne,5752,3,14,7,11,46,47,-1,49
St Gallen,5752,4,15,3,14,44,54,-10,48
FC Zürich,5752,5,11,10,11,41,35,6,43
FC Lugano,5752,6,10,6,16,30,49,-19,36
FC Thun,5752,7,10,5,17,43,61,-18,35
Grasshoppers,5752,8,9,6,17,41,55,-14,33
FC Sion,5752,9,5,9,18,40,56,-16,24
Young Boys,5753,1,23,7,2,77,36,41,76
FC Basel,5753,2,19,7,6,55,27,28,64
St Gallen,5753,3,16,2,14,50,53,-3,50
Lucerne,5753,4,13,8,11,45,47,-2,47
FC Zürich,5753,5,10,11,11,43,38,5,41
Grasshoppers,5753,6,10,6,16,43,50,-7,36
FC Lugano,5753,7,9,6,17,33,55,-22,33
FC Thun,5753,8,9,5,18,42,62,-20,32
FC Sion,5753,9,5,8,19,38,58,-20,23
Young Boys,5754,1,21,7,4,70,36,34,70
FC Basel,5754,2,18,7,7,53,27,26,61
St Gallen,5754,3,15,2,15,42,55,-13,47
FC Zürich,5754,4,11,11,10,43,35,8,44
Lucerne,5754,5,12,7,13,40,43,-3,43
Grasshoppers,5754,6,10,7,15,41,50,-9,37
FC Thun,5754,7,9,7,16,44,59,-15,34
FC Lugano,5754,8,9,7,16,30,48,-18,34
FC Sion,5754,9,7,9,16,45,55,-10,30
Young Boys,5755,1,23,6,3,73,32,41,75
FC Basel,5755,2,16,7,9,52,32,20,55
Lucerne,5755,3,13,8,11,41,45,-4,47
St Gallen,5755,4,14,5,13,43,53,-10,47
FC Zürich,5755,5,12,9,11,44,38,6,45
Grasshoppers,5755,6,12,6,14,44,46,-2,42
FC Thun,5755,7,10,5,17,46,59,-13,35
FC Lugano,5755,8,9,6,17,30,49,-19,33
FC Sion,5755,9,5,8,19,37,56,-19,23
Young Boys,5756,1,21,7,4,73,35,38,70
FC Basel,5756,2,16,9,7,55,29,26,57
St Gallen,5756,3,16,3,13,47,55,-8,51
FC Zürich,5756,4,12,9,11,46,35,11,45
Lucerne,5756,5,11,8,13,40,49,-9,41
Grasshoppers,5756,6,11,7,14,43,47,-4,40
FC Lugano,5756,7,11,5,16,34,52,-18,38
FC Thun,5756,8,9,5,18,42,64,-22,32
FC Sion,5756,9,7,7,18,42,56,-14,28
Young Boys,5757,1,21,8,3,71,33,38,71
FC Basel,5757,2,17,8,7,55,31,24,59
St Gallen,5757,3,14,4,14,45,54,-9,46
FC Zürich,5757,4,12,9,11,41,34,7,45
Lucerne,5757,5,11,10,11,40,44,-4,43
Grasshoppers,5757,6,10,7,15,40,48,-8,37
FC Thun,5757,7,10,7,15,45,57,-12,37
FC Lugano,5757,8,9,6,17,27,49,-22,33
FC Sion,5757,9,6,9,17,40,54,-14,27
Young Boys,5758,1,21,8,3,70,34,36,71
FC Basel,5758,2,17,8,7,52,27,25,59
St Gallen,5758,3,16,2,14,49,55,-6,50
Lucerne,5758,4,14,7,11,40,44,-4,49
FC Zürich,5758,5,10,9,13,40,43,-3,39
FC Lugano,5758,6,11,5,16,36,47,-11,38
FC Thun,5758,7,10,6,16,48,57,-9,36
Grasshoppers,5758,8,9,8,15,41,48,-7,35
FC Sion,5758,9,6,7,19,38,59,-21,25
Young Boys,5759,1,23,6,3,72,31,41,75
FC Basel,5759,2,16,8,8,49,27,22,56
St Gallen,5759,3,15,3,14,43,53,-10,48
Lucerne,5759,4,12,9,11,39,41,-2,45
FC Zürich,5759,5,11,10,11,40,34,6,43
FC Lugano,5759,6,12,5,15,32,49,-17,41
FC Thun,5759,7,9,6,17,42,58,-16,33
Grasshoppers,5759,8,8,8,16,40,50,-10,32
FC Sion,5759,9,6,9,17,40,54,-14,27
Young Boys,5760,1,21,8,3,73,33,40,71
FC Basel,5760,2,19,8,5,55,23,32,65
Lucerne,5760,3,13,10,9,45,40,5,49
St Gallen,5760,4,14,2,16,42,61,-19,44
FC Zürich,5760,5,10,9,13,40,39,1,39
FC Thun,5760,6,11,5,16,45,57,-12,38
Grasshoppers,5760,7,9,7,16,41,50,-9,34
FC Lugano,5760,8,9,5,18,30,55,-25,32
FC Sion,5760,9,7,8,17,40,53,-13,29
Young Boys,5761,1,21,7,4,68,36,32,70
FC Basel,5761,2,18,9,5,52,24,28,63
St Gallen,5761,3,16,2,14,43,52,-9,50
FC Zürich,5761,4,10,11,11,40,35,5,41
Lucerne,5761,5,11,8,13,41,48,-7,41
FC Thun,5761,6,10,7,15,45,57,-12,37
FC Lugano,5761,7,10,7,15,31,45,-14,37
Grasshoppers,5761,8,9,7,16,40,47,-7,34
FC Sion,5761,9,6,8,18,40,56,-16,26
Young Boys,5762,1,22,6,4,74,38,36,72
FC Basel,5762,2,16,8,8,51,27,24,56
St Gallen,5762,3,17,2,13,48,51,-3,53
FC Zürich,5762,4,12,9,11,46,35,11,45
Lucerne,5762,5,12,8,12,41,47,-6,44
Grasshoppers,5762,6,10,7,15,40,47,-7,37
FC Thun,5762,7,10,6,16,44,58,-14,36
FC Lugano,5762,8,10,5,17,28,50,-22,35
FC Sion,5762,9,6,7,19,40,59,-19,25
Young Boys,5763,1,20,8,4,71,37,34,68
FC Basel,5763,2,17,8,7,51,27,24,59
St Gallen,5763,3,14,5,13,42,52,-10,47
Lucerne,5763,4,12,10,10,42,41,1,46
FC Zürich,5763,5,11,9,12,40,37,3,42
FC Lugano,5763,6,11,7,14,34,45,-11,40
FC Thun,5763,7,11,5,16,46,56,-10,38
Grasshoppers,5763,8,9,6,17,40,53,-13,33
FC Sion,5763,9,6,8,18,38,56,-18,26
Young Boys,5764,1,22,6,4,72,35,37,72
FC Basel,5764,2,16,8,8,53,31,22,56
FC Zürich,5764,3,13,9,10,45,34,11,48
Lucerne,5764,4,13,9,10,45,42,3,48
St Gallen,5764,5,14,4,14,43,53,-10,46
Grasshoppers,5764,6,10,7,15,44,53,-9,37
FC Lugano,5764,7,9,6,17,27,50,-23,33
FC Thun,5764,8,8,7,17,41,58,-17,31
FC Sion,5764,9,7,8,17,39,53,-14,29
Young Boys,5765,1,21,7,4,73,35,38,70
FC Basel,5765,2,20,7,5,62,25,37,67
St Gallen,5765,3,14,4,14,41,54,-13,46
Lucerne,5765,4,12,8,12,47,50,-3,44
FC Zürich,5765,5,9,11,12,41,41,0,38
FC Lugano,5765,6,10,6,16,33,49,-16,36
FC Sion,5765,7,9,8,15,44,51,-7,35
FC Thun,5765,8,9,6,17,44,62,-18,33
Grasshoppers,5765,9,8,7,17,37,55,-18,31
Young Boys,5766,1,21,6,5,74,42,32,69
FC Basel,5766,2,16,8,8,51,28,23,56
Lucerne,5766,3,15,8,9,42,38,4,53
FC Zürich,5766,4,11,10,11,40,35,5,43
St Gallen,5766,5,13,3,16,41,56,-15,42
FC Lugano,5766,6,11,6,15,34,47,-13,39
Grasshoppers,5766,7,10,6,16,41,50,-9,36
FC Thun,5766,8,9,7,16,43,58,-15,34
FC Sion,5766,9,7,8,17,43,55,-12,29
Young Boys,5767,1,22,7,3,78,37,41,73
FC Basel,5767,2,18,9,5,57,23,34,63
St Gallen,5767,3,14,3,15,46,60,-14,45
Lucerne,5767,4,12,8,12,41,50,-9,44
FC Zürich,5767,5,10,11,11,39,36,3,41
FC Lugano,5767,6,11,5,16,33,50,-17,38
Grasshoppers,5767,7,9,7,16,43,51,-8,34
FC Thun,5767,8,9,6,17,43,60,-17,33
FC Sion,5767,9,7,8,17,47,60,-13,29
Young Boys,5768,1,20,10,2,66,31,35,70
FC Basel,5768,2,15,9,8,50,31,19,54
Lucerne,5768,3,14,8,10,45,42,3,50
St Gallen,5768,4,15,2,15,46,56,-10,47
FC Zürich,5768,5,9,11,12,38,37,1,38
FC Thun,5768,6,11,5,16,47,58,-11,38
FC Lugano,5768,7,11,5,16,33,51,-18,38
Grasshoppers,5768,8,8,8,16,39,50,-11,32
FC Sion,5768,9,7,10,15,44,52,-8,31
Young Boys,5769,1,22,7,3,73,34,39,73
FC Basel,5769,2,17,9,6,57,30,27,60
Lucerne,5769,3,13,8,11,42,42,0,47
FC Zürich,5769,4,12,10,10,40,33,7,46
St Gallen,5769,5,14,3,15,45,61,-16,45
FC Lugano,5769,6,10,7,15,34,45,-11,37
FC Thun,5769,7,10,5,17,43,59,-16,35
Grasshoppers,5769,8,9,7,16,40,52,-12,34
FC Sion,5769,9,5,8,19,37,55,-18,23
Young Boys,5770,1,21,6,5,68,40,28,69
FC Basel,5770,2,18,7,7,54,25,29,61
Lucerne,5770,3,14,7,11,42,42,0,49
St Gallen,5770,4,15,3,14,43,52,-9,48
FC Zürich,5770,5,12,9,11,44,38,6,45
Grasshoppers,5770,6,11,6,15,41,46,-5,39
FC Lugano,5770,7,9,6,17,30,48,-18,33
FC Thun,5770,8,9,5,18,43,61,-18,32
FC Sion,5770,9,7,7,18,41,54,-13,28
Young Boys,5771,1,22,6,4,75,36,39,72
FC Basel,5771,2,20,7,5,59,25,34,67
St Gallen,5771,3,16,2,14,44,52,-8,50
FC Zürich,5771,4,11,10,11,39,36,3,43
Lucerne,5771,5,12,7,13,41,47,-6,43
Grasshoppers,5771,6,11,7,14,47,50,-3,40
FC Lugano,5771,7,9,5,18,27,48,-21,32
FC Thun,5771,8,8,7,17,45,65,-20,31
FC Sion,5771,9,5,9,18,42,60,-18,24
Young Boys,5772,1,20,10,2,72,36,36,70
FC Basel,5772,2,16,8,8,51,28,23,56
Lucerne,5772,3,15,7,10,49,43,6,52
St Gallen,5772,4,16,2,14,43,54,-11,50
FC Zürich,5772,5,13,9,10,45,35,10,48
Grasshoppers,5772,6,9,8,15,47,55,-8,35
FC Lugano,5772,7,9,6,17,30,50,-20,33
FC Thun,5772,8,9,5,18,44,62,-18,32
FC Sion,5772,9,5,9,18,41,59,-18,24
Young Boys,5773,1,22,7,3,72,33,39,73
FC Basel,5773,2,20,7,5,58,25,33,67
St Gallen,5773,3,14,3,15,43,55,-12,45
Lucerne,5773,4,12,7,13,40,47,-7,43
FC Zürich,5773,5,10,9,13,39,40,-1,39
FC Thun,5773,6,11,5,16,50,56,-6,38
Grasshoppers,5773,7,9,7,16,39,51,-12,34
FC Lugano,5773,8,9,6,17,30,50,-20,33
FC Sion,5773,9,7,9,16,39,53,-14,30
Young Boys,5774,1,21,8,3,72,37,35,71
FC Basel,5774,2,18,8,6,55,27,28,62
Lucerne,5774,3,12,9,11,41,41,0,45
St Gallen,5774,4,14,2,16,43,58,-15,44
FC Zürich,5774,5,10,10,12,41,36,5,40
FC Lugano,5774,6,11,7,14,35,48,-13,40
Grasshoppers,5774,7,9,7,16,38,50,-12,34
FC Thun,5774,8,9,7,16,43,56,-13,34
FC Sion,5774,9,7,8,17,39,54,-15,29
Young Boys,5775,1,21,7,4,69,39,30,70
FC Basel,5775,2,16,9,7,52,27,25,57
Lucerne,5775,3,15,7,10,49,42,7,52
St Gallen,5775,4,15,4,13,45,53,-8,49
FC Thun,5775,5,11,6,15,47,56,-9,39
FC Zürich,5775,6,9,11,12,37,35,2,38
Grasshoppers,5775,7,9,7,16,42,53,-11,34
FC Lugano,5775,8,9,6,17,29,51,-22,33
FC Sion,5775,9,6,9,17,39,53,-14,27
Young Boys,5776,1,21,8,3,72,36,36,71
FC Basel,5776,2,19,8,5,58,26,32,65
St Gallen,5776,3,14,4,14,42,53,-11,46
Lucerne,5776,4,12,8,12,44,47,-3,44
FC Zürich,5776,5,9,12,11,41,40,1,39
Grasshoppers,5776,6,8,10,14,43,51,-8,34
FC Lugano,5776,7,9,7,16,30,48,-18,34
FC Thun,5776,8,9,6,17,42,59,-17,33
FC Sion,5776,9,6,11,15,40,52,-12,29
Young Boys,5777,1,21,8,3,69,34,35,71
FC Basel,5777,2,16,10,6,49,25,24,58
FC Zürich,5777,3,12,10,10,45,34,11,46
Lucerne,5777,4,12,10,10,40,41,-1,46
St Gallen,5777,5,13,5,14,40,52,-12,44
Grasshoppers,5777,6,11,6,15,43,48,-5,39
FC Thun,5777,7,10,5,17,44,61,-17,35
FC Lugano,5777,8,9,7,16,30,48,-18,34
FC Sion,5777,9,6,7,19,40,57,-17,25
Young Boys,5778,1,19,11,2,68,34,34,68
FC Basel,5778,2,18,9,5,59,28,31,63
St Gallen,5778,3,14,5,13,45,55,-10,47
Lucerne,5778,4,11,8,13,41,47,-6,41
FC Zürich,5778,5,10,10,12,40,38,2,40
FC Thun,5778,6,11,5,16,48,60,-12,38
FC Lugano,5778,7,10,8,14,30,44,-14,38
Grasshoppers,5778,8,9,8,15,43,52,-9,35
FC Sion,5778,9,5,10,17,39,55,-16,25
Young Boys,5779,1,21,6,5,68,34,34,69
FC Basel,5779,2,18,9,5,51,23,28,63
Lucerne,5779,3,14,8,10,44,43,1,50
St Gallen,5779,4,13,2,17,39,56,-17,41
FC Zürich,5779,5,9,11,12,37,37,0,38
FC Lugano,5779,6,11,5,16,35,48,-13,38
FC Thun,5779,7,10,6,16,45,55,-10,36
FC Sion,5779,8,9,7,16,43,55,-12,34
Grasshoppers,5779,9,9,6,17,41,52,-11,33
Young Boys,5780,1,22,6,4,73,33,40,72
FC Basel,5780,2,17,9,6,50,24,26,60
St Gallen,5780,3,15,2,15,42,52,-10,47
Lucerne,5780,4,12,9,11,37,40,-3,45
FC Lugano,5780,5,12,6,14,30,42,-12,42
FC Zürich,5780,6,10,10,12,39,35,4,40
FC Thun,5780,7,11,6,15,47,57,-10,39
Grasshoppers,5780,8,9,7,16,40,49,-9,34
FC Sion,5780,9,5,7,20,36,62,-26,22
Young Boys,5781,1,22,7,3,74,36,38,73
FC Basel,5781,2,18,9,5,56,25,31,63
Lucerne,5781,3,13,7,12,41,45,-4,46
St Gallen,5781,4,13,3,16,41,56,-15,42
FC Lugano,5781,5,12,5,15,33,46,-13,41
FC Zürich,5781,6,10,10,12,40,36,4,40
FC Thun,5781,7,11,5,16,48,57,-9,38
Grasshoppers,5781,8,8,8,16,42,55,-13,32
FC Sion,5781,9,6,8,18,40,59,-19,26
Young Boys,5782,1,21,6,5,70,38,32,69
FC Basel,5782,2,19,8,5,58,24,34,65
Lucerne,5782,3,13,8,11,44,44,0,47
St Gallen,5782,4,15,2,15,43,57,-14,47
FC Zürich,5782,5,10,11,11,41,38,3,41
Grasshoppers,5782,6,9,8,15,43,51,-8,35
FC Lugano,5782,7,10,5,17,31,49,-18,35
FC Thun,5782,8,9,7,16,46,60,-14,34
FC Sion,5782,9,6,9,17,42,57,-15,27
Young Boys,5783,1,21,7,4,69,38,31,70
FC Basel,5783,2,18,8,6,56,24,32,62
Lucerne,5783,3,12,9,11,41,46,-5,45
St Gallen,5783,4,14,2,16,43,58,-15,44
FC Zürich,5783,5,10,11,11,38,35,3,41
Grasshoppers,5783,6,10,7,15,43,47,-4,37
FC Lugano,5783,7,10,7,15,33,45,-12,37
FC Thun,5783,8,10,6,16,43,57,-14,36
FC Sion,5783,9,7,7,18,39,55,-16,28
Young Boys,5784,1,22,7,3,72,34,38,73
FC Basel,5784,2,18,8,6,56,29,27,62
St Gallen,5784,3,15,3,14,41,52,-11,48
FC Zürich,5784,4,11,10,11,42,36,6,43
Lucerne,5784,5,11,10,11,39,43,-4,43
FC Thun,5784,6,10,6,16,46,59,-13,36
Grasshoppers,5784,7,9,7,16,41,53,-12,34
FC Lugano,5784,8,9,6,17,28,46,-18,33
FC Sion,5784,9,6,9,17,41,54,-13,27
Young Boys,5785,1,23,7,2,77,31,46,76
FC Basel,5785,2,15,11,6,49,25,24,56
St Gallen,5785,3,14,4,14,43,57,-14,46
Lucerne,5785,4,12,9,11,40,44,-4,45
FC Zürich,5785,5,11,10,11,40,35,5,43
FC Thun,5785,6,11,6,15,45,57,-12,39
FC Lugano,5785,7,10,7,15,31,44,-13,37
Grasshoppers,5785,8,9,6,17,42,51,-9,33
FC Sion,5785,9,5,8,19,40,63,-23,23
Young Boys,5786,1,20,6,6,66,39,27,66
FC Basel,5786,2,17,9,6,53,27,26,60
Lucerne,5786,3,15,8,9,49,40,9,53
St Gallen,5786,4,15,2,15,44,54,-10,47
FC Zürich,5786,5,11,11,10,41,35,6,44
Grasshoppers,5786,6,10,6,16,45,51,-6,36
FC Lugano,5786,7,9,6,17,30,50,-20,33
FC Thun,5786,8,9,5,18,43,63,-20,32
FC Sion,5786,9,8,7,17,40,52,-12,31
Young Boys,5787,1,20,6,6,67,44,23,66
FC Basel,5787,2,19,7,6,58,27,31,64
FC Zürich,5787,3,12,10,10,43,34,9,46
Lucerne,5787,4,12,8,12,41,43,-2,44
St Gallen,5787,5,14,2,16,44,59,-15,44
FC Lugano,5787,6,12,5,15,34,45,-11,41
Grasshoppers,5787,7,9,7,16,39,48,-9,34
FC Sion,5787,8,8,8,16,43,51,-8,32
FC Thun,5787,9,9,5,18,41,59,-18,32
Young Boys,5788,1,20,7,5,68,39,29,67
FC Basel,5788,2,17,9,6,60,31,29,60
St Gallen,5788,3,16,3,13,44,52,-8,51
Lucerne,5788,4,13,8,11,45,45,0,47
FC Zürich,5788,5,11,9,12,43,38,5,42
FC Thun,5788,6,11,6,15,51,61,-10,39
Grasshoppers,5788,7,10,6,16,41,53,-12,36
FC Lugano,5788,8,10,5,17,31,50,-19,35
FC Sion,5788,9,6,7,19,41,55,-14,25
Young Boys,5789,1,22,7,3,75,36,39,73
FC Basel,5789,2,18,8,6,53,25,28,62
Lucerne,5789,3,12,9,11,48,53,-5,45
St Gallen,5789,4,13,4,15,44,57,-13,43
FC Lugano,5789,5,12,6,14,36,48,-12,42
FC Zürich,5789,6,10,10,12,42,41,1,40
FC Thun,5789,7,10,6,16,49,61,-12,36
Grasshoppers,5789,8,8,6,18,41,55,-14,30
FC Sion,5789,9,6,10,16,42,54,-12,28
Young Boys,5790,1,22,7,3,69,31,38,73
FC Basel,5790,2,17,10,5,50,23,27,61
FC Zürich,5790,3,12,9,11,45,34,11,45
St Gallen,5790,4,14,3,15,41,55,-14,45
Lucerne,5790,5,12,7,13,41,44,-3,43
FC Lugano,5790,6,11,5,16,32,50,-18,38
FC Sion,5790,7,9,7,16,40,50,-10,34
Grasshoppers,5790,8,9,6,17,39,51,-12,33
FC Thun,5790,9,8,6,18,39,58,-19,30
Young Boys,5791,1,21,8,3,73,38,35,71
FC Basel,5791,2,17,9,6,56,26,30,60
St Gallen,5791,3,14,5,13,42,51,-9,47
FC Zürich,5791,4,10,11,11,40,36,4,41
Lucerne,5791,5,11,8,13,40,46,-6,41
FC Lugano,5791,6,11,6,15,33,46,-13,39
Grasshoppers,5791,7,10,6,16,41,47,-6,36
FC Thun,5791,8,10,5,17,43,65,-22,35
FC Sion,5791,9,6,10,16,39,52,-13,28
Young Boys,5792,1,21,6,5,69,37,32,69
FC Basel,5792,2,18,8,6,57,30,27,62
Lucerne,5792,3,15,7,10,51,43,8,52
St Gallen,5792,4,15,2,15,47,58,-11,47
FC Zürich,5792,5,10,11,11,41,38,3,41
FC Lugano,5792,6,11,6,15,35,47,-12,39
FC Thun,5792,7,10,5,17,45,58,-13,35
Grasshoppers,5792,8,9,6,17,37,53,-16,33
FC Sion,5792,9,6,7,19,37,55,-18,25
Young Boys,5793,1,21,7,4,70,38,32,70
FC Basel,5793,2,20,7,5,60,25,35,67
St Gallen,5793,3,16,2,14,45,53,-8,50
Lucerne,5793,4,12,7,13,41,48,-7,43
FC Lugano,5793,5,11,6,15,33,47,-14,39
FC Thun,5793,6,11,5,16,45,57,-12,38
FC Zürich,5793,7,9,9,14,39,41,-2,36
Grasshoppers,5793,8,8,7,17,39,51,-12,31
FC Sion,5793,9,7,8,17,41,53,-12,29
Young Boys,5794,1,19,8,5,67,38,29,65
FC Basel,5794,2,18,8,6,54,25,29,62
St Gallen,5794,3,15,4,13,43,52,-9,49
Lucerne,5794,4,12,9,11,41,42,-1,45
FC Lugano,5794,5,11,7,14,31,44,-13,40
FC Zürich,5794,6,9,10,13,39,41,-2,37
Grasshoppers,5794,7,9,8,15,39,47,-8,35
FC Thun,5794,8,9,7,16,44,60,-16,34
FC Sion,5794,9,8,7,17,44,53,-9,31
Young Boys,5795,1,20,8,4,67,37,30,68
FC Basel,5795,2,16,7,9,54,31,23,55
St Gallen,5795,3,15,2,15,43,54,-11,47
Lucerne,5795,4,12,10,10,43,46,-3,46
FC Zürich,5795,5,10,10,12,44,39,5,40
FC Lugano,5795,6,11,7,14,32,45,-13,40
Grasshoppers,5795,7,9,9,14,42,49,-7,36
FC Thun,5795,8,10,6,16,43,57,-14,36
FC Sion,5795,9,7,9,16,42,52,-10,30
Young Boys,5796,1,21,7,4,70,36,34,70
FC Basel,5796,2,17,10,5,52,25,27,61
St Gallen,5796,3,14,3,15,40,57,-17,45
Lucerne,5796,4,12,7,13,40,44,-4,43
Grasshoppers,5796,5,12,6,14,47,44,3,42
FC Lugano,5796,6,12,5,15,32,43,-11,41
FC Zürich,5796,7,9,12,11,39,37,2,39
FC Thun,5796,8,8,7,17,39,61,-22,31
FC Sion,5796,9,6,9,17,40,52,-12,27
Young Boys,5797,1,22,8,2,77,33,44,74
FC Basel,5797,2,17,8,7,51,30,21,59
St Gallen,5797,3,15,2,15,45,56,-11,47
FC Zürich,5797,4,12,9,11,44,36,8,45
Lucerne,5797,5,12,7,13,48,52,-4,43
FC Lugano,5797,6,12,5,15,38,51,-13,41
Grasshoppers,5797,7,9,7,16,45,55,-10,34
FC Thun,5797,8,9,5,18,40,59,-19,32
FC Sion,5797,9,7,7,18,38,54,-16,28
Young Boys,5798,1,21,9,2,71,32,39,72
FC Basel,5798,2,17,8,7,53,25,28,59
Lucerne,5798,3,13,8,11,44,47,-3,47
St Gallen,5798,4,14,2,16,43,55,-12,44
FC Zürich,5798,5,10,11,11,38,37,1,41
FC Lugano,5798,6,10,7,15,31,47,-16,37
FC Thun,5798,7,9,7,16,43,59,-16,34
Grasshoppers,5798,8,8,9,15,40,49,-9,33
FC Sion,5798,9,7,9,16,43,55,-12,30
Young Boys,5799,1,21,7,4,76,39,37,70
FC Basel,5799,2,18,8,6,59,29,30,62
St Gallen,5799,3,15,2,15,47,53,-6,47
Lucerne,5799,4,12,9,11,42,49,-7,45
FC Zürich,5799,5,10,11,11,40,35,5,41
FC Lugano,5799,6,10,6,16,33,54,-21,36
FC Thun,5799,7,9,7,16,42,60,-18,34
Grasshoppers,5799,8,8,8,16,38,49,-11,32
FC Sion,5799,9,7,10,15,40,49,-9,31
Young Boys,5800,1,22,7,3,76,35,41,73
FC Basel,5800,2,19,7,6,57,26,31,64
St Gallen,5800,3,14,4,14,42,56,-14,46
Lucerne,5800,4,12,8,12,40,45,-5,44
FC Zürich,5800,5,11,9,12,40,39,1,42
Grasshoppers,5800,6,11,6,15,42,48,-6,39
FC Lugano,5800,7,10,6,16,33,47,-14,36
FC Thun,5800,8,10,5,17,46,59,-13,35
FC Sion,5800,9,5,8,19,39,60,-21,23
Young Boys,5801,1,22,7,3,69,33,36,73
FC Basel,5801,2,19,8,5,56,24,32,65
Lucerne,5801,3,13,8,11,45,45,0,47
St Gallen,5801,4,13,4,15,41,55,-14,43
FC Zürich,5801,5,10,11,11,39,36,3,41
FC Lugano,5801,6,10,5,17,30,47,-17,35
FC Thun,5801,7,9,7,16,42,56,-14,34
Grasshoppers,5801,8,8,8,16,38,51,-13,32
FC Sion,5801,9,6,10,16,37,50,-13,28
Young Boys,5802,1,22,7,3,73,39,34,73
FC Basel,5802,2,20,7,5,64,24,40,67
St Gallen,5802,3,15,3,14,46,54,-8,48
Lucerne,5802,4,12,9,11,40,46,-6,45
FC Zürich,5802,5,9,9,14,37,40,-3,36
FC Lugano,5802,6,10,6,16,34,48,-14,36
Grasshoppers,5802,7,9,7,16,39,47,-8,34
FC Thun,5802,8,9,6,17,40,60,-20,33
FC Sion,5802,9,7,8,17,39,54,-15,29
Young Boys,5803,1,21,7,4,73,38,35,70
FC Basel,5803,2,19,8,5,59,24,35,65
St Gallen,5803,3,15,2,15,43,56,-13,47
Lucerne,5803,4,12,7,13,40,49,-9,43
FC Zürich,5803,5,10,10,12,41,38,3,40
Grasshoppers,5803,6,11,6,15,44,50,-6,39
FC Lugano,5803,7,11,6,15,36,46,-10,39
FC Thun,5803,8,10,5,17,45,62,-17,35
FC Sion,5803,9,6,7,19,44,62,-18,25
Young Boys,5804,1,21,8,3,71,35,36,71
FC Basel,5804,2,19,7,6,55,27,28,64
Lucerne,5804,3,13,9,10,44,43,1,48
St Gallen,5804,4,15,3,14,48,56,-8,48
FC Zürich,5804,5,10,10,12,40,40,0,40
FC Thun,5804,6,11,5,16,48,57,-9,38
FC Lugano,5804,7,10,5,17,32,51,-19,35
Grasshoppers,5804,8,9,7,16,42,52,-10,34
FC Sion,5804,9,5,8,19,39,58,-19,23
Young Boys,5805,1,23,6,3,72,32,40,75
FC Basel,5805,2,17,10,5,53,24,29,61
FC Zürich,5805,3,11,11,10,41,34,7,44
Lucerne,5805,4,12,8,12,41,46,-5,44
St Gallen,5805,5,14,2,16,43,58,-15,44
FC Lugano,5805,6,11,6,15,34,48,-14,39
Grasshoppers,5805,7,9,6,17,40,50,-10,33
FC Sion,5805,8,8,7,17,41,53,-12,31
FC Thun,5805,9,8,6,18,41,61,-20,30
Young Boys,5806,1,22,6,4,72,33,39,72
FC Basel,5806,2,19,8,5,57,25,32,65
Lucerne,5806,3,14,7,11,42,42,0,49
St Gallen,5806,4,15,3,14,43,53,-10,48
FC Zürich,5806,5,10,11,11,39,37,2,41
FC Thun,5806,6,10,6,16,49,61,-12,36
Grasshoppers,5806,7,9,6,17,41,52,-11,33
FC Lugano,5806,8,9,6,17,29,50,-21,33
FC Sion,5806,9,6,7,19,39,58,-19,25
Young Boys,5807,1,22,8,2,72,33,39,74
FC Basel,5807,2,17,9,6,54,24,30,60
Lucerne,5807,3,13,8,11,43,45,-2,47
St Gallen,5807,4,14,3,15,44,58,-14,45
FC Zürich,5807,5,11,11,10,45,38,7,44
Grasshoppers,5807,6,9,7,16,43,52,-9,34
FC Thun,5807,7,8,9,15,45,60,-15,33
FC Lugano,5807,8,9,6,17,32,53,-21,33
FC Sion,5807,9,6,9,17,43,58,-15,27
Young Boys,5808,1,21,7,4,72,35,37,70
FC Basel,5808,2,18,9,5,55,22,33,63
Lucerne,5808,3,12,8,12,39,47,-8,44
St Gallen,5808,4,14,2,16,41,55,-14,44
FC Zürich,5808,5,10,10,12,42,39,3,40
Grasshoppers,5808,6,11,7,14,43,46,-3,40
FC Lugano,5808,7,11,6,15,31,47,-16,39
FC Thun,5808,8,9,8,15,42,56,-14,35
FC Sion,5808,9,6,7,19,38,56,-18,25
Young Boys,5809,1,21,7,4,73,36,37,70
FC Basel,5809,2,20,7,5,57,23,34,67
St Gallen,5809,3,15,2,15,47,56,-9,47
Lucerne,5809,4,12,8,12,41,47,-6,44
FC Zürich,5809,5,9,11,12,37,38,-1,38
FC Thun,5809,6,9,7,16,43,58,-15,34
FC Sion,5809,7,8,9,15,46,53,-7,33
Grasshoppers,5809,8,8,9,15,39,50,-11,33
FC Lugano,5809,9,9,6,17,29,51,-22,33
Young Boys,5810,1,23,7,2,76,35,41,76
FC Basel,5810,2,16,11,5,54,27,27,59
Lucerne,5810,3,14,7,11,47,46,1,49
St Gallen,5810,4,13,3,16,40,57,-17,42
FC Zürich,5810,5,10,10,12,40,35,5,40
FC Lugano,5810,6,11,5,16,30,47,-17,38
Grasshoppers,5810,7,9,6,17,43,51,-8,33
FC Thun,5810,8,9,6,17,42,62,-20,33
FC Sion,5810,9,8,7,17,41,53,-12,31
Young Boys,5811,1,21,7,4,71,36,35,70
FC Basel,5811,2,18,8,6,55,26,29,62
Lucerne,5811,3,13,7,12,43,48,-5,46
St Gallen,5811,4,14,2,16,44,56,-12,44
FC Zürich,5811,5,11,10,11,43,38,5,43
Grasshoppers,5811,6,10,6,16,41,52,-11,36
FC Thun,5811,7,10,5,17,44,60,-16,35
FC Lugano,5811,8,10,5,17,32,50,-18,35
FC Sion,5811,9,8,8,16,45,52,-7,32
Young Boys,5812,1,21,7,4,71,37,34,70
FC Basel,5812,2,17,9,6,50,24,26,60
Lucerne,5812,3,14,8,10,44,40,4,50
St Gallen,5812,4,14,3,15,42,51,-9,45
FC Zürich,5812,5,10,10,12,43,39,4,40
FC Lugano,5812,6,11,5,16,31,49,-18,38
Grasshoppers,5812,7,9,7,16,40,51,-11,34
FC Thun,5812,8,9,6,17,43,59,-16,33
FC Sion,5812,9,7,9,16,39,53,-14,30
Young Boys,5813,1,22,7,3,73,36,37,73
FC Basel,5813,2,16,8,8,58,28,30,56
Lucerne,5813,3,14,8,10,46,45,1,50
St Gallen,5813,4,15,2,15,44,55,-11,47
FC Zürich,5813,5,11,11,10,41,34,7,44
FC Thun,5813,6,9,7,16,44,65,-21,34
FC Lugano,5813,7,9,6,17,31,50,-19,33
Grasshoppers,5813,8,8,8,16,41,54,-13,32
FC Sion,5813,9,8,7,17,43,54,-11,31
Young Boys,5814,1,21,9,2,75,35,40,72
FC Basel,5814,2,15,10,7,52,31,21,55
St Gallen,5814,3,16,2,14,48,53,-5,50
Lucerne,5814,4,13,7,12,41,48,-7,46
FC Zürich,5814,5,11,10,11,43,36,7,43
FC Lugano,5814,6,11,6,15,33,47,-14,39
FC Thun,5814,7,10,6,16,43,55,-12,36
Grasshoppers,5814,8,9,7,16,42,53,-11,34
FC Sion,5814,9,6,7,19,42,61,-19,25
Young Boys,5815,1,21,7,4,73,39,34,70
FC Basel,5815,2,18,9,5,55,27,28,63
St Gallen,5815,3,16,2,14,46,54,-8,50
Lucerne,5815,4,13,8,11,45,48,-3,47
FC Zürich,5815,5,10,11,11,41,36,5,41
Grasshoppers,5815,6,9,7,16,45,52,-7,34
FC Lugano,5815,7,9,7,16,32,49,-17,34
FC Thun,5815,8,9,6,17,45,62,-17,33
FC Sion,5815,9,6,9,17,40,55,-15,27
Young Boys,5816,1,21,6,5,69,38,31,69
FC Basel,5816,2,18,8,6,58,25,33,62
Lucerne,5816,3,15,7,10,46,42,4,52
St Gallen,5816,4,15,2,15,45,56,-11,47
FC Zürich,5816,5,11,10,11,43,40,3,43
Grasshoppers,5816,6,10,6,16,43,51,-8,36
FC Lugano,5816,7,10,5,17,33,51,-18,35
FC Thun,5816,8,9,5,18,45,64,-19,32
FC Sion,5816,9,7,7,18,43,58,-15,28
Young Boys,5817,1,20,9,3,74,36,38,69
FC Basel,5817,2,17,10,5,53,25,28,61
FC Zürich,5817,3,12,9,11,45,35,10,45
Lucerne,5817,4,12,9,11,41,44,-3,45
St Gallen,5817,5,14,3,15,43,55,-12,45
Grasshoppers,5817,6,10,7,15,43,49,-6,37
FC Lugano,5817,7,10,6,16,32,54,-22,36
FC Thun,5817,8,9,6,17,44,59,-15,33
FC Sion,5817,9,6,9,17,40,58,-18,27
Young Boys,5818,1,23,7,2,77,34,43,76
FC Basel,5818,2,19,7,6,54,25,29,64
Lucerne,5818,3,12,8,12,41,45,-4,44
St Gallen,5818,4,14,2,16,41,54,-13,44
FC Zürich,5818,5,10,9,13,41,37,4,39
FC Lugano,5818,6,11,6,15,33,47,-14,39
FC Thun,5818,7,10,6,16,44,59,-15,36
Grasshoppers,5818,8,9,8,15,42,50,-8,35
FC Sion,5818,9,6,7,19,37,59,-22,25
Young Boys,5819,1,22,7,3,70,35,35,73
FC Basel,5819,2,19,7,6,64,26,38,64
Lucerne,5819,3,13,7,12,40,44,-4,46
St Gallen,5819,4,14,2,16,42,58,-16,44
FC Zürich,5819,5,11,9,12,45,40,5,42
Grasshoppers,5819,6,9,8,15,39,48,-9,35
FC Lugano,5819,7,10,5,17,30,52,-22,35
FC Sion,5819,8,8,8,16,39,49,-10,32
FC Thun,5819,9,9,5,18,42,59,-17,32
Young Boys,5820,1,22,6,4,72,36,36,72
FC Basel,5820,2,20,7,5,58,23,35,67
Lucerne,5820,3,13,8,11,41,42,-1,47
St Gallen,5820,4,14,3,15,40,54,-14,45
FC Zürich,5820,5,10,11,11,42,35,7,41
Grasshoppers,5820,6,11,7,14,46,48,-2,40
FC Lugano,5820,7,9,6,17,28,50,-22,33
FC Thun,5820,8,9,5,18,40,62,-22,32
FC Sion,5820,9,5,9,18,38,55,-17,24
Young Boys,5821,1,22,6,4,80,37,43,72
FC Basel,5821,2,19,8,5,57,26,31,65
Lucerne,5821,3,12,9,11,43,46,-3,45
St Gallen,5821,4,13,3,16,40,55,-15,42
FC Zürich,5821,5,9,13,10,42,38,4,40
Grasshoppers,5821,6,10,7,15,40,47,-7,37
FC Thun,5821,7,10,6,16,45,57,-12,36
FC Lugano,5821,8,10,6,16,32,51,-19,36
FC Sion,5821,9,6,8,18,37,59,-22,26
Young Boys,5822,1,22,6,4,74,38,36,72
FC Basel,5822,2,18,8,6,56,26,30,62
St Gallen,5822,3,15,3,14,46,55,-9,48
Lucerne,5822,4,13,7,12,44,45,-1,46
FC Zürich,5822,5,10,10,12,41,40,1,40
FC Lugano,5822,6,11,5,16,33,50,-17,38
Grasshoppers,5822,7,9,7,16,39,49,-10,34
FC Thun,5822,8,9,6,17,43,59,-16,33
FC Sion,5822,9,7,8,17,41,55,-14,29
Young Boys,5823,1,21,6,5,68,36,32,69
FC Basel,5823,2,17,9,6,57,29,28,60
St Gallen,5823,3,15,4,13,47,54,-7,49
Lucerne,5823,4,12,9,11,42,46,-4,45
FC Zürich,5823,5,11,9,12,41,38,3,42
Grasshoppers,5823,6,11,6,15,43,48,-5,39
FC Lugano,5823,7,10,7,15,33,46,-13,37
FC Thun,5823,8,9,6,17,43,61,-18,33
FC Sion,5823,9,6,8,18,39,55,-16,26
Young Boys,5824,1,21,6,5,72,35,37,69
FC Basel,5824,2,17,8,7,50,28,22,59
Lucerne,5824,3,13,8,11,40,41,-1,47
FC Zürich,5824,4,11,10,11,43,35,8,43
St Gallen,5824,5,13,4,15,44,57,-13,43
Grasshoppers,5824,6,11,6,15,42,48,-6,39
FC Lugano,5824,7,10,6,16,30,49,-19,36
FC Thun,5824,8,9,6,17,44,60,-16,33
FC Sion,5824,9,8,8,16,44,56,-12,32
Young Boys,5825,1,20,8,4,67,36,31,68
FC Basel,5825,2,18,9,5,56,24,32,63
FC Zürich,5825,3,12,10,10,44,36,8,46
St Gallen,5825,4,14,4,14,45,57,-12,46
Lucerne,5825,5,11,9,12,41,47,-6,42
Grasshoppers,5825,6,11,6,15,45,46,-1,39
FC Lugano,5825,7,9,7,16,31,48,-17,34
FC Thun,5825,8,9,6,17,41,59,-18,33
FC Sion,5825,9,6,9,17,40,57,-17,27
Young Boys,5826,1,20,8,4,67,35,32,68
FC Basel,5826,2,17,9,6,51,24,27,60
St Gallen,5826,3,16,3,13,49,52,-3,51
Lucerne,5826,4,13,8,11,40,44,-4,47
FC Zürich,5826,5,10,10,12,40,37,3,40
FC Lugano,5826,6,10,7,15,31,48,-17,37
FC Thun,5826,7,9,7,16,44,57,-13,34
Grasshoppers,5826,8,8,7,17,39,52,-13,31
FC Sion,5826,9,7,9,16,43,55,-12,30
Young Boys,5827,1,22,7,3,74,35,39,73
FC Basel,5827,2,19,8,5,54,22,32,65
St Gallen,5827,3,14,3,15,42,54,-12,45
Lucerne,5827,4,11,9,12,39,45,-6,42
FC Zürich,5827,5,9,11,12,41,41,0,38
FC Thun,5827,6,11,5,16,48,57,-9,38
FC Lugano,5827,7,10,8,14,31,45,-14,38
Grasshoppers,5827,8,10,6,16,45,48,-3,36
FC Sion,5827,9,5,9,18,39,66,-27,24
Young Boys,5828,1,22,7,3,70,31,39,73
FC Basel,5828,2,20,7,5,55,22,33,67
Lucerne,5828,3,13,8,11,45,46,-1,47
St Gallen,5828,4,14,3,15,43,57,-14,45
FC Zürich,5828,5,10,10,12,38,35,3,40
FC Lugano,5828,6,10,6,16,32,50,-18,36
Grasshoppers,5828,7,9,8,15,42,53,-11,35
FC Thun,5828,8,9,5,18,43,60,-17,32
FC Sion,5828,9,6,8,18,40,54,-14,26
Young Boys,5829,1,21,8,3,70,35,35,71
FC Basel,5829,2,18,8,6,56,26,30,62
Lucerne,5829,3,12,9,11,38,40,-2,45
St Gallen,5829,4,13,6,13,40,51,-11,45
FC Zürich,5829,5,11,10,11,41,35,6,43
FC Thun,5829,6,10,5,17,43,59,-16,35
FC Lugano,5829,7,9,8,15,28,44,-16,35
Grasshoppers,5829,8,8,8,16,39,50,-11,32
FC Sion,5829,9,6,10,16,39,54,-15,28
Young Boys,5830,1,20,7,5,68,36,32,67
FC Basel,5830,2,17,7,8,51,27,24,58
Lucerne,5830,3,13,8,11,42,42,0,47
FC Zürich,5830,4,12,10,10,41,34,7,46
St Gallen,5830,5,14,2,16,41,55,-14,44
FC Lugano,5830,6,11,6,15,33,47,-14,39
Grasshoppers,5830,7,10,7,15,40,48,-8,37
FC Sion,5830,8,8,9,15,46,54,-8,33
FC Thun,5830,9,8,6,18,42,61,-19,30
Young Boys,5831,1,22,8,2,68,31,37,74
FC Basel,5831,2,18,7,7,55,26,29,61
Lucerne,5831,3,14,9,9,46,41,5,51
St Gallen,5831,4,13,5,14,43,55,-12,44
FC Zürich,5831,5,10,11,11,39,35,4,41
FC Thun,5831,6,10,6,16,43,59,-16,36
FC Lugano,5831,7,9,8,15,30,46,-16,35
Grasshoppers,5831,8,9,6,17,41,54,-13,33
FC Sion,5831,9,5,8,19,37,55,-18,23
Young Boys,5832,1,22,7,3,70,32,38,73
FC Basel,5832,2,17,8,7,54,25,29,59
Lucerne,5832,3,13,7,12,42,47,-5,46
St Gallen,5832,4,13,5,14,41,54,-13,44
FC Zürich,5832,5,11,10,11,41,36,5,43
Grasshoppers,5832,6,11,6,15,42,47,-5,39
FC Lugano,5832,7,10,7,15,28,44,-16,37
FC Thun,5832,8,10,5,17,43,57,-14,35
FC Sion,5832,9,5,9,18,38,57,-19,24
Young Boys,5833,1,22,7,3,74,32,42,73
FC Basel,5833,2,17,7,8,52,30,22,58
Lucerne,5833,3,14,7,11,42,42,0,49
St Gallen,5833,4,15,4,13,45,52,-7,49
FC Zürich,5833,5,11,11,10,43,34,9,44
FC Lugano,5833,6,9,8,15,30,48,-18,35
FC Thun,5833,7,9,6,17,48,63,-15,33
Grasshoppers,5833,8,8,7,17,39,55,-16,31
FC Sion,5833,9,6,9,17,40,57,-17,27
Young Boys,5834,1,21,7,4,74,37,37,70
FC Basel,5834,2,19,8,5,57,23,34,65
Lucerne,5834,3,14,7,11,45,46,-1,49
St Gallen,5834,4,13,2,17,40,60,-20,41
FC Thun,5834,5,11,5,16,44,57,-13,38
FC Lugano,5834,6,11,5,16,33,49,-16,38
FC Zürich,5834,7,9,10,13,38,38,0,37
Grasshoppers,5834,8,9,6,17,41,53,-12,33
FC Sion,5834,9,8,8,16,46,55,-9,32
Young Boys,5835,1,22,7,3,74,36,38,73
FC Basel,5835,2,17,8,7,54,28,26,59
St Gallen,5835,3,16,2,14,44,53,-9,50
Lucerne,5835,4,13,9,10,46,47,-1,48
FC Zürich,5835,5,11,10,11,42,38,4,43
FC Lugano,5835,6,10,6,16,33,48,-15,36
Grasshoppers,5835,7,9,7,16,41,50,-9,34
FC Thun,5835,8,9,6,17,45,60,-15,33
FC Sion,5835,9,5,9,18,37,56,-19,24
Young Boys,5836,1,22,6,4,69,36,33,72
FC Basel,5836,2,17,9,6,52,25,27,60
Lucerne,5836,3,14,7,11,43,43,0,49
St Gallen,5836,4,13,4,15,44,57,-13,43
FC Zürich,5836,5,10,10,12,38,37,1,40
FC Thun,5836,6,11,5,16,46,55,-9,38
Grasshoppers,5836,7,10,6,16,45,52,-7,36
FC Lugano,5836,8,10,6,16,30,46,-16,36
FC Sion,5836,9,7,7,18,41,57,-16,28
Young Boys,5837,1,20,6,6,72,40,32,66
FC Basel,5837,2,16,10,6,51,25,26,58
Lucerne,5837,3,14,8,10,43,45,-2,50
St Gallen,5837,4,15,3,14,44,55,-11,48
FC Zürich,5837,5,10,10,12,39,36,3,40
FC Lugano,5837,6,11,6,15,33,47,-14,39
Grasshoppers,5837,7,10,7,15,43,49,-6,37
FC Thun,5837,8,10,6,16,44,58,-14,36
FC Sion,5837,9,6,8,18,40,54,-14,26
Young Boys,5838,1,22,8,2,72,31,41,74
FC Basel,5838,2,17,8,7,52,28,24,59
Lucerne,5838,3,14,8,10,47,42,5,50
St Gallen,5838,4,15,3,14,47,52,-5,48
FC Zürich,5838,5,11,9,12,40,38,2,42
FC Lugano,5838,6,10,5,17,32,56,-24,35
Grasshoppers,5838,7,9,7,16,39,51,-12,34
FC Thun,5838,8,8,7,17,42,59,-17,31
FC Sion,5838,9,6,9,17,39,53,-14,27
Young Boys,5839,1,21,8,3,68,34,34,71
FC Basel,5839,2,19,8,5,59,24,35,65
Lucerne,5839,3,13,9,10,44,44,0,48
St Gallen,5839,4,14,2,16,43,56,-13,44
FC Zürich,5839,5,10,10,12,40,38,2,40
FC Thun,5839,6,10,6,16,43,56,-13,36
FC Lugano,5839,7,10,6,16,30,47,-17,36
Grasshoppers,5839,8,9,7,16,41,51,-10,34
FC Sion,5839,9,6,8,18,41,59,-18,26
Young Boys,5840,1,20,7,5,69,37,32,67
FC Basel,5840,2,18,8,6,56,26,30,62
Lucerne,5840,3,14,8,10,42,41,1,50
FC Zürich,5840,4,12,10,10,43,35,8,46
St Gallen,5840,5,14,3,15,42,57,-15,45
Grasshoppers,5840,6,10,7,15,42,48,-6,37
FC Thun,5840,7,9,6,17,43,59,-16,33
FC Lugano,5840,8,9,6,17,29,49,-20,33
FC Sion,5840,9,7,7,18,41,55,-14,28
Young Boys,5841,1,23,7,2,71,31,40,76
FC Basel,5841,2,17,9,6,55,25,30,60
Lucerne,5841,3,13,8,11,40,45,-5,47
FC Zürich,5841,4,11,9,12,42,35,7,42
St Gallen,5841,5,13,3,16,41,61,-20,42
FC Lugano,5841,6,11,5,16,34,45,-11,38
Grasshoppers,5841,7,9,8,15,38,47,-9,35
FC Thun,5841,8,10,5,17,44,55,-11,35
FC Sion,5841,9,6,8,18,38,59,-21,26
Young Boys,5842,1,22,7,3,75,40,35,73
FC Basel,5842,2,17,9,6,55,27,28,60
St Gallen,5842,3,15,4,13,43,51,-8,49
Lucerne,5842,4,13,8,11,43,43,0,47
FC Zürich,5842,5,10,11,11,45,41,4,41
FC Thun,5842,6,10,6,16,44,58,-14,36
FC Lugano,5842,7,9,8,15,32,48,-16,35
Grasshoppers,5842,8,8,8,16,42,53,-11,32
FC Sion,5842,9,5,9,18,38,56,-18,24
Young Boys,5843,1,23,6,3,79,37,42,75
FC Basel,5843,2,18,7,7,54,27,27,61
Lucerne,5843,3,13,9,10,42,41,1,48
St Gallen,5843,4,14,2,16,42,56,-14,44
FC Zürich,5843,5,11,9,12,38,34,4,42
FC Lugano,5843,6,11,6,15,30,47,-17,39
Grasshoppers,5843,7,8,9,15,39,50,-11,33
FC Thun,5843,8,9,6,17,41,57,-16,33
FC Sion,5843,9,6,8,18,39,55,-16,26
Young Boys,5844,1,22,6,4,75,38,37,72
FC Basel,5844,2,17,7,8,54,27,27,58
Lucerne,5844,3,14,8,10,43,44,-1,50
St Gallen,5844,4,14,3,15,45,56,-11,45
FC Thun,5844,5,12,5,15,48,58,-10,41
FC Zürich,5844,6,10,10,12,39,39,0,40
FC Lugano,5844,7,11,5,16,34,48,-14,38
Grasshoppers,5844,8,8,7,17,40,52,-12,31
FC Sion,5844,9,6,9,17,42,58,-16,27
Young Boys,5845,1,22,6,4,72,36,36,72
FC Basel,5845,2,17,10,5,55,28,27,61
Lucerne,5845,3,13,8,11,44,44,0,47
St Gallen,5845,4,14,4,14,43,54,-11,46
FC Zürich,5845,5,11,11,10,43,35,8,44
Grasshoppers,5845,6,10,6,16,47,50,-3,36
FC Thun,5845,7,9,7,16,41,56,-15,34
FC Lugano,5845,8,9,6,17,28,50,-22,33
FC Sion,5845,9,6,8,18,38,58,-20,26
Young Boys,5846,1,21,7,4,71,37,34,70
FC Basel,5846,2,18,8,6,55,28,27,62
St Gallen,5846,3,14,4,14,42,56,-14,46
Lucerne,5846,4,12,8,12,45,46,-1,44
FC Zürich,5846,5,11,10,11,41,36,5,43
FC Lugano,5846,6,11,6,15,34,47,-13,39
Grasshoppers,5846,7,9,7,16,44,53,-9,34
FC Thun,5846,8,9,6,17,43,58,-15,33
FC Sion,5846,9,6,10,16,38,52,-14,28
Young Boys,5847,1,23,6,3,70,32,38,75
FC Basel,5847,2,19,7,6,55,24,31,64
Lucerne,5847,3,14,7,11,47,43,4,49
St Gallen,5847,4,15,2,15,44,55,-11,47
FC Zürich,5847,5,11,9,12,40,36,4,42
FC Thun,5847,6,10,5,17,43,59,-16,35
FC Lugano,5847,7,10,5,17,30,49,-19,35
Grasshoppers,5847,8,9,6,17,40,52,-12,33
FC Sion,5847,9,6,7,19,37,56,-19,25
Young Boys,5848,1,21,8,3,71,35,36,71
FC Basel,5848,2,17,10,5,55,26,29,61
St Gallen,5848,3,14,4,14,42,53,-11,46
FC Zürich,5848,4,11,10,11,41,38,3,43
Lucerne,5848,5,11,10,11,42,46,-4,43
Grasshoppers,5848,6,12,6,14,46,48,-2,42
FC Lugano,5848,7,9,8,15,32,48,-16,35
FC Thun,5848,8,9,5,18,43,62,-19,32
FC Sion,5848,9,6,7,19,40,56,-16,25
Young Boys,5849,1,21,8,3,69,33,36,71
FC Basel,5849,2,17,8,7,53,26,27,59
St Gallen,5849,3,15,4,13,50,55,-5,49
Lucerne,5849,4,12,8,12,38,46,-8,44
FC Zürich,5849,5,11,9,12,42,39,3,42
FC Lugano,5849,6,9,8,15,30,46,-16,35
Grasshoppers,5849,7,9,7,16,40,50,-10,34
FC Sion,5849,8,8,9,15,46,52,-6,33
FC Thun,5849,9,9,5,18,40,61,-21,32
Young Boys,5850,1,23,6,3,76,36,40,75
FC Basel,5850,2,18,8,6,55,25,30,62
St Gallen,5850,3,14,5,13,42,52,-10,47
Lucerne,5850,4,12,8,12,41,44,-3,44
FC Zürich,5850,5,9,11,12,38,38,0,38
FC Lugano,5850,6,10,8,14,34,47,-13,38
Grasshoppers,5850,7,9,7,16,42,51,-9,34
FC Thun,5850,8,9,6,17,41,59,-18,33
FC Sion,5850,9,6,9,17,39,56,-17,27
Young Boys,5851,1,22,6,4,72,36,36,72
FC Basel,5851,2,17,7,8,51,28,23,58
St Gallen,5851,3,16,2,14,46,54,-8,50
FC Zürich,5851,4,13,9,10,42,32,10,48
Lucerne,5851,5,12,9,11,41,44,-3,45
FC Thun,5851,6,11,5,16,47,57,-10,38
FC Lugano,5851,7,9,6,17,30,51,-21,33
Grasshoppers,5851,8,8,8,16,38,49,-11,32
FC Sion,5851,9,6,8,18,39,55,-16,26
Young Boys,5852,1,21,7,4,67,33,34,70
FC Basel,5852,2,18,8,6,52,25,27,62
St Gallen,5852,3,15,2,15,45,56,-11,47
Lucerne,5852,4,11,8,13,38,44,-6,41
FC Lugano,5852,5,12,5,15,35,46,-11,41
FC Zürich,5852,6,9,12,11,38,36,2,39
Grasshoppers,5852,7,10,8,14,40,46,-6,38
FC Thun,5852,8,8,8,16,40,56,-16,32
FC Sion,5852,9,6,10,16,40,53,-13,28
Young Boys,5853,1,20,9,3,68,34,34,69
FC Basel,5853,2,16,10,6,52,27,25,58
St Gallen,5853,3,14,4,14,40,53,-13,46
Lucerne,5853,4,12,9,11,40,42,-2,45
FC Zürich,5853,5,11,11,10,44,35,9,44
FC Thun,5853,6,9,7,16,39,56,-17,34
FC Lugano,5853,7,9,7,16,30,48,-18,34
FC Sion,5853,8,8,9,15,41,49,-8,33
Grasshoppers,5853,9,9,6,17,38,48,-10,33
Young Boys,5854,1,21,7,4,75,37,38,70
FC Basel,5854,2,19,8,5,61,25,36,65
Lucerne,5854,3,12,8,12,42,52,-10,44
St Gallen,5854,4,13,4,15,42,55,-13,43
FC Lugano,5854,5,12,5,15,37,48,-11,41
FC Zürich,5854,6,10,9,13,41,41,0,39
Grasshoppers,5854,7,10,7,15,41,48,-7,37
FC Thun,5854,8,10,5,17,45,62,-17,35
FC Sion,5854,9,6,9,17,40,56,-16,27
Young Boys,5855,1,20,8,4,73,40,33,68
FC Basel,5855,2,20,7,5,59,24,35,67
Lucerne,5855,3,13,9,10,43,42,1,48
FC Zürich,5855,4,10,11,11,39,35,4,41
St Gallen,5855,5,13,2,17,39,58,-19,41
Grasshoppers,5855,6,10,8,14,45,48,-3,38
FC Lugano,5855,7,10,6,16,30,47,-17,36
FC Thun,5855,8,9,7,16,43,60,-17,34
FC Sion,5855,9,6,8,18,40,57,-17,26
Young Boys,5856,1,20,8,4,67,34,33,68
FC Basel,5856,2,19,8,5,55,25,30,65
St Gallen,5856,3,14,3,15,44,56,-12,45
Lucerne,5856,4,12,8,12,44,47,-3,44
FC Zürich,5856,5,10,10,12,41,38,3,40
FC Lugano,5856,6,11,6,15,30,45,-15,39
Grasshoppers,5856,7,10,8,14,48,54,-6,38
FC Thun,5856,8,9,5,18,43,60,-17,32
FC Sion,5856,9,6,10,16,39,52,-13,28
Young Boys,5857,1,23,7,2,73,32,41,76
FC Basel,5857,2,17,8,7,51,26,25,59
FC Zürich,5857,3,13,9,10,46,35,11,48
St Gallen,5857,4,15,3,14,48,55,-7,48
Lucerne,5857,5,12,8,12,37,42,-5,44
FC Thun,5857,6,10,6,16,49,57,-8,36
Grasshoppers,5857,7,9,8,15,40,53,-13,35
FC Lugano,5857,8,9,5,18,28,52,-24,32
FC Sion,5857,9,5,8,19,38,58,-20,23
Young Boys,5858,1,21,7,4,72,37,35,70
FC Basel,5858,2,19,7,6,56,25,31,64
Lucerne,5858,3,12,9,11,42,43,-1,45
St Gallen,5858,4,14,3,15,42,53,-11,45
FC Zürich,5858,5,11,9,12,40,38,2,42
FC Lugano,5858,6,11,5,16,32,48,-16,38
Grasshoppers,5858,7,9,8,15,40,49,-9,35
FC Thun,5858,8,9,6,17,43,61,-18,33
FC Sion,5858,9,7,8,17,43,56,-13,29
Young Boys,5859,1,20,8,4,67,33,34,68
FC Basel,5859,2,16,9,7,52,27,25,57
Lucerne,5859,3,12,11,9,43,43,0,47
St Gallen,5859,4,15,2,15,41,53,-12,47
FC Zürich,5859,5,12,10,10,44,36,8,46
FC Lugano,5859,6,10,7,15,30,45,-15,37
FC Thun,5859,7,10,5,17,45,61,-16,35
Grasshoppers,5859,8,9,7,16,42,51,-9,34
FC Sion,5859,9,7,7,18,40,55,-15,28
Young Boys,5860,1,22,7,3,74,39,35,73
FC Basel,5860,2,19,7,6,68,28,40,64
St Gallen,5860,3,14,4,14,41,54,-13,46
FC Zürich,5860,4,11,10,11,42,39,3,43
Lucerne,5860,5,12,7,13,41,49,-8,43
FC Thun,5860,6,11,5,16,46,60,-14,38
FC Lugano,5860,7,10,7,15,31,44,-13,37
Grasshoppers,5860,8,8,7,17,38,52,-14,31
FC Sion,5860,9,5,10,17,38,54,-16,25
Young Boys,5861,1,20,8,4,71,36,35,68
FC Basel,5861,2,18,9,5,58,24,34,63
St Gallen,5861,3,13,4,15,41,58,-17,43
Lucerne,5861,4,11,9,12,42,49,-7,42
FC Zürich,5861,5,10,11,11,39,35,4,41
FC Lugano,5861,6,12,5,15,33,44,-11,41
FC Thun,5861,7,10,6,16,41,58,-17,36
Grasshoppers,5861,8,8,9,15,38,49,-11,33
FC Sion,5861,9,7,9,16,41,51,-10,30
Young Boys,5862,1,22,7,3,75,37,38,73
FC Basel,5862,2,18,8,6,57,28,29,62
Lucerne,5862,3,12,9,11,41,43,-2,45
FC Zürich,5862,4,11,10,11,41,34,7,43
St Gallen,5862,5,13,3,16,43,59,-16,42
Grasshoppers,5862,6,11,6,15,43,48,-5,39
FC Lugano,5862,7,10,5,17,29,49,-20,35
FC Sion,5862,8,8,7,17,42,55,-13,31
FC Thun,5862,9,8,7,17,42,60,-18,31
Young Boys,5863,1,21,6,5,70,39,31,69
FC Basel,5863,2,18,8,6,56,26,30,62
Lucerne,5863,3,14,7,11,43,43,0,49
St Gallen,5863,4,14,2,16,41,60,-19,44
FC Zürich,5863,5,10,11,11,41,35,6,41
FC Lugano,5863,6,12,5,15,37,48,-11,41
Grasshoppers,5863,7,11,6,15,43,47,-4,39
FC Thun,5863,8,9,6,17,45,61,-16,33
FC Sion,5863,9,6,7,19,40,57,-17,25
Young Boys,5864,1,22,8,2,70,32,38,74
FC Basel,5864,2,19,8,5,60,27,33,65
Lucerne,5864,3,11,11,10,41,45,-4,44
FC Zürich,5864,4,11,9,12,41,37,4,42
St Gallen,5864,5,13,3,16,41,56,-15,42
FC Thun,5864,6,11,5,16,45,58,-13,38
FC Lugano,5864,7,10,6,16,29,45,-16,36
Grasshoppers,5864,8,9,7,16,43,49,-6,34
FC Sion,5864,9,6,7,19,38,59,-21,25
Young Boys,5865,1,21,7,4,73,36,37,70
FC Basel,5865,2,17,10,5,53,25,28,61
Lucerne,5865,3,13,10,9,44,43,1,49
St Gallen,5865,4,15,3,14,44,54,-10,48
FC Zürich,5865,5,11,9,12,40,36,4,42
FC Lugano,5865,6,10,6,16,32,50,-18,36
Grasshoppers,5865,7,9,7,16,42,52,-10,34
FC Thun,5865,8,8,7,17,42,60,-18,31
FC Sion,5865,9,7,7,18,39,53,-14,28
Young Boys,5866,1,21,7,4,74,37,37,70
FC Basel,5866,2,19,8,5,57,26,31,65
Lucerne,5866,3,13,8,11,44,46,-2,47
St Gallen,5866,4,15,2,15,45,56,-11,47
FC Zürich,5866,5,10,10,12,39,36,3,40
FC Lugano,5866,6,11,6,15,33,48,-15,39
FC Thun,5866,7,10,6,16,45,59,-14,36
Grasshoppers,5866,8,9,7,16,42,54,-12,34
FC Sion,5866,9,5,8,19,39,56,-17,23
Young Boys,5867,1,21,7,4,76,40,36,70
FC Basel,5867,2,17,9,6,56,27,29,60
Lucerne,5867,3,14,8,10,44,42,2,50
St Gallen,5867,4,14,5,13,41,51,-10,47
FC Zürich,5867,5,11,9,12,39,36,3,42
FC Thun,5867,6,11,6,15,49,57,-8,39
FC Lugano,5867,7,9,7,16,27,44,-17,34
Grasshoppers,5867,8,8,7,17,38,53,-15,31
FC Sion,5867,9,6,8,18,39,59,-20,26
Young Boys,5868,1,22,6,4,71,36,35,72
FC Basel,5868,2,17,8,7,54,31,23,59
St Gallen,5868,3,15,3,14,48,58,-10,48
FC Zürich,5868,4,12,9,11,43,36,7,45
Lucerne,5868,5,12,7,13,39,46,-7,43
FC Thun,5868,6,10,6,16,45,56,-11,36
FC Lugano,5868,7,10,6,16,31,48,-17,36
Grasshoppers,5868,8,9,7,16,41,49,-8,34
FC Sion,5868,9,7,8,17,44,56,-12,29
Young Boys,5869,1,22,6,4,73,38,35,72
FC Basel,5869,2,20,7,5,57,24,33,67
St Gallen,5869,3,15,2,15,47,57,-10,47
Lucerne,5869,4,12,8,12,41,48,-7,44
FC Zürich,5869,5,11,9,12,39,37,2,42
FC Thun,5869,6,11,5,16,45,56,-11,38
Grasshoppers,5869,7,10,6,16,43,52,-9,36
FC Lugano,5869,8,9,6,17,28,46,-18,33
FC Sion,5869,9,6,7,19,42,57,-15,25
Young Boys,5870,1,22,7,3,75,36,39,73
FC Basel,5870,2,18,7,7,55,30,25,61
St Gallen,5870,3,17,2,13,49,51,-2,53
Lucerne,5870,4,11,9,12,40,45,-5,42
FC Zürich,5870,5,10,9,13,40,39,1,39
FC Lugano,5870,6,11,5,16,32,51,-19,38
Grasshoppers,5870,7,9,8,15,40,47,-7,35
FC Sion,5870,8,8,7,17,40,52,-12,31
FC Thun,5870,9,8,6,18,39,59,-20,30
Young Boys,5871,1,21,7,4,68,33,35,70
FC Basel,5871,2,20,7,5,58,22,36,67
St Gallen,5871,3,14,2,16,40,56,-16,44
Lucerne,5871,4,11,8,13,38,45,-7,41
FC Zürich,5871,5,10,10,12,41,39,2,40
FC Lugano,5871,6,11,7,14,35,44,-9,40
Grasshoppers,5871,7,11,6,15,45,49,-4,39
FC Thun,5871,8,10,6,16,44,59,-15,36
FC Sion,5871,9,6,7,19,38,60,-22,25
Young Boys,5872,1,22,7,3,75,36,39,73
FC Basel,5872,2,19,7,6,58,26,32,64
Lucerne,5872,3,14,8,10,44,44,0,50
FC Zürich,5872,4,11,9,12,42,37,5,42
St Gallen,5872,5,13,2,17,39,60,-21,41
Grasshoppers,5872,6,9,9,14,41,47,-6,36
FC Lugano,5872,7,10,5,17,29,49,-20,35
FC Thun,5872,8,9,6,17,43,59,-16,33
FC Sion,5872,9,7,7,18,44,57,-13,28
Young Boys,5873,1,22,8,2,72,33,39,74
FC Basel,5873,2,19,7,6,55,26,29,64
St Gallen,5873,3,15,2,15,45,55,-10,47
FC Zürich,5873,4,12,9,11,44,36,8,45
Lucerne,5873,5,12,8,12,42,45,-3,44
Grasshoppers,5873,6,10,8,14,42,46,-4,38
FC Lugano,5873,7,10,6,16,31,50,-19,36
FC Thun,5873,8,8,6,18,40,62,-22,30
FC Sion,5873,9,5,8,19,38,56,-18,23
Young Boys,5874,1,22,7,3,72,36,36,73
FC Basel,5874,2,19,8,5,62,22,40,65
St Gallen,5874,3,15,2,15,42,56,-14,47
Lucerne,5874,4,12,8,12,39,46,-7,44
FC Zürich,5874,5,10,12,10,43,37,6,42
Grasshoppers,5874,6,9,7,16,42,49,-7,34
FC Lugano,5874,7,9,5,18,29,51,-22,32
FC Sion,5874,8,7,10,15,44,54,-10,31
FC Thun,5874,9,8,7,17,42,64,-22,31
Young Boys,5875,1,19,10,3,68,36,32,67
FC Basel,5875,2,16,10,6,50,25,25,58
Lucerne,5875,3,13,9,10,41,39,2,48
St Gallen,5875,4,14,4,14,40,51,-11,46
FC Zürich,5875,5,9,11,12,40,39,1,38
FC Lugano,5875,6,10,7,15,31,47,-16,37
FC Thun,5875,7,9,8,15,45,58,-13,35
Grasshoppers,5875,8,8,9,15,40,49,-9,33
FC Sion,5875,9,8,8,16,41,52,-11,32
Young Boys,5876,1,22,6,4,73,41,32,72
FC Basel,5876,2,18,9,5,57,22,35,63
Lucerne,5876,3,13,8,11,44,45,-1,47
St Gallen,5876,4,14,3,15,43,55,-12,45
FC Zürich,5876,5,9,12,11,38,36,2,39
Grasshoppers,5876,6,10,7,15,45,50,-5,37
FC Thun,5876,7,10,6,16,43,57,-14,36
FC Lugano,5876,8,10,6,16,30,50,-20,36
FC Sion,5876,9,6,7,19,39,56,-17,25
Young Boys,5877,1,22,7,3,74,39,35,73
FC Basel,5877,2,16,11,5,56,29,27,59
St Gallen,5877,3,14,3,15,43,54,-11,45
Lucerne,5877,4,12,7,13,38,48,-10,43
FC Zürich,5877,5,9,12,11,43,41,2,39
FC Lugano,5877,6,10,6,16,31,48,-17,36
Grasshoppers,5877,7,9,8,15,40,48,-8,35
FC Thun,5877,8,9,7,16,45,59,-14,34
FC Sion,5877,9,8,9,15,50,54,-4,33
Young Boys,5878,1,22,6,4,76,37,39,72
FC Basel,5878,2,18,9,5,55,26,29,63
Lucerne,5878,3,12,8,12,44,48,-4,44
St Gallen,5878,4,14,2,16,43,57,-14,44
FC Zürich,5878,5,10,10,12,41,37,4,40
FC Thun,5878,6,11,6,15,45,56,-11,39
FC Lugano,5878,7,11,6,15,33,48,-15,39
FC Sion,5878,8,8,7,17,41,55,-14,31
Grasshoppers,5878,9,8,6,18,40,54,-14,30
Young Boys,5879,1,22,8,2,69,30,39,74
FC Basel,5879,2,16,10,6,50,23,27,58
Lucerne,5879,3,14,8,10,40,41,-1,50
St Gallen,5879,4,14,3,15,43,54,-11,45
FC Zürich,5879,5,11,10,11,39,35,4,43
FC Lugano,5879,6,11,6,15,32,45,-13,39
Grasshoppers,5879,7,10,6,16,42,48,-6,36
FC Thun,5879,8,9,5,18,43,60,-17,32
FC Sion,5879,9,5,8,19,35,57,-22,23
Young Boys,5880,1,21,6,5,70,36,34,69
FC Basel,5880,2,18,8,6,53,29,24,62
St Gallen,5880,3,15,3,14,47,54,-7,48
Lucerne,5880,4,12,10,10,44,45,-1,46
FC Zürich,5880,5,11,10,11,42,35,7,43
FC Lugano,5880,6,10,6,16,31,48,-17,36
Grasshoppers,5880,7,9,8,15,41,49,-8,35
FC Thun,5880,8,9,6,17,41,59,-18,33
FC Sion,5880,9,6,9,17,37,51,-14,27
Young Boys,5881,1,22,7,3,76,34,42,73
FC Basel,5881,2,16,8,8,53,30,23,56
St Gallen,5881,3,14,3,15,44,56,-12,45
Lucerne,5881,4,12,8,12,42,54,-12,44
FC Zürich,5881,5,10,10,12,46,43,3,40
FC Lugano,5881,6,11,5,16,35,48,-13,38
FC Thun,5881,7,10,7,15,44,57,-13,37
Grasshoppers,5881,8,9,8,15,42,50,-8,35
FC Sion,5881,9,7,10,15,44,54,-10,31
Young Boys,5882,1,20,7,5,70,40,30,67
FC Basel,5882,2,17,8,7,54,28,26,59
Lucerne,5882,3,14,8,10,44,43,1,50
St Gallen,5882,4,15,3,14,47,55,-8,48
FC Zürich,5882,5,9,12,11,38,36,2,39
FC Lugano,5882,6,10,8,14,34,47,-13,38
Grasshoppers,5882,7,10,6,16,45,50,-5,36
FC Thun,5882,8,8,7,17,41,60,-19,31
FC Sion,5882,9,7,9,16,42,56,-14,30
Young Boys,5883,1,21,8,3,73,38,35,71
FC Basel,5883,2,17,9,6,55,30,25,60
FC Zürich,5883,3,12,10,10,47,38,9,46
St Gallen,5883,4,14,3,15,44,55,-11,45
Lucerne,5883,5,11,8,13,37,43,-6,41
FC Thun,5883,6,11,5,16,47,58,-11,38
Grasshoppers,5883,7,10,7,15,43,50,-7,37
FC Lugano,5883,8,10,5,17,33,53,-20,35
FC Sion,5883,9,7,7,18,44,58,-14,28
Young Boys,5884,1,22,6,4,78,36,42,72
FC Basel,5884,2,18,7,7,53,25,28,61
St Gallen,5884,3,15,4,13,43,52,-9,49
Lucerne,5884,4,13,8,11,40,45,-5,47
FC Zürich,5884,5,12,10,10,43,36,7,46
Grasshoppers,5884,6,10,6,16,42,47,-5,36
FC Thun,5884,7,10,5,17,46,62,-16,35
FC Lugano,5884,8,9,7,16,32,54,-22,34
FC Sion,5884,9,5,7,20,40,60,-20,22
Young Boys,5885,1,23,6,3,78,36,42,75
FC Basel,5885,2,17,9,6,52,28,24,60
Lucerne,5885,3,14,7,11,45,45,0,49
St Gallen,5885,4,13,2,17,42,59,-17,41
FC Zürich,5885,5,10,10,12,40,37,3,40
FC Lugano,5885,6,11,5,16,33,48,-15,38
FC Thun,5885,7,10,7,15,45,57,-12,37
Grasshoppers,5885,8,9,7,16,41,50,-9,34
FC Sion,5885,9,7,7,18,39,55,-16,28
Young Boys,5886,1,22,7,3,70,35,35,73
FC Basel,5886,2,18,7,7,53,25,28,61
Lucerne,5886,3,12,10,10,42,43,-1,46
St Gallen,5886,4,14,4,14,43,54,-11,46
FC Zürich,5886,5,10,9,13,40,40,0,39
FC Sion,5886,6,9,8,15,47,52,-5,35
FC Thun,5886,7,10,5,17,45,59,-14,35
FC Lugano,5886,8,10,5,17,29,48,-19,35
Grasshoppers,5886,9,8,7,17,39,52,-13,31
Young Boys,5887,1,22,7,3,74,35,39,73
FC Basel,5887,2,18,7,7,55,29,26,61
Lucerne,5887,3,13,9,10,44,43,1,48
St Gallen,5887,4,15,3,14,48,55,-7,48
FC Zürich,5887,5,11,9,12,39,35,4,42
FC Thun,5887,6,12,5,15,47,56,-9,41
FC Lugano,5887,7,9,6,17,28,48,-20,33
Grasshoppers,5887,8,8,8,16,42,52,-10,32
FC Sion,5887,9,5,8,19,36,60,-24,23
Young Boys,5888,1,22,7,3,74,34,40,73
FC Basel,5888,2,17,9,6,53,26,27,60
St Gallen,5888,3,15,3,14,46,53,-7,48
Lucerne,5888,4,12,8,12,42,49,-7,44
FC Thun,5888,5,12,5,15,52,55,-3,41
FC Zürich,5888,6,10,10,12,41,41,0,40
Grasshoppers,5888,7,10,7,15,45,53,-8,37
FC Lugano,5888,8,9,5,18,29,51,-22,32
FC Sion,5888,9,6,8,18,39,59,-20,26
Young Boys,5889,1,20,7,5,66,41,25,67
FC Basel,5889,2,17,8,7,49,27,22,59
Lucerne,5889,3,13,8,11,40,42,-2,47
St Gallen,5889,4,14,4,14,46,55,-9,46
FC Zürich,5889,5,12,9,11,40,33,7,45
Grasshoppers,5889,6,11,6,15,49,48,1,39
FC Lugano,5889,7,11,5,16,31,45,-14,38
FC Thun,5889,8,10,5,17,43,57,-14,35
FC Sion,5889,9,6,8,18,39,55,-16,26
Young Boys,5890,1,20,8,4,69,36,33,68
FC Basel,5890,2,18,7,7,56,27,29,61
Lucerne,5890,3,13,7,12,45,48,-3,46
St Gallen,5890,4,14,2,16,41,57,-16,44
FC Zürich,5890,5,11,9,12,46,39,7,42
FC Lugano,5890,6,12,5,15,36,49,-13,41
Grasshoppers,5890,7,10,7,15,44,50,-6,37
FC Sion,5890,8,8,8,16,42,54,-12,32
FC Thun,5890,9,9,5,18,42,61,-19,32
Young Boys,5891,1,22,7,3,73,36,37,73
FC Basel,5891,2,19,7,6,60,26,34,64
FC Zürich,5891,3,13,9,10,46,33,13,48
St Gallen,5891,4,14,4,14,43,54,-11,46
Lucerne,5891,5,12,8,12,42,47,-5,44
FC Thun,5891,6,10,5,17,42,58,-16,35
FC Lugano,5891,7,9,7,16,30,49,-19,34
Grasshoppers,5891,8,9,6,17,41,54,-13,33
FC Sion,5891,9,5,9,18,37,57,-20,24
Young Boys,5892,1,22,7,3,71,32,39,73
FC Basel,5892,2,18,9,5,55,26,29,63
St Gallen,5892,3,15,3,14,46,58,-12,48
Lucerne,5892,4,13,7,12,43,45,-2,46
FC Zürich,5892,5,10,11,11,41,35,6,41
FC Thun,5892,6,11,5,16,45,58,-13,38
FC Lugano,5892,7,10,5,17,32,49,-17,35
Grasshoppers,5892,8,9,6,17,39,50,-11,33
FC Sion,5892,9,5,9,18,37,56,-19,24
Young Boys,5893,1,21,9,2,72,33,39,72
FC Basel,5893,2,18,8,6,53,25,28,62
St Gallen,5893,3,15,3,14,43,53,-10,48
Lucerne,5893,4,13,8,11,42,42,0,47
FC Zürich,5893,5,11,9,12,44,37,7,42
FC Thun,5893,6,10,6,16,42,56,-14,36
Grasshoppers,5893,7,9,7,16,39,49,-10,34
FC Lugano,5893,8,9,6,17,28,50,-22,33
FC Sion,5893,9,5,10,17,37,55,-18,25
Young Boys,5894,1,22,7,3,73,37,36,73
FC Basel,5894,2,18,9,5,54,24,30,63
St Gallen,5894,3,14,4,14,43,55,-12,46
Lucerne,5894,4,11,9,12,41,45,-4,42
FC Zürich,5894,5,9,12,11,41,39,2,39
FC Lugano,5894,6,11,6,15,35,48,-13,39
FC Thun,5894,7,9,7,16,44,60,-16,34
Grasshoppers,5894,8,8,7,17,39,52,-13,31
FC Sion,5894,9,7,9,16,42,52,-10,30
Young Boys,5895,1,21,8,3,68,32,36,71
FC Basel,5895,2,17,8,7,54,27,27,59
St Gallen,5895,3,15,3,14,42,53,-11,48
Lucerne,5895,4,12,8,12,38,41,-3,44
FC Zürich,5895,5,10,10,12,40,38,2,40
FC Lugano,5895,6,11,6,15,33,46,-13,39
FC Thun,5895,7,10,6,16,42,58,-16,36
Grasshoppers,5895,8,9,8,15,38,46,-8,35
FC Sion,5895,9,5,11,16,37,51,-14,26
Young Boys,5896,1,21,7,4,70,34,36,70
FC Basel,5896,2,17,9,6,54,27,27,60
Lucerne,5896,3,15,7,10,44,42,2,52
FC Zürich,5896,4,12,10,10,45,35,10,46
St Gallen,5896,5,14,4,14,42,53,-11,46
Grasshoppers,5896,6,10,6,16,42,50,-8,36
FC Thun,5896,7,10,5,17,45,62,-17,35
FC Lugano,5896,8,9,6,17,29,50,-21,33
FC Sion,5896,9,5,8,19,37,55,-18,23
FC Basel,5897,1,19,8,5,56,26,30,65
Young Boys,5897,2,19,7,6,70,43,27,64
Lucerne,5897,3,14,8,10,47,43,4,50
St Gallen,5897,4,14,5,13,42,51,-9,47
FC Zürich,5897,5,11,9,12,42,36,6,42
Grasshoppers,5897,6,9,8,15,43,53,-10,35
FC Lugano,5897,7,10,5,17,30,48,-18,35
FC Thun,5897,8,9,7,16,44,59,-15,34
FC Sion,5897,9,6,9,17,44,59,-15,27
Young Boys,5898,1,20,8,4,73,36,37,68
FC Basel,5898,2,20,7,5,60,26,34,67
Lucerne,5898,3,13,8,11,43,42,1,47
FC Zürich,5898,4,12,9,11,44,37,7,45
St Gallen,5898,5,14,2,16,40,54,-14,44
Grasshoppers,5898,6,11,6,15,41,48,-7,39
FC Lugano,5898,7,10,5,17,31,56,-25,35
FC Sion,5898,8,7,8,17,40,52,-12,29
FC Thun,5898,9,8,5,19,42,63,-21,29
Young Boys,5899,1,22,7,3,73,35,38,73
FC Basel,5899,2,18,8,6,54,25,29,62
St Gallen,5899,3,15,4,13,47,55,-8,49
Lucerne,5899,4,13,8,11,45,45,0,47
FC Zürich,5899,5,11,10,11,42,35,7,43
Grasshoppers,5899,6,9,7,16,43,53,-10,34
FC Lugano,5899,7,9,5,18,31,52,-21,32
FC Thun,5899,8,8,7,17,43,65,-22,31
FC Sion,5899,9,7,8,17,44,57,-13,29
Young Boys,5900,1,20,8,4,67,36,31,68
FC Basel,5900,2,16,10,6,51,25,26,58
Lucerne,5900,3,12,11,9,47,47,0,47
FC Zürich,5900,4,12,9,11,43,35,8,45
St Gallen,5900,5,13,5,14,44,57,-13,44
FC Thun,5900,6,11,6,15,45,57,-12,39
FC Lugano,5900,7,10,6,16,32,47,-15,36
Grasshoppers,5900,8,8,7,17,42,53,-11,31
FC Sion,5900,9,7,8,17,40,54,-14,29
Young Boys,5901,1,20,8,4,72,38,34,68
FC Basel,5901,2,17,9,6,54,29,25,60
Lucerne,5901,3,12,9,11,44,48,-4,45
St Gallen,5901,4,14,2,16,44,55,-11,44
FC Zürich,5901,5,11,9,12,46,37,9,42
Grasshoppers,5901,6,11,7,14,43,48,-5,40
FC Lugano,5901,7,11,6,15,35,51,-16,39
FC Thun,5901,8,9,6,17,43,59,-16,33
FC Sion,5901,9,7,8,17,40,56,-16,29
Young Boys,5902,1,22,6,4,74,36,38,72
FC Basel,5902,2,18,8,6,55,25,30,62
Lucerne,5902,3,13,9,10,41,42,-1,48
St Gallen,5902,4,15,2,15,44,56,-12,47
FC Zürich,5902,5,12,9,11,43,36,7,45
Grasshoppers,5902,6,10,8,14,41,47,-6,38
FC Thun,5902,7,9,6,17,41,57,-16,33
FC Lugano,5902,8,9,5,18,31,52,-21,32
FC Sion,5902,9,5,9,18,39,58,-19,24
Young Boys,5903,1,20,8,4,72,39,33,68
FC Basel,5903,2,16,8,8,51,29,22,56
Lucerne,5903,3,15,7,10,52,42,10,52
St Gallen,5903,4,15,2,15,42,58,-16,47
FC Zürich,5903,5,10,11,11,42,37,5,41
Grasshoppers,5903,6,10,7,15,46,56,-10,37
FC Thun,5903,7,10,6,16,47,59,-12,36
FC Lugano,5903,8,9,7,16,31,49,-18,34
FC Sion,5903,9,7,8,17,42,56,-14,29
Young Boys,5904,1,22,8,2,71,32,39,74
FC Basel,5904,2,19,7,6,57,26,31,64
Lucerne,5904,3,12,9,11,40,44,-4,45
St Gallen,5904,4,14,3,15,43,55,-12,45
FC Zürich,5904,5,11,10,11,44,37,7,43
Grasshoppers,5904,6,10,6,16,41,49,-8,36
FC Thun,5904,7,10,6,16,46,57,-11,36
FC Lugano,5904,8,9,8,15,32,49,-17,35
FC Sion,5904,9,5,7,20,35,60,-25,22
Young Boys,5905,1,21,7,4,69,34,35,70
FC Basel,5905,2,16,9,7,52,29,23,57
Lucerne,5905,3,14,9,9,46,39,7,51
St Gallen,5905,4,13,6,13,42,53,-11,45
FC Zürich,5905,5,11,9,12,41,37,4,42
Grasshoppers,5905,6,10,7,15,42,49,-7,37
FC Thun,5905,7,10,6,16,43,57,-14,36
FC Lugano,5905,8,9,6,17,28,52,-24,33
FC Sion,5905,9,6,9,17,40,53,-13,27
Young Boys,5906,1,21,6,5,70,36,34,69
FC Basel,5906,2,17,9,6,57,29,28,60
Lucerne,5906,3,13,10,9,45,41,4,49
St Gallen,5906,4,14,4,14,44,56,-12,46
FC Zürich,5906,5,9,12,11,38,35,3,39
FC Lugano,5906,6,11,5,16,30,46,-16,38
Grasshoppers,5906,7,10,7,15,39,49,-10,37
FC Thun,5906,8,8,7,17,42,60,-18,31
FC Sion,5906,9,6,10,16,39,52,-13,28
Young Boys,5907,1,21,7,4,68,38,30,70
FC Basel,5907,2,19,8,5,59,24,35,65
St Gallen,5907,3,14,4,14,42,56,-14,46
Lucerne,5907,4,12,9,11,39,40,-1,45
FC Zürich,5907,5,11,11,10,43,35,8,44
FC Thun,5907,6,9,7,16,45,61,-16,34
Grasshoppers,5907,7,8,9,15,40,49,-9,33
FC Lugano,5907,8,9,6,17,29,49,-20,33
FC Sion,5907,9,6,9,17,44,57,-13,27
Young Boys,5908,1,21,9,2,70,33,37,72
FC Basel,5908,2,15,9,8,49,28,21,54
Lucerne,5908,3,13,10,9,45,42,3,49
St Gallen,5908,4,14,3,15,39,53,-14,45
FC Zürich,5908,5,11,9,12,41,38,3,42
FC Lugano,5908,6,10,7,15,33,48,-15,37
FC Thun,5908,7,9,8,15,47,60,-13,35
Grasshoppers,5908,8,9,7,16,43,52,-9,34
FC Sion,5908,9,7,8,17,44,57,-13,29
Young Boys,5909,1,22,7,3,71,34,37,73
FC Basel,5909,2,19,7,6,54,25,29,64
St Gallen,5909,3,15,3,14,42,52,-10,48
Lucerne,5909,4,12,9,11,39,42,-3,45
FC Zürich,5909,5,10,11,11,43,38,5,41
Grasshoppers,5909,6,9,7,16,40,49,-9,34
FC Lugano,5909,7,9,7,16,30,47,-17,34
FC Sion,5909,8,7,9,16,41,52,-11,30
FC Thun,5909,9,8,6,18,42,63,-21,30
Young Boys,5910,1,23,6,3,75,36,39,75
FC Basel,5910,2,17,8,7,54,29,25,59
St Gallen,5910,3,14,4,14,39,50,-11,46
Lucerne,5910,4,12,8,12,39,44,-5,44
FC Zürich,5910,5,10,11,11,38,34,4,41
FC Thun,5910,6,10,7,15,47,57,-10,37
FC Lugano,5910,7,10,6,16,31,47,-16,36
Grasshoppers,5910,8,9,6,17,42,53,-11,33
FC Sion,5910,9,7,8,17,38,53,-15,29
Young Boys,5911,1,20,7,5,70,38,32,67
FC Basel,5911,2,17,9,6,55,28,27,60
Lucerne,5911,3,13,7,12,42,47,-5,46
FC Lugano,5911,4,13,5,14,36,45,-9,44
St Gallen,5911,5,14,2,16,41,55,-14,44
FC Zürich,5911,6,9,11,12,40,39,1,38
Grasshoppers,5911,7,9,9,14,41,47,-6,36
FC Thun,5911,8,9,8,15,41,55,-14,35
FC Sion,5911,9,7,8,17,41,53,-12,29
Young Boys,5912,1,22,6,4,68,33,35,72
FC Basel,5912,2,18,8,6,54,25,29,62
Lucerne,5912,3,13,9,10,42,40,2,48
St Gallen,5912,4,14,2,16,39,54,-15,44
FC Zürich,5912,5,10,10,12,40,36,4,40
FC Lugano,5912,6,11,6,15,29,44,-15,39
Grasshoppers,5912,7,10,7,15,40,47,-7,37
FC Thun,5912,8,8,7,17,41,62,-21,31
FC Sion,5912,9,7,7,18,42,54,-12,28
Young Boys,5913,1,22,7,3,68,33,35,73
FC Basel,5913,2,18,8,6,53,26,27,62
St Gallen,5913,3,15,3,14,45,55,-10,48
Lucerne,5913,4,12,9,11,41,43,-2,45
FC Zürich,5913,5,11,10,11,43,36,7,43
Grasshoppers,5913,6,8,9,15,41,50,-9,33
FC Thun,5913,7,9,6,17,44,60,-16,33
FC Lugano,5913,8,9,6,17,31,49,-18,33
FC Sion,5913,9,7,8,17,41,55,-14,29
Young Boys,5914,1,22,6,4,76,39,37,72
FC Basel,5914,2,18,7,7,53,30,23,61
Lucerne,5914,3,13,7,12,42,44,-2,46
St Gallen,5914,4,14,3,15,41,54,-13,45
Grasshoppers,5914,5,11,7,14,47,48,-1,40
FC Zürich,5914,6,9,12,11,39,36,3,39
FC Lugano,5914,7,9,7,16,29,48,-19,34
FC Sion,5914,8,7,10,15,43,53,-10,31
FC Thun,5914,9,8,7,17,45,63,-18,31
Young Boys,5915,1,21,8,3,75,38,37,71
FC Basel,5915,2,20,7,5,61,23,38,67
Lucerne,5915,3,13,9,10,43,42,1,48
St Gallen,5915,4,13,3,16,42,59,-17,42
FC Zürich,5915,5,10,10,12,40,37,3,40
Grasshoppers,5915,6,10,7,15,46,54,-8,37
FC Lugano,5915,7,10,6,16,29,48,-19,36
FC Thun,5915,8,9,5,18,41,64,-23,32
FC Sion,5915,9,7,7,18,43,55,-12,28
Young Boys,5916,1,22,8,2,73,33,40,74
FC Basel,5916,2,18,9,5,56,23,33,63
Lucerne,5916,3,13,7,12,47,45,2,46
St Gallen,5916,4,14,4,14,46,56,-10,46
FC Zürich,5916,5,10,12,10,39,34,5,42
FC Thun,5916,6,10,6,16,46,61,-15,36
Grasshoppers,5916,7,9,6,17,42,58,-16,33
FC Lugano,5916,8,9,6,17,31,55,-24,33
FC Sion,5916,9,5,10,17,41,56,-15,25
Young Boys,5917,1,22,6,4,72,36,36,72
FC Basel,5917,2,18,9,5,57,26,31,63
St Gallen,5917,3,15,3,14,43,55,-12,48
Lucerne,5917,4,13,7,12,45,45,0,46
FC Zürich,5917,5,10,11,11,43,40,3,41
FC Thun,5917,6,10,5,17,44,63,-19,35
Grasshoppers,5917,7,9,6,17,40,50,-10,33
FC Sion,5917,8,8,8,16,50,56,-6,32
FC Lugano,5917,9,9,5,18,30,53,-23,32
Young Boys,5918,1,22,7,3,73,37,36,73
FC Basel,5918,2,19,8,5,62,24,38,65
St Gallen,5918,3,14,3,15,42,56,-14,45
Lucerne,5918,4,12,8,12,39,46,-7,44
FC Zürich,5918,5,9,11,12,39,39,0,38
Grasshoppers,5918,6,10,6,16,41,50,-9,36
FC Lugano,5918,7,10,6,16,33,48,-15,36
FC Sion,5918,8,8,8,16,42,53,-11,32
FC Thun,5918,9,8,7,17,42,60,-18,31
Young Boys,5919,1,22,7,3,75,35,40,73
FC Basel,5919,2,17,8,7,59,33,26,59
St Gallen,5919,3,14,3,15,41,54,-13,45
Lucerne,5919,4,12,8,12,43,45,-2,44
FC Zürich,5919,5,11,9,12,44,42,2,42
FC Lugano,5919,6,11,5,16,33,47,-14,38
FC Thun,5919,7,10,5,17,44,62,-18,35
Grasshoppers,5919,8,9,7,16,40,52,-12,34
FC Sion,5919,9,8,8,16,41,50,-9,32
Young Boys,5920,1,22,8,2,70,32,38,74
FC Basel,5920,2,19,7,6,57,25,32,64
Lucerne,5920,3,12,10,10,45,42,3,46
St Gallen,5920,4,13,4,15,42,59,-17,43
FC Zürich,5920,5,11,9,12,39,34,5,42
FC Lugano,5920,6,10,6,16,31,51,-20,36
Grasshoppers,5920,7,9,8,15,42,48,-6,35
FC Thun,5920,8,9,5,18,43,61,-18,32
FC Sion,5920,9,7,7,18,41,58,-17,28
Young Boys,5921,1,21,8,3,75,35,40,71
FC Basel,5921,2,17,10,5,55,24,31,61
Lucerne,5921,3,13,9,10,45,47,-2,48
FC Zürich,5921,4,12,10,10,42,34,8,46
St Gallen,5921,5,14,2,16,43,56,-13,44
FC Lugano,5921,6,9,7,16,32,51,-19,34
Grasshoppers,5921,7,9,6,17,42,53,-11,33
FC Thun,5921,8,9,6,17,41,61,-20,33
FC Sion,5921,9,7,8,17,44,58,-14,29
Young Boys,5922,1,21,7,4,71,35,36,70
FC Basel,5922,2,16,8,8,55,32,23,56
Lucerne,5922,3,14,9,9,44,40,4,51
FC Zürich,5922,4,12,10,10,45,36,9,46
St Gallen,5922,5,14,4,14,43,54,-11,46
Grasshoppers,5922,6,10,7,15,45,51,-6,37
FC Lugano,5922,7,9,6,17,32,50,-18,33
FC Thun,5922,8,9,5,18,45,67,-22,32
FC Sion,5922,9,7,8,17,42,57,-15,29
Young Boys,5923,1,21,7,4,71,37,34,70
FC Basel,5923,2,19,7,6,56,28,28,64
Lucerne,5923,3,13,8,11,49,45,4,47
FC Zürich,5923,4,12,9,11,44,37,7,45
St Gallen,5923,5,13,3,16,43,60,-17,42
Grasshoppers,5923,6,11,7,14,48,48,0,40
FC Lugano,5923,7,10,5,17,34,55,-21,35
FC Thun,5923,8,9,6,17,45,62,-17,33
FC Sion,5923,9,5,10,17,40,58,-18,25
Young Boys,5924,1,21,7,4,77,37,40,70
FC Basel,5924,2,17,8,7,54,26,28,59
St Gallen,5924,3,16,2,14,45,53,-8,50
Lucerne,5924,4,12,8,12,42,45,-3,44
FC Zürich,5924,5,11,10,11,42,37,5,43
Grasshoppers,5924,6,10,6,16,40,48,-8,36
FC Thun,5924,7,10,6,16,45,58,-13,36
FC Lugano,5924,8,10,6,16,32,53,-21,36
FC Sion,5924,9,7,7,18,40,60,-20,28
Young Boys,5925,1,23,7,2,72,31,41,76
FC Basel,5925,2,17,9,6,56,25,31,60
Lucerne,5925,3,14,7,11,43,44,-1,49
St Gallen,5925,4,15,2,15,43,57,-14,47
FC Zürich,5925,5,10,10,12,40,38,2,40
FC Thun,5925,6,11,6,15,51,57,-6,39
FC Lugano,5925,7,9,5,18,29,50,-21,32
Grasshoppers,5925,8,8,7,17,39,53,-14,31
FC Sion,5925,9,7,7,18,41,59,-18,28
Young Boys,5926,1,22,6,4,69,33,36,72
FC Basel,5926,2,16,8,8,50,31,19,56
St Gallen,5926,3,14,3,15,46,58,-12,45
Lucerne,5926,4,11,11,10,42,44,-2,44
FC Zürich,5926,5,11,10,11,41,36,5,43
FC Thun,5926,6,11,6,15,46,55,-9,39
FC Lugano,5926,7,11,6,15,33,48,-15,39
Grasshoppers,5926,8,9,7,16,39,48,-9,34
FC Sion,5926,9,7,7,18,38,51,-13,28
Young Boys,5927,1,22,7,3,71,32,39,73
FC Basel,5927,2,17,8,7,51,24,27,59
St Gallen,5927,3,16,3,13,43,51,-8,51
Lucerne,5927,4,13,8,11,43,43,0,47
FC Zürich,5927,5,11,10,11,42,38,4,43
FC Lugano,5927,6,10,6,16,30,46,-16,36
Grasshoppers,5927,7,9,6,17,40,52,-12,33
FC Thun,5927,8,9,5,18,42,59,-17,32
FC Sion,5927,9,7,7,18,39,56,-17,28
Young Boys,5928,1,23,7,2,76,33,43,76
FC Basel,5928,2,18,9,5,59,29,30,63
Lucerne,5928,3,13,8,11,45,45,0,47
FC Zürich,5928,4,11,9,12,41,38,3,42
St Gallen,5928,5,13,3,16,43,59,-16,42
Grasshoppers,5928,6,9,8,15,41,51,-10,35
FC Lugano,5928,7,9,6,17,30,50,-20,33
FC Sion,5928,8,8,8,16,43,51,-8,32
FC Thun,5928,9,8,6,18,42,64,-22,30
Young Boys,5929,1,23,6,3,72,34,38,75
FC Basel,5929,2,19,7,6,54,22,32,64
Lucerne,5929,3,13,8,11,43,45,-2,47
St Gallen,5929,4,14,3,15,41,53,-12,45
FC Lugano,5929,5,11,5,16,32,47,-15,38
FC Zürich,5929,6,9,10,13,39,40,-1,37
FC Thun,5929,7,10,5,17,44,60,-16,35
Grasshoppers,5929,8,8,7,17,39,51,-12,31
FC Sion,5929,9,7,9,16,39,51,-12,30
Young Boys,5930,1,20,9,3,67,33,34,69
FC Basel,5930,2,19,8,5,58,27,31,65
St Gallen,5930,3,15,3,14,45,56,-11,48
Lucerne,5930,4,12,9,11,45,48,-3,45
FC Zürich,5930,5,11,9,12,44,38,6,42
FC Thun,5930,6,10,6,16,45,59,-14,36
Grasshoppers,5930,7,9,8,15,43,51,-8,35
FC Lugano,5930,8,10,5,17,34,48,-14,35
FC Sion,5930,9,5,9,18,36,57,-21,24
Young Boys,5931,1,23,6,3,72,34,38,75
FC Basel,5931,2,18,7,7,57,28,29,61
St Gallen,5931,3,14,4,14,46,53,-7,46
Lucerne,5931,4,11,9,12,41,50,-9,42
FC Lugano,5931,5,12,5,15,31,48,-17,41
FC Zürich,5931,6,10,9,13,41,39,2,39
FC Thun,5931,7,11,5,16,47,55,-8,38
Grasshoppers,5931,8,9,7,16,42,52,-10,34
FC Sion,5931,9,6,8,18,37,55,-18,26
Young Boys,5932,1,21,9,2,71,33,38,72
FC Basel,5932,2,18,9,5,52,23,29,63
Lucerne,5932,3,14,9,9,47,38,9,51
St Gallen,5932,4,14,2,16,40,58,-18,44
FC Zürich,5932,5,9,12,11,42,39,3,39
FC Lugano,5932,6,10,6,16,30,49,-19,36
Grasshoppers,5932,7,9,7,16,42,52,-10,34
FC Thun,5932,8,8,7,17,46,64,-18,31
FC Sion,5932,9,6,9,17,41,55,-14,27
Young Boys,5933,1,22,8,2,73,35,38,74
FC Basel,5933,2,17,7,8,57,29,28,58
St Gallen,5933,3,15,4,13,43,51,-8,49
FC Zürich,5933,4,12,9,11,42,37,5,45
Lucerne,5933,5,12,9,11,43,45,-2,45
Grasshoppers,5933,6,8,9,15,40,50,-10,33
FC Lugano,5933,7,9,5,18,30,52,-22,32
FC Sion,5933,8,7,10,15,43,52,-9,31
FC Thun,5933,9,8,7,17,42,62,-20,31
Young Boys,5934,1,22,7,3,71,32,39,73
FC Basel,5934,2,17,8,7,55,28,27,59
St Gallen,5934,3,15,3,14,43,55,-12,48
Lucerne,5934,4,12,11,9,43,43,0,47
FC Zürich,5934,5,9,11,12,41,41,0,38
FC Thun,5934,6,11,5,16,49,59,-10,38
FC Lugano,5934,7,9,7,16,31,48,-17,34
Grasshoppers,5934,8,9,6,17,40,55,-15,33
FC Sion,5934,9,7,8,17,43,55,-12,29
Young Boys,5935,1,21,6,5,71,34,37,69
FC Basel,5935,2,17,10,5,55,27,28,61
St Gallen,5935,3,13,4,15,45,58,-13,43
Lucerne,5935,4,11,9,12,39,44,-5,42
FC Zürich,5935,5,10,11,11,41,37,4,41
Grasshoppers,5935,6,11,6,15,42,48,-6,39
FC Lugano,5935,7,11,5,16,32,50,-18,38
FC Sion,5935,8,9,8,15,46,54,-8,35
FC Thun,5935,9,9,5,18,43,62,-19,32
Young Boys,5936,1,22,6,4,72,34,38,72
FC Basel,5936,2,20,7,5,58,26,32,67
St Gallen,5936,3,16,2,14,44,52,-8,50
Lucerne,5936,4,12,7,13,41,46,-5,43
FC Zürich,5936,5,10,11,11,42,38,4,41
FC Lugano,5936,6,11,6,15,30,45,-15,39
FC Thun,5936,7,9,6,17,43,59,-16,33
Grasshoppers,5936,8,8,7,17,37,49,-12,31
FC Sion,5936,9,5,10,17,38,56,-18,25
Young Boys,5937,1,22,7,3,73,34,39,73
FC Basel,5937,2,18,8,6,54,26,28,62
Lucerne,5937,3,14,7,11,43,43,0,49
St Gallen,5937,4,13,2,17,44,59,-15,41
FC Zürich,5937,5,10,10,12,42,41,1,40
FC Thun,5937,6,10,6,16,45,57,-12,36
FC Lugano,5937,7,10,5,17,31,50,-19,35
Grasshoppers,5937,8,9,7,16,39,50,-11,34
FC Sion,5937,9,7,10,15,45,56,-11,31
Young Boys,5938,1,20,6,6,69,40,29,66
FC Basel,5938,2,18,7,7,53,27,26,61
St Gallen,5938,3,16,3,13,47,52,-5,51
Lucerne,5938,4,13,7,12,40,43,-3,46
FC Zürich,5938,5,11,9,12,44,38,6,42
FC Lugano,5938,6,11,5,16,32,51,-19,38
Grasshoppers,5938,7,10,6,16,45,48,-3,36
FC Sion,5938,8,8,8,16,46,54,-8,32
FC Thun,5938,9,9,5,18,42,65,-23,32
Young Boys,5939,1,21,8,3,74,36,38,71
FC Basel,5939,2,20,7,5,59,24,35,67
St Gallen,5939,3,15,3,14,42,53,-11,48
Lucerne,5939,4,11,8,13,38,48,-10,41
FC Lugano,5939,5,11,7,14,34,45,-11,40
FC Zürich,5939,6,10,9,13,40,40,0,39
Grasshoppers,5939,7,9,7,16,40,49,-9,34
FC Thun,5939,8,9,5,18,41,59,-18,32
FC Sion,5939,9,7,8,17,40,54,-14,29
Young Boys,5940,1,20,9,3,67,33,34,69
FC Basel,5940,2,17,9,6,52,23,29,60
Lucerne,5940,3,13,10,9,43,41,2,49
FC Zürich,5940,4,12,9,11,47,37,10,45
St Gallen,5940,5,13,3,16,41,58,-17,42
Grasshoppers,5940,6,10,8,14,45,49,-4,38
FC Thun,5940,7,10,5,17,44,64,-20,35
FC Lugano,5940,8,9,6,17,32,51,-19,33
FC Sion,5940,9,6,9,17,41,56,-15,27
Young Boys,5941,1,22,6,4,72,38,34,72
FC Basel,5941,2,17,7,8,55,31,24,58
Lucerne,5941,3,13,9,10,43,43,0,48
St Gallen,5941,4,14,5,13,46,55,-9,47
FC Lugano,5941,5,10,7,15,29,45,-16,37
Grasshoppers,5941,6,10,6,16,46,48,-2,36
FC Zürich,5941,7,9,9,14,37,40,-3,36
FC Thun,5941,8,10,5,17,43,59,-16,35
FC Sion,5941,9,8,8,16,42,54,-12,32
Young Boys,5942,1,20,9,3,69,36,33,69
FC Basel,5942,2,18,8,6,56,25,31,62
Lucerne,5942,3,13,9,10,40,39,1,48
St Gallen,5942,4,14,2,16,40,55,-15,44
FC Zürich,5942,5,11,10,11,42,36,6,43
FC Lugano,5942,6,11,6,15,31,46,-15,39
FC Thun,5942,7,9,7,16,43,59,-16,34
Grasshoppers,5942,8,8,9,15,40,49,-9,33
FC Sion,5942,9,6,8,18,40,56,-16,26
Young Boys,5943,1,20,6,6,66,39,27,66
FC Basel,5943,2,18,7,7,56,28,28,61
St Gallen,5943,3,17,2,13,47,51,-4,53
Lucerne,5943,4,13,7,12,43,43,0,46
FC Lugano,5943,5,12,5,15,32,46,-14,41
FC Zürich,5943,6,9,11,12,41,39,2,38
Grasshoppers,5943,7,10,7,15,48,51,-3,37
FC Thun,5943,8,8,7,17,43,62,-19,31
FC Sion,5943,9,7,8,17,41,58,-17,29
Young Boys,5944,1,20,9,3,73,35,38,69
FC Basel,5944,2,17,9,6,51,27,24,60
Lucerne,5944,3,14,7,11,46,48,-2,49
St Gallen,5944,4,14,3,15,45,54,-9,45
FC Zürich,5944,5,11,10,11,41,39,2,43
Grasshoppers,5944,6,10,7,15,46,54,-8,37
FC Lugano,5944,7,10,6,16,31,47,-16,36
FC Thun,5944,8,9,6,17,46,60,-14,33
FC Sion,5944,9,6,9,17,40,55,-15,27
Young Boys,5945,1,22,6,4,68,33,35,72
FC Basel,5945,2,17,8,7,51,26,25,59
Lucerne,5945,3,14,7,11,43,43,0,49
St Gallen,5945,4,14,3,15,45,57,-12,45
FC Zürich,5945,5,11,9,12,41,36,5,42
Grasshoppers,5945,6,11,6,15,44,46,-2,39
FC Thun,5945,7,10,6,16,44,57,-13,36
FC Lugano,5945,8,10,5,17,32,50,-18,35
FC Sion,5945,9,6,8,18,39,59,-20,26
Young Boys,5946,1,22,6,4,70,34,36,72
FC Basel,5946,2,19,8,5,59,26,33,65
St Gallen,5946,3,14,3,15,44,54,-10,45
Lucerne,5946,4,11,8,13,39,45,-6,41
FC Lugano,5946,5,12,5,15,36,44,-8,41
FC Zürich,5946,6,9,12,11,39,38,1,39
Grasshoppers,5946,7,9,7,16,39,50,-11,34
FC Thun,5946,8,9,7,16,43,61,-18,34
FC Sion,5946,9,6,10,16,38,55,-17,28
Young Boys,5947,1,22,7,3,70,36,34,73
FC Basel,5947,2,17,9,6,55,27,28,60
St Gallen,5947,3,15,3,14,44,55,-11,48
Lucerne,5947,4,12,7,13,42,47,-5,43
FC Lugano,5947,5,12,6,14,35,45,-10,42
FC Zürich,5947,6,10,10,12,41,36,5,40
FC Thun,5947,7,11,5,16,47,58,-11,38
Grasshoppers,5947,8,9,6,17,41,52,-11,33
FC Sion,5947,9,6,7,19,40,59,-19,25
Young Boys,5948,1,22,7,3,79,36,43,73
FC Basel,5948,2,17,10,5,52,24,28,61
St Gallen,5948,3,14,3,15,44,56,-12,45
Lucerne,5948,4,12,8,12,41,53,-12,44
FC Zürich,5948,5,11,10,11,43,34,9,43
FC Thun,5948,6,10,6,16,46,56,-10,36
FC Lugano,5948,7,10,6,16,31,50,-19,36
Grasshoppers,5948,8,8,7,17,44,56,-12,31
FC Sion,5948,9,8,7,17,45,60,-15,31
Young Boys,5949,1,21,7,4,70,36,34,70
FC Basel,5949,2,19,7,6,59,26,33,64
St Gallen,5949,3,15,2,15,46,56,-10,47
FC Zürich,5949,4,11,9,12,42,40,2,42
Lucerne,5949,5,11,9,12,45,52,-7,42
FC Lugano,5949,6,12,5,15,38,48,-10,41
Grasshoppers,5949,7,10,8,14,41,47,-6,38
FC Thun,5949,8,9,7,16,46,61,-15,34
FC Sion,5949,9,5,8,19,37,58,-21,23
Young Boys,5950,1,21,7,4,76,41,35,70
FC Basel,5950,2,18,8,6,52,23,29,62
Lucerne,5950,3,12,7,13,41,46,-5,43
St Gallen,5950,4,13,2,17,40,57,-17,41
FC Zürich,5950,5,9,13,10,39,35,4,40
FC Thun,5950,6,11,6,15,44,53,-9,39
FC Lugano,5950,7,11,6,15,33,49,-16,39
Grasshoppers,5950,8,10,7,15,43,50,-7,37
FC Sion,5950,9,7,8,17,42,56,-14,29
Young Boys,5951,1,23,6,3,74,35,39,75
FC Basel,5951,2,19,7,6,53,24,29,64
FC Zürich,5951,3,12,10,10,44,35,9,46
Lucerne,5951,4,13,7,12,42,45,-3,46
St Gallen,5951,5,14,2,16,46,63,-17,44
FC Lugano,5951,6,10,6,16,35,51,-16,36
FC Thun,5951,7,10,5,17,46,58,-12,35
Grasshoppers,5951,8,9,6,17,43,56,-13,33
FC Sion,5951,9,6,7,19,40,56,-16,25
Young Boys,5952,1,22,8,2,71,33,38,74
FC Basel,5952,2,15,10,7,50,31,19,55
St Gallen,5952,3,14,3,15,42,57,-15,45
FC Zürich,5952,4,11,11,10,41,34,7,44
Lucerne,5952,5,12,7,13,41,43,-2,43
FC Lugano,5952,6,11,6,15,31,45,-14,39
Grasshoppers,5952,7,9,8,15,41,49,-8,35
FC Thun,5952,8,9,7,16,44,58,-14,34
FC Sion,5952,9,6,10,16,38,49,-11,28
Young Boys,5953,1,23,7,2,76,32,44,76
FC Basel,5953,2,19,7,6,56,25,31,64
Lucerne,5953,3,12,9,11,46,46,0,45
St Gallen,5953,4,14,3,15,45,54,-9,45
FC Zürich,5953,5,11,10,11,43,36,7,43
FC Lugano,5953,6,11,5,16,33,54,-21,38
FC Thun,5953,7,10,6,16,45,58,-13,36
Grasshoppers,5953,8,8,6,18,37,56,-19,30
FC Sion,5953,9,6,7,19,39,59,-20,25
Young Boys,5954,1,22,8,2,74,32,42,74
FC Basel,5954,2,18,8,6,52,25,27,62
St Gallen,5954,3,15,3,14,45,54,-9,48
Lucerne,5954,4,12,8,12,42,48,-6,44
FC Zürich,5954,5,10,10,12,40,37,3,40
FC Thun,5954,6,11,5,16,44,57,-13,38
FC Lugano,5954,7,10,7,15,32,47,-15,37
Grasshoppers,5954,8,9,7,16,41,50,-9,34
FC Sion,5954,9,5,8,19,37,57,-20,23
Young Boys,5955,1,22,7,3,69,32,37,73
FC Basel,5955,2,16,10,6,48,22,26,58
St Gallen,5955,3,14,5,13,43,53,-10,47
Lucerne,5955,4,12,8,12,41,44,-3,44
FC Zürich,5955,5,9,11,12,36,36,0,38
FC Lugano,5955,6,10,7,15,28,44,-16,37
Grasshoppers,5955,7,9,7,16,40,51,-11,34
FC Thun,5955,8,9,7,16,41,56,-15,34
FC Sion,5955,9,8,8,16,44,52,-8,32
Young Boys,5956,1,20,8,4,68,34,34,68
FC Basel,5956,2,18,8,6,54,23,31,62
FC Zürich,5956,3,13,9,10,41,33,8,48
Lucerne,5956,4,13,8,11,41,45,-4,47
St Gallen,5956,5,14,4,14,40,51,-11,46
Grasshoppers,5956,6,8,10,14,45,53,-8,34
FC Thun,5956,7,9,6,17,44,60,-16,33
FC Lugano,5956,8,9,6,17,27,46,-19,33
FC Sion,5956,9,6,9,17,39,54,-15,27
Young Boys,5957,1,20,8,4,72,33,39,68
FC Basel,5957,2,17,9,6,53,26,27,60
Lucerne,5957,3,13,10,9,40,39,1,49
St Gallen,5957,4,15,4,13,42,51,-9,49
FC Zürich,5957,5,10,10,12,40,40,0,40
FC Lugano,5957,6,10,6,16,29,51,-22,36
Grasshoppers,5957,7,9,8,15,37,47,-10,35
FC Thun,5957,8,10,5,17,45,56,-11,35
FC Sion,5957,9,6,8,18,37,52,-15,26
Young Boys,5958,1,20,8,4,69,36,33,68
FC Basel,5958,2,15,10,7,52,30,22,55
St Gallen,5958,3,15,4,13,44,51,-7,49
Lucerne,5958,4,12,10,10,41,44,-3,46
FC Zürich,5958,5,12,9,11,44,36,8,45
Grasshoppers,5958,6,10,7,15,41,48,-7,37
FC Thun,5958,7,10,6,16,42,56,-14,36
FC Lugano,5958,8,9,5,18,29,51,-22,32
FC Sion,5958,9,7,9,16,40,50,-10,30
Young Boys,5959,1,21,7,4,72,39,33,70
FC Basel,5959,2,19,8,5,61,24,37,65
Lucerne,5959,3,12,9,11,41,42,-1,45
St Gallen,5959,4,13,3,16,38,55,-17,42
FC Zürich,5959,5,10,10,12,38,36,2,40
Grasshoppers,5959,6,11,6,15,41,46,-5,39
FC Lugano,5959,7,11,5,16,33,51,-18,38
FC Thun,5959,8,10,6,16,42,57,-15,36
FC Sion,5959,9,6,8,18,38,54,-16,26
Young Boys,5960,1,20,7,5,68,34,34,67
FC Basel,5960,2,16,8,8,52,29,23,56
Lucerne,5960,3,15,8,9,48,44,4,53
St Gallen,5960,4,15,3,14,44,55,-11,48
FC Zürich,5960,5,11,10,11,44,39,5,43
Grasshoppers,5960,6,11,7,14,42,47,-5,40
FC Lugano,5960,7,10,6,16,33,50,-17,36
FC Thun,5960,8,9,6,17,43,60,-17,33
FC Sion,5960,9,5,9,18,38,54,-16,24
Young Boys,5961,1,22,7,3,70,35,35,73
FC Basel,5961,2,19,7,6,53,23,30,64
St Gallen,5961,3,16,2,14,48,54,-6,50
Lucerne,5961,4,11,7,14,38,45,-7,40
FC Zürich,5961,5,10,9,13,38,38,0,39
FC Thun,5961,6,11,6,15,43,54,-11,39
FC Lugano,5961,7,11,6,15,34,46,-12,39
Grasshoppers,5961,8,9,7,16,39,49,-10,34
FC Sion,5961,9,5,9,18,42,61,-19,24
Young Boys,5962,1,22,6,4,80,37,43,72
FC Basel,5962,2,17,9,6,54,26,28,60
St Gallen,5962,3,15,4,13,47,53,-6,49
Lucerne,5962,4,12,7,13,40,47,-7,43
FC Zürich,5962,5,11,9,12,44,41,3,42
FC Lugano,5962,6,11,6,15,34,52,-18,39
FC Thun,5962,7,10,7,15,47,58,-11,37
Grasshoppers,5962,8,9,6,17,43,57,-14,33
FC Sion,5962,9,6,8,18,43,61,-18,26
Young Boys,5963,1,22,8,2,73,34,39,74
FC Basel,5963,2,15,7,10,48,31,17,52
Lucerne,5963,3,14,8,10,41,41,0,50
FC Zürich,5963,4,12,10,10,44,35,9,46
St Gallen,5963,5,14,3,15,42,54,-12,45
FC Thun,5963,6,11,5,16,47,58,-11,38
FC Lugano,5963,7,10,6,16,30,46,-16,36
Grasshoppers,5963,8,8,8,16,41,52,-11,32
FC Sion,5963,9,6,9,17,40,55,-15,27
Young Boys,5964,1,20,7,5,68,39,29,67
FC Basel,5964,2,18,8,6,56,27,29,62
Lucerne,5964,3,16,7,9,48,39,9,55
St Gallen,5964,4,13,5,14,42,55,-13,44
FC Zürich,5964,5,10,9,13,40,38,2,39
FC Lugano,5964,6,10,7,15,31,47,-16,37
FC Thun,5964,7,10,6,16,45,57,-12,36
Grasshoppers,5964,8,8,7,17,39,51,-12,31
FC Sion,5964,9,7,8,17,39,55,-16,29
Young Boys,5965,1,20,7,5,68,37,31,67
FC Basel,5965,2,18,8,6,53,25,28,62
Lucerne,5965,3,13,9,10,41,44,-3,48
St Gallen,5965,4,14,5,13,42,52,-10,47
FC Zürich,5965,5,11,10,11,46,38,8,43
Grasshoppers,5965,6,10,7,15,45,50,-5,37
FC Lugano,5965,7,10,6,16,31,47,-16,36
FC Thun,5965,8,9,5,18,42,60,-18,32
FC Sion,5965,9,6,9,17,41,56,-15,27
Young Boys,5966,1,21,8,3,73,35,38,71
FC Basel,5966,2,19,8,5,58,22,36,65
Lucerne,5966,3,12,9,11,41,47,-6,45
St Gallen,5966,4,14,3,15,44,55,-11,45
FC Zürich,5966,5,10,11,11,42,39,3,41
Grasshoppers,5966,6,10,7,15,44,51,-7,37
FC Lugano,5966,7,10,6,16,32,50,-18,36
FC Thun,5966,8,8,6,18,46,68,-22,30
FC Sion,5966,9,7,8,17,41,54,-13,29
Young Boys,5967,1,20,8,4,75,38,37,68
FC Basel,5967,2,19,8,5,54,23,31,65
St Gallen,5967,3,14,4,14,44,56,-12,46
FC Zürich,5967,4,11,11,10,43,33,10,44
Lucerne,5967,5,12,8,12,40,43,-3,44
FC Lugano,5967,6,10,7,15,31,50,-19,37
FC Thun,5967,7,10,5,17,44,60,-16,35
Grasshoppers,5967,8,9,7,16,41,52,-11,34
FC Sion,5967,9,5,10,17,40,57,-17,25
Young Boys,5968,1,20,8,4,66,35,31,68
FC Basel,5968,2,17,9,6,55,27,28,60
St Gallen,5968,3,16,2,14,45,54,-9,50
Lucerne,5968,4,13,8,11,43,44,-1,47
FC Zürich,5968,5,11,10,11,42,37,5,43
FC Lugano,5968,6,10,5,17,33,48,-15,35
FC Sion,5968,7,9,7,16,43,52,-9,34
Grasshoppers,5968,8,9,6,17,41,53,-12,33
FC Thun,5968,9,9,5,18,44,62,-18,32
Young Boys,5969,1,20,7,5,66,37,29,67
FC Basel,5969,2,18,7,7,52,24,28,61
FC Zürich,5969,3,12,10,10,44,36,8,46
Lucerne,5969,4,13,7,12,41,44,-3,46
St Gallen,5969,5,14,2,16,41,55,-14,44
FC Lugano,5969,6,12,5,15,34,45,-11,41
Grasshoppers,5969,7,10,8,14,41,46,-5,38
FC Thun,5969,8,8,7,17,43,61,-18,31
FC Sion,5969,9,7,7,18,39,53,-14,28
Young Boys,5970,1,21,8,3,71,35,36,71
FC Basel,5970,2,17,10,5,55,27,28,61
St Gallen,5970,3,14,4,14,44,55,-11,46
Lucerne,5970,4,11,9,12,40,44,-4,42
FC Lugano,5970,5,11,6,15,33,49,-16,39
FC Zürich,5970,6,9,11,12,39,41,-2,38
FC Thun,5970,7,10,5,17,44,56,-12,35
Grasshoppers,5970,8,9,7,16,38,49,-11,34
FC Sion,5970,9,8,8,16,42,50,-8,32
Young Boys,5971,1,21,8,3,70,35,35,71
FC Basel,5971,2,16,8,8,50,26,24,56
St Gallen,5971,3,16,3,13,42,50,-8,51
Lucerne,5971,4,12,10,10,39,39,0,46
FC Zürich,5971,5,12,9,11,40,35,5,45
FC Lugano,5971,6,10,6,16,32,48,-16,36
FC Thun,5971,7,10,5,17,45,61,-16,35
Grasshoppers,5971,8,8,9,15,39,48,-9,33
FC Sion,5971,9,6,8,18,42,57,-15,26
Young Boys,5972,1,22,6,4,68,34,34,72
FC Basel,5972,2,20,7,5,60,23,37,67
Lucerne,5972,3,12,8,12,39,45,-6,44
FC Zürich,5972,4,11,10,11,43,36,7,43
St Gallen,5972,5,13,3,16,42,59,-17,42
Grasshoppers,5972,6,10,7,15,43,48,-5,37
FC Lugano,5972,7,10,5,17,30,48,-18,35
FC Sion,5972,8,8,8,16,43,50,-7,32
FC Thun,5972,9,8,6,18,42,67,-25,30
Young Boys,5973,1,23,6,3,70,33,37,75
FC Basel,5973,2,18,8,6,55,28,27,62
St Gallen,5973,3,15,3,14,47,54,-7,48
Lucerne,5973,4,11,9,12,37,43,-6,42
FC Lugano,5973,5,11,5,16,34,48,-14,38
FC Zürich,5973,6,9,9,14,38,43,-5,36
FC Thun,5973,7,10,6,16,46,58,-12,36
Grasshoppers,5973,8,9,8,15,41,48,-7,35
FC Sion,5973,9,7,8,17,43,56,-13,29
Young Boys,5974,1,22,8,2,71,33,38,74
FC Basel,5974,2,16,8,8,50,26,24,56
St Gallen,5974,3,16,3,13,46,53,-7,51
Lucerne,5974,4,13,8,11,43,44,-1,47
FC Zürich,5974,5,9,12,11,41,38,3,39
FC Thun,5974,6,10,6,16,43,58,-15,36
FC Lugano,5974,7,9,8,15,32,48,-16,35
Grasshoppers,5974,8,8,8,16,40,51,-11,32
FC Sion,5974,9,5,11,16,41,56,-15,26
Young Boys,5975,1,22,7,3,73,33,40,73
FC Basel,5975,2,18,8,6,56,25,31,62
Lucerne,5975,3,13,8,11,45,47,-2,47
St Gallen,5975,4,14,4,14,44,55,-11,46
FC Zürich,5975,5,11,9,12,39,38,1,42
FC Lugano,5975,6,12,5,15,33,47,-14,41
Grasshoppers,5975,7,8,9,15,41,51,-10,33
FC Thun,5975,8,8,6,18,40,59,-19,30
FC Sion,5975,9,6,8,18,41,57,-16,26
Young Boys,5976,1,20,8,4,69,38,31,68
FC Basel,5976,2,20,7,5,60,26,34,67
St Gallen,5976,3,14,3,15,41,54,-13,45
Lucerne,5976,4,12,7,13,43,46,-3,43
FC Zürich,5976,5,10,9,13,43,40,3,39
Grasshoppers,5976,6,10,8,14,43,48,-5,38
FC Lugano,5976,7,10,6,16,31,52,-21,36
FC Thun,5976,8,10,5,17,47,62,-15,35
FC Sion,5976,9,7,9,16,43,54,-11,30
Young Boys,5977,1,19,8,5,68,46,22,65
FC Basel,5977,2,17,8,7,58,31,27,59
St Gallen,5977,3,16,3,13,48,53,-5,51
FC Zürich,5977,4,13,9,10,46,36,10,48
Lucerne,5977,5,12,8,12,42,49,-7,44
Grasshoppers,5977,6,11,6,15,44,46,-2,39
FC Lugano,5977,7,10,6,16,34,48,-14,36
FC Thun,5977,8,9,5,18,42,59,-17,32
FC Sion,5977,9,7,7,18,42,56,-14,28
Young Boys,5978,1,23,6,3,73,32,41,75
FC Basel,5978,2,17,9,6,52,26,26,60
St Gallen,5978,3,14,3,15,42,54,-12,45
Lucerne,5978,4,12,8,12,38,44,-6,44
FC Zürich,5978,5,10,10,12,40,40,0,40
FC Lugano,5978,6,11,5,16,32,46,-14,38
FC Thun,5978,7,10,7,15,42,55,-13,37
FC Sion,5978,8,8,8,16,45,53,-8,32
Grasshoppers,5978,9,8,6,18,38,52,-14,30
Young Boys,5979,1,21,8,3,71,39,32,71
FC Basel,5979,2,18,8,6,59,25,34,62
Lucerne,5979,3,12,10,10,41,41,0,46
FC Zürich,5979,4,11,9,12,44,39,5,42
St Gallen,5979,5,13,2,17,39,58,-19,41
Grasshoppers,5979,6,11,7,14,48,48,0,40
FC Lugano,5979,7,10,6,16,33,50,-17,36
FC Thun,5979,8,10,5,17,46,63,-17,35
FC Sion,5979,9,7,7,18,40,58,-18,28
Young Boys,5980,1,22,6,4,68,36,32,72
FC Basel,5980,2,19,7,6,64,25,39,64
St Gallen,5980,3,15,2,15,44,54,-10,47
FC Zürich,5980,4,12,9,11,46,37,9,45
Lucerne,5980,5,12,7,13,42,48,-6,43
FC Thun,5980,6,10,5,17,44,63,-19,35
Grasshoppers,5980,7,9,7,16,39,49,-10,34
FC Sion,5980,8,8,8,16,44,52,-8,32
FC Lugano,5980,9,9,5,18,28,55,-27,32
Young Boys,5981,1,21,7,4,71,37,34,70
FC Basel,5981,2,17,10,5,53,24,29,61
St Gallen,5981,3,16,3,13,45,52,-7,51
Lucerne,5981,4,13,8,11,42,45,-3,47
FC Zürich,5981,5,12,10,10,44,33,11,46
Grasshoppers,5981,6,9,7,16,43,50,-7,34
FC Thun,5981,7,9,5,18,43,61,-18,32
FC Lugano,5981,8,9,5,18,28,52,-24,32
FC Sion,5981,9,6,9,17,38,53,-15,27
Young Boys,5982,1,23,6,3,78,37,41,75
FC Basel,5982,2,17,9,6,55,27,28,60
St Gallen,5982,3,14,5,13,42,52,-10,47
Lucerne,5982,4,12,9,11,42,42,0,45
FC Zürich,5982,5,11,10,11,42,34,8,43
Grasshoppers,5982,6,10,7,15,41,47,-6,37
FC Lugano,5982,7,9,7,16,29,51,-22,34
FC Thun,5982,8,9,5,18,43,65,-22,32
FC Sion,5982,9,6,8,18,38,55,-17,26
Young Boys,5983,1,22,6,4,75,35,40,72
FC Basel,5983,2,19,7,6,58,27,31,64
Lucerne,5983,3,13,8,11,40,46,-6,47
St Gallen,5983,4,14,3,15,41,53,-12,45
FC Zürich,5983,5,11,9,12,42,38,4,42
Grasshoppers,5983,6,9,9,14,42,49,-7,36
FC Thun,5983,7,10,6,16,44,57,-13,36
FC Lugano,5983,8,10,5,17,28,45,-17,35
FC Sion,5983,9,5,9,18,39,59,-20,24
Young Boys,5984,1,21,8,3,69,35,34,71
FC Basel,5984,2,16,10,6,51,26,25,58
Lucerne,5984,3,14,8,10,44,42,2,50
St Gallen,5984,4,13,3,16,44,59,-15,42
FC Zürich,5984,5,10,10,12,39,38,1,40
FC Lugano,5984,6,10,6,16,31,46,-15,36
FC Thun,5984,7,9,8,15,44,58,-14,35
Grasshoppers,5984,8,9,7,16,41,52,-11,34
FC Sion,5984,9,8,8,16,47,54,-7,32
Young Boys,5985,1,20,7,5,69,36,33,67
FC Basel,5985,2,17,9,6,53,24,29,60
Lucerne,5985,3,14,8,10,46,43,3,50
St Gallen,5985,4,14,4,14,43,55,-12,46
FC Zürich,5985,5,10,10,12,40,38,2,40
FC Lugano,5985,6,11,5,16,31,47,-16,38
Grasshoppers,5985,7,10,6,16,43,55,-12,36
FC Thun,5985,8,10,6,16,46,60,-14,36
FC Sion,5985,9,6,9,17,42,55,-13,27
Young Boys,5986,1,22,7,3,69,34,35,73
FC Basel,5986,2,17,8,7,52,26,26,59
Lucerne,5986,3,12,10,10,42,44,-2,46
St Gallen,5986,4,14,3,15,42,55,-13,45
FC Zürich,5986,5,11,10,11,43,37,6,43
FC Thun,5986,6,11,5,16,51,59,-8,38
FC Lugano,5986,7,10,5,17,32,51,-19,35
Grasshoppers,5986,8,9,6,17,41,51,-10,33
FC Sion,5986,9,7,8,17,42,57,-15,29
Young Boys,5987,1,23,6,3,79,37,42,75
FC Basel,5987,2,17,9,6,53,26,27,60
St Gallen,5987,3,14,4,14,42,53,-11,46
Lucerne,5987,4,12,7,13,41,49,-8,43
FC Lugano,5987,5,12,5,15,32,47,-15,41
FC Zürich,5987,6,9,10,13,40,39,1,37
FC Thun,5987,7,10,6,16,44,57,-13,36
Grasshoppers,5987,8,9,7,16,41,51,-10,34
FC Sion,5987,9,6,10,16,43,56,-13,28
Young Boys,5988,1,22,6,4,72,34,38,72
FC Basel,5988,2,18,8,6,57,28,29,62
Lucerne,5988,3,13,8,11,42,46,-4,47
St Gallen,5988,4,14,4,14,45,56,-11,46
FC Zürich,5988,5,10,10,12,44,38,6,40
Grasshoppers,5988,6,10,7,15,41,47,-6,37
FC Lugano,5988,7,10,6,16,30,50,-20,36
FC Thun,5988,8,9,6,17,44,62,-18,33
FC Sion,5988,9,6,9,17,40,54,-14,27
Young Boys,5989,1,21,7,4,74,39,35,70
FC Basel,5989,2,17,8,7,57,30,27,59
St Gallen,5989,3,15,4,13,45,52,-7,49
Lucerne,5989,4,12,9,11,42,46,-4,45
FC Zürich,5989,5,10,11,11,42,40,2,41
FC Lugano,5989,6,10,7,15,32,47,-15,37
Grasshoppers,5989,7,9,9,14,43,50,-7,36
FC Thun,5989,8,10,6,16,46,58,-12,36
FC Sion,5989,9,5,9,18,35,54,-19,24
Young Boys,5990,1,21,7,4,72,36,36,70
FC Basel,5990,2,18,9,5,53,24,29,63
Lucerne,5990,3,12,10,10,43,40,3,46
St Gallen,5990,4,13,4,15,41,55,-14,43
FC Zürich,5990,5,10,12,10,39,34,5,42
Grasshoppers,5990,6,10,7,15,43,53,-10,37
FC Lugano,5990,7,9,6,17,30,52,-22,33
FC Thun,5990,8,8,8,16,42,59,-17,32
FC Sion,5990,9,7,9,16,46,56,-10,30
Young Boys,5991,1,22,7,3,74,34,40,73
FC Basel,5991,2,19,7,6,51,23,28,64
Lucerne,5991,3,13,7,12,43,45,-2,46
FC Zürich,5991,4,12,9,11,40,34,6,45
St Gallen,5991,5,14,2,16,42,55,-13,44
FC Thun,5991,6,10,6,16,47,59,-12,36
FC Lugano,5991,7,10,5,17,30,49,-19,35
Grasshoppers,5991,8,8,8,16,45,57,-12,32
FC Sion,5991,9,6,9,17,44,60,-16,27
Young Boys,5992,1,21,8,3,69,34,35,71
FC Basel,5992,2,17,8,7,54,31,23,59
St Gallen,5992,3,16,2,14,45,53,-8,50
Lucerne,5992,4,13,8,11,44,43,1,47
FC Zürich,5992,5,11,10,11,41,36,5,43
FC Thun,5992,6,12,5,15,51,58,-7,41
Grasshoppers,5992,7,9,7,16,42,52,-10,34
FC Lugano,5992,8,9,6,17,30,51,-21,33
FC Sion,5992,9,5,8,19,38,56,-18,23
Young Boys,5993,1,23,6,3,75,34,41,75
FC Basel,5993,2,17,8,7,56,28,28,59
St Gallen,5993,3,16,2,14,45,54,-9,50
FC Zürich,5993,4,12,10,10,45,37,8,46
Lucerne,5993,5,12,7,13,40,49,-9,43
Grasshoppers,5993,6,10,7,15,41,47,-6,37
FC Lugano,5993,7,10,5,17,29,48,-19,35
FC Thun,5993,8,8,9,15,42,57,-15,33
FC Sion,5993,9,5,8,19,40,59,-19,23
Young Boys,5994,1,21,6,5,70,38,32,69
FC Basel,5994,2,17,8,7,53,25,28,59
Lucerne,5994,3,13,9,10,44,43,1,48
St Gallen,5994,4,14,4,14,43,54,-11,46
FC Zürich,5994,5,12,9,11,44,34,10,45
FC Thun,5994,6,11,5,16,44,60,-16,38
Grasshoppers,5994,7,10,6,16,44,49,-5,36
FC Lugano,5994,8,10,5,17,31,51,-20,35
FC Sion,5994,9,6,8,18,37,56,-19,26
Young Boys,5995,1,23,7,2,73,34,39,76
FC Basel,5995,2,18,8,6,53,25,28,62
St Gallen,5995,3,17,2,13,49,53,-4,53
Lucerne,5995,4,13,7,12,41,44,-3,46
FC Zürich,5995,5,10,10,12,40,38,2,40
Grasshoppers,5995,6,9,6,17,39,51,-12,33
FC Thun,5995,7,9,5,18,40,57,-17,32
FC Lugano,5995,8,9,5,18,34,55,-21,32
FC Sion,5995,9,7,8,17,42,54,-12,29
Young Boys,5996,1,21,7,4,71,37,34,70
FC Basel,5996,2,18,7,7,54,26,28,61
St Gallen,5996,3,15,2,15,43,55,-12,47
FC Zürich,5996,4,12,9,11,42,33,9,45
Lucerne,5996,5,12,8,12,42,49,-7,44
Grasshoppers,5996,6,10,7,15,44,52,-8,37
FC Thun,5996,7,10,5,17,44,57,-13,35
FC Lugano,5996,8,9,6,17,30,50,-20,33
FC Sion,5996,9,8,7,17,42,53,-11,31
Young Boys,5997,1,22,7,3,72,33,39,73
FC Basel,5997,2,17,7,8,53,31,22,58
St Gallen,5997,3,15,4,13,49,53,-4,49
FC Zürich,5997,4,11,11,10,44,38,6,44
Lucerne,5997,5,12,8,12,44,46,-2,44
FC Thun,5997,6,10,6,16,42,56,-14,36
Grasshoppers,5997,7,9,7,16,41,52,-11,34
FC Lugano,5997,8,9,5,18,30,57,-27,32
FC Sion,5997,9,7,9,16,44,53,-9,30
Young Boys,5998,1,22,7,3,69,31,38,73
FC Basel,5998,2,18,7,7,51,24,27,61
FC Zürich,5998,3,12,10,10,43,33,10,46
Lucerne,5998,4,13,7,12,41,45,-4,46
St Gallen,5998,5,14,3,15,41,54,-13,45
Grasshoppers,5998,6,9,7,16,38,48,-10,34
FC Thun,5998,7,9,7,16,42,56,-14,34
FC Lugano,5998,8,9,6,17,30,51,-21,33
FC Sion,5998,9,7,8,17,38,51,-13,29
Young Boys,5999,1,21,8,3,70,34,36,71
FC Basel,5999,2,18,7,7,54,31,23,61
St Gallen,5999,3,16,2,14,48,57,-9,50
Lucerne,5999,4,12,9,11,44,44,0,45
FC Zürich,5999,5,10,10,12,40,40,0,40
Grasshoppers,5999,6,10,6,16,41,51,-10,36
FC Lugano,5999,7,10,6,16,34,48,-14,36
FC Thun,5999,8,10,5,17,45,59,-14,35
FC Sion,5999,9,6,9,17,44,56,-12,27
Young Boys,6000,1,21,7,4,76,39,37,70
FC Basel,6000,2,19,8,5,62,25,37,65
Lucerne,6000,3,13,8,11,46,48,-2,47
St Gallen,6000,4,14,3,15,43,58,-15,45
FC Zürich,6000,5,10,11,11,39,37,2,41
Grasshoppers,6000,6,10,6,16,43,50,-7,36
FC Thun,6000,7,10,6,16,45,59,-14,36
FC Lugano,6000,8,10,5,17,32,53,-21,35
FC Sion,6000,9,6,8,18,39,56,-17,26
Young Boys,6001,1,20,8,4,72,39,33,68
FC Basel,6001,2,17,9,6,53,25,28,60
Lucerne,6001,3,13,9,10,43,41,2,48
St Gallen,6001,4,13,4,15,40,55,-15,43
FC Lugano,6001,5,11,7,14,33,46,-13,40
FC Zürich,6001,6,9,12,11,39,36,3,39
Grasshoppers,6001,7,11,6,15,45,51,-6,39
FC Thun,6001,8,9,6,17,44,61,-17,33
FC Sion,6001,9,6,9,17,41,56,-15,27
Young Boys,6002,1,22,7,3,72,33,39,73
FC Basel,6002,2,18,8,6,54,24,30,62
Lucerne,6002,3,12,9,11,40,41,-1,45
St Gallen,6002,4,14,3,15,43,55,-12,45
FC Zürich,6002,5,10,11,11,42,38,4,41
FC Thun,6002,6,10,6,16,45,60,-15,36
FC Lugano,6002,7,10,6,16,30,50,-20,36
Grasshoppers,6002,8,9,8,15,38,48,-10,35
FC Sion,6002,9,5,10,17,41,56,-15,25
Young Boys,6003,1,20,8,4,73,40,33,68
FC Basel,6003,2,16,10,6,55,28,27,58
St Gallen,6003,3,15,4,13,44,53,-9,49
Lucerne,6003,4,13,7,12,40,42,-2,46
FC Zürich,6003,5,12,9,11,42,37,5,45
Grasshoppers,6003,6,10,7,15,40,47,-7,37
FC Thun,6003,7,10,6,16,44,57,-13,36
FC Lugano,6003,8,10,5,17,32,51,-19,35
FC Sion,6003,9,6,8,18,41,56,-15,26
Young Boys,6004,1,22,6,4,72,35,37,72
FC Basel,6004,2,17,7,8,54,28,26,58
St Gallen,6004,3,15,2,15,43,55,-12,47
FC Zürich,6004,4,12,9,11,41,34,7,45
Lucerne,6004,5,12,8,12,39,47,-8,44
FC Lugano,6004,6,11,6,15,30,44,-14,39
FC Thun,6004,7,10,5,17,45,60,-15,35
Grasshoppers,6004,8,9,6,17,43,53,-10,33
FC Sion,6004,9,8,7,17,45,56,-11,31
Young Boys,6005,1,21,6,5,70,35,35,69
FC Basel,6005,2,19,7,6,56,26,30,64
St Gallen,6005,3,15,3,14,40,52,-12,48
Lucerne,6005,4,12,8,12,40,42,-2,44
FC Zürich,6005,5,10,9,13,42,41,1,39
FC Thun,6005,6,10,6,16,43,56,-13,36
FC Lugano,6005,7,10,6,16,30,49,-19,36
Grasshoppers,6005,8,9,8,15,38,47,-9,35
FC Sion,6005,9,7,9,16,40,51,-11,30
Young Boys,6006,1,21,7,4,75,39,36,70
FC Basel,6006,2,18,7,7,57,31,26,61
Lucerne,6006,3,14,9,9,48,42,6,51
FC Zürich,6006,4,12,10,10,42,35,7,46
St Gallen,6006,5,14,2,16,46,60,-14,44
FC Lugano,6006,6,10,7,15,34,50,-16,37
FC Thun,6006,7,10,5,17,46,59,-13,35
Grasshoppers,6006,8,9,6,17,41,53,-12,33
FC Sion,6006,9,6,7,19,36,56,-20,25
Young Boys,6007,1,23,7,2,73,32,41,76
FC Basel,6007,2,17,9,6,51,25,26,60
St Gallen,6007,3,15,3,14,44,56,-12,48
Lucerne,6007,4,12,8,12,42,47,-5,44
FC Zürich,6007,5,10,11,11,41,38,3,41
FC Thun,6007,6,10,6,16,45,55,-10,36
FC Lugano,6007,7,9,6,17,30,48,-18,33
FC Sion,6007,8,8,7,17,43,52,-9,31
Grasshoppers,6007,9,8,7,17,39,55,-16,31
Young Boys,6008,1,21,6,5,73,36,37,69
FC Basel,6008,2,16,8,8,52,30,22,56
Lucerne,6008,3,14,8,10,44,44,0,50
St Gallen,6008,4,15,2,15,47,59,-12,47
FC Lugano,6008,5,11,6,15,34,50,-16,39
FC Zürich,6008,6,9,11,12,40,39,1,38
FC Thun,6008,7,11,5,16,47,59,-12,38
Grasshoppers,6008,8,10,6,16,43,50,-7,36
FC Sion,6008,9,7,8,17,39,52,-13,29
Young Boys,6009,1,22,7,3,74,34,40,73
FC Basel,6009,2,17,9,6,56,26,30,60
St Gallen,6009,3,16,2,14,44,53,-9,50
Lucerne,6009,4,12,8,12,39,44,-5,44
FC Zürich,6009,5,10,11,11,41,36,5,41
FC Thun,6009,6,11,5,16,48,62,-14,38
FC Lugano,6009,7,10,7,15,31,47,-16,37
Grasshoppers,6009,8,8,7,17,39,51,-12,31
FC Sion,6009,9,6,8,18,39,58,-19,26
Young Boys,6010,1,21,8,3,70,33,37,71
FC Basel,6010,2,18,9,5,56,27,29,63
Lucerne,6010,3,12,8,12,42,47,-5,44
St Gallen,6010,4,13,4,15,41,56,-15,43
FC Lugano,6010,5,12,5,15,36,47,-11,41
FC Zürich,6010,6,10,10,12,41,39,2,40
FC Thun,6010,7,9,6,17,43,59,-16,33
Grasshoppers,6010,8,8,8,16,40,51,-11,32
FC Sion,6010,9,7,10,15,39,49,-10,31
Young Boys,6011,1,20,7,5,73,40,33,67
FC Basel,6011,2,17,9,6,55,25,30,60
Lucerne,6011,3,12,9,11,41,46,-5,45
St Gallen,6011,4,13,5,14,44,56,-12,44
FC Zürich,6011,5,11,10,11,41,38,3,43
Grasshoppers,6011,6,11,6,15,45,48,-3,39
FC Lugano,6011,7,10,7,15,33,49,-16,37
FC Thun,6011,8,10,6,16,44,58,-14,36
FC Sion,6011,9,6,9,17,42,58,-16,27
Young Boys,6012,1,21,6,5,68,37,31,69
FC Basel,6012,2,20,7,5,55,23,32,67
Lucerne,6012,3,13,7,12,41,44,-3,46
St Gallen,6012,4,14,2,16,42,55,-13,44
FC Zürich,6012,5,10,9,13,39,37,2,39
FC Thun,6012,6,11,5,16,46,56,-10,38
FC Lugano,6012,7,11,5,16,33,46,-13,38
FC Sion,6012,8,9,7,16,42,52,-10,34
Grasshoppers,6012,9,8,6,18,37,53,-16,30
Young Boys,6013,1,22,7,3,75,38,37,73
FC Basel,6013,2,19,7,6,59,26,33,64
Lucerne,6013,3,12,9,11,40,44,-4,45
St Gallen,6013,4,14,3,15,41,55,-14,45
FC Zürich,6013,5,11,9,12,40,38,2,42
FC Thun,6013,6,10,6,16,47,59,-12,36
Grasshoppers,6013,7,9,7,16,43,52,-9,34
FC Lugano,6013,8,9,7,16,30,49,-19,34
FC Sion,6013,9,6,9,17,40,54,-14,27
Young Boys,6014,1,22,7,3,74,34,40,73
FC Basel,6014,2,17,8,7,52,25,27,59
Lucerne,6014,3,14,8,10,47,44,3,50
St Gallen,6014,4,14,2,16,41,54,-13,44
FC Zürich,6014,5,10,12,10,42,37,5,42
FC Lugano,6014,6,10,6,16,32,54,-22,36
Grasshoppers,6014,7,8,9,15,42,51,-9,33
FC Thun,6014,8,9,5,18,46,66,-20,32
FC Sion,6014,9,7,9,16,45,56,-11,30
Young Boys,6015,1,23,6,3,72,34,38,75
FC Basel,6015,2,18,7,7,55,28,27,61
Lucerne,6015,3,14,7,11,42,43,-1,49
FC Zürich,6015,4,13,9,10,43,34,9,48
St Gallen,6015,5,15,2,15,41,52,-11,47
FC Lugano,6015,6,10,5,17,30,47,-17,35
Grasshoppers,6015,7,9,7,16,47,53,-6,34
FC Thun,6015,8,8,5,19,40,64,-24,29
FC Sion,6015,9,6,8,18,40,55,-15,26
Young Boys,6016,1,21,7,4,72,39,33,70
FC Basel,6016,2,18,8,6,57,30,27,62
Lucerne,6016,3,12,10,10,45,46,-1,46
FC Zürich,6016,4,11,10,11,43,36,7,43
St Gallen,6016,5,13,2,17,44,59,-15,41
FC Lugano,6016,6,11,6,15,32,45,-13,39
Grasshoppers,6016,7,10,7,15,45,53,-8,37
FC Thun,6016,8,9,6,17,45,62,-17,33
FC Sion,6016,9,7,8,17,40,53,-13,29
Young Boys,6017,1,22,7,3,76,37,39,73
FC Basel,6017,2,19,8,5,58,24,34,65
Lucerne,6017,3,13,9,10,43,44,-1,48
St Gallen,6017,4,13,4,15,41,54,-13,43
FC Lugano,6017,5,10,7,15,32,51,-19,37
FC Zürich,6017,6,9,9,14,38,40,-2,36
FC Thun,6017,7,10,6,16,41,56,-15,36
Grasshoppers,6017,8,9,7,16,38,47,-9,34
FC Sion,6017,9,7,7,18,39,53,-14,28
Young Boys,6018,1,22,7,3,72,34,38,73
FC Basel,6018,2,19,7,6,55,27,28,64
St Gallen,6018,3,15,3,14,45,54,-9,48
Lucerne,6018,4,12,8,12,44,49,-5,44
FC Zürich,6018,5,10,9,13,40,39,1,39
FC Lugano,6018,6,10,8,14,32,46,-14,38
FC Thun,6018,7,10,6,16,49,57,-8,36
Grasshoppers,6018,8,9,8,15,42,50,-8,35
FC Sion,6018,9,5,8,19,37,60,-23,23
Young Boys,6019,1,23,6,3,75,30,45,75
FC Basel,6019,2,18,8,6,54,25,29,62
St Gallen,6019,3,15,3,14,42,51,-9,48
Lucerne,6019,4,11,9,12,38,46,-8,42
FC Zürich,6019,5,9,12,11,37,35,2,39
Grasshoppers,6019,6,10,6,16,39,49,-10,36
FC Thun,6019,7,10,5,17,45,60,-15,35
FC Lugano,6019,8,9,7,16,28,48,-20,34
FC Sion,6019,9,7,8,17,39,53,-14,29
Young Boys,6020,1,21,6,5,71,38,33,69
FC Basel,6020,2,16,10,6,50,24,26,58
FC Zürich,6020,3,13,9,10,45,34,11,48
Lucerne,6020,4,12,10,10,42,45,-3,46
St Gallen,6020,5,13,4,15,42,58,-16,43
FC Lugano,6020,6,11,5,16,37,48,-11,38
Grasshoppers,6020,7,10,7,15,44,52,-8,37
FC Thun,6020,8,10,6,16,42,56,-14,36
FC Sion,6020,9,6,7,19,41,59,-18,25
Young Boys,6021,1,23,6,3,74,35,39,75
FC Basel,6021,2,16,9,7,52,29,23,57
St Gallen,6021,3,16,2,14,47,54,-7,50
Lucerne,6021,4,12,9,11,46,48,-2,45
FC Zürich,6021,5,11,10,11,49,41,8,43
Grasshoppers,6021,6,10,6,16,43,51,-8,36
FC Lugano,6021,7,10,6,16,34,53,-19,36
FC Thun,6021,8,10,5,17,48,59,-11,35
FC Sion,6021,9,6,7,19,39,62,-23,25
Young Boys,6022,1,22,6,4,73,39,34,72
FC Basel,6022,2,17,9,6,54,25,29,60
St Gallen,6022,3,15,4,13,46,54,-8,49
Lucerne,6022,4,11,9,12,40,46,-6,42
FC Zürich,6022,5,9,13,10,40,36,4,40
FC Thun,6022,6,10,7,15,44,57,-13,37
FC Lugano,6022,7,10,7,15,32,46,-14,37
Grasshoppers,6022,8,8,8,16,39,49,-10,32
FC Sion,6022,9,5,11,16,38,54,-16,26
Young Boys,6023,1,21,8,3,72,37,35,71
FC Basel,6023,2,16,9,7,51,27,24,57
St Gallen,6023,3,14,4,14,46,57,-11,46
FC Zürich,6023,4,11,10,11,42,37,5,43
Lucerne,6023,5,11,9,12,41,47,-6,42
FC Lugano,6023,6,10,8,14,33,47,-14,38
Grasshoppers,6023,7,10,7,15,43,48,-5,37
FC Thun,6023,8,10,6,16,44,57,-13,36
FC Sion,6023,9,7,7,18,40,55,-15,28
Young Boys,6024,1,20,8,4,70,36,34,68
FC Basel,6024,2,18,7,7,53,25,28,61
Lucerne,6024,3,13,7,12,40,47,-7,46
St Gallen,6024,4,14,2,16,40,54,-14,44
FC Lugano,6024,5,12,6,14,36,45,-9,42
FC Thun,6024,6,12,5,15,48,56,-8,41
FC Zürich,6024,7,10,10,12,39,36,3,40
Grasshoppers,6024,8,10,6,16,41,50,-9,36
FC Sion,6024,9,5,9,18,38,56,-18,24
Young Boys,6025,1,21,8,3,69,33,36,71
FC Basel,6025,2,19,7,6,55,25,30,64
Lucerne,6025,3,13,9,10,45,47,-2,48
St Gallen,6025,4,14,3,15,43,55,-12,45
FC Zürich,6025,5,10,9,13,37,38,-1,39
FC Thun,6025,6,10,6,16,48,58,-10,36
Grasshoppers,6025,7,9,8,15,43,50,-7,35
FC Lugano,6025,8,9,6,17,29,47,-18,33
FC Sion,6025,9,7,8,17,37,53,-16,29
Young Boys,6026,1,24,6,2,79,32,47,78
FC Basel,6026,2,17,9,6,53,25,28,60
St Gallen,6026,3,14,3,15,42,54,-12,45
FC Zürich,6026,4,11,11,10,41,34,7,44
Lucerne,6026,5,11,8,13,40,46,-6,41
Grasshoppers,6026,6,11,6,15,50,50,0,39
FC Lugano,6026,7,10,6,16,29,48,-19,36
FC Thun,6026,8,9,6,17,41,60,-19,33
FC Sion,6026,9,6,7,19,36,62,-26,25
Young Boys,6027,1,20,9,3,70,36,34,69
FC Basel,6027,2,18,9,5,53,25,28,63
Lucerne,6027,3,13,7,12,40,41,-1,46
FC Zürich,6027,4,11,10,11,44,36,8,43
St Gallen,6027,5,13,4,15,42,56,-14,43
FC Lugano,6027,6,10,7,15,31,47,-16,37
FC Sion,6027,7,8,9,15,42,52,-10,33
FC Thun,6027,8,9,6,17,44,62,-18,33
Grasshoppers,6027,9,8,7,17,41,52,-11,31
Young Boys,6028,1,21,7,4,68,35,33,70
FC Basel,6028,2,18,7,7,53,28,25,61
Lucerne,6028,3,13,8,11,43,45,-2,47
St Gallen,6028,4,15,2,15,44,55,-11,47
FC Zürich,6028,5,12,9,11,45,37,8,45
FC Lugano,6028,6,11,5,16,32,48,-16,38
Grasshoppers,6028,7,10,6,16,44,51,-7,36
FC Thun,6028,8,9,5,18,45,62,-17,32
FC Sion,6028,9,7,7,18,43,56,-13,28
Young Boys,6029,1,20,8,4,73,40,33,68
FC Basel,6029,2,18,8,6,53,25,28,62
St Gallen,6029,3,15,4,13,47,50,-3,49
Lucerne,6029,4,12,8,12,41,47,-6,44
FC Zürich,6029,5,10,10,12,38,35,3,40
FC Thun,6029,6,11,6,15,44,55,-11,39
Grasshoppers,6029,7,10,7,15,44,51,-7,37
FC Lugano,6029,8,9,6,17,29,51,-22,33
FC Sion,6029,9,5,11,16,39,54,-15,26
Young Boys,6030,1,22,6,4,73,33,40,72
FC Basel,6030,2,18,8,6,51,25,26,62
Lucerne,6030,3,13,8,11,47,43,4,47
St Gallen,6030,4,13,6,13,41,52,-11,45
FC Zürich,6030,5,11,10,11,45,38,7,43
Grasshoppers,6030,6,10,7,15,41,49,-8,37
FC Thun,6030,7,10,6,16,46,60,-14,36
FC Lugano,6030,8,9,7,16,30,55,-25,34
FC Sion,6030,9,5,8,19,37,56,-19,23
Young Boys,6031,1,22,8,2,71,33,38,74
FC Basel,6031,2,18,9,5,56,25,31,63
Lucerne,6031,3,12,9,11,40,43,-3,45
St Gallen,6031,4,14,3,15,41,56,-15,45
FC Zürich,6031,5,10,11,11,45,38,7,41
FC Lugano,6031,6,10,5,17,31,51,-20,35
FC Thun,6031,7,9,6,17,42,60,-18,33
Grasshoppers,6031,8,8,8,16,39,49,-10,32
FC Sion,6031,9,7,9,16,44,54,-10,30
Young Boys,6032,1,22,8,2,74,34,40,74
FC Basel,6032,2,16,10,6,52,28,24,58
St Gallen,6032,3,17,2,13,47,51,-4,53
Lucerne,6032,4,13,8,11,43,44,-1,47
FC Zürich,6032,5,11,10,11,45,37,8,43
Grasshoppers,6032,6,9,7,16,38,51,-13,34
FC Lugano,6032,7,9,7,16,33,51,-18,34
FC Thun,6032,8,9,6,17,46,59,-13,33
FC Sion,6032,9,5,8,19,36,59,-23,23
Young Boys,6033,1,22,7,3,71,35,36,73
FC Basel,6033,2,17,7,8,56,29,27,58
Lucerne,6033,3,13,8,11,40,40,0,47
St Gallen,6033,4,14,4,14,43,55,-12,46
FC Zürich,6033,5,11,11,10,39,32,7,44
Grasshoppers,6033,6,10,6,16,43,50,-7,36
FC Thun,6033,7,10,6,16,45,61,-16,36
FC Lugano,6033,8,9,7,16,28,46,-18,34
FC Sion,6033,9,6,8,18,40,57,-17,26
Young Boys,6034,1,22,7,3,77,40,37,73
FC Basel,6034,2,19,7,6,57,25,32,64
St Gallen,6034,3,15,4,13,45,52,-7,49
Lucerne,6034,4,12,9,11,42,45,-3,45
FC Zürich,6034,5,10,10,12,42,39,3,40
Grasshoppers,6034,6,10,7,15,42,48,-6,37
FC Lugano,6034,7,10,6,16,35,52,-17,36
FC Thun,6034,8,8,7,17,39,59,-20,31
FC Sion,6034,9,5,9,18,36,55,-19,24
Young Boys,6035,1,21,7,4,71,38,33,70
FC Basel,6035,2,19,7,6,57,26,31,64
Lucerne,6035,3,14,7,11,49,44,5,49
FC Zürich,6035,4,12,9,11,41,35,6,45
St Gallen,6035,5,13,3,16,41,57,-16,42
Grasshoppers,6035,6,11,6,15,46,49,-3,39
FC Thun,6035,7,10,5,17,43,60,-17,35
FC Lugano,6035,8,10,5,17,29,48,-19,35
FC Sion,6035,9,5,9,18,37,57,-20,24
Young Boys,6036,1,21,6,5,70,37,33,69
FC Basel,6036,2,18,8,6,54,25,29,62
Lucerne,6036,3,13,9,10,41,40,1,48
FC Zürich,6036,4,10,11,11,40,37,3,41
St Gallen,6036,5,13,2,17,38,59,-21,41
FC Thun,6036,6,11,6,15,44,54,-10,39
FC Lugano,6036,7,11,6,15,33,45,-12,39
Grasshoppers,6036,8,10,6,16,39,49,-10,36
FC Sion,6036,9,6,8,18,40,53,-13,26
Young Boys,6037,1,20,8,4,68,36,32,68
FC Basel,6037,2,18,8,6,52,24,28,62
Lucerne,6037,3,14,8,10,40,39,1,50
St Gallen,6037,4,13,3,16,38,56,-18,42
FC Zürich,6037,5,10,10,12,38,35,3,40
Grasshoppers,6037,6,10,7,15,42,48,-6,37
FC Lugano,6037,7,10,6,16,31,45,-14,36
FC Thun,6037,8,10,5,17,42,58,-16,35
FC Sion,6037,9,7,9,16,42,52,-10,30
Young Boys,6038,1,22,7,3,71,34,37,73
FC Basel,6038,2,17,9,6,52,26,26,60
Lucerne,6038,3,13,9,10,41,40,1,48
St Gallen,6038,4,14,3,15,41,55,-14,45
FC Zürich,6038,5,11,10,11,41,36,5,43
Grasshoppers,6038,6,10,7,15,46,48,-2,37
FC Lugano,6038,7,9,6,17,29,49,-20,33
FC Thun,6038,8,9,6,17,44,65,-21,33
FC Sion,6038,9,7,7,18,42,54,-12,28
Young Boys,6039,1,22,6,4,72,40,32,72
FC Basel,6039,2,18,8,6,56,25,31,62
Lucerne,6039,3,13,8,11,45,44,1,47
St Gallen,6039,4,14,3,15,40,54,-14,45
FC Lugano,6039,5,10,7,15,31,46,-15,37
FC Zürich,6039,6,9,9,14,39,41,-2,36
FC Thun,6039,7,10,6,16,47,60,-13,36
FC Sion,6039,8,9,8,15,48,53,-5,35
Grasshoppers,6039,9,8,7,17,39,54,-15,31
Young Boys,6040,1,22,8,2,71,33,38,74
FC Basel,6040,2,18,7,7,52,24,28,61
St Gallen,6040,3,16,2,14,43,52,-9,50
Lucerne,6040,4,13,8,11,41,43,-2,47
FC Zürich,6040,5,12,9,11,42,36,6,45
Grasshoppers,6040,6,10,6,16,43,49,-6,36
FC Lugano,6040,7,10,6,16,31,48,-17,36
FC Thun,6040,8,8,5,19,42,62,-20,29
FC Sion,6040,9,6,7,19,39,57,-18,25
Young Boys,6041,1,22,6,4,73,37,36,72
FC Basel,6041,2,18,8,6,53,25,28,62
Lucerne,6041,3,13,8,11,43,44,-1,47
FC Zürich,6041,4,10,12,10,40,35,5,42
St Gallen,6041,5,13,3,16,40,57,-17,42
Grasshoppers,6041,6,11,6,15,46,51,-5,39
FC Lugano,6041,7,10,6,16,32,50,-18,36
FC Sion,6041,8,8,7,17,44,54,-10,31
FC Thun,6041,9,8,6,18,45,63,-18,30
Young Boys,6042,1,22,6,4,76,36,40,72
FC Basel,6042,2,17,7,8,53,30,23,58
Lucerne,6042,3,13,8,11,40,44,-4,47
FC Zürich,6042,4,12,9,11,44,35,9,45
St Gallen,6042,5,14,2,16,41,54,-13,44
Grasshoppers,6042,6,10,8,14,41,46,-5,38
FC Lugano,6042,7,11,5,16,32,48,-16,38
FC Sion,6042,8,7,9,16,41,54,-13,30
FC Thun,6042,9,8,6,18,41,62,-21,30
Young Boys,6043,1,22,7,3,71,37,34,73
FC Basel,6043,2,18,7,7,57,28,29,61
St Gallen,6043,3,16,2,14,49,52,-3,50
FC Zürich,6043,4,11,10,11,39,34,5,43
FC Lugano,6043,5,12,6,14,37,48,-11,42
Lucerne,6043,6,11,7,14,38,48,-10,40
FC Thun,6043,7,10,6,16,48,61,-13,36
Grasshoppers,6043,8,9,6,17,39,51,-12,33
FC Sion,6043,9,6,7,19,40,59,-19,25
Young Boys,6044,1,23,7,2,75,33,42,76
FC Basel,6044,2,19,7,6,58,27,31,64
Lucerne,6044,3,13,7,12,44,45,-1,46
St Gallen,6044,4,14,2,16,40,57,-17,44
FC Zürich,6044,5,11,9,12,40,37,3,42
Grasshoppers,6044,6,10,7,15,42,48,-6,37
FC Thun,6044,7,9,6,17,44,59,-15,33
FC Lugano,6044,8,9,6,17,29,48,-19,33
FC Sion,6044,9,7,7,18,38,56,-18,28
Young Boys,6045,1,22,8,2,75,33,42,74
FC Basel,6045,2,18,7,7,55,27,28,61
Lucerne,6045,3,14,8,10,43,43,0,50
FC Zürich,6045,4,11,9,12,41,38,3,42
St Gallen,6045,5,13,3,16,42,58,-16,42
Grasshoppers,6045,6,10,7,15,40,49,-9,37
FC Thun,6045,7,10,5,17,46,62,-16,35
FC Lugano,6045,8,9,7,16,31,48,-17,34
FC Sion,6045,9,6,8,18,42,57,-15,26
Young Boys,6046,1,20,7,5,70,39,31,67
FC Basel,6046,2,19,7,6,62,26,36,64
FC Zürich,6046,3,13,9,10,44,35,9,48
St Gallen,6046,4,14,3,15,42,56,-14,45
Lucerne,6046,5,11,10,11,41,46,-5,43
FC Lugano,6046,6,12,5,15,32,45,-13,41
Grasshoppers,6046,7,9,7,16,40,51,-11,34
FC Thun,6046,8,9,5,18,42,60,-18,32
FC Sion,6046,9,7,7,18,43,58,-15,28
Young Boys,6047,1,22,8,2,71,33,38,74
FC Basel,6047,2,17,9,6,51,22,29,60
St Gallen,6047,3,14,4,14,42,56,-14,46
Lucerne,6047,4,12,8,12,42,43,-1,44
FC Lugano,6047,5,11,7,14,33,45,-12,40
FC Zürich,6047,6,9,10,13,39,41,-2,37
Grasshoppers,6047,7,10,6,16,41,52,-11,36
FC Thun,6047,8,10,5,17,43,59,-16,35
FC Sion,6047,9,6,9,17,43,54,-11,27
Young Boys,6048,1,21,7,4,70,36,34,70
FC Basel,6048,2,18,7,7,54,28,26,61
Lucerne,6048,3,14,7,11,44,45,-1,49
St Gallen,6048,4,14,3,15,45,56,-11,45
FC Zürich,6048,5,9,11,12,41,39,2,38
FC Thun,6048,6,10,7,15,44,57,-13,37
FC Lugano,6048,7,10,6,16,32,49,-17,36
Grasshoppers,6048,8,8,9,15,44,53,-9,33
FC Sion,6048,9,6,11,15,44,55,-11,29
Young Boys,6049,1,22,8,2,70,33,37,74
FC Basel,6049,2,17,9,6,58,29,29,60
Lucerne,6049,3,13,8,11,45,49,-4,47
FC Zürich,6049,4,11,11,10,41,35,6,44
St Gallen,6049,5,13,4,15,46,59,-13,43
FC Lugano,6049,6,10,6,16,30,46,-16,36
FC Thun,6049,7,9,8,15,40,54,-14,35
Grasshoppers,6049,8,8,7,17,37,48,-11,31
FC Sion,6049,9,6,9,17,38,52,-14,27
Young Boys,6050,1,21,7,4,68,34,34,70
FC Basel,6050,2,20,7,5,59,23,36,67
St Gallen,6050,3,15,2,15,44,58,-14,47
Lucerne,6050,4,13,7,12,41,46,-5,46
FC Zürich,6050,5,11,9,12,43,36,7,42
Grasshoppers,6050,6,10,7,15,44,49,-5,37
FC Thun,6050,7,10,5,17,44,58,-14,35
FC Lugano,6050,8,10,5,17,32,48,-16,35
FC Sion,6050,9,6,7,19,38,61,-23,25
Young Boys,6051,1,21,8,3,78,37,41,71
FC Basel,6051,2,18,7,7,58,32,26,61
Lucerne,6051,3,14,7,11,44,44,0,49
St Gallen,6051,4,14,3,15,45,58,-13,45
FC Zürich,6051,5,11,10,11,39,35,4,43
FC Thun,6051,6,10,5,17,47,60,-13,35
FC Lugano,6051,7,9,8,15,32,48,-16,35
Grasshoppers,6051,8,9,7,16,41,50,-9,34
FC Sion,6051,9,7,7,18,38,58,-20,28
Young Boys,6052,1,22,7,3,70,32,38,73
FC Basel,6052,2,20,7,5,59,23,36,67
St Gallen,6052,3,14,3,15,44,58,-14,45
Lucerne,6052,4,12,7,13,40,46,-6,43
FC Zürich,6052,5,10,10,12,40,37,3,40
Grasshoppers,6052,6,10,6,16,41,50,-9,36
FC Thun,6052,7,10,5,17,45,60,-15,35
FC Lugano,6052,8,10,5,17,30,49,-19,35
FC Sion,6052,9,6,10,16,43,57,-14,28
Young Boys,6053,1,22,8,2,74,32,42,74
FC Basel,6053,2,15,11,6,49,25,24,56
St Gallen,6053,3,16,3,13,45,53,-8,51
Lucerne,6053,4,12,9,11,44,44,0,45
FC Zürich,6053,5,11,10,11,40,36,4,43
Grasshoppers,6053,6,9,9,14,40,47,-7,36
FC Thun,6053,7,9,7,16,44,58,-14,34
FC Lugano,6053,8,9,5,18,28,52,-24,32
FC Sion,6053,9,6,8,18,41,58,-17,26
Young Boys,6054,1,21,8,3,68,33,35,71
FC Basel,6054,2,18,7,7,53,25,28,61
Lucerne,6054,3,14,8,10,43,41,2,50
St Gallen,6054,4,14,2,16,41,56,-15,44
FC Zürich,6054,5,10,9,13,38,39,-1,39
FC Lugano,6054,6,11,5,16,32,44,-12,38
Grasshoppers,6054,7,10,6,16,44,51,-7,36
FC Thun,6054,8,10,5,17,43,61,-18,35
FC Sion,6054,9,7,8,17,41,53,-12,29
Young Boys,6055,1,21,7,4,68,33,35,70
FC Basel,6055,2,16,10,6,52,26,26,58
St Gallen,6055,3,15,4,13,42,51,-9,49
Lucerne,6055,4,12,11,9,44,43,1,47
FC Zürich,6055,5,9,11,12,40,40,0,38
FC Lugano,6055,6,10,8,14,31,45,-14,38
FC Thun,6055,7,10,7,15,47,59,-12,37
Grasshoppers,6055,8,8,9,15,42,52,-10,33
FC Sion,6055,9,5,9,18,40,57,-17,24
Young Boys,6056,1,22,7,3,78,37,41,73
FC Basel,6056,2,15,12,5,50,25,25,57
St Gallen,6056,3,14,4,14,43,54,-11,46
Lucerne,6056,4,12,9,11,40,44,-4,45
FC Lugano,6056,5,12,5,15,34,48,-14,41
FC Zürich,6056,6,9,11,12,38,37,1,38
FC Thun,6056,7,9,8,15,44,57,-13,35
FC Sion,6056,8,8,7,17,43,54,-11,31
Grasshoppers,6056,9,8,7,17,39,53,-14,31
Young Boys,6057,1,21,7,4,74,39,35,70
FC Basel,6057,2,20,7,5,61,24,37,67
St Gallen,6057,3,15,3,14,42,53,-11,48
Lucerne,6057,4,12,7,13,38,46,-8,43
FC Lugano,6057,5,11,6,15,34,46,-12,39
FC Zürich,6057,6,9,11,12,37,36,1,38
FC Thun,6057,7,11,5,16,44,57,-13,38
Grasshoppers,6057,8,9,7,16,40,51,-11,34
FC Sion,6057,9,5,9,18,38,56,-18,24
Young Boys,6058,1,20,7,5,74,40,34,67
FC Basel,6058,2,18,8,6,56,24,32,62
Lucerne,6058,3,13,9,10,42,43,-1,48
St Gallen,6058,4,14,4,14,43,54,-11,46
FC Zürich,6058,5,11,11,10,49,36,13,44
Grasshoppers,6058,6,10,6,16,42,50,-8,36
FC Thun,6058,7,10,5,17,43,63,-20,35
FC Lugano,6058,8,9,8,15,31,53,-22,35
FC Sion,6058,9,6,8,18,40,57,-17,26
Young Boys,6059,1,22,7,3,73,36,37,73
FC Basel,6059,2,17,9,6,53,26,27,60
Lucerne,6059,3,13,8,11,39,43,-4,47
St Gallen,6059,4,14,5,13,45,52,-7,47
Grasshoppers,6059,5,11,7,14,40,44,-4,40
FC Zürich,6059,6,9,10,13,38,39,-1,37
FC Lugano,6059,7,9,7,16,31,48,-17,34
FC Thun,6059,8,9,5,18,41,60,-19,32
FC Sion,6059,9,7,8,17,42,54,-12,29
Young Boys,6060,1,22,7,3,74,39,35,73
FC Basel,6060,2,18,9,5,56,24,32,63
St Gallen,6060,3,15,3,14,48,55,-7,48
Lucerne,6060,4,11,9,12,41,48,-7,42
FC Zürich,6060,5,9,13,10,39,35,4,40
Grasshoppers,6060,6,11,7,14,43,46,-3,40
FC Lugano,6060,7,9,7,16,31,50,-19,34
FC Thun,6060,8,9,6,17,43,60,-17,33
FC Sion,6060,9,5,9,18,40,58,-18,24
Young Boys,6061,1,21,8,3,72,39,33,71
FC Basel,6061,2,19,8,5,58,25,33,65
St Gallen,6061,3,15,2,15,44,55,-11,47
Lucerne,6061,4,13,7,12,40,44,-4,46
FC Zürich,6061,5,10,10,12,40,37,3,40
Grasshoppers,6061,6,10,7,15,41,48,-7,37
FC Thun,6061,7,10,5,17,46,57,-11,35
FC Lugano,6061,8,10,5,17,32,49,-17,35
FC Sion,6061,9,6,8,18,37,56,-19,26
Young Boys,6062,1,21,7,4,70,36,34,70
FC Basel,6062,2,18,8,6,51,24,27,62
St Gallen,6062,3,15,2,15,45,59,-14,47
Lucerne,6062,4,12,7,13,41,45,-4,43
FC Zürich,6062,5,10,12,10,40,34,6,42
FC Lugano,6062,6,11,5,16,34,50,-16,38
Grasshoppers,6062,7,10,7,15,43,49,-6,37
FC Thun,6062,8,8,8,16,41,57,-16,32
FC Sion,6062,9,6,10,16,42,53,-11,28
Young Boys,6063,1,19,8,5,66,40,26,65
FC Basel,6063,2,17,7,8,54,27,27,58
Lucerne,6063,3,14,8,10,43,41,2,50
FC Zürich,6063,4,12,10,10,40,33,7,46
St Gallen,6063,5,14,2,16,40,58,-18,44
Grasshoppers,6063,6,12,6,14,46,47,-1,42
FC Lugano,6063,7,10,7,15,34,45,-11,37
FC Thun,6063,8,8,6,18,43,62,-19,30
FC Sion,6063,9,7,8,17,39,52,-13,29
Young Boys,6064,1,22,8,2,73,34,39,74
FC Basel,6064,2,16,10,6,52,27,25,58
St Gallen,6064,3,15,3,14,47,54,-7,48
Lucerne,6064,4,13,7,12,46,45,1,46
FC Zürich,6064,5,10,10,12,46,42,4,40
Grasshoppers,6064,6,10,7,15,40,47,-7,37
FC Lugano,6064,7,10,5,17,31,54,-23,35
FC Thun,6064,8,8,7,17,40,58,-18,31
FC Sion,6064,9,7,9,16,44,58,-14,30
Young Boys,6065,1,22,6,4,74,35,39,72
FC Basel,6065,2,17,10,5,55,28,27,61
Lucerne,6065,3,14,8,10,50,47,3,50
St Gallen,6065,4,13,3,16,42,58,-16,42
FC Zürich,6065,5,10,11,11,41,35,6,41
Grasshoppers,6065,6,10,6,16,40,48,-8,36
FC Lugano,6065,7,10,6,16,32,54,-22,36
FC Thun,6065,8,9,6,17,42,60,-18,33
FC Sion,6065,9,7,8,17,42,53,-11,29
Young Boys,6066,1,22,7,3,76,37,39,73
FC Basel,6066,2,17,8,7,53,28,25,59
St Gallen,6066,3,15,3,14,46,55,-9,48
FC Zürich,6066,4,12,9,11,40,34,6,45
Lucerne,6066,5,12,7,13,41,51,-10,43
FC Thun,6066,6,11,5,16,45,57,-12,38
FC Lugano,6066,7,11,5,16,37,50,-13,38
Grasshoppers,6066,8,10,7,15,47,49,-2,37
FC Sion,6066,9,5,7,20,37,61,-24,22
Young Boys,6067,1,21,6,5,67,37,30,69
FC Basel,6067,2,17,9,6,54,27,27,60
St Gallen,6067,3,16,3,13,48,52,-4,51
FC Zürich,6067,4,12,10,10,46,36,10,46
Lucerne,6067,5,12,9,11,39,44,-5,45
Grasshoppers,6067,6,10,8,14,42,48,-6,38
FC Thun,6067,7,9,6,17,44,61,-17,33
FC Lugano,6067,8,9,6,17,30,49,-19,33
FC Sion,6067,9,6,7,19,42,58,-16,25
Young Boys,6068,1,22,7,3,71,33,38,73
FC Basel,6068,2,16,9,7,50,26,24,57
Lucerne,6068,3,13,9,10,42,42,0,48
St Gallen,6068,4,14,2,16,40,56,-16,44
FC Zürich,6068,5,9,11,12,39,38,1,38
FC Thun,6068,6,11,5,16,47,59,-12,38
Grasshoppers,6068,7,10,7,15,44,50,-6,37
FC Lugano,6068,8,10,7,15,33,47,-14,37
FC Sion,6068,9,7,7,18,40,55,-15,28
Young Boys,6069,1,21,7,4,73,37,36,70
FC Basel,6069,2,18,9,5,61,26,35,63
St Gallen,6069,3,15,2,15,42,55,-13,47
Lucerne,6069,4,12,9,11,42,46,-4,45
FC Zürich,6069,5,10,10,12,39,39,0,40
Grasshoppers,6069,6,9,8,15,40,48,-8,35
FC Thun,6069,7,9,8,15,44,58,-14,35
FC Lugano,6069,8,10,5,17,30,50,-20,35
FC Sion,6069,9,7,8,17,40,52,-12,29
Young Boys,6070,1,21,6,5,73,39,34,69
FC Basel,6070,2,16,10,6,52,27,25,58
Lucerne,6070,3,13,8,11,44,44,0,47
St Gallen,6070,4,14,3,15,44,55,-11,45
FC Zürich,6070,5,11,10,11,43,37,6,43
Grasshoppers,6070,6,11,7,14,44,49,-5,40
FC Thun,6070,7,10,7,15,45,57,-12,37
FC Lugano,6070,8,10,5,17,29,47,-18,35
FC Sion,6070,9,6,8,18,41,60,-19,26
Young Boys,6071,1,20,6,6,73,40,33,66
FC Basel,6071,2,18,7,7,54,25,29,61
St Gallen,6071,3,15,3,14,44,54,-10,48
FC Zürich,6071,4,12,10,10,40,33,7,46
Lucerne,6071,5,12,8,12,44,49,-5,44
Grasshoppers,6071,6,11,7,14,43,48,-5,40
FC Lugano,6071,7,10,6,16,30,50,-20,36
FC Thun,6071,8,9,5,18,42,59,-17,32
FC Sion,6071,9,7,8,17,42,54,-12,29
Young Boys,6072,1,23,6,3,75,36,39,75
FC Basel,6072,2,16,9,7,55,27,28,57
St Gallen,6072,3,15,2,15,43,58,-15,47
FC Zürich,6072,4,12,10,10,41,33,8,46
Lucerne,6072,5,12,8,12,39,42,-3,44
Grasshoppers,6072,6,11,6,15,43,49,-6,39
FC Thun,6072,7,10,7,15,43,54,-11,37
FC Lugano,6072,8,10,5,17,33,51,-18,35
FC Sion,6072,9,5,7,20,36,58,-22,22
Young Boys,6073,1,22,7,3,74,34,40,73
FC Basel,6073,2,15,10,7,49,26,23,55
St Gallen,6073,3,15,3,14,43,53,-10,48
Lucerne,6073,4,12,9,11,43,44,-1,45
FC Zürich,6073,5,11,10,11,38,33,5,43
FC Thun,6073,6,12,5,15,45,55,-10,41
FC Lugano,6073,7,10,6,16,30,50,-20,36
Grasshoppers,6073,8,9,7,16,42,55,-13,34
FC Sion,6073,9,6,7,19,42,56,-14,25
Young Boys,6074,1,21,6,5,68,35,33,69
FC Basel,6074,2,19,8,5,57,24,33,65
St Gallen,6074,3,15,3,14,44,55,-11,48
FC Zürich,6074,4,11,10,11,46,38,8,43
Lucerne,6074,5,11,9,12,38,45,-7,42
FC Thun,6074,6,10,5,17,45,60,-15,35
FC Lugano,6074,7,10,5,17,31,49,-18,35
Grasshoppers,6074,8,9,7,16,40,49,-9,34
FC Sion,6074,9,8,7,17,41,55,-14,31
Young Boys,6075,1,21,6,5,70,39,31,69
FC Basel,6075,2,20,7,5,57,24,33,67
Lucerne,6075,3,14,7,11,43,42,1,49
Grasshoppers,6075,4,12,6,14,47,46,1,42
St Gallen,6075,5,13,3,16,42,56,-14,42
FC Zürich,6075,6,10,9,13,39,38,1,39
FC Lugano,6075,7,10,6,16,34,49,-15,36
FC Thun,6075,8,10,5,17,41,59,-18,35
FC Sion,6075,9,6,7,19,39,59,-20,25
Young Boys,6076,1,22,6,4,70,35,35,72
FC Basel,6076,2,18,8,6,53,25,28,62
St Gallen,6076,3,16,2,14,47,53,-6,50
Lucerne,6076,4,12,8,12,39,43,-4,44
FC Zürich,6076,5,10,10,12,38,37,1,40
Grasshoppers,6076,6,10,8,14,44,48,-4,38
FC Lugano,6076,7,10,6,16,29,46,-17,36
FC Thun,6076,8,9,7,16,45,61,-16,34
FC Sion,6076,9,6,7,19,41,58,-17,25
Young Boys,6077,1,21,6,5,69,37,32,69
FC Basel,6077,2,19,7,6,54,22,32,64
Lucerne,6077,3,13,9,10,41,41,0,48
St Gallen,6077,4,13,4,15,40,55,-15,43
FC Zürich,6077,5,10,9,13,40,40,0,39
FC Lugano,6077,6,11,6,15,36,48,-12,39
Grasshoppers,6077,7,10,8,14,45,48,-3,38
FC Thun,6077,8,9,6,17,43,62,-19,33
FC Sion,6077,9,6,9,17,41,56,-15,27
Young Boys,6078,1,22,7,3,69,31,38,73
FC Basel,6078,2,17,9,6,57,29,28,60
St Gallen,6078,3,15,3,14,43,54,-11,48
Lucerne,6078,4,12,9,11,40,41,-1,45
FC Zürich,6078,5,10,12,10,44,37,7,42
Grasshoppers,6078,6,10,6,16,42,50,-8,36
FC Thun,6078,7,10,6,16,46,59,-13,36
FC Lugano,6078,8,10,6,16,30,47,-17,36
FC Sion,6078,9,5,8,19,38,61,-23,23
Young Boys,6079,1,23,7,2,70,31,39,76
FC Basel,6079,2,17,8,7,54,27,27,59
St Gallen,6079,3,14,5,13,44,53,-9,47
Lucerne,6079,4,13,7,12,42,45,-3,46
FC Zürich,6079,5,11,10,11,42,35,7,43
FC Thun,6079,6,10,5,17,43,58,-15,35
Grasshoppers,6079,7,9,7,16,42,52,-10,34
FC Lugano,6079,8,9,6,17,29,51,-22,33
FC Sion,6079,9,5,11,16,41,55,-14,26
Young Boys,6080,1,21,8,3,71,37,34,71
FC Basel,6080,2,15,9,8,51,30,21,54
St Gallen,6080,3,16,2,14,44,52,-8,50
Lucerne,6080,4,12,8,12,41,45,-4,44
FC Zürich,6080,5,10,10,12,38,38,0,40
FC Lugano,6080,6,10,7,15,30,44,-14,37
FC Sion,6080,7,9,8,15,44,48,-4,35
Grasshoppers,6080,8,9,7,16,38,48,-10,34
FC Thun,6080,9,8,9,15,38,53,-15,33
Young Boys,6081,1,22,7,3,74,32,42,73
FC Basel,6081,2,18,8,6,53,27,26,62
Lucerne,6081,3,14,8,10,46,41,5,50
St Gallen,6081,4,14,2,16,40,58,-18,44
FC Zürich,6081,5,11,10,11,41,35,6,43
FC Thun,6081,6,11,6,15,45,56,-11,39
FC Lugano,6081,7,9,5,18,29,50,-21,32
Grasshoppers,6081,8,8,7,17,37,54,-17,31
FC Sion,6081,9,6,9,17,39,51,-12,27
Young Boys,6082,1,21,6,5,69,40,29,69
FC Basel,6082,2,17,10,5,59,28,31,61
Lucerne,6082,3,13,10,9,48,45,3,49
St Gallen,6082,4,14,3,15,42,55,-13,45
FC Zürich,6082,5,10,11,11,40,36,4,41
FC Thun,6082,6,10,6,16,44,60,-16,36
Grasshoppers,6082,7,9,7,16,41,49,-8,34
FC Lugano,6082,8,9,7,16,31,50,-19,34
FC Sion,6082,9,7,8,17,41,52,-11,29
Young Boys,6083,1,21,7,4,73,38,35,70
FC Basel,6083,2,18,7,7,58,28,30,61
St Gallen,6083,3,16,2,14,46,53,-7,50
Lucerne,6083,4,13,7,12,42,44,-2,46
FC Zürich,6083,5,10,11,11,40,37,3,41
FC Lugano,6083,6,10,6,16,32,52,-20,36
Grasshoppers,6083,7,9,7,16,40,48,-8,34
FC Sion,6083,8,8,8,16,39,51,-12,32
FC Thun,6083,9,9,5,18,41,60,-19,32
Young Boys,6084,1,22,6,4,73,36,37,72
FC Basel,6084,2,18,7,7,55,27,28,61
St Gallen,6084,3,15,3,14,46,54,-8,48
Lucerne,6084,4,13,7,12,42,50,-8,46
FC Zürich,6084,5,11,10,11,42,35,7,43
FC Lugano,6084,6,10,5,17,30,49,-19,35
Grasshoppers,6084,7,9,7,16,42,51,-9,34
FC Thun,6084,8,9,7,16,48,59,-11,34
FC Sion,6084,9,7,8,17,46,63,-17,29
Young Boys,6085,1,21,7,4,71,35,36,70
FC Basel,6085,2,20,7,5,59,25,34,67
Lucerne,6085,3,12,8,12,40,48,-8,44
St Gallen,6085,4,14,2,16,45,58,-13,44
FC Zürich,6085,5,11,10,11,44,36,8,43
FC Thun,6085,6,10,6,16,45,57,-12,36
FC Lugano,6085,7,10,6,16,30,50,-20,36
Grasshoppers,6085,8,9,7,16,41,50,-9,34
FC Sion,6085,9,6,9,17,41,57,-16,27
Young Boys,6086,1,20,7,5,72,39,33,67
FC Basel,6086,2,19,7,6,63,29,34,64
Lucerne,6086,3,12,8,12,41,48,-7,44
St Gallen,6086,4,13,4,15,42,56,-14,43
FC Lugano,6086,5,12,6,14,34,44,-10,42
FC Zürich,6086,6,10,9,13,38,39,-1,39
Grasshoppers,6086,7,10,7,15,41,47,-6,37
FC Sion,6086,8,8,9,15,44,51,-7,33
FC Thun,6086,9,9,5,18,42,64,-22,32
Young Boys,6087,1,20,9,3,71,38,33,69
FC Basel,6087,2,19,7,6,62,28,34,64
St Gallen,6087,3,16,2,14,49,55,-6,50
FC Zürich,6087,4,11,9,12,40,37,3,42
Lucerne,6087,5,11,8,13,38,45,-7,41
Grasshoppers,6087,6,11,7,14,42,47,-5,40
FC Lugano,6087,7,11,5,16,30,48,-18,38
FC Sion,6087,8,7,8,17,41,54,-13,29
FC Thun,6087,9,8,5,19,41,62,-21,29
Young Boys,6088,1,22,6,4,73,34,39,72
FC Basel,6088,2,18,7,7,52,29,23,61
Lucerne,6088,3,14,7,11,41,41,0,49
FC Zürich,6088,4,12,9,11,47,37,10,45
St Gallen,6088,5,14,3,15,41,53,-12,45
FC Lugano,6088,6,10,6,16,31,50,-19,36
Grasshoppers,6088,7,9,7,16,42,49,-7,34
FC Thun,6088,8,9,6,17,46,63,-17,33
FC Sion,6088,9,6,9,17,41,58,-17,27
Young Boys,6089,1,21,7,4,71,36,35,70
FC Basel,6089,2,17,10,5,50,23,27,61
Lucerne,6089,3,13,9,10,42,42,0,48
St Gallen,6089,4,15,3,14,47,54,-7,48
FC Zürich,6089,5,11,9,12,39,34,5,42
FC Lugano,6089,6,11,6,15,31,45,-14,39
Grasshoppers,6089,7,10,7,15,43,49,-6,37
FC Thun,6089,8,9,6,17,42,59,-17,33
FC Sion,6089,9,5,7,20,38,61,-23,22
Young Boys,6090,1,23,6,3,75,34,41,75
FC Basel,6090,2,17,8,7,54,31,23,59
Lucerne,6090,3,13,8,11,43,44,-1,47
St Gallen,6090,4,14,3,15,44,56,-12,45
FC Zürich,6090,5,10,12,10,41,35,6,42
Grasshoppers,6090,6,10,8,14,40,45,-5,38
FC Lugano,6090,7,9,7,16,31,49,-18,34
FC Thun,6090,8,8,6,18,40,61,-21,30
FC Sion,6090,9,7,8,17,42,55,-13,29
Young Boys,6091,1,22,7,3,72,33,39,73
FC Basel,6091,2,17,9,6,56,28,28,60
Lucerne,6091,3,14,7,11,41,43,-2,49
St Gallen,6091,4,14,3,15,44,55,-11,45
FC Thun,6091,5,12,5,15,49,57,-8,41
FC Zürich,6091,6,9,12,11,40,38,2,39
FC Lugano,6091,7,10,6,16,30,48,-18,36
Grasshoppers,6091,8,8,7,17,40,52,-12,31
FC Sion,6091,9,5,10,17,41,59,-18,25
Young Boys,6092,1,22,7,3,71,37,34,73
FC Basel,6092,2,17,9,6,52,28,24,60
Lucerne,6092,3,15,7,10,48,41,7,52
St Gallen,6092,4,15,2,15,44,55,-11,47
FC Zürich,6092,5,10,12,10,40,35,5,42
Grasshoppers,6092,6,9,7,16,43,51,-8,34
FC Thun,6092,7,9,7,16,44,59,-15,34
FC Lugano,6092,8,9,6,17,31,49,-18,33
FC Sion,6092,9,5,9,18,39,57,-18,24
Young Boys,6093,1,21,8,3,72,37,35,71
FC Basel,6093,2,18,8,6,57,27,30,62
FC Zürich,6093,3,12,9,11,44,37,7,45
St Gallen,6093,4,14,3,15,43,58,-15,45
Lucerne,6093,5,12,8,12,42,48,-6,44
FC Lugano,6093,6,11,6,15,35,48,-13,39
Grasshoppers,6093,7,9,7,16,43,53,-10,34
FC Thun,6093,8,9,6,17,43,58,-15,33
FC Sion,6093,9,6,9,17,40,53,-13,27
Young Boys,6094,1,20,8,4,68,36,32,68
FC Basel,6094,2,16,8,8,54,31,23,56
St Gallen,6094,3,16,3,13,46,53,-7,51
Lucerne,6094,4,12,9,11,42,44,-2,45
FC Zürich,6094,5,11,11,10,41,35,6,44
Grasshoppers,6094,6,10,6,16,40,49,-9,36
FC Thun,6094,7,10,6,16,46,58,-12,36
FC Lugano,6094,8,9,9,14,33,48,-15,36
FC Sion,6094,9,6,8,18,41,57,-16,26
Young Boys,6095,1,21,7,4,69,34,35,70
FC Basel,6095,2,18,9,5,54,25,29,63
St Gallen,6095,3,15,3,14,43,54,-11,48
FC Zürich,6095,4,12,9,11,46,39,7,45
Lucerne,6095,5,12,9,11,41,43,-2,45
Grasshoppers,6095,6,10,6,16,42,51,-9,36
FC Lugano,6095,7,10,5,17,32,48,-16,35
FC Thun,6095,8,9,5,18,45,62,-17,32
FC Sion,6095,9,7,7,18,40,56,-16,28
Young Boys,6096,1,21,8,3,71,35,36,71
FC Basel,6096,2,20,7,5,53,22,31,67
Lucerne,6096,3,13,8,11,44,43,1,47
St Gallen,6096,4,14,3,15,42,54,-12,45
FC Zürich,6096,5,11,10,11,50,38,12,43
Grasshoppers,6096,6,10,6,16,40,48,-8,36
FC Lugano,6096,7,9,5,18,30,55,-25,32
FC Sion,6096,8,7,9,16,42,59,-17,30
FC Thun,6096,9,8,6,18,46,64,-18,30
Young Boys,6097,1,23,7,2,72,33,39,76
FC Basel,6097,2,18,8,6,54,28,26,62
Lucerne,6097,3,13,9,10,44,41,3,48
St Gallen,6097,4,14,2,16,43,57,-14,44
FC Zürich,6097,5,10,9,13,39,37,2,39
FC Thun,6097,6,11,5,16,47,56,-9,38
Grasshoppers,6097,7,9,7,16,40,48,-8,34
FC Lugano,6097,8,9,6,17,30,49,-19,33
FC Sion,6097,9,7,7,18,39,59,-20,28
Young Boys,6098,1,22,7,3,75,35,40,73
FC Basel,6098,2,17,9,6,50,25,25,60
St Gallen,6098,3,15,2,15,42,52,-10,47
Lucerne,6098,4,12,7,13,39,45,-6,43
FC Lugano,6098,5,11,5,16,33,49,-16,38
FC Zürich,6098,6,9,10,13,37,38,-1,37
FC Thun,6098,7,10,6,16,41,54,-13,36
FC Sion,6098,8,9,8,15,45,50,-5,35
Grasshoppers,6098,9,9,6,17,38,52,-14,33
Young Boys,6099,1,21,8,3,67,31,36,71
FC Basel,6099,2,17,9,6,53,24,29,60
Lucerne,6099,3,14,9,9,45,40,5,51
St Gallen,6099,4,14,5,13,44,53,-9,47
FC Zürich,6099,5,12,9,11,46,38,8,45
FC Thun,6099,6,9,6,17,42,60,-18,33
FC Lugano,6099,7,9,6,17,27,48,-21,33
Grasshoppers,6099,8,8,8,16,40,53,-13,32
FC Sion,6099,9,6,8,18,39,56,-17,26
Young Boys,6100,1,21,7,4,66,33,33,70
FC Basel,6100,2,18,8,6,58,24,34,62
St Gallen,6100,3,14,4,14,44,55,-11,46
Lucerne,6100,4,12,9,11,42,46,-4,45
FC Zürich,6100,5,11,9,12,42,38,4,42
FC Lugano,6100,6,10,7,15,33,47,-14,37
Grasshoppers,6100,7,8,9,15,40,50,-10,33
FC Thun,6100,8,9,6,17,41,62,-21,33
FC Sion,6100,9,7,9,16,40,51,-11,30
Young Boys,6101,1,21,8,3,71,34,37,71
FC Basel,6101,2,17,9,6,54,28,26,60
FC Zürich,6101,3,13,9,10,44,34,10,48
Lucerne,6101,4,12,8,12,39,47,-8,44
St Gallen,6101,5,13,5,14,42,56,-14,44
Grasshoppers,6101,6,11,6,15,44,47,-3,39
FC Lugano,6101,7,10,6,16,32,47,-15,36
FC Thun,6101,8,8,6,18,42,60,-18,30
FC Sion,6101,9,6,9,17,38,53,-15,27
Young Boys,6102,1,23,7,2,75,33,42,76
FC Basel,6102,2,17,9,6,53,27,26,60
Lucerne,6102,3,13,8,11,43,45,-2,47
St Gallen,6102,4,14,2,16,41,54,-13,44
FC Zürich,6102,5,11,10,11,45,35,10,43
Grasshoppers,6102,6,10,6,16,43,51,-8,36
FC Thun,6102,7,10,6,16,45,57,-12,36
FC Lugano,6102,8,9,5,18,29,55,-26,32
FC Sion,6102,9,6,9,17,39,56,-17,27
Young Boys,6103,1,21,9,2,70,34,36,72
FC Basel,6103,2,18,7,7,54,24,30,61
Lucerne,6103,3,13,8,11,43,42,1,47
St Gallen,6103,4,15,2,15,46,57,-11,47
FC Zürich,6103,5,10,9,13,38,36,2,39
FC Lugano,6103,6,11,5,16,34,50,-16,38
Grasshoppers,6103,7,9,7,16,42,52,-10,34
FC Thun,6103,8,9,6,17,42,61,-19,33
FC Sion,6103,9,7,9,16,42,55,-13,30
Young Boys,6104,1,21,9,2,76,36,40,72
FC Basel,6104,2,17,9,6,55,30,25,60
St Gallen,6104,3,16,3,13,45,52,-7,51
Lucerne,6104,4,12,9,11,44,45,-1,45
FC Zürich,6104,5,10,9,13,39,37,2,39
FC Thun,6104,6,11,5,16,46,59,-13,38
FC Lugano,6104,7,11,5,16,31,50,-19,38
Grasshoppers,6104,8,8,8,16,43,53,-10,32
FC Sion,6104,9,5,9,18,40,57,-17,24
Young Boys,6105,1,21,7,4,69,33,36,70
FC Basel,6105,2,19,8,5,54,22,32,65
Lucerne,6105,3,13,8,11,42,45,-3,47
St Gallen,6105,4,13,3,16,39,57,-18,42
FC Lugano,6105,5,11,6,15,35,46,-11,39
FC Zürich,6105,6,9,11,12,39,38,1,38
Grasshoppers,6105,7,10,6,16,42,49,-7,36
FC Sion,6105,8,7,10,15,38,49,-11,31
FC Thun,6105,9,8,7,17,40,59,-19,31
Young Boys,6106,1,21,8,3,70,34,36,71
FC Basel,6106,2,18,9,5,52,22,30,63
Lucerne,6106,3,12,10,10,41,42,-1,46
St Gallen,6106,4,13,3,16,40,59,-19,42
FC Lugano,6106,5,12,5,15,40,48,-8,41
FC Zürich,6106,6,10,10,12,42,41,1,40
Grasshoppers,6106,7,9,8,15,41,48,-7,35
FC Thun,6106,8,9,5,18,43,60,-17,32
FC Sion,6106,9,7,8,17,41,56,-15,29
Young Boys,6107,1,22,7,3,75,36,39,73
FC Basel,6107,2,19,8,5,56,23,33,65
Lucerne,6107,3,13,8,11,48,45,3,47
St Gallen,6107,4,14,3,15,44,60,-16,45
FC Zürich,6107,5,11,9,12,43,37,6,42
Grasshoppers,6107,6,11,6,15,45,48,-3,39
FC Lugano,6107,7,9,5,18,30,58,-28,32
FC Thun,6107,8,8,6,18,39,60,-21,30
FC Sion,6107,9,7,8,17,42,55,-13,29
Young Boys,6108,1,21,9,2,73,35,38,72
FC Basel,6108,2,17,8,7,56,28,28,59
FC Zürich,6108,3,13,9,10,43,34,9,48
Lucerne,6108,4,13,9,10,41,40,1,48
St Gallen,6108,5,15,2,15,45,56,-11,47
FC Lugano,6108,6,10,6,16,32,49,-17,36
FC Thun,6108,7,10,5,17,41,59,-18,35
Grasshoppers,6108,8,8,8,16,40,51,-11,32
FC Sion,6108,9,5,8,19,35,54,-19,23
Young Boys,6109,1,21,7,4,75,36,39,70
FC Basel,6109,2,18,7,7,56,24,32,61
Lucerne,6109,3,14,7,11,45,42,3,49
St Gallen,6109,4,15,3,14,42,55,-13,48
FC Zürich,6109,5,11,10,11,43,36,7,43
FC Thun,6109,6,10,6,16,46,61,-15,36
FC Lugano,6109,7,10,6,16,32,51,-19,36
Grasshoppers,6109,8,8,8,16,39,50,-11,32
FC Sion,6109,9,6,8,18,36,59,-23,26
Young Boys,6110,1,21,7,4,68,34,34,70
FC Basel,6110,2,18,8,6,52,23,29,62
Lucerne,6110,3,12,8,12,40,43,-3,44
St Gallen,6110,4,14,2,16,42,57,-15,44
FC Zürich,6110,5,11,10,11,42,39,3,43
FC Thun,6110,6,11,5,16,50,61,-11,38
Grasshoppers,6110,7,10,6,16,44,50,-6,36
FC Lugano,6110,8,10,6,16,33,50,-17,36
FC Sion,6110,9,7,8,17,44,58,-14,29
Young Boys,6111,1,20,8,4,70,38,32,68
FC Basel,6111,2,20,7,5,56,22,34,67
Lucerne,6111,3,13,9,10,43,42,1,48
St Gallen,6111,4,14,2,16,42,55,-13,44
FC Zürich,6111,5,10,10,12,39,36,3,40
FC Lugano,6111,6,10,7,15,30,47,-17,37
Grasshoppers,6111,7,10,6,16,42,50,-8,36
FC Thun,6111,8,9,6,17,40,57,-17,33
FC Sion,6111,9,6,9,17,35,50,-15,27
Young Boys,6112,1,22,8,2,73,33,40,74
FC Basel,6112,2,17,10,5,57,27,30,61
Lucerne,6112,3,13,7,12,46,49,-3,46
FC Zürich,6112,4,11,11,10,41,34,7,44
St Gallen,6112,5,14,2,16,44,61,-17,44
Grasshoppers,6112,6,10,6,16,42,50,-8,36
FC Lugano,6112,7,10,5,17,31,49,-18,35
FC Thun,6112,8,9,6,17,43,60,-17,33
FC Sion,6112,9,6,9,17,41,55,-14,27
Young Boys,6113,1,23,6,3,73,32,41,75
FC Basel,6113,2,18,7,7,53,25,28,61
St Gallen,6113,3,14,2,16,42,58,-16,44
FC Zürich,6113,4,11,10,11,39,34,5,43
Lucerne,6113,5,11,9,12,44,50,-6,42
Grasshoppers,6113,6,11,7,14,44,46,-2,40
FC Lugano,6113,7,10,6,16,31,46,-15,36
FC Thun,6113,8,9,6,17,42,60,-18,33
FC Sion,6113,9,6,9,17,38,55,-17,27
Young Boys,6114,1,23,7,2,76,32,44,76
FC Basel,6114,2,19,8,5,58,26,32,65
St Gallen,6114,3,14,2,16,46,60,-14,44
Lucerne,6114,4,12,7,13,43,51,-8,43
FC Zürich,6114,5,10,9,13,38,37,1,39
FC Lugano,6114,6,11,5,16,34,48,-14,38
Grasshoppers,6114,7,9,7,16,40,49,-9,34
FC Sion,6114,8,8,8,16,41,54,-13,32
FC Thun,6114,9,9,5,18,44,63,-19,32
Young Boys,6115,1,20,10,2,69,33,36,70
FC Basel,6115,2,16,10,6,51,26,25,58
St Gallen,6115,3,15,2,15,42,57,-15,47
Lucerne,6115,4,12,9,11,40,42,-2,45
FC Lugano,6115,5,12,6,14,31,43,-12,42
FC Zürich,6115,6,10,10,12,40,37,3,40
FC Thun,6115,7,10,6,16,45,57,-12,36
Grasshoppers,6115,8,9,8,15,41,49,-8,35
FC Sion,6115,9,6,7,19,41,56,-15,25
Young Boys,6116,1,21,7,4,73,36,37,70
FC Basel,6116,2,18,7,7,57,27,30,61
Lucerne,6116,3,14,8,10,43,42,1,50
St Gallen,6116,4,15,2,15,45,55,-10,47
FC Zürich,6116,5,10,10,12,38,37,1,40
FC Lugano,6116,6,11,7,14,33,44,-11,40
FC Thun,6116,7,10,6,16,45,60,-15,36
Grasshoppers,6116,8,9,6,17,41,56,-15,33
FC Sion,6116,9,6,7,19,37,55,-18,25
Young Boys,6117,1,20,7,5,66,36,30,67
FC Basel,6117,2,16,8,8,51,29,22,56
Lucerne,6117,3,16,7,9,49,43,6,55
FC Zürich,6117,4,12,10,10,41,32,9,46
St Gallen,6117,5,14,2,16,46,61,-15,44
FC Lugano,6117,6,11,5,16,33,46,-13,38
Grasshoppers,6117,7,10,6,16,43,51,-8,36
FC Thun,6117,8,9,6,17,43,59,-16,33
FC Sion,6117,9,7,7,18,43,58,-15,28
Young Boys,6118,1,21,6,5,71,41,30,69
FC Basel,6118,2,17,8,7,52,27,25,59
Lucerne,6118,3,15,8,9,50,45,5,53
St Gallen,6118,4,14,2,16,42,54,-12,44
FC Zürich,6118,5,10,12,10,40,35,5,42
Grasshoppers,6118,6,10,7,15,45,50,-5,37
FC Thun,6118,7,10,6,16,45,57,-12,36
FC Lugano,6118,8,10,6,16,31,49,-18,36
FC Sion,6118,9,5,9,18,39,57,-18,24
Young Boys,6119,1,22,7,3,74,34,40,73
FC Basel,6119,2,19,7,6,55,25,30,64
FC Zürich,6119,3,12,10,10,46,34,12,46
Lucerne,6119,4,12,8,12,43,51,-8,44
St Gallen,6119,5,13,3,16,41,58,-17,42
FC Lugano,6119,6,10,6,16,33,51,-18,36
FC Thun,6119,7,10,5,17,44,58,-14,35
Grasshoppers,6119,8,9,7,16,41,49,-8,34
FC Sion,6119,9,7,7,18,39,56,-17,28
Young Boys,6120,1,22,7,3,72,32,40,73
FC Basel,6120,2,18,8,6,56,26,30,62
St Gallen,6120,3,14,2,16,41,57,-16,44
FC Zürich,6120,4,11,10,11,44,40,4,43
FC Lugano,6120,5,12,5,15,34,46,-12,41
Lucerne,6120,6,11,7,14,39,47,-8,40
Grasshoppers,6120,7,10,7,15,41,50,-9,37
FC Thun,6120,8,10,5,17,45,60,-15,35
FC Sion,6120,9,6,9,17,40,54,-14,27
Young Boys,6121,1,22,7,3,76,37,39,73
FC Basel,6121,2,18,8,6,54,27,27,62
Lucerne,6121,3,13,8,11,42,44,-2,47
St Gallen,6121,4,13,3,16,42,59,-17,42
FC Thun,6121,5,11,6,15,47,58,-11,39
FC Zürich,6121,6,9,10,13,39,38,1,37
Grasshoppers,6121,7,10,6,16,45,54,-9,36
FC Lugano,6121,8,9,8,15,33,50,-17,35
FC Sion,6121,9,7,8,17,43,54,-11,29
Young Boys,6122,1,22,7,3,69,34,35,73
FC Basel,6122,2,18,7,7,56,29,27,61
St Gallen,6122,3,15,3,14,42,52,-10,48
Lucerne,6122,4,12,8,12,43,47,-4,44
FC Zürich,6122,5,10,11,11,44,38,6,41
Grasshoppers,6122,6,11,7,14,45,48,-3,40
FC Lugano,6122,7,9,7,16,31,48,-17,34
FC Thun,6122,8,9,5,18,40,59,-19,32
FC Sion,6122,9,6,9,17,39,54,-15,27
Young Boys,6123,1,22,7,3,73,36,37,73
FC Basel,6123,2,19,7,6,57,26,31,64
Lucerne,6123,3,12,9,11,41,45,-4,45
St Gallen,6123,4,14,3,15,42,56,-14,45
FC Zürich,6123,5,10,9,13,40,38,2,39
FC Thun,6123,6,10,6,16,43,56,-13,36
Grasshoppers,6123,7,9,7,16,38,49,-11,34
FC Lugano,6123,8,9,7,16,29,46,-17,34
FC Sion,6123,9,7,9,16,44,55,-11,30
Young Boys,6124,1,21,7,4,71,37,34,70
FC Basel,6124,2,18,9,5,53,24,29,63
Lucerne,6124,3,13,9,10,48,46,2,48
St Gallen,6124,4,15,2,15,45,55,-10,47
FC Zürich,6124,5,10,11,11,46,39,7,41
Grasshoppers,6124,6,10,7,15,45,49,-4,37
FC Lugano,6124,7,10,6,16,32,50,-18,36
FC Thun,6124,8,9,6,17,43,61,-18,33
FC Sion,6124,9,6,7,19,43,65,-22,25
Young Boys,6125,1,21,8,3,72,34,38,71
FC Basel,6125,2,17,10,5,56,26,30,61
Lucerne,6125,3,14,8,10,43,41,2,50
FC Zürich,6125,4,11,11,10,39,33,6,44
St Gallen,6125,5,13,4,15,43,58,-15,43
FC Thun,6125,6,10,6,16,43,58,-15,36
FC Lugano,6125,7,9,7,16,29,48,-19,34
Grasshoppers,6125,8,8,8,16,38,50,-12,32
FC Sion,6125,9,6,8,18,39,54,-15,26
Young Boys,6126,1,20,7,5,72,44,28,67
FC Basel,6126,2,19,8,5,60,24,36,65
Lucerne,6126,3,13,8,11,42,43,-1,47
St Gallen,6126,4,14,3,15,41,54,-13,45
FC Zürich,6126,5,11,11,10,42,35,7,44
Grasshoppers,6126,6,11,6,15,43,48,-5,39
FC Lugano,6126,7,10,6,16,33,50,-17,36
FC Thun,6126,8,9,5,18,45,63,-18,32
FC Sion,6126,9,5,10,17,37,54,-17,25
Young Boys,6127,1,22,7,3,72,33,39,73
FC Basel,6127,2,17,9,6,53,24,29,60
FC Zürich,6127,3,12,9,11,42,35,7,45
Lucerne,6127,4,12,9,11,41,42,-1,45
St Gallen,6127,5,14,3,15,42,57,-15,45
Grasshoppers,6127,6,11,7,14,47,50,-3,40
FC Lugano,6127,7,10,6,16,32,50,-18,36
FC Thun,6127,8,8,6,18,42,64,-22,30
FC Sion,6127,9,5,10,17,43,59,-16,25
Young Boys,6128,1,20,8,4,70,37,33,68
FC Basel,6128,2,16,8,8,49,27,22,56
St Gallen,6128,3,15,3,14,43,52,-9,48
Lucerne,6128,4,12,10,10,41,43,-2,46
FC Zürich,6128,5,11,9,12,40,36,4,42
Grasshoppers,6128,6,11,6,15,47,48,-1,39
FC Thun,6128,7,10,5,17,42,60,-18,35
FC Lugano,6128,8,9,7,16,30,47,-17,34
FC Sion,6128,9,8,8,16,40,52,-12,32
Young Boys,6129,1,23,7,2,74,34,40,76
FC Basel,6129,2,17,7,8,54,28,26,58
FC Zürich,6129,3,13,9,10,46,34,12,48
Lucerne,6129,4,12,8,12,39,42,-3,44
St Gallen,6129,5,13,4,15,41,55,-14,43
FC Lugano,6129,6,11,5,16,32,48,-16,38
Grasshoppers,6129,7,10,7,15,42,51,-9,37
FC Thun,6129,8,9,5,18,41,61,-20,32
FC Sion,6129,9,6,8,18,43,59,-16,26
Young Boys,6130,1,22,6,4,69,36,33,72
FC Basel,6130,2,16,7,9,49,30,19,55
St Gallen,6130,3,15,3,14,43,53,-10,48
FC Zürich,6130,4,11,11,10,46,37,9,44
Lucerne,6130,5,12,8,12,41,44,-3,44
FC Thun,6130,6,11,6,15,47,56,-9,39
Grasshoppers,6130,7,10,7,15,39,46,-7,37
FC Lugano,6130,8,10,6,16,32,48,-16,36
FC Sion,6130,9,6,8,18,42,58,-16,26
Young Boys,6131,1,21,7,4,72,37,35,70
FC Basel,6131,2,20,7,5,58,24,34,67
St Gallen,6131,3,15,2,15,46,55,-9,47
Lucerne,6131,4,12,7,13,44,52,-8,43
FC Zürich,6131,5,10,9,13,41,40,1,39
FC Lugano,6131,6,11,6,15,32,47,-15,39
Grasshoppers,6131,7,10,6,16,42,48,-6,36
FC Thun,6131,8,9,6,17,43,61,-18,33
FC Sion,6131,9,7,8,17,40,54,-14,29
Young Boys,6132,1,22,6,4,70,36,34,72
FC Basel,6132,2,18,8,6,55,28,27,62
Lucerne,6132,3,13,9,10,45,45,0,48
St Gallen,6132,4,14,2,16,42,54,-12,44
FC Zürich,6132,5,11,10,11,41,36,5,43
FC Thun,6132,6,10,6,16,43,57,-14,36
Grasshoppers,6132,7,9,8,15,39,49,-10,35
FC Lugano,6132,8,9,5,18,29,49,-20,32
FC Sion,6132,9,7,8,17,40,50,-10,29
Young Boys,6133,1,20,7,5,66,34,32,67
FC Basel,6133,2,17,10,5,54,24,30,61
Lucerne,6133,3,13,9,10,41,42,-1,48
St Gallen,6133,4,15,2,15,43,55,-12,47
FC Zürich,6133,5,12,10,10,43,35,8,46
Grasshoppers,6133,6,10,6,16,39,46,-7,36
FC Lugano,6133,7,10,6,16,29,45,-16,36
FC Thun,6133,8,9,5,18,40,59,-19,32
FC Sion,6133,9,7,7,18,39,54,-15,28
Young Boys,6134,1,20,6,6,71,40,31,66
FC Basel,6134,2,18,9,5,54,26,28,63
Lucerne,6134,3,13,9,10,45,45,0,48
St Gallen,6134,4,14,3,15,46,55,-9,45
FC Zürich,6134,5,11,11,10,43,34,9,44
Grasshoppers,6134,6,10,8,14,43,48,-5,38
FC Lugano,6134,7,10,6,16,29,48,-19,36
FC Thun,6134,8,9,5,18,42,62,-20,32
FC Sion,6134,9,6,9,17,39,54,-15,27
Young Boys,6135,1,22,6,4,70,37,33,72
FC Basel,6135,2,18,9,5,55,22,33,63
St Gallen,6135,3,15,4,13,42,51,-9,49
Lucerne,6135,4,11,11,10,41,43,-2,44
FC Zürich,6135,5,11,10,11,41,36,5,43
FC Thun,6135,6,10,6,16,42,58,-16,36
Grasshoppers,6135,7,9,7,16,41,48,-7,34
FC Lugano,6135,8,9,6,17,29,49,-20,33
FC Sion,6135,9,6,7,19,37,54,-17,25
Young Boys,6136,1,22,7,3,73,37,36,73
FC Basel,6136,2,16,8,8,51,30,21,56
St Gallen,6136,3,16,2,14,48,55,-7,50
Lucerne,6136,4,14,7,11,44,41,3,49
FC Zürich,6136,5,11,10,11,42,37,5,43
Grasshoppers,6136,6,9,8,15,43,49,-6,35
FC Lugano,6136,7,10,5,17,32,51,-19,35
FC Thun,6136,8,9,6,17,44,59,-15,33
FC Sion,6136,9,6,9,17,40,58,-18,27
Young Boys,6137,1,21,7,4,70,37,33,70
FC Basel,6137,2,17,8,7,52,25,27,59
Lucerne,6137,3,14,7,11,45,43,2,49
St Gallen,6137,4,14,3,15,41,56,-15,45
FC Zürich,6137,5,11,11,10,40,34,6,44
Grasshoppers,6137,6,11,6,15,43,47,-4,39
FC Lugano,6137,7,9,7,16,29,47,-18,34
FC Thun,6137,8,9,6,17,44,60,-16,33
FC Sion,6137,9,7,7,18,42,57,-15,28
Young Boys,6138,1,21,6,5,70,35,35,69
FC Basel,6138,2,19,7,6,54,25,29,64
St Gallen,6138,3,16,2,14,42,51,-9,50
Lucerne,6138,4,13,7,12,41,43,-2,46
FC Zürich,6138,5,10,9,13,40,39,1,39
FC Thun,6138,6,11,6,15,44,55,-11,39
Grasshoppers,6138,7,10,7,15,44,49,-5,37
FC Lugano,6138,8,9,5,18,29,50,-21,32
FC Sion,6138,9,7,7,18,39,56,-17,28
Young Boys,6139,1,22,6,4,72,36,36,72
FC Basel,6139,2,19,8,5,59,24,35,65
FC Zürich,6139,3,12,9,11,41,33,8,45
St Gallen,6139,4,14,3,15,42,58,-16,45
Lucerne,6139,5,12,8,12,42,44,-2,44
Grasshoppers,6139,6,11,7,14,47,50,-3,40
FC Thun,6139,7,9,7,16,43,58,-15,34
FC Lugano,6139,8,9,5,18,28,52,-24,32
FC Sion,6139,9,6,7,19,43,62,-19,25
Young Boys,6140,1,22,6,4,74,35,39,72
FC Basel,6140,2,19,8,5,55,24,31,65
St Gallen,6140,3,15,3,14,47,53,-6,48
FC Zürich,6140,4,11,10,11,42,37,5,43
Lucerne,6140,5,12,7,13,42,54,-12,43
Grasshoppers,6140,6,10,6,16,42,48,-6,36
FC Lugano,6140,7,10,6,16,30,47,-17,36
FC Thun,6140,8,9,5,18,42,59,-17,32
FC Sion,6140,9,7,7,18,40,57,-17,28
Young Boys,6141,1,22,6,4,71,34,37,72
FC Basel,6141,2,18,8,6,52,25,27,62
FC Zürich,6141,3,12,9,11,43,36,7,45
St Gallen,6141,4,14,3,15,46,58,-12,45
Lucerne,6141,5,12,7,13,39,48,-9,43
FC Thun,6141,6,11,5,16,48,56,-8,38
FC Lugano,6141,7,11,5,16,33,46,-13,38
Grasshoppers,6141,8,9,7,16,44,56,-12,34
FC Sion,6141,9,6,8,18,41,58,-17,26
Young Boys,6142,1,22,8,2,70,31,39,74
FC Basel,6142,2,16,8,8,53,26,27,56
Lucerne,6142,3,13,8,11,41,44,-3,47
FC Zürich,6142,4,11,11,10,42,32,10,44
St Gallen,6142,5,14,2,16,41,55,-14,44
Grasshoppers,6142,6,10,8,14,42,48,-6,38
FC Lugano,6142,7,10,7,15,29,44,-15,37
FC Thun,6142,8,9,6,17,42,65,-23,33
FC Sion,6142,9,6,8,18,38,53,-15,26
Young Boys,6143,1,20,10,2,72,34,38,70
FC Basel,6143,2,16,9,7,57,33,24,57
St Gallen,6143,3,16,2,14,44,52,-8,50
Lucerne,6143,4,12,7,13,41,50,-9,43
FC Zürich,6143,5,10,10,12,41,40,1,40
FC Thun,6143,6,10,7,15,48,58,-10,37
Grasshoppers,6143,7,9,8,15,43,49,-6,35
FC Lugano,6143,8,9,7,16,29,47,-18,34
FC Sion,6143,9,8,8,16,44,56,-12,32
Young Boys,6144,1,21,6,5,71,38,33,69
FC Basel,6144,2,19,7,6,58,24,34,64
Lucerne,6144,3,15,8,9,42,38,4,53
FC Zürich,6144,4,11,10,11,42,37,5,43
St Gallen,6144,5,13,4,15,40,54,-14,43
FC Thun,6144,6,10,5,17,47,60,-13,35
FC Lugano,6144,7,10,5,17,30,51,-21,35
Grasshoppers,6144,8,9,6,17,41,53,-12,33
FC Sion,6144,9,6,9,17,36,52,-16,27
Young Boys,6145,1,21,8,3,71,35,36,71
FC Basel,6145,2,17,9,6,50,24,26,60
Lucerne,6145,3,13,8,11,43,47,-4,47
St Gallen,6145,4,14,4,14,45,54,-9,46
FC Zürich,6145,5,10,9,13,41,39,2,39
FC Thun,6145,6,11,5,16,44,57,-13,38
FC Lugano,6145,7,11,5,16,35,49,-14,38
Grasshoppers,6145,8,9,6,17,40,51,-11,33
FC Sion,6145,9,7,8,17,42,55,-13,29
Young Boys,6146,1,22,8,2,71,31,40,74
FC Basel,6146,2,16,10,6,52,25,27,58
St Gallen,6146,3,15,4,13,45,53,-8,49
FC Zürich,6146,4,11,11,10,43,36,7,44
Lucerne,6146,5,11,10,11,40,45,-5,43
Grasshoppers,6146,6,9,9,14,43,47,-4,36
FC Lugano,6146,7,9,8,15,30,48,-18,35
FC Thun,6146,8,8,6,18,42,63,-21,30
FC Sion,6146,9,6,8,18,40,58,-18,26
Young Boys,6147,1,22,6,4,69,34,35,72
FC Basel,6147,2,18,8,6,55,27,28,62
St Gallen,6147,3,14,3,15,44,58,-14,45
Lucerne,6147,4,12,8,12,42,45,-3,44
FC Zürich,6147,5,11,9,12,42,39,3,42
FC Lugano,6147,6,11,6,15,33,44,-11,39
Grasshoppers,6147,7,10,7,15,44,49,-5,37
FC Thun,6147,8,9,6,17,43,60,-17,33
FC Sion,6147,9,7,7,18,43,59,-16,28
Young Boys,6148,1,21,8,3,69,30,39,71
FC Basel,6148,2,18,7,7,55,27,28,61
Lucerne,6148,3,14,8,10,44,44,0,50
St Gallen,6148,4,14,2,16,43,58,-15,44
FC Zürich,6148,5,11,10,11,45,42,3,43
FC Thun,6148,6,10,6,16,48,59,-11,36
FC Lugano,6148,7,9,7,16,30,48,-18,34
Grasshoppers,6148,8,8,8,16,38,50,-12,32
FC Sion,6148,9,7,8,17,42,56,-14,29
Young Boys,6149,1,23,7,2,78,33,45,76
FC Basel,6149,2,18,8,6,52,25,27,62
Lucerne,6149,3,13,8,11,41,43,-2,47
St Gallen,6149,4,13,4,15,41,55,-14,43
FC Lugano,6149,5,11,7,14,36,47,-11,40
FC Zürich,6149,6,10,9,13,40,39,1,39
FC Thun,6149,7,11,5,16,48,61,-13,38
Grasshoppers,6149,8,9,6,17,43,54,-11,33
FC Sion,6149,9,5,8,19,40,62,-22,23
Young Boys,6150,1,22,6,4,78,35,43,72
FC Basel,6150,2,18,8,6,59,26,33,62
St Gallen,6150,3,15,3,14,44,53,-9,48
Lucerne,6150,4,12,9,11,40,46,-6,45
FC Zürich,6150,5,11,10,11,44,36,8,43
Grasshoppers,6150,6,10,7,15,43,49,-6,37
FC Thun,6150,7,10,5,17,41,63,-22,35
FC Lugano,6150,8,9,7,16,29,48,-19,34
FC Sion,6150,9,6,7,19,41,63,-22,25
Young Boys,6151,1,21,8,3,68,33,35,71
Lucerne,6151,2,16,7,9,45,38,7,55
FC Basel,6151,3,15,8,9,48,29,19,53
St Gallen,6151,4,14,2,16,40,55,-15,44
FC Zürich,6151,5,11,10,11,41,36,5,43
FC Thun,6151,6,11,5,16,45,57,-12,38
FC Lugano,6151,7,10,5,17,30,47,-17,35
FC Sion,6151,8,8,8,16,41,50,-9,32
Grasshoppers,6151,9,8,7,17,38,51,-13,31
Young Boys,6152,1,21,8,3,75,37,38,71
FC Basel,6152,2,18,9,5,56,27,29,63
Lucerne,6152,3,12,9,11,45,47,-2,45
FC Zürich,6152,4,11,10,11,40,34,6,43
St Gallen,6152,5,13,4,15,45,58,-13,43
Grasshoppers,6152,6,10,6,16,40,49,-9,36
FC Lugano,6152,7,10,6,16,31,49,-18,36
FC Thun,6152,8,9,5,18,41,59,-18,32
FC Sion,6152,9,8,7,17,40,53,-13,31
Young Boys,6153,1,23,6,3,72,32,40,75
FC Basel,6153,2,19,7,6,55,23,32,64
Lucerne,6153,3,12,8,12,40,47,-7,44
St Gallen,6153,4,14,2,16,41,57,-16,44
FC Zürich,6153,5,11,10,11,41,36,5,43
Grasshoppers,6153,6,10,6,16,46,51,-5,36
FC Thun,6153,7,10,6,16,48,60,-12,36
FC Lugano,6153,8,9,6,17,29,48,-19,33
FC Sion,6153,9,7,7,18,42,60,-18,28
Young Boys,6154,1,21,7,4,73,36,37,70
FC Basel,6154,2,17,8,7,52,26,26,59
Lucerne,6154,3,14,8,10,41,41,0,50
St Gallen,6154,4,14,4,14,41,52,-11,46
FC Zürich,6154,5,10,11,11,42,38,4,41
Grasshoppers,6154,6,9,9,14,43,49,-6,36
FC Lugano,6154,7,9,8,15,30,51,-21,35
FC Thun,6154,8,9,7,16,44,59,-15,34
FC Sion,6154,9,6,8,18,42,56,-14,26
Young Boys,6155,1,20,8,4,70,36,34,68
FC Basel,6155,2,17,9,6,54,24,30,60
St Gallen,6155,3,16,3,13,44,51,-7,51
Lucerne,6155,4,13,8,11,41,43,-2,47
FC Zürich,6155,5,11,9,12,44,39,5,42
Grasshoppers,6155,6,10,6,16,43,51,-8,36
FC Lugano,6155,7,10,6,16,28,45,-17,36
FC Thun,6155,8,10,5,17,45,61,-16,35
FC Sion,6155,9,6,8,18,40,59,-19,26
Young Boys,6156,1,20,7,5,69,38,31,67
FC Basel,6156,2,19,7,6,52,24,28,64
Lucerne,6156,3,13,8,11,40,41,-1,47
St Gallen,6156,4,13,3,16,39,55,-16,42
FC Zürich,6156,5,9,12,11,37,35,2,39
Grasshoppers,6156,6,11,6,15,42,48,-6,39
FC Lugano,6156,7,10,8,14,33,45,-12,38
FC Thun,6156,8,10,6,16,47,55,-8,36
FC Sion,6156,9,6,9,17,39,57,-18,27
Young Boys,6157,1,20,8,4,67,37,30,68
FC Basel,6157,2,17,10,5,57,25,32,61
Lucerne,6157,3,14,9,9,44,40,4,51
St Gallen,6157,4,15,3,14,45,55,-10,48
FC Zürich,6157,5,11,9,12,41,40,1,42
Grasshoppers,6157,6,10,6,16,42,48,-6,36
FC Thun,6157,7,10,6,16,43,57,-14,36
FC Lugano,6157,8,9,6,17,31,50,-19,33
FC Sion,6157,9,6,7,19,40,58,-18,25
Young Boys,6158,1,21,7,4,71,35,36,70
FC Basel,6158,2,19,7,6,56,24,32,64
St Gallen,6158,3,16,2,14,45,53,-8,50
Lucerne,6158,4,13,8,11,40,40,0,47
Grasshoppers,6158,5,11,6,15,43,48,-5,39
FC Zürich,6158,6,9,11,12,37,38,-1,38
FC Thun,6158,7,9,6,17,42,61,-19,33
FC Lugano,6158,8,9,6,17,28,49,-21,33
FC Sion,6158,9,7,7,18,41,55,-14,28
Young Boys,6159,1,22,6,4,74,35,39,72
FC Basel,6159,2,16,9,7,54,28,26,57
St Gallen,6159,3,15,3,14,43,56,-13,48
Lucerne,6159,4,13,8,11,40,43,-3,47
FC Zürich,6159,5,10,10,12,41,39,2,40
Grasshoppers,6159,6,11,7,14,45,47,-2,40
FC Thun,6159,7,10,6,16,44,57,-13,36
FC Lugano,6159,8,10,6,16,32,49,-17,36
FC Sion,6159,9,6,7,19,39,58,-19,25
Young Boys,6160,1,21,7,4,78,41,37,70
FC Basel,6160,2,19,8,5,61,29,32,65
St Gallen,6160,3,14,4,14,44,57,-13,46
Lucerne,6160,4,12,7,13,39,47,-8,43
FC Zürich,6160,5,11,9,12,44,39,5,42
Grasshoppers,6160,6,10,6,16,45,50,-5,36
FC Lugano,6160,7,10,6,16,32,50,-18,36
FC Sion,6160,8,8,8,16,46,57,-11,32
FC Thun,6160,9,9,5,18,41,60,-19,32
Young Boys,6161,1,22,7,3,71,30,41,73
FC Basel,6161,2,18,8,6,53,24,29,62
FC Zürich,6161,3,12,10,10,41,34,7,46
Lucerne,6161,4,13,7,12,40,44,-4,46
St Gallen,6161,5,14,2,16,41,56,-15,44
Grasshoppers,6161,6,10,6,16,43,51,-8,36
FC Lugano,6161,7,10,5,17,29,47,-18,35
FC Sion,6161,8,8,8,16,44,53,-9,32
FC Thun,6161,9,8,5,19,42,65,-23,29
Young Boys,6162,1,22,7,3,75,35,40,73
FC Basel,6162,2,16,8,8,54,32,22,56
St Gallen,6162,3,16,3,13,49,55,-6,51
Lucerne,6162,4,13,10,9,42,40,2,49
FC Thun,6162,5,12,5,15,49,57,-8,41
FC Zürich,6162,6,10,9,13,40,39,1,39
FC Lugano,6162,7,9,5,18,31,54,-23,32
Grasshoppers,6162,8,8,7,17,41,55,-14,31
FC Sion,6162,9,7,8,17,41,55,-14,29
Young Boys,6163,1,21,8,3,73,35,38,71
FC Basel,6163,2,17,9,6,55,27,28,60
FC Zürich,6163,3,11,11,10,47,37,10,44
St Gallen,6163,4,13,5,14,41,55,-14,44
Lucerne,6163,5,11,9,12,41,46,-5,42
Grasshoppers,6163,6,11,7,14,41,45,-4,40
FC Lugano,6163,7,9,8,15,32,51,-19,35
FC Thun,6163,8,8,8,16,44,60,-16,32
FC Sion,6163,9,5,11,16,37,55,-18,26
Young Boys,6164,1,20,8,4,73,40,33,68
FC Basel,6164,2,17,9,6,55,27,28,60
Lucerne,6164,3,13,8,11,43,44,-1,47
St Gallen,6164,4,14,3,15,43,58,-15,45
FC Zürich,6164,5,10,11,11,44,38,6,41
FC Lugano,6164,6,11,6,15,34,48,-14,39
FC Thun,6164,7,10,5,17,45,58,-13,35
Grasshoppers,6164,8,9,7,16,41,52,-11,34
FC Sion,6164,9,7,9,16,44,57,-13,30
Young Boys,6165,1,21,7,4,68,33,35,70
FC Basel,6165,2,18,8,6,54,24,30,62
FC Zürich,6165,3,13,9,10,45,36,9,48
St Gallen,6165,4,14,3,15,40,53,-13,45
Lucerne,6165,5,11,8,13,38,45,-7,41
Grasshoppers,6165,6,11,7,14,41,45,-4,40
FC Lugano,6165,7,10,6,16,32,47,-15,36
FC Thun,6165,8,9,5,18,44,63,-19,32
FC Sion,6165,9,7,7,18,39,55,-16,28
Young Boys,6166,1,21,8,3,68,33,35,71
FC Basel,6166,2,17,9,6,55,28,27,60
Lucerne,6166,3,13,7,12,42,44,-2,46
St Gallen,6166,4,13,4,15,43,59,-16,43
FC Zürich,6166,5,11,9,12,39,37,2,42
Grasshoppers,6166,6,11,6,15,47,53,-6,39
FC Lugano,6166,7,11,5,16,34,45,-11,38
FC Thun,6166,8,10,5,17,47,63,-16,35
FC Sion,6166,9,6,9,17,40,53,-13,27
Young Boys,6167,1,20,7,5,68,35,33,67
FC Basel,6167,2,18,7,7,54,27,27,61
Lucerne,6167,3,13,9,10,45,43,2,48
St Gallen,6167,4,15,3,14,44,56,-12,48
FC Zürich,6167,5,10,10,12,38,37,1,40
FC Thun,6167,6,11,5,16,46,59,-13,38
Grasshoppers,6167,7,10,6,16,43,51,-8,36
FC Lugano,6167,8,10,6,16,31,48,-17,36
FC Sion,6167,9,7,7,18,40,53,-13,28
Young Boys,6168,1,21,8,3,72,35,37,71
FC Basel,6168,2,19,7,6,61,26,35,64
St Gallen,6168,3,15,3,14,42,53,-11,48
Lucerne,6168,4,13,8,11,43,41,2,47
FC Zürich,6168,5,11,9,12,42,42,0,42
FC Thun,6168,6,10,6,16,48,64,-16,36
Grasshoppers,6168,7,9,7,16,40,54,-14,34
FC Lugano,6168,8,9,6,17,33,52,-19,33
FC Sion,6168,9,6,8,18,42,56,-14,26
Young Boys,6169,1,23,6,3,78,34,44,75
FC Basel,6169,2,18,7,7,53,28,25,61
St Gallen,6169,3,15,2,15,42,54,-12,47
FC Zürich,6169,4,11,11,10,44,37,7,44
Lucerne,6169,5,12,7,13,43,53,-10,43
Grasshoppers,6169,6,12,6,14,42,46,-4,42
FC Thun,6169,7,9,6,17,41,57,-16,33
FC Lugano,6169,8,9,5,18,31,51,-20,32
FC Sion,6169,9,6,8,18,41,55,-14,26
Young Boys,6170,1,21,9,2,74,31,43,72
FC Basel,6170,2,16,10,6,53,25,28,58
St Gallen,6170,3,14,3,15,45,61,-16,45
Lucerne,6170,4,11,11,10,42,44,-2,44
FC Zürich,6170,5,11,9,12,42,40,2,42
FC Lugano,6170,6,10,6,16,32,54,-22,36
Grasshoppers,6170,7,9,8,15,40,49,-9,35
FC Thun,6170,8,10,5,17,48,64,-16,35
FC Sion,6170,9,8,7,17,49,57,-8,31
Young Boys,6171,1,20,9,3,68,34,34,69
FC Basel,6171,2,17,8,7,54,28,26,59
St Gallen,6171,3,15,2,15,43,52,-9,47
Lucerne,6171,4,12,9,11,41,46,-5,45
FC Zürich,6171,5,9,11,12,40,39,1,38
FC Thun,6171,6,10,7,15,46,58,-12,37
FC Lugano,6171,7,10,6,16,31,48,-17,36
Grasshoppers,6171,8,9,8,15,42,50,-8,35
FC Sion,6171,9,8,8,16,42,52,-10,32
Young Boys,6172,1,19,9,4,68,37,31,66
FC Basel,6172,2,18,7,7,51,25,26,61
Lucerne,6172,3,13,9,10,40,40,0,48
St Gallen,6172,4,15,3,14,43,52,-9,48
FC Zürich,6172,5,11,10,11,42,35,7,43
FC Lugano,6172,6,9,8,15,31,48,-17,35
Grasshoppers,6172,7,9,7,16,42,51,-9,34
FC Sion,6172,8,8,8,16,41,50,-9,32
FC Thun,6172,9,9,5,18,41,61,-20,32
Young Boys,6173,1,22,8,2,74,32,42,74
FC Basel,6173,2,16,9,7,50,29,21,57
Lucerne,6173,3,13,9,10,43,43,0,48
St Gallen,6173,4,14,4,14,40,51,-11,46
FC Zürich,6173,5,10,10,12,42,38,4,40
FC Thun,6173,6,11,5,16,47,57,-10,38
FC Lugano,6173,7,9,7,16,30,47,-17,34
Grasshoppers,6173,8,8,8,16,38,53,-15,32
FC Sion,6173,9,6,10,16,39,53,-14,28
Young Boys,6174,1,20,9,3,68,37,31,69
FC Basel,6174,2,17,9,6,52,24,28,60
Lucerne,6174,3,13,8,11,38,40,-2,47
St Gallen,6174,4,14,3,15,42,54,-12,45
FC Zürich,6174,5,10,10,12,39,35,4,40
FC Lugano,6174,6,11,5,16,34,46,-12,38
Grasshoppers,6174,7,9,9,14,40,46,-6,36
FC Thun,6174,8,8,8,16,41,59,-18,32
FC Sion,6174,9,7,9,16,39,52,-13,30
Young Boys,6175,1,21,8,3,69,33,36,71
FC Basel,6175,2,18,7,7,56,29,27,61
Lucerne,6175,3,14,7,11,41,41,0,49
FC Zürich,6175,4,13,9,10,43,35,8,48
St Gallen,6175,5,13,3,16,39,54,-15,42
Grasshoppers,6175,6,9,8,15,39,45,-6,35
FC Thun,6175,7,10,5,17,47,62,-15,35
FC Lugano,6175,8,10,5,17,30,48,-18,35
FC Sion,6175,9,5,10,17,38,55,-17,25
Young Boys,6176,1,21,8,3,68,34,34,71
FC Basel,6176,2,18,8,6,52,27,25,62
St Gallen,6176,3,15,3,14,49,55,-6,48
Lucerne,6176,4,12,9,11,38,41,-3,45
FC Zürich,6176,5,11,9,12,40,37,3,42
FC Thun,6176,6,10,6,16,48,58,-10,36
FC Lugano,6176,7,10,5,17,33,51,-18,35
FC Sion,6176,8,8,7,17,42,54,-12,31
Grasshoppers,6176,9,8,7,17,37,50,-13,31
Young Boys,6177,1,20,7,5,67,35,32,67
FC Basel,6177,2,16,9,7,50,28,22,57
Lucerne,6177,3,15,8,9,48,44,4,53
St Gallen,6177,4,14,4,14,41,53,-12,46
FC Zürich,6177,5,12,9,11,44,37,7,45
FC Lugano,6177,6,10,7,15,32,45,-13,37
FC Thun,6177,7,10,6,16,45,59,-14,36
Grasshoppers,6177,8,8,7,17,38,50,-12,31
FC Sion,6177,9,7,7,18,41,55,-14,28
Young Boys,6178,1,21,8,3,71,36,35,71
FC Basel,6178,2,17,8,7,57,31,26,59
St Gallen,6178,3,16,2,14,47,55,-8,50
Lucerne,6178,4,12,7,13,41,47,-6,43
FC Thun,6178,5,12,5,15,49,57,-8,41
FC Zürich,6178,6,10,10,12,41,39,2,40
Grasshoppers,6178,7,9,7,16,41,52,-11,34
FC Sion,6178,8,8,8,16,44,54,-10,32
FC Lugano,6178,9,9,5,18,29,49,-20,32
Young Boys,6179,1,21,8,3,71,35,36,71
FC Basel,6179,2,18,8,6,57,28,29,62
Lucerne,6179,3,13,9,10,48,43,5,48
St Gallen,6179,4,15,2,15,43,56,-13,47
FC Zürich,6179,5,10,11,11,40,37,3,41
FC Lugano,6179,6,10,6,16,31,51,-20,36
Grasshoppers,6179,7,9,8,15,43,53,-10,35
FC Thun,6179,8,9,7,16,47,62,-15,34
FC Sion,6179,9,6,7,19,40,55,-15,25
Young Boys,6180,1,21,6,5,71,38,33,69
FC Basel,6180,2,17,10,5,50,23,27,61
Lucerne,6180,3,13,8,11,45,48,-3,47
St Gallen,6180,4,13,3,16,42,57,-15,42
FC Zürich,6180,5,10,11,11,46,42,4,41
FC Lugano,6180,6,11,6,15,36,47,-11,39
FC Sion,6180,7,10,7,15,50,53,-3,37
FC Thun,6180,8,9,6,17,44,62,-18,33
Grasshoppers,6180,9,8,7,17,39,53,-14,31
Young Boys,6181,1,21,8,3,72,36,36,71
FC Basel,6181,2,19,7,6,58,26,32,64
Lucerne,6181,3,13,9,10,47,47,0,48
St Gallen,6181,4,14,4,14,45,56,-11,46
FC Zürich,6181,5,11,10,11,41,34,7,43
Grasshoppers,6181,6,9,7,16,39,52,-13,34
FC Thun,6181,7,9,7,16,45,60,-15,34
FC Lugano,6181,8,9,7,16,32,49,-17,34
FC Sion,6181,9,5,9,18,39,58,-19,24
Young Boys,6182,1,21,8,3,72,36,36,71
FC Basel,6182,2,18,7,7,56,33,23,61
Lucerne,6182,3,13,8,11,42,42,0,47
St Gallen,6182,4,13,3,16,41,57,-16,42
FC Zürich,6182,5,10,11,11,39,36,3,41
FC Lugano,6182,6,10,8,14,32,46,-14,38
FC Thun,6182,7,10,7,15,48,56,-8,37
Grasshoppers,6182,8,9,6,17,39,52,-13,33
FC Sion,6182,9,7,8,17,43,54,-11,29
Young Boys,6183,1,24,6,2,79,31,48,78
FC Basel,6183,2,18,8,6,53,25,28,62
St Gallen,6183,3,14,4,14,44,55,-11,46
FC Zürich,6183,4,12,9,11,41,35,6,45
Lucerne,6183,5,11,8,13,38,47,-9,41
FC Lugano,6183,6,11,5,16,32,47,-15,38
Grasshoppers,6183,7,10,7,15,40,48,-8,37
FC Thun,6183,8,8,7,17,40,58,-18,31
FC Sion,6183,9,5,8,19,38,59,-21,23
Young Boys,6184,1,21,7,4,72,35,37,70
FC Basel,6184,2,18,7,7,55,26,29,61
Lucerne,6184,3,12,9,11,42,48,-6,45
FC Zürich,6184,4,11,11,10,41,34,7,44
St Gallen,6184,5,13,3,16,44,59,-15,42
Grasshoppers,6184,6,11,7,14,46,49,-3,40
FC Lugano,6184,7,10,7,15,34,49,-15,37
FC Thun,6184,8,10,6,16,42,55,-13,36
FC Sion,6184,9,6,7,19,37,58,-21,25
Young Boys,6185,1,23,7,2,76,33,43,76
FC Basel,6185,2,17,8,7,52,27,25,59
St Gallen,6185,3,15,3,14,44,55,-11,48
FC Zürich,6185,4,12,9,11,45,42,3,45
Lucerne,6185,5,11,8,13,41,50,-9,41
FC Thun,6185,6,10,6,16,47,59,-12,36
FC Lugano,6185,7,10,6,16,34,48,-14,36
Grasshoppers,6185,8,9,8,15,43,53,-10,35
FC Sion,6185,9,6,7,19,43,58,-15,25
Young Boys,6186,1,23,7,2,77,32,45,76
FC Basel,6186,2,19,8,5,57,25,32,65
St Gallen,6186,3,14,2,16,43,56,-13,44
Lucerne,6186,4,12,7,13,43,48,-5,43
FC Lugano,6186,5,12,5,15,34,48,-14,41
FC Zürich,6186,6,10,10,12,40,37,3,40
FC Thun,6186,7,10,6,16,47,59,-12,36
Grasshoppers,6186,8,9,6,17,40,59,-19,33
FC Sion,6186,9,6,7,19,39,56,-17,25
Young Boys,6187,1,22,6,4,74,37,37,72
FC Basel,6187,2,18,8,6,57,26,31,62
St Gallen,6187,3,16,2,14,48,56,-8,50
Lucerne,6187,4,12,9,11,43,46,-3,45
FC Zürich,6187,5,11,10,11,42,35,7,43
Grasshoppers,6187,6,10,6,16,42,53,-11,36
FC Thun,6187,7,10,5,17,46,62,-16,35
FC Lugano,6187,8,9,7,16,31,50,-19,34
FC Sion,6187,9,6,7,19,39,57,-18,25
Young Boys,6188,1,23,6,3,76,34,42,75
FC Basel,6188,2,17,9,6,56,29,27,60
Lucerne,6188,3,13,9,10,42,44,-2,48
St Gallen,6188,4,14,3,15,44,55,-11,45
FC Lugano,6188,5,11,6,15,32,46,-14,39
FC Zürich,6188,6,9,11,12,42,41,1,38
FC Thun,6188,7,9,7,16,44,58,-14,34
Grasshoppers,6188,8,9,6,17,44,56,-12,33
FC Sion,6188,9,6,9,17,38,55,-17,27
Young Boys,6189,1,20,7,5,69,36,33,67
FC Basel,6189,2,18,8,6,56,26,30,62
St Gallen,6189,3,15,3,14,45,56,-11,48
Lucerne,6189,4,13,8,11,46,44,2,47
FC Zürich,6189,5,11,10,11,40,35,5,43
Grasshoppers,6189,6,10,7,15,42,51,-9,37
FC Lugano,6189,7,9,8,15,31,47,-16,35
FC Thun,6189,8,10,5,17,46,64,-18,35
FC Sion,6189,9,6,8,18,40,56,-16,26
Young Boys,6190,1,22,6,4,73,39,34,72
FC Basel,6190,2,18,8,6,55,25,30,62
FC Zürich,6190,3,11,11,10,44,35,9,44
Lucerne,6190,4,12,8,12,41,44,-3,44
St Gallen,6190,5,13,5,14,41,54,-13,44
Grasshoppers,6190,6,11,6,15,43,46,-3,39
FC Lugano,6190,7,9,7,16,29,48,-19,34
FC Thun,6190,8,9,6,17,43,61,-18,33
FC Sion,6190,9,7,7,18,41,58,-17,28
Young Boys,6191,1,21,8,3,70,35,35,71
FC Basel,6191,2,17,9,6,52,23,29,60
St Gallen,6191,3,15,3,14,46,56,-10,48
Lucerne,6191,4,13,7,12,43,44,-1,46
FC Zürich,6191,5,9,12,11,37,36,1,39
FC Thun,6191,6,11,6,15,41,53,-12,39
FC Lugano,6191,7,11,5,16,34,49,-15,38
Grasshoppers,6191,8,9,7,16,38,49,-11,34
FC Sion,6191,9,5,9,18,40,56,-16,24
Young Boys,6192,1,22,6,4,75,33,42,72
FC Basel,6192,2,17,8,7,54,26,28,59
Lucerne,6192,3,13,9,10,41,43,-2,48
St Gallen,6192,4,14,2,16,42,55,-13,44
FC Zürich,6192,5,10,10,12,38,36,2,40
FC Lugano,6192,6,11,6,15,30,48,-18,39
FC Thun,6192,7,10,6,16,46,61,-15,36
Grasshoppers,6192,8,9,6,17,39,51,-12,33
FC Sion,6192,9,8,7,17,41,53,-12,31
Young Boys,6193,1,23,7,2,79,33,46,76
FC Basel,6193,2,16,10,6,52,28,24,58
St Gallen,6193,3,15,4,13,45,53,-8,49
Lucerne,6193,4,13,8,11,46,45,1,47
FC Zürich,6193,5,10,9,13,43,40,3,39
FC Lugano,6193,6,10,6,16,30,52,-22,36
FC Thun,6193,7,10,5,17,42,59,-17,35
Grasshoppers,6193,8,9,6,17,40,52,-12,33
FC Sion,6193,9,7,7,18,44,59,-15,28
Young Boys,6194,1,21,6,5,71,37,34,69
FC Basel,6194,2,18,7,7,54,28,26,61
Lucerne,6194,3,14,8,10,46,43,3,50
FC Zürich,6194,4,11,9,12,39,36,3,42
St Gallen,6194,5,13,3,16,40,56,-16,42
FC Lugano,6194,6,11,5,16,33,47,-14,38
FC Thun,6194,7,10,6,16,43,58,-15,36
Grasshoppers,6194,8,9,7,16,41,50,-9,34
FC Sion,6194,9,7,9,16,39,51,-12,30
Young Boys,6195,1,20,9,3,70,37,33,69
FC Basel,6195,2,18,8,6,56,27,29,62
Lucerne,6195,3,13,7,12,41,44,-3,46
St Gallen,6195,4,14,2,16,42,56,-14,44
FC Lugano,6195,5,12,6,14,31,42,-11,42
FC Zürich,6195,6,10,10,12,40,38,2,40
Grasshoppers,6195,7,9,7,16,41,51,-10,34
FC Thun,6195,8,9,7,16,45,58,-13,34
FC Sion,6195,9,7,8,17,42,55,-13,29
Young Boys,6196,1,23,7,2,78,33,45,76
FC Basel,6196,2,17,8,7,51,29,22,59
Lucerne,6196,3,15,8,9,50,43,7,53
St Gallen,6196,4,14,3,15,41,54,-13,45
FC Zürich,6196,5,10,10,12,39,37,2,40
FC Thun,6196,6,10,6,16,47,56,-9,36
FC Lugano,6196,7,10,6,16,33,50,-17,36
Grasshoppers,6196,8,8,6,18,40,60,-20,30
FC Sion,6196,9,6,8,18,39,56,-17,26
Young Boys,6197,1,21,6,5,69,37,32,69
FC Basel,6197,2,18,7,7,54,28,26,61
Lucerne,6197,3,13,9,10,44,40,4,48
St Gallen,6197,4,15,3,14,45,54,-9,48
FC Zürich,6197,5,10,10,12,42,38,4,40
FC Thun,6197,6,11,6,15,50,56,-6,39
FC Lugano,6197,7,11,6,15,33,47,-14,39
Grasshoppers,6197,8,9,6,17,37,53,-16,33
FC Sion,6197,9,6,7,19,38,59,-21,25
Young Boys,6198,1,21,6,5,74,40,34,69
FC Basel,6198,2,17,7,8,53,28,25,58
St Gallen,6198,3,15,3,14,46,53,-7,48
Lucerne,6198,4,13,7,12,41,50,-9,46
FC Zürich,6198,5,11,9,12,40,36,4,42
FC Lugano,6198,6,11,6,15,33,47,-14,39
FC Thun,6198,7,11,5,16,46,58,-12,38
Grasshoppers,6198,8,9,7,16,44,54,-10,34
FC Sion,6198,9,7,8,17,44,55,-11,29
Young Boys,6199,1,23,6,3,75,37,38,75
FC Basel,6199,2,15,9,8,50,30,20,54
Lucerne,6199,3,15,8,9,48,41,7,53
St Gallen,6199,4,14,4,14,42,53,-11,46
FC Zürich,6199,5,10,10,12,39,38,1,40
FC Thun,6199,6,11,5,16,45,59,-14,38
Grasshoppers,6199,7,10,6,16,43,49,-6,36
FC Lugano,6199,8,10,6,16,31,49,-18,36
FC Sion,6199,9,5,8,19,41,58,-17,23
Young Boys,6200,1,21,7,4,70,36,34,70
FC Basel,6200,2,18,7,7,56,30,26,61
Lucerne,6200,3,13,8,11,43,43,0,47
St Gallen,6200,4,15,2,15,43,56,-13,47
FC Zürich,6200,5,12,9,11,42,37,5,45
FC Thun,6200,6,10,6,16,47,58,-11,36
Grasshoppers,6200,7,9,8,15,44,51,-7,35
FC Lugano,6200,8,10,5,17,28,47,-19,35
FC Sion,6200,9,6,8,18,42,57,-15,26
Young Boys,6201,1,24,6,2,75,33,42,78
FC Basel,6201,2,19,7,6,55,25,30,64
St Gallen,6201,3,15,3,14,41,52,-11,48
Lucerne,6201,4,13,7,12,39,43,-4,46
FC Zürich,6201,5,9,10,13,40,41,-1,37
Grasshoppers,6201,6,10,6,16,44,47,-3,36
FC Lugano,6201,7,10,6,16,30,48,-18,36
FC Thun,6201,8,8,6,18,42,64,-22,30
FC Sion,6201,9,7,7,18,42,55,-13,28
Young Boys,6202,1,22,7,3,74,33,41,73
FC Basel,6202,2,20,7,5,59,23,36,67
Lucerne,6202,3,14,7,11,43,41,2,49
St Gallen,6202,4,13,4,15,42,58,-16,43
FC Zürich,6202,5,9,11,12,38,38,0,38
FC Thun,6202,6,10,5,17,44,58,-14,35
Grasshoppers,6202,7,9,7,16,38,50,-12,34
FC Lugano,6202,8,9,7,16,32,52,-20,34
FC Sion,6202,9,6,9,17,37,54,-17,27
Young Boys,6203,1,22,7,3,73,33,40,73
FC Basel,6203,2,18,9,5,55,25,30,63
St Gallen,6203,3,14,4,14,44,55,-11,46
Lucerne,6203,4,11,11,10,42,46,-4,44
FC Zürich,6203,5,11,10,11,41,36,5,43
Grasshoppers,6203,6,9,8,15,41,49,-8,35
FC Lugano,6203,7,9,6,17,29,49,-20,33
FC Sion,6203,8,8,8,16,41,52,-11,32
FC Thun,6203,9,8,5,19,42,63,-21,29
Young Boys,6204,1,21,7,4,68,35,33,70
FC Basel,6204,2,18,7,7,54,29,25,61
FC Zürich,6204,3,12,9,11,50,40,10,45
Lucerne,6204,4,12,9,11,40,41,-1,45
St Gallen,6204,5,14,3,15,40,52,-12,45
Grasshoppers,6204,6,10,8,14,42,48,-6,38
FC Thun,6204,7,10,6,16,48,60,-12,36
FC Lugano,6204,8,9,7,16,28,46,-18,34
FC Sion,6204,9,6,8,18,39,58,-19,26
Young Boys,6205,1,22,8,2,74,32,42,74
FC Basel,6205,2,16,7,9,50,29,21,55
St Gallen,6205,3,16,2,14,45,53,-8,50
Lucerne,6205,4,13,8,11,43,49,-6,47
FC Zürich,6205,5,11,11,10,41,34,7,44
Grasshoppers,6205,6,10,8,14,43,47,-4,38
FC Thun,6205,7,9,6,17,44,59,-15,33
FC Lugano,6205,8,9,6,17,28,47,-19,33
FC Sion,6205,9,6,8,18,43,61,-18,26
Young Boys,6206,1,22,7,3,73,35,38,73
FC Basel,6206,2,16,9,7,53,28,25,57
St Gallen,6206,3,16,3,13,46,53,-7,51
FC Zürich,6206,4,11,10,11,44,37,7,43
Lucerne,6206,5,11,9,12,39,46,-7,42
FC Thun,6206,6,12,5,15,49,56,-7,41
FC Lugano,6206,7,9,7,16,31,48,-17,34
Grasshoppers,6206,8,8,8,16,40,54,-14,32
FC Sion,6206,9,6,8,18,42,60,-18,26
Young Boys,6207,1,22,7,3,73,35,38,73
FC Basel,6207,2,17,9,6,56,28,28,60
FC Zürich,6207,3,12,10,10,42,33,9,46
Lucerne,6207,4,13,7,12,42,45,-3,46
St Gallen,6207,5,14,3,15,44,57,-13,45
FC Lugano,6207,6,11,5,16,30,45,-15,38
FC Thun,6207,7,10,5,17,43,62,-19,35
Grasshoppers,6207,8,8,7,17,42,55,-13,31
FC Sion,6207,9,7,7,18,41,53,-12,28
Young Boys,6208,1,20,8,4,70,36,34,68
FC Basel,6208,2,18,7,7,53,28,25,61
St Gallen,6208,3,15,3,14,45,52,-7,48
Lucerne,6208,4,12,9,11,41,46,-5,45
FC Zürich,6208,5,11,10,11,43,35,8,43
FC Lugano,6208,6,10,6,16,30,48,-18,36
Grasshoppers,6208,7,9,8,15,39,47,-8,35
FC Thun,6208,8,10,5,17,42,57,-15,35
FC Sion,6208,9,6,10,16,39,53,-14,28
Young Boys,6209,1,22,6,4,77,39,38,72
FC Basel,6209,2,18,8,6,55,26,29,62
St Gallen,6209,3,15,3,14,44,54,-10,48
Lucerne,6209,4,13,7,12,44,48,-4,46
FC Zürich,6209,5,11,10,11,42,36,6,43
FC Lugano,6209,6,10,6,16,31,50,-19,36
Grasshoppers,6209,7,8,8,16,40,50,-10,32
FC Thun,6209,8,8,8,16,45,61,-16,32
FC Sion,6209,9,6,10,16,41,55,-14,28
Young Boys,6210,1,23,7,2,77,34,43,76
FC Basel,6210,2,17,8,7,52,29,23,59
Lucerne,6210,3,12,10,10,41,41,0,46
St Gallen,6210,4,14,3,15,42,52,-10,45
FC Zürich,6210,5,10,11,11,42,38,4,41
FC Lugano,6210,6,11,6,15,30,46,-16,39
Grasshoppers,6210,7,10,7,15,41,48,-7,37
FC Thun,6210,8,9,6,17,46,61,-15,33
FC Sion,6210,9,5,8,19,41,63,-22,23
Young Boys,6211,1,21,6,5,69,38,31,69
FC Basel,6211,2,18,8,6,53,25,28,62
Lucerne,6211,3,13,9,10,42,42,0,48
St Gallen,6211,4,14,2,16,43,58,-15,44
FC Thun,6211,5,11,6,15,45,56,-11,39
FC Zürich,6211,6,9,11,12,38,36,2,38
Grasshoppers,6211,7,10,7,15,41,47,-6,37
FC Lugano,6211,8,10,6,16,30,46,-16,36
FC Sion,6211,9,6,9,17,41,54,-13,27
Young Boys,6212,1,21,7,4,70,37,33,70
FC Basel,6212,2,18,8,6,56,24,32,62
Lucerne,6212,3,13,8,11,43,49,-6,47
St Gallen,6212,4,14,3,15,44,55,-11,45
FC Zürich,6212,5,10,10,12,37,38,-1,40
FC Thun,6212,6,10,7,15,48,56,-8,37
Grasshoppers,6212,7,10,6,16,44,49,-5,36
FC Lugano,6212,8,9,7,16,29,47,-18,34
FC Sion,6212,9,7,8,17,40,56,-16,29
Young Boys,6213,1,21,8,3,74,35,39,71
FC Basel,6213,2,17,8,7,53,27,26,59
Lucerne,6213,3,14,7,11,42,41,1,49
St Gallen,6213,4,14,3,15,41,52,-11,45
FC Zürich,6213,5,11,10,11,42,38,4,43
FC Lugano,6213,6,11,5,16,33,52,-19,38
Grasshoppers,6213,7,9,7,16,39,50,-11,34
FC Sion,6213,8,8,8,16,42,51,-9,32
FC Thun,6213,9,8,6,18,43,63,-20,30
Young Boys,6214,1,21,8,3,72,35,37,71
FC Basel,6214,2,19,7,6,55,28,27,64
Lucerne,6214,3,14,7,11,46,43,3,49
St Gallen,6214,4,14,2,16,44,56,-12,44
FC Zürich,6214,5,11,10,11,43,35,8,43
FC Thun,6214,6,10,5,17,40,55,-15,35
FC Lugano,6214,7,9,6,17,31,54,-23,33
FC Sion,6214,8,8,8,16,40,52,-12,32
Grasshoppers,6214,9,8,7,17,37,50,-13,31
Young Boys,6215,1,22,6,4,72,34,38,72
FC Basel,6215,2,18,9,5,56,25,31,63
Lucerne,6215,3,13,8,11,44,41,3,47
St Gallen,6215,4,14,4,14,43,55,-12,46
FC Zürich,6215,5,9,11,12,37,35,2,38
FC Lugano,6215,6,10,7,15,29,47,-18,37
Grasshoppers,6215,7,9,7,16,41,52,-11,34
FC Thun,6215,8,9,6,17,40,59,-19,33
FC Sion,6215,9,7,8,17,38,52,-14,29
Young Boys,6216,1,21,7,4,71,35,36,70
FC Basel,6216,2,19,8,5,55,24,31,65
St Gallen,6216,3,16,3,13,46,52,-6,51
FC Zürich,6216,4,11,10,11,47,38,9,43
Lucerne,6216,5,12,7,13,38,44,-6,43
FC Lugano,6216,6,10,6,16,31,48,-17,36
FC Thun,6216,7,10,5,17,45,57,-12,35
Grasshoppers,6216,8,8,8,16,39,49,-10,32
FC Sion,6216,9,6,8,18,40,65,-25,26
Young Boys,6217,1,21,8,3,72,37,35,71
FC Basel,6217,2,18,7,7,57,30,27,61
St Gallen,6217,3,15,3,14,46,55,-9,48
Lucerne,6217,4,13,7,12,44,47,-3,46
FC Zürich,6217,5,11,10,11,44,37,7,43
FC Lugano,6217,6,11,5,16,35,49,-14,38
FC Thun,6217,7,10,6,16,45,62,-17,36
Grasshoppers,6217,8,9,7,16,41,50,-9,34
FC Sion,6217,9,5,9,18,37,54,-17,24
Young Boys,6218,1,22,7,3,71,32,39,73
FC Basel,6218,2,18,8,6,55,27,28,62
Lucerne,6218,3,13,8,11,44,43,1,47
St Gallen,6218,4,14,3,15,41,54,-13,45
FC Zürich,6218,5,11,10,11,45,40,5,43
FC Lugano,6218,6,11,5,16,36,52,-16,38
Grasshoppers,6218,7,9,7,16,41,53,-12,34
FC Thun,6218,8,8,7,17,44,61,-17,31
FC Sion,6218,9,7,7,18,37,52,-15,28
Young Boys,6219,1,20,8,4,71,40,31,68
FC Basel,6219,2,19,7,6,56,25,31,64
Lucerne,6219,3,14,7,11,46,42,4,49
FC Zürich,6219,4,11,9,12,42,38,4,42
FC Lugano,6219,5,12,5,15,35,47,-12,41
St Gallen,6219,6,13,2,17,40,59,-19,41
FC Thun,6219,7,11,5,16,49,59,-10,38
Grasshoppers,6219,8,8,8,16,42,56,-14,32
FC Sion,6219,9,6,9,17,44,59,-15,27
Young Boys,6220,1,21,6,5,70,38,32,69
FC Basel,6220,2,19,7,6,55,27,28,64
St Gallen,6220,3,15,2,15,45,54,-9,47
Lucerne,6220,4,12,9,11,43,47,-4,45
FC Zürich,6220,5,11,11,10,44,37,7,44
Grasshoppers,6220,6,9,8,15,41,48,-7,35
FC Thun,6220,7,9,6,17,42,59,-17,33
FC Lugano,6220,8,9,6,17,33,52,-19,33
FC Sion,6220,9,7,9,16,42,53,-11,30
Young Boys,6221,1,21,7,4,72,36,36,70
FC Basel,6221,2,18,8,6,55,24,31,62
FC Zürich,6221,3,13,9,10,46,34,12,48
St Gallen,6221,4,15,3,14,47,52,-5,48
Lucerne,6221,5,13,7,12,42,47,-5,46
FC Lugano,6221,6,10,6,16,29,48,-19,36
Grasshoppers,6221,7,8,8,16,40,51,-11,32
FC Thun,6221,8,8,7,17,43,64,-21,31
FC Sion,6221,9,6,9,17,42,60,-18,27
Young Boys,6222,1,22,7,3,72,35,37,73
FC Basel,6222,2,17,8,7,52,28,24,59
St Gallen,6222,3,15,3,14,42,52,-10,48
Lucerne,6222,4,12,8,12,41,45,-4,44
FC Zürich,6222,5,10,10,12,38,35,3,40
FC Thun,6222,6,11,5,16,44,56,-12,38
FC Lugano,6222,7,11,5,16,32,47,-15,38
Grasshoppers,6222,8,9,7,16,41,49,-8,34
FC Sion,6222,9,6,9,17,37,52,-15,27
Young Boys,6223,1,22,8,2,71,31,40,74
FC Basel,6223,2,15,8,9,50,29,21,53
Lucerne,6223,3,15,7,10,44,41,3,52
FC Zürich,6223,4,13,9,10,42,34,8,48
St Gallen,6223,5,13,3,16,41,57,-16,42
Grasshoppers,6223,6,9,8,15,41,49,-8,35
FC Lugano,6223,7,10,5,17,28,48,-20,35
FC Thun,6223,8,9,7,16,42,57,-15,34
FC Sion,6223,9,6,9,17,38,51,-13,27
Young Boys,6224,1,23,6,3,70,34,36,75
FC Basel,6224,2,17,8,7,54,28,26,59
St Gallen,6224,3,15,2,15,44,55,-11,47
Lucerne,6224,4,12,8,12,38,43,-5,44
FC Zürich,6224,5,11,10,11,40,35,5,43
FC Lugano,6224,6,11,5,16,31,45,-14,38
FC Thun,6224,7,10,6,16,46,59,-13,36
Grasshoppers,6224,8,9,6,17,39,49,-10,33
FC Sion,6224,9,6,9,17,41,55,-14,27
Young Boys,6225,1,21,7,4,70,37,33,70
FC Basel,6225,2,16,9,7,51,28,23,57
St Gallen,6225,3,16,2,14,46,53,-7,50
Lucerne,6225,4,13,8,11,44,44,0,47
FC Zürich,6225,5,10,11,11,43,39,4,41
Grasshoppers,6225,6,11,6,15,41,48,-7,39
FC Lugano,6225,7,10,6,16,34,50,-16,36
FC Thun,6225,8,10,5,17,41,57,-16,35
FC Sion,6225,9,6,8,18,39,53,-14,26
Young Boys,6226,1,21,8,3,75,37,38,71
FC Basel,6226,2,17,8,7,54,26,28,59
St Gallen,6226,3,16,2,14,49,54,-5,50
Lucerne,6226,4,12,8,12,44,55,-11,44
FC Zürich,6226,5,9,11,12,37,36,1,38
FC Thun,6226,6,11,5,16,48,58,-10,38
FC Lugano,6226,7,9,8,15,33,51,-18,35
FC Sion,6226,8,8,8,16,43,53,-10,32
Grasshoppers,6226,9,8,8,16,40,53,-13,32
Young Boys,6227,1,22,6,4,71,35,36,72
FC Basel,6227,2,18,8,6,59,32,27,62
Lucerne,6227,3,12,9,11,42,45,-3,45
St Gallen,6227,4,13,4,15,46,60,-14,43
FC Zürich,6227,5,10,10,12,44,40,4,40
FC Lugano,6227,6,10,7,15,33,49,-16,37
Grasshoppers,6227,7,10,6,16,43,51,-8,36
FC Thun,6227,8,10,6,16,46,59,-13,36
FC Sion,6227,9,6,10,16,41,54,-13,28
Young Boys,6228,1,21,7,4,72,35,37,70
FC Basel,6228,2,17,8,7,51,25,26,59
St Gallen,6228,3,15,3,14,44,55,-11,48
Lucerne,6228,4,13,7,12,39,41,-2,46
FC Zürich,6228,5,12,9,11,41,35,6,45
FC Thun,6228,6,11,6,15,43,55,-12,39
Grasshoppers,6228,7,9,8,15,39,47,-8,35
FC Lugano,6228,8,9,6,17,31,53,-22,33
FC Sion,6228,9,6,8,18,40,54,-14,26
Young Boys,6229,1,20,8,4,71,39,32,68
FC Basel,6229,2,18,9,5,57,26,31,63
Lucerne,6229,3,12,10,10,42,42,0,46
FC Zürich,6229,4,11,11,10,44,36,8,44
St Gallen,6229,5,13,3,16,39,55,-16,42
FC Lugano,6229,6,11,6,15,33,47,-14,39
Grasshoppers,6229,7,8,9,15,41,51,-10,33
FC Thun,6229,8,9,5,18,42,62,-20,32
FC Sion,6229,9,7,9,16,44,55,-11,30
Young Boys,6230,1,24,6,2,76,33,43,78
FC Basel,6230,2,18,8,6,56,24,32,62
Lucerne,6230,3,14,7,11,43,43,0,49
St Gallen,6230,4,14,2,16,41,54,-13,44
FC Zürich,6230,5,10,11,11,39,36,3,41
FC Lugano,6230,6,10,6,16,30,51,-21,36
Grasshoppers,6230,7,9,6,17,44,52,-8,33
FC Thun,6230,8,9,6,17,42,61,-19,33
FC Sion,6230,9,6,8,18,37,54,-17,26
Young Boys,6231,1,22,8,2,72,32,40,74
FC Basel,6231,2,19,7,6,59,27,32,64
St Gallen,6231,3,14,3,15,41,55,-14,45
Lucerne,6231,4,12,8,12,40,44,-4,44
FC Zürich,6231,5,10,9,13,43,39,4,39
FC Lugano,6231,6,11,5,16,31,49,-18,38
Grasshoppers,6231,7,8,10,14,39,47,-8,34
FC Thun,6231,8,9,7,16,43,58,-15,34
FC Sion,6231,9,5,11,16,38,55,-17,26
Young Boys,6232,1,21,8,3,68,33,35,71
FC Basel,6232,2,17,8,7,51,26,25,59
St Gallen,6232,3,17,2,13,44,49,-5,53
Lucerne,6232,4,13,8,11,42,39,3,47
FC Zürich,6232,5,11,10,11,44,37,7,43
Grasshoppers,6232,6,10,6,16,43,49,-6,36
FC Thun,6232,7,9,5,18,47,65,-18,32
FC Lugano,6232,8,9,5,18,27,53,-26,32
FC Sion,6232,9,7,8,17,43,58,-15,29
Young Boys,6233,1,22,6,4,70,35,35,72
FC Basel,6233,2,19,7,6,57,23,34,64
St Gallen,6233,3,14,2,16,43,61,-18,44
Lucerne,6233,4,12,7,13,43,49,-6,43
FC Lugano,6233,5,12,5,15,36,47,-11,41
FC Zürich,6233,6,10,10,12,42,39,3,40
FC Thun,6233,7,10,6,16,43,60,-17,36
Grasshoppers,6233,8,9,7,16,42,52,-10,34
FC Sion,6233,9,7,8,17,44,54,-10,29
Young Boys,6234,1,20,9,3,70,37,33,69
FC Basel,6234,2,18,9,5,57,27,30,63
Lucerne,6234,3,15,7,10,49,45,4,52
FC Zürich,6234,4,12,10,10,45,38,7,46
St Gallen,6234,5,13,3,16,41,55,-14,42
Grasshoppers,6234,6,10,7,15,41,47,-6,37
FC Lugano,6234,7,9,6,17,30,49,-19,33
FC Thun,6234,8,8,6,18,41,61,-20,30
FC Sion,6234,9,6,9,17,40,55,-15,27
Young Boys,6235,1,22,7,3,75,35,40,73
FC Basel,6235,2,19,8,5,57,25,32,65
St Gallen,6235,3,14,3,15,44,56,-12,45
Lucerne,6235,4,11,8,13,41,49,-8,41
FC Zürich,6235,5,10,10,12,38,35,3,40
FC Lugano,6235,6,10,7,15,28,46,-18,37
Grasshoppers,6235,7,10,6,16,42,49,-7,36
FC Thun,6235,8,9,6,17,43,61,-18,33
FC Sion,6235,9,7,9,16,41,53,-12,30
Young Boys,6236,1,21,6,5,74,42,32,69
FC Basel,6236,2,16,7,9,51,28,23,55
St Gallen,6236,3,16,2,14,48,54,-6,50
FC Zürich,6236,4,12,10,10,47,35,12,46
Lucerne,6236,5,12,8,12,41,46,-5,44
Grasshoppers,6236,6,11,6,15,45,50,-5,39
FC Thun,6236,7,10,6,16,47,59,-12,36
FC Lugano,6236,8,10,6,16,33,52,-19,36
FC Sion,6236,9,7,7,18,42,62,-20,28
Young Boys,6237,1,22,7,3,70,33,37,73
FC Basel,6237,2,18,9,5,52,22,30,63
St Gallen,6237,3,14,3,15,41,56,-15,45
FC Zürich,6237,4,11,11,10,40,34,6,44
Lucerne,6237,5,12,8,12,40,44,-4,44
Grasshoppers,6237,6,9,7,16,41,50,-9,34
FC Lugano,6237,7,9,7,16,28,45,-17,34
FC Sion,6237,8,8,7,17,42,53,-11,31
FC Thun,6237,9,8,7,17,42,59,-17,31
Young Boys,6238,1,20,7,5,75,44,31,67
FC Basel,6238,2,17,7,8,54,31,23,58
St Gallen,6238,3,15,4,13,44,52,-8,49
Lucerne,6238,4,12,10,10,44,45,-1,46
FC Zürich,6238,5,12,9,11,43,36,7,45
FC Lugano,6238,6,11,6,15,34,47,-13,39
FC Thun,6238,7,10,5,17,43,57,-14,35
Grasshoppers,6238,8,8,7,17,39,51,-12,31
FC Sion,6238,9,8,7,17,38,51,-13,31
Young Boys,6239,1,22,7,3,81,36,45,73
FC Basel,6239,2,17,8,7,51,28,23,59
Lucerne,6239,3,14,8,10,44,46,-2,50
St Gallen,6239,4,15,2,15,46,54,-8,47
FC Zürich,6239,5,9,12,11,41,39,2,39
FC Lugano,6239,6,10,7,15,34,52,-18,37
Grasshoppers,6239,7,9,7,16,42,51,-9,34
FC Thun,6239,8,8,8,16,41,57,-16,32
FC Sion,6239,9,6,9,17,38,55,-17,27
Young Boys,6240,1,21,9,2,75,35,40,72
FC Basel,6240,2,16,8,8,50,28,22,56
Lucerne,6240,3,15,8,9,46,42,4,53
FC Zürich,6240,4,13,9,10,45,35,10,48
St Gallen,6240,5,13,3,16,42,58,-16,42
FC Thun,6240,6,10,5,17,41,63,-22,35
FC Lugano,6240,7,9,6,17,33,53,-20,33
Grasshoppers,6240,8,8,7,17,38,51,-13,31
FC Sion,6240,9,7,9,16,49,54,-5,30
Young Boys,6241,1,21,7,4,69,37,32,70
FC Basel,6241,2,18,8,6,53,24,29,62
St Gallen,6241,3,16,3,13,46,52,-6,51
Lucerne,6241,4,14,7,11,44,41,3,49
FC Zürich,6241,5,12,9,11,40,35,5,45
Grasshoppers,6241,6,9,7,16,39,51,-12,34
FC Lugano,6241,7,9,5,18,29,51,-22,32
FC Thun,6241,8,8,7,17,40,57,-17,31
FC Sion,6241,9,6,9,17,40,52,-12,27
Young Boys,6242,1,21,7,4,71,35,36,70
FC Basel,6242,2,18,9,5,57,26,31,63
Lucerne,6242,3,12,9,11,38,45,-7,45
FC Zürich,6242,4,11,10,11,41,36,5,43
St Gallen,6242,5,13,4,15,42,56,-14,43
FC Lugano,6242,6,10,7,15,33,47,-14,37
FC Thun,6242,7,10,5,17,42,58,-16,35
Grasshoppers,6242,8,9,7,16,38,47,-9,34
FC Sion,6242,9,7,8,17,39,51,-12,29
Young Boys,6243,1,23,6,3,77,37,40,75
FC Basel,6243,2,18,7,7,60,29,31,61
St Gallen,6243,3,14,4,14,43,55,-12,46
Lucerne,6243,4,12,8,12,42,47,-5,44
FC Zürich,6243,5,10,11,11,44,40,4,41
FC Lugano,6243,6,10,7,15,31,46,-15,37
Grasshoppers,6243,7,9,8,15,41,49,-8,35
FC Thun,6243,8,9,7,16,47,63,-16,34
FC Sion,6243,9,6,8,18,41,60,-19,26
Young Boys,6244,1,23,6,3,77,36,41,75
FC Basel,6244,2,20,7,5,65,26,39,67
St Gallen,6244,3,14,2,16,41,60,-19,44
Lucerne,6244,4,11,9,12,38,46,-8,42
FC Lugano,6244,5,11,6,15,32,48,-16,39
FC Zürich,6244,6,9,9,14,37,38,-1,36
Grasshoppers,6244,7,9,8,15,41,48,-7,35
FC Thun,6244,8,9,6,17,44,62,-18,33
FC Sion,6244,9,8,7,17,43,54,-11,31
Young Boys,6245,1,20,8,4,73,39,34,68
FC Basel,6245,2,19,7,6,56,26,30,64
St Gallen,6245,3,15,2,15,46,59,-13,47
Lucerne,6245,4,12,8,12,41,46,-5,44
FC Lugano,6245,5,12,5,15,36,47,-11,41
Grasshoppers,6245,6,10,8,14,44,49,-5,38
FC Zürich,6245,7,9,9,14,37,38,-1,36
FC Thun,6245,8,10,5,17,43,58,-15,35
FC Sion,6245,9,7,8,17,41,55,-14,29
Young Boys,6246,1,23,7,2,77,36,41,76
FC Basel,6246,2,18,8,6,54,26,28,62
St Gallen,6246,3,15,3,14,46,53,-7,48
Lucerne,6246,4,12,9,11,44,47,-3,45
FC Zürich,6246,5,10,10,12,42,40,2,40
FC Thun,6246,6,10,5,17,44,56,-12,35
FC Lugano,6246,7,10,5,17,30,49,-19,35
Grasshoppers,6246,8,8,7,17,41,55,-14,31
FC Sion,6246,9,7,8,17,44,60,-16,29
Young Boys,6247,1,22,7,3,75,36,39,73
FC Basel,6247,2,16,9,7,50,27,23,57
Lucerne,6247,3,14,8,10,44,45,-1,50
St Gallen,6247,4,13,2,17,41,59,-18,41
FC Zürich,6247,5,9,11,12,38,36,2,38
FC Thun,6247,6,11,5,16,44,57,-13,38
FC Lugano,6247,7,10,6,16,31,47,-16,36
Grasshoppers,6247,8,9,8,15,43,52,-9,35
FC Sion,6247,9,8,8,16,42,49,-7,32
Young Boys,6248,1,22,7,3,72,34,38,73
FC Basel,6248,2,18,8,6,53,24,29,62
St Gallen,6248,3,15,2,15,42,53,-11,47
Lucerne,6248,4,13,7,12,40,42,-2,46
FC Zürich,6248,5,10,11,11,41,38,3,41
Grasshoppers,6248,6,10,6,16,41,49,-8,36
FC Lugano,6248,7,10,6,16,33,49,-16,36
FC Thun,6248,8,9,5,18,41,62,-21,32
FC Sion,6248,9,7,8,17,44,56,-12,29
Young Boys,6249,1,22,7,3,74,35,39,73
FC Basel,6249,2,16,10,6,53,28,25,58
Lucerne,6249,3,14,7,11,41,43,-2,49
St Gallen,6249,4,14,3,15,43,56,-13,45
FC Zürich,6249,5,11,9,12,42,38,4,42
Grasshoppers,6249,6,11,6,15,41,47,-6,39
FC Lugano,6249,7,10,5,17,31,49,-18,35
FC Thun,6249,8,9,7,16,42,56,-14,34
FC Sion,6249,9,6,8,18,38,53,-15,26
Young Boys,6250,1,22,6,4,71,34,37,72
FC Basel,6250,2,18,8,6,53,25,28,62
St Gallen,6250,3,14,4,14,44,56,-12,46
Lucerne,6250,4,12,8,12,42,47,-5,44
FC Zürich,6250,5,11,10,11,45,38,7,43
FC Thun,6250,6,10,6,16,46,57,-11,36
Grasshoppers,6250,7,9,7,16,40,51,-11,34
FC Lugano,6250,8,9,7,16,32,52,-20,34
FC Sion,6250,9,6,10,16,44,57,-13,28
Young Boys,6251,1,20,7,5,71,40,31,67
FC Basel,6251,2,19,8,5,57,25,32,65
St Gallen,6251,3,14,3,15,43,54,-11,45
FC Zürich,6251,4,11,11,10,44,36,8,44
Lucerne,6251,5,12,8,12,41,47,-6,44
FC Lugano,6251,6,11,5,16,32,47,-15,38
Grasshoppers,6251,7,9,9,14,46,52,-6,36
FC Thun,6251,8,8,7,17,41,62,-21,31
FC Sion,6251,9,6,10,16,44,56,-12,28
Young Boys,6252,1,20,8,4,69,36,33,68
FC Basel,6252,2,16,7,9,53,32,21,55
St Gallen,6252,3,15,3,14,44,52,-8,48
FC Zürich,6252,4,12,9,11,49,38,11,45
Lucerne,6252,5,12,9,11,41,44,-3,45
FC Lugano,6252,6,11,7,14,33,45,-12,40
FC Thun,6252,7,11,5,16,48,62,-14,38
Grasshoppers,6252,8,8,7,17,41,54,-13,31
FC Sion,6252,9,8,7,17,39,54,-15,31
Young Boys,6253,1,21,8,3,70,35,35,71
FC Basel,6253,2,18,8,6,57,26,31,62
St Gallen,6253,3,15,2,15,44,55,-11,47
FC Zürich,6253,4,12,10,10,43,36,7,46
Lucerne,6253,5,11,10,11,40,45,-5,43
FC Thun,6253,6,10,6,16,49,59,-10,36
FC Lugano,6253,7,10,6,16,33,48,-15,36
Grasshoppers,6253,8,8,9,15,38,52,-14,33
FC Sion,6253,9,5,9,18,37,55,-18,24
Young Boys,6254,1,22,6,4,71,36,35,72
FC Basel,6254,2,19,8,5,61,24,37,65
Lucerne,6254,3,14,7,11,46,45,1,49
St Gallen,6254,4,14,3,15,42,53,-11,45
FC Zürich,6254,5,10,12,10,43,37,6,42
Grasshoppers,6254,6,11,6,15,43,50,-7,39
FC Lugano,6254,7,9,5,18,28,50,-22,32
FC Thun,6254,8,8,6,18,41,63,-22,30
FC Sion,6254,9,6,9,17,41,58,-17,27
Young Boys,6255,1,23,7,2,71,31,40,76
FC Basel,6255,2,17,7,8,52,29,23,58
St Gallen,6255,3,15,3,14,46,56,-10,48
FC Zürich,6255,4,12,9,11,45,36,9,45
Lucerne,6255,5,12,9,11,41,45,-4,45
FC Thun,6255,6,10,6,16,50,61,-11,36
FC Lugano,6255,7,10,6,16,33,49,-16,36
Grasshoppers,6255,8,8,8,16,41,54,-13,32
FC Sion,6255,9,6,7,19,43,61,-18,25
Young Boys,6256,1,21,7,4,69,32,37,70
FC Basel,6256,2,18,9,5,54,23,31,63
Lucerne,6256,3,12,9,11,41,45,-4,45
St Gallen,6256,4,13,4,15,41,54,-13,43
FC Zürich,6256,5,10,10,12,40,36,4,40
Grasshoppers,6256,6,10,7,15,41,48,-7,37
FC Lugano,6256,7,10,7,15,29,47,-18,37
FC Sion,6256,8,8,8,16,40,50,-10,32
FC Thun,6256,9,8,7,17,43,63,-20,31
Young Boys,6257,1,22,6,4,75,35,40,72
FC Basel,6257,2,17,8,7,53,28,25,59
Lucerne,6257,3,14,7,11,43,46,-3,49
FC Zürich,6257,4,11,10,11,42,36,6,43
St Gallen,6257,5,13,3,16,44,61,-17,42
FC Lugano,6257,6,12,5,15,36,46,-10,41
Grasshoppers,6257,7,10,6,16,41,50,-9,36
FC Thun,6257,8,10,6,16,46,59,-13,36
FC Sion,6257,9,6,7,19,42,61,-19,25
Young Boys,6258,1,22,7,3,78,37,41,73
FC Basel,6258,2,17,9,6,52,26,26,60
St Gallen,6258,3,16,2,14,46,54,-8,50
Lucerne,6258,4,12,8,12,44,48,-4,44
FC Zürich,6258,5,10,11,11,39,35,4,41
FC Lugano,6258,6,11,6,15,32,46,-14,39
Grasshoppers,6258,7,10,7,15,41,50,-9,37
FC Thun,6258,8,8,7,17,41,58,-17,31
FC Sion,6258,9,6,7,19,38,57,-19,25
Young Boys,6259,1,21,8,3,68,32,36,71
FC Basel,6259,2,19,8,5,53,22,31,65
Lucerne,6259,3,13,7,12,42,44,-2,46
St Gallen,6259,4,14,2,16,42,55,-13,44
Grasshoppers,6259,5,11,7,14,39,44,-5,40
FC Zürich,6259,6,9,11,12,39,40,-1,38
FC Lugano,6259,7,10,6,16,31,48,-17,36
FC Thun,6259,8,10,5,17,45,58,-13,35
FC Sion,6259,9,6,8,18,36,52,-16,26
Young Boys,6260,1,22,7,3,74,35,39,73
FC Basel,6260,2,20,7,5,56,23,33,67
Lucerne,6260,3,12,8,12,41,43,-2,44
St Gallen,6260,4,13,3,16,40,54,-14,42
FC Zürich,6260,5,10,10,12,41,38,3,40
FC Lugano,6260,6,11,5,16,31,47,-16,38
FC Thun,6260,7,10,6,16,42,58,-16,36
Grasshoppers,6260,8,9,6,17,41,53,-12,33
FC Sion,6260,9,7,8,17,41,56,-15,29
Young Boys,6261,1,20,10,2,70,35,35,70
FC Basel,6261,2,16,9,7,54,30,24,57
Lucerne,6261,3,12,10,10,44,45,-1,46
St Gallen,6261,4,14,4,14,46,56,-10,46
FC Zürich,6261,5,11,9,12,44,38,6,42
FC Lugano,6261,6,9,8,15,32,48,-16,35
FC Sion,6261,7,8,9,15,45,55,-10,33
Grasshoppers,6261,8,8,9,15,39,49,-10,33
FC Thun,6261,9,9,6,17,44,62,-18,33
Young Boys,6262,1,23,6,3,80,34,46,75
FC Basel,6262,2,18,8,6,58,27,31,62
St Gallen,6262,3,14,3,15,45,56,-11,45
Lucerne,6262,4,12,7,13,42,56,-14,43
FC Zürich,6262,5,11,9,12,41,36,5,42
FC Lugano,6262,6,11,5,16,33,48,-15,38
FC Thun,6262,7,10,5,17,46,66,-20,35
Grasshoppers,6262,8,9,6,17,43,54,-11,33
FC Sion,6262,9,8,7,17,44,55,-11,31
Young Boys,6263,1,21,8,3,70,34,36,71
FC Basel,6263,2,17,9,6,55,28,27,60
Lucerne,6263,3,15,7,10,46,42,4,52
St Gallen,6263,4,14,3,15,45,58,-13,45
FC Zürich,6263,5,10,9,13,41,40,1,39
FC Thun,6263,6,11,6,15,47,58,-11,39
FC Lugano,6263,7,10,7,15,33,47,-14,37
Grasshoppers,6263,8,8,7,17,39,55,-16,31
FC Sion,6263,9,6,8,18,39,53,-14,26
Young Boys,6264,1,22,7,3,70,32,38,73
FC Basel,6264,2,16,10,6,51,26,25,58
St Gallen,6264,3,15,3,14,44,52,-8,48
Lucerne,6264,4,13,7,12,42,44,-2,46
FC Lugano,6264,5,12,5,15,32,44,-12,41
FC Zürich,6264,6,10,10,12,40,38,2,40
FC Thun,6264,7,11,6,15,45,55,-10,39
Grasshoppers,6264,8,9,6,17,42,55,-13,33
FC Sion,6264,9,5,8,19,37,57,-20,23
Young Boys,6265,1,22,6,4,75,38,37,72
FC Basel,6265,2,17,9,6,55,28,27,60
St Gallen,6265,3,17,2,13,50,54,-4,53
Lucerne,6265,4,13,9,10,43,43,0,48
FC Zürich,6265,5,10,10,12,40,37,3,40
Grasshoppers,6265,6,9,7,16,41,52,-11,34
FC Thun,6265,7,9,7,16,41,60,-19,34
FC Lugano,6265,8,9,7,16,33,53,-20,34
FC Sion,6265,9,6,7,19,43,56,-13,25
Young Boys,6266,1,20,6,6,67,40,27,66
FC Basel,6266,2,17,8,7,54,26,28,59
Lucerne,6266,3,14,9,9,43,37,6,51
FC Zürich,6266,4,12,10,10,45,37,8,46
St Gallen,6266,5,14,3,15,42,53,-11,45
FC Thun,6266,6,10,6,16,50,60,-10,36
FC Lugano,6266,7,10,6,16,32,50,-18,36
Grasshoppers,6266,8,9,6,17,40,57,-17,33
FC Sion,6266,9,7,8,17,42,55,-13,29
Young Boys,6267,1,20,7,5,70,37,33,67
FC Basel,6267,2,19,8,5,60,24,36,65
Lucerne,6267,3,15,7,10,48,41,7,52
St Gallen,6267,4,14,4,14,44,55,-11,46
FC Zürich,6267,5,9,10,13,39,40,-1,37
FC Lugano,6267,6,10,6,16,30,53,-23,36
Grasshoppers,6267,7,9,6,17,42,53,-11,33
FC Thun,6267,8,9,6,17,44,64,-20,33
FC Sion,6267,9,8,8,16,46,56,-10,32
Young Boys,6268,1,23,6,3,73,32,41,75
FC Basel,6268,2,19,7,6,53,23,30,64
Lucerne,6268,3,13,8,11,47,49,-2,47
St Gallen,6268,4,14,4,14,45,53,-8,46
FC Zürich,6268,5,11,9,12,43,38,5,42
FC Thun,6268,6,11,5,16,47,61,-14,38
Grasshoppers,6268,7,9,6,17,43,53,-10,33
FC Lugano,6268,8,9,5,18,33,58,-25,32
FC Sion,6268,9,6,8,18,40,57,-17,26
Young Boys,6269,1,21,7,4,74,34,40,70
FC Basel,6269,2,18,8,6,51,24,27,62
St Gallen,6269,3,15,2,15,41,52,-11,47
Lucerne,6269,4,12,8,12,42,45,-3,44
FC Zürich,6269,5,9,11,12,39,39,0,38
Grasshoppers,6269,6,10,8,14,42,48,-6,38
FC Thun,6269,7,10,7,15,48,59,-11,37
FC Lugano,6269,8,9,6,17,30,54,-24,33
FC Sion,6269,9,7,9,16,41,53,-12,30
Young Boys,6270,1,23,7,2,81,36,45,76
FC Basel,6270,2,18,9,5,57,25,32,63
St Gallen,6270,3,14,4,14,44,54,-10,46
Lucerne,6270,4,11,8,13,37,52,-15,41
FC Zürich,6270,5,10,10,12,40,35,5,40
FC Lugano,6270,6,11,6,15,34,49,-15,39
FC Thun,6270,7,9,7,16,41,58,-17,34
Grasshoppers,6270,8,8,8,16,40,50,-10,32
FC Sion,6270,9,5,11,16,38,53,-15,26
Young Boys,6271,1,20,8,4,78,43,35,68
FC Basel,6271,2,19,8,5,59,26,33,65
St Gallen,6271,3,15,2,15,42,55,-13,47
FC Zürich,6271,4,12,9,11,44,38,6,45
Lucerne,6271,5,12,8,12,41,45,-4,44
Grasshoppers,6271,6,12,6,14,49,47,2,42
FC Lugano,6271,7,10,5,17,28,51,-23,35
FC Thun,6271,8,8,7,17,41,58,-17,31
FC Sion,6271,9,5,9,18,40,59,-19,24
Young Boys,6272,1,21,8,3,69,34,35,71
FC Basel,6272,2,19,8,5,61,25,36,65
Lucerne,6272,3,13,9,10,46,46,0,48
St Gallen,6272,4,13,3,16,42,56,-14,42
FC Zürich,6272,5,10,10,12,41,39,2,40
FC Thun,6272,6,10,6,16,46,62,-16,36
FC Lugano,6272,7,10,6,16,36,52,-16,36
Grasshoppers,6272,8,9,8,15,41,49,-8,35
FC Sion,6272,9,6,8,18,39,58,-19,26
Young Boys,6273,1,20,7,5,65,36,29,67
FC Basel,6273,2,17,8,7,54,27,27,59
St Gallen,6273,3,15,3,14,43,53,-10,48
FC Zürich,6273,4,12,10,10,45,34,11,46
Lucerne,6273,5,11,9,12,40,44,-4,42
Grasshoppers,6273,6,10,7,15,43,50,-7,37
FC Lugano,6273,7,9,9,14,31,46,-15,36
FC Thun,6273,8,9,6,17,45,63,-18,33
FC Sion,6273,9,8,7,17,41,54,-13,31
Young Boys,6274,1,20,9,3,67,34,33,69
FC Basel,6274,2,18,8,6,53,25,28,62
Lucerne,6274,3,14,8,10,43,41,2,50
St Gallen,6274,4,13,5,14,41,54,-13,44
FC Zürich,6274,5,11,9,12,40,36,4,42
FC Lugano,6274,6,10,7,15,29,44,-15,37
FC Thun,6274,7,10,5,17,43,58,-15,35
Grasshoppers,6274,8,9,7,16,42,50,-8,34
FC Sion,6274,9,6,8,18,41,57,-16,26
Young Boys,6275,1,23,6,3,78,37,41,75
FC Basel,6275,2,18,8,6,61,29,32,62
Lucerne,6275,3,13,7,12,44,48,-4,46
St Gallen,6275,4,14,2,16,42,57,-15,44
FC Zürich,6275,5,10,10,12,41,42,-1,40
FC Thun,6275,6,11,5,16,50,58,-8,38
Grasshoppers,6275,7,10,7,15,44,53,-9,37
FC Lugano,6275,8,10,5,17,34,53,-19,35
FC Sion,6275,9,6,8,18,40,57,-17,26
Young Boys,6276,1,22,6,4,74,34,40,72
FC Basel,6276,2,19,7,6,56,23,33,64
St Gallen,6276,3,15,3,14,42,53,-11,48
Lucerne,6276,4,12,7,13,41,49,-8,43
FC Zürich,6276,5,9,11,12,37,35,2,38
FC Lugano,6276,6,10,7,15,30,44,-14,37
Grasshoppers,6276,7,10,6,16,43,52,-9,36
FC Thun,6276,8,10,5,17,43,61,-18,35
FC Sion,6276,9,7,8,17,40,55,-15,29
Young Boys,6277,1,23,6,3,72,35,37,75
FC Basel,6277,2,18,8,6,56,26,30,62
FC Zürich,6277,3,12,10,10,42,34,8,46
Lucerne,6277,4,12,9,11,43,45,-2,45
St Gallen,6277,5,13,3,16,42,59,-17,42
FC Lugano,6277,6,10,6,16,32,47,-15,36
Grasshoppers,6277,7,9,6,17,41,55,-14,33
FC Thun,6277,8,9,5,18,42,62,-20,32
FC Sion,6277,9,8,7,17,47,54,-7,31
Young Boys,6278,1,22,7,3,76,36,40,73
FC Basel,6278,2,19,7,6,55,26,29,64
Lucerne,6278,3,12,10,10,39,40,-1,46
St Gallen,6278,4,14,3,15,43,57,-14,45
FC Zürich,6278,5,9,10,13,37,36,1,37
FC Thun,6278,6,9,7,16,42,58,-16,34
FC Lugano,6278,7,9,7,16,29,48,-19,34
FC Sion,6278,8,8,9,15,44,52,-8,33
Grasshoppers,6278,9,8,8,16,39,51,-12,32
Young Boys,6279,1,23,6,3,79,35,44,75
FC Basel,6279,2,19,8,5,58,27,31,65
St Gallen,6279,3,16,3,13,44,51,-7,51
FC Zürich,6279,4,11,10,11,42,36,6,43
Lucerne,6279,5,11,8,13,41,48,-7,41
FC Lugano,6279,6,10,5,17,30,52,-22,35
Grasshoppers,6279,7,8,8,16,38,53,-15,32
FC Thun,6279,8,8,7,17,42,60,-18,31
FC Sion,6279,9,6,9,17,41,53,-12,27
Young Boys,6280,1,21,6,5,67,36,31,69
FC Basel,6280,2,19,7,6,59,26,33,64
Lucerne,6280,3,13,8,11,42,44,-2,47
St Gallen,6280,4,14,2,16,43,59,-16,44
FC Lugano,6280,5,12,6,14,31,43,-12,42
FC Zürich,6280,6,9,11,12,39,39,0,38
Grasshoppers,6280,7,9,7,16,41,48,-7,34
FC Thun,6280,8,9,7,16,45,59,-14,34
FC Sion,6280,9,7,8,17,42,55,-13,29
Young Boys,6281,1,21,7,4,67,33,34,70
FC Basel,6281,2,17,9,6,49,23,26,60
FC Zürich,6281,3,13,9,10,46,33,13,48
Lucerne,6281,4,13,8,11,43,40,3,47
St Gallen,6281,5,14,3,15,40,54,-14,45
Grasshoppers,6281,6,10,7,15,41,52,-11,37
FC Lugano,6281,7,10,6,16,31,48,-17,36
FC Thun,6281,8,9,5,18,44,64,-20,32
FC Sion,6281,9,6,8,18,40,54,-14,26
Young Boys,6282,1,23,7,2,73,30,43,76
FC Basel,6282,2,16,9,7,51,27,24,57
Lucerne,6282,3,14,8,10,44,39,5,50
FC Zürich,6282,4,11,10,11,43,37,6,43
St Gallen,6282,5,13,3,16,41,58,-17,42
FC Thun,6282,6,11,5,16,43,56,-13,38
FC Lugano,6282,7,9,7,16,31,53,-22,34
Grasshoppers,6282,8,9,6,17,38,51,-13,33
FC Sion,6282,9,7,7,18,40,53,-13,28
Young Boys,6283,1,22,6,4,71,35,36,72
FC Basel,6283,2,18,8,6,54,23,31,62
Lucerne,6283,3,13,7,12,42,45,-3,46
FC Zürich,6283,4,11,10,11,39,34,5,43
FC Lugano,6283,5,12,5,15,35,47,-12,41
St Gallen,6283,6,13,2,17,40,61,-21,41
Grasshoppers,6283,7,11,6,15,44,47,-3,39
FC Thun,6283,8,8,7,17,40,59,-19,31
FC Sion,6283,9,7,7,18,42,56,-14,28
Young Boys,6284,1,22,7,3,75,35,40,73
FC Basel,6284,2,19,8,5,54,24,30,65
St Gallen,6284,3,16,2,14,42,51,-9,50
Lucerne,6284,4,12,8,12,42,45,-3,44
FC Zürich,6284,5,11,10,11,43,38,5,43
Grasshoppers,6284,6,9,8,15,43,51,-8,35
FC Lugano,6284,7,10,5,17,34,52,-18,35
FC Thun,6284,8,9,6,17,42,60,-18,33
FC Sion,6284,9,5,8,19,36,55,-19,23
Young Boys,6285,1,21,8,3,68,39,29,71
FC Basel,6285,2,18,8,6,59,26,33,62
St Gallen,6285,3,15,2,15,42,55,-13,47
Lucerne,6285,4,12,8,12,39,42,-3,44
FC Zürich,6285,5,10,12,10,41,34,7,42
Grasshoppers,6285,6,10,8,14,40,46,-6,38
FC Lugano,6285,7,10,8,14,33,45,-12,38
FC Thun,6285,8,8,7,17,44,61,-17,31
FC Sion,6285,9,5,9,18,38,56,-18,24
Young Boys,6286,1,22,7,3,75,38,37,73
FC Basel,6286,2,18,9,5,56,24,32,63
Lucerne,6286,3,13,8,11,43,45,-2,47
St Gallen,6286,4,13,3,16,41,56,-15,42
FC Zürich,6286,5,10,10,12,39,35,4,40
Grasshoppers,6286,6,10,8,14,43,48,-5,38
FC Lugano,6286,7,11,5,16,33,48,-15,38
FC Thun,6286,8,9,6,17,43,62,-19,33
FC Sion,6286,9,5,10,17,39,56,-17,25
Young Boys,6287,1,22,6,4,76,34,42,72
FC Basel,6287,2,19,7,6,57,28,29,64
Lucerne,6287,3,13,7,12,40,44,-4,46
St Gallen,6287,4,14,2,16,42,56,-14,44
FC Lugano,6287,5,12,5,15,31,43,-12,41
FC Zürich,6287,6,10,9,13,39,37,2,39
FC Thun,6287,7,10,6,16,44,57,-13,36
Grasshoppers,6287,8,9,6,17,38,53,-15,33
FC Sion,6287,9,7,8,17,41,56,-15,29
Young Boys,6288,1,22,8,2,74,34,40,74
FC Basel,6288,2,17,8,7,57,28,29,59
Lucerne,6288,3,13,9,10,44,44,0,48
FC Zürich,6288,4,11,10,11,41,35,6,43
St Gallen,6288,5,13,2,17,41,61,-20,41
FC Thun,6288,6,10,6,16,43,58,-15,36
FC Lugano,6288,7,10,6,16,33,50,-17,36
Grasshoppers,6288,8,8,8,16,39,53,-14,32
FC Sion,6288,9,8,7,17,42,51,-9,31
Young Boys,6289,1,20,9,3,71,39,32,69
FC Basel,6289,2,19,8,5,57,23,34,65
St Gallen,6289,3,15,3,14,44,51,-7,48
FC Zürich,6289,4,11,9,12,41,38,3,42
FC Lugano,6289,5,12,5,15,35,44,-9,41
Lucerne,6289,6,11,8,13,41,52,-11,41
Grasshoppers,6289,7,10,7,15,42,46,-4,37
FC Thun,6289,8,9,6,17,41,59,-18,33
FC Sion,6289,9,5,9,18,36,56,-20,24
Young Boys,6290,1,23,7,2,73,35,38,76
FC Basel,6290,2,17,8,7,55,30,25,59
Lucerne,6290,3,13,8,11,43,43,0,47
St Gallen,6290,4,15,2,15,42,53,-11,47
FC Zürich,6290,5,10,10,12,41,38,3,40
FC Lugano,6290,6,11,5,16,31,46,-15,38
FC Thun,6290,7,10,7,15,45,58,-13,37
Grasshoppers,6290,8,9,6,17,41,51,-10,33
FC Sion,6290,9,6,7,19,40,57,-17,25
Young Boys,6291,1,22,6,4,75,37,38,72
FC Basel,6291,2,19,7,6,60,27,33,64
St Gallen,6291,3,14,4,14,43,54,-11,46
Lucerne,6291,4,11,9,12,39,46,-7,42
FC Zürich,6291,5,10,10,12,42,41,1,40
Grasshoppers,6291,6,9,8,15,43,51,-8,35
FC Thun,6291,7,10,5,17,47,64,-17,35
FC Lugano,6291,8,9,8,15,31,48,-17,35
FC Sion,6291,9,7,9,16,43,55,-12,30
Young Boys,6292,1,19,10,3,70,40,30,67
FC Basel,6292,2,17,9,6,53,26,27,60
Lucerne,6292,3,13,8,11,45,45,0,47
St Gallen,6292,4,14,4,14,45,55,-10,46
FC Zürich,6292,5,10,10,12,41,37,4,40
FC Lugano,6292,6,10,7,15,32,49,-17,37
Grasshoppers,6292,7,10,6,16,45,50,-5,36
FC Thun,6292,8,10,5,17,43,63,-20,35
FC Sion,6292,9,7,9,16,47,56,-9,30
Young Boys,6293,1,20,9,3,71,36,35,69
FC Basel,6293,2,19,7,6,58,28,30,64
Lucerne,6293,3,13,9,10,44,45,-1,48
St Gallen,6293,4,14,3,15,46,56,-10,45
FC Zürich,6293,5,9,11,12,38,39,-1,38
FC Lugano,6293,6,10,7,15,33,47,-14,37
FC Thun,6293,7,9,7,16,44,59,-15,34
Grasshoppers,6293,8,8,8,16,40,51,-11,32
FC Sion,6293,9,7,9,16,41,54,-13,30
Young Boys,6294,1,22,8,2,69,30,39,74
FC Basel,6294,2,17,9,6,51,25,26,60
Lucerne,6294,3,13,7,12,42,44,-2,46
St Gallen,6294,4,14,3,15,46,57,-11,45
FC Zürich,6294,5,11,9,12,39,35,4,42
FC Lugano,6294,6,10,6,16,31,48,-17,36
Grasshoppers,6294,7,9,7,16,39,48,-9,34
FC Thun,6294,8,9,6,17,41,58,-17,33
FC Sion,6294,9,8,7,17,40,53,-13,31
Young Boys,6295,1,21,7,4,69,34,35,70
FC Basel,6295,2,17,8,7,53,26,27,59
Lucerne,6295,3,14,8,10,44,43,1,50
St Gallen,6295,4,14,3,15,42,54,-12,45
FC Zürich,6295,5,11,10,11,41,34,7,43
FC Thun,6295,6,11,5,16,43,57,-14,38
FC Lugano,6295,7,10,6,16,30,49,-19,36
Grasshoppers,6295,8,9,7,16,40,49,-9,34
FC Sion,6295,9,6,8,18,37,53,-16,26
Young Boys,6296,1,22,7,3,76,35,41,73
FC Basel,6296,2,18,9,5,50,21,29,63
Lucerne,6296,3,13,8,11,41,45,-4,47
St Gallen,6296,4,14,3,15,43,52,-9,45
FC Zürich,6296,5,11,9,12,41,35,6,42
FC Thun,6296,6,11,5,16,42,56,-14,38
Grasshoppers,6296,7,10,6,16,40,48,-8,36
FC Lugano,6296,8,9,6,17,31,55,-24,33
FC Sion,6296,9,6,7,19,39,56,-17,25
Young Boys,6297,1,23,7,2,75,33,42,76
FC Basel,6297,2,16,9,7,49,27,22,57
St Gallen,6297,3,16,2,14,46,52,-6,50
Lucerne,6297,4,13,8,11,43,43,0,47
FC Zürich,6297,5,9,10,13,40,39,1,37
Grasshoppers,6297,6,9,9,14,43,49,-6,36
FC Lugano,6297,7,10,5,17,32,52,-20,35
FC Thun,6297,8,9,6,17,43,60,-17,33
FC Sion,6297,9,7,8,17,39,55,-16,29
Young Boys,6298,1,22,6,4,72,39,33,72
FC Basel,6298,2,18,7,7,57,29,28,61
St Gallen,6298,3,16,2,14,44,54,-10,50
Lucerne,6298,4,14,7,11,46,43,3,49
FC Zürich,6298,5,10,11,11,42,38,4,41
Grasshoppers,6298,6,10,6,16,45,52,-7,36
FC Thun,6298,7,10,6,16,46,57,-11,36
FC Lugano,6298,8,9,5,18,27,50,-23,32
FC Sion,6298,9,6,8,18,41,58,-17,26
Young Boys,6299,1,22,6,4,71,36,35,72
FC Basel,6299,2,20,7,5,58,25,33,67
Lucerne,6299,3,15,7,10,50,41,9,52
FC Zürich,6299,4,11,10,11,41,37,4,43
St Gallen,6299,5,13,2,17,41,60,-19,41
FC Thun,6299,6,10,6,16,45,56,-11,36
FC Lugano,6299,7,10,5,17,31,50,-19,35
Grasshoppers,6299,8,8,7,17,41,56,-15,31
FC Sion,6299,9,6,8,18,39,56,-17,26
Young Boys,6300,1,22,6,4,71,33,38,72
FC Basel,6300,2,18,8,6,55,25,30,62
St Gallen,6300,3,17,2,13,45,50,-5,53
Lucerne,6300,4,12,7,13,39,48,-9,43
FC Zürich,6300,5,10,11,11,40,35,5,41
Grasshoppers,6300,6,10,6,16,42,50,-8,36
FC Thun,6300,7,10,6,16,44,58,-14,36
FC Lugano,6300,8,10,5,17,30,48,-18,35
FC Sion,6300,9,6,7,19,37,56,-19,25
Young Boys,6301,1,21,9,2,69,31,38,72
FC Basel,6301,2,19,7,6,52,22,30,64
St Gallen,6301,3,15,3,14,45,53,-8,48
Lucerne,6301,4,13,8,11,40,42,-2,47
FC Zürich,6301,5,10,10,12,40,35,5,40
Grasshoppers,6301,6,9,7,16,39,49,-10,34
FC Lugano,6301,7,9,7,16,30,50,-20,34
FC Thun,6301,8,9,5,18,41,59,-18,32
FC Sion,6301,9,7,8,17,37,52,-15,29
Young Boys,6302,1,21,7,4,70,34,36,70
FC Basel,6302,2,18,8,6,61,32,29,62
Lucerne,6302,3,12,10,10,42,45,-3,46
St Gallen,6302,4,14,3,15,44,60,-16,45
FC Zürich,6302,5,11,10,11,42,40,2,43
FC Lugano,6302,6,10,7,15,29,44,-15,37
Grasshoppers,6302,7,9,7,16,39,48,-9,34
FC Thun,6302,8,9,5,18,41,60,-19,32
FC Sion,6302,9,7,9,16,48,53,-5,30
Young Boys,6303,1,22,7,3,72,36,36,73
FC Basel,6303,2,18,9,5,54,23,31,63
Lucerne,6303,3,11,10,11,44,47,-3,43
St Gallen,6303,4,13,3,16,38,54,-16,42
FC Lugano,6303,5,12,5,15,30,44,-14,41
FC Zürich,6303,6,10,10,12,42,38,4,40
Grasshoppers,6303,7,10,6,16,43,52,-9,36
FC Thun,6303,8,10,5,17,46,62,-16,35
FC Sion,6303,9,7,7,18,41,54,-13,28
Young Boys,6304,1,21,8,3,72,35,37,71
FC Basel,6304,2,18,9,5,56,26,30,63
St Gallen,6304,3,15,3,14,47,56,-9,48
FC Zürich,6304,4,10,12,10,43,36,7,42
Lucerne,6304,5,11,8,13,40,48,-8,41
FC Lugano,6304,6,11,6,15,32,47,-15,39
Grasshoppers,6304,7,8,9,15,40,50,-10,33
FC Thun,6304,8,9,6,17,44,61,-17,33
FC Sion,6304,9,6,9,17,40,55,-15,27
Young Boys,6305,1,21,6,5,68,37,31,69
FC Basel,6305,2,17,8,7,53,27,26,59
Lucerne,6305,3,15,8,9,46,42,4,53
St Gallen,6305,4,14,5,13,44,53,-9,47
FC Zürich,6305,5,11,10,11,42,37,5,43
FC Thun,6305,6,10,5,17,46,59,-13,35
Grasshoppers,6305,7,9,7,16,42,51,-9,34
FC Lugano,6305,8,9,6,17,28,47,-19,33
FC Sion,6305,9,6,9,17,37,53,-16,27
Young Boys,6306,1,22,7,3,69,32,37,73
FC Basel,6306,2,17,8,7,52,28,24,59
Lucerne,6306,3,14,8,10,45,44,1,50
St Gallen,6306,4,15,3,14,45,53,-8,48
FC Zürich,6306,5,9,12,11,39,38,1,39
FC Thun,6306,6,10,5,17,45,61,-16,35
FC Lugano,6306,7,9,6,17,30,49,-19,33
Grasshoppers,6306,8,8,8,16,38,48,-10,32
FC Sion,6306,9,7,9,16,42,52,-10,30
Young Boys,6307,1,24,6,2,70,31,39,78
FC Basel,6307,2,16,10,6,59,29,30,58
St Gallen,6307,3,16,3,13,46,52,-6,51
Lucerne,6307,4,12,9,11,41,43,-2,45
FC Zürich,6307,5,11,10,11,43,36,7,43
Grasshoppers,6307,6,10,6,16,39,47,-8,36
FC Lugano,6307,7,10,6,16,31,48,-17,36
FC Thun,6307,8,9,5,18,43,66,-23,32
FC Sion,6307,9,5,7,20,35,55,-20,22
Young Boys,6308,1,21,7,4,72,41,31,70
FC Basel,6308,2,18,8,6,55,27,28,62
Lucerne,6308,3,15,8,9,52,42,10,53
St Gallen,6308,4,14,3,15,42,53,-11,45
FC Zürich,6308,5,11,11,10,44,34,10,44
FC Lugano,6308,6,10,6,16,30,50,-20,36
FC Thun,6308,7,9,7,16,44,59,-15,34
Grasshoppers,6308,8,8,7,17,40,54,-14,31
FC Sion,6308,9,5,9,18,38,57,-19,24
Young Boys,6309,1,20,8,4,68,38,30,68
FC Basel,6309,2,18,8,6,57,24,33,62
Lucerne,6309,3,13,9,10,43,44,-1,48
St Gallen,6309,4,14,5,13,43,53,-10,47
FC Zürich,6309,5,11,10,11,41,36,5,43
Grasshoppers,6309,6,9,8,15,41,49,-8,35
FC Lugano,6309,7,9,7,16,29,46,-17,34
FC Thun,6309,8,9,6,17,43,60,-17,33
FC Sion,6309,9,6,9,17,39,54,-15,27
Young Boys,6310,1,21,9,2,75,39,36,72
FC Basel,6310,2,17,8,7,53,31,22,59
Lucerne,6310,3,13,9,10,48,45,3,48
St Gallen,6310,4,14,4,14,41,52,-11,46
FC Zürich,6310,5,11,10,11,43,37,6,43
Grasshoppers,6310,6,10,7,15,44,52,-8,37
FC Lugano,6310,7,9,8,15,31,47,-16,35
FC Thun,6310,8,9,6,17,44,59,-15,33
FC Sion,6310,9,5,9,18,40,57,-17,24
Young Boys,6311,1,19,10,3,65,32,33,67
FC Basel,6311,2,17,10,5,51,22,29,61
Lucerne,6311,3,14,9,9,44,42,2,51
St Gallen,6311,4,15,3,14,47,55,-8,48
FC Zürich,6311,5,10,11,11,39,35,4,41
FC Lugano,6311,6,10,6,16,31,49,-18,36
FC Thun,6311,7,9,7,16,43,57,-14,34
Grasshoppers,6311,8,8,8,16,39,49,-10,32
FC Sion,6311,9,6,8,18,37,55,-18,26
Young Boys,6312,1,22,7,3,75,38,37,73
FC Basel,6312,2,18,8,6,56,26,30,62
Lucerne,6312,3,14,7,11,43,45,-2,49
St Gallen,6312,4,14,2,16,43,56,-13,44
FC Zürich,6312,5,10,11,11,42,37,5,41
FC Lugano,6312,6,10,6,16,34,53,-19,36
FC Thun,6312,7,9,7,16,41,56,-15,34
Grasshoppers,6312,8,8,8,16,42,52,-10,32
FC Sion,6312,9,7,8,17,44,57,-13,29
Young Boys,6313,1,22,6,4,71,35,36,72
FC Basel,6313,2,18,7,7,53,27,26,61
St Gallen,6313,3,14,4,14,44,54,-10,46
FC Zürich,6313,4,11,11,10,44,36,8,44
Lucerne,6313,5,12,8,12,39,43,-4,44
Grasshoppers,6313,6,10,7,15,42,49,-7,37
FC Lugano,6313,7,9,8,15,30,47,-17,35
FC Thun,6313,8,9,7,16,45,59,-14,34
FC Sion,6313,9,6,8,18,39,57,-18,26
Young Boys,6314,1,22,6,4,68,34,34,72
FC Basel,6314,2,18,7,7,52,26,26,61
Lucerne,6314,3,14,7,11,43,39,4,49
FC Zürich,6314,4,12,9,11,41,35,6,45
St Gallen,6314,5,14,2,16,41,55,-14,44
FC Lugano,6314,6,11,5,16,32,46,-14,38
Grasshoppers,6314,7,9,7,16,38,49,-11,34
FC Thun,6314,8,9,5,18,40,58,-18,32
FC Sion,6314,9,7,8,17,38,51,-13,29
Young Boys,6315,1,21,7,4,68,35,33,70
FC Basel,6315,2,19,8,5,55,24,31,65
Lucerne,6315,3,13,7,12,41,44,-3,46
St Gallen,6315,4,14,3,15,45,57,-12,45
FC Zürich,6315,5,10,10,12,41,39,2,40
FC Lugano,6315,6,11,6,15,31,46,-15,39
Grasshoppers,6315,7,8,9,15,40,49,-9,33
FC Thun,6315,8,9,6,17,45,59,-14,33
FC Sion,6315,9,7,8,17,41,54,-13,29
Young Boys,6316,1,22,7,3,73,35,38,73
FC Basel,6316,2,18,9,5,56,24,32,63
Lucerne,6316,3,13,7,12,45,50,-5,46
St Gallen,6316,4,14,4,14,48,59,-11,46
FC Lugano,6316,5,11,6,15,32,45,-13,39
FC Zürich,6316,6,9,11,12,40,38,2,38
Grasshoppers,6316,7,10,6,16,41,51,-10,36
FC Thun,6316,8,9,6,17,46,60,-14,33
FC Sion,6316,9,6,8,18,41,60,-19,26
Young Boys,6317,1,21,8,3,72,38,34,71
FC Basel,6317,2,17,8,7,58,30,28,59
Lucerne,6317,3,12,10,10,41,42,-1,46
St Gallen,6317,4,14,4,14,44,56,-12,46
FC Zürich,6317,5,11,9,12,40,37,3,42
FC Lugano,6317,6,10,7,15,35,51,-16,37
Grasshoppers,6317,7,10,6,16,46,50,-4,36
FC Thun,6317,8,10,5,17,46,62,-16,35
FC Sion,6317,9,6,9,17,40,56,-16,27
Young Boys,6318,1,21,7,4,75,38,37,70
FC Basel,6318,2,18,8,6,59,28,31,62
St Gallen,6318,3,15,4,13,47,54,-7,49
Lucerne,6318,4,13,7,12,42,47,-5,46
FC Zürich,6318,5,11,9,12,41,36,5,42
FC Thun,6318,6,11,5,16,44,58,-14,38
Grasshoppers,6318,7,9,7,16,42,50,-8,34
FC Lugano,6318,8,9,6,17,29,51,-22,33
FC Sion,6318,9,7,7,18,42,59,-17,28
Young Boys,6319,1,21,8,3,73,37,36,71
FC Basel,6319,2,18,8,6,53,23,30,62
Lucerne,6319,3,14,8,10,44,40,4,50
St Gallen,6319,4,15,2,15,45,56,-11,47
FC Zürich,6319,5,11,11,10,47,36,11,44
FC Thun,6319,6,10,6,16,45,58,-13,36
Grasshoppers,6319,7,9,7,16,41,52,-11,34
FC Lugano,6319,8,9,6,17,30,53,-23,33
FC Sion,6319,9,5,8,19,39,62,-23,23
Young Boys,6320,1,21,8,3,73,33,40,71
FC Basel,6320,2,18,8,6,52,23,29,62
Lucerne,6320,3,13,10,9,42,41,1,49
St Gallen,6320,4,14,4,14,42,54,-12,46
FC Zürich,6320,5,11,10,11,43,37,6,43
Grasshoppers,6320,6,9,8,15,44,51,-7,35
FC Lugano,6320,7,9,7,16,31,52,-21,34
FC Thun,6320,8,8,6,18,41,62,-21,30
FC Sion,6320,9,7,7,18,44,59,-15,28
Young Boys,6321,1,22,6,4,74,36,38,72
FC Basel,6321,2,18,9,5,55,23,32,63
St Gallen,6321,3,15,3,14,43,53,-10,48
Lucerne,6321,4,13,8,11,41,42,-1,47
FC Zürich,6321,5,10,10,12,40,38,2,40
FC Lugano,6321,6,10,5,17,30,51,-21,35
Grasshoppers,6321,7,9,7,16,39,47,-8,34
FC Thun,6321,8,9,7,16,41,58,-17,34
FC Sion,6321,9,6,9,17,39,54,-15,27
Young Boys,6322,1,21,7,4,72,37,35,70
FC Basel,6322,2,17,9,6,55,27,28,60
Lucerne,6322,3,13,9,10,45,44,1,48
St Gallen,6322,4,13,5,14,38,52,-14,44
FC Zürich,6322,5,10,10,12,42,41,1,40
Grasshoppers,6322,6,11,7,14,44,47,-3,40
FC Lugano,6322,7,10,6,16,32,47,-15,36
FC Thun,6322,8,10,5,17,46,61,-15,35
FC Sion,6322,9,6,8,18,38,56,-18,26
Young Boys,6323,1,23,7,2,73,30,43,76
FC Basel,6323,2,19,7,6,56,24,32,64
Lucerne,6323,3,13,7,12,43,47,-4,46
St Gallen,6323,4,14,4,14,43,53,-10,46
FC Zürich,6323,5,9,11,12,37,36,1,38
Grasshoppers,6323,6,10,7,15,41,49,-8,37
FC Thun,6323,7,10,5,17,45,63,-18,35
FC Lugano,6323,8,9,7,16,29,47,-18,34
FC Sion,6323,9,5,9,18,37,55,-18,24
Young Boys,6324,1,21,7,4,69,34,35,70
FC Basel,6324,2,19,7,6,57,24,33,64
FC Zürich,6324,3,13,9,10,45,34,11,48
Lucerne,6324,4,12,9,11,40,45,-5,45
St Gallen,6324,5,14,3,15,42,54,-12,45
FC Lugano,6324,6,10,6,16,32,49,-17,36
FC Thun,6324,7,9,6,17,42,60,-18,33
Grasshoppers,6324,8,8,8,16,40,50,-10,32
FC Sion,6324,9,6,9,17,38,55,-17,27
Young Boys,6325,1,19,7,6,69,41,28,64
FC Basel,6325,2,18,8,6,58,28,30,62
Lucerne,6325,3,12,9,11,42,45,-3,45
FC Zürich,6325,4,11,10,11,44,37,7,43
St Gallen,6325,5,13,4,15,40,55,-15,43
FC Lugano,6325,6,11,7,14,32,44,-12,40
FC Thun,6325,7,11,6,15,46,56,-10,39
Grasshoppers,6325,8,9,8,15,41,50,-9,35
FC Sion,6325,9,6,9,17,44,60,-16,27
Young Boys,6326,1,22,8,2,73,33,40,74
FC Basel,6326,2,16,11,5,55,27,28,59
Lucerne,6326,3,13,8,11,45,45,0,47
St Gallen,6326,4,14,5,13,44,52,-8,47
FC Zürich,6326,5,10,10,12,39,38,1,40
FC Thun,6326,6,10,7,15,46,58,-12,37
Grasshoppers,6326,7,9,7,16,43,50,-7,34
FC Lugano,6326,8,9,6,17,28,48,-20,33
FC Sion,6326,9,6,8,18,40,62,-22,26
Young Boys,6327,1,22,8,2,71,33,38,74
FC Basel,6327,2,16,8,8,53,31,22,56
St Gallen,6327,3,15,2,15,43,55,-12,47
Lucerne,6327,4,13,7,12,43,47,-4,46
FC Zürich,6327,5,11,10,11,45,38,7,43
FC Thun,6327,6,11,6,15,49,59,-10,39
FC Lugano,6327,7,10,6,16,32,48,-16,36
Grasshoppers,6327,8,8,7,17,41,55,-14,31
FC Sion,6327,9,7,8,17,41,52,-11,29
Young Boys,6328,1,22,7,3,73,35,38,73
FC Basel,6328,2,18,8,6,55,27,28,62
St Gallen,6328,3,15,2,15,43,54,-11,47
Lucerne,6328,4,12,8,12,44,45,-1,44
FC Zürich,6328,5,10,11,11,43,40,3,41
FC Lugano,6328,6,11,6,15,32,48,-16,39
FC Thun,6328,7,10,6,16,46,60,-14,36
Grasshoppers,6328,8,8,7,17,38,49,-11,31
FC Sion,6328,9,6,9,17,42,58,-16,27
Young Boys,6329,1,22,7,3,70,35,35,73
FC Basel,6329,2,17,8,7,54,29,25,59
Lucerne,6329,3,14,8,10,43,42,1,50
St Gallen,6329,4,14,3,15,40,52,-12,45
FC Zürich,6329,5,11,9,12,39,34,5,42
FC Thun,6329,6,11,5,16,46,57,-11,38
FC Lugano,6329,7,10,6,16,29,45,-16,36
Grasshoppers,6329,8,9,7,16,38,49,-11,34
FC Sion,6329,9,6,7,19,37,53,-16,25
Young Boys,6330,1,22,7,3,71,33,38,73
FC Basel,6330,2,17,9,6,52,25,27,60
St Gallen,6330,3,14,3,15,43,55,-12,45
Lucerne,6330,4,12,7,13,38,45,-7,43
FC Zürich,6330,5,10,10,12,40,38,2,40
FC Lugano,6330,6,11,5,16,34,52,-18,38
Grasshoppers,6330,7,10,7,15,42,46,-4,37
FC Thun,6330,8,10,6,16,43,57,-14,36
FC Sion,6330,9,6,10,16,41,53,-12,28
Young Boys,6331,1,21,6,5,72,36,36,69
FC Basel,6331,2,19,7,6,54,23,31,64
Lucerne,6331,3,13,8,11,42,44,-2,47
St Gallen,6331,4,14,3,15,44,55,-11,45
FC Zürich,6331,5,11,9,12,42,37,5,42
Grasshoppers,6331,6,11,6,15,43,47,-4,39
FC Lugano,6331,7,10,7,15,31,48,-17,37
FC Thun,6331,8,9,6,17,42,57,-15,33
FC Sion,6331,9,6,8,18,37,60,-23,26
Young Boys,6332,1,21,8,3,78,35,43,71
FC Basel,6332,2,17,9,6,51,24,27,60
St Gallen,6332,3,15,3,14,46,54,-8,48
Lucerne,6332,4,13,8,11,41,52,-11,47
FC Zürich,6332,5,10,11,11,40,35,5,41
FC Lugano,6332,6,10,6,16,31,47,-16,36
FC Thun,6332,7,10,5,17,41,60,-19,35
FC Sion,6332,8,7,10,15,45,53,-8,31
Grasshoppers,6332,9,8,6,18,39,52,-13,30
Young Boys,6333,1,20,7,5,68,36,32,67
FC Basel,6333,2,19,7,6,54,24,30,64
St Gallen,6333,3,15,2,15,45,59,-14,47
Lucerne,6333,4,12,9,11,42,44,-2,45
FC Zürich,6333,5,11,9,12,45,38,7,42
Grasshoppers,6333,6,11,7,14,46,49,-3,40
FC Thun,6333,7,10,6,16,45,58,-13,36
FC Lugano,6333,8,10,5,17,32,52,-20,35
FC Sion,6333,9,6,8,18,39,56,-17,26
Young Boys,6334,1,21,6,5,70,38,32,69
FC Basel,6334,2,18,7,7,54,27,27,61
Lucerne,6334,3,14,7,11,45,43,2,49
St Gallen,6334,4,14,2,16,44,57,-13,44
FC Lugano,6334,5,12,5,15,33,46,-13,41
FC Zürich,6334,6,10,9,13,40,39,1,39
FC Thun,6334,7,11,5,16,45,56,-11,38
Grasshoppers,6334,8,10,6,16,40,49,-9,36
FC Sion,6334,9,7,7,18,41,57,-16,28
Young Boys,6335,1,22,7,3,72,34,38,73
FC Basel,6335,2,16,9,7,50,28,22,57
Lucerne,6335,3,13,8,11,42,43,-1,47
St Gallen,6335,4,14,4,14,42,54,-12,46
FC Zürich,6335,5,11,10,11,39,34,5,43
Grasshoppers,6335,6,10,6,16,40,51,-11,36
FC Thun,6335,7,10,5,17,47,58,-11,35
FC Lugano,6335,8,9,7,16,29,49,-20,34
FC Sion,6335,9,7,8,17,44,54,-10,29
Young Boys,6336,1,20,8,4,70,37,33,68
FC Basel,6336,2,17,8,7,53,29,24,59
FC Zürich,6336,3,13,9,10,47,35,12,48
St Gallen,6336,4,15,3,14,50,56,-6,48
Lucerne,6336,5,13,7,12,42,49,-7,46
FC Lugano,6336,6,10,7,15,34,48,-14,37
FC Thun,6336,7,9,7,16,44,60,-16,34
FC Sion,6336,8,7,9,16,44,56,-12,30
Grasshoppers,6336,9,8,6,18,42,56,-14,30
Young Boys,6337,1,21,8,3,71,36,35,71
FC Basel,6337,2,17,8,7,54,29,25,59
Lucerne,6337,3,12,10,10,42,43,-1,46
St Gallen,6337,4,13,3,16,39,56,-17,42
FC Thun,6337,5,11,6,15,48,59,-11,39
FC Zürich,6337,6,9,10,13,40,40,0,37
FC Lugano,6337,7,10,7,15,30,44,-14,37
FC Sion,6337,8,9,7,16,43,51,-8,34
Grasshoppers,6337,9,9,7,16,41,50,-9,34
Young Boys,6338,1,22,7,3,72,32,40,73
FC Basel,6338,2,17,9,6,57,27,30,60
Lucerne,6338,3,12,9,11,44,50,-6,45
St Gallen,6338,4,14,3,15,43,56,-13,45
FC Zürich,6338,5,11,11,10,45,36,9,44
FC Lugano,6338,6,10,8,14,35,48,-13,38
Grasshoppers,6338,7,9,7,16,41,52,-11,34
FC Thun,6338,8,9,6,17,43,63,-20,33
FC Sion,6338,9,6,8,18,43,59,-16,26
Young Boys,6339,1,24,6,2,76,33,43,78
FC Basel,6339,2,16,8,8,50,30,20,56
St Gallen,6339,3,15,3,14,45,53,-8,48
Lucerne,6339,4,13,8,11,42,41,1,47
FC Zürich,6339,5,10,11,11,42,38,4,41
FC Thun,6339,6,10,6,16,47,57,-10,36
FC Lugano,6339,7,10,5,17,30,52,-22,35
Grasshoppers,6339,8,8,8,16,41,51,-10,32
FC Sion,6339,9,6,9,17,41,59,-18,27
Young Boys,6340,1,22,7,3,69,33,36,73
FC Basel,6340,2,18,8,6,54,27,27,62
Lucerne,6340,3,14,7,11,43,43,0,49
St Gallen,6340,4,15,3,14,47,58,-11,48
FC Zürich,6340,5,9,11,12,40,38,2,38
FC Thun,6340,6,10,6,16,45,59,-14,36
FC Lugano,6340,7,10,6,16,33,48,-15,36
Grasshoppers,6340,8,9,6,17,40,50,-10,33
FC Sion,6340,9,5,10,17,40,55,-15,25
Young Boys,6341,1,22,8,2,73,31,42,74
FC Basel,6341,2,17,9,6,55,26,29,60
Lucerne,6341,3,14,9,9,44,39,5,51
FC Zürich,6341,4,13,9,10,47,35,12,48
St Gallen,6341,5,13,3,16,42,59,-17,42
FC Lugano,6341,6,10,5,17,31,53,-22,35
Grasshoppers,6341,7,8,8,16,40,53,-13,32
FC Thun,6341,8,8,7,17,43,63,-20,31
FC Sion,6341,9,5,10,17,39,55,-16,25
Young Boys,6342,1,22,6,4,70,35,35,72
FC Basel,6342,2,18,8,6,54,27,27,62
St Gallen,6342,3,14,2,16,45,59,-14,44
Lucerne,6342,4,12,7,13,43,44,-1,43
FC Lugano,6342,5,12,6,14,38,48,-10,42
FC Zürich,6342,6,10,11,11,42,37,5,41
FC Thun,6342,7,10,6,16,43,56,-13,36
Grasshoppers,6342,8,9,7,16,42,54,-12,34
FC Sion,6342,9,7,7,18,38,55,-17,28
Young Boys,6343,1,20,8,4,69,35,34,68
FC Basel,6343,2,16,11,5,50,24,26,59
Lucerne,6343,3,13,9,10,38,39,-1,48
St Gallen,6343,4,14,3,15,42,55,-13,45
FC Zürich,6343,5,10,10,12,39,35,4,40
FC Thun,6343,6,9,8,15,44,58,-14,35
FC Lugano,6343,7,10,5,17,30,48,-18,35
Grasshoppers,6343,8,9,7,16,41,50,-9,34
FC Sion,6343,9,8,9,15,44,53,-9,33
Young Boys,6344,1,22,6,4,72,37,35,72
FC Basel,6344,2,17,9,6,53,25,28,60
St Gallen,6344,3,15,3,14,44,55,-11,48
Lucerne,6344,4,12,10,10,43,44,-1,46
FC Zürich,6344,5,10,11,11,40,35,5,41
Grasshoppers,6344,6,9,9,14,41,47,-6,36
FC Thun,6344,7,10,6,16,42,55,-13,36
FC Lugano,6344,8,10,6,16,31,48,-17,36
FC Sion,6344,9,5,8,19,35,55,-20,23
Young Boys,6345,1,21,8,3,75,36,39,71
FC Basel,6345,2,17,9,6,52,26,26,60
Lucerne,6345,3,15,8,9,47,39,8,53
St Gallen,6345,4,14,3,15,45,57,-12,45
FC Zürich,6345,5,10,11,11,42,36,6,41
Grasshoppers,6345,6,11,6,15,44,52,-8,39
FC Thun,6345,7,9,6,17,44,60,-16,33
FC Lugano,6345,8,9,5,18,28,52,-24,32
FC Sion,6345,9,6,8,18,40,59,-19,26
Young Boys,6346,1,20,9,3,70,33,37,69
FC Basel,6346,2,18,8,6,55,29,26,62
Lucerne,6346,3,13,9,10,42,41,1,48
FC Zürich,6346,4,12,9,11,42,37,5,45
St Gallen,6346,5,14,3,15,46,56,-10,45
Grasshoppers,6346,6,10,7,15,39,45,-6,37
FC Lugano,6346,7,10,5,17,29,50,-21,35
FC Sion,6346,8,8,7,17,41,54,-13,31
FC Thun,6346,9,8,5,19,38,57,-19,29
Young Boys,6347,1,23,6,3,75,35,40,75
FC Basel,6347,2,17,8,7,54,26,28,59
Lucerne,6347,3,15,7,10,44,42,2,52
St Gallen,6347,4,14,2,16,42,59,-17,44
FC Zürich,6347,5,10,11,11,41,37,4,41
FC Thun,6347,6,10,6,16,44,58,-14,36
FC Lugano,6347,7,10,6,16,34,49,-15,36
Grasshoppers,6347,8,9,8,15,43,52,-9,35
FC Sion,6347,9,5,8,19,40,59,-19,23
Young Boys,6348,1,23,7,2,72,31,41,76
FC Basel,6348,2,16,7,9,56,31,25,55
St Gallen,6348,3,16,2,14,44,53,-9,50
Lucerne,6348,4,12,7,13,43,48,-5,43
FC Zürich,6348,5,10,12,10,39,34,5,42
FC Lugano,6348,6,11,6,15,32,46,-14,39
Grasshoppers,6348,7,10,7,15,40,48,-8,37
FC Thun,6348,8,9,7,16,42,61,-19,34
FC Sion,6348,9,5,9,18,35,51,-16,24
Young Boys,6349,1,21,7,4,77,37,40,70
FC Basel,6349,2,19,7,6,53,24,29,64
St Gallen,6349,3,14,4,14,41,56,-15,46
Lucerne,6349,4,11,9,12,42,51,-9,42
FC Zürich,6349,5,10,10,12,38,35,3,40
Grasshoppers,6349,6,11,7,14,44,47,-3,40
FC Lugano,6349,7,9,7,16,30,49,-19,34
FC Sion,6349,8,8,8,16,44,51,-7,32
FC Thun,6349,9,8,7,17,39,58,-19,31
Young Boys,6350,1,20,7,5,67,36,31,67
FC Basel,6350,2,18,7,7,55,25,30,61
St Gallen,6350,3,15,2,15,47,58,-11,47
Lucerne,6350,4,12,8,12,39,45,-6,44
FC Zürich,6350,5,10,10,12,38,37,1,40
FC Thun,6350,6,11,5,16,46,60,-14,38
FC Lugano,6350,7,11,5,16,31,47,-16,38
Grasshoppers,6350,8,10,7,15,45,51,-6,37
FC Sion,6350,9,7,9,16,43,52,-9,30
Young Boys,6351,1,21,7,4,74,36,38,70
FC Basel,6351,2,18,9,5,57,25,32,63
St Gallen,6351,3,14,3,15,41,54,-13,45
Lucerne,6351,4,12,8,12,40,50,-10,44
FC Zürich,6351,5,9,10,13,38,40,-2,37
FC Thun,6351,6,10,7,15,45,57,-12,37
FC Lugano,6351,7,10,7,15,29,44,-15,37
Grasshoppers,6351,8,9,7,16,42,52,-10,34
FC Sion,6351,9,7,10,15,46,54,-8,31
Young Boys,6352,1,21,6,5,71,36,35,69
FC Basel,6352,2,16,10,6,49,24,25,58
Lucerne,6352,3,14,9,9,43,40,3,51
St Gallen,6352,4,14,3,15,40,56,-16,45
FC Zürich,6352,5,10,11,11,40,36,4,41
Grasshoppers,6352,6,9,8,15,41,49,-8,35
FC Lugano,6352,7,10,5,17,32,48,-16,35
FC Thun,6352,8,9,7,16,41,57,-16,34
FC Sion,6352,9,8,7,17,40,51,-11,31
Young Boys,6353,1,20,8,4,70,36,34,68
FC Basel,6353,2,17,8,7,52,27,25,59
Lucerne,6353,3,14,8,10,48,44,4,50
St Gallen,6353,4,14,2,16,45,59,-14,44
FC Zürich,6353,5,11,10,11,40,34,6,43
FC Lugano,6353,6,11,6,15,36,50,-14,39
Grasshoppers,6353,7,10,7,15,40,49,-9,37
FC Thun,6353,8,9,8,15,41,54,-13,35
FC Sion,6353,9,6,7,19,37,56,-19,25
Young Boys,6354,1,20,6,6,69,41,28,66
FC Basel,6354,2,17,8,7,50,24,26,59
Lucerne,6354,3,12,8,12,45,50,-5,44
St Gallen,6354,4,14,2,16,42,57,-15,44
FC Zürich,6354,5,11,10,11,41,36,5,43
FC Lugano,6354,6,12,6,14,37,47,-10,42
Grasshoppers,6354,7,11,6,15,47,52,-5,39
FC Thun,6354,8,10,6,16,46,55,-9,36
FC Sion,6354,9,7,8,17,40,55,-15,29
Young Boys,6355,1,22,6,4,69,34,35,72
FC Basel,6355,2,16,8,8,53,28,25,56
FC Zürich,6355,3,13,9,10,42,33,9,48
Lucerne,6355,4,12,9,11,44,46,-2,45
St Gallen,6355,5,14,3,15,43,57,-14,45
FC Lugano,6355,6,11,6,15,32,45,-13,39
FC Thun,6355,7,10,5,17,45,59,-14,35
Grasshoppers,6355,8,9,6,17,42,57,-15,33
FC Sion,6355,9,7,8,17,44,55,-11,29
Young Boys,6356,1,22,6,4,71,37,34,72
FC Basel,6356,2,15,10,7,51,28,23,55
Lucerne,6356,3,16,7,9,46,39,7,55
FC Zürich,6356,4,11,11,10,40,33,7,44
St Gallen,6356,5,13,4,15,41,54,-13,43
FC Thun,6356,6,10,6,16,45,59,-14,36
FC Lugano,6356,7,9,7,16,29,47,-18,34
Grasshoppers,6356,8,9,6,17,40,52,-12,33
FC Sion,6356,9,7,7,18,42,56,-14,28
Young Boys,6357,1,21,9,2,72,34,38,72
FC Basel,6357,2,17,8,7,52,28,24,59
Lucerne,6357,3,14,7,11,47,45,2,49
St Gallen,6357,4,14,2,16,45,55,-10,44
FC Zürich,6357,5,11,10,11,41,36,5,43
FC Lugano,6357,6,10,6,16,28,46,-18,36
FC Thun,6357,7,10,5,17,42,56,-14,35
FC Sion,6357,8,7,10,15,42,53,-11,31
Grasshoppers,6357,9,8,7,17,39,55,-16,31
Young Boys,6358,1,22,7,3,69,34,35,73
FC Basel,6358,2,17,8,7,53,29,24,59
Lucerne,6358,3,14,8,10,45,43,2,50
St Gallen,6358,4,14,2,16,42,61,-19,44
FC Zürich,6358,5,10,9,13,42,42,0,39
FC Thun,6358,6,11,5,16,49,59,-10,38
FC Lugano,6358,7,11,5,16,35,47,-12,38
Grasshoppers,6358,8,9,7,16,41,50,-9,34
FC Sion,6358,9,7,7,18,43,54,-11,28
Young Boys,6359,1,23,6,3,71,32,39,75
FC Basel,6359,2,18,8,6,54,27,27,62
Lucerne,6359,3,14,7,11,45,43,2,49
St Gallen,6359,4,14,2,16,42,57,-15,44
FC Zürich,6359,5,10,10,12,44,40,4,40
FC Thun,6359,6,11,5,16,44,56,-12,38
FC Lugano,6359,7,10,5,17,32,51,-19,35
Grasshoppers,6359,8,9,7,16,43,51,-8,34
FC Sion,6359,9,6,8,18,38,56,-18,26
Young Boys,6360,1,22,6,4,74,37,37,72
FC Basel,6360,2,17,8,7,54,31,23,59
St Gallen,6360,3,17,2,13,47,50,-3,53
Lucerne,6360,4,11,9,12,40,47,-7,42
FC Thun,6360,5,12,5,15,49,54,-5,41
FC Zürich,6360,6,9,11,12,39,38,1,38
FC Lugano,6360,7,10,6,16,30,47,-17,36
Grasshoppers,6360,8,9,7,16,41,53,-12,34
FC Sion,6360,9,6,8,18,38,55,-17,26
Young Boys,6361,1,22,6,4,73,37,36,72
FC Basel,6361,2,17,8,7,56,27,29,59
Lucerne,6361,3,13,9,10,45,45,0,48
St Gallen,6361,4,14,5,13,42,51,-9,47
FC Lugano,6361,5,11,6,15,35,49,-14,39
FC Zürich,6361,6,9,9,14,38,40,-2,36
Grasshoppers,6361,7,9,8,15,40,48,-8,35
FC Thun,6361,8,10,5,17,46,62,-16,35
FC Sion,6361,9,7,8,17,38,54,-16,29
Young Boys,6362,1,23,7,2,75,32,43,76
FC Basel,6362,2,17,8,7,54,28,26,59
FC Zürich,6362,3,12,9,11,42,35,7,45
Lucerne,6362,4,12,9,11,43,46,-3,45
St Gallen,6362,5,14,3,15,44,55,-11,45
Grasshoppers,6362,6,10,6,16,42,53,-11,36
FC Lugano,6362,7,10,5,17,31,50,-19,35
FC Thun,6362,8,9,5,18,40,60,-20,32
FC Sion,6362,9,7,8,17,41,53,-12,29
Young Boys,6363,1,24,6,2,75,33,42,78
FC Basel,6363,2,16,10,6,51,26,25,58
St Gallen,6363,3,15,3,14,44,54,-10,48
FC Zürich,6363,4,12,9,11,44,35,9,45
Lucerne,6363,5,11,10,11,41,44,-3,43
FC Lugano,6363,6,10,6,16,29,46,-17,36
Grasshoppers,6363,7,9,7,16,39,49,-10,34
FC Thun,6363,8,9,6,17,40,58,-18,33
FC Sion,6363,9,6,7,19,40,58,-18,25
Young Boys,6364,1,22,6,4,75,35,40,72
FC Basel,6364,2,17,9,6,53,29,24,60
Lucerne,6364,3,13,9,10,45,43,2,48
St Gallen,6364,4,14,5,13,45,52,-7,47
FC Zürich,6364,5,11,11,10,41,35,6,44
Grasshoppers,6364,6,10,6,16,41,51,-10,36
FC Lugano,6364,7,9,7,16,28,49,-21,34
FC Thun,6364,8,8,6,18,40,59,-19,30
FC Sion,6364,9,6,9,17,41,56,-15,27
Young Boys,6365,1,23,6,3,70,31,39,75
FC Basel,6365,2,18,8,6,58,25,33,62
Lucerne,6365,3,14,7,11,41,42,-1,49
St Gallen,6365,4,13,3,16,42,56,-14,42
FC Zürich,6365,5,10,10,12,39,40,-1,40
FC Thun,6365,6,11,5,16,48,61,-13,38
FC Lugano,6365,7,10,5,17,30,49,-19,35
FC Sion,6365,8,8,8,16,43,52,-9,32
Grasshoppers,6365,9,8,6,18,38,53,-15,30
Young Boys,6366,1,22,7,3,76,40,36,73
FC Basel,6366,2,18,8,6,61,31,30,62
Lucerne,6366,3,13,8,11,46,45,1,47
St Gallen,6366,4,14,3,15,44,58,-14,45
FC Lugano,6366,5,11,6,15,30,47,-17,39
FC Zürich,6366,6,9,11,12,38,36,2,38
Grasshoppers,6366,7,9,7,16,41,51,-10,34
FC Thun,6366,8,9,7,16,43,58,-15,34
FC Sion,6366,9,7,7,18,44,57,-13,28
Young Boys,6367,1,23,6,3,71,33,38,75
FC Basel,6367,2,15,9,8,50,29,21,54
St Gallen,6367,3,16,2,14,47,55,-8,50
Lucerne,6367,4,13,8,11,44,45,-1,47
FC Zürich,6367,5,12,9,11,43,36,7,45
Grasshoppers,6367,6,10,6,16,42,49,-7,36
FC Lugano,6367,7,10,5,17,31,50,-19,35
FC Thun,6367,8,9,6,17,43,59,-16,33
FC Sion,6367,9,7,7,18,41,56,-15,28
Young Boys,6368,1,20,8,4,67,35,32,68
FC Basel,6368,2,17,8,7,52,27,25,59
St Gallen,6368,3,15,2,15,46,56,-10,47
FC Lugano,6368,4,13,5,14,36,42,-6,44
FC Zürich,6368,5,11,9,12,43,39,4,42
Lucerne,6368,6,11,9,12,39,45,-6,42
Grasshoppers,6368,7,10,8,14,42,47,-5,38
FC Thun,6368,8,10,6,16,47,60,-13,36
FC Sion,6368,9,6,7,19,39,60,-21,25
Young Boys,6369,1,21,8,3,69,34,35,71
FC Basel,6369,2,18,8,6,58,26,32,62
FC Zürich,6369,3,12,10,10,43,36,7,46
Lucerne,6369,4,12,9,11,42,45,-3,45
St Gallen,6369,5,14,3,15,45,56,-11,45
FC Thun,6369,6,10,6,16,43,60,-17,36
FC Lugano,6369,7,10,5,17,30,47,-17,35
Grasshoppers,6369,8,9,7,16,39,49,-10,34
FC Sion,6369,9,6,8,18,37,53,-16,26
Young Boys,6370,1,21,7,4,69,36,33,70
FC Basel,6370,2,17,8,7,50,25,25,59
Lucerne,6370,3,13,9,10,41,41,0,48
St Gallen,6370,4,15,3,14,45,55,-10,48
FC Zürich,6370,5,11,10,11,41,36,5,43
Grasshoppers,6370,6,11,7,14,44,46,-2,40
FC Thun,6370,7,9,7,16,42,56,-14,34
FC Lugano,6370,8,9,5,18,30,49,-19,32
FC Sion,6370,9,6,8,18,38,56,-18,26
Young Boys,6371,1,21,9,2,72,34,38,72
FC Basel,6371,2,18,9,5,53,23,30,63
Lucerne,6371,3,12,9,11,40,44,-4,45
St Gallen,6371,4,14,2,16,43,57,-14,44
FC Zürich,6371,5,9,10,13,39,40,-1,37
Grasshoppers,6371,6,9,9,14,42,47,-5,36
FC Thun,6371,7,10,6,16,45,59,-14,36
FC Lugano,6371,8,9,7,16,31,52,-21,34
FC Sion,6371,9,7,9,16,46,55,-9,30
Young Boys,6372,1,21,7,4,69,33,36,70
FC Basel,6372,2,18,7,7,52,25,27,61
St Gallen,6372,3,16,3,13,45,52,-7,51
Lucerne,6372,4,11,8,13,38,44,-6,41
FC Lugano,6372,5,11,7,14,32,45,-13,40
FC Thun,6372,6,11,5,16,45,59,-14,38
FC Zürich,6372,7,9,10,13,36,37,-1,37
Grasshoppers,6372,8,10,6,16,39,49,-10,36
FC Sion,6372,9,6,9,17,39,51,-12,27
Young Boys,6373,1,22,7,3,73,36,37,73
FC Basel,6373,2,17,9,6,54,27,27,60
St Gallen,6373,3,14,4,14,42,53,-11,46
Lucerne,6373,4,12,8,12,42,44,-2,44
FC Zürich,6373,5,10,10,12,41,37,4,40
FC Lugano,6373,6,11,6,15,30,46,-16,39
FC Thun,6373,7,10,6,16,46,60,-14,36
Grasshoppers,6373,8,8,8,16,38,50,-12,32
FC Sion,6373,9,7,8,17,43,56,-13,29
Young Boys,6374,1,24,6,2,75,32,43,78
FC Basel,6374,2,19,7,6,60,25,35,64
St Gallen,6374,3,14,3,15,44,56,-12,45
Lucerne,6374,4,12,8,12,40,48,-8,44
FC Lugano,6374,5,11,5,16,32,47,-15,38
FC Zürich,6374,6,9,10,13,38,38,0,37
FC Thun,6374,7,10,6,16,46,60,-14,36
Grasshoppers,6374,8,9,7,16,39,52,-13,34
FC Sion,6374,9,5,10,17,38,54,-16,25
Young Boys,6375,1,21,8,3,72,34,38,71
FC Basel,6375,2,18,7,7,56,31,25,61
St Gallen,6375,3,14,4,14,44,53,-9,46
Lucerne,6375,4,11,11,10,43,46,-3,44
FC Zürich,6375,5,10,10,12,44,43,1,40
FC Lugano,6375,6,11,6,15,34,50,-16,39
FC Thun,6375,7,10,6,16,44,56,-12,36
Grasshoppers,6375,8,9,8,15,45,53,-8,35
FC Sion,6375,9,6,8,18,43,59,-16,26
Young Boys,6376,1,22,6,4,70,36,34,72
FC Basel,6376,2,16,9,7,56,30,26,57
St Gallen,6376,3,17,2,13,45,51,-6,53
Lucerne,6376,4,13,8,11,48,46,2,47
FC Zürich,6376,5,11,10,11,42,35,7,43
FC Thun,6376,6,10,6,16,46,59,-13,36
FC Lugano,6376,7,10,5,17,31,52,-21,35
Grasshoppers,6376,8,8,7,17,42,56,-14,31
FC Sion,6376,9,7,7,18,38,53,-15,28
Young Boys,6377,1,20,8,4,67,34,33,68
FC Basel,6377,2,18,8,6,57,25,32,62
Lucerne,6377,3,15,7,10,44,41,3,52
St Gallen,6377,4,13,4,15,44,61,-17,43
FC Zürich,6377,5,10,11,11,44,39,5,41
FC Thun,6377,6,11,5,16,44,58,-14,38
FC Lugano,6377,7,9,7,16,29,48,-19,34
Grasshoppers,6377,8,9,6,17,41,52,-11,33
FC Sion,6377,9,6,10,16,44,56,-12,28
Young Boys,6378,1,22,7,3,73,34,39,73
FC Basel,6378,2,19,7,6,54,24,30,64
Lucerne,6378,3,14,7,11,45,47,-2,49
St Gallen,6378,4,15,2,15,42,56,-14,47
FC Zürich,6378,5,10,10,12,43,37,6,40
FC Lugano,6378,6,10,6,16,35,50,-15,36
FC Thun,6378,7,9,6,17,42,58,-16,33
Grasshoppers,6378,8,8,7,17,38,50,-12,31
FC Sion,6378,9,7,8,17,42,58,-16,29
Young Boys,6379,1,22,7,3,71,34,37,73
FC Basel,6379,2,17,8,7,50,25,25,59
St Gallen,6379,3,16,2,14,49,53,-4,50
Lucerne,6379,4,12,7,13,38,45,-7,43
FC Zürich,6379,5,11,9,12,42,37,5,42
FC Thun,6379,6,11,6,15,47,56,-9,39
FC Lugano,6379,7,11,5,16,29,48,-19,38
Grasshoppers,6379,8,10,6,16,44,50,-6,36
FC Sion,6379,9,5,8,19,40,62,-22,23
Young Boys,6380,1,21,8,3,70,32,38,71
FC Basel,6380,2,17,10,5,55,28,27,61
St Gallen,6380,3,15,3,14,46,55,-9,48
Lucerne,6380,4,12,8,12,38,43,-5,44
FC Zürich,6380,5,11,10,11,42,36,6,43
FC Thun,6380,6,9,7,16,46,60,-14,34
FC Lugano,6380,7,9,6,17,30,50,-20,33
Grasshoppers,6380,8,8,8,16,40,51,-11,32
FC Sion,6380,9,8,8,16,40,52,-12,32
Young Boys,6381,1,22,7,3,73,38,35,73
FC Basel,6381,2,17,9,6,54,26,28,60
St Gallen,6381,3,15,3,14,45,56,-11,48
Lucerne,6381,4,12,7,13,43,47,-4,43
FC Zürich,6381,5,11,9,12,42,36,6,42
FC Lugano,6381,6,11,5,16,34,48,-14,38
Grasshoppers,6381,7,10,7,15,42,49,-7,37
FC Thun,6381,8,9,6,17,44,64,-20,33
FC Sion,6381,9,7,7,18,47,60,-13,28
Young Boys,6382,1,21,7,4,73,37,36,70
FC Basel,6382,2,19,7,6,57,26,31,64
Lucerne,6382,3,12,9,11,40,46,-6,45
St Gallen,6382,4,14,2,16,44,61,-17,44
FC Zürich,6382,5,10,9,13,39,40,-1,39
FC Lugano,6382,6,11,6,15,35,49,-14,39
Grasshoppers,6382,7,10,6,16,44,49,-5,36
FC Sion,6382,8,9,7,16,49,54,-5,34
FC Thun,6382,9,9,5,18,43,62,-19,32
Young Boys,6383,1,21,7,4,74,40,34,70
FC Basel,6383,2,19,7,6,57,27,30,64
St Gallen,6383,3,15,2,15,43,53,-10,47
Lucerne,6383,4,13,7,12,42,47,-5,46
FC Zürich,6383,5,12,9,11,45,38,7,45
Grasshoppers,6383,6,11,6,15,48,48,0,39
FC Lugano,6383,7,10,6,16,32,48,-16,36
FC Thun,6383,8,9,5,18,42,62,-20,32
FC Sion,6383,9,6,7,19,38,58,-20,25
Young Boys,6384,1,23,6,3,73,33,40,75
FC Basel,6384,2,16,8,8,50,27,23,56
Lucerne,6384,3,14,7,11,42,44,-2,49
St Gallen,6384,4,14,4,14,41,52,-11,46
FC Zürich,6384,5,10,10,12,40,38,2,40
FC Lugano,6384,6,10,6,16,33,49,-16,36
Grasshoppers,6384,7,9,7,16,41,51,-10,34
FC Thun,6384,8,9,7,16,43,57,-14,34
FC Sion,6384,9,7,9,16,40,52,-12,30
Young Boys,6385,1,22,8,2,74,34,40,74
FC Basel,6385,2,17,8,7,51,26,25,59
Lucerne,6385,3,13,7,12,39,43,-4,46
St Gallen,6385,4,14,4,14,40,51,-11,46
FC Zürich,6385,5,10,10,12,40,36,4,40
FC Lugano,6385,6,11,7,14,32,45,-13,40
Grasshoppers,6385,7,10,7,15,42,48,-6,37
FC Thun,6385,8,9,7,16,43,59,-16,34
FC Sion,6385,9,5,8,19,36,55,-19,23
Young Boys,6386,1,21,8,3,68,32,36,71
FC Basel,6386,2,16,11,5,53,27,26,59
Lucerne,6386,3,13,10,9,43,42,1,49
St Gallen,6386,4,14,3,15,43,55,-12,45
FC Zürich,6386,5,10,10,12,42,38,4,40
FC Thun,6386,6,10,7,15,47,57,-10,37
FC Lugano,6386,7,10,6,16,29,45,-16,36
Grasshoppers,6386,8,9,8,15,42,51,-9,35
FC Sion,6386,9,6,7,19,40,60,-20,25
Young Boys,6387,1,23,6,3,72,35,37,75
FC Basel,6387,2,17,7,8,56,31,25,58
St Gallen,6387,3,16,2,14,48,56,-8,50
Lucerne,6387,4,12,9,11,41,44,-3,45
FC Zürich,6387,5,9,12,11,37,36,1,39
Grasshoppers,6387,6,10,7,15,43,49,-6,37
FC Lugano,6387,7,10,7,15,31,46,-15,37
FC Thun,6387,8,10,6,16,47,58,-11,36
FC Sion,6387,9,5,8,19,39,59,-20,23
Young Boys,6388,1,22,7,3,69,32,37,73
FC Basel,6388,2,18,8,6,53,25,28,62
St Gallen,6388,3,15,3,14,45,56,-11,48
Lucerne,6388,4,13,8,11,44,44,0,47
FC Zürich,6388,5,9,10,13,40,39,1,37
FC Lugano,6388,6,10,7,15,30,45,-15,37
Grasshoppers,6388,7,10,6,16,40,49,-9,36
FC Thun,6388,8,9,7,16,43,58,-15,34
FC Sion,6388,9,6,8,18,38,54,-16,26
Young Boys,6389,1,22,8,2,72,34,38,74
FC Basel,6389,2,17,10,5,54,24,30,61
St Gallen,6389,3,15,4,13,43,51,-8,49
FC Zürich,6389,4,11,11,10,40,33,7,44
Lucerne,6389,5,12,8,12,44,45,-1,44
Grasshoppers,6389,6,9,7,16,43,51,-8,34
FC Lugano,6389,7,9,7,16,31,53,-22,34
FC Thun,6389,8,9,5,18,41,59,-18,32
FC Sion,6389,9,6,8,18,40,58,-18,26
Young Boys,6390,1,22,6,4,69,33,36,72
FC Basel,6390,2,17,9,6,52,25,27,60
Lucerne,6390,3,14,7,11,41,42,-1,49
St Gallen,6390,4,13,4,15,40,53,-13,43
FC Thun,6390,5,11,6,15,47,58,-11,39
FC Zürich,6390,6,9,11,12,39,39,0,38
FC Lugano,6390,7,11,5,16,31,48,-17,38
Grasshoppers,6390,8,9,6,17,40,51,-11,33
FC Sion,6390,9,7,8,17,42,52,-10,29
Young Boys,6391,1,21,7,4,74,36,38,70
FC Basel,6391,2,19,8,5,57,26,31,65
St Gallen,6391,3,14,3,15,46,62,-16,45
FC Zürich,6391,4,11,10,11,44,38,6,43
Lucerne,6391,5,12,7,13,45,52,-7,43
FC Lugano,6391,6,10,6,16,34,52,-18,36
Grasshoppers,6391,7,9,7,16,42,54,-12,34
FC Sion,6391,8,8,9,15,50,52,-2,33
FC Thun,6391,9,9,5,18,42,62,-20,32
Young Boys,6392,1,22,7,3,74,36,38,73
FC Basel,6392,2,17,10,5,54,25,29,61
Lucerne,6392,3,13,8,11,43,44,-1,47
St Gallen,6392,4,14,2,16,40,54,-14,44
FC Zürich,6392,5,10,9,13,42,39,3,39
Grasshoppers,6392,6,10,7,15,40,48,-8,37
FC Thun,6392,7,10,7,15,46,58,-12,37
FC Lugano,6392,8,10,5,17,32,52,-20,35
FC Sion,6392,9,7,7,18,39,54,-15,28
Young Boys,6393,1,23,6,3,75,34,41,75
FC Basel,6393,2,18,7,7,57,26,31,61
Lucerne,6393,3,13,9,10,43,43,0,48
St Gallen,6393,4,14,4,14,42,53,-11,46
FC Zürich,6393,5,10,10,12,43,40,3,40
FC Lugano,6393,6,10,6,16,31,50,-19,36
Grasshoppers,6393,7,9,8,15,41,50,-9,35
FC Thun,6393,8,9,7,16,46,64,-18,34
FC Sion,6393,9,6,7,19,38,56,-18,25
Young Boys,6394,1,21,8,3,73,36,37,71
FC Basel,6394,2,15,10,7,50,30,20,55
Lucerne,6394,3,13,10,9,41,39,2,49
FC Zürich,6394,4,13,9,10,46,35,11,48
St Gallen,6394,5,13,5,14,41,56,-15,44
Grasshoppers,6394,6,8,10,14,39,47,-8,34
FC Thun,6394,7,9,7,16,43,57,-14,34
FC Lugano,6394,8,9,6,17,29,50,-21,33
FC Sion,6394,9,6,9,17,42,54,-12,27
Young Boys,6395,1,20,8,4,73,40,33,68
FC Basel,6395,2,18,9,5,59,25,34,63
Lucerne,6395,3,12,9,11,40,45,-5,45
FC Lugano,6395,4,12,6,14,36,45,-9,42
St Gallen,6395,5,13,3,16,38,55,-17,42
FC Zürich,6395,6,9,11,12,40,42,-2,38
Grasshoppers,6395,7,10,7,15,44,49,-5,37
FC Thun,6395,8,10,6,16,46,59,-13,36
FC Sion,6395,9,6,9,17,42,58,-16,27
Young Boys,6396,1,22,7,3,75,36,39,73
FC Basel,6396,2,18,7,7,58,28,30,61
FC Zürich,6396,3,13,9,10,45,35,10,48
Lucerne,6396,4,13,9,10,46,44,2,48
St Gallen,6396,5,14,3,15,43,54,-11,45
FC Lugano,6396,6,11,5,16,34,48,-14,38
FC Thun,6396,7,10,5,17,48,66,-18,35
Grasshoppers,6396,8,9,6,17,41,55,-14,33
FC Sion,6396,9,5,7,20,38,62,-24,22
Young Boys,6397,1,21,7,4,76,37,39,70
FC Basel,6397,2,19,7,6,58,26,32,64
St Gallen,6397,3,16,3,13,47,54,-7,51
Lucerne,6397,4,12,9,11,42,49,-7,45
FC Zürich,6397,5,10,9,13,40,39,1,39
FC Thun,6397,6,10,5,17,45,59,-14,35
Grasshoppers,6397,7,9,7,16,40,49,-9,34
FC Sion,6397,8,8,8,16,42,56,-14,32
FC Lugano,6397,9,9,5,18,32,53,-21,32
Young Boys,6398,1,20,9,3,71,38,33,69
FC Basel,6398,2,18,7,7,55,26,29,61
St Gallen,6398,3,16,2,14,45,54,-9,50
Lucerne,6398,4,13,8,11,44,44,0,47
FC Zürich,6398,5,12,9,11,41,35,6,45
FC Lugano,6398,6,10,6,16,32,48,-16,36
FC Thun,6398,7,10,5,17,44,60,-16,35
Grasshoppers,6398,8,9,7,16,42,51,-9,34
FC Sion,6398,9,6,7,19,39,57,-18,25
Young Boys,6399,1,20,8,4,77,41,36,68
FC Basel,6399,2,18,8,6,54,23,31,62
St Gallen,6399,3,15,3,14,44,54,-10,48
Lucerne,6399,4,12,7,13,44,54,-10,43
FC Zürich,6399,5,10,11,11,40,36,4,41
FC Lugano,6399,6,10,7,15,34,49,-15,37
Grasshoppers,6399,7,9,8,15,42,50,-8,35
FC Thun,6399,8,9,7,16,42,58,-16,34
FC Sion,6399,9,6,11,15,39,51,-12,29
Young Boys,6400,1,21,8,3,72,35,37,71
FC Basel,6400,2,17,8,7,54,25,29,59
Lucerne,6400,3,15,7,10,46,46,0,52
St Gallen,6400,4,14,3,15,45,58,-13,45
FC Zürich,6400,5,10,11,11,40,37,3,41
FC Lugano,6400,6,9,8,15,31,47,-16,35
Grasshoppers,6400,7,9,7,16,42,53,-11,34
FC Thun,6400,8,9,7,16,43,57,-14,34
FC Sion,6400,9,7,7,18,43,58,-15,28
Young Boys,6401,1,23,6,3,72,36,36,75
FC Basel,6401,2,18,7,7,56,24,32,61
St Gallen,6401,3,16,2,14,45,54,-9,50
FC Zürich,6401,4,13,9,10,44,34,10,48
Lucerne,6401,5,13,7,12,43,45,-2,46
FC Lugano,6401,6,10,5,17,32,51,-19,35
Grasshoppers,6401,7,9,6,17,42,55,-13,33
FC Thun,6401,8,9,5,18,46,64,-18,32
FC Sion,6401,9,6,7,19,40,57,-17,25
Young Boys,6402,1,21,9,2,72,36,36,72
FC Basel,6402,2,17,8,7,57,27,30,59
Lucerne,6402,3,14,7,11,44,46,-2,49
FC Zürich,6402,4,12,9,11,44,37,7,45
St Gallen,6402,5,13,2,17,38,57,-19,41
FC Thun,6402,6,10,6,16,46,62,-16,36
FC Lugano,6402,7,10,6,16,32,50,-18,36
FC Sion,6402,8,8,8,16,47,52,-5,32
Grasshoppers,6402,9,8,7,17,39,52,-13,31
Young Boys,6403,1,23,6,3,75,33,42,75
FC Basel,6403,2,18,8,6,60,25,35,62
Lucerne,6403,3,13,9,10,43,44,-1,48
FC Zürich,6403,4,10,11,11,40,34,6,41
St Gallen,6403,5,13,2,17,39,55,-16,41
FC Lugano,6403,6,10,7,15,29,45,-16,37
Grasshoppers,6403,7,9,7,16,39,50,-11,34
FC Sion,6403,8,8,7,17,39,54,-15,31
FC Thun,6403,9,8,7,17,39,63,-24,31
Young Boys,6404,1,21,8,3,70,34,36,71
FC Basel,6404,2,18,8,6,53,25,28,62
Lucerne,6404,3,13,8,11,42,43,-1,47
St Gallen,6404,4,14,3,15,43,57,-14,45
FC Zürich,6404,5,10,12,10,42,36,6,42
Grasshoppers,6404,6,10,7,15,39,47,-8,37
FC Thun,6404,7,9,6,17,43,58,-15,33
FC Lugano,6404,8,9,6,17,30,48,-18,33
FC Sion,6404,9,7,8,17,38,52,-14,29
Young Boys,6405,1,20,7,5,70,38,32,67
FC Basel,6405,2,18,8,6,54,25,29,62
Lucerne,6405,3,14,8,10,43,41,2,50
St Gallen,6405,4,15,4,13,46,55,-9,49
FC Zürich,6405,5,10,11,11,43,37,6,41
Grasshoppers,6405,6,10,6,16,43,51,-8,36
FC Thun,6405,7,9,6,17,41,60,-19,33
FC Lugano,6405,8,9,6,17,31,52,-21,33
FC Sion,6405,9,6,10,16,42,54,-12,28
Young Boys,6406,1,21,6,5,71,37,34,69
FC Basel,6406,2,17,9,6,51,25,26,60
Lucerne,6406,3,15,8,9,43,39,4,53
St Gallen,6406,4,14,4,14,42,53,-11,46
FC Zürich,6406,5,11,10,11,40,35,5,43
Grasshoppers,6406,6,11,6,15,42,47,-5,39
FC Thun,6406,7,9,6,17,41,57,-16,33
FC Lugano,6406,8,9,5,18,31,51,-20,32
FC Sion,6406,9,6,8,18,39,56,-17,26
Young Boys,6407,1,20,8,4,69,35,34,68
FC Basel,6407,2,17,9,6,51,25,26,60
Lucerne,6407,3,13,9,10,41,41,0,48
St Gallen,6407,4,13,3,16,39,55,-16,42
FC Zürich,6407,5,10,10,12,40,37,3,40
FC Thun,6407,6,11,6,15,48,58,-10,39
FC Lugano,6407,7,11,6,15,31,46,-15,39
Grasshoppers,6407,8,8,9,15,39,48,-9,33
FC Sion,6407,9,7,8,17,41,54,-13,29
Young Boys,6408,1,22,6,4,72,34,38,72
FC Basel,6408,2,19,8,5,62,27,35,65
St Gallen,6408,3,14,4,14,44,54,-10,46
Lucerne,6408,4,12,8,12,42,50,-8,44
FC Zürich,6408,5,10,9,13,40,39,1,39
Grasshoppers,6408,6,11,6,15,46,52,-6,39
FC Lugano,6408,7,11,6,15,31,47,-16,39
FC Thun,6408,8,9,5,18,45,61,-16,32
FC Sion,6408,9,6,8,18,40,58,-18,26
Young Boys,6409,1,21,6,5,74,41,33,69
FC Basel,6409,2,19,8,5,62,28,34,65
Lucerne,6409,3,11,11,10,44,48,-4,44
St Gallen,6409,4,13,3,16,42,56,-14,42
FC Zürich,6409,5,10,10,12,42,40,2,40
FC Thun,6409,6,10,6,16,43,56,-13,36
FC Lugano,6409,7,10,6,16,32,51,-19,36
Grasshoppers,6409,8,9,8,15,40,49,-9,35
FC Sion,6409,9,7,10,15,42,52,-10,31
Young Boys,6410,1,22,7,3,71,34,37,73
FC Basel,6410,2,16,9,7,52,29,23,57
Lucerne,6410,3,13,9,10,42,42,0,48
FC Zürich,6410,4,12,9,11,44,35,9,45
St Gallen,6410,5,13,4,15,41,54,-13,43
Grasshoppers,6410,6,10,6,16,42,52,-10,36
FC Thun,6410,7,10,6,16,46,59,-13,36
FC Lugano,6410,8,10,6,16,32,48,-16,36
FC Sion,6410,9,6,8,18,38,55,-17,26
Young Boys,6411,1,21,7,4,71,37,34,70
FC Basel,6411,2,18,8,6,58,28,30,62
St Gallen,6411,3,16,2,14,45,54,-9,50
FC Zürich,6411,4,11,10,11,43,36,7,43
Lucerne,6411,5,11,8,13,40,48,-8,41
FC Thun,6411,6,10,6,16,45,61,-16,36
FC Lugano,6411,7,10,6,16,31,47,-16,36
Grasshoppers,6411,8,9,8,15,42,52,-10,35
FC Sion,6411,9,7,7,18,42,54,-12,28
Young Boys,6412,1,23,6,3,75,33,42,75
FC Basel,6412,2,18,9,5,55,26,29,63
St Gallen,6412,3,13,5,14,43,55,-12,44
Lucerne,6412,4,11,10,11,42,46,-4,43
FC Zürich,6412,5,9,11,12,38,37,1,38
FC Lugano,6412,6,10,7,15,31,47,-16,37
FC Thun,6412,7,10,6,16,44,57,-13,36
Grasshoppers,6412,8,9,6,17,42,55,-13,33
FC Sion,6412,9,7,8,17,42,56,-14,29
Young Boys,6413,1,22,7,3,72,38,34,73
FC Basel,6413,2,19,7,6,54,25,29,64
FC Zürich,6413,3,13,9,10,44,34,10,48
Lucerne,6413,4,13,8,11,41,42,-1,47
St Gallen,6413,5,15,2,15,42,53,-11,47
Grasshoppers,6413,6,10,6,16,43,49,-6,36
FC Lugano,6413,7,9,5,18,32,52,-20,32
FC Thun,6413,8,8,5,19,40,61,-21,29
FC Sion,6413,9,7,7,18,42,56,-14,28
Young Boys,6414,1,20,9,3,73,38,35,69
FC Basel,6414,2,17,8,7,55,35,20,59
Lucerne,6414,3,14,8,10,45,42,3,50
St Gallen,6414,4,15,2,15,45,56,-11,47
FC Zürich,6414,5,10,11,11,46,38,8,41
FC Thun,6414,6,10,5,17,46,60,-14,35
FC Lugano,6414,7,9,7,16,30,50,-20,34
Grasshoppers,6414,8,8,8,16,40,50,-10,32
FC Sion,6414,9,8,8,16,39,50,-11,32
Young Boys,6415,1,22,7,3,70,32,38,73
FC Basel,6415,2,19,7,6,58,26,32,64
St Gallen,6415,3,15,3,14,43,54,-11,48
FC Zürich,6415,4,11,10,11,43,38,5,43
Lucerne,6415,5,11,10,11,41,45,-4,43
Grasshoppers,6415,6,11,7,14,44,46,-2,40
FC Lugano,6415,7,9,7,16,29,47,-18,34
FC Thun,6415,8,9,6,17,45,64,-19,33
FC Sion,6415,9,5,7,20,38,59,-21,22
Young Boys,6416,1,22,6,4,73,34,39,72
FC Basel,6416,2,18,7,7,52,27,25,61
Lucerne,6416,3,14,8,10,45,43,2,50
St Gallen,6416,4,15,3,14,45,54,-9,48
FC Zürich,6416,5,9,10,13,38,40,-2,37
FC Lugano,6416,6,10,6,16,28,47,-19,36
FC Thun,6416,7,10,5,17,47,60,-13,35
Grasshoppers,6416,8,9,7,16,43,50,-7,34
FC Sion,6416,9,7,8,17,39,55,-16,29
Young Boys,6417,1,20,6,6,68,41,27,66
FC Basel,6417,2,19,8,5,55,23,32,65
St Gallen,6417,3,15,3,14,43,52,-9,48
Lucerne,6417,4,12,8,12,41,46,-5,44
FC Zürich,6417,5,10,12,10,41,36,5,42
Grasshoppers,6417,6,10,7,15,45,49,-4,37
FC Lugano,6417,7,10,7,15,33,47,-14,37
FC Thun,6417,8,9,6,17,41,60,-19,33
FC Sion,6417,9,7,7,18,40,53,-13,28
Young Boys,6418,1,22,6,4,71,35,36,72
FC Basel,6418,2,18,7,7,57,25,32,61
St Gallen,6418,3,15,3,14,46,56,-10,48
Lucerne,6418,4,12,9,11,39,42,-3,45
FC Lugano,6418,5,12,5,15,35,46,-11,41
FC Zürich,6418,6,10,9,13,39,37,2,39
Grasshoppers,6418,7,9,8,15,41,49,-8,35
FC Thun,6418,8,10,5,17,46,65,-19,35
FC Sion,6418,9,6,8,18,39,58,-19,26
Young Boys,6419,1,21,7,4,70,35,35,70
FC Basel,6419,2,18,7,7,58,26,32,61
St Gallen,6419,3,15,3,14,44,55,-11,48
FC Zürich,6419,4,12,9,11,45,36,9,45
Lucerne,6419,5,11,10,11,41,47,-6,43
FC Lugano,6419,6,12,6,14,37,47,-10,42
Grasshoppers,6419,7,9,8,15,44,50,-6,35
FC Thun,6419,8,9,5,18,41,66,-25,32
FC Sion,6419,9,5,9,18,38,56,-18,24
Young Boys,6420,1,20,8,4,72,37,35,68
FC Basel,6420,2,19,8,5,59,24,35,65
St Gallen,6420,3,15,3,14,45,56,-11,48
Lucerne,6420,4,13,8,11,45,46,-1,47
FC Zürich,6420,5,11,11,10,44,36,8,44
Grasshoppers,6420,6,9,8,15,41,50,-9,35
FC Lugano,6420,7,9,5,18,29,54,-25,32
FC Sion,6420,8,7,9,16,42,55,-13,30
FC Thun,6420,9,8,6,18,38,57,-19,30
Young Boys,6421,1,22,6,4,74,39,35,72
FC Basel,6421,2,19,8,5,60,27,33,65
Lucerne,6421,3,13,9,10,42,42,0,48
St Gallen,6421,4,13,3,16,41,57,-16,42
FC Zürich,6421,5,10,10,12,43,39,4,40
FC Lugano,6421,6,11,6,15,31,43,-12,39
FC Thun,6421,7,9,6,17,44,64,-20,33
Grasshoppers,6421,8,8,8,16,39,49,-10,32
FC Sion,6421,9,7,8,17,42,56,-14,29
Young Boys,6422,1,22,6,4,74,37,37,72
FC Basel,6422,2,18,9,5,56,26,30,63
St Gallen,6422,3,15,2,15,42,55,-13,47
Lucerne,6422,4,11,9,12,37,42,-5,42
FC Zürich,6422,5,10,10,12,38,36,2,40
Grasshoppers,6422,6,11,6,15,43,50,-7,39
FC Lugano,6422,7,11,6,15,33,47,-14,39
FC Thun,6422,8,10,6,16,45,58,-13,36
FC Sion,6422,9,5,8,19,40,57,-17,23
Young Boys,6423,1,21,7,4,75,39,36,70
FC Basel,6423,2,19,8,5,53,22,31,65
Lucerne,6423,3,12,8,12,42,48,-6,44
St Gallen,6423,4,13,2,17,38,56,-18,41
FC Lugano,6423,5,11,7,14,35,48,-13,40
Grasshoppers,6423,6,10,7,15,44,48,-4,37
FC Thun,6423,7,10,7,15,43,56,-13,37
FC Zürich,6423,8,9,9,14,38,39,-1,36
FC Sion,6423,9,8,7,17,42,54,-12,31
Young Boys,6424,1,22,6,4,68,34,34,72
FC Basel,6424,2,19,8,5,56,23,33,65
Lucerne,6424,3,12,9,11,43,44,-1,45
St Gallen,6424,4,14,3,15,42,59,-17,45
FC Zürich,6424,5,10,9,13,39,36,3,39
FC Lugano,6424,6,11,6,15,35,47,-12,39
FC Thun,6424,7,10,5,17,42,58,-16,35
Grasshoppers,6424,8,9,6,17,41,50,-9,33
FC Sion,6424,9,7,8,17,40,55,-15,29
Young Boys,6425,1,21,7,4,70,38,32,70
FC Basel,6425,2,19,7,6,57,24,33,64
St Gallen,6425,3,15,3,14,43,53,-10,48
Lucerne,6425,4,13,8,11,43,43,0,47
FC Zürich,6425,5,11,11,10,41,33,8,44
Grasshoppers,6425,6,9,8,15,40,47,-7,35
FC Lugano,6425,7,9,6,17,28,49,-21,33
FC Thun,6425,8,8,8,16,42,61,-19,32
FC Sion,6425,9,5,10,17,41,57,-16,25
Young Boys,6426,1,21,8,3,70,32,38,71
FC Basel,6426,2,20,7,5,55,21,34,67
Lucerne,6426,3,12,8,12,38,43,-5,44
St Gallen,6426,4,14,2,16,40,57,-17,44
FC Zürich,6426,5,10,10,12,38,36,2,40
FC Lugano,6426,6,11,6,15,32,45,-13,39
FC Thun,6426,7,10,5,17,42,58,-16,35
Grasshoppers,6426,8,9,7,16,40,50,-10,34
FC Sion,6426,9,6,9,17,40,53,-13,27
Young Boys,6427,1,20,7,5,66,38,28,67
FC Basel,6427,2,17,8,7,52,25,27,59
Lucerne,6427,3,14,7,11,45,45,0,49
FC Zürich,6427,4,12,9,11,44,37,7,45
St Gallen,6427,5,14,3,15,43,55,-12,45
Grasshoppers,6427,6,11,6,15,45,47,-2,39
FC Lugano,6427,7,11,5,16,32,48,-16,38
FC Thun,6427,8,9,5,18,43,61,-18,32
FC Sion,6427,9,7,8,17,43,57,-14,29
Young Boys,6428,1,22,7,3,73,35,38,73
FC Basel,6428,2,16,8,8,52,29,23,56
Lucerne,6428,3,14,7,11,45,47,-2,49
St Gallen,6428,4,15,3,14,47,57,-10,48
FC Zürich,6428,5,12,10,10,41,34,7,46
Grasshoppers,6428,6,9,6,17,41,52,-11,33
FC Lugano,6428,7,9,6,17,33,53,-20,33
FC Sion,6428,8,8,8,16,45,53,-8,32
FC Thun,6428,9,9,5,18,43,60,-17,32
Young Boys,6429,1,24,6,2,79,32,47,78
FC Basel,6429,2,17,8,7,54,27,27,59
Lucerne,6429,3,13,9,10,41,40,1,48
St Gallen,6429,4,14,4,14,42,53,-11,46
FC Zürich,6429,5,11,11,10,42,35,7,44
FC Lugano,6429,6,9,7,16,28,48,-20,34
FC Thun,6429,7,9,6,17,50,63,-13,33
Grasshoppers,6429,8,9,6,17,41,59,-18,33
FC Sion,6429,9,5,9,18,41,61,-20,24
Young Boys,6430,1,22,6,4,76,38,38,72
FC Basel,6430,2,17,9,6,54,26,28,60
Lucerne,6430,3,12,10,10,43,41,2,46
St Gallen,6430,4,13,4,15,41,56,-15,43
FC Zürich,6430,5,10,11,11,39,35,4,41
FC Thun,6430,6,10,6,16,46,62,-16,36
FC Lugano,6430,7,10,6,16,31,48,-17,36
Grasshoppers,6430,8,9,6,17,39,58,-19,33
FC Sion,6430,9,8,8,16,47,52,-5,32
Young Boys,6431,1,22,7,3,73,35,38,73
FC Basel,6431,2,17,8,7,52,26,26,59
Lucerne,6431,3,14,8,10,48,42,6,50
St Gallen,6431,4,14,3,15,40,55,-15,45
FC Zürich,6431,5,11,11,10,40,33,7,44
Grasshoppers,6431,6,10,7,15,45,54,-9,37
FC Thun,6431,7,8,9,15,44,59,-15,33
FC Lugano,6431,8,9,6,17,28,49,-21,33
FC Sion,6431,9,5,9,18,38,55,-17,24
Young Boys,6432,1,21,9,2,76,37,39,72
FC Basel,6432,2,17,10,5,55,28,27,61
Lucerne,6432,3,13,9,10,46,44,2,48
St Gallen,6432,4,14,3,15,43,56,-13,45
FC Zürich,6432,5,10,10,12,40,37,3,40
FC Lugano,6432,6,11,5,16,32,48,-16,38
Grasshoppers,6432,7,9,9,14,44,50,-6,36
FC Thun,6432,8,8,7,17,43,61,-18,31
FC Sion,6432,9,6,8,18,39,57,-18,26
Young Boys,6433,1,21,6,5,72,39,33,69
FC Basel,6433,2,18,8,6,53,25,28,62
Lucerne,6433,3,14,7,11,43,43,0,49
Grasshoppers,6433,4,12,6,14,47,48,-1,42
St Gallen,6433,5,13,2,17,42,59,-17,41
FC Zürich,6433,6,9,11,12,40,39,1,38
FC Lugano,6433,7,11,5,16,32,47,-15,38
FC Thun,6433,8,9,7,16,44,59,-15,34
FC Sion,6433,9,7,8,17,40,54,-14,29
Young Boys,6434,1,23,7,2,72,30,42,76
FC Basel,6434,2,17,9,6,54,26,28,60
St Gallen,6434,3,16,3,13,49,53,-4,51
Lucerne,6434,4,13,7,12,44,49,-5,46
FC Zürich,6434,5,11,9,12,40,37,3,42
FC Thun,6434,6,11,6,15,48,57,-9,39
FC Lugano,6434,7,9,5,18,31,54,-23,32
Grasshoppers,6434,8,8,6,18,37,53,-16,30
FC Sion,6434,9,6,8,18,39,55,-16,26
Young Boys,6435,1,21,7,4,70,37,33,70
FC Basel,6435,2,17,9,6,55,29,26,60
Lucerne,6435,3,13,9,10,47,44,3,48
St Gallen,6435,4,14,2,16,40,57,-17,44
FC Zürich,6435,5,11,10,11,47,41,6,43
FC Lugano,6435,6,10,6,16,30,47,-17,36
Grasshoppers,6435,7,9,8,15,43,50,-7,35
FC Thun,6435,8,9,7,16,43,59,-16,34
FC Sion,6435,9,7,8,17,42,53,-11,29
Young Boys,6436,1,22,8,2,74,33,41,74
FC Basel,6436,2,17,8,7,53,26,27,59
Lucerne,6436,3,13,9,10,39,39,0,48
St Gallen,6436,4,14,4,14,41,53,-12,46
FC Zürich,6436,5,10,10,12,38,35,3,40
FC Thun,6436,6,10,6,16,44,58,-14,36
FC Lugano,6436,7,10,6,16,30,47,-17,36
Grasshoppers,6436,8,8,8,16,37,49,-12,32
FC Sion,6436,9,6,9,17,38,54,-16,27
Young Boys,6437,1,20,7,5,67,40,27,67
FC Basel,6437,2,18,7,7,56,25,31,61
St Gallen,6437,3,17,2,13,45,52,-7,53
Lucerne,6437,4,13,7,12,41,43,-2,46
FC Zürich,6437,5,11,11,10,41,34,7,44
FC Lugano,6437,6,10,6,16,30,47,-17,36
Grasshoppers,6437,7,8,8,16,36,50,-14,32
FC Sion,6437,8,8,7,17,44,51,-7,31
FC Thun,6437,9,8,7,17,39,57,-18,31
Young Boys,6438,1,22,7,3,75,33,42,73
FC Basel,6438,2,18,8,6,57,25,32,62
St Gallen,6438,3,15,2,15,46,58,-12,47
Lucerne,6438,4,13,7,12,43,51,-8,46
FC Zürich,6438,5,9,11,12,40,38,2,38
FC Lugano,6438,6,10,6,16,32,50,-18,36
Grasshoppers,6438,7,9,7,16,40,50,-10,34
FC Thun,6438,8,9,7,16,43,59,-16,34
FC Sion,6438,9,8,7,17,44,56,-12,31
Young Boys,6439,1,21,7,4,72,38,34,70
FC Basel,6439,2,16,11,5,51,25,26,59
Lucerne,6439,3,13,8,11,44,45,-1,47
St Gallen,6439,4,14,4,14,46,56,-10,46
FC Lugano,6439,5,11,6,15,32,46,-14,39
FC Zürich,6439,6,9,11,12,37,35,2,38
FC Thun,6439,7,11,5,16,47,57,-10,38
FC Sion,6439,8,8,8,16,44,57,-13,32
Grasshoppers,6439,9,8,6,18,42,56,-14,30
Young Boys,6440,1,21,8,3,71,33,38,71
FC Basel,6440,2,18,8,6,56,27,29,62
St Gallen,6440,3,14,4,14,44,57,-13,46
Lucerne,6440,4,11,9,12,41,49,-8,42
FC Zürich,6440,5,10,10,12,41,38,3,40
FC Lugano,6440,6,11,7,14,33,46,-13,40
Grasshoppers,6440,7,9,7,16,41,49,-8,34
FC Sion,6440,8,8,8,16,42,52,-10,32
FC Thun,6440,9,8,7,17,43,61,-18,31
Young Boys,6441,1,22,7,3,69,33,36,73
FC Basel,6441,2,17,8,7,52,27,25,59
St Gallen,6441,3,15,4,13,47,51,-4,49
Lucerne,6441,4,13,8,11,42,43,-1,47
FC Zürich,6441,5,11,9,12,43,39,4,42
FC Lugano,6441,6,10,6,16,33,51,-18,36
Grasshoppers,6441,7,9,8,15,40,49,-9,35
FC Thun,6441,8,8,6,18,42,63,-21,30
FC Sion,6441,9,7,8,17,41,53,-12,29
Young Boys,6442,1,22,7,3,72,34,38,73
FC Basel,6442,2,15,11,6,50,26,24,56
St Gallen,6442,3,14,3,15,41,54,-13,45
Lucerne,6442,4,11,10,11,43,46,-3,43
FC Lugano,6442,5,12,6,14,36,46,-10,42
FC Zürich,6442,6,9,11,12,40,39,1,38
FC Thun,6442,7,10,7,15,44,56,-12,37
Grasshoppers,6442,8,9,9,14,45,52,-7,36
FC Sion,6442,9,6,8,18,37,55,-18,26
Young Boys,6443,1,22,7,3,72,37,35,73
FC Basel,6443,2,19,7,6,63,25,38,64
Lucerne,6443,3,13,9,10,43,41,2,48
St Gallen,6443,4,13,3,16,39,56,-17,42
FC Zürich,6443,5,10,10,12,40,39,1,40
FC Thun,6443,6,11,5,16,50,64,-14,38
FC Lugano,6443,7,10,7,15,31,45,-14,37
Grasshoppers,6443,8,9,7,16,42,51,-9,34
FC Sion,6443,9,6,7,19,39,61,-22,25
Young Boys,6444,1,24,6,2,74,29,45,78
FC Basel,6444,2,16,8,8,50,27,23,56
St Gallen,6444,3,16,2,14,43,54,-11,50
FC Zürich,6444,4,11,10,11,44,36,8,43
Lucerne,6444,5,12,7,13,40,48,-8,43
FC Thun,6444,6,11,6,15,45,56,-11,39
Grasshoppers,6444,7,9,7,16,38,47,-9,34
FC Lugano,6444,8,9,5,18,28,50,-22,32
FC Sion,6444,9,7,7,18,40,55,-15,28
Young Boys,6445,1,20,7,5,67,36,31,67
FC Basel,6445,2,19,7,6,56,26,30,64
St Gallen,6445,3,15,3,14,47,56,-9,48
Lucerne,6445,4,12,7,13,40,47,-7,43
FC Zürich,6445,5,10,9,13,41,41,0,39
FC Lugano,6445,6,11,6,15,34,47,-13,39
FC Thun,6445,7,11,5,16,49,55,-6,38
Grasshoppers,6445,8,10,6,16,39,50,-11,36
FC Sion,6445,9,7,8,17,41,56,-15,29
Young Boys,6446,1,22,7,3,70,32,38,73
FC Basel,6446,2,19,8,5,53,24,29,65
Lucerne,6446,3,13,8,11,43,45,-2,47
St Gallen,6446,4,15,2,15,45,56,-11,47
FC Zürich,6446,5,10,9,13,40,38,2,39
FC Thun,6446,6,10,7,15,45,57,-12,37
FC Lugano,6446,7,10,5,17,31,48,-17,35
Grasshoppers,6446,8,9,6,17,40,52,-12,33
FC Sion,6446,9,6,8,18,41,56,-15,26
Young Boys,6447,1,20,10,2,71,35,36,70
FC Basel,6447,2,18,8,6,54,28,26,62
Lucerne,6447,3,13,8,11,43,43,0,47
FC Zürich,6447,4,10,11,11,40,36,4,41
St Gallen,6447,5,13,2,17,42,58,-16,41
FC Lugano,6447,6,11,6,15,31,45,-14,39
FC Sion,6447,7,8,9,15,43,53,-10,33
Grasshoppers,6447,8,9,6,17,42,53,-11,33
FC Thun,6447,9,9,6,17,43,58,-15,33
Young Boys,6448,1,23,6,3,71,33,38,75
FC Basel,6448,2,16,8,8,53,29,24,56
Lucerne,6448,3,13,9,10,43,42,1,48
St Gallen,6448,4,14,4,14,45,56,-11,46
FC Zürich,6448,5,11,9,12,41,37,4,42
FC Thun,6448,6,11,5,16,48,57,-9,38
FC Lugano,6448,7,10,6,16,31,47,-16,36
Grasshoppers,6448,8,9,6,17,40,54,-14,33
FC Sion,6448,9,7,7,18,40,57,-17,28
Young Boys,6449,1,20,6,6,68,36,32,66
FC Basel,6449,2,17,9,6,56,27,29,60
Lucerne,6449,3,13,9,10,42,42,0,48
St Gallen,6449,4,13,5,14,43,59,-16,44
Grasshoppers,6449,5,12,6,14,45,45,0,42
FC Zürich,6449,6,10,10,12,40,40,0,40
FC Thun,6449,7,10,5,17,44,62,-18,35
FC Lugano,6449,8,9,7,16,31,50,-19,34
FC Sion,6449,9,8,7,17,45,53,-8,31
Young Boys,6450,1,24,6,2,73,32,41,78
FC Basel,6450,2,17,9,6,56,28,28,60
Lucerne,6450,3,13,7,12,43,45,-2,46
St Gallen,6450,4,13,3,16,43,58,-15,42
FC Zürich,6450,5,9,11,12,39,37,2,38
FC Thun,6450,6,11,5,16,42,57,-15,38
FC Lugano,6450,7,11,5,16,31,47,-16,38
Grasshoppers,6450,8,9,6,17,40,51,-11,33
FC Sion,6450,9,7,8,17,43,55,-12,29
Young Boys,6451,1,22,8,2,68,31,37,74
FC Basel,6451,2,17,8,7,53,28,25,59
St Gallen,6451,3,15,2,15,43,58,-15,47
Lucerne,6451,4,12,9,11,40,43,-3,45
FC Zürich,6451,5,10,9,13,40,40,0,39
FC Thun,6451,6,11,6,15,48,57,-9,39
FC Lugano,6451,7,10,6,16,31,47,-16,36
Grasshoppers,6451,8,9,6,17,38,48,-10,33
FC Sion,6451,9,7,8,17,42,51,-9,29
Young Boys,6452,1,21,7,4,71,34,37,70
FC Basel,6452,2,19,7,6,58,28,30,64
St Gallen,6452,3,15,4,13,43,52,-9,49
Lucerne,6452,4,12,8,12,40,43,-3,44
FC Zürich,6452,5,9,11,12,39,38,1,38
FC Thun,6452,6,10,6,16,46,57,-11,36
FC Lugano,6452,7,10,6,16,28,47,-19,36
Grasshoppers,6452,8,9,8,15,40,50,-10,35
FC Sion,6452,9,5,11,16,40,56,-16,26
Young Boys,6453,1,22,7,3,72,35,37,73
FC Basel,6453,2,17,8,7,54,27,27,59
Lucerne,6453,3,14,9,9,41,39,2,51
St Gallen,6453,4,14,2,16,41,56,-15,44
FC Zürich,6453,5,9,12,11,37,34,3,39
FC Lugano,6453,6,10,7,15,31,45,-14,37
FC Thun,6453,7,8,9,15,43,58,-15,33
Grasshoppers,6453,8,8,7,17,39,51,-12,31
FC Sion,6453,9,7,9,16,41,54,-13,30
Young Boys,6454,1,22,7,3,69,32,37,73
FC Basel,6454,2,17,8,7,50,25,25,59
St Gallen,6454,3,15,3,14,43,52,-9,48
FC Zürich,6454,4,11,11,10,40,33,7,44
Lucerne,6454,5,12,7,13,40,46,-6,43
FC Lugano,6454,6,10,7,15,31,47,-16,37
FC Thun,6454,7,9,7,16,45,59,-14,34
Grasshoppers,6454,8,8,7,17,40,53,-13,31
FC Sion,6454,9,7,9,16,41,52,-11,30
Young Boys,6455,1,21,8,3,69,34,35,71
FC Basel,6455,2,18,8,6,51,26,25,62
St Gallen,6455,3,15,3,14,45,53,-8,48
Lucerne,6455,4,13,7,12,41,42,-1,46
FC Zürich,6455,5,10,11,11,39,36,3,41
FC Thun,6455,6,10,6,16,46,58,-12,36
FC Lugano,6455,7,9,8,15,30,47,-17,35
Grasshoppers,6455,8,8,7,17,38,51,-13,31
FC Sion,6455,9,7,8,17,41,53,-12,29
Young Boys,6456,1,20,7,5,67,37,30,67
FC Basel,6456,2,18,8,6,57,26,31,62
St Gallen,6456,3,16,3,13,46,51,-5,51
Lucerne,6456,4,13,7,12,41,46,-5,46
FC Zürich,6456,5,9,12,11,38,35,3,39
FC Lugano,6456,6,11,5,16,29,45,-16,38
Grasshoppers,6456,7,8,9,15,42,51,-9,33
FC Thun,6456,8,8,8,16,44,62,-18,32
FC Sion,6456,9,6,11,15,38,49,-11,29
Young Boys,6457,1,20,8,4,68,34,34,68
FC Basel,6457,2,19,8,5,56,25,31,65
Lucerne,6457,3,13,9,10,44,43,1,48
St Gallen,6457,4,13,2,17,41,60,-19,41
FC Zürich,6457,5,9,11,12,39,37,2,38
FC Thun,6457,6,11,5,16,44,58,-14,38
Grasshoppers,6457,7,10,7,15,41,47,-6,37
FC Lugano,6457,8,10,6,16,30,47,-17,36
FC Sion,6457,9,7,8,17,40,52,-12,29
Young Boys,6458,1,21,9,2,71,31,40,72
FC Basel,6458,2,16,8,8,51,29,22,56
St Gallen,6458,3,15,3,14,44,53,-9,48
Lucerne,6458,4,12,10,10,41,41,0,46
FC Zürich,6458,5,12,9,11,47,39,8,45
FC Lugano,6458,6,10,7,15,33,46,-13,37
Grasshoppers,6458,7,8,9,15,40,53,-13,33
FC Thun,6458,8,9,6,17,44,59,-15,33
FC Sion,6458,9,6,9,17,42,62,-20,27
Young Boys,6459,1,23,7,2,76,32,44,76
FC Basel,6459,2,17,7,8,59,33,26,58
St Gallen,6459,3,14,4,14,42,54,-12,46
FC Zürich,6459,4,12,9,11,43,36,7,45
Lucerne,6459,5,12,8,12,40,47,-7,44
FC Lugano,6459,6,11,5,16,32,48,-16,38
Grasshoppers,6459,7,9,6,17,41,54,-13,33
FC Thun,6459,8,9,5,18,46,65,-19,32
FC Sion,6459,9,7,9,16,42,52,-10,30
Young Boys,6460,1,22,8,2,72,32,40,74
FC Basel,6460,2,18,8,6,58,27,31,62
Lucerne,6460,3,12,11,9,43,43,0,47
St Gallen,6460,4,14,3,15,43,56,-13,45
FC Zürich,6460,5,10,10,12,39,38,1,40
FC Lugano,6460,6,10,6,16,30,47,-17,36
Grasshoppers,6460,7,9,7,16,42,51,-9,34
FC Thun,6460,8,8,7,17,44,63,-19,31
FC Sion,6460,9,7,8,17,43,57,-14,29
Young Boys,6461,1,21,7,4,71,36,35,70
FC Basel,6461,2,17,9,6,51,24,27,60
St Gallen,6461,3,15,3,14,43,56,-13,48
FC Zürich,6461,4,11,11,10,44,34,10,44
Lucerne,6461,5,12,8,12,43,49,-6,44
Grasshoppers,6461,6,12,6,14,49,50,-1,42
FC Lugano,6461,7,10,7,15,34,48,-14,37
FC Thun,6461,8,8,6,18,41,61,-20,30
FC Sion,6461,9,5,9,18,38,56,-18,24
Young Boys,6462,1,21,7,4,72,37,35,70
FC Basel,6462,2,17,9,6,54,28,26,60
FC Zürich,6462,3,12,9,11,45,36,9,45
Lucerne,6462,4,11,10,11,41,47,-6,43
St Gallen,6462,5,13,4,15,40,56,-16,43
FC Lugano,6462,6,11,5,16,33,47,-14,38
Grasshoppers,6462,7,9,8,15,42,51,-9,35
FC Thun,6462,8,10,5,17,45,59,-14,35
FC Sion,6462,9,8,7,17,45,56,-11,31
Young Boys,6463,1,24,6,2,73,30,43,78
FC Basel,6463,2,17,8,7,52,29,23,59
Lucerne,6463,3,12,8,12,44,48,-4,44
St Gallen,6463,4,14,2,16,44,58,-14,44
FC Zürich,6463,5,9,11,12,38,36,2,38
FC Lugano,6463,6,11,5,16,31,47,-16,38
FC Thun,6463,7,10,6,16,45,58,-13,36
Grasshoppers,6463,8,8,9,15,41,52,-11,33
FC Sion,6463,9,7,9,16,42,52,-10,30
Young Boys,6464,1,21,6,5,73,39,34,69
FC Basel,6464,2,19,8,5,56,25,31,65
FC Zürich,6464,3,12,10,10,43,36,7,46
Lucerne,6464,4,13,7,12,42,48,-6,46
St Gallen,6464,5,14,3,15,48,56,-8,45
Grasshoppers,6464,6,11,6,15,45,54,-9,39
FC Lugano,6464,7,10,5,17,32,49,-17,35
FC Thun,6464,8,9,5,18,42,59,-17,32
FC Sion,6464,9,6,8,18,42,57,-15,26
Young Boys,6465,1,21,8,3,68,31,37,71
FC Basel,6465,2,18,8,6,53,24,29,62
Lucerne,6465,3,13,9,10,45,41,4,48
St Gallen,6465,4,14,5,13,44,53,-9,47
FC Zürich,6465,5,12,10,10,42,35,7,46
FC Thun,6465,6,9,6,17,46,61,-15,33
FC Lugano,6465,7,9,6,17,27,49,-22,33
Grasshoppers,6465,8,8,8,16,37,48,-11,32
FC Sion,6465,9,6,8,18,39,59,-20,26
Young Boys,6466,1,23,7,2,77,33,44,76
FC Basel,6466,2,17,8,7,56,29,27,59
Lucerne,6466,3,14,8,10,49,51,-2,50
FC Zürich,6466,4,11,11,10,42,36,6,44
St Gallen,6466,5,13,4,15,40,56,-16,43
Grasshoppers,6466,6,9,8,15,40,48,-8,35
FC Lugano,6466,7,9,8,15,32,50,-18,35
FC Thun,6466,8,8,5,19,40,59,-19,29
FC Sion,6466,9,6,9,17,38,52,-14,27
Young Boys,6467,1,22,7,3,71,34,37,73
FC Basel,6467,2,16,10,6,50,26,24,58
Lucerne,6467,3,14,9,9,50,40,10,51
FC Zürich,6467,4,11,10,11,41,34,7,43
St Gallen,6467,5,13,3,16,41,55,-14,42
Grasshoppers,6467,6,10,6,16,43,50,-7,36
FC Thun,6467,7,10,6,16,42,56,-14,36
FC Lugano,6467,8,10,6,16,30,52,-22,36
FC Sion,6467,9,6,7,19,37,58,-21,25
Young Boys,6468,1,21,6,5,70,34,36,69
FC Basel,6468,2,16,8,8,50,28,22,56
Lucerne,6468,3,16,7,9,47,38,9,55
St Gallen,6468,4,15,3,14,44,55,-11,48
FC Thun,6468,5,11,6,15,48,59,-11,39
FC Zürich,6468,6,9,10,13,41,42,-1,37
FC Lugano,6468,7,10,6,16,30,49,-19,36
Grasshoppers,6468,8,9,7,16,42,52,-10,34
FC Sion,6468,9,6,9,17,43,58,-15,27
Young Boys,6469,1,22,7,3,73,36,37,73
FC Basel,6469,2,18,7,7,53,25,28,61
Lucerne,6469,3,13,8,11,46,47,-1,47
St Gallen,6469,4,14,4,14,43,53,-10,46
FC Zürich,6469,5,11,10,11,41,36,5,43
Grasshoppers,6469,6,10,7,15,42,49,-7,37
FC Lugano,6469,7,10,7,15,31,46,-15,37
FC Thun,6469,8,9,6,17,43,59,-16,33
FC Sion,6469,9,5,8,19,39,60,-21,23
Young Boys,6470,1,22,7,3,73,33,40,73
FC Basel,6470,2,17,9,6,55,26,29,60
St Gallen,6470,3,16,2,14,44,52,-8,50
Lucerne,6470,4,12,8,12,44,45,-1,44
FC Lugano,6470,5,11,5,16,32,50,-18,38
FC Zürich,6470,6,9,9,14,37,39,-2,36
FC Thun,6470,7,10,6,16,42,58,-16,36
Grasshoppers,6470,8,9,6,17,39,51,-12,33
FC Sion,6470,9,8,8,16,39,51,-12,32
Young Boys,6471,1,23,7,2,78,32,46,76
FC Basel,6471,2,17,8,7,53,29,24,59
St Gallen,6471,3,15,2,15,44,55,-11,47
Lucerne,6471,4,12,8,12,42,46,-4,44
FC Thun,6471,5,12,5,15,51,58,-7,41
FC Zürich,6471,6,10,9,13,41,41,0,39
FC Lugano,6471,7,11,6,15,36,54,-18,39
Grasshoppers,6471,8,9,7,16,42,51,-9,34
FC Sion,6471,9,5,8,19,37,58,-21,23
Young Boys,6472,1,21,7,4,68,35,33,70
FC Basel,6472,2,19,7,6,58,25,33,64
St Gallen,6472,3,15,2,15,45,53,-8,47
Lucerne,6472,4,13,7,12,42,46,-4,46
FC Zürich,6472,5,10,10,12,41,37,4,40
FC Lugano,6472,6,11,6,15,31,45,-14,39
Grasshoppers,6472,7,9,6,17,42,55,-13,33
FC Thun,6472,8,9,6,17,45,63,-18,33
FC Sion,6472,9,8,7,17,41,54,-13,31
Young Boys,6473,1,23,7,2,78,32,46,76
FC Basel,6473,2,19,7,6,57,26,31,64
Lucerne,6473,3,13,7,12,40,45,-5,46
FC Zürich,6473,4,11,10,11,39,34,5,43
St Gallen,6473,5,13,3,16,40,55,-15,42
Grasshoppers,6473,6,10,7,15,42,49,-7,37
FC Lugano,6473,7,10,5,17,31,51,-20,35
FC Thun,6473,8,9,5,18,44,62,-18,32
FC Sion,6473,9,6,9,17,39,56,-17,27
Young Boys,6474,1,23,7,2,79,32,47,76
FC Basel,6474,2,16,9,7,51,27,24,57
Lucerne,6474,3,15,7,10,46,46,0,52
FC Zürich,6474,4,12,9,11,42,34,8,45
St Gallen,6474,5,14,3,15,42,55,-13,45
Grasshoppers,6474,6,9,7,16,41,49,-8,34
FC Thun,6474,7,9,6,17,42,62,-20,33
FC Lugano,6474,8,9,5,18,29,52,-23,32
FC Sion,6474,9,6,9,17,39,54,-15,27
Young Boys,6475,1,20,8,4,71,40,31,68
FC Basel,6475,2,16,9,7,54,30,24,57
Lucerne,6475,3,15,7,10,43,39,4,52
FC Zürich,6475,4,13,9,10,46,37,9,48
St Gallen,6475,5,14,2,16,42,55,-13,44
FC Lugano,6475,6,11,5,16,31,47,-16,38
Grasshoppers,6475,7,10,6,16,45,53,-8,36
FC Thun,6475,8,9,6,17,46,61,-15,33
FC Sion,6475,9,6,8,18,41,57,-16,26
Young Boys,6476,1,20,7,5,70,41,29,67
FC Basel,6476,2,19,7,6,56,28,28,64
FC Zürich,6476,3,13,9,10,48,33,15,48
St Gallen,6476,4,15,2,15,45,55,-10,47
Lucerne,6476,5,11,8,13,40,48,-8,41
Grasshoppers,6476,6,11,7,14,48,49,-1,40
FC Lugano,6476,7,11,6,15,31,48,-17,39
FC Thun,6476,8,8,6,18,42,61,-19,30
FC Sion,6476,9,6,8,18,41,58,-17,26
Young Boys,6477,1,22,6,4,74,37,37,72
FC Basel,6477,2,20,7,5,58,22,36,67
Lucerne,6477,3,14,7,11,45,42,3,49
St Gallen,6477,4,14,3,15,42,56,-14,45
FC Lugano,6477,5,11,5,16,34,53,-19,38
FC Zürich,6477,6,9,9,14,42,42,0,36
Grasshoppers,6477,7,10,6,16,44,52,-8,36
FC Thun,6477,8,10,5,17,45,62,-17,35
FC Sion,6477,9,6,8,18,40,58,-18,26
Young Boys,6478,1,20,8,4,71,34,37,68
FC Basel,6478,2,18,8,6,53,25,28,62
Lucerne,6478,3,12,9,11,40,42,-2,45
St Gallen,6478,4,14,3,15,43,54,-11,45
FC Zürich,6478,5,11,10,11,41,34,7,43
Grasshoppers,6478,6,10,8,14,44,49,-5,38
FC Lugano,6478,7,11,5,16,29,50,-21,38
FC Thun,6478,8,9,7,16,40,55,-15,34
FC Sion,6478,9,6,8,18,37,55,-18,26
Young Boys,6479,1,23,7,2,70,31,39,76
FC Basel,6479,2,19,8,5,57,23,34,65
Lucerne,6479,3,13,8,11,42,44,-2,47
St Gallen,6479,4,13,2,17,41,56,-15,41
FC Zürich,6479,5,9,10,13,39,39,0,37
FC Lugano,6479,6,10,7,15,29,44,-15,37
FC Thun,6479,7,10,6,16,47,60,-13,36
Grasshoppers,6479,8,8,7,17,42,58,-16,31
FC Sion,6479,9,7,9,16,44,56,-12,30
Young Boys,6480,1,21,7,4,69,35,34,70
FC Basel,6480,2,19,8,5,51,22,29,65
St Gallen,6480,3,14,4,14,42,55,-13,46
Lucerne,6480,4,12,9,11,38,40,-2,45
FC Zürich,6480,5,10,10,12,40,37,3,40
Grasshoppers,6480,6,11,7,14,45,47,-2,40
FC Thun,6480,7,9,6,17,42,60,-18,33
FC Lugano,6480,8,9,5,18,29,49,-20,32
FC Sion,6480,9,7,8,17,41,52,-11,29
FC Basel,6481,1,20,7,5,56,23,33,67
Young Boys,6481,2,19,9,4,69,38,31,66
St Gallen,6481,3,14,4,14,42,53,-11,46
Lucerne,6481,4,11,10,11,40,45,-5,43
FC Zürich,6481,5,11,9,12,40,35,5,42
Grasshoppers,6481,6,10,8,14,45,48,-3,38
FC Lugano,6481,7,9,8,15,29,46,-17,35
FC Thun,6481,8,9,6,17,44,57,-13,33
FC Sion,6481,9,7,7,18,39,59,-20,28
Young Boys,6482,1,21,7,4,71,37,34,70
FC Basel,6482,2,17,7,8,53,29,24,58
St Gallen,6482,3,15,3,14,42,52,-10,48
Lucerne,6482,4,13,8,11,42,43,-1,47
FC Zürich,6482,5,12,10,10,47,37,10,46
FC Thun,6482,6,10,7,15,45,56,-11,37
Grasshoppers,6482,7,9,9,14,43,50,-7,36
FC Lugano,6482,8,10,6,16,31,48,-17,36
FC Sion,6482,9,5,7,20,40,62,-22,22
Young Boys,6483,1,20,8,4,70,36,34,68
FC Basel,6483,2,16,9,7,50,25,25,57
Lucerne,6483,3,14,8,10,46,42,4,50
St Gallen,6483,4,14,3,15,41,54,-13,45
FC Zürich,6483,5,11,10,11,40,33,7,43
FC Thun,6483,6,11,5,16,45,56,-11,38
FC Lugano,6483,7,10,5,17,29,53,-24,35
Grasshoppers,6483,8,9,7,16,40,52,-12,34
FC Sion,6483,9,7,9,16,41,51,-10,30
Young Boys,6484,1,22,6,4,73,36,37,72
FC Basel,6484,2,17,8,7,54,29,25,59
St Gallen,6484,3,16,3,13,50,52,-2,51
Lucerne,6484,4,14,8,10,49,45,4,50
FC Zürich,6484,5,10,10,12,41,38,3,40
Grasshoppers,6484,6,10,6,16,42,52,-10,36
FC Lugano,6484,7,10,6,16,31,49,-18,36
FC Thun,6484,8,9,7,16,42,58,-16,34
FC Sion,6484,9,5,8,19,36,59,-23,23
Young Boys,6485,1,20,8,4,69,37,32,68
FC Basel,6485,2,19,8,5,57,24,33,65
St Gallen,6485,3,15,3,14,44,54,-10,48
Lucerne,6485,4,12,8,12,40,45,-5,44
FC Zürich,6485,5,10,12,10,43,38,5,42
FC Lugano,6485,6,10,7,15,34,48,-14,37
FC Thun,6485,7,9,6,17,45,60,-15,33
Grasshoppers,6485,8,8,7,17,37,52,-15,31
FC Sion,6485,9,7,9,16,40,51,-11,30
Young Boys,6486,1,21,7,4,69,34,35,70
FC Basel,6486,2,19,7,6,53,24,29,64
St Gallen,6486,3,14,3,15,41,53,-12,45
FC Zürich,6486,4,11,11,10,41,35,6,44
Lucerne,6486,5,11,8,13,38,46,-8,41
FC Lugano,6486,6,11,5,16,31,45,-14,38
Grasshoppers,6486,7,9,8,15,45,52,-7,35
FC Thun,6486,8,9,6,17,45,64,-19,33
FC Sion,6486,9,7,9,16,44,54,-10,30
Young Boys,6487,1,22,8,2,73,34,39,74
FC Basel,6487,2,17,9,6,55,28,27,60
St Gallen,6487,3,16,2,14,44,53,-9,50
Lucerne,6487,4,13,8,11,43,45,-2,47
FC Zürich,6487,5,10,10,12,40,38,2,40
FC Thun,6487,6,10,6,16,47,61,-14,36
FC Lugano,6487,7,10,6,16,30,46,-16,36
Grasshoppers,6487,8,8,6,18,41,54,-13,30
FC Sion,6487,9,7,7,18,42,56,-14,28
Young Boys,6488,1,21,7,4,74,40,34,70
FC Basel,6488,2,18,8,6,53,26,27,62
St Gallen,6488,3,15,2,15,45,55,-10,47
FC Zürich,6488,4,12,10,10,42,35,7,46
Lucerne,6488,5,12,8,12,42,45,-3,44
Grasshoppers,6488,6,11,7,14,44,46,-2,40
FC Lugano,6488,7,11,5,16,32,45,-13,38
FC Thun,6488,8,9,6,17,41,57,-16,33
FC Sion,6488,9,5,7,20,41,65,-24,22
Young Boys,6489,1,23,7,2,76,35,41,76
FC Basel,6489,2,16,11,5,49,23,26,59
Lucerne,6489,3,13,8,11,43,44,-1,47
St Gallen,6489,4,14,2,16,41,58,-17,44
FC Zürich,6489,5,10,12,10,39,34,5,42
FC Lugano,6489,6,10,6,16,34,48,-14,36
Grasshoppers,6489,7,9,7,16,39,49,-10,34
FC Thun,6489,8,8,9,15,40,55,-15,33
FC Sion,6489,9,6,8,18,39,54,-15,26
FC Basel,6490,1,20,7,5,56,24,32,67
Young Boys,6490,2,20,6,6,67,39,28,66
FC Zürich,6490,3,12,9,11,41,35,6,45
St Gallen,6490,4,14,3,15,47,56,-9,45
Lucerne,6490,5,11,8,13,39,48,-9,41
FC Lugano,6490,6,12,5,15,33,46,-13,41
Grasshoppers,6490,7,10,7,15,44,48,-4,37
FC Thun,6490,8,10,5,17,46,59,-13,35
FC Sion,6490,9,6,8,18,38,56,-18,26
Young Boys,6491,1,20,6,6,72,43,29,66
FC Basel,6491,2,17,7,8,52,29,23,58
St Gallen,6491,3,15,2,15,45,55,-10,47
Lucerne,6491,4,12,8,12,43,48,-5,44
FC Zürich,6491,5,11,10,11,41,36,5,43
FC Lugano,6491,6,12,6,14,33,44,-11,42
Grasshoppers,6491,7,10,6,16,42,49,-7,36
FC Thun,6491,8,10,5,17,44,57,-13,35
FC Sion,6491,9,8,8,16,42,53,-11,32
Young Boys,6492,1,22,6,4,71,35,36,72
FC Basel,6492,2,19,8,5,53,23,30,65
Lucerne,6492,3,14,7,11,45,42,3,49
St Gallen,6492,4,14,4,14,42,53,-11,46
FC Lugano,6492,5,11,6,15,32,47,-15,39
FC Zürich,6492,6,9,11,12,40,38,2,38
FC Thun,6492,7,8,8,16,43,60,-17,32
Grasshoppers,6492,8,8,7,17,39,53,-14,31
FC Sion,6492,9,6,9,17,42,56,-14,27
Young Boys,6493,1,22,6,4,72,38,34,72
FC Basel,6493,2,18,9,5,58,25,33,63
Lucerne,6493,3,14,8,10,41,40,1,50
St Gallen,6493,4,14,2,16,43,58,-15,44
FC Zürich,6493,5,11,10,11,44,39,5,43
FC Lugano,6493,6,11,6,15,35,48,-13,39
Grasshoppers,6493,7,9,6,17,43,54,-11,33
FC Thun,6493,8,9,6,17,44,63,-19,33
FC Sion,6493,9,6,7,19,43,58,-15,25
Young Boys,6494,1,19,11,2,68,34,34,68
FC Basel,6494,2,16,10,6,54,27,27,58
Lucerne,6494,3,13,9,10,41,40,1,48
St Gallen,6494,4,14,5,13,44,53,-9,47
FC Zürich,6494,5,10,10,12,39,36,3,40
FC Lugano,6494,6,11,7,14,32,45,-13,40
FC Thun,6494,7,10,6,16,43,58,-15,36
Grasshoppers,6494,8,9,8,15,39,47,-8,35
FC Sion,6494,9,5,8,19,38,58,-20,23
Young Boys,6495,1,22,6,4,73,38,35,72
FC Basel,6495,2,16,9,7,58,33,25,57
Lucerne,6495,3,14,7,11,45,46,-1,49
St Gallen,6495,4,14,4,14,44,55,-11,46
FC Zürich,6495,5,11,10,11,44,37,7,43
Grasshoppers,6495,6,11,7,14,48,51,-3,40
FC Lugano,6495,7,11,5,16,32,47,-15,38
FC Thun,6495,8,8,6,18,44,65,-21,30
FC Sion,6495,9,6,8,18,41,57,-16,26
Young Boys,6496,1,20,8,4,70,36,34,68
FC Basel,6496,2,17,10,5,57,29,28,61
Lucerne,6496,3,13,9,10,43,43,0,48
St Gallen,6496,4,14,4,14,41,52,-11,46
FC Zürich,6496,5,11,11,10,42,33,9,44
FC Lugano,6496,6,10,6,16,29,47,-18,36
FC Thun,6496,7,10,5,17,44,60,-16,35
Grasshoppers,6496,8,9,6,17,41,52,-11,33
FC Sion,6496,9,6,9,17,38,53,-15,27
Young Boys,6497,1,21,6,5,70,35,35,69
FC Basel,6497,2,17,8,7,51,24,27,59
St Gallen,6497,3,15,3,14,44,54,-10,48
Lucerne,6497,4,12,10,10,39,41,-2,46
FC Zürich,6497,5,10,9,13,38,36,2,39
FC Lugano,6497,6,11,6,15,30,46,-16,39
Grasshoppers,6497,7,10,6,16,42,51,-9,36
FC Thun,6497,8,10,5,17,45,61,-16,35
FC Sion,6497,9,8,7,17,43,54,-11,31
Young Boys,6498,1,23,6,3,75,36,39,75
FC Basel,6498,2,17,9,6,55,28,27,60
Lucerne,6498,3,13,8,11,47,46,1,47
St Gallen,6498,4,14,3,15,43,55,-12,45
FC Zürich,6498,5,10,11,11,47,40,7,41
FC Thun,6498,6,12,5,15,52,59,-7,41
Grasshoppers,6498,7,9,7,16,41,51,-10,34
FC Lugano,6498,8,9,6,17,31,53,-22,33
FC Sion,6498,9,6,7,19,41,64,-23,25
Young Boys,6499,1,21,7,4,72,36,36,70
FC Basel,6499,2,19,8,5,61,28,33,65
Lucerne,6499,3,13,7,12,45,46,-1,46
St Gallen,6499,4,14,3,15,43,56,-13,45
FC Zürich,6499,5,11,10,11,41,36,5,43
FC Thun,6499,6,10,5,17,45,58,-13,35
FC Lugano,6499,7,10,5,17,30,49,-19,35
Grasshoppers,6499,8,9,7,16,41,56,-15,34
FC Sion,6499,9,7,8,17,40,53,-13,29
Young Boys,6500,1,23,6,3,71,34,37,75
FC Basel,6500,2,18,7,7,56,26,30,61
FC Zürich,6500,3,13,9,10,43,34,9,48
St Gallen,6500,4,15,3,14,46,54,-8,48
Lucerne,6500,5,13,7,12,40,44,-4,46
FC Thun,6500,6,10,5,17,47,64,-17,35
FC Lugano,6500,7,9,6,17,31,52,-21,33
Grasshoppers,6500,8,8,6,18,38,51,-13,30
FC Sion,6500,9,7,7,18,45,58,-13,28
Young Boys,6501,1,21,7,4,66,33,33,70
FC Basel,6501,2,17,9,6,52,25,27,60
Lucerne,6501,3,14,8,10,42,39,3,50
St Gallen,6501,4,14,4,14,43,53,-10,46
FC Zürich,6501,5,10,10,12,40,38,2,40
Grasshoppers,6501,6,10,7,15,40,47,-7,37
FC Thun,6501,7,10,7,15,44,54,-10,37
FC Lugano,6501,8,9,6,17,28,49,-21,33
FC Sion,6501,9,6,8,18,37,54,-17,26
Young Boys,6502,1,22,6,4,73,32,41,72
FC Basel,6502,2,19,7,6,52,24,28,64
St Gallen,6502,3,15,2,15,43,55,-12,47
Lucerne,6502,4,12,7,13,40,44,-4,43
FC Zürich,6502,5,11,9,12,40,36,4,42
FC Lugano,6502,6,11,5,16,31,51,-20,38
Grasshoppers,6502,7,10,7,15,39,46,-7,37
FC Thun,6502,8,9,6,17,43,59,-16,33
FC Sion,6502,9,7,7,18,41,55,-14,28
Young Boys,6503,1,21,7,4,70,36,34,70
FC Basel,6503,2,17,9,6,55,26,29,60
St Gallen,6503,3,16,2,14,47,52,-5,50
Lucerne,6503,4,14,7,11,40,44,-4,49
FC Zürich,6503,5,10,11,11,42,38,4,41
Grasshoppers,6503,6,10,6,16,41,49,-8,36
FC Lugano,6503,7,10,5,17,30,49,-19,35
FC Thun,6503,8,9,6,17,43,61,-18,33
FC Sion,6503,9,7,7,18,39,52,-13,28
Young Boys,6504,1,22,6,4,77,40,37,72
FC Basel,6504,2,19,8,5,62,23,39,65
Lucerne,6504,3,12,8,12,42,51,-9,44
St Gallen,6504,4,13,4,15,40,57,-17,43
FC Lugano,6504,5,12,6,14,36,45,-9,42
FC Zürich,6504,6,10,10,12,40,37,3,40
Grasshoppers,6504,7,9,7,16,41,51,-10,34
FC Thun,6504,8,9,6,17,43,61,-18,33
FC Sion,6504,9,6,9,17,41,57,-16,27
Young Boys,6505,1,22,7,3,74,35,39,73
FC Basel,6505,2,18,7,7,54,28,26,61
FC Zürich,6505,3,11,11,10,41,35,6,44
St Gallen,6505,4,14,2,16,43,55,-12,44
Lucerne,6505,5,12,7,13,40,45,-5,43
FC Lugano,6505,6,11,7,14,33,44,-11,40
FC Thun,6505,7,10,5,17,45,61,-16,35
Grasshoppers,6505,8,9,6,17,42,54,-12,33
FC Sion,6505,9,7,8,17,38,53,-15,29
Young Boys,6506,1,21,8,3,71,36,35,71
FC Basel,6506,2,17,9,6,53,27,26,60
St Gallen,6506,3,15,2,15,41,52,-11,47
FC Zürich,6506,4,11,11,10,44,38,6,44
Lucerne,6506,5,12,7,13,41,45,-4,43
FC Lugano,6506,6,11,6,15,32,45,-13,39
Grasshoppers,6506,7,9,7,16,41,51,-10,34
FC Thun,6506,8,9,7,16,44,58,-14,34
FC Sion,6506,9,7,7,18,38,53,-15,28
Young Boys,6507,1,21,7,4,73,37,36,70
FC Basel,6507,2,18,9,5,55,24,31,63
St Gallen,6507,3,14,4,14,45,54,-9,46
FC Zürich,6507,4,10,11,11,41,37,4,41
Lucerne,6507,5,11,7,14,40,52,-12,40
FC Lugano,6507,6,11,6,15,32,46,-14,39
Grasshoppers,6507,7,9,8,15,41,49,-8,35
FC Thun,6507,8,9,8,15,43,57,-14,35
FC Sion,6507,9,6,10,16,39,53,-14,28
Young Boys,6508,1,23,6,3,72,31,41,75
FC Basel,6508,2,18,8,6,57,25,32,62
St Gallen,6508,3,15,2,15,42,58,-16,47
Lucerne,6508,4,12,8,12,41,48,-7,44
FC Zürich,6508,5,10,10,12,41,38,3,40
FC Thun,6508,6,10,6,16,42,56,-14,36
FC Sion,6508,7,8,9,15,44,52,-8,33
Grasshoppers,6508,8,8,8,16,41,51,-10,32
FC Lugano,6508,9,9,5,18,29,50,-21,32
Young Boys,6509,1,22,6,4,72,34,38,72
FC Basel,6509,2,19,8,5,58,24,34,65
Lucerne,6509,3,13,8,11,41,46,-5,47
St Gallen,6509,4,13,4,15,41,54,-13,43
FC Zürich,6509,5,9,12,11,41,38,3,39
Grasshoppers,6509,6,10,7,15,46,50,-4,37
FC Lugano,6509,7,9,7,16,30,49,-19,34
FC Thun,6509,8,9,6,17,43,59,-16,33
FC Sion,6509,9,7,8,17,38,56,-18,29
Young Boys,6510,1,22,6,4,71,37,34,72
FC Basel,6510,2,17,9,6,54,26,28,60
St Gallen,6510,3,15,2,15,43,55,-12,47
FC Zürich,6510,4,11,11,10,40,34,6,44
Lucerne,6510,5,12,8,12,41,44,-3,44
FC Lugano,6510,6,12,6,14,33,44,-11,42
Grasshoppers,6510,7,11,6,15,45,49,-4,39
FC Thun,6510,8,8,6,18,41,61,-20,30
FC Sion,6510,9,5,8,19,37,55,-18,23
Young Boys,6511,1,22,7,3,77,34,43,73
FC Basel,6511,2,16,11,5,52,25,27,59
St Gallen,6511,3,15,3,14,47,55,-8,48
Lucerne,6511,4,13,8,11,42,44,-2,47
FC Zürich,6511,5,9,12,11,40,38,2,39
FC Lugano,6511,6,10,6,16,30,50,-20,36
FC Thun,6511,7,9,8,15,45,58,-13,35
FC Sion,6511,8,7,9,16,41,55,-14,30
Grasshoppers,6511,9,8,6,18,38,53,-15,30
Young Boys,6512,1,22,7,3,71,33,38,73
FC Basel,6512,2,18,7,7,55,26,29,61
St Gallen,6512,3,16,2,14,44,54,-10,50
Lucerne,6512,4,13,7,12,41,42,-1,46
FC Zürich,6512,5,10,10,12,40,39,1,40
FC Lugano,6512,6,11,5,16,34,51,-17,38
FC Thun,6512,7,10,6,16,45,58,-13,36
Grasshoppers,6512,8,9,7,16,41,51,-10,34
FC Sion,6512,9,5,9,18,39,56,-17,24
Young Boys,6513,1,21,6,5,68,36,32,69
FC Basel,6513,2,17,8,7,54,28,26,59
Lucerne,6513,3,15,8,9,44,39,5,53
St Gallen,6513,4,14,4,14,41,52,-11,46
FC Zürich,6513,5,10,9,13,39,41,-2,39
Grasshoppers,6513,6,10,7,15,45,52,-7,37
FC Lugano,6513,7,10,6,16,31,47,-16,36
FC Thun,6513,8,9,6,17,48,62,-14,33
FC Sion,6513,9,7,8,17,41,54,-13,29
Young Boys,6514,1,20,7,5,73,41,32,67
FC Basel,6514,2,18,8,6,54,26,28,62
Lucerne,6514,3,13,9,10,42,41,1,48
St Gallen,6514,4,14,2,16,42,56,-14,44
FC Lugano,6514,5,12,6,14,34,44,-10,42
FC Zürich,6514,6,9,10,13,39,40,-1,37
Grasshoppers,6514,7,10,7,15,43,50,-7,37
FC Thun,6514,8,8,9,15,43,58,-15,33
FC Sion,6514,9,7,8,17,41,55,-14,29
Young Boys,6515,1,22,7,3,71,32,39,73
FC Basel,6515,2,18,8,6,53,24,29,62
St Gallen,6515,3,14,3,15,40,53,-13,45
Lucerne,6515,4,11,9,12,39,46,-7,42
FC Zürich,6515,5,9,12,11,38,38,0,39
FC Lugano,6515,6,10,7,15,33,47,-14,37
FC Thun,6515,7,9,7,16,47,62,-15,34
FC Sion,6515,8,8,9,15,44,52,-8,33
Grasshoppers,6515,9,9,6,17,39,50,-11,33
Young Boys,6516,1,21,7,4,72,38,34,70
FC Basel,6516,2,17,10,5,55,26,29,61
Lucerne,6516,3,13,8,11,44,47,-3,47
FC Zürich,6516,4,12,10,10,42,33,9,46
St Gallen,6516,5,13,4,15,42,57,-15,43
FC Thun,6516,6,10,6,16,43,56,-13,36
FC Lugano,6516,7,10,6,16,32,47,-15,36
Grasshoppers,6516,8,9,7,16,41,51,-10,34
FC Sion,6516,9,6,8,18,41,57,-16,26
Young Boys,6517,1,22,7,3,71,35,36,73
FC Basel,6517,2,18,8,6,52,23,29,62
St Gallen,6517,3,15,3,14,42,54,-12,48
Lucerne,6517,4,11,9,12,40,46,-6,42
FC Zürich,6517,5,10,10,12,40,39,1,40
FC Lugano,6517,6,11,6,15,34,47,-13,39
Grasshoppers,6517,7,8,9,15,38,47,-9,33
FC Thun,6517,8,8,7,17,42,60,-18,31
FC Sion,6517,9,7,9,16,44,52,-8,30
Young Boys,6518,1,22,6,4,70,38,32,72
FC Basel,6518,2,17,9,6,53,25,28,60
Lucerne,6518,3,13,10,9,45,40,5,49
St Gallen,6518,4,13,5,14,41,57,-16,44
FC Zürich,6518,5,9,10,13,36,35,1,37
FC Lugano,6518,6,10,7,15,35,46,-11,37
FC Thun,6518,7,10,5,17,44,60,-16,35
Grasshoppers,6518,8,9,6,17,37,50,-13,33
FC Sion,6518,9,8,8,16,41,51,-10,32
Young Boys,6519,1,21,7,4,68,36,32,70
FC Basel,6519,2,18,9,5,55,23,32,63
Lucerne,6519,3,13,8,11,46,46,0,47
St Gallen,6519,4,14,3,15,45,56,-11,45
FC Zürich,6519,5,9,11,12,37,36,1,38
FC Thun,6519,6,10,6,16,45,59,-14,36
FC Lugano,6519,7,10,6,16,31,48,-17,36
Grasshoppers,6519,8,9,7,16,39,48,-9,34
FC Sion,6519,9,8,7,17,40,54,-14,31
Young Boys,6520,1,21,8,3,73,37,36,71
FC Basel,6520,2,17,8,7,51,26,25,59
St Gallen,6520,3,16,3,13,44,51,-7,51
Lucerne,6520,4,13,7,12,42,45,-3,46
FC Zürich,6520,5,12,9,11,43,36,7,45
Grasshoppers,6520,6,9,8,15,41,50,-9,35
FC Thun,6520,7,9,6,17,46,59,-13,33
FC Lugano,6520,8,9,5,18,29,49,-20,32
FC Sion,6520,9,7,8,17,40,56,-16,29
Young Boys,6521,1,20,7,5,67,37,30,67
FC Basel,6521,2,19,8,5,59,26,33,65
Lucerne,6521,3,14,8,10,45,40,5,50
St Gallen,6521,4,14,4,14,42,54,-12,46
FC Lugano,6521,5,12,5,15,34,47,-13,41
FC Zürich,6521,6,10,10,12,42,42,0,40
Grasshoppers,6521,7,9,7,16,39,49,-10,34
FC Thun,6521,8,9,5,18,43,63,-20,32
FC Sion,6521,9,6,8,18,40,53,-13,26
Young Boys,6522,1,21,7,4,74,38,36,70
FC Basel,6522,2,15,9,8,49,30,19,54
St Gallen,6522,3,15,2,15,44,55,-11,47
FC Zürich,6522,4,11,11,10,43,35,8,44
Lucerne,6522,5,12,8,12,40,46,-6,44
FC Thun,6522,6,11,6,15,48,56,-8,39
Grasshoppers,6522,7,10,7,15,44,51,-7,37
FC Lugano,6522,8,10,5,17,31,47,-16,35
FC Sion,6522,9,7,9,16,42,57,-15,30
Young Boys,6523,1,20,8,4,66,33,33,68
FC Basel,6523,2,17,7,8,51,27,24,58
St Gallen,6523,3,16,2,14,46,56,-10,50
Lucerne,6523,4,12,8,12,43,48,-5,44
FC Zürich,6523,5,11,10,11,44,37,7,43
FC Thun,6523,6,11,5,16,47,59,-12,38
FC Lugano,6523,7,11,5,16,30,47,-17,38
Grasshoppers,6523,8,9,7,16,43,53,-10,34
FC Sion,6523,9,7,8,17,43,53,-10,29
Young Boys,6524,1,22,8,2,76,36,40,74
FC Basel,6524,2,17,9,6,54,26,28,60
St Gallen,6524,3,15,2,15,43,57,-14,47
Lucerne,6524,4,12,8,12,41,46,-5,44
FC Zürich,6524,5,10,10,12,41,42,-1,40
FC Lugano,6524,6,11,6,15,35,46,-11,39
FC Thun,6524,7,10,6,16,47,60,-13,36
Grasshoppers,6524,8,8,7,17,40,53,-13,31
FC Sion,6524,9,7,8,17,41,52,-11,29
Young Boys,6525,1,22,6,4,72,34,38,72
FC Basel,6525,2,19,8,5,54,24,30,65
St Gallen,6525,3,14,3,15,42,54,-12,45
FC Zürich,6525,4,11,10,11,41,37,4,43
Lucerne,6525,5,12,7,13,43,48,-5,43
FC Lugano,6525,6,10,6,16,33,49,-16,36
Grasshoppers,6525,7,9,7,16,42,53,-11,34
FC Sion,6525,8,8,8,16,43,51,-8,32
FC Thun,6525,9,8,7,17,41,61,-20,31
Young Boys,6526,1,21,8,3,73,35,38,71
FC Basel,6526,2,17,10,5,53,23,30,61
St Gallen,6526,3,14,5,13,41,51,-10,47
Lucerne,6526,4,12,8,12,39,47,-8,44
FC Zürich,6526,5,10,9,13,39,39,0,39
FC Thun,6526,6,10,7,15,43,54,-11,37
FC Lugano,6526,7,10,6,16,29,45,-16,36
Grasshoppers,6526,8,9,8,15,42,50,-8,35
FC Sion,6526,9,6,9,17,39,54,-15,27
Young Boys,6527,1,22,6,4,70,33,37,72
FC Basel,6527,2,17,7,8,51,26,25,58
Lucerne,6527,3,14,8,10,46,41,5,50
St Gallen,6527,4,14,4,14,42,54,-12,46
FC Zürich,6527,5,11,11,10,41,35,6,44
FC Thun,6527,6,11,5,16,48,56,-8,38
Grasshoppers,6527,7,9,6,17,41,57,-16,33
FC Lugano,6527,8,9,6,17,29,50,-21,33
FC Sion,6527,9,6,9,17,38,54,-16,27
Young Boys,6528,1,22,8,2,74,36,38,74
FC Basel,6528,2,16,7,9,49,28,21,55
St Gallen,6528,3,15,3,14,45,56,-11,48
Lucerne,6528,4,13,8,11,43,42,1,47
FC Zürich,6528,5,12,10,10,44,35,9,46
Grasshoppers,6528,6,10,7,15,43,50,-7,37
FC Lugano,6528,7,9,8,15,30,47,-17,35
FC Thun,6528,8,9,5,18,43,61,-18,32
FC Sion,6528,9,6,8,18,42,58,-16,26
Young Boys,6529,1,22,7,3,73,34,39,73
FC Basel,6529,2,19,7,6,58,24,34,64
St Gallen,6529,3,15,2,15,42,56,-14,47
Lucerne,6529,4,12,8,12,38,44,-6,44
FC Zürich,6529,5,10,10,12,43,40,3,40
FC Thun,6529,6,11,5,16,47,57,-10,38
Grasshoppers,6529,7,10,6,16,41,53,-12,36
FC Lugano,6529,8,9,6,17,30,50,-20,33
FC Sion,6529,9,6,9,17,42,56,-14,27
Young Boys,6530,1,22,7,3,70,32,38,73
FC Basel,6530,2,16,9,7,53,30,23,57
St Gallen,6530,3,16,2,14,45,51,-6,50
Lucerne,6530,4,12,8,12,38,46,-8,44
FC Zürich,6530,5,11,10,11,42,38,4,43
Grasshoppers,6530,6,10,8,14,42,45,-3,38
FC Lugano,6530,7,11,5,16,31,44,-13,38
FC Thun,6530,8,10,6,16,46,58,-12,36
FC Sion,6530,9,5,7,20,36,59,-23,22
Young Boys,6531,1,21,7,4,73,37,36,70
FC Basel,6531,2,18,7,7,55,27,28,61
Lucerne,6531,3,13,7,12,41,45,-4,46
St Gallen,6531,4,14,3,15,43,56,-13,45
FC Zürich,6531,5,11,10,11,41,34,7,43
FC Thun,6531,6,11,6,15,43,53,-10,39
FC Lugano,6531,7,11,6,15,31,45,-14,39
Grasshoppers,6531,8,9,6,17,40,53,-13,33
FC Sion,6531,9,5,10,17,39,56,-17,25
Young Boys,6532,1,21,7,4,68,34,34,70
FC Basel,6532,2,17,8,7,52,28,24,59
Lucerne,6532,3,13,10,9,45,41,4,49
FC Zürich,6532,4,12,9,11,41,35,6,45
St Gallen,6532,5,14,3,15,42,59,-17,45
Grasshoppers,6532,6,10,6,16,41,51,-10,36
FC Thun,6532,7,10,6,16,43,56,-13,36
FC Lugano,6532,8,10,5,17,30,47,-17,35
FC Sion,6532,9,6,8,18,42,53,-11,26
Young Boys,6533,1,23,6,3,75,37,38,75
FC Basel,6533,2,18,9,5,57,24,33,63
Lucerne,6533,3,13,7,12,41,44,-3,46
St Gallen,6533,4,13,4,15,43,58,-15,43
FC Lugano,6533,5,11,6,15,33,47,-14,39
FC Zürich,6533,6,9,11,12,39,42,-3,38
FC Thun,6533,7,9,6,17,45,57,-12,33
FC Sion,6533,8,8,8,16,44,56,-12,32
Grasshoppers,6533,9,8,7,17,37,49,-12,31
Young Boys,6534,1,21,8,3,69,35,34,71
FC Basel,6534,2,18,7,7,56,26,30,61
FC Zürich,6534,3,12,10,10,42,34,8,46
Lucerne,6534,4,12,9,11,43,44,-1,45
St Gallen,6534,5,14,3,15,46,57,-11,45
FC Lugano,6534,6,10,6,16,32,49,-17,36
FC Thun,6534,7,9,7,16,43,62,-19,34
Grasshoppers,6534,8,8,8,16,39,52,-13,32
FC Sion,6534,9,7,8,17,42,53,-11,29
Young Boys,6535,1,22,7,3,74,36,38,73
FC Basel,6535,2,17,8,7,53,25,28,59
St Gallen,6535,3,16,3,13,47,52,-5,51
Lucerne,6535,4,13,8,11,43,45,-2,47
FC Zürich,6535,5,11,9,12,43,38,5,42
FC Lugano,6535,6,10,5,17,32,50,-18,35
FC Thun,6535,7,10,5,17,45,64,-19,35
Grasshoppers,6535,8,9,7,16,44,54,-10,34
FC Sion,6535,9,6,8,18,41,58,-17,26
Young Boys,6536,1,20,8,4,71,38,33,68
FC Basel,6536,2,19,8,5,59,24,35,65
Lucerne,6536,3,14,7,11,46,47,-1,49
FC Zürich,6536,4,12,10,10,47,37,10,46
St Gallen,6536,5,14,3,15,43,55,-12,45
FC Lugano,6536,6,10,7,15,33,50,-17,37
FC Thun,6536,7,10,5,17,47,64,-17,35
Grasshoppers,6536,8,9,6,17,39,52,-13,33
FC Sion,6536,9,5,8,19,41,59,-18,23
Young Boys,6537,1,21,7,4,67,34,33,70
FC Basel,6537,2,18,9,5,53,22,31,63
Lucerne,6537,3,12,10,10,41,39,2,46
St Gallen,6537,4,13,5,14,39,51,-12,44
FC Zürich,6537,5,9,12,11,38,36,2,39
FC Lugano,6537,6,11,5,16,32,49,-17,38
FC Sion,6537,7,8,9,15,41,49,-8,33
Grasshoppers,6537,8,8,8,16,39,49,-10,32
FC Thun,6537,9,8,7,17,42,63,-21,31
Young Boys,6538,1,22,7,3,72,31,41,73
FC Basel,6538,2,17,8,7,53,29,24,59
St Gallen,6538,3,15,3,14,43,53,-10,48
Lucerne,6538,4,12,8,12,42,47,-5,44
FC Zürich,6538,5,9,10,13,42,42,0,37
FC Thun,6538,6,10,7,15,48,60,-12,37
FC Lugano,6538,7,10,5,17,34,54,-20,35
FC Sion,6538,8,9,7,16,42,51,-9,34
Grasshoppers,6538,8,9,7,16,42,51,-9,34
Young Boys,6539,1,21,7,4,70,32,38,70
FC Basel,6539,2,18,8,6,56,26,30,62
Lucerne,6539,3,13,8,11,41,44,-3,47
FC Zürich,6539,4,11,11,10,42,35,7,44
St Gallen,6539,5,13,4,15,41,57,-16,43
Grasshoppers,6539,6,11,6,15,44,51,-7,39
FC Lugano,6539,7,11,6,15,31,43,-12,39
FC Thun,6539,8,8,6,18,45,65,-20,30
FC Sion,6539,9,6,8,18,38,55,-17,26
Young Boys,6540,1,22,7,3,75,38,37,73
FC Basel,6540,2,17,9,6,56,27,29,60
St Gallen,6540,3,16,2,14,47,56,-9,50
FC Zürich,6540,4,12,9,11,41,37,4,45
Lucerne,6540,5,12,8,12,42,45,-3,44
FC Lugano,6540,6,11,5,16,35,50,-15,38
Grasshoppers,6540,7,9,6,17,40,52,-12,33
FC Thun,6540,8,9,6,17,43,58,-15,33
FC Sion,6540,9,6,8,18,42,58,-16,26
Young Boys,6541,1,21,9,2,76,38,38,72
FC Basel,6541,2,18,8,6,54,27,27,62
Lucerne,6541,3,13,8,11,43,46,-3,47
St Gallen,6541,4,13,3,16,44,59,-15,42
FC Zürich,6541,5,9,10,13,38,41,-3,37
Grasshoppers,6541,6,10,7,15,49,54,-5,37
FC Lugano,6541,7,10,7,15,33,47,-14,37
FC Thun,6541,8,10,5,17,46,58,-12,35
FC Sion,6541,9,8,7,17,41,54,-13,31
Young Boys,6542,1,20,7,5,71,39,32,67
FC Basel,6542,2,19,8,5,57,27,30,65
Lucerne,6542,3,14,7,11,46,46,0,49
St Gallen,6542,4,14,4,14,47,58,-11,46
FC Zürich,6542,5,11,10,11,43,36,7,43
FC Thun,6542,6,10,6,16,45,57,-12,36
FC Lugano,6542,7,10,6,16,32,49,-17,36
Grasshoppers,6542,8,8,7,17,40,53,-13,31
FC Sion,6542,9,7,7,18,40,56,-16,28
Young Boys,6543,1,20,9,3,65,32,33,69
FC Basel,6543,2,18,8,6,55,27,28,62
St Gallen,6543,3,16,2,14,46,56,-10,50
Lucerne,6543,4,11,9,12,40,47,-7,42
FC Zürich,6543,5,10,11,11,40,36,4,41
FC Lugano,6543,6,11,5,16,34,45,-11,38
Grasshoppers,6543,7,9,8,15,41,49,-8,35
FC Thun,6543,8,9,6,17,42,57,-15,33
FC Sion,6543,9,7,8,17,38,52,-14,29
Young Boys,6544,1,21,8,3,72,36,36,71
FC Basel,6544,2,19,8,5,56,25,31,65
Lucerne,6544,3,13,8,11,44,42,2,47
St Gallen,6544,4,13,3,16,42,58,-16,42
FC Zürich,6544,5,9,12,11,37,34,3,39
FC Lugano,6544,6,11,5,16,31,50,-19,38
FC Thun,6544,7,10,6,16,43,56,-13,36
Grasshoppers,6544,8,9,7,16,40,49,-9,34
FC Sion,6544,9,6,9,17,39,54,-15,27
Young Boys,6545,1,21,6,5,68,36,32,69
FC Basel,6545,2,19,8,5,55,22,33,65
St Gallen,6545,3,15,3,14,40,50,-10,48
Lucerne,6545,4,13,8,11,41,41,0,47
FC Zürich,6545,5,11,10,11,41,36,5,43
FC Lugano,6545,6,11,6,15,29,43,-14,39
Grasshoppers,6545,7,9,7,16,45,52,-7,34
FC Thun,6545,8,8,5,19,40,65,-25,29
FC Sion,6545,9,6,9,17,41,55,-14,27
Young Boys,6546,1,21,7,4,70,35,35,70
FC Basel,6546,2,19,8,5,59,24,35,65
Lucerne,6546,3,14,8,10,42,40,2,50
St Gallen,6546,4,14,3,15,42,56,-14,45
FC Zürich,6546,5,10,11,11,42,39,3,41
Grasshoppers,6546,6,10,7,15,44,49,-5,37
FC Lugano,6546,7,10,6,16,31,48,-17,36
FC Thun,6546,8,8,7,17,42,61,-19,31
FC Sion,6546,9,6,7,19,41,61,-20,25
Young Boys,6547,1,20,8,4,67,36,31,68
FC Basel,6547,2,17,9,6,54,25,29,60
Lucerne,6547,3,12,9,11,44,46,-2,45
St Gallen,6547,4,14,3,15,42,55,-13,45
FC Zürich,6547,5,11,9,12,41,38,3,42
FC Lugano,6547,6,11,7,14,34,46,-12,40
FC Thun,6547,7,10,7,15,48,60,-12,37
Grasshoppers,6547,8,9,8,15,42,50,-8,35
FC Sion,6547,9,6,8,18,39,55,-16,26
Young Boys,6548,1,21,7,4,78,40,38,70
FC Basel,6548,2,20,7,5,61,24,37,67
St Gallen,6548,3,15,2,15,45,56,-11,47
Lucerne,6548,4,12,7,13,42,51,-9,43
FC Lugano,6548,5,11,7,14,35,47,-12,40
FC Zürich,6548,6,9,11,12,38,37,1,38
FC Thun,6548,7,10,5,17,45,64,-19,35
Grasshoppers,6548,8,9,6,17,41,53,-12,33
FC Sion,6548,9,7,8,17,47,60,-13,29
Young Boys,6549,1,23,7,2,77,33,44,76
FC Basel,6549,2,17,9,6,54,26,28,60
St Gallen,6549,3,15,3,14,44,54,-10,48
Lucerne,6549,4,12,9,11,43,47,-4,45
FC Zürich,6549,5,10,10,12,43,39,4,40
FC Lugano,6549,6,11,6,15,34,50,-16,39
FC Thun,6549,7,10,5,17,44,60,-16,35
Grasshoppers,6549,8,8,8,16,41,52,-11,32
FC Sion,6549,9,5,9,18,39,58,-19,24
Young Boys,6550,1,21,7,4,69,32,37,70
FC Basel,6550,2,18,8,6,55,27,28,62
St Gallen,6550,3,15,3,14,44,51,-7,48
Lucerne,6550,4,12,11,9,42,40,2,47
FC Zürich,6550,5,9,10,13,40,41,-1,37
FC Thun,6550,6,10,6,16,48,61,-13,36
FC Lugano,6550,7,10,6,16,29,49,-20,36
Grasshoppers,6550,8,8,8,16,42,54,-12,32
FC Sion,6550,9,8,7,17,42,56,-14,31
Young Boys,6551,1,22,6,4,76,33,43,72
FC Basel,6551,2,19,8,5,54,25,29,65
Lucerne,6551,3,14,7,11,51,44,7,49
St Gallen,6551,4,13,3,16,41,58,-17,42
FC Zürich,6551,5,10,10,12,40,37,3,40
FC Lugano,6551,6,11,5,16,35,58,-23,38
Grasshoppers,6551,7,10,6,16,41,49,-8,36
FC Thun,6551,8,9,5,18,41,59,-18,32
FC Sion,6551,9,7,8,17,38,54,-16,29
Young Boys,6552,1,21,8,3,73,35,38,71
FC Basel,6552,2,16,10,6,56,27,29,58
Lucerne,6552,3,14,7,11,46,51,-5,49
FC Zürich,6552,4,13,9,10,45,34,11,48
St Gallen,6552,5,13,4,15,42,55,-13,43
FC Thun,6552,6,10,6,16,48,57,-9,36
Grasshoppers,6552,7,10,6,16,45,54,-9,36
FC Lugano,6552,8,10,6,16,32,49,-17,36
FC Sion,6552,9,5,8,19,37,62,-25,23
Young Boys,6553,1,22,7,3,77,36,41,73
FC Basel,6553,2,18,9,5,53,24,29,63
St Gallen,6553,3,15,2,15,43,55,-12,47
Lucerne,6553,4,12,9,11,42,43,-1,45
FC Zürich,6553,5,10,11,11,40,35,5,41
Grasshoppers,6553,6,10,7,15,43,49,-6,37
FC Thun,6553,7,9,7,16,42,56,-14,34
FC Lugano,6553,8,9,7,16,29,51,-22,34
FC Sion,6553,9,6,7,19,39,59,-20,25
Young Boys,6554,1,21,6,5,66,37,29,69
FC Basel,6554,2,18,7,7,55,25,30,61
St Gallen,6554,3,15,3,14,43,53,-10,48
FC Zürich,6554,4,12,9,11,41,36,5,45
Lucerne,6554,5,11,8,13,40,46,-6,41
FC Lugano,6554,6,12,5,15,34,46,-12,41
Grasshoppers,6554,7,10,6,16,41,49,-8,36
FC Thun,6554,8,9,6,17,43,59,-16,33
FC Sion,6554,9,7,8,17,41,53,-12,29
Young Boys,6555,1,22,7,3,73,37,36,73
FC Basel,6555,2,19,7,6,57,26,31,64
St Gallen,6555,3,15,3,14,46,55,-9,48
Lucerne,6555,4,13,7,12,46,45,1,46
FC Zürich,6555,5,10,9,13,38,37,1,39
FC Lugano,6555,6,10,6,16,32,54,-22,36
Grasshoppers,6555,7,9,8,15,39,47,-8,35
FC Thun,6555,8,10,5,17,44,55,-11,35
FC Sion,6555,9,6,8,18,39,58,-19,26
Young Boys,6556,1,21,8,3,68,34,34,71
FC Basel,6556,2,17,7,8,53,27,26,58
Lucerne,6556,3,14,9,9,48,41,7,51
St Gallen,6556,4,15,4,13,45,52,-7,49
FC Zürich,6556,5,10,11,11,41,37,4,41
Grasshoppers,6556,6,10,7,15,45,51,-6,37
FC Lugano,6556,7,9,6,17,28,51,-23,33
FC Thun,6556,8,8,6,18,43,64,-21,30
FC Sion,6556,9,7,8,17,41,55,-14,29
Young Boys,6557,1,22,7,3,72,35,37,73
FC Basel,6557,2,17,9,6,54,27,27,60
St Gallen,6557,3,15,4,13,46,53,-7,49
Lucerne,6557,4,12,8,12,40,43,-3,44
FC Zürich,6557,5,10,11,11,41,37,4,41
FC Thun,6557,6,10,5,17,43,58,-15,35
FC Lugano,6557,7,9,8,15,31,47,-16,35
Grasshoppers,6557,8,8,8,16,39,51,-12,32
FC Sion,6557,9,7,8,17,40,55,-15,29
FC Basel,6558,1,20,7,5,58,23,35,67
Young Boys,6558,2,19,8,5,67,39,28,65
Lucerne,6558,3,12,9,11,41,42,-1,45
FC Zürich,6558,4,11,9,12,40,38,2,42
St Gallen,6558,5,13,3,16,41,56,-15,42
Grasshoppers,6558,6,11,6,15,44,50,-6,39
FC Lugano,6558,7,11,6,15,31,45,-14,39
FC Thun,6558,8,10,5,17,45,60,-15,35
FC Sion,6558,9,7,7,18,41,55,-14,28
Young Boys,6559,1,20,8,4,71,39,32,68
FC Basel,6559,2,16,10,6,49,24,25,58
Lucerne,6559,3,14,9,9,42,39,3,51
St Gallen,6559,4,14,5,13,44,54,-10,47
FC Zürich,6559,5,9,11,12,39,37,2,38
FC Lugano,6559,6,10,8,14,34,48,-14,38
Grasshoppers,6559,7,10,6,16,45,56,-11,36
FC Thun,6559,8,9,7,16,45,56,-11,34
FC Sion,6559,9,6,8,18,39,55,-16,26
Young Boys,6560,1,22,7,3,75,36,39,73
FC Basel,6560,2,17,9,6,53,27,26,60
St Gallen,6560,3,14,4,14,44,55,-11,46
Lucerne,6560,4,12,7,13,45,48,-3,43
FC Zürich,6560,5,10,11,11,43,38,5,41
Grasshoppers,6560,6,11,6,15,42,49,-7,39
FC Lugano,6560,7,11,6,15,32,48,-16,39
FC Thun,6560,8,9,5,18,40,59,-19,32
FC Sion,6560,9,6,9,17,41,55,-14,27
Young Boys,6561,1,21,8,3,76,41,35,71
FC Basel,6561,2,19,8,5,56,24,32,65
St Gallen,6561,3,16,2,14,43,52,-9,50
Lucerne,6561,4,12,8,12,41,46,-5,44
FC Zürich,6561,5,9,11,12,37,41,-4,38
FC Thun,6561,6,10,6,16,48,59,-11,36
Grasshoppers,6561,7,9,8,15,44,52,-8,35
FC Lugano,6561,8,10,5,17,34,49,-15,35
FC Sion,6561,9,5,10,17,38,53,-15,25
Young Boys,6562,1,21,7,4,70,35,35,70
FC Basel,6562,2,16,10,6,50,27,23,58
St Gallen,6562,3,16,2,14,49,56,-7,50
Lucerne,6562,4,13,8,11,43,45,-2,47
FC Zürich,6562,5,10,11,11,42,37,5,41
Grasshoppers,6562,6,10,6,16,41,48,-7,36
FC Thun,6562,7,10,5,17,44,59,-15,35
FC Lugano,6562,8,10,5,17,30,49,-19,35
FC Sion,6562,9,7,8,17,43,56,-13,29
Young Boys,6563,1,23,6,3,75,35,40,75
FC Basel,6563,2,20,7,5,60,23,37,67
St Gallen,6563,3,15,2,15,48,57,-9,47
Lucerne,6563,4,12,8,12,43,49,-6,44
FC Zürich,6563,5,9,11,12,36,35,1,38
FC Thun,6563,6,10,6,16,44,58,-14,36
FC Lugano,6563,7,10,6,16,31,51,-20,36
Grasshoppers,6563,8,8,7,17,39,52,-13,31
FC Sion,6563,9,7,7,18,40,56,-16,28
Young Boys,6564,1,22,7,3,70,32,38,73
FC Basel,6564,2,17,8,7,50,26,24,59
FC Zürich,6564,3,11,11,10,41,34,7,44
Lucerne,6564,4,12,8,12,39,45,-6,44
St Gallen,6564,5,13,2,17,40,56,-16,41
FC Lugano,6564,6,10,7,15,31,46,-15,37
Grasshoppers,6564,7,10,6,16,43,48,-5,36
FC Thun,6564,8,10,6,16,45,59,-14,36
FC Sion,6564,9,8,7,17,41,54,-13,31
Young Boys,6565,1,22,6,4,75,35,40,72
FC Basel,6565,2,20,7,5,59,24,35,67
St Gallen,6565,3,14,3,15,41,55,-14,45
Lucerne,6565,4,12,8,12,41,51,-10,44
Grasshoppers,6565,5,10,8,14,45,48,-3,38
FC Zürich,6565,6,9,10,13,37,39,-2,37
FC Lugano,6565,7,10,5,17,30,48,-18,35
FC Thun,6565,8,9,6,17,44,61,-17,33
FC Sion,6565,9,7,9,16,43,54,-11,30
Young Boys,6566,1,20,8,4,68,34,34,68
FC Basel,6566,2,17,8,7,53,27,26,59
FC Zürich,6566,3,13,9,10,42,33,9,48
Lucerne,6566,4,12,10,10,42,44,-2,46
St Gallen,6566,5,14,4,14,44,54,-10,46
FC Lugano,6566,6,11,6,15,32,46,-14,39
Grasshoppers,6566,7,8,10,14,41,49,-8,34
FC Thun,6566,8,8,6,18,40,60,-20,30
FC Sion,6566,9,6,9,17,40,55,-15,27
Young Boys,6567,1,22,7,3,70,34,36,73
FC Basel,6567,2,17,9,6,50,24,26,60
Lucerne,6567,3,13,9,10,44,42,2,48
FC Zürich,6567,4,12,9,11,45,36,9,45
St Gallen,6567,5,14,3,15,42,57,-15,45
FC Lugano,6567,6,11,6,15,36,47,-11,39
FC Thun,6567,7,10,6,16,47,59,-12,36
Grasshoppers,6567,8,9,6,17,40,50,-10,33
FC Sion,6567,9,5,7,20,35,60,-25,22
Young Boys,6568,1,22,6,4,69,35,34,72
FC Basel,6568,2,18,7,7,52,27,25,61
St Gallen,6568,3,16,2,14,44,52,-8,50
Lucerne,6568,4,12,9,11,39,41,-2,45
FC Zürich,6568,5,11,10,11,43,34,9,43
Grasshoppers,6568,6,9,8,15,41,49,-8,35
FC Thun,6568,7,9,7,16,43,58,-15,34
FC Lugano,6568,8,9,7,16,28,45,-17,34
FC Sion,6568,9,6,8,18,37,55,-18,26
Young Boys,6569,1,20,7,5,74,42,32,67
FC Basel,6569,2,19,8,5,55,24,31,65
St Gallen,6569,3,15,2,15,43,55,-12,47
Lucerne,6569,4,12,7,13,43,46,-3,43
FC Zürich,6569,5,9,11,12,39,37,2,38
FC Lugano,6569,6,10,7,15,31,47,-16,37
FC Sion,6569,7,9,8,15,48,55,-7,35
FC Thun,6569,8,9,8,15,42,56,-14,35
Grasshoppers,6569,9,9,6,17,40,53,-13,33
Young Boys,6570,1,21,8,3,74,38,36,71
FC Basel,6570,2,17,7,8,57,31,26,58
St Gallen,6570,3,15,3,14,43,55,-12,48
FC Zürich,6570,4,12,10,10,43,35,8,46
Lucerne,6570,5,12,7,13,43,49,-6,43
Grasshoppers,6570,6,11,6,15,42,46,-4,39
FC Thun,6570,7,10,6,16,44,61,-17,36
FC Lugano,6570,8,9,7,16,31,49,-18,34
FC Sion,6570,9,6,8,18,41,54,-13,26
Young Boys,6571,1,22,7,3,75,36,39,73
FC Basel,6571,2,17,8,7,52,26,26,59
St Gallen,6571,3,14,4,14,45,56,-11,46
FC Zürich,6571,4,11,11,10,41,35,6,44
Lucerne,6571,5,11,9,12,43,48,-5,42
FC Thun,6571,6,11,6,15,45,56,-11,39
Grasshoppers,6571,7,10,7,15,40,48,-8,37
FC Lugano,6571,8,10,6,16,32,50,-18,36
FC Sion,6571,9,5,8,19,39,57,-18,23
Young Boys,6572,1,24,6,2,80,33,47,78
FC Basel,6572,2,17,8,7,51,26,25,59
St Gallen,6572,3,14,4,14,42,53,-11,46
Lucerne,6572,4,12,7,13,40,47,-7,43
FC Zürich,6572,5,10,10,12,39,38,1,40
FC Thun,6572,6,11,6,15,45,54,-9,39
FC Lugano,6572,7,10,6,16,32,48,-16,36
Grasshoppers,6572,8,9,7,16,39,49,-10,34
FC Sion,6572,9,5,10,17,42,62,-20,25
Young Boys,6573,1,20,8,4,74,44,30,68
FC Basel,6573,2,18,9,5,60,28,32,63
Lucerne,6573,3,14,9,9,46,43,3,51
St Gallen,6573,4,14,3,15,44,59,-15,45
FC Zürich,6573,5,11,11,10,44,35,9,44
FC Thun,6573,6,10,5,17,47,60,-13,35
Grasshoppers,6573,7,9,7,16,43,55,-12,34
FC Lugano,6573,8,9,6,17,31,49,-18,33
FC Sion,6573,9,6,8,18,43,59,-16,26
Young Boys,6574,1,21,7,4,72,35,37,70
FC Basel,6574,2,18,7,7,54,26,28,61
Lucerne,6574,3,14,8,10,51,48,3,50
St Gallen,6574,4,14,3,15,45,57,-12,45
FC Zürich,6574,5,11,11,10,43,36,7,44
Grasshoppers,6574,6,10,7,15,43,49,-6,37
FC Lugano,6574,7,10,6,16,33,51,-18,36
FC Sion,6574,8,7,8,17,42,58,-16,29
FC Thun,6574,9,8,5,19,39,62,-23,29
Young Boys,6575,1,20,8,4,69,37,32,68
FC Basel,6575,2,16,10,6,51,26,25,58
Lucerne,6575,3,13,10,9,43,42,1,49
St Gallen,6575,4,14,3,15,44,56,-12,45
FC Zürich,6575,5,10,11,11,40,37,3,41
FC Thun,6575,6,10,6,16,45,59,-14,36
FC Lugano,6575,7,10,6,16,33,49,-16,36
Grasshoppers,6575,8,9,8,15,41,48,-7,35
FC Sion,6575,9,7,8,17,41,53,-12,29
Young Boys,6576,1,21,7,4,73,39,34,70
FC Basel,6576,2,18,8,6,59,30,29,62
St Gallen,6576,3,15,3,14,45,54,-9,48
Lucerne,6576,4,12,8,12,40,44,-4,44
FC Zürich,6576,5,11,9,12,42,37,5,42
Grasshoppers,6576,6,11,7,14,46,48,-2,40
FC Thun,6576,7,10,5,17,43,59,-16,35
FC Lugano,6576,8,10,5,17,29,49,-20,35
FC Sion,6576,9,6,8,18,41,58,-17,26
Young Boys,6577,1,21,8,3,71,37,34,71
FC Basel,6577,2,18,9,5,53,23,30,63
St Gallen,6577,3,14,4,14,43,54,-11,46
Lucerne,6577,4,12,9,11,42,44,-2,45
FC Zürich,6577,5,10,10,12,41,36,5,40
FC Thun,6577,6,11,5,16,42,55,-13,38
FC Lugano,6577,7,9,8,15,31,47,-16,35
Grasshoppers,6577,8,8,7,17,38,50,-12,31
FC Sion,6577,9,7,8,17,40,55,-15,29
Young Boys,6578,1,22,7,3,72,33,39,73
FC Basel,6578,2,16,10,6,52,26,26,58
Lucerne,6578,3,13,9,10,44,45,-1,48
FC Zürich,6578,4,11,9,12,43,39,4,42
St Gallen,6578,5,13,3,16,42,58,-16,42
FC Thun,6578,6,10,6,16,42,56,-14,36
FC Lugano,6578,7,10,5,17,32,50,-18,35
Grasshoppers,6578,8,9,7,16,43,52,-9,34
FC Sion,6578,9,8,8,16,40,51,-11,32
Young Boys,6579,1,22,7,3,75,33,42,73
FC Basel,6579,2,17,9,6,55,26,29,60
Lucerne,6579,3,14,8,10,48,46,2,50
St Gallen,6579,4,14,4,14,44,55,-11,46
FC Zürich,6579,5,9,11,12,36,37,-1,38
FC Thun,6579,6,10,6,16,43,58,-15,36
FC Lugano,6579,7,9,7,16,31,50,-19,34
FC Sion,6579,8,8,7,17,41,54,-13,31
Grasshoppers,6579,9,8,7,17,38,52,-14,31
Young Boys,6580,1,21,8,3,73,38,35,71
FC Basel,6580,2,17,7,8,52,26,26,58
St Gallen,6580,3,15,2,15,44,58,-14,47
FC Zürich,6580,4,11,10,11,42,35,7,43
Lucerne,6580,5,12,7,13,42,51,-9,43
FC Lugano,6580,6,11,6,15,36,48,-12,39
FC Thun,6580,7,10,7,15,46,56,-10,37
Grasshoppers,6580,8,8,8,16,43,55,-12,32
FC Sion,6580,9,8,7,17,45,56,-11,31
Young Boys,6581,1,20,10,2,71,35,36,70
FC Basel,6581,2,17,8,7,52,30,22,59
St Gallen,6581,3,17,2,13,52,52,0,53
Lucerne,6581,4,12,9,11,44,51,-7,45
FC Zürich,6581,5,10,11,11,44,39,5,41
FC Lugano,6581,6,10,7,15,35,50,-15,37
Grasshoppers,6581,7,10,6,16,40,49,-9,36
FC Thun,6581,8,8,6,18,45,63,-18,30
FC Sion,6581,9,6,9,17,40,54,-14,27
Young Boys,6582,1,23,6,3,80,35,45,75
FC Basel,6582,2,18,8,6,54,27,27,62
St Gallen,6582,3,14,3,15,39,53,-14,45
FC Zürich,6582,4,11,11,10,47,36,11,44
Lucerne,6582,5,12,8,12,43,49,-6,44
Grasshoppers,6582,6,10,7,15,42,50,-8,37
FC Lugano,6582,7,10,6,16,30,51,-21,36
FC Sion,6582,8,7,8,17,41,52,-11,29
FC Thun,6582,9,8,5,19,40,63,-23,29
Young Boys,6583,1,23,6,3,73,32,41,75
FC Basel,6583,2,16,8,8,49,27,22,56
St Gallen,6583,3,15,2,15,42,56,-14,47
Lucerne,6583,4,13,7,12,44,45,-1,46
FC Zürich,6583,5,11,10,11,44,34,10,43
Grasshoppers,6583,6,9,8,15,42,53,-11,35
FC Lugano,6583,7,10,5,17,32,48,-16,35
FC Thun,6583,8,9,6,17,42,60,-18,33
FC Sion,6583,9,8,8,16,46,59,-13,32
Young Boys,6584,1,21,8,3,71,36,35,71
FC Basel,6584,2,18,7,7,53,27,26,61
Lucerne,6584,3,13,9,10,40,41,-1,48
St Gallen,6584,4,15,2,15,46,57,-11,47
FC Zürich,6584,5,11,10,11,44,37,7,43
FC Lugano,6584,6,10,7,15,32,47,-15,37
Grasshoppers,6584,7,9,7,16,44,53,-9,34
FC Thun,6584,8,9,5,18,44,59,-15,32
FC Sion,6584,9,7,7,18,41,58,-17,28
Young Boys,6585,1,23,6,3,74,32,42,75
FC Basel,6585,2,17,9,6,53,28,25,60
St Gallen,6585,3,15,3,14,42,51,-9,48
Lucerne,6585,4,13,7,12,44,46,-2,46
FC Zürich,6585,5,10,10,12,43,40,3,40
FC Lugano,6585,6,10,6,16,34,49,-15,36
FC Sion,6585,7,9,7,16,41,52,-11,34
Grasshoppers,6585,8,8,7,17,38,51,-13,31
FC Thun,6585,9,8,7,17,44,64,-20,31
Young Boys,6586,1,22,6,4,70,35,35,72
FC Basel,6586,2,17,7,8,56,28,28,58
Lucerne,6586,3,13,8,11,43,44,-1,47
St Gallen,6586,4,14,4,14,46,55,-9,46
FC Lugano,6586,5,12,6,14,34,45,-11,42
FC Zürich,6586,6,9,11,12,38,37,1,38
FC Thun,6586,7,10,6,16,42,61,-19,36
Grasshoppers,6586,8,9,6,17,39,50,-11,33
FC Sion,6586,9,7,8,17,40,53,-13,29
Young Boys,6587,1,20,7,5,69,39,30,67
FC Basel,6587,2,19,8,5,55,24,31,65
Lucerne,6587,3,14,7,11,46,41,5,49
St Gallen,6587,4,15,2,15,44,54,-10,47
FC Zürich,6587,5,10,11,11,40,36,4,41
Grasshoppers,6587,6,11,6,15,45,54,-9,39
FC Lugano,6587,7,9,6,17,31,51,-20,33
FC Thun,6587,8,9,5,18,43,61,-18,32
FC Sion,6587,9,7,8,17,40,53,-13,29
Young Boys,6588,1,22,6,4,71,36,35,72
FC Basel,6588,2,17,7,8,55,27,28,58
Lucerne,6588,3,14,7,11,41,41,0,49
St Gallen,6588,4,15,3,14,42,52,-10,48
FC Zürich,6588,5,10,10,12,38,39,-1,40
FC Thun,6588,6,11,6,15,47,57,-10,39
FC Lugano,6588,7,11,5,16,32,45,-13,38
Grasshoppers,6588,8,9,7,16,40,51,-11,34
FC Sion,6588,9,5,9,18,37,55,-18,24
Young Boys,6589,1,19,9,4,67,38,29,66
FC Basel,6589,2,17,9,6,53,26,27,60
St Gallen,6589,3,16,3,13,46,50,-4,51
Lucerne,6589,4,12,8,12,37,45,-8,44
FC Zürich,6589,5,11,10,11,41,37,4,43
FC Lugano,6589,6,10,6,16,30,46,-16,36
Grasshoppers,6589,7,9,8,15,42,48,-6,35
FC Sion,6589,8,9,7,16,43,49,-6,34
FC Thun,6589,9,8,6,18,39,59,-20,30
Young Boys,6590,1,23,7,2,78,34,44,76
FC Basel,6590,2,18,9,5,60,27,33,63
St Gallen,6590,3,16,2,14,49,54,-5,50
Lucerne,6590,4,12,7,13,42,48,-6,43
FC Zürich,6590,5,10,10,12,40,38,2,40
FC Thun,6590,6,11,5,16,43,59,-16,38
FC Lugano,6590,7,10,5,17,31,53,-22,35
Grasshoppers,6590,8,9,6,17,40,51,-11,33
FC Sion,6590,9,6,7,19,38,57,-19,25
Young Boys,6591,1,22,7,3,74,35,39,73
FC Basel,6591,2,18,9,5,56,25,31,63
Lucerne,6591,3,13,7,12,43,46,-3,46
St Gallen,6591,4,14,4,14,45,55,-10,46
FC Zürich,6591,5,11,10,11,43,38,5,43
FC Lugano,6591,6,11,6,15,31,48,-17,39
FC Thun,6591,7,10,5,17,45,58,-13,35
Grasshoppers,6591,8,9,6,17,39,50,-11,33
FC Sion,6591,9,5,8,19,38,59,-21,23
Young Boys,6592,1,22,6,4,77,37,40,72
FC Basel,6592,2,18,7,7,54,28,26,61
St Gallen,6592,3,15,3,14,45,54,-9,48
Lucerne,6592,4,12,9,11,42,44,-2,45
FC Zürich,6592,5,10,10,12,39,43,-4,40
FC Thun,6592,6,10,6,16,49,57,-8,36
FC Lugano,6592,7,10,6,16,31,49,-18,36
Grasshoppers,6592,8,8,8,16,40,51,-11,32
FC Sion,6592,9,7,9,16,42,56,-14,30
Young Boys,6593,1,22,8,2,72,33,39,74
FC Basel,6593,2,17,9,6,53,26,27,60
St Gallen,6593,3,14,4,14,42,54,-12,46
Lucerne,6593,4,12,9,11,40,42,-2,45
FC Zürich,6593,5,9,10,13,40,39,1,37
FC Lugano,6593,6,10,7,15,28,44,-16,37
Grasshoppers,6593,7,10,6,16,42,50,-8,36
FC Thun,6593,8,9,7,16,43,58,-15,34
FC Sion,6593,9,7,8,17,41,55,-14,29
Young Boys,6594,1,22,8,2,71,34,37,74
FC Basel,6594,2,17,10,5,55,25,30,61
Lucerne,6594,3,13,8,11,44,45,-1,47
St Gallen,6594,4,15,2,15,49,61,-12,47
FC Zürich,6594,5,10,10,12,39,37,2,40
FC Thun,6594,6,10,6,16,46,57,-11,36
FC Lugano,6594,7,10,6,16,34,50,-16,36
Grasshoppers,6594,8,9,7,16,39,51,-12,34
FC Sion,6594,9,6,7,19,40,57,-17,25
Young Boys,6595,1,21,6,5,70,38,32,69
FC Basel,6595,2,18,9,5,56,23,33,63
St Gallen,6595,3,14,3,15,44,56,-12,45
Lucerne,6595,4,11,9,12,39,45,-6,42
FC Zürich,6595,5,10,11,11,40,36,4,41
FC Lugano,6595,6,11,5,16,34,48,-14,38
Grasshoppers,6595,7,10,6,16,41,50,-9,36
FC Thun,6595,8,10,6,16,43,59,-16,36
FC Sion,6595,9,8,7,17,41,53,-12,31
Young Boys,6596,1,23,6,3,71,34,37,75
FC Basel,6596,2,19,7,6,55,26,29,64
Lucerne,6596,3,15,7,10,43,40,3,52
St Gallen,6596,4,15,2,15,41,53,-12,47
FC Zürich,6596,5,9,11,12,39,37,2,38
Grasshoppers,6596,6,10,6,16,44,53,-9,36
FC Lugano,6596,7,10,5,17,29,46,-17,35
FC Thun,6596,8,8,6,18,45,63,-18,30
FC Sion,6596,9,6,8,18,43,58,-15,26
Young Boys,6597,1,22,8,2,72,33,39,74
FC Basel,6597,2,18,7,7,55,25,30,61
Lucerne,6597,3,13,8,11,42,43,-1,47
St Gallen,6597,4,14,3,15,40,53,-13,45
FC Zürich,6597,5,10,10,12,39,38,1,40
Grasshoppers,6597,6,9,9,14,42,48,-6,36
FC Lugano,6597,7,10,6,16,31,48,-17,36
FC Thun,6597,8,9,6,17,42,59,-17,33
FC Sion,6597,9,6,9,17,38,54,-16,27
Young Boys,6598,1,22,8,2,73,35,38,74
FC Basel,6598,2,17,7,8,53,28,25,58
Lucerne,6598,3,13,9,10,42,42,0,48
St Gallen,6598,4,14,4,14,42,53,-11,46
FC Zürich,6598,5,10,10,12,39,38,1,40
FC Thun,6598,6,11,5,16,49,56,-7,38
FC Lugano,6598,7,10,7,15,31,47,-16,37
Grasshoppers,6598,8,8,8,16,40,52,-12,32
FC Sion,6598,9,5,10,17,40,58,-18,25
Young Boys,6599,1,22,6,4,72,35,37,72
FC Basel,6599,2,18,7,7,54,28,26,61
St Gallen,6599,3,14,2,16,43,58,-15,44
FC Zürich,6599,4,10,11,11,41,38,3,41
Lucerne,6599,5,11,8,13,41,47,-6,41
FC Lugano,6599,6,11,6,15,32,44,-12,39
FC Thun,6599,7,10,6,16,44,58,-14,36
FC Sion,6599,8,9,8,15,48,54,-6,35
Grasshoppers,6599,9,9,6,17,39,52,-13,33
Young Boys,6600,1,23,7,2,71,32,39,76
FC Basel,6600,2,17,7,8,52,28,24,58
FC Zürich,6600,3,13,9,10,42,33,9,48
St Gallen,6600,4,15,3,14,44,54,-10,48
Lucerne,6600,5,13,7,12,43,45,-2,46
Grasshoppers,6600,6,10,6,16,43,50,-7,36
FC Thun,6600,7,10,5,17,45,60,-15,35
FC Lugano,6600,8,9,5,18,29,49,-20,32
FC Sion,6600,9,5,9,18,37,55,-18,24
Young Boys,6601,1,23,6,3,71,35,36,75
FC Basel,6601,2,17,9,6,58,29,29,60
Lucerne,6601,3,12,10,10,42,43,-1,46
St Gallen,6601,4,14,3,15,42,56,-14,45
FC Zürich,6601,5,11,10,11,40,38,2,43
FC Lugano,6601,6,10,6,16,32,45,-13,36
Grasshoppers,6601,7,9,7,16,42,51,-9,34
FC Thun,6601,8,9,6,17,44,60,-16,33
FC Sion,6601,9,6,9,17,37,51,-14,27
Young Boys,6602,1,22,6,4,74,38,36,72
FC Basel,6602,2,18,8,6,58,26,32,62
St Gallen,6602,3,15,3,14,42,51,-9,48
Lucerne,6602,4,12,8,12,40,45,-5,44
FC Zürich,6602,5,11,10,11,41,35,6,43
FC Lugano,6602,6,11,5,16,32,46,-14,38
Grasshoppers,6602,7,10,7,15,44,49,-5,37
FC Thun,6602,8,8,7,17,39,63,-24,31
FC Sion,6602,9,6,8,18,37,54,-17,26
Young Boys,6603,1,21,7,4,72,39,33,70
FC Basel,6603,2,18,7,7,51,25,26,61
St Gallen,6603,3,15,2,15,42,54,-12,47
Lucerne,6603,4,12,7,13,41,45,-4,43
FC Zürich,6603,5,10,10,12,39,37,2,40
FC Lugano,6603,6,11,6,15,33,46,-13,39
Grasshoppers,6603,7,10,7,15,44,50,-6,37
FC Thun,6603,8,10,7,15,44,56,-12,37
FC Sion,6603,9,6,9,17,43,57,-14,27
Young Boys,6604,1,21,8,3,72,36,36,71
FC Basel,6604,2,19,8,5,57,25,32,65
St Gallen,6604,3,14,4,14,45,55,-10,46
Lucerne,6604,4,11,10,11,39,44,-5,43
FC Zürich,6604,5,10,10,12,39,37,2,40
FC Thun,6604,6,11,5,16,46,56,-10,38
FC Lugano,6604,7,10,7,15,30,48,-18,37
Grasshoppers,6604,8,8,8,16,37,49,-12,32
FC Sion,6604,9,6,8,18,40,55,-15,26
Young Boys,6605,1,21,9,2,72,35,37,72
FC Basel,6605,2,17,9,6,50,24,26,60
St Gallen,6605,3,16,3,13,44,51,-7,51
Lucerne,6605,4,13,8,11,41,42,-1,47
FC Zürich,6605,5,10,9,13,41,37,4,39
FC Thun,6605,6,11,6,15,48,55,-7,39
FC Lugano,6605,7,10,6,16,31,49,-18,36
Grasshoppers,6605,8,9,6,17,38,52,-14,33
FC Sion,6605,9,5,8,19,37,57,-20,23
Young Boys,6606,1,21,8,3,72,34,38,71
FC Basel,6606,2,17,10,5,54,27,27,61
Lucerne,6606,3,12,10,10,40,41,-1,46
St Gallen,6606,4,13,4,15,40,56,-16,43
FC Zürich,6606,5,11,9,12,40,38,2,42
Grasshoppers,6606,6,9,8,15,40,49,-9,35
FC Lugano,6606,7,10,5,17,32,52,-20,35
FC Thun,6606,8,9,7,16,41,55,-14,34
FC Sion,6606,9,7,9,16,42,49,-7,30
Young Boys,6607,1,19,7,6,66,36,30,64
FC Basel,6607,2,18,8,6,51,23,28,62
St Gallen,6607,3,16,3,13,44,51,-7,51
Lucerne,6607,4,12,8,12,41,45,-4,44
FC Zürich,6607,5,10,10,12,40,38,2,40
Grasshoppers,6607,6,11,6,15,44,49,-5,39
FC Thun,6607,7,11,6,15,44,55,-11,39
FC Lugano,6607,8,11,5,16,31,46,-15,38
FC Sion,6607,9,6,7,19,40,58,-18,25
Young Boys,6608,1,21,7,4,71,36,35,70
FC Basel,6608,2,20,7,5,59,26,33,67
St Gallen,6608,3,15,3,14,44,56,-12,48
Lucerne,6608,4,12,8,12,39,42,-3,44
FC Zürich,6608,5,11,10,11,46,41,5,43
Grasshoppers,6608,6,11,6,15,44,49,-5,39
FC Thun,6608,7,9,6,17,46,62,-16,33
FC Lugano,6608,8,9,5,18,30,50,-20,32
FC Sion,6608,9,6,8,18,42,59,-17,26
Young Boys,6609,1,22,6,4,73,38,35,72
FC Basel,6609,2,18,9,5,58,26,32,63
St Gallen,6609,3,15,3,14,45,54,-9,48
FC Zürich,6609,4,12,10,10,42,35,7,46
Lucerne,6609,5,12,8,12,41,47,-6,44
FC Thun,6609,6,10,6,16,45,58,-13,36
Grasshoppers,6609,7,9,7,16,40,51,-11,34
FC Lugano,6609,8,9,6,17,32,51,-19,33
FC Sion,6609,9,6,7,19,40,56,-16,25
Young Boys,6610,1,19,9,4,65,33,32,66
FC Basel,6610,2,17,10,5,55,26,29,61
Lucerne,6610,3,13,8,11,42,41,1,47
St Gallen,6610,4,14,3,15,43,56,-13,45
FC Zürich,6610,5,11,10,11,43,39,4,43
FC Lugano,6610,6,10,6,16,31,47,-16,36
Grasshoppers,6610,7,9,8,15,39,49,-10,35
FC Sion,6610,8,8,9,15,47,55,-8,33
FC Thun,6610,9,8,7,17,43,62,-19,31
Young Boys,6611,1,22,6,4,73,34,39,72
FC Basel,6611,2,19,7,6,55,23,32,64
St Gallen,6611,3,15,3,14,45,52,-7,48
Lucerne,6611,4,12,7,13,39,49,-10,43
FC Zürich,6611,5,10,10,12,41,40,1,40
Grasshoppers,6611,6,11,6,15,47,46,1,39
FC Thun,6611,7,11,5,16,44,57,-13,38
FC Lugano,6611,8,9,5,18,28,51,-23,32
FC Sion,6611,9,6,9,17,41,61,-20,27
Young Boys,6612,1,20,9,3,71,37,34,69
FC Basel,6612,2,16,10,6,49,24,25,58
Lucerne,6612,3,12,9,11,43,46,-3,45
St Gallen,6612,4,14,3,15,43,54,-11,45
FC Zürich,6612,5,11,11,10,40,34,6,44
FC Lugano,6612,6,11,6,15,31,45,-14,39
Grasshoppers,6612,7,9,7,16,43,52,-9,34
FC Sion,6612,8,8,8,16,44,54,-10,32
FC Thun,6612,9,9,5,18,41,59,-18,32
Young Boys,6613,1,20,8,4,69,36,33,68
FC Basel,6613,2,19,7,6,60,25,35,64
Lucerne,6613,3,14,8,10,47,42,5,50
St Gallen,6613,4,15,2,15,44,62,-18,47
FC Zürich,6613,5,12,9,11,47,39,8,45
FC Lugano,6613,6,10,7,15,35,47,-12,37
Grasshoppers,6613,7,9,7,16,45,59,-14,34
FC Thun,6613,8,9,5,18,46,63,-17,32
FC Sion,6613,9,6,7,19,40,60,-20,25
Young Boys,6614,1,21,8,3,76,38,38,71
FC Basel,6614,2,17,8,7,53,27,26,59
Lucerne,6614,3,14,7,11,47,48,-1,49
St Gallen,6614,4,14,4,14,44,54,-10,46
FC Zürich,6614,5,11,9,12,41,38,3,42
Grasshoppers,6614,6,10,7,15,45,50,-5,37
FC Thun,6614,7,10,5,17,44,59,-15,35
FC Lugano,6614,8,9,6,17,28,52,-24,33
FC Sion,6614,9,7,8,17,42,54,-12,29
Young Boys,6615,1,23,6,3,80,37,43,75
FC Basel,6615,2,17,10,5,52,24,28,61
St Gallen,6615,3,15,3,14,45,53,-8,48
Lucerne,6615,4,12,8,12,38,46,-8,44
FC Zürich,6615,5,11,9,12,40,37,3,42
Grasshoppers,6615,6,11,6,15,45,51,-6,39
FC Thun,6615,7,9,6,17,44,60,-16,33
FC Lugano,6615,8,9,5,18,31,50,-19,32
FC Sion,6615,9,7,7,18,42,59,-17,28
Young Boys,6616,1,20,8,4,67,35,32,68
FC Basel,6616,2,19,8,5,54,23,31,65
Lucerne,6616,3,13,8,11,43,43,0,47
St Gallen,6616,4,15,2,15,44,56,-12,47
FC Zürich,6616,5,10,12,10,44,37,7,42
Grasshoppers,6616,6,9,7,16,43,48,-5,34
FC Thun,6616,7,9,6,17,41,57,-16,33
FC Lugano,6616,8,9,6,17,28,48,-20,33
FC Sion,6616,9,8,7,17,42,59,-17,31
Young Boys,6617,1,22,7,3,75,33,42,73
FC Basel,6617,2,17,8,7,52,26,26,59
Lucerne,6617,3,14,7,11,42,44,-2,49
St Gallen,6617,4,14,4,14,44,55,-11,46
FC Zürich,6617,5,11,9,12,40,37,3,42
Grasshoppers,6617,6,10,7,15,44,52,-8,37
FC Thun,6617,7,10,6,16,45,59,-14,36
FC Lugano,6617,8,9,6,17,29,50,-21,33
FC Sion,6617,9,6,8,18,44,59,-15,26
Young Boys,6618,1,21,6,5,70,38,32,69
FC Basel,6618,2,18,7,7,55,31,24,61
Lucerne,6618,3,15,7,10,46,42,4,52
St Gallen,6618,4,15,2,15,46,54,-8,47
FC Zürich,6618,5,11,9,12,43,37,6,42
Grasshoppers,6618,6,10,6,16,41,50,-9,36
FC Thun,6618,7,10,5,17,44,60,-16,35
FC Lugano,6618,8,10,5,17,30,47,-17,35
FC Sion,6618,9,7,7,18,39,55,-16,28
Young Boys,6619,1,23,6,3,77,37,40,75
FC Basel,6619,2,17,7,8,51,28,23,58
Lucerne,6619,3,13,9,10,46,45,1,48
St Gallen,6619,4,14,3,15,43,56,-13,45
FC Zürich,6619,5,10,11,11,39,36,3,41
FC Lugano,6619,6,11,6,15,34,48,-14,39
FC Thun,6619,7,10,6,16,43,55,-12,36
Grasshoppers,6619,8,9,6,17,39,48,-9,33
FC Sion,6619,9,6,8,18,41,60,-19,26
Young Boys,6620,1,22,6,4,74,37,37,72
FC Basel,6620,2,18,8,6,54,26,28,62
Lucerne,6620,3,13,7,12,40,44,-4,46
St Gallen,6620,4,14,3,15,41,52,-11,45
FC Zürich,6620,5,10,10,12,39,38,1,40
FC Thun,6620,6,11,5,16,45,58,-13,38
Grasshoppers,6620,7,10,6,16,40,47,-7,36
FC Lugano,6620,8,10,6,16,31,48,-17,36
FC Sion,6620,9,7,7,18,41,55,-14,28
Young Boys,6621,1,21,7,4,71,37,34,70
FC Basel,6621,2,19,7,6,56,27,29,64
FC Lugano,6621,3,13,5,14,33,44,-11,44
Lucerne,6621,4,12,7,13,39,44,-5,43
FC Zürich,6621,5,10,11,11,40,36,4,41
St Gallen,6621,6,13,2,17,42,57,-15,41
FC Thun,6621,7,10,6,16,43,56,-13,36
Grasshoppers,6621,8,9,8,15,40,48,-8,35
FC Sion,6621,9,6,9,17,40,55,-15,27
Young Boys,6622,1,21,7,4,69,36,33,70
FC Basel,6622,2,18,7,7,53,25,28,61
Lucerne,6622,3,12,10,10,43,44,-1,46
St Gallen,6622,4,14,4,14,41,54,-13,46
FC Zürich,6622,5,10,9,13,42,41,1,39
FC Thun,6622,6,10,6,16,45,58,-13,36
FC Lugano,6622,7,10,6,16,30,46,-16,36
Grasshoppers,6622,8,8,9,15,41,50,-9,33
FC Sion,6622,9,8,8,16,40,50,-10,32
Young Boys,6623,1,20,6,6,67,39,28,66
FC Basel,6623,2,18,8,6,51,24,27,62
Lucerne,6623,3,15,7,10,43,40,3,52
St Gallen,6623,4,15,3,14,42,53,-11,48
FC Zürich,6623,5,11,11,10,46,37,9,44
FC Thun,6623,6,10,5,17,45,61,-16,35
Grasshoppers,6623,7,9,7,16,45,50,-5,34
FC Lugano,6623,8,9,6,17,33,52,-19,33
FC Sion,6623,9,6,9,17,39,55,-16,27
Young Boys,6624,1,19,9,4,68,36,32,66
FC Basel,6624,2,16,9,7,52,29,23,57
Lucerne,6624,3,14,8,10,42,42,0,50
St Gallen,6624,4,15,3,14,46,53,-7,48
FC Zürich,6624,5,11,10,11,43,37,6,43
Grasshoppers,6624,6,10,8,14,43,49,-6,38
FC Lugano,6624,7,10,7,15,32,46,-14,37
FC Thun,6624,8,9,6,17,47,62,-15,33
FC Sion,6624,9,6,8,18,37,56,-19,26
Young Boys,6625,1,22,8,2,74,33,41,74
FC Basel,6625,2,17,9,6,53,26,27,60
Lucerne,6625,3,14,7,11,41,42,-1,49
St Gallen,6625,4,15,4,13,46,54,-8,49
FC Zürich,6625,5,10,10,12,40,38,2,40
FC Thun,6625,6,10,5,17,46,60,-14,35
Grasshoppers,6625,7,9,6,17,41,53,-12,33
FC Lugano,6625,8,9,6,17,31,51,-20,33
FC Sion,6625,9,6,9,17,41,56,-15,27
Young Boys,6626,1,21,7,4,71,31,40,70
FC Basel,6626,2,20,7,5,58,22,36,67
Lucerne,6626,3,12,8,12,40,46,-6,44
St Gallen,6626,4,14,2,16,43,59,-16,44
FC Zürich,6626,5,11,9,12,42,38,4,42
FC Lugano,6626,6,11,6,15,35,47,-12,39
Grasshoppers,6626,7,10,8,14,43,47,-4,38
FC Thun,6626,8,8,6,18,41,66,-25,30
FC Sion,6626,9,7,7,18,44,61,-17,28
Young Boys,6627,1,19,9,4,69,39,30,66
FC Basel,6627,2,17,9,6,52,28,24,60
Lucerne,6627,3,13,9,10,45,42,3,48
St Gallen,6627,4,14,4,14,42,53,-11,46
FC Zürich,6627,5,11,10,11,44,36,8,43
Grasshoppers,6627,6,11,6,15,42,48,-6,39
FC Lugano,6627,7,10,8,14,33,47,-14,38
FC Thun,6627,8,10,5,17,44,58,-14,35
FC Sion,6627,9,5,8,19,37,57,-20,23
Young Boys,6628,1,20,6,6,69,35,34,66
FC Basel,6628,2,19,8,5,54,25,29,65
St Gallen,6628,3,15,4,13,44,52,-8,49
Lucerne,6628,4,12,8,12,40,43,-3,44
FC Zürich,6628,5,10,10,12,41,40,1,40
FC Lugano,6628,6,11,6,15,35,50,-15,39
Grasshoppers,6628,7,10,7,15,44,49,-5,37
FC Thun,6628,8,10,6,16,48,62,-14,36
FC Sion,6628,9,6,7,19,37,56,-19,25
Young Boys,6629,1,22,7,3,69,32,37,73
FC Basel,6629,2,16,10,6,52,26,26,58
St Gallen,6629,3,14,3,15,43,60,-17,45
Lucerne,6629,4,12,7,13,39,47,-8,43
FC Zürich,6629,5,10,11,11,41,36,5,41
Grasshoppers,6629,6,10,7,15,44,49,-5,37
FC Lugano,6629,7,10,5,17,32,47,-15,35
FC Sion,6629,8,8,9,15,46,54,-8,33
FC Thun,6629,9,8,9,15,42,57,-15,33
Young Boys,6630,1,23,6,3,75,35,40,75
FC Basel,6630,2,17,8,7,54,27,27,59
Lucerne,6630,3,14,7,11,42,45,-3,49
St Gallen,6630,4,14,2,16,43,58,-15,44
FC Zürich,6630,5,10,10,12,40,40,0,40
FC Lugano,6630,6,11,5,16,33,47,-14,38
FC Thun,6630,7,10,5,17,45,60,-15,35
Grasshoppers,6630,8,9,7,16,42,50,-8,34
FC Sion,6630,9,7,8,17,46,58,-12,29
Young Boys,6631,1,22,6,4,74,36,38,72
FC Basel,6631,2,19,7,6,58,26,32,64
Lucerne,6631,3,13,8,11,41,42,-1,47
St Gallen,6631,4,14,4,14,45,58,-13,46
FC Zürich,6631,5,11,9,12,45,39,6,42
FC Thun,6631,6,11,5,16,45,58,-13,38
FC Lugano,6631,7,10,5,17,32,51,-19,35
Grasshoppers,6631,8,9,6,17,43,55,-12,33
FC Sion,6631,9,6,8,18,42,60,-18,26
Young Boys,6632,1,22,6,4,75,41,34,72
FC Basel,6632,2,18,8,6,57,25,32,62
Lucerne,6632,3,16,7,9,47,39,8,55
St Gallen,6632,4,13,2,17,41,60,-19,41
FC Zürich,6632,5,10,10,12,38,38,0,40
Grasshoppers,6632,6,10,6,16,47,52,-5,36
FC Thun,6632,7,10,5,17,48,62,-14,35
FC Lugano,6632,8,10,5,17,31,50,-19,35
FC Sion,6632,9,7,7,18,44,61,-17,28
Young Boys,6633,1,20,7,5,67,35,32,67
FC Basel,6633,2,18,9,5,53,24,29,63
Lucerne,6633,3,14,8,10,46,41,5,50
St Gallen,6633,4,14,3,15,43,55,-12,45
FC Zürich,6633,5,10,10,12,40,41,-1,40
FC Thun,6633,6,11,5,16,47,58,-11,38
Grasshoppers,6633,7,9,7,16,39,50,-11,34
FC Lugano,6633,8,9,7,16,30,48,-18,34
FC Sion,6633,9,7,8,17,41,54,-13,29
Young Boys,6634,1,21,7,4,70,37,33,70
FC Basel,6634,2,18,9,5,59,26,33,63
Lucerne,6634,3,14,9,9,45,40,5,51
St Gallen,6634,4,15,2,15,44,53,-9,47
FC Zürich,6634,5,10,10,12,44,41,3,40
Grasshoppers,6634,6,10,7,15,44,50,-6,37
FC Thun,6634,7,10,5,17,45,67,-22,35
FC Lugano,6634,8,9,7,16,30,49,-19,34
FC Sion,6634,9,5,8,19,40,58,-18,23
Young Boys,6635,1,21,9,2,76,34,42,72
FC Basel,6635,2,18,8,6,55,27,28,62
Lucerne,6635,3,13,8,11,41,48,-7,47
St Gallen,6635,4,15,2,15,43,53,-10,47
FC Zürich,6635,5,11,9,12,42,37,5,42
Grasshoppers,6635,6,9,8,15,40,49,-9,35
FC Lugano,6635,7,10,5,17,30,49,-19,35
FC Thun,6635,8,9,5,18,43,61,-18,32
FC Sion,6635,9,7,8,17,40,52,-12,29
Young Boys,6636,1,22,7,3,76,33,43,73
FC Basel,6636,2,18,8,6,55,24,31,62
Lucerne,6636,3,13,7,12,46,49,-3,46
St Gallen,6636,4,14,2,16,46,61,-15,44
FC Zürich,6636,5,11,10,11,41,35,6,43
FC Lugano,6636,6,11,5,16,35,53,-18,38
FC Thun,6636,7,10,6,16,43,57,-14,36
Grasshoppers,6636,8,9,8,15,40,49,-9,35
FC Sion,6636,9,6,7,19,40,61,-21,25
Young Boys,6637,1,21,7,4,69,37,32,70
FC Basel,6637,2,19,7,6,63,24,39,64
Lucerne,6637,3,12,9,11,40,42,-2,45
St Gallen,6637,4,14,3,15,43,58,-15,45
FC Zürich,6637,5,11,10,11,40,34,6,43
FC Sion,6637,6,9,8,15,43,52,-9,35
FC Lugano,6637,7,9,8,15,29,47,-18,35
Grasshoppers,6637,8,9,6,17,40,51,-11,33
FC Thun,6637,9,8,6,18,41,63,-22,30
Young Boys,6638,1,21,9,2,72,33,39,72
FC Basel,6638,2,17,9,6,53,25,28,60
St Gallen,6638,3,16,2,14,48,53,-5,50
Lucerne,6638,4,12,9,11,42,46,-4,45
FC Thun,6638,5,11,6,15,44,54,-10,39
FC Zürich,6638,6,9,10,13,38,39,-1,37
FC Lugano,6638,7,10,6,16,31,48,-17,36
Grasshoppers,6638,8,8,7,17,38,51,-13,31
FC Sion,6638,9,7,8,17,41,58,-17,29
Young Boys,6639,1,21,6,5,71,36,35,69
FC Basel,6639,2,20,7,5,60,27,33,67
St Gallen,6639,3,15,2,15,50,56,-6,47
Lucerne,6639,4,12,9,11,40,44,-4,45
FC Zürich,6639,5,10,11,11,40,36,4,41
FC Lugano,6639,6,10,7,15,29,46,-17,37
FC Thun,6639,7,10,5,17,41,57,-16,35
Grasshoppers,6639,8,8,8,16,39,49,-10,32
FC Sion,6639,9,6,9,17,36,55,-19,27
Young Boys,6640,1,23,6,3,75,37,38,75
FC Basel,6640,2,17,9,6,54,25,29,60
Lucerne,6640,3,13,7,12,39,43,-4,46
St Gallen,6640,4,14,3,15,40,52,-12,45
FC Zürich,6640,5,10,12,10,46,37,9,42
Grasshoppers,6640,6,10,7,15,44,49,-5,37
FC Lugano,6640,7,10,7,15,31,47,-16,37
FC Thun,6640,8,8,8,16,44,63,-19,32
FC Sion,6640,9,6,7,19,40,60,-20,25
Young Boys,6641,1,21,8,3,78,42,36,71
FC Basel,6641,2,16,10,6,50,24,26,58
Lucerne,6641,3,13,10,9,46,44,2,49
St Gallen,6641,4,13,6,13,43,54,-11,45
FC Zürich,6641,5,11,10,11,41,36,5,43
Grasshoppers,6641,6,9,7,16,46,59,-13,34
FC Lugano,6641,7,9,7,16,27,46,-19,34
FC Thun,6641,8,9,5,18,44,61,-17,32
FC Sion,6641,9,7,9,16,48,57,-9,30
Young Boys,6642,1,22,7,3,71,35,36,73
FC Basel,6642,2,19,8,5,58,25,33,65
Lucerne,6642,3,15,7,10,50,46,4,52
FC Zürich,6642,4,12,9,11,43,35,8,45
St Gallen,6642,5,13,2,17,42,61,-19,41
Grasshoppers,6642,6,10,6,16,44,50,-6,36
FC Lugano,6642,7,10,5,17,28,47,-19,35
FC Thun,6642,8,8,6,18,42,66,-24,30
FC Sion,6642,9,6,8,18,44,57,-13,26
Young Boys,6643,1,20,7,5,68,38,30,67
FC Basel,6643,2,18,8,6,55,27,28,62
Lucerne,6643,3,15,8,9,49,42,7,53
St Gallen,6643,4,14,3,15,42,53,-11,45
FC Zürich,6643,5,11,11,10,44,35,9,44
FC Lugano,6643,6,9,8,15,31,48,-17,35
FC Thun,6643,7,9,6,17,44,62,-18,33
Grasshoppers,6643,8,8,7,17,39,52,-13,31
FC Sion,6643,9,7,8,17,39,54,-15,29
Young Boys,6644,1,22,7,3,73,35,38,73
FC Basel,6644,2,17,10,5,54,24,30,61
Lucerne,6644,3,14,8,10,45,42,3,50
St Gallen,6644,4,14,4,14,44,56,-12,46
FC Zürich,6644,5,9,11,12,38,37,1,38
FC Thun,6644,6,10,6,16,44,58,-14,36
FC Lugano,6644,7,9,7,16,29,47,-18,34
Grasshoppers,6644,8,8,7,17,39,54,-15,31
FC Sion,6644,9,7,8,17,43,56,-13,29
Young Boys,6645,1,22,7,3,74,36,38,73
FC Basel,6645,2,18,8,6,54,26,28,62
Lucerne,6645,3,13,8,11,41,44,-3,47
FC Zürich,6645,4,11,10,11,42,37,5,43
St Gallen,6645,5,13,4,15,45,59,-14,43
FC Thun,6645,6,9,8,15,43,55,-12,35
FC Lugano,6645,7,9,8,15,31,47,-16,35
Grasshoppers,6645,8,8,8,16,40,52,-12,32
FC Sion,6645,9,6,9,17,45,59,-14,27
Young Boys,6646,1,22,7,3,76,33,43,73
FC Basel,6646,2,17,9,6,55,26,29,60
Lucerne,6646,3,14,7,11,43,45,-2,49
St Gallen,6646,4,14,4,14,42,52,-10,46
FC Zürich,6646,5,10,10,12,40,40,0,40
Grasshoppers,6646,6,11,6,15,44,49,-5,39
FC Lugano,6646,7,10,6,16,31,49,-18,36
FC Thun,6646,8,9,6,17,45,62,-17,33
FC Sion,6646,9,6,7,19,38,58,-20,25
Young Boys,6647,1,20,8,4,70,39,31,68
FC Basel,6647,2,17,9,6,53,24,29,60
Lucerne,6647,3,14,8,10,42,42,0,50
FC Zürich,6647,4,12,9,11,45,37,8,45
St Gallen,6647,5,14,3,15,43,54,-11,45
FC Lugano,6647,6,10,6,16,30,50,-20,36
Grasshoppers,6647,7,9,7,16,40,50,-10,34
FC Thun,6647,8,9,5,18,43,60,-17,32
FC Sion,6647,9,7,9,16,47,57,-10,30
Young Boys,6648,1,22,7,3,71,35,36,73
FC Basel,6648,2,17,9,6,55,25,30,60
St Gallen,6648,3,15,3,14,43,53,-10,48
Lucerne,6648,4,13,8,11,46,43,3,47
FC Zürich,6648,5,12,10,10,42,34,8,46
FC Lugano,6648,6,10,6,16,30,47,-17,36
Grasshoppers,6648,7,9,7,16,41,54,-13,34
FC Thun,6648,8,8,6,18,41,63,-22,30
FC Sion,6648,9,6,8,18,40,55,-15,26
Young Boys,6649,1,19,9,4,70,39,31,66
FC Basel,6649,2,17,9,6,52,23,29,60
St Gallen,6649,3,15,4,13,44,52,-8,49
Lucerne,6649,4,13,9,10,44,42,2,48
FC Zürich,6649,5,10,12,10,39,34,5,42
Grasshoppers,6649,6,10,7,15,44,51,-7,37
FC Lugano,6649,7,9,9,14,32,47,-15,36
FC Thun,6649,8,9,6,17,41,59,-18,33
FC Sion,6649,9,6,7,19,40,59,-19,25
Young Boys,6650,1,22,7,3,72,33,39,73
FC Basel,6650,2,17,8,7,51,26,25,59
St Gallen,6650,3,17,2,13,44,50,-6,53
Lucerne,6650,4,11,10,11,38,41,-3,43
FC Zürich,6650,5,11,9,12,41,38,3,42
FC Lugano,6650,6,10,7,15,31,46,-15,37
FC Thun,6650,7,10,6,16,42,55,-13,36
Grasshoppers,6650,8,9,8,15,38,47,-9,35
FC Sion,6650,9,5,7,20,38,59,-21,22
Young Boys,6651,1,22,8,2,71,34,37,74
FC Basel,6651,2,18,9,5,51,21,30,63
St Gallen,6651,3,15,2,15,44,56,-12,47
Lucerne,6651,4,13,7,12,43,46,-3,46
FC Zürich,6651,5,12,9,11,43,35,8,45
Grasshoppers,6651,6,8,9,15,44,53,-9,33
FC Lugano,6651,7,9,5,18,31,52,-21,32
FC Thun,6651,8,8,7,17,39,57,-18,31
FC Sion,6651,9,7,8,17,47,59,-12,29
Young Boys,6652,1,22,7,3,74,33,41,73
FC Basel,6652,2,18,9,5,57,28,29,63
Lucerne,6652,3,13,8,11,40,46,-6,47
St Gallen,6652,4,14,4,14,43,54,-11,46
FC Zürich,6652,5,11,9,12,43,39,4,42
FC Thun,6652,6,10,5,17,46,60,-14,35
Grasshoppers,6652,7,9,6,17,40,51,-11,33
FC Lugano,6652,8,9,6,17,29,48,-19,33
FC Sion,6652,9,7,8,17,42,55,-13,29
Young Boys,6653,1,21,7,4,70,36,34,70
FC Basel,6653,2,19,8,5,58,25,33,65
Lucerne,6653,3,13,9,10,42,41,1,48
FC Lugano,6653,4,12,6,14,34,45,-11,42
St Gallen,6653,5,13,3,16,43,58,-15,42
FC Zürich,6653,6,10,10,12,39,37,2,40
FC Thun,6653,7,10,6,16,48,59,-11,36
Grasshoppers,6653,8,8,8,16,40,53,-13,32
FC Sion,6653,9,5,9,18,43,63,-20,24
Young Boys,6654,1,23,6,3,72,32,40,75
FC Basel,6654,2,16,9,7,52,27,25,57
St Gallen,6654,3,16,2,14,45,53,-8,50
Lucerne,6654,4,12,9,11,41,45,-4,45
FC Zürich,6654,5,11,10,11,43,37,6,43
Grasshoppers,6654,6,10,7,15,40,47,-7,37
FC Thun,6654,7,9,7,16,43,57,-14,34
FC Lugano,6654,8,9,6,17,30,51,-21,33
FC Sion,6654,9,6,8,18,39,56,-17,26
Young Boys,6655,1,21,8,3,71,34,37,71
FC Basel,6655,2,17,9,6,53,27,26,60
Lucerne,6655,3,12,9,11,40,43,-3,45
St Gallen,6655,4,13,3,16,42,57,-15,42
FC Zürich,6655,5,10,11,11,40,36,4,41
FC Thun,6655,6,11,5,16,46,59,-13,38
FC Lugano,6655,7,10,7,15,30,44,-14,37
Grasshoppers,6655,8,9,7,16,40,51,-11,34
FC Sion,6655,9,8,7,17,44,55,-11,31
Young Boys,6656,1,22,6,4,70,37,33,72
FC Basel,6656,2,18,9,5,57,24,33,63
Lucerne,6656,3,13,8,11,43,43,0,47
St Gallen,6656,4,14,4,14,46,56,-10,46
FC Zürich,6656,5,10,11,11,39,36,3,41
Grasshoppers,6656,6,10,7,15,40,46,-6,37
FC Lugano,6656,7,9,7,16,30,48,-18,34
FC Thun,6656,8,8,7,17,40,59,-19,31
FC Sion,6656,9,7,7,18,41,57,-16,28
Young Boys,6657,1,21,6,5,67,35,32,69
FC Basel,6657,2,20,7,5,62,23,39,67
Lucerne,6657,3,13,7,12,41,44,-3,46
St Gallen,6657,4,14,4,14,41,54,-13,46
FC Zürich,6657,5,11,10,11,41,36,5,43
Grasshoppers,6657,6,10,6,16,43,48,-5,36
FC Thun,6657,7,10,6,16,43,61,-18,36
FC Lugano,6657,8,9,6,17,30,49,-19,33
FC Sion,6657,9,6,8,18,40,58,-18,26
Young Boys,6658,1,21,7,4,71,35,36,70
FC Basel,6658,2,18,8,6,60,31,29,62
Lucerne,6658,3,13,8,11,46,46,0,47
St Gallen,6658,4,14,2,16,42,56,-14,44
FC Zürich,6658,5,10,10,12,39,37,2,40
FC Thun,6658,6,10,7,15,44,57,-13,37
FC Lugano,6658,7,10,6,16,30,49,-19,36
Grasshoppers,6658,8,9,7,16,41,49,-8,34
FC Sion,6658,9,8,7,17,40,53,-13,31
Young Boys,6659,1,20,8,4,68,35,33,68
FC Basel,6659,2,19,7,6,57,23,34,64
Lucerne,6659,3,13,8,11,46,47,-1,47
St Gallen,6659,4,14,2,16,43,60,-17,44
FC Zürich,6659,5,10,11,11,42,38,4,41
FC Lugano,6659,6,10,8,14,35,46,-11,38
FC Thun,6659,7,10,6,16,44,58,-14,36
Grasshoppers,6659,8,9,8,15,40,50,-10,35
FC Sion,6659,9,5,10,17,40,58,-18,25
Young Boys,6660,1,23,6,3,73,32,41,75
FC Basel,6660,2,18,8,6,52,24,28,62
Lucerne,6660,3,14,7,11,43,41,2,49
FC Zürich,6660,4,12,10,10,48,38,10,46
St Gallen,6660,5,14,2,16,42,55,-13,44
Grasshoppers,6660,6,10,6,16,44,51,-7,36
FC Lugano,6660,7,10,5,17,30,50,-20,35
FC Thun,6660,8,9,5,18,40,61,-21,32
FC Sion,6660,9,6,7,19,40,60,-20,25
Young Boys,6661,1,19,8,5,67,37,30,65
FC Basel,6661,2,18,9,5,54,24,30,63
Lucerne,6661,3,15,8,9,47,39,8,53
FC Zürich,6661,4,11,9,12,43,40,3,42
St Gallen,6661,5,13,3,16,39,59,-20,42
FC Lugano,6661,6,11,6,15,34,46,-12,39
Grasshoppers,6661,7,10,6,16,40,48,-8,36
FC Thun,6661,8,9,6,17,42,59,-17,33
FC Sion,6661,9,6,9,17,39,53,-14,27
Young Boys,6662,1,23,6,3,77,37,40,75
FC Basel,6662,2,18,7,7,52,29,23,61
St Gallen,6662,3,14,4,14,44,55,-11,46
Lucerne,6662,4,12,8,12,44,44,0,44
FC Zürich,6662,5,10,10,12,40,37,3,40
Grasshoppers,6662,6,10,7,15,42,48,-6,37
FC Thun,6662,7,10,5,17,44,57,-13,35
FC Lugano,6662,8,9,7,16,30,52,-22,34
FC Sion,6662,9,7,8,17,41,55,-14,29
Young Boys,6663,1,21,7,4,71,37,34,70
FC Basel,6663,2,18,8,6,55,29,26,62
Lucerne,6663,3,15,7,10,46,39,7,52
St Gallen,6663,4,15,3,14,42,53,-11,48
FC Zürich,6663,5,9,11,12,38,37,1,38
Grasshoppers,6663,6,10,6,16,41,50,-9,36
FC Thun,6663,7,10,5,17,43,58,-15,35
FC Lugano,6663,8,9,6,17,32,50,-18,33
FC Sion,6663,9,6,9,17,38,53,-15,27
Young Boys,6664,1,20,6,6,67,40,27,66
FC Basel,6664,2,18,8,6,53,25,28,62
St Gallen,6664,3,15,3,14,45,55,-10,48
Lucerne,6664,4,13,7,12,42,47,-5,46
FC Zürich,6664,5,10,9,13,38,36,2,39
FC Lugano,6664,6,11,6,15,36,47,-11,39
Grasshoppers,6664,7,9,8,15,41,47,-6,35
FC Thun,6664,8,9,7,16,42,55,-13,34
FC Sion,6664,9,8,8,16,42,54,-12,32
Young Boys,6665,1,22,8,2,71,33,38,74
FC Basel,6665,2,18,8,6,56,26,30,62
Lucerne,6665,3,13,7,12,41,47,-6,46
St Gallen,6665,4,13,3,16,43,57,-14,42
FC Zürich,6665,5,10,9,13,37,35,2,39
FC Lugano,6665,6,11,5,16,30,45,-15,38
Grasshoppers,6665,7,10,7,15,43,48,-5,37
FC Thun,6665,8,10,5,17,42,59,-17,35
FC Sion,6665,9,7,8,17,41,54,-13,29
Young Boys,6666,1,22,7,3,74,34,40,73
FC Basel,6666,2,18,8,6,56,24,32,62
Lucerne,6666,3,13,7,12,45,51,-6,46
St Gallen,6666,4,14,3,15,43,58,-15,45
FC Zürich,6666,5,11,10,11,41,36,5,43
FC Lugano,6666,6,11,5,16,35,50,-15,38
Grasshoppers,6666,7,9,6,17,41,50,-9,33
FC Thun,6666,8,9,6,17,45,62,-17,33
FC Sion,6666,9,7,8,17,37,52,-15,29
Young Boys,6667,1,20,7,5,69,38,31,67
FC Basel,6667,2,19,7,6,60,28,32,64
St Gallen,6667,3,15,2,15,42,53,-11,47
Lucerne,6667,4,12,9,11,42,43,-1,45
FC Zürich,6667,5,10,11,11,40,39,1,41
FC Lugano,6667,6,11,6,15,31,46,-15,39
Grasshoppers,6667,7,9,7,16,43,51,-8,34
FC Thun,6667,8,9,6,17,45,61,-16,33
FC Sion,6667,9,8,7,17,40,53,-13,31
Young Boys,6668,1,20,7,5,68,41,27,67
FC Basel,6668,2,17,8,7,52,28,24,59
St Gallen,6668,3,16,3,13,49,53,-4,51
Lucerne,6668,4,12,10,10,42,45,-3,46
FC Zürich,6668,5,10,10,12,41,38,3,40
FC Thun,6668,6,11,5,16,46,58,-12,38
FC Lugano,6668,7,10,6,16,34,49,-15,36
Grasshoppers,6668,8,9,7,16,45,52,-7,34
FC Sion,6668,9,7,8,17,43,56,-13,29
Young Boys,6669,1,21,6,5,70,39,31,69
FC Basel,6669,2,19,8,5,55,22,33,65
St Gallen,6669,3,14,5,13,43,52,-9,47
Lucerne,6669,4,11,10,11,41,46,-5,43
FC Zürich,6669,5,10,10,12,41,38,3,40
Grasshoppers,6669,6,10,7,15,49,55,-6,37
FC Lugano,6669,7,10,7,15,33,48,-15,37
FC Sion,6669,8,8,7,17,44,55,-11,31
FC Thun,6669,9,8,6,18,41,62,-21,30
Young Boys,6670,1,22,7,3,75,32,43,73
FC Basel,6670,2,18,7,7,52,24,28,61
St Gallen,6670,3,16,2,14,48,52,-4,50
Lucerne,6670,4,12,8,12,41,46,-5,44
FC Zürich,6670,5,10,9,13,38,39,-1,39
FC Thun,6670,6,10,6,16,44,58,-14,36
FC Lugano,6670,7,10,6,16,30,51,-21,36
FC Sion,6670,8,8,8,16,44,54,-10,32
Grasshoppers,6670,9,8,7,17,37,53,-16,31
Young Boys,6671,1,23,7,2,75,34,41,76
FC Basel,6671,2,17,8,7,52,27,25,59
St Gallen,6671,3,16,3,13,46,52,-6,51
Lucerne,6671,4,12,8,12,43,47,-4,44
FC Zürich,6671,5,10,10,12,38,37,1,40
FC Lugano,6671,6,11,7,14,32,44,-12,40
FC Thun,6671,7,9,7,16,45,59,-14,34
Grasshoppers,6671,8,8,8,16,41,53,-12,32
FC Sion,6671,9,5,8,19,38,57,-19,23
Young Boys,6672,1,21,8,3,70,34,36,71
FC Basel,6672,2,18,7,7,55,28,27,61
St Gallen,6672,3,15,3,14,46,55,-9,48
Lucerne,6672,4,13,8,11,44,42,2,47
FC Zürich,6672,5,11,10,11,41,36,5,43
FC Lugano,6672,6,11,5,16,30,46,-16,38
FC Thun,6672,7,10,6,16,44,59,-15,36
Grasshoppers,6672,8,8,7,17,39,55,-16,31
FC Sion,6672,9,6,8,18,42,56,-14,26
Young Boys,6673,1,21,6,5,72,39,33,69
FC Basel,6673,2,18,8,6,57,28,29,62
Lucerne,6673,3,13,7,12,45,45,0,46
St Gallen,6673,4,14,4,14,43,56,-13,46
FC Zürich,6673,5,11,10,11,42,39,3,43
FC Thun,6673,6,11,5,16,52,59,-7,38
Grasshoppers,6673,7,10,7,15,43,51,-8,37
FC Lugano,6673,8,9,5,18,28,50,-22,32
FC Sion,6673,9,6,10,16,42,57,-15,28
Young Boys,6674,1,20,7,5,70,39,31,67
FC Basel,6674,2,18,9,5,58,24,34,63
St Gallen,6674,3,15,2,15,43,56,-13,47
Lucerne,6674,4,12,9,11,40,44,-4,45
FC Zürich,6674,5,10,11,11,40,39,1,41
FC Lugano,6674,6,11,7,14,35,46,-11,40
Grasshoppers,6674,7,9,7,16,39,48,-9,34
FC Thun,6674,8,9,7,16,43,58,-15,34
FC Sion,6674,9,5,11,16,39,53,-14,26
Young Boys,6675,1,21,8,3,69,33,36,71
FC Basel,6675,2,16,9,7,52,29,23,57
St Gallen,6675,3,14,4,14,46,58,-12,46
Lucerne,6675,4,12,8,12,37,42,-5,44
FC Zürich,6675,5,10,10,12,39,35,4,40
Grasshoppers,6675,6,11,6,15,45,52,-7,39
FC Thun,6675,7,10,7,15,49,58,-9,37
FC Lugano,6675,8,10,7,15,34,47,-13,37
FC Sion,6675,9,6,9,17,39,56,-17,27
Young Boys,6676,1,22,6,4,73,35,38,72
FC Basel,6676,2,16,8,8,53,30,23,56
St Gallen,6676,3,16,2,14,48,53,-5,50
Lucerne,6676,4,14,7,11,48,45,3,49
FC Thun,6676,5,12,5,15,45,55,-10,41
FC Zürich,6676,6,9,12,11,38,36,2,39
FC Lugano,6676,7,10,6,16,30,51,-21,36
Grasshoppers,6676,8,9,7,16,38,50,-12,34
FC Sion,6676,9,5,9,18,37,55,-18,24
Young Boys,6677,1,23,7,2,76,33,43,76
FC Basel,6677,2,17,8,7,57,27,30,59
St Gallen,6677,3,16,2,14,43,52,-9,50
Lucerne,6677,4,12,7,13,37,48,-11,43
FC Zürich,6677,5,10,11,11,42,37,5,41
Grasshoppers,6677,6,10,7,15,42,49,-7,37
FC Lugano,6677,7,10,6,16,32,48,-16,36
FC Thun,6677,8,8,8,16,44,61,-17,32
FC Sion,6677,9,6,8,18,39,57,-18,26
Young Boys,6678,1,21,8,3,73,35,38,71
FC Basel,6678,2,18,8,6,59,28,31,62
St Gallen,6678,3,15,3,14,44,55,-11,48
Lucerne,6678,4,11,10,11,40,46,-6,43
FC Zürich,6678,5,10,10,12,39,37,2,40
Grasshoppers,6678,6,10,8,14,41,47,-6,38
FC Lugano,6678,7,10,5,17,29,47,-18,35
FC Thun,6678,8,8,7,17,40,60,-20,31
FC Sion,6678,9,7,9,16,42,52,-10,30
Young Boys,6679,1,23,7,2,77,32,45,76
FC Basel,6679,2,18,7,7,56,30,26,61
Lucerne,6679,3,14,7,11,44,42,2,49
St Gallen,6679,4,14,3,15,40,52,-12,45
FC Zürich,6679,5,11,9,12,46,40,6,42
FC Thun,6679,6,11,5,16,47,60,-13,38
FC Lugano,6679,7,10,5,17,29,55,-26,35
Grasshoppers,6679,8,9,6,17,43,51,-8,33
FC Sion,6679,9,5,9,18,38,58,-20,24
Young Boys,6680,1,22,7,3,68,32,36,73
FC Basel,6680,2,18,8,6,52,24,28,62
Lucerne,6680,3,12,8,12,40,42,-2,44
St Gallen,6680,4,13,5,14,40,52,-12,44
FC Zürich,6680,5,11,9,12,43,36,7,42
FC Lugano,6680,6,11,6,15,30,45,-15,39
Grasshoppers,6680,7,10,6,16,43,51,-8,36
FC Thun,6680,8,10,5,17,43,58,-15,35
FC Sion,6680,9,6,8,18,39,58,-19,26
Young Boys,6681,1,21,7,4,70,35,35,70
FC Basel,6681,2,20,7,5,60,25,35,67
Lucerne,6681,3,12,8,12,40,45,-5,44
St Gallen,6681,4,13,4,15,43,59,-16,43
FC Zürich,6681,5,10,9,13,37,39,-2,39
Grasshoppers,6681,6,11,6,15,44,52,-8,39
FC Thun,6681,7,11,5,16,51,60,-9,38
FC Lugano,6681,8,9,7,16,29,47,-18,34
FC Sion,6681,9,7,7,18,44,56,-12,28
Young Boys,6682,1,23,6,3,74,34,40,75
FC Basel,6682,2,17,8,7,52,27,25,59
Lucerne,6682,3,14,7,11,44,44,0,49
St Gallen,6682,4,13,3,16,41,62,-21,42
FC Lugano,6682,5,12,5,15,35,47,-12,41
FC Zürich,6682,6,10,9,13,37,36,1,39
FC Thun,6682,7,11,5,16,47,61,-14,38
Grasshoppers,6682,8,9,6,17,44,53,-9,33
FC Sion,6682,9,7,7,18,45,55,-10,28
Young Boys,6683,1,19,9,4,70,39,31,66
FC Basel,6683,2,18,8,6,59,30,29,62
St Gallen,6683,3,14,3,15,43,56,-13,45
FC Zürich,6683,4,11,10,11,45,39,6,43
Lucerne,6683,5,11,9,12,40,48,-8,42
FC Lugano,6683,6,10,7,15,34,49,-15,37
Grasshoppers,6683,7,9,9,14,43,48,-5,36
FC Sion,6683,8,8,9,15,43,49,-6,33
FC Thun,6683,9,9,6,17,43,62,-19,33
Young Boys,6684,1,20,8,4,69,36,33,68
FC Basel,6684,2,19,8,5,57,23,34,65
Lucerne,6684,3,12,8,12,40,47,-7,44
St Gallen,6684,4,14,2,16,43,59,-16,44
FC Zürich,6684,5,10,12,10,39,33,6,42
FC Lugano,6684,6,11,5,16,34,48,-14,38
Grasshoppers,6684,7,10,6,16,42,51,-9,36
FC Thun,6684,8,10,6,16,41,56,-15,36
FC Sion,6684,9,6,9,17,40,52,-12,27
Young Boys,6685,1,21,7,4,70,35,35,70
FC Basel,6685,2,18,8,6,55,26,29,62
Lucerne,6685,3,13,7,12,43,44,-1,46
St Gallen,6685,4,14,3,15,41,53,-12,45
FC Zürich,6685,5,10,10,12,39,37,2,40
Grasshoppers,6685,6,11,6,15,44,51,-7,39
FC Lugano,6685,7,10,6,16,29,47,-18,36
FC Thun,6685,8,9,6,17,45,61,-16,33
FC Sion,6685,9,7,9,16,42,54,-12,30
Young Boys,6686,1,21,7,4,73,38,35,70
FC Basel,6686,2,20,7,5,58,22,36,67
St Gallen,6686,3,15,3,14,42,53,-11,48
Lucerne,6686,4,11,9,12,37,44,-7,42
FC Zürich,6686,5,10,10,12,39,37,2,40
Grasshoppers,6686,6,9,7,16,41,48,-7,34
FC Lugano,6686,7,9,7,16,32,51,-19,34
FC Thun,6686,8,9,6,17,42,60,-18,33
FC Sion,6686,9,7,10,15,40,51,-11,31
Young Boys,6687,1,21,7,4,77,44,33,70
FC Basel,6687,2,16,10,6,53,27,26,58
Lucerne,6687,3,14,8,10,49,43,6,50
FC Zürich,6687,4,12,10,10,43,35,8,46
St Gallen,6687,5,13,4,15,44,59,-15,43
Grasshoppers,6687,6,10,7,15,41,48,-7,37
FC Thun,6687,7,9,6,17,46,59,-13,33
FC Lugano,6687,8,9,6,17,33,56,-23,33
FC Sion,6687,9,7,8,17,42,57,-15,29
Young Boys,6688,1,24,6,2,76,31,45,78
FC Basel,6688,2,18,8,6,53,25,28,62
St Gallen,6688,3,16,2,14,48,55,-7,50
Lucerne,6688,4,12,8,12,44,46,-2,44
FC Zürich,6688,5,9,12,11,40,38,2,39
Grasshoppers,6688,6,10,6,16,41,53,-12,36
FC Lugano,6688,7,10,6,16,32,50,-18,36
FC Thun,6688,8,9,6,17,41,58,-17,33
FC Sion,6688,9,5,8,19,41,60,-19,23
Young Boys,6689,1,20,7,5,69,38,31,67
FC Basel,6689,2,19,7,6,55,25,30,64
St Gallen,6689,3,16,3,13,47,53,-6,51
FC Zürich,6689,4,12,9,11,45,39,6,45
Lucerne,6689,5,11,9,12,39,45,-6,42
Grasshoppers,6689,6,9,9,14,41,47,-6,36
FC Lugano,6689,7,10,6,16,33,49,-16,36
FC Thun,6689,8,9,6,17,41,56,-15,33
FC Sion,6689,9,6,8,18,40,58,-18,26
Young Boys,6690,1,21,8,3,72,34,38,71
FC Basel,6690,2,18,8,6,57,29,28,62
Lucerne,6690,3,13,7,12,42,46,-4,46
St Gallen,6690,4,14,3,15,42,54,-12,45
FC Lugano,6690,5,11,5,16,32,48,-16,38
FC Zürich,6690,6,9,10,13,42,43,-1,37
Grasshoppers,6690,7,9,8,15,41,48,-7,35
FC Sion,6690,8,8,9,15,41,51,-10,33
FC Thun,6690,9,8,8,16,41,57,-16,32
Young Boys,6691,1,21,7,4,72,39,33,70
FC Basel,6691,2,19,7,6,56,24,32,64
Lucerne,6691,3,14,7,11,45,43,2,49
St Gallen,6691,4,15,2,15,44,57,-13,47
FC Zürich,6691,5,10,9,13,38,38,0,39
Grasshoppers,6691,6,9,8,15,42,48,-6,35
FC Thun,6691,7,10,5,17,45,62,-17,35
FC Lugano,6691,8,10,5,17,32,51,-19,35
FC Sion,6691,9,7,8,17,42,54,-12,29
Young Boys,6692,1,22,7,3,71,31,40,73
FC Basel,6692,2,20,7,5,61,25,36,67
Lucerne,6692,3,13,7,12,40,43,-3,46
St Gallen,6692,4,14,4,14,44,55,-11,46
FC Zürich,6692,5,11,10,11,44,39,5,43
FC Thun,6692,6,9,6,17,42,61,-19,33
FC Lugano,6692,7,9,6,17,30,52,-22,33
Grasshoppers,6692,8,8,7,17,39,52,-13,31
FC Sion,6692,9,5,12,15,40,53,-13,27
Young Boys,6693,1,23,7,2,79,35,44,76
FC Basel,6693,2,18,8,6,55,25,30,62
Lucerne,6693,3,13,8,11,41,42,-1,47
St Gallen,6693,4,14,3,15,41,57,-16,45
FC Zürich,6693,5,11,10,11,41,35,6,43
FC Lugano,6693,6,10,5,17,32,49,-17,35
FC Thun,6693,7,9,6,17,41,59,-18,33
FC Sion,6693,8,8,7,17,42,58,-16,31
Grasshoppers,6693,9,8,6,18,40,52,-12,30
Young Boys,6694,1,22,7,3,73,34,39,73
FC Basel,6694,2,17,9,6,51,25,26,60
Lucerne,6694,3,12,11,9,42,41,1,47
St Gallen,6694,4,13,4,15,43,60,-17,43
FC Zürich,6694,5,10,11,11,41,35,6,41
FC Lugano,6694,6,11,7,14,32,45,-13,40
FC Thun,6694,7,9,7,16,45,59,-14,34
Grasshoppers,6694,8,9,6,17,38,52,-14,33
FC Sion,6694,9,6,8,18,44,58,-14,26
Young Boys,6695,1,22,6,4,69,31,38,72
FC Basel,6695,2,19,7,6,55,24,31,64
St Gallen,6695,3,15,2,15,43,55,-12,47
Lucerne,6695,4,12,8,12,42,47,-5,44
FC Zürich,6695,5,11,10,11,41,35,6,43
FC Lugano,6695,6,10,5,17,30,51,-21,35
FC Thun,6695,7,9,6,17,43,58,-15,33
Grasshoppers,6695,8,8,8,16,41,52,-11,32
FC Sion,6695,9,8,8,16,40,51,-11,32
Young Boys,6696,1,21,6,5,69,36,33,69
FC Basel,6696,2,16,9,7,49,24,25,57
St Gallen,6696,3,16,2,14,45,51,-6,50
Lucerne,6696,4,14,7,11,42,44,-2,49
FC Zürich,6696,5,10,11,11,40,36,4,41
FC Lugano,6696,6,11,5,16,31,46,-15,38
Grasshoppers,6696,7,10,6,16,42,51,-9,36
FC Thun,6696,8,9,7,16,43,59,-16,34
FC Sion,6696,9,7,7,18,41,55,-14,28
Young Boys,6697,1,20,9,3,71,36,35,69
FC Basel,6697,2,17,9,6,55,30,25,60
Lucerne,6697,3,13,9,10,43,41,2,48
St Gallen,6697,4,14,3,15,41,55,-14,45
FC Zürich,6697,5,10,10,12,42,39,3,40
FC Thun,6697,6,11,6,15,47,56,-9,39
FC Lugano,6697,7,10,7,15,34,49,-15,37
Grasshoppers,6697,8,8,9,15,41,50,-9,33
FC Sion,6697,9,6,8,18,38,56,-18,26
Young Boys,6698,1,22,6,4,67,37,30,72
FC Basel,6698,2,20,7,5,58,24,34,67
St Gallen,6698,3,15,3,14,46,53,-7,48
Lucerne,6698,4,11,10,11,40,44,-4,43
FC Zürich,6698,5,10,10,12,43,39,4,40
FC Thun,6698,6,10,6,16,46,61,-15,36
Grasshoppers,6698,7,9,8,15,41,48,-7,35
FC Lugano,6698,8,9,7,16,31,51,-20,34
FC Sion,6698,9,6,7,19,41,56,-15,25
Young Boys,6699,1,22,6,4,74,34,40,72
FC Basel,6699,2,19,8,5,60,25,35,65
Lucerne,6699,3,12,9,11,41,48,-7,45
St Gallen,6699,4,13,3,16,42,58,-16,42
FC Zürich,6699,5,10,11,11,40,36,4,41
FC Lugano,6699,6,11,6,15,32,48,-16,39
FC Sion,6699,7,8,9,15,44,52,-8,33
FC Thun,6699,8,9,6,17,42,61,-19,33
Grasshoppers,6699,9,8,6,18,38,51,-13,30
Young Boys,6700,1,21,8,3,68,35,33,71
FC Basel,6700,2,16,9,7,49,25,24,57
Lucerne,6700,3,13,9,10,41,42,-1,48
St Gallen,6700,4,14,3,15,43,56,-13,45
FC Zürich,6700,5,10,9,13,40,37,3,39
FC Lugano,6700,6,11,6,15,33,46,-13,39
Grasshoppers,6700,7,9,8,15,39,46,-7,35
FC Thun,6700,8,9,7,16,43,57,-14,34
FC Sion,6700,9,8,7,17,42,54,-12,31
Young Boys,6701,1,22,7,3,73,32,41,73
FC Basel,6701,2,18,7,7,51,26,25,61
FC Zürich,6701,3,12,9,11,46,35,11,45
Lucerne,6701,4,12,8,12,43,46,-3,44
St Gallen,6701,5,14,2,16,47,60,-13,44
FC Thun,6701,6,10,7,15,45,58,-13,37
FC Lugano,6701,7,10,5,17,33,53,-20,35
Grasshoppers,6701,8,8,8,16,39,53,-14,32
FC Sion,6701,9,7,9,16,44,58,-14,30
Young Boys,6702,1,22,7,3,71,35,36,73
FC Basel,6702,2,17,8,7,56,27,29,59
FC Zürich,6702,3,12,10,10,40,32,8,46
Lucerne,6702,4,12,9,11,40,41,-1,45
St Gallen,6702,5,13,4,15,42,56,-14,43
Grasshoppers,6702,6,10,8,14,40,45,-5,38
FC Lugano,6702,7,10,5,17,31,51,-20,35
FC Thun,6702,8,9,6,17,42,61,-19,33
FC Sion,6702,9,6,9,17,40,54,-14,27
Young Boys,6703,1,22,7,3,77,36,41,73
FC Basel,6703,2,20,7,5,59,24,35,67
Lucerne,6703,3,13,8,11,42,45,-3,47
St Gallen,6703,4,14,2,16,41,57,-16,44
FC Zürich,6703,5,11,9,12,39,39,0,42
Grasshoppers,6703,6,10,6,16,46,51,-5,36
FC Lugano,6703,7,10,6,16,31,49,-18,36
FC Thun,6703,8,9,5,18,45,60,-15,32
FC Sion,6703,9,6,8,18,40,59,-19,26
Young Boys,6704,1,21,7,4,70,37,33,70
FC Basel,6704,2,18,9,5,54,23,31,63
Lucerne,6704,3,12,8,12,41,44,-3,44
FC Lugano,6704,4,13,5,14,32,42,-10,44
St Gallen,6704,5,14,2,16,39,53,-14,44
FC Zürich,6704,6,10,10,12,43,38,5,40
Grasshoppers,6704,7,10,6,16,45,51,-6,36
FC Thun,6704,8,9,6,17,43,60,-17,33
FC Sion,6704,9,7,7,18,43,62,-19,28
Young Boys,6705,1,20,9,3,69,36,33,69
FC Basel,6705,2,16,11,5,52,25,27,59
Lucerne,6705,3,13,8,11,42,43,-1,47
St Gallen,6705,4,14,3,15,43,53,-10,45
FC Zürich,6705,5,10,11,11,42,38,4,41
FC Lugano,6705,6,11,6,15,30,46,-16,39
Grasshoppers,6705,7,10,7,15,41,47,-6,37
FC Thun,6705,8,9,6,17,44,59,-15,33
FC Sion,6705,9,6,9,17,41,57,-16,27
Young Boys,6706,1,22,6,4,74,34,40,72
FC Basel,6706,2,17,8,7,53,29,24,59
St Gallen,6706,3,17,2,13,47,49,-2,53
Lucerne,6706,4,13,7,12,41,46,-5,46
FC Zürich,6706,5,10,10,12,41,38,3,40
Grasshoppers,6706,6,11,6,15,47,48,-1,39
FC Lugano,6706,7,11,5,16,31,47,-16,38
FC Thun,6706,8,8,6,18,40,65,-25,30
FC Sion,6706,9,6,8,18,40,58,-18,26
Young Boys,6707,1,23,6,3,74,33,41,75
FC Basel,6707,2,17,9,6,52,27,25,60
Lucerne,6707,3,12,9,11,40,43,-3,45
St Gallen,6707,4,13,4,15,43,56,-13,43
FC Zürich,6707,5,10,11,11,41,35,6,41
FC Lugano,6707,6,12,5,15,32,45,-13,41
FC Sion,6707,7,8,8,16,45,52,-7,32
FC Thun,6707,8,9,5,18,39,63,-24,32
Grasshoppers,6707,9,8,7,17,40,52,-12,31
Young Boys,6708,1,22,6,4,71,38,33,72
FC Basel,6708,2,18,8,6,53,26,27,62
St Gallen,6708,3,16,2,14,44,52,-8,50
Lucerne,6708,4,13,7,12,47,46,1,46
FC Zürich,6708,5,10,11,11,42,38,4,41
FC Lugano,6708,6,11,5,16,34,48,-14,38
Grasshoppers,6708,7,10,7,15,43,51,-8,37
FC Thun,6708,8,9,5,18,42,59,-17,32
FC Sion,6708,9,5,9,18,37,55,-18,24
Young Boys,6709,1,22,6,4,71,35,36,72
FC Basel,6709,2,20,7,5,55,24,31,67
Lucerne,6709,3,13,7,12,41,45,-4,46
St Gallen,6709,4,14,3,15,45,56,-11,45
FC Zürich,6709,5,9,11,12,38,36,2,38
Grasshoppers,6709,6,10,7,15,42,50,-8,37
FC Thun,6709,7,10,5,17,42,55,-13,35
FC Lugano,6709,8,9,6,17,30,50,-20,33
FC Sion,6709,9,6,10,16,41,54,-13,28
Young Boys,6710,1,20,7,5,69,38,31,67
FC Basel,6710,2,18,8,6,55,27,28,62
St Gallen,6710,3,14,3,15,44,58,-14,45
Lucerne,6710,4,12,8,12,39,44,-5,44
FC Zürich,6710,5,11,10,11,44,37,7,43
Grasshoppers,6710,6,10,7,15,43,47,-4,37
FC Lugano,6710,7,10,7,15,31,46,-15,37
FC Thun,6710,8,10,6,16,44,59,-15,36
FC Sion,6710,9,7,8,17,40,53,-13,29
Young Boys,6711,1,21,7,4,71,38,33,70
FC Basel,6711,2,19,7,6,59,25,34,64
Lucerne,6711,3,13,8,11,42,45,-3,47
St Gallen,6711,4,13,3,16,41,57,-16,42
FC Zürich,6711,5,10,10,12,40,36,4,40
FC Lugano,6711,6,11,5,16,30,47,-17,38
Grasshoppers,6711,7,9,8,15,41,47,-6,35
FC Thun,6711,8,9,6,17,41,61,-20,33
FC Sion,6711,9,7,10,15,42,51,-9,31
Young Boys,6712,1,19,8,5,70,41,29,65
FC Basel,6712,2,17,8,7,54,27,27,59
Lucerne,6712,3,15,7,10,45,41,4,52
St Gallen,6712,4,15,3,14,44,54,-10,48
Grasshoppers,6712,5,11,7,14,42,47,-5,40
FC Zürich,6712,6,10,9,13,42,38,4,39
FC Lugano,6712,7,11,5,16,34,49,-15,38
FC Thun,6712,8,9,6,17,42,61,-19,33
FC Sion,6712,9,6,9,17,42,57,-15,27
Young Boys,6713,1,21,7,4,69,35,34,70
FC Basel,6713,2,18,7,7,53,27,26,61
Lucerne,6713,3,12,10,10,39,38,1,46
FC Zürich,6713,4,12,9,11,43,36,7,45
FC Lugano,6713,5,12,6,14,33,42,-9,42
St Gallen,6713,6,13,2,17,39,60,-21,41
Grasshoppers,6713,7,10,7,15,41,46,-5,37
FC Thun,6713,8,9,5,18,42,61,-19,32
FC Sion,6713,9,7,7,18,38,52,-14,28
Young Boys,6714,1,22,7,3,71,35,36,73
FC Basel,6714,2,17,9,6,54,24,30,60
Lucerne,6714,3,11,10,11,41,47,-6,43
St Gallen,6714,4,13,4,15,44,59,-15,43
FC Zürich,6714,5,10,12,10,43,35,8,42
FC Lugano,6714,6,9,8,15,30,46,-16,35
Grasshoppers,6714,7,9,7,16,40,50,-10,34
FC Sion,6714,8,9,7,16,44,55,-11,34
FC Thun,6714,9,9,6,17,43,59,-16,33
Young Boys,6715,1,22,8,2,73,35,38,74
FC Basel,6715,2,17,8,7,51,26,25,59
Lucerne,6715,3,14,8,10,45,41,4,50
St Gallen,6715,4,14,3,15,42,57,-15,45
FC Zürich,6715,5,10,11,11,41,37,4,41
FC Thun,6715,6,11,5,16,44,57,-13,38
Grasshoppers,6715,7,9,7,16,40,48,-8,34
FC Lugano,6715,8,9,6,17,29,49,-20,33
FC Sion,6715,9,6,8,18,42,57,-15,26
Young Boys,6716,1,21,6,5,69,38,31,69
FC Basel,6716,2,19,8,5,57,25,32,65
Lucerne,6716,3,14,7,11,41,41,0,49
FC Zürich,6716,4,11,9,12,44,37,7,42
St Gallen,6716,5,13,2,17,39,56,-17,41
FC Lugano,6716,6,11,5,16,31,46,-15,38
Grasshoppers,6716,7,10,7,15,43,50,-7,37
FC Thun,6716,8,8,8,16,42,59,-17,32
FC Sion,6716,9,7,8,17,40,54,-14,29
Young Boys,6717,1,21,7,4,75,39,36,70
FC Basel,6717,2,19,8,5,58,23,35,65
Lucerne,6717,3,14,8,10,45,43,2,50
St Gallen,6717,4,13,3,16,42,59,-17,42
FC Zürich,6717,5,10,11,11,42,39,3,41
FC Lugano,6717,6,11,5,16,33,49,-16,38
FC Thun,6717,7,10,6,16,46,57,-11,36
Grasshoppers,6717,8,8,7,17,42,56,-14,31
FC Sion,6717,9,7,7,18,39,57,-18,28
Young Boys,6718,1,22,8,2,70,33,37,74
FC Basel,6718,2,16,9,7,52,27,25,57
St Gallen,6718,3,14,4,14,42,53,-11,46
Lucerne,6718,4,12,9,11,41,44,-3,45
FC Zürich,6718,5,11,10,11,42,38,4,43
FC Lugano,6718,6,11,6,15,32,45,-13,39
Grasshoppers,6718,7,10,6,16,43,49,-6,36
FC Thun,6718,8,10,5,17,43,57,-14,35
FC Sion,6718,9,5,9,18,38,57,-19,24
Young Boys,6719,1,21,8,3,74,34,40,71
FC Basel,6719,2,17,8,7,55,29,26,59
Lucerne,6719,3,12,9,11,43,44,-1,45
St Gallen,6719,4,14,3,15,41,54,-13,45
FC Zürich,6719,5,11,11,10,41,35,6,44
Grasshoppers,6719,6,11,7,14,45,47,-2,40
FC Lugano,6719,7,10,6,16,30,49,-19,36
FC Thun,6719,8,9,7,16,42,58,-16,34
FC Sion,6719,9,6,7,19,39,60,-21,25
Young Boys,6720,1,23,7,2,74,32,42,76
FC Basel,6720,2,17,8,7,53,26,27,59
Lucerne,6720,3,14,7,11,46,47,-1,49
FC Zürich,6720,4,13,9,10,45,35,10,48
St Gallen,6720,5,13,3,16,43,59,-16,42
Grasshoppers,6720,6,10,6,16,41,51,-10,36
FC Lugano,6720,7,9,6,17,29,49,-20,33
FC Thun,6720,8,8,7,17,41,58,-17,31
FC Sion,6720,9,6,9,17,40,55,-15,27
Young Boys,6721,1,22,6,4,73,33,40,72
FC Basel,6721,2,18,7,7,55,29,26,61
Lucerne,6721,3,13,8,11,39,45,-6,47
St Gallen,6721,4,15,2,15,45,53,-8,47
FC Lugano,6721,5,12,5,15,33,46,-13,41
FC Zürich,6721,6,9,10,13,39,38,1,37
Grasshoppers,6721,7,10,7,15,46,48,-2,37
FC Thun,6721,8,10,6,16,44,58,-14,36
FC Sion,6721,9,5,9,18,38,62,-24,24
Young Boys,6722,1,20,9,3,68,34,34,69
FC Basel,6722,2,17,8,7,55,29,26,59
Lucerne,6722,3,13,8,11,43,45,-2,47
St Gallen,6722,4,14,3,15,44,56,-12,45
FC Zürich,6722,5,11,9,12,41,37,4,42
Grasshoppers,6722,6,11,6,15,43,49,-6,39
FC Lugano,6722,7,10,8,14,31,45,-14,38
FC Sion,6722,8,8,8,16,44,52,-8,32
FC Thun,6722,9,8,5,19,39,61,-22,29
Young Boys,6723,1,22,6,4,74,35,39,72
FC Basel,6723,2,16,8,8,51,29,22,56
St Gallen,6723,3,15,4,13,43,52,-9,49
Lucerne,6723,4,13,9,10,40,40,0,48
FC Zürich,6723,5,11,9,12,42,38,4,42
FC Thun,6723,6,11,6,15,48,55,-7,39
FC Lugano,6723,7,10,5,17,31,51,-20,35
Grasshoppers,6723,8,9,7,16,40,49,-9,34
FC Sion,6723,9,6,8,18,37,57,-20,26
Young Boys,6724,1,23,6,3,75,33,42,75
FC Basel,6724,2,19,7,6,57,23,34,64
St Gallen,6724,3,14,4,14,42,53,-11,46
Lucerne,6724,4,12,9,11,42,47,-5,45
FC Zürich,6724,5,10,9,13,40,40,0,39
FC Lugano,6724,6,10,6,16,33,52,-19,36
FC Thun,6724,7,10,5,17,44,59,-15,35
Grasshoppers,6724,8,9,7,16,41,52,-11,34
FC Sion,6724,9,7,7,18,39,54,-15,28
Young Boys,6725,1,21,7,4,70,37,33,70
FC Basel,6725,2,17,8,7,51,26,25,59
Lucerne,6725,3,14,8,10,44,42,2,50
St Gallen,6725,4,15,3,14,42,52,-10,48
FC Zürich,6725,5,11,9,12,42,35,7,42
FC Lugano,6725,6,11,5,16,31,46,-15,38
Grasshoppers,6725,7,9,6,17,43,52,-9,33
FC Thun,6725,8,9,5,18,41,62,-21,32
FC Sion,6725,9,8,7,17,42,54,-12,31
Young Boys,6726,1,22,6,4,70,36,34,72
FC Basel,6726,2,18,7,7,55,27,28,61
Lucerne,6726,3,12,8,12,41,45,-4,44
FC Zürich,6726,4,11,10,11,39,35,4,43
St Gallen,6726,5,13,4,15,40,54,-14,43
Grasshoppers,6726,6,11,6,15,46,49,-3,39
FC Lugano,6726,7,11,6,15,31,45,-14,39
FC Thun,6726,8,9,5,18,42,61,-19,32
FC Sion,6726,9,7,8,17,39,51,-12,29
Young Boys,6727,1,21,6,5,74,40,34,69
FC Basel,6727,2,17,7,8,53,27,26,58
Lucerne,6727,3,14,7,11,43,44,-1,49
St Gallen,6727,4,15,3,14,43,54,-11,48
FC Zürich,6727,5,11,9,12,41,37,4,42
FC Lugano,6727,6,11,5,16,34,49,-15,38
Grasshoppers,6727,7,10,6,16,41,47,-6,36
FC Thun,6727,8,9,6,17,43,61,-18,33
FC Sion,6727,9,7,9,16,40,53,-13,30
Young Boys,6728,1,23,7,2,73,35,38,76
FC Basel,6728,2,17,8,7,52,27,25,59
St Gallen,6728,3,15,2,15,43,56,-13,47
FC Zürich,6728,4,11,10,11,42,37,5,43
Lucerne,6728,5,12,7,13,42,46,-4,43
FC Lugano,6728,6,11,5,16,35,48,-13,38
FC Thun,6728,7,9,8,15,44,57,-13,35
FC Sion,6728,8,7,9,16,42,53,-11,30
Grasshoppers,6728,9,8,6,18,39,53,-14,30
Young Boys,6729,1,21,8,3,74,39,35,71
FC Basel,6729,2,16,10,6,54,30,24,58
FC Zürich,6729,3,13,9,10,44,34,10,48
Lucerne,6729,4,12,9,11,41,44,-3,45
St Gallen,6729,5,13,2,17,42,57,-15,41
Grasshoppers,6729,6,10,8,14,42,48,-6,38
FC Lugano,6729,7,10,6,16,34,51,-17,36
FC Thun,6729,8,9,6,17,42,58,-16,33
FC Sion,6729,9,7,8,17,41,53,-12,29
Young Boys,6730,1,21,8,3,67,34,33,71
FC Basel,6730,2,17,8,7,54,27,27,59
St Gallen,6730,3,15,3,14,44,54,-10,48
Lucerne,6730,4,11,9,12,40,47,-7,42
FC Zürich,6730,5,9,12,11,40,37,3,39
FC Lugano,6730,6,11,6,15,33,45,-12,39
FC Thun,6730,7,11,5,16,45,56,-11,38
Grasshoppers,6730,8,10,6,16,43,49,-6,36
FC Sion,6730,9,6,9,17,39,56,-17,27
Young Boys,6731,1,21,8,3,73,34,39,71
FC Basel,6731,2,17,9,6,52,27,25,60
Lucerne,6731,3,13,9,10,46,46,0,48
FC Zürich,6731,4,12,9,11,45,36,9,45
St Gallen,6731,5,14,3,15,47,58,-11,45
FC Lugano,6731,6,11,5,16,33,50,-17,38
FC Thun,6731,7,9,6,17,44,60,-16,33
Grasshoppers,6731,8,8,8,16,37,48,-11,32
FC Sion,6731,9,7,7,18,42,60,-18,28
Young Boys,6732,1,23,6,3,74,33,41,75
FC Basel,6732,2,18,8,6,54,27,27,62
Lucerne,6732,3,12,9,11,40,43,-3,45
St Gallen,6732,4,14,2,16,45,58,-13,44
FC Zürich,6732,5,11,9,12,41,36,5,42
Grasshoppers,6732,6,10,8,14,43,49,-6,38
FC Lugano,6732,7,10,5,17,30,51,-21,35
FC Thun,6732,8,9,5,18,40,57,-17,32
FC Sion,6732,9,7,8,17,41,54,-13,29
Young Boys,6733,1,21,9,2,75,38,37,72
FC Basel,6733,2,19,8,5,56,23,33,65
Lucerne,6733,3,12,10,10,40,42,-2,46
FC Zürich,6733,4,11,9,12,43,41,2,42
St Gallen,6733,5,13,3,16,39,54,-15,42
FC Lugano,6733,6,11,7,14,35,45,-10,40
FC Thun,6733,7,9,5,18,44,61,-17,32
FC Sion,6733,8,8,7,17,44,58,-14,31
Grasshoppers,6733,9,8,6,18,39,53,-14,30
Young Boys,6734,1,21,6,5,69,36,33,69
FC Basel,6734,2,17,10,5,55,25,30,61
Lucerne,6734,3,15,8,9,50,40,10,53
St Gallen,6734,4,14,4,14,41,53,-12,46
FC Zürich,6734,5,10,12,10,42,37,5,42
Grasshoppers,6734,6,10,6,16,43,53,-10,36
FC Lugano,6734,7,9,7,16,32,52,-20,34
FC Thun,6734,8,8,7,17,40,60,-20,31
FC Sion,6734,9,6,8,18,38,54,-16,26
Young Boys,6735,1,21,8,3,72,35,37,71
FC Basel,6735,2,17,9,6,55,26,29,60
FC Zürich,6735,3,11,11,10,42,35,7,44
St Gallen,6735,4,14,2,16,42,56,-14,44
Lucerne,6735,5,12,7,13,41,48,-7,43
FC Lugano,6735,6,11,6,15,31,46,-15,39
Grasshoppers,6735,7,10,7,15,42,50,-8,37
FC Thun,6735,8,8,8,16,42,58,-16,32
FC Sion,6735,9,7,8,17,44,57,-13,29
Young Boys,6736,1,22,7,3,77,37,40,73
FC Basel,6736,2,18,9,5,52,24,28,63
St Gallen,6736,3,14,4,14,42,53,-11,46
Grasshoppers,6736,4,12,6,14,45,49,-4,42
Lucerne,6736,5,11,8,13,40,47,-7,41
FC Lugano,6736,6,12,5,15,35,49,-14,41
FC Zürich,6736,7,10,9,13,40,37,3,39
FC Thun,6736,8,10,5,17,44,59,-15,35
FC Sion,6736,9,5,7,20,39,59,-20,22
Young Boys,6737,1,19,8,5,65,37,28,65
FC Basel,6737,2,17,8,7,54,29,25,59
Lucerne,6737,3,13,9,10,44,41,3,48
FC Zürich,6737,4,11,10,11,43,37,6,43
St Gallen,6737,5,13,4,15,40,59,-19,43
FC Lugano,6737,6,11,7,14,32,44,-12,40
FC Thun,6737,7,10,7,15,44,56,-12,37
Grasshoppers,6737,8,10,6,16,43,49,-6,36
FC Sion,6737,9,6,9,17,41,54,-13,27
Young Boys,6738,1,22,7,3,73,38,35,73
FC Basel,6738,2,17,9,6,56,29,27,60
St Gallen,6738,3,14,4,14,47,55,-8,46
Lucerne,6738,4,12,9,11,41,46,-5,45
FC Zürich,6738,5,10,11,11,40,37,3,41
Grasshoppers,6738,6,10,8,14,44,48,-4,38
FC Thun,6738,7,9,6,17,42,58,-16,33
FC Lugano,6738,8,9,6,17,31,50,-19,33
FC Sion,6738,9,7,8,17,40,53,-13,29
Young Boys,6739,1,22,6,4,74,36,38,72
FC Basel,6739,2,17,8,7,52,25,27,59
St Gallen,6739,3,16,2,14,43,52,-9,50
Lucerne,6739,4,13,8,11,42,41,1,47
FC Zürich,6739,5,11,10,11,42,38,4,43
Grasshoppers,6739,6,10,6,16,44,54,-10,36
FC Thun,6739,7,9,6,17,42,59,-17,33
FC Lugano,6739,8,9,5,18,29,51,-22,32
FC Sion,6739,9,8,7,17,43,55,-12,31
Young Boys,6740,1,21,8,3,71,34,37,71
FC Basel,6740,2,17,8,7,50,28,22,59
St Gallen,6740,3,16,2,14,45,51,-6,50
FC Zürich,6740,4,13,9,10,47,33,14,48
Lucerne,6740,5,12,7,13,39,46,-7,43
Grasshoppers,6740,6,10,7,15,42,46,-4,37
FC Thun,6740,7,9,7,16,42,59,-17,34
FC Lugano,6740,8,9,5,18,30,52,-22,32
FC Sion,6740,9,6,9,17,39,56,-17,27
Young Boys,6741,1,22,8,2,75,33,42,74
FC Basel,6741,2,19,8,5,57,25,32,65
Lucerne,6741,3,13,8,11,40,44,-4,47
St Gallen,6741,4,13,4,15,45,58,-13,43
FC Zürich,6741,5,11,9,12,44,40,4,42
FC Lugano,6741,6,10,7,15,36,54,-18,37
Grasshoppers,6741,7,9,7,16,41,52,-11,34
FC Thun,6741,8,9,5,18,46,62,-16,32
FC Sion,6741,9,6,8,18,40,56,-16,26
Young Boys,6742,1,22,6,4,70,35,35,72
FC Basel,6742,2,18,7,7,51,25,26,61
St Gallen,6742,3,15,2,15,43,53,-10,47
Lucerne,6742,4,12,9,11,42,44,-2,45
FC Zürich,6742,5,10,10,12,40,38,2,40
FC Thun,6742,6,11,5,16,46,60,-14,38
Grasshoppers,6742,7,9,7,16,42,51,-9,34
FC Lugano,6742,8,9,7,16,31,48,-17,34
FC Sion,6742,9,8,7,17,42,53,-11,31
Young Boys,6743,1,20,8,4,69,36,33,68
FC Basel,6743,2,18,8,6,59,25,34,62
St Gallen,6743,3,15,2,15,43,56,-13,47
Lucerne,6743,4,12,10,10,45,44,1,46
FC Zürich,6743,5,9,12,11,41,42,-1,39
FC Lugano,6743,6,11,6,15,32,47,-15,39
FC Thun,6743,7,10,6,16,46,59,-13,36
Grasshoppers,6743,8,8,9,15,41,51,-10,33
FC Sion,6743,9,6,9,17,39,55,-16,27
Young Boys,6744,1,23,6,3,73,32,41,75
FC Basel,6744,2,18,7,7,54,27,27,61
St Gallen,6744,3,16,2,14,44,52,-8,50
Lucerne,6744,4,11,8,13,39,50,-11,41
FC Zürich,6744,5,10,10,12,38,35,3,40
FC Thun,6744,6,11,6,15,44,56,-12,39
FC Lugano,6744,7,10,6,16,30,47,-17,36
Grasshoppers,6744,8,8,8,16,40,50,-10,32
FC Sion,6744,9,7,7,18,40,53,-13,28
Young Boys,6745,1,21,8,3,75,37,38,71
FC Basel,6745,2,20,7,5,58,24,34,67
St Gallen,6745,3,15,2,15,43,54,-11,47
Lucerne,6745,4,12,8,12,40,48,-8,44
FC Zürich,6745,5,10,10,12,39,36,3,40
FC Lugano,6745,6,10,6,16,29,46,-17,36
FC Thun,6745,7,9,7,16,42,56,-14,34
Grasshoppers,6745,8,8,9,15,41,52,-11,33
FC Sion,6745,9,7,7,18,43,57,-14,28
Young Boys,6746,1,20,8,4,72,36,36,68
FC Basel,6746,2,17,8,7,53,28,25,59
Lucerne,6746,3,14,7,11,41,46,-5,49
St Gallen,6746,4,13,3,16,42,58,-16,42
FC Lugano,6746,5,12,5,15,37,48,-11,41
Grasshoppers,6746,6,11,7,14,45,47,-2,40
FC Zürich,6746,7,10,9,13,43,41,2,39
FC Thun,6746,8,10,6,16,44,59,-15,36
FC Sion,6746,9,6,9,17,39,53,-14,27
Young Boys,6747,1,21,7,4,70,36,34,70
FC Basel,6747,2,16,8,8,53,31,22,56
Lucerne,6747,3,13,8,11,45,44,1,47
FC Zürich,6747,4,12,10,10,44,37,7,46
St Gallen,6747,5,14,3,15,44,57,-13,45
Grasshoppers,6747,6,10,6,16,43,52,-9,36
FC Thun,6747,7,10,6,16,45,56,-11,36
FC Lugano,6747,8,9,7,16,30,50,-20,34
FC Sion,6747,9,8,7,17,42,53,-11,31
Young Boys,6748,1,21,7,4,71,38,33,70
FC Basel,6748,2,20,7,5,59,25,34,67
Lucerne,6748,3,13,8,11,43,42,1,47
St Gallen,6748,4,15,2,15,44,59,-15,47
FC Zürich,6748,5,12,9,11,45,33,12,45
Grasshoppers,6748,6,9,6,17,42,52,-10,33
FC Thun,6748,7,9,6,17,43,60,-17,33
FC Lugano,6748,8,9,5,18,28,50,-22,32
FC Sion,6748,9,7,8,17,41,57,-16,29
Young Boys,6749,1,21,8,3,68,32,36,71
FC Basel,6749,2,18,9,5,56,27,29,63
Lucerne,6749,3,12,9,11,41,44,-3,45
St Gallen,6749,4,14,2,16,43,55,-12,44
FC Lugano,6749,5,12,5,15,32,46,-14,41
FC Zürich,6749,6,10,9,13,42,42,0,39
FC Sion,6749,7,9,8,15,45,51,-6,35
Grasshoppers,6749,8,9,6,17,38,49,-11,33
FC Thun,6749,9,8,6,18,42,61,-19,30
Young Boys,6750,1,22,6,4,72,36,36,72
FC Basel,6750,2,19,8,5,57,24,33,65
Lucerne,6750,3,12,8,12,40,45,-5,44
St Gallen,6750,4,14,2,16,44,60,-16,44
FC Zürich,6750,5,10,11,11,39,36,3,41
Grasshoppers,6750,6,10,8,14,43,48,-5,38
FC Lugano,6750,7,10,5,17,30,47,-17,35
FC Thun,6750,8,9,6,17,41,56,-15,33
FC Sion,6750,9,7,8,17,41,55,-14,29
Young Boys,6751,1,21,7,4,75,36,39,70
FC Basel,6751,2,18,8,6,56,25,31,62
St Gallen,6751,3,14,3,15,41,54,-13,45
Lucerne,6751,4,12,8,12,42,48,-6,44
FC Zürich,6751,5,11,10,11,42,35,7,43
Grasshoppers,6751,6,11,6,15,45,49,-4,39
FC Lugano,6751,7,10,6,16,28,49,-21,36
FC Thun,6751,8,9,5,18,42,63,-21,32
FC Sion,6751,9,7,9,16,40,52,-12,30
Young Boys,6752,1,22,6,4,75,36,39,72
FC Basel,6752,2,18,8,6,56,26,30,62
Lucerne,6752,3,14,8,10,43,43,0,50
St Gallen,6752,4,15,3,14,43,52,-9,48
FC Zürich,6752,5,10,10,12,39,39,0,40
FC Thun,6752,6,9,8,15,45,59,-14,35
Grasshoppers,6752,7,9,6,17,42,52,-10,33
FC Lugano,6752,8,9,5,18,30,52,-22,32
FC Sion,6752,9,7,8,17,41,55,-14,29
Young Boys,6753,1,22,6,4,72,36,36,72
FC Basel,6753,2,18,8,6,52,24,28,62
St Gallen,6753,3,15,3,14,43,55,-12,48
FC Zürich,6753,4,12,10,10,45,32,13,46
Lucerne,6753,5,13,7,12,44,47,-3,46
FC Thun,6753,6,10,5,17,44,56,-12,35
Grasshoppers,6753,7,9,6,17,42,54,-12,33
FC Lugano,6753,8,9,6,17,28,52,-24,33
FC Sion,6753,9,7,7,18,43,57,-14,28
Young Boys,6754,1,21,7,4,71,36,35,70
FC Basel,6754,2,18,9,5,52,22,30,63
Lucerne,6754,3,13,8,11,41,42,-1,47
St Gallen,6754,4,13,4,15,39,53,-14,43
FC Zürich,6754,5,9,10,13,38,38,0,37
FC Lugano,6754,6,10,6,16,29,46,-17,36
Grasshoppers,6754,7,9,8,15,43,50,-7,35
FC Sion,6754,8,9,8,15,44,53,-9,35
FC Thun,6754,9,9,6,17,41,58,-17,33
Young Boys,6755,1,22,8,2,73,32,41,74
FC Basel,6755,2,18,8,6,55,25,30,62
St Gallen,6755,3,15,2,15,45,57,-12,47
FC Zrich,6755,4,11,9,12,40,36,4,42
Lucerne,6755,5,11,8,13,38,45,-7,41
FC Lugano,6755,6,11,6,15,34,46,-12,39
FC Thun,6755,7,10,6,16,43,60,-17,36
Grasshoppers,6755,8,9,7,16,39,50,-11,34
FC Sion,6755,9,6,8,18,40,56,-16,26
Young Boys,6756,1,21,6,5,73,37,36,69
FC Basel,6756,2,19,7,6,61,26,35,64
Lucerne,6756,3,14,8,10,46,43,3,50
St Gallen,6756,4,13,4,15,45,60,-15,43
FC Zürich,6756,5,11,9,12,42,39,3,42
FC Lugano,6756,6,11,6,15,37,52,-15,39
FC Thun,6756,7,9,6,17,46,62,-16,33
Grasshoppers,6756,8,8,7,17,36,53,-17,31
FC Sion,6756,9,7,9,16,42,56,-14,30
Young Boys,6757,1,21,9,2,73,33,40,72
FC Basel,6757,2,17,8,7,51,27,24,59
FC Zürich,6757,3,13,9,10,45,35,10,48
Lucerne,6757,4,13,9,10,40,41,-1,48
St Gallen,6757,5,13,2,17,40,58,-18,41
FC Lugano,6757,6,10,6,16,34,51,-17,36
Grasshoppers,6757,7,8,9,15,39,51,-12,33
FC Thun,6757,8,9,6,17,44,58,-14,33
FC Sion,6757,9,6,10,16,39,51,-12,28
Young Boys,6758,1,23,6,3,74,35,39,75
FC Basel,6758,2,16,7,9,53,32,21,55
St Gallen,6758,3,15,2,15,43,55,-12,47
Lucerne,6758,4,13,7,12,47,46,1,46
FC Zürich,6758,5,11,10,11,42,36,6,43
FC Thun,6758,6,11,6,15,47,59,-12,39
FC Lugano,6758,7,11,5,16,32,50,-18,38
Grasshoppers,6758,8,9,6,17,40,51,-11,33
FC Sion,6758,9,7,7,18,43,57,-14,28
Young Boys,6759,1,21,7,4,70,36,34,70
FC Basel,6759,2,16,8,8,51,29,22,56
St Gallen,6759,3,15,3,14,44,53,-9,48
Lucerne,6759,4,12,9,11,40,43,-3,45
FC Zürich,6759,5,10,10,12,38,35,3,40
FC Sion,6759,6,9,8,15,43,50,-7,35
FC Thun,6759,7,9,8,15,42,56,-14,35
FC Lugano,6759,8,9,8,15,29,46,-17,35
Grasshoppers,6759,9,9,7,16,39,48,-9,34
Young Boys,6760,1,20,8,4,70,34,36,68
FC Basel,6760,2,19,7,6,56,24,32,64
Lucerne,6760,3,12,9,11,39,42,-3,45
St Gallen,6760,4,14,3,15,41,54,-13,45
FC Zürich,6760,5,11,10,11,42,37,5,43
FC Thun,6760,6,11,5,16,43,56,-13,38
Grasshoppers,6760,7,10,7,15,40,46,-6,37
FC Lugano,6760,8,10,5,17,32,51,-19,35
FC Sion,6760,9,6,8,18,38,57,-19,26
Young Boys,6761,1,23,6,3,75,37,38,75
FC Basel,6761,2,16,10,6,52,28,24,58
St Gallen,6761,3,14,5,13,47,53,-6,47
Lucerne,6761,4,12,9,11,39,45,-6,45
FC Zürich,6761,5,9,11,12,40,38,2,38
Grasshoppers,6761,6,10,6,16,43,50,-7,36
FC Lugano,6761,7,9,8,15,31,48,-17,35
FC Thun,6761,8,9,6,17,44,60,-16,33
FC Sion,6761,9,7,9,16,42,54,-12,30
Young Boys,6762,1,20,9,3,70,35,35,69
FC Basel,6762,2,18,7,7,61,27,34,61
Lucerne,6762,3,13,8,11,45,48,-3,47
St Gallen,6762,4,15,2,15,45,57,-12,47
FC Zürich,6762,5,12,9,11,42,37,5,45
FC Thun,6762,6,11,5,16,47,59,-12,38
FC Lugano,6762,7,11,5,16,32,49,-17,38
Grasshoppers,6762,8,8,8,16,39,49,-10,32
FC Sion,6762,9,5,9,18,37,57,-20,24
Young Boys,6763,1,22,7,3,66,31,35,73
FC Basel,6763,2,16,8,8,51,29,22,56
St Gallen,6763,3,16,3,13,44,51,-7,51
FC Zürich,6763,4,12,9,11,45,35,10,45
Lucerne,6763,5,11,10,11,38,42,-4,43
FC Thun,6763,6,11,6,15,46,58,-12,39
FC Lugano,6763,7,10,6,16,29,47,-18,36
Grasshoppers,6763,8,8,9,15,39,48,-9,33
FC Sion,6763,9,5,8,19,36,53,-17,23
Young Boys,6764,1,21,7,4,73,35,38,70
FC Basel,6764,2,18,8,6,53,24,29,62
Lucerne,6764,3,12,9,11,39,42,-3,45
St Gallen,6764,4,14,3,15,39,51,-12,45
FC Zürich,6764,5,11,9,12,43,41,2,42
FC Lugano,6764,6,11,6,15,30,47,-17,39
Grasshoppers,6764,7,10,6,16,43,51,-8,36
FC Thun,6764,8,10,5,17,45,62,-17,35
FC Sion,6764,9,7,7,18,45,57,-12,28
Young Boys,6765,1,23,6,3,73,34,39,75
FC Basel,6765,2,17,9,6,50,25,25,60
Lucerne,6765,3,14,8,10,43,41,2,50
St Gallen,6765,4,14,4,14,42,53,-11,46
FC Lugano,6765,5,11,5,16,32,47,-15,38
FC Zürich,6765,6,9,10,13,39,39,0,37
Grasshoppers,6765,7,9,6,17,40,51,-11,33
FC Thun,6765,8,9,6,17,43,62,-19,33
FC Sion,6765,9,7,8,17,44,54,-10,29
Young Boys,6766,1,21,6,5,72,35,37,69
FC Basel,6766,2,18,7,7,53,26,27,61
FC Zürich,6766,3,13,9,10,43,34,9,48
Lucerne,6766,4,13,8,11,43,45,-2,47
St Gallen,6766,5,14,4,14,41,52,-11,46
FC Lugano,6766,6,11,5,16,32,47,-15,38
Grasshoppers,6766,7,10,6,16,41,49,-8,36
FC Thun,6766,8,10,5,17,43,58,-15,35
FC Sion,6766,9,5,8,19,38,60,-22,23
Young Boys,6767,1,19,8,5,71,41,30,65
FC Basel,6767,2,17,8,7,59,32,27,59
Lucerne,6767,3,15,7,10,48,41,7,52
St Gallen,6767,4,16,2,14,45,51,-6,50
FC Zürich,6767,5,9,12,11,41,38,3,39
FC Thun,6767,6,10,6,16,45,60,-15,36
FC Lugano,6767,7,10,6,16,31,49,-18,36
FC Sion,6767,8,8,8,16,43,56,-13,32
Grasshoppers,6767,9,8,7,17,42,57,-15,31
Young Boys,6768,1,20,6,6,68,38,30,66
FC Basel,6768,2,17,10,5,54,25,29,61
St Gallen,6768,3,15,4,13,48,54,-6,49
Lucerne,6768,4,12,11,9,43,43,0,47
FC Zürich,6768,5,10,11,11,40,35,5,41
Grasshoppers,6768,6,11,7,14,45,50,-5,40
FC Lugano,6768,7,9,7,16,28,47,-19,34
FC Thun,6768,8,8,6,18,40,60,-20,30
FC Sion,6768,9,7,8,17,42,56,-14,29
Young Boys,6769,1,23,6,3,75,34,41,75
FC Basel,6769,2,17,8,7,56,31,25,59
Lucerne,6769,3,13,8,11,47,43,4,47
St Gallen,6769,4,13,2,17,41,61,-20,41
Grasshoppers,6769,5,11,7,14,43,46,-3,40
FC Zürich,6769,6,9,11,12,41,39,2,38
FC Lugano,6769,7,11,5,16,32,52,-20,38
FC Thun,6769,8,10,5,17,44,60,-16,35
FC Sion,6769,9,7,8,17,42,55,-13,29
Young Boys,6770,1,21,8,3,70,34,36,71
FC Basel,6770,2,19,7,6,60,27,33,64
Lucerne,6770,3,13,9,10,45,43,2,48
St Gallen,6770,4,15,3,14,48,57,-9,48
FC Zürich,6770,5,12,9,11,46,37,9,45
Grasshoppers,6770,6,9,8,15,41,47,-6,35
FC Thun,6770,7,9,6,17,46,62,-16,33
FC Lugano,6770,8,9,6,17,29,52,-23,33
FC Sion,6770,9,5,8,19,39,65,-26,23
Young Boys,6771,1,20,7,5,66,38,28,67
FC Basel,6771,2,18,9,5,56,26,30,63
St Gallen,6771,3,15,3,14,40,52,-12,48
Lucerne,6771,4,11,9,12,41,45,-4,42
FC Lugano,6771,5,12,5,15,33,46,-13,41
FC Zürich,6771,6,10,10,12,40,36,4,40
FC Thun,6771,7,10,6,16,46,59,-13,36
Grasshoppers,6771,8,9,8,15,42,48,-6,35
FC Sion,6771,9,7,7,18,41,55,-14,28
Young Boys,6772,1,21,8,3,70,38,32,71
FC Basel,6772,2,20,7,5,60,24,36,67
Lucerne,6772,3,14,7,11,47,43,4,49
FC Zürich,6772,4,11,9,12,42,39,3,42
St Gallen,6772,5,13,3,16,43,57,-14,42
Grasshoppers,6772,6,9,8,15,43,54,-11,35
FC Lugano,6772,7,10,5,17,31,50,-19,35
FC Thun,6772,8,9,6,17,43,60,-17,33
FC Sion,6772,9,6,9,17,41,55,-14,27
Young Boys,6773,1,21,7,4,69,37,32,70
FC Basel,6773,2,19,7,6,56,25,31,64
Lucerne,6773,3,12,10,10,39,40,-1,46
St Gallen,6773,4,14,3,15,43,53,-10,45
FC Zürich,6773,5,10,10,12,40,37,3,40
Grasshoppers,6773,6,10,7,15,43,50,-7,37
FC Lugano,6773,7,10,6,16,34,52,-18,36
FC Thun,6773,8,10,5,17,43,59,-16,35
FC Sion,6773,9,6,9,17,39,53,-14,27
Young Boys,6774,1,22,7,3,73,34,39,73
FC Basel,6774,2,18,7,7,52,24,28,61
St Gallen,6774,3,15,4,13,42,51,-9,49
FC Zürich,6774,4,13,9,10,43,34,9,48
Lucerne,6774,5,11,10,11,39,44,-5,43
Grasshoppers,6774,6,10,6,16,44,57,-13,36
FC Thun,6774,7,10,5,17,46,57,-11,35
FC Lugano,6774,8,9,6,17,30,48,-18,33
FC Sion,6774,9,5,8,19,43,63,-20,23
Young Boys,6775,1,21,7,4,70,37,33,70
FC Basel,6775,2,16,10,6,53,26,27,58
Lucerne,6775,3,14,8,10,44,42,2,50
St Gallen,6775,4,15,2,15,45,55,-10,47
FC Zürich,6775,5,11,11,10,42,33,9,44
FC Lugano,6775,6,11,5,16,36,50,-14,38
FC Thun,6775,7,8,8,16,40,59,-19,32
Grasshoppers,6775,8,8,7,17,41,52,-11,31
FC Sion,6775,9,7,8,17,36,53,-17,29
Young Boys,6776,1,22,6,4,75,38,37,72
FC Basel,6776,2,17,9,6,58,30,28,60
St Gallen,6776,3,17,2,13,51,52,-1,53
Lucerne,6776,4,11,9,12,41,49,-8,42
FC Zürich,6776,5,10,10,12,40,39,1,40
FC Thun,6776,6,10,6,16,45,57,-12,36
FC Lugano,6776,7,10,5,17,31,49,-18,35
Grasshoppers,6776,8,9,7,16,40,52,-12,34
FC Sion,6776,9,7,8,17,44,59,-15,29
Young Boys,6777,1,22,7,3,70,34,36,73
FC Basel,6777,2,16,9,7,50,27,23,57
Lucerne,6777,3,14,7,11,42,41,1,49
FC Zürich,6777,4,12,10,10,42,33,9,46
St Gallen,6777,5,14,2,16,42,56,-14,44
FC Lugano,6777,6,11,6,15,34,45,-11,39
Grasshoppers,6777,7,10,6,16,45,51,-6,36
FC Thun,6777,8,10,6,16,46,60,-14,36
FC Sion,6777,9,5,7,20,35,59,-24,22
Young Boys,6778,1,23,6,3,73,35,38,75
FC Basel,6778,2,17,8,7,51,28,23,59
Lucerne,6778,3,14,7,11,44,42,2,49
St Gallen,6778,4,14,3,15,46,57,-11,45
FC Zürich,6778,5,10,11,11,38,34,4,41
FC Thun,6778,6,11,6,15,47,57,-10,39
FC Lugano,6778,7,10,6,16,29,47,-18,36
Grasshoppers,6778,8,8,6,18,38,52,-14,30
FC Sion,6778,9,7,7,18,44,58,-14,28
Young Boys,6779,1,23,6,3,79,36,43,75
FC Basel,6779,2,19,7,6,55,28,27,64
Lucerne,6779,3,13,7,12,40,43,-3,46
St Gallen,6779,4,13,2,17,41,57,-16,41
FC Zürich,6779,5,10,10,12,40,37,3,40
Grasshoppers,6779,6,10,7,15,40,48,-8,37
FC Thun,6779,7,10,6,16,45,59,-14,36
FC Lugano,6779,8,10,5,17,33,51,-18,35
FC Sion,6779,9,7,8,17,41,55,-14,29
Young Boys,6780,1,20,8,4,68,35,33,68
FC Basel,6780,2,18,8,6,57,26,31,62
St Gallen,6780,3,14,4,14,41,52,-11,46
Lucerne,6780,4,12,8,12,43,47,-4,44
FC Zürich,6780,5,9,11,12,42,41,1,38
FC Lugano,6780,6,10,7,15,34,50,-16,37
FC Thun,6780,7,9,8,15,46,60,-14,35
Grasshoppers,6780,8,9,7,16,42,53,-11,34
FC Sion,6780,9,8,9,15,42,51,-9,33
Young Boys,6781,1,23,7,2,70,30,40,76
FC Basel,6781,2,18,9,5,53,22,31,63
Lucerne,6781,3,12,8,12,40,44,-4,44
St Gallen,6781,4,13,3,16,41,56,-15,42
FC Zürich,6781,5,10,9,13,38,39,-1,39
FC Lugano,6781,6,11,6,15,35,48,-13,39
FC Thun,6781,7,10,6,16,42,56,-14,36
Grasshoppers,6781,8,9,6,17,38,50,-12,33
FC Sion,6781,9,7,8,17,42,54,-12,29
Young Boys,6782,1,23,6,3,78,36,42,75
FC Basel,6782,2,19,8,5,59,23,36,65
Lucerne,6782,3,14,8,10,44,45,-1,50
St Gallen,6782,4,15,2,15,44,57,-13,47
FC Zürich,6782,5,10,9,13,38,37,1,39
FC Thun,6782,6,11,5,16,45,58,-13,38
FC Lugano,6782,7,10,5,17,29,49,-20,35
Grasshoppers,6782,8,9,6,17,40,50,-10,33
FC Sion,6782,9,5,7,20,39,61,-22,22
Young Boys,6783,1,21,8,3,71,37,34,71
FC Basel,6783,2,17,9,6,56,26,30,60
Lucerne,6783,3,12,9,11,42,45,-3,45
FC Zürich,6783,4,11,11,10,43,35,8,44
St Gallen,6783,5,14,2,16,43,61,-18,44
FC Lugano,6783,6,10,6,16,35,49,-14,36
Grasshoppers,6783,7,8,9,15,38,48,-10,33
FC Thun,6783,8,8,8,16,41,59,-18,32
FC Sion,6783,9,7,10,15,41,50,-9,31
Young Boys,6784,1,19,10,3,69,36,33,67
FC Basel,6784,2,18,8,6,56,26,30,62
Lucerne,6784,3,13,9,10,41,41,0,48
St Gallen,6784,4,14,4,14,43,53,-10,46
FC Zürich,6784,5,12,9,11,40,35,5,45
FC Thun,6784,6,11,5,16,46,56,-10,38
Grasshoppers,6784,7,9,7,16,40,51,-11,34
FC Lugano,6784,8,9,6,17,28,49,-21,33
FC Sion,6784,9,6,8,18,41,57,-16,26
Young Boys,6785,1,22,8,2,73,32,41,74
FC Basel,6785,2,17,8,7,51,26,25,59
St Gallen,6785,3,15,3,14,42,52,-10,48
Lucerne,6785,4,12,9,11,41,43,-2,45
FC Zürich,6785,5,11,10,11,42,37,5,43
FC Lugano,6785,6,10,6,16,33,48,-15,36
FC Thun,6785,7,10,5,17,48,62,-14,35
Grasshoppers,6785,8,8,8,16,39,50,-11,32
FC Sion,6785,9,7,7,18,40,59,-19,28
Young Boys,6786,1,20,8,4,68,37,31,68
FC Basel,6786,2,18,7,7,53,25,28,61
Lucerne,6786,3,13,8,11,42,42,0,47
St Gallen,6786,4,14,3,15,39,53,-14,45
FC Zürich,6786,5,11,11,10,42,34,8,44
FC Lugano,6786,6,12,6,14,34,43,-9,42
Grasshoppers,6786,7,9,8,15,40,49,-9,35
FC Thun,6786,8,8,7,17,41,60,-19,31
FC Sion,6786,9,5,10,17,37,53,-16,25
Young Boys,6787,1,20,7,5,68,36,32,67
FC Basel,6787,2,19,8,5,56,25,31,65
Lucerne,6787,3,13,8,11,46,45,1,47
St Gallen,6787,4,14,4,14,43,55,-12,46
FC Zürich,6787,5,12,9,11,49,35,14,45
FC Thun,6787,6,10,6,16,42,56,-14,36
Grasshoppers,6787,7,9,7,16,40,51,-11,34
FC Lugano,6787,8,9,7,16,29,48,-19,34
FC Sion,6787,9,6,8,18,36,58,-22,26
Young Boys,6788,1,22,7,3,71,35,36,73
FC Basel,6788,2,18,8,6,53,24,29,62
Lucerne,6788,3,13,8,11,41,42,-1,47
St Gallen,6788,4,13,3,16,43,58,-15,42
Grasshoppers,6788,5,11,7,14,45,46,-1,40
FC Zürich,6788,6,10,9,13,40,38,2,39
FC Lugano,6788,7,11,5,16,34,48,-14,38
FC Thun,6788,8,10,5,17,43,60,-17,35
FC Sion,6788,9,6,8,18,39,58,-19,26
Young Boys,6789,1,21,7,4,72,38,34,70
FC Basel,6789,2,18,8,6,54,28,26,62
Lucerne,6789,3,14,8,10,49,41,8,50
St Gallen,6789,4,14,2,16,42,58,-16,44
FC Zürich,6789,5,10,11,11,37,34,3,41
FC Thun,6789,6,10,6,16,44,57,-13,36
FC Lugano,6789,7,10,5,17,30,51,-21,35
Grasshoppers,6789,8,8,9,15,41,50,-9,33
FC Sion,6789,9,6,10,16,38,50,-12,28
Young Boys,6790,1,20,10,2,75,39,36,70
FC Basel,6790,2,18,8,6,58,25,33,62
Lucerne,6790,3,13,8,11,44,44,0,47
St Gallen,6790,4,14,2,16,39,56,-17,44
FC Zürich,6790,5,11,9,12,41,39,2,42
FC Lugano,6790,6,11,6,15,32,47,-15,39
Grasshoppers,6790,7,9,9,14,43,50,-7,36
FC Thun,6790,8,9,6,17,40,58,-18,33
FC Sion,6790,9,6,8,18,44,58,-14,26
Young Boys,6791,1,20,8,4,72,39,33,68
FC Basel,6791,2,17,9,6,55,27,28,60
St Gallen,6791,3,14,4,14,42,54,-12,46
FC Zürich,6791,4,12,9,11,41,34,7,45
Lucerne,6791,5,12,9,11,43,46,-3,45
FC Lugano,6791,6,11,6,15,33,46,-13,39
Grasshoppers,6791,7,8,9,15,41,50,-9,33
FC Thun,6791,8,9,6,17,41,59,-18,33
FC Sion,6791,9,6,10,16,40,53,-13,28
Young Boys,6792,1,22,6,4,71,38,33,72
FC Basel,6792,2,20,7,5,64,23,41,67
Lucerne,6792,3,14,8,10,47,43,4,50
St Gallen,6792,4,14,2,16,41,60,-19,44
FC Zürich,6792,5,10,10,12,39,38,1,40
FC Thun,6792,6,10,5,17,44,60,-16,35
FC Lugano,6792,7,9,6,17,29,50,-21,33
Grasshoppers,6792,8,8,8,16,43,55,-12,32
FC Sion,6792,9,7,8,17,44,55,-11,29
Young Boys,6793,1,21,7,4,69,34,35,70
FC Basel,6793,2,18,9,5,55,23,32,63
St Gallen,6793,3,15,2,15,45,56,-11,47
FC Zürich,6793,4,10,12,10,42,36,6,42
FC Lugano,6793,5,12,6,14,34,43,-9,42
Lucerne,6793,6,11,8,13,38,48,-10,41
Grasshoppers,6793,7,10,7,15,41,47,-6,37
FC Thun,6793,8,9,6,17,44,62,-18,33
FC Sion,6793,9,6,7,19,41,60,-19,25
Young Boys,6794,1,23,6,3,74,39,35,75
FC Basel,6794,2,17,9,6,57,25,32,60
St Gallen,6794,3,16,3,13,46,52,-6,51
Lucerne,6794,4,12,9,11,43,45,-2,45
FC Zürich,6794,5,11,10,11,44,38,6,43
FC Lugano,6794,6,10,6,16,29,46,-17,36
FC Thun,6794,7,9,6,17,44,62,-18,33
Grasshoppers,6794,8,8,7,17,38,50,-12,31
FC Sion,6794,9,6,8,18,40,58,-18,26
Young Boys,6795,1,22,7,3,79,39,40,73
FC Basel,6795,2,18,9,5,63,25,38,63
St Gallen,6795,3,14,3,15,44,61,-17,45
FC Zürich,6795,4,11,10,11,42,37,5,43
Lucerne,6795,5,11,8,13,41,51,-10,41
Grasshoppers,6795,6,11,6,15,46,51,-5,39
FC Lugano,6795,7,10,6,16,33,50,-17,36
FC Thun,6795,8,9,6,17,43,63,-20,33
FC Sion,6795,9,6,9,17,41,55,-14,27
Young Boys,6796,1,21,7,4,69,34,35,70
FC Basel,6796,2,19,7,6,55,25,30,64
Lucerne,6796,3,14,8,10,46,43,3,50
FC Zürich,6796,4,11,10,11,42,36,6,43
St Gallen,6796,5,13,2,17,43,59,-16,41
FC Lugano,6796,6,11,5,16,32,49,-17,38
FC Thun,6796,7,10,6,16,45,58,-13,36
FC Sion,6796,8,8,7,17,42,53,-11,31
Grasshoppers,6796,9,8,6,18,39,56,-17,30
Young Boys,6797,1,20,8,4,69,37,32,68
FC Basel,6797,2,19,7,6,54,25,29,64
Lucerne,6797,3,13,9,10,42,42,0,48
St Gallen,6797,4,14,3,15,40,53,-13,45
FC Zürich,6797,5,10,10,12,41,40,1,40
Grasshoppers,6797,6,10,7,15,44,48,-4,37
FC Lugano,6797,7,10,6,16,29,45,-16,36
FC Thun,6797,8,9,5,18,45,63,-18,32
FC Sion,6797,9,7,9,16,46,57,-11,30
Young Boys,6798,1,22,7,3,78,38,40,73
FC Basel,6798,2,17,9,6,55,26,29,60
Lucerne,6798,3,13,8,11,44,47,-3,47
St Gallen,6798,4,14,2,16,42,57,-15,44
FC Zürich,6798,5,10,11,11,41,36,5,41
FC Lugano,6798,6,11,6,15,35,46,-11,39
FC Thun,6798,7,11,5,16,47,64,-17,38
Grasshoppers,6798,8,8,7,17,42,56,-14,31
FC Sion,6798,9,7,7,18,42,56,-14,28
Young Boys,6799,1,22,8,2,77,31,46,74
FC Basel,6799,2,17,9,6,54,27,27,60
Lucerne,6799,3,12,9,11,39,42,-3,45
St Gallen,6799,4,13,4,15,39,53,-14,43
FC Zürich,6799,5,10,10,12,39,39,0,40
FC Thun,6799,6,11,6,15,45,55,-10,39
FC Lugano,6799,7,11,6,15,32,47,-15,39
Grasshoppers,6799,8,9,8,15,40,49,-9,35
FC Sion,6799,9,5,8,19,35,57,-22,23
Young Boys,6800,1,22,6,4,72,36,36,72
FC Basel,6800,2,19,7,6,56,26,30,64
Lucerne,6800,3,14,8,10,46,44,2,50
St Gallen,6800,4,14,2,16,43,58,-15,44
FC Zürich,6800,5,11,10,11,43,36,7,43
FC Lugano,6800,6,10,6,16,31,48,-17,36
Grasshoppers,6800,7,9,8,15,41,51,-10,35
FC Thun,6800,8,8,6,18,43,61,-18,30
FC Sion,6800,9,7,7,18,42,57,-15,28
Young Boys,6801,1,23,6,3,72,33,39,75
FC Basel,6801,2,18,7,7,55,27,28,61
FC Zürich,6801,3,12,10,10,44,35,9,46
Lucerne,6801,4,12,9,11,41,42,-1,45
St Gallen,6801,5,14,2,16,41,56,-15,44
Grasshoppers,6801,6,9,8,15,43,51,-8,35
FC Thun,6801,7,9,6,17,45,64,-19,33
FC Lugano,6801,8,9,6,17,29,49,-20,33
FC Sion,6801,9,7,8,17,41,54,-13,29
Young Boys,6802,1,23,7,2,78,34,44,76
FC Basel,6802,2,17,8,7,55,26,29,59
Lucerne,6802,3,14,8,10,42,43,-1,50
St Gallen,6802,4,14,4,14,39,50,-11,46
FC Zürich,6802,5,9,10,13,39,44,-5,37
FC Lugano,6802,6,10,7,15,30,47,-17,37
FC Thun,6802,7,10,5,17,43,58,-15,35
Grasshoppers,6802,8,8,7,17,37,48,-11,31
FC Sion,6802,9,7,8,17,39,52,-13,29
Young Boys,6803,1,22,7,3,73,36,37,73
FC Basel,6803,2,17,8,7,56,29,27,59
Lucerne,6803,3,14,9,9,41,38,3,51
St Gallen,6803,4,15,3,14,43,56,-13,48
FC Zürich,6803,5,10,11,11,41,36,5,41
Grasshoppers,6803,6,10,7,15,41,47,-6,37
FC Lugano,6803,7,9,6,17,28,48,-20,33
FC Thun,6803,8,9,5,18,42,59,-17,32
FC Sion,6803,9,6,8,18,39,55,-16,26
Young Boys,6804,1,22,7,3,73,35,38,73
FC Basel,6804,2,18,8,6,55,26,29,62
St Gallen,6804,3,16,2,14,47,55,-8,50
Lucerne,6804,4,13,7,12,43,44,-1,46
FC Thun,6804,5,11,5,16,45,58,-13,38
FC Lugano,6804,6,11,5,16,32,48,-16,38
FC Zürich,6804,7,9,10,13,40,39,1,37
Grasshoppers,6804,8,8,6,18,38,60,-22,30
FC Sion,6804,9,7,8,17,45,53,-8,29
Young Boys,6805,1,22,8,2,74,36,38,74
FC Basel,6805,2,18,9,5,58,25,33,63
St Gallen,6805,3,15,4,13,47,54,-7,49
Lucerne,6805,4,13,7,12,43,43,0,46
FC Zürich,6805,5,11,9,12,39,38,1,42
Grasshoppers,6805,6,10,7,15,49,51,-2,37
FC Thun,6805,7,10,5,17,43,63,-20,35
FC Lugano,6805,8,9,6,17,31,51,-20,33
FC Sion,6805,9,5,7,20,38,61,-23,22
Young Boys,6806,1,22,7,3,79,38,41,73
FC Basel,6806,2,17,10,5,53,25,28,61
St Gallen,6806,3,16,2,14,45,51,-6,50
Lucerne,6806,4,11,9,12,40,50,-10,42
FC Zürich,6806,5,10,10,12,39,37,2,40
Grasshoppers,6806,6,10,7,15,42,48,-6,37
FC Lugano,6806,7,10,6,16,32,47,-15,36
FC Thun,6806,8,9,6,17,42,59,-17,33
FC Sion,6806,9,7,7,18,42,59,-17,28
Young Boys,6807,1,23,6,3,71,32,39,75
FC Basel,6807,2,17,7,8,52,29,23,58
St Gallen,6807,3,17,2,13,48,50,-2,53
Lucerne,6807,4,13,7,12,40,44,-4,46
FC Zürich,6807,5,11,10,11,41,37,4,43
Grasshoppers,6807,6,9,7,16,39,48,-9,34
FC Thun,6807,7,9,7,16,41,57,-16,34
FC Lugano,6807,8,9,6,17,30,48,-18,33
FC Sion,6807,9,6,8,18,37,54,-17,26
Young Boys,6808,1,20,6,6,67,37,30,66
FC Basel,6808,2,18,8,6,58,29,29,62
Lucerne,6808,3,15,7,10,48,45,3,52
FC Zürich,6808,4,11,11,10,41,33,8,44
St Gallen,6808,5,13,3,16,40,56,-16,42
FC Lugano,6808,6,11,5,16,31,46,-15,38
Grasshoppers,6808,7,10,6,16,42,52,-10,36
FC Thun,6808,8,9,6,17,45,60,-15,33
FC Sion,6808,9,7,8,17,39,53,-14,29
Young Boys,6809,1,19,9,4,68,37,31,66
FC Basel,6809,2,19,7,6,52,24,28,64
St Gallen,6809,3,16,2,14,43,51,-8,50
Lucerne,6809,4,12,9,11,43,44,-1,45
FC Zürich,6809,5,10,10,12,41,37,4,40
FC Lugano,6809,6,10,7,15,33,49,-16,37
FC Thun,6809,7,10,5,17,45,60,-15,35
Grasshoppers,6809,8,8,8,16,39,50,-11,32
FC Sion,6809,9,8,7,17,41,53,-12,31
Young Boys,6810,1,21,6,5,70,36,34,69
FC Basel,6810,2,18,8,6,54,24,30,62
Lucerne,6810,3,13,8,11,43,44,-1,47
St Gallen,6810,4,13,5,14,38,52,-14,44
FC Zürich,6810,5,11,9,12,45,37,8,42
Grasshoppers,6810,6,10,7,15,41,48,-7,37
FC Lugano,6810,7,10,6,16,31,48,-17,36
FC Thun,6810,8,9,6,17,40,61,-21,33
FC Sion,6810,9,7,9,16,42,54,-12,30
Young Boys,6811,1,20,7,5,72,38,34,67
FC Basel,6811,2,16,9,7,51,27,24,57
Lucerne,6811,3,14,9,9,50,45,5,51
St Gallen,6811,4,15,3,14,45,55,-10,48
FC Zürich,6811,5,11,10,11,39,35,4,43
FC Lugano,6811,6,11,5,16,33,51,-18,38
Grasshoppers,6811,7,10,7,15,42,49,-7,37
FC Thun,6811,8,9,6,17,41,57,-16,33
FC Sion,6811,9,6,8,18,37,53,-16,26
Young Boys,6812,1,22,6,4,72,33,39,72
FC Basel,6812,2,20,7,5,60,26,34,67
St Gallen,6812,3,15,2,15,47,56,-9,47
Lucerne,6812,4,12,8,12,41,48,-7,44
FC Lugano,6812,5,11,6,15,32,48,-16,39
FC Zürich,6812,6,9,9,14,40,42,-2,36
Grasshoppers,6812,7,10,6,16,44,52,-8,36
FC Thun,6812,8,10,5,17,51,63,-12,35
FC Sion,6812,9,7,7,18,42,61,-19,28
Young Boys,6813,1,20,10,2,72,36,36,70
FC Basel,6813,2,17,9,6,54,27,27,60
St Gallen,6813,3,14,3,15,46,62,-16,45
FC Zürich,6813,4,11,11,10,42,32,10,44
Lucerne,6813,5,11,10,11,41,44,-3,43
Grasshoppers,6813,6,9,9,14,44,50,-6,36
FC Thun,6813,7,9,8,15,42,56,-14,35
FC Lugano,6813,8,9,8,15,31,47,-16,35
FC Sion,6813,9,6,8,18,45,63,-18,26
Young Boys,6814,1,21,8,3,73,37,36,71
FC Basel,6814,2,16,9,7,57,30,27,57
Lucerne,6814,3,13,9,10,42,45,-3,48
St Gallen,6814,4,14,4,14,44,55,-11,46
FC Zürich,6814,5,11,10,11,42,38,4,43
Grasshoppers,6814,6,10,7,15,41,49,-8,37
FC Thun,6814,7,10,6,16,48,60,-12,36
FC Lugano,6814,8,9,7,16,32,50,-18,34
FC Sion,6814,9,5,10,17,41,56,-15,25
Young Boys,6815,1,21,8,3,73,36,37,71
FC Basel,6815,2,16,9,7,51,28,23,57
Lucerne,6815,3,13,8,11,41,45,-4,47
St Gallen,6815,4,14,3,15,43,54,-11,45
FC Zürich,6815,5,11,10,11,40,33,7,43
FC Lugano,6815,6,12,5,15,34,46,-12,41
FC Thun,6815,7,10,6,16,43,56,-13,36
Grasshoppers,6815,8,9,7,16,43,51,-8,34
FC Sion,6815,9,6,8,18,39,58,-19,26
Young Boys,6816,1,24,6,2,72,32,40,78
FC Basel,6816,2,17,8,7,52,26,26,59
St Gallen,6816,3,14,4,14,42,54,-12,46
FC Zürich,6816,4,12,9,11,44,39,5,45
Lucerne,6816,5,11,8,13,41,47,-6,41
FC Thun,6816,6,11,5,16,49,60,-11,38
Grasshoppers,6816,7,10,6,16,44,51,-7,36
FC Lugano,6816,8,9,7,16,29,47,-18,34
FC Sion,6816,9,6,7,19,40,57,-17,25
Young Boys,6817,1,22,8,2,71,34,37,74
FC Basel,6817,2,17,9,6,54,25,29,60
Lucerne,6817,3,13,7,12,43,45,-2,46
St Gallen,6817,4,14,4,14,44,55,-11,46
FC Zürich,6817,5,10,10,12,42,36,6,40
FC Lugano,6817,6,11,6,15,33,46,-13,39
FC Thun,6817,7,9,7,16,43,60,-17,34
Grasshoppers,6817,8,8,7,17,39,50,-11,31
FC Sion,6817,9,6,10,16,42,60,-18,28
Young Boys,6818,1,22,6,4,74,37,37,72
FC Basel,6818,2,18,9,5,54,23,31,63
St Gallen,6818,3,15,4,13,47,52,-5,49
Lucerne,6818,4,13,7,12,44,44,0,46
FC Zürich,6818,5,10,10,12,39,36,3,40
FC Thun,6818,6,11,5,16,44,57,-13,38
Grasshoppers,6818,7,10,6,16,42,51,-9,36
FC Lugano,6818,8,9,6,17,30,53,-23,33
FC Sion,6818,9,6,7,19,37,58,-21,25
Young Boys,6819,1,23,7,2,76,31,45,76
FC Basel,6819,2,16,10,6,51,26,25,58
St Gallen,6819,3,16,3,13,46,52,-6,51
Lucerne,6819,4,13,8,11,43,41,2,47
FC Zürich,6819,5,10,10,12,40,36,4,40
FC Thun,6819,6,11,6,15,51,55,-4,39
FC Lugano,6819,7,9,6,17,28,53,-25,33
Grasshoppers,6819,8,8,7,17,38,55,-17,31
FC Sion,6819,9,5,9,18,37,61,-24,24
Young Boys,6820,1,23,6,3,76,34,42,75
FC Basel,6820,2,18,8,6,54,24,30,62
St Gallen,6820,3,15,3,14,42,52,-10,48
Lucerne,6820,4,13,8,11,46,48,-2,47
FC Zürich,6820,5,11,10,11,43,36,7,43
Grasshoppers,6820,6,10,6,16,45,53,-8,36
FC Thun,6820,7,9,5,18,41,60,-19,32
FC Lugano,6820,8,9,5,18,29,54,-25,32
FC Sion,6820,9,7,7,18,40,55,-15,28
Young Boys,6821,1,21,8,3,67,34,33,71
FC Basel,6821,2,18,9,5,53,23,30,63
St Gallen,6821,3,16,2,14,44,52,-8,50
Lucerne,6821,4,13,9,10,42,40,2,48
FC Zürich,6821,5,9,12,11,37,34,3,39
Grasshoppers,6821,6,9,7,16,43,52,-9,34
FC Thun,6821,7,9,7,16,47,62,-15,34
FC Lugano,6821,8,9,6,17,27,47,-20,33
FC Sion,6821,9,5,10,17,39,55,-16,25
Young Boys,6822,1,21,6,5,70,33,37,69
FC Basel,6822,2,18,9,5,54,24,30,63
St Gallen,6822,3,14,3,15,43,57,-14,45
Lucerne,6822,4,12,8,12,41,45,-4,44
FC Zürich,6822,5,11,10,11,41,36,5,43
Grasshoppers,6822,6,10,6,16,42,55,-13,36
FC Thun,6822,7,10,5,17,45,60,-15,35
FC Sion,6822,8,9,7,16,47,52,-5,34
FC Lugano,6822,9,9,6,17,28,49,-21,33
Young Boys,6823,1,23,7,2,77,36,41,76
FC Basel,6823,2,17,9,6,55,27,28,60
St Gallen,6823,3,15,3,14,46,53,-7,48
FC Zürich,6823,4,12,10,10,41,33,8,46
Lucerne,6823,5,13,7,12,43,47,-4,46
Grasshoppers,6823,6,10,7,15,41,47,-6,37
FC Lugano,6823,7,10,5,17,31,49,-18,35
FC Thun,6823,8,8,5,19,38,60,-22,29
FC Sion,6823,9,6,7,19,38,58,-20,25
Young Boys,6824,1,22,7,3,74,37,37,73
FC Basel,6824,2,15,9,8,50,28,22,54
Lucerne,6824,3,13,9,10,42,41,1,48
St Gallen,6824,4,14,2,16,41,57,-16,44
FC Zürich,6824,5,11,10,11,42,37,5,43
FC Lugano,6824,6,10,7,15,32,45,-13,37
Grasshoppers,6824,7,10,6,16,44,50,-6,36
FC Thun,6824,8,9,7,16,44,60,-16,34
FC Sion,6824,9,7,9,16,45,59,-14,30
Young Boys,6825,1,21,7,4,71,36,35,70
FC Basel,6825,2,19,7,6,58,25,33,64
FC Zürich,6825,3,12,9,11,43,36,7,45
Lucerne,6825,4,12,9,11,41,44,-3,45
St Gallen,6825,5,13,3,16,40,58,-18,42
FC Lugano,6825,6,10,6,16,31,48,-17,36
Grasshoppers,6825,7,9,7,16,39,51,-12,34
FC Sion,6825,8,8,9,15,41,50,-9,33
FC Thun,6825,9,9,5,18,42,58,-16,32
Young Boys,6826,1,21,7,4,68,34,34,70
FC Basel,6826,2,17,7,8,55,29,26,58
St Gallen,6826,3,15,3,14,44,54,-10,48
Lucerne,6826,4,13,7,12,42,46,-4,46
FC Zürich,6826,5,12,9,11,47,39,8,45
Grasshoppers,6826,6,11,6,15,44,47,-3,39
FC Lugano,6826,7,10,6,16,32,46,-14,36
FC Thun,6826,8,10,5,17,45,60,-15,35
FC Sion,6826,9,6,8,18,39,61,-22,26
Young Boys,6827,1,22,8,2,72,34,38,74
FC Basel,6827,2,17,9,6,56,27,29,60
St Gallen,6827,3,16,3,13,47,55,-8,51
FC Zürich,6827,4,11,10,11,44,38,6,43
Lucerne,6827,5,11,8,13,41,47,-6,41
FC Lugano,6827,6,10,6,16,33,51,-18,36
FC Thun,6827,7,10,5,17,41,59,-18,35
Grasshoppers,6827,8,9,7,16,41,50,-9,34
FC Sion,6827,9,6,8,18,39,53,-14,26
Young Boys,6828,1,23,7,2,70,31,39,76
FC Basel,6828,2,16,9,7,53,28,25,57
Lucerne,6828,3,15,7,10,46,39,7,52
St Gallen,6828,4,13,3,16,40,57,-17,42
FC Zürich,6828,5,10,10,12,42,39,3,40
FC Thun,6828,6,11,5,16,46,57,-11,38
FC Lugano,6828,7,10,5,17,32,50,-18,35
Grasshoppers,6828,8,9,7,16,41,54,-13,34
FC Sion,6828,9,7,7,18,39,54,-15,28
Young Boys,6829,1,22,7,3,75,35,40,73
FC Basel,6829,2,18,7,7,53,27,26,61
St Gallen,6829,3,14,4,14,45,56,-11,46
Lucerne,6829,4,12,8,12,43,45,-2,44
FC Zürich,6829,5,11,9,12,40,37,3,42
FC Lugano,6829,6,10,6,16,31,48,-17,36
FC Sion,6829,7,9,8,15,45,51,-6,35
FC Thun,6829,8,10,5,17,43,58,-15,35
Grasshoppers,6829,9,8,6,18,37,55,-18,30
Young Boys,6830,1,21,8,3,72,37,35,71
FC Basel,6830,2,17,8,7,54,24,30,59
Lucerne,6830,3,13,10,9,43,42,1,49
St Gallen,6830,4,15,3,14,42,52,-10,48
FC Zürich,6830,5,10,10,12,39,37,2,40
FC Lugano,6830,6,10,6,16,31,48,-17,36
Grasshoppers,6830,7,9,8,15,45,52,-7,35
FC Thun,6830,8,9,7,16,44,62,-18,34
FC Sion,6830,9,6,8,18,38,54,-16,26
Young Boys,6831,1,23,6,3,76,37,39,75
FC Basel,6831,2,16,9,7,51,30,21,57
Lucerne,6831,3,13,9,10,43,40,3,48
St Gallen,6831,4,13,4,15,41,56,-15,43
FC Zürich,6831,5,11,9,12,43,40,3,42
FC Lugano,6831,6,11,5,16,32,47,-15,38
FC Thun,6831,7,10,5,17,46,58,-12,35
Grasshoppers,6831,8,9,7,16,39,49,-10,34
FC Sion,6831,9,7,8,17,41,55,-14,29
Young Boys,6832,1,22,6,4,72,36,36,72
FC Basel,6832,2,17,8,7,50,25,25,59
Lucerne,6832,3,14,8,10,45,39,6,50
FC Zürich,6832,4,12,9,11,41,34,7,45
St Gallen,6832,5,14,3,15,42,56,-14,45
Grasshoppers,6832,6,9,8,15,39,47,-8,35
FC Lugano,6832,7,10,5,17,31,52,-21,35
FC Sion,6832,8,8,7,17,41,51,-10,31
FC Thun,6832,9,8,6,18,40,61,-21,30
Young Boys,6833,1,21,6,5,73,41,32,69
FC Basel,6833,2,18,8,6,60,26,34,62
Lucerne,6833,3,14,8,10,43,40,3,50
St Gallen,6833,4,13,4,15,42,58,-16,43
FC Zürich,6833,5,11,9,12,40,37,3,42
Grasshoppers,6833,6,10,7,15,43,47,-4,37
FC Lugano,6833,7,10,7,15,33,48,-15,37
FC Thun,6833,8,10,6,16,42,60,-18,36
FC Sion,6833,9,6,7,19,38,57,-19,25
Young Boys,6834,1,21,7,4,75,37,38,70
FC Basel,6834,2,18,8,6,54,27,27,62
St Gallen,6834,3,16,2,14,43,51,-8,50
FC Zürich,6834,4,12,9,11,46,39,7,45
Lucerne,6834,5,12,9,11,40,46,-6,45
Grasshoppers,6834,6,11,6,15,45,47,-2,39
FC Lugano,6834,7,10,6,16,33,52,-19,36
FC Thun,6834,8,9,5,18,41,60,-19,32
FC Sion,6834,9,5,8,19,37,55,-18,23
Young Boys,6835,1,21,6,5,70,33,37,69
FC Basel,6835,2,16,8,8,49,27,22,56
St Gallen,6835,3,15,3,14,42,52,-10,48
FC Zürich,6835,4,11,11,10,43,36,7,44
Lucerne,6835,5,12,8,12,40,47,-7,44
FC Thun,6835,6,11,6,15,48,57,-9,39
Grasshoppers,6835,7,10,7,15,42,50,-8,37
FC Lugano,6835,8,10,7,15,29,45,-16,37
FC Sion,6835,9,6,8,18,41,57,-16,26
Young Boys,6836,1,21,8,3,72,36,36,71
FC Basel,6836,2,18,7,7,53,28,25,61
FC Zürich,6836,3,12,9,11,44,36,8,45
Lucerne,6836,4,11,10,11,42,47,-5,43
St Gallen,6836,5,13,4,15,42,56,-14,43
FC Lugano,6836,6,12,5,15,35,47,-12,41
Grasshoppers,6836,7,10,7,15,42,46,-4,37
FC Thun,6836,8,9,6,17,43,60,-17,33
FC Sion,6836,9,5,10,17,36,53,-17,25
Young Boys,6837,1,22,8,2,74,33,41,74
FC Basel,6837,2,16,8,8,50,27,23,56
St Gallen,6837,3,16,3,13,45,50,-5,51
Lucerne,6837,4,12,10,10,42,40,2,46
FC Zürich,6837,5,11,10,11,43,38,5,43
Grasshoppers,6837,6,10,8,14,45,46,-1,38
FC Thun,6837,7,9,7,16,43,60,-17,34
FC Lugano,6837,8,9,5,18,30,57,-27,32
FC Sion,6837,9,6,7,19,39,60,-21,25
Young Boys,6838,1,22,6,4,73,36,37,72
FC Basel,6838,2,19,7,6,55,25,30,64
Lucerne,6838,3,13,8,11,43,44,-1,47
St Gallen,6838,4,15,2,15,45,55,-10,47
FC Zürich,6838,5,11,10,11,43,36,7,43
FC Lugano,6838,6,10,7,15,31,47,-16,37
FC Thun,6838,7,9,5,18,44,61,-17,32
FC Sion,6838,8,8,7,17,41,54,-13,31
Grasshoppers,6838,9,8,6,18,39,56,-17,30
Young Boys,6839,1,22,6,4,75,37,38,72
FC Basel,6839,2,15,10,7,51,29,22,55
St Gallen,6839,3,15,3,14,49,58,-9,48
Lucerne,6839,4,12,8,12,41,45,-4,44
FC Lugano,6839,5,12,5,15,36,49,-13,41
FC Zürich,6839,6,9,11,12,39,37,2,38
FC Thun,6839,7,11,5,16,48,55,-7,38
Grasshoppers,6839,8,10,7,15,42,53,-11,37
FC Sion,6839,9,6,9,17,40,58,-18,27
Young Boys,6840,1,21,6,5,69,38,31,69
FC Basel,6840,2,19,8,5,59,24,35,65
Lucerne,6840,3,11,11,10,40,43,-3,44
St Gallen,6840,4,13,4,15,40,53,-13,43
Grasshoppers,6840,5,11,7,14,45,46,-1,40
FC Zürich,6840,6,9,10,13,38,42,-4,37
FC Thun,6840,7,10,5,17,44,60,-16,35
FC Lugano,6840,8,9,8,15,31,47,-16,35
FC Sion,6840,9,8,7,17,40,53,-13,31
Young Boys,6841,1,22,6,4,73,36,37,72
FC Basel,6841,2,19,8,5,58,22,36,65
St Gallen,6841,3,14,3,15,42,55,-13,45
FC Zürich,6841,4,11,10,11,43,36,7,43
Lucerne,6841,5,11,8,13,37,45,-8,41
FC Lugano,6841,6,12,5,15,32,46,-14,41
Grasshoppers,6841,7,9,7,16,41,51,-10,34
FC Thun,6841,8,9,6,17,44,63,-19,33
FC Sion,6841,9,6,9,17,43,59,-16,27
Young Boys,6842,1,22,8,2,74,34,40,74
FC Basel,6842,2,16,9,7,51,25,26,57
St Gallen,6842,3,16,2,14,46,55,-9,50
Lucerne,6842,4,13,8,11,45,46,-1,47
FC Zürich,6842,5,11,9,12,41,36,5,42
FC Thun,6842,6,10,6,16,47,58,-11,36
FC Lugano,6842,7,10,5,17,31,51,-20,35
Grasshoppers,6842,8,8,7,17,40,53,-13,31
FC Sion,6842,9,7,8,17,42,59,-17,29
Young Boys,6843,1,22,8,2,76,35,41,74
FC Basel,6843,2,18,9,5,55,23,32,63
St Gallen,6843,3,14,4,14,43,54,-11,46
Lucerne,6843,4,12,8,12,41,47,-6,44
FC Zürich,6843,5,11,10,11,44,36,8,43
FC Lugano,6843,6,11,5,16,33,51,-18,38
Grasshoppers,6843,7,10,7,15,43,50,-7,37
FC Thun,6843,8,8,6,18,42,64,-22,30
FC Sion,6843,9,5,9,18,39,56,-17,24
Young Boys,6844,1,21,6,5,69,37,32,69
FC Basel,6844,2,17,7,8,50,26,24,58
Lucerne,6844,3,13,9,10,42,41,1,48
St Gallen,6844,4,14,4,14,44,55,-11,46
FC Zürich,6844,5,11,9,12,41,35,6,42
FC Lugano,6844,6,11,7,14,33,46,-13,40
FC Thun,6844,7,10,6,16,42,57,-15,36
Grasshoppers,6844,8,9,7,16,39,48,-9,34
FC Sion,6844,9,6,9,17,40,55,-15,27
Young Boys,6845,1,22,6,4,72,37,35,72
FC Basel,6845,2,16,7,9,53,30,23,55
St Gallen,6845,3,16,3,13,49,55,-6,51
Lucerne,6845,4,12,8,12,44,49,-5,44
FC Zürich,6845,5,10,11,11,40,35,5,41
FC Thun,6845,6,12,5,15,46,55,-9,41
FC Lugano,6845,7,10,7,15,33,48,-15,37
Grasshoppers,6845,8,9,7,16,40,51,-11,34
FC Sion,6845,9,6,8,18,39,56,-17,26
Young Boys,6846,1,21,7,4,71,36,35,70
FC Basel,6846,2,18,8,6,58,29,29,62
Lucerne,6846,3,12,9,11,40,43,-3,45
St Gallen,6846,4,13,6,13,43,54,-11,45
FC Zürich,6846,5,11,9,12,44,41,3,42
FC Lugano,6846,6,11,6,15,36,50,-14,39
FC Thun,6846,7,11,5,16,50,58,-8,38
Grasshoppers,6846,8,9,6,17,40,50,-10,33
FC Sion,6846,9,6,8,18,39,60,-21,26
Young Boys,6847,1,24,6,2,82,37,45,78
FC Basel,6847,2,17,9,6,53,27,26,60
Lucerne,6847,3,14,7,11,50,48,2,49
St Gallen,6847,4,13,2,17,42,60,-18,41
FC Zürich,6847,5,10,10,12,38,36,2,40
FC Lugano,6847,6,11,5,16,36,50,-14,38
FC Thun,6847,7,10,6,16,45,61,-16,36
Grasshoppers,6847,8,9,7,16,42,53,-11,34
FC Sion,6847,9,6,8,18,41,57,-16,26
Young Boys,6848,1,22,6,4,72,34,38,72
FC Basel,6848,2,18,9,5,54,24,30,63
Lucerne,6848,3,14,7,11,48,43,5,49
St Gallen,6848,4,14,3,15,44,56,-12,45
FC Zürich,6848,5,9,12,11,41,38,3,39
FC Sion,6848,6,9,8,15,42,50,-8,35
FC Thun,6848,7,9,7,16,44,57,-13,34
FC Lugano,6848,8,9,6,17,29,56,-27,33
Grasshoppers,6848,9,8,6,18,37,53,-16,30
Young Boys,6849,1,19,9,4,65,33,32,66
FC Basel,6849,2,18,8,6,52,25,27,62
Lucerne,6849,3,12,8,12,40,43,-3,44
St Gallen,6849,4,14,2,16,41,57,-16,44
FC Lugano,6849,5,12,6,14,35,45,-10,42
Grasshoppers,6849,6,10,8,14,42,46,-4,38
FC Zürich,6849,7,9,10,13,38,37,1,37
FC Thun,6849,8,9,7,16,43,58,-15,34
FC Sion,6849,9,8,8,16,41,53,-12,32
Young Boys,6850,1,21,7,4,68,34,34,70
FC Basel,6850,2,17,9,6,53,26,27,60
Lucerne,6850,3,13,8,11,43,44,-1,47
St Gallen,6850,4,14,3,15,42,56,-14,45
FC Zürich,6850,5,10,11,11,38,33,5,41
FC Lugano,6850,6,11,5,16,32,45,-13,38
Grasshoppers,6850,7,9,9,14,46,49,-3,36
FC Thun,6850,8,9,6,17,42,63,-21,33
FC Sion,6850,9,7,8,17,38,52,-14,29
Young Boys,6851,1,22,6,4,72,38,34,72
FC Basel,6851,2,16,7,9,49,27,22,55
Lucerne,6851,3,15,7,10,48,44,4,52
St Gallen,6851,4,15,4,13,45,52,-7,49
FC Zürich,6851,5,9,11,12,41,39,2,38
FC Thun,6851,6,10,7,15,43,56,-13,37
FC Lugano,6851,7,10,7,15,36,50,-14,37
Grasshoppers,6851,8,9,7,16,40,52,-12,34
FC Sion,6851,9,5,10,17,42,58,-16,25
Young Boys,6852,1,20,8,4,70,38,32,68
FC Basel,6852,2,16,10,6,50,24,26,58
Lucerne,6852,3,14,9,9,42,40,2,51
St Gallen,6852,4,13,4,15,42,55,-13,43
FC Lugano,6852,5,11,7,14,33,46,-13,40
FC Zürich,6852,6,9,12,11,38,35,3,39
FC Thun,6852,7,9,7,16,46,59,-13,34
FC Sion,6852,8,8,8,16,48,55,-7,32
Grasshoppers,6852,9,8,7,17,39,56,-17,31
Young Boys,6853,1,21,9,2,72,35,37,72
FC Basel,6853,2,18,9,5,57,25,32,63
St Gallen,6853,3,15,4,13,44,53,-9,49
Lucerne,6853,4,12,9,11,43,45,-2,45
FC Zürich,6853,5,10,11,11,41,38,3,41
FC Lugano,6853,6,10,6,16,32,49,-17,36
Grasshoppers,6853,7,9,7,16,42,50,-8,34
FC Thun,6853,8,9,5,18,42,62,-20,32
FC Sion,6853,9,6,8,18,37,53,-16,26
Young Boys,6854,1,21,8,3,72,33,39,71
FC Basel,6854,2,17,9,6,56,27,29,60
St Gallen,6854,3,15,3,14,44,53,-9,48
FC Zürich,6854,4,12,9,11,39,35,4,45
Lucerne,6854,5,12,8,12,40,46,-6,44
FC Lugano,6854,6,11,5,16,32,49,-17,38
Grasshoppers,6854,7,9,8,15,40,47,-7,35
FC Thun,6854,8,8,6,18,40,60,-20,30
FC Sion,6854,9,7,8,17,39,52,-13,29
Young Boys,6855,1,23,6,3,82,37,45,75
FC Basel,6855,2,19,7,6,55,26,29,64
St Gallen,6855,3,15,3,14,48,58,-10,48
Lucerne,6855,4,13,7,12,44,48,-4,46
FC Zürich,6855,5,11,11,10,44,37,7,44
Grasshoppers,6855,6,9,7,16,42,51,-9,34
FC Thun,6855,7,9,7,16,45,60,-15,34
FC Lugano,6855,8,9,6,17,34,57,-23,33
FC Sion,6855,9,5,8,19,38,58,-20,23
Young Boys,6856,1,21,8,3,70,34,36,71
FC Basel,6856,2,18,9,5,54,25,29,63
Lucerne,6856,3,13,8,11,44,44,0,47
St Gallen,6856,4,15,2,15,40,53,-13,47
FC Zürich,6856,5,10,11,11,43,38,5,41
Grasshoppers,6856,6,11,6,15,46,51,-5,39
FC Lugano,6856,7,9,6,17,30,50,-20,33
FC Sion,6856,8,7,9,16,40,51,-11,30
FC Thun,6856,9,8,5,19,41,62,-21,29
Young Boys,6857,1,22,7,3,70,35,35,73
FC Basel,6857,2,16,9,7,50,27,23,57
St Gallen,6857,3,16,3,13,50,52,-2,51
Lucerne,6857,4,12,7,13,39,46,-7,43
FC Lugano,6857,5,11,6,15,31,46,-15,39
FC Zürich,6857,6,9,11,12,40,38,2,38
FC Thun,6857,7,11,5,16,45,57,-12,38
Grasshoppers,6857,8,10,6,16,43,50,-7,36
FC Sion,6857,9,6,8,18,43,60,-17,26
Young Boys,6858,1,20,7,5,69,37,32,67
FC Basel,6858,2,18,9,5,56,25,31,63
Lucerne,6858,3,12,9,11,42,44,-2,45
St Gallen,6858,4,14,3,15,44,58,-14,45
FC Zürich,6858,5,10,11,11,39,35,4,41
Grasshoppers,6858,6,11,6,15,46,50,-4,39
FC Lugano,6858,7,11,5,16,30,46,-16,38
FC Thun,6858,8,9,6,17,44,60,-16,33
FC Sion,6858,9,7,8,17,40,55,-15,29
Young Boys,6859,1,21,7,4,74,42,32,70
FC Basel,6859,2,19,8,5,54,23,31,65
Lucerne,6859,3,14,8,10,47,39,8,50
St Gallen,6859,4,13,3,16,39,56,-17,42
FC Zürich,6859,5,10,9,13,42,40,2,39
FC Thun,6859,6,10,6,16,44,58,-14,36
FC Lugano,6859,7,10,5,17,31,51,-20,35
Grasshoppers,6859,8,9,7,16,46,56,-10,34
FC Sion,6859,9,8,7,17,45,57,-12,31
Young Boys,6860,1,21,7,4,73,35,38,70
FC Basel,6860,2,18,8,6,55,27,28,62
St Gallen,6860,3,16,2,14,48,52,-4,50
Lucerne,6860,4,12,7,13,43,55,-12,43
FC Zürich,6860,5,11,9,12,42,38,4,42
FC Thun,6860,6,10,7,15,44,57,-13,37
FC Lugano,6860,7,10,5,17,29,48,-19,35
Grasshoppers,6860,8,9,7,16,42,51,-9,34
FC Sion,6860,9,7,8,17,39,52,-13,29
Young Boys,6861,1,23,6,3,74,34,40,75
FC Basel,6861,2,17,7,8,51,27,24,58
St Gallen,6861,3,14,3,15,43,54,-11,45
Lucerne,6861,4,12,8,12,43,47,-4,44
FC Zürich,6861,5,11,9,12,43,39,4,42
FC Lugano,6861,6,11,6,15,32,47,-15,39
Grasshoppers,6861,7,9,8,15,43,50,-7,35
FC Thun,6861,8,9,6,17,42,58,-16,33
FC Sion,6861,9,8,7,17,41,56,-15,31
Young Boys,6862,1,22,8,2,73,33,40,74
FC Basel,6862,2,17,9,6,56,27,29,60
St Gallen,6862,3,14,2,16,42,59,-17,44
FC Zürich,6862,4,11,10,11,44,36,8,43
Lucerne,6862,5,11,7,14,38,49,-11,40
FC Lugano,6862,6,11,6,15,34,46,-12,39
Grasshoppers,6862,7,10,8,14,39,45,-6,38
FC Thun,6862,8,9,7,16,46,60,-14,34
FC Sion,6862,9,6,9,17,40,57,-17,27
Young Boys,6863,1,21,6,5,73,37,36,69
FC Basel,6863,2,19,7,6,56,27,29,64
FC Zürich,6863,3,12,10,10,44,34,10,46
Lucerne,6863,4,13,7,12,39,44,-5,46
St Gallen,6863,5,13,2,17,41,62,-21,41
FC Lugano,6863,6,11,5,16,34,48,-14,38
Grasshoppers,6863,7,10,6,16,45,52,-7,36
FC Sion,6863,8,8,8,16,44,53,-9,32
FC Thun,6863,9,9,5,18,43,62,-19,32
Young Boys,6864,1,22,7,3,74,36,38,73
FC Basel,6864,2,16,10,6,50,27,23,58
Lucerne,6864,3,15,8,9,48,42,6,53
St Gallen,6864,4,14,2,16,42,56,-14,44
FC Zürich,6864,5,10,10,12,39,35,4,40
Grasshoppers,6864,6,9,8,15,44,51,-7,35
FC Thun,6864,7,9,8,15,46,60,-14,35
FC Lugano,6864,8,9,5,18,28,51,-23,32
FC Sion,6864,9,7,8,17,42,55,-13,29
Young Boys,6865,1,21,7,4,69,34,35,70
FC Basel,6865,2,18,7,7,56,29,27,61
St Gallen,6865,3,15,3,14,44,54,-10,48
FC Zürich,6865,4,12,10,10,43,35,8,46
Lucerne,6865,5,13,7,12,40,44,-4,46
FC Lugano,6865,6,9,7,16,30,47,-17,34
Grasshoppers,6865,7,9,6,17,39,50,-11,33
FC Thun,6865,8,9,6,17,43,59,-16,33
FC Sion,6865,9,8,7,17,38,50,-12,31
Young Boys,6866,1,21,6,5,70,39,31,69
FC Basel,6866,2,20,7,5,61,24,37,67
St Gallen,6866,3,15,2,15,43,56,-13,47
Lucerne,6866,4,12,8,12,43,49,-6,44
FC Zürich,6866,5,11,10,11,43,38,5,43
Grasshoppers,6866,6,10,7,15,47,53,-6,37
FC Lugano,6866,7,10,5,17,32,50,-18,35
FC Thun,6866,8,9,6,17,46,62,-16,33
FC Sion,6866,9,6,9,17,42,56,-14,27
Young Boys,6867,1,21,8,3,69,34,35,71
FC Basel,6867,2,19,7,6,55,26,29,64
St Gallen,6867,3,15,2,15,44,56,-12,47
Lucerne,6867,4,12,8,12,40,44,-4,44
FC Zürich,6867,5,11,10,11,42,35,7,43
Grasshoppers,6867,6,10,8,14,43,47,-4,38
FC Lugano,6867,7,10,5,17,32,51,-19,35
FC Thun,6867,8,8,7,17,45,64,-19,31
FC Sion,6867,9,7,7,18,42,55,-13,28
Young Boys,6868,1,20,7,5,71,43,28,67
FC Basel,6868,2,17,8,7,51,26,25,59
St Gallen,6868,3,14,4,14,47,57,-10,46
Lucerne,6868,4,12,9,11,45,45,0,45
FC Zürich,6868,5,11,10,11,40,35,5,43
Grasshoppers,6868,6,11,6,15,44,48,-4,39
FC Thun,6868,7,11,6,15,41,53,-12,39
FC Lugano,6868,8,10,6,16,34,52,-18,36
FC Sion,6868,9,6,8,18,40,54,-14,26
Young Boys,6869,1,22,7,3,73,36,37,73
FC Basel,6869,2,17,7,8,54,28,26,58
St Gallen,6869,3,14,3,15,41,54,-13,45
Lucerne,6869,4,12,8,12,39,43,-4,44
FC Zürich,6869,5,11,9,12,41,37,4,42
FC Lugano,6869,6,11,6,15,32,47,-15,39
FC Thun,6869,7,11,5,16,43,57,-14,38
Grasshoppers,6869,8,9,7,16,41,50,-9,34
FC Sion,6869,9,7,8,17,42,54,-12,29
Young Boys,6870,1,24,6,2,77,31,46,78
FC Basel,6870,2,18,8,6,56,29,27,62
St Gallen,6870,3,15,2,15,48,56,-8,47
FC Zürich,6870,4,11,10,11,43,37,6,43
Lucerne,6870,5,12,7,13,41,46,-5,43
Grasshoppers,6870,6,10,7,15,42,47,-5,37
FC Thun,6870,7,9,5,18,43,63,-20,32
FC Lugano,6870,8,9,5,18,28,54,-26,32
FC Sion,6870,9,7,8,17,41,56,-15,29
Young Boys,6871,1,22,6,4,68,33,35,72
FC Basel,6871,2,18,8,6,53,23,30,62
St Gallen,6871,3,15,3,14,45,53,-8,48
Lucerne,6871,4,13,7,12,42,46,-4,46
FC Zürich,6871,5,10,12,10,42,36,6,42
Grasshoppers,6871,6,10,6,16,42,52,-10,36
FC Thun,6871,7,10,6,16,47,59,-12,36
FC Lugano,6871,8,9,6,17,29,49,-20,33
FC Sion,6871,9,6,8,18,40,57,-17,26
Young Boys,6872,1,21,6,5,68,36,32,69
FC Basel,6872,2,18,8,6,55,22,33,62
Lucerne,6872,3,15,8,9,44,38,6,53
St Gallen,6872,4,14,2,16,41,59,-18,44
FC Zürich,6872,5,11,10,11,45,37,8,43
Grasshoppers,6872,6,10,7,15,41,47,-6,37
FC Lugano,6872,7,10,6,16,31,50,-19,36
FC Thun,6872,8,9,5,18,44,61,-17,32
FC Sion,6872,9,6,8,18,41,60,-19,26
Young Boys,6873,1,23,6,3,72,32,40,75
FC Basel,6873,2,17,7,8,53,28,25,58
Lucerne,6873,3,14,7,11,46,44,2,49
St Gallen,6873,4,15,2,15,42,57,-15,47
FC Zürich,6873,5,10,11,11,43,37,6,41
Grasshoppers,6873,6,10,6,16,42,50,-8,36
FC Lugano,6873,7,10,6,16,33,50,-17,36
FC Thun,6873,8,9,6,17,43,61,-18,33
FC Sion,6873,9,7,7,18,42,57,-15,28
Young Boys,6874,1,23,7,2,80,36,44,76
FC Basel,6874,2,18,7,7,60,28,32,61
Lucerne,6874,3,14,7,11,43,45,-2,49
St Gallen,6874,4,15,2,15,45,56,-11,47
FC Zürich,6874,5,11,9,12,41,36,5,42
FC Lugano,6874,6,11,5,16,33,55,-22,38
Grasshoppers,6874,7,9,6,17,39,50,-11,33
FC Thun,6874,8,9,5,18,43,62,-19,32
FC Sion,6874,9,6,8,18,40,56,-16,26
Young Boys,6875,1,20,6,6,69,41,28,66
FC Basel,6875,2,18,8,6,55,27,28,62
Lucerne,6875,3,13,7,12,45,47,-2,46
St Gallen,6875,4,13,3,16,45,63,-18,42
FC Lugano,6875,5,12,5,15,36,43,-7,41
FC Zürich,6875,6,10,10,12,40,38,2,40
Grasshoppers,6875,7,11,6,15,47,52,-5,39
FC Thun,6875,8,10,5,17,42,58,-16,35
FC Sion,6875,9,8,8,16,48,58,-10,32
Young Boys,6876,1,23,6,3,73,35,38,75
FC Basel,6876,2,17,8,7,58,31,27,59
St Gallen,6876,3,15,2,15,46,54,-8,47
Lucerne,6876,4,12,9,11,40,42,-2,45
FC Zürich,6876,5,11,10,11,39,34,5,43
FC Lugano,6876,6,11,6,15,32,47,-15,39
Grasshoppers,6876,7,10,7,15,42,48,-6,37
FC Thun,6876,8,8,6,18,41,63,-22,30
FC Sion,6876,9,6,8,18,39,56,-17,26
Young Boys,6877,1,22,7,3,71,34,37,73
FC Basel,6877,2,18,8,6,55,24,31,62
Lucerne,6877,3,12,8,12,41,47,-6,44
St Gallen,6877,4,13,3,16,41,58,-17,42
FC Lugano,6877,5,12,5,15,36,46,-10,41
FC Zürich,6877,6,10,10,12,39,39,0,40
FC Thun,6877,7,10,6,16,42,55,-13,36
Grasshoppers,6877,8,9,7,16,41,49,-8,34
FC Sion,6877,9,7,8,17,41,55,-14,29
Young Boys,6878,1,22,6,4,72,37,35,72
FC Basel,6878,2,17,8,7,54,30,24,59
Lucerne,6878,3,12,9,11,42,46,-4,45
St Gallen,6878,4,14,3,15,45,56,-11,45
FC Zürich,6878,5,10,9,13,41,39,2,39
Grasshoppers,6878,6,10,7,15,42,47,-5,37
FC Lugano,6878,7,10,6,16,29,45,-16,36
FC Thun,6878,8,10,5,17,42,57,-15,35
FC Sion,6878,9,9,7,16,45,55,-10,34
Young Boys,6879,1,21,6,5,71,36,35,69
FC Basel,6879,2,17,8,7,54,28,26,59
Lucerne,6879,3,15,7,10,45,44,1,52
St Gallen,6879,4,15,2,15,44,54,-10,47
FC Zürich,6879,5,9,13,10,39,35,4,40
FC Lugano,6879,6,10,6,16,31,48,-17,36
Grasshoppers,6879,7,9,7,16,41,51,-10,34
FC Thun,6879,8,9,7,16,45,61,-16,34
FC Sion,6879,9,7,8,17,41,54,-13,29
Young Boys,6880,1,22,7,3,70,33,37,73
FC Basel,6880,2,20,7,5,57,22,35,67
Lucerne,6880,3,12,9,11,41,44,-3,45
St Gallen,6880,4,14,3,15,45,57,-12,45
FC Zürich,6880,5,11,10,11,44,34,10,43
FC Lugano,6880,6,9,7,16,30,49,-19,34
Grasshoppers,6880,7,8,8,16,40,50,-10,32
FC Thun,6880,8,8,7,17,42,65,-23,31
FC Sion,6880,9,6,10,16,43,58,-15,28
Young Boys,6881,1,21,7,4,68,34,34,70
FC Basel,6881,2,18,7,7,53,28,25,61
Lucerne,6881,3,13,8,11,43,44,-1,47
St Gallen,6881,4,14,3,15,44,57,-13,45
FC Zürich,6881,5,10,9,13,39,40,-1,39
FC Lugano,6881,6,11,6,15,32,45,-13,39
Grasshoppers,6881,7,10,7,15,44,49,-5,37
FC Thun,6881,8,10,5,17,46,61,-15,35
FC Sion,6881,9,7,8,17,44,55,-11,29
Young Boys,6882,1,21,7,4,70,37,33,70
FC Basel,6882,2,18,9,5,56,24,32,63
Lucerne,6882,3,14,8,10,48,43,5,50
FC Zürich,6882,4,11,10,11,41,35,6,43
St Gallen,6882,5,13,2,17,40,63,-23,41
Grasshoppers,6882,6,10,7,15,40,46,-6,37
FC Thun,6882,7,10,5,17,45,57,-12,35
FC Lugano,6882,8,10,5,17,33,50,-17,35
FC Sion,6882,9,7,7,18,39,57,-18,28
Young Boys,6883,1,20,8,4,66,35,31,68
FC Basel,6883,2,17,8,7,51,25,26,59
Lucerne,6883,3,14,9,9,47,40,7,51
FC Zürich,6883,4,12,9,11,48,37,11,45
St Gallen,6883,5,14,2,16,41,55,-14,44
Grasshoppers,6883,6,10,8,14,42,46,-4,38
FC Lugano,6883,7,10,6,16,32,49,-17,36
FC Thun,6883,8,9,5,18,43,61,-18,32
FC Sion,6883,9,7,7,18,38,60,-22,28
Young Boys,6884,1,20,7,5,68,37,31,67
FC Basel,6884,2,18,9,5,58,23,35,63
Lucerne,6884,3,12,10,10,42,41,1,46
St Gallen,6884,4,13,5,14,44,57,-13,44
FC Zürich,6884,5,10,10,12,39,34,5,40
FC Lugano,6884,6,11,6,15,31,47,-16,39
Grasshoppers,6884,7,10,7,15,40,49,-9,37
FC Thun,6884,8,10,6,16,42,59,-17,36
FC Sion,6884,9,6,8,18,38,55,-17,26
Young Boys,6885,1,21,6,5,69,36,33,69
FC Basel,6885,2,20,7,5,60,23,37,67
Lucerne,6885,3,15,7,10,47,41,6,52
St Gallen,6885,4,14,3,15,42,54,-12,45
FC Zürich,6885,5,11,10,11,40,37,3,43
Grasshoppers,6885,6,9,6,17,38,48,-10,33
FC Sion,6885,7,8,8,16,40,51,-11,32
FC Lugano,6885,8,9,5,18,29,54,-25,32
FC Thun,6885,9,8,6,18,40,61,-21,30
Young Boys,6886,1,19,9,4,69,38,31,66
FC Basel,6886,2,18,9,5,52,22,30,63
Lucerne,6886,3,13,8,11,45,46,-1,47
St Gallen,6886,4,14,3,15,40,54,-14,45
FC Zürich,6886,5,11,9,12,39,36,3,42
Grasshoppers,6886,6,11,7,14,44,47,-3,40
FC Lugano,6886,7,10,5,17,30,49,-19,35
FC Thun,6886,8,9,6,17,42,56,-14,33
FC Sion,6886,9,7,8,17,41,54,-13,29
Young Boys,6887,1,21,7,4,72,38,34,70
FC Basel,6887,2,19,8,5,56,26,30,65
Lucerne,6887,3,12,10,10,43,44,-1,46
St Gallen,6887,4,13,3,16,42,56,-14,42
FC Lugano,6887,5,11,6,15,34,48,-14,39
FC Zürich,6887,6,9,11,12,41,41,0,38
Grasshoppers,6887,7,10,7,15,44,50,-6,37
FC Thun,6887,8,9,6,17,44,59,-15,33
FC Sion,6887,9,6,10,16,40,54,-14,28
Young Boys,6888,1,21,7,4,70,39,31,70
FC Basel,6888,2,17,9,6,56,26,30,60
St Gallen,6888,3,14,5,13,44,53,-9,47
FC Zürich,6888,4,12,9,11,43,34,9,45
Lucerne,6888,5,12,8,12,40,46,-6,44
Grasshoppers,6888,6,10,6,16,45,50,-5,36
FC Thun,6888,7,10,6,16,45,58,-13,36
FC Lugano,6888,8,10,6,16,31,47,-16,36
FC Sion,6888,9,6,8,18,37,58,-21,26
Young Boys,6889,1,22,7,3,76,35,41,73
FC Basel,6889,2,19,8,5,57,23,34,65
St Gallen,6889,3,15,3,14,42,51,-9,48
FC Zürich,6889,4,11,10,11,44,38,6,43
Lucerne,6889,5,11,9,12,38,45,-7,42
FC Thun,6889,6,10,6,16,42,59,-17,36
Grasshoppers,6889,7,9,8,15,42,49,-7,35
FC Lugano,6889,8,9,7,16,31,52,-21,34
FC Sion,6889,9,5,8,19,38,58,-20,23
Young Boys,6890,1,22,7,3,72,35,37,73
FC Basel,6890,2,19,8,5,60,25,35,65
St Gallen,6890,3,15,3,14,47,55,-8,48
Lucerne,6890,4,12,7,13,40,47,-7,43
FC Zürich,6890,5,11,9,12,39,37,2,42
FC Lugano,6890,6,11,5,16,31,45,-14,38
Grasshoppers,6890,7,9,7,16,43,49,-6,34
FC Thun,6890,8,8,6,18,43,64,-21,30
FC Sion,6890,9,7,8,17,41,59,-18,29
Young Boys,6891,1,24,6,2,79,31,48,78
FC Basel,6891,2,18,7,7,54,30,24,61
Lucerne,6891,3,12,8,12,40,45,-5,44
FC Zürich,6891,4,11,10,11,41,34,7,43
St Gallen,6891,5,13,3,16,41,57,-16,42
FC Lugano,6891,6,11,5,16,34,52,-18,38
FC Sion,6891,7,9,7,16,42,53,-11,34
FC Thun,6891,8,9,6,17,43,58,-15,33
Grasshoppers,6891,9,8,6,18,38,52,-14,30
Young Boys,6892,1,22,8,2,70,30,40,74
FC Basel,6892,2,18,8,6,54,26,28,62
St Gallen,6892,3,15,2,15,41,53,-12,47
Lucerne,6892,4,12,10,10,43,43,0,46
FC Zürich,6892,5,11,10,11,42,37,5,43
Grasshoppers,6892,6,9,8,15,43,50,-7,35
FC Thun,6892,7,9,7,16,48,61,-13,34
FC Lugano,6892,8,9,6,17,31,52,-21,33
FC Sion,6892,9,6,7,19,37,57,-20,25
Young Boys,6893,1,23,6,3,77,34,43,75
FC Basel,6893,2,18,8,6,53,25,28,62
FC Zürich,6893,3,12,10,10,42,32,10,46
Lucerne,6893,4,12,9,11,40,45,-5,45
St Gallen,6893,5,13,4,15,42,56,-14,43
Grasshoppers,6893,6,9,7,16,43,52,-9,34
FC Thun,6893,7,9,6,17,42,60,-18,33
FC Lugano,6893,8,9,6,17,28,50,-22,33
FC Sion,6893,9,7,8,17,42,55,-13,29
Young Boys,6894,1,20,9,3,69,34,35,69
FC Basel,6894,2,18,8,6,57,27,30,62
St Gallen,6894,3,14,4,14,45,56,-11,46
FC Zürich,6894,4,12,9,11,46,34,12,45
Lucerne,6894,5,12,9,11,41,46,-5,45
FC Lugano,6894,6,9,7,16,29,49,-20,34
FC Sion,6894,7,8,9,15,42,51,-9,33
Grasshoppers,6894,8,8,8,16,38,49,-11,32
FC Thun,6894,9,9,5,18,40,61,-21,32
Young Boys,6895,1,22,6,4,70,35,35,72
FC Basel,6895,2,19,8,5,60,24,36,65
Lucerne,6895,3,12,9,11,40,43,-3,45
St Gallen,6895,4,14,3,15,42,59,-17,45
FC Zürich,6895,5,10,11,11,41,38,3,41
Grasshoppers,6895,6,10,7,15,42,48,-6,37
FC Lugano,6895,7,10,5,17,32,47,-15,35
FC Thun,6895,8,9,6,17,43,62,-19,33
FC Sion,6895,9,7,7,18,42,56,-14,28
Young Boys,6896,1,21,7,4,74,37,37,70
FC Basel,6896,2,17,9,6,56,27,29,60
Lucerne,6896,3,14,8,10,42,40,2,50
St Gallen,6896,4,13,3,16,41,59,-18,42
FC Zürich,6896,5,10,10,12,43,40,3,40
FC Lugano,6896,6,11,6,15,33,49,-16,39
FC Thun,6896,7,11,5,16,48,58,-10,38
Grasshoppers,6896,8,9,6,17,41,55,-14,33
FC Sion,6896,9,7,8,17,43,56,-13,29
Young Boys,6897,1,21,8,3,72,33,39,71
FC Basel,6897,2,20,7,5,55,23,32,67
Lucerne,6897,3,13,7,12,41,45,-4,46
St Gallen,6897,4,13,4,15,42,56,-14,43
FC Lugano,6897,5,11,6,15,30,45,-15,39
FC Thun,6897,6,11,5,16,47,60,-13,38
FC Zürich,6897,7,9,9,14,37,41,-4,36
Grasshoppers,6897,8,9,7,16,44,51,-7,34
FC Sion,6897,9,6,9,17,43,57,-14,27
Young Boys,6898,1,22,7,3,71,34,37,73
FC Basel,6898,2,17,8,7,58,31,27,59
Lucerne,6898,3,14,9,9,44,41,3,51
FC Zürich,6898,4,11,10,11,43,37,6,43
St Gallen,6898,5,13,2,17,39,57,-18,41
FC Lugano,6898,6,11,6,15,33,46,-13,39
Grasshoppers,6898,7,10,7,15,44,49,-5,37
FC Thun,6898,8,9,5,18,45,65,-20,32
FC Sion,6898,9,6,8,18,41,58,-17,26
Young Boys,6899,1,19,9,4,68,37,31,66
FC Basel,6899,2,17,9,6,53,28,25,60
Lucerne,6899,3,13,10,9,40,38,2,49
FC Zürich,6899,4,12,9,11,43,35,8,45
St Gallen,6899,5,14,3,15,44,56,-12,45
FC Lugano,6899,6,11,5,16,33,50,-17,38
FC Thun,6899,7,9,6,17,43,58,-15,33
Grasshoppers,6899,8,8,8,16,40,50,-10,32
FC Sion,6899,9,8,7,17,42,54,-12,31
Young Boys,6900,1,21,7,4,67,32,35,70
FC Basel,6900,2,20,7,5,59,21,38,67
Lucerne,6900,3,12,9,11,41,47,-6,45
St Gallen,6900,4,13,4,15,41,58,-17,43
Grasshoppers,6900,5,12,6,14,44,48,-4,42
FC Zürich,6900,6,10,9,13,40,41,-1,39
FC Lugano,6900,7,10,6,16,34,51,-17,36
FC Thun,6900,8,9,5,18,47,62,-15,32
FC Sion,6900,9,7,7,18,44,57,-13,28
Young Boys,6901,1,21,6,5,69,37,32,69
FC Basel,6901,2,20,7,5,54,22,32,67
Lucerne,6901,3,13,8,11,41,43,-2,47
St Gallen,6901,4,15,2,15,45,54,-9,47
FC Zürich,6901,5,11,10,11,42,36,6,43
FC Lugano,6901,6,10,7,15,32,47,-15,37
Grasshoppers,6901,7,10,6,16,39,47,-8,36
FC Thun,6901,8,8,5,19,41,63,-22,29
FC Sion,6901,9,7,7,18,44,58,-14,28
Young Boys,6902,1,21,8,3,69,31,38,71
FC Basel,6902,2,16,7,9,48,28,20,55
Lucerne,6902,3,13,8,11,44,45,-1,47
St Gallen,6902,4,15,2,15,46,57,-11,47
FC Zürich,6902,5,11,11,10,41,33,8,44
Grasshoppers,6902,6,11,6,15,42,49,-7,39
FC Thun,6902,7,10,6,16,46,56,-10,36
FC Lugano,6902,8,10,6,16,28,45,-17,36
FC Sion,6902,9,6,8,18,38,58,-20,26
Young Boys,6903,1,21,7,4,69,35,34,70
FC Basel,6903,2,18,8,6,55,23,32,62
FC Zürich,6903,3,12,9,11,43,38,5,45
Lucerne,6903,4,12,9,11,41,43,-2,45
St Gallen,6903,5,13,4,15,41,55,-14,43
Grasshoppers,6903,6,10,6,16,42,49,-7,36
FC Lugano,6903,7,10,6,16,34,49,-15,36
FC Thun,6903,8,10,5,17,44,60,-16,35
FC Sion,6903,9,7,8,17,40,57,-17,29
Young Boys,6904,1,24,6,2,81,34,47,78
FC Basel,6904,2,18,7,7,59,32,27,61
FC Zürich,6904,3,12,9,11,47,38,9,45
Lucerne,6904,4,12,8,12,42,48,-6,44
St Gallen,6904,5,13,4,15,43,57,-14,43
FC Thun,6904,6,11,5,16,50,60,-10,38
FC Lugano,6904,7,10,6,16,31,47,-16,36
Grasshoppers,6904,8,9,7,16,40,53,-13,34
FC Sion,6904,9,5,8,19,39,63,-24,23
Young Boys,6905,1,22,7,3,77,37,40,73
FC Basel,6905,2,18,8,6,57,27,30,62
FC Zürich,6905,3,12,9,11,43,36,7,45
Lucerne,6905,4,11,9,12,39,45,-6,42
FC Lugano,6905,5,12,6,14,32,44,-12,42
St Gallen,6905,6,13,3,16,39,55,-16,42
FC Thun,6905,7,10,5,17,43,59,-16,35
Grasshoppers,6905,8,9,7,16,43,53,-10,34
FC Sion,6905,9,6,8,18,40,57,-17,26
Young Boys,6906,1,22,8,2,71,34,37,74
FC Basel,6906,2,16,10,6,50,25,25,58
Lucerne,6906,3,13,8,11,43,43,0,47
St Gallen,6906,4,14,3,15,42,55,-13,45
FC Lugano,6906,5,11,6,15,38,49,-11,39
FC Zürich,6906,6,9,11,12,40,39,1,38
FC Thun,6906,7,10,6,16,44,56,-12,36
Grasshoppers,6906,8,9,6,17,37,51,-14,33
FC Sion,6906,9,6,10,16,38,51,-13,28
Young Boys,6907,1,22,7,3,73,35,38,73
FC Basel,6907,2,18,9,5,56,25,31,63
St Gallen,6907,3,16,2,14,48,54,-6,50
FC Zürich,6907,4,10,12,10,42,37,5,42
Lucerne,6907,5,11,8,13,40,46,-6,41
FC Thun,6907,6,10,7,15,48,58,-10,37
FC Lugano,6907,7,10,6,16,30,48,-18,36
Grasshoppers,6907,8,9,7,16,43,54,-11,34
FC Sion,6907,9,5,8,19,39,62,-23,23
Young Boys,6908,1,22,6,4,73,38,35,72
FC Basel,6908,2,18,8,6,55,27,28,62
St Gallen,6908,3,15,3,14,41,51,-10,48
FC Zürich,6908,4,12,10,10,43,34,9,46
Lucerne,6908,5,12,8,12,41,44,-3,44
FC Lugano,6908,6,9,7,16,30,49,-19,34
Grasshoppers,6908,7,9,6,17,40,51,-11,33
FC Thun,6908,8,9,5,18,41,59,-18,32
FC Sion,6908,9,8,7,17,42,53,-11,31
Young Boys,6909,1,20,6,6,68,40,28,66
FC Basel,6909,2,18,9,5,53,23,30,63
Lucerne,6909,3,13,10,9,42,41,1,49
St Gallen,6909,4,13,3,16,41,58,-17,42
Grasshoppers,6909,5,11,7,14,43,44,-1,40
FC Lugano,6909,6,11,6,15,35,45,-10,39
FC Zürich,6909,7,9,11,12,41,41,0,38
FC Thun,6909,8,9,7,16,45,59,-14,34
FC Sion,6909,9,6,9,17,38,55,-17,27
Young Boys,6910,1,22,8,2,75,33,42,74
FC Basel,6910,2,18,7,7,53,27,26,61
St Gallen,6910,3,15,2,15,43,55,-12,47
FC Zürich,6910,4,12,10,10,44,34,10,46
Lucerne,6910,5,11,8,13,41,48,-7,41
Grasshoppers,6910,6,10,7,15,41,49,-8,37
FC Lugano,6910,7,10,5,17,29,51,-22,35
FC Thun,6910,8,9,6,17,41,57,-16,33
FC Sion,6910,9,7,7,18,43,56,-13,28
Young Boys,6911,1,22,7,3,73,34,39,73
FC Basel,6911,2,17,8,7,55,28,27,59
St Gallen,6911,3,15,4,13,46,52,-6,49
Lucerne,6911,4,13,9,10,44,45,-1,48
FC Zürich,6911,5,10,12,10,39,34,5,42
FC Thun,6911,6,9,7,16,40,60,-20,34
FC Lugano,6911,7,9,5,18,30,51,-21,32
Grasshoppers,6911,8,8,7,17,39,51,-12,31
FC Sion,6911,9,6,11,15,38,49,-11,29
Young Boys,6912,1,22,6,4,74,34,40,72
FC Basel,6912,2,16,8,8,54,29,25,56
St Gallen,6912,3,15,3,14,45,55,-10,48
FC Zürich,6912,4,11,10,11,40,36,4,43
Lucerne,6912,5,11,9,12,43,49,-6,42
FC Lugano,6912,6,12,6,14,35,46,-11,42
Grasshoppers,6912,7,11,6,15,42,48,-6,39
FC Thun,6912,8,9,6,17,41,60,-19,33
FC Sion,6912,9,6,8,18,39,56,-17,26
Young Boys,6913,1,21,8,3,71,35,36,71
FC Basel,6913,2,17,9,6,54,26,28,60
Lucerne,6913,3,12,10,10,41,43,-2,46
St Gallen,6913,4,14,3,15,44,57,-13,45
FC Zürich,6913,5,11,9,12,41,37,4,42
Grasshoppers,6913,6,10,7,15,40,46,-6,37
FC Thun,6913,7,10,5,17,42,59,-17,35
FC Lugano,6913,8,10,5,17,34,51,-17,35
FC Sion,6913,9,7,8,17,40,53,-13,29
Young Boys,6914,1,22,7,3,75,37,38,73
FC Basel,6914,2,17,9,6,54,26,28,60
St Gallen,6914,3,15,3,14,45,54,-9,48
Lucerne,6914,4,12,7,13,42,47,-5,43
FC Zürich,6914,5,10,10,12,42,40,2,40
Grasshoppers,6914,6,10,8,14,40,46,-6,38
FC Thun,6914,7,10,6,16,43,56,-13,36
FC Lugano,6914,8,9,6,17,33,54,-21,33
FC Sion,6914,9,7,8,17,40,54,-14,29
Young Boys,6915,1,20,6,6,71,42,29,66
FC Basel,6915,2,18,7,7,57,30,27,61
St Gallen,6915,3,16,2,14,47,55,-8,50
Lucerne,6915,4,14,7,11,52,49,3,49
FC Zürich,6915,5,11,10,11,42,37,5,43
Grasshoppers,6915,6,10,7,15,42,47,-5,37
FC Lugano,6915,7,10,5,17,33,53,-20,35
FC Sion,6915,8,8,7,17,41,53,-12,31
FC Thun,6915,9,8,7,17,44,63,-19,31
Young Boys,6916,1,23,7,2,74,32,42,76
FC Basel,6916,2,17,9,6,50,26,24,60
St Gallen,6916,3,14,3,15,42,54,-12,45
Lucerne,6916,4,11,8,13,40,46,-6,41
FC Zürich,6916,5,10,9,13,42,39,3,39
FC Thun,6916,6,10,6,16,41,55,-14,36
FC Lugano,6916,7,10,6,16,32,51,-19,36
Grasshoppers,6916,8,9,8,15,40,48,-8,35
FC Sion,6916,9,8,8,16,41,51,-10,32
Young Boys,6917,1,21,7,4,71,35,36,70
FC Basel,6917,2,18,8,6,56,28,28,62
St Gallen,6917,3,15,3,14,48,54,-6,48
FC Zürich,6917,4,11,9,12,42,38,4,42
Lucerne,6917,5,11,8,13,39,49,-10,41
Grasshoppers,6917,6,11,7,14,45,47,-2,40
FC Lugano,6917,7,11,6,15,34,52,-18,39
FC Thun,6917,8,10,7,15,47,59,-12,37
FC Sion,6917,9,5,7,20,39,59,-20,22
Young Boys,6918,1,22,6,4,72,34,38,72
FC Basel,6918,2,18,7,7,56,27,29,61
St Gallen,6918,3,15,2,15,42,52,-10,47
Lucerne,6918,4,12,8,12,40,48,-8,44
FC Zürich,6918,5,11,10,11,41,36,5,43
Grasshoppers,6918,6,10,6,16,43,50,-7,36
FC Thun,6918,7,10,6,16,42,58,-16,36
FC Lugano,6918,8,10,6,16,31,48,-17,36
FC Sion,6918,9,7,7,18,39,53,-14,28
Young Boys,6919,1,22,6,4,75,36,39,72
FC Basel,6919,2,17,8,7,51,26,25,59
Lucerne,6919,3,13,8,11,41,45,-4,47
St Gallen,6919,4,14,3,15,45,55,-10,45
FC Lugano,6919,5,11,6,15,33,49,-16,39
FC Zürich,6919,6,9,11,12,38,36,2,38
FC Thun,6919,7,10,6,16,42,56,-14,36
Grasshoppers,6919,8,9,6,17,41,50,-9,33
FC Sion,6919,9,8,8,16,41,54,-13,32
Young Boys,6920,1,22,8,2,73,33,40,74
FC Basel,6920,2,19,8,5,55,22,33,65
St Gallen,6920,3,14,2,16,42,58,-16,44
Lucerne,6920,4,12,7,13,43,48,-5,43
FC Lugano,6920,5,11,6,15,34,45,-11,39
FC Zürich,6920,6,9,11,12,37,37,0,38
FC Thun,6920,7,10,5,17,44,59,-15,35
Grasshoppers,6920,8,9,6,17,42,56,-14,33
FC Sion,6920,9,7,9,16,42,54,-12,30
Young Boys,6921,1,21,8,3,70,36,34,71
FC Basel,6921,2,17,8,7,51,30,21,59
Lucerne,6921,3,14,8,10,41,40,1,50
FC Zürich,6921,4,12,10,10,48,35,13,46
St Gallen,6921,5,14,2,16,43,58,-15,44
FC Thun,6921,6,10,6,16,45,58,-13,36
FC Lugano,6921,7,9,7,16,33,51,-18,34
Grasshoppers,6921,8,9,6,17,39,49,-10,33
FC Sion,6921,9,7,7,18,45,58,-13,28
Young Boys,6922,1,22,7,3,76,37,39,73
FC Basel,6922,2,17,7,8,52,28,24,58
Lucerne,6922,3,13,7,12,44,45,-1,46
FC Zürich,6922,4,11,9,12,42,37,5,42
St Gallen,6922,5,13,3,16,42,56,-14,42
Grasshoppers,6922,6,11,6,15,43,52,-9,39
FC Lugano,6922,7,11,6,15,34,48,-14,39
FC Thun,6922,8,10,5,17,44,59,-15,35
FC Sion,6922,9,7,8,17,40,55,-15,29
Young Boys,6923,1,21,7,4,75,34,41,70
FC Basel,6923,2,16,8,8,51,29,22,56
Lucerne,6923,3,14,8,10,44,44,0,50
St Gallen,6923,4,15,3,14,44,55,-11,48
FC Zürich,6923,5,11,10,11,41,34,7,43
FC Thun,6923,6,10,7,15,43,55,-12,37
Grasshoppers,6923,7,9,8,15,40,49,-9,35
FC Lugano,6923,8,9,6,17,28,51,-23,33
FC Sion,6923,9,7,7,18,41,56,-15,28
Young Boys,6924,1,22,6,4,74,36,38,72
FC Basel,6924,2,18,8,6,51,25,26,62
St Gallen,6924,3,15,3,14,43,50,-7,48
Lucerne,6924,4,11,9,12,38,48,-10,42
FC Zürich,6924,5,10,10,12,39,37,2,40
FC Thun,6924,6,11,5,16,47,57,-10,38
Grasshoppers,6924,7,10,7,15,43,49,-6,37
FC Lugano,6924,8,10,6,16,33,50,-17,36
FC Sion,6924,9,6,8,18,37,53,-16,26
Young Boys,6925,1,22,6,4,73,36,37,72
FC Basel,6925,2,15,8,9,50,29,21,53
Lucerne,6925,3,15,7,10,48,44,4,52
St Gallen,6925,4,16,2,14,45,54,-9,50
FC Zürich,6925,5,11,9,12,43,39,4,42
Grasshoppers,6925,6,10,7,15,42,49,-7,37
FC Thun,6925,7,9,8,15,44,58,-14,35
FC Lugano,6925,8,10,5,17,32,53,-21,35
FC Sion,6925,9,6,8,18,39,54,-15,26
Young Boys,6926,1,21,6,5,68,34,34,69
FC Basel,6926,2,20,7,5,56,23,33,67
Lucerne,6926,3,13,7,12,41,42,-1,46
St Gallen,6926,4,13,2,17,41,58,-17,41
FC Zürich,6926,5,10,9,13,37,36,1,39
FC Lugano,6926,6,11,5,16,30,46,-16,38
Grasshoppers,6926,7,10,6,16,41,50,-9,36
FC Thun,6926,8,10,6,16,43,57,-14,36
FC Sion,6926,9,8,8,16,41,52,-11,32
Young Boys,6927,1,20,7,5,70,42,28,67
FC Basel,6927,2,17,10,5,52,24,28,61
Lucerne,6927,3,14,8,10,42,39,3,50
FC Zürich,6927,4,11,11,10,42,34,8,44
St Gallen,6927,5,13,5,14,41,54,-13,44
FC Lugano,6927,6,10,8,14,33,44,-11,38
Grasshoppers,6927,7,10,7,15,40,47,-7,37
FC Thun,6927,8,9,6,17,42,59,-17,33
FC Sion,6927,9,5,8,19,40,59,-19,23
Young Boys,6928,1,22,7,3,75,34,41,73
FC Basel,6928,2,18,7,7,56,30,26,61
St Gallen,6928,3,15,3,14,46,53,-7,48
Lucerne,6928,4,13,8,11,44,47,-3,47
FC Zürich,6928,5,12,9,11,44,37,7,45
FC Lugano,6928,6,10,6,16,31,50,-19,36
FC Thun,6928,7,9,7,16,43,58,-15,34
Grasshoppers,6928,8,8,7,17,39,51,-12,31
FC Sion,6928,9,6,8,18,37,55,-18,26
Young Boys,6929,1,22,6,4,76,35,41,72
FC Basel,6929,2,18,9,5,53,24,29,63
Lucerne,6929,3,14,7,11,43,42,1,49
St Gallen,6929,4,14,4,14,44,55,-11,46
FC Zürich,6929,5,11,10,11,43,38,5,43
FC Thun,6929,6,10,7,15,46,57,-11,37
FC Lugano,6929,7,10,5,17,31,49,-18,35
Grasshoppers,6929,8,9,6,17,39,54,-15,33
FC Sion,6929,9,5,8,19,37,58,-21,23
Young Boys,6930,1,22,6,4,74,36,38,72
FC Basel,6930,2,19,8,5,56,25,31,65
St Gallen,6930,3,15,3,14,44,55,-11,48
FC Zürich,6930,4,12,9,11,46,38,8,45
Lucerne,6930,5,11,7,14,39,46,-7,40
Grasshoppers,6930,6,11,6,15,43,46,-3,39
FC Lugano,6930,7,11,5,16,35,51,-16,38
FC Thun,6930,8,9,5,18,46,67,-21,32
FC Sion,6930,9,6,7,19,39,58,-19,25
Young Boys,6931,1,20,9,3,72,39,33,69
FC Basel,6931,2,18,8,6,52,23,29,62
St Gallen,6931,3,15,4,13,46,52,-6,49
Lucerne,6931,4,13,8,11,43,43,0,47
FC Thun,6931,5,10,7,15,42,55,-13,37
FC Zürich,6931,6,9,9,14,38,39,-1,36
FC Lugano,6931,7,10,6,16,31,49,-18,36
Grasshoppers,6931,8,8,9,15,40,49,-9,33
FC Sion,6931,9,6,10,16,43,58,-15,28
Young Boys,6932,1,23,6,3,72,32,40,75
FC Basel,6932,2,17,7,8,52,27,25,58
St Gallen,6932,3,16,2,14,44,54,-10,50
Lucerne,6932,4,12,8,12,39,43,-4,44
FC Zürich,6932,5,11,10,11,43,37,6,43
Grasshoppers,6932,6,10,6,16,41,50,-9,36
FC Lugano,6932,7,10,6,16,33,48,-15,36
FC Thun,6932,8,10,5,17,45,60,-15,35
FC Sion,6932,9,6,8,18,40,58,-18,26
Young Boys,6933,1,22,7,3,76,37,39,73
FC Basel,6933,2,18,7,7,58,31,27,61
Lucerne,6933,3,13,9,10,43,42,1,48
St Gallen,6933,4,14,3,15,43,55,-12,45
FC Zürich,6933,5,10,11,11,41,40,1,41
Grasshoppers,6933,6,10,6,16,42,53,-11,36
FC Lugano,6933,7,9,7,16,31,49,-18,34
FC Thun,6933,8,9,6,17,49,62,-13,33
FC Sion,6933,9,7,8,17,43,57,-14,29
Young Boys,6934,1,20,6,6,67,36,31,66
FC Basel,6934,2,17,7,8,49,26,23,58
Lucerne,6934,3,14,8,10,48,43,5,50
St Gallen,6934,4,14,4,14,46,57,-11,46
FC Zürich,6934,5,11,10,11,40,36,4,43
FC Thun,6934,6,12,5,15,48,57,-9,41
FC Lugano,6934,7,10,6,16,29,48,-19,36
Grasshoppers,6934,8,9,7,16,41,51,-10,34
FC Sion,6934,9,6,9,17,44,58,-14,27
Young Boys,6935,1,21,9,2,71,34,37,72
FC Basel,6935,2,19,8,5,57,23,34,65
Lucerne,6935,3,13,9,10,43,44,-1,48
St Gallen,6935,4,15,2,15,46,56,-10,47
FC Zürich,6935,5,11,9,12,43,41,2,42
FC Lugano,6935,6,10,5,17,33,49,-16,35
Grasshoppers,6935,7,8,8,16,39,50,-11,32
FC Thun,6935,8,9,5,18,44,66,-22,32
FC Sion,6935,9,6,9,17,41,54,-13,27
Young Boys,6936,1,22,7,3,75,35,40,73
FC Basel,6936,2,18,7,7,53,24,29,61
St Gallen,6936,3,15,3,14,43,52,-9,48
Lucerne,6936,4,13,8,11,43,47,-4,47
FC Zürich,6936,5,10,9,13,41,38,3,39
FC Lugano,6936,6,11,6,15,30,44,-14,39
FC Thun,6936,7,11,5,16,45,58,-13,38
Grasshoppers,6936,8,9,6,17,39,52,-13,33
FC Sion,6936,9,6,7,19,37,56,-19,25
Young Boys,6937,1,21,8,3,70,33,37,71
FC Basel,6937,2,18,9,5,53,25,28,63
Lucerne,6937,3,12,11,9,41,40,1,47
FC Zürich,6937,4,11,11,10,46,38,8,44
St Gallen,6937,5,13,3,16,43,60,-17,42
FC Lugano,6937,6,10,6,16,32,48,-16,36
Grasshoppers,6937,7,9,7,16,41,51,-10,34
FC Thun,6937,8,8,7,17,41,60,-19,31
FC Sion,6937,9,7,8,17,43,55,-12,29
Young Boys,6938,1,22,7,3,77,36,41,73
FC Basel,6938,2,19,7,6,55,26,29,64
St Gallen,6938,3,14,3,15,41,55,-14,45
Lucerne,6938,4,11,10,11,37,43,-6,43
FC Zürich,6938,5,10,10,12,40,36,4,40
Grasshoppers,6938,6,9,8,15,43,52,-9,35
FC Thun,6938,7,10,5,17,45,61,-16,35
FC Lugano,6938,8,9,7,16,30,48,-18,34
FC Sion,6938,9,7,9,16,44,55,-11,30
Young Boys,6939,1,24,6,2,74,31,43,78
FC Basel,6939,2,17,7,8,52,27,25,58
St Gallen,6939,3,15,3,14,45,55,-10,48
Lucerne,6939,4,13,7,12,45,48,-3,46
FC Zürich,6939,5,11,10,11,42,36,6,43
FC Lugano,6939,6,10,6,16,33,50,-17,36
FC Thun,6939,7,10,5,17,43,59,-16,35
Grasshoppers,6939,8,8,6,18,40,56,-16,30
FC Sion,6939,9,7,8,17,40,52,-12,29
Young Boys,6940,1,22,7,3,71,32,39,73
FC Basel,6940,2,17,10,5,55,25,30,61
Lucerne,6940,3,12,10,10,40,41,-1,46
FC Zürich,6940,4,11,11,10,42,36,6,44
St Gallen,6940,5,13,3,16,40,58,-18,42
FC Thun,6940,6,10,6,16,46,61,-15,36
FC Lugano,6940,7,10,5,17,32,46,-14,35
FC Sion,6940,8,8,7,17,41,52,-11,31
Grasshoppers,6940,9,8,7,17,38,54,-16,31
Young Boys,6941,1,22,7,3,71,36,35,73
FC Basel,6941,2,18,8,6,53,25,28,62
St Gallen,6941,3,15,3,14,45,53,-8,48
FC Zürich,6941,4,10,11,11,43,39,4,41
Lucerne,6941,5,11,8,13,38,46,-8,41
FC Lugano,6941,6,10,8,14,33,47,-14,38
Grasshoppers,6941,7,10,7,15,41,49,-8,37
FC Thun,6941,8,9,6,17,42,58,-16,33
FC Sion,6941,9,6,8,18,42,55,-13,26
Young Boys,6942,1,21,8,3,70,36,34,71
FC Basel,6942,2,18,8,6,55,24,31,62
FC Zürich,6942,3,12,10,10,47,33,14,46
Lucerne,6942,4,13,7,12,41,47,-6,46
St Gallen,6942,5,14,2,16,44,57,-13,44
FC Lugano,6942,6,11,6,15,35,50,-15,39
Grasshoppers,6942,7,10,6,16,43,52,-9,36
FC Thun,6942,8,9,6,17,42,59,-17,33
FC Sion,6942,9,5,9,18,37,56,-19,24
Young Boys,6943,1,22,8,2,70,30,40,74
FC Basel,6943,2,16,9,7,51,28,23,57
Lucerne,6943,3,11,11,10,38,40,-2,44
St Gallen,6943,4,13,3,16,40,54,-14,42
FC Lugano,6943,5,11,7,14,30,43,-13,40
FC Thun,6943,6,11,6,15,47,55,-8,39
FC Zürich,6943,7,9,10,13,38,41,-3,37
Grasshoppers,6943,8,10,6,16,40,50,-10,36
FC Sion,6943,9,7,8,17,39,52,-13,29
Young Boys,6944,1,21,6,5,71,38,33,69
FC Basel,6944,2,16,10,6,51,27,24,58
Lucerne,6944,3,13,8,11,42,42,0,47
St Gallen,6944,4,15,2,15,42,53,-11,47
FC Zürich,6944,5,12,10,10,45,36,9,46
FC Lugano,6944,6,11,5,16,34,49,-15,38
FC Thun,6944,7,10,6,16,43,57,-14,36
Grasshoppers,6944,8,9,7,16,40,50,-10,34
FC Sion,6944,9,6,8,18,41,57,-16,26
Young Boys,6945,1,24,6,2,79,30,49,78
FC Basel,6945,2,17,8,7,48,24,24,59
Lucerne,6945,3,14,8,10,42,43,-1,50
St Gallen,6945,4,14,2,16,40,54,-14,44
FC Zürich,6945,5,10,10,12,40,36,4,40
FC Lugano,6945,6,10,6,16,29,49,-20,36
FC Thun,6945,7,10,5,17,48,59,-11,35
Grasshoppers,6945,8,9,6,17,39,54,-15,33
FC Sion,6945,9,7,7,18,40,56,-16,28
Young Boys,6946,1,21,7,4,70,35,35,70
FC Basel,6946,2,17,10,5,54,24,30,61
St Gallen,6946,3,14,4,14,42,55,-13,46
Lucerne,6946,4,12,8,12,41,47,-6,44
FC Zürich,6946,5,10,10,12,42,38,4,40
FC Thun,6946,6,10,6,16,44,56,-12,36
FC Sion,6946,7,9,8,15,46,53,-7,35
Grasshoppers,6946,8,9,7,16,42,54,-12,34
FC Lugano,6946,9,9,6,17,31,50,-19,33
Young Boys,6947,1,21,7,4,72,37,35,70
FC Basel,6947,2,19,8,5,61,27,34,65
Lucerne,6947,3,13,7,12,50,48,2,46
St Gallen,6947,4,14,4,14,43,56,-13,46
FC Zürich,6947,5,11,9,12,42,37,5,42
Grasshoppers,6947,6,9,8,15,41,53,-12,35
FC Thun,6947,7,9,7,16,42,60,-18,34
FC Lugano,6947,8,9,7,16,33,52,-19,34
FC Sion,6947,9,6,9,17,42,56,-14,27
Young Boys,6948,1,23,7,2,75,35,40,76
FC Basel,6948,2,17,9,6,55,25,30,60
Lucerne,6948,3,14,8,10,44,39,5,50
St Gallen,6948,4,15,3,14,43,50,-7,48
FC Zürich,6948,5,9,11,12,41,40,1,38
FC Thun,6948,6,10,5,17,46,62,-16,35
FC Lugano,6948,7,9,6,17,29,49,-20,33
Grasshoppers,6948,8,8,7,17,39,56,-17,31
FC Sion,6948,9,6,10,16,43,59,-16,28
Young Boys,6949,1,23,6,3,73,33,40,75
FC Basel,6949,2,17,9,6,55,27,28,60
St Gallen,6949,3,16,3,13,45,53,-8,51
Lucerne,6949,4,12,9,11,42,44,-2,45
FC Zürich,6949,5,10,11,11,41,38,3,41
FC Thun,6949,6,9,8,15,41,55,-14,35
FC Lugano,6949,7,9,7,16,28,49,-21,34
Grasshoppers,6949,8,8,8,16,41,51,-10,32
FC Sion,6949,9,5,9,18,40,56,-16,24
Young Boys,6950,1,22,8,2,76,38,38,74
FC Basel,6950,2,17,9,6,56,27,29,60
Lucerne,6950,3,13,9,10,42,42,0,48
St Gallen,6950,4,13,4,15,41,54,-13,43
FC Zürich,6950,5,9,11,12,40,42,-2,38
FC Lugano,6950,6,10,7,15,32,48,-16,37
FC Thun,6950,7,10,5,17,45,59,-14,35
FC Sion,6950,8,8,8,16,39,50,-11,32
Grasshoppers,6950,9,8,7,17,42,53,-11,31
Young Boys,6951,1,22,7,3,71,34,37,73
FC Basel,6951,2,18,9,5,56,24,32,63
St Gallen,6951,3,16,3,13,47,51,-4,51
Lucerne,6951,4,13,7,12,41,46,-5,46
FC Zürich,6951,5,10,11,11,41,37,4,41
FC Thun,6951,6,10,5,17,47,59,-12,35
FC Lugano,6951,7,10,5,17,33,51,-18,35
Grasshoppers,6951,8,9,7,16,41,51,-10,34
FC Sion,6951,9,5,8,19,37,61,-24,23
Young Boys,6952,1,22,8,2,78,30,48,74
FC Basel,6952,2,17,8,7,53,26,27,59
St Gallen,6952,3,16,2,14,46,56,-10,50
Lucerne,6952,4,13,8,11,42,46,-4,47
FC Zürich,6952,5,12,10,10,43,35,8,46
Grasshoppers,6952,6,9,7,16,41,54,-13,34
FC Thun,6952,7,9,6,17,43,57,-14,33
FC Lugano,6952,8,9,5,18,29,53,-24,32
FC Sion,6952,9,6,8,18,40,58,-18,26
Young Boys,6953,1,21,8,3,73,33,40,71
FC Basel,6953,2,19,7,6,55,25,30,64
St Gallen,6953,3,16,3,13,43,51,-8,51
Lucerne,6953,4,12,7,13,39,46,-7,43
FC Zürich,6953,5,10,10,12,40,38,2,40
Grasshoppers,6953,6,10,7,15,43,50,-7,37
FC Lugano,6953,7,9,7,16,29,50,-21,34
FC Sion,6953,8,8,8,16,42,51,-9,32
FC Thun,6953,9,8,5,19,39,59,-20,29
Young Boys,6954,1,21,7,4,76,40,36,70
FC Basel,6954,2,19,8,5,56,25,31,65
Lucerne,6954,3,13,8,11,46,46,0,47
FC Zürich,6954,4,10,12,10,44,38,6,42
St Gallen,6954,5,13,3,16,42,59,-17,42
Grasshoppers,6954,6,11,7,14,44,47,-3,40
FC Lugano,6954,7,10,6,16,33,51,-18,36
FC Thun,6954,8,9,7,16,45,58,-13,34
FC Sion,6954,9,5,8,19,41,63,-22,23
Young Boys,6955,1,23,6,3,72,33,39,75
FC Basel,6955,2,16,8,8,49,29,20,56
Lucerne,6955,3,13,8,11,43,44,-1,47
St Gallen,6955,4,14,3,15,43,54,-11,45
FC Zürich,6955,5,10,11,11,41,38,3,41
FC Thun,6955,6,12,5,15,46,55,-9,41
FC Lugano,6955,7,9,8,15,32,48,-16,35
Grasshoppers,6955,8,9,6,17,38,50,-12,33
FC Sion,6955,9,7,7,18,42,55,-13,28
Young Boys,6956,1,21,7,4,82,36,46,70
FC Basel,6956,2,17,8,7,55,27,28,59
St Gallen,6956,3,16,2,14,44,54,-10,50
Lucerne,6956,4,12,8,12,40,47,-7,44
FC Zürich,6956,5,9,11,12,38,36,2,38
FC Thun,6956,6,10,7,15,49,57,-8,37
Grasshoppers,6956,7,9,8,15,42,55,-13,35
FC Sion,6956,8,8,9,15,43,52,-9,33
FC Lugano,6956,9,9,6,17,28,57,-29,33
Young Boys,6957,1,23,7,2,75,32,43,76
FC Basel,6957,2,17,9,6,55,27,28,60
Lucerne,6957,3,13,9,10,43,43,0,48
St Gallen,6957,4,13,3,16,43,59,-16,42
FC Zürich,6957,5,9,12,11,37,35,2,39
FC Lugano,6957,6,10,7,15,31,48,-17,37
FC Thun,6957,7,10,5,17,43,58,-15,35
Grasshoppers,6957,8,8,7,17,38,49,-11,31
FC Sion,6957,9,7,9,16,43,57,-14,30
Young Boys,6958,1,21,8,3,71,34,37,71
FC Basel,6958,2,17,9,6,53,27,26,60
Lucerne,6958,3,12,9,11,39,44,-5,45
FC Zürich,6958,4,11,10,11,44,37,7,43
St Gallen,6958,5,13,4,15,42,55,-13,43
Grasshoppers,6958,6,10,7,15,43,49,-6,37
FC Thun,6958,7,10,6,16,45,56,-11,36
FC Lugano,6958,8,10,6,16,31,48,-17,36
FC Sion,6958,9,7,7,18,40,58,-18,28
Young Boys,6959,1,22,7,3,70,33,37,73
FC Basel,6959,2,18,7,7,57,27,30,61
Lucerne,6959,3,13,7,12,42,46,-4,46
St Gallen,6959,4,14,2,16,42,56,-14,44
FC Zürich,6959,5,11,9,12,42,38,4,42
FC Lugano,6959,6,12,6,14,36,46,-10,42
Grasshoppers,6959,7,9,7,16,39,50,-11,34
FC Sion,6959,8,8,7,17,41,54,-13,31
FC Thun,6959,9,8,6,18,42,61,-19,30
Young Boys,6960,1,20,8,4,73,40,33,68
FC Basel,6960,2,18,8,6,58,28,30,62
Lucerne,6960,3,12,9,11,44,50,-6,45
St Gallen,6960,4,14,2,16,43,57,-14,44
FC Zürich,6960,5,10,11,11,39,35,4,41
FC Lugano,6960,6,10,7,15,37,50,-13,37
Grasshoppers,6960,7,10,6,16,42,51,-9,36
FC Thun,6960,8,10,5,17,47,60,-13,35
FC Sion,6960,9,8,8,16,41,53,-12,32
Young Boys,6961,1,21,6,5,75,41,34,69
FC Basel,6961,2,18,8,6,52,25,27,62
St Gallen,6961,3,15,2,15,45,56,-11,47
Lucerne,6961,4,12,8,12,41,45,-4,44
FC Zürich,6961,5,10,10,12,40,38,2,40
FC Thun,6961,6,11,5,16,46,58,-12,38
Grasshoppers,6961,7,10,6,16,46,54,-8,36
FC Lugano,6961,8,10,6,16,33,49,-16,36
FC Sion,6961,9,8,7,17,45,57,-12,31
Young Boys,6962,1,21,6,5,69,37,32,69
FC Basel,6962,2,18,8,6,58,29,29,62
Lucerne,6962,3,13,8,11,45,44,1,47
St Gallen,6962,4,14,3,15,46,63,-17,45
FC Zürich,6962,5,11,10,11,40,35,5,43
FC Lugano,6962,6,11,6,15,35,45,-10,39
Grasshoppers,6962,7,9,6,17,40,51,-11,33
FC Sion,6962,8,8,8,16,45,54,-9,32
FC Thun,6962,9,9,5,18,41,61,-20,32
Young Boys,6963,1,21,7,4,73,38,35,70
FC Basel,6963,2,20,7,5,54,24,30,67
St Gallen,6963,3,15,2,15,44,56,-12,47
Lucerne,6963,4,12,8,12,42,44,-2,44
FC Zürich,6963,5,10,11,11,41,37,4,41
Grasshoppers,6963,6,9,7,16,40,52,-12,34
FC Thun,6963,7,9,7,16,44,57,-13,34
FC Lugano,6963,8,9,7,16,30,49,-19,34
FC Sion,6963,9,7,8,17,44,55,-11,29
Young Boys,6964,1,20,10,2,70,35,35,70
FC Basel,6964,2,18,9,5,57,26,31,63
Lucerne,6964,3,12,9,11,41,43,-2,45
St Gallen,6964,4,13,4,15,40,55,-15,43
FC Zürich,6964,5,10,10,12,41,37,4,40
Grasshoppers,6964,6,10,7,15,43,49,-6,37
FC Lugano,6964,7,9,8,15,29,45,-16,35
FC Thun,6964,8,10,5,17,43,62,-19,35
FC Sion,6964,9,7,8,17,41,53,-12,29
Young Boys,6965,1,23,6,3,75,34,41,75
FC Basel,6965,2,18,8,6,53,24,29,62
Lucerne,6965,3,13,9,10,41,42,-1,48
St Gallen,6965,4,13,3,16,43,60,-17,42
FC Zürich,6965,5,9,11,12,40,39,1,38
FC Lugano,6965,6,10,7,15,31,48,-17,37
FC Thun,6965,7,9,6,17,43,58,-15,33
Grasshoppers,6965,8,8,8,16,41,51,-10,32
FC Sion,6965,9,8,8,16,43,54,-11,32
Young Boys,6966,1,23,6,3,75,32,43,75
FC Basel,6966,2,20,7,5,59,23,36,67
St Gallen,6966,3,16,2,14,47,55,-8,50
Lucerne,6966,4,12,7,13,42,48,-6,43
FC Zürich,6966,5,10,9,13,42,42,0,39
Grasshoppers,6966,6,10,7,15,41,49,-8,37
FC Lugano,6966,7,10,5,17,29,50,-21,35
FC Thun,6966,8,9,6,17,43,61,-18,33
FC Sion,6966,9,6,7,19,39,57,-18,25
Young Boys,6967,1,24,6,2,71,31,40,78
FC Basel,6967,2,15,8,9,48,31,17,53
Lucerne,6967,3,13,7,12,42,42,0,46
St Gallen,6967,4,14,3,15,40,54,-14,45
FC Zürich,6967,5,11,10,11,45,39,6,43
Grasshoppers,6967,6,11,6,15,43,47,-4,39
FC Lugano,6967,7,11,5,16,34,49,-15,38
FC Thun,6967,8,10,5,17,46,59,-13,35
FC Sion,6967,9,6,8,18,39,56,-17,26
Young Boys,6968,1,21,7,4,68,35,33,70
FC Basel,6968,2,18,8,6,54,26,28,62
St Gallen,6968,3,16,2,14,46,54,-8,50
Lucerne,6968,4,13,9,10,42,43,-1,48
FC Lugano,6968,5,11,5,16,35,47,-12,38
FC Zürich,6968,6,9,10,13,38,40,-2,37
FC Thun,6968,7,10,6,16,46,59,-13,36
Grasshoppers,6968,8,9,7,16,42,51,-9,34
FC Sion,6968,9,6,8,18,39,55,-16,26
Young Boys,6969,1,23,6,3,75,33,42,75
FC Basel,6969,2,17,8,7,54,30,24,59
Lucerne,6969,3,12,8,12,41,46,-5,44
St Gallen,6969,4,13,5,14,42,54,-12,44
FC Zürich,6969,5,10,10,12,44,41,3,40
Grasshoppers,6969,6,11,7,14,46,48,-2,40
FC Lugano,6969,7,11,6,15,36,48,-12,39
FC Thun,6969,8,8,6,18,42,65,-23,30
FC Sion,6969,9,7,8,17,40,55,-15,29
Young Boys,6970,1,23,6,3,74,32,42,75
FC Basel,6970,2,16,9,7,49,27,22,57
Lucerne,6970,3,12,9,11,40,43,-3,45
St Gallen,6970,4,14,3,15,42,52,-10,45
FC Thun,6970,5,11,6,15,46,55,-9,39
FC Zürich,6970,6,9,11,12,38,39,-1,38
FC Lugano,6970,7,9,8,15,29,47,-18,35
Grasshoppers,6970,8,9,7,16,40,50,-10,34
FC Sion,6970,9,8,7,17,42,55,-13,31
Young Boys,6971,1,22,6,4,71,35,36,72
FC Basel,6971,2,15,9,8,53,31,22,54
Lucerne,6971,3,13,9,10,46,44,2,48
St Gallen,6971,4,15,3,14,46,57,-11,48
FC Zürich,6971,5,10,10,12,40,39,1,40
Grasshoppers,6971,6,10,7,15,42,51,-9,37
FC Lugano,6971,7,10,7,15,34,47,-13,37
FC Thun,6971,8,9,7,16,43,60,-17,34
FC Sion,6971,9,7,8,17,43,54,-11,29
Young Boys,6972,1,20,7,5,70,41,29,67
FC Basel,6972,2,18,8,6,53,24,29,62
St Gallen,6972,3,15,3,14,43,53,-10,48
Lucerne,6972,4,12,9,11,43,46,-3,45
FC Zürich,6972,5,10,10,12,41,37,4,40
FC Lugano,6972,6,10,7,15,31,47,-16,37
FC Thun,6972,7,10,6,16,46,60,-14,36
Grasshoppers,6972,8,9,8,15,45,51,-6,35
FC Sion,6972,9,7,8,17,42,55,-13,29
Young Boys,6973,1,24,6,2,77,32,45,78
FC Basel,6973,2,18,7,7,52,25,27,61
St Gallen,6973,3,14,3,15,41,55,-14,45
FC Zürich,6973,4,11,10,11,41,34,7,43
Lucerne,6973,5,12,7,13,42,45,-3,43
FC Thun,6973,6,10,6,16,42,55,-13,36
FC Lugano,6973,7,9,7,16,31,51,-20,34
Grasshoppers,6973,8,9,6,17,38,50,-12,33
FC Sion,6973,9,7,8,17,38,55,-17,29
Young Boys,6974,1,22,8,2,70,31,39,74
FC Basel,6974,2,18,8,6,57,24,33,62
Lucerne,6974,3,13,8,11,41,43,-2,47
St Gallen,6974,4,14,4,14,44,56,-12,46
FC Zürich,6974,5,11,9,12,41,40,1,42
FC Thun,6974,6,10,6,16,51,60,-9,36
Grasshoppers,6974,7,9,7,16,38,52,-14,34
FC Lugano,6974,8,9,7,16,30,48,-18,34
FC Sion,6974,9,5,9,18,40,58,-18,24
Young Boys,6975,1,22,6,4,71,33,38,72
FC Basel,6975,2,19,7,6,52,27,25,64
St Gallen,6975,3,14,5,13,46,53,-7,47
Lucerne,6975,4,12,9,11,44,44,0,45
FC Zürich,6975,5,10,11,11,40,35,5,41
FC Thun,6975,6,10,6,16,43,56,-13,36
Grasshoppers,6975,7,9,7,16,39,49,-10,34
FC Lugano,6975,8,9,7,16,29,51,-22,34
FC Sion,6975,9,6,8,18,37,53,-16,26
Young Boys,6976,1,19,9,4,70,38,32,66
FC Basel,6976,2,18,8,6,53,26,27,62
Lucerne,6976,3,12,9,11,43,44,-1,45
St Gallen,6976,4,14,3,15,43,55,-12,45
FC Lugano,6976,5,12,6,14,34,46,-12,42
FC Zürich,6976,6,9,11,12,39,37,2,38
Grasshoppers,6976,7,10,7,15,42,50,-8,37
FC Thun,6976,8,9,6,17,44,60,-16,33
FC Sion,6976,9,7,9,16,42,54,-12,30
Young Boys,6977,1,22,7,3,70,31,39,73
FC Basel,6977,2,18,8,6,55,27,28,62
Lucerne,6977,3,12,9,11,40,43,-3,45
St Gallen,6977,4,13,5,14,42,55,-13,44
FC Zürich,6977,5,10,11,11,42,38,4,41
Grasshoppers,6977,6,10,6,16,44,49,-5,36
FC Lugano,6977,7,9,9,14,32,47,-15,36
FC Thun,6977,8,10,5,17,49,64,-15,35
FC Sion,6977,9,6,8,18,41,61,-20,26
Young Boys,6978,1,22,7,3,75,33,42,73
FC Basel,6978,2,18,9,5,54,25,29,63
St Gallen,6978,3,15,3,14,44,52,-8,48
Lucerne,6978,4,11,7,14,38,46,-8,40
Grasshoppers,6978,5,11,6,15,44,47,-3,39
FC Lugano,6978,6,11,6,15,31,49,-18,39
FC Zürich,6978,7,9,11,12,42,40,2,38
FC Thun,6978,8,9,7,16,44,59,-15,34
FC Sion,6978,9,6,8,18,37,58,-21,26
Young Boys,6979,1,20,7,5,70,40,30,67
FC Basel,6979,2,19,8,5,59,25,34,65
Lucerne,6979,3,12,9,11,41,44,-3,45
St Gallen,6979,4,13,5,14,41,53,-12,44
FC Zürich,6979,5,10,12,10,40,34,6,42
FC Lugano,6979,6,11,7,14,31,43,-12,40
Grasshoppers,6979,7,10,8,14,41,46,-5,38
FC Thun,6979,8,8,6,18,39,59,-20,30
FC Sion,6979,9,6,8,18,39,57,-18,26
Young Boys,6980,1,23,6,3,79,34,45,75
FC Basel,6980,2,17,8,7,57,26,31,59
St Gallen,6980,3,15,3,14,43,55,-12,48
Lucerne,6980,4,13,8,11,41,44,-3,47
FC Zürich,6980,5,12,10,10,41,34,7,46
FC Lugano,6980,6,10,6,16,31,49,-18,36
Grasshoppers,6980,7,9,6,17,41,55,-14,33
FC Thun,6980,8,9,5,18,43,61,-18,32
FC Sion,6980,9,6,8,18,39,57,-18,26
FC Basel,6981,1,20,7,5,58,25,33,67
Young Boys,6981,2,20,7,5,72,40,32,67
St Gallen,6981,3,15,3,14,44,53,-9,48
Lucerne,6981,4,12,8,12,43,51,-8,44
Grasshoppers,6981,5,11,7,14,43,46,-3,40
FC Zürich,6981,6,9,10,13,37,37,0,37
FC Lugano,6981,7,9,7,16,30,48,-18,34
FC Thun,6981,8,9,6,17,42,57,-15,33
FC Sion,6981,9,7,9,16,39,51,-12,30
Young Boys,6982,1,22,8,2,71,31,40,74
FC Basel,6982,2,17,10,5,53,24,29,61
Lucerne,6982,3,13,8,11,40,42,-2,47
St Gallen,6982,4,13,4,15,40,54,-14,43
FC Zürich,6982,5,10,10,12,37,35,2,40
FC Thun,6982,6,10,7,15,45,55,-10,37
FC Lugano,6982,7,10,6,16,28,47,-19,36
Grasshoppers,6982,8,9,7,16,39,51,-12,34
FC Sion,6982,9,6,8,18,39,53,-14,26
Young Boys,6983,1,21,9,2,75,37,38,72
FC Basel,6983,2,17,8,7,53,27,26,59
St Gallen,6983,3,16,3,13,44,50,-6,51
Lucerne,6983,4,11,11,10,44,46,-2,44
FC Zürich,6983,5,10,9,13,39,36,3,39
FC Thun,6983,6,10,6,16,45,57,-12,36
Grasshoppers,6983,7,9,8,15,41,51,-10,35
FC Lugano,6983,8,9,7,16,29,48,-19,34
FC Sion,6983,9,6,9,17,37,55,-18,27
Young Boys,6984,1,20,7,5,68,36,32,67
FC Basel,6984,2,18,8,6,54,25,29,62
Lucerne,6984,3,15,7,10,43,41,2,52
St Gallen,6984,4,14,4,14,43,54,-11,46
FC Zürich,6984,5,10,11,11,41,40,1,41
FC Lugano,6984,6,11,6,15,34,45,-11,39
FC Thun,6984,7,10,6,16,47,61,-14,36
Grasshoppers,6984,8,8,8,16,40,51,-11,32
FC Sion,6984,9,5,9,18,41,58,-17,24
Young Boys,6985,1,21,6,5,69,34,35,69
FC Basel,6985,2,19,7,6,56,25,31,64
Lucerne,6985,3,13,7,12,41,48,-7,46
St Gallen,6985,4,14,3,15,43,56,-13,45
FC Zürich,6985,5,11,10,11,41,35,6,43
FC Lugano,6985,6,11,6,15,31,45,-14,39
Grasshoppers,6985,7,10,7,15,41,49,-8,37
FC Thun,6985,8,10,6,16,48,59,-11,36
FC Sion,6985,9,5,8,19,36,55,-19,23
Young Boys,6986,1,24,6,2,74,30,44,78
FC Basel,6986,2,15,9,8,47,25,22,54
Lucerne,6986,3,14,8,10,43,40,3,50
FC Zürich,6986,4,12,10,10,45,34,11,46
St Gallen,6986,5,14,4,14,41,54,-13,46
FC Thun,6986,6,9,6,17,41,59,-18,33
Grasshoppers,6986,7,8,8,16,38,53,-15,32
FC Lugano,6986,8,9,5,18,30,49,-19,32
FC Sion,6986,9,7,8,17,41,56,-15,29
Young Boys,6987,1,21,6,5,69,37,32,69
FC Basel,6987,2,18,8,6,54,23,31,62
Lucerne,6987,3,15,7,10,42,39,3,52
St Gallen,6987,4,15,3,14,43,54,-11,48
FC Zürich,6987,5,11,9,12,44,37,7,42
FC Lugano,6987,6,12,5,15,35,47,-12,41
FC Thun,6987,7,10,5,17,42,58,-16,35
Grasshoppers,6987,8,9,6,17,40,51,-11,33
FC Sion,6987,9,5,7,20,34,57,-23,22
Young Boys,6988,1,21,6,5,72,38,34,69
FC Basel,6988,2,16,9,7,49,24,25,57
Lucerne,6988,3,13,9,10,45,44,1,48
St Gallen,6988,4,14,3,15,41,57,-16,45
FC Lugano,6988,5,12,5,15,40,47,-7,41
FC Zürich,6988,6,9,12,11,37,35,2,39
Grasshoppers,6988,7,10,6,16,43,52,-9,36
FC Thun,6988,8,9,6,17,40,58,-18,33
FC Sion,6988,9,8,8,16,41,53,-12,32
Young Boys,6989,1,21,7,4,70,36,34,70
FC Basel,6989,2,19,7,6,55,26,29,64
Lucerne,6989,3,14,8,10,46,43,3,50
St Gallen,6989,4,14,3,15,43,57,-14,45
FC Zürich,6989,5,11,10,11,41,36,5,43
FC Lugano,6989,6,10,5,17,30,49,-19,35
Grasshoppers,6989,7,9,7,16,42,51,-9,34
FC Thun,6989,8,8,7,17,41,59,-18,31
FC Sion,6989,9,6,10,16,40,51,-11,28
Young Boys,6990,1,22,7,3,70,33,37,73
FC Basel,6990,2,17,10,5,51,24,27,61
St Gallen,6990,3,16,2,14,46,52,-6,50
Grasshoppers,6990,4,12,6,14,46,47,-1,42
FC Zürich,6990,5,10,11,11,41,37,4,41
Lucerne,6990,6,11,8,13,40,50,-10,41
FC Lugano,6990,7,11,5,16,36,49,-13,38
FC Thun,6990,8,8,7,17,42,59,-17,31
FC Sion,6990,9,5,8,19,36,57,-21,23
Young Boys,6991,1,22,7,3,72,34,38,73
FC Basel,6991,2,17,9,6,53,26,27,60
St Gallen,6991,3,15,3,14,43,53,-10,48
Lucerne,6991,4,11,10,11,38,43,-5,43
FC Zürich,6991,5,10,11,11,42,38,4,41
FC Thun,6991,6,10,7,15,42,54,-12,37
FC Lugano,6991,7,9,7,16,31,50,-19,34
Grasshoppers,6991,8,8,8,16,38,48,-10,32
FC Sion,6991,9,7,8,17,40,53,-13,29
Young Boys,6992,1,21,7,4,70,34,36,70
FC Basel,6992,2,19,7,6,58,27,31,64
Lucerne,6992,3,13,7,12,42,42,0,46
St Gallen,6992,4,14,3,15,39,55,-16,45
FC Zürich,6992,5,11,10,11,42,37,5,43
Grasshoppers,6992,6,11,7,14,43,45,-2,40
FC Lugano,6992,7,10,6,16,32,49,-17,36
FC Thun,6992,8,8,6,18,40,61,-21,30
FC Sion,6992,9,6,9,17,37,53,-16,27
Young Boys,6993,1,22,7,3,75,37,38,73
FC Basel,6993,2,17,9,6,55,27,28,60
St Gallen,6993,3,15,4,13,46,54,-8,49
Lucerne,6993,4,12,8,12,46,47,-1,44
FC Zürich,6993,5,9,10,13,39,40,-1,37
FC Lugano,6993,6,10,7,15,33,49,-16,37
FC Thun,6993,7,9,8,15,44,58,-14,35
Grasshoppers,6993,8,9,7,16,43,55,-12,34
FC Sion,6993,9,7,8,17,40,54,-14,29
Young Boys,6994,1,23,6,3,79,37,42,75
FC Basel,6994,2,19,7,6,58,30,28,64
Lucerne,6994,3,14,8,10,50,44,6,50
St Gallen,6994,4,13,3,16,42,60,-18,42
FC Zürich,6994,5,9,11,12,39,39,0,38
FC Thun,6994,6,11,5,16,47,59,-12,38
FC Lugano,6994,7,9,8,15,30,49,-19,35
Grasshoppers,6994,8,8,6,18,42,60,-18,30
FC Sion,6994,9,7,8,17,45,54,-9,29
Young Boys,6995,1,22,7,3,79,35,44,73
FC Basel,6995,2,17,9,6,55,27,28,60
St Gallen,6995,3,15,2,15,43,56,-13,47
Lucerne,6995,4,12,7,13,40,43,-3,43
FC Zürich,6995,5,11,9,12,40,36,4,42
Grasshoppers,6995,6,11,7,14,45,50,-5,40
FC Thun,6995,7,9,8,15,46,60,-14,35
FC Lugano,6995,8,9,5,18,29,53,-24,32
FC Sion,6995,9,7,8,17,42,59,-17,29
Young Boys,6996,1,22,8,2,72,34,38,74
FC Basel,6996,2,18,8,6,55,24,31,62
St Gallen,6996,3,15,3,14,42,53,-11,48
Lucerne,6996,4,12,9,11,42,44,-2,45
FC Zürich,6996,5,11,9,12,45,42,3,42
FC Thun,6996,6,11,5,16,46,57,-11,38
Grasshoppers,6996,7,9,8,15,42,50,-8,35
FC Lugano,6996,8,9,5,18,29,50,-21,32
FC Sion,6996,9,6,7,19,37,56,-19,25
Young Boys,6997,1,22,8,2,72,33,39,74
FC Basel,6997,2,18,8,6,54,26,28,62
St Gallen,6997,3,14,3,15,43,54,-11,45
FC Zürich,6997,4,10,11,11,41,37,4,41
Lucerne,6997,5,11,8,13,40,48,-8,41
Grasshoppers,6997,6,11,6,15,44,50,-6,39
FC Lugano,6997,7,10,7,15,33,48,-15,37
FC Thun,6997,8,9,7,16,47,61,-14,34
FC Sion,6997,9,6,8,18,39,56,-17,26
Young Boys,6998,1,20,7,5,70,36,34,67
FC Basel,6998,2,18,9,5,55,23,32,63
St Gallen,6998,3,15,4,13,47,54,-7,49
Lucerne,6998,4,12,8,12,40,46,-6,44
FC Zürich,6998,5,11,10,11,44,35,9,43
Grasshoppers,6998,6,10,7,15,41,50,-9,37
FC Thun,6998,7,10,5,17,44,59,-15,35
FC Lugano,6998,8,10,5,17,31,53,-22,35
FC Sion,6998,9,7,7,18,38,54,-16,28
Young Boys,6999,1,21,7,4,72,37,35,70
FC Basel,6999,2,19,7,6,56,25,31,64
Lucerne,6999,3,14,7,11,44,46,-2,49
FC Zürich,6999,4,12,9,11,43,36,7,45
St Gallen,6999,5,14,2,16,42,55,-13,44
FC Thun,6999,6,10,5,17,46,63,-17,35
FC Lugano,6999,7,10,5,17,31,50,-19,35
Grasshoppers,6999,8,9,7,16,45,51,-6,34
FC Sion,6999,9,7,7,18,43,59,-16,28
Young Boys,7000,1,22,8,2,72,34,38,74
FC Basel,7000,2,18,8,6,60,26,34,62
FC Zürich,7000,3,12,10,10,42,34,8,46
St Gallen,7000,4,14,4,14,49,64,-15,46
Lucerne,7000,5,11,9,12,43,49,-6,42
Grasshoppers,7000,6,9,8,15,42,51,-9,35
FC Lugano,7000,7,10,5,17,31,48,-17,35
FC Thun,7000,8,9,5,18,44,61,-17,32
FC Sion,7000,9,6,9,17,41,57,-16,27
Young Boys,7001,1,23,7,2,75,33,42,76
FC Basel,7001,2,18,8,6,54,24,30,62
St Gallen,7001,3,14,3,15,44,56,-12,45
Lucerne,7001,4,12,8,12,43,49,-6,44
FC Zürich,7001,5,10,10,12,39,40,-1,40
FC Thun,7001,6,11,5,16,46,55,-9,38
FC Lugano,7001,7,10,6,16,31,50,-19,36
Grasshoppers,7001,8,8,7,17,41,55,-14,31
FC Sion,7001,9,7,8,17,43,54,-11,29
Young Boys,7002,1,20,8,4,72,38,34,68
FC Basel,7002,2,19,8,5,55,23,32,65
Lucerne,7002,3,12,11,9,43,41,2,47
FC Zürich,7002,4,12,9,11,42,35,7,45
St Gallen,7002,5,13,3,16,41,57,-16,42
Grasshoppers,7002,6,10,7,15,42,49,-7,37
FC Thun,7002,7,10,5,17,46,59,-13,35
FC Lugano,7002,8,10,5,17,31,53,-22,35
FC Sion,7002,9,6,8,18,38,55,-17,26
Young Boys,7003,1,20,8,4,69,38,31,68
FC Basel,7003,2,18,7,7,54,25,29,61
St Gallen,7003,3,16,3,13,45,51,-6,51
Lucerne,7003,4,14,8,10,43,41,2,50
FC Zürich,7003,5,10,10,12,39,36,3,40
FC Lugano,7003,6,10,6,16,28,46,-18,36
Grasshoppers,7003,7,9,7,16,41,49,-8,34
FC Thun,7003,8,9,6,17,41,59,-18,33
FC Sion,7003,9,6,9,17,40,55,-15,27
Young Boys,7004,1,21,7,4,71,36,35,70
FC Basel,7004,2,19,8,5,59,24,35,65
St Gallen,7004,3,15,4,13,45,54,-9,49
Lucerne,7004,4,12,8,12,40,44,-4,44
FC Lugano,7004,5,10,7,15,35,49,-14,37
FC Zürich,7004,6,9,9,14,39,43,-4,36
Grasshoppers,7004,7,9,8,15,43,50,-7,35
FC Thun,7004,8,9,6,17,44,62,-18,33
FC Sion,7004,9,7,9,16,41,55,-14,30
Young Boys,7005,1,22,7,3,73,34,39,73
FC Basel,7005,2,19,7,6,56,26,30,64
Lucerne,7005,3,15,7,10,51,43,8,52
St Gallen,7005,4,13,2,17,44,64,-20,41
FC Zürich,7005,5,10,10,12,41,38,3,40
FC Thun,7005,6,10,6,16,46,60,-14,36
FC Lugano,7005,7,10,6,16,34,52,-18,36
Grasshoppers,7005,8,9,6,17,43,56,-13,33
FC Sion,7005,9,6,9,17,41,56,-15,27
Young Boys,7006,1,23,7,2,77,32,45,76
FC Basel,7006,2,18,8,6,54,22,32,62
St Gallen,7006,3,14,5,13,43,53,-10,47
Lucerne,7006,4,12,7,13,40,47,-7,43
FC Zürich,7006,5,9,10,13,37,38,-1,37
FC Lugano,7006,6,10,7,15,31,49,-18,37
FC Thun,7006,7,9,7,16,42,60,-18,34
Grasshoppers,7006,8,8,9,15,41,51,-10,33
FC Sion,7006,9,6,10,16,40,53,-13,28
Young Boys,7007,1,23,6,3,78,35,43,75
FC Basel,7007,2,18,7,7,54,28,26,61
St Gallen,7007,3,15,3,14,43,52,-9,48
Lucerne,7007,4,11,8,13,38,49,-11,41
FC Lugano,7007,5,12,5,15,33,46,-13,41
FC Zürich,7007,6,10,10,12,40,38,2,40
Grasshoppers,7007,7,11,7,14,43,46,-3,40
FC Thun,7007,8,9,6,17,40,56,-16,33
FC Sion,7007,9,5,8,19,37,56,-19,23
Young Boys,7008,1,19,9,4,68,38,30,66
FC Basel,7008,2,16,10,6,50,25,25,58
Lucerne,7008,3,14,7,11,44,43,1,49
St Gallen,7008,4,13,3,16,40,55,-15,42
FC Lugano,7008,5,11,6,15,33,49,-16,39
FC Zürich,7008,6,9,11,12,39,39,0,38
Grasshoppers,7008,7,10,7,15,43,47,-4,37
FC Sion,7008,8,9,8,15,47,52,-5,35
FC Thun,7008,9,9,7,16,46,62,-16,34
Young Boys,7009,1,23,7,2,79,30,49,76
FC Basel,7009,2,16,10,6,54,26,28,58
Lucerne,7009,3,12,9,11,41,46,-5,45
St Gallen,7009,4,14,3,15,41,52,-11,45
FC Zürich,7009,5,9,13,10,39,35,4,40
FC Lugano,7009,6,10,7,15,30,49,-19,37
Grasshoppers,7009,7,9,8,15,40,49,-9,35
FC Thun,7009,8,9,7,16,46,60,-14,34
FC Sion,7009,9,6,8,18,38,61,-23,26
Young Boys,7010,1,21,7,4,72,35,37,70
FC Basel,7010,2,20,7,5,53,21,32,67
Lucerne,7010,3,13,7,12,42,44,-2,46
St Gallen,7010,4,13,4,15,41,56,-15,43
FC Zürich,7010,5,10,9,13,39,40,-1,39
FC Lugano,7010,6,10,6,16,30,50,-20,36
Grasshoppers,7010,7,9,8,15,42,55,-13,35
FC Thun,7010,8,9,6,17,46,61,-15,33
FC Sion,7010,9,8,8,16,48,51,-3,32
Young Boys,7011,1,20,9,3,69,34,35,69
FC Basel,7011,2,18,8,6,55,26,29,62
Lucerne,7011,3,12,8,12,39,46,-7,44
St Gallen,7011,4,13,5,14,43,55,-12,44
FC Zürich,7011,5,10,9,13,41,42,-1,39
Grasshoppers,7011,6,10,8,14,46,48,-2,38
FC Lugano,7011,7,10,7,15,32,48,-16,37
FC Thun,7011,8,10,5,17,46,58,-12,35
FC Sion,7011,9,7,9,16,41,55,-14,30
Young Boys,7012,1,23,7,2,70,31,39,76
FC Basel,7012,2,17,9,6,51,26,25,60
St Gallen,7012,3,15,3,14,44,53,-9,48
Lucerne,7012,4,12,7,13,40,42,-2,43
FC Zürich,7012,5,10,10,12,41,38,3,40
Grasshoppers,7012,6,10,7,15,42,48,-6,37
FC Lugano,7012,7,10,6,16,30,49,-19,36
FC Thun,7012,8,9,6,17,44,59,-15,33
FC Sion,7012,9,7,7,18,42,58,-16,28
Young Boys,7013,1,21,6,5,70,36,34,69
FC Basel,7013,2,17,8,7,53,25,28,59
Lucerne,7013,3,14,8,10,47,43,4,50
St Gallen,7013,4,15,4,13,46,52,-6,49
FC Zürich,7013,5,10,11,11,37,33,4,41
Grasshoppers,7013,6,10,6,16,42,50,-8,36
FC Thun,7013,7,10,6,16,44,60,-16,36
FC Lugano,7013,8,10,6,16,31,52,-21,36
FC Sion,7013,9,6,7,19,39,58,-19,25
Young Boys,7014,1,21,9,2,74,35,39,72
FC Basel,7014,2,16,10,6,53,28,25,58
Lucerne,7014,3,14,8,10,47,46,1,50
St Gallen,7014,4,14,5,13,45,55,-10,47
FC Zürich,7014,5,11,10,11,43,36,7,43
Grasshoppers,7014,6,9,8,15,41,48,-7,35
FC Thun,7014,7,9,6,17,43,61,-18,33
FC Lugano,7014,8,9,6,17,30,51,-21,33
FC Sion,7014,9,6,8,18,41,57,-16,26
Young Boys,7015,1,23,6,3,74,35,39,75
FC Basel,7015,2,18,8,6,52,25,27,62
Lucerne,7015,3,12,8,12,44,49,-5,44
FC Zürich,7015,4,11,10,11,42,35,7,43
St Gallen,7015,5,13,4,15,43,57,-14,43
Grasshoppers,7015,6,11,6,15,46,50,-4,39
FC Thun,7015,7,9,7,16,44,60,-16,34
FC Lugano,7015,8,9,7,16,31,51,-20,34
FC Sion,7015,9,6,8,18,40,54,-14,26
Young Boys,7016,1,22,7,3,71,35,36,73
FC Basel,7016,2,18,9,5,54,24,30,63
Lucerne,7016,3,13,7,12,44,44,0,46
St Gallen,7016,4,14,2,16,42,56,-14,44
FC Zürich,7016,5,9,12,11,38,35,3,39
FC Lugano,7016,6,11,5,16,31,46,-15,38
Grasshoppers,7016,7,10,6,16,43,52,-9,36
FC Thun,7016,8,9,6,17,42,60,-18,33
FC Sion,7016,9,7,8,17,43,56,-13,29
Young Boys,7017,1,23,7,2,75,33,42,76
FC Basel,7017,2,18,8,6,53,24,29,62
Lucerne,7017,3,12,8,12,41,45,-4,44
St Gallen,7017,4,14,2,16,46,61,-15,44
FC Zürich,7017,5,9,13,10,40,36,4,40
FC Lugano,7017,6,10,6,16,29,49,-20,36
Grasshoppers,7017,7,9,7,16,41,49,-8,34
FC Thun,7017,8,8,8,16,42,59,-17,32
FC Sion,7017,9,7,9,16,44,55,-11,30
Young Boys,7018,1,22,7,3,74,36,38,73
FC Basel,7018,2,16,10,6,50,27,23,58
Lucerne,7018,3,13,8,11,42,44,-2,47
FC Zürich,7018,4,11,11,10,44,36,8,44
St Gallen,7018,5,14,2,16,39,55,-16,44
Grasshoppers,7018,6,10,6,16,43,49,-6,36
FC Thun,7018,7,10,6,16,45,58,-13,36
FC Lugano,7018,8,10,5,17,32,49,-17,35
FC Sion,7018,9,7,7,18,40,55,-15,28
Young Boys,7019,1,22,8,2,73,35,38,74
FC Basel,7019,2,17,10,5,59,24,35,61
Lucerne,7019,3,13,8,11,45,49,-4,47
St Gallen,7019,4,14,2,16,41,59,-18,44
FC Zürich,7019,5,10,10,12,40,37,3,40
FC Thun,7019,6,11,6,15,47,56,-9,39
FC Lugano,7019,7,11,6,15,30,44,-14,39
Grasshoppers,7019,8,9,6,17,45,53,-8,33
FC Sion,7019,9,5,8,19,38,61,-23,23
Young Boys,7020,1,24,6,2,72,29,43,78
FC Basel,7020,2,17,9,6,52,25,27,60
Lucerne,7020,3,13,8,11,41,43,-2,47
St Gallen,7020,4,14,2,16,43,55,-12,44
FC Lugano,7020,5,12,5,15,31,44,-13,41
FC Zürich,7020,6,10,10,12,41,39,2,40
Grasshoppers,7020,7,10,6,16,44,48,-4,36
FC Thun,7020,8,8,6,18,42,62,-20,30
FC Sion,7020,9,6,8,18,40,61,-21,26
Young Boys,7021,1,23,6,3,78,36,42,75
FC Basel,7021,2,18,7,7,56,25,31,61
Lucerne,7021,3,14,7,11,45,44,1,49
St Gallen,7021,4,15,3,14,44,53,-9,48
FC Zürich,7021,5,10,10,12,42,38,4,40
Grasshoppers,7021,6,10,6,16,42,48,-6,36
FC Thun,7021,7,10,6,16,43,61,-18,36
FC Lugano,7021,8,9,6,17,28,52,-24,33
FC Sion,7021,9,5,9,18,39,60,-21,24
Young Boys,7022,1,21,6,5,77,42,35,69
FC Basel,7022,2,20,7,5,62,24,38,67
Lucerne,7022,3,15,7,10,48,47,1,52
St Gallen,7022,4,14,2,16,41,55,-14,44
FC Zürich,7022,5,11,10,11,38,33,5,43
FC Lugano,7022,6,10,5,17,32,50,-18,35
Grasshoppers,7022,7,9,7,16,46,57,-11,34
FC Thun,7022,8,9,6,17,44,61,-17,33
FC Sion,7022,9,6,8,18,37,56,-19,26
Young Boys,7023,1,21,6,5,68,36,32,69
FC Basel,7023,2,19,7,6,58,27,31,64
St Gallen,7023,3,14,3,15,43,56,-13,45
Lucerne,7023,4,12,8,12,40,43,-3,44
FC Zürich,7023,5,10,9,13,39,36,3,39
FC Lugano,7023,6,10,7,15,30,46,-16,37
Grasshoppers,7023,7,10,6,16,40,47,-7,36
FC Thun,7023,8,10,5,17,45,62,-17,35
FC Sion,7023,9,9,7,16,40,50,-10,34
Young Boys,7024,1,21,8,3,71,34,37,71
FC Basel,7024,2,19,7,6,55,26,29,64
Lucerne,7024,3,11,10,11,40,44,-4,43
St Gallen,7024,4,13,4,15,41,55,-14,43
FC Zürich,7024,5,10,10,12,42,40,2,40
FC Thun,7024,6,11,5,16,46,56,-10,38
Grasshoppers,7024,7,9,8,15,41,50,-9,35
FC Lugano,7024,8,9,8,15,30,47,-17,35
FC Sion,7024,9,7,8,17,43,57,-14,29
Young Boys,7025,1,21,8,3,79,37,42,71
FC Basel,7025,2,19,8,5,57,26,31,65
Lucerne,7025,3,13,9,10,43,47,-4,48
St Gallen,7025,4,13,2,17,41,61,-20,41
FC Zürich,7025,5,10,10,12,39,36,3,40
FC Lugano,7025,6,10,6,16,34,49,-15,36
Grasshoppers,7025,7,8,10,14,42,50,-8,34
FC Thun,7025,8,9,7,16,51,63,-12,34
FC Sion,7025,9,7,8,17,44,61,-17,29
Young Boys,7026,1,23,6,3,76,34,42,75
FC Basel,7026,2,16,10,6,50,27,23,58
Lucerne,7026,3,12,8,12,39,48,-9,44
St Gallen,7026,4,14,2,16,42,54,-12,44
FC Lugano,7026,5,12,5,15,34,45,-11,41
FC Zürich,7026,6,9,12,11,41,41,0,39
FC Thun,7026,7,10,7,15,45,56,-11,37
Grasshoppers,7026,8,9,7,16,40,49,-9,34
FC Sion,7026,9,6,9,17,41,54,-13,27
Young Boys,7027,1,22,6,4,77,38,39,72
FC Basel,7027,2,18,8,6,54,24,30,62
St Gallen,7027,3,15,2,15,42,53,-11,47
Lucerne,7027,4,12,7,13,38,48,-10,43
FC Zürich,7027,5,11,9,12,39,35,4,42
FC Lugano,7027,6,11,5,16,31,46,-15,38
Grasshoppers,7027,7,10,7,15,43,51,-8,37
FC Sion,7027,8,8,7,17,44,54,-10,31
FC Thun,7027,9,8,7,17,41,60,-19,31
Young Boys,7028,1,22,7,3,71,37,34,73
FC Basel,7028,2,19,7,6,52,23,29,64
St Gallen,7028,3,15,3,14,43,51,-8,48
Lucerne,7028,4,11,9,12,40,45,-5,42
FC Zürich,7028,5,10,9,13,43,38,5,39
FC Lugano,7028,6,11,5,16,32,48,-16,38
FC Thun,7028,7,10,6,16,47,62,-15,36
Grasshoppers,7028,8,9,8,15,45,51,-6,35
FC Sion,7028,9,6,8,18,43,61,-18,26
Young Boys,7029,1,23,6,3,75,32,43,75
FC Basel,7029,2,17,8,7,52,24,28,59
St Gallen,7029,3,14,3,15,41,55,-14,45
FC Lugano,7029,4,13,5,14,34,44,-10,44
FC Zürich,7029,5,11,10,11,42,37,5,43
Lucerne,7029,6,11,10,11,38,44,-6,43
FC Thun,7029,7,10,5,17,44,59,-15,35
Grasshoppers,7029,8,8,7,17,39,53,-14,31
FC Sion,7029,9,6,8,18,39,56,-17,26
Young Boys,7030,1,21,7,4,69,35,34,70
FC Basel,7030,2,18,9,5,53,25,28,63
St Gallen,7030,3,15,3,14,44,52,-8,48
Lucerne,7030,4,13,8,11,43,43,0,47
FC Zürich,7030,5,10,10,12,42,38,4,40
FC Thun,7030,6,10,7,15,45,57,-12,37
FC Lugano,7030,7,10,6,16,29,48,-19,36
Grasshoppers,7030,8,8,9,15,40,49,-9,33
FC Sion,7030,9,5,9,18,39,57,-18,24
Young Boys,7031,1,21,6,5,69,38,31,69
FC Basel,7031,2,19,7,6,55,25,30,64
Lucerne,7031,3,13,7,12,43,48,-5,46
FC Zürich,7031,4,12,9,11,45,39,6,45
St Gallen,7031,5,14,2,16,45,57,-12,44
FC Thun,7031,6,10,5,17,46,59,-13,35
FC Lugano,7031,7,10,5,17,31,49,-18,35
FC Sion,7031,8,9,7,16,50,56,-6,34
Grasshoppers,7031,9,9,6,17,40,53,-13,33
Young Boys,7032,1,20,7,5,66,37,29,67
FC Basel,7032,2,19,7,6,56,24,32,64
St Gallen,7032,3,15,2,15,44,56,-12,47
FC Zürich,7032,4,12,9,11,44,38,6,45
Lucerne,7032,5,11,9,12,38,43,-5,42
Grasshoppers,7032,6,11,6,15,41,46,-5,39
FC Lugano,7032,7,11,6,15,34,46,-12,39
FC Thun,7032,8,9,6,17,43,59,-16,33
FC Sion,7032,9,6,8,18,40,57,-17,26
Young Boys,7033,1,23,6,3,72,30,42,75
FC Basel,7033,2,18,7,7,58,29,29,61
Lucerne,7033,3,13,8,11,41,45,-4,47
FC Zürich,7033,4,11,11,10,42,36,6,44
St Gallen,7033,5,13,3,16,42,60,-18,42
FC Lugano,7033,6,10,8,14,30,44,-14,38
Grasshoppers,7033,7,10,6,16,42,51,-9,36
FC Sion,7033,8,7,8,17,45,55,-10,29
FC Thun,7033,9,8,5,19,39,61,-22,29
Young Boys,7034,1,22,7,3,71,34,37,73
FC Basel,7034,2,17,9,6,49,24,25,60
St Gallen,7034,3,13,5,14,41,54,-13,44
Lucerne,7034,4,12,7,13,39,42,-3,43
FC Zürich,7034,5,10,10,12,39,36,3,40
Grasshoppers,7034,6,11,7,14,41,46,-5,40
FC Lugano,7034,7,11,6,15,32,46,-14,39
FC Thun,7034,8,9,7,16,42,57,-15,34
FC Sion,7034,9,6,8,18,40,55,-15,26
Young Boys,7035,1,21,7,4,74,38,36,70
FC Basel,7035,2,19,8,5,59,22,37,65
FC Zürich,7035,3,12,10,10,46,36,10,46
Lucerne,7035,4,12,10,10,43,45,-2,46
St Gallen,7035,5,14,3,15,41,55,-14,45
FC Lugano,7035,6,10,6,16,33,52,-19,36
FC Thun,7035,7,9,6,17,46,63,-17,33
Grasshoppers,7035,8,8,8,16,43,54,-11,32
FC Sion,7035,9,6,8,18,40,60,-20,26
Young Boys,7036,1,20,9,3,66,35,31,69
FC Basel,7036,2,18,8,6,57,24,33,62
Lucerne,7036,3,13,10,9,43,41,2,49
FC Zürich,7036,4,11,9,12,39,35,4,42
St Gallen,7036,5,13,2,17,40,57,-17,41
FC Lugano,7036,6,10,6,16,30,46,-16,36
FC Thun,7036,7,10,5,17,43,63,-20,35
Grasshoppers,7036,8,9,7,16,41,51,-10,34
FC Sion,7036,9,8,8,16,45,52,-7,32
Young Boys,7037,1,23,6,3,76,36,40,75
FC Basel,7037,2,18,7,7,60,29,31,61
Lucerne,7037,3,14,7,11,47,45,2,49
St Gallen,7037,4,14,2,16,42,58,-16,44
FC Zürich,7037,5,10,10,12,42,40,2,40
FC Lugano,7037,6,11,5,16,30,47,-17,38
Grasshoppers,7037,7,9,6,17,39,50,-11,33
FC Thun,7037,8,9,6,17,41,58,-17,33
FC Sion,7037,9,8,7,17,40,54,-14,31
Young Boys,7038,1,23,7,2,77,32,45,76
FC Basel,7038,2,18,9,5,55,23,32,63
Lucerne,7038,3,12,8,12,41,46,-5,44
St Gallen,7038,4,13,5,14,40,52,-12,44
FC Zürich,7038,5,10,11,11,40,37,3,41
Grasshoppers,7038,6,10,6,16,39,49,-10,36
FC Lugano,7038,7,9,7,16,32,51,-19,34
FC Thun,7038,8,9,6,17,40,58,-18,33
FC Sion,7038,9,6,9,17,37,53,-16,27
Young Boys,7039,1,22,6,4,71,38,33,72
FC Basel,7039,2,17,7,8,52,27,25,58
Lucerne,7039,3,13,8,11,44,43,1,47
St Gallen,7039,4,14,2,16,41,55,-14,44
FC Zürich,7039,5,11,9,12,39,35,4,42
FC Lugano,7039,6,11,5,16,31,47,-16,38
Grasshoppers,7039,7,10,7,15,44,48,-4,37
FC Thun,7039,8,10,6,16,43,58,-15,36
FC Sion,7039,9,7,8,17,41,55,-14,29
Young Boys,7040,1,21,7,4,74,38,36,70
FC Basel,7040,2,17,9,6,51,25,26,60
Lucerne,7040,3,15,7,10,47,40,7,52
St Gallen,7040,4,13,2,17,41,60,-19,41
FC Zürich,7040,5,9,12,11,38,35,3,39
FC Lugano,7040,6,10,7,15,34,47,-13,37
Grasshoppers,7040,7,10,6,16,43,55,-12,36
FC Thun,7040,8,9,6,17,44,62,-18,33
FC Sion,7040,9,8,8,16,42,52,-10,32
Young Boys,7041,1,22,8,2,73,34,39,74
FC Basel,7041,2,18,8,6,53,23,30,62
St Gallen,7041,3,15,3,14,45,57,-12,48
Lucerne,7041,4,12,7,13,42,45,-3,43
FC Zürich,7041,5,11,9,12,45,36,9,42
Grasshoppers,7041,6,11,7,14,44,48,-4,40
FC Thun,7041,7,10,6,16,43,57,-14,36
FC Lugano,7041,8,9,5,18,31,53,-22,32
FC Sion,7041,9,5,9,18,39,62,-23,24
Young Boys,7042,1,21,8,3,70,35,35,71
FC Basel,7042,2,18,7,7,55,29,26,61
Lucerne,7042,3,14,7,11,41,40,1,49
St Gallen,7042,4,15,3,14,42,51,-9,48
FC Zürich,7042,5,11,10,11,40,35,5,43
Grasshoppers,7042,6,9,8,15,43,49,-6,35
FC Lugano,7042,7,9,6,17,27,46,-19,33
FC Thun,7042,8,9,5,18,41,61,-20,32
FC Sion,7042,9,6,10,16,39,52,-13,28
Young Boys,7043,1,21,8,3,72,35,37,71
FC Basel,7043,2,17,8,7,52,25,27,59
St Gallen,7043,3,15,2,15,48,57,-9,47
Lucerne,7043,4,12,8,12,38,48,-10,44
FC Zürich,7043,5,10,9,13,40,39,1,39
FC Lugano,7043,6,11,5,16,35,49,-14,38
Grasshoppers,7043,7,10,6,16,41,48,-7,36
FC Thun,7043,8,9,7,16,43,58,-15,34
FC Sion,7043,9,8,9,15,42,52,-10,33
Young Boys,7044,1,21,7,4,72,34,38,70
FC Basel,7044,2,16,9,7,51,27,24,57
St Gallen,7044,3,15,3,14,45,55,-10,48
Lucerne,7044,4,12,9,11,42,44,-2,45
FC Zürich,7044,5,10,11,11,39,36,3,41
Grasshoppers,7044,6,10,8,14,43,47,-4,38
FC Lugano,7044,7,10,5,17,29,51,-22,35
FC Thun,7044,8,9,6,17,45,61,-16,33
FC Sion,7044,9,7,10,15,39,50,-11,31
Young Boys,7045,1,22,6,4,74,38,36,72
FC Basel,7045,2,19,7,6,57,26,31,64
FC Zürich,7045,3,11,10,11,41,36,5,43
Lucerne,7045,4,12,7,13,38,44,-6,43
St Gallen,7045,5,13,3,16,39,55,-16,42
Grasshoppers,7045,6,11,6,15,46,47,-1,39
FC Lugano,7045,7,11,5,16,32,47,-15,38
FC Thun,7045,8,10,6,16,43,58,-15,36
FC Sion,7045,9,6,8,18,40,59,-19,26
Young Boys,7046,1,20,9,3,70,38,32,69
FC Basel,7046,2,19,7,6,56,25,31,64
St Gallen,7046,3,16,3,13,44,49,-5,51
Lucerne,7046,4,12,8,12,40,48,-8,44
FC Zürich,7046,5,11,10,11,42,36,6,43
FC Lugano,7046,6,10,8,14,33,45,-12,38
FC Thun,7046,7,9,6,17,44,57,-13,33
Grasshoppers,7046,8,8,8,16,39,52,-13,32
FC Sion,7046,9,5,9,18,39,57,-18,24
Young Boys,7047,1,21,7,4,68,36,32,70
FC Basel,7047,2,17,9,6,54,26,28,60
St Gallen,7047,3,15,3,14,44,56,-12,48
FC Zürich,7047,4,12,10,10,44,34,10,46
Lucerne,7047,5,13,7,12,42,46,-4,46
Grasshoppers,7047,6,10,7,15,44,48,-4,37
FC Lugano,7047,7,9,5,18,29,50,-21,32
FC Thun,7047,8,8,7,17,40,59,-19,31
FC Sion,7047,9,7,9,16,42,52,-10,30
Young Boys,7048,1,23,6,3,72,34,38,75
FC Basel,7048,2,18,9,5,56,25,31,63
St Gallen,7048,3,13,6,13,40,51,-11,45
Lucerne,7048,4,11,10,11,38,44,-6,43
FC Zürich,7048,5,10,10,12,40,39,1,40
FC Thun,7048,6,11,5,16,46,56,-10,38
FC Lugano,7048,7,10,7,15,29,44,-15,37
Grasshoppers,7048,8,9,7,16,41,51,-10,34
FC Sion,7048,9,5,8,19,38,56,-18,23
Young Boys,7049,1,23,7,2,79,32,47,76
FC Basel,7049,2,18,8,6,56,27,29,62
Lucerne,7049,3,13,7,12,45,50,-5,46
St Gallen,7049,4,14,3,15,41,52,-11,45
FC Zürich,7049,5,11,10,11,41,35,6,43
FC Lugano,7049,6,11,6,15,31,47,-16,39
FC Thun,7049,7,10,5,17,44,59,-15,35
Grasshoppers,7049,8,9,6,17,42,53,-11,33
FC Sion,7049,9,5,8,19,38,62,-24,23
Young Boys,7050,1,21,7,4,67,32,35,70
FC Basel,7050,2,19,8,5,58,23,35,65
St Gallen,7050,3,15,4,13,44,51,-7,49
Lucerne,7050,4,12,9,11,40,44,-4,45
FC Zürich,7050,5,11,9,12,41,36,5,42
FC Lugano,7050,6,10,7,15,32,48,-16,37
FC Thun,7050,7,9,5,18,43,65,-22,32
FC Sion,7050,8,8,7,17,39,51,-12,31
Grasshoppers,7050,9,8,6,18,37,51,-14,30
Young Boys,7051,1,22,6,4,72,32,40,72
FC Basel,7051,2,18,8,6,55,25,30,62
St Gallen,7051,3,15,2,15,43,56,-13,47
Lucerne,7051,4,13,7,12,41,44,-3,46
FC Zürich,7051,5,11,11,10,41,35,6,44
FC Thun,7051,6,11,6,15,47,57,-10,39
FC Lugano,7051,7,10,5,17,31,49,-18,35
Grasshoppers,7051,8,9,7,16,40,52,-12,34
FC Sion,7051,9,5,8,19,38,58,-20,23
Young Boys,7052,1,22,7,3,74,35,39,73
FC Basel,7052,2,18,9,5,58,24,34,63
Lucerne,7052,3,13,8,11,39,44,-5,47
St Gallen,7052,4,13,3,16,39,55,-16,42
FC Lugano,7052,5,11,6,15,31,46,-15,39
FC Zürich,7052,6,9,10,13,38,38,0,37
Grasshoppers,7052,7,10,6,16,42,49,-7,36
FC Thun,7052,8,10,5,17,47,62,-15,35
FC Sion,7052,9,7,8,17,41,56,-15,29
Young Boys,7053,1,21,8,3,77,36,41,71
FC Basel,7053,2,18,8,6,58,29,29,62
St Gallen,7053,3,15,2,15,43,53,-10,47
FC Zürich,7053,4,12,9,11,40,34,6,45
Lucerne,7053,5,12,7,13,39,48,-9,43
FC Lugano,7053,6,10,6,16,31,46,-15,36
Grasshoppers,7053,7,9,6,17,39,54,-15,33
FC Thun,7053,8,9,6,17,42,60,-18,33
FC Sion,7053,9,8,8,16,43,52,-9,32
Young Boys,7054,1,19,8,5,66,37,29,65
FC Basel,7054,2,18,9,5,55,22,33,63
Lucerne,7054,3,13,9,10,40,40,0,48
St Gallen,7054,4,14,3,15,45,58,-13,45
FC Zürich,7054,5,10,12,10,39,33,6,42
FC Lugano,7054,6,10,7,15,30,46,-16,37
Grasshoppers,7054,7,9,7,16,42,52,-10,34
FC Thun,7054,8,9,6,17,39,57,-18,33
FC Sion,7054,9,7,9,16,41,52,-11,30
Young Boys,7055,1,21,6,5,71,37,34,69
FC Basel,7055,2,18,8,6,53,25,28,62
St Gallen,7055,3,16,3,13,51,56,-5,51
FC Zürich,7055,4,12,10,10,43,36,7,46
Lucerne,7055,5,12,7,13,44,48,-4,43
Grasshoppers,7055,6,11,6,15,46,53,-7,39
FC Thun,7055,7,10,5,17,45,60,-15,35
FC Lugano,7055,8,9,5,18,30,53,-23,32
FC Sion,7055,9,6,8,18,47,62,-15,26
Young Boys,7056,1,21,7,4,70,37,33,70
FC Basel,7056,2,17,9,6,58,29,29,60
Lucerne,7056,3,13,9,10,45,42,3,48
St Gallen,7056,4,15,3,14,43,53,-10,48
FC Zürich,7056,5,11,11,10,44,37,7,44
FC Lugano,7056,6,10,6,16,28,45,-17,36
FC Thun,7056,7,10,5,17,43,58,-15,35
Grasshoppers,7056,8,9,6,17,40,53,-13,33
FC Sion,7056,9,6,8,18,42,59,-17,26
Young Boys,7057,1,23,7,2,68,29,39,76
FC Basel,7057,2,17,8,7,51,24,27,59
Lucerne,7057,3,13,9,10,40,41,-1,48
FC Zürich,7057,4,12,9,11,40,34,6,45
St Gallen,7057,5,13,3,16,39,57,-18,42
FC Lugano,7057,6,10,6,16,29,46,-17,36
Grasshoppers,7057,7,9,7,16,40,49,-9,34
FC Thun,7057,8,9,7,16,45,60,-15,34
FC Sion,7057,9,6,8,18,41,53,-12,26
Young Boys,7058,1,22,8,2,72,33,39,74
FC Basel,7058,2,18,9,5,53,23,30,63
Lucerne,7058,3,14,7,11,44,45,-1,49
FC Zürich,7058,4,12,9,11,41,35,6,45
St Gallen,7058,5,13,2,17,39,56,-17,41
FC Lugano,7058,6,10,5,17,30,49,-19,35
Grasshoppers,7058,7,9,7,16,41,48,-7,34
FC Thun,7058,8,8,7,17,42,61,-19,31
FC Sion,7058,9,7,8,17,39,51,-12,29
Young Boys,7059,1,21,9,2,71,34,37,72
FC Basel,7059,2,18,8,6,56,27,29,62
Lucerne,7059,3,13,9,10,46,44,2,48
St Gallen,7059,4,14,3,15,42,58,-16,45
FC Zürich,7059,5,9,11,12,39,39,0,38
Grasshoppers,7059,6,10,7,15,41,48,-7,37
FC Lugano,7059,7,9,7,16,30,48,-18,34
FC Thun,7059,8,9,6,17,41,59,-18,33
FC Sion,7059,9,7,8,17,43,52,-9,29
Young Boys,7060,1,21,8,3,74,40,34,71
FC Basel,7060,2,15,9,8,51,32,19,54
Lucerne,7060,3,13,10,9,46,44,2,49
St Gallen,7060,4,14,3,15,45,57,-12,45
FC Zürich,7060,5,10,11,11,41,38,3,41
FC Thun,7060,6,10,6,16,46,59,-13,36
FC Lugano,7060,7,10,6,16,30,48,-18,36
Grasshoppers,7060,8,9,8,15,43,48,-5,35
FC Sion,7060,9,6,11,15,44,54,-10,29
Young Boys,7061,1,21,8,3,67,32,35,71
FC Basel,7061,2,17,8,7,51,24,27,59
Lucerne,7061,3,12,8,12,38,42,-4,44
St Gallen,7061,4,13,5,14,41,53,-12,44
FC Zürich,7061,5,11,10,11,43,39,4,43
FC Lugano,7061,6,12,5,15,34,46,-12,41
Grasshoppers,7061,7,10,8,14,40,45,-5,38
FC Thun,7061,8,9,6,17,41,59,-18,33
FC Sion,7061,9,5,10,17,38,53,-15,25
Young Boys,7062,1,23,7,2,72,31,41,76
FC Basel,7062,2,17,7,8,54,28,26,58
St Gallen,7062,3,15,3,14,42,53,-11,48
FC Zürich,7062,4,12,10,10,46,35,11,46
Lucerne,7062,5,13,7,12,41,45,-4,46
FC Thun,7062,6,10,5,17,47,60,-13,35
Grasshoppers,7062,7,9,6,17,41,52,-11,33
FC Lugano,7062,8,9,6,17,28,48,-20,33
FC Sion,7062,9,6,9,17,38,57,-19,27
Young Boys,7063,1,20,8,4,71,39,32,68
FC Basel,7063,2,18,9,5,55,24,31,63
Lucerne,7063,3,14,7,11,47,46,1,49
FC Zürich,7063,4,11,10,11,41,37,4,43
St Gallen,7063,5,13,3,16,41,58,-17,42
FC Lugano,7063,6,11,6,15,35,49,-14,39
Grasshoppers,7063,7,9,7,16,40,48,-8,34
FC Thun,7063,8,9,7,16,43,58,-15,34
FC Sion,7063,9,6,9,17,40,54,-14,27
Young Boys,7064,1,22,7,3,77,36,41,73
FC Basel,7064,2,16,10,6,51,25,26,58
Lucerne,7064,3,15,8,9,48,42,6,53
St Gallen,7064,4,13,3,16,42,61,-19,42
FC Zürich,7064,5,10,10,12,39,37,2,40
FC Thun,7064,6,10,7,15,43,56,-13,37
FC Lugano,7064,7,9,6,17,29,50,-21,33
Grasshoppers,7064,8,8,8,16,41,53,-12,32
FC Sion,7064,9,8,7,17,46,56,-10,31
Young Boys,7065,1,21,7,4,69,35,34,70
FC Basel,7065,2,18,8,6,51,23,28,62
St Gallen,7065,3,16,2,14,45,52,-7,50
FC Zürich,7065,4,11,11,10,43,36,7,44
Lucerne,7065,5,11,9,12,39,44,-5,42
Grasshoppers,7065,6,10,8,14,46,48,-2,38
FC Thun,7065,7,9,6,17,42,61,-19,33
FC Lugano,7065,8,9,6,17,30,49,-19,33
FC Sion,7065,9,7,7,18,40,57,-17,28
Young Boys,7066,1,22,6,4,72,35,37,72
FC Basel,7066,2,17,9,6,54,27,27,60
St Gallen,7066,3,15,4,13,44,52,-8,49
Lucerne,7066,4,13,8,11,48,47,1,47
FC Zürich,7066,5,10,9,13,39,36,3,39
FC Lugano,7066,6,10,5,17,29,48,-19,35
Grasshoppers,7066,7,9,7,16,40,53,-13,34
FC Thun,7066,8,9,7,16,43,59,-16,34
FC Sion,7066,9,7,9,16,41,53,-12,30
Young Boys,7067,1,23,7,2,76,30,46,76
FC Basel,7067,2,19,8,5,57,23,34,65
Lucerne,7067,3,12,9,11,45,46,-1,45
St Gallen,7067,4,14,3,15,40,53,-13,45
FC Zürich,7067,5,9,10,13,39,42,-3,37
FC Thun,7067,6,10,5,17,48,62,-14,35
FC Lugano,7067,7,10,5,17,32,51,-19,35
Grasshoppers,7067,8,9,7,16,39,55,-16,34
FC Sion,7067,9,7,8,17,40,54,-14,29
Young Boys,7068,1,22,6,4,71,36,35,72
FC Basel,7068,2,18,8,6,55,26,29,62
Lucerne,7068,3,12,8,12,41,46,-5,44
FC Lugano,7068,4,13,5,14,36,45,-9,44
St Gallen,7068,5,13,3,16,39,56,-17,42
FC Thun,7068,6,11,6,15,50,58,-8,39
FC Zürich,7068,7,9,10,13,39,39,0,37
Grasshoppers,7068,8,9,6,17,42,53,-11,33
FC Sion,7068,9,7,8,17,41,55,-14,29
Young Boys,7069,1,21,6,5,73,39,34,69
FC Basel,7069,2,18,8,6,53,25,28,62
Lucerne,7069,3,13,8,11,41,43,-2,47
St Gallen,7069,4,13,5,14,42,54,-12,44
Grasshoppers,7069,5,11,6,15,41,45,-4,39
FC Lugano,7069,6,11,6,15,32,48,-16,39
FC Zürich,7069,7,9,9,14,38,42,-4,36
FC Thun,7069,8,10,6,16,43,56,-13,36
FC Sion,7069,9,7,8,17,42,53,-11,29
Young Boys,7070,1,23,6,3,78,37,41,75
FC Basel,7070,2,18,8,6,55,28,27,62
Lucerne,7070,3,12,9,11,44,46,-2,45
St Gallen,7070,4,14,3,15,47,58,-11,45
FC Zürich,7070,5,11,9,12,47,37,10,42
FC Lugano,7070,6,10,7,15,30,47,-17,37
Grasshoppers,7070,7,10,6,16,43,52,-9,36
FC Thun,7070,8,9,5,18,41,58,-17,32
FC Sion,7070,9,7,7,18,40,62,-22,28
Young Boys,7071,1,23,6,3,75,36,39,75
FC Basel,7071,2,17,8,7,54,27,27,59
Lucerne,7071,3,14,8,10,47,45,2,50
St Gallen,7071,4,14,3,15,44,57,-13,45
FC Zürich,7071,5,11,11,10,42,35,7,44
FC Lugano,7071,6,10,7,15,33,49,-16,37
FC Thun,7071,7,9,7,16,44,59,-15,34
Grasshoppers,7071,8,9,6,17,41,52,-11,33
FC Sion,7071,9,5,8,19,40,60,-20,23
Young Boys,7072,1,21,7,4,71,36,35,70
FC Basel,7072,2,18,8,6,55,25,30,62
Lucerne,7072,3,13,9,10,43,44,-1,48
FC Zürich,7072,4,11,10,11,39,34,5,43
St Gallen,7072,5,13,3,16,42,61,-19,42
Grasshoppers,7072,6,11,6,15,46,49,-3,39
FC Lugano,7072,7,10,5,17,31,49,-18,35
FC Thun,7072,8,9,5,18,42,60,-18,32
FC Sion,7072,9,8,7,17,43,54,-11,31
Young Boys,7073,1,22,8,2,78,37,41,74
FC Basel,7073,2,17,9,6,59,26,33,60
FC Zürich,7073,3,12,10,10,42,35,7,46
Lucerne,7073,4,13,7,12,44,49,-5,46
St Gallen,7073,5,13,5,14,41,54,-13,44
Grasshoppers,7073,6,11,6,15,44,50,-6,39
FC Thun,7073,7,9,6,17,44,61,-17,33
FC Lugano,7073,8,9,6,17,31,51,-20,33
FC Sion,7073,9,5,9,18,40,60,-20,24
Young Boys,7074,1,24,6,2,77,34,43,78
FC Basel,7074,2,18,8,6,61,27,34,62
Lucerne,7074,3,13,8,11,45,48,-3,47
FC Zürich,7074,4,12,9,11,42,36,6,45
St Gallen,7074,5,14,2,16,41,55,-14,44
Grasshoppers,7074,6,10,7,15,45,49,-4,37
FC Lugano,7074,7,9,5,18,30,52,-22,32
FC Thun,7074,8,8,7,17,40,62,-22,31
FC Sion,7074,9,6,8,18,37,55,-18,26
Young Boys,7075,1,23,7,2,74,33,41,76
FC Basel,7075,2,18,8,6,55,27,28,62
Lucerne,7075,3,13,8,11,43,43,0,47
St Gallen,7075,4,14,2,16,43,54,-11,44
FC Zürich,7075,5,10,11,11,44,37,7,41
FC Lugano,7075,6,10,7,15,30,46,-16,37
FC Sion,7075,7,8,8,16,44,54,-10,32
Grasshoppers,7075,8,8,7,17,38,54,-16,31
FC Thun,7075,9,8,6,18,43,66,-23,30
Young Boys,7076,1,22,7,3,76,36,40,73
FC Basel,7076,2,17,8,7,54,28,26,59
St Gallen,7076,3,15,4,13,45,52,-7,49
Lucerne,7076,4,12,8,12,41,47,-6,44
FC Zürich,7076,5,10,10,12,38,37,1,40
Grasshoppers,7076,6,11,6,15,42,50,-8,39
FC Thun,7076,7,10,5,17,42,59,-17,35
FC Lugano,7076,8,9,6,17,29,48,-19,33
FC Sion,7076,9,7,8,17,42,52,-10,29
Young Boys,7077,1,21,9,2,72,36,36,72
FC Basel,7077,2,19,8,5,59,23,36,65
Lucerne,7077,3,14,7,11,45,44,1,49
St Gallen,7077,4,15,2,15,46,55,-9,47
FC Zürich,7077,5,9,12,11,40,40,0,39
FC Lugano,7077,6,9,7,16,29,48,-19,34
FC Thun,7077,7,9,6,17,44,61,-17,33
Grasshoppers,7077,8,8,7,17,39,52,-13,31
FC Sion,7077,9,7,8,17,43,58,-15,29
Young Boys,7078,1,23,7,2,71,30,41,76
FC Basel,7078,2,18,8,6,54,23,31,62
St Gallen,7078,3,13,5,14,40,52,-12,44
FC Zürich,7078,4,11,9,12,39,37,2,42
Lucerne,7078,5,11,9,12,41,47,-6,42
FC Lugano,7078,6,11,5,16,32,48,-16,38
Grasshoppers,7078,7,9,8,15,45,51,-6,35
FC Thun,7078,8,9,6,17,42,59,-17,33
FC Sion,7078,9,6,9,17,38,55,-17,27
Young Boys,7079,1,21,8,3,72,34,38,71
FC Basel,7079,2,17,8,7,55,24,31,59
FC Zürich,7079,3,11,11,10,40,33,7,44
Lucerne,7079,4,12,8,12,39,48,-9,44
St Gallen,7079,5,14,2,16,41,55,-14,44
FC Lugano,7079,6,12,5,15,33,44,-11,41
Grasshoppers,7079,7,9,7,16,40,50,-10,34
FC Thun,7079,8,9,7,16,44,64,-20,34
FC Sion,7079,9,6,10,16,42,54,-12,28
Young Boys,7080,1,21,8,3,71,34,37,71
FC Basel,7080,2,16,9,7,54,32,22,57
St Gallen,7080,3,16,3,13,47,51,-4,51
Lucerne,7080,4,12,10,10,41,43,-2,46
FC Zürich,7080,5,12,9,11,49,41,8,45
FC Thun,7080,6,10,6,16,46,59,-13,36
FC Lugano,7080,7,9,6,17,32,52,-20,33
Grasshoppers,7080,8,8,8,16,37,49,-12,32
FC Sion,7080,9,7,7,18,42,58,-16,28
Young Boys,7081,1,23,7,2,75,32,43,76
FC Basel,7081,2,17,8,7,51,25,26,59
Lucerne,7081,3,13,8,11,39,42,-3,47
St Gallen,7081,4,14,3,15,42,55,-13,45
FC Zürich,7081,5,10,10,12,39,36,3,40
FC Thun,7081,6,10,6,16,44,58,-14,36
FC Lugano,7081,7,9,7,16,29,47,-18,34
Grasshoppers,7081,8,8,8,16,39,51,-12,32
FC Sion,7081,9,8,7,17,42,54,-12,31
Young Boys,7082,1,23,7,2,73,32,41,76
FC Basel,7082,2,18,8,6,54,25,29,62
St Gallen,7082,3,15,3,14,44,53,-9,48
Lucerne,7082,4,12,10,10,41,42,-1,46
FC Zürich,7082,5,12,9,11,45,36,9,45
FC Thun,7082,6,9,6,17,44,61,-17,33
Grasshoppers,7082,7,8,8,16,40,53,-13,32
FC Lugano,7082,8,9,5,18,29,52,-23,32
FC Sion,7082,9,6,8,18,41,57,-16,26
Young Boys,7083,1,23,6,3,72,33,39,75
FC Basel,7083,2,18,9,5,58,26,32,63
St Gallen,7083,3,15,3,14,47,56,-9,48
Lucerne,7083,4,13,8,11,43,46,-3,47
FC Zürich,7083,5,9,10,13,38,38,0,37
Grasshoppers,7083,6,10,6,16,42,49,-7,36
FC Lugano,7083,7,10,6,16,31,49,-18,36
FC Thun,7083,8,10,5,17,46,58,-12,35
FC Sion,7083,9,6,7,19,42,64,-22,25
Young Boys,7084,1,22,6,4,75,36,39,72
FC Basel,7084,2,19,7,6,56,26,30,64
St Gallen,7084,3,15,2,15,42,52,-10,47
Lucerne,7084,4,13,7,12,40,47,-7,46
FC Zürich,7084,5,9,11,12,39,37,2,38
FC Thun,7084,6,11,5,16,47,59,-12,38
FC Lugano,7084,7,10,6,16,32,49,-17,36
Grasshoppers,7084,8,9,7,16,41,51,-10,34
FC Sion,7084,9,6,9,17,38,53,-15,27
Young Boys,7085,1,20,9,3,69,34,35,69
FC Basel,7085,2,18,8,6,55,26,29,62
St Gallen,7085,3,15,3,14,44,53,-9,48
FC Zürich,7085,4,11,10,11,42,37,5,43
Lucerne,7085,5,12,7,13,41,46,-5,43
Grasshoppers,7085,6,10,8,14,44,47,-3,38
FC Thun,7085,7,10,7,15,44,56,-12,37
FC Lugano,7085,8,9,6,17,31,52,-21,33
FC Sion,7085,9,6,8,18,38,57,-19,26
Young Boys,7086,1,23,6,3,79,36,43,75
FC Basel,7086,2,19,7,6,55,25,30,64
Lucerne,7086,3,12,8,12,38,45,-7,44
FC Zürich,7086,4,11,9,12,40,37,3,42
St Gallen,7086,5,13,3,16,38,57,-19,42
FC Lugano,7086,6,11,5,16,36,48,-12,38
Grasshoppers,7086,7,10,7,15,40,47,-7,37
FC Thun,7086,8,10,5,17,44,56,-12,35
FC Sion,7086,9,6,8,18,37,56,-19,26
Young Boys,7087,1,22,7,3,72,33,39,73
FC Basel,7087,2,19,8,5,55,23,32,65
St Gallen,7087,3,14,4,14,43,54,-11,46
Lucerne,7087,4,12,8,12,40,47,-7,44
FC Zürich,7087,5,10,11,11,42,35,7,41
Grasshoppers,7087,6,10,7,15,44,49,-5,37
FC Lugano,7087,7,10,6,16,32,48,-16,36
FC Thun,7087,8,9,6,17,43,62,-19,33
FC Sion,7087,9,5,9,18,38,58,-20,24
Young Boys,7088,1,23,6,3,72,31,41,75
FC Basel,7088,2,19,7,6,60,28,32,64
Lucerne,7088,3,14,7,11,43,45,-2,49
St Gallen,7088,4,15,3,14,44,54,-10,48
FC Zürich,7088,5,9,10,13,40,40,0,37
FC Lugano,7088,6,10,6,16,31,48,-17,36
Grasshoppers,7088,7,9,7,16,40,51,-11,34
FC Thun,7088,8,8,7,17,42,61,-19,31
FC Sion,7088,9,6,9,17,36,50,-14,27
Young Boys,7089,1,21,7,4,70,35,35,70
FC Basel,7089,2,18,7,7,57,29,28,61
FC Zürich,7089,3,13,9,10,47,36,11,48
Lucerne,7089,4,13,8,11,43,45,-2,47
St Gallen,7089,5,15,2,15,42,57,-15,47
FC Lugano,7089,6,10,6,16,29,48,-19,36
FC Thun,7089,7,9,6,17,46,63,-17,33
Grasshoppers,7089,8,8,7,17,41,52,-11,31
FC Sion,7089,9,7,8,17,43,53,-10,29
Young Boys,7090,1,23,6,3,75,37,38,75
FC Basel,7090,2,17,7,8,53,28,25,58
Lucerne,7090,3,13,8,11,46,47,-1,47
FC Zürich,7090,4,10,11,11,41,35,6,41
St Gallen,7090,5,13,2,17,41,57,-16,41
FC Thun,7090,6,11,6,15,45,56,-11,39
FC Lugano,7090,7,10,7,15,32,48,-16,37
Grasshoppers,7090,8,10,6,16,44,53,-9,36
FC Sion,7090,9,7,7,18,40,56,-16,28
Young Boys,7091,1,20,7,5,67,38,29,67
FC Basel,7091,2,19,8,5,60,22,38,65
St Gallen,7091,3,14,3,15,43,56,-13,45
Lucerne,7091,4,12,8,12,41,47,-6,44
FC Zürich,7091,5,11,10,11,43,38,5,43
Grasshoppers,7091,6,11,7,14,49,47,2,40
FC Lugano,7091,7,11,6,15,34,48,-14,39
FC Thun,7091,8,9,6,17,45,62,-17,33
FC Sion,7091,9,6,7,19,41,65,-24,25
Young Boys,7092,1,20,8,4,68,33,35,68
FC Basel,7092,2,17,8,7,51,27,24,59
St Gallen,7092,3,16,3,13,49,51,-2,51
Lucerne,7092,4,12,9,11,41,45,-4,45
FC Zürich,7092,5,11,11,10,44,34,10,44
FC Lugano,7092,6,11,6,15,31,47,-16,39
Grasshoppers,7092,7,8,9,15,41,50,-9,33
FC Thun,7092,8,9,5,18,42,62,-20,32
FC Sion,7092,9,6,9,17,40,58,-18,27
Young Boys,7093,1,22,8,2,78,33,45,74
FC Basel,7093,2,18,8,6,57,26,31,62
Lucerne,7093,3,13,7,12,39,45,-6,46
St Gallen,7093,4,14,3,15,44,56,-12,45
FC Zürich,7093,5,11,10,11,40,35,5,43
Grasshoppers,7093,6,11,7,14,44,46,-2,40
FC Thun,7093,7,9,6,17,44,60,-16,33
FC Lugano,7093,8,9,6,17,28,49,-21,33
FC Sion,7093,9,6,7,19,39,63,-24,25
Young Boys,7094,1,21,8,3,73,39,34,71
FC Basel,7094,2,18,9,5,53,23,30,63
St Gallen,7094,3,15,3,14,42,52,-10,48
FC Zürich,7094,4,11,10,11,43,35,8,43
Lucerne,7094,5,11,9,12,38,42,-4,42
Grasshoppers,7094,6,10,7,15,40,47,-7,37
FC Lugano,7094,7,9,7,16,32,51,-19,34
FC Sion,7094,8,8,7,17,43,53,-10,31
FC Thun,7094,9,8,6,18,41,63,-22,30
Young Boys,7095,1,23,7,2,74,31,43,76
FC Basel,7095,2,17,9,6,54,27,27,60
Lucerne,7095,3,12,9,11,41,42,-1,45
St Gallen,7095,4,14,2,16,43,57,-14,44
FC Zürich,7095,5,11,10,11,42,38,4,43
FC Lugano,7095,6,10,6,16,31,49,-18,36
FC Thun,7095,7,10,5,17,42,57,-15,35
Grasshoppers,7095,8,9,6,17,37,50,-13,33
FC Sion,7095,9,7,8,17,40,53,-13,29
Young Boys,7096,1,24,6,2,77,31,46,78
FC Basel,7096,2,17,8,7,54,26,28,59
St Gallen,7096,3,14,4,14,40,52,-12,46
Lucerne,7096,4,12,8,12,42,48,-6,44
FC Zürich,7096,5,11,10,11,41,35,6,43
FC Lugano,7096,6,10,6,16,32,50,-18,36
FC Thun,7096,7,9,7,16,42,60,-18,34
Grasshoppers,7096,8,8,8,16,38,50,-12,32
FC Sion,7096,9,6,9,17,39,53,-14,27
Young Boys,7097,1,22,7,3,74,32,42,73
FC Basel,7097,2,18,9,5,62,26,36,63
St Gallen,7097,3,15,2,15,43,57,-14,47
Lucerne,7097,4,13,7,12,44,46,-2,46
FC Zürich,7097,5,11,11,10,46,38,8,44
Grasshoppers,7097,6,10,7,15,40,49,-9,37
FC Lugano,7097,7,10,6,16,32,50,-18,36
FC Thun,7097,8,9,5,18,43,65,-22,32
FC Sion,7097,9,5,8,19,40,61,-21,23
Young Boys,7098,1,22,6,4,73,37,36,72
FC Basel,7098,2,20,7,5,60,26,34,67
St Gallen,7098,3,15,3,14,45,54,-9,48
Lucerne,7098,4,12,8,12,42,44,-2,44
FC Zürich,7098,5,11,10,11,40,35,5,43
FC Lugano,7098,6,9,7,16,29,51,-22,34
Grasshoppers,7098,7,8,8,16,39,52,-13,32
FC Thun,7098,8,8,7,17,43,60,-17,31
FC Sion,7098,9,6,10,16,42,54,-12,28
Young Boys,7099,1,21,7,4,70,37,33,70
FC Basel,7099,2,18,8,6,55,25,30,62
Lucerne,7099,3,13,7,12,43,43,0,46
St Gallen,7099,4,14,3,15,42,54,-12,45
FC Lugano,7099,5,12,5,15,34,48,-14,41
FC Zürich,7099,6,10,10,12,39,39,0,40
Grasshoppers,7099,7,11,6,15,44,51,-7,39
FC Thun,7099,8,9,6,17,45,60,-15,33
FC Sion,7099,9,5,10,17,40,55,-15,25
Young Boys,7100,1,21,7,4,71,35,36,70
FC Basel,7100,2,16,9,7,50,26,24,57
St Gallen,7100,3,15,3,14,43,53,-10,48
FC Zürich,7100,4,12,10,10,46,38,8,46
Lucerne,7100,5,12,8,12,38,43,-5,44
Grasshoppers,7100,6,10,8,14,46,47,-1,38
FC Lugano,7100,7,11,5,16,33,48,-15,38
FC Thun,7100,8,8,7,17,45,63,-18,31
FC Sion,7100,9,6,9,17,40,59,-19,27
Young Boys,7101,1,23,7,2,73,32,41,76
FC Basel,7101,2,16,9,7,50,27,23,57
Lucerne,7101,3,13,8,11,41,42,-1,47
St Gallen,7101,4,15,2,15,41,56,-15,47
FC Zürich,7101,5,12,9,11,43,36,7,45
FC Lugano,7101,6,11,5,16,32,45,-13,38
FC Thun,7101,7,9,5,18,42,60,-18,32
FC Sion,7101,8,8,7,17,43,53,-10,31
Grasshoppers,7101,9,8,6,18,40,54,-14,30
Young Boys,7102,1,20,7,5,67,35,32,67
FC Basel,7102,2,18,9,5,56,25,31,63
St Gallen,7102,3,15,4,13,47,51,-4,49
Lucerne,7102,4,13,8,11,42,43,-1,47
FC Zürich,7102,5,10,9,13,39,37,2,39
Grasshoppers,7102,6,11,6,15,45,49,-4,39
FC Lugano,7102,7,11,5,16,30,49,-19,38
FC Thun,7102,8,9,5,18,45,64,-19,32
FC Sion,7102,9,7,7,18,39,57,-18,28
Young Boys,7103,1,22,6,4,70,35,35,72
FC Basel,7103,2,18,7,7,58,25,33,61
St Gallen,7103,3,15,4,13,42,51,-9,49
Lucerne,7103,4,13,8,11,43,46,-3,47
FC Zürich,7103,5,12,9,11,42,37,5,45
FC Lugano,7103,6,10,6,16,30,45,-15,36
Grasshoppers,7103,7,9,7,16,41,51,-10,34
FC Thun,7103,8,9,6,17,43,63,-20,33
FC Sion,7103,9,5,9,18,38,54,-16,24
Young Boys,7104,1,23,7,2,72,31,41,76
FC Basel,7104,2,17,7,8,53,33,20,58
Lucerne,7104,3,13,7,12,40,43,-3,46
St Gallen,7104,4,14,3,15,42,54,-12,45
FC Zürich,7104,5,10,11,11,42,36,6,41
FC Thun,7104,6,10,7,15,45,57,-12,37
FC Lugano,7104,7,10,6,16,31,47,-16,36
Grasshoppers,7104,8,9,7,16,41,50,-9,34
FC Sion,7104,9,6,9,17,40,55,-15,27
Young Boys,7105,1,20,8,4,70,37,33,68
FC Basel,7105,2,18,8,6,53,28,25,62
St Gallen,7105,3,16,3,13,51,54,-3,51
Lucerne,7105,4,12,10,10,45,45,0,46
FC Zürich,7105,5,10,10,12,38,35,3,40
Grasshoppers,7105,6,11,6,15,45,52,-7,39
FC Lugano,7105,7,9,7,16,29,49,-20,34
FC Thun,7105,8,9,6,17,42,58,-16,33
FC Sion,7105,9,5,10,17,37,52,-15,25
Young Boys,7106,1,22,7,3,75,39,36,73
FC Basel,7106,2,19,7,6,55,24,31,64
St Gallen,7106,3,16,2,14,45,51,-6,50
Lucerne,7106,4,13,7,12,47,46,1,46
FC Zürich,7106,5,10,11,11,41,36,5,41
FC Thun,7106,6,10,5,17,44,60,-16,35
Grasshoppers,7106,7,9,7,16,44,57,-13,34
FC Lugano,7106,8,9,6,17,29,51,-22,33
FC Sion,7106,9,6,8,18,40,56,-16,26
Young Boys,7107,1,22,6,4,70,33,37,72
FC Basel,7107,2,18,9,5,58,27,31,63
Lucerne,7107,3,14,7,11,42,45,-3,49
St Gallen,7107,4,14,3,15,46,56,-10,45
FC Zürich,7107,5,11,10,11,41,34,7,43
FC Thun,7107,6,10,5,17,42,56,-14,35
FC Lugano,7107,7,10,5,17,30,48,-18,35
Grasshoppers,7107,8,9,7,16,38,50,-12,34
FC Sion,7107,9,6,8,18,36,54,-18,26
Young Boys,7108,1,21,8,3,73,35,38,71
FC Basel,7108,2,18,8,6,55,25,30,62
Lucerne,7108,3,13,8,11,43,41,2,47
St Gallen,7108,4,14,2,16,40,54,-14,44
FC Zürich,7108,5,11,10,11,42,37,5,43
FC Lugano,7108,6,11,5,16,30,46,-16,38
Grasshoppers,7108,7,9,7,16,42,54,-12,34
FC Thun,7108,8,9,7,16,44,60,-16,34
FC Sion,7108,9,7,7,18,42,59,-17,28
Young Boys,7109,1,22,7,3,71,35,36,73
FC Basel,7109,2,17,9,6,53,25,28,60
St Gallen,7109,3,14,3,15,42,55,-13,45
FC Zürich,7109,4,11,9,12,41,40,1,42
Lucerne,7109,5,11,9,12,40,46,-6,42
FC Thun,7109,6,11,5,16,47,57,-10,38
FC Lugano,7109,7,10,7,15,33,48,-15,37
Grasshoppers,7109,8,9,7,16,38,47,-9,34
FC Sion,7109,9,7,8,17,40,52,-12,29
FC Basel,7110,1,20,7,5,61,24,37,67
Young Boys,7110,2,19,9,4,71,41,30,66
St Gallen,7110,3,15,3,14,43,52,-9,48
Lucerne,7110,4,11,10,11,40,46,-6,43
FC Zürich,7110,5,10,10,12,41,42,-1,40
FC Lugano,7110,6,10,8,14,33,47,-14,38
Grasshoppers,7110,7,9,9,14,39,46,-7,36
FC Thun,7110,8,10,6,16,46,57,-11,36
FC Sion,7110,9,5,8,19,38,57,-19,23
Young Boys,7111,1,23,7,2,73,34,39,76
FC Basel,7111,2,18,8,6,54,25,29,62
St Gallen,7111,3,14,3,15,45,56,-11,45
Lucerne,7111,4,12,8,12,41,46,-5,44
FC Zürich,7111,5,11,9,12,41,39,2,42
FC Lugano,7111,6,11,6,15,34,47,-13,39
Grasshoppers,7111,7,9,6,17,42,52,-10,33
FC Thun,7111,8,8,7,17,41,58,-17,31
FC Sion,7111,9,7,8,17,40,54,-14,29
Young Boys,7112,1,20,8,4,69,38,31,68
FC Basel,7112,2,18,7,7,56,27,29,61
St Gallen,7112,3,15,2,15,46,56,-10,47
Lucerne,7112,4,13,7,12,39,41,-2,46
FC Zürich,7112,5,12,9,11,43,36,7,45
FC Lugano,7112,6,11,6,15,32,46,-14,39
Grasshoppers,7112,7,10,6,16,39,48,-9,36
FC Thun,7112,8,9,5,18,42,64,-22,32
FC Sion,7112,9,7,8,17,42,52,-10,29
Young Boys,7113,1,23,6,3,75,32,43,75
FC Basel,7113,2,19,7,6,54,23,31,64
St Gallen,7113,3,16,2,14,51,52,-1,50
Lucerne,7113,4,13,7,12,44,48,-4,46
FC Zürich,7113,5,9,9,14,39,39,0,36
FC Thun,7113,6,10,5,17,41,59,-18,35
FC Lugano,7113,7,10,5,17,29,54,-25,35
Grasshoppers,7113,8,9,6,17,39,52,-13,33
FC Sion,7113,9,8,7,17,44,57,-13,31
Young Boys,7114,1,22,6,4,74,37,37,72
FC Basel,7114,2,20,7,5,63,23,40,67
Lucerne,7114,3,13,7,12,41,44,-3,46
St Gallen,7114,4,14,3,15,42,59,-17,45
FC Thun,7114,5,11,5,16,48,62,-14,38
FC Zürich,7114,6,9,10,13,40,41,-1,37
FC Lugano,7114,7,9,7,16,31,50,-19,34
FC Sion,7114,8,8,8,16,42,51,-9,32
Grasshoppers,7114,9,8,7,17,40,54,-14,31
Young Boys,7115,1,20,6,6,67,38,29,66
FC Basel,7115,2,19,8,5,59,27,32,65
St Gallen,7115,3,16,3,13,45,52,-7,51
Lucerne,7115,4,14,7,11,42,41,1,49
Grasshoppers,7115,5,11,6,15,44,47,-3,39
FC Zürich,7115,6,9,11,12,40,40,0,38
FC Thun,7115,7,10,5,17,46,60,-14,35
FC Lugano,7115,8,9,6,17,30,49,-19,33
FC Sion,7115,9,6,8,18,35,54,-19,26
Young Boys,7116,1,21,8,3,68,34,34,71
FC Basel,7116,2,20,7,5,58,24,34,67
St Gallen,7116,3,14,2,16,41,53,-12,44
FC Zürich,7116,4,11,9,12,38,35,3,42
Lucerne,7116,5,11,8,13,37,46,-9,41
FC Lugano,7116,6,11,6,15,31,44,-13,39
Grasshoppers,7116,7,9,8,15,40,47,-7,35
FC Thun,7116,8,9,5,18,43,61,-18,32
FC Sion,7116,9,8,7,17,41,53,-12,31
Young Boys,7117,1,21,7,4,79,41,38,70
FC Basel,7117,2,17,8,7,54,28,26,59
Lucerne,7117,3,16,7,9,47,42,5,55
St Gallen,7117,4,13,3,16,41,57,-16,42
FC Zürich,7117,5,10,11,11,39,36,3,41
FC Thun,7117,6,11,5,16,46,57,-11,38
FC Lugano,7117,7,10,7,15,30,45,-15,37
Grasshoppers,7117,8,8,6,18,39,58,-19,30
FC Sion,7117,9,7,8,17,46,57,-11,29
Young Boys,7118,1,23,6,3,75,35,40,75
FC Basel,7118,2,17,9,6,53,28,25,60
St Gallen,7118,3,14,3,15,42,53,-11,45
Lucerne,7118,4,12,8,12,42,47,-5,44
FC Zürich,7118,5,11,10,11,43,37,6,43
Grasshoppers,7118,6,11,6,15,46,49,-3,39
FC Lugano,7118,7,9,6,17,32,52,-20,33
FC Thun,7118,8,8,8,16,41,59,-18,32
FC Sion,7118,9,7,8,17,37,51,-14,29
Young Boys,7119,1,20,8,4,68,38,30,68
FC Basel,7119,2,20,7,5,57,22,35,67
St Gallen,7119,3,15,2,15,46,56,-10,47
Lucerne,7119,4,12,7,13,39,48,-9,43
Grasshoppers,7119,5,11,6,15,46,48,-2,39
FC Zürich,7119,6,9,11,12,38,36,2,38
FC Lugano,7119,7,10,7,15,31,46,-15,37
FC Thun,7119,8,10,6,16,45,60,-15,36
FC Sion,7119,9,5,10,17,39,55,-16,25
Young Boys,7120,1,23,6,3,69,32,37,75
FC Basel,7120,2,16,8,8,49,31,18,56
St Gallen,7120,3,16,2,14,49,54,-5,50
Lucerne,7120,4,13,7,12,40,43,-3,46
FC Zürich,7120,5,12,9,11,45,33,12,45
FC Thun,7120,6,11,6,15,45,55,-10,39
Grasshoppers,7120,7,10,6,16,39,49,-10,36
FC Lugano,7120,8,9,5,18,29,52,-23,32
FC Sion,7120,9,6,7,19,39,55,-16,25
Young Boys,7121,1,20,9,3,69,33,36,69
FC Basel,7121,2,16,10,6,51,27,24,58
Lucerne,7121,3,14,7,11,44,41,3,49
FC Lugano,7121,4,12,6,14,32,43,-11,42
FC Zürich,7121,5,10,11,11,39,35,4,41
St Gallen,7121,6,13,2,17,40,59,-19,41
Grasshoppers,7121,7,9,8,15,40,48,-8,35
FC Sion,7121,8,8,9,15,44,54,-10,33
FC Thun,7121,9,8,6,18,42,61,-19,30
Young Boys,7122,1,20,7,5,68,40,28,67
FC Basel,7122,2,18,7,7,56,26,30,61
St Gallen,7122,3,17,2,13,48,50,-2,53
Lucerne,7122,4,13,7,12,42,45,-3,46
FC Zürich,7122,5,12,9,11,42,36,6,45
FC Thun,7122,6,10,6,16,48,60,-12,36
FC Lugano,7122,7,10,5,17,31,50,-19,35
Grasshoppers,7122,8,9,7,16,45,56,-11,34
FC Sion,7122,9,5,10,17,42,59,-17,25
Young Boys,7123,1,24,6,2,74,31,43,78
FC Basel,7123,2,18,7,7,53,28,25,61
Lucerne,7123,3,14,7,11,42,42,0,49
FC Zürich,7123,4,11,10,11,44,38,6,43
St Gallen,7123,5,13,2,17,40,59,-19,41
FC Thun,7123,6,10,6,16,47,60,-13,36
FC Lugano,7123,7,10,5,17,32,50,-18,35
Grasshoppers,7123,8,9,6,17,38,51,-13,33
FC Sion,7123,9,7,7,18,43,54,-11,28
Young Boys,7124,1,21,8,3,73,36,37,71
FC Basel,7124,2,16,11,5,53,27,26,59
Lucerne,7124,3,13,9,10,43,41,2,48
St Gallen,7124,4,14,3,15,43,57,-14,45
FC Zürich,7124,5,11,11,10,43,36,7,44
FC Lugano,7124,6,10,5,17,30,50,-20,35
FC Thun,7124,7,9,7,16,46,60,-14,34
Grasshoppers,7124,8,9,6,17,41,49,-8,33
FC Sion,7124,9,6,10,16,41,57,-16,28
Young Boys,7125,1,22,7,3,73,36,37,73
FC Basel,7125,2,15,8,9,50,32,18,53
St Gallen,7125,3,14,4,14,41,53,-12,46
FC Zürich,7125,4,11,10,11,44,37,7,43
Lucerne,7125,5,11,10,11,40,46,-6,43
FC Lugano,7125,6,10,7,15,37,49,-12,37
FC Thun,7125,7,10,7,15,45,58,-13,37
Grasshoppers,7125,8,8,9,15,39,50,-11,33
FC Sion,7125,9,8,8,16,42,50,-8,32
Young Boys,7126,1,22,7,3,75,36,39,73
FC Basel,7126,2,17,8,7,54,31,23,59
St Gallen,7126,3,16,2,14,49,57,-8,50
FC Zürich,7126,4,13,9,10,49,33,16,48
Lucerne,7126,5,13,8,11,41,42,-1,47
FC Lugano,7126,6,10,5,17,31,53,-22,35
Grasshoppers,7126,7,9,6,17,42,51,-9,33
FC Thun,7126,8,9,6,17,41,57,-16,33
FC Sion,7126,9,6,7,19,40,62,-22,25
Young Boys,7127,1,20,10,2,69,34,35,70
FC Basel,7127,2,18,8,6,58,28,30,62
Lucerne,7127,3,12,11,9,46,44,2,47
St Gallen,7127,4,13,3,16,39,55,-16,42
FC Lugano,7127,5,11,6,15,30,46,-16,39
FC Zürich,7127,6,9,11,12,40,38,2,38
Grasshoppers,7127,7,9,9,14,43,49,-6,36
FC Thun,7127,8,9,7,16,43,60,-17,34
FC Sion,7127,9,6,9,17,41,55,-14,27
Young Boys,7128,1,21,6,5,68,35,33,69
FC Basel,7128,2,16,9,7,50,28,22,57
Lucerne,7128,3,13,9,10,44,43,1,48
St Gallen,7128,4,14,4,14,42,51,-9,46
FC Zürich,7128,5,11,9,12,44,38,6,42
FC Lugano,7128,6,11,7,14,33,46,-13,40
Grasshoppers,7128,7,10,6,16,41,50,-9,36
FC Thun,7128,8,9,6,17,41,59,-18,33
FC Sion,7128,9,7,8,17,39,52,-13,29
Young Boys,7129,1,21,7,4,72,38,34,70
FC Basel,7129,2,18,8,6,54,26,28,62
St Gallen,7129,3,14,4,14,43,53,-10,46
Lucerne,7129,4,12,8,12,42,45,-3,44
FC Lugano,7129,5,12,5,15,32,46,-14,41
FC Zürich,7129,6,9,10,13,37,37,0,37
Grasshoppers,7129,7,9,7,16,42,52,-10,34
FC Sion,7129,8,8,9,15,43,51,-8,33
FC Thun,7129,9,9,6,17,42,59,-17,33
Young Boys,7130,1,21,8,3,71,38,33,71
FC Basel,7130,2,19,7,6,59,25,34,64
St Gallen,7130,3,14,4,14,45,54,-9,46
Lucerne,7130,4,12,8,12,40,45,-5,44
FC Zürich,7130,5,11,9,12,40,36,4,42
FC Lugano,7130,6,11,6,15,32,47,-15,39
FC Thun,7130,7,10,6,16,48,63,-15,36
Grasshoppers,7130,8,9,6,17,43,51,-8,33
FC Sion,7130,9,5,10,17,41,60,-19,25
Young Boys,7131,1,22,7,3,70,35,35,73
FC Basel,7131,2,18,7,7,57,29,28,61
Lucerne,7131,3,13,8,11,40,43,-3,47
St Gallen,7131,4,15,2,15,44,56,-12,47
FC Zürich,7131,5,11,9,12,41,37,4,42
Grasshoppers,7131,6,10,7,15,41,49,-8,37
FC Thun,7131,7,10,5,17,47,62,-15,35
FC Lugano,7131,8,9,6,17,28,46,-18,33
FC Sion,7131,9,7,7,18,46,57,-11,28
Young Boys,7132,1,22,7,3,70,31,39,73
FC Basel,7132,2,18,7,7,52,26,26,61
St Gallen,7132,3,15,3,14,48,54,-6,48
FC Zürich,7132,4,12,10,10,43,36,7,46
Lucerne,7132,5,11,9,12,41,49,-8,42
FC Lugano,7132,6,9,8,15,32,51,-19,35
Grasshoppers,7132,7,9,7,16,38,48,-10,34
FC Thun,7132,8,9,6,17,44,59,-15,33
FC Sion,7132,9,7,7,18,43,57,-14,28
Young Boys,7133,1,20,8,4,71,35,36,68
FC Basel,7133,2,16,9,7,50,28,22,57
Lucerne,7133,3,14,9,9,41,39,2,51
St Gallen,7133,4,14,3,15,43,56,-13,45
FC Zürich,7133,5,10,12,10,44,38,6,42
FC Thun,7133,6,10,7,15,47,58,-11,37
Grasshoppers,7133,7,10,6,16,44,51,-7,36
FC Lugano,7133,8,9,7,16,32,49,-17,34
FC Sion,7133,9,6,9,17,39,57,-18,27
Young Boys,7134,1,24,6,2,82,37,45,78
FC Basel,7134,2,16,9,7,51,30,21,57
St Gallen,7134,3,14,3,15,42,54,-12,45
Lucerne,7134,4,12,7,13,41,50,-9,43
FC Lugano,7134,5,12,5,15,39,47,-8,41
FC Thun,7134,6,11,6,15,50,56,-6,39
FC Zürich,7134,7,9,11,12,38,42,-4,38
Grasshoppers,7134,8,10,6,16,44,50,-6,36
FC Sion,7134,9,5,9,18,39,60,-21,24
Young Boys,7135,1,21,7,4,71,38,33,70
FC Basel,7135,2,19,7,6,59,24,35,64
St Gallen,7135,3,15,3,14,44,56,-12,48
Lucerne,7135,4,12,8,12,42,48,-6,44
FC Zürich,7135,5,10,10,12,39,37,2,40
Grasshoppers,7135,6,11,7,14,50,49,1,40
FC Lugano,7135,7,10,5,17,33,49,-16,35
FC Thun,7135,8,9,6,17,45,63,-18,33
FC Sion,7135,9,6,9,17,37,56,-19,27
Young Boys,7136,1,22,8,2,77,38,39,74
FC Basel,7136,2,17,7,8,56,29,27,58
Lucerne,7136,3,12,8,12,43,49,-6,44
St Gallen,7136,4,14,2,16,41,58,-17,44
FC Zürich,7136,5,11,10,11,44,39,5,43
Grasshoppers,7136,6,9,8,15,48,53,-5,35
FC Lugano,7136,7,10,5,17,31,49,-18,35
FC Thun,7136,8,10,5,17,44,65,-21,35
FC Sion,7136,9,8,9,15,49,53,-4,33
Young Boys,7137,1,22,7,3,73,36,37,73
FC Basel,7137,2,16,8,8,54,32,22,56
Lucerne,7137,3,13,8,11,43,43,0,47
St Gallen,7137,4,13,4,15,41,54,-13,43
FC Zürich,7137,5,10,9,13,39,38,1,39
FC Thun,7137,6,11,6,15,50,60,-10,39
FC Lugano,7137,7,11,5,16,33,48,-15,38
Grasshoppers,7137,8,10,6,16,45,53,-8,36
FC Sion,7137,9,7,9,16,42,56,-14,30
Young Boys,7138,1,23,7,2,71,31,40,76
FC Basel,7138,2,15,11,6,52,28,24,56
St Gallen,7138,3,16,2,14,51,57,-6,50
Lucerne,7138,4,12,9,11,44,47,-3,45
FC Zürich,7138,5,11,10,11,41,35,6,43
FC Lugano,7138,6,11,6,15,34,49,-15,39
Grasshoppers,7138,7,10,6,16,44,54,-10,36
FC Thun,7138,8,9,6,17,46,62,-16,33
FC Sion,7138,9,5,7,20,38,58,-20,22
Young Boys,7139,1,20,8,4,68,34,34,68
FC Basel,7139,2,18,8,6,56,29,27,62
St Gallen,7139,3,15,3,14,44,54,-10,48
Lucerne,7139,4,13,8,11,40,41,-1,47
FC Zürich,7139,5,12,10,10,41,34,7,46
FC Lugano,7139,6,9,7,16,30,48,-18,34
FC Thun,7139,7,9,5,18,47,64,-17,32
FC Sion,7139,8,7,10,15,42,51,-9,31
Grasshoppers,7139,9,8,7,17,37,50,-13,31
Young Boys,7140,1,22,7,3,80,35,45,73
FC Basel,7140,2,19,7,6,60,27,33,64
Lucerne,7140,3,13,8,11,48,48,0,47
St Gallen,7140,4,15,2,15,42,57,-15,47
FC Zürich,7140,5,10,10,12,41,40,1,40
FC Lugano,7140,6,10,5,17,33,55,-22,35
Grasshoppers,7140,7,9,7,16,41,52,-11,34
FC Sion,7140,8,8,8,16,43,54,-11,32
FC Thun,7140,9,8,6,18,43,63,-20,30
Young Boys,7141,1,21,8,3,69,33,36,71
FC Basel,7141,2,18,8,6,55,27,28,62
St Gallen,7141,3,15,3,14,43,53,-10,48
Lucerne,7141,4,12,9,11,39,42,-3,45
FC Zürich,7141,5,10,12,10,41,35,6,42
Grasshoppers,7141,6,10,7,15,40,47,-7,37
FC Thun,7141,7,9,6,17,41,57,-16,33
FC Lugano,7141,8,9,6,17,29,49,-20,33
FC Sion,7141,9,6,9,17,40,54,-14,27
Young Boys,7142,1,21,8,3,72,36,36,71
FC Basel,7142,2,19,7,6,57,27,30,64
St Gallen,7142,3,15,3,14,43,53,-10,48
FC Zürich,7142,4,12,9,11,43,36,7,45
Lucerne,7142,5,12,8,12,44,46,-2,44
FC Thun,7142,6,10,6,16,46,61,-15,36
FC Lugano,7142,7,10,5,17,30,49,-19,35
Grasshoppers,7142,8,8,9,15,43,53,-10,33
FC Sion,7142,9,5,9,18,41,58,-17,24
Young Boys,7143,1,21,6,5,72,36,36,69
FC Basel,7143,2,15,8,9,49,31,18,53
Lucerne,7143,3,14,9,9,44,42,2,51
St Gallen,7143,4,14,5,13,45,54,-9,47
FC Zürich,7143,5,12,10,10,42,33,9,46
FC Lugano,7143,6,10,7,15,31,46,-15,37
Grasshoppers,7143,7,10,6,16,42,52,-10,36
FC Thun,7143,8,10,5,17,46,60,-14,35
FC Sion,7143,9,6,8,18,42,59,-17,26
Young Boys,7144,1,22,7,3,71,35,36,73
FC Basel,7144,2,18,8,6,56,26,30,62
St Gallen,7144,3,15,3,14,46,54,-8,48
Lucerne,7144,4,13,7,12,44,47,-3,46
FC Lugano,7144,5,11,6,15,33,47,-14,39
FC Zürich,7144,6,9,11,12,39,39,0,38
FC Thun,7144,7,10,6,16,44,57,-13,36
Grasshoppers,7144,8,8,8,16,42,52,-10,32
FC Sion,7144,9,5,10,17,39,57,-18,25
Young Boys,7145,1,21,7,4,65,33,32,70
FC Basel,7145,2,18,8,6,60,28,32,62
St Gallen,7145,3,15,2,15,44,57,-13,47
Lucerne,7145,4,12,9,11,40,45,-5,45
FC Zürich,7145,5,11,9,12,40,37,3,42
FC Lugano,7145,6,12,5,15,31,43,-12,41
Grasshoppers,7145,7,9,6,17,40,49,-9,33
FC Thun,7145,8,9,5,18,42,61,-19,32
FC Sion,7145,9,8,7,17,43,52,-9,31
Young Boys,7146,1,22,7,3,72,32,40,73
FC Basel,7146,2,17,7,8,53,31,22,58
St Gallen,7146,3,14,5,13,46,56,-10,47
FC Zürich,7146,4,11,10,11,42,35,7,43
Lucerne,7146,5,11,10,11,41,46,-5,43
FC Lugano,7146,6,10,8,14,32,46,-14,38
FC Thun,7146,7,10,6,16,45,57,-12,36
Grasshoppers,7146,8,8,8,16,39,52,-13,32
FC Sion,7146,9,6,9,17,37,52,-15,27
Young Boys,7147,1,23,6,3,74,34,40,75
FC Basel,7147,2,19,7,6,53,23,30,64
St Gallen,7147,3,14,3,15,43,57,-14,45
Lucerne,7147,4,12,8,12,37,41,-4,44
FC Zürich,7147,5,10,9,13,38,36,2,39
FC Thun,7147,6,10,6,16,43,57,-14,36
FC Lugano,7147,7,10,6,16,31,49,-18,36
Grasshoppers,7147,8,8,8,16,39,50,-11,32
FC Sion,7147,9,8,7,17,43,54,-11,31
Young Boys,7148,1,22,8,2,72,32,40,74
FC Basel,7148,2,15,10,7,49,26,23,55
Lucerne,7148,3,14,8,10,44,43,1,50
FC Zürich,7148,4,11,11,10,44,34,10,44
St Gallen,7148,5,13,5,14,43,57,-14,44
FC Thun,7148,6,10,6,16,44,61,-17,36
FC Lugano,7148,7,9,8,15,31,49,-18,35
Grasshoppers,7148,8,8,6,18,37,52,-15,30
FC Sion,7148,9,7,8,17,46,56,-10,29
Young Boys,7149,1,21,9,2,74,35,39,72
FC Basel,7149,2,16,9,7,52,29,23,57
Lucerne,7149,3,13,10,9,44,42,2,49
St Gallen,7149,4,15,3,14,42,52,-10,48
FC Thun,7149,5,12,5,15,48,55,-7,41
FC Zürich,7149,6,9,9,14,36,38,-2,36
FC Lugano,7149,7,10,6,16,30,49,-19,36
Grasshoppers,7149,8,8,9,15,38,48,-10,33
FC Sion,7149,9,6,8,18,37,53,-16,26
Young Boys,7150,1,21,7,4,76,41,35,70
FC Basel,7150,2,17,10,5,57,29,28,61
Lucerne,7150,3,13,7,12,44,46,-2,46
St Gallen,7150,4,14,3,15,45,58,-13,45
FC Zürich,7150,5,11,10,11,40,35,5,43
FC Lugano,7150,6,11,5,16,34,48,-14,38
Grasshoppers,7150,7,10,6,16,42,53,-11,36
FC Thun,7150,8,8,7,17,41,58,-17,31
FC Sion,7150,9,7,9,16,44,55,-11,30
Young Boys,7151,1,21,9,2,71,33,38,72
FC Basel,7151,2,17,10,5,58,30,28,61
Lucerne,7151,3,13,8,11,43,42,1,47
St Gallen,7151,4,14,4,14,48,58,-10,46
FC Zürich,7151,5,11,10,11,42,36,6,43
FC Lugano,7151,6,11,5,16,31,51,-20,38
FC Thun,7151,7,10,5,17,45,59,-14,35
Grasshoppers,7151,8,8,7,17,39,50,-11,31
FC Sion,7151,9,6,8,18,38,56,-18,26
Young Boys,7152,1,23,6,3,72,39,33,75
FC Basel,7152,2,17,7,8,58,28,30,58
St Gallen,7152,3,16,2,14,44,52,-8,50
FC Zürich,7152,4,11,10,11,44,35,9,43
Lucerne,7152,5,11,8,13,41,49,-8,41
FC Thun,7152,6,10,6,16,42,59,-17,36
FC Lugano,7152,7,10,6,16,32,49,-17,36
Grasshoppers,7152,8,9,6,17,40,51,-11,33
FC Sion,7152,9,8,7,17,42,53,-11,31
Young Boys,7153,1,22,8,2,72,32,40,74
FC Basel,7153,2,18,8,6,59,30,29,62
Lucerne,7153,3,12,9,11,43,46,-3,45
FC Zürich,7153,4,11,10,11,40,34,6,43
St Gallen,7153,5,13,3,16,40,57,-17,42
Grasshoppers,7153,6,9,9,14,40,46,-6,36
FC Lugano,7153,7,10,6,16,30,48,-18,36
FC Thun,7153,8,8,7,17,43,61,-18,31
FC Sion,7153,9,7,8,17,41,54,-13,29
Young Boys,7154,1,19,8,5,65,35,30,65
FC Basel,7154,2,17,8,7,51,29,22,59
Lucerne,7154,3,15,7,10,43,40,3,52
St Gallen,7154,4,16,2,14,47,51,-4,50
FC Zürich,7154,5,10,11,11,39,35,4,41
Grasshoppers,7154,6,10,7,15,42,47,-5,37
FC Lugano,7154,7,9,7,16,29,48,-19,34
FC Thun,7154,8,8,7,17,44,61,-17,31
FC Sion,7154,9,7,9,16,39,53,-14,30
Young Boys,7155,1,20,9,3,67,32,35,69
FC Basel,7155,2,18,7,7,52,27,25,61
Lucerne,7155,3,12,8,12,44,46,-2,44
St Gallen,7155,4,13,4,15,43,58,-15,43
FC Zürich,7155,5,11,9,12,40,35,5,42
Grasshoppers,7155,6,10,8,14,45,50,-5,38
FC Thun,7155,7,10,6,16,42,57,-15,36
FC Lugano,7155,8,9,8,15,31,47,-16,35
FC Sion,7155,9,6,11,15,41,53,-12,29
Young Boys,7156,1,19,9,4,70,39,31,66
FC Basel,7156,2,16,10,6,57,29,28,58
Lucerne,7156,3,12,11,9,43,43,0,47
St Gallen,7156,4,14,2,16,41,56,-15,44
FC Zürich,7156,5,10,12,10,41,36,5,42
Grasshoppers,7156,6,10,8,14,43,48,-5,38
FC Lugano,7156,7,10,8,14,31,44,-13,38
FC Thun,7156,8,9,5,18,41,61,-20,32
FC Sion,7156,9,7,9,16,41,52,-11,30
Young Boys,7157,1,23,7,2,73,32,41,76
FC Basel,7157,2,16,9,7,52,29,23,57
St Gallen,7157,3,15,4,13,46,55,-9,49
FC Zürich,7157,4,12,9,11,44,37,7,45
Lucerne,7157,5,11,8,13,43,48,-5,41
FC Thun,7157,6,11,6,15,47,57,-10,39
Grasshoppers,7157,7,10,6,16,43,54,-11,36
FC Lugano,7157,8,9,7,16,32,50,-18,34
FC Sion,7157,9,5,8,19,40,58,-18,23
Young Boys,7158,1,21,8,3,69,33,36,71
FC Basel,7158,2,20,7,5,60,26,34,67
Lucerne,7158,3,13,7,12,41,44,-3,46
St Gallen,7158,4,14,3,15,42,55,-13,45
FC Zürich,7158,5,10,9,13,45,41,4,39
FC Lugano,7158,6,11,6,15,32,45,-13,39
FC Thun,7158,7,10,6,16,45,61,-16,36
Grasshoppers,7158,8,8,7,17,40,51,-11,31
FC Sion,7158,9,6,9,17,38,56,-18,27
Young Boys,7159,1,22,6,4,71,35,36,72
FC Basel,7159,2,19,8,5,58,23,35,65
St Gallen,7159,3,15,2,15,42,55,-13,47
FC Zürich,7159,4,10,12,10,38,33,5,42
Lucerne,7159,5,11,8,13,40,47,-7,41
Grasshoppers,7159,6,11,7,14,44,48,-4,40
FC Lugano,7159,7,10,7,15,31,45,-14,37
FC Thun,7159,8,8,6,18,41,63,-22,30
FC Sion,7159,9,6,8,18,38,54,-16,26
Young Boys,7160,1,23,7,2,72,31,41,76
FC Basel,7160,2,17,8,7,50,26,24,59
St Gallen,7160,3,15,3,14,49,54,-5,48
Lucerne,7160,4,13,8,11,41,41,0,47
FC Zürich,7160,5,12,10,10,46,35,11,46
FC Lugano,7160,6,10,5,17,31,53,-22,35
Grasshoppers,7160,7,9,7,16,41,49,-8,34
FC Thun,7160,8,9,7,16,42,57,-15,34
FC Sion,7160,9,5,7,20,38,64,-26,22
Young Boys,7161,1,21,7,4,70,35,35,70
FC Basel,7161,2,19,7,6,59,29,30,64
St Gallen,7161,3,15,3,14,46,56,-10,48
Lucerne,7161,4,13,8,11,42,42,0,47
FC Zürich,7161,5,10,9,13,41,40,1,39
FC Thun,7161,6,10,7,15,44,56,-12,37
FC Lugano,7161,7,10,5,17,30,48,-18,35
Grasshoppers,7161,8,8,8,16,37,49,-12,32
FC Sion,7161,9,6,10,16,38,52,-14,28
Young Boys,7162,1,21,7,4,69,36,33,70
FC Basel,7162,2,16,9,7,53,27,26,57
St Gallen,7162,3,14,5,13,42,52,-10,47
FC Zürich,7162,4,12,10,10,44,35,9,46
Lucerne,7162,5,12,9,11,43,46,-3,45
Grasshoppers,7162,6,10,7,15,41,48,-7,37
FC Lugano,7162,7,10,7,15,31,46,-15,37
FC Thun,7162,8,8,7,17,40,59,-19,31
FC Sion,7162,9,6,9,17,38,52,-14,27
Young Boys,7163,1,22,7,3,80,36,44,73
FC Basel,7163,2,19,7,6,59,28,31,64
St Gallen,7163,3,15,3,14,46,54,-8,48
FC Zürich,7163,4,12,9,11,43,37,6,45
Lucerne,7163,5,12,8,12,41,45,-4,44
Grasshoppers,7163,6,11,6,15,43,51,-8,39
FC Lugano,7163,7,9,6,17,31,52,-21,33
FC Thun,7163,8,8,5,19,40,63,-23,29
FC Sion,7163,9,7,7,18,41,58,-17,28
Young Boys,7164,1,22,6,4,74,35,39,72
FC Basel,7164,2,17,9,6,55,27,28,60
Lucerne,7164,3,13,9,10,43,45,-2,48
St Gallen,7164,4,14,2,16,48,61,-13,44
FC Zürich,7164,5,10,10,12,41,38,3,40
FC Lugano,7164,6,10,6,16,36,53,-17,36
Grasshoppers,7164,7,9,8,15,38,48,-10,35
FC Thun,7164,8,9,7,16,43,58,-15,34
FC Sion,7164,9,7,9,16,40,53,-13,30
Young Boys,7165,1,22,6,4,71,34,37,72
FC Basel,7165,2,18,8,6,56,25,31,62
St Gallen,7165,3,14,3,15,43,55,-12,45
Lucerne,7165,4,12,7,13,40,50,-10,43
FC Zürich,7165,5,10,10,12,42,38,4,40
Grasshoppers,7165,6,11,7,14,47,49,-2,40
FC Lugano,7165,7,11,5,16,34,47,-13,38
FC Thun,7165,8,9,6,17,44,62,-18,33
FC Sion,7165,9,7,8,17,40,57,-17,29
Young Boys,7166,1,23,6,3,76,33,43,75
FC Basel,7166,2,17,10,5,50,23,27,61
St Gallen,7166,3,15,3,14,41,52,-11,48
Lucerne,7166,4,12,9,11,41,45,-4,45
FC Lugano,7166,5,11,6,15,34,49,-15,39
FC Zürich,7166,6,9,9,14,37,38,-1,36
FC Thun,7166,7,9,8,15,42,56,-14,35
Grasshoppers,7166,8,9,7,16,39,49,-10,34
FC Sion,7166,9,6,8,18,39,54,-15,26
Young Boys,7167,1,20,8,4,71,38,33,68
FC Basel,7167,2,19,8,5,58,23,35,65
St Gallen,7167,3,16,3,13,47,53,-6,51
FC Zürich,7167,4,10,10,12,41,38,3,40
Grasshoppers,7167,5,11,7,14,41,45,-4,40
Lucerne,7167,6,11,7,14,41,51,-10,40
FC Lugano,7167,7,11,6,15,37,50,-13,39
FC Thun,7167,8,8,7,17,41,61,-20,31
FC Sion,7167,9,5,10,17,38,56,-18,25
Young Boys,7168,1,22,7,3,72,34,38,73
FC Basel,7168,2,18,9,5,59,26,33,63
St Gallen,7168,3,15,4,13,43,52,-9,49
Lucerne,7168,4,11,10,11,39,44,-5,43
FC Zürich,7168,5,11,9,12,42,39,3,42
Grasshoppers,7168,6,9,9,14,41,46,-5,36
FC Thun,7168,7,10,6,16,44,59,-15,36
FC Lugano,7168,8,9,7,16,29,47,-18,34
FC Sion,7168,9,5,7,20,36,58,-22,22
Young Boys,7169,1,24,6,2,82,35,47,78
FC Basel,7169,2,18,7,7,54,27,27,61
Lucerne,7169,3,14,8,10,45,43,2,50
St Gallen,7169,4,14,3,15,43,54,-11,45
FC Zürich,7169,5,11,10,11,42,37,5,43
Grasshoppers,7169,6,10,6,16,43,52,-9,36
FC Lugano,7169,7,10,5,17,30,51,-21,35
FC Thun,7169,8,9,6,17,44,58,-14,33
FC Sion,7169,9,5,7,20,38,64,-26,22
Young Boys,7170,1,20,7,5,66,37,29,67
FC Basel,7170,2,19,8,5,57,22,35,65
St Gallen,7170,3,15,3,14,42,55,-13,48
Lucerne,7170,4,13,8,11,41,43,-2,47
FC Zürich,7170,5,10,10,12,40,37,3,40
FC Lugano,7170,6,10,7,15,32,45,-13,37
FC Thun,7170,7,10,6,16,47,59,-12,36
Grasshoppers,7170,8,8,9,15,40,49,-9,33
FC Sion,7170,9,6,8,18,38,56,-18,26
Young Boys,7171,1,22,6,4,70,35,35,72
FC Basel,7171,2,16,8,8,52,33,19,56
Lucerne,7171,3,14,8,10,45,41,4,50
St Gallen,7171,4,13,5,14,39,51,-12,44
FC Zürich,7171,5,10,11,11,43,36,7,41
FC Lugano,7171,6,11,6,15,31,46,-15,39
FC Thun,7171,7,9,7,16,45,58,-13,34
FC Sion,7171,8,8,8,16,40,53,-13,32
Grasshoppers,7171,9,8,7,17,39,51,-12,31
Young Boys,7172,1,22,7,3,75,36,39,73
FC Basel,7172,2,18,8,6,52,27,25,62
Lucerne,7172,3,14,7,11,45,43,2,49
St Gallen,7172,4,13,4,15,40,54,-14,43
FC Zürich,7172,5,10,10,12,43,36,7,40
FC Thun,7172,6,10,6,16,43,56,-13,36
Grasshoppers,7172,7,8,9,15,40,49,-9,33
FC Lugano,7172,8,9,6,17,29,54,-25,33
FC Sion,7172,9,7,9,16,40,52,-12,30
Young Boys,7173,1,23,6,3,70,32,38,75
FC Basel,7173,2,18,7,7,52,25,27,61
FC Zürich,7173,3,11,10,11,42,39,3,43
Lucerne,7173,4,12,7,13,40,46,-6,43
St Gallen,7173,5,13,3,16,39,57,-18,42
Grasshoppers,7173,6,11,7,14,41,45,-4,40
FC Lugano,7173,7,10,7,15,33,46,-13,37
FC Thun,7173,8,9,7,16,44,56,-12,34
FC Sion,7173,9,6,8,18,38,53,-15,26
Young Boys,7174,1,23,6,3,74,34,40,75
FC Basel,7174,2,16,9,7,53,29,24,57
Lucerne,7174,3,13,9,10,42,42,0,48
St Gallen,7174,4,15,3,14,42,51,-9,48
FC Zürich,7174,5,10,11,11,41,38,3,41
FC Thun,7174,6,11,5,16,44,54,-10,38
FC Lugano,7174,7,10,6,16,31,49,-18,36
Grasshoppers,7174,8,9,6,17,39,50,-11,33
FC Sion,7174,9,6,7,19,37,56,-19,25
Young Boys,7175,1,20,8,4,72,37,35,68
FC Basel,7175,2,18,8,6,58,27,31,62
Lucerne,7175,3,14,8,10,44,43,1,50
St Gallen,7175,4,15,2,15,44,57,-13,47
FC Zürich,7175,5,9,11,12,36,38,-2,38
FC Thun,7175,6,10,6,16,46,59,-13,36
FC Lugano,7175,7,10,6,16,30,48,-18,36
Grasshoppers,7175,8,9,8,15,43,50,-7,35
FC Sion,7175,9,6,9,17,39,53,-14,27
Young Boys,7176,1,20,7,5,67,37,30,67
FC Basel,7176,2,17,8,7,51,25,26,59
Lucerne,7176,3,12,8,12,40,43,-3,44
St Gallen,7176,4,14,2,16,42,57,-15,44
FC Zürich,7176,5,11,10,11,40,35,5,43
FC Thun,7176,6,11,6,15,46,57,-11,39
FC Lugano,7176,7,11,6,15,32,44,-12,39
Grasshoppers,7176,8,10,6,16,42,51,-9,36
FC Sion,7176,9,7,9,16,41,52,-11,30
Young Boys,7177,1,20,8,4,72,38,34,68
FC Basel,7177,2,18,7,7,56,28,28,61
FC Zürich,7177,3,12,10,10,45,34,11,46
St Gallen,7177,4,14,2,16,43,55,-12,44
Lucerne,7177,5,11,9,12,38,44,-6,42
FC Lugano,7177,6,11,6,15,31,47,-16,39
Grasshoppers,7177,7,10,7,15,43,50,-7,37
FC Thun,7177,8,10,5,17,44,61,-17,35
FC Sion,7177,9,7,8,17,43,58,-15,29
Young Boys,7178,1,21,8,3,74,38,36,71
FC Basel,7178,2,17,10,5,51,24,27,61
St Gallen,7178,3,15,3,14,42,51,-9,48
Lucerne,7178,4,13,7,12,42,42,0,46
FC Zürich,7178,5,11,9,12,41,37,4,42
FC Thun,7178,6,10,7,15,46,58,-12,37
Grasshoppers,7178,7,9,7,16,43,54,-11,34
FC Lugano,7178,8,9,6,17,30,49,-19,33
FC Sion,7178,9,7,7,18,39,55,-16,28
Young Boys,7179,1,21,7,4,70,35,35,70
FC Basel,7179,2,18,7,7,51,25,26,61
Lucerne,7179,3,13,9,10,44,43,1,48
St Gallen,7179,4,15,3,14,44,53,-9,48
FC Zürich,7179,5,10,10,12,39,36,3,40
FC Lugano,7179,6,10,7,15,31,46,-15,37
Grasshoppers,7179,7,9,8,15,41,50,-9,35
FC Thun,7179,8,10,5,17,45,58,-13,35
FC Sion,7179,9,6,8,18,37,56,-19,26
Young Boys,7180,1,21,7,4,67,35,32,70
FC Basel,7180,2,19,8,5,58,26,32,65
Lucerne,7180,3,13,8,11,43,43,0,47
St Gallen,7180,4,14,3,15,42,55,-13,45
FC Zürich,7180,5,10,11,11,39,35,4,41
FC Thun,7180,6,10,6,16,44,60,-16,36
Grasshoppers,7180,7,9,7,16,40,49,-9,34
FC Lugano,7180,8,9,6,17,28,46,-18,33
FC Sion,7180,9,7,8,17,39,51,-12,29
Young Boys,7181,1,21,9,2,76,37,39,72
FC Basel,7181,2,17,8,7,54,29,25,59
St Gallen,7181,3,15,3,14,43,53,-10,48
Lucerne,7181,4,12,9,11,42,44,-2,45
FC Lugano,7181,5,12,5,15,36,45,-9,41
FC Zürich,7181,6,10,9,13,37,38,-1,39
FC Thun,7181,7,10,6,16,46,60,-14,36
Grasshoppers,7181,8,9,7,16,44,52,-8,34
FC Sion,7181,9,6,8,18,36,56,-20,26
Young Boys,7182,1,22,6,4,72,34,38,72
FC Basel,7182,2,18,8,6,50,23,27,62
St Gallen,7182,3,16,2,14,46,54,-8,50
Lucerne,7182,4,13,8,11,40,41,-1,47
FC Zürich,7182,5,10,11,11,39,35,4,41
FC Lugano,7182,6,9,7,16,29,48,-19,34
FC Thun,7182,7,8,8,16,43,59,-16,32
FC Sion,7182,8,8,7,17,43,53,-10,31
Grasshoppers,7182,9,8,7,17,41,56,-15,31
Young Boys,7183,1,22,6,4,75,40,35,72
FC Basel,7183,2,19,7,6,55,23,32,64
St Gallen,7183,3,15,3,14,44,53,-9,48
FC Zürich,7183,4,11,10,11,42,38,4,43
Lucerne,7183,5,11,8,13,42,50,-8,41
Grasshoppers,7183,6,11,6,15,46,50,-4,39
FC Lugano,7183,7,10,7,15,32,46,-14,37
FC Thun,7183,8,10,5,17,47,60,-13,35
FC Sion,7183,9,5,8,19,38,61,-23,23
Young Boys,7184,1,22,7,3,70,35,35,73
FC Basel,7184,2,18,8,6,56,28,28,62
FC Zürich,7184,3,12,10,10,46,33,13,46
Lucerne,7184,4,12,10,10,42,41,1,46
St Gallen,7184,5,14,3,15,42,57,-15,45
Grasshoppers,7184,6,9,7,16,43,51,-8,34
FC Lugano,7184,7,9,7,16,30,50,-20,34
FC Thun,7184,8,9,6,17,43,59,-16,33
FC Sion,7184,9,6,8,18,40,58,-18,26
Young Boys,7185,1,23,6,3,71,32,39,75
FC Basel,7185,2,18,8,6,54,26,28,62
Lucerne,7185,3,13,8,11,41,43,-2,47
St Gallen,7185,4,13,5,14,41,53,-12,44
FC Zürich,7185,5,10,11,11,39,35,4,41
Grasshoppers,7185,6,9,7,16,41,49,-8,34
FC Thun,7185,7,9,7,16,42,57,-15,34
FC Lugano,7185,8,9,7,16,27,44,-17,34
FC Sion,7185,9,7,7,18,40,57,-17,28
Young Boys,7186,1,22,8,2,73,33,40,74
FC Basel,7186,2,16,8,8,49,26,23,56
St Gallen,7186,3,16,2,14,44,53,-9,50
Lucerne,7186,4,13,8,11,43,45,-2,47
FC Zürich,7186,5,10,11,11,39,34,5,41
FC Thun,7186,6,10,5,17,42,57,-15,35
Grasshoppers,7186,7,9,7,16,41,52,-11,34
FC Lugano,7186,8,9,7,16,29,46,-17,34
FC Sion,7186,9,6,10,16,41,55,-14,28
Young Boys,7187,1,20,7,5,66,38,28,67
FC Basel,7187,2,18,7,7,58,27,31,61
Lucerne,7187,3,15,7,10,46,45,1,52
St Gallen,7187,4,15,2,15,50,58,-8,47
FC Zürich,7187,5,12,9,11,42,34,8,45
FC Thun,7187,6,10,5,17,45,61,-16,35
FC Lugano,7187,7,10,5,17,30,50,-20,35
FC Sion,7187,8,8,7,17,46,56,-10,31
Grasshoppers,7187,9,8,7,17,36,50,-14,31
Young Boys,7188,1,21,6,5,67,39,28,69
FC Basel,7188,2,20,7,5,59,23,36,67
Lucerne,7188,3,13,7,12,50,46,4,46
St Gallen,7188,4,14,2,16,43,59,-16,44
FC Zürich,7188,5,10,11,11,39,37,2,41
Grasshoppers,7188,6,10,7,15,47,52,-5,37
FC Lugano,7188,7,10,6,16,33,51,-18,36
FC Thun,7188,8,8,8,16,43,60,-17,32
FC Sion,7188,9,7,8,17,41,55,-14,29
Young Boys,7189,1,22,6,4,69,32,37,72
FC Basel,7189,2,17,8,7,53,29,24,59
Lucerne,7189,3,12,10,10,43,42,1,46
FC Zürich,7189,4,11,10,11,43,36,7,43
St Gallen,7189,5,13,4,15,41,56,-15,43
Grasshoppers,7189,6,10,8,14,42,48,-6,38
FC Thun,7189,7,10,7,15,45,57,-12,37
FC Lugano,7189,8,10,6,16,31,49,-18,36
FC Sion,7189,9,6,7,19,40,58,-18,25
Young Boys,7190,1,21,7,4,69,35,34,70
FC Basel,7190,2,16,10,6,50,25,25,58
Lucerne,7190,3,14,8,10,42,39,3,50
St Gallen,7190,4,13,4,15,38,53,-15,43
FC Zürich,7190,5,10,10,12,42,37,5,40
FC Lugano,7190,6,10,7,15,30,46,-16,37
Grasshoppers,7190,7,10,6,16,39,48,-9,36
FC Thun,7190,8,9,8,15,45,59,-14,35
FC Sion,7190,9,7,8,17,41,54,-13,29
Young Boys,7191,1,23,6,3,78,33,45,75
FC Basel,7191,2,18,7,7,56,32,24,61
St Gallen,7191,3,15,2,15,46,55,-9,47
FC Zürich,7191,4,10,11,11,44,41,3,41
Lucerne,7191,5,11,7,14,38,53,-15,40
FC Lugano,7191,6,11,6,15,31,45,-14,39
FC Thun,7191,7,10,5,17,48,60,-12,35
Grasshoppers,7191,8,9,7,16,42,49,-7,34
FC Sion,7191,9,7,9,16,41,56,-15,30
Young Boys,7192,1,22,7,3,73,35,38,73
FC Basel,7192,2,16,10,6,53,29,24,58
St Gallen,7192,3,15,3,14,46,52,-6,48
Lucerne,7192,4,12,10,10,43,46,-3,46
FC Zürich,7192,5,10,11,11,39,35,4,41
FC Thun,7192,6,10,6,16,42,57,-15,36
Grasshoppers,7192,7,9,7,16,41,49,-8,34
FC Lugano,7192,8,9,7,16,33,53,-20,34
FC Sion,7192,9,6,9,17,39,53,-14,27
Young Boys,7193,1,21,7,4,72,38,34,70
FC Basel,7193,2,17,7,8,50,28,22,58
Lucerne,7193,3,14,8,10,43,40,3,50
St Gallen,7193,4,15,2,15,43,54,-11,47
FC Zürich,7193,5,10,10,12,41,39,2,40
FC Lugano,7193,6,10,6,16,31,47,-16,36
FC Sion,7193,7,9,8,15,45,52,-7,35
Grasshoppers,7193,8,8,8,16,40,51,-11,32
FC Thun,7193,9,8,8,16,40,56,-16,32
Young Boys,7194,1,22,7,3,70,33,37,73
FC Basel,7194,2,18,8,6,57,26,31,62
Lucerne,7194,3,12,9,11,42,44,-2,45
St Gallen,7194,4,14,3,15,42,55,-13,45
FC Zürich,7194,5,11,10,11,41,38,3,43
FC Lugano,7194,6,11,6,15,30,44,-14,39
Grasshoppers,7194,7,8,8,16,40,52,-12,32
FC Thun,7194,8,9,5,18,41,57,-16,32
FC Sion,7194,9,7,8,17,39,53,-14,29
Young Boys,7195,1,23,6,3,72,34,38,75
FC Basel,7195,2,18,7,7,53,26,27,61
St Gallen,7195,3,15,2,15,44,56,-12,47
Lucerne,7195,4,12,9,11,40,45,-5,45
FC Zürich,7195,5,9,11,12,36,37,-1,38
FC Lugano,7195,6,10,7,15,32,44,-12,37
Grasshoppers,7195,7,9,9,14,39,45,-6,36
FC Thun,7195,8,10,6,16,43,56,-13,36
FC Sion,7195,9,5,9,18,39,55,-16,24
Young Boys,7196,1,23,7,2,76,36,40,76
FC Basel,7196,2,17,9,6,55,27,28,60
Lucerne,7196,3,13,8,11,47,48,-1,47
FC Zürich,7196,4,12,10,10,42,34,8,46
St Gallen,7196,5,14,4,14,43,54,-11,46
Grasshoppers,7196,6,8,8,16,39,51,-12,32
FC Lugano,7196,7,9,5,18,31,52,-21,32
FC Sion,7196,8,7,9,16,43,55,-12,30
FC Thun,7196,9,8,6,18,39,58,-19,30
Young Boys,7197,1,22,7,3,73,36,37,73
FC Basel,7197,2,18,8,6,53,29,24,62
Lucerne,7197,3,13,7,12,46,45,1,46
St Gallen,7197,4,14,3,15,41,54,-13,45
FC Zürich,7197,5,11,10,11,42,34,8,43
FC Thun,7197,6,10,6,16,44,55,-11,36
FC Lugano,7197,7,10,5,17,30,47,-17,35
Grasshoppers,7197,8,9,7,16,39,51,-12,34
FC Sion,7197,9,6,9,17,37,54,-17,27
Young Boys,7198,1,21,7,4,73,39,34,70
FC Basel,7198,2,17,9,6,54,26,28,60
Lucerne,7198,3,14,7,11,43,44,-1,49
St Gallen,7198,4,15,3,14,46,56,-10,48
FC Zürich,7198,5,11,11,10,43,36,7,44
Grasshoppers,7198,6,9,8,15,43,51,-8,35
FC Thun,7198,7,9,6,17,42,59,-17,33
FC Lugano,7198,8,9,6,17,31,49,-18,33
FC Sion,7198,9,6,9,17,44,59,-15,27
Young Boys,7199,1,21,9,2,74,34,40,72
FC Basel,7199,2,17,9,6,53,26,27,60
St Gallen,7199,3,14,5,13,43,52,-9,47
Lucerne,7199,4,12,9,11,40,42,-2,45
FC Zürich,7199,5,9,11,12,42,41,1,38
FC Lugano,7199,6,9,8,15,30,49,-19,35
Grasshoppers,7199,7,9,7,16,40,50,-10,34
FC Thun,7199,8,9,7,16,41,57,-16,34
FC Sion,7199,9,7,9,16,43,55,-12,30
Young Boys,7200,1,22,6,4,73,34,39,72
FC Basel,7200,2,17,8,7,49,25,24,59
St Gallen,7200,3,15,4,13,45,52,-7,49
Lucerne,7200,4,13,9,10,46,39,7,48
FC Zürich,7200,5,12,10,10,42,35,7,46
FC Thun,7200,6,10,5,17,42,57,-15,35
Grasshoppers,7200,7,9,6,17,39,53,-14,33
FC Lugano,7200,8,9,6,17,30,53,-23,33
FC Sion,7200,9,6,8,18,39,57,-18,26
Young Boys,7201,1,20,8,4,69,39,30,68
FC Basel,7201,2,18,8,6,53,22,31,62
Lucerne,7201,3,14,9,9,44,40,4,51
St Gallen,7201,4,14,4,14,44,55,-11,46
FC Zürich,7201,5,11,10,11,42,36,6,43
Grasshoppers,7201,6,10,7,15,44,49,-5,37
FC Lugano,7201,7,9,7,16,32,51,-19,34
FC Thun,7201,8,9,5,18,42,60,-18,32
FC Sion,7201,9,6,8,18,38,56,-18,26
Young Boys,7202,1,20,8,4,74,43,31,68
FC Basel,7202,2,19,8,5,55,24,31,65
Lucerne,7202,3,13,8,11,46,45,1,47
St Gallen,7202,4,15,2,15,44,54,-10,47
FC Zürich,7202,5,12,10,10,43,35,8,46
Grasshoppers,7202,6,10,7,15,45,48,-3,37
FC Thun,7202,7,9,6,17,43,59,-16,33
FC Lugano,7202,8,9,6,17,31,52,-21,33
FC Sion,7202,9,6,7,19,39,60,-21,25
Young Boys,7203,1,21,8,3,75,38,37,71
FC Basel,7203,2,17,10,5,53,25,28,61
St Gallen,7203,3,15,2,15,47,56,-9,47
FC Zürich,7203,4,12,10,10,45,34,11,46
Lucerne,7203,5,11,9,12,37,46,-9,42
Grasshoppers,7203,6,10,8,14,44,49,-5,38
FC Lugano,7203,7,11,5,16,32,48,-16,38
FC Thun,7203,8,8,6,18,43,61,-18,30
FC Sion,7203,9,6,8,18,42,61,-19,26
Young Boys,7204,1,22,7,3,71,35,36,73
FC Basel,7204,2,18,7,7,58,27,31,61
St Gallen,7204,3,14,4,14,44,56,-12,46
FC Zürich,7204,4,11,9,12,42,34,8,42
Lucerne,7204,5,11,8,13,39,47,-8,41
FC Thun,7204,6,11,5,16,44,57,-13,38
Grasshoppers,7204,7,10,7,15,41,50,-9,37
FC Lugano,7204,8,10,7,15,32,47,-15,37
FC Sion,7204,9,6,8,18,38,56,-18,26
Young Boys,7205,1,21,6,5,75,40,35,69
FC Basel,7205,2,18,8,6,50,23,27,62
St Gallen,7205,3,15,3,14,43,53,-10,48
Lucerne,7205,4,12,8,12,42,46,-4,44
FC Lugano,7205,5,12,6,14,36,46,-10,42
FC Zürich,7205,6,9,11,12,40,38,2,38
FC Thun,7205,7,10,6,16,43,57,-14,36
Grasshoppers,7205,8,9,7,16,44,51,-7,34
FC Sion,7205,9,7,7,18,39,58,-19,28
Young Boys,7206,1,23,6,3,71,33,38,75
FC Basel,7206,2,19,8,5,57,25,32,65
St Gallen,7206,3,15,3,14,41,52,-11,48
Lucerne,7206,4,13,8,11,44,45,-1,47
FC Zürich,7206,5,11,10,11,41,35,6,43
FC Thun,7206,6,10,5,17,46,57,-11,35
FC Lugano,7206,7,9,7,16,29,47,-18,34
Grasshoppers,7206,8,8,6,18,40,54,-14,30
FC Sion,7206,9,6,7,19,39,60,-21,25
Young Boys,7207,1,21,7,4,76,40,36,70
FC Basel,7207,2,17,8,7,57,30,27,59
St Gallen,7207,3,15,4,13,44,53,-9,49
Lucerne,7207,4,11,10,11,42,49,-7,43
FC Zürich,7207,5,10,10,12,39,36,3,40
Grasshoppers,7207,6,10,6,16,41,49,-8,36
FC Thun,7207,7,10,6,16,44,56,-12,36
FC Lugano,7207,8,9,8,15,30,49,-19,35
FC Sion,7207,9,8,7,17,41,52,-11,31
Young Boys,7208,1,21,7,4,71,36,35,70
FC Basel,7208,2,19,7,6,55,26,29,64
Lucerne,7208,3,14,9,9,41,39,2,51
St Gallen,7208,4,13,3,16,39,53,-14,42
FC Lugano,7208,5,11,5,16,31,46,-15,38
Grasshoppers,7208,6,10,7,15,42,49,-7,37
FC Zürich,7208,7,9,9,14,38,39,-1,36
FC Thun,7208,8,10,5,17,45,60,-15,35
FC Sion,7208,9,7,8,17,41,55,-14,29
Young Boys,7209,1,22,7,3,76,36,40,73
FC Basel,7209,2,17,10,5,56,27,29,61
Lucerne,7209,3,14,7,11,42,46,-4,49
FC Zürich,7209,4,11,10,11,45,39,6,43
St Gallen,7209,5,13,4,15,39,53,-14,43
FC Thun,7209,6,11,5,16,48,58,-10,38
FC Lugano,7209,7,10,5,17,31,51,-20,35
Grasshoppers,7209,8,9,7,16,43,51,-8,34
FC Sion,7209,9,5,9,18,40,59,-19,24
Young Boys,7210,1,21,8,3,69,34,35,71
FC Basel,7210,2,19,8,5,55,23,32,65
Lucerne,7210,3,13,9,10,42,42,0,48
St Gallen,7210,4,13,4,15,43,56,-13,43
FC Zürich,7210,5,10,11,11,43,36,7,41
FC Lugano,7210,6,9,7,16,29,48,-19,34
FC Sion,7210,7,8,8,16,45,56,-11,32
FC Thun,7210,8,8,8,16,45,63,-18,32
Grasshoppers,7210,9,8,7,17,37,50,-13,31
Young Boys,7211,1,20,6,6,69,41,28,66
FC Basel,7211,2,17,9,6,53,23,30,60
St Gallen,7211,3,14,4,14,42,54,-12,46
FC Zürich,7211,4,11,10,11,40,36,4,43
Lucerne,7211,5,11,8,13,38,48,-10,41
Grasshoppers,7211,6,11,6,15,47,50,-3,39
FC Lugano,7211,7,10,8,14,33,47,-14,38
FC Sion,7211,8,9,7,16,48,53,-5,34
FC Thun,7211,9,9,6,17,42,60,-18,33
Young Boys,7212,1,24,6,2,73,31,42,78
FC Basel,7212,2,18,8,6,59,27,32,62
Lucerne,7212,3,14,8,10,43,40,3,50
St Gallen,7212,4,15,2,15,42,55,-13,47
FC Zürich,7212,5,10,10,12,42,37,5,40
FC Lugano,7212,6,10,5,17,29,48,-19,35
Grasshoppers,7212,7,9,7,16,39,48,-9,34
FC Thun,7212,8,8,7,17,42,62,-20,31
FC Sion,7212,9,6,7,19,37,58,-21,25
Young Boys,7213,1,23,6,3,72,34,38,75
FC Basel,7213,2,19,7,6,56,25,31,64
St Gallen,7213,3,14,2,16,41,57,-16,44
Lucerne,7213,4,12,7,13,42,46,-4,43
FC Lugano,7213,5,12,5,15,33,46,-13,41
FC Thun,7213,6,11,5,16,48,56,-8,38
FC Zürich,7213,7,9,9,14,38,41,-3,36
Grasshoppers,7213,8,9,6,17,39,52,-13,33
FC Sion,7213,9,8,7,17,43,55,-12,31
Young Boys,7214,1,22,6,4,73,39,34,72
FC Basel,7214,2,18,8,6,63,28,35,62
St Gallen,7214,3,14,2,16,42,58,-16,44
Lucerne,7214,4,12,7,13,38,45,-7,43
FC Lugano,7214,5,12,5,15,35,48,-13,41
Grasshoppers,7214,6,11,6,15,43,50,-7,39
FC Zürich,7214,7,9,10,13,40,42,-2,37
FC Thun,7214,8,10,6,16,47,61,-14,36
FC Sion,7214,9,7,8,17,45,55,-10,29
Young Boys,7215,1,21,6,5,72,35,37,69
FC Basel,7215,2,18,8,6,54,26,28,62
Lucerne,7215,3,14,8,10,44,41,3,50
FC Zürich,7215,4,12,9,11,40,35,5,45
St Gallen,7215,5,13,3,16,43,66,-23,42
FC Thun,7215,6,10,5,17,45,59,-14,35
FC Sion,7215,7,9,7,16,46,50,-4,34
Grasshoppers,7215,8,9,6,17,38,49,-11,33
FC Lugano,7215,9,9,6,17,30,51,-21,33
Young Boys,7216,1,22,7,3,72,35,37,73
FC Basel,7216,2,19,7,6,61,27,34,64
Lucerne,7216,3,14,7,11,43,41,2,49
St Gallen,7216,4,13,2,17,40,57,-17,41
FC Zürich,7216,5,10,10,12,39,36,3,40
Grasshoppers,7216,6,11,6,15,40,47,-7,39
FC Lugano,7216,7,10,7,15,30,45,-15,37
FC Thun,7216,8,10,5,17,43,61,-18,35
FC Sion,7216,9,6,7,19,39,58,-19,25
Young Boys,7217,1,23,7,2,77,35,42,76
FC Basel,7217,2,18,7,7,56,26,30,61
St Gallen,7217,3,15,4,13,44,52,-8,49
FC Zürich,7217,4,12,9,11,41,33,8,45
Lucerne,7217,5,12,9,11,43,45,-2,45
Grasshoppers,7217,6,10,6,16,46,56,-10,36
FC Thun,7217,7,9,6,17,45,65,-20,33
FC Lugano,7217,8,9,6,17,29,49,-20,33
FC Sion,7217,9,5,8,19,38,58,-20,23
Young Boys,7218,1,22,6,4,76,36,40,72
FC Basel,7218,2,20,7,5,66,31,35,67
Lucerne,7218,3,12,9,11,45,51,-6,45
St Gallen,7218,4,13,4,15,45,59,-14,43
FC Zürich,7218,5,10,10,12,41,39,2,40
FC Lugano,7218,6,10,7,15,33,50,-17,37
FC Thun,7218,7,10,5,17,44,60,-16,35
Grasshoppers,7218,8,9,6,17,40,51,-11,33
FC Sion,7218,9,7,8,17,44,57,-13,29
Young Boys,7219,1,21,6,5,67,34,33,69
FC Basel,7219,2,18,7,7,55,26,29,61
Lucerne,7219,3,12,10,10,42,41,1,46
FC Lugano,7219,4,12,6,14,32,43,-11,42
St Gallen,7219,5,13,3,16,40,57,-17,42
FC Zürich,7219,6,10,9,13,39,37,2,39
FC Thun,7219,7,11,5,16,43,60,-17,38
Grasshoppers,7219,8,9,7,16,39,49,-10,34
FC Sion,7219,9,8,7,17,41,51,-10,31
Young Boys,7220,1,21,8,3,74,38,36,71
FC Basel,7220,2,17,9,6,57,29,28,60
Lucerne,7220,3,13,10,9,48,43,5,49
St Gallen,7220,4,14,3,15,44,59,-15,45
FC Zürich,7220,5,9,12,11,41,40,1,39
FC Lugano,7220,6,9,8,15,33,49,-16,35
FC Thun,7220,7,9,6,17,43,61,-18,33
Grasshoppers,7220,8,8,8,16,39,51,-12,32
FC Sion,7220,9,7,10,15,47,56,-9,31
Young Boys,7221,1,19,9,4,67,37,30,66
FC Basel,7221,2,18,8,6,55,25,30,62
St Gallen,7221,3,16,2,14,49,55,-6,50
Lucerne,7221,4,13,7,12,43,47,-4,46
FC Zürich,7221,5,10,10,12,39,37,2,40
FC Lugano,7221,6,11,5,16,31,47,-16,38
Grasshoppers,7221,7,9,8,15,43,51,-8,35
FC Thun,7221,8,10,5,17,45,59,-14,35
FC Sion,7221,9,6,10,16,46,60,-14,28
Young Boys,7222,1,22,6,4,68,35,33,72
FC Basel,7222,2,18,9,5,56,23,33,63
Lucerne,7222,3,14,7,11,44,43,1,49
St Gallen,7222,4,14,3,15,41,54,-13,45
FC Zürich,7222,5,11,11,10,45,35,10,44
Grasshoppers,7222,6,10,6,16,41,52,-11,36
FC Lugano,7222,7,9,7,16,30,49,-19,34
FC Thun,7222,8,9,6,17,43,57,-14,33
FC Sion,7222,9,6,7,19,38,58,-20,25
Young Boys,7223,1,22,8,2,74,33,41,74
FC Basel,7223,2,18,9,5,56,27,29,63
Lucerne,7223,3,12,10,10,47,45,2,46
FC Zürich,7223,4,12,9,11,46,39,7,45
St Gallen,7223,5,13,2,17,39,63,-24,41
FC Lugano,7223,6,10,6,16,33,47,-14,36
FC Thun,7223,7,10,5,17,43,57,-14,35
Grasshoppers,7223,8,9,6,17,40,50,-10,33
FC Sion,7223,9,7,7,18,41,58,-17,28
Young Boys,7224,1,20,8,4,69,38,31,68
FC Basel,7224,2,19,8,5,55,24,31,65
St Gallen,7224,3,15,2,15,43,55,-12,47
Lucerne,7224,4,12,10,10,46,40,6,46
FC Zürich,7224,5,10,9,13,40,39,1,39
FC Lugano,7224,6,11,6,15,32,45,-13,39
Grasshoppers,7224,7,10,6,16,40,54,-14,36
FC Thun,7224,8,10,5,17,43,56,-13,35
FC Sion,7224,9,6,8,18,39,56,-17,26
Young Boys,7225,1,24,6,2,79,31,48,78
FC Basel,7225,2,18,8,6,55,28,27,62
St Gallen,7225,3,14,3,15,43,56,-13,45
Lucerne,7225,4,12,8,12,40,50,-10,44
FC Zürich,7225,5,10,11,11,40,37,3,41
FC Lugano,7225,6,10,7,15,30,44,-14,37
FC Thun,7225,7,9,7,16,42,57,-15,34
Grasshoppers,7225,8,8,6,18,37,52,-15,30
FC Sion,7225,9,7,8,17,39,50,-11,29
Young Boys,7226,1,20,7,5,70,42,28,67
FC Basel,7226,2,17,8,7,57,25,32,59
St Gallen,7226,3,15,3,14,44,55,-11,48
FC Zürich,7226,4,12,10,10,45,36,9,46
Lucerne,7226,5,12,10,10,41,42,-1,46
Grasshoppers,7226,6,11,7,14,42,46,-4,40
FC Lugano,7226,7,10,6,16,32,51,-19,36
FC Thun,7226,8,9,6,17,46,61,-15,33
FC Sion,7226,9,6,7,19,39,58,-19,25
Young Boys,7227,1,21,7,4,67,34,33,70
FC Basel,7227,2,18,9,5,55,25,30,63
Lucerne,7227,3,12,10,10,44,44,0,46
St Gallen,7227,4,14,3,15,40,55,-15,45
FC Zürich,7227,5,11,10,11,39,36,3,43
Grasshoppers,7227,6,10,7,15,44,48,-4,37
FC Lugano,7227,7,10,6,16,32,47,-15,36
FC Thun,7227,8,9,6,17,44,59,-15,33
FC Sion,7227,9,6,8,18,40,57,-17,26
Young Boys,7228,1,20,7,5,71,38,33,67
FC Basel,7228,2,17,10,5,55,27,28,61
Lucerne,7228,3,14,8,10,43,40,3,50
St Gallen,7228,4,13,5,14,38,51,-13,44
FC Zürich,7228,5,11,10,11,43,39,4,43
Grasshoppers,7228,6,10,7,15,40,47,-7,37
FC Lugano,7228,7,10,5,17,29,48,-19,35
FC Thun,7228,8,9,7,16,47,62,-15,34
FC Sion,7228,9,6,9,17,39,53,-14,27
Young Boys,7229,1,21,6,5,69,36,33,69
FC Basel,7229,2,18,9,5,54,24,30,63
Lucerne,7229,3,13,7,12,43,45,-2,46
St Gallen,7229,4,13,4,15,40,54,-14,43
FC Zürich,7229,5,10,11,11,40,36,4,41
FC Lugano,7229,6,12,5,15,36,47,-11,41
Grasshoppers,7229,7,10,6,16,41,49,-8,36
FC Thun,7229,8,9,6,17,45,63,-18,33
FC Sion,7229,9,6,10,16,40,54,-14,28
Young Boys,7230,1,23,7,2,81,37,44,76
FC Basel,7230,2,17,9,6,56,28,28,60
St Gallen,7230,3,15,2,15,44,53,-9,47
Lucerne,7230,4,12,9,11,40,48,-8,45
FC Zürich,7230,5,10,9,13,41,39,2,39
FC Lugano,7230,6,10,6,16,33,50,-17,36
FC Thun,7230,7,9,6,17,45,61,-16,33
FC Sion,7230,8,8,8,16,45,56,-11,32
Grasshoppers,7230,9,8,8,16,41,54,-13,32
Young Boys,7231,1,22,6,4,69,35,34,72
FC Basel,7231,2,17,7,8,51,27,24,58
St Gallen,7231,3,14,4,14,40,54,-14,46
FC Zürich,7231,4,12,9,11,46,39,7,45
Lucerne,7231,5,12,9,11,40,42,-2,45
Grasshoppers,7231,6,10,7,15,45,50,-5,37
FC Thun,7231,7,10,6,16,47,61,-14,36
FC Lugano,7231,8,9,6,17,28,49,-21,33
FC Sion,7231,9,7,8,17,47,56,-9,29
Young Boys,7232,1,20,8,4,69,35,34,68
FC Basel,7232,2,18,8,6,53,25,28,62
St Gallen,7232,3,17,2,13,48,53,-5,53
Lucerne,7232,4,11,8,13,37,45,-8,41
FC Zürich,7232,5,10,10,12,39,35,4,40
FC Lugano,7232,6,11,6,15,32,47,-15,39
Grasshoppers,7232,7,10,8,14,42,47,-5,38
FC Thun,7232,8,8,7,17,42,60,-18,31
FC Sion,7232,9,6,9,17,38,53,-15,27
Young Boys,7233,1,23,7,2,77,31,46,76
FC Basel,7233,2,17,9,6,54,25,29,60
St Gallen,7233,3,15,4,13,47,53,-6,49
Lucerne,7233,4,13,7,12,44,51,-7,46
FC Zürich,7233,5,10,10,12,39,36,3,40
FC Lugano,7233,6,9,7,16,29,48,-19,34
FC Thun,7233,7,9,6,17,44,62,-18,33
FC Sion,7233,8,8,7,17,39,52,-13,31
Grasshoppers,7233,9,8,7,17,38,53,-15,31
Young Boys,7234,1,20,7,5,67,35,32,67
FC Basel,7234,2,18,8,6,55,24,31,62
Lucerne,7234,3,12,9,11,39,43,-4,45
St Gallen,7234,4,14,3,15,46,57,-11,45
FC Zürich,7234,5,10,11,11,39,37,2,41
FC Lugano,7234,6,11,6,15,32,47,-15,39
Grasshoppers,7234,7,10,6,16,40,47,-7,36
FC Thun,7234,8,10,6,16,42,58,-16,36
FC Sion,7234,9,7,8,17,43,55,-12,29
Young Boys,7235,1,21,8,3,73,38,35,71
FC Basel,7235,2,19,8,5,58,25,33,65
Lucerne,7235,3,12,9,11,40,42,-2,45
St Gallen,7235,4,13,4,15,41,55,-14,43
FC Zürich,7235,5,10,9,13,39,38,1,39
Grasshoppers,7235,6,9,9,14,44,49,-5,36
FC Lugano,7235,7,10,5,17,32,50,-18,35
FC Thun,7235,8,9,6,17,43,62,-19,33
FC Sion,7235,9,7,10,15,40,51,-11,31
Young Boys,7236,1,22,6,4,70,33,37,72
FC Basel,7236,2,19,8,5,55,24,31,65
Lucerne,7236,3,13,8,11,46,45,1,47
St Gallen,7236,4,13,3,16,41,57,-16,42
FC Zürich,7236,5,10,11,11,40,36,4,41
FC Lugano,7236,6,12,5,15,33,46,-13,41
Grasshoppers,7236,7,9,6,17,40,53,-13,33
FC Thun,7236,8,9,6,17,43,58,-15,33
FC Sion,7236,9,6,9,17,41,57,-16,27
Young Boys,7237,1,20,8,4,68,36,32,68
FC Basel,7237,2,20,7,5,62,25,37,67
Lucerne,7237,3,12,10,10,43,44,-1,46
St Gallen,7237,4,13,5,14,41,55,-14,44
FC Zürich,7237,5,11,10,11,44,36,8,43
FC Lugano,7237,6,10,7,15,32,47,-15,37
Grasshoppers,7237,7,9,7,16,41,51,-10,34
FC Thun,7237,8,9,6,17,44,63,-19,33
FC Sion,7237,9,6,8,18,39,57,-18,26
Young Boys,7238,1,22,7,3,69,32,37,73
FC Basel,7238,2,19,8,5,55,23,32,65
Lucerne,7238,3,13,7,12,45,44,1,46
St Gallen,7238,4,14,4,14,44,55,-11,46
FC Zürich,7238,5,11,10,11,42,35,7,43
Grasshoppers,7238,6,10,7,15,40,47,-7,37
FC Lugano,7238,7,9,7,16,31,51,-20,34
FC Thun,7238,8,8,7,17,41,61,-20,31
FC Sion,7238,9,6,7,19,37,56,-19,25
Young Boys,7239,1,22,6,4,71,37,34,72
FC Basel,7239,2,18,8,6,57,29,28,62
St Gallen,7239,3,16,3,13,47,53,-6,51
FC Zürich,7239,4,12,10,10,49,38,11,46
Lucerne,7239,5,12,8,12,42,48,-6,44
Grasshoppers,7239,6,9,8,15,41,48,-7,35
FC Thun,7239,7,9,6,17,42,61,-19,33
FC Lugano,7239,8,9,6,17,32,51,-19,33
FC Sion,7239,9,5,9,18,40,56,-16,24
Young Boys,7240,1,21,8,3,72,34,38,71
FC Basel,7240,2,16,10,6,53,27,26,58
St Gallen,7240,3,15,3,14,43,53,-10,48
Lucerne,7240,4,12,9,11,39,42,-3,45
FC Zürich,7240,5,10,12,10,41,36,5,42
FC Thun,7240,6,10,6,16,49,63,-14,36
FC Lugano,7240,7,10,6,16,29,49,-20,36
Grasshoppers,7240,8,9,7,16,40,50,-10,34
FC Sion,7240,9,7,7,18,42,54,-12,28
Young Boys,7241,1,21,6,5,70,38,32,69
FC Basel,7241,2,18,7,7,54,26,28,61
Lucerne,7241,3,13,8,11,39,41,-2,47
St Gallen,7241,4,14,2,16,44,58,-14,44
FC Zürich,7241,5,11,9,12,43,38,5,42
Grasshoppers,7241,6,11,7,14,47,47,0,40
FC Lugano,7241,7,11,6,15,31,47,-16,39
FC Thun,7241,8,8,7,17,44,65,-21,31
FC Sion,7241,9,7,8,17,44,56,-12,29
Young Boys,7242,1,21,7,4,72,38,34,70
FC Basel,7242,2,17,9,6,56,27,29,60
St Gallen,7242,3,15,2,15,43,52,-9,47
Lucerne,7242,4,12,8,12,43,49,-6,44
FC Lugano,7242,5,11,6,15,35,49,-14,39
FC Zürich,7242,6,9,11,12,38,38,0,38
Grasshoppers,7242,7,9,8,15,43,48,-5,35
FC Sion,7242,8,9,7,16,43,53,-10,34
FC Thun,7242,9,8,8,16,41,60,-19,32
Young Boys,7243,1,21,8,3,73,38,35,71
FC Basel,7243,2,17,7,8,56,32,24,58
St Gallen,7243,3,16,3,13,48,54,-6,51
Lucerne,7243,4,14,7,11,45,46,-1,49
FC Zürich,7243,5,11,10,11,38,34,4,43
Grasshoppers,7243,6,10,7,15,43,49,-6,37
FC Thun,7243,7,10,5,17,43,57,-14,35
FC Lugano,7243,8,9,6,17,29,47,-18,33
FC Sion,7243,9,5,9,18,37,55,-18,24
Young Boys,7244,1,22,7,3,74,33,41,73
FC Basel,7244,2,18,8,6,52,24,28,62
Lucerne,7244,3,14,7,11,45,47,-2,49
St Gallen,7244,4,14,4,14,44,56,-12,46
FC Zürich,7244,5,11,9,12,43,37,6,42
FC Lugano,7244,6,10,6,16,32,50,-18,36
Grasshoppers,7244,7,9,6,17,42,54,-12,33
FC Thun,7244,8,9,5,18,44,60,-16,32
FC Sion,7244,9,7,8,17,42,57,-15,29
Young Boys,7245,1,22,7,3,72,33,39,73
FC Basel,7245,2,18,9,5,57,27,30,63
Lucerne,7245,3,13,9,10,44,44,0,48
St Gallen,7245,4,15,3,14,45,54,-9,48
FC Zürich,7245,5,11,9,12,45,38,7,42
FC Thun,7245,6,11,5,16,47,61,-14,38
Grasshoppers,7245,7,9,7,16,44,52,-8,34
FC Lugano,7245,8,9,6,17,30,51,-21,33
FC Sion,7245,9,5,7,20,38,62,-24,22
Young Boys,7246,1,22,6,4,72,38,34,72
FC Basel,7246,2,18,8,6,52,25,27,62
St Gallen,7246,3,14,4,14,45,54,-9,46
Lucerne,7246,4,12,9,11,45,47,-2,45
FC Lugano,7246,5,11,7,14,32,43,-11,40
FC Zürich,7246,6,9,10,13,38,39,-1,37
Grasshoppers,7246,7,10,7,15,46,53,-7,37
FC Thun,7246,8,9,5,18,41,58,-17,32
FC Sion,7246,9,7,8,17,43,57,-14,29
Young Boys,7247,1,20,8,4,69,36,33,68
FC Basel,7247,2,16,9,7,50,28,22,57
Lucerne,7247,3,14,7,11,44,42,2,49
St Gallen,7247,4,15,3,14,44,54,-10,48
FC Lugano,7247,5,12,5,15,34,44,-10,41
FC Zürich,7247,6,9,11,12,40,39,1,38
FC Thun,7247,7,10,6,16,44,59,-15,36
Grasshoppers,7247,8,9,7,16,42,52,-10,34
FC Sion,7247,9,6,10,16,42,55,-13,28
Young Boys,7248,1,24,6,2,76,34,42,78
FC Basel,7248,2,15,9,8,49,30,19,54
Lucerne,7248,3,13,8,11,42,42,0,47
FC Zürich,7248,4,12,10,10,42,33,9,46
St Gallen,7248,5,13,4,15,42,55,-13,43
FC Lugano,7248,6,11,5,16,31,47,-16,38
FC Thun,7248,7,10,6,16,43,57,-14,36
Grasshoppers,7248,8,9,8,15,42,49,-7,35
FC Sion,7248,9,5,8,19,35,55,-20,23
Young Boys,7249,1,20,7,5,69,39,30,67
FC Basel,7249,2,18,8,6,54,25,29,62
Lucerne,7249,3,13,9,10,46,44,2,48
FC Zürich,7249,4,12,10,10,42,32,10,46
St Gallen,7249,5,14,2,16,41,55,-14,44
FC Lugano,7249,6,11,5,16,30,49,-19,38
Grasshoppers,7249,7,9,7,16,43,51,-8,34
FC Thun,7249,8,9,6,17,42,60,-18,33
FC Sion,7249,9,7,8,17,43,55,-12,29
Young Boys,7250,1,22,7,3,70,31,39,73
FC Basel,7250,2,16,8,8,53,30,23,56
St Gallen,7250,3,16,3,13,44,52,-8,51
FC Zürich,7250,4,13,9,10,45,33,12,48
Lucerne,7250,5,13,9,10,40,42,-2,48
Grasshoppers,7250,6,10,6,16,40,48,-8,36
FC Thun,7250,7,9,6,17,43,58,-15,33
FC Lugano,7250,8,9,5,18,29,49,-20,32
FC Sion,7250,9,5,9,18,34,55,-21,24
Young Boys,7251,1,22,7,3,68,35,33,73
FC Basel,7251,2,18,8,6,59,25,34,62
Lucerne,7251,3,14,8,10,47,42,5,50
St Gallen,7251,4,14,4,14,44,58,-14,46
FC Zürich,7251,5,10,10,12,41,39,2,40
FC Lugano,7251,6,10,7,15,33,49,-16,37
FC Thun,7251,7,9,8,15,43,57,-14,35
Grasshoppers,7251,8,8,7,17,43,56,-13,31
FC Sion,7251,9,5,9,18,40,57,-17,24
Young Boys,7252,1,21,9,2,69,33,36,72
FC Basel,7252,2,16,10,6,54,30,24,58
Lucerne,7252,3,12,9,11,41,45,-4,45
FC Zürich,7252,4,11,10,11,43,35,8,43
FC Lugano,7252,5,12,6,14,34,43,-9,42
St Gallen,7252,6,13,3,16,42,58,-16,42
FC Thun,7252,7,8,9,15,44,59,-15,33
Grasshoppers,7252,8,8,8,16,40,50,-10,32
FC Sion,7252,9,6,10,16,38,52,-14,28
Young Boys,7253,1,19,7,6,64,36,28,64
FC Basel,7253,2,18,9,5,55,26,29,63
Lucerne,7253,3,13,9,10,39,39,0,48
St Gallen,7253,4,13,4,15,41,56,-15,43
Grasshoppers,7253,5,11,7,14,41,45,-4,40
FC Zürich,7253,6,10,9,13,42,41,1,39
FC Lugano,7253,7,11,6,15,33,46,-13,39
FC Thun,7253,8,9,6,17,45,60,-15,33
FC Sion,7253,9,8,7,17,40,51,-11,31
Young Boys,7254,1,23,7,2,75,32,43,76
FC Basel,7254,2,17,7,8,55,29,26,58
Lucerne,7254,3,15,8,9,49,42,7,53
St Gallen,7254,4,15,3,14,45,53,-8,48
FC Zürich,7254,5,11,10,11,43,38,5,43
Grasshoppers,7254,6,10,6,16,42,52,-10,36
FC Thun,7254,7,9,6,17,43,61,-18,33
FC Lugano,7254,8,9,6,17,31,56,-25,33
FC Sion,7254,9,5,7,20,36,56,-20,22
Young Boys,7255,1,21,8,3,68,36,32,71
FC Basel,7255,2,18,9,5,57,24,33,63
St Gallen,7255,3,13,5,14,44,56,-12,44
Lucerne,7255,4,11,10,11,40,45,-5,43
FC Zürich,7255,5,10,11,11,41,36,5,41
Grasshoppers,7255,6,11,6,15,46,47,-1,39
FC Lugano,7255,7,9,8,15,30,47,-17,35
FC Thun,7255,8,10,5,17,44,62,-18,35
FC Sion,7255,9,6,8,18,40,57,-17,26
Young Boys,7256,1,21,7,4,70,36,34,70
FC Basel,7256,2,19,7,6,56,27,29,64
St Gallen,7256,3,16,2,14,45,53,-8,50
Lucerne,7256,4,12,8,12,41,44,-3,44
FC Zürich,7256,5,10,10,12,39,36,3,40
FC Lugano,7256,6,11,6,15,32,46,-14,39
FC Thun,7256,7,11,5,16,48,58,-10,38
Grasshoppers,7256,8,8,6,18,38,53,-15,30
FC Sion,7256,9,6,9,17,37,53,-16,27
Young Boys,7257,1,21,6,5,67,34,33,69
FC Basel,7257,2,19,8,5,53,23,30,65
St Gallen,7257,3,15,2,15,44,56,-12,47
FC Zürich,7257,4,11,11,10,41,34,7,44
Lucerne,7257,5,12,7,13,39,45,-6,43
Grasshoppers,7257,6,11,6,15,43,48,-5,39
FC Lugano,7257,7,10,5,17,33,50,-17,35
FC Thun,7257,8,9,5,18,44,62,-18,32
FC Sion,7257,9,7,8,17,41,53,-12,29
Young Boys,7258,1,21,7,4,70,38,32,70
FC Basel,7258,2,18,7,7,53,26,27,61
Lucerne,7258,3,14,8,10,43,41,2,50
St Gallen,7258,4,14,3,15,45,56,-11,45
FC Zürich,7258,5,10,9,13,40,39,1,39
FC Thun,7258,6,11,5,16,45,55,-10,38
Grasshoppers,7258,7,10,6,16,42,50,-8,36
FC Lugano,7258,8,10,5,17,32,50,-18,35
FC Sion,7258,9,7,8,17,39,54,-15,29
Young Boys,7259,1,20,7,5,72,40,32,67
FC Basel,7259,2,19,8,5,54,22,32,65
St Gallen,7259,3,14,5,13,42,52,-10,47
Grasshoppers,7259,4,12,6,14,44,46,-2,42
Lucerne,7259,5,11,9,12,39,47,-8,42
FC Zürich,7259,6,10,11,11,40,36,4,41
FC Lugano,7259,7,10,6,16,32,48,-16,36
FC Thun,7259,8,8,7,17,43,60,-17,31
FC Sion,7259,9,6,9,17,40,55,-15,27
Young Boys,7260,1,20,9,3,73,36,37,69
FC Basel,7260,2,17,10,5,58,27,31,61
Lucerne,7260,3,12,9,11,42,44,-2,45
St Gallen,7260,4,14,2,16,43,61,-18,44
FC Zürich,7260,5,10,10,12,41,37,4,40
Grasshoppers,7260,6,11,7,14,45,49,-4,40
FC Lugano,7260,7,11,5,16,34,51,-17,38
FC Thun,7260,8,9,6,17,46,64,-18,33
FC Sion,7260,9,7,8,17,41,54,-13,29
Young Boys,7261,1,22,7,3,82,35,47,73
FC Basel,7261,2,17,9,6,50,23,27,60
Lucerne,7261,3,14,9,9,45,40,5,51
St Gallen,7261,4,14,3,15,42,54,-12,45
FC Zürich,7261,5,10,12,10,42,36,6,42
Grasshoppers,7261,6,10,6,16,40,54,-14,36
FC Lugano,7261,7,10,6,16,30,53,-23,36
FC Thun,7261,8,9,7,16,44,57,-13,34
FC Sion,7261,9,5,7,20,36,59,-23,22
Young Boys,7262,1,21,7,4,71,35,36,70
FC Basel,7262,2,18,9,5,57,25,32,63
Lucerne,7262,3,13,9,10,46,47,-1,48
St Gallen,7262,4,14,4,14,41,53,-12,46
FC Zürich,7262,5,11,9,12,44,35,9,42
FC Thun,7262,6,10,5,17,42,59,-17,35
Grasshoppers,7262,7,9,7,16,40,48,-8,34
FC Lugano,7262,8,9,5,18,30,53,-23,32
FC Sion,7262,9,8,7,17,40,56,-16,31
Young Boys,7263,1,21,6,5,70,36,34,69
FC Basel,7263,2,19,7,6,57,25,32,64
Lucerne,7263,3,13,8,11,44,42,2,47
St Gallen,7263,4,13,5,14,43,57,-14,44
FC Zürich,7263,5,10,10,12,40,42,-2,40
FC Lugano,7263,6,11,6,15,36,49,-13,39
FC Thun,7263,7,11,5,16,48,58,-10,38
FC Sion,7263,8,7,9,16,43,55,-12,30
Grasshoppers,7263,9,8,6,18,37,54,-17,30
Young Boys,7264,1,23,6,3,75,33,42,75
FC Basel,7264,2,17,7,8,51,27,24,58
Lucerne,7264,3,14,8,10,43,44,-1,50
St Gallen,7264,4,14,3,15,42,54,-12,45
FC Lugano,7264,5,11,6,15,32,47,-15,39
Grasshoppers,7264,6,10,7,15,41,47,-6,37
FC Zürich,7264,7,9,9,14,37,38,-1,36
FC Thun,7264,8,10,5,17,43,56,-13,35
FC Sion,7264,9,6,9,17,38,56,-18,27
Young Boys,7265,1,22,7,3,75,36,39,73
FC Basel,7265,2,19,7,6,56,25,31,64
St Gallen,7265,3,15,3,14,43,53,-10,48
Lucerne,7265,4,13,8,11,43,40,3,47
FC Zürich,7265,5,10,11,11,39,35,4,41
Grasshoppers,7265,6,10,6,16,38,49,-11,36
FC Lugano,7265,7,10,6,16,31,50,-19,36
FC Thun,7265,8,9,5,18,42,59,-17,32
FC Sion,7265,9,5,9,18,38,58,-20,24
FC Basel,7266,1,20,7,5,58,24,34,67
Young Boys,7266,2,20,7,5,70,38,32,67
Lucerne,7266,3,13,9,10,49,48,1,48
St Gallen,7266,4,13,3,16,45,62,-17,42
FC Zürich,7266,5,10,10,12,41,38,3,40
FC Lugano,7266,6,10,7,15,33,49,-16,37
Grasshoppers,7266,7,10,6,16,44,50,-6,36
FC Sion,7266,8,8,8,16,41,53,-12,32
FC Thun,7266,9,9,5,18,41,60,-19,32
Young Boys,7267,1,21,7,4,73,38,35,70
FC Basel,7267,2,19,7,6,57,27,30,64
Lucerne,7267,3,14,7,11,44,43,1,49
St Gallen,7267,4,14,2,16,41,57,-16,44
FC Zürich,7267,5,11,9,12,41,35,6,42
FC Lugano,7267,6,12,5,15,34,45,-11,41
Grasshoppers,7267,7,10,7,15,42,49,-7,37
FC Thun,7267,8,10,5,17,41,58,-17,35
FC Sion,7267,9,5,7,20,39,60,-21,22
Young Boys,7268,1,21,7,4,70,35,35,70
FC Basel,7268,2,16,8,8,49,26,23,56
Lucerne,7268,3,14,7,11,46,45,1,49
St Gallen,7268,4,14,2,16,43,60,-17,44
FC Zürich,7268,5,10,10,12,40,38,2,40
Grasshoppers,7268,6,11,7,14,46,48,-2,40
FC Lugano,7268,7,10,6,16,32,47,-15,36
FC Thun,7268,8,9,7,16,45,58,-13,34
FC Sion,7268,9,8,8,16,41,55,-14,32
Young Boys,7269,1,22,7,3,74,36,38,73
FC Basel,7269,2,19,8,5,54,21,33,65
St Gallen,7269,3,15,3,14,43,53,-10,48
Lucerne,7269,4,13,7,12,44,48,-4,46
FC Zürich,7269,5,10,10,12,39,39,0,40
FC Thun,7269,6,10,6,16,47,56,-9,36
FC Lugano,7269,7,9,8,15,29,46,-17,35
Grasshoppers,7269,8,9,7,16,43,55,-12,34
FC Sion,7269,9,5,8,19,40,59,-19,23
Young Boys,7270,1,20,9,3,70,35,35,69
FC Basel,7270,2,17,10,5,57,24,33,61
Lucerne,7270,3,13,9,10,44,42,2,48
St Gallen,7270,4,13,4,15,39,59,-20,43
FC Zürich,7270,5,9,12,11,41,38,3,39
FC Lugano,7270,6,11,5,16,32,49,-17,38
FC Thun,7270,7,10,6,16,45,59,-14,36
Grasshoppers,7270,8,9,7,16,43,52,-9,34
FC Sion,7270,9,6,10,16,38,51,-13,28
Young Boys,7271,1,21,8,3,70,33,37,71
FC Basel,7271,2,18,9,5,55,24,31,63
St Gallen,7271,3,14,3,15,45,57,-12,45
Lucerne,7271,4,11,10,11,39,47,-8,43
FC Lugano,7271,5,11,6,15,35,47,-12,39
FC Zürich,7271,6,9,10,13,39,40,-1,37
Grasshoppers,7271,7,9,8,15,40,48,-8,35
FC Thun,7271,8,9,7,16,44,60,-16,34
FC Sion,7271,9,7,9,16,43,54,-11,30
Young Boys,7272,1,23,6,3,75,36,39,75
FC Basel,7272,2,18,7,7,57,28,29,61
St Gallen,7272,3,15,2,15,42,52,-10,47
Lucerne,7272,4,13,7,12,41,43,-2,46
FC Zürich,7272,5,12,9,11,49,37,12,45
FC Lugano,7272,6,11,5,16,32,48,-16,38
Grasshoppers,7272,7,9,7,16,40,52,-12,34
FC Thun,7272,8,9,6,17,47,64,-17,33
FC Sion,7272,9,6,7,19,40,63,-23,25
Young Boys,7273,1,20,6,6,67,37,30,66
FC Basel,7273,2,19,8,5,61,25,36,65
Lucerne,7273,3,13,9,10,44,43,1,48
FC Zürich,7273,4,11,10,11,39,37,2,43
St Gallen,7273,5,13,4,15,42,58,-16,43
FC Lugano,7273,6,10,7,15,31,46,-15,37
FC Thun,7273,7,10,6,16,49,57,-8,36
Grasshoppers,7273,8,10,6,16,42,54,-12,36
FC Sion,7273,9,6,8,18,38,56,-18,26
Young Boys,7274,1,22,6,4,74,35,39,72
FC Basel,7274,2,18,7,7,57,29,28,61
St Gallen,7274,3,16,2,14,49,58,-9,50
Lucerne,7274,4,13,7,12,43,44,-1,46
FC Zürich,7274,5,10,10,12,38,36,2,40
Grasshoppers,7274,6,10,6,16,41,51,-10,36
FC Lugano,7274,7,10,6,16,29,48,-19,36
FC Thun,7274,8,10,5,17,45,58,-13,35
FC Sion,7274,9,7,7,18,44,61,-17,28
Young Boys,7275,1,21,7,4,68,37,31,70
FC Basel,7275,2,19,8,5,56,24,32,65
Lucerne,7275,3,13,9,10,45,45,0,48
FC Zürich,7275,4,11,10,11,43,36,7,43
St Gallen,7275,5,13,3,16,42,59,-17,42
FC Thun,7275,6,11,5,16,48,58,-10,38
FC Lugano,7275,7,11,5,16,34,49,-15,38
Grasshoppers,7275,8,8,6,18,40,52,-12,30
FC Sion,7275,9,7,7,18,40,56,-16,28
Young Boys,7276,1,22,6,4,78,37,41,72
FC Basel,7276,2,18,9,5,57,26,31,63
St Gallen,7276,3,14,3,15,41,58,-17,45
Lucerne,7276,4,12,8,12,44,48,-4,44
FC Zürich,7276,5,11,9,12,43,40,3,42
Grasshoppers,7276,6,10,6,16,44,52,-8,36
FC Lugano,7276,7,10,5,17,32,52,-20,35
FC Sion,7276,8,9,7,16,47,54,-7,34
FC Thun,7276,9,9,5,18,44,63,-19,32
Young Boys,7277,1,21,8,3,69,33,36,71
FC Basel,7277,2,16,10,6,49,24,25,58
Lucerne,7277,3,13,9,10,40,40,0,48
FC Zürich,7277,4,11,11,10,43,36,7,44
St Gallen,7277,5,13,3,16,44,58,-14,42
FC Thun,7277,6,11,5,16,44,57,-13,38
FC Lugano,7277,7,10,7,15,33,49,-16,37
Grasshoppers,7277,8,8,8,16,37,48,-11,32
FC Sion,7277,9,6,9,17,41,55,-14,27
Young Boys,7278,1,23,6,3,74,35,39,75
FC Basel,7278,2,17,9,6,57,25,32,60
Lucerne,7278,3,12,9,11,42,49,-7,45
St Gallen,7278,4,14,2,16,40,57,-17,44
FC Zürich,7278,5,11,10,11,40,35,5,43
Grasshoppers,7278,6,9,7,16,39,47,-8,34
FC Sion,7278,7,9,7,16,42,51,-9,34
FC Thun,7278,8,9,6,17,40,56,-16,33
FC Lugano,7278,9,9,6,17,28,47,-19,33
Young Boys,7279,1,21,6,5,70,37,33,69
FC Basel,7279,2,18,8,6,59,32,27,62
St Gallen,7279,3,15,4,13,44,52,-8,49
Lucerne,7279,4,12,9,11,43,45,-2,45
FC Zürich,7279,5,10,11,11,43,37,6,41
Grasshoppers,7279,6,10,6,16,43,50,-7,36
FC Sion,7279,7,8,9,15,41,51,-10,33
FC Lugano,7279,8,9,6,17,29,49,-20,33
FC Thun,7279,9,9,5,18,42,61,-19,32
Young Boys,7280,1,21,6,5,69,36,33,69
FC Basel,7280,2,16,8,8,53,30,23,56
Lucerne,7280,3,16,7,9,50,40,10,55
FC Zürich,7280,4,12,9,11,43,37,6,45
St Gallen,7280,5,13,3,16,41,58,-17,42
FC Thun,7280,6,10,5,17,44,58,-14,35
FC Lugano,7280,7,10,5,17,30,51,-21,35
FC Sion,7280,8,9,7,16,45,53,-8,34
Grasshoppers,7280,9,9,6,17,37,49,-12,33
Young Boys,7281,1,20,8,4,71,36,35,68
FC Basel,7281,2,17,7,8,51,29,22,58
Lucerne,7281,3,14,8,10,46,41,5,50
FC Zürich,7281,4,13,9,10,47,35,12,48
St Gallen,7281,5,14,2,16,42,58,-16,44
FC Lugano,7281,6,11,6,15,32,46,-14,39
Grasshoppers,7281,7,9,8,15,41,49,-8,35
FC Thun,7281,8,8,6,18,39,58,-19,30
FC Sion,7281,9,7,8,17,42,59,-17,29
Young Boys,7282,1,21,7,4,71,38,33,70
FC Basel,7282,2,18,8,6,54,26,28,62
St Gallen,7282,3,16,2,14,45,53,-8,50
Lucerne,7282,4,13,7,12,42,44,-2,46
FC Zürich,7282,5,10,10,12,42,38,4,40
FC Lugano,7282,6,11,5,16,30,49,-19,38
Grasshoppers,7282,7,9,7,16,41,47,-6,34
FC Thun,7282,8,9,7,16,44,57,-13,34
FC Sion,7282,9,7,7,18,42,59,-17,28
Young Boys,7283,1,22,8,2,75,34,41,74
FC Basel,7283,2,18,7,7,55,26,29,61
St Gallen,7283,3,14,3,15,42,56,-14,45
Lucerne,7283,4,12,7,13,41,48,-7,43
FC Zürich,7283,5,11,9,12,41,38,3,42
Grasshoppers,7283,6,10,7,15,44,49,-5,37
FC Thun,7283,7,10,5,17,43,59,-16,35
FC Lugano,7283,8,9,7,16,31,49,-18,34
FC Sion,7283,9,8,7,17,41,54,-13,31
Young Boys,7284,1,23,7,2,73,32,41,76
FC Basel,7284,2,18,8,6,53,23,30,62
St Gallen,7284,3,15,2,15,44,58,-14,47
Lucerne,7284,4,12,8,12,43,49,-6,44
FC Zürich,7284,5,10,10,12,39,38,1,40
Grasshoppers,7284,6,10,7,15,44,48,-4,37
FC Lugano,7284,7,10,5,17,32,49,-17,35
FC Thun,7284,8,9,6,17,43,58,-15,33
FC Sion,7284,9,7,7,18,40,56,-16,28
Young Boys,7285,1,21,6,5,74,39,35,69
FC Basel,7285,2,17,8,7,54,30,24,59
St Gallen,7285,3,15,3,14,46,52,-6,48
Lucerne,7285,4,12,7,13,42,50,-8,43
FC Zürich,7285,5,10,11,11,45,40,5,41
Grasshoppers,7285,6,11,6,15,42,48,-6,39
FC Lugano,7285,7,10,7,15,33,49,-16,37
FC Thun,7285,8,10,6,16,42,56,-14,36
FC Sion,7285,9,7,8,17,41,55,-14,29
Young Boys,7286,1,22,7,3,76,36,40,73
FC Basel,7286,2,19,7,6,58,26,32,64
Lucerne,7286,3,13,7,12,40,49,-9,46
St Gallen,7286,4,14,3,15,46,53,-7,45
FC Zürich,7286,5,10,10,12,40,37,3,40
Grasshoppers,7286,6,10,7,15,46,50,-4,37
FC Thun,7286,7,10,5,17,44,62,-18,35
FC Lugano,7286,8,9,6,17,30,51,-21,33
FC Sion,7286,9,7,8,17,39,55,-16,29
Young Boys,7287,1,21,6,5,70,39,31,69
FC Basel,7287,2,19,8,5,54,25,29,65
St Gallen,7287,3,15,3,14,43,52,-9,48
Lucerne,7287,4,13,7,12,42,45,-3,46
FC Zürich,7287,5,10,11,11,41,36,5,41
FC Lugano,7287,6,10,7,15,34,47,-13,37
FC Thun,7287,7,10,6,16,43,56,-13,36
Grasshoppers,7287,8,9,7,16,39,48,-9,34
FC Sion,7287,9,5,9,18,37,55,-18,24
Young Boys,7288,1,22,7,3,75,34,41,73
FC Basel,7288,2,19,8,5,60,25,35,65
St Gallen,7288,3,16,2,14,44,55,-11,50
Lucerne,7288,4,13,7,12,45,46,-1,46
FC Zürich,7288,5,10,10,12,40,40,0,40
Grasshoppers,7288,6,10,6,16,41,49,-8,36
FC Thun,7288,7,10,5,17,45,59,-14,35
FC Lugano,7288,8,10,5,17,30,49,-19,35
FC Sion,7288,9,5,8,19,39,62,-23,23
Young Boys,7289,1,22,6,4,77,39,38,72
FC Basel,7289,2,18,8,6,55,26,29,62
Lucerne,7289,3,14,7,11,43,43,0,49
St Gallen,7289,4,14,3,15,40,54,-14,45
FC Zürich,7289,5,9,11,12,39,38,1,38
FC Lugano,7289,6,11,5,16,32,46,-14,38
Grasshoppers,7289,7,9,7,16,40,49,-9,34
FC Thun,7289,8,9,6,17,42,59,-17,33
FC Sion,7289,9,7,9,16,39,53,-14,30
Young Boys,7290,1,21,8,3,74,38,36,71
FC Basel,7290,2,17,9,6,55,28,27,60
Lucerne,7290,3,13,9,10,41,41,0,48
St Gallen,7290,4,14,3,15,44,56,-12,45
FC Zürich,7290,5,10,11,11,42,37,5,41
FC Lugano,7290,6,11,5,16,31,50,-19,38
Grasshoppers,7290,7,10,6,16,40,48,-8,36
FC Thun,7290,8,8,7,17,43,60,-17,31
FC Sion,7290,9,7,8,17,44,56,-12,29
Young Boys,7291,1,21,7,4,69,35,34,70
FC Basel,7291,2,17,9,6,55,24,31,60
Lucerne,7291,3,14,9,9,44,41,3,51
FC Zürich,7291,4,12,9,11,44,37,7,45
St Gallen,7291,5,13,2,17,39,59,-20,41
FC Thun,7291,6,11,5,16,46,60,-14,38
FC Lugano,7291,7,10,6,16,30,47,-17,36
Grasshoppers,7291,8,9,6,17,41,51,-10,33
FC Sion,7291,9,7,7,18,43,57,-14,28
Young Boys,7292,1,20,8,4,68,39,29,68
FC Basel,7292,2,16,9,7,51,26,25,57
St Gallen,7292,3,15,4,13,47,51,-4,49
FC Zürich,7292,4,12,9,11,45,33,12,45
Lucerne,7292,5,12,7,13,39,43,-4,43
Grasshoppers,7292,6,12,6,14,46,46,0,42
FC Lugano,7292,7,10,7,15,28,45,-17,37
FC Thun,7292,8,9,6,17,41,59,-18,33
FC Sion,7292,9,6,8,18,38,61,-23,26
Young Boys,7293,1,20,8,4,70,37,33,68
FC Basel,7293,2,16,9,7,54,30,24,57
St Gallen,7293,3,16,2,14,48,54,-6,50
Lucerne,7293,4,12,10,10,42,43,-1,46
FC Zürich,7293,5,11,11,10,44,36,8,44
Grasshoppers,7293,6,11,7,14,45,47,-2,40
FC Lugano,7293,7,10,6,16,33,50,-17,36
FC Thun,7293,8,10,5,17,41,58,-17,35
FC Sion,7293,9,5,8,19,37,59,-22,23
Young Boys,7294,1,22,8,2,76,33,43,74
FC Basel,7294,2,18,8,6,54,24,30,62
St Gallen,7294,3,14,4,14,42,52,-10,46
FC Zürich,7294,4,11,10,11,40,36,4,43
Lucerne,7294,5,11,9,12,41,50,-9,42
Grasshoppers,7294,6,10,8,14,42,47,-5,38
FC Lugano,7294,7,10,7,15,32,47,-15,37
FC Thun,7294,8,9,5,18,43,57,-14,32
FC Sion,7294,9,5,9,18,37,61,-24,24
Young Boys,7295,1,23,7,2,78,36,42,76
FC Basel,7295,2,17,8,7,59,32,27,59
Lucerne,7295,3,13,8,11,44,46,-2,47
FC Zürich,7295,4,12,10,10,44,36,8,46
St Gallen,7295,5,14,2,16,45,58,-13,44
FC Lugano,7295,6,11,5,16,32,49,-17,38
FC Thun,7295,7,9,5,18,45,64,-19,32
Grasshoppers,7295,8,8,7,17,42,55,-13,31
FC Sion,7295,9,7,8,17,43,56,-13,29
Young Boys,7296,1,22,8,2,77,34,43,74
FC Basel,7296,2,16,8,8,51,29,22,56
St Gallen,7296,3,16,2,14,48,55,-7,50
Lucerne,7296,4,12,10,10,45,44,1,46
FC Zürich,7296,5,10,11,11,42,39,3,41
FC Thun,7296,6,11,6,15,50,59,-9,39
Grasshoppers,7296,7,9,8,15,40,49,-9,35
FC Lugano,7296,8,9,6,17,30,54,-24,33
FC Sion,7296,9,6,7,19,40,60,-20,25
Young Boys,7297,1,22,6,4,81,42,39,72
FC Basel,7297,2,18,9,5,61,25,36,63
St Gallen,7297,3,15,3,14,42,52,-10,48
Lucerne,7297,4,13,7,12,41,44,-3,46
FC Zürich,7297,5,10,12,10,40,35,5,42
Grasshoppers,7297,6,11,6,15,45,47,-2,39
FC Thun,7297,7,9,6,17,45,64,-19,33
FC Lugano,7297,8,9,5,18,29,57,-28,32
FC Sion,7297,9,6,8,18,41,59,-18,26
Young Boys,7298,1,21,8,3,71,33,38,71
FC Basel,7298,2,20,7,5,54,23,31,67
St Gallen,7298,3,15,2,15,44,54,-10,47
Lucerne,7298,4,13,7,12,43,45,-2,46
FC Zürich,7298,5,11,9,12,41,35,6,42
Grasshoppers,7298,6,10,7,15,44,48,-4,37
FC Lugano,7298,7,9,6,17,28,48,-20,33
FC Thun,7298,8,8,6,18,40,60,-20,30
FC Sion,7298,9,7,8,17,39,58,-19,29
Young Boys,7299,1,23,7,2,75,33,42,76
FC Basel,7299,2,17,8,7,55,30,25,59
St Gallen,7299,3,14,3,15,43,55,-12,45
FC Zürich,7299,4,11,9,12,44,38,6,42
Lucerne,7299,5,11,9,12,45,52,-7,42
FC Lugano,7299,6,11,6,15,34,47,-13,39
Grasshoppers,7299,7,9,9,14,40,47,-7,36
FC Thun,7299,8,8,8,16,43,62,-19,32
FC Sion,7299,9,6,9,17,42,57,-15,27
Young Boys,7300,1,21,6,5,72,40,32,69
FC Basel,7300,2,18,9,5,56,25,31,63
Lucerne,7300,3,13,8,11,49,50,-1,47
St Gallen,7300,4,14,5,13,46,56,-10,47
FC Zürich,7300,5,10,10,12,40,38,2,40
FC Thun,7300,6,11,6,15,46,57,-11,39
FC Lugano,7300,7,10,8,14,32,46,-14,38
Grasshoppers,7300,8,8,6,18,40,52,-12,30
FC Sion,7300,9,6,8,18,40,57,-17,26
Young Boys,7301,1,21,7,4,69,35,34,70
FC Basel,7301,2,18,7,7,60,30,30,61
Lucerne,7301,3,14,8,10,43,41,2,50
FC Zürich,7301,4,12,9,11,43,37,6,45
St Gallen,7301,5,14,2,16,42,58,-16,44
FC Thun,7301,6,11,5,16,49,58,-9,38
FC Lugano,7301,7,10,5,17,30,46,-16,35
Grasshoppers,7301,8,8,7,17,36,51,-15,31
FC Sion,7301,9,7,8,17,40,56,-16,29
Young Boys,7302,1,22,7,3,76,40,36,73
FC Basel,7302,2,19,7,6,65,28,37,64
Lucerne,7302,3,11,10,11,40,47,-7,43
St Gallen,7302,4,13,4,15,41,54,-13,43
FC Zürich,7302,5,10,9,13,38,41,-3,39
Grasshoppers,7302,6,10,7,15,42,49,-7,37
FC Lugano,7302,7,10,7,15,33,47,-14,37
FC Thun,7302,8,10,5,17,45,59,-14,35
FC Sion,7302,9,7,8,17,39,54,-15,29
Young Boys,7303,1,22,7,3,70,34,36,73
FC Basel,7303,2,18,9,5,57,25,32,63
Lucerne,7303,3,13,9,10,44,42,2,48
FC Zürich,7303,4,11,9,12,44,41,3,42
St Gallen,7303,5,13,2,17,41,59,-18,41
FC Thun,7303,6,10,7,15,46,57,-11,37
FC Lugano,7303,7,10,6,16,32,49,-17,36
Grasshoppers,7303,8,9,6,17,41,54,-13,33
FC Sion,7303,9,6,9,17,39,53,-14,27
Young Boys,7304,1,23,6,3,76,33,43,75
FC Basel,7304,2,19,8,5,53,23,30,65
Lucerne,7304,3,13,8,11,45,43,2,47
St Gallen,7304,4,14,4,14,45,56,-11,46
FC Zürich,7304,5,10,10,12,41,37,4,40
FC Lugano,7304,6,10,6,16,30,49,-19,36
Grasshoppers,7304,7,9,6,17,41,55,-14,33
FC Thun,7304,8,9,6,17,40,60,-20,33
FC Sion,7304,9,6,8,18,44,59,-15,26
Young Boys,7305,1,23,6,3,77,36,41,75
FC Basel,7305,2,19,7,6,55,25,30,64
St Gallen,7305,3,15,3,14,43,52,-9,48
Lucerne,7305,4,12,8,12,42,48,-6,44
FC Zürich,7305,5,10,10,12,38,36,2,40
Grasshoppers,7305,6,11,7,14,42,47,-5,40
FC Thun,7305,7,9,5,18,41,59,-18,32
FC Lugano,7305,8,9,5,18,30,51,-21,32
FC Sion,7305,9,6,9,17,41,55,-14,27
Young Boys,7306,1,20,9,3,70,35,35,69
FC Basel,7306,2,19,8,5,57,26,31,65
Lucerne,7306,3,13,7,12,45,48,-3,46
St Gallen,7306,4,13,4,15,43,57,-14,43
FC Zürich,7306,5,10,10,12,39,39,0,40
FC Lugano,7306,6,11,7,14,32,45,-13,40
Grasshoppers,7306,7,9,8,15,39,48,-9,35
FC Thun,7306,8,9,7,16,46,58,-12,34
FC Sion,7306,9,5,10,17,38,53,-15,25
Young Boys,7307,1,20,7,5,68,37,31,67
FC Basel,7307,2,19,8,5,55,24,31,65
Lucerne,7307,3,13,10,9,44,41,3,49
St Gallen,7307,4,13,3,16,41,56,-15,42
FC Lugano,7307,5,12,5,15,30,43,-13,41
FC Zürich,7307,6,10,9,13,38,38,0,39
FC Thun,7307,7,10,6,16,46,57,-11,36
FC Sion,7307,8,8,8,16,44,54,-10,32
Grasshoppers,7307,9,8,6,18,37,53,-16,30
Young Boys,7308,1,22,7,3,76,37,39,73
FC Basel,7308,2,19,8,5,57,24,33,65
Lucerne,7308,3,13,8,11,45,47,-2,47
FC Zürich,7308,4,11,10,11,44,37,7,43
St Gallen,7308,5,13,4,15,42,60,-18,43
Grasshoppers,7308,6,10,6,16,43,52,-9,36
FC Lugano,7308,7,10,6,16,33,51,-18,36
FC Sion,7308,8,7,8,17,46,57,-11,29
FC Thun,7308,9,8,5,19,43,64,-21,29
Young Boys,7309,1,22,7,3,71,40,31,73
FC Basel,7309,2,19,7,6,64,25,39,64
FC Zürich,7309,3,11,11,10,42,35,7,44
Lucerne,7309,4,12,8,12,42,46,-4,44
St Gallen,7309,5,13,3,16,39,53,-14,42
FC Lugano,7309,6,11,5,16,30,45,-15,38
Grasshoppers,7309,7,8,9,15,41,52,-11,33
FC Thun,7309,8,8,7,17,42,60,-18,31
FC Sion,7309,9,7,9,16,41,56,-15,30
Young Boys,7310,1,20,7,5,68,39,29,67
FC Basel,7310,2,17,8,7,56,27,29,59
FC Zürich,7310,3,13,9,10,45,34,11,48
Lucerne,7310,4,13,9,10,43,45,-2,48
St Gallen,7310,5,15,3,14,44,53,-9,48
FC Lugano,7310,6,10,7,15,34,48,-14,37
Grasshoppers,7310,7,10,6,16,46,51,-5,36
FC Thun,7310,8,10,5,17,44,63,-19,35
FC Sion,7310,9,5,8,19,40,60,-20,23
Young Boys,7311,1,20,8,4,68,35,33,68
FC Basel,7311,2,17,8,7,58,27,31,59
St Gallen,7311,3,16,3,13,48,54,-6,51
FC Zürich,7311,4,12,10,10,41,34,7,46
Lucerne,7311,5,12,8,12,40,48,-8,44
FC Lugano,7311,6,11,7,14,32,43,-11,40
Grasshoppers,7311,7,9,7,16,38,51,-13,34
FC Thun,7311,8,9,5,18,39,60,-21,32
FC Sion,7311,9,6,8,18,43,55,-12,26
Young Boys,7312,1,23,6,3,75,33,42,75
FC Basel,7312,2,18,8,6,57,26,31,62
St Gallen,7312,3,14,3,15,44,57,-13,45
Lucerne,7312,4,12,8,12,41,45,-4,44
FC Lugano,7312,5,11,6,15,35,51,-16,39
FC Zürich,7312,6,9,10,13,38,42,-4,37
FC Thun,7312,7,9,8,15,45,58,-13,35
Grasshoppers,7312,8,8,8,16,42,53,-11,32
FC Sion,7312,9,8,7,17,41,53,-12,31
Young Boys,7313,1,22,6,4,76,35,41,72
FC Basel,7313,2,17,10,5,52,22,30,61
St Gallen,7313,3,15,3,14,41,53,-12,48
Lucerne,7313,4,12,9,11,42,47,-5,45
FC Zürich,7313,5,11,9,12,43,38,5,42
Grasshoppers,7313,6,10,8,14,42,46,-4,38
FC Thun,7313,7,9,7,16,42,57,-15,34
FC Lugano,7313,8,9,5,18,30,56,-26,32
FC Sion,7313,9,7,7,18,41,55,-14,28
Young Boys,7314,1,20,8,4,69,37,32,68
FC Basel,7314,2,16,9,7,51,26,25,57
St Gallen,7314,3,16,3,13,46,51,-5,51
Lucerne,7314,4,14,8,10,40,40,0,50
FC Zürich,7314,5,10,11,11,41,38,3,41
FC Thun,7314,6,10,7,15,47,57,-10,37
FC Lugano,7314,7,10,7,15,31,46,-15,37
Grasshoppers,7314,8,9,7,16,41,52,-11,34
FC Sion,7314,9,5,8,19,42,61,-19,23
Young Boys,7315,1,21,8,3,74,37,37,71
FC Basel,7315,2,17,8,7,57,26,31,59
St Gallen,7315,3,15,2,15,42,55,-13,47
Lucerne,7315,4,12,8,12,42,47,-5,44
FC Zürich,7315,5,11,9,12,43,42,1,42
FC Thun,7315,6,12,5,15,47,57,-10,41
FC Lugano,7315,7,10,7,15,33,46,-13,37
Grasshoppers,7315,8,10,6,16,42,51,-9,36
FC Sion,7315,9,6,7,19,40,59,-19,25
Young Boys,7316,1,21,7,4,71,38,33,70
FC Basel,7316,2,18,8,6,55,24,31,62
St Gallen,7316,3,14,4,14,43,54,-11,46
FC Zürich,7316,4,12,9,11,41,34,7,45
Lucerne,7316,5,11,9,12,41,45,-4,42
FC Thun,7316,6,11,5,16,43,57,-14,38
FC Lugano,7316,7,10,6,16,28,46,-18,36
Grasshoppers,7316,8,9,7,16,40,49,-9,34
FC Sion,7316,9,7,7,18,41,56,-15,28
Young Boys,7317,1,23,6,3,75,37,38,75
FC Basel,7317,2,16,8,8,47,24,23,56
St Gallen,7317,3,16,2,14,44,51,-7,50
Lucerne,7317,4,12,9,11,38,40,-2,45
FC Thun,7317,5,12,5,15,46,54,-8,41
FC Lugano,7317,6,11,5,16,31,49,-18,38
FC Zürich,7317,7,9,9,14,36,37,-1,36
Grasshoppers,7317,8,9,7,16,40,50,-10,34
FC Sion,7317,9,7,7,18,40,55,-15,28
Young Boys,7318,1,20,8,4,66,34,32,68
FC Basel,7318,2,16,9,7,52,29,23,57
St Gallen,7318,3,16,3,13,49,54,-5,51
Lucerne,7318,4,14,8,10,44,42,2,50
FC Zürich,7318,5,10,10,12,41,40,1,40
Grasshoppers,7318,6,10,6,16,44,51,-7,36
FC Sion,7318,7,9,7,16,45,53,-8,34
FC Lugano,7318,8,9,7,16,28,47,-19,34
FC Thun,7318,9,8,6,18,43,62,-19,30
Young Boys,7319,1,22,7,3,75,34,41,73
FC Basel,7319,2,16,9,7,54,30,24,57
Lucerne,7319,3,14,8,10,46,47,-1,50
FC Zürich,7319,4,12,9,11,44,37,7,45
St Gallen,7319,5,13,4,15,42,56,-14,43
FC Thun,7319,6,11,5,16,44,56,-12,38
FC Lugano,7319,7,9,7,16,33,52,-19,34
Grasshoppers,7319,8,9,6,17,38,49,-11,33
FC Sion,7319,9,7,7,18,41,56,-15,28
Young Boys,7320,1,20,8,4,69,36,33,68
FC Basel,7320,2,16,9,7,51,28,23,57
FC Zürich,7320,3,12,10,10,42,33,9,46
Lucerne,7320,4,13,7,12,42,42,0,46
St Gallen,7320,5,14,2,16,44,58,-14,44
FC Lugano,7320,6,11,6,15,33,47,-14,39
Grasshoppers,7320,7,10,7,15,42,51,-9,37
FC Thun,7320,8,9,8,15,43,57,-14,35
FC Sion,7320,9,7,7,18,44,58,-14,28
Young Boys,7321,1,22,6,4,70,34,36,72
FC Basel,7321,2,18,8,6,51,25,26,62
FC Zürich,7321,3,11,10,11,41,35,6,43
St Gallen,7321,4,13,4,15,41,54,-13,43
Grasshoppers,7321,5,12,6,14,42,44,-2,42
Lucerne,7321,6,11,9,12,38,43,-5,42
FC Lugano,7321,7,10,7,15,29,44,-15,37
FC Thun,7321,8,9,7,16,44,59,-15,34
FC Sion,7321,9,5,9,18,40,58,-18,24
Young Boys,7322,1,23,6,3,78,35,43,75
FC Basel,7322,2,19,7,6,57,28,29,64
Lucerne,7322,3,12,9,11,41,45,-4,45
St Gallen,7322,4,14,2,16,43,55,-12,44
FC Zürich,7322,5,11,9,12,40,38,2,42
FC Lugano,7322,6,10,6,16,29,48,-19,36
FC Thun,7322,7,10,5,17,42,57,-15,35
Grasshoppers,7322,8,9,7,16,42,51,-9,34
FC Sion,7322,9,7,7,18,40,55,-15,28
Young Boys,7323,1,22,7,3,72,34,38,73
FC Basel,7323,2,17,9,6,56,28,28,60
Lucerne,7323,3,14,7,11,45,43,2,49
St Gallen,7323,4,14,2,16,43,58,-15,44
FC Zürich,7323,5,10,12,10,44,38,6,42
Grasshoppers,7323,6,10,6,16,43,51,-8,36
FC Thun,7323,7,9,6,17,42,60,-18,33
FC Lugano,7323,8,9,6,17,30,52,-22,33
FC Sion,7323,9,7,9,16,43,54,-11,30
Young Boys,7324,1,23,6,3,72,33,39,75
FC Basel,7324,2,19,8,5,57,25,32,65
Lucerne,7324,3,13,7,12,43,44,-1,46
St Gallen,7324,4,14,3,15,44,57,-13,45
FC Zürich,7324,5,11,10,11,43,36,7,43
FC Lugano,7324,6,10,5,17,31,52,-21,35
FC Thun,7324,7,9,6,17,44,60,-16,33
Grasshoppers,7324,8,8,8,16,40,52,-12,32
FC Sion,7324,9,6,9,17,39,54,-15,27
Young Boys,7325,1,21,8,3,75,38,37,71
FC Basel,7325,2,19,8,5,57,26,31,65
Lucerne,7325,3,13,9,10,41,41,0,48
St Gallen,7325,4,13,2,17,39,57,-18,41
FC Zürich,7325,5,10,10,12,42,39,3,40
Grasshoppers,7325,6,11,6,15,44,47,-3,39
FC Lugano,7325,7,11,6,15,32,48,-16,39
FC Thun,7325,8,8,6,18,42,63,-21,30
FC Sion,7325,9,7,7,18,43,56,-13,28
Young Boys,7326,1,23,6,3,75,32,43,75
FC Basel,7326,2,16,10,6,53,27,26,58
Lucerne,7326,3,13,9,10,47,45,2,48
FC Zürich,7326,4,11,11,10,40,34,6,44
St Gallen,7326,5,13,4,15,41,56,-15,43
Grasshoppers,7326,6,11,6,15,41,47,-6,39
FC Lugano,7326,7,10,5,17,29,51,-22,35
FC Thun,7326,8,9,6,17,42,57,-15,33
FC Sion,7326,9,6,7,19,40,59,-19,25
Young Boys,7327,1,21,7,4,76,36,40,70
FC Basel,7327,2,20,7,5,58,23,35,67
Lucerne,7327,3,12,9,11,41,44,-3,45
St Gallen,7327,4,14,3,15,43,56,-13,45
FC Zürich,7327,5,11,9,12,42,41,1,42
FC Lugano,7327,6,11,5,16,33,50,-17,38
Grasshoppers,7327,7,9,6,17,41,55,-14,33
FC Sion,7327,8,8,8,16,42,52,-10,32
FC Thun,7327,9,8,6,18,41,60,-19,30
Young Boys,7328,1,23,6,3,69,30,39,75
FC Basel,7328,2,18,7,7,54,25,29,61
Lucerne,7328,3,14,8,10,43,43,0,50
St Gallen,7328,4,14,3,15,46,59,-13,45
FC Zürich,7328,5,10,10,12,39,38,1,40
Grasshoppers,7328,6,10,7,15,41,49,-8,37
FC Thun,7328,7,10,5,17,44,58,-14,35
FC Lugano,7328,8,9,7,16,30,47,-17,34
FC Sion,7328,9,6,7,19,41,58,-17,25
Young Boys,7329,1,22,6,4,72,36,36,72
FC Basel,7329,2,17,7,8,55,29,26,58
St Gallen,7329,3,16,2,14,44,51,-7,50
Lucerne,7329,4,14,7,11,42,43,-1,49
FC Zürich,7329,5,11,11,10,47,39,8,44
Grasshoppers,7329,6,10,6,16,41,49,-8,36
FC Lugano,7329,7,9,5,18,32,53,-21,32
FC Thun,7329,8,8,7,17,42,61,-19,31
FC Sion,7329,9,7,9,16,40,54,-14,30
Young Boys,7330,1,21,9,2,70,34,36,72
FC Basel,7330,2,18,9,5,57,24,33,63
Lucerne,7330,3,13,8,11,42,43,-1,47
St Gallen,7330,4,14,3,15,40,55,-15,45
FC Zürich,7330,5,10,9,13,39,40,-1,39
Grasshoppers,7330,6,10,6,16,42,49,-7,36
FC Lugano,7330,7,9,7,16,30,47,-17,34
FC Thun,7330,8,9,6,17,44,62,-18,33
FC Sion,7330,9,7,9,16,42,52,-10,30
Young Boys,7331,1,22,6,4,70,34,36,72
FC Basel,7331,2,19,7,6,55,24,31,64
Lucerne,7331,3,16,7,9,44,40,4,55
St Gallen,7331,4,14,3,15,43,53,-10,45
FC Zürich,7331,5,11,9,12,40,37,3,42
FC Lugano,7331,6,10,6,16,30,46,-16,36
Grasshoppers,7331,7,8,8,16,40,51,-11,32
FC Thun,7331,8,8,6,18,42,63,-21,30
FC Sion,7331,9,6,8,18,38,54,-16,26
Young Boys,7332,1,20,7,5,71,39,32,67
FC Basel,7332,2,16,10,6,51,26,25,58
St Gallen,7332,3,16,3,13,46,52,-6,51
Lucerne,7332,4,12,8,12,45,51,-6,44
FC Lugano,7332,5,11,5,16,32,50,-18,38
FC Zürich,7332,6,9,10,13,38,38,0,37
Grasshoppers,7332,7,10,6,16,45,54,-9,36
FC Sion,7332,8,9,8,15,49,52,-3,35
FC Thun,7332,9,10,5,17,44,59,-15,35
Young Boys,7333,1,23,6,3,78,34,44,75
FC Basel,7333,2,19,8,5,59,25,34,65
Lucerne,7333,3,13,8,11,41,43,-2,47
St Gallen,7333,4,14,5,13,47,53,-6,47
FC Zürich,7333,5,10,10,12,39,38,1,40
FC Lugano,7333,6,9,7,16,31,50,-19,34
Grasshoppers,7333,7,8,7,17,37,52,-15,31
FC Sion,7333,8,8,7,17,41,58,-17,31
FC Thun,7333,9,8,6,18,41,61,-20,30
Young Boys,7334,1,22,8,2,72,31,41,74
FC Basel,7334,2,18,9,5,50,22,28,63
St Gallen,7334,3,15,2,15,42,52,-10,47
Lucerne,7334,4,12,7,13,38,42,-4,43
FC Zürich,7334,5,9,10,13,38,40,-2,37
Grasshoppers,7334,6,9,8,15,41,49,-8,35
FC Lugano,7334,7,10,5,17,32,51,-19,35
FC Sion,7334,8,8,9,15,45,55,-10,33
FC Thun,7334,9,9,6,17,41,57,-16,33
Young Boys,7335,1,22,8,2,72,33,39,74
FC Basel,7335,2,18,9,5,53,25,28,63
Lucerne,7335,3,12,8,12,42,45,-3,44
St Gallen,7335,4,13,4,15,40,55,-15,43
FC Zürich,7335,5,10,9,13,45,41,4,39
FC Lugano,7335,6,11,5,16,33,48,-15,38
Grasshoppers,7335,7,9,7,16,40,50,-10,34
FC Thun,7335,8,9,7,16,44,58,-14,34
FC Sion,7335,9,7,9,16,43,57,-14,30
Young Boys,7336,1,21,7,4,70,36,34,70
FC Basel,7336,2,18,7,7,53,25,28,61
St Gallen,7336,3,15,2,15,45,57,-12,47
FC Zürich,7336,4,12,9,11,45,38,7,45
Lucerne,7336,5,12,9,11,44,46,-2,45
FC Thun,7336,6,11,5,16,46,58,-12,38
FC Lugano,7336,7,10,5,17,34,52,-18,35
Grasshoppers,7336,8,8,8,16,40,51,-11,32
FC Sion,7336,9,7,8,17,42,56,-14,29
Young Boys,7337,1,23,6,3,72,33,39,75
FC Basel,7337,2,19,8,5,54,23,31,65
Lucerne,7337,3,13,7,12,39,44,-5,46
St Gallen,7337,4,14,4,14,41,51,-10,46
FC Zürich,7337,5,10,9,13,40,38,2,39
Grasshoppers,7337,6,11,6,15,44,49,-5,39
FC Thun,7337,7,10,5,17,45,60,-15,35
FC Lugano,7337,8,9,5,18,27,49,-22,32
FC Sion,7337,9,6,8,18,39,54,-15,26
Young Boys,7338,1,20,8,4,69,37,32,68
FC Basel,7338,2,17,9,6,59,29,30,60
Lucerne,7338,3,14,8,10,42,43,-1,50
St Gallen,7338,4,15,2,15,42,52,-10,47
FC Zürich,7338,5,11,10,11,42,38,4,43
FC Lugano,7338,6,9,7,16,29,47,-18,34
Grasshoppers,7338,7,9,6,17,41,50,-9,33
FC Thun,7338,8,9,6,17,43,60,-17,33
FC Sion,7338,9,8,8,16,42,53,-11,32
Young Boys,7339,1,22,8,2,78,35,43,74
FC Basel,7339,2,15,8,9,48,27,21,53
St Gallen,7339,3,16,3,13,45,52,-7,51
FC Zürich,7339,4,13,9,10,43,34,9,48
Lucerne,7339,5,13,9,10,41,40,1,48
FC Thun,7339,6,10,6,16,47,57,-10,36
FC Lugano,7339,7,9,6,17,29,51,-22,33
Grasshoppers,7339,8,8,8,16,38,51,-13,32
FC Sion,7339,9,6,7,19,39,61,-22,25
Young Boys,7340,1,23,7,2,75,32,43,76
FC Basel,7340,2,18,8,6,53,26,27,62
St Gallen,7340,3,14,4,14,43,52,-9,46
Lucerne,7340,4,12,8,12,40,44,-4,44
FC Zürich,7340,5,10,10,12,40,40,0,40
FC Thun,7340,6,11,5,16,47,57,-10,38
FC Lugano,7340,7,10,6,16,31,49,-18,36
Grasshoppers,7340,8,9,7,16,38,49,-11,34
FC Sion,7340,9,5,9,18,38,56,-18,24
Young Boys,7341,1,21,7,4,71,35,36,70
FC Basel,7341,2,18,7,7,54,28,26,61
Lucerne,7341,3,13,9,10,43,40,3,48
St Gallen,7341,4,15,3,14,43,52,-9,48
FC Zürich,7341,5,11,11,10,41,35,6,44
FC Thun,7341,6,9,7,16,45,61,-16,34
FC Lugano,7341,7,9,7,16,29,50,-21,34
Grasshoppers,7341,8,9,6,17,40,52,-12,33
FC Sion,7341,9,6,9,17,40,53,-13,27
Young Boys,7342,1,20,7,5,70,39,31,67
FC Basel,7342,2,18,9,5,51,22,29,63
Lucerne,7342,3,13,9,10,41,42,-1,48
FC Zürich,7342,4,10,12,10,41,34,7,42
St Gallen,7342,5,13,3,16,42,57,-15,42
FC Lugano,7342,6,11,7,14,32,44,-12,40
Grasshoppers,7342,7,10,7,15,44,49,-5,37
FC Thun,7342,8,8,8,16,41,59,-18,32
FC Sion,7342,9,5,10,17,40,56,-16,25
Young Boys,7343,1,23,6,3,73,33,40,75
FC Basel,7343,2,18,8,6,56,26,30,62
St Gallen,7343,3,15,3,14,45,54,-9,48
Lucerne,7343,4,12,8,12,40,47,-7,44
FC Zürich,7343,5,9,11,12,39,37,2,38
Grasshoppers,7343,6,10,7,15,42,52,-10,37
FC Lugano,7343,7,10,7,15,32,47,-15,37
FC Thun,7343,8,9,6,17,43,59,-16,33
FC Sion,7343,9,6,8,18,41,56,-15,26
Young Boys,7344,1,22,6,4,72,36,36,72
FC Basel,7344,2,17,9,6,55,28,27,60
Lucerne,7344,3,12,9,11,42,44,-2,45
St Gallen,7344,4,14,3,15,47,58,-11,45
FC Zürich,7344,5,9,13,10,41,37,4,40
FC Lugano,7344,6,10,6,16,31,50,-19,36
Grasshoppers,7344,7,9,8,15,39,46,-7,35
FC Thun,7344,8,9,6,17,42,60,-18,33
FC Sion,7344,9,7,10,15,42,52,-10,31
Young Boys,7345,1,22,6,4,74,38,36,72
FC Basel,7345,2,19,8,5,56,25,31,65
St Gallen,7345,3,14,3,15,46,55,-9,45
Lucerne,7345,4,12,7,13,42,48,-6,43
Grasshoppers,7345,5,12,6,14,45,46,-1,42
FC Zürich,7345,6,10,11,11,40,36,4,41
FC Lugano,7345,7,10,6,16,30,51,-21,36
FC Sion,7345,8,7,8,17,38,53,-15,29
FC Thun,7345,9,8,5,19,39,58,-19,29
Young Boys,7346,1,22,8,2,75,35,40,74
FC Basel,7346,2,18,9,5,58,26,32,63
Lucerne,7346,3,13,8,11,43,48,-5,47
FC Zürich,7346,4,11,10,11,42,36,6,43
St Gallen,7346,5,13,2,17,42,59,-17,41
FC Lugano,7346,6,11,5,16,33,49,-16,38
Grasshoppers,7346,7,9,8,15,41,49,-8,35
FC Thun,7346,8,10,5,17,44,58,-14,35
FC Sion,7346,9,6,7,19,41,59,-18,25
Young Boys,7347,1,23,7,2,77,33,44,76
FC Basel,7347,2,18,8,6,55,29,26,62
St Gallen,7347,3,14,3,15,45,59,-14,45
Lucerne,7347,4,12,8,12,43,45,-2,44
FC Lugano,7347,5,11,6,15,32,47,-15,39
FC Zürich,7347,6,9,11,12,36,34,2,38
Grasshoppers,7347,7,10,7,15,39,49,-10,37
FC Thun,7347,8,8,7,17,41,58,-17,31
FC Sion,7347,9,5,11,16,41,55,-14,26
Young Boys,7348,1,22,7,3,72,34,38,73
FC Basel,7348,2,16,10,6,50,26,24,58
Lucerne,7348,3,13,8,11,43,45,-2,47
St Gallen,7348,4,13,3,16,42,58,-16,42
FC Thun,7348,5,11,6,15,46,55,-9,39
FC Lugano,7348,6,11,6,15,35,48,-13,39
FC Zürich,7348,7,9,11,12,37,35,2,38
Grasshoppers,7348,8,10,7,15,42,48,-6,37
FC Sion,7348,9,6,8,18,38,56,-18,26
Young Boys,7349,1,21,6,5,77,42,35,69
FC Basel,7349,2,18,9,5,54,24,30,63
Lucerne,7349,3,13,8,11,40,47,-7,47
St Gallen,7349,4,14,3,15,40,53,-13,45
FC Zürich,7349,5,10,11,11,42,37,5,41
FC Lugano,7349,6,10,6,16,35,51,-16,36
Grasshoppers,7349,7,9,7,16,43,50,-7,34
FC Thun,7349,8,9,7,16,43,57,-14,34
FC Sion,7349,9,7,9,16,41,54,-13,30
Young Boys,7350,1,23,7,2,74,32,42,76
FC Basel,7350,2,16,9,7,50,26,24,57
St Gallen,7350,3,16,2,14,51,56,-5,50
FC Zürich,7350,4,11,11,10,41,34,7,44
Lucerne,7350,5,11,9,12,39,48,-9,42
FC Thun,7350,6,10,5,17,42,59,-17,35
FC Lugano,7350,7,10,5,17,31,49,-18,35
Grasshoppers,7350,8,9,7,16,41,51,-10,34
FC Sion,7350,9,6,9,17,40,54,-14,27
Young Boys,7351,1,21,6,5,70,36,34,69
FC Basel,7351,2,17,9,6,52,24,28,60
St Gallen,7351,3,14,4,14,42,52,-10,46
FC Zürich,7351,4,11,9,12,42,37,5,42
Lucerne,7351,5,11,8,13,41,50,-9,41
FC Lugano,7351,6,12,5,15,35,48,-13,41
Grasshoppers,7351,7,11,6,15,44,49,-5,39
FC Thun,7351,8,11,6,15,46,55,-9,39
FC Sion,7351,9,6,7,19,35,56,-21,25
Young Boys,7352,1,19,9,4,68,36,32,66
FC Basel,7352,2,18,8,6,57,25,32,62
Lucerne,7352,3,13,8,11,44,45,-1,47
FC Zürich,7352,4,12,9,11,49,39,10,45
St Gallen,7352,5,14,3,15,43,56,-13,45
FC Lugano,7352,6,10,6,16,32,51,-19,36
Grasshoppers,7352,7,9,8,15,40,49,-9,35
FC Sion,7352,8,8,8,16,42,52,-10,32
FC Thun,7352,9,9,5,18,41,63,-22,32
Young Boys,7353,1,21,8,3,72,35,37,71
FC Basel,7353,2,17,8,7,54,29,25,59
Lucerne,7353,3,13,7,12,45,47,-2,46
St Gallen,7353,4,14,2,16,44,61,-17,44
FC Zürich,7353,5,10,9,13,41,39,2,39
Grasshoppers,7353,6,11,6,15,43,50,-7,39
FC Lugano,7353,7,11,6,15,36,48,-12,39
FC Thun,7353,8,10,5,17,42,58,-16,35
FC Sion,7353,9,8,7,17,44,54,-10,31
Young Boys,7354,1,21,7,4,72,39,33,70
FC Basel,7354,2,17,9,6,54,25,29,60
Lucerne,7354,3,13,9,10,43,40,3,48
St Gallen,7354,4,15,3,14,42,52,-10,48
FC Zürich,7354,5,11,11,10,40,33,7,44
FC Lugano,7354,6,10,7,15,29,45,-16,37
FC Thun,7354,7,10,5,17,45,59,-14,35
Grasshoppers,7354,8,9,7,16,40,54,-14,34
FC Sion,7354,9,5,8,19,41,59,-18,23
Young Boys,7355,1,20,7,5,70,36,34,67
FC Basel,7355,2,20,7,5,59,26,33,67
Lucerne,7355,3,14,8,10,43,43,0,50
St Gallen,7355,4,13,2,17,40,58,-18,41
FC Zürich,7355,5,10,10,12,46,43,3,40
FC Lugano,7355,6,11,6,15,36,48,-12,39
Grasshoppers,7355,7,9,8,15,41,49,-8,35
FC Thun,7355,8,9,7,16,45,60,-15,34
FC Sion,7355,9,7,7,18,38,55,-17,28
Young Boys,7356,1,21,8,3,69,34,35,71
FC Basel,7356,2,18,8,6,55,25,30,62
Lucerne,7356,3,13,9,10,43,43,0,48
FC Zürich,7356,4,11,11,10,43,34,9,44
St Gallen,7356,5,13,3,16,39,58,-19,42
FC Lugano,7356,6,10,5,17,31,48,-17,35
Grasshoppers,7356,7,9,6,17,40,52,-12,33
FC Thun,7356,8,9,6,17,43,58,-15,33
FC Sion,7356,9,8,8,16,37,48,-11,32
Young Boys,7357,1,23,6,3,79,35,44,75
FC Basel,7357,2,18,7,7,54,31,23,61
Lucerne,7357,3,14,8,10,45,45,0,50
St Gallen,7357,4,14,4,14,45,55,-10,46
FC Zürich,7357,5,11,10,11,41,37,4,43
Grasshoppers,7357,6,9,7,16,39,48,-9,34
FC Thun,7357,7,9,6,17,41,56,-15,33
FC Lugano,7357,8,9,6,17,31,52,-21,33
FC Sion,7357,9,6,8,18,38,54,-16,26
Young Boys,7358,1,23,7,2,77,33,44,76
FC Basel,7358,2,17,9,6,53,26,27,60
St Gallen,7358,3,15,2,15,42,54,-12,47
Lucerne,7358,4,13,7,12,42,48,-6,46
FC Zürich,7358,5,12,9,11,46,37,9,45
Grasshoppers,7358,6,10,7,15,38,45,-7,37
FC Thun,7358,7,9,7,16,40,56,-16,34
FC Lugano,7358,8,9,5,18,29,53,-24,32
FC Sion,7358,9,6,7,19,41,56,-15,25
Young Boys,7359,1,21,7,4,72,37,35,70
FC Basel,7359,2,16,10,6,51,25,26,58
Lucerne,7359,3,16,7,9,53,42,11,55
St Gallen,7359,4,14,3,15,43,59,-16,45
FC Lugano,7359,5,11,5,16,29,46,-17,38
FC Zürich,7359,6,9,10,13,37,37,0,37
FC Thun,7359,7,10,7,15,44,57,-13,37
Grasshoppers,7359,8,9,6,17,42,54,-12,33
FC Sion,7359,9,7,7,18,45,59,-14,28
Young Boys,7360,1,21,8,3,69,35,34,71
FC Basel,7360,2,19,7,6,60,29,31,64
St Gallen,7360,3,15,3,14,46,54,-8,48
Lucerne,7360,4,13,8,11,41,42,-1,47
FC Zürich,7360,5,11,10,11,44,39,5,43
FC Thun,7360,6,10,5,17,44,60,-16,35
FC Lugano,7360,7,9,6,17,29,50,-21,33
Grasshoppers,7360,8,8,7,17,37,48,-11,31
FC Sion,7360,9,6,10,16,41,54,-13,28
Young Boys,7361,1,23,6,3,74,34,40,75
FC Basel,7361,2,17,8,7,57,27,30,59
St Gallen,7361,3,14,3,15,43,55,-12,45
FC Zürich,7361,4,11,11,10,39,33,6,44
Lucerne,7361,5,12,8,12,41,49,-8,44
FC Thun,7361,6,11,5,16,46,57,-11,38
FC Lugano,7361,7,10,7,15,29,44,-15,37
Grasshoppers,7361,8,9,6,17,42,54,-12,33
FC Sion,7361,9,6,8,18,40,58,-18,26
Young Boys,7362,1,20,8,4,68,35,33,68
FC Basel,7362,2,17,9,6,55,24,31,60
St Gallen,7362,3,15,3,14,43,55,-12,48
Lucerne,7362,4,13,7,12,40,45,-5,46
FC Zürich,7362,5,11,10,11,43,36,7,43
FC Lugano,7362,6,12,5,15,36,48,-12,41
Grasshoppers,7362,7,10,7,15,42,49,-7,37
FC Thun,7362,8,10,5,17,45,62,-17,35
FC Sion,7362,9,5,8,19,38,56,-18,23
Young Boys,7363,1,21,8,3,70,34,36,71
FC Basel,7363,2,18,8,6,56,25,31,62
St Gallen,7363,3,15,3,14,46,55,-9,48
FC Zürich,7363,4,10,10,12,42,38,4,40
FC Lugano,7363,5,11,7,14,35,47,-12,40
Lucerne,7363,6,11,7,14,39,52,-13,40
FC Thun,7363,7,11,5,16,45,57,-12,38
Grasshoppers,7363,8,9,7,16,42,51,-9,34
FC Sion,7363,9,6,9,17,40,56,-16,27
Young Boys,7364,1,23,7,2,83,34,49,76
FC Basel,7364,2,18,9,5,58,23,35,63
St Gallen,7364,3,14,3,15,42,56,-14,45
Lucerne,7364,4,11,8,13,37,47,-10,41
FC Lugano,7364,5,11,6,15,33,51,-18,39
FC Zürich,7364,6,9,11,12,40,39,1,38
Grasshoppers,7364,7,9,7,16,42,52,-10,34
FC Thun,7364,8,9,6,17,44,66,-22,33
FC Sion,7364,9,7,9,16,45,56,-11,30
Young Boys,7365,1,22,7,3,74,35,39,73
FC Basel,7365,2,16,9,7,52,28,24,57
St Gallen,7365,3,15,3,14,42,52,-10,48
Lucerne,7365,4,13,8,11,42,45,-3,47
FC Zürich,7365,5,10,10,12,41,38,3,40
FC Thun,7365,6,11,6,15,46,58,-12,39
Grasshoppers,7365,7,9,8,15,43,50,-7,35
FC Lugano,7365,8,9,6,17,31,51,-20,33
FC Sion,7365,9,6,9,17,38,52,-14,27
Young Boys,7366,1,22,7,3,75,35,40,73
FC Basel,7366,2,16,11,5,52,26,26,59
St Gallen,7366,3,14,4,14,42,53,-11,46
Lucerne,7366,4,12,9,11,40,42,-2,45
FC Zürich,7366,5,10,12,10,42,37,5,42
FC Thun,7366,6,10,7,15,46,56,-10,37
FC Lugano,7366,7,10,6,16,30,50,-20,36
Grasshoppers,7366,8,9,7,16,41,51,-10,34
FC Sion,7366,9,6,7,19,41,59,-18,25
Young Boys,7367,1,20,8,4,69,36,33,68
FC Basel,7367,2,17,9,6,55,26,29,60
St Gallen,7367,3,15,3,14,43,56,-13,48
Lucerne,7367,4,13,8,11,45,42,3,47
FC Zürich,7367,5,10,10,12,40,36,4,40
FC Thun,7367,6,11,5,16,43,58,-15,38
FC Lugano,7367,7,11,5,16,31,48,-17,38
Grasshoppers,7367,8,10,6,16,41,49,-8,36
FC Sion,7367,9,6,8,18,40,56,-16,26
Young Boys,7368,1,22,7,3,76,42,34,73
FC Basel,7368,2,18,8,6,54,24,30,62
Lucerne,7368,3,12,9,11,42,44,-2,45
St Gallen,7368,4,14,2,16,42,59,-17,44
FC Lugano,7368,5,11,6,15,35,49,-14,39
FC Thun,7368,6,11,5,16,44,56,-12,38
FC Zürich,7368,7,9,9,14,38,39,-1,36
FC Sion,7368,8,8,8,16,44,51,-7,32
Grasshoppers,7368,9,8,8,16,41,52,-11,32
Young Boys,7369,1,20,7,5,65,36,29,67
FC Basel,7369,2,18,9,5,57,24,33,63
Lucerne,7369,3,15,7,10,44,43,1,52
St Gallen,7369,4,13,4,15,40,57,-17,43
FC Zürich,7369,5,10,10,12,41,38,3,40
FC Lugano,7369,6,11,5,16,33,45,-12,38
Grasshoppers,7369,7,9,8,15,41,48,-7,35
FC Thun,7369,8,10,5,17,45,60,-15,35
FC Sion,7369,9,6,9,17,40,55,-15,27
Young Boys,7370,1,19,7,6,66,46,20,64
FC Basel,7370,2,17,8,7,55,28,27,59
FC Zürich,7370,3,12,10,10,44,35,9,46
Lucerne,7370,4,12,9,11,41,46,-5,45
St Gallen,7370,5,14,3,15,42,54,-12,45
FC Lugano,7370,6,12,5,15,33,43,-10,41
Grasshoppers,7370,7,10,8,14,48,49,-1,38
FC Thun,7370,8,10,6,16,50,63,-13,36
FC Sion,7370,9,6,8,18,43,58,-15,26
Young Boys,7371,1,21,8,3,69,33,36,71
FC Basel,7371,2,18,8,6,55,26,29,62
St Gallen,7371,3,15,4,13,47,55,-8,49
Lucerne,7371,4,11,8,13,40,49,-9,41
FC Lugano,7371,5,11,7,14,34,47,-13,40
FC Zürich,7371,6,9,10,13,41,41,0,37
FC Thun,7371,7,10,6,16,45,58,-13,36
Grasshoppers,7371,8,8,9,15,41,51,-10,33
FC Sion,7371,9,6,10,16,40,52,-12,28
Young Boys,7372,1,20,7,5,71,42,29,67
FC Basel,7372,2,18,7,7,56,25,31,61
Lucerne,7372,3,13,9,10,45,46,-1,48
St Gallen,7372,4,15,2,15,44,53,-9,47
FC Zürich,7372,5,12,10,10,40,33,7,46
Grasshoppers,7372,6,10,6,16,43,50,-7,36
FC Thun,7372,7,9,6,17,42,59,-17,33
FC Lugano,7372,8,9,6,17,30,52,-22,33
FC Sion,7372,9,8,7,17,40,51,-11,31
Young Boys,7373,1,22,6,4,74,36,38,72
FC Basel,7373,2,17,8,7,53,27,26,59
Lucerne,7373,3,13,8,11,43,46,-3,47
St Gallen,7373,4,15,2,15,43,54,-11,47
FC Thun,7373,5,11,6,15,46,56,-10,39
FC Zürich,7373,6,9,11,12,43,41,2,38
Grasshoppers,7373,7,10,7,15,44,51,-7,37
FC Lugano,7373,8,10,6,16,33,51,-18,36
FC Sion,7373,9,6,8,18,41,58,-17,26
Young Boys,7374,1,20,6,6,70,43,27,66
FC Basel,7374,2,17,9,6,55,28,27,60
Lucerne,7374,3,14,9,9,49,44,5,51
St Gallen,7374,4,13,4,15,40,54,-14,43
FC Zürich,7374,5,10,10,12,45,36,9,40
Grasshoppers,7374,6,11,7,14,45,48,-3,40
FC Lugano,7374,7,10,7,15,30,45,-15,37
FC Thun,7374,8,10,5,17,44,61,-17,35
FC Sion,7374,9,7,7,18,41,60,-19,28
Young Boys,7375,1,20,8,4,75,41,34,68
FC Basel,7375,2,16,10,6,52,26,26,58
FC Zürich,7375,3,12,10,10,44,34,10,46
Lucerne,7375,4,12,9,11,42,44,-2,45
St Gallen,7375,5,14,3,15,45,59,-14,45
Grasshoppers,7375,6,11,7,14,44,48,-4,40
FC Lugano,7375,7,10,7,15,33,49,-16,37
FC Thun,7375,8,9,5,18,41,58,-17,32
FC Sion,7375,9,7,7,18,40,57,-17,28
Young Boys,7376,1,20,6,6,67,36,31,66
FC Basel,7376,2,19,7,6,55,26,29,64
Lucerne,7376,3,16,7,9,45,38,7,55
FC Zürich,7376,4,11,9,12,41,38,3,42
St Gallen,7376,5,13,2,17,40,56,-16,41
Grasshoppers,7376,6,11,6,15,43,45,-2,39
FC Lugano,7376,7,11,5,16,34,49,-15,38
FC Thun,7376,8,9,5,18,41,59,-18,32
FC Sion,7376,9,7,7,18,37,56,-19,28
Young Boys,7377,1,22,6,4,70,36,34,72
FC Basel,7377,2,16,10,6,57,30,27,58
Lucerne,7377,3,14,7,11,44,46,-2,49
St Gallen,7377,4,14,4,14,44,54,-10,46
FC Zürich,7377,5,9,12,11,40,37,3,39
FC Lugano,7377,6,10,6,16,32,49,-17,36
FC Sion,7377,7,9,8,15,45,53,-8,35
FC Thun,7377,8,8,8,16,45,61,-16,32
Grasshoppers,7377,9,8,7,17,40,51,-11,31
Young Boys,7378,1,20,8,4,68,34,34,68
FC Basel,7378,2,17,9,6,50,23,27,60
St Gallen,7378,3,17,2,13,45,51,-6,53
Lucerne,7378,4,13,8,11,41,42,-1,47
FC Zürich,7378,5,10,11,11,39,35,4,41
FC Lugano,7378,6,9,7,16,29,48,-19,34
Grasshoppers,7378,7,9,6,17,39,51,-12,33
FC Sion,7378,8,8,8,16,45,51,-6,32
FC Thun,7378,9,9,5,18,43,64,-21,32
Young Boys,7379,1,22,8,2,74,31,43,74
FC Basel,7379,2,18,9,5,54,23,31,63
Lucerne,7379,3,13,7,12,49,49,0,46
St Gallen,7379,4,14,4,14,47,58,-11,46
FC Zürich,7379,5,11,9,12,42,38,4,42
FC Lugano,7379,6,11,6,15,36,49,-13,39
Grasshoppers,7379,7,9,6,17,40,56,-16,33
FC Sion,7379,8,7,8,17,40,55,-15,29
FC Thun,7379,9,8,5,19,39,62,-23,29
Young Boys,7380,1,20,7,5,70,37,33,67
FC Basel,7380,2,18,8,6,56,28,28,62
Lucerne,7380,3,15,7,10,48,41,7,52
St Gallen,7380,4,14,3,15,40,56,-16,45
FC Zürich,7380,5,10,10,12,45,42,3,40
FC Lugano,7380,6,10,7,15,35,51,-16,37
FC Sion,7380,7,9,7,16,45,51,-6,34
FC Thun,7380,8,9,6,17,40,58,-18,33
Grasshoppers,7380,9,8,7,17,37,52,-15,31
Young Boys,7381,1,22,7,3,69,32,37,73
FC Basel,7381,2,18,8,6,57,25,32,62
Lucerne,7381,3,14,8,10,44,43,1,50
St Gallen,7381,4,14,2,16,42,57,-15,44
FC Zürich,7381,5,9,11,12,38,38,0,38
FC Lugano,7381,6,10,7,15,31,46,-15,37
Grasshoppers,7381,7,10,6,16,41,49,-8,36
FC Sion,7381,8,8,7,17,45,53,-8,31
FC Thun,7381,9,8,6,18,40,64,-24,30
Young Boys,7382,1,22,7,3,75,35,40,73
FC Basel,7382,2,18,8,6,55,30,25,62
Lucerne,7382,3,13,9,10,45,43,2,48
St Gallen,7382,4,13,4,15,41,54,-13,43
FC Zürich,7382,5,10,10,12,42,39,3,40
FC Thun,7382,6,10,6,16,49,59,-10,36
Grasshoppers,7382,7,10,6,16,40,51,-11,36
FC Lugano,7382,8,10,6,16,31,50,-19,36
FC Sion,7382,9,6,8,18,37,54,-17,26
Young Boys,7383,1,19,11,2,72,38,34,68
FC Basel,7383,2,18,8,6,55,24,31,62
Lucerne,7383,3,14,9,9,44,41,3,51
St Gallen,7383,4,14,3,15,47,56,-9,45
FC Zürich,7383,5,10,9,13,40,40,0,39
Grasshoppers,7383,6,9,7,16,41,50,-9,34
FC Lugano,7383,7,9,7,16,31,52,-21,34
FC Sion,7383,8,8,9,15,45,52,-7,33
FC Thun,7383,9,9,5,18,42,64,-22,32
Young Boys,7384,1,21,8,3,71,37,34,71
FC Basel,7384,2,17,9,6,55,29,26,60
Lucerne,7384,3,13,7,12,44,45,-1,46
St Gallen,7384,4,14,3,15,44,56,-12,45
FC Zürich,7384,5,10,11,11,40,36,4,41
FC Thun,7384,6,10,6,16,43,56,-13,36
FC Lugano,7384,7,10,6,16,32,48,-16,36
FC Sion,7384,8,9,7,16,44,55,-11,34
Grasshoppers,7384,9,8,7,17,42,53,-11,31
Young Boys,7385,1,22,6,4,74,38,36,72
FC Basel,7385,2,17,8,7,50,25,25,59
Lucerne,7385,3,14,8,10,44,41,3,50
FC Zürich,7385,4,11,10,11,39,35,4,43
St Gallen,7385,5,13,4,15,40,55,-15,43
FC Lugano,7385,6,10,7,15,32,50,-18,37
Grasshoppers,7385,7,9,7,16,41,50,-9,34
FC Sion,7385,8,8,8,16,47,52,-5,32
FC Thun,7385,9,8,6,18,39,60,-21,30
Young Boys,7386,1,21,9,2,72,34,38,72
FC Basel,7386,2,17,8,7,52,27,25,59
Lucerne,7386,3,13,9,10,47,45,2,48
St Gallen,7386,4,14,4,14,45,55,-10,46
FC Zürich,7386,5,9,10,13,37,36,1,37
Grasshoppers,7386,6,10,7,15,42,51,-9,37
FC Lugano,7386,7,9,9,14,29,44,-15,36
FC Thun,7386,8,9,6,17,41,58,-17,33
FC Sion,7386,9,7,8,17,41,56,-15,29
Young Boys,7387,1,24,6,2,79,35,44,78
FC Basel,7387,2,16,8,8,50,27,23,56
Lucerne,7387,3,12,9,11,40,43,-3,45
St Gallen,7387,4,14,3,15,41,53,-12,45
FC Zürich,7387,5,10,10,12,41,39,2,40
Grasshoppers,7387,6,11,6,15,44,50,-6,39
FC Lugano,7387,7,11,5,16,31,47,-16,38
FC Thun,7387,8,9,6,17,41,57,-16,33
FC Sion,7387,9,6,9,17,43,59,-16,27
Young Boys,7388,1,22,6,4,76,36,40,72
FC Basel,7388,2,19,7,6,53,25,28,64
St Gallen,7388,3,15,4,13,44,51,-7,49
Lucerne,7388,4,12,8,12,42,49,-7,44
FC Zürich,7388,5,9,12,11,36,33,3,39
FC Lugano,7388,6,10,8,14,32,46,-14,38
FC Thun,7388,7,9,6,17,42,59,-17,33
Grasshoppers,7388,8,8,7,17,40,51,-11,31
FC Sion,7388,9,6,10,16,40,55,-15,28
Young Boys,7389,1,20,8,4,72,39,33,68
FC Basel,7389,2,18,9,5,55,24,31,63
Lucerne,7389,3,14,7,11,45,45,0,49
St Gallen,7389,4,14,4,14,42,56,-14,46
FC Lugano,7389,5,11,6,15,36,47,-11,39
FC Zürich,7389,6,9,11,12,40,38,2,38
Grasshoppers,7389,7,9,8,15,41,48,-7,35
FC Thun,7389,8,9,6,17,42,61,-19,33
FC Sion,7389,9,6,9,17,39,54,-15,27
FC Basel,7390,1,19,8,5,55,25,30,65
Young Boys,7390,2,19,8,5,70,41,29,65
Lucerne,7390,3,13,9,10,42,41,1,48
St Gallen,7390,4,13,3,16,41,58,-17,42
FC Lugano,7390,5,11,6,15,33,45,-12,39
FC Zürich,7390,6,9,11,12,40,40,0,38
Grasshoppers,7390,7,10,8,14,44,49,-5,38
FC Sion,7390,8,8,9,15,49,57,-8,33
FC Thun,7390,9,8,6,18,46,64,-18,30
Young Boys,7391,1,22,7,3,74,33,41,73
FC Basel,7391,2,19,7,6,53,25,28,64
St Gallen,7391,3,14,3,15,41,52,-11,45
Lucerne,7391,4,12,7,13,38,47,-9,43
FC Lugano,7391,5,12,5,15,33,46,-13,41
FC Zürich,7391,6,10,10,12,40,36,4,40
Grasshoppers,7391,7,9,8,15,41,49,-8,35
FC Thun,7391,8,8,7,17,41,58,-17,31
FC Sion,7391,9,6,10,16,39,54,-15,28
Young Boys,7392,1,21,8,3,71,35,36,71
FC Basel,7392,2,18,9,5,53,23,30,63
St Gallen,7392,3,14,3,15,43,56,-13,45
FC Zürich,7392,4,11,10,11,42,36,6,43
Lucerne,7392,5,11,9,12,42,47,-5,42
FC Lugano,7392,6,12,6,14,32,42,-10,42
Grasshoppers,7392,7,11,6,15,46,52,-6,39
FC Thun,7392,8,8,5,19,42,64,-22,29
FC Sion,7392,9,6,8,18,42,58,-16,26
Young Boys,7393,1,21,7,4,68,33,35,70
FC Basel,7393,2,18,8,6,54,27,27,62
Lucerne,7393,3,12,10,10,44,45,-1,46
St Gallen,7393,4,14,3,15,44,54,-10,45
FC Zürich,7393,5,11,10,11,42,35,7,43
FC Thun,7393,6,11,5,16,45,59,-14,38
Grasshoppers,7393,7,9,8,15,41,49,-8,35
FC Lugano,7393,8,10,5,17,30,48,-18,35
FC Sion,7393,9,6,8,18,36,54,-18,26
Young Boys,7394,1,23,7,2,71,32,39,76
FC Basel,7394,2,19,7,6,54,25,29,64
St Gallen,7394,3,14,3,15,41,54,-13,45
Lucerne,7394,4,12,8,12,41,45,-4,44
FC Lugano,7394,5,11,6,15,32,45,-13,39
FC Zürich,7394,6,9,10,13,40,41,-1,37
Grasshoppers,7394,7,10,6,16,41,49,-8,36
FC Thun,7394,8,9,6,17,45,59,-14,33
FC Sion,7394,9,7,7,18,39,54,-15,28
Young Boys,7395,1,20,6,6,69,36,33,66
FC Basel,7395,2,19,7,6,55,24,31,64
Lucerne,7395,3,12,8,12,40,46,-6,44
St Gallen,7395,4,14,2,16,44,60,-16,44
FC Zürich,7395,5,11,9,12,43,38,5,42
FC Lugano,7395,6,12,5,15,36,48,-12,41
Grasshoppers,7395,7,11,7,14,41,46,-5,40
FC Thun,7395,8,10,5,17,44,60,-16,35
FC Sion,7395,9,7,7,18,42,56,-14,28
Young Boys,7396,1,23,6,3,73,34,39,75
FC Basel,7396,2,19,7,6,55,25,30,64
St Gallen,7396,3,15,3,14,44,55,-11,48
Lucerne,7396,4,12,7,13,40,43,-3,43
FC Zürich,7396,5,10,10,12,41,38,3,40
FC Lugano,7396,6,11,6,15,31,46,-15,39
Grasshoppers,7396,7,10,6,16,42,50,-8,36
FC Thun,7396,8,9,6,17,43,60,-17,33
FC Sion,7396,9,6,7,19,38,56,-18,25
Young Boys,7397,1,21,7,4,69,36,33,70
FC Basel,7397,2,19,7,6,55,25,30,64
Lucerne,7397,3,13,9,10,42,42,0,48
FC Zürich,7397,4,11,11,10,41,35,6,44
St Gallen,7397,5,13,4,15,42,57,-15,43
FC Sion,7397,6,9,8,15,45,51,-6,35
Grasshoppers,7397,7,9,6,17,40,50,-10,33
FC Lugano,7397,8,9,6,17,30,49,-19,33
FC Thun,7397,9,8,6,18,40,59,-19,30
Young Boys,7398,1,19,10,3,65,33,32,67
FC Basel,7398,2,20,7,5,53,21,32,67
Lucerne,7398,3,12,10,10,46,44,2,46
St Gallen,7398,4,13,4,15,42,56,-14,43
FC Zürich,7398,5,10,11,11,40,36,4,41
Grasshoppers,7398,6,9,9,14,39,46,-7,36
FC Lugano,7398,7,9,8,15,30,50,-20,35
FC Sion,7398,8,7,9,16,39,49,-10,30
FC Thun,7398,9,8,6,18,40,59,-19,30
Young Boys,7399,1,21,8,3,70,33,37,71
FC Basel,7399,2,18,9,5,50,21,29,63
Lucerne,7399,3,14,7,11,44,45,-1,49
St Gallen,7399,4,13,2,17,39,58,-19,41
Grasshoppers,7399,5,11,6,15,46,49,-3,39
FC Lugano,7399,6,11,5,16,33,45,-12,38
FC Zürich,7399,7,9,10,13,38,41,-3,37
FC Thun,7399,8,10,6,16,44,59,-15,36
FC Sion,7399,9,6,9,17,40,53,-13,27
Young Boys,7400,1,22,8,2,71,32,39,74
FC Basel,7400,2,17,8,7,55,26,29,59
Lucerne,7400,3,13,8,11,42,44,-2,47
St Gallen,7400,4,15,2,15,44,53,-9,47
FC Zürich,7400,5,10,10,12,39,37,2,40
FC Lugano,7400,6,10,7,15,32,49,-17,37
FC Sion,7400,7,9,7,16,41,49,-8,34
FC Thun,7400,8,9,6,17,40,60,-20,33
Grasshoppers,7400,9,8,6,18,37,51,-14,30
Young Boys,7401,1,24,6,2,82,35,47,78
FC Basel,7401,2,18,8,6,57,25,32,62
St Gallen,7401,3,16,2,14,48,55,-7,50
Lucerne,7401,4,13,7,12,41,51,-10,46
FC Zürich,7401,5,10,10,12,40,38,2,40
FC Thun,7401,6,11,6,15,46,57,-11,39
Grasshoppers,7401,7,9,6,17,43,53,-10,33
FC Lugano,7401,8,9,5,18,30,53,-23,32
FC Sion,7401,9,5,8,19,37,57,-20,23
Young Boys,7402,1,22,8,2,75,34,41,74
FC Basel,7402,2,16,10,6,50,25,25,58
St Gallen,7402,3,15,3,14,43,54,-11,48
Lucerne,7402,4,13,8,11,40,41,-1,47
FC Zürich,7402,5,10,10,12,38,36,2,40
FC Thun,7402,6,10,6,16,46,60,-14,36
Grasshoppers,7402,7,9,7,16,43,54,-11,34
FC Lugano,7402,8,9,6,17,31,50,-19,33
FC Sion,7402,9,7,8,17,43,55,-12,29
Young Boys,7403,1,21,8,3,73,37,36,71
FC Basel,7403,2,17,10,5,57,25,32,61
Lucerne,7403,3,12,11,9,41,40,1,47
FC Zürich,7403,4,12,10,10,45,36,9,46
St Gallen,7403,5,14,3,15,39,54,-15,45
Grasshoppers,7403,6,9,8,15,40,48,-8,35
FC Lugano,7403,7,10,5,17,33,54,-21,35
FC Thun,7403,8,9,7,16,42,57,-15,34
FC Sion,7403,9,5,8,19,38,57,-19,23
Young Boys,7404,1,20,8,4,70,39,31,68
FC Basel,7404,2,18,9,5,56,26,30,63
Lucerne,7404,3,12,10,10,45,44,1,46
FC Zürich,7404,4,11,10,11,41,38,3,43
St Gallen,7404,5,13,3,16,44,60,-16,42
FC Lugano,7404,6,11,5,16,35,48,-13,38
Grasshoppers,7404,7,10,6,16,41,51,-10,36
FC Thun,7404,8,10,5,17,46,59,-13,35
FC Sion,7404,9,7,8,17,44,57,-13,29
Young Boys,7405,1,23,6,3,74,37,37,75
FC Basel,7405,2,17,9,6,55,27,28,60
St Gallen,7405,3,14,3,15,42,55,-13,45
Lucerne,7405,4,12,8,12,39,41,-2,44
FC Zürich,7405,5,11,9,12,40,35,5,42
FC Lugano,7405,6,11,5,16,33,48,-15,38
Grasshoppers,7405,7,10,6,16,40,49,-9,36
FC Sion,7405,8,8,8,16,43,52,-9,32
FC Thun,7405,9,8,6,18,40,62,-22,30
Young Boys,7406,1,22,7,3,77,36,41,73
FC Basel,7406,2,19,8,5,60,26,34,65
Lucerne,7406,3,13,8,11,44,45,-1,47
St Gallen,7406,4,13,4,15,39,53,-14,43
FC Zürich,7406,5,10,10,12,42,39,3,40
FC Lugano,7406,6,10,7,15,33,47,-14,37
FC Thun,7406,7,9,6,17,41,59,-18,33
Grasshoppers,7406,8,8,7,17,38,53,-15,31
FC Sion,7406,9,8,7,17,40,56,-16,31
Young Boys,7407,1,21,8,3,74,39,35,71
FC Basel,7407,2,18,8,6,53,26,27,62
St Gallen,7407,3,15,2,15,44,53,-9,47
Lucerne,7407,4,12,8,12,39,46,-7,44
FC Zürich,7407,5,11,9,12,41,36,5,42
FC Thun,7407,6,11,5,16,44,56,-12,38
Grasshoppers,7407,7,10,7,15,44,48,-4,37
FC Lugano,7407,8,10,5,17,32,49,-17,35
FC Sion,7407,9,6,8,18,39,57,-18,26
Young Boys,7408,1,22,6,4,76,40,36,72
FC Basel,7408,2,18,8,6,59,28,31,62
St Gallen,7408,3,15,4,13,48,55,-7,49
Lucerne,7408,4,13,8,11,45,46,-1,47
FC Zürich,7408,5,11,10,11,41,35,6,43
Grasshoppers,7408,6,10,6,16,42,52,-10,36
FC Thun,7408,7,10,6,16,42,58,-16,36
FC Lugano,7408,8,10,5,17,31,50,-19,35
FC Sion,7408,9,5,7,20,38,58,-20,22
FC Basel,7409,1,19,7,6,57,25,32,64
Young Boys,7409,2,19,6,7,65,38,27,63
Lucerne,7409,3,14,7,11,40,44,-4,49
St Gallen,7409,4,15,2,15,45,56,-11,47
FC Zürich,7409,5,12,9,11,48,37,11,45
Grasshoppers,7409,6,10,7,15,45,49,-4,37
FC Thun,7409,7,10,5,17,44,62,-18,35
FC Lugano,7409,8,10,5,17,30,50,-20,35
FC Sion,7409,9,7,8,17,42,55,-13,29
Young Boys,7410,1,23,6,3,72,35,37,75
FC Basel,7410,2,18,8,6,55,26,29,62
Lucerne,7410,3,12,10,10,39,40,-1,46
St Gallen,7410,4,14,4,14,41,53,-12,46
FC Zürich,7410,5,9,10,13,40,40,0,37
Grasshoppers,7410,6,10,7,15,44,47,-3,37
FC Lugano,7410,7,10,5,17,28,45,-17,35
FC Thun,7410,8,8,7,17,39,58,-19,31
FC Sion,7410,9,7,9,16,41,55,-14,30
Young Boys,7411,1,22,7,3,71,35,36,73
FC Basel,7411,2,17,9,6,54,26,28,60
Lucerne,7411,3,12,9,11,43,44,-1,45
St Gallen,7411,4,13,3,16,43,58,-15,42
FC Zürich,7411,5,10,11,11,42,36,6,41
FC Lugano,7411,6,10,8,14,31,45,-14,38
FC Thun,7411,7,11,5,16,43,59,-16,38
Grasshoppers,7411,8,8,8,16,39,49,-10,32
FC Sion,7411,9,7,8,17,41,55,-14,29
Young Boys,7412,1,20,9,3,70,37,33,69
FC Basel,7412,2,18,8,6,60,31,29,62
Lucerne,7412,3,11,11,10,40,43,-3,44
FC Zürich,7412,4,11,10,11,43,38,5,43
St Gallen,7412,5,13,3,16,44,58,-14,42
Grasshoppers,7412,6,10,7,15,44,49,-5,37
FC Lugano,7412,7,10,7,15,31,47,-16,37
FC Thun,7412,8,9,6,17,45,62,-17,33
FC Sion,7412,9,7,9,16,42,54,-12,30
Young Boys,7413,1,21,8,3,74,42,32,71
FC Basel,7413,2,16,8,8,52,29,23,56
Lucerne,7413,3,13,9,10,44,42,2,48
St Gallen,7413,4,13,5,14,40,54,-14,44
FC Zürich,7413,5,11,9,12,40,36,4,42
FC Lugano,7413,6,11,6,15,35,50,-15,39
Grasshoppers,7413,7,9,7,16,39,49,-10,34
FC Sion,7413,8,8,9,15,44,49,-5,33
FC Thun,7413,9,9,5,18,43,60,-17,32
Young Boys,7414,1,21,7,4,69,35,34,70
FC Basel,7414,2,18,8,6,56,28,28,62
Lucerne,7414,3,13,8,11,45,46,-1,47
FC Zürich,7414,4,11,10,11,43,39,4,43
St Gallen,7414,5,13,2,17,42,63,-21,41
FC Thun,7414,6,11,6,15,48,57,-9,39
Grasshoppers,7414,7,10,7,15,43,51,-8,37
FC Lugano,7414,8,10,6,16,34,47,-13,36
FC Sion,7414,9,6,8,18,42,56,-14,26
Young Boys,7415,1,21,7,4,72,35,37,70
FC Basel,7415,2,19,7,6,58,24,34,64
St Gallen,7415,3,15,3,14,44,53,-9,48
Lucerne,7415,4,13,8,11,42,45,-3,47
FC Zürich,7415,5,10,10,12,39,35,4,40
FC Thun,7415,6,11,5,16,45,60,-15,38
FC Lugano,7415,7,10,7,15,30,48,-18,37
Grasshoppers,7415,8,9,6,17,43,52,-9,33
FC Sion,7415,9,6,7,19,36,57,-21,25
Young Boys,7416,1,21,7,4,68,33,35,70
FC Basel,7416,2,18,7,7,54,26,28,61
Lucerne,7416,3,13,8,11,41,45,-4,47
St Gallen,7416,4,14,3,15,42,55,-13,45
FC Zürich,7416,5,11,10,11,40,35,5,43
FC Thun,7416,6,10,6,16,44,57,-13,36
FC Lugano,7416,7,9,7,16,29,46,-17,34
FC Sion,7416,8,8,8,16,40,49,-9,32
Grasshoppers,7416,9,8,8,16,38,50,-12,32
Young Boys,7417,1,21,6,5,70,37,33,69
FC Basel,7417,2,17,9,6,51,24,27,60
St Gallen,7417,3,15,2,15,41,56,-15,47
Lucerne,7417,4,12,9,11,43,44,-1,45
FC Zürich,7417,5,10,10,12,41,40,1,40
FC Lugano,7417,6,11,6,15,34,47,-13,39
Grasshoppers,7417,7,10,7,15,43,50,-7,37
FC Thun,7417,8,10,7,15,49,57,-8,37
FC Sion,7417,9,6,8,18,39,56,-17,26
Young Boys,7418,1,20,10,2,73,37,36,70
FC Basel,7418,2,19,8,5,56,23,33,65
Lucerne,7418,3,13,9,10,48,41,7,48
St Gallen,7418,4,15,3,14,43,53,-10,48
FC Zürich,7418,5,9,10,13,37,38,-1,37
Grasshoppers,7418,6,10,7,15,41,49,-8,37
FC Lugano,7418,7,10,6,16,32,53,-21,36
FC Thun,7418,8,9,5,18,43,62,-19,32
FC Sion,7418,9,6,8,18,38,55,-17,26
Young Boys,7419,1,23,6,3,69,31,38,75
FC Basel,7419,2,18,7,7,53,26,27,61
Lucerne,7419,3,15,7,10,44,41,3,52
St Gallen,7419,4,15,2,15,45,54,-9,47
FC Zürich,7419,5,10,10,12,38,37,1,40
FC Lugano,7419,6,11,5,16,31,46,-15,38
Grasshoppers,7419,7,9,7,16,40,50,-10,34
FC Thun,7419,8,9,6,17,44,59,-15,33
FC Sion,7419,9,5,8,19,38,58,-20,23
Young Boys,7420,1,20,8,4,71,40,31,68
FC Basel,7420,2,17,8,7,56,30,26,59
St Gallen,7420,3,15,3,14,47,56,-9,48
Lucerne,7420,4,13,8,11,43,45,-2,47
FC Zürich,7420,5,11,10,11,42,34,8,43
FC Lugano,7420,6,10,7,15,30,45,-15,37
FC Thun,7420,7,10,6,16,44,56,-12,36
Grasshoppers,7420,8,8,7,17,38,53,-15,31
FC Sion,7420,9,7,9,16,42,54,-12,30
Young Boys,7421,1,22,7,3,74,36,38,73
FC Basel,7421,2,18,8,6,53,25,28,62
St Gallen,7421,3,15,2,15,42,53,-11,47
Lucerne,7421,4,12,9,11,40,44,-4,45
FC Zürich,7421,5,11,9,12,41,36,5,42
FC Thun,7421,6,11,5,16,47,58,-11,38
FC Lugano,7421,7,10,5,17,29,50,-21,35
Grasshoppers,7421,8,8,9,15,38,47,-9,33
FC Sion,7421,9,6,8,18,42,57,-15,26
Young Boys,7422,1,21,6,5,70,35,35,69
FC Basel,7422,2,18,9,5,55,26,29,63
Lucerne,7422,3,14,7,11,43,42,1,49
St Gallen,7422,4,15,3,14,45,55,-10,48
FC Zürich,7422,5,12,10,10,45,35,10,46
Grasshoppers,7422,6,10,7,15,44,51,-7,37
FC Thun,7422,7,9,6,17,45,62,-17,33
FC Lugano,7422,8,9,5,18,29,50,-21,32
FC Sion,7422,9,5,9,18,39,59,-20,24
Young Boys,7423,1,21,8,3,71,32,39,71
FC Basel,7423,2,17,8,7,53,26,27,59
St Gallen,7423,3,15,3,14,43,54,-11,48
Lucerne,7423,4,13,8,11,44,45,-1,47
FC Zürich,7423,5,11,10,11,44,36,8,43
Grasshoppers,7423,6,10,7,15,39,46,-7,37
FC Lugano,7423,7,10,5,17,32,55,-23,35
FC Sion,7423,8,8,8,16,42,52,-10,32
FC Thun,7423,9,8,5,19,41,63,-22,29
Young Boys,7424,1,20,8,4,72,39,33,68
FC Basel,7424,2,16,9,7,50,26,24,57
St Gallen,7424,3,16,2,14,46,53,-7,50
Lucerne,7424,4,12,9,11,42,45,-3,45
FC Zürich,7424,5,11,10,11,41,37,4,43
FC Lugano,7424,6,11,6,15,34,48,-14,39
Grasshoppers,7424,7,10,6,16,42,51,-9,36
FC Thun,7424,8,9,7,16,44,57,-13,34
FC Sion,7424,9,6,9,17,43,58,-15,27
Young Boys,7425,1,20,10,2,70,34,36,70
FC Basel,7425,2,18,8,6,55,28,27,62
FC Zürich,7425,3,12,10,10,44,34,10,46
St Gallen,7425,4,14,3,15,43,53,-10,45
Lucerne,7425,5,11,9,12,39,45,-6,42
Grasshoppers,7425,6,10,8,14,42,48,-6,38
FC Lugano,7425,7,10,5,17,29,49,-20,35
FC Sion,7425,8,7,9,16,39,50,-11,30
FC Thun,7425,9,8,6,18,42,62,-20,30
Young Boys,7426,1,22,7,3,74,34,40,73
FC Basel,7426,2,18,9,5,55,23,32,63
Lucerne,7426,3,13,8,11,44,44,0,47
St Gallen,7426,4,13,3,16,45,64,-19,42
FC Zürich,7426,5,9,12,11,39,36,3,39
FC Lugano,7426,6,10,6,16,32,51,-19,36
Grasshoppers,7426,7,9,8,15,43,54,-11,35
FC Thun,7426,8,9,7,16,48,58,-10,34
FC Sion,7426,9,7,8,17,47,63,-16,29
Young Boys,7427,1,22,6,4,83,35,48,72
FC Basel,7427,2,18,8,6,56,28,28,62
St Gallen,7427,3,14,5,13,43,53,-10,47
Lucerne,7427,4,13,7,12,40,48,-8,46
FC Zürich,7427,5,11,10,11,45,36,9,43
Grasshoppers,7427,6,11,7,14,44,48,-4,40
FC Lugano,7427,7,9,7,16,28,51,-23,34
FC Thun,7427,8,9,5,18,44,64,-20,32
FC Sion,7427,9,5,9,18,38,58,-20,24
Young Boys,7428,1,22,7,3,73,36,37,73
FC Basel,7428,2,17,8,7,51,25,26,59
St Gallen,7428,3,14,2,16,42,56,-14,44
Lucerne,7428,4,12,7,13,41,43,-2,43
FC Zürich,7428,5,11,9,12,38,34,4,42
FC Lugano,7428,6,12,5,15,34,47,-13,41
FC Thun,7428,7,10,5,17,43,60,-17,35
FC Sion,7428,8,9,7,16,43,51,-8,34
Grasshoppers,7428,9,9,6,17,42,55,-13,33
Young Boys,7429,1,22,6,4,69,34,35,72
FC Basel,7429,2,18,9,5,57,26,31,63
St Gallen,7429,3,14,4,14,48,58,-10,46
FC Zürich,7429,4,11,11,10,42,35,7,44
Lucerne,7429,5,11,8,13,38,47,-9,41
Grasshoppers,7429,6,11,7,14,45,47,-2,40
FC Lugano,7429,7,11,6,15,33,46,-13,39
FC Thun,7429,8,9,5,18,43,61,-18,32
FC Sion,7429,9,5,8,19,37,58,-21,23
Young Boys,7430,1,21,8,3,75,38,37,71
FC Basel,7430,2,18,8,6,59,28,31,62
St Gallen,7430,3,16,2,14,44,52,-8,50
Lucerne,7430,4,13,7,12,47,48,-1,46
FC Zürich,7430,5,10,11,11,39,37,2,41
Grasshoppers,7430,6,10,6,16,43,50,-7,36
FC Thun,7430,7,10,5,17,42,59,-17,35
FC Lugano,7430,8,9,6,17,28,49,-21,33
FC Sion,7430,9,6,9,17,40,56,-16,27
Young Boys,7431,1,22,8,2,75,33,42,74
FC Basel,7431,2,17,10,5,54,23,31,61
St Gallen,7431,3,15,3,14,44,52,-8,48
Lucerne,7431,4,13,8,11,42,42,0,47
FC Zürich,7431,5,9,11,12,37,38,-1,38
FC Lugano,7431,6,10,5,17,30,55,-25,35
Grasshoppers,7431,7,9,7,16,43,53,-10,34
FC Thun,7431,8,9,6,17,44,59,-15,33
FC Sion,7431,9,7,8,17,37,51,-14,29
Young Boys,7432,1,21,6,5,69,36,33,69
FC Basel,7432,2,18,9,5,54,24,30,63
St Gallen,7432,3,15,3,14,44,53,-9,48
Lucerne,7432,4,13,8,11,42,44,-2,47
FC Zürich,7432,5,11,10,11,43,36,7,43
Grasshoppers,7432,6,11,6,15,47,52,-5,39
FC Lugano,7432,7,11,6,15,31,45,-14,39
FC Thun,7432,8,8,6,18,46,65,-19,30
FC Sion,7432,9,5,8,19,38,59,-21,23
Young Boys,7433,1,23,6,3,75,35,40,75
FC Basel,7433,2,17,8,7,52,26,26,59
St Gallen,7433,3,15,2,15,44,54,-10,47
FC Zürich,7433,4,12,9,11,44,37,7,45
Lucerne,7433,5,11,9,12,37,43,-6,42
FC Lugano,7433,6,11,5,16,31,48,-17,38
Grasshoppers,7433,7,9,7,16,40,50,-10,34
FC Thun,7433,8,9,6,17,43,59,-16,33
FC Sion,7433,9,7,8,17,42,56,-14,29
Young Boys,7434,1,22,6,4,69,34,35,72
FC Basel,7434,2,18,7,7,54,26,28,61
Lucerne,7434,3,12,9,11,42,45,-3,45
St Gallen,7434,4,13,4,15,43,56,-13,43
FC Lugano,7434,5,11,7,14,35,47,-12,40
FC Zürich,7434,6,9,10,13,39,42,-3,37
Grasshoppers,7434,7,10,7,15,45,49,-4,37
FC Thun,7434,8,10,5,17,45,60,-15,35
FC Sion,7434,9,7,9,16,41,54,-13,30
Young Boys,7435,1,22,6,4,80,35,45,72
FC Basel,7435,2,18,9,5,53,23,30,63
St Gallen,7435,3,15,2,15,42,53,-11,47
FC Zürich,7435,4,10,11,11,39,34,5,41
Lucerne,7435,5,11,8,13,39,46,-7,41
Grasshoppers,7435,6,11,7,14,45,48,-3,40
FC Lugano,7435,7,11,6,15,30,48,-18,39
FC Thun,7435,8,9,6,17,41,58,-17,33
FC Sion,7435,9,6,7,19,37,61,-24,25
Young Boys,7436,1,20,6,6,71,40,31,66
FC Basel,7436,2,19,7,6,64,27,37,64
Lucerne,7436,3,13,7,12,45,47,-2,46
FC Lugano,7436,4,13,5,14,37,45,-8,44
St Gallen,7436,5,14,2,16,41,62,-21,44
Grasshoppers,7436,6,12,6,14,47,45,2,42
FC Zürich,7436,7,11,9,12,40,38,2,42
FC Thun,7436,8,10,5,17,47,61,-14,35
FC Sion,7436,9,5,7,20,34,61,-27,22
Young Boys,7437,1,22,6,4,71,33,38,72
FC Basel,7437,2,18,8,6,58,27,31,62
Lucerne,7437,3,12,9,11,40,44,-4,45
St Gallen,7437,4,14,3,15,44,58,-14,45
FC Zürich,7437,5,10,11,11,42,35,7,41
Grasshoppers,7437,6,10,7,15,40,47,-7,37
FC Lugano,7437,7,10,6,16,29,47,-18,36
FC Thun,7437,8,9,5,18,43,61,-18,32
FC Sion,7437,9,8,7,17,41,56,-15,31
Young Boys,7438,1,20,8,4,73,39,34,68
FC Basel,7438,2,18,8,6,54,26,28,62
Lucerne,7438,3,12,9,11,43,48,-5,45
St Gallen,7438,4,13,5,14,43,56,-13,44
FC Zürich,7438,5,10,11,11,39,34,5,41
Grasshoppers,7438,6,11,6,15,42,48,-6,39
FC Lugano,7438,7,10,7,15,32,47,-15,37
FC Thun,7438,8,9,6,17,41,57,-16,33
FC Sion,7438,9,6,10,16,41,53,-12,28
Young Boys,7439,1,20,8,4,68,37,31,68
FC Basel,7439,2,17,9,6,57,28,29,60
Lucerne,7439,3,13,9,10,43,43,0,48
St Gallen,7439,4,14,5,13,44,54,-10,47
FC Zürich,7439,5,11,10,11,42,36,6,43
FC Lugano,7439,6,10,7,15,29,44,-15,37
Grasshoppers,7439,7,10,6,16,45,49,-4,36
FC Thun,7439,8,8,6,18,42,68,-26,30
FC Sion,7439,9,7,8,17,48,59,-11,29
Young Boys,7440,1,22,8,2,69,31,38,74
FC Basel,7440,2,18,8,6,56,27,29,62
FC Zürich,7440,3,12,9,11,41,35,6,45
St Gallen,7440,4,14,3,15,47,57,-10,45
Lucerne,7440,5,12,8,12,41,47,-6,44
FC Lugano,7440,6,11,5,16,31,46,-15,38
FC Thun,7440,7,9,5,18,43,61,-18,32
Grasshoppers,7440,8,8,7,17,41,54,-13,31
FC Sion,7440,9,7,9,16,40,51,-11,30
Young Boys,7441,1,20,9,3,72,36,36,69
FC Basel,7441,2,17,8,7,53,27,26,59
Lucerne,7441,3,14,8,10,41,41,0,50
St Gallen,7441,4,13,5,14,44,56,-12,44
FC Thun,7441,5,12,5,15,44,53,-9,41
FC Zürich,7441,6,10,9,13,40,40,0,39
FC Lugano,7441,7,10,7,15,32,46,-14,37
Grasshoppers,7441,8,8,7,17,40,54,-14,31
FC Sion,7441,9,6,10,16,42,55,-13,28
Young Boys,7442,1,22,6,4,73,35,38,72
FC Basel,7442,2,17,8,7,54,29,25,59
St Gallen,7442,3,15,3,14,45,54,-9,48
Lucerne,7442,4,12,9,11,43,48,-5,45
FC Zürich,7442,5,11,10,11,45,40,5,43
Grasshoppers,7442,6,10,7,15,41,49,-8,37
FC Lugano,7442,7,9,8,15,34,50,-16,35
FC Thun,7442,8,9,6,17,45,59,-14,33
FC Sion,7442,9,7,7,18,41,57,-16,28
Young Boys,7443,1,21,7,4,71,38,33,70
FC Basel,7443,2,18,8,6,59,24,35,62
St Gallen,7443,3,14,4,14,42,53,-11,46
Lucerne,7443,4,12,7,13,40,50,-10,43
FC Zürich,7443,5,11,9,12,43,38,5,42
FC Lugano,7443,6,11,6,15,34,46,-12,39
Grasshoppers,7443,7,10,7,15,42,48,-6,37
FC Sion,7443,8,8,8,16,45,54,-9,32
FC Thun,7443,9,8,6,18,40,65,-25,30
Young Boys,7444,1,20,8,4,73,37,36,68
FC Basel,7444,2,19,7,6,56,29,27,64
Lucerne,7444,3,13,8,11,44,45,-1,47
St Gallen,7444,4,15,2,15,43,54,-11,47
FC Zürich,7444,5,11,9,12,45,40,5,42
Grasshoppers,7444,6,9,8,15,43,50,-7,35
FC Thun,7444,7,10,5,17,48,62,-14,35
FC Lugano,7444,8,9,6,17,29,52,-23,33
FC Sion,7444,9,7,9,16,44,56,-12,30
Young Boys,7445,1,22,7,3,73,36,37,73
FC Basel,7445,2,18,7,7,56,29,27,61
Lucerne,7445,3,13,8,11,41,43,-2,47
St Gallen,7445,4,15,2,15,44,54,-10,47
FC Zürich,7445,5,12,10,10,44,34,10,46
Grasshoppers,7445,6,10,8,14,44,49,-5,38
FC Lugano,7445,7,10,5,17,29,49,-20,35
FC Thun,7445,8,9,5,18,45,60,-15,32
FC Sion,7445,9,5,8,19,36,58,-22,23
Young Boys,7446,1,20,8,4,71,37,34,68
FC Basel,7446,2,18,7,7,55,29,26,61
Lucerne,7446,3,13,8,11,41,41,0,47
St Gallen,7446,4,14,2,16,41,55,-14,44
FC Zürich,7446,5,11,10,11,44,37,7,43
FC Lugano,7446,6,11,5,16,32,48,-16,38
Grasshoppers,7446,7,10,7,15,42,50,-8,37
FC Thun,7446,8,10,6,16,45,59,-14,36
FC Sion,7446,9,6,9,17,39,54,-15,27
Young Boys,7447,1,24,6,2,75,33,42,78
FC Basel,7447,2,17,7,8,55,27,28,58
St Gallen,7447,3,15,2,15,42,53,-11,47
FC Zürich,7447,4,12,9,11,42,34,8,45
Lucerne,7447,5,12,8,12,43,49,-6,44
Grasshoppers,7447,6,11,6,15,45,51,-6,39
FC Lugano,7447,7,10,6,16,30,46,-16,36
FC Thun,7447,8,9,5,18,42,62,-20,32
FC Sion,7447,9,6,7,19,41,60,-19,25
Young Boys,7448,1,23,7,2,71,30,41,76
FC Basel,7448,2,16,8,8,52,32,20,56
St Gallen,7448,3,15,4,13,46,53,-7,49
FC Zürich,7448,4,12,9,11,44,35,9,45
Lucerne,7448,5,12,8,12,41,46,-5,44
FC Lugano,7448,6,10,6,16,30,47,-17,36
Grasshoppers,7448,7,9,8,15,40,48,-8,35
FC Thun,7448,8,8,8,16,45,62,-17,32
FC Sion,7448,9,5,10,17,38,54,-16,25
Young Boys,7449,1,21,6,5,73,37,36,69
FC Basel,7449,2,19,8,5,54,22,32,65
Lucerne,7449,3,13,9,10,45,45,0,48
FC Zürich,7449,4,11,9,12,41,38,3,42
St Gallen,7449,5,13,3,16,41,55,-14,42
FC Lugano,7449,6,11,5,16,34,52,-18,38
Grasshoppers,7449,7,10,6,16,40,49,-9,36
FC Thun,7449,8,9,5,18,41,60,-19,32
FC Sion,7449,9,8,7,17,40,51,-11,31
Young Boys,7450,1,20,8,4,73,40,33,68
FC Basel,7450,2,17,8,7,58,28,30,59
Lucerne,7450,3,14,9,9,44,42,2,51
St Gallen,7450,4,13,4,15,41,60,-19,43
FC Zürich,7450,5,11,9,12,40,37,3,42
FC Lugano,7450,6,10,8,14,36,49,-13,38
FC Thun,7450,7,10,6,16,45,56,-11,36
Grasshoppers,7450,8,8,7,17,39,54,-15,31
FC Sion,7450,9,7,9,16,43,53,-10,30
Young Boys,7451,1,22,6,4,70,40,30,72
FC Basel,7451,2,18,7,7,54,25,29,61
St Gallen,7451,3,15,3,14,42,51,-9,48
Lucerne,7451,4,12,8,12,39,45,-6,44
FC Zürich,7451,5,11,10,11,40,34,6,43
FC Lugano,7451,6,10,6,16,28,44,-16,36
FC Thun,7451,7,10,5,17,43,60,-17,35
Grasshoppers,7451,8,9,6,17,40,51,-11,33
FC Sion,7451,9,7,9,16,45,51,-6,30
Young Boys,7452,1,21,8,3,71,35,36,71
FC Basel,7452,2,15,9,8,52,30,22,54
Lucerne,7452,3,15,8,9,44,41,3,53
St Gallen,7452,4,14,4,14,43,54,-11,46
FC Zürich,7452,5,11,9,12,42,37,5,42
Grasshoppers,7452,6,10,7,15,44,48,-4,37
FC Thun,7452,7,10,6,16,43,57,-14,36
FC Lugano,7452,8,9,6,17,28,47,-19,33
FC Sion,7452,9,6,9,17,39,57,-18,27
Young Boys,7453,1,20,7,5,73,38,35,67
FC Basel,7453,2,18,8,6,58,29,29,62
Lucerne,7453,3,13,10,9,45,44,1,49
St Gallen,7453,4,14,3,15,46,58,-12,45
FC Zürich,7453,5,10,9,13,39,37,2,39
FC Lugano,7453,6,11,6,15,32,48,-16,39
FC Thun,7453,7,10,6,16,44,61,-17,36
Grasshoppers,7453,8,9,8,15,42,50,-8,35
FC Sion,7453,9,5,11,16,40,54,-14,26
Young Boys,7454,1,21,8,3,70,34,36,71
FC Basel,7454,2,18,9,5,53,24,29,63
Lucerne,7454,3,13,7,12,43,46,-3,46
St Gallen,7454,4,13,3,16,44,58,-14,42
FC Zürich,7454,5,9,12,11,39,36,3,39
FC Lugano,7454,6,10,7,15,29,44,-15,37
Grasshoppers,7454,7,9,7,16,44,54,-10,34
FC Sion,7454,8,8,9,15,44,53,-9,33
FC Thun,7454,9,9,6,17,44,61,-17,33
Young Boys,7455,1,23,6,3,77,33,44,75
FC Basel,7455,2,16,9,7,48,25,23,57
St Gallen,7455,3,15,3,14,43,53,-10,48
Lucerne,7455,4,12,9,11,40,46,-6,45
FC Zürich,7455,5,11,10,11,43,36,7,43
FC Thun,7455,6,12,5,15,46,54,-8,41
Grasshoppers,7455,7,9,7,16,40,50,-10,34
FC Lugano,7455,8,9,6,17,34,55,-21,33
FC Sion,7455,9,6,7,19,37,56,-19,25
Young Boys,7456,1,20,8,4,72,37,35,68
FC Basel,7456,2,19,8,5,59,24,35,65
Lucerne,7456,3,14,9,9,44,39,5,51
FC Zürich,7456,4,11,10,11,45,38,7,43
St Gallen,7456,5,13,2,17,42,62,-20,41
FC Lugano,7456,6,10,7,15,32,51,-19,37
FC Thun,7456,7,10,5,17,46,61,-15,35
Grasshoppers,7456,8,8,8,16,40,51,-11,32
FC Sion,7456,9,6,9,17,41,58,-17,27
Young Boys,7457,1,22,7,3,76,38,38,73
FC Basel,7457,2,16,10,6,54,29,25,58
St Gallen,7457,3,16,2,14,45,52,-7,50
Lucerne,7457,4,13,8,11,41,42,-1,47
FC Zürich,7457,5,11,10,11,44,36,8,43
FC Lugano,7457,6,11,5,16,30,45,-15,38
FC Thun,7457,7,10,5,17,47,60,-13,35
Grasshoppers,7457,8,9,7,16,43,56,-13,34
FC Sion,7457,9,5,8,19,38,60,-22,23
Young Boys,7458,1,21,6,5,74,41,33,69
FC Basel,7458,2,19,7,6,58,26,32,64
St Gallen,7458,3,15,2,15,46,55,-9,47
Lucerne,7458,4,13,7,12,45,51,-6,46
FC Zürich,7458,5,10,9,13,37,38,-1,39
FC Thun,7458,6,11,6,15,45,55,-10,39
FC Lugano,7458,7,11,5,16,33,50,-17,38
Grasshoppers,7458,8,9,7,16,41,49,-8,34
FC Sion,7458,9,6,9,17,39,53,-14,27
Young Boys,7459,1,21,8,3,74,34,40,71
FC Basel,7459,2,16,11,5,53,26,27,59
Lucerne,7459,3,13,8,11,46,49,-3,47
St Gallen,7459,4,14,3,15,41,53,-12,45
FC Zürich,7459,5,9,12,11,39,37,2,39
Grasshoppers,7459,6,10,7,15,42,49,-7,37
FC Lugano,7459,7,10,6,16,31,49,-18,36
FC Thun,7459,8,9,6,17,44,62,-18,33
FC Sion,7459,9,7,9,16,40,51,-11,30
Young Boys,7460,1,21,9,2,68,32,36,72
FC Basel,7460,2,17,9,6,54,28,26,60
Lucerne,7460,3,15,7,10,49,39,10,52
FC Zürich,7460,4,10,11,11,41,37,4,41
St Gallen,7460,5,13,2,17,40,57,-17,41
FC Thun,7460,6,10,7,15,46,59,-13,37
FC Lugano,7460,7,10,6,16,29,49,-20,36
Grasshoppers,7460,8,9,7,16,42,49,-7,34
FC Sion,7460,9,6,8,18,43,62,-19,26
Young Boys,7461,1,22,7,3,74,34,40,73
FC Basel,7461,2,17,7,8,54,30,24,58
St Gallen,7461,3,16,2,14,47,52,-5,50
Lucerne,7461,4,14,7,11,40,41,-1,49
FC Zürich,7461,5,10,10,12,42,39,3,40
FC Lugano,7461,6,11,5,16,32,48,-16,38
FC Thun,7461,7,9,7,16,43,61,-18,34
FC Sion,7461,8,7,9,16,44,57,-13,30
Grasshoppers,7461,9,8,6,18,38,52,-14,30
Young Boys,7462,1,21,6,5,69,37,32,69
FC Basel,7462,2,18,7,7,52,25,27,61
St Gallen,7462,3,15,2,15,44,55,-11,47
Lucerne,7462,4,12,9,11,40,42,-2,45
FC Thun,7462,5,12,5,15,47,54,-7,41
FC Zürich,7462,6,10,9,13,37,37,0,39
FC Lugano,7462,7,11,6,15,32,45,-13,39
Grasshoppers,7462,8,9,8,15,41,49,-8,35
FC Sion,7462,9,6,8,18,40,58,-18,26
Young Boys,7463,1,22,6,4,73,39,34,72
FC Basel,7463,2,20,7,5,57,24,33,67
St Gallen,7463,3,15,2,15,43,54,-11,47
Lucerne,7463,4,12,7,13,42,46,-4,43
FC Zürich,7463,5,11,9,12,39,35,4,42
Grasshoppers,7463,6,11,6,15,43,48,-5,39
FC Thun,7463,7,11,5,16,45,57,-12,38
FC Lugano,7463,8,9,5,18,29,50,-21,32
FC Sion,7463,9,6,7,19,39,57,-18,25
Young Boys,7464,1,21,7,4,71,35,36,70
FC Basel,7464,2,19,7,6,58,29,29,64
St Gallen,7464,3,14,2,16,41,59,-18,44
FC Zürich,7464,4,10,11,11,40,34,6,41
Lucerne,7464,5,11,8,13,40,45,-5,41
FC Lugano,7464,6,11,6,15,34,45,-11,39
Grasshoppers,7464,7,10,6,16,43,51,-8,36
FC Thun,7464,8,10,6,16,44,59,-15,36
FC Sion,7464,9,8,7,17,40,54,-14,31
Young Boys,7465,1,23,7,2,76,34,42,76
FC Basel,7465,2,17,7,8,52,28,24,58
Lucerne,7465,3,12,9,11,41,40,1,45
St Gallen,7465,4,14,2,16,40,60,-20,44
FC Zürich,7465,5,10,9,13,39,40,-1,39
FC Lugano,7465,6,11,6,15,30,47,-17,39
FC Thun,7465,7,10,6,16,47,60,-13,36
Grasshoppers,7465,8,9,6,17,41,52,-11,33
FC Sion,7465,9,8,8,16,46,51,-5,32
Young Boys,7466,1,20,7,5,71,38,33,67
FC Basel,7466,2,19,7,6,56,27,29,64
St Gallen,7466,3,16,2,14,44,54,-10,50
Lucerne,7466,4,13,8,11,46,47,-1,47
FC Zürich,7466,5,12,9,11,43,34,9,45
FC Thun,7466,6,11,5,16,49,58,-9,38
Grasshoppers,7466,7,9,7,16,44,52,-8,34
FC Lugano,7466,8,9,5,18,30,54,-24,32
FC Sion,7466,9,6,8,18,37,56,-19,26
Young Boys,7467,1,21,8,3,74,33,41,71
FC Basel,7467,2,17,8,7,52,28,24,59
Lucerne,7467,3,14,8,10,43,45,-2,50
St Gallen,7467,4,14,4,14,43,52,-9,46
FC Zürich,7467,5,10,9,13,39,39,0,39
FC Thun,7467,6,11,5,16,45,58,-13,38
FC Lugano,7467,7,10,6,16,28,45,-17,36
Grasshoppers,7467,8,8,8,16,38,49,-11,32
FC Sion,7467,9,7,8,17,39,52,-13,29
Young Boys,7468,1,21,7,4,71,36,35,70
FC Basel,7468,2,18,8,6,61,27,34,62
St Gallen,7468,3,15,2,15,44,55,-11,47
Lucerne,7468,4,13,7,12,39,44,-5,46
FC Zürich,7468,5,10,9,13,39,41,-2,39
FC Thun,7468,6,10,7,15,43,56,-13,37
Grasshoppers,7468,7,9,8,15,38,46,-8,35
FC Lugano,7468,8,10,5,17,35,53,-18,35
FC Sion,7468,9,7,9,16,38,50,-12,30
Young Boys,7469,1,21,7,4,74,36,38,70
FC Basel,7469,2,16,10,6,53,31,22,58
Lucerne,7469,3,12,9,11,40,45,-5,45
St Gallen,7469,4,14,2,16,43,55,-12,44
FC Lugano,7469,5,11,7,14,33,44,-11,40
FC Zürich,7469,6,9,12,11,41,38,3,39
Grasshoppers,7469,7,10,7,15,41,49,-8,37
FC Thun,7469,8,10,6,16,44,59,-15,36
FC Sion,7469,9,7,8,17,40,52,-12,29
Young Boys,7470,1,21,6,5,66,34,32,69
FC Basel,7470,2,19,7,6,55,23,32,64
Lucerne,7470,3,12,9,11,41,44,-3,45
FC Zürich,7470,4,11,9,12,45,37,8,42
St Gallen,7470,5,13,3,16,41,60,-19,42
FC Lugano,7470,6,11,6,15,30,45,-15,39
FC Sion,7470,7,9,8,15,45,52,-7,35
Grasshoppers,7470,8,9,7,16,41,51,-10,34
FC Thun,7470,9,9,5,18,44,62,-18,32
Young Boys,7471,1,22,8,2,75,36,39,74
FC Basel,7471,2,17,8,7,54,29,25,59
Lucerne,7471,3,13,8,11,44,42,2,47
St Gallen,7471,4,15,2,15,43,56,-13,47
FC Lugano,7471,5,11,6,15,31,47,-16,39
Grasshoppers,7471,6,10,8,14,41,47,-6,38
FC Zürich,7471,7,9,10,13,37,37,0,37
FC Thun,7471,8,10,5,17,41,56,-15,35
FC Sion,7471,9,5,9,18,41,57,-16,24
Young Boys,7472,1,19,9,4,66,38,28,66
FC Basel,7472,2,18,8,6,53,25,28,62
FC Zürich,7472,3,12,10,10,47,35,12,46
Lucerne,7472,4,12,9,11,40,43,-3,45
St Gallen,7472,5,13,3,16,41,56,-15,42
FC Lugano,7472,6,12,5,15,35,49,-14,41
Grasshoppers,7472,7,10,6,16,43,48,-5,36
FC Thun,7472,8,8,7,17,43,60,-17,31
FC Sion,7472,9,7,9,16,39,53,-14,30
Young Boys,7473,1,23,7,2,74,32,42,76
FC Basel,7473,2,16,8,8,51,28,23,56
St Gallen,7473,3,15,4,13,44,52,-8,49
FC Zürich,7473,4,12,10,10,47,38,9,46
Lucerne,7473,5,13,7,12,39,43,-4,46
FC Thun,7473,6,10,6,16,49,62,-13,36
FC Lugano,7473,7,9,7,16,29,50,-21,34
Grasshoppers,7473,8,8,6,18,40,54,-14,30
FC Sion,7473,9,6,9,17,47,61,-14,27
Young Boys,7474,1,21,6,5,70,36,34,69
FC Basel,7474,2,18,8,6,53,26,27,62
Lucerne,7474,3,13,8,11,43,44,-1,47
FC Zürich,7474,4,11,10,11,41,36,5,43
St Gallen,7474,5,13,4,15,44,57,-13,43
Grasshoppers,7474,6,10,7,15,43,49,-6,37
FC Lugano,7474,7,10,6,16,34,50,-16,36
FC Thun,7474,8,9,7,16,42,58,-16,34
FC Sion,7474,9,7,8,17,42,56,-14,29
Young Boys,7475,1,23,7,2,73,32,41,76
FC Basel,7475,2,18,8,6,57,25,32,62
FC Zürich,7475,3,12,10,10,43,34,9,46
Lucerne,7475,4,13,7,12,42,45,-3,46
St Gallen,7475,5,14,3,15,42,55,-13,45
Grasshoppers,7475,6,10,6,16,44,49,-5,36
FC Lugano,7475,7,10,6,16,32,49,-17,36
FC Thun,7475,8,8,5,19,41,66,-25,29
FC Sion,7475,9,6,8,18,38,57,-19,26
Young Boys,7476,1,21,9,2,70,34,36,72
FC Basel,7476,2,18,8,6,53,24,29,62
St Gallen,7476,3,14,4,14,46,60,-14,46
Lucerne,7476,4,12,8,12,49,49,0,44
FC Zürich,7476,5,11,10,11,41,34,7,43
Grasshoppers,7476,6,9,9,14,45,52,-7,36
FC Lugano,7476,7,10,6,16,31,50,-19,36
FC Thun,7476,8,9,6,17,45,57,-12,33
FC Sion,7476,9,5,10,17,40,60,-20,25
Young Boys,7477,1,22,6,4,71,36,35,72
FC Basel,7477,2,15,9,8,48,32,16,54
Lucerne,7477,3,15,8,9,47,40,7,53
St Gallen,7477,4,15,2,15,45,55,-10,47
FC Zürich,7477,5,12,9,11,48,39,9,45
FC Thun,7477,6,10,6,16,49,61,-12,36
FC Lugano,7477,7,10,5,17,30,47,-17,35
Grasshoppers,7477,8,9,7,16,46,56,-10,34
FC Sion,7477,9,6,8,18,44,62,-18,26
Young Boys,7478,1,22,6,4,69,32,37,72
FC Basel,7478,2,17,8,7,52,27,25,59
St Gallen,7478,3,15,3,14,44,53,-9,48
FC Zürich,7478,4,12,9,11,43,35,8,45
Lucerne,7478,5,12,7,13,38,45,-7,43
Grasshoppers,7478,6,10,6,16,41,48,-7,36
FC Thun,7478,7,10,6,16,46,60,-14,36
FC Lugano,7478,8,10,6,16,30,49,-19,36
FC Sion,7478,9,7,7,18,39,53,-14,28
Young Boys,7479,1,23,7,2,75,31,44,76
FC Basel,7479,2,17,9,6,50,23,27,60
St Gallen,7479,3,15,2,15,43,53,-10,47
FC Zürich,7479,4,11,10,11,43,39,4,43
Lucerne,7479,5,11,9,12,38,45,-7,42
FC Lugano,7479,6,11,5,16,34,49,-15,38
Grasshoppers,7479,7,9,8,15,42,49,-7,35
FC Thun,7479,8,9,6,17,43,61,-18,33
FC Sion,7479,9,6,8,18,38,56,-18,26
Young Boys,7480,1,22,7,3,75,33,42,73
FC Basel,7480,2,17,10,5,55,27,28,61
St Gallen,7480,3,14,4,14,42,52,-10,46
Lucerne,7480,4,12,8,12,43,49,-6,44
FC Zürich,7480,5,11,9,12,39,38,1,42
FC Thun,7480,6,10,6,16,49,61,-12,36
FC Lugano,7480,7,10,6,16,30,48,-18,36
Grasshoppers,7480,8,9,7,16,41,51,-10,34
FC Sion,7480,9,6,9,17,42,57,-15,27
Young Boys,7481,1,24,6,2,76,35,41,78
FC Basel,7481,2,18,8,6,54,26,28,62
Lucerne,7481,3,13,8,11,44,44,0,47
St Gallen,7481,4,13,4,15,42,56,-14,43
FC Zürich,7481,5,10,11,11,41,35,6,41
FC Lugano,7481,6,11,5,16,34,51,-17,38
FC Thun,7481,7,9,6,17,44,60,-16,33
Grasshoppers,7481,8,8,7,17,40,53,-13,31
FC Sion,7481,9,6,9,17,42,57,-15,27
Young Boys,7482,1,23,6,3,72,36,36,75
FC Basel,7482,2,16,8,8,52,29,23,56
FC Zürich,7482,3,12,9,11,48,39,9,45
Lucerne,7482,4,12,9,11,42,44,-2,45
St Gallen,7482,5,14,3,15,42,54,-12,45
FC Lugano,7482,6,12,5,15,34,45,-11,41
Grasshoppers,7482,7,10,7,15,45,51,-6,37
FC Thun,7482,8,9,5,18,46,63,-17,32
FC Sion,7482,9,6,8,18,40,60,-20,26
Young Boys,7483,1,21,9,2,69,31,38,72
FC Basel,7483,2,16,9,7,50,26,24,57
Lucerne,7483,3,14,7,11,46,44,2,49
St Gallen,7483,4,15,3,14,47,56,-9,48
FC Zürich,7483,5,10,11,11,40,36,4,41
Grasshoppers,7483,6,9,8,15,41,50,-9,35
FC Thun,7483,7,9,8,15,45,59,-14,35
FC Lugano,7483,8,9,7,16,30,50,-20,34
FC Sion,7483,9,6,8,18,42,58,-16,26
Young Boys,7484,1,20,7,5,69,38,31,67
FC Basel,7484,2,17,9,6,56,30,26,60
St Gallen,7484,3,16,3,13,46,54,-8,51
Lucerne,7484,4,13,10,9,45,43,2,49
FC Zürich,7484,5,12,9,11,43,35,8,45
Grasshoppers,7484,6,11,6,15,42,48,-6,39
FC Lugano,7484,7,9,6,17,29,48,-19,33
FC Thun,7484,8,8,5,19,42,61,-19,29
FC Sion,7484,9,7,7,18,40,55,-15,28
Young Boys,7485,1,22,7,3,76,36,40,73
FC Basel,7485,2,18,7,7,58,27,31,61
St Gallen,7485,3,15,2,15,46,55,-9,47
FC Zürich,7485,4,11,11,10,44,35,9,44
Lucerne,7485,5,11,9,12,39,48,-9,42
Grasshoppers,7485,6,9,8,15,41,49,-8,35
FC Lugano,7485,7,9,7,16,29,49,-20,34
FC Thun,7485,8,9,6,17,40,59,-19,33
FC Sion,7485,9,8,7,17,44,59,-15,31
Young Boys,7486,1,21,7,4,74,38,36,70
FC Basel,7486,2,17,9,6,55,26,29,60
St Gallen,7486,3,15,3,14,45,53,-8,48
Lucerne,7486,4,13,8,11,40,43,-3,47
FC Zürich,7486,5,9,11,12,38,38,0,38
Grasshoppers,7486,6,10,6,16,44,51,-7,36
FC Thun,7486,7,10,6,16,43,57,-14,36
FC Lugano,7486,8,10,6,16,32,51,-19,36
FC Sion,7486,9,7,8,17,42,56,-14,29
Young Boys,7487,1,22,8,2,74,33,41,74
FC Basel,7487,2,17,9,6,51,25,26,60
Lucerne,7487,3,13,9,10,44,41,3,48
St Gallen,7487,4,15,2,15,44,57,-13,47
FC Zürich,7487,5,11,10,11,42,36,6,43
Grasshoppers,7487,6,10,7,15,42,50,-8,37
FC Lugano,7487,7,9,6,17,29,50,-21,33
FC Sion,7487,8,7,8,17,42,55,-13,29
FC Thun,7487,9,8,5,19,42,63,-21,29
Young Boys,7488,1,21,7,4,71,34,37,70
FC Basel,7488,2,17,9,6,52,25,27,60
Lucerne,7488,3,13,8,11,42,45,-3,47
St Gallen,7488,4,14,3,15,40,55,-15,45
FC Lugano,7488,5,11,7,14,33,44,-11,40
FC Zürich,7488,6,9,11,12,39,38,1,38
Grasshoppers,7488,7,9,7,16,44,54,-10,34
FC Thun,7488,8,9,6,17,44,62,-18,33
FC Sion,7488,9,8,8,16,44,52,-8,32
Young Boys,7489,1,22,7,3,76,36,40,73
FC Basel,7489,2,19,8,5,56,24,32,65
Lucerne,7489,3,12,9,11,43,47,-4,45
FC Zürich,7489,4,10,12,10,41,36,5,42
St Gallen,7489,5,13,3,16,44,60,-16,42
Grasshoppers,7489,6,9,9,14,46,51,-5,36
FC Thun,7489,7,9,7,16,47,60,-13,34
FC Lugano,7489,8,9,7,16,31,48,-17,34
FC Sion,7489,9,6,8,18,43,65,-22,26
Young Boys,7490,1,23,7,2,73,29,44,76
FC Basel,7490,2,17,7,8,53,30,23,58
St Gallen,7490,3,15,2,15,50,56,-6,47
Lucerne,7490,4,13,7,12,39,47,-8,46
FC Zürich,7490,5,12,9,11,44,37,7,45
Grasshoppers,7490,6,9,8,15,42,49,-7,35
FC Lugano,7490,7,10,5,17,29,48,-19,35
FC Thun,7490,8,9,7,16,46,61,-15,34
FC Sion,7490,9,6,8,18,40,59,-19,26
Young Boys,7491,1,20,8,4,68,36,32,68
FC Basel,7491,2,19,7,6,57,28,29,64
Lucerne,7491,3,13,8,11,42,43,-1,47
FC Zürich,7491,4,12,9,11,43,38,5,45
St Gallen,7491,5,13,3,16,40,55,-15,42
FC Lugano,7491,6,11,7,14,33,43,-10,40
Grasshoppers,7491,7,11,6,15,41,47,-6,39
FC Thun,7491,8,8,5,19,40,60,-20,29
FC Sion,7491,9,7,7,18,41,55,-14,28
Young Boys,7492,1,22,7,3,72,34,38,73
FC Basel,7492,2,17,8,7,57,30,27,59
St Gallen,7492,3,16,3,13,52,52,0,51
FC Zürich,7492,4,11,11,10,43,35,8,44
Lucerne,7492,5,11,8,13,38,51,-13,41
Grasshoppers,7492,6,11,6,15,46,51,-5,39
FC Thun,7492,7,10,5,17,43,62,-19,35
FC Lugano,7492,8,9,6,17,30,49,-19,33
FC Sion,7492,9,5,10,17,38,55,-17,25
Young Boys,7493,1,21,7,4,70,35,35,70
FC Basel,7493,2,15,10,7,52,30,22,55
St Gallen,7493,3,16,3,13,47,52,-5,51
Lucerne,7493,4,13,8,11,40,43,-3,47
FC Zürich,7493,5,9,12,11,44,41,3,39
Grasshoppers,7493,6,10,6,16,43,52,-9,36
FC Thun,7493,7,10,6,16,46,61,-15,36
FC Lugano,7493,8,9,8,15,32,48,-16,35
FC Sion,7493,9,7,8,17,44,56,-12,29
Young Boys,7494,1,24,6,2,71,31,40,78
FC Basel,7494,2,17,9,6,50,23,27,60
St Gallen,7494,3,14,3,15,45,56,-11,45
Lucerne,7494,4,12,8,12,42,46,-4,44
FC Lugano,7494,5,11,5,16,33,49,-16,38
FC Zürich,7494,6,9,9,14,37,37,0,36
Grasshoppers,7494,7,10,6,16,43,50,-7,36
FC Thun,7494,8,10,5,17,43,58,-15,35
FC Sion,7494,9,8,7,17,42,56,-14,31
Young Boys,7495,1,22,7,3,73,33,40,73
FC Basel,7495,2,19,8,5,53,24,29,65
Lucerne,7495,3,13,8,11,41,41,0,47
St Gallen,7495,4,15,2,15,42,54,-12,47
FC Zürich,7495,5,11,10,11,43,37,6,43
FC Lugano,7495,6,10,5,17,33,55,-22,35
Grasshoppers,7495,7,9,7,16,41,49,-8,34
FC Thun,7495,8,9,6,17,41,57,-16,33
FC Sion,7495,9,5,9,18,38,55,-17,24
Young Boys,7496,1,23,6,3,73,34,39,75
FC Basel,7496,2,18,8,6,53,25,28,62
St Gallen,7496,3,14,3,15,42,54,-12,45
FC Zürich,7496,4,11,11,10,45,39,6,44
Lucerne,7496,5,11,9,12,40,45,-5,42
Grasshoppers,7496,6,10,7,15,40,47,-7,37
FC Lugano,7496,7,10,6,16,33,51,-18,36
FC Thun,7496,8,8,7,17,45,64,-19,31
FC Sion,7496,9,7,7,18,43,55,-12,28
FC Basel,7497,1,20,7,5,62,26,36,67
Young Boys,7497,2,20,7,5,69,36,33,67
Lucerne,7497,3,13,9,10,40,39,1,48
St Gallen,7497,4,15,2,15,44,59,-15,47
FC Zürich,7497,5,11,9,12,44,39,5,42
Grasshoppers,7497,6,10,6,16,40,51,-11,36
FC Thun,7497,7,9,6,17,44,59,-15,33
FC Lugano,7497,8,9,6,17,29,48,-19,33
FC Sion,7497,9,7,8,17,40,55,-15,29
Young Boys,7498,1,20,7,5,67,40,27,67
FC Basel,7498,2,19,7,6,57,24,33,64
Lucerne,7498,3,14,8,10,47,43,4,50
St Gallen,7498,4,15,2,15,43,55,-12,47
FC Zürich,7498,5,10,10,12,42,40,2,40
Grasshoppers,7498,6,10,7,15,44,50,-6,37
FC Lugano,7498,7,9,7,16,30,48,-18,34
FC Thun,7498,8,9,6,17,44,60,-16,33
FC Sion,7498,9,7,8,17,41,55,-14,29
Young Boys,7499,1,21,7,4,72,35,37,70
FC Basel,7499,2,19,8,5,64,28,36,65
St Gallen,7499,3,15,4,13,45,54,-9,49
Lucerne,7499,4,13,7,12,43,46,-3,46
FC Zürich,7499,5,11,10,11,42,38,4,43
FC Thun,7499,6,10,5,17,48,64,-16,35
Grasshoppers,7499,7,9,6,17,41,52,-11,33
FC Lugano,7499,8,9,6,17,27,46,-19,33
FC Sion,7499,9,6,9,17,39,58,-19,27
Young Boys,7500,1,21,8,3,71,34,37,71
FC Basel,7500,2,18,9,5,54,26,28,63
Lucerne,7500,3,14,8,10,44,41,3,50
St Gallen,7500,4,14,4,14,45,54,-9,46
FC Zürich,7500,5,10,11,11,42,37,5,41
FC Lugano,7500,6,10,6,16,33,51,-18,36
Grasshoppers,7500,7,9,7,16,39,47,-8,34
FC Thun,7500,8,9,5,18,43,62,-19,32
FC Sion,7500,9,6,8,18,41,60,-19,26
Young Boys,7501,1,19,8,5,69,39,30,65
FC Basel,7501,2,18,8,6,56,28,28,62
Lucerne,7501,3,14,8,10,46,42,4,50
St Gallen,7501,4,16,2,14,48,54,-6,50
FC Zürich,7501,5,12,9,11,45,37,8,45
FC Thun,7501,6,9,6,17,44,62,-18,33
FC Lugano,7501,7,9,6,17,29,48,-19,33
Grasshoppers,7501,8,8,8,16,41,55,-14,32
FC Sion,7501,9,7,9,16,46,59,-13,30
Young Boys,7502,1,21,7,4,69,36,33,70
FC Basel,7502,2,18,7,7,54,25,29,61
St Gallen,7502,3,16,2,14,45,54,-9,50
Lucerne,7502,4,13,7,12,41,44,-3,46
FC Zürich,7502,5,10,10,12,40,38,2,40
FC Thun,7502,6,10,6,16,45,59,-14,36
FC Lugano,7502,7,9,7,16,32,51,-19,34
Grasshoppers,7502,8,9,6,17,41,51,-10,33
FC Sion,7502,9,8,8,16,43,52,-9,32
Young Boys,7503,1,21,6,5,67,35,32,69
FC Basel,7503,2,19,7,6,52,22,30,64
St Gallen,7503,3,17,2,13,45,49,-4,53
Lucerne,7503,4,11,8,13,38,44,-6,41
Grasshoppers,7503,5,10,8,14,43,47,-4,38
FC Lugano,7503,6,11,5,16,30,46,-16,38
FC Zürich,7503,7,9,10,13,40,41,-1,37
FC Thun,7503,8,10,6,16,42,55,-13,36
FC Sion,7503,9,6,8,18,40,58,-18,26
Young Boys,7504,1,22,7,3,73,33,40,73
FC Basel,7504,2,16,10,6,52,27,25,58
St Gallen,7504,3,15,4,13,45,53,-8,49
FC Zürich,7504,4,12,9,11,44,35,9,45
Lucerne,7504,5,11,8,13,43,49,-6,41
FC Thun,7504,6,11,5,16,46,59,-13,38
Grasshoppers,7504,7,10,6,16,43,51,-8,36
FC Lugano,7504,8,10,6,16,33,52,-19,36
FC Sion,7504,9,6,7,19,38,58,-20,25
Young Boys,7505,1,21,7,4,70,34,36,70
FC Basel,7505,2,18,8,6,55,24,31,62
Lucerne,7505,3,12,10,10,39,41,-2,46
St Gallen,7505,4,14,2,16,40,56,-16,44
Grasshoppers,7505,5,12,6,14,43,44,-1,42
FC Zürich,7505,6,9,10,13,41,41,0,37
FC Lugano,7505,7,10,6,16,31,48,-17,36
FC Thun,7505,8,10,5,17,42,60,-18,35
FC Sion,7505,9,7,8,17,44,57,-13,29
Young Boys,7506,1,22,7,3,76,35,41,73
FC Basel,7506,2,17,8,7,50,28,22,59
St Gallen,7506,3,15,3,14,44,54,-10,48
Lucerne,7506,4,12,9,11,42,46,-4,45
FC Zürich,7506,5,10,11,11,41,36,5,41
Grasshoppers,7506,6,10,6,16,42,49,-7,36
FC Thun,7506,7,10,6,16,44,57,-13,36
FC Lugano,7506,8,10,6,16,30,49,-19,36
FC Sion,7506,9,6,8,18,42,57,-15,26
Young Boys,7507,1,21,7,4,76,36,40,70
FC Basel,7507,2,17,8,7,53,26,27,59
St Gallen,7507,3,15,3,14,45,54,-9,48
FC Zürich,7507,4,12,9,11,45,37,8,45
Lucerne,7507,5,12,8,12,39,47,-8,44
FC Lugano,7507,6,11,5,16,34,50,-16,38
FC Thun,7507,7,10,7,15,48,61,-13,37
Grasshoppers,7507,8,8,8,16,40,52,-12,32
FC Sion,7507,9,6,9,17,39,56,-17,27
Young Boys,7508,1,21,6,5,73,38,35,69
FC Basel,7508,2,18,8,6,54,23,31,62
St Gallen,7508,3,15,3,14,49,54,-5,48
FC Zürich,7508,4,12,10,10,41,33,8,46
Lucerne,7508,5,12,7,13,39,47,-8,43
Grasshoppers,7508,6,12,6,14,42,45,-3,42
FC Lugano,7508,7,10,5,17,32,54,-22,35
FC Thun,7508,8,9,6,17,41,59,-18,33
FC Sion,7508,9,6,7,19,40,58,-18,25
Young Boys,7509,1,21,8,3,68,32,36,71
FC Basel,7509,2,18,8,6,54,25,29,62
Lucerne,7509,3,12,10,10,43,46,-3,46
FC Zürich,7509,4,11,9,12,43,42,1,42
St Gallen,7509,5,13,3,16,40,58,-18,42
FC Thun,7509,6,11,5,16,50,61,-11,38
Grasshoppers,7509,7,10,7,15,44,49,-5,37
FC Lugano,7509,8,10,7,15,33,46,-13,37
FC Sion,7509,9,6,7,19,44,60,-16,25
Young Boys,7510,1,23,7,2,80,35,45,76
FC Basel,7510,2,16,8,8,49,29,20,56
Lucerne,7510,3,13,8,11,43,44,-1,47
St Gallen,7510,4,14,4,14,41,51,-10,46
FC Zürich,7510,5,11,11,10,43,34,9,44
Grasshoppers,7510,6,11,6,15,44,52,-8,39
FC Lugano,7510,7,9,7,16,33,50,-17,34
FC Thun,7510,8,9,6,17,44,60,-16,33
FC Sion,7510,9,5,9,18,36,58,-22,24
Young Boys,7511,1,22,7,3,69,32,37,73
FC Basel,7511,2,18,8,6,58,27,31,62
St Gallen,7511,3,14,5,13,45,54,-9,47
Lucerne,7511,4,12,9,11,40,44,-4,45
FC Zürich,7511,5,9,10,13,38,38,0,37
FC Lugano,7511,6,10,6,16,29,46,-17,36
FC Thun,7511,7,10,5,17,43,59,-16,35
Grasshoppers,7511,8,8,8,16,40,51,-11,32
FC Sion,7511,9,7,10,15,42,53,-11,31
Young Boys,7512,1,22,7,3,71,34,37,73
FC Basel,7512,2,19,8,5,59,23,36,65
Lucerne,7512,3,14,8,10,47,43,4,50
St Gallen,7512,4,13,3,16,40,63,-23,42
FC Zürich,7512,5,10,10,12,42,39,3,40
FC Lugano,7512,6,10,7,15,35,50,-15,37
Grasshoppers,7512,7,10,6,16,45,48,-3,36
FC Sion,7512,8,7,8,17,42,59,-17,29
FC Thun,7512,9,8,5,19,42,64,-22,29
Young Boys,7513,1,22,7,3,74,35,39,73
FC Basel,7513,2,17,9,6,56,28,28,60
Lucerne,7513,3,14,8,10,45,41,4,50
St Gallen,7513,4,13,3,16,41,60,-19,42
FC Zürich,7513,5,10,9,13,40,39,1,39
FC Lugano,7513,6,11,5,16,32,48,-16,38
FC Sion,7513,7,10,7,15,47,53,-6,37
Grasshoppers,7513,8,9,6,17,43,55,-12,33
FC Thun,7513,9,8,6,18,45,64,-19,30
Young Boys,7514,1,22,8,2,71,31,40,74
FC Basel,7514,2,18,9,5,56,26,30,63
Lucerne,7514,3,13,8,11,43,46,-3,47
St Gallen,7514,4,15,2,15,45,56,-11,47
FC Zürich,7514,5,11,10,11,41,36,5,43
FC Lugano,7514,6,11,5,16,31,48,-17,38
FC Thun,7514,7,10,5,17,45,60,-15,35
Grasshoppers,7514,8,9,6,17,42,48,-6,33
FC Sion,7514,9,5,7,20,37,60,-23,22
Young Boys,7515,1,20,9,3,71,36,35,69
FC Basel,7515,2,17,10,5,55,26,29,61
Lucerne,7515,3,13,8,11,43,44,-1,47
St Gallen,7515,4,14,3,15,41,54,-13,45
FC Zürich,7515,5,11,10,11,39,35,4,43
FC Lugano,7515,6,11,5,16,30,46,-16,38
Grasshoppers,7515,7,10,7,15,40,46,-6,37
FC Thun,7515,8,8,7,17,41,59,-18,31
FC Sion,7515,9,6,9,17,40,54,-14,27
Young Boys,7516,1,22,7,3,74,36,38,73
FC Basel,7516,2,19,7,6,56,24,32,64
Lucerne,7516,3,13,8,11,46,44,2,47
St Gallen,7516,4,14,3,15,45,58,-13,45
FC Zürich,7516,5,10,9,13,37,40,-3,39
FC Lugano,7516,6,10,6,16,32,49,-17,36
FC Sion,7516,7,9,7,16,43,51,-8,34
Grasshoppers,7516,8,9,6,17,38,54,-16,33
FC Thun,7516,9,9,5,18,43,58,-15,32
Young Boys,7517,1,22,6,4,75,36,39,72
FC Basel,7517,2,19,7,6,55,24,31,64
St Gallen,7517,3,17,2,13,44,51,-7,53
FC Zürich,7517,4,12,9,11,43,36,7,45
Lucerne,7517,5,11,8,13,38,47,-9,41
Grasshoppers,7517,6,10,6,16,43,52,-9,36
FC Lugano,7517,7,10,6,16,31,47,-16,36
FC Thun,7517,8,9,6,17,45,62,-17,33
FC Sion,7517,9,5,8,19,38,57,-19,23
Young Boys,7518,1,21,8,3,75,38,37,71
FC Basel,7518,2,17,9,6,52,26,26,60
St Gallen,7518,3,15,4,13,43,51,-8,49
Lucerne,7518,4,12,9,11,43,46,-3,45
FC Zürich,7518,5,11,10,11,41,35,6,43
Grasshoppers,7518,6,11,6,15,45,47,-2,39
FC Lugano,7518,7,10,7,15,31,45,-14,37
FC Thun,7518,8,9,5,18,43,60,-17,32
FC Sion,7518,9,5,8,19,37,62,-25,23
Young Boys,7519,1,23,7,2,73,32,41,76
FC Basel,7519,2,17,9,6,56,30,26,60
Lucerne,7519,3,14,8,10,44,40,4,50
St Gallen,7519,4,16,2,14,43,53,-10,50
FC Zürich,7519,5,10,9,13,42,41,1,39
Grasshoppers,7519,6,10,6,16,40,49,-9,36
FC Lugano,7519,7,10,5,17,32,48,-16,35
FC Thun,7519,8,9,5,18,45,62,-17,32
FC Sion,7519,9,6,7,19,37,57,-20,25
Young Boys,7520,1,21,7,4,77,36,41,70
FC Basel,7520,2,17,8,7,52,27,25,59
Lucerne,7520,3,14,7,11,43,45,-2,49
FC Zürich,7520,4,12,9,11,42,36,6,45
St Gallen,7520,5,14,3,15,42,55,-13,45
Grasshoppers,7520,6,11,6,15,45,48,-3,39
FC Thun,7520,7,9,6,17,45,61,-16,33
FC Lugano,7520,8,9,6,17,28,53,-25,33
FC Sion,7520,9,7,8,17,43,56,-13,29
Young Boys,7521,1,23,6,3,71,33,38,75
FC Basel,7521,2,18,9,5,55,25,30,63
St Gallen,7521,3,14,2,16,41,56,-15,44
FC Zürich,7521,4,11,10,11,44,36,8,43
Lucerne,7521,5,11,8,13,38,46,-8,41
FC Lugano,7521,6,11,5,16,31,48,-17,38
Grasshoppers,7521,7,9,8,15,41,49,-8,35
FC Thun,7521,8,9,6,17,45,61,-16,33
FC Sion,7521,9,7,8,17,42,54,-12,29
Young Boys,7522,1,21,8,3,71,36,35,71
FC Basel,7522,2,19,7,6,58,23,35,64
St Gallen,7522,3,15,3,14,48,57,-9,48
Lucerne,7522,4,13,8,11,44,47,-3,47
FC Zürich,7522,5,11,10,11,41,38,3,43
FC Lugano,7522,6,10,6,16,34,51,-17,36
FC Thun,7522,7,9,5,18,46,63,-17,32
Grasshoppers,7522,8,8,7,17,40,55,-15,31
FC Sion,7522,9,7,8,17,45,57,-12,29
Young Boys,7523,1,21,7,4,66,32,34,70
FC Basel,7523,2,16,9,7,49,26,23,57
St Gallen,7523,3,15,3,14,41,52,-11,48
Lucerne,7523,4,13,8,11,41,41,0,47
FC Zürich,7523,5,12,9,11,42,34,8,45
FC Lugano,7523,6,10,5,17,30,48,-18,35
FC Sion,7523,7,9,7,16,41,49,-8,34
FC Thun,7523,8,9,6,17,41,58,-17,33
Grasshoppers,7523,9,8,8,16,37,48,-11,32
Young Boys,7524,1,22,6,4,75,36,39,72
FC Basel,7524,2,19,8,5,55,23,32,65
Lucerne,7524,3,14,7,11,42,42,0,49
St Gallen,7524,4,13,2,17,41,61,-20,41
FC Zürich,7524,5,10,10,12,39,36,3,40
FC Lugano,7524,6,11,6,15,31,45,-14,39
FC Thun,7524,7,9,8,15,42,56,-14,35
Grasshoppers,7524,8,8,8,16,44,56,-12,32
FC Sion,7524,9,6,9,17,43,57,-14,27
Young Boys,7525,1,22,6,4,71,34,37,72
FC Basel,7525,2,19,7,6,62,26,36,64
St Gallen,7525,3,15,3,14,46,59,-13,48
FC Zürich,7525,4,11,10,11,42,36,6,43
Lucerne,7525,5,12,7,13,42,48,-6,43
Grasshoppers,7525,6,10,7,15,41,48,-7,37
FC Lugano,7525,7,9,6,17,31,52,-21,33
FC Thun,7525,8,8,7,17,39,60,-21,31
FC Sion,7525,9,7,9,16,41,52,-11,30
Young Boys,7526,1,20,8,4,65,34,31,68
FC Basel,7526,2,16,9,7,52,27,25,57
St Gallen,7526,3,16,3,13,45,52,-7,51
FC Zürich,7526,4,12,10,10,45,35,10,46
Lucerne,7526,5,12,10,10,43,44,-1,46
FC Lugano,7526,6,10,7,15,34,49,-15,37
Grasshoppers,7526,7,9,8,15,40,47,-7,35
FC Thun,7526,8,8,6,18,40,62,-22,30
FC Sion,7526,9,6,9,17,37,51,-14,27
Young Boys,7527,1,20,8,4,72,38,34,68
FC Basel,7527,2,19,7,6,58,28,30,64
Lucerne,7527,3,12,9,11,43,46,-3,45
FC Zürich,7527,4,11,9,12,41,37,4,42
St Gallen,7527,5,13,3,16,43,61,-18,42
FC Lugano,7527,6,11,7,14,34,45,-11,40
FC Thun,7527,7,10,5,17,42,60,-18,35
Grasshoppers,7527,8,9,7,16,43,49,-6,34
FC Sion,7527,9,8,7,17,46,58,-12,31
Young Boys,7528,1,23,6,3,76,32,44,75
FC Basel,7528,2,20,7,5,59,21,38,67
Lucerne,7528,3,14,7,11,43,44,-1,49
St Gallen,7528,4,13,2,17,40,61,-21,41
FC Lugano,7528,5,11,5,16,34,51,-17,38
FC Zürich,7528,6,9,9,14,37,39,-2,36
Grasshoppers,7528,7,9,6,17,38,49,-11,33
FC Thun,7528,8,9,6,17,41,61,-20,33
FC Sion,7528,9,8,8,16,41,51,-10,32
Young Boys,7529,1,21,9,2,70,34,36,72
FC Basel,7529,2,17,8,7,48,24,24,59
Lucerne,7529,3,14,8,10,48,42,6,50
St Gallen,7529,4,14,2,16,42,57,-15,44
FC Zürich,7529,5,10,11,11,37,36,1,41
Grasshoppers,7529,6,9,9,14,44,51,-7,36
FC Lugano,7529,7,9,6,17,29,49,-20,33
FC Thun,7529,8,8,8,16,41,57,-16,32
FC Sion,7529,9,7,9,16,45,54,-9,30
Young Boys,7530,1,20,8,4,67,33,34,68
FC Basel,7530,2,18,8,6,55,23,32,62
FC Zürich,7530,3,12,9,11,44,38,6,45
Lucerne,7530,4,12,8,12,39,44,-5,44
St Gallen,7530,5,14,2,16,40,56,-16,44
Grasshoppers,7530,6,11,7,14,45,45,0,40
FC Lugano,7530,7,10,6,16,33,48,-15,36
FC Thun,7530,8,9,6,17,41,64,-23,33
FC Sion,7530,9,7,8,17,38,51,-13,29
Young Boys,7531,1,22,7,3,72,37,35,73
FC Basel,7531,2,19,7,6,59,27,32,64
Lucerne,7531,3,12,8,12,40,45,-5,44
St Gallen,7531,4,13,3,16,40,55,-15,42
FC Lugano,7531,5,11,7,14,30,43,-13,40
FC Zürich,7531,6,9,11,12,42,40,2,38
FC Thun,7531,7,9,7,16,43,61,-18,34
Grasshoppers,7531,8,9,6,17,42,51,-9,33
FC Sion,7531,9,8,8,16,44,53,-9,32
Young Boys,7532,1,19,8,5,67,38,29,65
FC Basel,7532,2,18,7,7,52,26,26,61
Lucerne,7532,3,15,7,10,45,39,6,52
St Gallen,7532,4,14,3,15,41,54,-13,45
FC Zürich,7532,5,11,11,10,41,34,7,44
Grasshoppers,7532,6,11,6,15,46,48,-2,39
FC Lugano,7532,7,9,8,15,29,49,-20,35
FC Thun,7532,8,9,6,17,41,59,-18,33
FC Sion,7532,9,6,8,18,39,54,-15,26
Young Boys,7533,1,21,6,5,73,39,34,69
FC Basel,7533,2,20,7,5,66,27,39,67
Lucerne,7533,3,12,8,12,40,46,-6,44
FC Zürich,7533,4,11,10,11,41,38,3,43
St Gallen,7533,5,13,4,15,42,57,-15,43
Grasshoppers,7533,6,10,6,16,38,47,-9,36
FC Sion,7533,7,9,7,16,41,49,-8,34
FC Thun,7533,8,9,6,17,42,58,-16,33
FC Lugano,7533,9,9,6,17,30,52,-22,33
Young Boys,7534,1,22,6,4,73,37,36,72
FC Basel,7534,2,17,9,6,53,26,27,60
Lucerne,7534,3,14,8,10,46,42,4,50
St Gallen,7534,4,14,4,14,39,50,-11,46
FC Thun,7534,5,11,6,15,46,57,-11,39
FC Zürich,7534,6,9,11,12,39,37,2,38
FC Lugano,7534,7,10,6,16,29,46,-17,36
Grasshoppers,7534,8,9,7,16,39,51,-12,34
FC Sion,7534,9,5,9,18,38,56,-18,24
Young Boys,7535,1,23,6,3,73,36,37,75
FC Basel,7535,2,16,10,6,53,26,27,58
St Gallen,7535,3,15,3,14,43,55,-12,48
Lucerne,7535,4,12,8,12,44,47,-3,44
FC Zürich,7535,5,10,12,10,41,36,5,42
Grasshoppers,7535,6,10,6,16,43,51,-8,36
FC Lugano,7535,7,10,6,16,33,50,-17,36
FC Thun,7535,8,9,6,17,43,59,-16,33
FC Sion,7535,9,6,9,17,41,54,-13,27
Young Boys,7536,1,21,8,3,73,35,38,71
FC Basel,7536,2,17,8,7,57,29,28,59
St Gallen,7536,3,15,3,14,48,57,-9,48
Lucerne,7536,4,12,9,11,41,46,-5,45
FC Zürich,7536,5,11,10,11,40,37,3,43
Grasshoppers,7536,6,11,7,14,43,48,-5,40
FC Thun,7536,7,10,5,17,45,58,-13,35
FC Lugano,7536,8,9,6,17,32,54,-22,33
FC Sion,7536,9,6,8,18,38,53,-15,26
Young Boys,7537,1,22,7,3,73,34,39,73
FC Basel,7537,2,16,9,7,54,28,26,57
St Gallen,7537,3,15,4,13,44,53,-9,49
Lucerne,7537,4,13,7,12,39,41,-2,46
FC Zürich,7537,5,10,11,11,39,35,4,41
FC Lugano,7537,6,11,6,15,32,47,-15,39
Grasshoppers,7537,7,10,6,16,38,48,-10,36
FC Thun,7537,8,9,6,17,46,60,-14,33
FC Sion,7537,9,6,8,18,41,60,-19,26
Young Boys,7538,1,20,8,4,69,36,33,68
FC Basel,7538,2,17,9,6,52,25,27,60
Lucerne,7538,3,15,7,10,46,43,3,52
FC Zürich,7538,4,12,10,10,42,34,8,46
St Gallen,7538,5,14,3,15,43,55,-12,45
FC Thun,7538,6,10,6,16,49,57,-8,36
FC Lugano,7538,7,10,5,17,30,48,-18,35
Grasshoppers,7538,8,9,7,16,42,55,-13,34
FC Sion,7538,9,5,9,18,39,59,-20,24
Young Boys,7539,1,22,7,3,71,33,38,73
FC Basel,7539,2,18,7,7,55,27,28,61
FC Zürich,7539,3,13,9,10,44,33,11,48
St Gallen,7539,4,15,3,14,42,52,-10,48
Lucerne,7539,5,13,8,11,45,46,-1,47
Grasshoppers,7539,6,10,8,14,43,47,-4,38
FC Lugano,7539,7,9,6,17,30,50,-20,33
FC Thun,7539,8,8,6,18,41,64,-23,30
FC Sion,7539,9,5,8,19,36,55,-19,23
Young Boys,7540,1,22,7,3,71,34,37,73
FC Basel,7540,2,17,8,7,49,26,23,59
St Gallen,7540,3,15,4,13,46,53,-7,49
FC Zürich,7540,4,13,9,10,44,33,11,48
Lucerne,7540,5,11,9,12,41,45,-4,42
FC Thun,7540,6,10,6,16,43,57,-14,36
FC Lugano,7540,7,10,5,17,28,48,-20,35
Grasshoppers,7540,8,8,9,15,39,48,-9,33
FC Sion,7540,9,5,9,18,42,59,-17,24
Young Boys,7541,1,22,7,3,73,34,39,73
FC Basel,7541,2,17,8,7,53,26,27,59
St Gallen,7541,3,14,4,14,44,57,-13,46
Lucerne,7541,4,12,9,11,40,44,-4,45
FC Zürich,7541,5,11,9,12,41,38,3,42
Grasshoppers,7541,6,11,6,15,41,47,-6,39
FC Lugano,7541,7,11,6,15,32,45,-13,39
FC Thun,7541,8,10,5,17,46,58,-12,35
FC Sion,7541,9,5,8,19,40,61,-21,23
Young Boys,7542,1,22,6,4,72,38,34,72
FC Basel,7542,2,19,7,6,58,23,35,64
Lucerne,7542,3,13,7,12,42,44,-2,46
St Gallen,7542,4,14,2,16,41,57,-16,44
FC Zürich,7542,5,10,10,12,38,36,2,40
FC Thun,7542,6,11,5,16,42,54,-12,38
FC Lugano,7542,7,10,6,16,29,49,-20,36
Grasshoppers,7542,8,9,6,17,40,51,-11,33
FC Sion,7542,9,8,7,17,44,54,-10,31
Young Boys,7543,1,21,7,4,72,38,34,70
FC Basel,7543,2,18,9,5,56,25,31,63
Lucerne,7543,3,12,9,11,41,44,-3,45
FC Zürich,7543,4,11,11,10,42,36,6,44
St Gallen,7543,5,13,4,15,42,57,-15,43
Grasshoppers,7543,6,12,6,14,45,45,0,42
FC Lugano,7543,7,9,8,15,31,47,-16,35
FC Thun,7543,8,8,6,18,44,66,-22,30
FC Sion,7543,9,5,10,17,42,57,-15,25
Young Boys,7544,1,23,6,3,74,34,40,75
FC Basel,7544,2,17,9,6,51,25,26,60
Lucerne,7544,3,13,7,12,40,44,-4,46
St Gallen,7544,4,14,4,14,42,51,-9,46
FC Zürich,7544,5,10,10,12,37,35,2,40
FC Lugano,7544,6,10,7,15,30,45,-15,37
Grasshoppers,7544,7,10,6,16,45,50,-5,36
FC Thun,7544,8,9,6,17,41,58,-17,33
FC Sion,7544,9,7,7,18,37,55,-18,28
Young Boys,7545,1,22,6,4,70,34,36,72
FC Basel,7545,2,17,9,6,53,24,29,60
Lucerne,7545,3,11,10,11,39,42,-3,43
Grasshoppers,7545,4,12,6,14,44,47,-3,42
St Gallen,7545,5,13,3,16,39,56,-17,42
FC Lugano,7545,6,11,6,15,35,48,-13,39
FC Zürich,7545,7,9,11,12,40,39,1,38
FC Thun,7545,8,10,5,17,44,62,-18,35
FC Sion,7545,9,7,8,17,41,53,-12,29
Young Boys,7546,1,23,7,2,74,33,41,76
FC Basel,7546,2,17,8,7,54,28,26,59
St Gallen,7546,3,15,3,14,44,53,-9,48
Lucerne,7546,4,12,8,12,38,44,-6,44
FC Zürich,7546,5,11,9,12,44,39,5,42
FC Lugano,7546,6,12,5,15,34,44,-10,41
FC Thun,7546,7,10,6,16,43,58,-15,36
Grasshoppers,7546,8,9,7,16,41,51,-10,34
FC Sion,7546,9,5,7,20,37,59,-22,22
Young Boys,7547,1,22,6,4,72,36,36,72
FC Basel,7547,2,18,7,7,63,29,34,61
St Gallen,7547,3,16,3,13,42,50,-8,51
Lucerne,7547,4,13,8,11,46,45,1,47
FC Zürich,7547,5,11,10,11,44,37,7,43
Grasshoppers,7547,6,10,6,16,41,50,-9,36
FC Lugano,7547,7,10,6,16,32,47,-15,36
FC Thun,7547,8,8,7,17,40,64,-24,31
FC Sion,7547,9,5,9,18,36,58,-22,24
Young Boys,7548,1,22,6,4,70,38,32,72
FC Basel,7548,2,19,8,5,57,22,35,65
Lucerne,7548,3,13,7,12,39,40,-1,46
St Gallen,7548,4,14,2,16,40,56,-16,44
FC Zürich,7548,5,10,11,11,41,37,4,41
Grasshoppers,7548,6,10,7,15,42,48,-6,37
FC Lugano,7548,7,10,6,16,31,49,-18,36
FC Sion,7548,8,8,7,17,42,52,-10,31
FC Thun,7548,9,8,6,18,40,60,-20,30
Young Boys,7549,1,22,7,3,67,32,35,73
FC Basel,7549,2,17,7,8,52,29,23,58
Lucerne,7549,3,13,7,12,41,42,-1,46
St Gallen,7549,4,14,3,15,45,57,-12,45
FC Zürich,7549,5,11,10,11,43,37,6,43
FC Thun,7549,6,12,5,15,48,55,-7,41
Grasshoppers,7549,7,10,7,15,40,49,-9,37
FC Lugano,7549,8,10,5,17,31,50,-19,35
FC Sion,7549,9,5,9,18,36,52,-16,24
Young Boys,7550,1,22,8,2,72,32,40,74
FC Basel,7550,2,19,8,5,54,22,32,65
Lucerne,7550,3,12,9,11,42,44,-2,45
St Gallen,7550,4,13,4,15,40,54,-14,43
FC Zürich,7550,5,9,10,13,40,40,0,37
FC Lugano,7550,6,10,6,16,30,50,-20,36
Grasshoppers,7550,7,9,8,15,41,48,-7,35
FC Thun,7550,8,9,6,17,47,63,-16,33
FC Sion,7550,9,8,7,17,43,56,-13,31
Young Boys,7551,1,21,6,5,70,38,32,69
FC Basel,7551,2,17,9,6,54,27,27,60
Lucerne,7551,3,13,10,9,45,42,3,49
St Gallen,7551,4,14,4,14,41,53,-12,46
FC Zürich,7551,5,11,10,11,40,34,6,43
Grasshoppers,7551,6,10,8,14,43,48,-5,38
FC Lugano,7551,7,10,6,16,29,46,-17,36
FC Thun,7551,8,9,6,17,41,57,-16,33
FC Sion,7551,9,6,7,19,40,58,-18,25
Young Boys,7552,1,20,7,5,70,39,31,67
FC Basel,7552,2,19,8,5,58,23,35,65
Lucerne,7552,3,14,8,10,42,41,1,50
FC Zürich,7552,4,11,11,10,46,37,9,44
St Gallen,7552,5,13,3,16,43,59,-16,42
FC Lugano,7552,6,10,6,16,32,49,-17,36
FC Thun,7552,7,10,5,17,43,62,-19,35
Grasshoppers,7552,8,9,7,16,40,49,-9,34
FC Sion,7552,9,6,9,17,43,58,-15,27
Young Boys,7553,1,21,8,3,70,33,37,71
FC Basel,7553,2,17,9,6,53,27,26,60
Lucerne,7553,3,13,9,10,44,42,2,48
St Gallen,7553,4,15,3,14,44,54,-10,48
FC Zürich,7553,5,12,10,10,41,33,8,46
Grasshoppers,7553,6,9,8,15,42,48,-6,35
FC Thun,7553,7,9,5,18,42,60,-18,32
FC Lugano,7553,8,9,5,18,29,52,-23,32
FC Sion,7553,9,6,9,17,41,57,-16,27
Young Boys,7554,1,22,8,2,74,35,39,74
FC Basel,7554,2,16,9,7,56,32,24,57
Lucerne,7554,3,13,9,10,45,44,1,48
St Gallen,7554,4,15,2,15,44,54,-10,47
FC Zürich,7554,5,12,9,11,43,37,6,45
FC Lugano,7554,6,11,6,15,32,45,-13,39
FC Thun,7554,7,9,6,17,44,60,-16,33
Grasshoppers,7554,8,8,7,17,41,56,-15,31
FC Sion,7554,9,6,8,18,40,56,-16,26
Young Boys,7555,1,22,7,3,79,36,43,73
FC Basel,7555,2,19,7,6,52,25,27,64
St Gallen,7555,3,15,3,14,43,51,-8,48
Lucerne,7555,4,11,8,13,39,46,-7,41
Grasshoppers,7555,5,11,7,14,48,49,-1,40
FC Zürich,7555,6,9,11,12,39,37,2,38
FC Thun,7555,7,10,5,17,44,64,-20,35
FC Lugano,7555,8,9,8,15,29,49,-20,35
FC Sion,7555,9,6,8,18,42,58,-16,26
Young Boys,7556,1,23,6,3,76,35,41,75
FC Basel,7556,2,18,7,7,55,31,24,61
Lucerne,7556,3,13,8,11,46,42,4,47
St Gallen,7556,4,15,2,15,41,56,-15,47
FC Zürich,7556,5,11,10,11,46,39,7,43
FC Lugano,7556,6,11,6,15,33,48,-15,39
Grasshoppers,7556,7,9,6,17,43,55,-12,33
FC Thun,7556,8,9,5,18,42,63,-21,32
FC Sion,7556,9,6,8,18,44,57,-13,26
Young Boys,7557,1,21,6,5,69,41,28,69
FC Basel,7557,2,18,7,7,51,23,28,61
Lucerne,7557,3,14,8,10,45,42,3,50
St Gallen,7557,4,14,3,15,41,55,-14,45
FC Zürich,7557,5,11,9,12,42,34,8,42
FC Lugano,7557,6,10,6,16,30,46,-16,36
Grasshoppers,7557,7,9,8,15,40,48,-8,35
FC Sion,7557,8,8,8,16,43,52,-9,32
FC Thun,7557,9,9,5,18,40,60,-20,32
Young Boys,7558,1,21,8,3,72,34,38,71
FC Basel,7558,2,17,8,7,55,28,27,59
St Gallen,7558,3,15,2,15,43,53,-10,47
Lucerne,7558,4,12,8,12,43,46,-3,44
FC Zürich,7558,5,11,10,11,40,36,4,43
Grasshoppers,7558,6,11,7,14,41,46,-5,40
FC Lugano,7558,7,11,5,16,32,48,-16,38
FC Thun,7558,8,9,6,17,41,60,-19,33
FC Sion,7558,9,6,8,18,37,53,-16,26
Young Boys,7559,1,21,8,3,73,37,36,71
FC Basel,7559,2,19,8,5,61,24,37,65
Lucerne,7559,3,13,8,11,41,44,-3,47
St Gallen,7559,4,15,2,15,44,58,-14,47
FC Zürich,7559,5,11,9,12,42,40,2,42
FC Thun,7559,6,11,5,16,49,59,-10,38
Grasshoppers,7559,7,9,7,16,40,51,-11,34
FC Lugano,7559,8,9,7,16,30,47,-17,34
FC Sion,7559,9,5,8,19,40,60,-20,23
Young Boys,7560,1,23,6,3,77,38,39,75
FC Basel,7560,2,17,10,5,53,24,29,61
St Gallen,7560,3,14,3,15,42,58,-16,45
Lucerne,7560,4,12,8,12,43,43,0,44
FC Zürich,7560,5,10,9,13,43,41,2,39
FC Lugano,7560,6,11,5,16,34,48,-14,38
Grasshoppers,7560,7,10,7,15,40,47,-7,37
FC Thun,7560,8,9,7,16,43,57,-14,34
FC Sion,7560,9,7,7,18,43,62,-19,28
Young Boys,7561,1,22,7,3,75,36,39,73
FC Basel,7561,2,18,9,5,58,27,31,63
St Gallen,7561,3,14,2,16,43,58,-15,44
FC Zürich,7561,4,11,10,11,42,34,8,43
FC Lugano,7561,5,12,6,14,31,43,-12,42
Lucerne,7561,6,11,8,13,41,50,-9,41
FC Thun,7561,7,10,5,17,44,60,-16,35
Grasshoppers,7561,8,9,6,17,44,54,-10,33
FC Sion,7561,9,7,7,18,40,56,-16,28
Young Boys,7562,1,22,7,3,72,35,37,73
FC Basel,7562,2,17,8,7,52,27,25,59
Lucerne,7562,3,14,8,10,43,42,1,50
St Gallen,7562,4,16,2,14,45,53,-8,50
FC Zürich,7562,5,11,11,10,41,34,7,44
Grasshoppers,7562,6,9,7,16,40,48,-8,34
FC Thun,7562,7,9,5,18,42,59,-17,32
FC Lugano,7562,8,9,5,18,27,49,-22,32
FC Sion,7562,9,6,9,17,41,56,-15,27
Young Boys,7563,1,22,7,3,75,34,41,73
FC Basel,7563,2,17,8,7,54,28,26,59
Lucerne,7563,3,13,8,11,42,45,-3,47
FC Zürich,7563,4,11,11,10,47,35,12,44
St Gallen,7563,5,13,3,16,44,60,-16,42
Grasshoppers,7563,6,11,6,15,44,49,-5,39
FC Thun,7563,7,10,6,16,46,57,-11,36
FC Lugano,7563,8,10,6,16,33,55,-22,36
FC Sion,7563,9,6,7,19,37,59,-22,25
Young Boys,7564,1,22,6,4,76,36,40,72
FC Basel,7564,2,20,7,5,51,21,30,67
Lucerne,7564,3,14,7,11,45,45,0,49
St Gallen,7564,4,14,3,15,44,53,-9,45
Grasshoppers,7564,5,11,6,15,44,49,-5,39
FC Zürich,7564,6,9,10,13,38,38,0,37
FC Lugano,7564,7,10,5,17,32,55,-23,35
FC Thun,7564,8,9,5,18,41,59,-18,32
FC Sion,7564,9,6,9,17,37,52,-15,27
Young Boys,7565,1,23,6,3,76,36,40,75
FC Basel,7565,2,19,8,5,59,23,36,65
St Gallen,7565,3,15,4,13,43,51,-8,49
FC Zürich,7565,4,11,10,11,44,37,7,43
Lucerne,7565,5,12,7,13,39,46,-7,43
Grasshoppers,7565,6,10,6,16,41,48,-7,36
FC Lugano,7565,7,9,7,16,30,51,-21,34
FC Thun,7565,8,9,5,18,42,65,-23,32
FC Sion,7565,9,6,7,19,40,57,-17,25
Young Boys,7566,1,21,7,4,73,36,37,70
FC Basel,7566,2,17,10,5,55,28,27,61
Lucerne,7566,3,13,9,10,41,42,-1,48
St Gallen,7566,4,15,3,14,45,56,-11,48
FC Zürich,7566,5,11,10,11,42,36,6,43
Grasshoppers,7566,6,10,7,15,45,50,-5,37
FC Thun,7566,7,9,7,16,44,60,-16,34
FC Lugano,7566,8,9,6,17,31,50,-19,33
FC Sion,7566,9,5,9,18,40,58,-18,24
Young Boys,7567,1,21,6,5,73,35,38,69
FC Basel,7567,2,17,8,7,53,27,26,59
Lucerne,7567,3,15,8,9,45,41,4,53
FC Zürich,7567,4,11,10,11,44,39,5,43
St Gallen,7567,5,13,4,15,42,57,-15,43
FC Lugano,7567,6,11,5,16,34,50,-16,38
FC Thun,7567,7,9,6,17,44,62,-18,33
FC Sion,7567,8,7,10,15,42,53,-11,31
Grasshoppers,7567,9,8,7,17,37,50,-13,31
Young Boys,7568,1,19,10,3,70,38,32,67
FC Basel,7568,2,18,8,6,55,26,29,62
Lucerne,7568,3,13,8,11,40,41,-1,47
St Gallen,7568,4,14,3,15,41,53,-12,45
FC Zürich,7568,5,11,10,11,42,35,7,43
Grasshoppers,7568,6,9,9,14,42,49,-7,36
FC Thun,7568,7,9,7,16,42,58,-16,34
FC Lugano,7568,8,9,6,17,32,52,-20,33
FC Sion,7568,9,6,11,15,40,52,-12,29
Young Boys,7569,1,22,7,3,69,32,37,73
FC Basel,7569,2,18,7,7,53,26,27,61
St Gallen,7569,3,15,2,15,45,56,-11,47
Lucerne,7569,4,13,7,12,44,45,-1,46
FC Zürich,7569,5,11,10,11,42,36,6,43
FC Thun,7569,6,10,6,16,41,56,-15,36
FC Sion,7569,7,9,7,16,44,51,-7,34
FC Lugano,7569,8,9,5,18,29,49,-20,32
Grasshoppers,7569,9,8,7,17,39,55,-16,31
Young Boys,7570,1,22,7,3,75,35,40,73
FC Basel,7570,2,18,7,7,53,26,27,61
St Gallen,7570,3,15,3,14,42,51,-9,48
Lucerne,7570,4,12,8,12,44,53,-9,44
FC Zürich,7570,5,10,11,11,43,39,4,41
FC Thun,7570,6,9,7,16,42,57,-15,34
FC Lugano,7570,7,9,7,16,32,53,-21,34
Grasshoppers,7570,8,9,6,17,43,50,-7,33
FC Sion,7570,9,8,8,16,39,49,-10,32
Young Boys,7571,1,22,6,4,72,32,40,72
FC Basel,7571,2,18,7,7,55,28,27,61
FC Zürich,7571,3,13,9,10,44,33,11,48
St Gallen,7571,4,14,3,15,43,56,-13,45
Lucerne,7571,5,12,8,12,39,45,-6,44
FC Lugano,7571,6,11,5,16,31,47,-16,38
FC Sion,7571,7,8,8,16,39,51,-12,32
FC Thun,7571,8,9,5,18,44,61,-17,32
Grasshoppers,7571,9,8,7,17,40,54,-14,31
Young Boys,7572,1,22,7,3,71,35,36,73
FC Basel,7572,2,18,8,6,53,26,27,62
Lucerne,7572,3,13,7,12,45,47,-2,46
St Gallen,7572,4,14,3,15,45,60,-15,45
FC Zürich,7572,5,10,12,10,41,35,6,42
Grasshoppers,7572,6,11,6,15,51,50,1,39
FC Lugano,7572,7,10,7,15,37,51,-14,37
FC Thun,7572,8,8,7,17,44,64,-20,31
FC Sion,7572,9,5,9,18,37,56,-19,24
Young Boys,7573,1,22,7,3,73,38,35,73
FC Basel,7573,2,16,8,8,52,29,23,56
Lucerne,7573,3,14,9,9,47,42,5,51
St Gallen,7573,4,15,3,14,45,53,-8,48
FC Thun,7573,5,12,5,15,47,57,-10,41
FC Zürich,7573,6,10,9,13,42,40,2,39
FC Lugano,7573,7,10,7,15,30,45,-15,37
Grasshoppers,7573,8,9,7,16,44,52,-8,34
FC Sion,7573,9,5,7,20,38,62,-24,22
Young Boys,7574,1,22,8,2,71,33,38,74
FC Basel,7574,2,16,9,7,52,29,23,57
St Gallen,7574,3,16,2,14,45,52,-7,50
FC Zürich,7574,4,11,10,11,41,36,5,43
Lucerne,7574,5,11,9,12,40,48,-8,42
Grasshoppers,7574,6,9,8,15,42,47,-5,35
FC Thun,7574,7,9,7,16,43,59,-16,34
FC Lugano,7574,8,9,7,16,31,49,-18,34
FC Sion,7574,9,6,10,16,40,52,-12,28
Young Boys,7575,1,22,7,3,76,39,37,73
FC Basel,7575,2,17,9,6,57,29,28,60
St Gallen,7575,3,15,3,14,45,53,-8,48
Lucerne,7575,4,13,7,12,43,46,-3,46
FC Zürich,7575,5,11,10,11,44,37,7,43
Grasshoppers,7575,6,10,6,16,42,53,-11,36
FC Thun,7575,7,10,6,16,45,62,-17,36
FC Lugano,7575,8,10,5,17,35,50,-15,35
FC Sion,7575,9,6,7,19,38,56,-18,25
Young Boys,7576,1,22,6,4,69,33,36,72
FC Basel,7576,2,17,10,5,51,23,28,61
Lucerne,7576,3,12,9,11,45,45,0,45
St Gallen,7576,4,14,3,15,41,53,-12,45
FC Zürich,7576,5,11,10,11,42,37,5,43
Grasshoppers,7576,6,10,8,14,42,46,-4,38
FC Thun,7576,7,10,6,16,49,61,-12,36
FC Lugano,7576,8,10,5,17,30,51,-21,35
FC Sion,7576,9,6,7,19,39,59,-20,25
Young Boys,7577,1,21,7,4,72,36,36,70
FC Basel,7577,2,18,8,6,55,29,26,62
St Gallen,7577,3,15,4,13,46,53,-7,49
Lucerne,7577,4,12,8,12,45,49,-4,44
FC Zürich,7577,5,10,10,12,42,37,5,40
Grasshoppers,7577,6,10,7,15,41,50,-9,37
FC Thun,7577,7,10,6,16,47,60,-13,36
FC Lugano,7577,8,9,7,16,30,49,-19,34
FC Sion,7577,9,6,9,17,43,58,-15,27
Young Boys,7578,1,23,6,3,77,37,40,75
FC Basel,7578,2,20,7,5,58,23,35,67
FC Zürich,7578,3,12,9,11,41,34,7,45
Lucerne,7578,4,12,8,12,39,44,-5,44
St Gallen,7578,5,13,4,15,42,56,-14,43
FC Lugano,7578,6,11,5,16,33,50,-17,38
Grasshoppers,7578,7,9,6,17,39,49,-10,33
FC Thun,7578,8,9,5,18,40,59,-19,32
FC Sion,7578,9,6,8,18,39,56,-17,26
Young Boys,7579,1,21,6,5,70,37,33,69
FC Basel,7579,2,18,8,6,51,24,27,62
Lucerne,7579,3,12,9,11,39,41,-2,45
St Gallen,7579,4,14,3,15,42,54,-12,45
FC Lugano,7579,5,12,5,15,33,44,-11,41
FC Zürich,7579,6,9,12,11,36,35,1,39
Grasshoppers,7579,7,9,7,16,40,50,-10,34
FC Thun,7579,8,9,6,17,43,59,-16,33
FC Sion,7579,9,8,8,16,42,52,-10,32
Young Boys,7580,1,21,7,4,68,39,29,70
FC Basel,7580,2,19,8,5,62,23,39,65
Lucerne,7580,3,14,8,10,41,41,0,50
St Gallen,7580,4,13,5,14,42,54,-12,44
FC Zürich,7580,5,11,9,12,43,35,8,42
FC Lugano,7580,6,10,6,16,30,46,-16,36
Grasshoppers,7580,7,9,7,16,40,51,-11,34
FC Thun,7580,8,9,5,18,41,60,-19,32
FC Sion,7580,9,6,9,17,38,56,-18,27
Young Boys,7581,1,23,6,3,68,32,36,75
FC Basel,7581,2,18,7,7,53,26,27,61
Lucerne,7581,3,14,7,11,51,45,6,49
St Gallen,7581,4,15,2,15,43,56,-13,47
FC Zürich,7581,5,11,9,12,43,38,5,42
FC Lugano,7581,6,11,5,16,33,47,-14,38
Grasshoppers,7581,7,10,6,16,44,56,-12,36
FC Thun,7581,8,10,5,17,46,59,-13,35
FC Sion,7581,9,5,7,20,35,57,-22,22
Young Boys,7582,1,21,7,4,73,35,38,70
FC Basel,7582,2,19,7,6,57,25,32,64
St Gallen,7582,3,15,2,15,43,53,-10,47
Lucerne,7582,4,13,7,12,41,49,-8,46
FC Zürich,7582,5,11,9,12,43,38,5,42
Grasshoppers,7582,6,11,6,15,46,50,-4,39
FC Lugano,7582,7,10,6,16,32,48,-16,36
FC Thun,7582,8,9,5,18,44,65,-21,32
FC Sion,7582,9,7,7,18,43,59,-16,28
Young Boys,7583,1,20,8,4,66,33,33,68
FC Basel,7583,2,18,8,6,57,26,31,62
Lucerne,7583,3,12,10,10,43,45,-2,46
St Gallen,7583,4,13,4,15,43,57,-14,43
FC Zürich,7583,5,11,9,12,41,40,1,42
Grasshoppers,7583,6,11,7,14,46,49,-3,40
FC Lugano,7583,7,10,7,15,33,48,-15,37
FC Thun,7583,8,9,5,18,45,63,-18,32
FC Sion,7583,9,7,8,17,40,53,-13,29
Young Boys,7584,1,23,6,3,71,31,40,75
FC Basel,7584,2,17,8,7,52,26,26,59
St Gallen,7584,3,14,4,14,48,57,-9,46
Lucerne,7584,4,12,8,12,41,49,-8,44
FC Zürich,7584,5,10,10,12,38,36,2,40
FC Thun,7584,6,11,6,15,45,55,-10,39
FC Lugano,7584,7,10,7,15,32,47,-15,37
Grasshoppers,7584,8,9,6,17,39,51,-12,33
FC Sion,7584,9,6,9,17,38,52,-14,27
Young Boys,7585,1,21,8,3,72,32,40,71
FC Basel,7585,2,15,9,8,48,29,19,54
Lucerne,7585,3,15,7,10,43,42,1,52
FC Zürich,7585,4,12,10,10,44,35,9,46
St Gallen,7585,5,13,4,15,41,55,-14,43
Grasshoppers,7585,6,10,7,15,41,47,-6,37
FC Thun,7585,7,9,7,16,45,60,-15,34
FC Lugano,7585,8,9,6,17,28,49,-21,33
FC Sion,7585,9,7,8,17,39,52,-13,29
Young Boys,7586,1,22,7,3,76,38,38,73
FC Basel,7586,2,17,8,7,51,28,23,59
Lucerne,7586,3,15,7,10,45,41,4,52
St Gallen,7586,4,14,4,14,40,51,-11,46
FC Zürich,7586,5,11,9,12,41,37,4,42
FC Thun,7586,6,10,5,17,46,59,-13,35
FC Lugano,7586,7,10,5,17,29,46,-17,35
Grasshoppers,7586,8,9,7,16,40,51,-11,34
FC Sion,7586,9,6,8,18,43,60,-17,26
Young Boys,7587,1,21,8,3,74,36,38,71
FC Basel,7587,2,19,8,5,58,24,34,65
St Gallen,7587,3,13,4,15,40,55,-15,43
Lucerne,7587,4,11,9,12,40,45,-5,42
FC Zürich,7587,5,9,10,13,37,37,0,37
Grasshoppers,7587,6,10,7,15,41,49,-8,37
FC Lugano,7587,7,10,7,15,30,48,-18,37
FC Sion,7587,8,8,9,15,42,51,-9,33
FC Thun,7587,9,9,6,17,41,58,-17,33
Young Boys,7588,1,22,6,4,67,34,33,72
FC Basel,7588,2,20,7,5,60,24,36,67
Lucerne,7588,3,14,7,11,42,43,-1,49
St Gallen,7588,4,13,2,17,41,60,-19,41
FC Zürich,7588,5,10,10,12,39,40,-1,40
Grasshoppers,7588,6,11,6,15,44,47,-3,39
FC Lugano,7588,7,10,6,16,31,45,-14,36
FC Thun,7588,8,10,5,17,45,58,-13,35
FC Sion,7588,9,6,7,19,38,56,-18,25
Young Boys,7589,1,23,6,3,81,37,44,75
FC Basel,7589,2,16,10,6,51,28,23,58
St Gallen,7589,3,15,4,13,46,54,-8,49
Lucerne,7589,4,11,9,12,41,47,-6,42
FC Zürich,7589,5,10,11,11,40,36,4,41
FC Thun,7589,6,11,6,15,50,56,-6,39
FC Lugano,7589,7,10,6,16,37,56,-19,36
Grasshoppers,7589,8,8,7,17,40,54,-14,31
FC Sion,7589,9,6,9,17,39,57,-18,27
Young Boys,7590,1,21,8,3,73,36,37,71
FC Basel,7590,2,17,9,6,56,26,30,60
Lucerne,7590,3,15,7,10,48,45,3,52
FC Zürich,7590,4,11,10,11,44,40,4,43
St Gallen,7590,5,13,4,15,41,57,-16,43
Grasshoppers,7590,6,10,7,15,46,52,-6,37
FC Lugano,7590,7,9,8,15,33,49,-16,35
FC Thun,7590,8,8,7,17,43,64,-21,31
FC Sion,7590,9,6,8,18,45,60,-15,26
Young Boys,7591,1,22,7,3,78,37,41,73
FC Basel,7591,2,19,7,6,60,26,34,64
Lucerne,7591,3,14,7,11,49,47,2,49
FC Zürich,7591,4,12,10,10,45,35,10,46
St Gallen,7591,5,14,2,16,41,58,-17,44
FC Lugano,7591,6,10,5,17,31,52,-21,35
Grasshoppers,7591,7,9,6,17,43,60,-17,33
FC Thun,7591,8,8,7,17,43,62,-19,31
FC Sion,7591,9,6,9,17,43,56,-13,27
Young Boys,7592,1,22,6,4,69,34,35,72
FC Basel,7592,2,17,9,6,54,24,30,60
St Gallen,7592,3,16,2,14,45,52,-7,50
Lucerne,7592,4,12,10,10,43,43,0,46
FC Zürich,7592,5,10,11,11,37,34,3,41
FC Lugano,7592,6,10,6,16,30,47,-17,36
FC Thun,7592,7,10,5,17,43,61,-18,35
Grasshoppers,7592,8,9,7,16,40,48,-8,34
FC Sion,7592,9,6,8,18,38,56,-18,26
Young Boys,7593,1,21,8,3,72,36,36,71
FC Basel,7593,2,16,8,8,51,31,20,56
St Gallen,7593,3,15,3,14,40,50,-10,48
Lucerne,7593,4,12,9,11,41,44,-3,45
FC Lugano,7593,5,11,7,14,32,44,-12,40
FC Zürich,7593,6,10,9,13,43,43,0,39
Grasshoppers,7593,7,9,7,16,43,53,-10,34
FC Thun,7593,8,9,7,16,47,61,-14,34
FC Sion,7593,9,8,8,16,44,51,-7,32
Young Boys,7594,1,20,8,4,67,37,30,68
FC Basel,7594,2,20,7,5,65,25,40,67
Lucerne,7594,3,14,8,10,41,41,0,50
St Gallen,7594,4,15,2,15,42,53,-11,47
FC Zürich,7594,5,10,9,13,40,42,-2,39
FC Lugano,7594,6,11,5,16,32,45,-13,38
FC Thun,7594,7,10,6,16,42,59,-17,36
Grasshoppers,7594,8,8,7,17,37,48,-11,31
FC Sion,7594,9,6,8,18,40,56,-16,26
Young Boys,7595,1,22,8,2,74,35,39,74
FC Basel,7595,2,16,9,7,53,28,25,57
St Gallen,7595,3,15,4,13,47,52,-5,49
Lucerne,7595,4,13,9,10,43,43,0,48
FC Zürich,7595,5,11,10,11,42,35,7,43
FC Lugano,7595,6,9,6,17,28,53,-25,33
Grasshoppers,7595,7,8,8,16,39,49,-10,32
FC Thun,7595,8,8,7,17,40,59,-19,31
FC Sion,7595,9,7,9,16,39,51,-12,30
Young Boys,7596,1,21,6,5,73,34,39,69
FC Basel,7596,2,19,8,5,55,21,34,65
Lucerne,7596,3,14,7,11,43,42,1,49
St Gallen,7596,4,14,2,16,44,56,-12,44
FC Zürich,7596,5,10,11,11,39,37,2,41
FC Lugano,7596,6,11,5,16,33,52,-19,38
Grasshoppers,7596,7,10,6,16,43,50,-7,36
FC Thun,7596,8,10,6,16,45,61,-16,36
FC Sion,7596,9,6,7,19,41,63,-22,25
Young Boys,7597,1,23,6,3,72,34,38,75
FC Basel,7597,2,19,7,6,57,27,30,64
FC Zürich,7597,3,12,9,11,43,38,5,45
St Gallen,7597,4,14,3,15,41,56,-15,45
Lucerne,7597,5,12,7,13,41,47,-6,43
FC Thun,7597,6,11,5,16,51,60,-9,38
FC Lugano,7597,7,10,6,16,30,45,-15,36
Grasshoppers,7597,8,8,7,17,39,52,-13,31
FC Sion,7597,9,6,8,18,40,55,-15,26
Young Boys,7598,1,23,6,3,74,34,40,75
FC Basel,7598,2,20,7,5,57,25,32,67
St Gallen,7598,3,16,2,14,42,51,-9,50
Lucerne,7598,4,12,7,13,41,47,-6,43
FC Zürich,7598,5,10,10,12,40,37,3,40
FC Lugano,7598,6,10,5,17,29,48,-19,35
Grasshoppers,7598,7,9,7,16,40,51,-11,34
FC Thun,7598,8,8,7,17,41,61,-20,31
FC Sion,7598,9,7,7,18,41,51,-10,28
Young Boys,7599,1,22,7,3,73,36,37,73
FC Basel,7599,2,18,9,5,53,24,29,63
Lucerne,7599,3,13,8,11,45,42,3,47
FC Zürich,7599,4,12,10,10,45,34,11,46
St Gallen,7599,5,13,5,14,41,55,-14,44
Grasshoppers,7599,6,9,8,15,43,52,-9,35
FC Lugano,7599,7,9,6,17,31,53,-22,33
FC Thun,7599,8,8,6,18,39,59,-20,30
FC Sion,7599,9,7,7,18,41,56,-15,28
Young Boys,7600,1,24,6,2,76,35,41,78
FC Basel,7600,2,16,10,6,54,27,27,58
St Gallen,7600,3,16,3,13,45,49,-4,51
Lucerne,7600,4,12,8,12,42,47,-5,44
FC Zürich,7600,5,10,10,12,41,38,3,40
Grasshoppers,7600,6,9,8,15,43,51,-8,35
FC Thun,7600,7,9,7,16,42,59,-17,34
FC Lugano,7600,8,9,5,18,31,54,-23,32
FC Sion,7600,9,6,9,17,41,55,-14,27
Young Boys,7601,1,22,7,3,73,31,42,73
FC Basel,7601,2,17,9,6,53,24,29,60
St Gallen,7601,3,15,3,14,45,56,-11,48
FC Zürich,7601,4,11,11,10,41,35,6,44
Lucerne,7601,5,12,7,13,39,44,-5,43
Grasshoppers,7601,6,11,7,14,42,47,-5,40
FC Lugano,7601,7,9,7,16,28,50,-22,34
FC Thun,7601,8,9,6,17,46,62,-16,33
FC Sion,7601,9,6,7,19,40,58,-18,25
Young Boys,7602,1,23,6,3,74,37,37,75
FC Basel,7602,2,17,8,7,55,30,25,59
FC Zürich,7602,3,12,9,11,43,35,8,45
Lucerne,7602,4,12,8,12,44,49,-5,44
St Gallen,7602,5,14,2,16,41,57,-16,44
Grasshoppers,7602,6,10,6,16,42,47,-5,36
FC Thun,7602,7,10,6,16,44,59,-15,36
FC Lugano,7602,8,10,6,16,31,47,-16,36
FC Sion,7602,9,7,7,18,42,55,-13,28
Young Boys,7603,1,20,8,4,69,39,30,68
FC Basel,7603,2,18,9,5,58,27,31,63
Lucerne,7603,3,13,9,10,48,43,5,48
St Gallen,7603,4,13,3,16,41,64,-23,42
FC Zürich,7603,5,10,11,11,42,38,4,41
FC Lugano,7603,6,11,6,15,33,45,-12,39
Grasshoppers,7603,7,10,7,15,44,50,-6,37
FC Thun,7603,8,9,5,18,41,58,-17,32
FC Sion,7603,9,7,8,17,44,56,-12,29
Young Boys,7604,1,21,8,3,72,36,36,71
FC Basel,7604,2,18,9,5,57,27,30,63
St Gallen,7604,3,14,2,16,44,57,-13,44
Lucerne,7604,4,11,9,12,38,45,-7,42
FC Zürich,7604,5,10,10,12,41,39,2,40
Grasshoppers,7604,6,9,9,14,41,48,-7,36
FC Thun,7604,7,10,6,16,43,56,-13,36
FC Lugano,7604,8,10,6,16,32,48,-16,36
FC Sion,7604,9,7,9,16,42,54,-12,30
Young Boys,7605,1,20,9,3,73,38,35,69
FC Basel,7605,2,18,9,5,52,23,29,63
Lucerne,7605,3,14,9,9,46,42,4,51
St Gallen,7605,4,14,4,14,44,55,-11,46
FC Zürich,7605,5,11,10,11,41,37,4,43
Grasshoppers,7605,6,10,7,15,46,51,-5,37
FC Thun,7605,7,9,6,17,43,62,-19,33
FC Lugano,7605,8,9,6,17,31,50,-19,33
FC Sion,7605,9,5,8,19,38,56,-18,23
Young Boys,7606,1,21,7,4,69,34,35,70
FC Basel,7606,2,20,7,5,61,23,38,67
St Gallen,7606,3,14,4,14,44,56,-12,46
Lucerne,7606,4,12,8,12,41,45,-4,44
FC Zürich,7606,5,10,11,11,42,40,2,41
FC Thun,7606,6,10,6,16,43,58,-15,36
FC Lugano,7606,7,9,8,15,30,49,-19,35
Grasshoppers,7606,8,9,7,16,37,49,-12,34
FC Sion,7606,9,6,8,18,41,54,-13,26
Young Boys,7607,1,23,6,3,80,38,42,75
FC Basel,7607,2,18,7,7,57,29,28,61
St Gallen,7607,3,16,3,13,46,54,-8,51
Lucerne,7607,4,12,7,13,48,50,-2,43
FC Zürich,7607,5,10,9,13,44,39,5,39
FC Lugano,7607,6,11,6,15,35,49,-14,39
FC Thun,7607,7,10,6,16,43,58,-15,36
Grasshoppers,7607,8,9,7,16,42,59,-17,34
FC Sion,7607,9,6,7,19,42,61,-19,25
Young Boys,7608,1,20,9,3,69,35,34,69
FC Basel,7608,2,18,8,6,57,28,29,62
Lucerne,7608,3,13,9,10,42,42,0,48
St Gallen,7608,4,14,3,15,42,55,-13,45
FC Zürich,7608,5,9,11,12,37,37,0,38
FC Lugano,7608,6,11,5,16,32,44,-12,38
Grasshoppers,7608,7,10,6,16,46,51,-5,36
FC Thun,7608,8,10,6,16,45,61,-16,36
FC Sion,7608,9,6,9,17,41,58,-17,27
Young Boys,7609,1,22,6,4,69,33,36,72
FC Basel,7609,2,17,9,6,53,26,27,60
FC Zürich,7609,3,12,10,10,48,36,12,46
St Gallen,7609,4,14,4,14,44,54,-10,46
Lucerne,7609,5,11,7,14,40,49,-9,40
Grasshoppers,7609,6,11,6,15,46,50,-4,39
FC Lugano,7609,7,10,6,16,30,48,-18,36
FC Thun,7609,8,9,7,16,47,61,-14,34
FC Sion,7609,9,7,7,18,41,61,-20,28
Young Boys,7610,1,21,6,5,72,37,35,69
FC Basel,7610,2,18,8,6,56,25,31,62
Lucerne,7610,3,14,7,11,46,51,-5,49
St Gallen,7610,4,13,4,15,41,54,-13,43
FC Lugano,7610,5,12,5,15,35,46,-11,41
Grasshoppers,7610,6,11,6,15,46,49,-3,39
FC Zürich,7610,7,9,11,12,40,39,1,38
FC Thun,7610,8,10,6,16,47,63,-16,36
FC Sion,7610,9,5,9,18,41,60,-19,24
Young Boys,7611,1,21,7,4,69,34,35,70
FC Basel,7611,2,16,9,7,48,24,24,57
St Gallen,7611,3,16,2,14,45,53,-8,50
Lucerne,7611,4,13,9,10,43,42,1,48
FC Zürich,7611,5,12,10,10,41,33,8,46
Grasshoppers,7611,6,10,7,15,47,48,-1,37
FC Lugano,7611,7,10,6,16,31,50,-19,36
FC Thun,7611,8,9,7,16,43,59,-16,34
FC Sion,7611,9,5,7,20,39,63,-24,22
Young Boys,7612,1,20,8,4,72,35,37,68
FC Basel,7612,2,18,7,7,54,27,27,61
Lucerne,7612,3,13,8,11,43,44,-1,47
St Gallen,7612,4,15,2,15,44,54,-10,47
FC Zürich,7612,5,12,10,10,40,33,7,46
FC Lugano,7612,6,10,5,17,28,50,-22,35
FC Sion,7612,7,9,7,16,47,55,-8,34
Grasshoppers,7612,8,9,7,16,38,47,-9,34
FC Thun,7612,9,8,6,18,40,61,-21,30
Young Boys,7613,1,23,7,2,74,31,43,76
FC Basel,7613,2,17,7,8,49,25,24,58
St Gallen,7613,3,15,2,15,43,55,-12,47
Lucerne,7613,4,13,7,12,40,45,-5,46
FC Zürich,7613,5,11,9,12,39,37,2,42
Grasshoppers,7613,6,10,7,15,45,50,-5,37
FC Thun,7613,7,10,6,16,44,57,-13,36
FC Lugano,7613,8,10,5,17,31,48,-17,35
FC Sion,7613,9,6,8,18,38,55,-17,26
Young Boys,7614,1,21,7,4,74,38,36,70
FC Basel,7614,2,18,8,6,56,26,30,62
St Gallen,7614,3,14,4,14,45,54,-9,46
FC Zürich,7614,4,12,9,11,44,37,7,45
Lucerne,7614,5,12,8,12,44,52,-8,44
Grasshoppers,7614,6,10,6,16,47,55,-8,36
FC Lugano,7614,7,10,6,16,36,51,-15,36
FC Thun,7614,8,9,5,18,43,64,-21,32
FC Sion,7614,9,8,7,17,40,52,-12,31
FC Basel,7615,1,20,7,5,58,22,36,67
Young Boys,7615,2,20,7,5,69,36,33,67
Lucerne,7615,3,15,7,10,46,44,2,52
FC Zürich,7615,4,11,9,12,43,40,3,42
St Gallen,7615,5,13,2,17,42,59,-17,41
FC Thun,7615,6,10,6,16,45,58,-13,36
FC Lugano,7615,7,10,5,17,33,53,-20,35
Grasshoppers,7615,8,9,7,16,38,49,-11,34
FC Sion,7615,9,6,10,16,41,54,-13,28
Young Boys,7616,1,21,7,4,72,36,36,70
FC Basel,7616,2,17,10,5,56,27,29,61
Lucerne,7616,3,12,10,10,43,44,-1,46
St Gallen,7616,4,13,3,16,45,59,-14,42
FC Zürich,7616,5,10,11,11,40,37,3,41
Grasshoppers,7616,6,10,7,15,42,49,-7,37
FC Thun,7616,7,10,6,16,43,56,-13,36
FC Lugano,7616,8,10,5,17,32,52,-20,35
FC Sion,7616,9,7,9,16,40,53,-13,30
Young Boys,7617,1,22,7,3,72,33,39,73
FC Basel,7617,2,19,7,6,58,26,32,64
St Gallen,7617,3,16,2,14,45,55,-10,50
FC Zürich,7617,4,12,9,11,41,34,7,45
Lucerne,7617,5,12,7,13,43,53,-10,43
Grasshoppers,7617,6,9,8,15,42,49,-7,35
FC Lugano,7617,7,10,5,17,31,47,-16,35
FC Thun,7617,8,9,5,18,42,61,-19,32
FC Sion,7617,9,6,8,18,41,57,-16,26
Young Boys,7618,1,20,8,4,67,35,32,68
FC Basel,7618,2,18,9,5,55,25,30,63
FC Lugano,7618,3,13,5,14,34,44,-10,44
St Gallen,7618,4,14,2,16,44,58,-14,44
Lucerne,7618,5,12,7,13,43,48,-5,43
FC Zürich,7618,6,11,9,12,41,35,6,42
Grasshoppers,7618,7,10,7,15,41,48,-7,37
FC Thun,7618,8,8,8,16,40,57,-17,32
FC Sion,7618,9,6,9,17,40,55,-15,27
Young Boys,7619,1,20,8,4,68,36,32,68
FC Basel,7619,2,19,7,6,58,24,34,64
FC Zürich,7619,3,11,10,11,39,35,4,43
Lucerne,7619,4,11,9,12,41,48,-7,42
St Gallen,7619,5,13,3,16,40,54,-14,42
FC Lugano,7619,6,10,8,14,31,45,-14,38
FC Sion,7619,7,10,7,15,44,50,-6,37
Grasshoppers,7619,8,10,7,15,44,51,-7,37
FC Thun,7619,9,8,5,19,41,63,-22,29
Young Boys,7620,1,20,8,4,75,42,33,68
FC Basel,7620,2,18,8,6,57,27,30,62
Lucerne,7620,3,12,9,11,44,48,-4,45
St Gallen,7620,4,13,4,15,41,55,-14,43
FC Lugano,7620,5,11,7,14,32,45,-13,40
FC Zürich,7620,6,9,11,12,40,39,1,38
FC Thun,7620,7,10,5,17,44,59,-15,35
Grasshoppers,7620,8,9,7,16,42,52,-10,34
FC Sion,7620,9,8,9,15,44,52,-8,33
Young Boys,7621,1,21,8,3,71,36,35,71
FC Basel,7621,2,17,8,7,54,29,25,59
Lucerne,7621,3,15,8,9,44,39,5,53
St Gallen,7621,4,15,2,15,42,54,-12,47
FC Zürich,7621,5,10,12,10,40,35,5,42
Grasshoppers,7621,6,10,6,16,46,51,-5,36
FC Thun,7621,7,9,6,17,44,60,-16,33
FC Lugano,7621,8,9,6,17,28,47,-19,33
FC Sion,7621,9,5,10,17,39,57,-18,25
Young Boys,7622,1,21,8,3,72,35,37,71
FC Basel,7622,2,18,8,6,52,24,28,62
Lucerne,7622,3,14,8,10,43,42,1,50
FC Zürich,7622,4,13,9,10,44,33,11,48
St Gallen,7622,5,13,3,16,39,53,-14,42
Grasshoppers,7622,6,9,7,16,44,55,-11,34
FC Lugano,7622,7,9,6,17,28,48,-20,33
FC Sion,7622,8,8,8,16,43,51,-8,32
FC Thun,7622,9,8,5,19,40,64,-24,29
Young Boys,7623,1,20,9,3,68,32,36,69
FC Basel,7623,2,16,9,7,50,26,24,57
St Gallen,7623,3,15,3,14,43,56,-13,48
Lucerne,7623,4,12,9,11,40,44,-4,45
FC Zürich,7623,5,10,10,12,39,36,3,40
Grasshoppers,7623,6,11,6,15,45,47,-2,39
FC Thun,7623,7,10,6,16,42,56,-14,36
FC Lugano,7623,8,9,9,14,30,45,-15,36
FC Sion,7623,9,6,9,17,42,57,-15,27
Young Boys,7624,1,21,9,2,70,33,37,72
FC Basel,7624,2,18,7,7,52,26,26,61
St Gallen,7624,3,14,4,14,42,53,-11,46
FC Zürich,7624,4,11,10,11,42,36,6,43
Lucerne,7624,5,11,10,11,40,44,-4,43
Grasshoppers,7624,6,10,7,15,43,49,-6,37
FC Lugano,7624,7,9,8,15,28,44,-16,35
FC Thun,7624,8,9,7,16,43,60,-17,34
FC Sion,7624,9,6,8,18,41,56,-15,26
Young Boys,7625,1,22,6,4,71,36,35,72
FC Basel,7625,2,16,9,7,53,33,20,57
St Gallen,7625,3,15,4,13,43,51,-8,49
Lucerne,7625,4,13,9,10,43,42,1,48
FC Zürich,7625,5,12,9,11,46,37,9,45
FC Thun,7625,6,10,6,16,47,58,-11,36
FC Lugano,7625,7,10,5,17,30,48,-18,35
Grasshoppers,7625,8,9,7,16,42,53,-11,34
FC Sion,7625,9,6,7,19,38,55,-17,25
Young Boys,7626,1,22,6,4,71,37,34,72
FC Basel,7626,2,19,7,6,55,25,30,64
St Gallen,7626,3,15,2,15,44,55,-11,47
Lucerne,7626,4,13,7,12,45,46,-1,46
FC Lugano,7626,5,12,5,15,32,45,-13,41
FC Zürich,7626,6,9,9,14,40,41,-1,36
Grasshoppers,7626,7,9,8,15,42,50,-8,35
FC Thun,7626,8,9,7,16,47,62,-15,34
FC Sion,7626,9,6,9,17,40,55,-15,27
Young Boys,7627,1,22,7,3,77,38,39,73
FC Basel,7627,2,19,8,5,62,26,36,65
St Gallen,7627,3,14,4,14,45,60,-15,46
FC Zürich,7627,4,11,9,12,42,42,0,42
Lucerne,7627,5,11,8,13,41,50,-9,41
FC Lugano,7627,6,10,7,15,38,49,-11,37
Grasshoppers,7627,7,9,7,16,41,53,-12,34
FC Thun,7627,8,9,7,16,43,58,-15,34
FC Sion,7627,9,6,9,17,42,55,-13,27
Young Boys,7628,1,23,6,3,75,39,36,75
FC Basel,7628,2,20,7,5,60,23,37,67
St Gallen,7628,3,15,3,14,42,51,-9,48
Lucerne,7628,4,13,8,11,41,42,-1,47
FC Zürich,7628,5,9,11,12,41,40,1,38
Grasshoppers,7628,6,10,6,16,44,51,-7,36
FC Thun,7628,7,9,6,17,44,63,-19,33
FC Lugano,7628,8,9,6,17,32,51,-19,33
FC Sion,7628,9,6,7,19,40,59,-19,25
Young Boys,7629,1,22,7,3,69,33,36,73
FC Basel,7629,2,19,8,5,53,23,30,65
St Gallen,7629,3,15,2,15,43,53,-10,47
Lucerne,7629,4,13,7,12,40,41,-1,46
FC Zürich,7629,5,12,9,11,46,37,9,45
FC Lugano,7629,6,10,5,17,29,50,-21,35
Grasshoppers,7629,7,8,8,16,41,53,-12,32
FC Thun,7629,8,8,8,16,44,60,-16,32
FC Sion,7629,9,6,8,18,39,54,-15,26
Young Boys,7630,1,21,7,4,69,35,34,70
FC Basel,7630,2,19,8,5,52,23,29,65
Lucerne,7630,3,13,9,10,42,41,1,48
St Gallen,7630,4,14,3,15,44,56,-12,45
FC Zürich,7630,5,10,10,12,41,37,4,40
FC Lugano,7630,6,11,5,16,31,49,-18,38
FC Thun,7630,7,10,7,15,44,56,-12,37
Grasshoppers,7630,8,8,6,18,41,53,-12,30
FC Sion,7630,9,7,7,18,41,55,-14,28
Young Boys,7631,1,21,7,4,71,36,35,70
FC Basel,7631,2,17,9,6,51,25,26,60
Lucerne,7631,3,13,10,9,42,40,2,49
St Gallen,7631,4,14,4,14,41,53,-12,46
FC Zürich,7631,5,11,9,12,41,35,6,42
FC Thun,7631,6,10,6,16,41,55,-14,36
Grasshoppers,7631,7,9,8,15,40,49,-9,35
FC Lugano,7631,8,10,5,17,29,47,-18,35
FC Sion,7631,9,6,8,18,38,54,-16,26
Young Boys,7632,1,22,8,2,71,32,39,74
FC Basel,7632,2,17,9,6,49,23,26,60
St Gallen,7632,3,16,2,14,45,52,-7,50
Lucerne,7632,4,13,7,12,40,43,-3,46
FC Zürich,7632,5,11,9,12,46,37,9,42
Grasshoppers,7632,6,9,8,15,39,47,-8,35
FC Lugano,7632,7,9,5,18,29,51,-22,32
FC Thun,7632,8,8,7,17,41,63,-22,31
FC Sion,7632,9,7,9,16,42,54,-12,30
Young Boys,7633,1,21,8,3,72,34,38,71
FC Basel,7633,2,18,8,6,54,25,29,62
St Gallen,7633,3,17,2,13,47,52,-5,53
Lucerne,7633,4,13,8,11,46,43,3,47
FC Zürich,7633,5,11,9,12,43,38,5,42
FC Thun,7633,6,9,7,16,41,55,-14,34
Grasshoppers,7633,7,9,6,17,40,51,-11,33
FC Lugano,7633,8,9,5,18,30,59,-29,32
FC Sion,7633,9,6,9,17,38,54,-16,27
Young Boys,7634,1,23,6,3,72,34,38,75
FC Basel,7634,2,16,9,7,50,27,23,57
Lucerne,7634,3,13,7,12,39,42,-3,46
FC Zürich,7634,4,11,10,11,40,33,7,43
FC Lugano,7634,5,12,6,14,33,44,-11,42
St Gallen,7634,6,13,3,16,43,60,-17,42
FC Thun,7634,7,9,7,16,46,60,-14,34
Grasshoppers,7634,8,8,7,17,42,55,-13,31
FC Sion,7634,9,7,9,16,45,55,-10,30
Young Boys,7635,1,22,6,4,71,38,33,72
FC Basel,7635,2,19,8,5,59,25,34,65
Lucerne,7635,3,13,8,11,42,46,-4,47
St Gallen,7635,4,15,2,15,47,56,-9,47
FC Zürich,7635,5,9,12,11,39,36,3,39
Grasshoppers,7635,6,10,6,16,44,48,-4,36
FC Thun,7635,7,9,7,16,42,58,-16,34
FC Lugano,7635,8,9,6,17,28,47,-19,33
FC Sion,7635,9,6,9,17,41,59,-18,27
Young Boys,7636,1,21,8,3,70,35,35,71
FC Basel,7636,2,18,8,6,58,28,30,62
St Gallen,7636,3,16,2,14,49,56,-7,50
Lucerne,7636,4,13,7,12,42,45,-3,46
FC Zürich,7636,5,11,10,11,40,34,6,43
FC Thun,7636,6,10,6,16,44,60,-16,36
FC Lugano,7636,7,10,5,17,31,49,-18,35
Grasshoppers,7636,8,8,7,17,40,51,-11,31
FC Sion,7636,9,7,7,18,40,56,-16,28
Young Boys,7637,1,21,7,4,72,36,36,70
FC Basel,7637,2,18,7,7,55,25,30,61
Lucerne,7637,3,14,7,11,44,46,-2,49
FC Lugano,7637,4,13,5,14,36,44,-8,44
St Gallen,7637,5,14,2,16,42,60,-18,44
FC Zürich,7637,6,10,9,13,39,40,-1,39
FC Thun,7637,7,10,5,17,43,59,-16,35
Grasshoppers,7637,8,9,7,16,40,51,-11,34
FC Sion,7637,9,7,7,18,45,55,-10,28
Young Boys,7638,1,22,8,2,74,33,41,74
FC Basel,7638,2,18,9,5,52,24,28,63
St Gallen,7638,3,15,2,15,43,52,-9,47
FC Zürich,7638,4,10,11,11,38,36,2,41
Lucerne,7638,5,11,8,13,38,46,-8,41
FC Thun,7638,6,11,5,16,47,55,-8,38
Grasshoppers,7638,7,10,7,15,40,49,-9,37
FC Lugano,7638,8,10,7,15,30,46,-16,37
FC Sion,7638,9,5,7,20,36,57,-21,22
Young Boys,7639,1,21,7,4,74,37,37,70
FC Basel,7639,2,18,9,5,54,24,30,63
Lucerne,7639,3,12,11,9,43,40,3,47
FC Zürich,7639,4,11,11,10,40,33,7,44
St Gallen,7639,5,13,3,16,41,58,-17,42
FC Thun,7639,6,10,6,16,41,57,-16,36
Grasshoppers,7639,7,9,7,16,39,48,-9,34
FC Lugano,7639,8,9,7,16,32,50,-18,34
FC Sion,7639,9,7,7,18,38,55,-17,28
Young Boys,7640,1,22,8,2,71,32,39,74
FC Basel,7640,2,16,9,7,48,25,23,57
Lucerne,7640,3,14,8,10,42,39,3,50
St Gallen,7640,4,13,5,14,40,52,-12,44
FC Zürich,7640,5,10,12,10,42,35,7,42
Grasshoppers,7640,6,10,7,15,43,50,-7,37
FC Thun,7640,7,10,5,17,44,60,-16,35
FC Lugano,7640,8,9,7,16,29,47,-18,34
FC Sion,7640,9,5,9,18,37,56,-19,24
Young Boys,7641,1,20,8,4,70,36,34,68
FC Basel,7641,2,17,9,6,53,25,28,60
Lucerne,7641,3,13,10,9,44,43,1,49
FC Zürich,7641,4,12,9,11,43,36,7,45
St Gallen,7641,5,13,4,15,41,56,-15,43
Grasshoppers,7641,6,10,7,15,47,53,-6,37
FC Lugano,7641,7,10,6,16,32,50,-18,36
FC Thun,7641,8,9,7,16,43,57,-14,34
FC Sion,7641,9,5,10,17,42,59,-17,25
Young Boys,7642,1,21,7,4,72,38,34,70
FC Basel,7642,2,20,7,5,55,23,32,67
FC Zürich,7642,3,12,9,11,42,34,8,45
Lucerne,7642,4,12,8,12,45,45,0,44
St Gallen,7642,5,13,3,16,39,59,-20,42
Grasshoppers,7642,6,10,8,14,48,52,-4,38
FC Lugano,7642,7,10,6,16,29,47,-18,36
FC Thun,7642,8,8,7,17,42,60,-18,31
FC Sion,7642,9,6,9,17,40,54,-14,27
Young Boys,7643,1,21,7,4,71,36,35,70
FC Basel,7643,2,18,8,6,54,26,28,62
Lucerne,7643,3,13,8,11,41,44,-3,47
St Gallen,7643,4,14,3,15,44,56,-12,45
FC Lugano,7643,5,12,5,15,35,48,-13,41
FC Zürich,7643,6,10,10,12,38,35,3,40
Grasshoppers,7643,7,9,8,15,43,48,-5,35
FC Thun,7643,8,8,7,17,39,58,-19,31
FC Sion,7643,9,7,8,17,40,54,-14,29
Young Boys,7644,1,21,9,2,72,35,37,72
FC Basel,7644,2,16,10,6,51,27,24,58
FC Zürich,7644,3,12,10,10,42,34,8,46
Lucerne,7644,4,12,9,11,41,44,-3,45
St Gallen,7644,5,13,4,15,40,59,-19,43
Grasshoppers,7644,6,9,8,15,42,49,-7,35
FC Lugano,7644,7,10,5,17,31,46,-15,35
FC Thun,7644,8,9,7,16,44,59,-15,34
FC Sion,7644,9,6,10,16,43,53,-10,28
Young Boys,7645,1,21,7,4,71,35,36,70
FC Basel,7645,2,17,9,6,54,28,26,60
Lucerne,7645,3,13,9,10,42,41,1,48
St Gallen,7645,4,14,3,15,42,55,-13,45
FC Zürich,7645,5,11,11,10,44,36,8,44
Grasshoppers,7645,6,9,8,15,42,52,-10,35
FC Lugano,7645,7,9,6,17,31,53,-22,33
FC Sion,7645,8,8,8,16,44,54,-10,32
FC Thun,7645,9,9,5,18,44,60,-16,32
Young Boys,7646,1,23,7,2,74,35,39,76
FC Basel,7646,2,18,9,5,52,23,29,63
Lucerne,7646,3,13,7,12,44,47,-3,46
St Gallen,7646,4,14,4,14,43,53,-10,46
FC Zürich,7646,5,10,10,12,42,38,4,40
FC Lugano,7646,6,9,7,16,29,48,-19,34
Grasshoppers,7646,7,9,6,17,40,50,-10,33
FC Thun,7646,8,9,6,17,43,60,-17,33
FC Sion,7646,9,7,8,17,43,56,-13,29
Young Boys,7647,1,24,6,2,77,33,44,78
FC Basel,7647,2,15,10,7,49,28,21,55
Lucerne,7647,3,12,10,10,44,45,-1,46
St Gallen,7647,4,14,4,14,44,53,-9,46
FC Zürich,7647,5,10,10,12,39,37,2,40
FC Lugano,7647,6,10,6,16,30,49,-19,36
FC Thun,7647,7,9,7,16,44,58,-14,34
Grasshoppers,7647,8,8,8,16,39,51,-12,32
FC Sion,7647,9,7,9,16,41,53,-12,30
Young Boys,7648,1,22,7,3,75,36,39,73
FC Basel,7648,2,17,8,7,50,25,25,59
Lucerne,7648,3,14,8,10,47,44,3,50
St Gallen,7648,4,13,4,15,42,55,-13,43
FC Zürich,7648,5,11,9,12,41,38,3,42
Grasshoppers,7648,6,10,7,15,42,52,-10,37
FC Thun,7648,7,10,6,16,47,57,-10,36
FC Lugano,7648,8,9,7,16,30,48,-18,34
FC Sion,7648,9,6,8,18,37,56,-19,26
Young Boys,7649,1,23,7,2,74,35,39,76
FC Basel,7649,2,17,9,6,52,25,27,60
Lucerne,7649,3,13,8,11,45,45,0,47
St Gallen,7649,4,14,2,16,43,59,-16,44
FC Zürich,7649,5,11,10,11,44,36,8,43
FC Lugano,7649,6,11,6,15,35,46,-11,39
Grasshoppers,7649,7,10,6,16,43,51,-8,36
FC Thun,7649,8,10,5,17,45,61,-16,35
FC Sion,7649,9,5,7,20,39,62,-23,22
Young Boys,7650,1,22,7,3,74,34,40,73
FC Basel,7650,2,16,10,6,54,30,24,58
FC Zürich,7650,3,13,9,10,46,36,10,48
Lucerne,7650,4,13,8,11,42,42,0,47
St Gallen,7650,5,13,5,14,42,57,-15,44
Grasshoppers,7650,6,9,7,16,42,53,-11,34
FC Lugano,7650,7,9,6,17,29,50,-21,33
FC Thun,7650,8,8,8,16,42,58,-16,32
FC Sion,7650,9,7,8,17,44,55,-11,29
Young Boys,7651,1,23,7,2,78,33,45,76
FC Basel,7651,2,17,8,7,53,28,25,59
St Gallen,7651,3,16,2,14,44,54,-10,50
Lucerne,7651,4,12,8,12,43,49,-6,44
FC Zürich,7651,5,10,10,12,41,37,4,40
Grasshoppers,7651,6,11,7,14,46,47,-1,40
FC Lugano,7651,7,10,5,17,31,53,-22,35
FC Thun,7651,8,9,6,17,42,60,-18,33
FC Sion,7651,9,5,9,18,41,58,-17,24
Young Boys,7652,1,24,6,2,76,34,42,78
FC Basel,7652,2,16,9,7,51,29,22,57
Lucerne,7652,3,13,8,11,47,47,0,47
St Gallen,7652,4,13,4,15,47,61,-14,43
FC Lugano,7652,5,12,5,15,38,49,-11,41
FC Zürich,7652,6,10,10,12,40,38,2,40
FC Thun,7652,7,9,8,15,43,57,-14,35
Grasshoppers,7652,8,8,8,16,41,53,-12,32
FC Sion,7652,9,5,10,17,42,57,-15,25
Young Boys,7653,1,22,8,2,74,32,42,74
FC Basel,7653,2,18,7,7,49,25,24,61
St Gallen,7653,3,15,3,14,41,50,-9,48
Lucerne,7653,4,11,8,13,38,46,-8,41
FC Zürich,7653,5,10,10,12,40,40,0,40
FC Thun,7653,6,11,5,16,49,57,-8,38
FC Lugano,7653,7,10,8,14,32,46,-14,38
Grasshoppers,7653,8,9,7,16,41,50,-9,34
FC Sion,7653,9,6,8,18,40,58,-18,26
Young Boys,7654,1,20,8,4,70,39,31,68
FC Basel,7654,2,17,9,6,53,24,29,60
Lucerne,7654,3,13,9,10,45,43,2,48
St Gallen,7654,4,14,4,14,43,54,-11,46
FC Zürich,7654,5,12,9,11,40,33,7,45
FC Lugano,7654,6,11,5,16,33,49,-16,38
Grasshoppers,7654,7,10,6,16,42,49,-7,36
FC Sion,7654,8,7,9,16,44,54,-10,30
FC Thun,7654,9,8,5,19,40,65,-25,29
Young Boys,7655,1,22,6,4,76,36,40,72
FC Basel,7655,2,17,7,8,57,30,27,58
St Gallen,7655,3,14,3,15,41,55,-14,45
Lucerne,7655,4,12,8,12,41,45,-4,44
FC Zürich,7655,5,11,9,12,44,39,5,42
FC Lugano,7655,6,12,5,15,32,47,-15,41
FC Thun,7655,7,11,5,16,48,60,-12,38
FC Sion,7655,8,8,8,16,42,51,-9,32
Grasshoppers,7655,9,8,7,17,40,58,-18,31
Young Boys,7656,1,24,6,2,78,34,44,78
FC Basel,7656,2,16,10,6,55,28,27,58
Lucerne,7656,3,12,10,10,42,46,-4,46
St Gallen,7656,4,13,4,15,41,56,-15,43
FC Zürich,7656,5,10,12,10,44,37,7,42
FC Lugano,7656,6,10,6,16,32,47,-15,36
FC Thun,7656,7,10,6,16,47,63,-16,36
Grasshoppers,7656,8,8,7,17,42,56,-14,31
FC Sion,7656,9,7,7,18,45,59,-14,28
Young Boys,7657,1,20,8,4,71,37,34,68
FC Basel,7657,2,17,9,6,59,26,33,60
FC Zürich,7657,3,12,10,10,44,35,9,46
Lucerne,7657,4,13,7,12,44,48,-4,46
St Gallen,7657,5,14,4,14,44,56,-12,46
Grasshoppers,7657,6,10,7,15,41,49,-8,37
FC Lugano,7657,7,10,7,15,31,46,-15,37
FC Thun,7657,8,8,7,17,42,65,-23,31
FC Sion,7657,9,6,9,17,41,55,-14,27
Young Boys,7658,1,22,7,3,73,34,39,73
FC Basel,7658,2,18,8,6,51,24,27,62
Lucerne,7658,3,13,8,11,41,44,-3,47
St Gallen,7658,4,13,4,15,41,55,-14,43
FC Zürich,7658,5,10,9,13,40,38,2,39
Grasshoppers,7658,6,11,6,15,42,48,-6,39
FC Lugano,7658,7,11,6,15,31,45,-14,39
FC Thun,7658,8,10,5,17,45,56,-11,35
FC Sion,7658,9,6,7,19,38,58,-20,25
Young Boys,7659,1,22,7,3,75,34,41,73
FC Basel,7659,2,17,8,7,53,27,26,59
Lucerne,7659,3,14,7,11,42,42,0,49
St Gallen,7659,4,14,2,16,45,57,-12,44
FC Zürich,7659,5,10,10,12,37,35,2,40
FC Lugano,7659,6,11,5,16,30,47,-17,38
FC Thun,7659,7,10,7,15,45,56,-11,37
Grasshoppers,7659,8,10,6,16,41,54,-13,36
FC Sion,7659,9,6,8,18,42,58,-16,26
Young Boys,7660,1,19,9,4,65,36,29,66
FC Basel,7660,2,18,9,5,56,24,32,63
St Gallen,7660,3,15,3,14,52,58,-6,48
Lucerne,7660,4,12,9,11,41,47,-6,45
FC Zürich,7660,5,9,12,11,39,36,3,39
Grasshoppers,7660,6,10,7,15,41,47,-6,37
FC Lugano,7660,7,9,8,15,29,47,-18,35
FC Thun,7660,8,9,7,16,42,59,-17,34
FC Sion,7660,9,7,8,17,44,55,-11,29
Young Boys,7661,1,22,6,4,73,34,39,72
FC Basel,7661,2,17,8,7,52,27,25,59
Lucerne,7661,3,13,10,9,46,45,1,49
St Gallen,7661,4,14,4,14,44,55,-11,46
FC Zürich,7661,5,11,10,11,42,34,8,43
FC Thun,7661,6,11,5,16,43,57,-14,38
Grasshoppers,7661,7,9,8,15,44,51,-7,35
FC Lugano,7661,8,9,7,16,30,48,-18,34
FC Sion,7661,9,5,8,19,36,59,-23,23
Young Boys,7662,1,22,8,2,71,31,40,74
FC Basel,7662,2,18,7,7,64,31,33,61
Lucerne,7662,3,13,9,10,42,45,-3,48
St Gallen,7662,4,15,3,14,45,55,-10,48
FC Zürich,7662,5,11,10,11,41,35,6,43
FC Lugano,7662,6,9,7,16,30,47,-17,34
Grasshoppers,7662,7,9,6,17,39,48,-9,33
FC Thun,7662,8,9,5,18,43,65,-22,32
FC Sion,7662,9,7,7,18,37,55,-18,28
Young Boys,7663,1,21,7,4,70,35,35,70
FC Basel,7663,2,18,8,6,53,25,28,62
Lucerne,7663,3,13,9,10,42,41,1,48
St Gallen,7663,4,15,3,14,44,53,-9,48
FC Zürich,7663,5,11,9,12,39,36,3,42
FC Lugano,7663,6,11,5,16,30,46,-16,38
FC Thun,7663,7,10,5,17,42,55,-13,35
Grasshoppers,7663,8,9,7,16,40,52,-12,34
FC Sion,7663,9,6,7,19,37,54,-17,25
Young Boys,7664,1,22,8,2,73,34,39,74
FC Basel,7664,2,17,8,7,52,27,25,59
Lucerne,7664,3,13,9,10,43,41,2,48
St Gallen,7664,4,15,2,15,42,54,-12,47
FC Zürich,7664,5,11,9,12,42,41,1,42
Grasshoppers,7664,6,10,6,16,44,51,-7,36
FC Thun,7664,7,10,5,17,47,61,-14,35
FC Lugano,7664,8,10,5,17,31,47,-16,35
FC Sion,7664,9,6,8,18,38,56,-18,26
Young Boys,7665,1,23,7,2,83,37,46,76
FC Basel,7665,2,16,10,6,56,28,28,58
Lucerne,7665,3,13,8,11,42,47,-5,47
St Gallen,7665,4,14,2,16,43,59,-16,44
FC Zürich,7665,5,10,12,10,40,34,6,42
FC Lugano,7665,6,10,7,15,30,49,-19,37
Grasshoppers,7665,7,8,8,16,38,51,-13,32
FC Thun,7665,8,8,7,17,39,57,-18,31
FC Sion,7665,9,7,9,16,43,52,-9,30
Young Boys,7666,1,23,6,3,71,32,39,75
FC Basel,7666,2,19,7,6,58,24,34,64
St Gallen,7666,3,16,2,14,43,52,-9,50
FC Zürich,7666,4,11,10,11,44,39,5,43
Lucerne,7666,5,12,7,13,43,46,-3,43
FC Lugano,7666,6,10,6,16,32,50,-18,36
FC Thun,7666,7,10,5,17,45,60,-15,35
Grasshoppers,7666,8,9,6,17,37,51,-14,33
FC Sion,7666,9,6,7,19,38,57,-19,25
Young Boys,7667,1,20,8,4,71,39,32,68
FC Basel,7667,2,19,7,6,60,25,35,64
St Gallen,7667,3,15,2,15,45,59,-14,47
Lucerne,7667,4,11,9,12,41,47,-6,42
FC Zürich,7667,5,10,9,13,38,36,2,39
FC Lugano,7667,6,11,6,15,34,49,-15,39
Grasshoppers,7667,7,9,9,14,42,49,-7,36
FC Thun,7667,8,9,6,17,42,63,-21,33
FC Sion,7667,9,8,8,16,44,50,-6,32
Young Boys,7668,1,21,7,4,71,36,35,70
FC Basel,7668,2,18,8,6,52,25,27,62
Lucerne,7668,3,14,8,10,44,41,3,50
FC Zürich,7668,4,12,10,10,42,35,7,46
St Gallen,7668,5,13,3,16,42,59,-17,42
FC Lugano,7668,6,10,7,15,32,46,-14,37
Grasshoppers,7668,7,9,7,16,40,49,-9,34
FC Thun,7668,8,8,7,17,44,61,-17,31
FC Sion,7668,9,6,9,17,40,55,-15,27
Young Boys,7669,1,21,7,4,71,36,35,70
FC Basel,7669,2,17,10,5,52,25,27,61
Lucerne,7669,3,14,8,10,45,41,4,50
St Gallen,7669,4,13,3,16,42,60,-18,42
FC Zürich,7669,5,9,11,12,38,36,2,38
Grasshoppers,7669,6,10,7,15,40,49,-9,37
FC Thun,7669,7,10,6,16,43,56,-13,36
FC Lugano,7669,8,9,7,16,33,52,-19,34
FC Sion,7669,9,7,9,16,40,49,-9,30
Young Boys,7670,1,22,8,2,76,36,40,74
FC Basel,7670,2,18,8,6,59,31,28,62
Lucerne,7670,3,14,7,11,42,43,-1,49
St Gallen,7670,4,15,2,15,46,58,-12,47
FC Zürich,7670,5,11,9,12,41,38,3,42
FC Thun,7670,6,12,5,15,49,55,-6,41
Grasshoppers,7670,7,9,6,17,40,51,-11,33
FC Lugano,7670,8,9,6,17,34,52,-18,33
FC Sion,7670,9,5,7,20,37,60,-23,22
Young Boys,7671,1,20,7,5,68,38,30,67
FC Basel,7671,2,19,7,6,62,26,36,64
Lucerne,7671,3,15,8,9,49,44,5,53
St Gallen,7671,4,14,4,14,42,60,-18,46
FC Zürich,7671,5,11,9,12,42,38,4,42
Grasshoppers,7671,6,10,7,15,44,48,-4,37
FC Lugano,7671,7,10,6,16,33,50,-17,36
FC Thun,7671,8,8,5,19,43,66,-23,29
FC Sion,7671,9,6,9,17,42,55,-13,27
Young Boys,7672,1,21,8,3,68,36,32,71
FC Basel,7672,2,17,8,7,54,28,26,59
St Gallen,7672,3,15,3,14,42,52,-10,48
Lucerne,7672,4,13,7,12,44,44,0,46
FC Zürich,7672,5,10,11,11,40,36,4,41
Grasshoppers,7672,6,10,7,15,43,48,-5,37
FC Lugano,7672,7,9,7,16,30,48,-18,34
FC Thun,7672,8,9,6,17,43,60,-17,33
FC Sion,7672,9,7,9,16,40,52,-12,30
Young Boys,7673,1,21,7,4,69,37,32,70
FC Basel,7673,2,17,8,7,50,26,24,59
St Gallen,7673,3,16,3,13,48,53,-5,51
Lucerne,7673,4,13,8,11,42,44,-2,47
FC Zürich,7673,5,10,11,11,39,34,5,41
FC Lugano,7673,6,11,5,16,33,46,-13,38
Grasshoppers,7673,7,8,9,15,40,49,-9,33
FC Thun,7673,8,8,8,16,41,58,-17,32
FC Sion,7673,9,6,9,17,41,56,-15,27
Young Boys,7674,1,21,8,3,72,34,38,71
FC Basel,7674,2,15,11,6,50,26,24,56
St Gallen,7674,3,15,3,14,46,54,-8,48
FC Zürich,7674,4,12,9,11,43,37,6,45
Lucerne,7674,5,11,9,12,42,50,-8,42
Grasshoppers,7674,6,10,8,14,43,49,-6,38
FC Lugano,7674,7,10,6,16,34,49,-15,36
FC Thun,7674,8,9,7,16,44,60,-16,34
FC Sion,7674,9,7,7,18,41,56,-15,28
Young Boys,7675,1,21,7,4,74,39,35,70
FC Basel,7675,2,18,7,7,58,27,31,61
Lucerne,7675,3,13,8,11,49,49,0,47
St Gallen,7675,4,14,2,16,42,56,-14,44
FC Zürich,7675,5,11,9,12,43,40,3,42
FC Thun,7675,6,12,5,15,51,58,-7,41
FC Lugano,7675,7,11,6,15,31,44,-13,39
Grasshoppers,7675,8,8,6,18,40,58,-18,30
FC Sion,7675,9,7,8,17,42,59,-17,29
Young Boys,7676,1,22,7,3,74,33,41,73
FC Basel,7676,2,16,10,6,52,26,26,58
Lucerne,7676,3,13,8,11,43,47,-4,47
St Gallen,7676,4,15,2,15,46,55,-9,47
FC Zürich,7676,5,12,10,10,44,34,10,46
Grasshoppers,7676,6,10,7,15,46,53,-7,37
FC Lugano,7676,7,10,6,16,30,48,-18,36
FC Thun,7676,8,9,6,17,43,62,-19,33
FC Sion,7676,9,5,8,19,37,57,-20,23
Young Boys,7677,1,23,7,2,74,34,40,76
FC Basel,7677,2,17,8,7,51,26,25,59
St Gallen,7677,3,16,2,14,48,53,-5,50
Lucerne,7677,4,13,7,12,46,44,2,46
FC Zürich,7677,5,11,11,10,41,32,9,44
FC Thun,7677,6,10,5,17,45,60,-15,35
FC Lugano,7677,7,9,6,17,28,51,-23,33
Grasshoppers,7677,8,8,8,16,39,52,-13,32
FC Sion,7677,9,6,8,18,41,61,-20,26
Young Boys,7678,1,23,6,3,75,34,41,75
FC Basel,7678,2,19,8,5,56,25,31,65
FC Zürich,7678,3,12,9,11,41,35,6,45
St Gallen,7678,4,14,3,15,45,57,-12,45
Lucerne,7678,5,12,8,12,40,45,-5,44
Grasshoppers,7678,6,11,6,15,43,46,-3,39
FC Lugano,7678,7,10,5,17,29,49,-20,35
FC Thun,7678,8,9,5,18,44,58,-14,32
FC Sion,7678,9,5,8,19,38,62,-24,23
Young Boys,7679,1,20,8,4,72,39,33,68
FC Basel,7679,2,17,9,6,55,28,27,60
St Gallen,7679,3,15,2,15,47,58,-11,47
Lucerne,7679,4,11,10,11,42,47,-5,43
FC Zürich,7679,5,10,10,12,41,38,3,40
Grasshoppers,7679,6,11,6,15,45,51,-6,39
FC Lugano,7679,7,11,6,15,37,49,-12,39
FC Thun,7679,8,10,5,17,41,58,-17,35
FC Sion,7679,9,7,8,17,41,53,-12,29
Young Boys,7680,1,21,7,4,71,37,34,70
FC Basel,7680,2,15,9,8,50,28,22,54
St Gallen,7680,3,17,2,13,45,51,-6,53
Lucerne,7680,4,14,7,11,44,48,-4,49
FC Zürich,7680,5,12,9,11,45,37,8,45
Grasshoppers,7680,6,10,6,16,42,47,-5,36
FC Lugano,7680,7,10,5,17,32,49,-17,35
FC Thun,7680,8,9,6,17,43,60,-17,33
FC Sion,7680,9,7,7,18,40,55,-15,28
Young Boys,7681,1,22,7,3,74,33,41,73
FC Basel,7681,2,18,8,6,57,28,29,62
St Gallen,7681,3,14,3,15,44,59,-15,45
FC Lugano,7681,4,12,6,14,36,47,-11,42
Lucerne,7681,5,11,7,14,41,51,-10,40
FC Zürich,7681,6,10,9,13,42,39,3,39
FC Thun,7681,7,11,5,16,47,61,-14,38
Grasshoppers,7681,8,10,6,16,42,50,-8,36
FC Sion,7681,9,7,7,18,42,57,-15,28
Young Boys,7682,1,21,9,2,69,31,38,72
FC Basel,7682,2,18,9,5,51,22,29,63
St Gallen,7682,3,15,4,13,43,51,-8,49
Lucerne,7682,4,13,7,12,39,43,-4,46
FC Zürich,7682,5,11,9,12,40,36,4,42
FC Lugano,7682,6,10,6,16,30,46,-16,36
Grasshoppers,7682,7,9,7,16,40,50,-10,34
FC Thun,7682,8,9,6,17,43,59,-16,33
FC Sion,7682,9,5,9,18,40,57,-17,24
Young Boys,7683,1,21,7,4,69,33,36,70
FC Basel,7683,2,17,9,6,57,28,29,60
Lucerne,7683,3,13,9,10,46,46,0,48
FC Zürich,7683,4,12,10,10,45,34,11,46
St Gallen,7683,5,13,4,15,42,55,-13,43
FC Lugano,7683,6,10,7,15,32,48,-16,37
Grasshoppers,7683,7,10,6,16,39,48,-9,36
FC Thun,7683,8,9,6,17,42,62,-20,33
FC Sion,7683,9,6,8,18,38,56,-18,26
FC Basel,7684,1,19,8,5,55,23,32,65
Young Boys,7684,2,19,7,6,70,42,28,64
Lucerne,7684,3,13,9,10,42,41,1,48
St Gallen,7684,4,13,5,14,41,53,-12,44
FC Zürich,7684,5,10,10,12,39,39,0,40
FC Lugano,7684,6,11,5,16,31,46,-15,38
FC Sion,7684,7,9,8,15,47,52,-5,35
Grasshoppers,7684,8,9,6,17,43,55,-12,33
FC Thun,7684,9,9,6,17,44,61,-17,33
Young Boys,7685,1,21,8,3,73,35,38,71
FC Basel,7685,2,18,9,5,54,25,29,63
Lucerne,7685,3,13,9,10,47,44,3,48
St Gallen,7685,4,15,3,14,46,56,-10,48
FC Zürich,7685,5,11,11,10,46,36,10,44
Grasshoppers,7685,6,9,9,14,40,47,-7,36
FC Thun,7685,7,9,6,17,45,62,-17,33
FC Lugano,7685,8,9,6,17,30,55,-25,33
FC Sion,7685,9,5,7,20,36,57,-21,22
Young Boys,7686,1,22,6,4,73,39,34,72
FC Basel,7686,2,20,7,5,58,21,37,67
Lucerne,7686,3,13,7,12,42,45,-3,46
St Gallen,7686,4,14,2,16,40,57,-17,44
FC Zürich,7686,5,11,10,11,39,35,4,43
FC Lugano,7686,6,10,6,16,30,46,-16,36
FC Thun,7686,7,10,5,17,46,59,-13,35
FC Sion,7686,8,8,7,17,46,54,-8,31
Grasshoppers,7686,9,8,6,18,40,58,-18,30
Young Boys,7687,1,22,7,3,74,34,40,73
FC Basel,7687,2,16,8,8,51,33,18,56
St Gallen,7687,3,14,4,14,41,52,-11,46
Lucerne,7687,4,11,10,11,43,47,-4,43
FC Zürich,7687,5,11,9,12,43,38,5,42
FC Thun,7687,6,12,5,15,51,57,-6,41
FC Lugano,7687,7,10,6,16,32,48,-16,36
Grasshoppers,7687,8,8,9,15,41,51,-10,33
FC Sion,7687,9,7,8,17,39,55,-16,29
Young Boys,7688,1,22,7,3,77,37,40,73
FC Basel,7688,2,18,8,6,57,25,32,62
Lucerne,7688,3,14,7,11,46,50,-4,49
St Gallen,7688,4,15,3,14,46,56,-10,48
FC Zürich,7688,5,10,11,11,42,37,5,41
FC Lugano,7688,6,10,5,17,30,49,-19,35
Grasshoppers,7688,7,9,7,16,42,53,-11,34
FC Thun,7688,8,8,7,17,42,60,-18,31
FC Sion,7688,9,5,11,16,41,56,-15,26
Young Boys,7689,1,21,7,4,67,35,32,70
FC Basel,7689,2,16,8,8,50,25,25,56
Lucerne,7689,3,15,7,10,46,42,4,52
St Gallen,7689,4,15,2,15,42,53,-11,47
Grasshoppers,7689,5,12,6,14,46,48,-2,42
FC Zürich,7689,6,9,11,12,38,36,2,38
FC Lugano,7689,7,10,5,17,30,47,-17,35
FC Thun,7689,8,9,5,18,42,63,-21,32
FC Sion,7689,9,7,9,16,39,51,-12,30
Young Boys,7690,1,21,8,3,70,37,33,71
FC Basel,7690,2,17,8,7,52,26,26,59
St Gallen,7690,3,15,3,14,48,54,-6,48
Lucerne,7690,4,13,8,11,47,44,3,47
FC Zürich,7690,5,12,10,10,45,34,11,46
Grasshoppers,7690,6,10,7,15,44,56,-12,37
FC Thun,7690,7,10,5,17,43,59,-16,35
FC Lugano,7690,8,9,6,17,31,53,-22,33
FC Sion,7690,9,5,9,18,42,59,-17,24
Young Boys,7691,1,22,6,4,74,38,36,72
FC Basel,7691,2,19,8,5,59,25,34,65
St Gallen,7691,3,16,2,14,46,55,-9,50
Lucerne,7691,4,12,8,12,41,43,-2,44
FC Zürich,7691,5,10,10,12,40,38,2,40
FC Thun,7691,6,10,5,17,44,60,-16,35
FC Lugano,7691,7,10,5,17,31,51,-20,35
FC Sion,7691,8,8,7,17,43,54,-11,31
Grasshoppers,7691,9,8,7,17,38,52,-14,31
Young Boys,7692,1,21,8,3,74,40,34,71
FC Basel,7692,2,18,7,7,58,26,32,61
FC Zürich,7692,3,13,9,10,43,33,10,48
St Gallen,7692,4,15,3,14,45,55,-10,48
Lucerne,7692,5,11,8,13,40,50,-10,41
FC Lugano,7692,6,11,5,16,33,48,-15,38
Grasshoppers,7692,7,10,7,15,42,47,-5,37
FC Thun,7692,8,9,5,18,41,60,-19,32
FC Sion,7692,9,6,8,18,42,59,-17,26
Young Boys,7693,1,20,9,3,71,37,34,69
FC Basel,7693,2,18,9,5,61,27,34,63
Lucerne,7693,3,14,8,10,44,42,2,50
St Gallen,7693,4,15,2,15,42,55,-13,47
FC Zürich,7693,5,10,10,12,41,39,2,40
FC Lugano,7693,6,10,6,16,31,46,-15,36
FC Thun,7693,7,10,5,17,43,62,-19,35
Grasshoppers,7693,8,9,6,17,41,49,-8,33
FC Sion,7693,9,7,7,18,39,56,-17,28
Young Boys,7694,1,21,8,3,73,36,37,71
FC Basel,7694,2,16,10,6,55,26,29,58
Lucerne,7694,3,13,9,10,39,41,-2,48
St Gallen,7694,4,14,4,14,43,54,-11,46
FC Zürich,7694,5,10,11,11,41,36,5,41
Grasshoppers,7694,6,10,7,15,41,48,-7,37
FC Lugano,7694,7,10,7,15,31,46,-15,37
FC Thun,7694,8,9,6,17,44,65,-21,33
FC Sion,7694,9,5,10,17,40,55,-15,25
Young Boys,7695,1,22,7,3,73,33,40,73
FC Basel,7695,2,18,8,6,54,27,27,62
Lucerne,7695,3,12,8,12,44,49,-5,44
St Gallen,7695,4,13,4,15,42,56,-14,43
FC Zürich,7695,5,11,9,12,42,35,7,42
Grasshoppers,7695,6,11,7,14,44,47,-3,40
FC Thun,7695,7,11,5,16,44,57,-13,38
FC Lugano,7695,8,10,5,17,31,52,-21,35
FC Sion,7695,9,6,7,19,38,56,-18,25
Young Boys,7696,1,20,9,3,69,36,33,69
FC Basel,7696,2,18,8,6,54,25,29,62
FC Zürich,7696,3,13,9,10,42,33,9,48
Lucerne,7696,4,13,8,11,39,41,-2,47
St Gallen,7696,5,14,4,14,46,59,-13,46
FC Lugano,7696,6,10,6,16,32,45,-13,36
Grasshoppers,7696,7,9,8,15,44,52,-8,35
FC Thun,7696,8,9,5,18,43,62,-19,32
FC Sion,7696,9,5,9,18,44,60,-16,24
Young Boys,7697,1,21,6,5,71,39,32,69
FC Basel,7697,2,18,8,6,51,24,27,62
Lucerne,7697,3,14,7,11,42,40,2,49
FC Zürich,7697,4,11,9,12,41,36,5,42
St Gallen,7697,5,13,3,16,40,54,-14,42
Grasshoppers,7697,6,11,6,15,43,47,-4,39
FC Sion,7697,7,9,7,16,45,52,-7,34
FC Thun,7697,8,9,6,17,39,57,-18,33
FC Lugano,7697,9,9,6,17,28,51,-23,33
Young Boys,7698,1,20,8,4,69,35,34,68
FC Basel,7698,2,17,9,6,57,31,26,60
FC Zürich,7698,3,12,9,11,47,38,9,45
St Gallen,7698,4,14,3,15,45,57,-12,45
Lucerne,7698,5,11,9,12,40,45,-5,42
FC Lugano,7698,6,11,5,16,34,49,-15,38
Grasshoppers,7698,7,10,6,16,41,51,-10,36
FC Thun,7698,8,10,6,16,46,61,-15,36
FC Sion,7698,9,8,7,17,43,55,-12,31
Young Boys,7699,1,21,9,2,72,34,38,72
FC Basel,7699,2,18,8,6,55,26,29,62
Lucerne,7699,3,12,9,11,43,46,-3,45
St Gallen,7699,4,13,4,15,44,58,-14,43
FC Zürich,7699,5,10,11,11,41,38,3,41
FC Lugano,7699,6,10,6,16,33,50,-17,36
FC Thun,7699,7,10,5,17,45,57,-12,35
Grasshoppers,7699,8,9,7,16,40,51,-11,34
FC Sion,7699,9,7,9,16,41,54,-13,30
Young Boys,7700,1,23,7,2,79,33,46,76
FC Basel,7700,2,17,8,7,50,28,22,59
St Gallen,7700,3,16,3,13,48,52,-4,51
FC Zürich,7700,4,10,11,11,43,39,4,41
Lucerne,7700,5,11,8,13,39,48,-9,41
FC Lugano,7700,6,10,6,16,29,50,-21,36
FC Thun,7700,7,10,5,17,44,58,-14,35
Grasshoppers,7700,8,9,7,16,42,51,-9,34
FC Sion,7700,9,6,9,17,43,58,-15,27
Young Boys,7701,1,20,10,2,71,36,35,70
FC Basel,7701,2,17,8,7,52,23,29,59
Lucerne,7701,3,14,8,10,46,45,1,50
FC Zürich,7701,4,11,10,11,38,34,4,43
St Gallen,7701,5,13,3,16,42,58,-16,42
FC Thun,7701,6,11,5,16,46,58,-12,38
FC Lugano,7701,7,10,6,16,32,48,-16,36
Grasshoppers,7701,8,9,7,16,42,52,-10,34
FC Sion,7701,9,6,9,17,40,55,-15,27
Young Boys,7702,1,23,6,3,72,33,39,75
FC Basel,7702,2,19,7,6,53,23,30,64
St Gallen,7702,3,14,4,14,43,55,-12,46
FC Zürich,7702,4,12,9,11,43,34,9,45
Lucerne,7702,5,12,8,12,39,44,-5,44
FC Lugano,7702,6,11,6,15,33,47,-14,39
FC Thun,7702,7,10,5,17,42,55,-13,35
Grasshoppers,7702,8,9,6,17,38,52,-14,33
FC Sion,7702,9,5,7,20,37,57,-20,22
Young Boys,7703,1,21,7,4,69,34,35,70
FC Basel,7703,2,17,7,8,55,26,29,58
St Gallen,7703,3,15,2,15,43,54,-11,47
Lucerne,7703,4,12,9,11,39,46,-7,45
FC Zürich,7703,5,11,10,11,47,36,11,43
FC Thun,7703,6,11,6,15,43,55,-12,39
FC Lugano,7703,7,10,7,15,29,45,-16,37
Grasshoppers,7703,8,9,9,14,38,45,-7,36
FC Sion,7703,9,6,7,19,36,58,-22,25
FC Basel,7704,1,20,7,5,58,24,34,67
Young Boys,7704,2,20,6,6,65,37,28,66
Lucerne,7704,3,13,9,10,43,44,-1,48
St Gallen,7704,4,14,3,15,43,58,-15,45
FC Zürich,7704,5,10,10,12,44,40,4,40
Grasshoppers,7704,6,10,7,15,47,51,-4,37
FC Thun,7704,7,10,5,17,46,62,-16,35
FC Lugano,7704,8,9,6,17,31,49,-18,33
FC Sion,7704,9,8,7,17,45,57,-12,31
Young Boys,7705,1,23,7,2,75,34,41,76
FC Basel,7705,2,18,7,7,53,29,24,61
Lucerne,7705,3,13,8,11,43,44,-1,47
St Gallen,7705,4,15,2,15,44,54,-10,47
FC Zürich,7705,5,11,9,12,42,39,3,42
FC Lugano,7705,6,11,5,16,32,47,-15,38
Grasshoppers,7705,7,8,8,16,40,50,-10,32
FC Thun,7705,8,9,5,18,46,64,-18,32
FC Sion,7705,9,7,7,18,41,55,-14,28
Young Boys,7706,1,22,7,3,72,34,38,73
FC Basel,7706,2,17,8,7,51,28,23,59
St Gallen,7706,3,15,2,15,45,55,-10,47
Lucerne,7706,4,12,9,11,42,45,-3,45
FC Zürich,7706,5,11,9,12,39,34,5,42
FC Lugano,7706,6,12,5,15,34,47,-13,41
Grasshoppers,7706,7,10,7,15,47,52,-5,37
FC Sion,7706,8,7,8,17,42,54,-12,29
FC Thun,7706,9,8,5,19,42,65,-23,29
Young Boys,7707,1,23,6,3,74,33,41,75
FC Basel,7707,2,18,7,7,50,25,25,61
St Gallen,7707,3,15,2,15,45,56,-11,47
FC Zürich,7707,4,10,12,10,40,35,5,42
Lucerne,7707,5,11,8,13,38,48,-10,41
Grasshoppers,7707,6,10,6,16,40,47,-7,36
FC Sion,7707,7,9,8,15,45,50,-5,35
FC Lugano,7707,8,9,7,16,31,49,-18,34
FC Thun,7707,9,8,6,18,39,59,-20,30
Young Boys,7708,1,22,8,2,71,31,40,74
FC Basel,7708,2,17,9,6,54,26,28,60
Lucerne,7708,3,13,8,11,43,45,-2,47
St Gallen,7708,4,14,2,16,42,59,-17,44
FC Zürich,7708,5,11,9,12,42,37,5,42
FC Lugano,7708,6,11,5,16,33,48,-15,38
Grasshoppers,7708,7,10,7,15,45,51,-6,37
FC Sion,7708,8,8,7,17,40,53,-13,31
FC Thun,7708,9,8,5,19,45,65,-20,29
Young Boys,7709,1,23,7,2,76,32,44,76
FC Basel,7709,2,18,7,7,53,28,25,61
Lucerne,7709,3,13,9,10,42,41,1,48
FC Zürich,7709,4,10,12,10,39,33,6,42
St Gallen,7709,5,13,2,17,40,59,-19,41
FC Lugano,7709,6,10,6,16,31,47,-16,36
FC Thun,7709,7,9,7,16,44,58,-14,34
Grasshoppers,7709,8,8,8,16,39,51,-12,32
FC Sion,7709,9,6,10,16,39,54,-15,28
Young Boys,7710,1,21,7,4,72,36,36,70
FC Basel,7710,2,18,7,7,52,27,25,61
Lucerne,7710,3,13,9,10,41,43,-2,48
FC Zürich,7710,4,12,9,11,45,37,8,45
St Gallen,7710,5,14,3,15,42,53,-11,45
Grasshoppers,7710,6,10,8,14,46,52,-6,38
FC Lugano,7710,7,10,6,16,31,47,-16,36
FC Thun,7710,8,8,6,18,41,61,-20,30
FC Sion,7710,9,5,11,16,42,56,-14,26
Young Boys,7711,1,23,6,3,75,35,40,75
FC Basel,7711,2,18,9,5,57,27,30,63
FC Zürich,7711,3,12,10,10,48,37,11,46
Lucerne,7711,4,13,7,12,45,44,1,46
St Gallen,7711,5,14,2,16,40,60,-20,44
Grasshoppers,7711,6,10,6,16,40,49,-9,36
FC Lugano,7711,7,10,5,17,31,51,-20,35
FC Thun,7711,8,9,6,17,43,59,-16,33
FC Sion,7711,9,6,7,19,42,59,-17,25
Young Boys,7712,1,21,7,4,72,37,35,70
FC Basel,7712,2,15,11,6,55,31,24,56
St Gallen,7712,3,15,2,15,43,57,-14,47
Lucerne,7712,4,12,8,12,40,45,-5,44
FC Zürich,7712,5,10,11,11,41,36,5,41
Grasshoppers,7712,6,11,7,14,42,45,-3,40
FC Lugano,7712,7,11,5,16,31,45,-14,38
FC Thun,7712,8,9,7,16,47,62,-15,34
FC Sion,7712,9,7,8,17,41,54,-13,29
Young Boys,7713,1,22,8,2,72,34,38,74
FC Basel,7713,2,17,9,6,55,29,26,60
St Gallen,7713,3,15,2,15,45,56,-11,47
Lucerne,7713,4,11,9,12,40,45,-5,42
FC Lugano,7713,5,11,7,14,37,46,-9,40
FC Thun,7713,6,11,6,15,46,56,-10,39
FC Zürich,7713,7,9,11,12,39,40,-1,38
Grasshoppers,7713,8,8,8,16,41,53,-12,32
FC Sion,7713,9,6,8,18,39,55,-16,26
Young Boys,7714,1,20,9,3,71,38,33,69
FC Basel,7714,2,18,9,5,53,22,31,63
St Gallen,7714,3,14,3,15,42,55,-13,45
Lucerne,7714,4,12,8,12,39,43,-4,44
FC Lugano,7714,5,11,6,15,36,47,-11,39
FC Zürich,7714,6,9,11,12,38,39,-1,38
FC Thun,7714,7,10,6,16,45,58,-13,36
Grasshoppers,7714,8,9,8,15,40,48,-8,35
FC Sion,7714,9,6,10,16,42,56,-14,28
Young Boys,7715,1,21,6,5,71,36,35,69
FC Basel,7715,2,17,9,6,54,27,27,60
FC Zürich,7715,3,12,10,10,43,34,9,46
Lucerne,7715,4,12,9,11,40,44,-4,45
St Gallen,7715,5,13,3,16,41,58,-17,42
Grasshoppers,7715,6,10,7,15,42,48,-6,37
FC Lugano,7715,7,10,7,15,31,45,-14,37
FC Thun,7715,8,9,6,17,44,63,-19,33
FC Sion,7715,9,8,7,17,43,54,-11,31
Young Boys,7716,1,21,8,3,68,33,35,71
FC Basel,7716,2,17,10,5,55,25,30,61
Lucerne,7716,3,13,10,9,41,39,2,49
St Gallen,7716,4,14,4,14,42,51,-9,46
FC Zürich,7716,5,10,11,11,42,38,4,41
FC Thun,7716,6,10,5,17,47,62,-15,35
FC Lugano,7716,7,10,5,17,29,48,-19,35
Grasshoppers,7716,8,8,7,17,39,53,-14,31
FC Sion,7716,9,6,10,16,44,58,-14,28
Young Boys,7717,1,22,8,2,72,33,39,74
FC Basel,7717,2,16,9,7,50,25,25,57
St Gallen,7717,3,14,5,13,43,53,-10,47
FC Zürich,7717,4,11,11,10,38,32,6,44
Lucerne,7717,5,12,8,12,37,43,-6,44
Grasshoppers,7717,6,10,7,15,43,49,-6,37
FC Lugano,7717,7,10,7,15,30,44,-14,37
FC Thun,7717,8,9,5,18,43,61,-18,32
FC Sion,7717,9,6,8,18,40,56,-16,26
Young Boys,7718,1,20,8,4,69,35,34,68
FC Basel,7718,2,16,10,6,53,28,25,58
Lucerne,7718,3,15,7,10,50,45,5,52
FC Zürich,7718,4,11,11,10,43,35,8,44
St Gallen,7718,5,13,4,15,41,55,-14,43
Grasshoppers,7718,6,10,8,14,42,48,-6,38
FC Lugano,7718,7,9,7,16,28,48,-20,34
FC Thun,7718,8,8,7,17,40,57,-17,31
FC Sion,7718,9,6,10,16,39,54,-15,28
Young Boys,7719,1,20,8,4,70,38,32,68
FC Basel,7719,2,19,7,6,57,27,30,64
St Gallen,7719,3,14,4,14,42,55,-13,46
Lucerne,7719,4,12,9,11,40,43,-3,45
FC Zürich,7719,5,11,10,11,49,40,9,43
Grasshoppers,7719,6,10,7,15,44,48,-4,37
FC Thun,7719,7,10,6,16,43,60,-17,36
FC Lugano,7719,8,10,5,17,34,50,-16,35
FC Sion,7719,9,6,8,18,41,59,-18,26
Young Boys,7720,1,22,6,4,73,36,37,72
FC Basel,7720,2,17,9,6,55,26,29,60
Lucerne,7720,3,14,8,10,49,44,5,50
FC Zürich,7720,4,12,10,10,43,35,8,46
St Gallen,7720,5,14,3,15,41,56,-15,45
FC Thun,7720,6,9,6,17,40,58,-18,33
FC Sion,7720,7,8,8,16,39,49,-10,32
FC Lugano,7720,8,9,5,18,31,53,-22,32
Grasshoppers,7720,9,8,7,17,39,53,-14,31
Young Boys,7721,1,21,6,5,67,34,33,69
FC Basel,7721,2,18,9,5,59,28,31,63
Lucerne,7721,3,13,10,9,44,42,2,49
St Gallen,7721,4,14,2,16,44,56,-12,44
FC Lugano,7721,5,11,6,15,35,47,-12,39
Grasshoppers,7721,6,10,7,15,41,47,-6,37
FC Thun,7721,7,10,7,15,45,57,-12,37
FC Zürich,7721,8,9,9,14,36,41,-5,36
FC Sion,7721,9,6,8,18,35,54,-19,26
Young Boys,7722,1,22,8,2,78,34,44,74
FC Basel,7722,2,17,9,6,55,24,31,60
Lucerne,7722,3,14,8,10,44,43,1,50
FC Zürich,7722,4,11,11,10,43,33,10,44
St Gallen,7722,5,13,2,17,40,62,-22,41
Grasshoppers,7722,6,10,8,14,41,47,-6,38
FC Lugano,7722,7,10,6,16,30,50,-20,36
FC Thun,7722,8,9,5,18,43,63,-20,32
FC Sion,7722,9,6,7,19,41,59,-18,25
Young Boys,7723,1,22,8,2,75,35,40,74
FC Basel,7723,2,18,8,6,60,30,30,62
St Gallen,7723,3,15,3,14,43,53,-10,48
Lucerne,7723,4,12,9,11,44,47,-3,45
FC Zürich,7723,5,10,11,11,41,37,4,41
FC Thun,7723,6,10,6,16,49,59,-10,36
FC Lugano,7723,7,9,8,15,30,46,-16,35
Grasshoppers,7723,8,8,7,17,37,53,-16,31
FC Sion,7723,9,6,8,18,40,59,-19,26
Young Boys,7724,1,22,7,3,73,36,37,73
FC Basel,7724,2,16,9,7,51,26,25,57
St Gallen,7724,3,15,4,13,45,54,-9,49
FC Zürich,7724,4,12,10,10,45,34,11,46
Lucerne,7724,5,13,7,12,45,48,-3,46
Grasshoppers,7724,6,10,7,15,39,46,-7,37
FC Thun,7724,7,9,7,16,40,57,-17,34
FC Lugano,7724,8,9,7,16,33,51,-18,34
FC Sion,7724,9,5,8,19,38,57,-19,23
Young Boys,7725,1,22,7,3,72,32,40,73
FC Basel,7725,2,19,8,5,56,24,32,65
St Gallen,7725,3,16,3,13,49,51,-2,51
Lucerne,7725,4,12,8,12,41,47,-6,44
FC Zürich,7725,5,10,9,13,38,37,1,39
FC Lugano,7725,6,10,7,15,33,49,-16,37
Grasshoppers,7725,7,9,6,17,41,54,-13,33
FC Thun,7725,8,9,5,18,41,61,-20,32
FC Sion,7725,9,7,7,18,39,55,-16,28
Young Boys,7726,1,21,7,4,76,37,39,70
FC Basel,7726,2,17,10,5,56,25,31,61
Lucerne,7726,3,13,8,11,39,43,-4,47
St Gallen,7726,4,13,4,15,40,53,-13,43
FC Zürich,7726,5,9,13,10,41,37,4,40
FC Lugano,7726,6,11,6,15,31,45,-14,39
Grasshoppers,7726,7,10,7,15,46,47,-1,37
FC Thun,7726,8,9,7,16,44,62,-18,34
FC Sion,7726,9,6,8,18,40,64,-24,26
Young Boys,7727,1,20,6,6,68,36,32,66
FC Basel,7727,2,17,8,7,53,27,26,59
Lucerne,7727,3,14,8,10,46,45,1,50
St Gallen,7727,4,14,3,15,47,60,-13,45
FC Zürich,7727,5,10,10,12,38,37,1,40
FC Lugano,7727,6,11,5,16,34,48,-14,38
Grasshoppers,7727,7,10,7,15,42,50,-8,37
FC Thun,7727,8,10,6,16,45,57,-12,36
FC Sion,7727,9,7,9,16,41,54,-13,30
Young Boys,7728,1,22,8,2,74,31,43,74
FC Basel,7728,2,19,8,5,52,21,31,65
Lucerne,7728,3,14,8,10,44,41,3,50
St Gallen,7728,4,14,2,16,42,56,-14,44
FC Zürich,7728,5,10,10,12,39,37,2,40
FC Lugano,7728,6,11,5,16,34,49,-15,38
FC Thun,7728,7,9,6,17,42,59,-17,33
Grasshoppers,7728,8,8,7,17,40,53,-13,31
FC Sion,7728,9,6,8,18,39,59,-20,26
Young Boys,7729,1,22,6,4,71,35,36,72
FC Basel,7729,2,16,9,7,52,28,24,57
Lucerne,7729,3,13,9,10,42,42,0,48
FC Zürich,7729,4,11,11,10,40,34,6,44
Grasshoppers,7729,5,12,6,14,42,46,-4,42
St Gallen,7729,6,13,3,16,39,54,-15,42
FC Lugano,7729,7,10,7,15,29,44,-15,37
FC Thun,7729,8,9,7,16,43,56,-13,34
FC Sion,7729,9,5,8,19,36,55,-19,23
Young Boys,7730,1,20,6,6,70,38,32,66
FC Basel,7730,2,18,7,7,55,26,29,61
Lucerne,7730,3,13,8,11,43,47,-4,47
St Gallen,7730,4,14,3,15,43,58,-15,45
FC Zürich,7730,5,11,10,11,42,37,5,43
Grasshoppers,7730,6,12,6,14,50,46,4,42
FC Lugano,7730,7,11,5,16,34,47,-13,38
FC Thun,7730,8,10,5,17,41,56,-15,35
FC Sion,7730,9,6,8,18,37,60,-23,26
Young Boys,7731,1,24,6,2,77,33,44,78
FC Basel,7731,2,17,8,7,51,27,24,59
Lucerne,7731,3,13,8,11,43,43,0,47
St Gallen,7731,4,14,4,14,45,54,-9,46
FC Zürich,7731,5,10,9,13,38,38,0,39
FC Lugano,7731,6,11,5,16,32,46,-14,38
Grasshoppers,7731,7,10,6,16,42,51,-9,36
FC Thun,7731,8,9,5,18,44,62,-18,32
FC Sion,7731,9,7,7,18,44,62,-18,28
Young Boys,7732,1,22,8,2,73,33,40,74
FC Basel,7732,2,16,7,9,51,32,19,55
Lucerne,7732,3,13,9,10,43,41,2,48
St Gallen,7732,4,14,4,14,44,56,-12,46
FC Zürich,7732,5,10,9,13,39,38,1,39
FC Thun,7732,6,11,6,15,47,57,-10,39
FC Lugano,7732,7,11,6,15,32,46,-14,39
Grasshoppers,7732,8,8,9,15,39,49,-10,33
FC Sion,7732,9,5,10,17,37,53,-16,25
Young Boys,7733,1,21,8,3,75,36,39,71
FC Basel,7733,2,20,7,5,55,25,30,67
St Gallen,7733,3,16,2,14,45,52,-7,50
Lucerne,7733,4,13,7,12,45,47,-2,46
FC Zürich,7733,5,11,10,11,45,36,9,43
Grasshoppers,7733,6,9,8,15,42,52,-10,35
FC Lugano,7733,7,9,5,18,30,54,-24,32
FC Thun,7733,8,8,7,17,45,62,-17,31
FC Sion,7733,9,6,8,18,40,58,-18,26
Young Boys,7734,1,21,9,2,70,31,39,72
FC Basel,7734,2,17,9,6,53,28,25,60
Lucerne,7734,3,12,9,11,43,48,-5,45
St Gallen,7734,4,14,2,16,43,57,-14,44
FC Zürich,7734,5,10,10,12,40,40,0,40
FC Lugano,7734,6,11,5,16,33,47,-14,38
Grasshoppers,7734,7,9,9,14,39,46,-7,36
FC Sion,7734,8,8,9,15,44,50,-6,33
FC Thun,7734,9,8,6,18,41,59,-18,30
Young Boys,7735,1,22,7,3,76,37,39,73
FC Basel,7735,2,17,9,6,55,27,28,60
St Gallen,7735,3,14,4,14,41,52,-11,46
Lucerne,7735,4,11,9,12,39,45,-6,42
FC Zürich,7735,5,10,11,11,40,36,4,41
FC Lugano,7735,6,11,6,15,33,49,-16,39
Grasshoppers,7735,7,8,8,16,40,51,-11,32
FC Thun,7735,8,8,8,16,42,59,-17,32
FC Sion,7735,9,7,10,15,40,50,-10,31
Young Boys,7736,1,23,6,3,74,35,39,75
FC Basel,7736,2,18,7,7,57,26,31,61
Lucerne,7736,3,13,8,11,43,46,-3,47
St Gallen,7736,4,14,2,16,43,56,-13,44
FC Zürich,7736,5,11,10,11,39,35,4,43
Grasshoppers,7736,6,11,6,15,48,53,-5,39
FC Lugano,7736,7,10,6,16,32,50,-18,36
FC Thun,7736,8,10,5,17,46,61,-15,35
FC Sion,7736,9,5,8,19,39,59,-20,23
Young Boys,7737,1,21,7,4,70,34,36,70
FC Basel,7737,2,18,8,6,55,28,27,62
Lucerne,7737,3,13,8,11,42,43,-1,47
St Gallen,7737,4,14,4,14,43,55,-12,46
FC Zürich,7737,5,12,9,11,45,37,8,45
FC Thun,7737,6,10,6,16,46,59,-13,36
Grasshoppers,7737,7,9,8,15,39,47,-8,35
FC Lugano,7737,8,9,5,18,32,54,-22,32
FC Sion,7737,9,6,9,17,40,55,-15,27
Young Boys,7738,1,21,6,5,68,36,32,69
FC Basel,7738,2,17,9,6,54,26,28,60
St Gallen,7738,3,14,5,13,42,52,-10,47
Lucerne,7738,4,12,8,12,40,42,-2,44
FC Zürich,7738,5,11,10,11,42,37,5,43
FC Lugano,7738,6,11,5,16,30,46,-16,38
Grasshoppers,7738,7,10,6,16,40,49,-9,36
FC Thun,7738,8,10,5,17,44,59,-15,35
FC Sion,7738,9,7,8,17,40,53,-13,29
Young Boys,7739,1,22,7,3,77,35,42,73
FC Basel,7739,2,17,8,7,55,28,27,59
Lucerne,7739,3,14,8,10,42,42,0,50
St Gallen,7739,4,14,3,15,42,55,-13,45
FC Zürich,7739,5,10,11,11,44,41,3,41
FC Thun,7739,6,10,6,16,45,59,-14,36
FC Lugano,7739,7,9,8,15,31,48,-17,35
Grasshoppers,7739,8,9,7,16,40,50,-10,34
FC Sion,7739,9,6,8,18,39,57,-18,26
Young Boys,7740,1,24,6,2,73,32,41,78
FC Basel,7740,2,19,7,6,55,25,30,64
St Gallen,7740,3,15,2,15,42,52,-10,47
Lucerne,7740,4,13,7,12,44,45,-1,46
FC Zürich,7740,5,10,10,12,38,35,3,40
FC Thun,7740,6,10,6,16,46,60,-14,36
FC Lugano,7740,7,10,5,17,29,47,-18,35
Grasshoppers,7740,8,8,6,18,42,57,-15,30
FC Sion,7740,9,6,9,17,39,55,-16,27
Young Boys,7741,1,20,6,6,70,42,28,66
FC Basel,7741,2,18,8,6,53,24,29,62
Lucerne,7741,3,14,7,11,46,44,2,49
FC Zürich,7741,4,12,10,10,45,35,10,46
St Gallen,7741,5,14,3,15,42,54,-12,45
FC Lugano,7741,6,11,5,16,31,48,-17,38
Grasshoppers,7741,7,9,7,16,40,48,-8,34
FC Thun,7741,8,9,7,16,45,60,-15,34
FC Sion,7741,9,7,7,18,41,58,-17,28
Young Boys,7742,1,20,8,4,69,35,34,68
FC Basel,7742,2,17,9,6,51,25,26,60
St Gallen,7742,3,14,5,13,43,52,-9,47
FC Zürich,7742,4,12,10,10,45,36,9,46
Lucerne,7742,5,13,7,12,42,46,-4,46
Grasshoppers,7742,6,9,8,15,43,51,-8,35
FC Thun,7742,7,9,8,15,48,62,-14,35
FC Lugano,7742,8,9,7,16,29,48,-19,34
FC Sion,7742,9,5,10,17,37,52,-15,25
Young Boys,7743,1,21,8,3,73,35,38,71
FC Basel,7743,2,18,8,6,52,24,28,62
Lucerne,7743,3,15,7,10,45,44,1,52
St Gallen,7743,4,13,2,17,43,59,-16,41
FC Zürich,7743,5,10,10,12,39,40,-1,40
FC Thun,7743,6,11,5,16,49,56,-7,38
FC Lugano,7743,7,11,5,16,30,47,-17,38
Grasshoppers,7743,8,9,7,16,44,55,-11,34
FC Sion,7743,9,6,8,18,42,57,-15,26
Young Boys,7744,1,22,6,4,72,33,39,72
FC Basel,7744,2,17,8,7,53,26,27,59
Lucerne,7744,3,14,7,11,40,42,-2,49
St Gallen,7744,4,15,2,15,41,52,-11,47
FC Lugano,7744,5,11,5,16,31,47,-16,38
FC Zürich,7744,6,9,10,13,39,40,-1,37
FC Thun,7744,7,10,6,16,44,56,-12,36
Grasshoppers,7744,8,9,6,17,38,51,-13,33
FC Sion,7744,9,8,8,16,40,51,-11,32
Young Boys,7745,1,22,6,4,73,33,40,72
FC Basel,7745,2,16,10,6,48,24,24,58
Lucerne,7745,3,12,10,10,40,45,-5,46
St Gallen,7745,4,13,5,14,41,53,-12,44
FC Zürich,7745,5,11,9,12,40,35,5,42
FC Thun,7745,6,10,6,16,44,58,-14,36
Grasshoppers,7745,7,9,8,15,41,50,-9,35
FC Lugano,7745,8,10,5,17,32,49,-17,35
FC Sion,7745,9,7,9,16,40,52,-12,30
Young Boys,7746,1,21,7,4,72,36,36,70
FC Basel,7746,2,18,9,5,55,23,32,63
Lucerne,7746,3,15,7,10,48,46,2,52
St Gallen,7746,4,15,2,15,44,53,-9,47
FC Zürich,7746,5,10,11,11,41,37,4,41
Grasshoppers,7746,6,9,6,17,43,57,-14,33
FC Lugano,7746,7,9,6,17,29,48,-19,33
FC Thun,7746,8,9,5,18,47,64,-17,32
FC Sion,7746,9,8,7,17,45,60,-15,31
Young Boys,7747,1,22,7,3,69,32,37,73
FC Basel,7747,2,19,7,6,56,25,31,64
St Gallen,7747,3,15,2,15,44,54,-10,47
Lucerne,7747,4,12,8,12,38,43,-5,44
FC Zürich,7747,5,10,10,12,41,40,1,40
Grasshoppers,7747,6,10,7,15,43,47,-4,37
FC Lugano,7747,7,10,5,17,32,47,-15,35
FC Thun,7747,8,10,5,17,44,62,-18,35
FC Sion,7747,9,6,9,17,39,56,-17,27
Young Boys,7748,1,21,7,4,69,35,34,70
FC Basel,7748,2,17,8,7,54,27,27,59
Lucerne,7748,3,14,9,9,44,41,3,51
St Gallen,7748,4,14,3,15,42,57,-15,45
FC Zürich,7748,5,10,11,11,44,38,6,41
FC Lugano,7748,6,10,6,16,33,46,-13,36
FC Thun,7748,7,10,5,17,46,61,-15,35
Grasshoppers,7748,8,9,7,16,42,53,-11,34
FC Sion,7748,9,7,8,17,39,55,-16,29
Young Boys,7749,1,21,9,2,73,35,38,72
FC Basel,7749,2,16,10,6,54,28,26,58
St Gallen,7749,3,17,2,13,44,51,-7,53
FC Zürich,7749,4,12,10,10,45,36,9,46
Lucerne,7749,5,13,7,12,42,46,-4,46
Grasshoppers,7749,6,9,6,17,39,50,-11,33
FC Thun,7749,7,9,6,17,42,60,-18,33
FC Lugano,7749,8,9,6,17,30,48,-18,33
FC Sion,7749,9,6,8,18,38,53,-15,26
Young Boys,7750,1,20,7,5,66,37,29,67
FC Basel,7750,2,18,7,7,57,28,29,61
Lucerne,7750,3,15,8,9,43,39,4,53
St Gallen,7750,4,14,3,15,40,53,-13,45
FC Zürich,7750,5,10,11,11,43,39,4,41
Grasshoppers,7750,6,11,6,15,42,47,-5,39
FC Lugano,7750,7,10,6,16,30,46,-16,36
FC Thun,7750,8,8,7,17,45,62,-17,31
FC Sion,7750,9,5,11,16,38,53,-15,26
Young Boys,7751,1,21,9,2,75,34,41,72
FC Basel,7751,2,18,8,6,56,26,30,62
Lucerne,7751,3,13,7,12,44,47,-3,46
St Gallen,7751,4,13,2,17,41,59,-18,41
FC Zürich,7751,5,10,10,12,39,38,1,40
FC Lugano,7751,6,11,5,16,33,49,-16,38
Grasshoppers,7751,7,10,7,15,42,50,-8,37
FC Thun,7751,8,9,6,17,42,59,-17,33
FC Sion,7751,9,7,10,15,38,48,-10,31
Young Boys,7752,1,22,6,4,78,36,42,72
FC Basel,7752,2,16,8,8,50,27,23,56
St Gallen,7752,3,16,2,14,46,53,-7,50
FC Zürich,7752,4,10,12,10,38,33,5,42
Lucerne,7752,5,11,7,14,41,58,-17,40
Grasshoppers,7752,6,11,6,15,43,48,-5,39
FC Lugano,7752,7,11,6,15,35,48,-13,39
FC Thun,7752,8,10,5,17,43,58,-15,35
FC Sion,7752,9,7,8,17,41,54,-13,29
Young Boys,7753,1,22,7,3,70,32,38,73
FC Basel,7753,2,19,8,5,56,23,33,65
Lucerne,7753,3,13,8,11,41,44,-3,47
FC Zürich,7753,4,11,11,10,41,35,6,44
St Gallen,7753,5,13,2,17,42,58,-16,41
FC Lugano,7753,6,10,6,16,30,49,-19,36
Grasshoppers,7753,7,9,8,15,42,49,-7,35
FC Thun,7753,8,9,5,18,43,60,-17,32
FC Sion,7753,9,7,7,18,39,54,-15,28
Young Boys,7754,1,21,7,4,70,35,35,70
FC Basel,7754,2,20,7,5,58,24,34,67
Lucerne,7754,3,13,9,10,44,43,1,48
St Gallen,7754,4,14,3,15,42,57,-15,45
FC Zürich,7754,5,10,9,13,40,38,2,39
Grasshoppers,7754,6,10,6,16,41,51,-10,36
FC Thun,7754,7,10,6,16,45,59,-14,36
FC Lugano,7754,8,10,5,17,32,52,-20,35
FC Sion,7754,9,6,8,18,38,51,-13,26
Young Boys,7755,1,21,7,4,68,35,33,70
FC Basel,7755,2,17,8,7,58,28,30,59
Lucerne,7755,3,13,10,9,42,41,1,49
FC Zürich,7755,4,12,10,10,41,34,7,46
St Gallen,7755,5,14,3,15,45,57,-12,45
FC Lugano,7755,6,10,6,16,33,47,-14,36
FC Thun,7755,7,9,7,16,44,63,-19,34
Grasshoppers,7755,8,8,8,16,41,51,-10,32
FC Sion,7755,9,7,7,18,39,55,-16,28
Young Boys,7756,1,22,6,4,74,36,38,72
FC Basel,7756,2,18,7,7,53,25,28,61
Lucerne,7756,3,13,9,10,41,41,0,48
St Gallen,7756,4,14,3,15,40,54,-14,45
FC Zürich,7756,5,10,10,12,41,37,4,40
FC Thun,7756,6,11,5,16,44,56,-12,38
Grasshoppers,7756,7,10,7,15,40,48,-8,37
FC Lugano,7756,8,9,7,16,34,54,-20,34
FC Sion,7756,9,6,8,18,37,53,-16,26
Young Boys,7757,1,22,7,3,74,33,41,73
FC Basel,7757,2,18,8,6,55,26,29,62
FC Zürich,7757,3,13,9,10,46,38,8,48
Lucerne,7757,4,12,8,12,41,45,-4,44
St Gallen,7757,5,13,2,17,40,60,-20,41
FC Lugano,7757,6,10,7,15,35,50,-15,37
Grasshoppers,7757,7,9,7,16,39,49,-10,34
FC Thun,7757,8,9,7,16,43,58,-15,34
FC Sion,7757,9,6,9,17,43,57,-14,27
Young Boys,7758,1,21,7,4,75,37,38,70
FC Basel,7758,2,18,8,6,54,27,27,62
Lucerne,7758,3,15,7,10,48,46,2,52
St Gallen,7758,4,15,2,15,44,53,-9,47
FC Zürich,7758,5,9,11,12,37,35,2,38
Grasshoppers,7758,6,10,6,16,40,50,-10,36
FC Lugano,7758,7,10,6,16,31,49,-18,36
FC Sion,7758,8,8,7,17,39,52,-13,31
FC Thun,7758,9,8,6,18,40,59,-19,30
Young Boys,7759,1,19,10,3,71,38,33,67
FC Basel,7759,2,16,9,7,52,27,25,57
Lucerne,7759,3,15,7,10,49,45,4,52
St Gallen,7759,4,14,3,15,43,55,-12,45
FC Zürich,7759,5,10,10,12,41,40,1,40
FC Thun,7759,6,9,8,15,43,55,-12,35
FC Lugano,7759,7,9,8,15,33,52,-19,35
Grasshoppers,7759,8,8,9,15,38,48,-10,33
FC Sion,7759,9,7,10,15,40,50,-10,31
Young Boys,7760,1,22,6,4,74,37,37,72
FC Basel,7760,2,17,8,7,60,30,30,59
St Gallen,7760,3,15,4,13,44,53,-9,49
Lucerne,7760,4,12,8,12,39,46,-7,44
FC Zürich,7760,5,11,10,11,44,38,6,43
FC Lugano,7760,6,10,8,14,33,45,-12,38
FC Thun,7760,7,10,5,17,42,59,-17,35
Grasshoppers,7760,8,9,6,17,40,52,-12,33
FC Sion,7760,9,7,7,18,39,55,-16,28
Young Boys,7761,1,21,7,4,69,40,29,70
FC Basel,7761,2,16,8,8,51,29,22,56
Lucerne,7761,3,14,9,9,43,40,3,51
FC Zürich,7761,4,12,10,10,43,33,10,46
St Gallen,7761,5,14,3,15,44,55,-11,45
FC Thun,7761,6,10,6,16,43,55,-12,36
FC Lugano,7761,7,10,6,16,31,48,-17,36
Grasshoppers,7761,8,9,7,16,42,49,-7,34
FC Sion,7761,9,6,8,18,37,54,-17,26
Young Boys,7762,1,21,6,5,70,36,34,69
FC Basel,7762,2,18,7,7,57,29,28,61
Lucerne,7762,3,13,9,10,45,44,1,48
St Gallen,7762,4,14,2,16,42,58,-16,44
FC Zürich,7762,5,11,10,11,40,35,5,43
FC Lugano,7762,6,11,6,15,31,46,-15,39
Grasshoppers,7762,7,9,8,15,40,48,-8,35
FC Thun,7762,8,9,7,16,44,57,-13,34
FC Sion,7762,9,7,7,18,40,56,-16,28
Young Boys,7763,1,24,6,2,74,31,43,78
FC Basel,7763,2,17,7,8,51,29,22,58
FC Zürich,7763,3,12,10,10,45,35,10,46
Lucerne,7763,4,12,8,12,41,45,-4,44
St Gallen,7763,5,14,2,16,40,55,-15,44
FC Lugano,7763,6,11,5,16,30,48,-18,38
Grasshoppers,7763,7,9,8,15,41,48,-7,35
FC Thun,7763,8,8,6,18,42,62,-20,30
FC Sion,7763,9,6,10,16,44,55,-11,28
Young Boys,7764,1,20,8,4,68,34,34,68
FC Basel,7764,2,19,7,6,57,25,32,64
St Gallen,7764,3,16,2,14,45,56,-11,50
Lucerne,7764,4,13,8,11,41,40,1,47
FC Zürich,7764,5,10,11,11,42,39,3,41
Grasshoppers,7764,6,11,6,15,39,46,-7,39
FC Thun,7764,7,10,6,16,45,58,-13,36
FC Lugano,7764,8,9,6,17,31,52,-21,33
FC Sion,7764,9,5,8,19,37,55,-18,23
Young Boys,7765,1,21,7,4,75,40,35,70
FC Basel,7765,2,18,9,5,59,26,33,63
St Gallen,7765,3,14,5,13,45,55,-10,47
Lucerne,7765,4,12,10,10,46,49,-3,46
FC Zürich,7765,5,11,10,11,40,35,5,43
FC Lugano,7765,6,9,7,16,30,49,-19,34
FC Thun,7765,7,9,6,17,41,57,-16,33
FC Sion,7765,8,8,8,16,42,52,-10,32
Grasshoppers,7765,9,8,6,18,39,54,-15,30
Young Boys,7766,1,20,7,5,72,38,34,67
FC Basel,7766,2,18,8,6,56,26,30,62
Lucerne,7766,3,16,7,9,47,39,8,55
FC Zürich,7766,4,10,12,10,42,35,7,42
St Gallen,7766,5,13,3,16,39,57,-18,42
FC Lugano,7766,6,10,7,15,32,47,-15,37
Grasshoppers,7766,7,9,7,16,40,52,-12,34
FC Thun,7766,8,9,7,16,42,56,-14,34
FC Sion,7766,9,5,10,17,38,58,-20,25
Young Boys,7767,1,23,6,3,74,35,39,75
FC Basel,7767,2,15,9,8,50,30,20,54
Lucerne,7767,3,14,8,10,45,44,1,50
St Gallen,7767,4,15,3,14,45,55,-10,48
FC Zürich,7767,5,11,11,10,40,34,6,44
FC Lugano,7767,6,10,6,16,32,47,-15,36
Grasshoppers,7767,7,8,9,15,42,51,-9,33
FC Thun,7767,8,8,8,16,42,59,-17,32
FC Sion,7767,9,6,8,18,40,55,-15,26
Young Boys,7768,1,23,6,3,77,36,41,75
FC Basel,7768,2,17,8,7,51,27,24,59
St Gallen,7768,3,15,2,15,46,53,-7,47
Lucerne,7768,4,13,7,12,40,47,-7,46
FC Zürich,7768,5,10,10,12,38,37,1,40
FC Lugano,7768,6,11,5,16,32,49,-17,38
Grasshoppers,7768,7,10,7,15,43,49,-6,37
FC Thun,7768,8,10,7,15,46,55,-9,37
FC Sion,7768,9,5,8,19,36,56,-20,23
Young Boys,7769,1,21,7,4,73,37,36,70
FC Basel,7769,2,17,7,8,51,27,24,58
St Gallen,7769,3,15,4,13,48,53,-5,49
FC Zürich,7769,4,11,10,11,41,34,7,43
Lucerne,7769,5,11,9,12,39,49,-10,42
FC Thun,7769,6,10,6,16,42,57,-15,36
FC Lugano,7769,7,9,8,15,30,47,-17,35
Grasshoppers,7769,8,9,7,16,41,52,-11,34
FC Sion,7769,9,8,8,16,46,55,-9,32
Young Boys,7770,1,23,6,3,76,35,41,75
FC Basel,7770,2,18,7,7,60,26,34,61
Lucerne,7770,3,13,8,11,43,45,-2,47
FC Zürich,7770,4,12,10,10,40,32,8,46
St Gallen,7770,5,14,3,15,43,60,-17,45
FC Lugano,7770,6,10,6,16,34,50,-16,36
FC Thun,7770,7,10,5,17,46,64,-18,35
Grasshoppers,7770,8,8,6,18,40,53,-13,30
FC Sion,7770,9,7,7,18,41,58,-17,28
Young Boys,7771,1,22,8,2,73,35,38,74
FC Basel,7771,2,17,9,6,52,27,25,60
Lucerne,7771,3,14,7,11,45,42,3,49
FC Zürich,7771,4,13,9,10,46,34,12,48
St Gallen,7771,5,14,3,15,43,56,-13,45
FC Thun,7771,6,10,5,17,44,58,-14,35
Grasshoppers,7771,7,9,7,16,42,53,-11,34
FC Lugano,7771,8,9,5,18,29,50,-21,32
FC Sion,7771,9,6,7,19,38,57,-19,25
Young Boys,7772,1,22,7,3,71,34,37,73
FC Basel,7772,2,18,9,5,54,23,31,63
St Gallen,7772,3,14,3,15,41,54,-13,45
Lucerne,7772,4,11,9,12,39,47,-8,42
FC Zürich,7772,5,10,11,11,39,34,5,41
FC Thun,7772,6,11,6,15,42,54,-12,39
Grasshoppers,7772,7,10,6,16,39,46,-7,36
FC Lugano,7772,8,9,6,17,30,49,-19,33
FC Sion,7772,9,6,9,17,39,53,-14,27
Young Boys,7773,1,22,8,2,74,36,38,74
FC Basel,7773,2,16,10,6,50,27,23,58
Lucerne,7773,3,13,7,12,45,44,1,46
St Gallen,7773,4,14,2,16,41,56,-15,44
FC Lugano,7773,5,11,6,15,32,50,-18,39
FC Zürich,7773,6,9,11,12,37,35,2,38
FC Thun,7773,7,10,7,15,43,55,-12,37
Grasshoppers,7773,8,9,6,17,41,50,-9,33
FC Sion,7773,9,7,9,16,41,51,-10,30
Young Boys,7774,1,21,7,4,71,35,36,70
FC Basel,7774,2,18,8,6,54,25,29,62
Lucerne,7774,3,12,10,10,41,43,-2,46
St Gallen,7774,4,14,2,16,40,53,-13,44
FC Zürich,7774,5,10,11,11,38,35,3,41
FC Lugano,7774,6,10,7,15,30,46,-16,37
Grasshoppers,7774,7,10,6,16,40,48,-8,36
FC Thun,7774,8,9,6,17,42,59,-17,33
FC Sion,7774,9,7,9,16,40,52,-12,30
Young Boys,7775,1,23,6,3,72,37,35,75
FC Basel,7775,2,17,10,5,53,24,29,61
St Gallen,7775,3,15,4,13,45,51,-6,49
Lucerne,7775,4,13,7,12,44,44,0,46
FC Zürich,7775,5,10,11,11,43,36,7,41
FC Thun,7775,6,10,7,15,43,56,-13,37
FC Lugano,7775,7,9,7,16,30,50,-20,34
Grasshoppers,7775,8,8,7,17,39,51,-12,31
FC Sion,7775,9,5,9,18,38,58,-20,24
Young Boys,7776,1,21,7,4,75,39,36,70
FC Basel,7776,2,17,9,6,53,27,26,60
Lucerne,7776,3,13,8,11,50,50,0,47
FC Zürich,7776,4,12,9,11,42,36,6,45
St Gallen,7776,5,13,5,14,43,57,-14,44
FC Lugano,7776,6,10,6,16,32,50,-18,36
Grasshoppers,7776,7,9,7,16,41,50,-9,34
FC Sion,7776,8,8,8,16,40,51,-11,32
FC Thun,7776,9,9,5,18,42,58,-16,32
Young Boys,7777,1,21,7,4,72,36,36,70
FC Basel,7777,2,18,9,5,54,25,29,63
St Gallen,7777,3,15,3,14,43,53,-10,48
Lucerne,7777,4,11,9,12,41,45,-4,42
FC Lugano,7777,5,12,5,15,34,47,-13,41
FC Zürich,7777,6,9,10,13,41,41,0,37
FC Thun,7777,7,10,6,16,47,60,-13,36
Grasshoppers,7777,8,9,7,16,42,51,-9,34
FC Sion,7777,9,7,8,17,38,54,-16,29
Young Boys,7778,1,21,8,3,72,34,38,71
FC Basel,7778,2,16,9,7,50,28,22,57
St Gallen,7778,3,15,2,15,48,55,-7,47
Lucerne,7778,4,13,7,12,43,46,-3,46
FC Zürich,7778,5,11,10,11,41,37,4,43
FC Lugano,7778,6,11,5,16,31,48,-17,38
Grasshoppers,7778,7,9,8,15,46,56,-10,35
FC Sion,7778,8,8,8,16,46,55,-9,32
FC Thun,7778,9,9,5,18,48,66,-18,32
Young Boys,7779,1,22,7,3,77,35,42,73
FC Basel,7779,2,19,7,6,56,24,32,64
Lucerne,7779,3,13,7,12,39,48,-9,46
St Gallen,7779,4,14,3,15,42,53,-11,45
FC Zürich,7779,5,11,10,11,40,34,6,43
FC Thun,7779,6,10,6,16,43,58,-15,36
Grasshoppers,7779,7,9,7,16,44,53,-9,34
FC Lugano,7779,8,9,6,17,30,50,-20,33
FC Sion,7779,9,7,7,18,41,57,-16,28
Young Boys,7780,1,22,6,4,73,37,36,72
FC Basel,7780,2,17,7,8,53,27,26,58
Lucerne,7780,3,14,7,11,46,46,0,49
St Gallen,7780,4,15,3,14,43,51,-8,48
FC Zürich,7780,5,11,10,11,41,35,6,43
FC Lugano,7780,6,10,6,16,32,51,-19,36
FC Thun,7780,7,10,5,17,43,58,-15,35
Grasshoppers,7780,8,9,6,17,37,52,-15,33
FC Sion,7780,9,7,8,17,39,50,-11,29
Young Boys,7781,1,20,7,5,69,37,32,67
FC Basel,7781,2,17,9,6,51,25,26,60
Lucerne,7781,3,13,9,10,42,41,1,48
FC Zürich,7781,4,11,10,11,41,36,5,43
St Gallen,7781,5,13,4,15,40,53,-13,43
FC Lugano,7781,6,12,5,15,33,46,-13,41
FC Sion,7781,7,9,8,15,45,49,-4,35
FC Thun,7781,8,9,6,17,41,62,-21,33
Grasshoppers,7781,9,8,6,18,37,50,-13,30
Young Boys,7782,1,22,7,3,73,35,38,73
FC Basel,7782,2,17,10,5,55,27,28,61
St Gallen,7782,3,13,4,15,42,56,-14,43
Lucerne,7782,4,11,8,13,40,48,-8,41
FC Zürich,7782,5,10,10,12,39,37,2,40
Grasshoppers,7782,6,11,6,15,42,51,-9,39
FC Thun,7782,7,10,6,16,46,57,-11,36
FC Lugano,7782,8,10,6,16,32,48,-16,36
FC Sion,7782,9,8,7,17,43,53,-10,31
Young Boys,7783,1,24,6,2,81,36,45,78
FC Basel,7783,2,17,7,8,55,27,28,58
Lucerne,7783,3,15,7,10,47,43,4,52
St Gallen,7783,4,13,4,15,41,57,-16,43
FC Zürich,7783,5,10,10,12,41,39,2,40
Grasshoppers,7783,6,10,6,16,44,54,-10,36
FC Thun,7783,7,10,5,17,44,57,-13,35
FC Lugano,7783,8,9,7,16,28,47,-19,34
FC Sion,7783,9,6,8,18,41,62,-21,26
Young Boys,7784,1,22,6,4,73,36,37,72
FC Basel,7784,2,18,9,5,57,24,33,63
Lucerne,7784,3,14,7,11,41,43,-2,49
St Gallen,7784,4,13,3,16,39,53,-14,42
FC Zürich,7784,5,10,11,11,39,36,3,41
FC Lugano,7784,6,10,6,16,28,47,-19,36
FC Thun,7784,7,10,5,17,43,59,-16,35
Grasshoppers,7784,8,9,6,17,38,49,-11,33
FC Sion,7784,9,8,7,17,42,53,-11,31
Young Boys,7785,1,21,8,3,72,34,38,71
FC Basel,7785,2,16,8,8,49,28,21,56
Lucerne,7785,3,13,9,10,44,44,0,48
St Gallen,7785,4,15,3,14,42,53,-11,48
FC Zürich,7785,5,12,9,11,45,36,9,45
Grasshoppers,7785,6,11,6,15,44,50,-6,39
FC Thun,7785,7,10,5,17,44,57,-13,35
FC Lugano,7785,8,9,6,17,29,48,-19,33
FC Sion,7785,9,6,8,18,41,60,-19,26
Young Boys,7786,1,20,7,5,70,37,33,67
FC Basel,7786,2,18,8,6,54,25,29,62
St Gallen,7786,3,15,2,15,44,55,-11,47
Lucerne,7786,4,12,9,11,41,46,-5,45
FC Zürich,7786,5,10,9,13,39,37,2,39
FC Lugano,7786,6,11,5,16,34,48,-14,38
FC Thun,7786,7,10,6,16,45,61,-16,36
Grasshoppers,7786,8,9,8,15,42,50,-8,35
FC Sion,7786,9,7,10,15,43,53,-10,31
Young Boys,7787,1,21,7,4,71,37,34,70
FC Basel,7787,2,18,7,7,55,27,28,61
St Gallen,7787,3,16,2,14,44,53,-9,50
FC Zürich,7787,4,12,10,10,42,35,7,46
Lucerne,7787,5,11,7,14,38,47,-9,40
FC Thun,7787,6,10,6,16,43,57,-14,36
FC Lugano,7787,7,10,6,16,34,49,-15,36
Grasshoppers,7787,8,9,7,16,38,50,-12,34
FC Sion,7787,9,7,8,17,42,52,-10,29
Young Boys,7788,1,23,6,3,74,34,40,75
FC Basel,7788,2,17,7,8,51,27,24,58
Lucerne,7788,3,14,7,11,45,43,2,49
St Gallen,7788,4,15,2,15,42,54,-12,47
FC Zürich,7788,5,11,10,11,41,38,3,43
Grasshoppers,7788,6,11,6,15,45,49,-4,39
FC Thun,7788,7,9,5,18,42,61,-19,32
FC Lugano,7788,8,9,5,18,30,52,-22,32
FC Sion,7788,9,7,8,17,41,53,-12,29
Young Boys,7789,1,23,6,3,76,36,40,75
FC Basel,7789,2,20,7,5,59,25,34,67
St Gallen,7789,3,14,2,16,42,58,-16,44
FC Zürich,7789,4,11,10,11,44,39,5,43
Lucerne,7789,5,12,7,13,42,46,-4,43
FC Lugano,7789,6,11,6,15,34,50,-16,39
Grasshoppers,7789,7,10,6,16,44,51,-7,36
FC Thun,7789,8,10,5,17,44,58,-14,35
FC Sion,7789,9,5,7,20,36,58,-22,22
Young Boys,7790,1,23,7,2,73,33,40,76
FC Basel,7790,2,16,9,7,50,26,24,57
St Gallen,7790,3,14,5,13,45,55,-10,47
Lucerne,7790,4,12,9,11,45,42,3,45
FC Zürich,7790,5,10,9,13,39,39,0,39
Grasshoppers,7790,6,10,7,15,40,46,-6,37
FC Thun,7790,7,10,6,16,48,59,-11,36
FC Lugano,7790,8,10,6,16,31,53,-22,36
FC Sion,7790,9,6,8,18,40,58,-18,26
Young Boys,7791,1,21,8,3,70,33,37,71
FC Basel,7791,2,17,9,6,54,30,24,60
St Gallen,7791,3,15,3,14,47,53,-6,48
Lucerne,7791,4,11,11,10,40,42,-2,44
FC Zürich,7791,5,10,10,12,45,43,2,40
FC Lugano,7791,6,10,7,15,30,47,-17,37
FC Sion,7791,7,9,7,16,45,54,-9,34
FC Thun,7791,8,9,6,17,44,60,-16,33
Grasshoppers,7791,9,8,7,17,40,53,-13,31
Young Boys,7792,1,24,6,2,78,34,44,78
FC Basel,7792,2,15,10,7,50,29,21,55
St Gallen,7792,3,15,4,13,47,56,-9,49
Lucerne,7792,4,12,10,10,42,44,-2,46
FC Zürich,7792,5,10,11,11,39,34,5,41
FC Thun,7792,6,10,7,15,43,55,-12,37
Grasshoppers,7792,7,9,7,16,40,50,-10,34
FC Lugano,7792,8,9,5,18,30,51,-21,32
FC Sion,7792,9,6,8,18,40,56,-16,26
Young Boys,7793,1,21,8,3,75,36,39,71
FC Basel,7793,2,19,7,6,61,27,34,64
St Gallen,7793,3,15,2,15,43,57,-14,47
Lucerne,7793,4,13,7,12,40,45,-5,46
FC Zürich,7793,5,12,9,11,44,36,8,45
Grasshoppers,7793,6,10,7,15,42,51,-9,37
FC Lugano,7793,7,10,6,16,31,47,-16,36
FC Thun,7793,8,9,5,18,46,68,-22,32
FC Sion,7793,9,6,7,19,42,57,-15,25
Young Boys,7794,1,22,7,3,73,34,39,73
FC Basel,7794,2,17,9,6,56,27,29,60
Lucerne,7794,3,13,7,12,41,47,-6,46
St Gallen,7794,4,14,3,15,44,55,-11,45
FC Zürich,7794,5,10,10,12,39,37,2,40
FC Thun,7794,6,10,6,16,45,59,-14,36
FC Lugano,7794,7,10,6,16,30,49,-19,36
Grasshoppers,7794,8,9,7,16,40,50,-10,34
FC Sion,7794,9,8,7,17,43,53,-10,31
Young Boys,7795,1,20,8,4,65,35,30,68
FC Basel,7795,2,17,9,6,52,26,26,60
St Gallen,7795,3,16,2,14,46,53,-7,50
Lucerne,7795,4,12,9,11,37,41,-4,45
FC Zürich,7795,5,10,11,11,40,38,2,41
Grasshoppers,7795,6,10,7,15,44,48,-4,37
FC Lugano,7795,7,9,7,16,28,45,-17,34
FC Sion,7795,8,8,8,16,43,52,-9,32
FC Thun,7795,9,8,7,17,46,63,-17,31
Young Boys,7796,1,22,6,4,75,42,33,72
FC Basel,7796,2,19,7,6,60,24,36,64
Lucerne,7796,3,14,7,11,44,42,2,49
St Gallen,7796,4,15,2,15,44,55,-11,47
FC Thun,7796,5,11,5,16,49,60,-11,38
FC Zürich,7796,6,9,10,13,39,41,-2,37
Grasshoppers,7796,7,9,7,16,39,52,-13,34
FC Lugano,7796,8,9,6,17,30,49,-19,33
FC Sion,7796,9,7,8,17,46,61,-15,29
Young Boys,7797,1,21,6,5,68,37,31,69
FC Basel,7797,2,18,8,6,58,24,34,62
Lucerne,7797,3,13,9,10,44,41,3,48
St Gallen,7797,4,14,3,15,40,55,-15,45
FC Zürich,7797,5,9,12,11,40,39,1,39
FC Lugano,7797,6,10,6,16,30,50,-20,36
FC Thun,7797,7,9,7,16,41,60,-19,34
FC Sion,7797,8,8,9,15,45,51,-6,33
Grasshoppers,7797,9,9,6,17,42,51,-9,33
Young Boys,7798,1,21,9,2,72,36,36,72
FC Basel,7798,2,18,9,5,57,26,31,63
Lucerne,7798,3,13,9,10,44,43,1,48
St Gallen,7798,4,13,3,16,41,58,-17,42
FC Lugano,7798,5,11,6,15,33,47,-14,39
FC Zürich,7798,6,9,10,13,40,39,1,37
FC Thun,7798,7,10,7,15,45,58,-13,37
Grasshoppers,7798,8,9,7,16,43,48,-5,34
FC Sion,7798,9,5,10,17,40,60,-20,25
Young Boys,7799,1,22,7,3,70,32,38,73
FC Basel,7799,2,18,8,6,54,27,27,62
St Gallen,7799,3,15,3,14,45,54,-9,48
Lucerne,7799,4,13,8,11,42,43,-1,47
FC Zürich,7799,5,11,9,12,44,36,8,42
FC Thun,7799,6,12,5,15,47,57,-10,41
FC Lugano,7799,7,9,6,17,29,49,-20,33
Grasshoppers,7799,8,8,8,16,38,51,-13,32
FC Sion,7799,9,5,8,19,39,59,-20,23
Young Boys,7800,1,21,8,3,70,35,35,71
FC Basel,7800,2,18,8,6,54,26,28,62
Lucerne,7800,3,14,8,10,47,46,1,50
St Gallen,7800,4,15,2,15,46,53,-7,47
FC Zürich,7800,5,11,9,12,40,37,3,42
Grasshoppers,7800,6,10,7,15,43,48,-5,37
FC Lugano,7800,7,10,5,17,32,51,-19,35
FC Thun,7800,8,9,6,17,43,60,-17,33
FC Sion,7800,9,6,7,19,36,55,-19,25
Young Boys,7801,1,22,7,3,76,34,42,73
FC Basel,7801,2,17,10,5,52,24,28,61
St Gallen,7801,3,14,5,13,43,52,-9,47
Lucerne,7801,4,12,9,11,39,43,-4,45
FC Zürich,7801,5,10,9,13,39,38,1,39
FC Thun,7801,6,10,7,15,44,56,-12,37
FC Lugano,7801,7,10,6,16,33,49,-16,36
Grasshoppers,7801,8,8,9,15,41,50,-9,33
FC Sion,7801,9,6,8,18,37,58,-21,26
Young Boys,7802,1,22,7,3,71,40,31,73
FC Basel,7802,2,17,9,6,59,28,31,60
Lucerne,7802,3,14,8,10,50,46,4,50
FC Zürich,7802,4,13,9,10,43,34,9,48
St Gallen,7802,5,13,3,16,41,55,-14,42
FC Thun,7802,6,10,6,16,46,60,-14,36
Grasshoppers,7802,7,9,6,17,43,55,-12,33
FC Lugano,7802,8,9,6,17,28,47,-19,33
FC Sion,7802,9,6,8,18,40,56,-16,26
Young Boys,7803,1,20,9,3,69,36,33,69
FC Basel,7803,2,19,7,6,55,26,29,64
Lucerne,7803,3,13,8,11,45,44,1,47
FC Zürich,7803,4,12,9,11,44,34,10,45
St Gallen,7803,5,13,2,17,41,57,-16,41
FC Lugano,7803,6,11,5,16,29,46,-17,38
Grasshoppers,7803,7,9,7,16,40,50,-10,34
FC Sion,7803,8,8,8,16,41,54,-13,32
FC Thun,7803,9,9,5,18,42,59,-17,32
Young Boys,7804,1,23,6,3,73,33,40,75
FC Basel,7804,2,19,8,5,55,25,30,65
Lucerne,7804,3,13,8,11,43,46,-3,47
FC Zürich,7804,4,12,9,11,43,35,8,45
St Gallen,7804,5,13,5,14,42,55,-13,44
FC Thun,7804,6,10,5,17,45,57,-12,35
FC Lugano,7804,7,10,5,17,30,46,-16,35
Grasshoppers,7804,8,8,7,17,38,50,-12,31
FC Sion,7804,9,5,9,18,37,59,-22,24
Young Boys,7805,1,23,7,2,72,32,40,76
FC Basel,7805,2,16,9,7,51,27,24,57
Lucerne,7805,3,15,7,10,43,39,4,52
St Gallen,7805,4,13,4,15,42,56,-14,43
FC Lugano,7805,5,11,6,15,29,43,-14,39
FC Zürich,7805,6,9,10,13,38,40,-2,37
FC Thun,7805,7,10,5,17,44,56,-12,35
Grasshoppers,7805,8,9,6,17,40,51,-11,33
FC Sion,7805,9,7,8,17,40,55,-15,29
Young Boys,7806,1,24,6,2,73,31,42,78
FC Basel,7806,2,16,8,8,49,25,24,56
St Gallen,7806,3,14,3,15,41,53,-12,45
Lucerne,7806,4,12,8,12,40,45,-5,44
FC Zürich,7806,5,11,9,12,42,38,4,42
FC Lugano,7806,6,11,6,15,32,47,-15,39
Grasshoppers,7806,7,10,7,15,42,49,-7,37
FC Thun,7806,8,9,5,18,43,61,-18,32
FC Sion,7806,9,7,8,17,43,56,-13,29
Young Boys,7807,1,20,9,3,68,34,34,69
FC Basel,7807,2,16,10,6,52,27,25,58
Lucerne,7807,3,14,8,10,45,40,5,50
St Gallen,7807,4,15,2,15,43,52,-9,47
FC Zürich,7807,5,11,10,11,44,35,9,43
Grasshoppers,7807,6,10,6,16,41,49,-8,36
FC Lugano,7807,7,10,6,16,30,50,-20,36
FC Thun,7807,8,10,5,17,44,63,-19,35
FC Sion,7807,9,6,8,18,37,54,-17,26
Young Boys,7808,1,22,7,3,73,35,38,73
FC Basel,7808,2,17,9,6,57,29,28,60
St Gallen,7808,3,15,2,15,41,52,-11,47
Lucerne,7808,4,12,9,11,42,44,-2,45
FC Zürich,7808,5,10,10,12,39,38,1,40
FC Lugano,7808,6,11,5,16,33,47,-14,38
Grasshoppers,7808,7,9,7,16,41,51,-10,34
FC Sion,7808,8,8,8,16,42,53,-11,32
FC Thun,7808,9,9,5,18,46,65,-19,32
Young Boys,7809,1,22,7,3,75,38,37,73
FC Basel,7809,2,19,7,6,59,25,34,64
Lucerne,7809,3,13,8,11,46,49,-3,47
St Gallen,7809,4,13,4,15,41,55,-14,43
FC Zürich,7809,5,9,10,13,38,37,1,37
FC Thun,7809,6,10,7,15,43,56,-13,37
FC Lugano,7809,7,10,6,16,30,49,-19,36
Grasshoppers,7809,8,9,8,15,44,54,-10,35
FC Sion,7809,9,6,9,17,39,52,-13,27
Young Boys,7810,1,21,7,4,69,35,34,70
FC Basel,7810,2,20,7,5,60,25,35,67
Lucerne,7810,3,14,8,10,43,42,1,50
St Gallen,7810,4,13,2,17,39,54,-15,41
FC Zürich,7810,5,9,11,12,40,39,1,38
FC Lugano,7810,6,10,7,15,30,45,-15,37
FC Thun,7810,7,9,7,16,43,61,-18,34
Grasshoppers,7810,8,8,9,15,41,51,-10,33
FC Sion,7810,9,6,10,16,44,57,-13,28
Young Boys,7811,1,22,7,3,75,33,42,73
FC Basel,7811,2,16,10,6,52,28,24,58
St Gallen,7811,3,14,4,14,44,55,-11,46
Lucerne,7811,4,12,9,11,45,47,-2,45
FC Zürich,7811,5,10,11,11,40,35,5,41
FC Lugano,7811,6,11,6,15,32,51,-19,39
FC Thun,7811,7,10,7,15,47,58,-11,37
Grasshoppers,7811,8,9,8,15,44,51,-7,35
FC Sion,7811,9,5,8,19,36,57,-21,23
Young Boys,7812,1,22,6,4,76,37,39,72
FC Basel,7812,2,17,9,6,57,28,29,60
St Gallen,7812,3,15,4,13,47,55,-8,49
Lucerne,7812,4,13,7,12,43,49,-6,46
FC Zürich,7812,5,10,11,11,43,39,4,41
Grasshoppers,7812,6,11,6,15,49,46,3,39
FC Lugano,7812,7,10,7,15,35,49,-14,37
FC Thun,7812,8,9,7,16,46,61,-15,34
FC Sion,7812,9,5,7,20,38,70,-32,22
Young Boys,7813,1,21,7,4,71,36,35,70
FC Basel,7813,2,16,10,6,52,26,26,58
Lucerne,7813,3,13,9,10,45,42,3,48
FC Zürich,7813,4,12,9,11,43,36,7,45
St Gallen,7813,5,13,4,15,42,58,-16,43
FC Lugano,7813,6,11,5,16,34,50,-16,38
Grasshoppers,7813,7,10,6,16,42,50,-8,36
FC Thun,7813,8,9,7,16,42,58,-16,34
FC Sion,7813,9,6,9,17,37,52,-15,27
Young Boys,7814,1,20,9,3,72,38,34,69
FC Basel,7814,2,18,9,5,59,27,32,63
Lucerne,7814,3,13,9,10,42,42,0,48
St Gallen,7814,4,13,4,15,40,56,-16,43
FC Zürich,7814,5,10,10,12,40,39,1,40
FC Lugano,7814,6,10,7,15,34,46,-12,37
FC Thun,7814,7,10,5,17,46,62,-16,35
Grasshoppers,7814,8,9,7,16,45,53,-8,34
FC Sion,7814,9,7,8,17,38,53,-15,29
Young Boys,7815,1,23,6,3,75,33,42,75
FC Basel,7815,2,17,8,7,51,27,24,59
St Gallen,7815,3,14,2,16,45,57,-12,44
FC Zürich,7815,4,11,10,11,42,36,6,43
Lucerne,7815,5,12,7,13,40,48,-8,43
Grasshoppers,7815,6,12,6,14,47,46,1,42
FC Lugano,7815,7,11,5,16,34,48,-14,38
FC Thun,7815,8,8,8,16,40,59,-19,32
FC Sion,7815,9,6,8,18,37,57,-20,26
Young Boys,7816,1,22,7,3,74,32,42,73
FC Basel,7816,2,18,8,6,52,23,29,62
Lucerne,7816,3,13,8,11,41,42,-1,47
St Gallen,7816,4,14,2,16,43,54,-11,44
FC Lugano,7816,5,12,5,15,31,47,-16,41
FC Zürich,7816,6,9,12,11,37,34,3,39
FC Thun,7816,7,9,7,16,44,56,-12,34
Grasshoppers,7816,8,8,8,16,38,54,-16,32
FC Sion,7816,9,6,9,17,38,56,-18,27
Young Boys,7817,1,22,6,4,69,33,36,72
FC Basel,7817,2,18,9,5,52,23,29,63
St Gallen,7817,3,14,4,14,41,53,-12,46
Lucerne,7817,4,12,9,11,38,41,-3,45
FC Zürich,7817,5,10,12,10,41,36,5,42
FC Thun,7817,6,9,8,15,46,58,-12,35
FC Lugano,7817,7,9,6,17,28,46,-18,33
Grasshoppers,7817,8,8,8,16,40,52,-12,32
FC Sion,7817,9,6,10,16,40,53,-13,28
Young Boys,7818,1,22,7,3,70,34,36,73
FC Basel,7818,2,17,9,6,53,25,28,60
Lucerne,7818,3,15,7,10,44,43,1,52
St Gallen,7818,4,15,3,14,42,52,-10,48
FC Zürich,7818,5,10,9,13,42,41,1,39
FC Thun,7818,6,10,6,16,46,60,-14,36
Grasshoppers,7818,7,9,6,17,39,51,-12,33
FC Lugano,7818,8,9,5,18,29,48,-19,32
FC Sion,7818,9,7,8,17,43,54,-11,29
Young Boys,7819,1,20,8,4,69,35,34,68
FC Basel,7819,2,19,7,6,53,23,30,64
Lucerne,7819,3,13,8,11,41,44,-3,47
St Gallen,7819,4,15,2,15,45,53,-8,47
FC Zürich,7819,5,10,10,12,43,39,4,40
FC Thun,7819,6,11,5,16,44,59,-15,38
Grasshoppers,7819,7,10,6,16,42,50,-8,36
FC Lugano,7819,8,9,5,18,32,54,-22,32
FC Sion,7819,9,7,9,16,43,55,-12,30
Young Boys,7820,1,21,9,2,69,30,39,72
FC Basel,7820,2,18,7,7,52,26,26,61
Lucerne,7820,3,14,8,10,45,42,3,50
St Gallen,7820,4,14,2,16,41,55,-14,44
FC Thun,7820,5,11,6,15,48,58,-10,39
FC Zürich,7820,6,9,11,12,40,40,0,38
FC Lugano,7820,7,10,7,15,33,49,-16,37
Grasshoppers,7820,8,9,6,17,42,54,-12,33
FC Sion,7820,9,5,10,17,40,56,-16,25
Young Boys,7821,1,23,7,2,76,35,41,76
FC Basel,7821,2,16,8,8,54,32,22,56
St Gallen,7821,3,15,3,14,47,57,-10,48
Lucerne,7821,4,13,7,12,47,48,-1,46
FC Zürich,7821,5,10,10,12,42,38,4,40
FC Thun,7821,6,10,7,15,47,58,-11,37
Grasshoppers,7821,7,10,6,16,48,56,-8,36
FC Lugano,7821,8,10,6,16,30,47,-17,36
FC Sion,7821,9,6,8,18,40,60,-20,26
Young Boys,7822,1,22,6,4,72,33,39,72
FC Basel,7822,2,17,9,6,51,25,26,60
Lucerne,7822,3,14,7,11,46,48,-2,49
FC Zürich,7822,4,12,10,10,45,33,12,46
St Gallen,7822,5,13,4,15,42,55,-13,43
FC Lugano,7822,6,11,5,16,30,47,-17,38
FC Thun,7822,7,10,5,17,43,58,-15,35
Grasshoppers,7822,8,9,7,16,42,51,-9,34
FC Sion,7822,9,5,9,18,40,61,-21,24
Young Boys,7823,1,22,7,3,71,35,36,73
FC Basel,7823,2,16,8,8,54,29,25,56
Lucerne,7823,3,14,9,9,44,41,3,51
FC Zürich,7823,4,12,9,11,42,35,7,45
St Gallen,7823,5,14,3,15,43,58,-15,45
FC Lugano,7823,6,11,5,16,35,50,-15,38
Grasshoppers,7823,7,10,6,16,41,48,-7,36
FC Thun,7823,8,10,6,16,43,57,-14,36
FC Sion,7823,9,5,7,20,38,58,-20,22
Young Boys,7824,1,21,9,2,73,36,37,72
FC Basel,7824,2,19,7,6,59,27,32,64
St Gallen,7824,3,15,3,14,48,57,-9,48
Lucerne,7824,4,12,8,12,42,46,-4,44
FC Zürich,7824,5,10,9,13,41,39,2,39
Grasshoppers,7824,6,10,8,14,43,47,-4,38
FC Thun,7824,7,10,6,16,46,65,-19,36
FC Lugano,7824,8,9,7,16,33,50,-17,34
FC Sion,7824,9,6,7,19,43,61,-18,25
Young Boys,7825,1,20,6,6,70,38,32,66
FC Basel,7825,2,18,7,7,61,34,27,61
St Gallen,7825,3,15,4,13,47,55,-8,49
Lucerne,7825,4,13,9,10,43,42,1,48
FC Zürich,7825,5,11,9,12,46,43,3,42
FC Thun,7825,6,11,5,16,50,61,-11,38
FC Lugano,7825,7,10,6,16,30,48,-18,36
Grasshoppers,7825,8,9,7,16,41,50,-9,34
FC Sion,7825,9,7,7,18,39,56,-17,28
Young Boys,7826,1,22,8,2,77,33,44,74
FC Basel,7826,2,17,10,5,53,25,28,61
St Gallen,7826,3,14,4,14,44,53,-9,46
Lucerne,7826,4,12,9,11,42,48,-6,45
FC Zürich,7826,5,11,10,11,40,34,6,43
FC Thun,7826,6,10,7,15,46,55,-9,37
FC Lugano,7826,7,9,7,16,28,48,-20,34
Grasshoppers,7826,8,9,6,17,45,58,-13,33
FC Sion,7826,9,6,7,19,38,59,-21,25
Young Boys,7827,1,22,6,4,76,38,38,72
FC Basel,7827,2,18,8,6,56,27,29,62
St Gallen,7827,3,15,2,15,45,58,-13,47
FC Zürich,7827,4,12,9,11,43,36,7,45
Lucerne,7827,5,12,8,12,44,48,-4,44
FC Lugano,7827,6,10,5,17,30,50,-20,35
Grasshoppers,7827,7,9,7,16,40,50,-10,34
FC Thun,7827,8,9,7,16,43,58,-15,34
FC Sion,7827,9,7,8,17,42,54,-12,29
Young Boys,7828,1,22,7,3,72,34,38,73
FC Basel,7828,2,18,7,7,55,27,28,61
FC Zürich,7828,3,13,9,10,45,34,11,48
St Gallen,7828,4,15,2,15,45,55,-10,47
Lucerne,7828,5,13,7,12,42,45,-3,46
Grasshoppers,7828,6,9,8,15,41,50,-9,35
FC Thun,7828,7,9,5,18,43,61,-18,32
FC Lugano,7828,8,9,5,18,28,50,-22,32
FC Sion,7828,9,7,8,17,38,53,-15,29
Young Boys,7829,1,23,6,3,82,38,44,75
FC Basel,7829,2,16,9,7,53,30,23,57
Lucerne,7829,3,12,8,12,41,45,-4,44
St Gallen,7829,4,14,2,16,43,58,-15,44
FC Zürich,7829,5,11,10,11,42,36,6,43
Grasshoppers,7829,6,11,6,15,45,47,-2,39
FC Lugano,7829,7,11,6,15,33,48,-15,39
FC Thun,7829,8,10,6,16,47,59,-12,36
FC Sion,7829,9,6,7,19,42,67,-25,25
Young Boys,7830,1,20,8,4,72,38,34,68
FC Basel,7830,2,19,7,6,56,27,29,64
St Gallen,7830,3,14,3,15,46,57,-11,45
Lucerne,7830,4,11,10,11,38,43,-5,43
FC Zürich,7830,5,10,10,12,38,35,3,40
Grasshoppers,7830,6,10,8,14,41,47,-6,38
FC Lugano,7830,7,10,7,15,30,46,-16,37
FC Thun,7830,8,10,6,16,43,55,-12,36
FC Sion,7830,9,6,9,17,39,55,-16,27
Young Boys,7831,1,22,7,3,73,36,37,73
FC Basel,7831,2,16,10,6,55,29,26,58
Lucerne,7831,3,12,10,10,44,45,-1,46
FC Zürich,7831,4,11,11,10,43,37,6,44
St Gallen,7831,5,13,3,16,40,56,-16,42
FC Lugano,7831,6,11,5,16,30,46,-16,38
Grasshoppers,7831,7,10,7,15,46,51,-5,37
FC Thun,7831,8,8,7,17,45,63,-18,31
FC Sion,7831,9,7,8,17,43,56,-13,29
Young Boys,7832,1,23,6,3,78,34,44,75
FC Basel,7832,2,17,8,7,56,28,28,59
St Gallen,7832,3,15,3,14,45,56,-11,48
FC Zürich,7832,4,11,10,11,39,34,5,43
Lucerne,7832,5,12,7,13,43,50,-7,43
FC Thun,7832,6,10,6,16,44,56,-12,36
FC Lugano,7832,7,10,6,16,32,49,-17,36
Grasshoppers,7832,8,9,6,17,39,51,-12,33
FC Sion,7832,9,7,8,17,37,55,-18,29
Young Boys,7833,1,22,7,3,74,33,41,73
FC Basel,7833,2,18,8,6,56,27,29,62
St Gallen,7833,3,14,5,13,42,52,-10,47
Lucerne,7833,4,12,9,11,43,45,-2,45
FC Zürich,7833,5,10,10,12,39,36,3,40
FC Thun,7833,6,10,5,17,47,59,-12,35
Grasshoppers,7833,7,9,7,16,39,50,-11,34
FC Lugano,7833,8,9,7,16,31,53,-22,34
FC Sion,7833,9,7,8,17,37,53,-16,29
Young Boys,7834,1,22,7,3,70,33,37,73
FC Basel,7834,2,18,9,5,56,26,30,63
St Gallen,7834,3,14,3,15,42,56,-14,45
FC Zürich,7834,4,11,10,11,40,35,5,43
Lucerne,7834,5,11,9,12,39,44,-5,42
Grasshoppers,7834,6,10,7,15,40,47,-7,37
FC Lugano,7834,7,10,6,16,34,48,-14,36
FC Thun,7834,8,9,7,16,43,56,-13,34
FC Sion,7834,9,6,8,18,35,54,-19,26
Young Boys,7835,1,23,7,2,77,33,44,76
FC Basel,7835,2,18,9,5,55,27,28,63
Lucerne,7835,3,12,7,13,43,50,-7,43
St Gallen,7835,4,13,4,15,42,56,-14,43
FC Zürich,7835,5,10,10,12,42,40,2,40
FC Lugano,7835,6,10,7,15,32,47,-15,37
Grasshoppers,7835,7,10,6,16,45,52,-7,36
FC Thun,7835,8,10,5,17,48,59,-11,35
FC Sion,7835,9,7,7,18,39,59,-20,28
Young Boys,7836,1,23,6,3,74,31,43,75
FC Basel,7836,2,18,8,6,53,24,29,62
Lucerne,7836,3,12,9,11,41,46,-5,45
St Gallen,7836,4,14,2,16,42,56,-14,44
FC Zürich,7836,5,10,10,12,39,37,2,40
FC Lugano,7836,6,11,6,15,33,48,-15,39
Grasshoppers,7836,7,10,6,16,39,48,-9,36
FC Thun,7836,8,8,7,17,40,59,-19,31
FC Sion,7836,9,7,8,17,39,51,-12,29
Young Boys,7837,1,23,6,3,73,34,39,75
FC Basel,7837,2,18,7,7,53,26,27,61
St Gallen,7837,3,15,3,14,45,55,-10,48
Lucerne,7837,4,13,8,11,48,46,2,47
FC Zürich,7837,5,11,11,10,42,35,7,44
Grasshoppers,7837,6,10,7,15,45,49,-4,37
FC Thun,7837,7,9,6,17,42,59,-17,33
FC Lugano,7837,8,9,6,17,29,51,-22,33
FC Sion,7837,9,5,8,19,38,60,-22,23
Young Boys,7838,1,20,8,4,69,36,33,68
FC Basel,7838,2,16,9,7,53,26,27,57
Lucerne,7838,3,15,7,10,45,44,1,52
St Gallen,7838,4,14,4,14,40,53,-13,46
FC Zürich,7838,5,10,11,11,41,36,5,41
FC Thun,7838,6,10,7,15,44,56,-12,37
FC Lugano,7838,7,9,7,16,29,47,-18,34
Grasshoppers,7838,8,9,6,17,41,53,-12,33
FC Sion,7838,9,7,9,16,40,51,-11,30
Young Boys,7839,1,21,7,4,70,36,34,70
FC Basel,7839,2,19,7,6,54,24,30,64
St Gallen,7839,3,15,2,15,42,53,-11,47
FC Zürich,7839,4,12,9,11,45,34,11,45
Lucerne,7839,5,12,8,12,39,45,-6,44
Grasshoppers,7839,6,10,6,16,40,49,-9,36
FC Lugano,7839,7,10,6,16,29,47,-18,36
FC Thun,7839,8,9,6,17,44,60,-16,33
FC Sion,7839,9,6,9,17,37,52,-15,27
Young Boys,7840,1,23,7,2,72,33,39,76
FC Basel,7840,2,18,8,6,57,26,31,62
St Gallen,7840,3,15,3,14,46,56,-10,48
Lucerne,7840,4,12,9,11,41,44,-3,45
FC Zürich,7840,5,9,9,14,38,41,-3,36
FC Lugano,7840,6,10,6,16,35,50,-15,36
FC Thun,7840,7,10,5,17,44,60,-16,35
Grasshoppers,7840,8,9,7,16,40,49,-9,34
FC Sion,7840,9,7,8,17,39,53,-14,29
Young Boys,7841,1,22,7,3,71,32,39,73
FC Basel,7841,2,17,9,6,51,26,25,60
Lucerne,7841,3,13,8,11,42,44,-2,47
St Gallen,7841,4,14,3,15,43,55,-12,45
FC Lugano,7841,5,11,6,15,30,44,-14,39
FC Zürich,7841,6,9,11,12,39,38,1,38
Grasshoppers,7841,7,9,7,16,40,48,-8,34
FC Thun,7841,8,9,7,16,44,59,-15,34
FC Sion,7841,9,6,10,16,40,54,-14,28
Young Boys,7842,1,22,7,3,70,32,38,73
FC Basel,7842,2,18,8,6,58,26,32,62
Lucerne,7842,3,13,7,12,44,47,-3,46
FC Zürich,7842,4,11,11,10,43,37,6,44
St Gallen,7842,5,14,2,16,42,58,-16,44
FC Lugano,7842,6,11,6,15,34,48,-14,39
FC Sion,7842,7,8,8,16,43,52,-9,32
FC Thun,7842,8,9,5,18,44,65,-21,32
Grasshoppers,7842,9,8,6,18,37,50,-13,30
Young Boys,7843,1,24,6,2,75,32,43,78
FC Basel,7843,2,16,8,8,50,27,23,56
St Gallen,7843,3,14,4,14,43,56,-13,46
FC Zürich,7843,4,12,9,11,47,39,8,45
Lucerne,7843,5,11,8,13,38,47,-9,41
FC Thun,7843,6,11,5,16,46,56,-10,38
FC Lugano,7843,7,9,7,16,33,50,-17,34
Grasshoppers,7843,8,9,6,17,38,52,-14,33
FC Sion,7843,9,8,7,17,42,53,-11,31
Young Boys,7844,1,21,8,3,68,33,35,71
FC Basel,7844,2,18,9,5,55,25,30,63
St Gallen,7844,3,15,2,15,41,53,-12,47
FC Zürich,7844,4,11,11,10,43,37,6,44
Lucerne,7844,5,12,8,12,41,45,-4,44
Grasshoppers,7844,6,10,6,16,42,47,-5,36
FC Thun,7844,7,9,6,17,43,61,-18,33
FC Lugano,7844,8,9,6,17,31,50,-19,33
FC Sion,7844,9,7,8,17,39,52,-13,29
Young Boys,7845,1,20,8,4,70,40,30,68
FC Basel,7845,2,19,8,5,60,28,32,65
Lucerne,7845,3,13,9,10,45,44,1,48
St Gallen,7845,4,15,2,15,47,55,-8,47
FC Zürich,7845,5,10,9,13,40,40,0,39
Grasshoppers,7845,6,10,8,14,43,49,-6,38
FC Lugano,7845,7,10,6,16,30,49,-19,36
FC Thun,7845,8,10,5,17,47,59,-12,35
FC Sion,7845,9,6,7,19,38,56,-18,25
Young Boys,7846,1,21,8,3,72,33,39,71
FC Basel,7846,2,17,10,5,53,25,28,61
St Gallen,7846,3,14,4,14,43,53,-10,46
Lucerne,7846,4,12,8,12,44,49,-5,44
FC Zürich,7846,5,11,10,11,40,35,5,43
Grasshoppers,7846,6,10,8,14,41,47,-6,38
FC Lugano,7846,7,9,6,17,27,49,-22,33
FC Sion,7846,8,7,10,15,44,54,-10,31
FC Thun,7846,9,8,6,18,42,61,-19,30
Young Boys,7847,1,22,7,3,71,34,37,73
FC Basel,7847,2,18,8,6,52,25,27,62
St Gallen,7847,3,15,3,14,44,53,-9,48
Lucerne,7847,4,12,9,11,45,46,-1,45
FC Zürich,7847,5,10,10,12,41,40,1,40
FC Thun,7847,6,10,6,16,50,60,-10,36
Grasshoppers,7847,7,10,6,16,42,53,-11,36
FC Lugano,7847,8,9,7,16,32,51,-19,34
FC Sion,7847,9,6,8,18,43,58,-15,26
Young Boys,7848,1,22,6,4,73,35,38,72
FC Basel,7848,2,19,8,5,55,24,31,65
St Gallen,7848,3,15,2,15,43,55,-12,47
Lucerne,7848,4,11,8,13,38,46,-8,41
FC Zürich,7848,5,9,13,10,40,36,4,40
Grasshoppers,7848,6,11,6,15,45,49,-4,39
FC Thun,7848,7,10,6,16,48,60,-12,36
FC Lugano,7848,8,9,7,16,28,47,-19,34
FC Sion,7848,9,6,8,18,37,55,-18,26
Young Boys,7849,1,22,7,3,72,34,38,73
FC Basel,7849,2,17,8,7,54,27,27,59
Lucerne,7849,3,13,8,11,40,40,0,47
FC Zürich,7849,4,11,10,11,44,39,5,43
St Gallen,7849,5,13,4,15,43,56,-13,43
Grasshoppers,7849,6,11,7,14,45,49,-4,40
FC Lugano,7849,7,9,8,15,30,48,-18,35
FC Thun,7849,8,9,5,18,44,61,-17,32
FC Sion,7849,9,7,7,18,40,58,-18,28
Young Boys,7850,1,21,7,4,70,39,31,70
FC Basel,7850,2,17,7,8,59,29,30,58
Lucerne,7850,3,14,8,10,42,40,2,50
St Gallen,7850,4,15,2,15,42,59,-17,47
FC Lugano,7850,5,12,5,15,37,45,-8,41
FC Zürich,7850,6,10,10,12,41,39,2,40
Grasshoppers,7850,7,10,6,16,40,46,-6,36
FC Thun,7850,8,9,6,17,42,62,-20,33
FC Sion,7850,9,6,9,17,40,54,-14,27
Young Boys,7851,1,21,7,4,78,43,35,70
FC Basel,7851,2,20,7,5,57,25,32,67
Lucerne,7851,3,12,9,11,44,48,-4,45
St Gallen,7851,4,14,2,16,42,54,-12,44
FC Zürich,7851,5,9,11,12,42,41,1,38
FC Lugano,7851,6,10,7,15,33,49,-16,37
Grasshoppers,7851,7,8,10,14,41,49,-8,34
FC Thun,7851,8,9,7,16,44,57,-13,34
FC Sion,7851,9,7,8,17,42,57,-15,29
Young Boys,7852,1,20,7,5,69,41,28,67
FC Basel,7852,2,18,8,6,59,26,33,62
St Gallen,7852,3,16,3,13,46,51,-5,51
Lucerne,7852,4,13,8,11,43,44,-1,47
FC Zürich,7852,5,10,10,12,39,37,2,40
Grasshoppers,7852,6,9,8,15,44,53,-9,35
FC Thun,7852,7,9,7,16,46,62,-16,34
FC Lugano,7852,8,9,7,16,29,49,-20,34
FC Sion,7852,9,7,8,17,43,55,-12,29
Young Boys,7853,1,23,7,2,74,31,43,76
FC Basel,7853,2,17,9,6,54,27,27,60
Lucerne,7853,3,13,9,10,44,41,3,48
St Gallen,7853,4,13,2,17,40,62,-22,41
FC Zürich,7853,5,10,10,12,39,36,3,40
FC Lugano,7853,6,11,6,15,33,45,-12,39
FC Thun,7853,7,9,6,17,41,58,-17,33
FC Sion,7853,8,8,8,16,41,52,-11,32
Grasshoppers,7853,9,8,7,17,36,50,-14,31
Young Boys,7854,1,21,8,3,75,37,38,71
FC Basel,7854,2,16,9,7,53,29,24,57
Lucerne,7854,3,14,8,10,47,43,4,50
St Gallen,7854,4,14,3,15,42,56,-14,45
FC Zürich,7854,5,10,11,11,38,35,3,41
FC Lugano,7854,6,10,5,17,31,51,-20,35
FC Thun,7854,7,9,7,16,42,58,-16,34
FC Sion,7854,8,8,9,15,42,50,-8,33
Grasshoppers,7854,9,9,6,17,41,52,-11,33
Young Boys,7855,1,22,6,4,74,37,37,72
FC Basel,7855,2,18,8,6,58,31,27,62
St Gallen,7855,3,13,6,13,44,55,-11,45
FC Zürich,7855,4,11,11,10,44,36,8,44
Lucerne,7855,5,11,10,11,37,42,-5,43
FC Lugano,7855,6,9,8,15,27,43,-16,35
FC Thun,7855,7,9,7,16,47,62,-15,34
Grasshoppers,7855,8,8,7,17,40,53,-13,31
FC Sion,7855,9,7,9,16,44,56,-12,30
Young Boys,7856,1,23,6,3,78,37,41,75
FC Basel,7856,2,17,9,6,53,25,28,60
Lucerne,7856,3,15,7,10,47,44,3,52
St Gallen,7856,4,14,3,15,43,58,-15,45
FC Zürich,7856,5,10,10,12,38,38,0,40
FC Thun,7856,6,10,6,16,46,57,-11,36
Grasshoppers,7856,7,9,6,17,38,54,-16,33
FC Lugano,7856,8,9,5,18,34,56,-22,32
FC Sion,7856,9,7,8,17,44,52,-8,29
Young Boys,7857,1,21,8,3,72,35,37,71
FC Basel,7857,2,18,8,6,52,25,27,62
St Gallen,7857,3,15,3,14,45,55,-10,48
Lucerne,7857,4,11,10,11,41,45,-4,43
FC Zürich,7857,5,9,13,10,38,34,4,40
FC Thun,7857,6,10,6,16,45,57,-12,36
Grasshoppers,7857,7,9,8,15,41,51,-10,35
FC Lugano,7857,8,9,8,15,31,47,-16,35
FC Sion,7857,9,6,8,18,40,56,-16,26
Young Boys,7858,1,21,7,4,72,34,38,70
FC Basel,7858,2,18,9,5,59,28,31,63
Lucerne,7858,3,12,10,10,40,41,-1,46
St Gallen,7858,4,14,4,14,44,55,-11,46
FC Lugano,7858,5,12,5,15,32,45,-13,41
FC Zürich,7858,6,10,10,12,41,38,3,40
Grasshoppers,7858,7,10,7,15,40,48,-8,37
FC Thun,7858,8,8,6,18,40,61,-21,30
FC Sion,7858,9,5,10,17,38,56,-18,25
Young Boys,7859,1,21,8,3,70,35,35,71
FC Basel,7859,2,18,9,5,55,25,30,63
Lucerne,7859,3,13,8,11,48,46,2,47
St Gallen,7859,4,14,4,14,43,54,-11,46
FC Zürich,7859,5,10,10,12,38,37,1,40
Grasshoppers,7859,6,9,8,15,47,55,-8,35
FC Lugano,7859,7,9,6,17,31,50,-19,33
FC Sion,7859,8,8,8,16,44,55,-11,32
FC Thun,7859,9,8,7,17,44,63,-19,31
Young Boys,7860,1,22,6,4,76,40,36,72
FC Basel,7860,2,18,8,6,59,28,31,62
Lucerne,7860,3,12,10,10,44,43,1,46
St Gallen,7860,4,14,3,15,43,58,-15,45
FC Zürich,7860,5,10,10,12,40,38,2,40
FC Lugano,7860,6,11,6,15,33,47,-14,39
Grasshoppers,7860,7,10,7,15,42,51,-9,37
FC Thun,7860,8,8,7,17,42,60,-18,31
FC Sion,7860,9,7,7,18,42,56,-14,28
Young Boys,7861,1,22,8,2,72,33,39,74
FC Basel,7861,2,19,8,5,56,23,33,65
St Gallen,7861,3,14,3,15,44,55,-11,45
Lucerne,7861,4,12,8,12,44,48,-4,44
FC Zürich,7861,5,10,10,12,41,37,4,40
Grasshoppers,7861,6,11,7,14,46,48,-2,40
FC Lugano,7861,7,10,5,17,33,54,-21,35
FC Thun,7861,8,9,5,18,41,63,-22,32
FC Sion,7861,9,6,8,18,39,55,-16,26
Young Boys,7862,1,21,8,3,77,39,38,71
FC Basel,7862,2,17,9,6,56,29,27,60
FC Zürich,7862,3,13,9,10,43,33,10,48
Lucerne,7862,4,13,9,10,43,44,-1,48
St Gallen,7862,5,14,3,15,41,52,-11,45
Grasshoppers,7862,6,10,8,14,45,47,-2,38
FC Lugano,7862,7,9,6,17,29,49,-20,33
FC Thun,7862,8,8,6,18,42,62,-20,30
FC Sion,7862,9,6,8,18,41,62,-21,26
Young Boys,7863,1,20,9,3,71,35,36,69
FC Basel,7863,2,18,9,5,52,23,29,63
Lucerne,7863,3,14,7,11,45,42,3,49
St Gallen,7863,4,13,2,17,41,60,-19,41
FC Zürich,7863,5,9,12,11,38,35,3,39
FC Lugano,7863,6,10,7,15,34,52,-18,37
FC Thun,7863,7,10,6,16,41,55,-14,36
FC Sion,7863,8,8,9,15,41,48,-7,33
Grasshoppers,7863,9,8,7,17,40,53,-13,31
Young Boys,7864,1,23,6,3,74,32,42,75
FC Basel,7864,2,17,8,7,51,25,26,59
Lucerne,7864,3,13,9,10,42,43,-1,48
St Gallen,7864,4,14,3,15,45,57,-12,45
FC Zürich,7864,5,11,9,12,39,35,4,42
FC Thun,7864,6,11,5,16,45,56,-11,38
FC Lugano,7864,7,11,5,16,30,49,-19,38
Grasshoppers,7864,8,8,7,17,38,51,-13,31
FC Sion,7864,9,6,8,18,40,56,-16,26
Young Boys,7865,1,22,7,3,74,34,40,73
FC Basel,7865,2,17,9,6,54,27,27,60
St Gallen,7865,3,14,3,15,43,56,-13,45
Lucerne,7865,4,12,7,13,40,51,-11,43
FC Zürich,7865,5,11,9,12,41,37,4,42
Grasshoppers,7865,6,11,7,14,48,49,-1,40
FC Lugano,7865,7,11,6,15,31,47,-16,39
FC Thun,7865,8,10,7,15,46,58,-12,37
FC Sion,7865,9,5,7,20,38,56,-18,22
Young Boys,7866,1,21,9,2,73,36,37,72
FC Basel,7866,2,16,11,5,52,25,27,59
Lucerne,7866,3,12,11,9,39,39,0,47
St Gallen,7866,4,14,4,14,46,56,-10,46
FC Zürich,7866,5,10,11,11,44,39,5,41
FC Thun,7866,6,10,7,15,49,60,-11,37
FC Lugano,7866,7,10,6,16,32,50,-18,36
Grasshoppers,7866,8,8,8,16,42,52,-10,32
FC Sion,7866,9,5,9,18,39,59,-20,24
Young Boys,7867,1,22,7,3,73,37,36,73
FC Basel,7867,2,17,9,6,56,31,25,60
Lucerne,7867,3,14,8,10,43,41,2,50
St Gallen,7867,4,14,2,16,43,57,-14,44
FC Zürich,7867,5,11,10,11,44,43,1,43
FC Lugano,7867,6,11,5,16,37,47,-10,38
Grasshoppers,7867,7,10,7,15,41,47,-6,37
FC Thun,7867,8,9,5,18,43,61,-18,32
FC Sion,7867,9,6,7,19,40,56,-16,25
Young Boys,7868,1,21,8,3,74,37,37,71
FC Basel,7868,2,17,8,7,52,29,23,59
St Gallen,7868,3,15,4,13,46,51,-5,49
Lucerne,7868,4,13,9,10,42,40,2,48
FC Zürich,7868,5,12,9,11,42,33,9,45
Grasshoppers,7868,6,10,8,14,42,46,-4,38
FC Lugano,7868,7,9,5,18,29,54,-25,32
FC Sion,7868,8,7,8,17,42,56,-14,29
FC Thun,7868,9,8,5,19,43,66,-23,29
Young Boys,7869,1,20,8,4,69,35,34,68
FC Basel,7869,2,19,7,6,54,26,28,64
Lucerne,7869,3,13,7,12,42,44,-2,46
St Gallen,7869,4,14,3,15,43,56,-13,45
FC Zürich,7869,5,10,10,12,38,35,3,40
Grasshoppers,7869,6,10,7,15,40,47,-7,37
FC Thun,7869,7,10,6,16,42,57,-15,36
FC Lugano,7869,8,9,8,15,30,46,-16,35
FC Sion,7869,9,7,8,17,40,52,-12,29
Young Boys,7870,1,22,6,4,76,35,41,72
FC Basel,7870,2,18,9,5,55,26,29,63
St Gallen,7870,3,14,3,15,42,55,-13,45
Lucerne,7870,4,12,8,12,44,53,-9,44
FC Zürich,7870,5,10,10,12,40,37,3,40
Grasshoppers,7870,6,11,6,15,43,46,-3,39
FC Lugano,7870,7,11,5,16,33,50,-17,38
FC Thun,7870,8,10,5,17,43,59,-16,35
FC Sion,7870,9,6,8,18,41,56,-15,26
Young Boys,7871,1,22,7,3,71,33,38,73
FC Basel,7871,2,17,9,6,54,26,28,60
St Gallen,7871,3,15,2,15,43,54,-11,47
Lucerne,7871,4,12,9,11,40,43,-3,45
FC Zürich,7871,5,11,9,12,41,36,5,42
FC Lugano,7871,6,11,6,15,31,47,-16,39
Grasshoppers,7871,7,9,8,15,44,49,-5,35
FC Thun,7871,8,9,6,17,43,63,-20,33
FC Sion,7871,9,6,8,18,41,57,-16,26
Young Boys,7872,1,22,7,3,71,33,38,73
FC Basel,7872,2,17,9,6,54,25,29,60
Lucerne,7872,3,13,8,11,41,42,-1,47
St Gallen,7872,4,14,5,13,42,52,-10,47
FC Zürich,7872,5,12,9,11,48,37,11,45
Grasshoppers,7872,6,10,7,15,42,50,-8,37
FC Lugano,7872,7,9,7,16,32,50,-18,34
FC Thun,7872,8,8,5,19,42,66,-24,29
FC Sion,7872,9,6,9,17,40,57,-17,27
Young Boys,7873,1,21,8,3,70,36,34,71
FC Basel,7873,2,17,9,6,55,28,27,60
Lucerne,7873,3,14,9,9,48,43,5,51
St Gallen,7873,4,16,2,14,46,55,-9,50
FC Zürich,7873,5,9,12,11,38,36,2,39
Grasshoppers,7873,6,10,6,16,44,51,-7,36
FC Lugano,7873,7,9,8,15,31,47,-16,35
FC Thun,7873,8,8,7,17,41,59,-18,31
FC Sion,7873,9,5,9,18,36,54,-18,24
Young Boys,7874,1,21,7,4,73,35,38,70
FC Basel,7874,2,17,7,8,51,30,21,58
St Gallen,7874,3,15,2,15,44,57,-13,47
FC Zürich,7874,4,12,10,10,41,33,8,46
Lucerne,7874,5,12,8,12,44,44,0,44
FC Lugano,7874,6,12,5,15,35,46,-11,41
Grasshoppers,7874,7,11,6,15,45,50,-5,39
FC Thun,7874,8,9,5,18,40,58,-18,32
FC Sion,7874,9,6,8,18,38,58,-20,26
Young Boys,7875,1,22,8,2,73,31,42,74
FC Basel,7875,2,16,8,8,48,29,19,56
St Gallen,7875,3,16,2,14,43,52,-9,50
Lucerne,7875,4,14,7,11,44,41,3,49
FC Zürich,7875,5,10,9,13,37,38,-1,39
FC Thun,7875,6,10,7,15,42,54,-12,37
FC Lugano,7875,7,10,6,16,30,47,-17,36
FC Sion,7875,8,7,9,16,41,51,-10,30
Grasshoppers,7875,9,8,6,18,37,52,-15,30
Young Boys,7876,1,20,6,6,72,39,33,66
FC Basel,7876,2,19,8,5,58,23,35,65
Lucerne,7876,3,14,7,11,44,41,3,49
St Gallen,7876,4,15,3,14,44,56,-12,48
FC Zürich,7876,5,10,11,11,38,35,3,41
Grasshoppers,7876,6,10,6,16,41,50,-9,36
FC Thun,7876,7,10,5,17,45,62,-17,35
FC Lugano,7876,8,9,5,18,28,53,-25,32
FC Sion,7876,9,7,9,16,41,52,-11,30
Young Boys,7877,1,21,8,3,73,35,38,71
FC Basel,7877,2,16,9,7,52,31,21,57
Lucerne,7877,3,15,7,10,47,44,3,52
St Gallen,7877,4,14,3,15,49,56,-7,45
FC Zürich,7877,5,9,13,10,42,38,4,40
FC Thun,7877,6,10,7,15,48,60,-12,37
Grasshoppers,7877,7,9,8,15,41,48,-7,35
FC Lugano,7877,8,9,7,16,29,48,-19,34
FC Sion,7877,9,6,8,18,41,62,-21,26
Young Boys,7878,1,23,6,3,71,33,38,75
FC Basel,7878,2,17,9,6,53,27,26,60
St Gallen,7878,3,14,4,14,43,53,-10,46
Lucerne,7878,4,12,8,12,37,43,-6,44
FC Lugano,7878,5,11,5,16,31,46,-15,38
FC Zürich,7878,6,9,9,14,38,39,-1,36
FC Thun,7878,7,10,6,16,41,55,-14,36
Grasshoppers,7878,8,9,7,16,39,47,-8,34
FC Sion,7878,9,8,8,16,39,49,-10,32
Young Boys,7879,1,21,7,4,74,41,33,70
FC Basel,7879,2,18,9,5,55,26,29,63
St Gallen,7879,3,14,4,14,41,53,-12,46
Lucerne,7879,4,12,9,11,44,46,-2,45
FC Zürich,7879,5,10,10,12,39,35,4,40
FC Thun,7879,6,11,6,15,44,56,-12,39
FC Lugano,7879,7,10,6,16,33,50,-17,36
Grasshoppers,7879,8,9,6,17,41,52,-11,33
FC Sion,7879,9,6,9,17,42,54,-12,27
Young Boys,7880,1,23,6,3,80,33,47,75
FC Basel,7880,2,19,8,5,53,23,30,65
Lucerne,7880,3,14,7,11,46,43,3,49
St Gallen,7880,4,14,2,16,41,58,-17,44
FC Zürich,7880,5,10,11,11,39,35,4,41
FC Lugano,7880,6,10,5,17,31,52,-21,35
FC Thun,7880,7,9,7,16,43,59,-16,34
Grasshoppers,7880,8,8,7,17,37,53,-16,31
FC Sion,7880,9,6,9,17,41,55,-14,27
Young Boys,7881,1,23,6,3,73,33,40,75
FC Basel,7881,2,18,7,7,54,27,27,61
St Gallen,7881,3,15,2,15,47,58,-11,47
Lucerne,7881,4,13,7,12,43,44,-1,46
FC Zürich,7881,5,11,9,12,41,36,5,42
FC Thun,7881,6,10,5,17,42,60,-18,35
FC Lugano,7881,7,10,5,17,30,52,-22,35
Grasshoppers,7881,8,9,6,17,40,49,-9,33
FC Sion,7881,9,8,7,17,43,54,-11,31
Young Boys,7882,1,22,7,3,73,34,39,73
FC Basel,7882,2,18,8,6,54,24,30,62
St Gallen,7882,3,15,3,14,44,53,-9,48
FC Zürich,7882,4,11,10,11,40,35,5,43
Lucerne,7882,5,11,8,13,38,46,-8,41
FC Thun,7882,6,10,6,16,43,57,-14,36
FC Lugano,7882,7,10,6,16,30,47,-17,36
Grasshoppers,7882,8,9,8,15,39,47,-8,35
FC Sion,7882,9,5,10,17,39,57,-18,25
Young Boys,7883,1,20,8,4,69,37,32,68
FC Basel,7883,2,16,9,7,57,34,23,57
Lucerne,7883,3,14,9,9,47,43,4,51
St Gallen,7883,4,14,3,15,45,57,-12,45
FC Zürich,7883,5,11,11,10,41,35,6,44
FC Lugano,7883,6,10,8,14,31,44,-13,38
Grasshoppers,7883,7,9,8,15,45,51,-6,35
FC Thun,7883,8,9,6,17,47,64,-17,33
FC Sion,7883,9,6,8,18,40,57,-17,26
Young Boys,7884,1,21,9,2,70,34,36,72
FC Basel,7884,2,17,10,5,60,25,35,61
Lucerne,7884,3,13,8,11,41,43,-2,47
St Gallen,7884,4,15,2,15,43,60,-17,47
FC Zürich,7884,5,11,11,10,42,34,8,44
Grasshoppers,7884,6,9,7,16,44,53,-9,34
FC Thun,7884,7,9,7,16,49,63,-14,34
FC Lugano,7884,8,9,6,17,28,48,-20,33
FC Sion,7884,9,6,8,18,40,57,-17,26
Young Boys,7885,1,23,7,2,76,35,41,76
FC Basel,7885,2,16,10,6,52,27,25,58
Lucerne,7885,3,12,8,12,39,43,-4,44
St Gallen,7885,4,13,5,14,41,53,-12,44
FC Zürich,7885,5,11,10,11,43,38,5,43
Grasshoppers,7885,6,10,6,16,41,49,-8,36
FC Lugano,7885,7,10,6,16,34,52,-18,36
FC Thun,7885,8,9,8,15,44,57,-13,35
FC Sion,7885,9,6,8,18,36,52,-16,26
Young Boys,7886,1,22,8,2,78,36,42,74
FC Basel,7886,2,17,8,7,53,31,22,59
St Gallen,7886,3,15,3,14,46,54,-8,48
Lucerne,7886,4,12,7,13,41,47,-6,43
FC Lugano,7886,5,11,6,15,32,47,-15,39
FC Zürich,7886,6,9,11,12,38,36,2,38
Grasshoppers,7886,7,9,8,15,41,48,-7,35
FC Thun,7886,8,9,5,18,42,61,-19,32
FC Sion,7886,9,7,10,15,42,53,-11,31
Young Boys,7887,1,21,8,3,70,34,36,71
FC Basel,7887,2,18,8,6,53,26,27,62
St Gallen,7887,3,16,2,14,45,53,-8,50
Lucerne,7887,4,12,7,13,39,49,-10,43
FC Zürich,7887,5,11,9,12,42,37,5,42
FC Thun,7887,6,11,5,16,47,59,-12,38
Grasshoppers,7887,7,9,7,16,45,51,-6,34
FC Lugano,7887,8,9,5,18,28,48,-20,32
FC Sion,7887,9,8,7,17,43,55,-12,31
Young Boys,7888,1,24,6,2,75,32,43,78
FC Basel,7888,2,17,8,7,54,26,28,59
Lucerne,7888,3,14,8,10,43,42,1,50
FC Zürich,7888,4,13,9,10,46,35,11,48
St Gallen,7888,5,14,2,16,41,56,-15,44
FC Thun,7888,6,10,5,17,45,59,-14,35
FC Lugano,7888,7,10,5,17,30,50,-20,35
Grasshoppers,7888,8,8,6,18,37,50,-13,30
FC Sion,7888,9,6,7,19,38,59,-21,25
Young Boys,7889,1,20,9,3,69,35,34,69
FC Basel,7889,2,17,9,6,50,23,27,60
St Gallen,7889,3,13,4,15,40,55,-15,43
Lucerne,7889,4,11,9,12,37,42,-5,42
FC Lugano,7889,5,12,6,14,35,45,-10,42
FC Zürich,7889,6,10,10,12,39,37,2,40
Grasshoppers,7889,7,11,7,14,43,45,-2,40
FC Thun,7889,8,9,6,17,43,61,-18,33
FC Sion,7889,9,7,8,17,43,56,-13,29
Young Boys,7890,1,22,8,2,77,37,40,74
FC Basel,7890,2,17,10,5,57,29,28,61
St Gallen,7890,3,14,4,14,44,54,-10,46
FC Zürich,7890,4,11,10,11,42,35,7,43
Lucerne,7890,5,11,8,13,41,49,-8,41
FC Thun,7890,6,11,5,16,45,59,-14,38
Grasshoppers,7890,7,9,7,16,42,53,-11,34
FC Lugano,7890,8,9,7,16,31,51,-20,34
FC Sion,7890,9,7,7,18,42,54,-12,28
Young Boys,7891,1,23,6,3,74,36,38,75
FC Basel,7891,2,17,8,7,53,28,25,59
Lucerne,7891,3,13,8,11,43,44,-1,47
St Gallen,7891,4,14,4,14,41,53,-12,46
FC Zürich,7891,5,10,9,13,38,35,3,39
Grasshoppers,7891,6,10,7,15,47,50,-3,37
FC Sion,7891,7,9,8,15,46,52,-6,35
FC Lugano,7891,8,10,5,17,30,49,-19,35
FC Thun,7891,9,8,5,19,39,64,-25,29
Young Boys,7892,1,22,7,3,70,32,38,73
FC Basel,7892,2,18,8,6,57,30,27,62
St Gallen,7892,3,16,3,13,48,50,-2,51
FC Zürich,7892,4,12,10,10,46,36,10,46
Lucerne,7892,5,11,8,13,41,48,-7,41
Grasshoppers,7892,6,10,7,15,41,49,-8,37
FC Lugano,7892,7,10,6,16,31,50,-19,36
FC Thun,7892,8,9,5,18,41,60,-19,32
FC Sion,7892,9,5,8,19,37,57,-20,23
Young Boys,7893,1,22,7,3,73,34,39,73
FC Basel,7893,2,18,8,6,52,24,28,62
Lucerne,7893,3,12,10,10,40,41,-1,46
St Gallen,7893,4,13,4,15,41,55,-14,43
FC Lugano,7893,5,12,5,15,31,43,-12,41
FC Zürich,7893,6,10,9,13,41,40,1,39
Grasshoppers,7893,7,10,6,16,44,55,-11,36
FC Thun,7893,8,10,5,17,48,60,-12,35
FC Sion,7893,9,6,8,18,40,58,-18,26
Young Boys,7894,1,22,6,4,71,36,35,72
FC Basel,7894,2,17,8,7,54,24,30,59
Lucerne,7894,3,14,8,10,43,42,1,50
FC Zürich,7894,4,11,9,12,39,37,2,42
FC Lugano,7894,5,12,5,15,34,46,-12,41
St Gallen,7894,6,13,2,17,41,61,-20,41
FC Thun,7894,7,11,6,15,49,53,-4,39
Grasshoppers,7894,8,9,7,16,43,52,-9,34
FC Sion,7894,9,6,7,19,40,63,-23,25
Young Boys,7895,1,22,8,2,72,32,40,74
FC Basel,7895,2,18,8,6,53,25,28,62
FC Zürich,7895,3,12,10,10,41,33,8,46
Lucerne,7895,4,12,10,10,43,44,-1,46
St Gallen,7895,5,13,2,17,42,58,-16,41
Grasshoppers,7895,6,10,7,15,39,48,-9,37
FC Lugano,7895,7,10,6,16,32,48,-16,36
FC Thun,7895,8,8,6,18,40,58,-18,30
FC Sion,7895,9,7,7,18,38,54,-16,28
Young Boys,7896,1,22,7,3,71,33,38,73
FC Basel,7896,2,17,8,7,55,30,25,59
St Gallen,7896,3,15,2,15,46,59,-13,47
FC Zürich,7896,4,12,9,11,44,35,9,45
Lucerne,7896,5,11,7,14,37,47,-10,40
FC Thun,7896,6,11,5,16,48,62,-14,38
FC Lugano,7896,7,11,5,16,32,47,-15,38
Grasshoppers,7896,8,9,6,17,40,54,-14,33
FC Sion,7896,9,8,7,17,47,53,-6,31
Young Boys,7897,1,24,6,2,76,32,44,78
FC Basel,7897,2,18,8,6,54,23,31,62
St Gallen,7897,3,15,2,15,45,55,-10,47
Lucerne,7897,4,12,8,12,41,47,-6,44
FC Zürich,7897,5,10,11,11,38,35,3,41
Grasshoppers,7897,6,9,8,15,43,51,-8,35
FC Thun,7897,7,9,7,16,42,57,-15,34
FC Lugano,7897,8,9,6,17,28,47,-19,33
FC Sion,7897,9,6,8,18,38,58,-20,26
Young Boys,7898,1,22,8,2,73,31,42,74
FC Basel,7898,2,17,8,7,52,29,23,59
Lucerne,7898,3,14,8,10,49,42,7,50
St Gallen,7898,4,14,2,16,44,62,-18,44
FC Zürich,7898,5,11,10,11,45,37,8,43
FC Lugano,7898,6,11,5,16,34,48,-14,38
FC Thun,7898,7,10,6,16,44,57,-13,36
Grasshoppers,7898,8,9,6,17,39,53,-14,33
FC Sion,7898,9,5,9,18,38,59,-21,24
Young Boys,7899,1,23,6,3,77,34,43,75
FC Basel,7899,2,18,7,7,55,27,28,61
St Gallen,7899,3,16,2,14,44,55,-11,50
Lucerne,7899,4,12,8,12,42,47,-5,44
FC Zürich,7899,5,10,9,13,37,38,-1,39
FC Thun,7899,6,11,6,15,47,57,-10,39
FC Lugano,7899,7,10,5,17,31,50,-19,35
Grasshoppers,7899,8,8,9,15,39,49,-10,33
FC Sion,7899,9,6,8,18,40,55,-15,26
Young Boys,7900,1,22,6,4,73,38,35,72
FC Basel,7900,2,17,9,6,55,27,28,60
St Gallen,7900,3,14,4,14,47,57,-10,46
Lucerne,7900,4,11,10,11,41,44,-3,43
FC Zürich,7900,5,10,9,13,43,39,4,39
FC Lugano,7900,6,11,5,16,33,53,-20,38
FC Thun,7900,7,10,6,16,46,57,-11,36
Grasshoppers,7900,8,9,8,15,41,49,-8,35
FC Sion,7900,9,8,7,17,44,59,-15,31
Young Boys,7901,1,23,6,3,75,36,39,75
FC Basel,7901,2,16,10,6,53,28,25,58
Lucerne,7901,3,13,9,10,45,42,3,48
St Gallen,7901,4,14,5,13,44,54,-10,47
FC Zürich,7901,5,11,9,12,46,38,8,42
FC Lugano,7901,6,11,6,15,30,45,-15,39
Grasshoppers,7901,7,9,6,17,41,55,-14,33
FC Thun,7901,8,8,6,18,43,65,-22,30
FC Sion,7901,9,7,7,18,45,59,-14,28
Young Boys,7902,1,21,8,3,70,34,36,71
FC Basel,7902,2,16,9,7,52,30,22,57
Lucerne,7902,3,13,8,11,45,48,-3,47
FC Zürich,7902,4,12,10,10,46,34,12,46
St Gallen,7902,5,14,2,16,42,57,-15,44
FC Thun,7902,6,10,7,15,44,56,-12,37
FC Lugano,7902,7,10,7,15,32,49,-17,37
Grasshoppers,7902,8,9,6,17,39,50,-11,33
FC Sion,7902,9,7,7,18,42,54,-12,28
Young Boys,7903,1,21,7,4,72,38,34,70
FC Basel,7903,2,16,9,7,51,27,24,57
Lucerne,7903,3,15,7,10,47,42,5,52
FC Zürich,7903,4,12,10,10,42,33,9,46
St Gallen,7903,5,14,3,15,43,55,-12,45
FC Lugano,7903,6,11,5,16,33,46,-13,38
Grasshoppers,7903,7,9,7,16,43,54,-11,34
FC Thun,7903,8,8,8,16,43,59,-16,32
FC Sion,7903,9,6,8,18,42,62,-20,26
Young Boys,7904,1,22,6,4,71,36,35,72
FC Basel,7904,2,18,9,5,55,26,29,63
St Gallen,7904,3,13,5,14,41,53,-12,44
FC Zürich,7904,4,11,10,11,42,37,5,43
Lucerne,7904,5,12,7,13,38,47,-9,43
FC Lugano,7904,6,11,6,15,33,44,-11,39
Grasshoppers,7904,7,9,8,15,41,47,-6,35
FC Thun,7904,8,9,6,17,45,60,-15,33
FC Sion,7904,9,6,9,17,38,54,-16,27
Young Boys,7905,1,23,7,2,77,36,41,76
FC Basel,7905,2,16,9,7,51,27,24,57
Lucerne,7905,3,12,9,11,40,44,-4,45
St Gallen,7905,4,14,3,15,43,55,-12,45
FC Zürich,7905,5,11,9,12,44,37,7,42
FC Lugano,7905,6,11,6,15,35,48,-13,39
Grasshoppers,7905,7,9,8,15,41,48,-7,35
FC Thun,7905,8,9,7,16,42,59,-17,34
FC Sion,7905,9,6,8,18,38,57,-19,26
Young Boys,7906,1,23,6,3,73,32,41,75
FC Basel,7906,2,18,8,6,55,26,29,62
St Gallen,7906,3,15,3,14,41,53,-12,48
Lucerne,7906,4,12,8,12,40,44,-4,44
FC Zürich,7906,5,9,11,12,40,40,0,38
FC Lugano,7906,6,10,6,16,31,48,-17,36
FC Thun,7906,7,9,8,15,44,58,-14,35
Grasshoppers,7906,8,9,6,17,41,50,-9,33
FC Sion,7906,9,7,8,17,41,55,-14,29
Young Boys,7907,1,23,6,3,73,32,41,75
FC Basel,7907,2,17,7,8,53,32,21,58
Lucerne,7907,3,13,8,11,46,44,2,47
St Gallen,7907,4,14,2,16,43,58,-15,44
FC Zürich,7907,5,10,10,12,40,36,4,40
FC Thun,7907,6,11,6,15,47,56,-9,39
FC Lugano,7907,7,10,5,17,29,49,-20,35
Grasshoppers,7907,8,9,7,16,40,52,-12,34
FC Sion,7907,9,7,9,16,41,53,-12,30
Young Boys,7908,1,22,8,2,73,36,37,74
FC Basel,7908,2,17,8,7,58,29,29,59
Lucerne,7908,3,14,9,9,48,43,5,51
FC Zürich,7908,4,12,10,10,43,35,8,46
St Gallen,7908,5,14,3,15,42,61,-19,45
Grasshoppers,7908,6,9,8,15,43,48,-5,35
FC Thun,7908,7,9,6,17,44,58,-14,33
FC Lugano,7908,8,9,6,17,31,49,-18,33
FC Sion,7908,9,5,8,19,39,62,-23,23
Young Boys,7909,1,20,9,3,67,33,34,69
FC Basel,7909,2,18,9,5,52,24,28,63
St Gallen,7909,3,15,2,15,42,54,-12,47
Lucerne,7909,4,12,10,10,41,42,-1,46
FC Zürich,7909,5,9,11,12,41,39,2,38
FC Lugano,7909,6,10,6,16,30,46,-16,36
FC Sion,7909,7,9,8,15,46,52,-6,35
Grasshoppers,7909,8,9,7,16,43,53,-10,34
FC Thun,7909,9,8,6,18,44,63,-19,30
Young Boys,7910,1,21,9,2,72,36,36,72
FC Basel,7910,2,18,8,6,57,26,31,62
Lucerne,7910,3,13,7,12,43,44,-1,46
St Gallen,7910,4,14,3,15,40,53,-13,45
FC Zürich,7910,5,11,11,10,41,35,6,44
FC Lugano,7910,6,9,8,15,29,45,-16,35
Grasshoppers,7910,7,9,7,16,42,52,-10,34
FC Thun,7910,8,9,5,18,42,61,-19,32
FC Sion,7910,9,7,8,17,43,57,-14,29
Young Boys,7911,1,22,6,4,76,34,42,72
FC Basel,7911,2,19,7,6,58,27,31,64
St Gallen,7911,3,15,3,14,44,54,-10,48
Lucerne,7911,4,13,7,12,40,45,-5,46
FC Zürich,7911,5,12,9,11,45,35,10,45
FC Lugano,7911,6,10,6,16,29,47,-18,36
FC Thun,7911,7,10,5,17,48,61,-13,35
Grasshoppers,7911,8,9,6,17,38,57,-19,33
FC Sion,7911,9,6,7,19,42,60,-18,25
Young Boys,7912,1,19,9,4,72,41,31,66
FC Basel,7912,2,17,9,6,51,24,27,60
St Gallen,7912,3,16,3,13,44,51,-7,51
Lucerne,7912,4,13,9,10,46,43,3,48
FC Zürich,7912,5,10,11,11,41,37,4,41
FC Lugano,7912,6,9,7,16,29,50,-21,34
Grasshoppers,7912,7,8,9,15,48,57,-9,33
FC Thun,7912,8,8,9,15,48,63,-15,33
FC Sion,7912,9,7,8,17,43,56,-13,29
Young Boys,7913,1,23,6,3,76,33,43,75
FC Basel,7913,2,17,8,7,52,28,24,59
Lucerne,7913,3,13,8,11,41,47,-6,47
St Gallen,7913,4,14,2,16,44,54,-10,44
FC Zürich,7913,5,10,10,12,44,38,6,40
FC Lugano,7913,6,11,5,16,31,45,-14,38
FC Thun,7913,7,10,6,16,44,57,-13,36
Grasshoppers,7913,8,9,6,17,40,53,-13,33
FC Sion,7913,9,8,7,17,42,59,-17,31
Young Boys,7914,1,22,6,4,70,33,37,72
FC Basel,7914,2,19,8,5,52,22,30,65
Lucerne,7914,3,13,8,11,44,42,2,47
St Gallen,7914,4,15,2,15,45,56,-11,47
FC Zürich,7914,5,11,10,11,44,37,7,43
FC Thun,7914,6,10,6,16,45,59,-14,36
FC Lugano,7914,7,10,5,17,32,53,-21,35
Grasshoppers,7914,8,9,6,17,38,49,-11,33
FC Sion,7914,9,6,7,19,37,56,-19,25
Young Boys,7915,1,23,6,3,77,35,42,75
FC Basel,7915,2,16,9,7,54,30,24,57
St Gallen,7915,3,15,3,14,43,55,-12,48
Lucerne,7915,4,13,8,11,45,47,-2,47
FC Zürich,7915,5,9,12,11,40,37,3,39
Grasshoppers,7915,6,10,7,15,42,48,-6,37
FC Thun,7915,7,9,7,16,42,57,-15,34
FC Lugano,7915,8,9,7,16,31,50,-19,34
FC Sion,7915,9,5,11,16,39,54,-15,26
Young Boys,7916,1,21,8,3,68,32,36,71
FC Basel,7916,2,17,9,6,57,26,31,60
Lucerne,7916,3,14,8,10,41,43,-2,50
St Gallen,7916,4,13,5,14,41,53,-12,44
FC Zürich,7916,5,9,11,12,41,39,2,38
FC Lugano,7916,6,10,8,14,32,46,-14,38
Grasshoppers,7916,7,9,7,16,39,48,-9,34
FC Sion,7916,8,7,10,15,41,50,-9,31
FC Thun,7916,9,8,6,18,42,65,-23,30
Young Boys,7917,1,21,6,5,70,38,32,69
FC Basel,7917,2,19,8,5,53,23,30,65
Lucerne,7917,3,13,9,10,44,42,2,48
St Gallen,7917,4,14,5,13,40,50,-10,47
FC Zürich,7917,5,11,10,11,45,38,7,43
FC Lugano,7917,6,10,6,16,31,49,-18,36
Grasshoppers,7917,7,9,7,16,44,52,-8,34
FC Thun,7917,8,9,6,17,45,62,-17,33
FC Sion,7917,9,6,7,19,40,58,-18,25
Young Boys,7918,1,22,7,3,76,37,39,73
FC Basel,7918,2,16,10,6,49,24,25,58
Lucerne,7918,3,12,9,11,41,43,-2,45
St Gallen,7918,4,13,4,15,42,57,-15,43
FC Zürich,7918,5,10,10,12,39,36,3,40
FC Lugano,7918,6,10,7,15,32,48,-16,37
FC Thun,7918,7,9,7,16,43,60,-17,34
FC Sion,7918,8,8,9,15,43,51,-8,33
Grasshoppers,7918,9,8,9,15,43,52,-9,33
Young Boys,7919,1,21,7,4,72,35,37,70
FC Basel,7919,2,20,7,5,59,25,34,67
St Gallen,7919,3,14,3,15,43,59,-16,45
Lucerne,7919,4,12,8,12,42,46,-4,44
Grasshoppers,7919,5,11,6,15,44,47,-3,39
FC Lugano,7919,6,10,8,14,34,47,-13,38
FC Zürich,7919,7,9,10,13,36,37,-1,37
FC Thun,7919,8,10,5,17,45,57,-12,35
FC Sion,7919,9,6,8,18,37,59,-22,26
Young Boys,7920,1,24,6,2,76,33,43,78
FC Basel,7920,2,19,7,6,55,28,27,64
St Gallen,7920,3,15,3,14,47,54,-7,48
Lucerne,7920,4,12,8,12,41,44,-3,44
FC Zürich,7920,5,11,10,11,42,34,8,43
FC Thun,7920,6,10,6,16,47,60,-13,36
FC Lugano,7920,7,9,7,16,30,51,-21,34
Grasshoppers,7920,8,8,6,18,38,52,-14,30
FC Sion,7920,9,6,7,19,38,58,-20,25
Young Boys,7921,1,22,7,3,76,36,40,73
FC Basel,7921,2,17,9,6,61,29,32,60
St Gallen,7921,3,15,3,14,43,52,-9,48
Lucerne,7921,4,11,9,12,45,52,-7,42
FC Zürich,7921,5,10,11,11,43,37,6,41
Grasshoppers,7921,6,11,7,14,44,49,-5,40
FC Lugano,7921,7,11,6,15,33,49,-16,39
FC Thun,7921,8,8,7,17,39,60,-21,31
FC Sion,7921,9,6,7,19,38,58,-20,25
Young Boys,7922,1,20,6,6,67,36,31,66
FC Basel,7922,2,19,7,6,59,22,37,64
Lucerne,7922,3,14,7,11,43,44,-1,49
FC Zürich,7922,4,12,9,11,43,33,10,45
St Gallen,7922,5,14,3,15,45,60,-15,45
Grasshoppers,7922,6,11,6,15,43,48,-5,39
FC Thun,7922,7,10,5,17,44,60,-16,35
FC Lugano,7922,8,10,5,17,29,51,-22,35
FC Sion,7922,9,6,8,18,42,61,-19,26
Young Boys,7923,1,22,6,4,75,37,38,72
FC Basel,7923,2,17,8,7,58,32,26,59
St Gallen,7923,3,15,3,14,48,60,-12,48
Lucerne,7923,4,12,8,12,42,48,-6,44
FC Zürich,7923,5,11,10,11,41,37,4,43
Grasshoppers,7923,6,10,7,15,43,49,-6,37
FC Thun,7923,7,9,7,16,43,58,-15,34
FC Lugano,7923,8,9,6,17,31,51,-20,33
FC Sion,7923,9,8,7,17,43,52,-9,31
Young Boys,7924,1,21,8,3,72,33,39,71
FC Basel,7924,2,18,9,5,54,24,30,63
Lucerne,7924,3,13,9,10,44,42,2,48
St Gallen,7924,4,13,4,15,41,57,-16,43
FC Zürich,7924,5,10,11,11,43,39,4,41
FC Lugano,7924,6,10,6,16,32,51,-19,36
Grasshoppers,7924,7,8,9,15,41,53,-12,33
FC Thun,7924,8,8,7,17,44,62,-18,31
FC Sion,7924,9,6,11,15,44,54,-10,29
Young Boys,7925,1,21,7,4,71,42,29,70
FC Basel,7925,2,19,7,6,61,25,36,64
St Gallen,7925,3,15,3,14,43,53,-10,48
Lucerne,7925,4,12,8,12,46,51,-5,44
FC Zürich,7925,5,10,11,11,44,38,6,41
Grasshoppers,7925,6,10,7,15,49,51,-2,37
FC Lugano,7925,7,9,7,16,32,50,-18,34
FC Thun,7925,8,9,6,17,44,62,-18,33
FC Sion,7925,9,7,8,17,40,58,-18,29
Young Boys,7926,1,24,6,2,82,34,48,78
FC Basel,7926,2,18,7,7,50,25,25,61
Lucerne,7926,3,13,8,11,43,47,-4,47
St Gallen,7926,4,15,2,15,43,53,-10,47
FC Zürich,7926,5,10,10,12,38,38,0,40
FC Thun,7926,6,9,7,16,45,58,-13,34
Grasshoppers,7926,7,9,6,17,42,55,-13,33
FC Lugano,7926,8,9,6,17,28,50,-22,33
FC Sion,7926,9,7,8,17,44,55,-11,29
Young Boys,7927,1,21,7,4,73,35,38,70
FC Basel,7927,2,19,7,6,58,24,34,64
St Gallen,7927,3,15,3,14,42,52,-10,48
Lucerne,7927,4,13,7,12,41,50,-9,46
FC Lugano,7927,5,11,6,15,31,45,-14,39
FC Zürich,7927,6,9,9,14,36,39,-3,36
FC Thun,7927,7,10,6,16,42,57,-15,36
Grasshoppers,7927,8,9,8,15,44,52,-8,35
FC Sion,7927,9,6,9,17,38,51,-13,27
Young Boys,7928,1,21,8,3,73,41,32,71
FC Basel,7928,2,18,9,5,58,27,31,63
Lucerne,7928,3,14,7,11,41,41,0,49
St Gallen,7928,4,13,3,16,40,60,-20,42
FC Zürich,7928,5,10,9,13,42,41,1,39
FC Lugano,7928,6,11,5,16,33,47,-14,38
FC Thun,7928,7,10,5,17,44,61,-17,35
Grasshoppers,7928,8,9,7,16,41,50,-9,34
FC Sion,7928,9,8,7,17,51,55,-4,31
Young Boys,7929,1,23,7,2,79,34,45,76
FC Basel,7929,2,18,8,6,53,25,28,62
Lucerne,7929,3,14,7,11,45,42,3,49
St Gallen,7929,4,14,3,15,43,55,-12,45
FC Zürich,7929,5,9,10,13,37,40,-3,37
FC Thun,7929,6,10,5,17,46,61,-15,35
Grasshoppers,7929,7,9,6,17,42,55,-13,33
FC Lugano,7929,8,9,6,17,30,55,-25,33
FC Sion,7929,9,8,8,16,46,54,-8,32
Young Boys,7930,1,22,8,2,73,33,40,74
FC Basel,7930,2,18,9,5,58,26,32,63
St Gallen,7930,3,16,2,14,45,53,-8,50
Lucerne,7930,4,13,8,11,40,44,-4,47
FC Zürich,7930,5,10,10,12,42,38,4,40
Grasshoppers,7930,6,8,8,16,39,49,-10,32
FC Thun,7930,7,8,8,16,44,61,-17,32
FC Lugano,7930,8,9,5,18,31,53,-22,32
FC Sion,7930,9,7,8,17,38,53,-15,29
Young Boys,7931,1,20,9,3,72,36,36,69
FC Basel,7931,2,18,9,5,58,28,30,63
Lucerne,7931,3,14,8,10,44,45,-1,50
St Gallen,7931,4,13,4,15,44,57,-13,43
FC Zürich,7931,5,10,12,10,40,35,5,42
Grasshoppers,7931,6,9,8,15,40,50,-10,35
FC Lugano,7931,7,9,7,16,32,49,-17,34
FC Thun,7931,8,9,6,17,44,60,-16,33
FC Sion,7931,9,6,9,17,43,57,-14,27
Young Boys,7932,1,22,8,2,71,32,39,74
FC Basel,7932,2,18,8,6,55,25,30,62
St Gallen,7932,3,14,3,15,41,54,-13,45
Lucerne,7932,4,12,8,12,45,47,-2,44
FC Zürich,7932,5,10,11,11,39,36,3,41
FC Lugano,7932,6,11,6,15,33,47,-14,39
Grasshoppers,7932,7,9,7,16,41,51,-10,34
FC Thun,7932,8,9,7,16,42,58,-16,34
FC Sion,7932,9,5,10,17,37,54,-17,25
Young Boys,7933,1,21,7,4,74,38,36,70
FC Basel,7933,2,20,7,5,59,26,33,67
St Gallen,7933,3,15,3,14,49,55,-6,48
Lucerne,7933,4,12,8,12,42,49,-7,44
FC Zürich,7933,5,10,10,12,41,39,2,40
Grasshoppers,7933,6,11,6,15,43,49,-6,39
FC Lugano,7933,7,9,7,16,32,51,-19,34
FC Thun,7933,8,9,5,18,42,60,-18,32
FC Sion,7933,9,7,7,18,44,59,-15,28
Young Boys,7934,1,23,7,2,75,33,42,76
FC Basel,7934,2,18,8,6,54,26,28,62
Lucerne,7934,3,13,9,10,43,42,1,48
St Gallen,7934,4,15,3,14,46,52,-6,48
FC Zürich,7934,5,10,11,11,40,37,3,41
FC Thun,7934,6,10,5,17,47,57,-10,35
Grasshoppers,7934,7,9,6,17,40,54,-14,33
FC Lugano,7934,8,9,6,17,32,56,-24,33
FC Sion,7934,9,5,9,18,37,57,-20,24
Young Boys,7935,1,21,7,4,69,38,31,70
FC Basel,7935,2,19,8,5,60,24,36,65
FC Lugano,7935,3,12,6,14,35,42,-7,42
St Gallen,7935,4,13,3,16,42,62,-20,42
Lucerne,7935,5,11,8,13,39,47,-8,41
FC Zürich,7935,6,10,10,12,41,40,1,40
Grasshoppers,7935,7,11,6,15,44,49,-5,39
FC Thun,7935,8,10,5,17,46,59,-13,35
FC Sion,7935,9,7,7,18,43,58,-15,28
Young Boys,7936,1,21,8,3,72,36,36,71
FC Basel,7936,2,15,8,9,49,29,20,53
Lucerne,7936,3,14,7,11,44,45,-1,49
St Gallen,7936,4,15,2,15,47,58,-11,47
FC Zürich,7936,5,12,10,10,44,33,11,46
FC Lugano,7936,6,10,6,16,33,50,-17,36
FC Thun,7936,7,10,5,17,43,58,-15,35
Grasshoppers,7936,8,8,8,16,40,50,-10,32
FC Sion,7936,9,8,8,16,40,53,-13,32
Young Boys,7937,1,23,7,2,73,32,41,76
FC Basel,7937,2,17,8,7,52,26,26,59
St Gallen,7937,3,16,2,14,42,51,-9,50
Lucerne,7937,4,13,8,11,41,41,0,47
FC Zürich,7937,5,9,11,12,41,40,1,38
FC Thun,7937,6,9,7,16,43,60,-17,34
FC Lugano,7937,7,9,6,17,30,50,-20,33
Grasshoppers,7937,8,8,8,16,37,48,-11,32
FC Sion,7937,9,8,7,17,42,53,-11,31
Young Boys,7938,1,23,6,3,74,32,42,75
FC Basel,7938,2,18,8,6,55,24,31,62
St Gallen,7938,3,15,3,14,44,54,-10,48
Lucerne,7938,4,12,8,12,40,48,-8,44
FC Zürich,7938,5,9,11,12,40,38,2,38
FC Lugano,7938,6,10,6,16,29,45,-16,36
Grasshoppers,7938,7,9,8,15,46,55,-9,35
FC Thun,7938,8,9,7,16,42,58,-16,34
FC Sion,7938,9,7,7,18,40,56,-16,28
Young Boys,7939,1,21,8,3,69,34,35,71
FC Basel,7939,2,17,9,6,54,28,26,60
St Gallen,7939,3,15,4,13,47,56,-9,49
FC Zürich,7939,4,11,11,10,42,34,8,44
Lucerne,7939,5,11,8,13,39,44,-5,41
FC Lugano,7939,6,10,7,15,31,46,-15,37
Grasshoppers,7939,7,10,6,16,40,48,-8,36
FC Thun,7939,8,10,5,17,41,57,-16,35
FC Sion,7939,9,6,8,18,41,57,-16,26
Young Boys,7940,1,21,6,5,67,34,33,69
FC Basel,7940,2,19,8,5,57,25,32,65
Lucerne,7940,3,13,8,11,45,45,0,47
St Gallen,7940,4,14,3,15,41,53,-12,45
FC Zürich,7940,5,9,11,12,40,38,2,38
FC Lugano,7940,6,11,5,16,32,50,-18,38
Grasshoppers,7940,7,9,7,16,41,50,-9,34
FC Thun,7940,8,9,6,17,43,60,-17,33
FC Sion,7940,9,7,10,15,39,50,-11,31
Young Boys,7941,1,21,7,4,69,34,35,70
FC Basel,7941,2,17,10,5,51,24,27,61
Lucerne,7941,3,14,7,11,46,43,3,49
St Gallen,7941,4,14,4,14,42,53,-11,46
FC Zürich,7941,5,10,11,11,41,36,5,41
FC Lugano,7941,6,10,6,16,32,48,-16,36
FC Thun,7941,7,9,8,15,50,59,-9,35
Grasshoppers,7941,8,9,6,17,43,61,-18,33
FC Sion,7941,9,6,9,17,42,58,-16,27
Young Boys,7942,1,22,8,2,75,34,41,74
FC Basel,7942,2,18,7,7,52,27,25,61
FC Zürich,7942,3,13,9,10,44,35,9,48
Lucerne,7942,4,13,7,12,43,46,-3,46
St Gallen,7942,5,14,3,15,45,58,-13,45
FC Lugano,7942,6,10,6,16,32,46,-14,36
Grasshoppers,7942,7,9,8,15,41,52,-11,35
FC Thun,7942,8,9,6,17,44,61,-17,33
FC Sion,7942,9,5,8,19,40,57,-17,23
Young Boys,7943,1,21,7,4,70,37,33,70
FC Basel,7943,2,19,8,5,57,24,33,65
St Gallen,7943,3,15,3,14,47,55,-8,48
Lucerne,7943,4,11,9,12,39,48,-9,42
FC Zürich,7943,5,9,10,13,40,43,-3,37
Grasshoppers,7943,6,10,7,15,46,52,-6,37
FC Lugano,7943,7,10,6,16,31,45,-14,36
FC Sion,7943,8,8,9,15,48,54,-6,33
FC Thun,7943,9,8,7,17,43,63,-20,31
Young Boys,7944,1,21,7,4,72,37,35,70
FC Basel,7944,2,18,7,7,54,28,26,61
Lucerne,7944,3,13,8,11,44,44,0,47
St Gallen,7944,4,15,2,15,45,59,-14,47
FC Zürich,7944,5,11,9,12,41,36,5,42
FC Thun,7944,6,10,5,17,43,58,-15,35
FC Lugano,7944,7,10,5,17,31,51,-20,35
FC Sion,7944,8,9,7,16,45,52,-7,34
Grasshoppers,7944,9,8,8,16,40,50,-10,32
Young Boys,7945,1,21,9,2,71,34,37,72
FC Basel,7945,2,17,9,6,50,23,27,60
St Gallen,7945,3,15,3,14,42,52,-10,48
Lucerne,7945,4,12,9,11,40,43,-3,45
FC Zürich,7945,5,10,10,12,39,37,2,40
Grasshoppers,7945,6,10,7,15,43,49,-6,37
FC Lugano,7945,7,10,6,16,30,46,-16,36
FC Thun,7945,8,10,5,17,42,55,-13,35
FC Sion,7945,9,6,8,18,38,56,-18,26
Young Boys,7946,1,23,7,2,79,37,42,76
FC Basel,7946,2,16,9,7,50,30,20,57
St Gallen,7946,3,16,2,14,45,53,-8,50
Lucerne,7946,4,12,9,11,43,45,-2,45
FC Zürich,7946,5,11,11,10,45,36,9,44
FC Thun,7946,6,10,7,15,50,60,-10,37
Grasshoppers,7946,7,9,6,17,41,52,-11,33
FC Lugano,7946,8,9,6,17,30,49,-19,33
FC Sion,7946,9,6,7,19,40,61,-21,25
Young Boys,7947,1,21,8,3,70,34,36,71
FC Basel,7947,2,16,9,7,53,28,25,57
Lucerne,7947,3,13,8,11,40,42,-2,47
FC Zürich,7947,4,12,9,11,42,36,6,45
St Gallen,7947,5,14,3,15,46,58,-12,45
FC Lugano,7947,6,12,5,15,33,47,-14,41
FC Thun,7947,7,10,6,16,45,58,-13,36
Grasshoppers,7947,8,9,6,17,39,48,-9,33
FC Sion,7947,9,6,8,18,40,57,-17,26
Young Boys,7948,1,20,8,4,69,38,31,68
FC Basel,7948,2,19,7,6,54,25,29,64
FC Zürich,7948,3,12,10,10,41,33,8,46
Lucerne,7948,4,13,7,12,41,42,-1,46
St Gallen,7948,5,14,2,16,42,57,-15,44
FC Lugano,7948,6,10,7,15,33,48,-15,37
Grasshoppers,7948,7,9,7,16,39,48,-9,34
FC Thun,7948,8,9,5,18,42,60,-18,32
FC Sion,7948,9,8,7,17,44,54,-10,31
Young Boys,7949,1,21,6,5,69,37,32,69
FC Basel,7949,2,16,10,6,53,29,24,58
Lucerne,7949,3,14,9,9,48,43,5,51
St Gallen,7949,4,15,4,13,48,54,-6,49
FC Zürich,7949,5,11,11,10,43,35,8,44
FC Thun,7949,6,10,6,16,44,57,-13,36
FC Lugano,7949,7,10,5,17,31,47,-16,35
Grasshoppers,7949,8,9,6,17,40,53,-13,33
FC Sion,7949,9,6,7,19,41,62,-21,25
Young Boys,7950,1,21,6,5,68,35,33,69
FC Basel,7950,2,19,7,6,56,25,31,64
St Gallen,7950,3,16,2,14,48,54,-6,50
Lucerne,7950,4,12,8,12,43,48,-5,44
FC Zürich,7950,5,11,9,12,43,38,5,42
FC Lugano,7950,6,12,6,14,34,45,-11,42
Grasshoppers,7950,7,10,7,15,42,47,-5,37
FC Thun,7950,8,8,7,17,40,59,-19,31
FC Sion,7950,9,5,8,19,35,58,-23,23
Young Boys,7951,1,21,6,5,69,39,30,69
FC Basel,7951,2,19,8,5,58,25,33,65
Lucerne,7951,3,14,8,10,41,39,2,50
St Gallen,7951,4,13,3,16,41,58,-17,42
FC Zürich,7951,5,10,9,13,40,39,1,39
FC Lugano,7951,6,11,6,15,33,46,-13,39
Grasshoppers,7951,7,10,7,15,43,48,-5,37
FC Thun,7951,8,10,6,16,42,56,-14,36
FC Sion,7951,9,6,7,19,39,56,-17,25
Young Boys,7952,1,22,8,2,78,34,44,74
FC Basel,7952,2,15,8,9,52,33,19,53
St Gallen,7952,3,16,2,14,47,54,-7,50
Lucerne,7952,4,14,7,11,44,49,-5,49
FC Zürich,7952,5,10,10,12,44,38,6,40
FC Lugano,7952,6,11,6,15,33,48,-15,39
Grasshoppers,7952,7,10,6,16,42,50,-8,36
FC Thun,7952,8,9,5,18,40,61,-21,32
FC Sion,7952,9,7,8,17,41,54,-13,29
Young Boys,7953,1,21,7,4,73,38,35,70
FC Basel,7953,2,17,8,7,52,26,26,59
Lucerne,7953,3,14,7,11,45,46,-1,49
St Gallen,7953,4,13,4,15,46,60,-14,43
FC Zürich,7953,5,10,11,11,39,35,4,41
Grasshoppers,7953,6,10,6,16,41,49,-8,36
FC Thun,7953,7,10,6,16,45,57,-12,36
FC Lugano,7953,8,9,8,15,31,48,-17,35
FC Sion,7953,9,8,7,17,42,55,-13,31
Young Boys,7954,1,23,6,3,78,37,41,75
FC Basel,7954,2,17,7,8,51,28,23,58
Lucerne,7954,3,14,8,10,45,44,1,50
St Gallen,7954,4,14,4,14,43,52,-9,46
FC Zürich,7954,5,11,9,12,41,36,5,42
FC Thun,7954,6,10,6,16,44,59,-15,36
Grasshoppers,7954,7,9,7,16,42,49,-7,34
FC Lugano,7954,8,9,6,17,32,53,-21,33
FC Sion,7954,9,7,7,18,42,60,-18,28
Young Boys,7955,1,21,7,4,74,42,32,70
FC Basel,7955,2,18,7,7,51,24,27,61
St Gallen,7955,3,16,2,14,44,52,-8,50
Lucerne,7955,4,12,7,13,40,47,-7,43
FC Zürich,7955,5,10,9,13,38,37,1,39
FC Thun,7955,6,11,6,15,47,54,-7,39
Grasshoppers,7955,7,10,8,14,45,48,-3,38
FC Lugano,7955,8,10,5,17,31,48,-17,35
FC Sion,7955,9,7,7,18,42,60,-18,28
Young Boys,7956,1,20,8,4,69,36,33,68
FC Basel,7956,2,19,8,5,55,22,33,65
Lucerne,7956,3,12,9,11,43,45,-2,45
St Gallen,7956,4,14,3,15,41,56,-15,45
FC Zürich,7956,5,11,9,12,40,37,3,42
Grasshoppers,7956,6,11,7,14,43,46,-3,40
FC Lugano,7956,7,10,7,15,34,49,-15,37
FC Thun,7956,8,10,5,17,42,58,-16,35
FC Sion,7956,9,5,8,19,35,53,-18,23
Young Boys,7957,1,22,7,3,72,33,39,73
FC Basel,7957,2,20,7,5,57,22,35,67
St Gallen,7957,3,15,2,15,46,55,-9,47
Lucerne,7957,4,12,8,12,40,45,-5,44
FC Zürich,7957,5,10,10,12,41,38,3,40
FC Thun,7957,6,9,7,16,41,58,-17,34
FC Lugano,7957,7,9,7,16,31,51,-20,34
Grasshoppers,7957,8,8,7,17,39,55,-16,31
FC Sion,7957,9,7,9,16,43,53,-10,30
Young Boys,7958,1,22,7,3,75,35,40,73
FC Basel,7958,2,18,8,6,56,27,29,62
St Gallen,7958,3,16,2,14,45,54,-9,50
Lucerne,7958,4,11,8,13,38,45,-7,41
FC Zürich,7958,5,10,10,12,40,40,0,40
FC Thun,7958,6,11,5,16,50,57,-7,38
Grasshoppers,7958,7,10,7,15,43,53,-10,37
FC Lugano,7958,8,10,5,17,30,49,-19,35
FC Sion,7958,9,6,8,18,39,56,-17,26
Young Boys,7959,1,22,7,3,73,31,42,73
FC Basel,7959,2,18,9,5,55,24,31,63
Lucerne,7959,3,12,10,10,41,46,-5,46
St Gallen,7959,4,13,4,15,43,56,-13,43
FC Thun,7959,5,11,5,16,50,60,-10,38
FC Lugano,7959,6,11,5,16,32,49,-17,38
FC Zürich,7959,7,9,10,13,40,42,-2,37
Grasshoppers,7959,8,9,8,15,41,49,-8,35
FC Sion,7959,9,6,8,18,38,56,-18,26
Young Boys,7960,1,22,6,4,71,35,36,72
FC Basel,7960,2,18,8,6,56,24,32,62
St Gallen,7960,3,15,3,14,45,55,-10,48
Lucerne,7960,4,13,7,12,41,44,-3,46
FC Zürich,7960,5,10,10,12,40,37,3,40
FC Thun,7960,6,11,5,16,45,58,-13,38
Grasshoppers,7960,7,10,6,16,40,48,-8,36
FC Lugano,7960,8,10,5,17,29,47,-18,35
FC Sion,7960,9,6,8,18,38,57,-19,26
Young Boys,7961,1,21,7,4,68,34,34,70
FC Basel,7961,2,19,8,5,56,24,32,65
St Gallen,7961,3,15,4,13,46,54,-8,49
Lucerne,7961,4,13,7,12,43,45,-2,46
FC Zürich,7961,5,11,9,12,39,36,3,42
Grasshoppers,7961,6,10,6,16,45,50,-5,36
FC Thun,7961,7,10,5,17,42,57,-15,35
FC Lugano,7961,8,10,5,17,30,51,-21,35
FC Sion,7961,9,5,9,18,37,55,-18,24
FC Basel,7962,1,19,8,5,58,26,32,65
Young Boys,7962,2,19,8,5,67,41,26,65
Lucerne,7962,3,12,10,10,43,44,-1,46
St Gallen,7962,4,13,3,16,41,58,-17,42
FC Lugano,7962,5,12,5,15,32,45,-13,41
FC Zürich,7962,6,10,10,12,41,39,2,40
Grasshoppers,7962,7,9,8,15,42,51,-9,35
FC Thun,7962,8,10,5,17,47,58,-11,35
FC Sion,7962,9,8,7,17,47,56,-9,31
Young Boys,7963,1,22,7,3,69,30,39,73
FC Basel,7963,2,18,8,6,55,25,30,62
St Gallen,7963,3,17,2,13,47,52,-5,53
FC Zürich,7963,4,11,10,11,43,37,6,43
Lucerne,7963,5,12,7,13,41,46,-5,43
FC Lugano,7963,6,10,5,17,31,49,-18,35
Grasshoppers,7963,7,9,7,16,40,52,-12,34
FC Thun,7963,8,9,5,18,41,60,-19,32
FC Sion,7963,9,6,9,17,37,53,-16,27
Young Boys,7964,1,22,7,3,71,33,38,73
FC Basel,7964,2,17,9,6,52,26,26,60
St Gallen,7964,3,14,4,14,43,52,-9,46
Lucerne,7964,4,12,9,11,40,45,-5,45
FC Lugano,7964,5,11,6,15,33,45,-12,39
FC Zürich,7964,6,9,10,13,40,43,-3,37
FC Thun,7964,7,10,6,16,46,58,-12,36
Grasshoppers,7964,8,9,8,15,41,49,-8,35
FC Sion,7964,9,7,7,18,39,54,-15,28
Young Boys,7965,1,23,7,2,76,34,42,76
FC Basel,7965,2,18,8,6,54,25,29,62
Lucerne,7965,3,13,8,11,44,45,-1,47
FC Zürich,7965,4,11,9,12,41,37,4,42
St Gallen,7965,5,13,3,16,41,60,-19,42
FC Lugano,7965,6,10,5,17,35,50,-15,35
Grasshoppers,7965,7,9,7,16,41,53,-12,34
FC Thun,7965,8,9,7,16,43,58,-15,34
FC Sion,7965,9,7,8,17,42,55,-13,29
Young Boys,7966,1,21,6,5,70,36,34,69
FC Basel,7966,2,18,8,6,53,25,28,62
Lucerne,7966,3,14,9,9,42,39,3,51
St Gallen,7966,4,13,5,14,43,55,-12,44
FC Lugano,7966,5,11,6,15,37,49,-12,39
FC Thun,7966,6,11,5,16,43,56,-13,38
FC Zürich,7966,7,9,9,14,37,40,-3,36
Grasshoppers,7966,8,9,6,17,38,50,-12,33
FC Sion,7966,9,7,8,17,40,53,-13,29
Young Boys,7967,1,22,8,2,75,35,40,74
FC Basel,7967,2,17,9,6,53,27,26,60
Lucerne,7967,3,13,7,12,40,43,-3,46
St Gallen,7967,4,14,3,15,41,54,-13,45
FC Zürich,7967,5,10,11,11,42,39,3,41
FC Lugano,7967,6,11,6,15,35,49,-14,39
FC Thun,7967,7,9,6,17,46,62,-16,33
Grasshoppers,7967,8,8,7,17,38,52,-14,31
FC Sion,7967,9,7,9,16,43,52,-9,30
Young Boys,7968,1,22,8,2,70,32,38,74
FC Basel,7968,2,17,9,6,49,23,26,60
Lucerne,7968,3,14,7,11,46,42,4,49
St Gallen,7968,4,15,4,13,44,51,-7,49
FC Zürich,7968,5,10,10,12,38,36,2,40
FC Thun,7968,6,11,5,16,47,56,-9,38
FC Lugano,7968,7,9,7,16,31,51,-20,34
Grasshoppers,7968,8,9,6,17,40,55,-15,33
FC Sion,7968,9,5,8,19,36,55,-19,23
Young Boys,7969,1,20,8,4,69,39,30,68
FC Basel,7969,2,18,7,7,55,28,27,61
Lucerne,7969,3,14,8,10,45,42,3,50
St Gallen,7969,4,15,2,15,42,55,-13,47
FC Zürich,7969,5,11,10,11,43,37,6,43
Grasshoppers,7969,6,10,7,15,45,48,-3,37
FC Lugano,7969,7,10,5,17,31,50,-19,35
FC Thun,7969,8,9,6,17,42,58,-16,33
FC Sion,7969,9,6,9,17,40,55,-15,27
Young Boys,7970,1,20,6,6,70,40,30,66
FC Basel,7970,2,18,9,5,55,23,32,63
St Gallen,7970,3,15,4,13,47,52,-5,49
Lucerne,7970,4,12,8,12,40,48,-8,44
FC Zürich,7970,5,9,13,10,39,35,4,40
FC Lugano,7970,6,10,7,15,30,45,-15,37
Grasshoppers,7970,7,10,6,16,42,49,-7,36
FC Thun,7970,8,10,6,16,42,57,-15,36
FC Sion,7970,9,6,9,17,43,59,-16,27
Young Boys,7971,1,23,6,3,72,34,38,75
FC Basel,7971,2,17,9,6,56,29,27,60
St Gallen,7971,3,15,3,14,45,56,-11,48
Lucerne,7971,4,13,7,12,46,48,-2,46
FC Zürich,7971,5,10,11,11,45,39,6,41
Grasshoppers,7971,6,10,6,16,42,53,-11,36
FC Thun,7971,7,10,5,17,43,57,-14,35
FC Lugano,7971,8,9,6,17,36,54,-18,33
FC Sion,7971,9,7,7,18,37,52,-15,28
Young Boys,7972,1,22,8,2,75,36,39,74
FC Basel,7972,2,16,8,8,50,30,20,56
St Gallen,7972,3,15,3,14,43,54,-11,48
Lucerne,7972,4,12,8,12,39,45,-6,44
FC Zürich,7972,5,11,9,12,42,35,7,42
Grasshoppers,7972,6,9,9,14,43,48,-5,36
FC Thun,7972,7,10,6,16,44,57,-13,36
FC Lugano,7972,8,10,6,16,30,47,-17,36
FC Sion,7972,9,7,7,18,44,58,-14,28
Young Boys,7973,1,23,7,2,73,30,43,76
FC Basel,7973,2,17,10,5,53,22,31,61
St Gallen,7973,3,14,3,15,41,52,-11,45
Lucerne,7973,4,12,8,12,42,49,-7,44
FC Zürich,7973,5,11,10,11,40,35,5,43
FC Lugano,7973,6,11,6,15,32,47,-15,39
FC Thun,7973,7,9,5,18,42,62,-20,32
Grasshoppers,7973,8,8,7,17,41,54,-13,31
FC Sion,7973,9,7,8,17,41,54,-13,29
Young Boys,7974,1,20,8,4,66,33,33,68
FC Basel,7974,2,19,8,5,53,22,31,65
Lucerne,7974,3,13,9,10,46,40,6,48
St Gallen,7974,4,14,2,16,44,59,-15,44
FC Zürich,7974,5,11,10,11,42,35,7,43
FC Lugano,7974,6,11,5,16,32,48,-16,38
Grasshoppers,7974,7,10,7,15,40,52,-12,37
FC Thun,7974,8,8,7,17,40,57,-17,31
FC Sion,7974,9,6,8,18,41,58,-17,26
Young Boys,7975,1,20,7,5,65,36,29,67
FC Basel,7975,2,19,7,6,54,24,30,64
Lucerne,7975,3,12,9,11,47,47,0,45
St Gallen,7975,4,14,2,16,40,59,-19,44
FC Zürich,7975,5,11,9,12,41,37,4,42
FC Lugano,7975,6,12,5,15,36,46,-10,41
Grasshoppers,7975,7,10,7,15,42,49,-7,37
FC Thun,7975,8,10,5,17,45,59,-14,35
FC Sion,7975,9,7,7,18,40,53,-13,28
Young Boys,7976,1,23,6,3,72,33,39,75
FC Basel,7976,2,18,8,6,56,27,29,62
Lucerne,7976,3,12,8,12,40,47,-7,44
St Gallen,7976,4,14,2,16,44,59,-15,44
FC Zürich,7976,5,10,10,12,43,38,5,40
FC Lugano,7976,6,11,6,15,31,46,-15,39
FC Thun,7976,7,10,7,15,46,58,-12,37
Grasshoppers,7976,8,9,6,17,39,50,-11,33
FC Sion,7976,9,7,7,18,44,57,-13,28
Young Boys,7977,1,20,9,3,68,32,36,69
FC Basel,7977,2,18,7,7,52,26,26,61
St Gallen,7977,3,16,3,13,47,55,-8,51
Lucerne,7977,4,13,8,11,41,42,-1,47
FC Zürich,7977,5,12,9,11,46,35,11,45
Grasshoppers,7977,6,9,8,15,38,46,-8,35
FC Thun,7977,7,10,5,17,42,58,-16,35
FC Lugano,7977,8,9,6,17,32,54,-22,33
FC Sion,7977,9,5,9,18,39,57,-18,24
Young Boys,7978,1,21,6,5,67,37,30,69
FC Basel,7978,2,19,8,5,58,25,33,65
Lucerne,7978,3,14,8,10,47,44,3,50
FC Zürich,7978,4,11,10,11,43,38,5,43
Grasshoppers,7978,5,12,6,14,44,45,-1,42
St Gallen,7978,6,13,3,16,45,60,-15,42
FC Lugano,7978,7,9,6,17,30,51,-21,33
FC Thun,7978,8,9,5,18,39,59,-20,32
FC Sion,7978,9,6,8,18,44,58,-14,26
Young Boys,7979,1,22,7,3,78,34,44,73
FC Basel,7979,2,17,9,6,51,25,26,60
St Gallen,7979,3,15,4,13,47,54,-7,49
FC Zürich,7979,4,12,10,10,44,35,9,46
Lucerne,7979,5,11,10,11,40,44,-4,43
FC Lugano,7979,6,9,7,16,31,53,-22,34
Grasshoppers,7979,7,8,9,15,38,47,-9,33
FC Thun,7979,8,8,7,17,39,57,-18,31
FC Sion,7979,9,7,7,18,38,57,-19,28
Young Boys,7980,1,21,8,3,73,36,37,71
FC Basel,7980,2,19,7,6,53,26,27,64
St Gallen,7980,3,15,3,14,44,52,-8,48
Lucerne,7980,4,13,8,11,42,42,0,47
FC Zürich,7980,5,10,9,13,39,38,1,39
FC Thun,7980,6,11,5,16,46,57,-11,38
FC Lugano,7980,7,11,5,16,32,49,-17,38
Grasshoppers,7980,8,9,7,16,43,51,-8,34
FC Sion,7980,9,5,8,19,39,60,-21,23
Young Boys,7981,1,20,8,4,71,38,33,68
FC Basel,7981,2,19,7,6,54,24,30,64
Lucerne,7981,3,13,8,11,43,43,0,47
FC Lugano,7981,4,12,5,15,33,43,-10,41
St Gallen,7981,5,13,2,17,38,58,-20,41
FC Zürich,7981,6,10,9,13,41,41,0,39
Grasshoppers,7981,7,9,8,15,42,50,-8,35
FC Sion,7981,8,9,7,16,46,53,-7,34
FC Thun,7981,9,9,6,17,43,61,-18,33
Young Boys,7982,1,21,6,5,71,36,35,69
FC Basel,7982,2,18,8,6,55,28,27,62
Lucerne,7982,3,14,8,10,45,43,2,50
St Gallen,7982,4,13,5,14,43,56,-13,44
Grasshoppers,7982,5,11,6,15,43,50,-7,39
FC Lugano,7982,6,11,6,15,31,45,-14,39
FC Zürich,7982,7,9,11,12,39,37,2,38
FC Thun,7982,8,9,7,16,44,59,-15,34
FC Sion,7982,9,5,9,18,39,56,-17,24
Young Boys,7983,1,23,6,3,73,37,36,75
FC Basel,7983,2,18,8,6,58,27,31,62
St Gallen,7983,3,15,4,13,43,52,-9,49
Lucerne,7983,4,13,7,12,42,46,-4,46
FC Zürich,7983,5,12,9,11,46,36,10,45
Grasshoppers,7983,6,10,7,15,44,47,-3,37
FC Lugano,7983,7,9,6,17,29,50,-21,33
FC Thun,7983,8,8,6,18,43,63,-20,30
FC Sion,7983,9,6,7,19,37,57,-20,25
Young Boys,7984,1,21,9,2,71,34,37,72
FC Basel,7984,2,15,8,9,48,36,12,53
Lucerne,7984,3,13,9,10,45,41,4,48
St Gallen,7984,4,15,3,14,50,56,-6,48
FC Thun,7984,5,12,5,15,48,54,-6,41
FC Zürich,7984,6,10,10,12,41,38,3,40
FC Lugano,7984,7,10,7,15,34,49,-15,37
Grasshoppers,7984,8,9,6,17,38,51,-13,33
FC Sion,7984,9,6,9,17,41,57,-16,27
Young Boys,7985,1,21,7,4,73,37,36,70
FC Basel,7985,2,18,8,6,58,28,30,62
Lucerne,7985,3,12,10,10,44,45,-1,46
St Gallen,7985,4,14,3,15,44,57,-13,45
FC Zürich,7985,5,9,12,11,40,38,2,39
FC Lugano,7985,6,10,6,16,33,50,-17,36
FC Thun,7985,7,9,7,16,42,59,-17,34
Grasshoppers,7985,8,8,9,15,40,50,-10,33
FC Sion,7985,9,8,8,16,41,51,-10,32
Young Boys,7986,1,20,8,4,69,40,29,68
FC Basel,7986,2,17,8,7,54,28,26,59
St Gallen,7986,3,17,2,13,48,53,-5,53
Lucerne,7986,4,13,7,12,44,43,1,46
FC Zürich,7986,5,11,9,12,46,40,6,42
FC Lugano,7986,6,11,6,15,35,48,-13,39
FC Sion,7986,7,8,8,16,42,53,-11,32
Grasshoppers,7986,8,8,7,17,36,48,-12,31
FC Thun,7986,9,8,7,17,39,60,-21,31
Young Boys,7987,1,23,6,3,72,33,39,75
FC Basel,7987,2,17,9,6,50,25,25,60
St Gallen,7987,3,15,3,14,44,51,-7,48
Lucerne,7987,4,12,9,11,40,44,-4,45
FC Zürich,7987,5,10,12,10,38,33,5,42
FC Thun,7987,6,10,6,16,44,56,-12,36
Grasshoppers,7987,7,9,6,17,42,51,-9,33
FC Lugano,7987,8,9,6,17,28,48,-20,33
FC Sion,7987,9,6,9,17,40,57,-17,27
Young Boys,7988,1,21,9,2,70,33,37,72
FC Basel,7988,2,17,10,5,55,24,31,61
St Gallen,7988,3,15,4,13,45,53,-8,49
Lucerne,7988,4,12,9,11,47,50,-3,45
FC Zürich,7988,5,11,10,11,39,33,6,43
FC Thun,7988,6,10,6,16,46,60,-14,36
FC Lugano,7988,7,9,7,16,32,49,-17,34
Grasshoppers,7988,8,9,6,17,43,57,-14,33
FC Sion,7988,9,5,9,18,38,56,-18,24
Young Boys,7989,1,21,7,4,75,39,36,70
FC Basel,7989,2,18,8,6,54,25,29,62
Lucerne,7989,3,13,9,10,42,41,1,48
St Gallen,7989,4,14,3,15,40,55,-15,45
FC Zürich,7989,5,10,10,12,41,36,5,40
Grasshoppers,7989,6,10,7,15,45,50,-5,37
FC Thun,7989,7,10,6,16,44,60,-16,36
FC Lugano,7989,8,10,6,16,30,48,-18,36
FC Sion,7989,9,6,8,18,42,59,-17,26
Young Boys,7990,1,21,7,4,75,38,37,70
FC Basel,7990,2,18,8,6,52,25,27,62
Lucerne,7990,3,14,8,10,46,44,2,50
FC Zürich,7990,4,12,9,11,42,36,6,45
St Gallen,7990,5,14,2,16,42,55,-13,44
Grasshoppers,7990,6,10,6,16,42,49,-7,36
FC Thun,7990,7,10,6,16,44,58,-14,36
FC Lugano,7990,8,10,5,17,31,49,-18,35
FC Sion,7990,9,6,7,19,38,58,-20,25
Young Boys,7991,1,21,6,5,70,37,33,69
FC Basel,7991,2,18,9,5,55,22,33,63
St Gallen,7991,3,14,4,14,44,54,-10,46
Lucerne,7991,4,11,8,13,39,50,-11,41
Grasshoppers,7991,5,11,6,15,42,48,-6,39
FC Zürich,7991,6,9,11,12,36,35,1,38
FC Lugano,7991,7,10,7,15,33,47,-14,37
FC Sion,7991,8,9,8,15,44,51,-7,35
FC Thun,7991,9,8,7,17,40,59,-19,31
Young Boys,7992,1,22,6,4,68,36,32,72
FC Basel,7992,2,18,7,7,52,24,28,61
FC Zürich,7992,3,13,9,10,44,35,9,48
Lucerne,7992,4,13,9,10,44,43,1,48
St Gallen,7992,5,15,2,15,43,56,-13,47
Grasshoppers,7992,6,10,7,15,41,47,-6,37
FC Lugano,7992,7,10,6,16,35,49,-14,36
FC Thun,7992,8,8,6,18,41,61,-20,30
FC Sion,7992,9,5,8,19,39,56,-17,23
Young Boys,7993,1,20,10,2,72,37,35,70
FC Basel,7993,2,19,8,5,56,25,31,65
Lucerne,7993,3,14,8,10,43,41,2,50
St Gallen,7993,4,13,4,15,43,56,-13,43
FC Zürich,7993,5,10,11,11,41,38,3,41
FC Lugano,7993,6,9,8,15,32,49,-17,35
Grasshoppers,7993,7,9,7,16,41,49,-8,34
FC Thun,7993,8,9,5,18,43,62,-19,32
FC Sion,7993,9,6,9,17,40,54,-14,27
Young Boys,7994,1,20,6,6,67,41,26,66
FC Basel,7994,2,19,7,6,53,23,30,64
Lucerne,7994,3,14,8,10,45,46,-1,50
FC Zürich,7994,4,12,9,11,44,34,10,45
St Gallen,7994,5,14,3,15,47,55,-8,45
Grasshoppers,7994,6,10,7,15,45,49,-4,37
FC Lugano,7994,7,10,6,16,31,50,-19,36
FC Thun,7994,8,9,6,17,45,61,-16,33
FC Sion,7994,9,6,8,18,39,57,-18,26
Young Boys,7995,1,21,8,3,72,35,37,71
FC Basel,7995,2,19,7,6,58,28,30,64
Lucerne,7995,3,15,8,9,49,41,8,53
St Gallen,7995,4,14,2,16,45,60,-15,44
FC Zürich,7995,5,10,9,13,40,37,3,39
FC Lugano,7995,6,10,6,16,30,46,-16,36
Grasshoppers,7995,7,9,7,16,42,55,-13,34
FC Thun,7995,8,9,5,18,43,61,-18,32
FC Sion,7995,9,7,8,17,47,63,-16,29
Young Boys,7996,1,21,8,3,71,34,37,71
FC Basel,7996,2,17,8,7,58,29,29,59
St Gallen,7996,3,16,2,14,48,54,-6,50
FC Zürich,7996,4,12,9,11,46,37,9,45
Lucerne,7996,5,11,9,12,40,48,-8,42
FC Lugano,7996,6,11,5,16,32,49,-17,38
Grasshoppers,7996,7,8,9,15,40,50,-10,33
FC Thun,7996,8,9,6,17,43,62,-19,33
FC Sion,7996,9,7,8,17,40,55,-15,29
Young Boys,7997,1,22,8,2,72,32,40,74
FC Basel,7997,2,18,8,6,58,28,30,62
Lucerne,7997,3,12,9,11,39,42,-3,45
St Gallen,7997,4,13,4,15,42,55,-13,43
FC Zürich,7997,5,10,10,12,37,37,0,40
FC Lugano,7997,6,11,6,15,31,44,-13,39
FC Thun,7997,7,10,6,16,48,62,-14,36
Grasshoppers,7997,8,8,7,17,40,53,-13,31
FC Sion,7997,9,6,10,16,39,53,-14,28
Young Boys,7998,1,24,6,2,76,32,44,78
FC Basel,7998,2,16,9,7,52,28,24,57
Lucerne,7998,3,15,7,10,48,44,4,52
St Gallen,7998,4,14,3,15,41,58,-17,45
FC Zürich,7998,5,10,11,11,41,36,5,41
FC Thun,7998,6,10,6,16,44,57,-13,36
FC Lugano,7998,7,9,5,18,28,51,-23,32
FC Sion,7998,8,7,9,16,45,55,-10,30
Grasshoppers,7998,9,8,6,18,42,56,-14,30
Young Boys,7999,1,22,6,4,73,34,39,72
FC Basel,7999,2,19,7,6,57,23,34,64
Lucerne,7999,3,14,8,10,45,44,1,50
St Gallen,7999,4,14,3,15,44,57,-13,45
FC Zürich,7999,5,10,11,11,39,37,2,41
FC Lugano,7999,6,10,5,17,33,50,-17,35
FC Thun,7999,7,9,7,16,44,61,-17,34
Grasshoppers,7999,8,8,8,16,40,51,-11,32
FC Sion,7999,9,6,9,17,38,56,-18,27
Young Boys,8000,1,22,7,3,71,34,37,73
FC Basel,8000,2,18,7,7,57,26,31,61
St Gallen,8000,3,15,2,15,48,54,-6,47
Lucerne,8000,4,12,8,12,47,52,-5,44
FC Zürich,8000,5,11,9,12,38,37,1,42
FC Lugano,8000,6,11,6,15,33,48,-15,39
FC Thun,8000,7,10,6,16,41,55,-14,36
Grasshoppers,8000,8,8,7,17,37,54,-17,31
FC Sion,8000,9,7,8,17,39,51,-12,29
Young Boys,8001,1,23,6,3,70,32,38,75
FC Basel,8001,2,19,7,6,58,25,33,64
Lucerne,8001,3,13,7,12,43,44,-1,46
St Gallen,8001,4,13,3,16,43,59,-16,42
FC Zürich,8001,5,10,9,13,39,40,-1,39
FC Thun,8001,6,11,6,15,45,56,-11,39
FC Lugano,8001,7,10,5,17,31,52,-21,35
Grasshoppers,8001,8,9,7,16,42,51,-9,34
FC Sion,8001,9,7,8,17,44,56,-12,29
Young Boys,8002,1,22,7,3,70,34,36,73
FC Basel,8002,2,17,7,8,58,29,29,58
Lucerne,8002,3,12,9,11,41,45,-4,45
St Gallen,8002,4,14,3,15,43,59,-16,45
FC Zürich,8002,5,10,10,12,39,36,3,40
FC Thun,8002,6,10,7,15,44,56,-12,37
FC Lugano,8002,7,10,6,16,29,46,-17,36
Grasshoppers,8002,8,9,7,16,38,48,-10,34
FC Sion,8002,9,8,8,16,43,52,-9,32
Young Boys,8003,1,19,8,5,68,37,31,65
FC Basel,8003,2,17,8,7,57,27,30,59
St Gallen,8003,3,15,3,14,44,54,-10,48
Lucerne,8003,4,13,8,11,40,47,-7,47
FC Zürich,8003,5,10,9,13,41,38,3,39
Grasshoppers,8003,6,11,6,15,42,47,-5,39
FC Lugano,8003,7,11,6,15,30,44,-14,39
FC Thun,8003,8,11,5,16,44,57,-13,38
FC Sion,8003,9,6,9,17,39,54,-15,27
Young Boys,8004,1,23,6,3,77,35,42,75
FC Basel,8004,2,17,9,6,54,28,26,60
St Gallen,8004,3,14,4,14,48,58,-10,46
Lucerne,8004,4,12,8,12,44,50,-6,44
FC Zürich,8004,5,11,9,12,43,41,2,42
FC Lugano,8004,6,11,5,16,33,49,-16,38
FC Thun,8004,7,10,5,17,48,57,-9,35
Grasshoppers,8004,8,9,7,16,40,54,-14,34
FC Sion,8004,9,6,9,17,39,54,-15,27
Young Boys,8005,1,23,6,3,74,34,40,75
FC Basel,8005,2,19,8,5,53,21,32,65
Lucerne,8005,3,12,9,11,43,46,-3,45
St Gallen,8005,4,14,2,16,43,55,-12,44
FC Zürich,8005,5,11,9,12,40,36,4,42
FC Thun,8005,6,11,5,16,44,55,-11,38
Grasshoppers,8005,7,9,7,16,40,51,-11,34
FC Lugano,8005,8,9,6,17,29,50,-21,33
FC Sion,8005,9,6,8,18,38,56,-18,26
Young Boys,8006,1,19,9,4,67,35,32,66
FC Basel,8006,2,18,8,6,54,29,25,62
St Gallen,8006,3,15,4,13,43,50,-7,49
Lucerne,8006,4,11,10,11,39,43,-4,43
FC Zürich,8006,5,10,10,12,40,37,3,40
Grasshoppers,8006,6,10,7,15,40,46,-6,37
FC Lugano,8006,7,10,7,15,29,44,-15,37
FC Thun,8006,8,9,6,17,42,60,-18,33
FC Sion,8006,9,7,9,16,41,51,-10,30
Young Boys,8007,1,22,8,2,76,34,42,74
FC Basel,8007,2,17,7,8,55,31,24,58
FC Zürich,8007,3,11,11,10,42,34,8,44
Lucerne,8007,4,12,8,12,42,49,-7,44
St Gallen,8007,5,14,2,16,44,57,-13,44
Grasshoppers,8007,6,11,7,14,43,46,-3,40
FC Thun,8007,7,10,6,16,47,60,-13,36
FC Lugano,8007,8,10,6,16,30,50,-20,36
FC Sion,8007,9,6,7,19,41,59,-18,25
Young Boys,8008,1,22,7,3,69,32,37,73
FC Basel,8008,2,18,8,6,56,26,30,62
St Gallen,8008,3,15,3,14,47,60,-13,48
Lucerne,8008,4,13,7,12,40,42,-2,46
FC Zürich,8008,5,10,11,11,40,36,4,41
FC Lugano,8008,6,10,7,15,33,48,-15,37
Grasshoppers,8008,7,9,6,17,39,51,-12,33
FC Thun,8008,8,9,5,18,42,60,-18,32
FC Sion,8008,9,7,8,17,43,54,-11,29
Young Boys,8009,1,22,6,4,76,39,37,72
FC Basel,8009,2,19,8,5,60,25,35,65
St Gallen,8009,3,15,2,15,47,56,-9,47
Lucerne,8009,4,13,7,12,46,47,-1,46
FC Zürich,8009,5,10,10,12,41,37,4,40
Grasshoppers,8009,6,10,6,16,45,53,-8,36
FC Thun,8009,7,10,5,17,44,61,-17,35
FC Lugano,8009,8,10,5,17,31,54,-23,35
FC Sion,8009,9,7,7,18,40,58,-18,28
Young Boys,8010,1,21,6,5,69,37,32,69
FC Basel,8010,2,17,9,6,55,28,27,60
Lucerne,8010,3,13,10,9,43,40,3,49
St Gallen,8010,4,13,3,16,42,59,-17,42
FC Zürich,8010,5,10,9,13,39,39,0,39
FC Lugano,8010,6,11,6,15,34,46,-12,39
Grasshoppers,8010,7,10,8,14,44,48,-4,38
FC Thun,8010,8,10,6,16,43,56,-13,36
FC Sion,8010,9,7,7,18,40,56,-16,28
Young Boys,8011,1,21,7,4,70,38,32,70
FC Basel,8011,2,18,9,5,56,25,31,63
Lucerne,8011,3,13,9,10,45,41,4,48
FC Zürich,8011,4,12,9,11,45,38,7,45
St Gallen,8011,5,14,3,15,44,56,-12,45
FC Lugano,8011,6,10,5,17,31,50,-19,35
Grasshoppers,8011,7,9,7,16,40,52,-12,34
FC Thun,8011,8,9,7,16,45,60,-15,34
FC Sion,8011,9,6,8,18,42,58,-16,26
Young Boys,8012,1,23,6,3,74,33,41,75
FC Basel,8012,2,19,8,5,55,26,29,65
Lucerne,8012,3,12,8,12,45,48,-3,44
St Gallen,8012,4,13,4,15,45,58,-13,43
FC Zürich,8012,5,9,12,11,39,36,3,39
Grasshoppers,8012,6,10,6,16,43,50,-7,36
FC Lugano,8012,7,10,6,16,31,51,-20,36
FC Thun,8012,8,9,7,16,46,61,-15,34
FC Sion,8012,9,6,9,17,42,57,-15,27
Young Boys,8013,1,21,8,3,74,40,34,71
FC Basel,8013,2,16,10,6,53,26,27,58
Lucerne,8013,3,14,8,10,48,41,7,50
St Gallen,8013,4,14,3,15,41,56,-15,45
FC Zürich,8013,5,11,11,10,43,37,6,44
FC Lugano,8013,6,9,8,15,29,48,-19,35
FC Thun,8013,7,9,7,16,47,62,-15,34
Grasshoppers,8013,8,8,7,17,42,55,-13,31
FC Sion,8013,9,6,10,16,44,56,-12,28
Young Boys,8014,1,23,6,3,79,35,44,75
FC Basel,8014,2,18,9,5,58,25,33,63
St Gallen,8014,3,15,4,13,43,52,-9,49
FC Zürich,8014,4,12,10,10,45,37,8,46
Lucerne,8014,5,12,8,12,40,47,-7,44
Grasshoppers,8014,6,10,7,15,43,49,-6,37
FC Thun,8014,7,9,5,18,43,61,-18,32
FC Lugano,8014,8,9,5,18,30,52,-22,32
FC Sion,8014,9,5,8,19,39,62,-23,23
Young Boys,8015,1,21,6,5,71,36,35,69
FC Basel,8015,2,19,8,5,59,23,36,65
Lucerne,8015,3,14,7,11,42,44,-2,49
St Gallen,8015,4,15,4,13,45,53,-8,49
FC Zürich,8015,5,9,9,14,37,40,-3,36
FC Thun,8015,6,10,6,16,44,58,-14,36
FC Lugano,8015,7,10,6,16,29,49,-20,36
Grasshoppers,8015,8,9,7,16,43,51,-8,34
FC Sion,8015,9,7,7,18,40,56,-16,28
Young Boys,8016,1,22,6,4,69,34,35,72
FC Basel,8016,2,20,7,5,58,26,32,67
Lucerne,8016,3,12,8,12,43,49,-6,44
St Gallen,8016,4,14,2,16,44,56,-12,44
FC Zürich,8016,5,9,11,12,42,40,2,38
FC Thun,8016,6,11,5,16,47,58,-11,38
FC Lugano,8016,7,10,6,16,32,48,-16,36
FC Sion,8016,8,8,8,16,43,55,-12,32
Grasshoppers,8016,9,8,7,17,40,52,-12,31
Young Boys,8017,1,23,6,3,70,32,38,75
FC Basel,8017,2,18,7,7,57,28,29,61
Lucerne,8017,3,12,8,12,41,46,-5,44
St Gallen,8017,4,14,2,16,42,57,-15,44
FC Zürich,8017,5,10,10,12,42,39,3,40
FC Thun,8017,6,11,6,15,45,54,-9,39
FC Lugano,8017,7,10,6,16,28,47,-19,36
Grasshoppers,8017,8,9,7,16,39,48,-9,34
FC Sion,8017,9,6,10,16,40,53,-13,28
Young Boys,8018,1,22,7,3,70,32,38,73
FC Basel,8018,2,18,9,5,56,27,29,63
Lucerne,8018,3,14,7,11,46,43,3,49
FC Zürich,8018,4,12,9,11,43,35,8,45
St Gallen,8018,5,14,3,15,44,57,-13,45
Grasshoppers,8018,6,10,6,16,41,48,-7,36
FC Thun,8018,7,10,5,17,44,60,-16,35
FC Lugano,8018,8,9,5,18,30,53,-23,32
FC Sion,8018,9,6,7,19,39,58,-19,25
Young Boys,8019,1,20,8,4,64,31,33,68
FC Basel,8019,2,17,9,6,54,28,26,60
Lucerne,8019,3,12,10,10,42,44,-2,46
FC Zürich,8019,4,12,9,11,45,33,12,45
St Gallen,8019,5,14,2,16,43,59,-16,44
FC Lugano,8019,6,11,6,15,32,45,-13,39
Grasshoppers,8019,7,10,8,14,41,47,-6,38
FC Thun,8019,8,9,7,16,42,58,-16,34
FC Sion,8019,9,6,7,19,38,56,-18,25
Young Boys,8020,1,22,6,4,69,34,35,72
FC Basel,8020,2,17,8,7,56,29,27,59
Lucerne,8020,3,15,7,10,42,40,2,52
FC Zürich,8020,4,11,11,10,43,35,8,44
St Gallen,8020,5,14,2,16,43,56,-13,44
FC Lugano,8020,6,10,6,16,32,51,-19,36
FC Sion,8020,7,8,8,16,43,52,-9,32
Grasshoppers,8020,8,8,7,17,39,52,-13,31
FC Thun,8020,9,8,7,17,42,60,-18,31
Young Boys,8021,1,21,8,3,71,33,38,71
FC Basel,8021,2,18,8,6,55,24,31,62
Lucerne,8021,3,12,9,11,40,46,-6,45
St Gallen,8021,4,14,3,15,41,55,-14,45
FC Zürich,8021,5,10,11,11,40,35,5,41
FC Thun,8021,6,10,6,16,42,56,-14,36
FC Lugano,8021,7,10,6,16,30,48,-18,36
Grasshoppers,8021,8,9,8,15,39,47,-8,35
FC Sion,8021,9,7,7,18,39,53,-14,28
Young Boys,8022,1,22,6,4,73,34,39,72
FC Basel,8022,2,18,8,6,54,25,29,62
Lucerne,8022,3,14,8,10,43,40,3,50
St Gallen,8022,4,15,2,15,44,55,-11,47
FC Zürich,8022,5,12,10,10,44,35,9,46
FC Lugano,8022,6,9,6,17,32,54,-22,33
FC Thun,8022,7,9,5,18,43,63,-20,32
Grasshoppers,8022,8,8,7,17,39,55,-16,31
FC Sion,8022,9,7,8,17,40,51,-11,29
Young Boys,8023,1,22,6,4,72,36,36,72
FC Basel,8023,2,20,7,5,57,25,32,67
St Gallen,8023,3,15,2,15,43,55,-12,47
Lucerne,8023,4,13,7,12,42,46,-4,46
FC Zürich,8023,5,10,10,12,38,38,0,40
Grasshoppers,8023,6,10,6,16,46,53,-7,36
FC Thun,8023,7,9,6,17,45,60,-15,33
FC Lugano,8023,8,9,6,17,27,46,-19,33
FC Sion,8023,9,7,8,17,44,55,-11,29
Young Boys,8024,1,20,9,3,68,35,33,69
FC Basel,8024,2,16,11,5,51,24,27,59
Lucerne,8024,3,12,11,9,42,40,2,47
St Gallen,8024,4,13,5,14,41,54,-13,44
FC Zürich,8024,5,10,11,11,39,35,4,41
FC Lugano,8024,6,10,7,15,32,48,-16,37
Grasshoppers,8024,7,9,9,14,39,45,-6,36
FC Thun,8024,8,9,7,16,43,57,-14,34
FC Sion,8024,9,5,10,17,37,54,-17,25
Young Boys,8025,1,22,8,2,74,37,37,74
FC Basel,8025,2,15,11,6,52,28,24,56
Lucerne,8025,3,13,9,10,45,42,3,48
St Gallen,8025,4,14,3,15,42,56,-14,45
FC Zürich,8025,5,9,12,11,43,40,3,39
FC Thun,8025,6,10,6,16,44,58,-14,36
FC Lugano,8025,7,10,6,16,33,51,-18,36
Grasshoppers,8025,8,9,6,17,44,53,-9,33
FC Sion,8025,9,7,9,16,41,53,-12,30
Young Boys,8026,1,21,6,5,69,37,32,69
FC Basel,8026,2,17,9,6,54,25,29,60
Lucerne,8026,3,12,10,10,45,47,-2,46
St Gallen,8026,4,14,4,14,41,51,-10,46
FC Zürich,8026,5,12,9,11,43,35,8,45
FC Lugano,8026,6,10,7,15,30,45,-15,37
FC Thun,8026,7,10,5,17,40,59,-19,35
Grasshoppers,8026,8,9,7,16,41,50,-9,34
FC Sion,8026,9,7,7,18,38,52,-14,28
Young Boys,8027,1,21,7,4,71,36,35,70
FC Basel,8027,2,17,8,7,52,28,24,59
St Gallen,8027,3,15,2,15,47,55,-8,47
Lucerne,8027,4,11,9,12,43,50,-7,42
FC Zürich,8027,5,10,11,11,39,34,5,41
FC Lugano,8027,6,11,6,15,33,48,-15,39
FC Thun,8027,7,11,5,16,48,57,-9,38
FC Sion,8027,8,8,8,16,41,52,-11,32
Grasshoppers,8027,9,8,8,16,44,58,-14,32
Young Boys,8028,1,21,8,3,71,34,37,71
FC Basel,8028,2,17,9,6,59,30,29,60
Lucerne,8028,3,14,7,11,42,43,-1,49
St Gallen,8028,4,15,2,15,43,55,-12,47
FC Zürich,8028,5,12,10,10,44,37,7,46
FC Thun,8028,6,10,6,16,49,61,-12,36
FC Lugano,8028,7,10,6,16,32,49,-17,36
Grasshoppers,8028,8,9,7,16,39,50,-11,34
FC Sion,8028,9,5,7,20,37,57,-20,22
Young Boys,8029,1,21,8,3,74,35,39,71
FC Basel,8029,2,19,7,6,59,28,31,64
FC Zürich,8029,3,13,9,10,44,34,10,48
Lucerne,8029,4,12,9,11,43,48,-5,45
St Gallen,8029,5,14,2,16,45,57,-12,44
Grasshoppers,8029,6,9,8,15,40,49,-9,35
FC Lugano,8029,7,10,5,17,30,46,-16,35
FC Thun,8029,8,9,5,18,43,60,-17,32
FC Sion,8029,9,7,7,18,38,59,-21,28
Young Boys,8030,1,22,7,3,71,35,36,73
FC Basel,8030,2,17,7,8,50,28,22,58
Lucerne,8030,3,14,8,10,44,41,3,50
St Gallen,8030,4,15,3,14,44,58,-14,48
FC Lugano,8030,5,11,5,16,33,47,-14,38
FC Zürich,8030,6,9,9,14,37,42,-5,36
Grasshoppers,8030,7,10,6,16,39,47,-8,36
FC Thun,8030,8,9,6,17,43,56,-13,33
FC Sion,8030,9,7,9,16,46,53,-7,30
Young Boys,8031,1,22,7,3,73,34,39,73
FC Basel,8031,2,17,9,6,55,27,28,60
Lucerne,8031,3,14,7,11,43,45,-2,49
St Gallen,8031,4,13,3,16,41,56,-15,42
FC Zürich,8031,5,10,11,11,41,37,4,41
FC Lugano,8031,6,10,6,16,30,46,-16,36
Grasshoppers,8031,7,9,7,16,40,50,-10,34
FC Sion,8031,8,8,8,16,42,52,-10,32
FC Thun,8031,9,8,8,16,43,61,-18,32
Young Boys,8032,1,22,6,4,73,39,34,72
FC Basel,8032,2,19,8,5,57,26,31,65
St Gallen,8032,3,16,3,13,44,51,-7,51
FC Zürich,8032,4,11,9,12,43,39,4,42
Grasshoppers,8032,5,12,6,14,47,50,-3,42
Lucerne,8032,6,11,8,13,42,49,-7,41
FC Lugano,8032,7,9,6,17,30,49,-19,33
FC Thun,8032,8,9,5,18,44,60,-16,32
FC Sion,8032,9,6,7,19,39,56,-17,25
Young Boys,8033,1,23,7,2,74,32,42,76
FC Basel,8033,2,18,7,7,58,26,32,61
St Gallen,8033,3,15,2,15,44,56,-12,47
Lucerne,8033,4,13,7,12,40,48,-8,46
FC Zürich,8033,5,11,9,12,44,39,5,42
FC Lugano,8033,6,11,5,16,34,47,-13,38
FC Thun,8033,7,11,5,16,44,60,-16,38
Grasshoppers,8033,8,9,7,16,42,49,-7,34
FC Sion,8033,9,5,7,20,37,60,-23,22
Young Boys,8034,1,21,6,5,71,40,31,69
FC Basel,8034,2,18,9,5,55,23,32,63
Lucerne,8034,3,14,8,10,47,41,6,50
St Gallen,8034,4,14,4,14,42,53,-11,46
FC Thun,8034,5,11,6,15,46,56,-10,39
FC Zürich,8034,6,9,10,13,37,38,-1,37
Grasshoppers,8034,7,10,7,15,42,48,-6,37
FC Lugano,8034,8,9,6,17,30,55,-25,33
FC Sion,8034,9,6,8,18,39,55,-16,26
Young Boys,8035,1,22,7,3,72,32,40,73
FC Basel,8035,2,20,7,5,58,23,35,67
Lucerne,8035,3,12,8,12,42,49,-7,44
St Gallen,8035,4,14,2,16,43,56,-13,44
FC Zürich,8035,5,10,10,12,39,37,2,40
FC Lugano,8035,6,11,6,15,32,45,-13,39
Grasshoppers,8035,7,10,7,15,45,52,-7,37
FC Thun,8035,8,9,6,17,42,59,-17,33
FC Sion,8035,9,6,7,19,38,58,-20,25
Young Boys,8036,1,21,6,5,70,35,35,69
FC Basel,8036,2,17,9,6,55,29,26,60
Lucerne,8036,3,13,8,11,42,45,-3,47
FC Zürich,8036,4,12,9,11,43,37,6,45
St Gallen,8036,5,14,3,15,46,56,-10,45
Grasshoppers,8036,6,11,6,15,42,49,-7,39
FC Thun,8036,7,10,6,16,48,57,-9,36
FC Lugano,8036,8,10,6,16,31,50,-19,36
FC Sion,8036,9,6,7,19,37,56,-19,25
Young Boys,8037,1,23,6,3,72,33,39,75
FC Basel,8037,2,18,8,6,54,26,28,62
Lucerne,8037,3,12,8,12,40,44,-4,44
St Gallen,8037,4,14,2,16,40,55,-15,44
FC Zürich,8037,5,11,9,12,40,35,5,42
FC Thun,8037,6,10,6,16,45,59,-14,36
FC Lugano,8037,7,10,5,17,30,48,-18,35
Grasshoppers,8037,8,9,7,16,42,52,-10,34
FC Sion,8037,9,7,9,16,42,53,-11,30
Young Boys,8038,1,23,6,3,76,36,40,75
FC Basel,8038,2,19,7,6,57,23,34,64
St Gallen,8038,3,15,3,14,45,55,-10,48
Lucerne,8038,4,12,8,12,38,42,-4,44
FC Zürich,8038,5,11,9,12,39,36,3,42
FC Lugano,8038,6,11,5,16,33,53,-20,38
FC Thun,8038,7,10,5,17,44,58,-14,35
Grasshoppers,8038,8,8,7,17,39,53,-14,31
FC Sion,8038,9,6,8,18,38,53,-15,26
Young Boys,8039,1,21,7,4,72,33,39,70
FC Basel,8039,2,18,9,5,53,23,30,63
Lucerne,8039,3,13,9,10,39,40,-1,48
FC Zürich,8039,4,12,9,11,42,37,5,45
St Gallen,8039,5,13,4,15,41,56,-15,43
Grasshoppers,8039,6,9,7,16,42,50,-8,34
FC Thun,8039,7,9,6,17,41,57,-16,33
FC Lugano,8039,8,9,6,17,29,49,-20,33
FC Sion,8039,9,8,7,17,45,59,-14,31
Young Boys,8040,1,21,7,4,68,38,30,70
FC Basel,8040,2,17,10,5,56,24,32,61
St Gallen,8040,3,15,4,13,44,52,-8,49
Lucerne,8040,4,13,9,10,40,40,0,48
FC Zürich,8040,5,9,11,12,40,40,0,38
FC Thun,8040,6,10,5,17,42,57,-15,35
FC Lugano,8040,7,10,5,17,31,50,-19,35
FC Sion,8040,8,8,8,16,42,50,-8,32
Grasshoppers,8040,9,8,7,17,37,49,-12,31
Young Boys,8041,1,21,7,4,71,37,34,70
FC Basel,8041,2,18,8,6,53,25,28,62
St Gallen,8041,3,16,3,13,47,53,-6,51
FC Zürich,8041,4,11,10,11,44,34,10,43
Lucerne,8041,5,11,9,12,41,45,-4,42
FC Lugano,8041,6,10,6,16,31,48,-17,36
Grasshoppers,8041,7,9,7,16,39,47,-8,34
FC Thun,8041,8,9,6,17,41,62,-21,33
FC Sion,8041,9,7,8,17,42,58,-16,29
Young Boys,8042,1,23,7,2,73,31,42,76
FC Basel,8042,2,18,8,6,57,25,32,62
St Gallen,8042,3,16,2,14,46,53,-7,50
Lucerne,8042,4,11,9,12,37,46,-9,42
FC Zürich,8042,5,10,11,11,41,37,4,41
Grasshoppers,8042,6,10,7,15,42,49,-7,37
FC Lugano,8042,7,9,7,16,29,47,-18,34
FC Thun,8042,8,9,6,17,45,63,-18,33
FC Sion,8042,9,6,7,19,39,58,-19,25
Young Boys,8043,1,21,8,3,74,37,37,71
FC Basel,8043,2,18,9,5,60,27,33,63
Lucerne,8043,3,13,8,11,47,48,-1,47
St Gallen,8043,4,14,2,16,42,61,-19,44
FC Zürich,8043,5,11,10,11,44,37,7,43
FC Lugano,8043,6,10,6,16,32,50,-18,36
FC Thun,8043,7,9,7,16,44,61,-17,34
Grasshoppers,8043,8,9,6,17,43,53,-10,33
FC Sion,8043,9,7,8,17,45,57,-12,29
Young Boys,8044,1,22,7,3,72,39,33,73
FC Basel,8044,2,18,8,6,54,26,28,62
Lucerne,8044,3,13,8,11,45,44,1,47
St Gallen,8044,4,14,3,15,42,56,-14,45
FC Zürich,8044,5,10,10,12,43,37,6,40
FC Lugano,8044,6,10,7,15,29,45,-16,37
Grasshoppers,8044,7,10,6,16,48,53,-5,36
FC Thun,8044,8,9,5,18,43,62,-19,32
FC Sion,8044,9,7,8,17,47,61,-14,29
Young Boys,8045,1,23,6,3,80,34,46,75
FC Basel,8045,2,19,8,5,61,25,36,65
St Gallen,8045,3,14,4,14,44,55,-11,46
Lucerne,8045,4,12,8,12,43,51,-8,44
FC Zürich,8045,5,10,9,13,38,42,-4,39
Grasshoppers,8045,6,10,7,15,43,50,-7,37
FC Lugano,8045,7,10,5,17,33,50,-17,35
FC Thun,8045,8,9,6,17,41,57,-16,33
FC Sion,8045,9,6,9,17,36,55,-19,27
Young Boys,8046,1,21,8,3,73,33,40,71
FC Basel,8046,2,17,9,6,54,27,27,60
St Gallen,8046,3,15,3,14,44,53,-9,48
FC Zürich,8046,4,11,9,12,41,38,3,42
Lucerne,8046,5,11,9,12,38,46,-8,42
Grasshoppers,8046,6,11,6,15,42,50,-8,39
FC Lugano,8046,7,9,7,16,30,47,-17,34
FC Thun,8046,8,9,6,17,45,61,-16,33
FC Sion,8046,9,8,7,17,42,54,-12,31
Young Boys,8047,1,24,6,2,79,35,44,78
FC Basel,8047,2,18,8,6,59,29,30,62
Lucerne,8047,3,11,11,10,41,45,-4,44
St Gallen,8047,4,13,3,16,40,56,-16,42
FC Zürich,8047,5,10,10,12,39,40,-1,40
FC Lugano,8047,6,10,7,15,33,46,-13,37
FC Thun,8047,7,10,5,17,44,61,-17,35
Grasshoppers,8047,8,9,7,16,41,51,-10,34
FC Sion,8047,9,7,7,18,42,55,-13,28
Young Boys,8048,1,21,7,4,74,40,34,70
FC Basel,8048,2,17,10,5,56,24,32,61
St Gallen,8048,3,14,3,15,45,59,-14,45
FC Zürich,8048,4,11,10,11,42,37,5,43
Lucerne,8048,5,11,10,11,42,46,-4,43
Grasshoppers,8048,6,11,6,15,44,48,-4,39
FC Lugano,8048,7,10,6,16,33,47,-14,36
FC Thun,8048,8,10,5,17,44,65,-21,35
FC Sion,8048,9,7,7,18,43,57,-14,28
Young Boys,8049,1,23,7,2,77,35,42,76
FC Basel,8049,2,16,9,7,51,27,24,57
St Gallen,8049,3,15,3,14,44,52,-8,48
FC Zürich,8049,4,10,12,10,39,34,5,42
Lucerne,8049,5,11,9,12,41,50,-9,42
FC Thun,8049,6,10,7,15,46,58,-12,37
FC Lugano,8049,7,10,7,15,32,48,-16,37
Grasshoppers,8049,8,9,7,16,42,51,-9,34
FC Sion,8049,9,5,9,18,39,56,-17,24
Young Boys,8050,1,21,9,2,70,34,36,72
FC Basel,8050,2,17,8,7,56,29,27,59
St Gallen,8050,3,15,3,14,46,56,-10,48
Lucerne,8050,4,12,9,11,46,50,-4,45
FC Zürich,8050,5,11,10,11,45,38,7,43
FC Lugano,8050,6,10,7,15,34,49,-15,37
Grasshoppers,8050,7,9,8,15,47,52,-5,35
FC Thun,8050,8,10,5,17,42,59,-17,35
FC Sion,8050,9,6,7,19,40,59,-19,25
Young Boys,8051,1,22,8,2,73,31,42,74
FC Basel,8051,2,18,8,6,57,26,31,62
Lucerne,8051,3,13,7,12,41,44,-3,46
St Gallen,8051,4,14,2,16,43,59,-16,44
FC Zürich,8051,5,10,9,13,38,38,0,39
FC Lugano,8051,6,11,5,16,32,51,-19,38
FC Thun,8051,7,10,5,17,47,63,-16,35
Grasshoppers,8051,8,9,7,16,43,52,-9,34
FC Sion,8051,9,7,9,16,41,51,-10,30
Young Boys,8052,1,22,6,4,74,35,39,72
FC Basel,8052,2,20,7,5,58,23,35,67
St Gallen,8052,3,14,4,14,47,58,-11,46
Lucerne,8052,4,12,7,13,40,47,-7,43
FC Zürich,8052,5,10,10,12,38,37,1,40
Grasshoppers,8052,6,10,6,16,42,50,-8,36
FC Thun,8052,7,10,6,16,45,60,-15,36
FC Lugano,8052,8,9,7,16,32,52,-20,34
FC Sion,8052,9,6,9,17,41,55,-14,27
Young Boys,8053,1,21,6,5,69,36,33,69
FC Basel,8053,2,19,8,5,56,22,34,65
Lucerne,8053,3,15,7,10,43,42,1,52
St Gallen,8053,4,13,3,16,41,57,-16,42
FC Zürich,8053,5,10,11,11,42,39,3,41
Grasshoppers,8053,6,11,6,15,43,45,-2,39
FC Lugano,8053,7,10,6,16,30,47,-17,36
FC Thun,8053,8,9,5,18,43,62,-19,32
FC Sion,8053,9,6,8,18,41,58,-17,26
Young Boys,8054,1,21,8,3,72,36,36,71
FC Basel,8054,2,18,7,7,57,27,30,61
St Gallen,8054,3,16,3,13,46,54,-8,51
Lucerne,8054,4,12,9,11,43,45,-2,45
FC Zürich,8054,5,10,9,13,37,39,-2,39
FC Lugano,8054,6,9,8,15,32,48,-16,35
Grasshoppers,8054,7,9,7,16,43,54,-11,34
FC Thun,8054,8,9,7,16,45,60,-15,34
FC Sion,8054,9,7,8,17,41,53,-12,29
Young Boys,8055,1,22,7,3,75,37,38,73
FC Basel,8055,2,19,8,5,55,24,31,65
Lucerne,8055,3,14,8,10,46,42,4,50
St Gallen,8055,4,13,4,15,42,55,-13,43
FC Zürich,8055,5,10,9,13,40,38,2,39
FC Lugano,8055,6,10,7,15,33,49,-16,37
Grasshoppers,8055,7,9,7,16,39,50,-11,34
FC Thun,8055,8,9,5,18,42,64,-22,32
FC Sion,8055,9,6,9,17,40,53,-13,27
Young Boys,8056,1,21,7,4,71,36,35,70
FC Basel,8056,2,19,8,5,55,24,31,65
St Gallen,8056,3,16,2,14,50,56,-6,50
Lucerne,8056,4,13,8,11,46,47,-1,47
FC Zürich,8056,5,11,11,10,40,32,8,44
Grasshoppers,8056,6,9,7,16,41,55,-14,34
FC Thun,8056,7,9,6,17,44,60,-16,33
FC Lugano,8056,8,9,6,17,29,49,-20,33
FC Sion,8056,9,5,9,18,39,56,-17,24
Young Boys,8057,1,20,8,4,69,36,33,68
FC Basel,8057,2,19,7,6,57,25,32,64
St Gallen,8057,3,17,2,13,44,51,-7,53
Lucerne,8057,4,12,8,12,44,46,-2,44
FC Zürich,8057,5,10,9,13,39,40,-1,39
Grasshoppers,8057,6,9,8,15,45,54,-9,35
FC Lugano,8057,7,10,5,17,29,48,-19,35
FC Thun,8057,8,9,7,16,43,58,-15,34
FC Sion,8057,9,7,8,17,45,57,-12,29
Young Boys,8058,1,22,7,3,76,38,38,73
FC Basel,8058,2,19,7,6,54,23,31,64
St Gallen,8058,3,15,2,15,47,57,-10,47
Lucerne,8058,4,12,7,13,40,47,-7,43
FC Lugano,8058,5,12,6,14,37,48,-11,42
FC Zürich,8058,6,10,9,13,42,40,2,39
FC Thun,8058,7,10,5,17,45,59,-14,35
Grasshoppers,8058,8,9,6,17,40,54,-14,33
FC Sion,8058,9,7,7,18,46,61,-15,28
Young Boys,8059,1,22,7,3,74,37,37,73
FC Basel,8059,2,16,9,7,53,26,27,57
Lucerne,8059,3,12,9,11,39,44,-5,45
St Gallen,8059,4,13,6,13,42,53,-11,45
FC Zürich,8059,5,10,11,11,42,39,3,41
FC Lugano,8059,6,10,7,15,33,49,-16,37
Grasshoppers,8059,7,10,6,16,42,51,-9,36
FC Thun,8059,8,10,6,16,45,57,-12,36
FC Sion,8059,9,6,9,17,40,54,-14,27
Young Boys,8060,1,22,7,3,74,37,37,73
FC Basel,8060,2,19,8,5,57,24,33,65
Lucerne,8060,3,13,8,11,45,44,1,47
St Gallen,8060,4,15,2,15,43,53,-10,47
FC Zürich,8060,5,11,10,11,41,35,6,43
FC Lugano,8060,6,11,5,16,32,51,-19,38
FC Thun,8060,7,10,5,17,45,59,-14,35
Grasshoppers,8060,8,8,7,17,40,53,-13,31
FC Sion,8060,9,5,8,19,38,59,-21,23
Young Boys,8061,1,22,7,3,75,36,39,73
FC Basel,8061,2,16,9,7,52,26,26,57
Lucerne,8061,3,14,8,10,49,44,5,50
FC Zürich,8061,4,11,10,11,41,36,5,43
St Gallen,8061,5,13,4,15,44,61,-17,43
FC Lugano,8061,6,10,5,17,32,50,-18,35
FC Sion,8061,7,8,9,15,45,52,-7,33
Grasshoppers,8061,8,8,9,15,42,55,-13,33
FC Thun,8061,9,8,7,17,39,59,-20,31
Young Boys,8062,1,21,6,5,69,38,31,69
FC Basel,8062,2,19,8,5,57,24,33,65
St Gallen,8062,3,15,2,15,45,55,-10,47
Lucerne,8062,4,12,7,13,43,51,-8,43
Grasshoppers,8062,5,12,6,14,52,47,5,42
FC Lugano,8062,6,12,5,15,33,48,-15,41
FC Zürich,8062,7,10,10,12,46,39,7,40
FC Thun,8062,8,9,5,18,41,65,-24,32
FC Sion,8062,9,6,7,19,41,60,-19,25
Young Boys,8063,1,20,8,4,68,35,33,68
FC Basel,8063,2,18,8,6,58,26,32,62
Lucerne,8063,3,13,8,11,43,42,1,47
FC Zürich,8063,4,11,10,11,43,38,5,43
St Gallen,8063,5,13,3,16,40,60,-20,42
FC Lugano,8063,6,10,8,14,30,44,-14,38
FC Thun,8063,7,9,7,16,48,60,-12,34
Grasshoppers,8063,8,9,7,16,40,54,-14,34
FC Sion,8063,9,7,9,16,43,54,-11,30
Young Boys,8064,1,22,7,3,72,39,33,73
FC Basel,8064,2,18,8,6,64,28,36,62
Lucerne,8064,3,13,8,11,43,43,0,47
St Gallen,8064,4,14,3,15,42,58,-16,45
FC Zürich,8064,5,10,10,12,39,36,3,40
Grasshoppers,8064,6,11,6,15,41,47,-6,39
FC Lugano,8064,7,10,6,16,30,49,-19,36
FC Thun,8064,8,8,6,18,41,62,-21,30
FC Sion,8064,9,7,8,17,42,52,-10,29
Young Boys,8065,1,22,6,4,72,33,39,72
FC Basel,8065,2,16,9,7,51,27,24,57
Lucerne,8065,3,14,8,10,45,43,2,50
St Gallen,8065,4,14,5,13,43,53,-10,47
FC Zürich,8065,5,11,10,11,41,35,6,43
Grasshoppers,8065,6,10,6,16,43,53,-10,36
FC Thun,8065,7,10,6,16,47,59,-12,36
FC Lugano,8065,8,10,6,16,31,48,-17,36
FC Sion,8065,9,5,8,19,39,61,-22,23
Young Boys,8066,1,23,6,3,75,35,40,75
FC Basel,8066,2,18,7,7,54,29,25,61
St Gallen,8066,3,15,3,14,45,54,-9,48
Lucerne,8066,4,12,8,12,42,45,-3,44
FC Zürich,8066,5,11,10,11,45,34,11,43
FC Lugano,8066,6,10,7,15,30,47,-17,37
Grasshoppers,8066,7,9,6,17,43,55,-12,33
FC Thun,8066,8,9,5,18,44,65,-21,32
FC Sion,8066,9,7,8,17,40,54,-14,29
Young Boys,8067,1,22,7,3,75,36,39,73
FC Basel,8067,2,17,9,6,55,27,28,60
Lucerne,8067,3,13,7,12,41,44,-3,46
St Gallen,8067,4,14,4,14,43,54,-11,46
FC Zürich,8067,5,10,10,12,39,38,1,40
FC Lugano,8067,6,11,6,15,32,47,-15,39
Grasshoppers,8067,7,10,6,16,39,48,-9,36
FC Thun,8067,8,10,5,17,43,57,-14,35
FC Sion,8067,9,6,8,18,38,54,-16,26
Young Boys,8068,1,21,7,4,71,37,34,70
FC Basel,8068,2,18,8,6,53,24,29,62
Lucerne,8068,3,14,8,10,46,41,5,50
St Gallen,8068,4,13,4,15,41,54,-13,43
FC Zürich,8068,5,10,11,11,41,37,4,41
FC Lugano,8068,6,10,7,15,30,48,-18,37
FC Thun,8068,7,10,5,17,44,60,-16,35
FC Sion,8068,8,8,8,16,45,54,-9,32
Grasshoppers,8068,9,8,6,18,39,55,-16,30
Young Boys,8069,1,21,7,4,67,34,33,70
FC Basel,8069,2,18,7,7,52,24,28,61
Lucerne,8069,3,15,8,9,45,40,5,53
FC Zürich,8069,4,12,10,10,41,32,9,46
St Gallen,8069,5,14,2,16,42,58,-16,44
FC Lugano,8069,6,10,6,16,31,46,-15,36
Grasshoppers,8069,7,9,7,16,41,50,-9,34
FC Thun,8069,8,9,5,18,45,62,-17,32
FC Sion,8069,9,6,8,18,37,55,-18,26
Young Boys,8070,1,22,8,2,80,35,45,74
FC Basel,8070,2,17,8,7,55,30,25,59
St Gallen,8070,3,17,2,13,46,52,-6,53
Lucerne,8070,4,14,7,11,42,44,-2,49
FC Zürich,8070,5,10,9,13,41,41,0,39
Grasshoppers,8070,6,9,7,16,40,50,-10,34
FC Thun,8070,7,9,6,17,44,62,-18,33
FC Lugano,8070,8,9,5,18,29,55,-26,32
FC Sion,8070,9,7,8,17,46,54,-8,29
Young Boys,8071,1,21,7,4,70,35,35,70
FC Basel,8071,2,18,7,7,56,28,28,61
Lucerne,8071,3,14,7,11,44,44,0,49
St Gallen,8071,4,15,3,14,47,55,-8,48
FC Zürich,8071,5,10,10,12,38,35,3,40
FC Lugano,8071,6,11,6,15,31,45,-14,39
FC Sion,8071,7,8,8,16,40,52,-12,32
FC Thun,8071,8,9,5,18,41,60,-19,32
Grasshoppers,8071,9,8,7,17,38,51,-13,31
Young Boys,8072,1,21,9,2,72,35,37,72
FC Basel,8072,2,18,8,6,57,29,28,62
FC Zürich,8072,3,12,9,11,46,39,7,45
Lucerne,8072,4,12,8,12,48,50,-2,44
St Gallen,8072,5,13,4,15,43,59,-16,43
Grasshoppers,8072,6,10,7,15,44,51,-7,37
FC Lugano,8072,7,9,7,16,30,50,-20,34
FC Thun,8072,8,8,7,17,43,61,-18,31
FC Sion,8072,9,7,9,16,46,55,-9,30
Young Boys,8073,1,22,8,2,72,32,40,74
FC Basel,8073,2,19,7,6,52,24,28,64
Lucerne,8073,3,12,9,11,39,41,-2,45
St Gallen,8073,4,14,2,16,40,57,-17,44
FC Zürich,8073,5,11,9,12,40,36,4,42
FC Lugano,8073,6,11,6,15,32,44,-12,39
Grasshoppers,8073,7,10,7,15,38,46,-8,37
FC Thun,8073,8,9,5,18,42,58,-16,32
FC Sion,8073,9,6,7,19,38,55,-17,25
Young Boys,8074,1,21,7,4,68,37,31,70
FC Basel,8074,2,18,8,6,57,25,32,62
Lucerne,8074,3,14,7,11,42,44,-2,49
St Gallen,8074,4,14,3,15,41,53,-12,45
FC Zürich,8074,5,10,12,10,39,33,6,42
FC Lugano,8074,6,10,7,15,29,45,-16,37
FC Thun,8074,7,9,7,16,46,59,-13,34
FC Sion,8074,8,7,9,16,44,54,-10,30
Grasshoppers,8074,9,8,6,18,40,56,-16,30
Young Boys,8075,1,22,7,3,75,33,42,73
FC Basel,8075,2,17,8,7,54,25,29,59
St Gallen,8075,3,16,3,13,47,54,-7,51
Lucerne,8075,4,13,8,11,40,43,-3,47
FC Zürich,8075,5,11,10,11,40,35,5,43
FC Lugano,8075,6,9,6,17,32,50,-18,33
FC Thun,8075,7,9,6,17,42,64,-22,33
Grasshoppers,8075,8,8,7,17,36,51,-15,31
FC Sion,8075,9,7,9,16,42,53,-11,30
Young Boys,8076,1,23,6,3,76,38,38,75
FC Basel,8076,2,19,7,6,55,26,29,64
Lucerne,8076,3,12,9,11,41,43,-2,45
St Gallen,8076,4,13,4,15,41,57,-16,43
FC Zürich,8076,5,11,9,12,40,35,5,42
FC Lugano,8076,6,10,6,16,32,48,-16,36
Grasshoppers,8076,7,9,8,15,43,51,-8,35
FC Thun,8076,8,9,6,17,44,61,-17,33
FC Sion,8076,9,7,7,18,41,54,-13,28
Young Boys,8077,1,22,7,3,74,35,39,73
FC Basel,8077,2,16,7,9,50,30,20,55
St Gallen,8077,3,15,3,14,45,53,-8,48
Lucerne,8077,4,12,8,12,40,43,-3,44
FC Zürich,8077,5,11,9,12,42,38,4,42
FC Thun,8077,6,12,5,15,44,54,-10,41
FC Lugano,8077,7,11,6,15,32,45,-13,39
Grasshoppers,8077,8,8,7,17,38,53,-15,31
FC Sion,8077,9,7,8,17,42,56,-14,29
Young Boys,8078,1,20,8,4,69,36,33,68
FC Basel,8078,2,17,10,5,56,25,31,61
Lucerne,8078,3,14,7,11,44,47,-3,49
St Gallen,8078,4,14,2,16,41,57,-16,44
FC Zürich,8078,5,11,10,11,44,36,8,43
FC Lugano,8078,6,12,5,15,35,49,-14,41
FC Thun,8078,7,9,6,17,45,62,-17,33
FC Sion,8078,8,8,7,17,42,52,-10,31
Grasshoppers,8078,9,8,7,17,41,53,-12,31
Young Boys,8079,1,22,7,3,73,37,36,73
FC Basel,8079,2,18,7,7,57,28,29,61
St Gallen,8079,3,17,2,13,49,53,-4,53
Lucerne,8079,4,12,9,11,43,47,-4,45
FC Zürich,8079,5,10,11,11,40,38,2,41
Grasshoppers,8079,6,10,7,15,41,49,-8,37
FC Lugano,8079,7,9,7,16,31,49,-18,34
FC Thun,8079,8,8,7,17,43,62,-19,31
FC Sion,8079,9,6,7,19,43,57,-14,25
Young Boys,8080,1,21,7,4,71,35,36,70
FC Basel,8080,2,18,7,7,62,27,35,61
St Gallen,8080,3,16,3,13,45,53,-8,51
Lucerne,8080,4,13,7,12,44,51,-7,46
FC Zürich,8080,5,12,9,11,44,36,8,45
FC Thun,8080,6,9,7,16,41,60,-19,34
FC Lugano,8080,7,9,6,17,29,47,-18,33
Grasshoppers,8080,8,8,8,16,41,55,-14,32
FC Sion,8080,9,6,10,16,40,53,-13,28
Young Boys,8081,1,22,7,3,73,36,37,73
FC Basel,8081,2,16,11,5,55,28,27,59
St Gallen,8081,3,15,4,13,47,54,-7,49
Lucerne,8081,4,12,9,11,41,44,-3,45
FC Zürich,8081,5,10,11,11,39,35,4,41
FC Lugano,8081,6,9,7,16,30,49,-19,34
FC Sion,8081,7,8,8,16,40,50,-10,32
Grasshoppers,8081,8,8,8,16,38,49,-11,32
FC Thun,8081,9,8,7,17,39,57,-18,31
Young Boys,8082,1,23,6,3,70,32,38,75
FC Basel,8082,2,18,8,6,52,24,28,62
Lucerne,8082,3,13,9,10,45,46,-1,48
St Gallen,8082,4,14,2,16,46,58,-12,44
FC Zürich,8082,5,10,11,11,40,37,3,41
FC Lugano,8082,6,10,6,16,31,47,-16,36
Grasshoppers,8082,7,9,7,16,40,49,-9,34
FC Sion,8082,8,8,7,17,43,56,-13,31
FC Thun,8082,9,8,6,18,42,60,-18,30
Young Boys,8083,1,21,8,3,71,38,33,71
FC Basel,8083,2,19,8,5,56,23,33,65
St Gallen,8083,3,15,2,15,41,51,-10,47
Lucerne,8083,4,12,8,12,45,50,-5,44
FC Thun,8083,5,11,6,15,45,57,-12,39
FC Lugano,8083,6,11,5,16,32,46,-14,38
FC Zürich,8083,7,9,9,14,36,38,-2,36
Grasshoppers,8083,8,8,8,16,43,53,-10,32
FC Sion,8083,9,7,8,17,37,50,-13,29
Young Boys,8084,1,21,7,4,66,35,31,70
FC Basel,8084,2,17,8,7,57,29,28,59
St Gallen,8084,3,16,2,14,45,54,-9,50
Lucerne,8084,4,13,8,11,40,42,-2,47
FC Zürich,8084,5,12,10,10,44,34,10,46
FC Lugano,8084,6,10,6,16,33,47,-14,36
Grasshoppers,8084,7,9,7,16,40,50,-10,34
FC Thun,8084,8,9,6,17,43,63,-20,33
FC Sion,8084,9,6,8,18,39,53,-14,26
Young Boys,8085,1,20,8,4,67,33,34,68
FC Basel,8085,2,18,7,7,53,29,24,61
Lucerne,8085,3,15,8,9,46,39,7,53
St Gallen,8085,4,15,3,14,43,55,-12,48
FC Zürich,8085,5,11,9,12,42,37,5,42
Grasshoppers,8085,6,10,6,16,44,49,-5,36
FC Thun,8085,7,10,5,17,44,57,-13,35
FC Lugano,8085,8,10,5,17,32,50,-18,35
FC Sion,8085,9,5,9,18,39,61,-22,24
Young Boys,8086,1,22,7,3,77,38,39,73
FC Basel,8086,2,18,9,5,58,25,33,63
St Gallen,8086,3,15,2,15,45,56,-11,47
FC Zürich,8086,4,11,10,11,40,35,5,43
Lucerne,8086,5,12,7,13,40,49,-9,43
FC Thun,8086,6,10,6,16,46,59,-13,36
FC Lugano,8086,7,10,5,17,31,49,-18,35
Grasshoppers,8086,8,9,7,16,43,51,-8,34
FC Sion,8086,9,7,7,18,41,59,-18,28
Young Boys,8087,1,23,6,3,77,39,38,75
FC Basel,8087,2,16,9,7,52,30,22,57
Lucerne,8087,3,14,8,10,48,43,5,50
St Gallen,8087,4,14,3,15,46,61,-15,45
FC Zürich,8087,5,11,10,11,42,36,6,43
FC Lugano,8087,6,10,6,16,35,52,-17,36
Grasshoppers,8087,7,9,7,16,39,50,-11,34
FC Thun,8087,8,9,6,17,42,57,-15,33
FC Sion,8087,9,7,7,18,43,56,-13,28
Young Boys,8088,1,21,7,4,78,39,39,70
FC Basel,8088,2,18,8,6,58,28,30,62
Lucerne,8088,3,15,7,10,44,40,4,52
St Gallen,8088,4,13,4,15,41,56,-15,43
FC Zürich,8088,5,11,9,12,46,38,8,42
Grasshoppers,8088,6,10,6,16,42,53,-11,36
FC Lugano,8088,7,10,5,17,31,54,-23,35
FC Thun,8088,8,9,6,17,44,64,-20,33
FC Sion,8088,9,6,10,16,45,57,-12,28
Young Boys,8089,1,21,8,3,73,35,38,71
FC Basel,8089,2,15,10,7,48,25,23,55
Lucerne,8089,3,14,7,11,44,41,3,49
St Gallen,8089,4,13,4,15,42,59,-17,43
FC Zürich,8089,5,11,9,12,45,38,7,42
FC Lugano,8089,6,11,6,15,34,47,-13,39
Grasshoppers,8089,7,10,8,14,47,51,-4,38
FC Thun,8089,8,9,7,16,46,61,-15,34
FC Sion,8089,9,7,7,18,43,65,-22,28
Young Boys,8090,1,20,6,6,66,35,31,66
FC Basel,8090,2,17,8,7,53,28,25,59
St Gallen,8090,3,16,2,14,46,53,-7,50
Lucerne,8090,4,13,7,12,43,45,-2,46
FC Zürich,8090,5,11,10,11,42,36,6,43
FC Lugano,8090,6,11,6,15,31,46,-15,39
Grasshoppers,8090,7,10,6,16,42,51,-9,36
FC Thun,8090,8,10,6,16,44,58,-14,36
FC Sion,8090,9,7,7,18,39,54,-15,28
Young Boys,8091,1,20,9,3,73,39,34,69
FC Basel,8091,2,17,9,6,54,25,29,60
Lucerne,8091,3,15,8,9,46,42,4,53
St Gallen,8091,4,13,3,16,40,54,-14,42
FC Zürich,8091,5,10,9,13,44,42,2,39
FC Thun,8091,6,11,5,16,49,60,-11,38
FC Lugano,8091,7,10,5,17,32,50,-18,35
FC Sion,8091,8,8,8,16,47,60,-13,32
Grasshoppers,8091,9,8,8,16,42,55,-13,32
Young Boys,8092,1,22,6,4,70,35,35,72
FC Basel,8092,2,19,7,6,58,25,33,64
Lucerne,8092,3,13,8,11,44,43,1,47
St Gallen,8092,4,14,3,15,44,57,-13,45
FC Zürich,8092,5,11,9,12,39,36,3,42
Grasshoppers,8092,6,10,7,15,42,51,-9,37
FC Lugano,8092,7,10,5,17,31,48,-17,35
FC Thun,8092,8,9,6,17,42,59,-17,33
FC Sion,8092,9,7,7,18,39,55,-16,28
Young Boys,8093,1,20,6,6,68,39,29,66
FC Basel,8093,2,18,8,6,56,24,32,62
Lucerne,8093,3,13,7,12,45,47,-2,46
St Gallen,8093,4,14,4,14,41,53,-12,46
FC Zürich,8093,5,11,11,10,42,36,6,44
Grasshoppers,8093,6,11,6,15,45,48,-3,39
FC Lugano,8093,7,11,6,15,30,45,-15,39
FC Thun,8093,8,8,6,18,43,64,-21,30
FC Sion,8093,9,6,10,16,42,56,-14,28
Young Boys,8094,1,21,8,3,72,37,35,71
FC Basel,8094,2,18,8,6,56,28,28,62
Lucerne,8094,3,14,7,11,48,45,3,49
FC Zürich,8094,4,11,11,10,41,34,7,44
St Gallen,8094,5,14,2,16,42,56,-14,44
Grasshoppers,8094,6,10,6,16,42,50,-8,36
FC Thun,8094,7,10,5,17,43,57,-14,35
FC Lugano,8094,8,9,7,16,29,52,-23,34
FC Sion,8094,9,6,8,18,42,56,-14,26
Young Boys,8095,1,22,6,4,74,36,38,72
FC Basel,8095,2,17,9,6,53,27,26,60
Lucerne,8095,3,14,8,10,46,43,3,50
St Gallen,8095,4,15,2,15,42,55,-13,47
FC Zürich,8095,5,10,11,11,43,39,4,41
FC Thun,8095,6,10,6,16,44,59,-15,36
FC Lugano,8095,7,10,5,17,33,51,-18,35
Grasshoppers,8095,8,9,7,16,40,48,-8,34
FC Sion,8095,9,6,8,18,38,55,-17,26
Young Boys,8096,1,23,6,3,82,36,46,75
FC Basel,8096,2,17,8,7,51,28,23,59
FC Zürich,8096,3,12,10,10,44,35,9,46
St Gallen,8096,4,14,3,15,46,59,-13,45
Lucerne,8096,5,11,9,12,41,45,-4,42
FC Lugano,8096,6,10,6,16,30,49,-19,36
Grasshoppers,8096,7,9,8,15,42,49,-7,35
FC Thun,8096,8,9,7,16,42,58,-16,34
FC Sion,8096,9,6,9,17,41,60,-19,27
Young Boys,8097,1,20,8,4,69,37,32,68
FC Basel,8097,2,16,9,7,51,26,25,57
Lucerne,8097,3,14,9,9,46,42,4,51
FC Zürich,8097,4,12,9,11,43,34,9,45
St Gallen,8097,5,14,2,16,43,59,-16,44
FC Thun,8097,6,11,6,15,47,55,-8,39
FC Lugano,8097,7,10,6,16,31,48,-17,36
Grasshoppers,8097,8,8,7,17,38,51,-13,31
FC Sion,8097,9,7,8,17,42,58,-16,29
Young Boys,8098,1,20,8,4,69,37,32,68
FC Basel,8098,2,19,7,6,58,27,31,64
Lucerne,8098,3,13,8,11,42,44,-2,47
St Gallen,8098,4,14,3,15,44,54,-10,45
FC Zürich,8098,5,11,9,12,40,38,2,42
FC Lugano,8098,6,10,6,16,31,49,-18,36
FC Thun,8098,7,10,5,17,45,57,-12,35
Grasshoppers,8098,8,9,7,16,43,48,-5,34
FC Sion,8098,9,8,7,17,38,56,-18,31
Young Boys,8099,1,22,8,2,72,33,39,74
FC Basel,8099,2,17,8,7,53,28,25,59
St Gallen,8099,3,15,3,14,45,53,-8,48
Lucerne,8099,4,13,8,11,42,44,-2,47
FC Zürich,8099,5,11,10,11,39,34,5,43
Grasshoppers,8099,6,8,9,15,42,51,-9,33
FC Lugano,8099,7,9,6,17,29,48,-19,33
FC Thun,8099,8,8,8,16,47,63,-16,32
FC Sion,8099,9,6,10,16,42,57,-15,28
Young Boys,8100,1,22,7,3,72,33,39,73
FC Basel,8100,2,18,9,5,58,23,35,63
Lucerne,8100,3,12,9,11,41,46,-5,45
St Gallen,8100,4,14,3,15,42,58,-16,45
FC Zürich,8100,5,10,11,11,40,36,4,41
Grasshoppers,8100,6,9,8,15,40,50,-10,35
FC Thun,8100,7,10,5,17,44,59,-15,35
FC Lugano,8100,8,10,5,17,34,53,-19,35
FC Sion,8100,9,6,9,17,37,50,-13,27
Young Boys,8101,1,22,6,4,72,36,36,72
FC Basel,8101,2,18,7,7,54,30,24,61
St Gallen,8101,3,16,3,13,48,53,-5,51
Lucerne,8101,4,14,8,10,52,49,3,50
FC Zürich,8101,5,10,9,13,38,40,-2,39
Grasshoppers,8101,6,10,6,16,43,52,-9,36
FC Lugano,8101,7,10,5,17,35,50,-15,35
FC Thun,8101,8,9,5,18,44,58,-14,32
FC Sion,8101,9,7,7,18,38,56,-18,28
Young Boys,8102,1,22,7,3,73,34,39,73
FC Basel,8102,2,17,8,7,52,24,28,59
Lucerne,8102,3,13,7,12,44,47,-3,46
St Gallen,8102,4,14,2,16,42,60,-18,44
FC Zürich,8102,5,10,12,10,39,34,5,42
FC Lugano,8102,6,10,6,16,34,51,-17,36
FC Thun,8102,7,10,5,17,41,55,-14,35
Grasshoppers,8102,8,9,7,16,42,51,-9,34
FC Sion,8102,9,8,8,16,39,50,-11,32
Young Boys,8103,1,22,6,4,72,34,38,72
FC Basel,8103,2,18,9,5,55,24,31,63
Lucerne,8103,3,13,8,11,42,45,-3,47
St Gallen,8103,4,13,5,14,41,53,-12,44
FC Zürich,8103,5,11,10,11,45,38,7,43
Grasshoppers,8103,6,10,6,16,43,50,-7,36
FC Lugano,8103,7,10,6,16,30,48,-18,36
FC Thun,8103,8,9,6,17,45,62,-17,33
FC Sion,8103,9,6,8,18,39,58,-19,26
Young Boys,8104,1,23,6,3,74,35,39,75
FC Basel,8104,2,17,8,7,50,26,24,59
St Gallen,8104,3,15,4,13,43,52,-9,49
Lucerne,8104,4,13,7,12,42,44,-2,46
FC Zürich,8104,5,11,9,12,41,35,6,42
FC Thun,8104,6,10,6,16,42,56,-14,36
FC Lugano,8104,7,10,6,16,30,45,-15,36
Grasshoppers,8104,8,8,6,18,40,55,-15,30
FC Sion,8104,9,7,8,17,41,55,-14,29
Young Boys,8105,1,22,7,3,70,35,35,73
FC Basel,8105,2,17,7,8,53,28,25,58
St Gallen,8105,3,16,2,14,45,54,-9,50
Lucerne,8105,4,13,8,11,41,41,0,47
FC Zürich,8105,5,12,10,10,44,36,8,46
FC Thun,8105,6,10,6,16,44,58,-14,36
Grasshoppers,8105,7,8,8,16,39,50,-11,32
FC Lugano,8105,8,9,5,18,30,50,-20,32
FC Sion,8105,9,7,7,18,41,55,-14,28
Young Boys,8106,1,23,7,2,77,31,46,76
FC Basel,8106,2,17,9,6,51,27,24,60
Lucerne,8106,3,12,8,12,45,47,-2,44
St Gallen,8106,4,14,2,16,41,57,-16,44
FC Zürich,8106,5,10,12,10,44,38,6,42
FC Lugano,8106,6,10,7,15,32,48,-16,37
FC Thun,8106,7,10,6,16,47,58,-11,36
Grasshoppers,8106,8,9,6,17,39,51,-12,33
FC Sion,8106,9,7,7,18,43,62,-19,28
Young Boys,8107,1,23,6,3,74,35,39,75
FC Basel,8107,2,19,7,6,57,24,33,64
Lucerne,8107,3,13,8,11,44,46,-2,47
St Gallen,8107,4,14,3,15,42,56,-14,45
FC Zürich,8107,5,11,10,11,40,34,6,43
Grasshoppers,8107,6,9,7,16,42,50,-8,34
FC Lugano,8107,7,9,6,17,30,49,-19,33
FC Thun,8107,8,8,7,17,41,61,-20,31
FC Sion,8107,9,7,8,17,40,55,-15,29
Young Boys,8108,1,22,7,3,75,36,39,73
FC Basel,8108,2,17,8,7,56,29,27,59
Lucerne,8108,3,13,8,11,42,43,-1,47
St Gallen,8108,4,13,5,14,43,55,-12,44
FC Zürich,8108,5,11,10,11,39,35,4,43
Grasshoppers,8108,6,11,7,14,44,48,-4,40
FC Lugano,8108,7,9,6,17,30,49,-19,33
FC Thun,8108,8,8,7,17,40,62,-22,31
FC Sion,8108,9,7,8,17,45,57,-12,29
Young Boys,8109,1,21,6,5,75,39,36,69
FC Basel,8109,2,18,8,6,58,26,32,62
FC Zürich,8109,3,12,9,11,45,37,8,45
St Gallen,8109,4,14,2,16,42,58,-16,44
Lucerne,8109,5,12,7,13,40,48,-8,43
FC Thun,8109,6,11,6,15,47,58,-11,39
Grasshoppers,8109,7,10,7,15,44,51,-7,37
FC Lugano,8109,8,10,5,17,32,51,-19,35
FC Sion,8109,9,7,8,17,41,56,-15,29
Young Boys,8110,1,21,8,3,73,37,36,71
FC Basel,8110,2,20,7,5,59,23,36,67
St Gallen,8110,3,15,3,14,45,51,-6,48
Lucerne,8110,4,13,7,12,50,49,1,46
FC Zürich,8110,5,10,10,12,41,37,4,40
Grasshoppers,8110,6,9,8,15,39,51,-12,35
FC Thun,8110,7,8,8,16,42,60,-18,32
FC Lugano,8110,8,9,5,18,28,57,-29,32
FC Sion,8110,9,6,10,16,41,53,-12,28
Young Boys,8111,1,21,6,5,67,41,26,69
FC Basel,8111,2,16,9,7,54,29,25,57
Lucerne,8111,3,15,8,9,47,40,7,53
St Gallen,8111,4,15,2,15,47,55,-8,47
FC Zürich,8111,5,11,11,10,41,35,6,44
Grasshoppers,8111,6,9,7,16,41,48,-7,34
FC Thun,8111,7,8,9,15,44,59,-15,33
FC Lugano,8111,8,9,6,17,28,49,-21,33
FC Sion,8111,9,7,8,17,41,54,-13,29
Young Boys,8112,1,23,6,3,72,32,40,75
FC Basel,8112,2,18,8,6,60,28,32,62
Lucerne,8112,3,12,8,12,42,46,-4,44
St Gallen,8112,4,13,3,16,44,59,-15,42
FC Zürich,8112,5,10,11,11,41,36,5,41
FC Lugano,8112,6,11,6,15,31,47,-16,39
FC Thun,8112,7,10,6,16,44,60,-16,36
Grasshoppers,8112,8,9,7,16,42,52,-10,34
FC Sion,8112,9,7,7,18,42,58,-16,28
Young Boys,8113,1,21,7,4,72,37,35,70
FC Basel,8113,2,16,10,6,52,27,25,58
Lucerne,8113,3,15,7,10,47,45,2,52
St Gallen,8113,4,15,4,13,45,50,-5,49
FC Zürich,8113,5,10,12,10,38,32,6,42
FC Thun,8113,6,9,8,15,46,57,-11,35
Grasshoppers,8113,7,8,8,16,41,53,-12,32
FC Lugano,8113,8,9,5,18,28,50,-22,32
FC Sion,8113,9,6,9,17,37,55,-18,27
Young Boys,8114,1,22,6,4,74,36,38,72
FC Basel,8114,2,19,7,6,53,24,29,64
Lucerne,8114,3,14,7,11,46,44,2,49
St Gallen,8114,4,15,3,14,46,52,-6,48
FC Zürich,8114,5,11,9,12,46,38,8,42
Grasshoppers,8114,6,10,6,16,40,50,-10,36
FC Lugano,8114,7,10,6,16,30,52,-22,36
FC Thun,8114,8,9,5,18,41,59,-18,32
FC Sion,8114,9,6,7,19,39,60,-21,25
Young Boys,8115,1,23,6,3,71,33,38,75
FC Basel,8115,2,16,9,7,55,29,26,57
Lucerne,8115,3,12,9,11,45,44,1,45
St Gallen,8115,4,13,4,15,42,56,-14,43
FC Zürich,8115,5,11,9,12,41,38,3,42
FC Lugano,8115,6,12,5,15,34,47,-13,41
Grasshoppers,8115,7,10,6,16,41,51,-10,36
FC Thun,8115,8,10,6,16,43,58,-15,36
FC Sion,8115,9,6,8,18,38,54,-16,26
Young Boys,8116,1,22,6,4,74,36,38,72
FC Basel,8116,2,19,7,6,60,24,36,64
Lucerne,8116,3,14,7,11,42,44,-2,49
FC Zürich,8116,4,12,10,10,46,39,7,46
St Gallen,8116,5,13,3,16,39,56,-17,42
Grasshoppers,8116,6,9,8,15,44,52,-8,35
FC Lugano,8116,7,10,5,17,30,48,-18,35
FC Thun,8116,8,8,8,16,45,65,-20,32
FC Sion,8116,9,5,10,17,43,59,-16,25
Young Boys,8117,1,20,9,3,71,36,35,69
FC Basel,8117,2,16,10,6,56,30,26,58
St Gallen,8117,3,14,5,13,43,53,-10,47
FC Zürich,8117,4,12,9,11,43,34,9,45
Lucerne,8117,5,12,9,11,39,42,-3,45
Grasshoppers,8117,6,10,7,15,43,47,-4,37
FC Lugano,8117,7,10,7,15,32,47,-15,37
FC Thun,8117,8,9,7,16,43,59,-16,34
FC Sion,8117,9,5,9,18,37,59,-22,24
Young Boys,8118,1,21,7,4,72,33,39,70
FC Basel,8118,2,17,8,7,56,26,30,59
Lucerne,8118,3,14,7,11,43,42,1,49
FC Zürich,8118,4,11,10,11,40,36,4,43
St Gallen,8118,5,13,2,17,40,62,-22,41
Grasshoppers,8118,6,11,6,15,41,47,-6,39
FC Lugano,8118,7,11,5,16,34,49,-15,38
FC Sion,8118,8,9,7,16,41,51,-10,34
FC Thun,8118,9,8,6,18,40,61,-21,30
Young Boys,8119,1,22,7,3,76,35,41,73
FC Basel,8119,2,18,9,5,56,26,30,63
St Gallen,8119,3,15,2,15,42,53,-11,47
Lucerne,8119,4,12,8,12,39,42,-3,44
FC Zürich,8119,5,10,11,11,41,36,5,41
Grasshoppers,8119,6,11,6,15,44,49,-5,39
FC Lugano,8119,7,10,5,17,29,50,-21,35
FC Thun,8119,8,9,6,17,43,60,-17,33
FC Sion,8119,9,6,8,18,38,57,-19,26
Young Boys,8120,1,23,7,2,74,34,40,76
FC Basel,8120,2,17,9,6,54,25,29,60
St Gallen,8120,3,15,2,15,42,54,-12,47
FC Zürich,8120,4,12,10,10,45,33,12,46
Lucerne,8120,5,12,7,13,40,48,-8,43
Grasshoppers,8120,6,9,8,15,42,50,-8,35
FC Lugano,8120,7,10,5,17,31,49,-18,35
FC Thun,8120,8,9,7,16,41,57,-16,34
FC Sion,8120,9,6,7,19,38,57,-19,25
Young Boys,8121,1,22,6,4,73,34,39,72
FC Basel,8121,2,18,7,7,56,28,28,61
St Gallen,8121,3,15,3,14,43,53,-10,48
Lucerne,8121,4,13,8,11,41,44,-3,47
FC Lugano,8121,5,11,5,16,31,48,-17,38
FC Zürich,8121,6,9,9,14,40,40,0,36
Grasshoppers,8121,7,9,7,16,38,48,-10,34
FC Thun,8121,8,9,7,16,42,59,-17,34
FC Sion,8121,9,8,8,16,42,52,-10,32
Young Boys,8122,1,21,6,5,68,39,29,69
FC Basel,8122,2,17,8,7,53,27,26,59
Lucerne,8122,3,13,8,11,43,46,-3,47
FC Zürich,8122,4,12,9,11,44,37,7,45
St Gallen,8122,5,14,3,15,43,56,-13,45
Grasshoppers,8122,6,10,8,14,46,51,-5,38
FC Thun,8122,7,10,5,17,47,60,-13,35
FC Lugano,8122,8,10,5,17,32,48,-16,35
FC Sion,8122,9,7,8,17,42,54,-12,29
Young Boys,8123,1,22,6,4,70,34,36,72
FC Basel,8123,2,18,9,5,61,25,36,63
Lucerne,8123,3,14,8,10,42,40,2,50
FC Zürich,8123,4,11,10,11,42,36,6,43
St Gallen,8123,5,13,2,17,44,64,-20,41
FC Lugano,8123,6,11,5,16,32,50,-18,38
FC Thun,8123,7,9,6,17,45,66,-21,33
FC Sion,8123,8,8,7,17,45,54,-9,31
Grasshoppers,8123,9,8,7,17,38,50,-12,31
Young Boys,8124,1,21,7,4,72,37,35,70
FC Basel,8124,2,18,7,7,55,27,28,61
St Gallen,8124,3,16,2,14,43,52,-9,50
Lucerne,8124,4,14,7,11,42,41,1,49
FC Zürich,8124,5,10,10,12,41,40,1,40
FC Thun,8124,6,10,6,16,44,58,-14,36
FC Lugano,8124,7,9,6,17,28,48,-20,33
FC Sion,8124,8,8,8,16,44,54,-10,32
Grasshoppers,8124,9,8,7,17,38,50,-12,31
Young Boys,8125,1,23,7,2,80,37,43,76
FC Basel,8125,2,18,8,6,54,26,28,62
Lucerne,8125,3,13,7,12,43,44,-1,46
FC Lugano,8125,4,12,5,15,35,46,-11,41
St Gallen,8125,5,13,2,17,40,58,-18,41
FC Zürich,8125,6,9,11,12,40,39,1,38
FC Thun,8125,7,10,6,16,47,58,-11,36
FC Sion,8125,8,8,7,17,43,58,-15,31
Grasshoppers,8125,9,8,7,17,40,56,-16,31
Young Boys,8126,1,21,9,2,74,35,39,72
FC Basel,8126,2,18,8,6,54,26,28,62
St Gallen,8126,3,15,3,14,49,57,-8,48
FC Zürich,8126,4,12,9,11,41,39,2,45
Lucerne,8126,5,12,9,11,41,42,-1,45
FC Lugano,8126,6,10,7,15,35,46,-11,37
Grasshoppers,8126,7,9,6,17,38,53,-15,33
FC Thun,8126,8,9,6,17,43,60,-17,33
FC Sion,8126,9,5,9,18,41,58,-17,24
Young Boys,8127,1,21,9,2,71,34,37,72
FC Basel,8127,2,17,8,7,53,27,26,59
St Gallen,8127,3,15,2,15,41,54,-13,47
Lucerne,8127,4,13,7,12,42,45,-3,46
FC Zürich,8127,5,10,10,12,39,37,2,40
FC Lugano,8127,6,10,7,15,33,47,-14,37
FC Thun,8127,7,10,6,16,46,59,-13,36
Grasshoppers,8127,8,9,8,15,43,52,-9,35
FC Sion,8127,9,6,9,17,39,52,-13,27
Young Boys,8128,1,21,6,5,69,40,29,69
FC Basel,8128,2,19,7,6,57,24,33,64
St Gallen,8128,3,14,4,14,44,56,-12,46
Lucerne,8128,4,12,8,12,40,44,-4,44
FC Zürich,8128,5,11,9,12,42,37,5,42
FC Lugano,8128,6,11,7,14,35,48,-13,40
Grasshoppers,8128,7,11,6,15,44,48,-4,39
FC Thun,8128,8,8,6,18,39,57,-18,30
FC Sion,8128,9,6,9,17,37,53,-16,27
Young Boys,8129,1,22,7,3,72,35,37,73
FC Basel,8129,2,18,9,5,54,24,30,63
Lucerne,8129,3,13,9,10,40,40,0,48
St Gallen,8129,4,15,3,14,43,52,-9,48
FC Zürich,8129,5,11,10,11,41,34,7,43
FC Thun,8129,6,9,6,17,40,57,-17,33
FC Lugano,8129,7,9,6,17,29,49,-20,33
Grasshoppers,8129,8,8,8,16,40,52,-12,32
FC Sion,8129,9,6,8,18,37,53,-16,26
Young Boys,8130,1,21,7,4,68,34,34,70
FC Basel,8130,2,20,7,5,56,23,33,67
Lucerne,8130,3,13,8,11,44,46,-2,47
St Gallen,8130,4,14,2,16,46,61,-15,44
FC Zürich,8130,5,11,10,11,42,37,5,43
FC Lugano,8130,6,10,6,16,31,47,-16,36
Grasshoppers,8130,7,9,6,17,40,52,-12,33
FC Thun,8130,8,9,6,17,41,57,-16,33
FC Sion,8130,9,7,8,17,46,57,-11,29
Young Boys,8131,1,21,6,5,70,36,34,69
FC Basel,8131,2,19,8,5,57,27,30,65
Lucerne,8131,3,12,8,12,42,46,-4,44
St Gallen,8131,4,14,2,16,44,58,-14,44
FC Zürich,8131,5,11,10,11,46,38,8,43
FC Lugano,8131,6,10,6,16,31,49,-18,36
Grasshoppers,8131,7,9,8,15,43,51,-8,35
FC Thun,8131,8,9,7,16,44,60,-16,34
FC Sion,8131,9,7,9,16,42,54,-12,30
Young Boys,8132,1,22,6,4,70,34,36,72
FC Basel,8132,2,17,9,6,56,27,29,60
Lucerne,8132,3,13,9,10,45,41,4,48
St Gallen,8132,4,13,6,13,42,53,-11,45
FC Zürich,8132,5,10,10,12,41,39,2,40
Grasshoppers,8132,6,10,6,16,41,50,-9,36
FC Thun,8132,7,10,6,16,46,63,-17,36
FC Lugano,8132,8,9,7,16,29,48,-19,34
FC Sion,8132,9,6,9,17,39,54,-15,27
Young Boys,8133,1,23,7,2,72,33,39,76
FC Basel,8133,2,17,7,8,54,29,25,58
St Gallen,8133,3,15,2,15,47,57,-10,47
Lucerne,8133,4,13,7,12,47,48,-1,46
FC Zürich,8133,5,10,10,12,42,38,4,40
FC Thun,8133,6,11,6,15,46,57,-11,39
Grasshoppers,8133,7,10,6,16,43,53,-10,36
FC Lugano,8133,8,10,6,16,31,48,-17,36
FC Sion,8133,9,5,9,18,38,57,-19,24
Young Boys,8134,1,21,6,5,73,36,37,69
FC Basel,8134,2,20,7,5,60,23,37,67
St Gallen,8134,3,14,2,16,40,56,-16,44
Lucerne,8134,4,11,7,14,41,52,-11,40
FC Zürich,8134,5,9,12,11,38,36,2,39
FC Lugano,8134,6,11,6,15,31,46,-15,39
Grasshoppers,8134,7,10,6,16,41,50,-9,36
FC Thun,8134,8,10,6,16,45,60,-15,36
FC Sion,8134,9,8,8,16,44,54,-10,32
Young Boys,8135,1,20,9,3,69,32,37,69
FC Basel,8135,2,17,10,5,51,22,29,61
Lucerne,8135,3,13,9,10,46,43,3,48
St Gallen,8135,4,15,2,15,42,54,-12,47
FC Zürich,8135,5,10,10,12,37,35,2,40
FC Thun,8135,6,10,6,16,47,60,-13,36
Grasshoppers,8135,7,9,8,15,41,51,-10,35
FC Lugano,8135,8,10,5,17,29,51,-22,35
FC Sion,8135,9,6,9,17,41,55,-14,27
Young Boys,8136,1,22,8,2,73,35,38,74
FC Basel,8136,2,17,9,6,52,25,27,60
Lucerne,8136,3,13,8,11,45,44,1,47
FC Zürich,8136,4,12,10,10,41,34,7,46
St Gallen,8136,5,14,3,15,43,57,-14,45
FC Thun,8136,6,10,5,17,41,56,-15,35
FC Lugano,8136,7,9,5,18,30,52,-22,32
Grasshoppers,8136,8,8,7,17,40,51,-11,31
FC Sion,8136,9,7,9,16,41,52,-11,30
Young Boys,8137,1,22,6,4,76,38,38,72
FC Basel,8137,2,18,9,5,55,24,31,63
St Gallen,8137,3,14,4,14,42,57,-15,46
Lucerne,8137,4,12,8,12,41,47,-6,44
FC Zürich,8137,5,9,11,12,40,39,1,38
FC Thun,8137,6,11,5,16,48,61,-13,38
FC Lugano,8137,7,11,5,16,35,51,-16,38
Grasshoppers,8137,8,8,7,17,40,52,-12,31
FC Sion,8137,9,7,9,16,46,54,-8,30
Young Boys,8138,1,22,6,4,69,34,35,72
FC Basel,8138,2,19,8,5,54,22,32,65
St Gallen,8138,3,15,3,14,44,55,-11,48
FC Zürich,8138,4,10,11,11,40,36,4,41
Lucerne,8138,5,11,8,13,39,45,-6,41
FC Lugano,8138,6,11,5,16,32,46,-14,38
Grasshoppers,8138,7,9,7,16,39,49,-10,34
FC Sion,8138,8,8,7,17,41,53,-12,31
FC Thun,8138,9,8,7,17,41,59,-18,31
Young Boys,8139,1,21,7,4,71,37,34,70
FC Basel,8139,2,20,7,5,62,23,39,67
St Gallen,8139,3,14,2,16,42,57,-15,44
FC Lugano,8139,4,12,6,14,35,47,-12,42
Lucerne,8139,5,11,7,14,38,51,-13,40
FC Zürich,8139,6,9,11,12,41,41,0,38
FC Thun,8139,7,10,6,16,45,57,-12,36
Grasshoppers,8139,8,9,6,17,38,49,-11,33
FC Sion,8139,9,8,8,16,42,52,-10,32
Young Boys,8140,1,24,6,2,79,31,48,78
FC Basel,8140,2,17,9,6,55,26,29,60
St Gallen,8140,3,14,4,14,45,56,-11,46
FC Zürich,8140,4,11,10,11,39,35,4,43
Lucerne,8140,5,12,7,13,42,50,-8,43
FC Lugano,8140,6,11,5,16,32,50,-18,38
Grasshoppers,8140,7,9,8,15,39,49,-10,35
FC Thun,8140,8,8,6,18,41,62,-21,30
FC Sion,8140,9,6,9,17,39,52,-13,27
Young Boys,8141,1,21,6,5,70,34,36,69
FC Basel,8141,2,18,7,7,52,26,26,61
St Gallen,8141,3,15,2,15,43,53,-10,47
FC Zürich,8141,4,12,9,11,45,36,9,45
Lucerne,8141,5,12,8,12,38,43,-5,44
Grasshoppers,8141,6,10,8,14,42,47,-5,38
FC Lugano,8141,7,11,5,16,31,48,-17,38
FC Thun,8141,8,9,7,16,45,60,-15,34
FC Sion,8141,9,6,8,18,37,56,-19,26
FC Basel,8142,1,20,7,5,61,24,37,67
Young Boys,8142,2,20,7,5,68,40,28,67
Lucerne,8142,3,13,8,11,41,41,0,47
St Gallen,8142,4,14,4,14,42,54,-12,46
FC Lugano,8142,5,11,7,14,34,45,-11,40
FC Zürich,8142,6,9,11,12,37,36,1,38
FC Thun,8142,7,10,6,16,45,61,-16,36
Grasshoppers,8142,8,8,6,18,40,53,-13,30
FC Sion,8142,9,7,8,17,42,56,-14,29
Young Boys,8143,1,20,6,6,71,46,25,66
FC Basel,8143,2,18,7,7,56,25,31,61
Lucerne,8143,3,14,8,10,45,43,2,50
FC Zürich,8143,4,11,10,11,42,35,7,43
St Gallen,8143,5,13,4,15,43,57,-14,43
Grasshoppers,8143,6,10,7,15,46,50,-4,37
FC Thun,8143,7,10,7,15,43,56,-13,37
FC Lugano,8143,8,10,6,16,30,49,-19,36
FC Sion,8143,9,6,9,17,39,54,-15,27
Young Boys,8144,1,21,7,4,71,38,33,70
FC Basel,8144,2,19,8,5,59,26,33,65
Lucerne,8144,3,14,7,11,44,44,0,49
St Gallen,8144,4,15,2,15,44,56,-12,47
FC Zürich,8144,5,10,11,11,41,36,5,41
FC Lugano,8144,6,11,5,16,31,46,-15,38
Grasshoppers,8144,7,9,7,16,45,53,-8,34
FC Thun,8144,8,8,8,16,45,63,-18,32
FC Sion,8144,9,5,9,18,41,59,-18,24
Young Boys,8145,1,21,8,3,71,35,36,71
FC Basel,8145,2,18,8,6,55,26,29,62
St Gallen,8145,3,14,4,14,43,54,-11,46
Lucerne,8145,4,12,8,12,43,43,0,44
FC Zürich,8145,5,11,10,11,40,36,4,43
FC Thun,8145,6,11,5,16,44,55,-11,38
FC Lugano,8145,7,9,8,15,30,48,-18,35
Grasshoppers,8145,8,9,7,16,40,52,-12,34
FC Sion,8145,9,6,8,18,37,54,-17,26
Young Boys,8146,1,20,6,6,67,42,25,66
FC Basel,8146,2,19,8,5,61,21,40,65
Lucerne,8146,3,13,9,10,42,42,0,48
FC Zürich,8146,4,11,10,11,42,38,4,43
St Gallen,8146,5,13,3,16,42,59,-17,42
Grasshoppers,8146,6,10,8,14,42,46,-4,38
FC Lugano,8146,7,10,5,17,31,49,-18,35
FC Sion,8146,8,8,9,15,46,54,-8,33
FC Thun,8146,9,8,6,18,42,64,-22,30
Young Boys,8147,1,23,7,2,73,34,39,76
FC Basel,8147,2,17,10,5,57,26,31,61
St Gallen,8147,3,15,3,14,42,52,-10,48
FC Zürich,8147,4,11,10,11,41,35,6,43
Lucerne,8147,5,11,8,13,39,47,-8,41
FC Lugano,8147,6,11,5,16,35,48,-13,38
Grasshoppers,8147,7,9,7,16,39,47,-8,34
FC Thun,8147,8,9,7,16,40,59,-19,34
FC Sion,8147,9,5,9,18,37,55,-18,24
Young Boys,8148,1,20,9,3,71,33,38,69
FC Basel,8148,2,18,9,5,56,25,31,63
St Gallen,8148,3,14,5,13,41,51,-10,47
Lucerne,8148,4,11,9,12,39,46,-7,42
FC Zürich,8148,5,10,11,11,41,37,4,41
FC Lugano,8148,6,9,9,14,30,45,-15,36
Grasshoppers,8148,7,9,7,16,39,49,-10,34
FC Thun,8148,8,9,7,16,44,59,-15,34
FC Sion,8148,9,7,8,17,41,57,-16,29
Young Boys,8149,1,22,8,2,74,34,40,74
FC Basel,8149,2,17,10,5,55,25,30,61
Lucerne,8149,3,13,8,11,40,44,-4,47
St Gallen,8149,4,13,5,14,42,54,-12,44
FC Zürich,8149,5,10,11,11,42,36,6,41
FC Thun,8149,6,10,5,17,47,63,-16,35
FC Lugano,8149,7,9,7,16,34,51,-17,34
FC Sion,8149,8,8,8,16,41,54,-13,32
Grasshoppers,8149,9,8,6,18,38,52,-14,30
Young Boys,8150,1,21,8,3,73,37,36,71
FC Basel,8150,2,17,8,7,54,27,27,59
Lucerne,8150,3,12,10,10,42,43,-1,46
St Gallen,8150,4,14,3,15,43,58,-15,45
FC Zürich,8150,5,11,11,10,43,34,9,44
FC Lugano,8150,6,11,6,15,31,45,-14,39
Grasshoppers,8150,7,10,6,16,43,51,-8,36
FC Thun,8150,8,9,6,17,44,63,-19,33
FC Sion,8150,9,5,10,17,41,56,-15,25
Young Boys,8151,1,21,8,3,68,35,33,71
FC Basel,8151,2,16,10,6,51,25,26,58
Lucerne,8151,3,13,9,10,43,42,1,48
St Gallen,8151,4,15,3,14,44,54,-10,48
FC Zürich,8151,5,10,10,12,38,36,2,40
Grasshoppers,8151,6,10,7,15,44,49,-5,37
FC Lugano,8151,7,10,5,17,28,47,-19,35
FC Thun,8151,8,9,6,17,44,61,-17,33
FC Sion,8151,9,7,8,17,41,52,-11,29
Young Boys,8152,1,22,6,4,73,34,39,72
FC Basel,8152,2,17,7,8,49,29,20,58
St Gallen,8152,3,16,3,13,45,52,-7,51
Lucerne,8152,4,13,8,11,41,40,1,47
FC Zürich,8152,5,11,9,12,43,38,5,42
FC Lugano,8152,6,11,5,16,33,49,-16,38
FC Sion,8152,7,8,8,16,43,53,-10,32
FC Thun,8152,8,9,5,18,40,60,-20,32
Grasshoppers,8152,9,8,7,17,40,52,-12,31
Young Boys,8153,1,22,7,3,70,32,38,73
FC Basel,8153,2,18,9,5,55,24,31,63
Lucerne,8153,3,12,8,12,44,46,-2,44
St Gallen,8153,4,13,4,15,44,58,-14,43
FC Zürich,8153,5,10,12,10,38,33,5,42
FC Lugano,8153,6,11,6,15,33,48,-15,39
Grasshoppers,8153,7,10,6,16,44,50,-6,36
FC Thun,8153,8,9,6,17,41,61,-20,33
FC Sion,8153,9,6,8,18,38,55,-17,26
Young Boys,8154,1,21,8,3,73,37,36,71
FC Basel,8154,2,19,8,5,59,26,33,65
Lucerne,8154,3,13,7,12,44,48,-4,46
St Gallen,8154,4,14,2,16,41,55,-14,44
FC Zürich,8154,5,11,10,11,41,34,7,43
Grasshoppers,8154,6,10,6,16,39,47,-8,36
FC Lugano,8154,7,10,6,16,32,51,-19,36
FC Thun,8154,8,9,5,18,40,57,-17,32
FC Sion,8154,9,7,8,17,38,52,-14,29
Young Boys,8155,1,21,7,4,71,35,36,70
FC Basel,8155,2,16,9,7,51,27,24,57
Lucerne,8155,3,13,9,10,46,46,0,48
St Gallen,8155,4,15,2,15,45,56,-11,47
FC Zürich,8155,5,9,12,11,39,37,2,39
FC Thun,8155,6,11,6,15,45,56,-11,39
Grasshoppers,8155,7,9,8,15,42,50,-8,35
FC Lugano,8155,8,9,7,16,33,52,-19,34
FC Sion,8155,9,6,10,16,39,52,-13,28
Young Boys,8156,1,22,7,3,71,32,39,73
FC Basel,8156,2,18,8,6,55,25,30,62
Lucerne,8156,3,13,9,10,47,45,2,48
St Gallen,8156,4,14,3,15,46,55,-9,45
FC Zürich,8156,5,10,10,12,42,43,-1,40
Grasshoppers,8156,6,10,7,15,43,50,-7,37
FC Thun,8156,7,10,5,17,44,59,-15,35
FC Lugano,8156,8,10,5,17,32,51,-19,35
FC Sion,8156,9,6,8,18,40,60,-20,26
Young Boys,8157,1,22,6,4,69,36,33,72
FC Basel,8157,2,20,7,5,61,24,37,67
Lucerne,8157,3,11,10,11,37,42,-5,43
St Gallen,8157,4,13,4,15,43,56,-13,43
FC Zürich,8157,5,9,10,13,39,44,-5,37
FC Lugano,8157,6,10,7,15,30,45,-15,37
FC Thun,8157,7,10,6,16,48,60,-12,36
Grasshoppers,8157,8,9,8,15,39,46,-7,35
FC Sion,8157,9,7,8,17,42,55,-13,29
Young Boys,8158,1,22,7,3,74,33,41,73
FC Basel,8158,2,16,11,5,55,27,28,59
St Gallen,8158,3,15,3,14,45,57,-12,48
FC Zürich,8158,4,11,11,10,42,35,7,44
Lucerne,8158,5,12,8,12,40,44,-4,44
FC Lugano,8158,6,11,6,15,34,51,-17,39
Grasshoppers,8158,7,10,7,15,44,49,-5,37
FC Thun,8158,8,8,7,17,45,64,-19,31
FC Sion,8158,9,5,8,19,39,58,-19,23
Young Boys,8159,1,22,7,3,73,33,40,73
FC Basel,8159,2,18,8,6,58,31,27,62
FC Zürich,8159,3,13,9,10,48,34,14,48
Lucerne,8159,4,13,7,12,42,46,-4,46
St Gallen,8159,5,14,3,15,43,57,-14,45
Grasshoppers,8159,6,10,6,16,42,50,-8,36
FC Lugano,8159,7,10,5,17,30,51,-21,35
FC Sion,8159,8,7,8,17,40,54,-14,29
FC Thun,8159,9,8,5,19,41,61,-20,29
Young Boys,8160,1,23,7,2,70,30,40,76
FC Basel,8160,2,16,9,7,48,24,24,57
St Gallen,8160,3,16,3,13,46,52,-6,51
Lucerne,8160,4,13,8,11,41,41,0,47
FC Zürich,8160,5,11,10,11,41,37,4,43
FC Thun,8160,6,10,7,15,47,56,-9,37
FC Lugano,8160,7,9,6,17,30,52,-22,33
Grasshoppers,8160,8,8,6,18,36,51,-15,30
FC Sion,8160,9,6,8,18,39,55,-16,26
Young Boys,8161,1,21,6,5,66,34,32,69
FC Basel,8161,2,17,8,7,52,26,26,59
St Gallen,8161,3,15,3,14,45,56,-11,48
Lucerne,8161,4,12,8,12,40,42,-2,44
FC Lugano,8161,5,12,6,14,34,46,-12,42
FC Zürich,8161,6,10,9,13,40,41,-1,39
Grasshoppers,8161,7,9,8,15,39,47,-8,35
FC Sion,8161,8,8,9,15,44,51,-7,33
FC Thun,8161,9,8,7,17,42,59,-17,31
Young Boys,8162,1,22,7,3,69,32,37,73
FC Basel,8162,2,18,8,6,53,24,29,62
St Gallen,8162,3,16,2,14,46,54,-8,50
FC Zürich,8162,4,11,9,12,40,37,3,42
FC Lugano,8162,5,12,6,14,32,44,-12,42
Lucerne,8162,6,11,8,13,40,45,-5,41
Grasshoppers,8162,7,10,6,16,44,48,-4,36
FC Thun,8162,8,9,5,18,44,62,-18,32
FC Sion,8162,9,6,7,19,38,60,-22,25
Young Boys,8163,1,23,7,2,71,31,40,76
FC Basel,8163,2,16,10,6,52,27,25,58
Lucerne,8163,3,13,8,11,43,43,0,47
St Gallen,8163,4,14,3,15,42,54,-12,45
FC Zürich,8163,5,10,10,12,44,40,4,40
FC Lugano,8163,6,11,5,16,30,47,-17,38
Grasshoppers,8163,7,10,7,15,41,47,-6,37
FC Thun,8163,8,9,6,17,47,62,-15,33
FC Sion,8163,9,6,8,18,39,58,-19,26
Young Boys,8164,1,21,6,5,70,37,33,69
FC Basel,8164,2,17,10,5,52,23,29,61
Lucerne,8164,3,14,8,10,46,42,4,50
St Gallen,8164,4,15,3,14,46,57,-11,48
Grasshoppers,8164,5,12,6,14,45,48,-3,42
FC Zürich,8164,6,9,12,11,41,38,3,39
FC Thun,8164,7,9,6,17,45,62,-17,33
FC Lugano,8164,8,9,6,17,32,53,-21,33
FC Sion,8164,9,6,7,19,39,56,-17,25
Young Boys,8165,1,21,6,5,70,34,36,69
FC Basel,8165,2,17,9,6,53,27,26,60
Lucerne,8165,3,14,9,9,43,41,2,51
St Gallen,8165,4,14,3,15,44,55,-11,45
FC Zürich,8165,5,10,10,12,39,37,2,40
FC Thun,8165,6,11,5,16,48,56,-8,38
FC Lugano,8165,7,10,6,16,31,50,-19,36
Grasshoppers,8165,8,8,8,16,39,52,-13,32
FC Sion,8165,9,7,8,17,39,54,-15,29
Young Boys,8166,1,22,7,3,72,35,37,73
FC Basel,8166,2,18,8,6,57,26,31,62
Lucerne,8166,3,13,8,11,43,46,-3,47
St Gallen,8166,4,14,2,16,42,58,-16,44
FC Zürich,8166,5,10,11,11,42,38,4,41
Grasshoppers,8166,6,9,8,15,45,54,-9,35
FC Thun,8166,7,8,9,15,43,58,-15,33
FC Lugano,8166,8,9,6,17,29,48,-19,33
FC Sion,8166,9,7,9,16,46,56,-10,30
Young Boys,8167,1,21,7,4,71,38,33,70
FC Basel,8167,2,18,7,7,53,26,27,61
FC Zürich,8167,3,12,10,10,42,35,7,46
Lucerne,8167,4,12,8,12,37,40,-3,44
St Gallen,8167,5,14,2,16,40,53,-13,44
Grasshoppers,8167,6,12,6,14,43,47,-4,42
FC Lugano,8167,7,10,7,15,30,45,-15,37
FC Thun,8167,8,9,5,18,46,63,-17,32
FC Sion,8167,9,6,8,18,40,55,-15,26
Young Boys,8168,1,23,6,3,71,31,40,75
FC Basel,8168,2,15,10,7,51,30,21,55
Lucerne,8168,3,16,7,9,50,40,10,55
St Gallen,8168,4,14,3,15,41,54,-13,45
FC Zürich,8168,5,10,11,11,39,35,4,41
FC Lugano,8168,6,10,5,17,29,48,-19,35
Grasshoppers,8168,7,9,7,16,39,50,-11,34
FC Thun,8168,8,9,7,16,44,59,-15,34
FC Sion,8168,9,6,8,18,37,54,-17,26
Young Boys,8169,1,22,7,3,71,33,38,73
FC Basel,8169,2,18,8,6,53,27,26,62
FC Zürich,8169,3,13,9,10,47,32,15,48
St Gallen,8169,4,15,3,14,43,52,-9,48
Lucerne,8169,5,12,8,12,39,43,-4,44
FC Thun,8169,6,9,6,17,41,58,-17,33
Grasshoppers,8169,7,8,8,16,38,49,-11,32
FC Lugano,8169,8,9,5,18,29,50,-21,32
FC Sion,8169,9,7,8,17,37,54,-17,29
Young Boys,8170,1,21,7,4,71,38,33,70
FC Basel,8170,2,16,9,7,49,26,23,57
Lucerne,8170,3,13,9,10,41,42,-1,48
St Gallen,8170,4,15,3,14,45,56,-11,48
FC Zürich,8170,5,10,9,13,39,40,-1,39
FC Lugano,8170,6,11,5,16,32,46,-14,38
FC Sion,8170,7,9,7,16,49,53,-4,34
Grasshoppers,8170,8,9,7,16,42,55,-13,34
FC Thun,8170,9,9,6,17,45,57,-12,33
Young Boys,8171,1,21,6,5,71,35,36,69
FC Basel,8171,2,17,7,8,51,28,23,58
St Gallen,8171,3,16,2,14,47,55,-8,50
Lucerne,8171,4,13,7,12,41,45,-4,46
FC Zürich,8171,5,10,11,11,41,37,4,41
Grasshoppers,8171,6,10,7,15,41,51,-10,37
FC Thun,8171,7,10,6,16,47,58,-11,36
FC Lugano,8171,8,10,6,16,30,48,-18,36
FC Sion,8171,9,7,8,17,43,55,-12,29
Young Boys,8172,1,23,6,3,71,32,39,75
FC Basel,8172,2,18,8,6,50,24,26,62
Lucerne,8172,3,12,9,11,42,44,-2,45
St Gallen,8172,4,13,5,14,40,52,-12,44
FC Zürich,8172,5,9,11,12,39,37,2,38
FC Lugano,8172,6,10,7,15,31,47,-16,37
Grasshoppers,8172,7,9,8,15,42,50,-8,35
FC Thun,8172,8,10,5,17,43,58,-15,35
FC Sion,8172,9,6,9,17,40,54,-14,27
Young Boys,8173,1,22,7,3,76,35,41,73
FC Basel,8173,2,18,8,6,54,24,30,62
FC Zürich,8173,3,12,9,11,43,37,6,45
St Gallen,8173,4,14,2,16,41,54,-13,44
Lucerne,8173,5,12,7,13,38,46,-8,43
FC Lugano,8173,6,11,5,16,34,51,-17,38
Grasshoppers,8173,7,10,6,16,39,49,-10,36
FC Thun,8173,8,9,6,17,43,60,-17,33
FC Sion,8173,9,7,8,17,41,53,-12,29
Young Boys,8174,1,20,9,3,67,33,34,69
FC Basel,8174,2,18,8,6,58,27,31,62
St Gallen,8174,3,14,3,15,44,58,-14,45
Lucerne,8174,4,11,10,11,39,44,-5,43
FC Zürich,8174,5,10,11,11,41,37,4,41
Grasshoppers,8174,6,10,8,14,42,47,-5,38
FC Lugano,8174,7,10,7,15,33,48,-15,37
FC Thun,8174,8,10,6,16,43,56,-13,36
FC Sion,8174,9,6,8,18,37,54,-17,26
Young Boys,8175,1,22,6,4,71,36,35,72
FC Basel,8175,2,18,9,5,55,22,33,63
Lucerne,8175,3,13,9,10,43,42,1,48
St Gallen,8175,4,13,5,14,42,55,-13,44
FC Zürich,8175,5,10,9,13,38,37,1,39
FC Thun,8175,6,10,6,16,44,59,-15,36
FC Lugano,8175,7,10,6,16,31,50,-19,36
FC Sion,8175,8,8,8,16,41,49,-8,32
Grasshoppers,8175,9,8,6,18,39,54,-15,30
Young Boys,8176,1,21,7,4,66,35,31,70
FC Basel,8176,2,18,8,6,54,24,30,62
St Gallen,8176,3,16,3,13,45,53,-8,51
Lucerne,8176,4,14,7,11,43,41,2,49
FC Zürich,8176,5,11,9,12,46,39,7,42
Grasshoppers,8176,6,9,6,17,41,53,-12,33
FC Lugano,8176,7,9,6,17,29,48,-19,33
FC Thun,8176,8,9,5,18,47,66,-19,32
FC Sion,8176,9,8,7,17,44,56,-12,31
Young Boys,8177,1,21,7,4,74,38,36,70
FC Basel,8177,2,17,8,7,54,29,25,59
St Gallen,8177,3,16,2,14,46,54,-8,50
Lucerne,8177,4,14,7,11,45,43,2,49
FC Zürich,8177,5,11,10,11,41,36,5,43
FC Lugano,8177,6,11,6,15,33,49,-16,39
Grasshoppers,8177,7,10,6,16,44,54,-10,36
FC Thun,8177,8,8,6,18,41,60,-19,30
FC Sion,8177,9,6,8,18,39,54,-15,26
Young Boys,8178,1,20,8,4,71,39,32,68
FC Basel,8178,2,19,7,6,58,27,31,64
Lucerne,8178,3,13,8,11,42,45,-3,47
FC Zürich,8178,4,12,10,10,48,37,11,46
St Gallen,8178,5,14,4,14,44,55,-11,46
FC Thun,8178,6,10,5,17,47,61,-14,35
FC Lugano,8178,7,9,8,15,32,49,-17,35
Grasshoppers,8178,8,8,7,17,39,53,-14,31
FC Sion,8178,9,6,9,17,41,56,-15,27
Young Boys,8179,1,21,8,3,70,35,35,71
FC Basel,8179,2,18,8,6,55,23,32,62
Lucerne,8179,3,13,9,10,44,44,0,48
St Gallen,8179,4,14,3,15,42,54,-12,45
FC Zürich,8179,5,11,9,12,41,37,4,42
FC Lugano,8179,6,12,5,15,36,49,-13,41
Grasshoppers,8179,7,10,7,15,40,46,-6,37
FC Thun,8179,8,8,6,18,39,61,-22,30
FC Sion,8179,9,5,9,18,37,55,-18,24
Young Boys,8180,1,22,7,3,74,34,40,73
FC Basel,8180,2,17,9,6,57,28,29,60
St Gallen,8180,3,14,4,14,42,54,-12,46
Lucerne,8180,4,12,8,12,40,45,-5,44
FC Zürich,8180,5,10,12,10,38,33,5,42
FC Lugano,8180,6,11,5,16,32,49,-17,38
Grasshoppers,8180,7,10,7,15,40,48,-8,37
FC Thun,8180,8,8,7,17,41,59,-18,31
FC Sion,8180,9,6,9,17,36,50,-14,27
Young Boys,8181,1,22,6,4,73,34,39,72
FC Basel,8181,2,18,9,5,56,26,30,63
Lucerne,8181,3,13,7,12,41,45,-4,46
St Gallen,8181,4,14,3,15,40,52,-12,45
FC Zürich,8181,5,10,11,11,40,36,4,41
FC Lugano,8181,6,10,6,16,32,49,-17,36
Grasshoppers,8181,7,9,7,16,39,49,-10,34
FC Thun,8181,8,8,8,16,44,60,-16,32
FC Sion,8181,9,7,9,16,41,55,-14,30
Young Boys,8182,1,20,7,5,69,39,30,67
FC Basel,8182,2,19,8,5,58,28,30,65
Lucerne,8182,3,13,9,10,46,44,2,48
St Gallen,8182,4,13,3,16,44,62,-18,42
FC Zürich,8182,5,10,10,12,39,36,3,40
FC Lugano,8182,6,11,6,15,35,47,-12,39
FC Thun,8182,7,10,6,16,43,58,-15,36
Grasshoppers,8182,8,9,7,16,41,50,-9,34
FC Sion,8182,9,7,8,17,43,54,-11,29
Young Boys,8183,1,21,8,3,75,39,36,71
FC Basel,8183,2,18,9,5,57,25,32,63
St Gallen,8183,3,14,4,14,45,57,-12,46
FC Lugano,8183,4,13,5,14,41,50,-9,44
Lucerne,8183,5,11,9,12,41,46,-5,42
FC Zürich,8183,6,10,9,13,39,40,-1,39
Grasshoppers,8183,7,10,8,14,42,45,-3,38
FC Thun,8183,8,9,6,17,45,63,-18,33
FC Sion,8183,9,5,8,19,39,59,-20,23
Young Boys,8184,1,22,8,2,74,36,38,74
FC Basel,8184,2,16,9,7,51,27,24,57
St Gallen,8184,3,16,3,13,46,52,-6,51
Lucerne,8184,4,12,8,12,40,43,-3,44
FC Zürich,8184,5,11,10,11,42,37,5,43
Grasshoppers,8184,6,9,8,15,42,47,-5,35
FC Thun,8184,7,9,7,16,43,57,-14,34
FC Lugano,8184,8,9,7,16,29,48,-19,34
FC Sion,8184,9,6,8,18,39,59,-20,26
Young Boys,8185,1,22,6,4,77,34,43,72
FC Basel,8185,2,17,9,6,53,27,26,60
St Gallen,8185,3,14,3,15,46,55,-9,45
Lucerne,8185,4,11,9,12,39,52,-13,42
FC Thun,8185,5,12,5,15,47,55,-8,41
FC Zürich,8185,6,10,10,12,39,36,3,40
Grasshoppers,8185,7,10,7,15,42,48,-6,37
FC Lugano,8185,8,10,6,16,28,47,-19,36
FC Sion,8185,9,6,9,17,38,55,-17,27
Young Boys,8186,1,22,7,3,72,33,39,73
FC Basel,8186,2,16,7,9,50,27,23,55
St Gallen,8186,3,16,2,14,45,54,-9,50
Lucerne,8186,4,13,8,11,42,44,-2,47
FC Zürich,8186,5,12,10,10,42,33,9,46
FC Lugano,8186,6,9,7,16,29,48,-19,34
Grasshoppers,8186,7,8,9,15,41,51,-10,33
FC Sion,8186,8,8,8,16,39,50,-11,32
FC Thun,8186,9,8,6,18,40,60,-20,30
Young Boys,8187,1,22,7,3,74,34,40,73
FC Basel,8187,2,15,10,7,49,28,21,55
Lucerne,8187,3,15,7,10,47,40,7,52
FC Zürich,8187,4,13,9,10,46,36,10,48
St Gallen,8187,5,13,3,16,42,60,-18,42
Grasshoppers,8187,6,11,6,15,45,48,-3,39
FC Lugano,8187,7,10,5,17,33,56,-23,35
FC Thun,8187,8,8,6,18,41,64,-23,30
FC Sion,8187,9,7,7,18,44,55,-11,28
Young Boys,8188,1,22,6,4,73,35,38,72
FC Basel,8188,2,19,8,5,60,25,35,65
Lucerne,8188,3,12,8,12,43,48,-5,44
FC Zürich,8188,4,11,10,11,42,35,7,43
St Gallen,8188,5,13,4,15,40,55,-15,43
FC Lugano,8188,6,11,5,16,30,50,-20,38
Grasshoppers,8188,7,10,6,16,40,47,-7,36
FC Thun,8188,8,9,5,18,40,61,-21,32
FC Sion,8188,9,7,8,17,38,50,-12,29
Young Boys,8189,1,22,7,3,74,36,38,73
FC Basel,8189,2,19,7,6,55,26,29,64
Lucerne,8189,3,14,7,11,42,43,-1,49
FC Zürich,8189,4,11,11,10,44,36,8,44
St Gallen,8189,5,13,2,17,41,57,-16,41
FC Lugano,8189,6,10,6,16,34,51,-17,36
FC Thun,8189,7,9,5,18,42,60,-18,32
FC Sion,8189,8,7,10,15,38,49,-11,31
Grasshoppers,8189,9,8,7,17,38,50,-12,31
Young Boys,8190,1,20,8,4,70,35,35,68
FC Basel,8190,2,18,9,5,56,25,31,63
Lucerne,8190,3,14,9,9,43,40,3,51
FC Zürich,8190,4,11,10,11,44,35,9,43
St Gallen,8190,5,13,2,17,40,59,-19,41
FC Lugano,8190,6,10,6,16,30,48,-18,36
Grasshoppers,8190,7,8,9,15,39,50,-11,33
FC Sion,8190,8,7,10,15,40,50,-10,31
FC Thun,8190,9,8,7,17,39,59,-20,31
Young Boys,8191,1,22,8,2,76,35,41,74
FC Basel,8191,2,18,8,6,59,30,29,62
Lucerne,8191,3,13,9,10,41,41,0,48
St Gallen,8191,4,13,5,14,40,52,-12,44
FC Zürich,8191,5,10,10,12,42,37,5,40
FC Thun,8191,6,10,5,17,47,64,-17,35
FC Lugano,8191,7,9,8,15,28,45,-17,35
Grasshoppers,8191,8,9,7,16,41,52,-11,34
FC Sion,8191,9,5,10,17,39,57,-18,25
Young Boys,8192,1,21,7,4,71,34,37,70
FC Basel,8192,2,17,10,5,55,26,29,61
Lucerne,8192,3,14,8,10,46,44,2,50
St Gallen,8192,4,14,2,16,47,60,-13,44
FC Zürich,8192,5,10,11,11,43,38,5,41
FC Lugano,8192,6,11,5,16,30,47,-17,38
Grasshoppers,8192,7,10,7,15,43,53,-10,37
FC Thun,8192,8,9,6,17,45,60,-15,33
FC Sion,8192,9,6,8,18,40,58,-18,26
Young Boys,8193,1,21,7,4,70,34,36,70
FC Basel,8193,2,18,8,6,55,24,31,62
Lucerne,8193,3,13,7,12,43,43,0,46
St Gallen,8193,4,14,2,16,40,56,-16,44
FC Zürich,8193,5,10,10,12,41,38,3,40
Grasshoppers,8193,6,11,6,15,44,49,-5,39
FC Lugano,8193,7,11,6,15,33,47,-14,39
FC Thun,8193,8,9,6,17,44,64,-20,33
FC Sion,8193,9,7,8,17,40,55,-15,29
Young Boys,8194,1,23,7,2,71,32,39,76
FC Basel,8194,2,18,8,6,56,24,32,62
St Gallen,8194,3,15,2,15,45,56,-11,47
Lucerne,8194,4,13,7,12,43,45,-2,46
FC Zürich,8194,5,11,9,12,42,37,5,42
FC Thun,8194,6,10,5,17,44,59,-15,35
FC Lugano,8194,7,10,5,17,30,48,-18,35
FC Sion,8194,8,8,7,17,42,54,-12,31
Grasshoppers,8194,9,8,6,18,39,57,-18,30
Young Boys,8195,1,21,8,3,69,34,35,71
FC Basel,8195,2,20,7,5,56,23,33,67
Lucerne,8195,3,13,9,10,47,46,1,48
St Gallen,8195,4,14,3,15,46,59,-13,45
FC Zürich,8195,5,11,10,11,42,36,6,43
FC Thun,8195,6,10,6,16,44,58,-14,36
FC Lugano,8195,7,10,5,17,35,52,-17,35
Grasshoppers,8195,8,8,6,18,37,50,-13,30
FC Sion,8195,9,6,8,18,40,58,-18,26
Young Boys,8196,1,24,6,2,78,31,47,78
FC Basel,8196,2,18,7,7,53,29,24,61
St Gallen,8196,3,17,2,13,48,52,-4,53
FC Zürich,8196,4,11,10,11,41,36,5,43
Lucerne,8196,5,12,7,13,45,49,-4,43
Grasshoppers,8196,6,10,6,16,43,51,-8,36
FC Thun,8196,7,10,5,17,44,59,-15,35
FC Lugano,8196,8,9,5,18,29,56,-27,32
FC Sion,8196,9,5,8,19,42,60,-18,23
Young Boys,8197,1,23,6,3,75,35,40,75
FC Basel,8197,2,18,8,6,57,28,29,62
Lucerne,8197,3,14,7,11,45,43,2,49
St Gallen,8197,4,14,4,14,41,55,-14,46
FC Zürich,8197,5,10,10,12,41,38,3,40
FC Thun,8197,6,10,5,17,47,63,-16,35
FC Lugano,8197,7,9,7,16,30,48,-18,34
Grasshoppers,8197,8,9,6,17,40,53,-13,33
FC Sion,8197,9,7,7,18,39,52,-13,28
Young Boys,8198,1,23,6,3,71,33,38,75
FC Basel,8198,2,18,8,6,54,26,28,62
St Gallen,8198,3,14,3,15,41,56,-15,45
Lucerne,8198,4,12,8,12,41,46,-5,44
FC Zürich,8198,5,10,10,12,41,35,6,40
Grasshoppers,8198,6,10,6,16,43,49,-6,36
FC Thun,8198,7,10,6,16,45,58,-13,36
FC Lugano,8198,8,9,8,15,28,46,-18,35
FC Sion,8198,9,7,7,18,42,57,-15,28
Young Boys,8199,1,21,6,5,67,37,30,69
FC Basel,8199,2,18,8,6,53,25,28,62
Lucerne,8199,3,12,10,10,39,42,-3,46
St Gallen,8199,4,14,3,15,42,54,-12,45
FC Zürich,8199,5,10,10,12,41,39,2,40
FC Lugano,8199,6,11,6,15,32,44,-12,39
Grasshoppers,8199,7,10,8,14,44,47,-3,38
FC Thun,8199,8,9,6,17,47,62,-15,33
FC Sion,8199,9,6,9,17,43,58,-15,27
Young Boys,8200,1,22,8,2,76,33,43,74
FC Basel,8200,2,18,9,5,59,25,34,63
St Gallen,8200,3,15,3,14,43,53,-10,48
Lucerne,8200,4,13,7,12,42,46,-4,46
FC Zürich,8200,5,10,11,11,43,39,4,41
FC Thun,8200,6,10,6,16,44,60,-16,36
FC Lugano,8200,7,9,6,17,29,49,-20,33
Grasshoppers,8200,8,8,7,17,41,53,-12,31
FC Sion,8200,9,6,9,17,40,59,-19,27
Young Boys,8201,1,22,7,3,76,37,39,73
FC Basel,8201,2,16,10,6,55,31,24,58
Lucerne,8201,3,14,7,11,43,44,-1,49
St Gallen,8201,4,14,2,16,42,56,-14,44
FC Zürich,8201,5,10,10,12,42,38,4,40
Grasshoppers,8201,6,11,6,15,44,47,-3,39
FC Lugano,8201,7,11,5,16,34,50,-16,38
FC Thun,8201,8,9,6,17,42,59,-17,33
FC Sion,8201,9,7,7,18,41,57,-16,28
Young Boys,8202,1,21,7,4,70,34,36,70
FC Basel,8202,2,17,8,7,55,29,26,59
Lucerne,8202,3,13,9,10,45,46,-1,48
FC Zürich,8202,4,11,9,12,43,36,7,42
St Gallen,8202,5,13,3,16,43,59,-16,42
FC Lugano,8202,6,11,6,15,32,47,-15,39
FC Thun,8202,7,11,5,16,45,56,-11,38
Grasshoppers,8202,8,10,6,16,43,49,-6,36
FC Sion,8202,9,7,7,18,39,59,-20,28
Young Boys,8203,1,21,6,5,71,40,31,69
FC Basel,8203,2,17,10,5,54,27,27,61
Lucerne,8203,3,14,7,11,46,46,0,49
St Gallen,8203,4,15,3,14,46,56,-10,48
FC Zürich,8203,5,9,12,11,39,39,0,39
FC Lugano,8203,6,11,5,16,34,47,-13,38
FC Thun,8203,7,9,8,15,43,57,-14,35
Grasshoppers,8203,8,9,6,17,42,53,-11,33
FC Sion,8203,9,6,9,17,44,54,-10,27
Young Boys,8204,1,22,8,2,73,33,40,74
FC Basel,8204,2,17,9,6,54,28,26,60
Lucerne,8204,3,14,7,11,44,42,2,49
FC Zürich,8204,4,12,9,11,44,36,8,45
St Gallen,8204,5,14,3,15,42,55,-13,45
Grasshoppers,8204,6,10,7,15,41,49,-8,37
FC Lugano,8204,7,10,5,17,31,51,-20,35
FC Thun,8204,8,9,5,18,43,59,-16,32
FC Sion,8204,9,6,7,19,40,59,-19,25
Young Boys,8205,1,20,10,2,71,31,40,70
FC Basel,8205,2,17,9,6,55,24,31,60
St Gallen,8205,3,16,2,14,43,54,-11,50
Lucerne,8205,4,13,9,10,45,42,3,48
FC Zürich,8205,5,11,10,11,43,36,7,43
FC Thun,8205,6,10,6,16,47,59,-12,36
Grasshoppers,8205,7,9,7,16,43,55,-12,34
FC Lugano,8205,8,9,6,17,31,58,-27,33
FC Sion,8205,9,5,9,18,38,57,-19,24
Young Boys,8206,1,22,6,4,72,33,39,72
FC Basel,8206,2,17,7,8,56,32,24,58
St Gallen,8206,3,16,3,13,50,54,-4,51
Lucerne,8206,4,14,8,10,43,42,1,50
FC Zürich,8206,5,12,10,10,45,35,10,46
Grasshoppers,8206,6,10,7,15,41,48,-7,37
FC Lugano,8206,7,9,6,17,31,53,-22,33
FC Thun,8206,8,8,6,18,41,62,-21,30
FC Sion,8206,9,5,9,18,36,56,-20,24
Young Boys,8207,1,21,6,5,76,41,35,69
FC Basel,8207,2,16,9,7,53,28,25,57
St Gallen,8207,3,15,3,14,42,52,-10,48
Lucerne,8207,4,13,8,11,43,43,0,47
FC Zürich,8207,5,12,10,10,42,33,9,46
FC Thun,8207,6,11,5,16,45,57,-12,38
Grasshoppers,8207,7,9,7,16,42,53,-11,34
FC Lugano,8207,8,9,6,17,28,50,-22,33
FC Sion,8207,9,7,8,17,42,56,-14,29
Young Boys,8208,1,21,7,4,72,38,34,70
FC Basel,8208,2,19,7,6,58,31,27,64
St Gallen,8208,3,15,4,13,46,52,-6,49
Lucerne,8208,4,13,9,10,43,42,1,48
FC Zürich,8208,5,10,10,12,39,37,2,40
FC Lugano,8208,6,10,6,16,29,46,-17,36
FC Thun,8208,7,9,6,17,42,59,-17,33
Grasshoppers,8208,8,8,7,17,37,48,-11,31
FC Sion,8208,9,7,8,17,39,52,-13,29
Young Boys,8209,1,22,8,2,73,30,43,74
FC Basel,8209,2,17,9,6,57,28,29,60
Lucerne,8209,3,13,9,10,46,49,-3,48
St Gallen,8209,4,14,3,15,44,56,-12,45
FC Zürich,8209,5,10,9,13,40,41,-1,39
FC Thun,8209,6,10,6,16,46,60,-14,36
FC Sion,8209,7,8,9,15,42,52,-10,33
FC Lugano,8209,8,9,6,17,28,49,-21,33
Grasshoppers,8209,9,8,7,17,40,51,-11,31
Young Boys,8210,1,22,6,4,72,34,38,72
FC Basel,8210,2,18,8,6,54,26,28,62
St Gallen,8210,3,15,3,14,46,54,-8,48
FC Zürich,8210,4,11,11,10,46,38,8,44
Lucerne,8210,5,11,9,12,41,47,-6,42
Grasshoppers,8210,6,10,6,16,40,52,-12,36
FC Lugano,8210,7,10,6,16,31,49,-18,36
FC Sion,8210,8,8,7,17,44,56,-12,31
FC Thun,8210,9,8,6,18,41,59,-18,30
Young Boys,8211,1,23,6,3,72,33,39,75
FC Basel,8211,2,17,8,7,51,26,25,59
St Gallen,8211,3,15,3,14,43,54,-11,48
Lucerne,8211,4,13,7,12,41,43,-2,46
FC Zürich,8211,5,10,10,12,39,36,3,40
FC Lugano,8211,6,11,6,15,31,45,-14,39
Grasshoppers,8211,7,10,6,16,42,49,-7,36
FC Thun,8211,8,8,6,18,42,62,-20,30
FC Sion,8211,9,7,8,17,42,55,-13,29
Young Boys,8212,1,21,7,4,71,34,37,70
FC Basel,8212,2,16,9,7,52,29,23,57
Lucerne,8212,3,13,8,11,42,45,-3,47
St Gallen,8212,4,14,3,15,41,56,-15,45
FC Zürich,8212,5,10,12,10,39,33,6,42
FC Lugano,8212,6,11,6,15,32,47,-15,39
FC Sion,8212,7,8,9,15,42,49,-7,33
Grasshoppers,8212,8,8,8,16,37,47,-10,32
FC Thun,8212,9,8,8,16,44,60,-16,32
Young Boys,8213,1,21,6,5,69,37,32,69
FC Basel,8213,2,18,9,5,53,25,28,63
St Gallen,8213,3,15,3,14,41,51,-10,48
Lucerne,8213,4,12,8,12,43,45,-2,44
FC Lugano,8213,5,12,5,15,31,44,-13,41
FC Zürich,8213,6,10,10,12,41,37,4,40
FC Thun,8213,7,11,5,16,47,56,-9,38
Grasshoppers,8213,8,9,7,16,42,52,-10,34
FC Sion,8213,9,6,7,19,39,59,-20,25
Young Boys,8214,1,23,6,3,76,33,43,75
FC Basel,8214,2,18,8,6,58,26,32,62
St Gallen,8214,3,15,3,14,44,54,-10,48
FC Zürich,8214,4,12,10,10,44,36,8,46
Lucerne,8214,5,11,8,13,38,49,-11,41
Grasshoppers,8214,6,10,6,16,43,51,-8,36
FC Lugano,8214,7,10,5,17,31,48,-17,35
FC Thun,8214,8,9,5,18,44,64,-20,32
FC Sion,8214,9,7,7,18,39,56,-17,28
Young Boys,8215,1,22,6,4,75,38,37,72
FC Basel,8215,2,18,7,7,54,26,28,61
St Gallen,8215,3,14,4,14,46,57,-11,46
FC Zürich,8215,4,12,9,11,42,34,8,45
Grasshoppers,8215,5,12,6,14,47,47,0,42
Lucerne,8215,6,11,9,12,40,46,-6,42
FC Lugano,8215,7,10,7,15,31,48,-17,37
FC Thun,8215,8,10,5,17,41,58,-17,35
FC Sion,8215,9,5,7,20,40,62,-22,22
Young Boys,8216,1,20,8,4,68,36,32,68
FC Basel,8216,2,18,8,6,53,24,29,62
St Gallen,8216,3,14,4,14,40,52,-12,46
Lucerne,8216,4,12,7,13,37,43,-6,43
FC Zürich,8216,5,10,10,12,39,37,2,40
FC Lugano,8216,6,11,7,14,31,43,-12,40
Grasshoppers,8216,7,10,7,15,42,46,-4,37
FC Thun,8216,8,10,5,17,41,56,-15,35
FC Sion,8216,9,6,10,16,38,52,-14,28
Young Boys,8217,1,24,6,2,78,34,44,78
FC Basel,8217,2,15,9,8,51,30,21,54
Lucerne,8217,3,14,8,10,43,42,1,50
St Gallen,8217,4,14,5,13,44,52,-8,47
FC Zürich,8217,5,12,9,11,42,36,6,45
FC Thun,8217,6,9,7,16,43,57,-14,34
Grasshoppers,8217,7,9,6,17,41,54,-13,33
FC Lugano,8217,8,9,6,17,28,48,-20,33
FC Sion,8217,9,6,8,18,39,56,-17,26
Young Boys,8218,1,22,7,3,78,38,40,73
FC Basel,8218,2,17,10,5,57,27,30,61
Lucerne,8218,3,14,8,10,47,47,0,50
St Gallen,8218,4,15,3,14,43,54,-11,48
FC Zürich,8218,5,11,9,12,41,36,5,42
FC Thun,8218,6,11,6,15,49,58,-9,39
Grasshoppers,8218,7,9,6,17,42,54,-12,33
FC Lugano,8218,8,9,6,17,30,50,-20,33
FC Sion,8218,9,5,7,20,39,62,-23,22
Young Boys,8219,1,21,7,4,79,39,40,70
FC Basel,8219,2,16,10,6,54,32,22,58
Lucerne,8219,3,15,8,9,43,38,5,53
St Gallen,8219,4,13,4,15,45,59,-14,43
FC Zürich,8219,5,9,12,11,41,38,3,39
FC Lugano,8219,6,10,6,16,31,51,-20,36
Grasshoppers,8219,7,8,9,15,39,48,-9,33
FC Thun,8219,8,8,8,16,40,56,-16,32
FC Sion,8219,9,7,10,15,43,54,-11,31
Young Boys,8220,1,22,8,2,77,36,41,74
FC Basel,8220,2,16,8,8,52,29,23,56
Lucerne,8220,3,13,8,11,41,46,-5,47
FC Zürich,8220,4,12,9,11,42,37,5,45
St Gallen,8220,5,14,3,15,43,56,-13,45
FC Thun,8220,6,11,6,15,47,58,-11,39
FC Lugano,8220,7,9,7,16,30,47,-17,34
Grasshoppers,8220,8,8,8,16,43,53,-10,32
FC Sion,8220,9,6,9,17,46,59,-13,27
Young Boys,8221,1,21,7,4,72,38,34,70
FC Basel,8221,2,19,8,5,55,23,32,65
Lucerne,8221,3,12,9,11,42,42,0,45
St Gallen,8221,4,13,5,14,42,56,-14,44
FC Zürich,8221,5,9,11,12,37,37,0,38
Grasshoppers,8221,6,10,7,15,43,52,-9,37
FC Lugano,8221,7,10,7,15,30,45,-15,37
FC Thun,8221,8,9,5,18,44,60,-16,32
FC Sion,8221,9,7,9,16,43,55,-12,30
Young Boys,8222,1,22,6,4,79,38,41,72
FC Basel,8222,2,18,9,5,54,24,30,63
Lucerne,8222,3,12,10,10,41,44,-3,46
St Gallen,8222,4,14,3,15,43,55,-12,45
FC Zürich,8222,5,11,10,11,42,37,5,43
Grasshoppers,8222,6,10,7,15,44,49,-5,37
FC Thun,8222,7,9,6,17,43,59,-16,33
FC Lugano,8222,8,9,6,17,30,53,-23,33
FC Sion,8222,9,7,7,18,37,54,-17,28
Young Boys,8223,1,21,7,4,69,37,32,70
FC Basel,8223,2,17,8,7,52,25,27,59
Lucerne,8223,3,14,8,10,49,43,6,50
St Gallen,8223,4,14,3,15,44,59,-15,45
FC Zürich,8223,5,10,11,11,41,38,3,41
FC Thun,8223,6,11,6,15,48,59,-11,39
FC Lugano,8223,7,9,8,15,31,50,-19,35
Grasshoppers,8223,8,9,6,17,43,51,-8,33
FC Sion,8223,9,7,7,18,44,59,-15,28
Young Boys,8224,1,21,6,5,77,40,37,69
FC Basel,8224,2,17,9,6,55,28,27,60
Lucerne,8224,3,12,10,10,45,46,-1,46
St Gallen,8224,4,14,4,14,43,54,-11,46
FC Zürich,8224,5,12,9,11,44,37,7,45
Grasshoppers,8224,6,10,8,14,43,49,-6,38
FC Lugano,8224,7,10,5,17,32,54,-22,35
FC Thun,8224,8,9,6,17,45,60,-15,33
FC Sion,8224,9,7,7,18,41,57,-16,28
Young Boys,8225,1,20,6,6,69,40,29,66
FC Basel,8225,2,18,8,6,56,27,29,62
Lucerne,8225,3,14,9,9,49,45,4,51
FC Zürich,8225,4,11,9,12,41,37,4,42
FC Lugano,8225,5,12,6,14,35,46,-11,42
St Gallen,8225,6,13,3,16,43,58,-15,42
Grasshoppers,8225,7,11,6,15,45,50,-5,39
FC Thun,8225,8,8,6,18,41,62,-21,30
FC Sion,8225,9,6,9,17,40,54,-14,27
Young Boys,8226,1,20,8,4,69,36,33,68
FC Basel,8226,2,19,8,5,56,25,31,65
Lucerne,8226,3,13,8,11,44,44,0,47
FC Zürich,8226,4,11,11,10,46,36,10,44
St Gallen,8226,5,13,3,16,39,53,-14,42
Grasshoppers,8226,6,10,7,15,42,49,-7,37
FC Lugano,8226,7,10,7,15,31,47,-16,37
FC Thun,8226,8,8,7,17,43,63,-20,31
FC Sion,8226,9,6,9,17,38,55,-17,27
Young Boys,8227,1,20,7,5,69,37,32,67
FC Basel,8227,2,19,7,6,56,24,32,64
Lucerne,8227,3,12,9,11,42,45,-3,45
St Gallen,8227,4,13,3,16,42,56,-14,42
FC Zürich,8227,5,10,9,13,40,39,1,39
Grasshoppers,8227,6,11,6,15,44,48,-4,39
FC Lugano,8227,7,10,7,15,31,48,-17,37
FC Thun,8227,8,10,5,17,41,59,-18,35
FC Sion,8227,9,9,7,16,42,51,-9,34
Young Boys,8228,1,21,6,5,70,37,33,69
FC Basel,8228,2,19,7,6,59,25,34,64
Lucerne,8228,3,15,8,9,45,39,6,53
St Gallen,8228,4,15,3,14,46,52,-6,48
FC Zürich,8228,5,9,10,13,38,40,-2,37
FC Thun,8228,6,10,5,17,41,59,-18,35
FC Lugano,8228,7,10,5,17,28,46,-18,35
Grasshoppers,8228,8,9,6,17,39,51,-12,33
FC Sion,8228,9,7,8,17,41,58,-17,29
Young Boys,8229,1,22,8,2,75,36,39,74
FC Basel,8229,2,17,8,7,52,28,24,59
St Gallen,8229,3,15,4,13,45,51,-6,49
FC Zürich,8229,4,11,10,11,40,34,6,43
Lucerne,8229,5,11,8,13,42,48,-6,41
Grasshoppers,8229,6,10,7,15,43,49,-6,37
FC Thun,8229,7,10,6,16,44,57,-13,36
FC Lugano,8229,8,10,6,16,31,48,-17,36
FC Sion,8229,9,5,9,18,38,59,-21,24
Young Boys,8230,1,21,8,3,73,37,36,71
FC Basel,8230,2,16,11,5,57,27,30,59
St Gallen,8230,3,15,4,13,45,53,-8,49
Lucerne,8230,4,11,11,10,40,46,-6,44
FC Zürich,8230,5,10,11,11,41,39,2,41
FC Thun,8230,6,11,6,15,46,55,-9,39
Grasshoppers,8230,7,10,7,15,44,48,-4,37
FC Lugano,8230,8,9,7,16,30,48,-18,34
FC Sion,8230,9,5,7,20,36,59,-23,22
Young Boys,8231,1,23,6,3,74,33,41,75
FC Basel,8231,2,18,7,7,54,27,27,61
St Gallen,8231,3,14,3,15,42,56,-14,45
Lucerne,8231,4,12,7,13,42,50,-8,43
FC Lugano,8231,5,11,6,15,33,45,-12,39
FC Zürich,8231,6,9,11,12,38,36,2,38
Grasshoppers,8231,7,10,6,16,40,49,-9,36
FC Thun,8231,8,10,5,17,43,57,-14,35
FC Sion,8231,9,7,9,16,41,54,-13,30
Young Boys,8232,1,21,6,5,71,35,36,69
FC Basel,8232,2,18,9,5,52,24,28,63
Lucerne,8232,3,12,8,12,41,50,-9,44
St Gallen,8232,4,13,5,14,41,53,-12,44
FC Zürich,8232,5,11,10,11,44,39,5,43
FC Thun,8232,6,11,5,16,43,54,-11,38
FC Lugano,8232,7,10,6,16,33,50,-17,36
Grasshoppers,8232,8,9,7,16,43,49,-6,34
FC Sion,8232,9,7,8,17,41,55,-14,29
Young Boys,8233,1,21,7,4,69,35,34,70
FC Basel,8233,2,19,7,6,59,27,32,64
Lucerne,8233,3,13,8,11,43,45,-2,47
St Gallen,8233,4,14,3,15,44,58,-14,45
FC Zürich,8233,5,10,11,11,40,38,2,41
Grasshoppers,8233,6,11,6,15,45,47,-2,39
FC Lugano,8233,7,9,7,16,31,48,-17,34
FC Thun,8233,8,9,6,17,42,59,-17,33
FC Sion,8233,9,5,11,16,37,53,-16,26
Young Boys,8234,1,20,9,3,69,34,35,69
FC Basel,8234,2,17,8,7,53,24,29,59
Lucerne,8234,3,14,8,10,43,41,2,50
St Gallen,8234,4,15,2,15,41,52,-11,47
FC Zürich,8234,5,11,9,12,41,38,3,42
FC Lugano,8234,6,11,6,15,37,49,-12,39
FC Thun,8234,7,10,5,17,43,60,-17,35
Grasshoppers,8234,8,9,6,17,37,51,-14,33
FC Sion,8234,9,7,7,18,36,51,-15,28
Young Boys,8235,1,20,7,5,70,39,31,67
FC Basel,8235,2,17,8,7,55,27,28,59
St Gallen,8235,3,16,2,14,47,55,-8,50
Lucerne,8235,4,13,8,11,45,49,-4,47
FC Zürich,8235,5,10,10,12,40,39,1,40
FC Lugano,8235,6,11,5,16,36,48,-12,38
FC Thun,8235,7,11,5,16,50,63,-13,38
Grasshoppers,8235,8,9,8,15,43,49,-6,35
FC Sion,8235,9,7,7,18,41,58,-17,28
Young Boys,8236,1,22,6,4,73,36,37,72
FC Basel,8236,2,20,7,5,54,23,31,67
Lucerne,8236,3,13,8,11,41,42,-1,47
St Gallen,8236,4,13,2,17,42,59,-17,41
FC Lugano,8236,5,11,6,15,33,46,-13,39
FC Zürich,8236,6,9,11,12,40,41,-1,38
Grasshoppers,8236,7,10,6,16,49,51,-2,36
FC Sion,8236,8,8,8,16,45,61,-16,32
FC Thun,8236,9,8,6,18,43,61,-18,30
Young Boys,8237,1,21,6,5,67,38,29,69
FC Basel,8237,2,18,8,6,55,25,30,62
St Gallen,8237,3,16,2,14,44,53,-9,50
Lucerne,8237,4,12,8,12,41,46,-5,44
Grasshoppers,8237,5,11,6,15,42,47,-5,39
FC Zürich,8237,6,9,10,13,37,36,1,37
FC Lugano,8237,7,10,6,16,31,47,-16,36
FC Sion,8237,8,9,7,16,41,48,-7,34
FC Thun,8237,9,9,5,18,40,58,-18,32
Young Boys,8238,1,22,7,3,73,34,39,73
FC Basel,8238,2,17,8,7,58,28,30,59
Lucerne,8238,3,13,9,10,43,42,1,48
St Gallen,8238,4,15,2,15,46,56,-10,47
FC Zürich,8238,5,11,10,11,40,36,4,43
FC Lugano,8238,6,10,7,15,31,47,-16,37
Grasshoppers,8238,7,9,7,16,39,49,-10,34
FC Thun,8238,8,9,6,17,43,63,-20,33
FC Sion,8238,9,6,8,18,39,57,-18,26
Young Boys,8239,1,23,6,3,72,31,41,75
FC Basel,8239,2,18,8,6,56,24,32,62
St Gallen,8239,3,14,3,15,43,58,-15,45
Lucerne,8239,4,12,7,13,41,49,-8,43
FC Zürich,8239,5,10,11,11,41,36,5,41
Grasshoppers,8239,6,10,6,16,42,50,-8,36
FC Lugano,8239,7,10,6,16,32,47,-15,36
FC Sion,8239,8,8,8,16,41,53,-12,32
FC Thun,8239,9,9,5,18,41,61,-20,32
Young Boys,8240,1,22,7,3,69,31,38,73
FC Basel,8240,2,18,9,5,53,23,30,63
Lucerne,8240,3,14,8,10,41,41,0,50
St Gallen,8240,4,13,2,17,39,54,-15,41
FC Zürich,8240,5,9,12,11,38,36,2,39
FC Lugano,8240,6,10,6,16,32,50,-18,36
FC Thun,8240,7,10,5,17,45,60,-15,35
Grasshoppers,8240,8,8,8,16,37,48,-11,32
FC Sion,8240,9,7,9,16,39,50,-11,30
Young Boys,8241,1,22,6,4,68,36,32,72
FC Basel,8241,2,19,8,5,58,23,35,65
St Gallen,8241,3,15,4,13,42,51,-9,49
FC Zürich,8241,4,11,10,11,45,39,6,43
Lucerne,8241,5,11,8,13,36,41,-5,41
FC Lugano,8241,6,11,5,16,31,46,-15,38
Grasshoppers,8241,7,10,7,15,41,49,-8,37
FC Thun,8241,8,8,8,16,44,62,-18,32
FC Sion,8241,9,5,8,19,36,54,-18,23
Young Boys,8242,1,21,7,4,72,37,35,70
FC Basel,8242,2,19,8,5,53,24,29,65
Lucerne,8242,3,12,9,11,40,43,-3,45
FC Zürich,8242,4,11,10,11,45,38,7,43
St Gallen,8242,5,13,4,15,41,54,-13,43
Grasshoppers,8242,6,12,6,14,50,53,-3,42
FC Lugano,8242,7,10,6,16,31,48,-17,36
FC Thun,8242,8,9,5,18,45,64,-19,32
FC Sion,8242,9,5,9,18,38,54,-16,24
Young Boys,8243,1,21,8,3,73,34,39,71
FC Basel,8243,2,19,7,6,55,25,30,64
St Gallen,8243,3,14,5,13,46,55,-9,47
FC Zürich,8243,4,11,10,11,41,36,5,43
Lucerne,8243,5,11,8,13,38,48,-10,41
Grasshoppers,8243,6,11,7,14,45,47,-2,40
FC Lugano,8243,7,10,6,16,30,47,-17,36
FC Thun,8243,8,9,5,18,43,61,-18,32
FC Sion,8243,9,5,10,17,39,57,-18,25
Young Boys,8244,1,22,6,4,68,35,33,72
FC Basel,8244,2,19,7,6,56,25,31,64
St Gallen,8244,3,14,2,16,41,59,-18,44
FC Zürich,8244,4,11,10,11,46,37,9,43
Lucerne,8244,5,11,8,13,38,43,-5,41
FC Lugano,8244,6,11,6,15,35,47,-12,39
Grasshoppers,8244,7,10,7,15,44,49,-5,37
FC Thun,8244,8,9,6,17,43,64,-21,33
FC Sion,8244,9,7,8,17,43,55,-12,29
Young Boys,8245,1,22,6,4,71,34,37,72
FC Basel,8245,2,18,8,6,54,26,28,62
St Gallen,8245,3,14,3,15,40,52,-12,45
Lucerne,8245,4,12,7,13,41,47,-6,43
FC Zürich,8245,5,10,10,12,41,39,2,40
FC Lugano,8245,6,11,6,15,31,46,-15,39
Grasshoppers,8245,7,10,7,15,46,51,-5,37
FC Sion,8245,8,8,8,16,40,52,-12,32
FC Thun,8245,9,8,7,17,43,60,-17,31
Young Boys,8246,1,22,7,3,72,35,37,73
FC Basel,8246,2,17,9,6,52,26,26,60
St Gallen,8246,3,16,2,14,45,53,-8,50
Lucerne,8246,4,12,7,13,38,43,-5,43
FC Zürich,8246,5,9,12,11,37,35,2,39
Grasshoppers,8246,6,10,7,15,42,48,-6,37
FC Lugano,8246,7,10,6,16,31,47,-16,36
FC Thun,8246,8,9,6,17,43,58,-15,33
FC Sion,8246,9,7,8,17,40,55,-15,29
Young Boys,8247,1,21,8,3,72,36,36,71
FC Basel,8247,2,17,9,6,54,26,28,60
St Gallen,8247,3,16,2,14,45,53,-8,50
FC Zürich,8247,4,11,11,10,43,37,6,44
Lucerne,8247,5,12,8,12,41,45,-4,44
FC Thun,8247,6,10,7,15,49,58,-9,37
Grasshoppers,8247,7,10,6,16,40,53,-13,36
FC Lugano,8247,8,9,6,17,31,51,-20,33
FC Sion,8247,9,6,7,19,41,57,-16,25
Young Boys,8248,1,23,6,3,78,34,44,75
FC Basel,8248,2,18,8,6,57,28,29,62
St Gallen,8248,3,15,4,13,48,56,-8,49
Lucerne,8248,4,12,7,13,40,48,-8,43
FC Zürich,8248,5,10,10,12,43,40,3,40
FC Thun,8248,6,10,6,16,44,58,-14,36
Grasshoppers,8248,7,9,7,16,41,50,-9,34
FC Lugano,8248,8,9,6,17,31,53,-22,33
FC Sion,8248,9,7,8,17,42,57,-15,29
Young Boys,8249,1,21,6,5,68,37,31,69
FC Basel,8249,2,18,7,7,54,28,26,61
St Gallen,8249,3,15,2,15,44,58,-14,47
Lucerne,8249,4,13,7,12,43,43,0,46
FC Zürich,8249,5,10,10,12,41,36,5,40
FC Lugano,8249,6,11,6,15,35,47,-12,39
FC Thun,8249,7,10,5,17,41,57,-16,35
FC Sion,8249,8,9,7,16,43,49,-6,34
Grasshoppers,8249,9,9,6,17,37,51,-14,33
Young Boys,8250,1,22,7,3,72,31,41,73
FC Basel,8250,2,17,8,7,54,27,27,59
Lucerne,8250,3,14,9,9,46,40,6,51
St Gallen,8250,4,14,3,15,42,56,-14,45
FC Zürich,8250,5,11,9,12,41,38,3,42
FC Lugano,8250,6,11,6,15,30,47,-17,39
FC Thun,8250,7,11,5,16,45,55,-10,38
Grasshoppers,8250,8,8,7,17,37,52,-15,31
FC Sion,8250,9,5,8,19,38,59,-21,23
Young Boys,8251,1,23,7,2,75,31,44,76
FC Basel,8251,2,17,8,7,52,30,22,59
St Gallen,8251,3,15,4,13,45,54,-9,49
Lucerne,8251,4,13,7,12,44,45,-1,46
FC Zürich,8251,5,10,10,12,43,39,4,40
FC Thun,8251,6,11,5,16,47,58,-11,38
FC Lugano,8251,7,10,5,17,29,46,-17,35
Grasshoppers,8251,8,9,6,17,41,56,-15,33
FC Sion,8251,9,5,10,17,37,54,-17,25
Young Boys,8252,1,21,8,3,69,32,37,71
FC Basel,8252,2,19,8,5,54,22,32,65
Lucerne,8252,3,13,7,12,43,45,-2,46
St Gallen,8252,4,14,3,15,42,54,-12,45
FC Zürich,8252,5,10,10,12,38,38,0,40
Grasshoppers,8252,6,11,6,15,42,46,-4,39
FC Lugano,8252,7,9,7,16,30,49,-19,34
FC Sion,8252,8,8,8,16,41,53,-12,32
FC Thun,8252,9,8,5,19,39,59,-20,29
Young Boys,8253,1,20,8,4,68,40,28,68
FC Basel,8253,2,17,10,5,53,26,27,61
Lucerne,8253,3,14,8,10,45,39,6,50
FC Zürich,8253,4,12,9,11,42,36,6,45
St Gallen,8253,5,13,4,15,45,59,-14,43
Grasshoppers,8253,6,9,9,14,39,46,-7,36
FC Lugano,8253,7,10,5,17,31,50,-19,35
FC Thun,8253,8,8,7,17,40,58,-18,31
FC Sion,8253,9,7,8,17,47,56,-9,29
Young Boys,8254,1,22,6,4,71,36,35,72
FC Basel,8254,2,18,7,7,54,26,28,61
Lucerne,8254,3,14,7,11,50,42,8,49
St Gallen,8254,4,15,3,14,43,57,-14,48
FC Zürich,8254,5,11,9,12,40,38,2,42
FC Lugano,8254,6,10,5,17,33,51,-18,35
Grasshoppers,8254,7,9,6,17,38,54,-16,33
FC Sion,8254,8,8,8,16,42,50,-8,32
FC Thun,8254,9,9,5,18,41,58,-17,32
Young Boys,8255,1,21,9,2,69,32,37,72
FC Basel,8255,2,18,9,5,58,27,31,63
Lucerne,8255,3,13,7,12,46,47,-1,46
St Gallen,8255,4,14,4,14,44,57,-13,46
FC Zürich,8255,5,11,9,12,43,38,5,42
FC Lugano,8255,6,10,7,15,32,48,-16,37
FC Thun,8255,7,9,6,17,41,57,-16,33
FC Sion,8255,8,7,9,16,41,53,-12,30
Grasshoppers,8255,9,8,6,18,37,52,-15,30
Young Boys,8256,1,23,6,3,76,34,42,75
FC Basel,8256,2,16,7,9,48,27,21,55
Lucerne,8256,3,14,7,11,44,47,-3,49
St Gallen,8256,4,15,3,14,49,57,-8,48
FC Zürich,8256,5,11,10,11,43,36,7,43
FC Thun,8256,6,11,5,16,43,56,-13,38
FC Lugano,8256,7,9,7,16,33,52,-19,34
Grasshoppers,8256,8,9,6,17,38,49,-11,33
FC Sion,8256,9,7,7,18,42,58,-16,28
Young Boys,8257,1,20,8,4,71,40,31,68
FC Basel,8257,2,17,8,7,56,27,29,59
St Gallen,8257,3,14,3,15,42,59,-17,45
Lucerne,8257,4,11,10,11,43,48,-5,43
FC Zürich,8257,5,10,11,11,38,35,3,41
Grasshoppers,8257,6,11,7,14,45,47,-2,40
FC Lugano,8257,7,11,6,15,33,44,-11,39
FC Thun,8257,8,10,5,17,45,62,-17,35
FC Sion,8257,9,7,8,17,43,54,-11,29
Young Boys,8258,1,21,7,4,69,38,31,70
FC Basel,8258,2,19,8,5,59,25,34,65
St Gallen,8258,3,14,2,16,43,57,-14,44
Lucerne,8258,4,12,7,13,43,51,-8,43
Grasshoppers,8258,5,11,6,15,44,49,-5,39
FC Lugano,8258,6,11,6,15,31,45,-14,39
FC Zürich,8258,7,9,11,12,37,35,2,38
FC Thun,8258,8,9,6,17,43,59,-16,33
FC Sion,8258,9,8,7,17,42,52,-10,31
Young Boys,8259,1,23,6,3,73,32,41,75
FC Basel,8259,2,16,11,5,53,26,27,59
FC Zürich,8259,3,12,10,10,42,33,9,46
Lucerne,8259,4,12,10,10,43,42,1,46
St Gallen,8259,5,14,4,14,43,54,-11,46
FC Lugano,8259,6,9,7,16,28,45,-17,34
FC Thun,8259,7,9,6,17,44,59,-15,33
Grasshoppers,8259,8,8,7,17,38,53,-15,31
FC Sion,8259,9,7,7,18,40,60,-20,28
Young Boys,8260,1,21,8,3,69,33,36,71
FC Basel,8260,2,17,10,5,51,23,28,61
Lucerne,8260,3,15,8,9,45,40,5,53
St Gallen,8260,4,14,2,16,42,55,-13,44
FC Zürich,8260,5,10,11,11,38,34,4,41
FC Lugano,8260,6,11,5,16,31,47,-16,38
FC Thun,8260,7,9,6,17,42,59,-17,33
Grasshoppers,8260,8,8,7,17,38,51,-13,31
FC Sion,8260,9,6,9,17,40,54,-14,27
Young Boys,8261,1,20,8,4,72,39,33,68
FC Basel,8261,2,17,8,7,51,26,25,59
Lucerne,8261,3,13,10,9,46,44,2,49
St Gallen,8261,4,15,4,13,45,53,-8,49
FC Zürich,8261,5,12,9,11,42,35,7,45
Grasshoppers,8261,6,11,6,15,43,49,-6,39
FC Lugano,8261,7,9,7,16,32,51,-19,34
FC Thun,8261,8,9,6,17,42,58,-16,33
FC Sion,8261,9,5,8,19,40,58,-18,23
Young Boys,8262,1,24,6,2,79,37,42,78
FC Basel,8262,2,17,7,8,61,32,29,58
Lucerne,8262,3,13,7,12,46,50,-4,46
St Gallen,8262,4,14,3,15,40,53,-13,45
FC Zürich,8262,5,11,11,10,45,35,10,44
FC Lugano,8262,6,10,7,15,32,47,-15,37
FC Thun,8262,7,10,6,16,47,65,-18,36
Grasshoppers,8262,8,9,7,16,42,51,-9,34
FC Sion,8262,9,5,8,19,38,60,-22,23
Young Boys,8263,1,23,6,3,72,33,39,75
FC Basel,8263,2,17,7,8,52,32,20,58
St Gallen,8263,3,14,3,15,40,55,-15,45
Lucerne,8263,4,12,8,12,42,44,-2,44
Grasshoppers,8263,5,12,6,14,44,45,-1,42
FC Zürich,8263,6,10,10,12,39,36,3,40
FC Lugano,8263,7,10,6,16,31,50,-19,36
FC Thun,8263,8,9,5,18,43,60,-17,32
FC Sion,8263,9,8,7,17,43,51,-8,31
Young Boys,8264,1,21,8,3,74,35,39,71
FC Basel,8264,2,17,8,7,55,27,28,59
St Gallen,8264,3,16,3,13,46,54,-8,51
Lucerne,8264,4,13,9,10,44,45,-1,48
FC Zürich,8264,5,10,10,12,42,38,4,40
FC Lugano,8264,6,11,6,15,33,44,-11,39
FC Thun,8264,7,10,6,16,47,61,-14,36
Grasshoppers,8264,8,9,7,16,41,53,-12,34
FC Sion,8264,9,5,7,20,38,63,-25,22
Young Boys,8265,1,22,7,3,78,37,41,73
FC Basel,8265,2,19,7,6,62,27,35,64
FC Zürich,8265,3,11,11,10,43,35,8,44
Lucerne,8265,4,12,8,12,41,46,-5,44
St Gallen,8265,5,14,2,16,45,57,-12,44
Grasshoppers,8265,6,10,7,15,42,51,-9,37
FC Lugano,8265,7,10,5,17,30,52,-22,35
FC Thun,8265,8,9,7,16,41,59,-18,34
FC Sion,8265,9,6,8,18,39,57,-18,26
Young Boys,8266,1,22,8,2,74,33,41,74
FC Basel,8266,2,17,8,7,56,26,30,59
St Gallen,8266,3,14,4,14,44,56,-12,46
FC Zürich,8266,4,12,9,11,41,35,6,45
Lucerne,8266,5,12,8,12,41,47,-6,44
FC Lugano,8266,6,11,6,15,35,50,-15,39
Grasshoppers,8266,7,9,8,15,40,49,-9,35
FC Thun,8266,8,8,6,18,41,62,-21,30
FC Sion,8266,9,6,9,17,37,51,-14,27
Young Boys,8267,1,21,7,4,70,35,35,70
FC Basel,8267,2,18,8,6,53,26,27,62
St Gallen,8267,3,15,3,14,46,57,-11,48
Lucerne,8267,4,12,8,12,43,45,-2,44
FC Zürich,8267,5,10,10,12,39,40,-1,40
FC Lugano,8267,6,11,6,15,39,51,-12,39
FC Thun,8267,7,9,6,17,45,60,-15,33
Grasshoppers,8267,8,8,8,16,39,51,-12,32
FC Sion,8267,9,7,10,15,41,50,-9,31
Young Boys,8268,1,21,7,4,70,36,34,70
FC Basel,8268,2,17,7,8,56,29,27,58
Lucerne,8268,3,13,10,9,44,41,3,49
St Gallen,8268,4,14,4,14,44,56,-12,46
FC Zürich,8268,5,11,10,11,43,36,7,43
FC Lugano,8268,6,11,5,16,33,49,-16,38
Grasshoppers,8268,7,10,7,15,44,48,-4,37
FC Thun,8268,8,9,6,17,42,64,-22,33
FC Sion,8268,9,6,8,18,42,59,-17,26
Young Boys,8269,1,21,7,4,73,40,33,70
FC Basel,8269,2,17,9,6,54,26,28,60
Lucerne,8269,3,12,10,10,43,45,-2,46
FC Zürich,8269,4,12,9,11,42,36,6,45
St Gallen,8269,5,13,2,17,40,57,-17,41
FC Lugano,8269,6,11,6,15,32,47,-15,39
Grasshoppers,8269,7,10,8,14,47,50,-3,38
FC Thun,8269,8,9,5,18,41,58,-17,32
FC Sion,8269,9,7,8,17,39,52,-13,29
Young Boys,8270,1,23,7,2,75,35,40,76
FC Basel,8270,2,17,9,6,54,25,29,60
Lucerne,8270,3,14,7,11,45,43,2,49
St Gallen,8270,4,15,2,15,44,55,-11,47
FC Zürich,8270,5,11,11,10,43,36,7,44
Grasshoppers,8270,6,10,6,16,42,50,-8,36
FC Thun,8270,7,9,7,16,42,60,-18,34
FC Lugano,8270,8,9,5,18,28,51,-23,32
FC Sion,8270,9,5,8,19,38,56,-18,23
Young Boys,8271,1,23,6,3,73,33,40,75
FC Basel,8271,2,19,7,6,54,27,27,64
Lucerne,8271,3,14,7,11,48,46,2,49
St Gallen,8271,4,14,2,16,47,60,-13,44
FC Zürich,8271,5,11,9,12,40,35,5,42
Grasshoppers,8271,6,10,6,16,45,51,-6,36
FC Thun,8271,7,10,5,17,45,61,-16,35
FC Lugano,8271,8,10,5,17,30,51,-21,35
FC Sion,8271,9,6,7,19,41,59,-18,25
Young Boys,8272,1,23,7,2,74,32,42,76
FC Basel,8272,2,16,10,6,52,25,27,58
Lucerne,8272,3,13,8,11,45,44,1,47
St Gallen,8272,4,14,4,14,43,54,-11,46
FC Zürich,8272,5,10,12,10,39,34,5,42
FC Thun,8272,6,10,5,17,43,59,-16,35
Grasshoppers,8272,7,9,6,17,40,53,-13,33
FC Lugano,8272,8,9,6,17,28,51,-23,33
FC Sion,8272,9,7,8,17,42,54,-12,29
Young Boys,8273,1,21,7,4,74,37,37,70
FC Basel,8273,2,19,8,5,58,24,34,65
Lucerne,8273,3,13,8,11,44,49,-5,47
St Gallen,8273,4,13,5,14,45,57,-12,44
FC Zürich,8273,5,10,9,13,41,39,2,39
Grasshoppers,8273,6,10,7,15,44,49,-5,37
FC Thun,8273,7,10,5,17,44,60,-16,35
FC Lugano,8273,8,9,6,17,29,51,-22,33
FC Sion,8273,9,8,7,17,43,56,-13,31
Young Boys,8274,1,21,9,2,70,31,39,72
FC Basel,8274,2,16,9,7,50,28,22,57
Lucerne,8274,3,12,9,11,44,43,1,45
St Gallen,8274,4,14,3,15,43,56,-13,45
FC Zürich,8274,5,10,10,12,42,38,4,40
FC Lugano,8274,6,11,6,15,30,48,-18,39
FC Thun,8274,7,11,5,16,47,58,-11,38
Grasshoppers,8274,8,10,6,16,41,50,-9,36
FC Sion,8274,9,6,9,17,40,55,-15,27
Young Boys,8275,1,20,7,5,72,42,30,67
FC Basel,8275,2,17,9,6,58,28,30,60
St Gallen,8275,3,15,4,13,44,51,-7,49
Lucerne,8275,4,11,9,12,38,49,-11,42
FC Zürich,8275,5,10,11,11,42,39,3,41
Grasshoppers,8275,6,11,6,15,46,47,-1,39
FC Lugano,8275,7,10,7,15,33,47,-14,37
FC Thun,8275,8,10,5,17,43,59,-16,35
FC Sion,8275,9,7,8,17,41,55,-14,29
Young Boys,8276,1,20,10,2,72,35,37,70
FC Basel,8276,2,17,9,6,52,24,28,60
Lucerne,8276,3,12,9,11,40,43,-3,45
St Gallen,8276,4,14,2,16,44,56,-12,44
FC Zürich,8276,5,11,9,12,43,37,6,42
FC Thun,8276,6,11,6,15,48,58,-10,39
FC Lugano,8276,7,11,6,15,34,50,-16,39
Grasshoppers,8276,8,8,7,17,41,57,-16,31
FC Sion,8276,9,7,8,17,41,55,-14,29
Young Boys,8277,1,21,7,4,70,34,36,70
FC Basel,8277,2,17,9,6,52,25,27,60
Lucerne,8277,3,13,9,10,41,40,1,48
St Gallen,8277,4,14,4,14,42,54,-12,46
FC Zürich,8277,5,11,11,10,40,32,8,44
FC Lugano,8277,6,10,6,16,31,47,-16,36
FC Thun,8277,7,10,5,17,44,61,-17,35
Grasshoppers,8277,8,9,6,17,39,50,-11,33
FC Sion,8277,9,6,9,17,38,54,-16,27
Young Boys,8278,1,21,9,2,71,33,38,72
FC Basel,8278,2,18,8,6,56,25,31,62
Lucerne,8278,3,13,9,10,42,42,0,48
St Gallen,8278,4,14,4,14,42,54,-12,46
FC Zürich,8278,5,10,11,11,43,39,4,41
Grasshoppers,8278,6,10,7,15,42,48,-6,37
FC Thun,8278,7,9,6,17,44,60,-16,33
FC Lugano,8278,8,9,6,17,30,53,-23,33
FC Sion,8278,9,6,8,18,40,56,-16,26
Young Boys,8279,1,22,7,3,70,32,38,73
FC Basel,8279,2,17,9,6,52,24,28,60
Lucerne,8279,3,13,9,10,41,41,0,48
St Gallen,8279,4,14,4,14,41,52,-11,46
FC Zürich,8279,5,12,9,11,42,37,5,45
FC Lugano,8279,6,10,6,16,30,45,-15,36
Grasshoppers,8279,7,9,7,16,38,49,-11,34
FC Thun,8279,8,9,7,16,42,56,-14,34
FC Sion,8279,9,5,8,19,35,55,-20,23
Young Boys,8280,1,22,6,4,68,32,36,72
FC Basel,8280,2,20,7,5,59,24,35,67
St Gallen,8280,3,14,4,14,42,54,-12,46
Lucerne,8280,4,12,9,11,38,43,-5,45
FC Zürich,8280,5,10,9,13,40,40,0,39
FC Thun,8280,6,10,5,17,45,58,-13,35
FC Lugano,8280,7,9,7,16,28,46,-18,34
Grasshoppers,8280,8,9,6,17,38,48,-10,33
FC Sion,8280,9,8,7,17,38,51,-13,31
Young Boys,8281,1,21,8,3,70,33,37,71
FC Basel,8281,2,20,7,5,57,24,33,67
Lucerne,8281,3,13,8,11,41,43,-2,47
St Gallen,8281,4,13,3,16,38,58,-20,42
FC Zürich,8281,5,10,9,13,40,37,3,39
FC Lugano,8281,6,11,6,15,32,48,-16,39
FC Thun,8281,7,10,5,17,48,61,-13,35
Grasshoppers,8281,8,9,6,17,39,51,-12,33
FC Sion,8281,9,7,8,17,42,52,-10,29
Young Boys,8282,1,21,7,4,69,36,33,70
FC Basel,8282,2,17,8,7,55,27,28,59
Lucerne,8282,3,14,8,10,44,41,3,50
St Gallen,8282,4,15,2,15,40,51,-11,47
FC Lugano,8282,5,11,7,14,32,43,-11,40
FC Zürich,8282,6,9,10,13,39,42,-3,37
FC Thun,8282,7,10,6,16,42,57,-15,36
Grasshoppers,8282,8,8,8,16,40,52,-12,32
FC Sion,8282,9,7,8,17,41,53,-12,29
Young Boys,8283,1,22,7,3,69,33,36,73
FC Basel,8283,2,18,8,6,56,26,30,62
Lucerne,8283,3,14,8,10,43,42,1,50
St Gallen,8283,4,15,3,14,43,55,-12,48
FC Zürich,8283,5,9,11,12,39,37,2,38
FC Thun,8283,6,10,5,17,43,62,-19,35
Grasshoppers,8283,7,9,7,16,45,50,-5,34
FC Lugano,8283,8,9,6,17,29,47,-18,33
FC Sion,8283,9,7,7,18,37,52,-15,28
Young Boys,8284,1,20,7,5,66,34,32,67
FC Basel,8284,2,19,8,5,51,22,29,65
Lucerne,8284,3,14,8,10,45,42,3,50
St Gallen,8284,4,13,4,15,40,55,-15,43
FC Zürich,8284,5,9,10,13,37,40,-3,37
FC Lugano,8284,6,10,6,16,31,47,-16,36
FC Sion,8284,7,9,8,15,42,48,-6,35
Grasshoppers,8284,8,9,8,15,40,50,-10,35
FC Thun,8284,9,9,5,18,44,58,-14,32
Young Boys,8285,1,22,7,3,73,34,39,73
FC Basel,8285,2,17,8,7,50,24,26,59
St Gallen,8285,3,14,2,16,43,56,-13,44
FC Zürich,8285,4,11,10,11,44,39,5,43
Lucerne,8285,5,11,10,11,43,46,-3,43
FC Lugano,8285,6,12,5,15,35,49,-14,41
Grasshoppers,8285,7,10,7,15,40,47,-7,37
FC Thun,8285,8,9,5,18,41,60,-19,32
FC Sion,8285,9,7,8,17,41,55,-14,29
Young Boys,8286,1,21,7,4,72,38,34,70
FC Basel,8286,2,18,8,6,55,25,30,62
Lucerne,8286,3,13,9,10,43,41,2,48
St Gallen,8286,4,15,3,14,44,52,-8,48
FC Zürich,8286,5,11,11,10,43,34,9,44
FC Lugano,8286,6,9,8,15,31,50,-19,35
FC Thun,8286,7,9,6,17,43,61,-18,33
Grasshoppers,8286,8,8,7,17,37,52,-15,31
FC Sion,8286,9,6,9,17,40,55,-15,27
Young Boys,8287,1,21,7,4,69,33,36,70
FC Basel,8287,2,16,8,8,55,33,22,56
St Gallen,8287,3,15,3,14,43,53,-10,48
Lucerne,8287,4,12,8,12,44,48,-4,44
FC Zürich,8287,5,11,10,11,46,40,6,43
FC Lugano,8287,6,11,6,15,31,46,-15,39
Grasshoppers,8287,7,10,7,15,39,47,-8,37
FC Thun,8287,8,9,8,15,44,58,-14,35
FC Sion,8287,9,6,9,17,38,51,-13,27
Young Boys,8288,1,21,7,4,71,35,36,70
FC Basel,8288,2,16,8,8,50,28,22,56
Lucerne,8288,3,14,8,10,46,46,0,50
St Gallen,8288,4,14,3,15,44,57,-13,45
FC Zürich,8288,5,11,10,11,43,37,6,43
FC Thun,8288,6,10,6,16,46,56,-10,36
FC Sion,8288,7,9,8,15,46,52,-6,35
FC Lugano,8288,8,10,5,17,31,51,-20,35
Grasshoppers,8288,9,8,7,17,39,54,-15,31
Young Boys,8289,1,22,6,4,71,38,33,72
FC Basel,8289,2,18,8,6,58,29,29,62
St Gallen,8289,3,16,2,14,47,58,-11,50
Lucerne,8289,4,13,7,12,44,46,-2,46
FC Zürich,8289,5,11,11,10,44,36,8,44
Grasshoppers,8289,6,9,7,16,42,51,-9,34
FC Thun,8289,7,9,6,17,46,63,-17,33
FC Lugano,8289,8,9,5,18,30,50,-20,32
FC Sion,8289,9,7,8,17,44,55,-11,29
Young Boys,8290,1,20,8,4,71,38,33,68
FC Basel,8290,2,19,8,5,54,23,31,65
St Gallen,8290,3,15,3,14,47,54,-7,48
Lucerne,8290,4,12,8,12,46,48,-2,44
FC Zrich,8290,5,11,10,11,41,35,6,43
Grasshoppers,8290,6,11,6,15,48,52,-4,39
FC Thun,8290,7,9,6,17,42,59,-17,33
FC Lugano,8290,8,9,5,18,29,56,-27,32
FC Sion,8290,9,7,8,17,42,55,-13,29
Young Boys,8291,1,23,6,3,73,35,38,75
FC Basel,8291,2,18,7,7,55,29,26,61
St Gallen,8291,3,16,2,14,47,56,-9,50
Lucerne,8291,4,12,7,13,40,45,-5,43
FC Zürich,8291,5,10,11,11,40,36,4,41
Grasshoppers,8291,6,10,7,15,43,48,-5,37
FC Lugano,8291,7,10,6,16,31,48,-17,36
FC Thun,8291,8,9,6,17,43,60,-17,33
FC Sion,8291,9,6,8,18,40,55,-15,26
Young Boys,8292,1,22,8,2,72,34,38,74
FC Basel,8292,2,18,8,6,55,24,31,62
Lucerne,8292,3,13,7,12,47,48,-1,46
St Gallen,8292,4,14,2,16,41,52,-11,44
FC Zürich,8292,5,11,9,12,40,38,2,42
FC Lugano,8292,6,11,6,15,34,47,-13,39
FC Thun,8292,7,11,5,16,46,59,-13,38
Grasshoppers,8292,8,8,7,17,39,57,-18,31
FC Sion,8292,9,6,8,18,40,55,-15,26
Young Boys,8293,1,21,7,4,69,38,31,70
FC Basel,8293,2,19,8,5,59,24,35,65
St Gallen,8293,3,16,2,14,44,53,-9,50
Lucerne,8293,4,12,8,12,41,45,-4,44
FC Zürich,8293,5,10,10,12,41,40,1,40
Grasshoppers,8293,6,10,7,15,40,47,-7,37
FC Lugano,8293,7,10,6,16,33,48,-15,36
FC Thun,8293,8,9,6,17,45,62,-17,33
FC Sion,8293,9,6,8,18,40,55,-15,26
Young Boys,8294,1,22,6,4,73,35,38,72
FC Basel,8294,2,18,8,6,55,24,31,62
Lucerne,8294,3,13,9,10,47,46,1,48
FC Zürich,8294,4,12,9,11,39,36,3,45
St Gallen,8294,5,13,2,17,42,60,-18,41
Grasshoppers,8294,6,9,9,14,42,49,-7,36
FC Thun,8294,7,10,6,16,46,58,-12,36
FC Lugano,8294,8,10,5,17,32,52,-20,35
FC Sion,8294,9,6,8,18,38,54,-16,26
Young Boys,8295,1,22,7,3,76,32,44,73
FC Basel,8295,2,17,7,8,55,29,26,58
St Gallen,8295,3,15,3,14,43,54,-11,48
Lucerne,8295,4,13,8,11,43,43,0,47
FC Zürich,8295,5,10,9,13,40,37,3,39
FC Thun,8295,6,11,6,15,47,58,-11,39
Grasshoppers,8295,7,10,7,15,41,50,-9,37
FC Lugano,8295,8,9,6,17,28,52,-24,33
FC Sion,8295,9,7,7,18,39,57,-18,28
Young Boys,8296,1,23,6,3,81,36,45,75
FC Basel,8296,2,18,8,6,55,26,29,62
FC Zürich,8296,3,12,9,11,42,37,5,45
St Gallen,8296,4,14,2,16,44,56,-12,44
Lucerne,8296,5,11,9,12,41,50,-9,42
FC Lugano,8296,6,11,6,15,34,46,-12,39
Grasshoppers,8296,7,8,9,15,40,52,-12,33
FC Thun,8296,8,8,7,17,40,57,-17,31
FC Sion,8296,9,7,8,17,38,55,-17,29
Young Boys,8297,1,21,8,3,73,32,41,71
FC Basel,8297,2,16,9,7,50,27,23,57
Lucerne,8297,3,13,9,10,43,42,1,48
St Gallen,8297,4,15,3,14,44,54,-10,48
FC Zürich,8297,5,11,10,11,44,36,8,43
Grasshoppers,8297,6,10,7,15,43,49,-6,37
FC Thun,8297,7,9,6,17,42,59,-17,33
FC Lugano,8297,8,9,6,17,31,55,-24,33
FC Sion,8297,9,7,8,17,39,55,-16,29
Young Boys,8298,1,23,7,2,78,34,44,76
FC Basel,8298,2,18,7,7,53,26,27,61
Lucerne,8298,3,13,9,10,43,43,0,48
FC Zürich,8298,4,12,9,11,40,33,7,45
St Gallen,8298,5,14,2,16,40,55,-15,44
Grasshoppers,8298,6,9,8,15,42,50,-8,35
FC Lugano,8298,7,10,5,17,28,47,-19,35
FC Thun,8298,8,9,5,18,41,60,-19,32
FC Sion,8298,9,6,8,18,39,56,-17,26
Young Boys,8299,1,22,8,2,69,31,38,74
FC Basel,8299,2,17,9,6,53,24,29,60
St Gallen,8299,3,14,4,14,39,52,-13,46
Lucerne,8299,4,12,9,11,40,45,-5,45
FC Thun,8299,5,12,5,15,46,55,-9,41
FC Zürich,8299,6,10,10,12,47,38,9,40
FC Lugano,8299,7,9,7,16,28,52,-24,34
Grasshoppers,8299,8,8,6,18,39,53,-14,30
FC Sion,8299,9,7,8,17,42,53,-11,29
Young Boys,8300,1,20,8,4,69,37,32,68
FC Basel,8300,2,17,10,5,55,24,31,61
Lucerne,8300,3,13,9,10,48,45,3,48
St Gallen,8300,4,15,2,15,43,58,-15,47
FC Zürich,8300,5,10,10,12,38,35,3,40
FC Thun,8300,6,11,6,15,50,57,-7,39
FC Lugano,8300,7,11,6,15,31,48,-17,39
Grasshoppers,8300,8,10,6,16,45,55,-10,36
FC Sion,8300,9,5,7,20,38,58,-20,22
Young Boys,8301,1,24,6,2,79,32,47,78
FC Basel,8301,2,19,7,6,59,24,35,64
Lucerne,8301,3,13,8,11,42,43,-1,47
St Gallen,8301,4,14,2,16,40,56,-16,44
FC Zürich,8301,5,11,9,12,41,37,4,42
FC Lugano,8301,6,10,6,16,31,50,-19,36
FC Thun,8301,7,10,5,17,44,62,-18,35
Grasshoppers,8301,8,9,6,17,40,52,-12,33
FC Sion,8301,9,6,7,19,36,56,-20,25
Young Boys,8302,1,22,8,2,76,34,42,74
FC Basel,8302,2,18,8,6,53,27,26,62
St Gallen,8302,3,14,4,14,41,52,-11,46
Lucerne,8302,4,12,8,12,41,48,-7,44
FC Zürich,8302,5,10,10,12,41,39,2,40
FC Lugano,8302,6,11,7,14,37,48,-11,40
FC Thun,8302,7,9,7,16,43,59,-16,34
Grasshoppers,8302,8,8,7,17,39,51,-12,31
FC Sion,8302,9,6,9,17,40,53,-13,27
Young Boys,8303,1,22,8,2,73,32,41,74
FC Basel,8303,2,18,9,5,55,25,30,63
Lucerne,8303,3,12,8,12,44,50,-6,44
St Gallen,8303,4,14,2,16,43,56,-13,44
FC Lugano,8303,5,11,6,15,33,47,-14,39
FC Zürich,8303,6,9,11,12,40,39,1,38
Grasshoppers,8303,7,9,7,16,39,50,-11,34
FC Thun,8303,8,9,7,16,42,57,-15,34
FC Sion,8303,9,7,8,17,40,53,-13,29
Young Boys,8304,1,21,7,4,72,37,35,70
FC Basel,8304,2,17,9,6,55,26,29,60
Lucerne,8304,3,14,8,10,50,45,5,50
St Gallen,8304,4,16,2,14,43,53,-10,50
FC Zürich,8304,5,10,11,11,43,38,5,41
FC Thun,8304,6,11,5,16,45,60,-15,38
FC Lugano,8304,7,9,6,17,30,52,-22,33
Grasshoppers,8304,8,8,6,18,42,57,-15,30
FC Sion,8304,9,7,8,17,43,55,-12,29
Young Boys,8305,1,24,6,2,76,34,42,78
FC Basel,8305,2,16,9,7,51,28,23,57
Lucerne,8305,3,13,9,10,41,41,0,48
FC Zürich,8305,4,11,10,11,43,38,5,43
St Gallen,8305,5,13,3,16,41,56,-15,42
FC Lugano,8305,6,11,5,16,31,45,-14,38
FC Thun,8305,7,10,6,16,48,60,-12,36
Grasshoppers,8305,8,9,6,17,41,53,-12,33
FC Sion,8305,9,6,8,18,39,56,-17,26
Young Boys,8306,1,21,6,5,73,39,34,69
FC Basel,8306,2,19,7,6,57,26,31,64
St Gallen,8306,3,14,3,15,44,55,-11,45
FC Zürich,8306,4,11,9,12,41,38,3,42
Lucerne,8306,5,11,9,12,39,46,-7,42
FC Lugano,8306,6,11,6,15,33,47,-14,39
Grasshoppers,8306,7,10,7,15,39,46,-7,37
FC Thun,8306,8,10,5,17,44,61,-17,35
FC Sion,8306,9,7,8,17,43,55,-12,29
Young Boys,8307,1,22,6,4,74,35,39,72
FC Basel,8307,2,17,8,7,52,28,24,59
St Gallen,8307,3,15,4,13,45,52,-7,49
Lucerne,8307,4,12,7,13,37,43,-6,43
FC Zürich,8307,5,9,12,11,37,34,3,39
Grasshoppers,8307,6,11,6,15,42,47,-5,39
FC Lugano,8307,7,10,7,15,32,49,-17,37
FC Thun,8307,8,9,5,18,42,60,-18,32
FC Sion,8307,9,7,9,16,41,54,-13,30
Young Boys,8308,1,22,7,3,70,35,35,73
FC Basel,8308,2,17,8,7,53,27,26,59
St Gallen,8308,3,16,3,13,46,52,-6,51
Lucerne,8308,4,14,8,10,45,43,2,50
FC Zürich,8308,5,10,9,13,40,42,-2,39
FC Lugano,8308,6,10,5,17,35,49,-14,35
FC Thun,8308,7,9,6,17,43,62,-19,33
Grasshoppers,8308,8,8,8,16,40,50,-10,32
FC Sion,8308,9,7,8,17,43,55,-12,29
Young Boys,8309,1,22,8,2,75,33,42,74
FC Basel,8309,2,18,8,6,59,26,33,62
Lucerne,8309,3,13,7,12,40,48,-8,46
St Gallen,8309,4,14,4,14,45,56,-11,46
FC Zürich,8309,5,12,9,11,42,34,8,45
Grasshoppers,8309,6,9,8,15,42,49,-7,35
FC Lugano,8309,7,9,6,17,30,51,-21,33
FC Thun,8309,8,9,5,18,43,62,-19,32
FC Sion,8309,9,6,9,17,38,55,-17,27
Young Boys,8310,1,21,9,2,69,33,36,72
FC Basel,8310,2,16,9,7,52,28,24,57
St Gallen,8310,3,16,2,14,47,53,-6,50
FC Zürich,8310,4,12,10,10,44,34,10,46
Lucerne,8310,5,12,9,11,42,46,-4,45
Grasshoppers,8310,6,10,6,16,41,49,-8,36
FC Lugano,8310,7,10,5,17,31,48,-17,35
FC Thun,8310,8,8,6,18,42,61,-19,30
FC Sion,8310,9,7,8,17,40,56,-16,29
Young Boys,8311,1,21,7,4,71,37,34,70
FC Basel,8311,2,18,9,5,59,28,31,63
St Gallen,8311,3,15,3,14,45,56,-11,48
Lucerne,8311,4,12,9,11,43,44,-1,45
FC Zürich,8311,5,11,9,12,41,39,2,42
FC Lugano,8311,6,11,5,16,34,49,-15,38
FC Thun,8311,7,10,5,17,48,61,-13,35
Grasshoppers,8311,8,8,7,17,41,54,-13,31
FC Sion,8311,9,7,8,17,40,54,-14,29
Young Boys,8312,1,21,7,4,70,35,35,70
FC Basel,8312,2,18,8,6,56,24,32,62
Lucerne,8312,3,13,9,10,43,47,-4,48
FC Zürich,8312,4,12,9,11,41,34,7,45
St Gallen,8312,5,13,4,15,43,57,-14,43
Grasshoppers,8312,6,9,8,15,42,51,-9,35
FC Thun,8312,7,9,6,17,44,58,-14,33
FC Lugano,8312,8,9,6,17,30,49,-19,33
FC Sion,8312,9,8,7,17,42,56,-14,31
Young Boys,8313,1,22,7,3,78,37,41,73
FC Basel,8313,2,16,11,5,51,24,27,59
Lucerne,8313,3,12,9,11,46,47,-1,45
St Gallen,8313,4,14,3,15,43,58,-15,45
FC Zürich,8313,5,11,10,11,38,33,5,43
Grasshoppers,8313,6,11,7,14,48,51,-3,40
FC Lugano,8313,7,10,5,17,32,51,-19,35
FC Thun,8313,8,9,6,17,39,56,-17,33
FC Sion,8313,9,6,8,18,38,56,-18,26
Young Boys,8314,1,22,7,3,75,35,40,73
FC Basel,8314,2,16,9,7,52,29,23,57
St Gallen,8314,3,14,4,14,44,54,-10,46
Lucerne,8314,4,12,8,12,43,46,-3,44
FC Zürich,8314,5,11,10,11,43,38,5,43
Grasshoppers,8314,6,11,6,15,42,50,-8,39
FC Thun,8314,7,11,5,16,49,62,-13,38
FC Lugano,8314,8,10,6,16,32,50,-18,36
FC Sion,8314,9,5,9,18,42,58,-16,24
Young Boys,8315,1,21,6,5,70,37,33,69
FC Basel,8315,2,17,7,8,53,26,27,58
Lucerne,8315,3,13,9,10,43,43,0,48
St Gallen,8315,4,15,3,14,45,56,-11,48
FC Zürich,8315,5,11,11,10,40,33,7,44
Grasshoppers,8315,6,10,7,15,42,46,-4,37
FC Lugano,8315,7,10,6,16,31,49,-18,36
FC Thun,8315,8,8,7,17,39,59,-20,31
FC Sion,8315,9,6,10,16,39,53,-14,28
Young Boys,8316,1,24,6,2,76,34,42,78
FC Basel,8316,2,17,7,8,51,28,23,58
St Gallen,8316,3,16,2,14,48,52,-4,50
FC Zürich,8316,4,13,9,10,47,34,13,48
Lucerne,8316,5,12,8,12,41,46,-5,44
Grasshoppers,8316,6,10,7,15,42,47,-5,37
FC Lugano,8316,7,9,5,18,29,52,-23,32
FC Thun,8316,8,8,6,18,42,65,-23,30
FC Sion,8316,9,6,8,18,41,59,-18,26
Young Boys,8317,1,21,8,3,68,34,34,71
FC Basel,8317,2,20,7,5,57,24,33,67
St Gallen,8317,3,15,2,15,45,57,-12,47
FC Zürich,8317,4,12,9,11,45,36,9,45
Lucerne,8317,5,12,8,12,40,43,-3,44
Grasshoppers,8317,6,10,6,16,42,50,-8,36
FC Lugano,8317,7,9,5,18,28,51,-23,32
FC Sion,8317,8,7,9,16,43,53,-10,30
FC Thun,8317,9,8,6,18,39,59,-20,30
Young Boys,8318,1,22,7,3,72,36,36,73
FC Basel,8318,2,18,7,7,58,25,33,61
Lucerne,8318,3,15,8,9,44,40,4,53
St Gallen,8318,4,15,2,15,40,51,-11,47
FC Zürich,8318,5,9,10,13,40,39,1,37
Grasshoppers,8318,6,10,6,16,43,48,-5,36
FC Thun,8318,7,10,5,17,46,68,-22,35
FC Lugano,8318,8,9,6,17,30,50,-20,33
FC Sion,8318,9,7,7,18,41,57,-16,28
Young Boys,8319,1,21,7,4,72,35,37,70
FC Basel,8319,2,17,9,6,58,29,29,60
FC Lugano,8319,3,13,5,14,36,44,-8,44
Lucerne,8319,4,12,8,12,39,48,-9,44
St Gallen,8319,5,14,2,16,46,60,-14,44
FC Zürich,8319,6,10,10,12,39,40,-1,40
FC Thun,8319,7,11,5,16,48,58,-10,38
Grasshoppers,8319,8,9,7,16,42,50,-8,34
FC Sion,8319,9,7,7,18,40,56,-16,28
Young Boys,8320,1,21,7,4,69,36,33,70
FC Basel,8320,2,17,9,6,52,25,27,60
Lucerne,8320,3,13,9,10,40,40,0,48
St Gallen,8320,4,14,5,13,40,50,-10,47
FC Zürich,8320,5,11,11,10,41,33,8,44
FC Lugano,8320,6,10,7,15,32,46,-14,37
Grasshoppers,8320,7,9,7,16,42,49,-7,34
FC Sion,8320,8,7,8,17,39,51,-12,29
FC Thun,8320,9,8,5,19,42,67,-25,29
Young Boys,8321,1,20,8,4,72,39,33,68
FC Basel,8321,2,17,9,6,54,26,28,60
Lucerne,8321,3,14,7,11,42,43,-1,49
St Gallen,8321,4,14,3,15,43,55,-12,45
FC Zürich,8321,5,10,10,12,41,41,0,40
Grasshoppers,8321,6,11,6,15,45,46,-1,39
FC Lugano,8321,7,10,6,16,32,48,-16,36
FC Sion,8321,8,9,7,16,42,55,-13,34
FC Thun,8321,9,8,6,18,41,59,-18,30
Young Boys,8322,1,22,8,2,73,30,43,74
FC Basel,8322,2,17,9,6,55,27,28,60
Lucerne,8322,3,13,9,10,42,42,0,48
St Gallen,8322,4,13,5,14,43,55,-12,44
FC Zürich,8322,5,10,10,12,39,37,2,40
FC Lugano,8322,6,10,6,16,29,47,-18,36
FC Thun,8322,7,9,7,16,41,56,-15,34
Grasshoppers,8322,8,9,6,17,39,51,-12,33
FC Sion,8322,9,7,8,17,39,55,-16,29
Young Boys,8323,1,22,6,4,70,34,36,72
FC Basel,8323,2,18,7,7,57,26,31,61
St Gallen,8323,3,17,2,13,46,51,-5,53
Lucerne,8323,4,13,8,11,43,44,-1,47
FC Zürich,8323,5,10,10,12,39,38,1,40
FC Thun,8323,6,11,5,16,47,60,-13,38
Grasshoppers,8323,7,10,6,16,44,52,-8,36
FC Lugano,8323,8,9,7,16,33,50,-17,34
FC Sion,8323,9,5,7,20,36,60,-24,22
Young Boys,8324,1,23,6,3,75,38,37,75
FC Basel,8324,2,18,7,7,57,32,25,61
St Gallen,8324,3,14,3,15,47,57,-10,45
Lucerne,8324,4,12,8,12,44,47,-3,44
FC Zürich,8324,5,10,10,12,44,41,3,40
FC Thun,8324,6,11,5,16,44,56,-12,38
Grasshoppers,8324,7,10,6,16,42,51,-9,36
FC Lugano,8324,8,10,6,16,30,47,-17,36
FC Sion,8324,9,7,7,18,44,58,-14,28
FC Basel,8325,1,20,7,5,60,24,36,67
Young Boys,8325,2,20,7,5,69,38,31,67
Lucerne,8325,3,13,8,11,45,48,-3,47
FC Zürich,8325,4,11,9,12,39,34,5,42
St Gallen,8325,5,13,3,16,39,57,-18,42
Grasshoppers,8325,6,10,7,15,39,46,-7,37
FC Lugano,8325,7,10,7,15,32,47,-15,37
FC Thun,8325,8,9,6,17,42,59,-17,33
FC Sion,8325,9,7,8,17,40,52,-12,29
Young Boys,8326,1,23,7,2,80,36,44,76
FC Basel,8326,2,16,7,9,52,31,21,55
St Gallen,8326,3,15,4,13,45,53,-8,49
Lucerne,8326,4,13,9,10,41,41,0,48
FC Zürich,8326,5,11,10,11,40,34,6,43
FC Thun,8326,6,10,6,16,42,56,-14,36
FC Lugano,8326,7,10,6,16,29,49,-20,36
Grasshoppers,8326,8,9,7,16,39,51,-12,34
FC Sion,8326,9,5,8,19,40,57,-17,23
Young Boys,8327,1,22,7,3,70,33,37,73
FC Basel,8327,2,16,9,7,54,30,24,57
St Gallen,8327,3,15,4,13,46,53,-7,49
FC Zürich,8327,4,12,9,11,47,37,10,45
Lucerne,8327,5,12,9,11,41,45,-4,45
FC Thun,8327,6,11,6,15,48,56,-8,39
Grasshoppers,8327,7,9,7,16,42,49,-7,34
FC Lugano,8327,8,9,6,17,31,52,-21,33
FC Sion,8327,9,6,7,19,36,60,-24,25
Young Boys,8328,1,22,6,4,68,35,33,72
FC Basel,8328,2,19,8,5,59,23,36,65
St Gallen,8328,3,15,3,14,42,53,-11,48
Lucerne,8328,4,13,8,11,43,44,-1,47
FC Zürich,8328,5,9,11,12,37,39,-2,38
FC Lugano,8328,6,10,6,16,28,44,-16,36
Grasshoppers,8328,7,9,6,17,43,57,-14,33
FC Thun,8328,8,9,5,18,45,61,-16,32
FC Sion,8328,9,7,9,16,44,53,-9,30
Young Boys,8329,1,22,8,2,73,35,38,74
FC Basel,8329,2,15,8,9,50,33,17,53
St Gallen,8329,3,14,3,15,44,55,-11,45
FC Zürich,8329,4,11,10,11,45,40,5,43
Lucerne,8329,5,11,10,11,42,45,-3,43
FC Lugano,8329,6,12,5,15,34,45,-11,41
FC Thun,8329,7,10,6,16,45,58,-13,36
Grasshoppers,8329,8,8,9,15,39,50,-11,33
FC Sion,8329,9,7,9,16,46,57,-11,30
Young Boys,8330,1,22,7,3,71,33,38,73
FC Basel,8330,2,17,9,6,51,25,26,60
St Gallen,8330,3,14,4,14,43,54,-11,46
Lucerne,8330,4,12,9,11,40,43,-3,45
FC Lugano,8330,5,11,6,15,32,46,-14,39
Grasshoppers,8330,6,10,8,14,44,49,-5,38
FC Zürich,8330,7,9,10,13,39,39,0,37
FC Thun,8330,8,10,6,16,44,57,-13,36
FC Sion,8330,9,6,7,19,40,58,-18,25
Young Boys,8331,1,21,9,2,73,33,40,72
FC Basel,8331,2,17,9,6,55,25,30,60
Lucerne,8331,3,13,10,9,47,44,3,49
St Gallen,8331,4,13,3,16,43,57,-14,42
FC Zürich,8331,5,10,10,12,42,39,3,40
FC Lugano,8331,6,10,6,16,34,54,-20,36
Grasshoppers,8331,7,9,7,16,41,51,-10,34
FC Thun,8331,8,9,6,17,43,63,-20,33
FC Sion,8331,9,8,8,16,41,53,-12,32
Young Boys,8332,1,21,7,4,67,37,30,70
FC Basel,8332,2,19,8,5,56,26,30,65
Lucerne,8332,3,13,7,12,43,45,-2,46
St Gallen,8332,4,14,3,15,46,57,-11,45
FC Zürich,8332,5,10,11,11,42,38,4,41
Grasshoppers,8332,6,11,6,15,46,47,-1,39
FC Lugano,8332,7,10,7,15,31,47,-16,37
FC Thun,8332,8,9,5,18,42,60,-18,32
FC Sion,8332,9,6,8,18,44,60,-16,26
Young Boys,8333,1,22,6,4,74,39,35,72
FC Basel,8333,2,17,10,5,56,25,31,61
St Gallen,8333,3,14,4,14,42,54,-12,46
Lucerne,8333,4,12,9,11,41,43,-2,45
FC Zürich,8333,5,11,11,10,40,33,7,44
Grasshoppers,8333,6,10,7,15,45,49,-4,37
FC Thun,8333,7,9,7,16,41,58,-17,34
FC Lugano,8333,8,9,7,16,29,49,-20,34
FC Sion,8333,9,6,7,19,38,56,-18,25
Young Boys,8334,1,21,7,4,72,38,34,70
FC Basel,8334,2,18,8,6,52,24,28,62
Lucerne,8334,3,13,7,12,44,43,1,46
St Gallen,8334,4,14,3,15,43,56,-13,45
FC Zürich,8334,5,11,11,10,44,35,9,44
Grasshoppers,8334,6,10,8,14,46,50,-4,38
FC Lugano,8334,7,10,6,16,31,52,-21,36
FC Thun,8334,8,9,7,16,44,58,-14,34
FC Sion,8334,9,5,9,18,39,59,-20,24
Young Boys,8335,1,21,6,5,71,36,35,69
FC Basel,8335,2,19,8,5,55,24,31,65
St Gallen,8335,3,15,3,14,41,52,-11,48
Lucerne,8335,4,13,7,12,41,42,-1,46
FC Zürich,8335,5,11,9,12,41,39,2,42
Grasshoppers,8335,6,10,7,15,41,49,-8,37
FC Thun,8335,7,9,6,17,44,59,-15,33
FC Lugano,8335,8,9,5,18,28,51,-23,32
FC Sion,8335,9,8,7,17,45,55,-10,31
Young Boys,8336,1,22,7,3,75,37,38,73
FC Basel,8336,2,20,7,5,59,26,33,67
St Gallen,8336,3,15,3,14,43,52,-9,48
Lucerne,8336,4,11,8,13,42,49,-7,41
Grasshoppers,8336,5,11,7,14,45,50,-5,40
FC Zürich,8336,6,9,10,13,41,42,-1,37
FC Lugano,8336,7,10,6,16,34,51,-17,36
FC Thun,8336,8,9,6,17,43,59,-16,33
FC Sion,8336,9,5,10,17,40,56,-16,25
Young Boys,8337,1,23,7,2,74,33,41,76
FC Basel,8337,2,17,8,7,51,24,27,59
Lucerne,8337,3,15,7,10,44,43,1,52
St Gallen,8337,4,15,2,15,41,53,-12,47
FC Zürich,8337,5,11,9,12,38,34,4,42
FC Lugano,8337,6,11,5,16,31,47,-16,38
Grasshoppers,8337,7,9,7,16,42,51,-9,34
FC Thun,8337,8,8,6,18,40,60,-20,30
FC Sion,8337,9,6,7,19,40,56,-16,25
Young Boys,8338,1,21,8,3,70,35,35,71
FC Basel,8338,2,17,8,7,55,29,26,59
Lucerne,8338,3,13,9,10,46,45,1,48
St Gallen,8338,4,14,5,13,45,54,-9,47
FC Zürich,8338,5,10,10,12,42,41,1,40
FC Thun,8338,6,10,7,15,42,54,-12,37
FC Lugano,8338,7,9,8,15,31,48,-17,35
Grasshoppers,8338,8,8,9,15,39,49,-10,33
FC Sion,8338,9,5,10,17,41,56,-15,25
Young Boys,8339,1,23,6,3,79,35,44,75
FC Basel,8339,2,18,7,7,57,27,30,61
Lucerne,8339,3,13,8,11,44,49,-5,47
St Gallen,8339,4,14,2,16,42,58,-16,44
Grasshoppers,8339,5,11,6,15,42,49,-7,39
FC Lugano,8339,6,11,6,15,33,47,-14,39
FC Zürich,8339,7,9,9,14,38,40,-2,36
FC Thun,8339,8,10,5,17,47,62,-15,35
FC Sion,8339,9,7,7,18,41,56,-15,28
Young Boys,8340,1,22,6,4,71,36,35,72
FC Basel,8340,2,18,9,5,59,26,33,63
FC Zürich,8340,3,11,11,10,42,36,6,44
Lucerne,8340,4,12,8,12,41,48,-7,44
St Gallen,8340,5,14,2,16,47,62,-15,44
FC Lugano,8340,6,11,6,15,34,49,-15,39
Grasshoppers,8340,7,9,8,15,42,49,-7,35
FC Thun,8340,8,9,7,16,44,59,-15,34
FC Sion,8340,9,6,7,19,43,58,-15,25
Young Boys,8341,1,21,8,3,72,35,37,71
FC Basel,8341,2,18,9,5,58,25,33,63
St Gallen,8341,3,15,4,13,42,50,-8,49
Lucerne,8341,4,13,7,12,40,44,-4,46
FC Zürich,8341,5,10,11,11,40,37,3,41
Grasshoppers,8341,6,9,7,16,43,54,-11,34
FC Lugano,8341,7,9,7,16,30,47,-17,34
FC Thun,8341,8,8,8,16,44,63,-19,32
FC Sion,8341,9,6,9,17,40,54,-14,27
Young Boys,8342,1,22,6,4,80,37,43,72
FC Basel,8342,2,20,7,5,58,24,34,67
St Gallen,8342,3,16,2,14,45,52,-7,50
Lucerne,8342,4,12,7,13,39,49,-10,43
FC Zürich,8342,5,10,10,12,41,37,4,40
Grasshoppers,8342,6,10,7,15,43,48,-5,37
FC Thun,8342,7,10,6,16,44,58,-14,36
FC Lugano,8342,8,10,5,17,30,51,-21,35
FC Sion,8342,9,5,8,19,38,62,-24,23
Young Boys,8343,1,22,7,3,71,35,36,73
FC Basel,8343,2,17,10,5,55,26,29,61
Lucerne,8343,3,13,7,12,43,45,-2,46
St Gallen,8343,4,14,2,16,43,57,-14,44
FC Zürich,8343,5,10,12,10,38,33,5,42
FC Thun,8343,6,10,7,15,46,57,-11,37
FC Lugano,8343,7,10,6,16,29,49,-20,36
FC Sion,8343,8,8,7,17,44,51,-7,31
Grasshoppers,8343,9,8,6,18,39,55,-16,30
Young Boys,8344,1,22,6,4,73,38,35,72
FC Basel,8344,2,20,7,5,60,26,34,67
Lucerne,8344,3,13,7,12,47,45,2,46
St Gallen,8344,4,14,3,15,43,56,-13,45
FC Zürich,8344,5,10,10,12,40,36,4,40
FC Lugano,8344,6,11,5,16,32,49,-17,38
FC Thun,8344,7,10,5,17,42,61,-19,35
Grasshoppers,8344,8,8,7,17,38,50,-12,31
FC Sion,8344,9,6,10,16,38,52,-14,28
Young Boys,8345,1,22,6,4,71,34,37,72
FC Basel,8345,2,17,8,7,53,26,27,59
St Gallen,8345,3,16,2,14,46,51,-5,50
FC Zürich,8345,4,11,11,10,47,35,12,44
Lucerne,8345,5,12,7,13,39,47,-8,43
Grasshoppers,8345,6,10,6,16,41,49,-8,36
FC Thun,8345,7,9,7,16,45,58,-13,34
FC Lugano,8345,8,9,6,17,29,54,-25,33
FC Sion,8345,9,8,7,17,42,59,-17,31
Young Boys,8346,1,22,7,3,70,33,37,73
FC Basel,8346,2,18,7,7,54,25,29,61
St Gallen,8346,3,15,3,14,43,54,-11,48
Lucerne,8346,4,12,7,13,41,48,-7,43
FC Lugano,8346,5,12,6,14,32,43,-11,42
FC Zürich,8346,6,10,10,12,40,37,3,40
Grasshoppers,8346,7,9,6,17,40,50,-10,33
FC Thun,8346,8,9,5,18,42,59,-17,32
FC Sion,8346,9,7,9,16,41,54,-13,30
Young Boys,8347,1,21,7,4,71,33,38,70
FC Basel,8347,2,19,7,6,52,22,30,64
St Gallen,8347,3,15,3,14,41,51,-10,48
Lucerne,8347,4,12,9,11,40,44,-4,45
FC Zürich,8347,5,11,10,11,40,36,4,43
Grasshoppers,8347,6,11,6,15,45,50,-5,39
FC Lugano,8347,7,10,7,15,34,47,-13,37
FC Thun,8347,8,9,6,17,42,58,-16,33
FC Sion,8347,9,5,7,20,36,60,-24,22
Young Boys,8348,1,24,6,2,79,35,44,78
FC Basel,8348,2,18,7,7,54,28,26,61
Lucerne,8348,3,14,7,11,42,46,-4,49
St Gallen,8348,4,13,4,15,43,56,-13,43
FC Lugano,8348,5,11,6,15,33,45,-12,39
FC Zürich,8348,6,9,9,14,38,41,-3,36
FC Thun,8348,7,10,6,16,43,57,-14,36
Grasshoppers,8348,8,8,7,17,42,55,-13,31
FC Sion,8348,9,7,8,17,44,55,-11,29
Young Boys,8349,1,21,8,3,72,36,36,71
FC Basel,8349,2,17,10,5,54,27,27,61
St Gallen,8349,3,16,2,14,43,52,-9,50
Lucerne,8349,4,12,9,11,44,45,-1,45
FC Zürich,8349,5,10,10,12,42,41,1,40
FC Lugano,8349,6,10,5,17,33,48,-15,35
FC Thun,8349,7,9,7,16,42,57,-15,34
Grasshoppers,8349,8,8,9,15,39,48,-9,33
FC Sion,8349,9,7,8,17,41,56,-15,29
Young Boys,8350,1,22,7,3,71,31,40,73
FC Basel,8350,2,17,10,5,55,25,30,61
Lucerne,8350,3,13,8,11,43,47,-4,47
FC Zürich,8350,4,11,11,10,43,36,7,44
St Gallen,8350,5,13,3,16,42,57,-15,42
FC Lugano,8350,6,10,6,16,32,50,-18,36
Grasshoppers,8350,7,9,7,16,39,49,-10,34
FC Thun,8350,8,9,6,17,46,63,-17,33
FC Sion,8350,9,6,10,16,38,51,-13,28
Young Boys,8351,1,22,6,4,74,37,37,72
FC Basel,8351,2,18,8,6,56,25,31,62
St Gallen,8351,3,14,4,14,43,55,-12,46
FC Zürich,8351,4,11,10,11,44,37,7,43
Lucerne,8351,5,12,7,13,39,44,-5,43
Grasshoppers,8351,6,11,6,15,47,51,-4,39
FC Thun,8351,7,10,5,17,46,61,-15,35
FC Lugano,8351,8,9,7,16,30,50,-20,34
FC Sion,8351,9,7,7,18,41,60,-19,28
Young Boys,8352,1,22,7,3,71,31,40,73
FC Basel,8352,2,15,8,9,49,29,20,53
St Gallen,8352,3,15,3,14,45,55,-10,48
Lucerne,8352,4,12,9,11,40,43,-3,45
FC Zürich,8352,5,11,9,12,39,36,3,42
FC Thun,8352,6,12,5,15,49,57,-8,41
FC Lugano,8352,7,10,6,16,32,49,-17,36
Grasshoppers,8352,8,8,9,15,40,51,-11,33
FC Sion,8352,9,7,8,17,41,55,-14,29
Young Boys,8353,1,21,8,3,73,37,36,71
FC Basel,8353,2,18,9,5,54,24,30,63
St Gallen,8353,3,14,4,14,43,54,-11,46
Lucerne,8353,4,12,8,12,42,47,-5,44
FC Zürich,8353,5,9,12,11,36,34,2,39
FC Lugano,8353,6,10,7,15,32,46,-14,37
FC Thun,8353,7,10,6,16,44,55,-11,36
Grasshoppers,8353,8,9,7,16,42,51,-9,34
FC Sion,8353,9,6,9,17,38,56,-18,27
Young Boys,8354,1,20,9,3,67,34,33,69
FC Basel,8354,2,17,9,6,49,23,26,60
Lucerne,8354,3,13,8,11,42,42,0,47
FC Zürich,8354,4,12,10,10,51,36,15,46
St Gallen,8354,5,14,4,14,43,54,-11,46
Grasshoppers,8354,6,9,8,15,43,51,-8,35
FC Thun,8354,7,10,5,17,47,60,-13,35
FC Lugano,8354,8,9,7,16,29,49,-20,34
FC Sion,8354,9,5,10,17,40,62,-22,25
Young Boys,8355,1,22,7,3,72,35,37,73
FC Basel,8355,2,18,7,7,52,28,24,61
Lucerne,8355,3,13,9,10,43,40,3,48
St Gallen,8355,4,14,3,15,43,55,-12,45
FC Zürich,8355,5,9,11,12,40,40,0,38
FC Lugano,8355,6,9,8,15,32,48,-16,35
FC Thun,8355,7,9,7,16,42,56,-14,34
Grasshoppers,8355,8,8,8,16,40,52,-12,32
FC Sion,8355,9,7,10,15,41,51,-10,31
Young Boys,8356,1,22,7,3,72,36,36,73
FC Basel,8356,2,17,10,5,51,24,27,61
Lucerne,8356,3,12,9,11,40,43,-3,45
St Gallen,8356,4,14,2,16,42,56,-14,44
FC Zürich,8356,5,11,9,12,41,37,4,42
FC Sion,8356,6,10,7,15,48,52,-4,37
FC Lugano,8356,7,10,5,17,33,49,-16,35
FC Thun,8356,8,9,6,17,44,62,-18,33
Grasshoppers,8356,9,8,7,17,42,54,-12,31
Young Boys,8357,1,21,9,2,71,32,39,72
FC Basel,8357,2,16,10,6,53,26,27,58
Lucerne,8357,3,13,9,10,42,42,0,48
St Gallen,8357,4,15,3,14,42,52,-10,48
FC Zürich,8357,5,9,12,11,42,40,2,39
Grasshoppers,8357,6,9,8,15,42,49,-7,35
FC Lugano,8357,7,9,7,16,29,46,-17,34
FC Thun,8357,8,9,6,17,43,61,-18,33
FC Sion,8357,9,7,8,17,41,57,-16,29
Young Boys,8358,1,22,8,2,79,37,42,74
FC Basel,8358,2,18,8,6,53,24,29,62
Lucerne,8358,3,13,8,11,43,49,-6,47
St Gallen,8358,4,14,4,14,42,53,-11,46
FC Zürich,8358,5,12,9,11,42,37,5,45
Grasshoppers,8358,6,9,7,16,44,51,-7,34
FC Lugano,8358,7,9,7,16,31,48,-17,34
FC Thun,8358,8,9,5,18,42,60,-18,32
FC Sion,8358,9,6,8,18,40,57,-17,26
Young Boys,8359,1,22,7,3,70,33,37,73
FC Basel,8359,2,18,7,7,51,24,27,61
Lucerne,8359,3,14,8,10,44,44,0,50
FC Zürich,8359,4,12,9,11,42,36,6,45
St Gallen,8359,5,13,3,16,41,58,-17,42
FC Lugano,8359,6,11,6,15,33,45,-12,39
Grasshoppers,8359,7,9,7,16,41,50,-9,34
FC Thun,8359,8,9,5,18,47,61,-14,32
FC Sion,8359,9,6,8,18,43,61,-18,26
Young Boys,8360,1,22,6,4,75,37,38,72
FC Basel,8360,2,18,9,5,57,24,33,63
St Gallen,8360,3,16,3,13,45,52,-7,51
FC Zürich,8360,4,11,10,11,44,36,8,43
Lucerne,8360,5,11,9,12,39,48,-9,42
Grasshoppers,8360,6,9,7,16,40,49,-9,34
FC Lugano,8360,7,9,6,17,31,50,-19,33
FC Thun,8360,8,9,5,18,42,62,-20,32
FC Sion,8360,9,8,7,17,41,56,-15,31
Young Boys,8361,1,22,7,3,75,33,42,73
FC Basel,8361,2,17,9,6,61,26,35,60
St Gallen,8361,3,15,4,13,46,55,-9,49
Lucerne,8361,4,11,10,11,38,44,-6,43
FC Zürich,8361,5,10,10,12,40,36,4,40
FC Lugano,8361,6,10,7,15,32,51,-19,37
Grasshoppers,8361,7,8,9,15,40,49,-9,33
FC Sion,8361,8,8,8,16,44,52,-8,32
FC Thun,8361,9,8,6,18,43,73,-30,30
Young Boys,8362,1,21,8,3,72,38,34,71
FC Basel,8362,2,18,8,6,55,25,30,62
St Gallen,8362,3,16,3,13,43,51,-8,51
FC Zürich,8362,4,11,10,11,39,34,5,43
Lucerne,8362,5,11,8,13,38,43,-5,41
FC Thun,8362,6,10,5,17,48,63,-15,35
FC Lugano,8362,7,10,5,17,29,46,-17,35
Grasshoppers,8362,8,9,7,16,44,52,-8,34
FC Sion,8362,9,6,10,16,40,56,-16,28
Young Boys,8363,1,22,7,3,76,33,43,73
FC Basel,8363,2,19,7,6,60,26,34,64
Lucerne,8363,3,13,9,10,47,46,1,48
FC Zürich,8363,4,12,10,10,46,36,10,46
St Gallen,8363,5,13,3,16,39,56,-17,42
FC Lugano,8363,6,10,6,16,30,52,-22,36
Grasshoppers,8363,7,9,7,16,41,51,-10,34
FC Thun,8363,8,9,6,17,44,64,-20,33
FC Sion,8363,9,6,7,19,40,59,-19,25
Young Boys,8364,1,20,8,4,69,39,30,68
FC Basel,8364,2,20,7,5,59,25,34,67
Lucerne,8364,3,12,9,11,42,45,-3,45
FC Zürich,8364,4,11,9,12,47,40,7,42
St Gallen,8364,5,13,3,16,42,57,-15,42
Grasshoppers,8364,6,11,6,15,44,51,-7,39
FC Thun,8364,7,11,5,16,48,58,-10,38
FC Lugano,8364,8,10,7,15,34,49,-15,37
FC Sion,8364,9,5,8,19,38,59,-21,23
Young Boys,8365,1,20,8,4,71,38,33,68
FC Basel,8365,2,19,8,5,61,27,34,65
St Gallen,8365,3,15,2,15,44,54,-10,47
Lucerne,8365,4,12,7,13,40,45,-5,43
FC Zürich,8365,5,10,9,13,39,39,0,39
FC Lugano,8365,6,11,6,15,33,46,-13,39
Grasshoppers,8365,7,10,7,15,45,49,-4,37
FC Thun,8365,8,10,6,16,42,58,-16,36
FC Sion,8365,9,7,7,18,40,59,-19,28
Young Boys,8366,1,22,7,3,73,35,38,73
FC Basel,8366,2,17,8,7,53,26,27,59
Lucerne,8366,3,12,8,12,39,45,-6,44
St Gallen,8366,4,13,4,15,38,52,-14,43
FC Zürich,8366,5,11,9,12,40,36,4,42
FC Lugano,8366,6,12,5,15,32,44,-12,41
FC Thun,8366,7,10,6,16,44,57,-13,36
FC Sion,8366,8,8,8,16,41,53,-12,32
Grasshoppers,8366,9,8,7,17,41,53,-12,31
Young Boys,8367,1,19,9,4,67,35,32,66
FC Basel,8367,2,18,9,5,56,24,32,63
St Gallen,8367,3,14,4,14,45,57,-12,46
Lucerne,8367,4,12,9,11,46,49,-3,45
FC Zürich,8367,5,11,10,11,40,34,6,43
FC Lugano,8367,6,11,6,15,33,46,-13,39
FC Thun,8367,7,10,6,16,43,60,-17,36
Grasshoppers,8367,8,9,8,15,43,51,-8,35
FC Sion,8367,9,5,9,18,37,54,-17,24
Young Boys,8368,1,23,6,3,76,35,41,75
FC Basel,8368,2,16,8,8,50,27,23,56
St Gallen,8368,3,16,2,14,44,53,-9,50
Lucerne,8368,4,14,7,11,44,41,3,49
FC Zürich,8368,5,11,11,10,42,36,6,44
Grasshoppers,8368,6,10,6,16,42,57,-15,36
FC Thun,8368,7,9,7,16,44,58,-14,34
FC Lugano,8368,8,9,5,18,30,52,-22,32
FC Sion,8368,9,6,8,18,43,56,-13,26
Young Boys,8369,1,22,7,3,76,34,42,73
FC Basel,8369,2,17,10,5,53,25,28,61
Lucerne,8369,3,12,8,12,42,47,-5,44
St Gallen,8369,4,13,4,15,41,54,-13,43
FC Zürich,8369,5,10,11,11,39,35,4,41
FC Lugano,8369,6,12,5,15,34,48,-14,41
Grasshoppers,8369,7,9,8,15,41,49,-8,35
FC Thun,8369,8,9,7,16,40,56,-16,34
FC Sion,8369,9,5,10,17,37,55,-18,25
Young Boys,8370,1,23,7,2,75,36,39,76
FC Basel,8370,2,17,8,7,57,28,29,59
St Gallen,8370,3,15,3,14,43,53,-10,48
Lucerne,8370,4,12,9,11,37,39,-2,45
FC Zürich,8370,5,11,11,10,43,36,7,44
FC Thun,8370,6,10,6,16,44,62,-18,36
Grasshoppers,8370,7,9,7,16,39,48,-9,34
FC Lugano,8370,8,9,6,17,30,50,-20,33
FC Sion,8370,9,5,9,18,40,56,-16,24
Young Boys,8371,1,21,8,3,74,37,37,71
FC Basel,8371,2,17,9,6,57,27,30,60
Lucerne,8371,3,14,8,10,44,44,0,50
St Gallen,8371,4,14,3,15,41,55,-14,45
FC Zürich,8371,5,11,10,11,43,39,4,43
Grasshoppers,8371,6,10,7,15,47,51,-4,37
FC Lugano,8371,7,10,5,17,30,48,-18,35
FC Thun,8371,8,8,8,16,43,61,-18,32
FC Sion,8371,9,5,10,17,40,57,-17,25
Young Boys,8372,1,20,8,4,70,37,33,68
FC Basel,8372,2,15,8,9,48,29,19,53
Lucerne,8372,3,14,9,9,50,43,7,51
St Gallen,8372,4,15,3,14,45,55,-10,48
FC Zürich,8372,5,12,10,10,47,37,10,46
FC Lugano,8372,6,11,6,15,34,50,-16,39
Grasshoppers,8372,7,9,8,15,41,51,-10,35
FC Thun,8372,8,9,7,16,46,62,-16,34
FC Sion,8372,9,5,9,18,38,55,-17,24
Young Boys,8373,1,20,6,6,66,36,30,66
FC Basel,8373,2,19,8,5,60,27,33,65
Lucerne,8373,3,14,8,10,41,40,1,50
St Gallen,8373,4,15,3,14,47,54,-7,48
FC Zürich,8373,5,10,10,12,39,38,1,40
Grasshoppers,8373,6,10,7,15,40,48,-8,37
FC Thun,8373,7,10,5,17,45,58,-13,35
FC Lugano,8373,8,9,6,17,30,50,-20,33
FC Sion,8373,9,7,7,18,39,56,-17,28
Young Boys,8374,1,22,7,3,73,35,38,73
FC Basel,8374,2,18,8,6,55,25,30,62
St Gallen,8374,3,14,4,14,44,56,-12,46
Lucerne,8374,4,12,8,12,42,49,-7,44
FC Zürich,8374,5,10,11,11,40,35,5,41
FC Lugano,8374,6,11,6,15,35,48,-13,39
Grasshoppers,8374,7,9,8,15,42,49,-7,35
FC Thun,8374,8,8,7,17,42,60,-18,31
FC Sion,8374,9,5,11,16,38,54,-16,26
Young Boys,8375,1,23,7,2,80,36,44,76
FC Basel,8375,2,17,8,7,52,25,27,59
Lucerne,8375,3,14,7,11,42,45,-3,49
FC Zürich,8375,4,13,9,10,45,33,12,48
St Gallen,8375,5,13,5,14,40,52,-12,44
FC Lugano,8375,6,9,6,17,28,51,-23,33
Grasshoppers,8375,7,8,8,16,42,52,-10,32
FC Thun,8375,8,8,7,17,45,63,-18,31
FC Sion,8375,9,6,9,17,42,59,-17,27
Young Boys,8376,1,22,8,2,69,30,39,74
FC Basel,8376,2,18,8,6,57,27,30,62
Lucerne,8376,3,13,7,12,45,50,-5,46
St Gallen,8376,4,13,3,16,43,58,-15,42
FC Zürich,8376,5,9,11,12,40,40,0,38
Grasshoppers,8376,6,9,9,14,43,49,-6,36
FC Thun,8376,7,10,6,16,48,61,-13,36
FC Lugano,8376,8,10,6,16,31,47,-16,36
FC Sion,8376,9,6,10,16,45,59,-14,28
Young Boys,8377,1,22,8,2,74,35,39,74
FC Basel,8377,2,16,9,7,50,26,24,57
Lucerne,8377,3,13,9,10,41,41,0,48
St Gallen,8377,4,14,4,14,42,53,-11,46
FC Thun,8377,5,12,5,15,46,57,-11,41
FC Zürich,8377,6,9,11,12,38,38,0,38
FC Lugano,8377,7,10,6,16,33,48,-15,36
Grasshoppers,8377,8,9,7,16,41,50,-9,34
FC Sion,8377,9,5,9,18,43,60,-17,24
Young Boys,8378,1,20,7,5,69,36,33,67
FC Basel,8378,2,18,8,6,56,26,30,62
Lucerne,8378,3,14,9,9,47,40,7,51
St Gallen,8378,4,14,3,15,41,55,-14,45
FC Zürich,8378,5,9,11,12,39,38,1,38
FC Lugano,8378,6,11,5,16,31,50,-19,38
FC Thun,8378,7,10,6,16,46,59,-13,36
Grasshoppers,8378,8,9,6,17,41,52,-11,33
FC Sion,8378,9,7,9,16,43,57,-14,30
Young Boys,8379,1,22,7,3,77,38,39,73
FC Basel,8379,2,18,9,5,57,26,31,63
Lucerne,8379,3,13,8,11,44,43,1,47
FC Zürich,8379,4,11,10,11,42,37,5,43
St Gallen,8379,5,13,4,15,42,59,-17,43
FC Lugano,8379,6,10,5,17,38,51,-13,35
FC Sion,8379,7,8,8,16,45,58,-13,32
Grasshoppers,8379,8,8,8,16,41,55,-14,32
FC Thun,8379,9,8,7,17,42,61,-19,31
Young Boys,8380,1,23,6,3,75,33,42,75
FC Basel,8380,2,18,8,6,53,26,27,62
Lucerne,8380,3,13,9,10,41,42,-1,48
St Gallen,8380,4,14,3,15,44,56,-12,45
FC Zürich,8380,5,11,9,12,46,39,7,42
Grasshoppers,8380,6,10,7,15,44,52,-8,37
FC Lugano,8380,7,10,5,17,33,52,-19,35
FC Thun,8380,8,9,5,18,44,61,-17,32
FC Sion,8380,9,6,8,18,39,58,-19,26
Young Boys,8381,1,24,6,2,72,30,42,78
FC Basel,8381,2,18,8,6,56,26,30,62
Lucerne,8381,3,13,8,11,43,44,-1,47
St Gallen,8381,4,13,4,15,42,60,-18,43
FC Zürich,8381,5,9,11,12,40,38,2,38
Grasshoppers,8381,6,10,6,16,42,51,-9,36
FC Lugano,8381,7,10,6,16,30,45,-15,36
FC Thun,8381,8,9,7,16,44,57,-13,34
FC Sion,8381,9,6,8,18,39,57,-18,26
Young Boys,8382,1,21,7,4,71,37,34,70
FC Basel,8382,2,19,8,5,62,24,38,65
Lucerne,8382,3,14,8,10,47,45,2,50
St Gallen,8382,4,14,3,15,48,60,-12,45
FC Zürich,8382,5,11,9,12,41,36,5,42
Grasshoppers,8382,6,10,8,14,41,47,-6,38
FC Lugano,8382,7,9,5,18,29,54,-25,32
FC Sion,8382,8,8,7,17,44,53,-9,31
FC Thun,8382,9,8,5,19,39,66,-27,29
Young Boys,8383,1,22,6,4,69,34,35,72
FC Basel,8383,2,18,8,6,53,25,28,62
Lucerne,8383,3,14,7,11,42,41,1,49
St Gallen,8383,4,14,3,15,42,56,-14,45
FC Zürich,8383,5,11,9,12,40,35,5,42
Grasshoppers,8383,6,10,7,15,40,47,-7,37
FC Lugano,8383,7,9,6,17,31,51,-20,33
FC Sion,8383,8,8,7,17,41,52,-11,31
FC Thun,8383,9,8,7,17,41,58,-17,31
Young Boys,8384,1,22,7,3,74,36,38,73
FC Basel,8384,2,17,10,5,53,26,27,61
Lucerne,8384,3,13,8,11,43,45,-2,47
FC Zürich,8384,4,11,10,11,43,37,6,43
St Gallen,8384,5,13,3,16,41,56,-15,42
Grasshoppers,8384,6,11,7,14,48,48,0,40
FC Lugano,8384,7,11,5,16,31,44,-13,38
FC Thun,8384,8,9,5,18,44,65,-21,32
FC Sion,8384,9,6,7,19,40,60,-20,25
Young Boys,8385,1,20,7,5,68,37,31,67
FC Basel,8385,2,18,8,6,55,25,30,62
Lucerne,8385,3,14,8,10,44,42,2,50
St Gallen,8385,4,13,4,15,40,55,-15,43
FC Zürich,8385,5,10,11,11,39,35,4,41
Grasshoppers,8385,6,10,7,15,42,48,-6,37
FC Lugano,8385,7,9,8,15,28,44,-16,35
FC Thun,8385,8,10,5,17,45,62,-17,35
FC Sion,8385,9,6,10,16,41,54,-13,28
Young Boys,8386,1,24,6,2,78,33,45,78
FC Basel,8386,2,18,8,6,56,26,30,62
St Gallen,8386,3,14,3,15,44,58,-14,45
FC Zürich,8386,4,11,10,11,42,37,5,43
Lucerne,8386,5,12,7,13,41,48,-7,43
Grasshoppers,8386,6,11,6,15,43,47,-4,39
FC Lugano,8386,7,9,7,16,30,51,-21,34
FC Thun,8386,8,9,6,17,43,60,-17,33
FC Sion,8386,9,6,7,19,40,57,-17,25
Young Boys,8387,1,20,8,4,69,38,31,68
FC Basel,8387,2,18,8,6,55,27,28,62
FC Zürich,8387,3,12,9,11,42,39,3,45
Lucerne,8387,4,12,8,12,42,47,-5,44
St Gallen,8387,5,14,2,16,44,58,-14,44
Grasshoppers,8387,6,10,8,14,41,46,-5,38
FC Lugano,8387,7,10,5,17,33,50,-17,35
FC Thun,8387,8,9,7,16,44,59,-15,34
FC Sion,8387,9,8,7,17,45,51,-6,31
Young Boys,8388,1,22,7,3,72,35,37,73
FC Basel,8388,2,19,7,6,55,24,31,64
Lucerne,8388,3,13,8,11,43,47,-4,47
FC Zürich,8388,4,12,10,10,44,37,7,46
St Gallen,8388,5,14,4,14,49,55,-6,46
FC Lugano,8388,6,9,6,17,31,50,-19,33
Grasshoppers,8388,7,8,8,16,44,54,-10,32
FC Thun,8388,8,8,6,18,41,60,-19,30
FC Sion,8388,9,7,8,17,43,60,-17,29
Young Boys,8389,1,22,8,2,72,31,41,74
FC Basel,8389,2,17,7,8,53,27,26,58
St Gallen,8389,3,15,3,14,43,53,-10,48
Lucerne,8389,4,12,8,12,40,47,-7,44
FC Thun,8389,5,11,5,16,46,57,-11,38
FC Zürich,8389,6,9,10,13,39,40,-1,37
FC Lugano,8389,7,9,9,14,31,46,-15,36
Grasshoppers,8389,8,9,6,17,39,52,-13,33
FC Sion,8389,9,8,8,16,42,52,-10,32
Young Boys,8390,1,23,6,3,72,35,37,75
FC Basel,8390,2,17,7,8,51,26,25,58
St Gallen,8390,3,15,4,13,48,55,-7,49
Lucerne,8390,4,12,8,12,42,49,-7,44
FC Zürich,8390,5,10,9,13,38,38,0,39
FC Thun,8390,6,11,5,16,49,58,-9,38
FC Lugano,8390,7,10,7,15,29,44,-15,37
Grasshoppers,8390,8,9,6,17,39,50,-11,33
FC Sion,8390,9,7,8,17,44,57,-13,29
Young Boys,8391,1,22,7,3,70,34,36,73
FC Basel,8391,2,17,8,7,52,29,23,59
Lucerne,8391,3,13,7,12,46,45,1,46
St Gallen,8391,4,14,4,14,42,53,-11,46
FC Zürich,8391,5,10,10,12,44,40,4,40
Grasshoppers,8391,6,10,7,15,41,48,-7,37
FC Lugano,8391,7,10,6,16,31,50,-19,36
FC Thun,8391,8,9,6,17,43,61,-18,33
FC Sion,8391,9,7,9,16,44,53,-9,30
Young Boys,8392,1,21,9,2,72,34,38,72
FC Basel,8392,2,17,10,5,57,26,31,61
St Gallen,8392,3,15,3,14,43,54,-11,48
Lucerne,8392,4,12,8,12,42,50,-8,44
FC Zürich,8392,5,10,11,11,42,37,5,41
FC Thun,8392,6,9,8,15,43,57,-14,35
Grasshoppers,8392,7,8,9,15,40,49,-9,33
FC Lugano,8392,8,9,5,18,30,51,-21,32
FC Sion,8392,9,6,11,15,40,51,-11,29
Young Boys,8393,1,22,7,3,70,33,37,73
FC Basel,8393,2,16,11,5,53,25,28,59
St Gallen,8393,3,16,3,13,46,54,-8,51
Lucerne,8393,4,12,7,13,40,46,-6,43
FC Zürich,8393,5,9,11,12,41,39,2,38
Grasshoppers,8393,6,10,6,16,39,47,-8,36
FC Thun,8393,7,10,6,16,45,59,-14,36
FC Lugano,8393,8,10,5,17,29,46,-17,35
FC Sion,8393,9,7,8,17,41,55,-14,29
Young Boys,8394,1,22,6,4,73,36,37,72
FC Basel,8394,2,18,7,7,53,24,29,61
Lucerne,8394,3,15,7,10,43,41,2,52
FC Zürich,8394,4,12,9,11,42,34,8,45
St Gallen,8394,5,14,3,15,43,53,-10,45
Grasshoppers,8394,6,10,6,16,42,53,-11,36
FC Thun,8394,7,9,6,17,47,64,-17,33
FC Lugano,8394,8,9,5,18,29,50,-21,32
FC Sion,8394,9,6,9,17,40,57,-17,27
Young Boys,8395,1,21,8,3,72,35,37,71
FC Basel,8395,2,17,8,7,55,29,26,59
FC Zürich,8395,3,13,9,10,43,34,9,48
Lucerne,8395,4,13,8,11,39,43,-4,47
St Gallen,8395,5,14,2,16,43,57,-14,44
FC Thun,8395,6,10,5,17,42,58,-16,35
FC Lugano,8395,7,10,5,17,30,47,-17,35
Grasshoppers,8395,8,8,9,15,38,47,-9,33
FC Sion,8395,9,7,8,17,41,53,-12,29
Young Boys,8396,1,21,8,3,72,34,38,71
FC Basel,8396,2,17,9,6,54,28,26,60
FC Zürich,8396,3,13,9,10,44,34,10,48
St Gallen,8396,4,14,4,14,42,55,-13,46
Lucerne,8396,5,12,8,12,48,47,1,44
FC Lugano,8396,6,11,5,16,35,50,-15,38
Grasshoppers,8396,7,9,7,16,40,53,-13,34
FC Thun,8396,8,8,6,18,39,58,-19,30
FC Sion,8396,9,7,8,17,38,53,-15,29
Young Boys,8397,1,22,7,3,72,35,37,73
FC Basel,8397,2,16,8,8,51,27,24,56
St Gallen,8397,3,16,3,13,46,50,-4,51
Lucerne,8397,4,12,9,11,42,45,-3,45
FC Zürich,8397,5,11,10,11,42,39,3,43
FC Thun,8397,6,10,5,17,44,57,-13,35
FC Lugano,8397,7,9,6,17,29,52,-23,33
Grasshoppers,8397,8,8,8,16,41,51,-10,32
FC Sion,8397,9,8,8,16,40,51,-11,32
Young Boys,8398,1,21,8,3,73,35,38,71
FC Basel,8398,2,17,7,8,52,31,21,58
St Gallen,8398,3,15,2,15,43,55,-12,47
Lucerne,8398,4,11,9,12,39,47,-8,42
FC Zürich,8398,5,10,11,11,42,37,5,41
FC Lugano,8398,6,10,7,15,30,46,-16,37
FC Thun,8398,7,10,6,16,48,58,-10,36
Grasshoppers,8398,8,9,8,15,41,50,-9,35
FC Sion,8398,9,8,8,16,43,52,-9,32
Young Boys,8399,1,23,7,2,78,35,43,76
FC Basel,8399,2,18,7,7,58,28,30,61
Lucerne,8399,3,12,9,11,41,48,-7,45
St Gallen,8399,4,14,3,15,43,54,-11,45
FC Zürich,8399,5,10,10,12,41,38,3,40
FC Thun,8399,6,10,6,16,45,60,-15,36
FC Lugano,8399,7,9,8,15,29,48,-19,35
Grasshoppers,8399,8,9,7,16,43,55,-12,34
FC Sion,8399,9,7,7,18,41,53,-12,28
Young Boys,8400,1,23,7,2,75,34,41,76
FC Basel,8400,2,15,10,7,52,30,22,55
Lucerne,8400,3,13,8,11,44,43,1,47
St Gallen,8400,4,15,2,15,47,57,-10,47
FC Zürich,8400,5,10,11,11,43,39,4,41
Grasshoppers,8400,6,11,6,15,40,47,-7,39
FC Lugano,8400,7,11,6,15,34,47,-13,39
FC Thun,8400,8,9,7,16,41,57,-16,34
FC Sion,8400,9,5,7,20,35,57,-22,22
Young Boys,8401,1,23,6,3,74,31,43,75
FC Basel,8401,2,16,11,5,51,24,27,59
St Gallen,8401,3,15,3,14,46,56,-10,48
FC Zürich,8401,4,11,11,10,40,33,7,44
Lucerne,8401,5,12,8,12,42,52,-10,44
FC Lugano,8401,6,10,6,16,33,48,-15,36
Grasshoppers,8401,7,9,8,15,42,49,-7,35
FC Thun,8401,8,9,7,16,45,59,-14,34
FC Sion,8401,9,5,8,19,37,58,-21,23
Young Boys,8402,1,22,8,2,74,32,42,74
FC Basel,8402,2,15,10,7,50,27,23,55
Lucerne,8402,3,14,8,10,43,41,2,50
St Gallen,8402,4,14,3,15,43,54,-11,45
FC Zürich,8402,5,11,9,12,42,37,5,42
FC Lugano,8402,6,12,5,15,31,45,-14,41
FC Thun,8402,7,9,8,15,44,57,-13,35
Grasshoppers,8402,8,8,7,17,38,52,-14,31
FC Sion,8402,9,6,8,18,41,61,-20,26
Young Boys,8403,1,23,6,3,70,32,38,75
FC Basel,8403,2,18,8,6,56,26,30,62
St Gallen,8403,3,15,3,14,45,55,-10,48
Lucerne,8403,4,13,7,12,45,49,-4,46
FC Zürich,8403,5,10,10,12,40,36,4,40
FC Lugano,8403,6,11,6,15,33,46,-13,39
Grasshoppers,8403,7,10,6,16,42,49,-7,36
FC Thun,8403,8,10,5,17,41,58,-17,35
FC Sion,8403,9,5,7,20,37,58,-21,22
Young Boys,8404,1,21,6,5,68,34,34,69
FC Basel,8404,2,18,9,5,54,22,32,63
St Gallen,8404,3,15,3,14,43,54,-11,48
FC Zürich,8404,4,11,11,10,43,34,9,44
Lucerne,8404,5,12,7,13,39,46,-7,43
FC Lugano,8404,6,11,6,15,32,48,-16,39
Grasshoppers,8404,7,10,7,15,43,49,-6,37
FC Thun,8404,8,9,6,17,43,60,-17,33
FC Sion,8404,9,5,9,18,40,58,-18,24
Young Boys,8405,1,22,7,3,72,33,39,73
FC Basel,8405,2,18,7,7,53,27,26,61
St Gallen,8405,3,15,2,15,46,53,-7,47
FC Zürich,8405,4,12,10,10,42,34,8,46
Lucerne,8405,5,11,9,12,39,49,-10,42
FC Lugano,8405,6,10,6,16,33,50,-17,36
Grasshoppers,8405,7,8,10,14,40,48,-8,34
FC Thun,8405,8,9,7,16,43,58,-15,34
FC Sion,8405,9,6,8,18,38,54,-16,26
Young Boys,8406,1,22,6,4,73,36,37,72
FC Basel,8406,2,16,7,9,55,30,25,55
Lucerne,8406,3,12,10,10,39,42,-3,46
St Gallen,8406,4,14,4,14,42,52,-10,46
FC Zürich,8406,5,10,10,12,40,37,3,40
Grasshoppers,8406,6,11,7,14,44,48,-4,40
FC Lugano,8406,7,9,8,15,29,46,-17,35
FC Sion,8406,8,9,7,16,45,52,-7,34
FC Thun,8406,9,9,5,18,40,64,-24,32
Young Boys,8407,1,23,6,3,72,35,37,75
FC Basel,8407,2,17,9,6,53,24,29,60
St Gallen,8407,3,14,4,14,43,54,-11,46
FC Zürich,8407,4,11,11,10,39,33,6,44
Lucerne,8407,5,12,8,12,39,45,-6,44
Grasshoppers,8407,6,9,8,15,40,47,-7,35
FC Lugano,8407,7,10,5,17,30,47,-17,35
FC Thun,8407,8,8,9,15,40,55,-15,33
FC Sion,8407,9,5,10,17,36,52,-16,25
Young Boys,8408,1,21,7,4,69,33,36,70
FC Basel,8408,2,17,9,6,54,29,25,60
Lucerne,8408,3,14,7,11,45,44,1,49
FC Zürich,8408,4,12,10,10,44,33,11,46
St Gallen,8408,5,13,3,16,43,58,-15,42
Grasshoppers,8408,6,11,6,15,44,50,-6,39
FC Lugano,8408,7,9,6,17,31,54,-23,33
FC Thun,8408,8,8,7,17,43,61,-18,31
FC Sion,8408,9,7,9,16,41,52,-11,30
Young Boys,8409,1,21,8,3,71,35,36,71
FC Basel,8409,2,18,7,7,52,25,27,61
St Gallen,8409,3,15,2,15,43,54,-11,47
Lucerne,8409,4,12,9,11,41,42,-1,45
FC Zürich,8409,5,11,11,10,42,35,7,44
FC Lugano,8409,6,10,6,16,33,52,-19,36
FC Thun,8409,7,9,6,17,40,58,-18,33
FC Sion,8409,8,8,8,16,40,50,-10,32
Grasshoppers,8409,9,8,7,17,38,49,-11,31
Young Boys,8410,1,21,7,4,70,35,35,70
FC Basel,8410,2,18,9,5,55,27,28,63
Lucerne,8410,3,12,10,10,41,42,-1,46
St Gallen,8410,4,13,5,14,43,57,-14,44
FC Thun,8410,5,10,7,15,48,57,-9,37
FC Lugano,8410,6,10,7,15,32,48,-16,37
FC Zürich,8410,7,9,9,14,39,40,-1,36
FC Sion,8410,8,8,9,15,44,52,-8,33
Grasshoppers,8410,9,8,7,17,37,51,-14,31
Young Boys,8411,1,21,8,3,69,34,35,71
FC Basel,8411,2,17,9,6,53,26,27,60
Lucerne,8411,3,14,8,10,43,40,3,50
St Gallen,8411,4,14,3,15,40,54,-14,45
FC Zürich,8411,5,10,10,12,42,40,2,40
FC Thun,8411,6,10,6,16,46,57,-11,36
FC Lugano,8411,7,9,8,15,29,46,-17,35
Grasshoppers,8411,8,9,6,17,40,52,-12,33
FC Sion,8411,9,7,8,17,40,53,-13,29
Young Boys,8412,1,22,7,3,74,37,37,73
FC Basel,8412,2,18,7,7,57,27,30,61
St Gallen,8412,3,15,4,13,43,51,-8,49
Lucerne,8412,4,12,8,12,39,47,-8,44
FC Zürich,8412,5,9,11,12,42,40,2,38
FC Lugano,8412,6,10,8,14,34,48,-14,38
Grasshoppers,8412,7,9,6,17,40,51,-11,33
FC Thun,8412,8,9,5,18,42,60,-18,32
FC Sion,8412,9,7,10,15,42,52,-10,31
Young Boys,8413,1,21,8,3,69,36,33,71
FC Basel,8413,2,19,8,5,59,25,34,65
Lucerne,8413,3,13,8,11,42,42,0,47
St Gallen,8413,4,13,4,15,39,54,-15,43
FC Zürich,8413,5,10,11,11,39,35,4,41
FC Lugano,8413,6,11,7,14,34,45,-11,40
FC Thun,8413,7,9,6,17,43,62,-19,33
Grasshoppers,8413,8,8,7,17,40,51,-11,31
FC Sion,8413,9,5,11,16,38,53,-15,26
Young Boys,8414,1,22,6,4,76,41,35,72
FC Basel,8414,2,17,9,6,52,27,25,60
Lucerne,8414,3,13,8,11,46,46,0,47
St Gallen,8414,4,14,2,16,44,56,-12,44
FC Lugano,8414,5,12,5,15,33,47,-14,41
FC Zürich,8414,6,9,10,13,37,37,0,37
FC Thun,8414,7,10,7,15,41,54,-13,37
Grasshoppers,8414,8,10,6,16,45,51,-6,36
FC Sion,8414,9,6,9,17,36,51,-15,27
Young Boys,8415,1,22,7,3,76,34,42,73
FC Basel,8415,2,18,7,7,55,27,28,61
Lucerne,8415,3,14,8,10,42,43,-1,50
St Gallen,8415,4,15,3,14,48,55,-7,48
FC Zürich,8415,5,10,11,11,40,34,6,41
Grasshoppers,8415,6,9,7,16,40,48,-8,34
FC Lugano,8415,7,9,7,16,29,53,-24,34
FC Thun,8415,8,8,7,17,38,58,-20,31
FC Sion,8415,9,6,9,17,37,53,-16,27
Young Boys,8416,1,21,8,3,70,31,39,71
FC Basel,8416,2,19,8,5,59,23,36,65
Lucerne,8416,3,14,8,10,45,45,0,50
St Gallen,8416,4,13,4,15,43,56,-13,43
FC Lugano,8416,5,10,7,15,32,48,-16,37
FC Zürich,8416,6,9,9,14,39,46,-7,36
FC Thun,8416,7,10,6,16,46,61,-15,36
Grasshoppers,8416,8,8,7,17,38,52,-14,31
FC Sion,8416,9,7,9,16,42,52,-10,30
Young Boys,8417,1,22,6,4,70,35,35,72
FC Basel,8417,2,18,7,7,52,25,27,61
Lucerne,8417,3,13,7,12,42,46,-4,46
St Gallen,8417,4,13,2,17,39,56,-17,41
Grasshoppers,8417,5,11,6,15,40,46,-6,39
FC Lugano,8417,6,11,5,16,32,49,-17,38
FC Zürich,8417,7,9,10,13,38,37,1,37
FC Thun,8417,8,10,6,16,42,55,-13,36
FC Sion,8417,9,9,7,16,42,48,-6,34
Young Boys,8418,1,22,6,4,72,34,38,72
FC Basel,8418,2,19,8,5,60,25,35,65
FC Zürich,8418,3,12,10,10,43,34,9,46
Lucerne,8418,4,12,8,12,40,50,-10,44
St Gallen,8418,5,14,2,16,43,59,-16,44
Grasshoppers,8418,6,11,7,14,42,44,-2,40
FC Lugano,8418,7,10,5,17,34,49,-15,35
FC Thun,8418,8,8,6,18,43,63,-20,30
FC Sion,8418,9,6,8,18,39,58,-19,26
Young Boys,8419,1,20,8,4,68,38,30,68
FC Basel,8419,2,16,8,8,50,30,20,56
Lucerne,8419,3,14,9,9,49,40,9,51
FC Zürich,8419,4,12,10,10,42,34,8,46
St Gallen,8419,5,14,4,14,42,54,-12,46
Grasshoppers,8419,6,10,7,15,42,47,-5,37
FC Thun,8419,7,10,6,16,43,56,-13,36
FC Lugano,8419,8,9,7,16,29,48,-19,34
FC Sion,8419,9,5,9,18,37,55,-18,24
Young Boys,8420,1,22,6,4,71,36,35,72
FC Basel,8420,2,16,8,8,54,29,25,56
Lucerne,8420,3,14,8,10,45,43,2,50
St Gallen,8420,4,15,2,15,43,54,-11,47
FC Zürich,8420,5,11,11,10,41,35,6,44
FC Thun,8420,6,10,6,16,44,57,-13,36
Grasshoppers,8420,7,9,8,15,40,49,-9,35
FC Lugano,8420,8,9,7,16,29,47,-18,34
FC Sion,8420,9,6,8,18,40,57,-17,26
Young Boys,8421,1,20,9,3,68,34,34,69
FC Basel,8421,2,16,9,7,51,27,24,57
Lucerne,8421,3,13,8,11,43,42,1,47
St Gallen,8421,4,14,4,14,42,54,-12,46
FC Zürich,8421,5,10,12,10,40,35,5,42
Grasshoppers,8421,6,11,6,15,41,45,-4,39
FC Lugano,8421,7,10,7,15,30,47,-17,37
FC Thun,8421,8,9,6,17,40,57,-17,33
FC Sion,8421,9,6,9,17,39,53,-14,27
Young Boys,8422,1,21,8,3,71,32,39,71
FC Basel,8422,2,17,10,5,55,25,30,61
St Gallen,8422,3,16,3,13,48,50,-2,51
Lucerne,8422,4,12,8,12,39,47,-8,44
FC Zürich,8422,5,9,12,11,39,37,2,39
FC Lugano,8422,6,10,6,16,29,49,-20,36
Grasshoppers,8422,7,9,8,15,40,50,-10,35
FC Thun,8422,8,9,6,17,45,61,-16,33
FC Sion,8422,9,6,9,17,40,55,-15,27
Young Boys,8423,1,20,6,6,70,39,31,66
FC Basel,8423,2,17,7,8,55,29,26,58
Lucerne,8423,3,13,8,11,43,44,-1,47
St Gallen,8423,4,14,3,15,41,56,-15,45
FC Lugano,8423,5,13,5,14,35,44,-9,44
FC Zürich,8423,6,10,9,13,40,38,2,39
Grasshoppers,8423,7,10,8,14,45,50,-5,38
FC Thun,8423,8,10,6,16,45,59,-14,36
FC Sion,8423,9,7,8,17,40,55,-15,29
Young Boys,8424,1,23,6,3,78,35,43,75
FC Basel,8424,2,17,9,6,58,29,29,60
St Gallen,8424,3,16,3,13,48,54,-6,51
Lucerne,8424,4,13,8,11,46,47,-1,47
FC Zürich,8424,5,10,10,12,40,38,2,40
FC Lugano,8424,6,10,5,17,33,54,-21,35
Grasshoppers,8424,7,9,7,16,42,52,-10,34
FC Thun,8424,8,9,6,17,41,60,-19,33
FC Sion,8424,9,6,8,18,38,55,-17,26
Young Boys,8425,1,22,7,3,71,33,38,73
FC Basel,8425,2,17,7,8,52,28,24,58
Lucerne,8425,3,15,7,10,44,41,3,52
FC Zürich,8425,4,13,9,10,41,33,8,48
St Gallen,8425,5,13,2,17,39,55,-16,41
FC Thun,8425,6,10,6,16,43,57,-14,36
FC Lugano,8425,7,10,5,17,29,47,-18,35
Grasshoppers,8425,8,8,7,17,37,49,-12,31
FC Sion,8425,9,6,10,16,38,51,-13,28
Young Boys,8426,1,22,6,4,72,35,37,72
FC Basel,8426,2,17,7,8,53,28,25,58
St Gallen,8426,3,15,2,15,43,56,-13,47
FC Zürich,8426,4,12,10,10,44,33,11,46
Lucerne,8426,5,13,7,12,40,41,-1,46
Grasshoppers,8426,6,11,6,15,44,51,-7,39
FC Lugano,8426,7,10,6,16,29,46,-17,36
FC Thun,8426,8,9,5,18,44,63,-19,32
FC Sion,8426,9,7,7,18,44,60,-16,28
Young Boys,8427,1,22,8,2,71,32,39,74
FC Basel,8427,2,16,9,7,50,27,23,57
St Gallen,8427,3,15,4,13,46,53,-7,49
Lucerne,8427,4,12,9,11,43,44,-1,45
FC Zürich,8427,5,11,10,11,42,37,5,43
FC Lugano,8427,6,9,9,14,31,46,-15,36
Grasshoppers,8427,7,9,8,15,40,49,-9,35
FC Thun,8427,8,9,5,18,44,60,-16,32
FC Sion,8427,9,6,8,18,39,58,-19,26
Young Boys,8428,1,22,6,4,72,33,39,72
FC Basel,8428,2,17,10,5,55,27,28,61
St Gallen,8428,3,14,4,14,42,56,-14,46
Lucerne,8428,4,12,9,11,41,42,-1,45
FC Zürich,8428,5,10,10,12,40,39,1,40
FC Lugano,8428,6,10,6,16,30,46,-16,36
Grasshoppers,8428,7,9,7,16,42,51,-9,34
FC Thun,8428,8,9,7,16,46,62,-16,34
FC Sion,8428,9,7,9,16,39,51,-12,30
Young Boys,8429,1,23,7,2,79,36,43,76
FC Basel,8429,2,17,9,6,53,27,26,60
FC Zürich,8429,3,12,10,10,43,34,9,46
Lucerne,8429,4,12,8,12,43,49,-6,44
St Gallen,8429,5,13,5,14,41,54,-13,44
Grasshoppers,8429,6,10,7,15,44,50,-6,37
FC Lugano,8429,7,9,6,17,30,49,-19,33
FC Sion,8429,8,7,9,16,44,55,-11,30
FC Thun,8429,9,8,5,19,41,64,-23,29
Young Boys,8430,1,22,7,3,75,32,43,73
FC Basel,8430,2,18,8,6,55,24,31,62
St Gallen,8430,3,15,3,14,43,52,-9,48
FC Zürich,8430,4,12,10,10,42,35,7,46
Lucerne,8430,5,12,8,12,39,47,-8,44
FC Lugano,8430,6,11,5,16,30,45,-15,38
Grasshoppers,8430,7,10,6,16,48,52,-4,36
FC Thun,8430,8,8,6,18,41,63,-22,30
FC Sion,8430,9,6,7,19,41,64,-23,25
Young Boys,8431,1,22,6,4,75,36,39,72
FC Basel,8431,2,17,8,7,53,27,26,59
Lucerne,8431,3,14,8,10,43,46,-3,50
St Gallen,8431,4,15,2,15,42,56,-14,47
FC Zürich,8431,5,12,9,11,44,34,10,45
FC Thun,8431,6,11,5,16,48,58,-10,38
FC Lugano,8431,7,10,5,17,29,49,-20,35
Grasshoppers,8431,8,8,6,18,39,52,-13,30
FC Sion,8431,9,7,7,18,41,56,-15,28
Young Boys,8432,1,21,8,3,73,36,37,71
FC Basel,8432,2,17,9,6,52,26,26,60
Lucerne,8432,3,14,8,10,42,40,2,50
St Gallen,8432,4,14,2,16,40,53,-13,44
FC Zürich,8432,5,11,10,11,43,38,5,43
FC Thun,8432,6,11,5,16,47,60,-13,38
FC Lugano,8432,7,10,6,16,30,47,-17,36
Grasshoppers,8432,8,9,7,16,43,55,-12,34
FC Sion,8432,9,6,7,19,41,56,-15,25
Young Boys,8433,1,21,8,3,75,35,40,71
FC Basel,8433,2,17,9,6,54,31,23,60
Lucerne,8433,3,14,8,10,46,45,1,50
St Gallen,8433,4,13,3,16,42,56,-14,42
FC Zürich,8433,5,10,9,13,41,40,1,39
FC Lugano,8433,6,11,6,15,32,46,-14,39
FC Thun,8433,7,10,6,16,45,61,-16,36
Grasshoppers,8433,8,8,8,16,43,55,-12,32
FC Sion,8433,9,7,9,16,44,53,-9,30
Young Boys,8434,1,23,7,2,72,31,41,76
FC Basel,8434,2,19,7,6,60,25,35,64
Lucerne,8434,3,12,7,13,41,46,-5,43
St Gallen,8434,4,13,3,16,40,58,-18,42
FC Zürich,8434,5,10,10,12,40,40,0,40
FC Thun,8434,6,11,5,16,50,59,-9,38
FC Lugano,8434,7,11,5,16,35,49,-14,38
Grasshoppers,8434,8,9,7,16,39,50,-11,34
FC Sion,8434,9,5,11,16,35,54,-19,26
Young Boys,8435,1,22,7,3,72,32,40,73
FC Basel,8435,2,17,8,7,53,29,24,59
St Gallen,8435,3,14,4,14,42,53,-11,46
Lucerne,8435,4,12,9,11,39,42,-3,45
FC Zürich,8435,5,11,9,12,39,37,2,42
FC Thun,8435,6,10,6,16,44,56,-12,36
FC Lugano,8435,7,10,6,16,31,47,-16,36
Grasshoppers,8435,8,8,8,16,38,53,-15,32
FC Sion,8435,9,7,9,16,41,50,-9,30
Young Boys,8436,1,22,6,4,76,37,39,72
FC Basel,8436,2,19,7,6,52,25,27,64
St Gallen,8436,3,14,3,15,47,58,-11,45
Lucerne,8436,4,12,8,12,42,46,-4,44
FC Zürich,8436,5,10,10,12,41,37,4,40
Grasshoppers,8436,6,11,6,15,44,50,-6,39
FC Lugano,8436,7,11,6,15,33,47,-14,39
FC Thun,8436,8,10,5,17,45,59,-14,35
FC Sion,8436,9,6,7,19,47,68,-21,25
Young Boys,8437,1,20,8,4,68,38,30,68
FC Basel,8437,2,16,9,7,55,29,26,57
Lucerne,8437,3,12,10,10,42,44,-2,46
St Gallen,8437,4,13,6,13,42,53,-11,45
FC Zürich,8437,5,11,10,11,42,37,5,43
FC Thun,8437,6,12,5,15,51,58,-7,41
FC Lugano,8437,7,10,8,14,32,45,-13,38
Grasshoppers,8437,8,8,7,17,42,54,-12,31
FC Sion,8437,9,6,9,17,43,59,-16,27
Young Boys,8438,1,20,6,6,72,43,29,66
FC Basel,8438,2,17,7,8,54,34,20,58
Lucerne,8438,3,15,7,10,48,43,5,52
FC Zürich,8438,4,12,10,10,43,33,10,46
St Gallen,8438,5,14,2,16,45,60,-15,44
FC Lugano,8438,6,11,5,16,33,47,-14,38
Grasshoppers,8438,7,10,7,15,43,50,-7,37
FC Thun,8438,8,9,8,15,42,55,-13,35
FC Sion,8438,9,6,8,18,40,55,-15,26
Young Boys,8439,1,22,7,3,72,32,40,73
FC Basel,8439,2,20,7,5,61,23,38,67
Lucerne,8439,3,13,7,12,43,47,-4,46
St Gallen,8439,4,14,2,16,42,55,-13,44
Grasshoppers,8439,5,11,7,14,45,47,-2,40
FC Lugano,8439,6,11,5,16,29,49,-20,38
FC Zürich,8439,7,9,9,14,38,41,-3,36
FC Thun,8439,8,9,5,18,41,62,-21,32
FC Sion,8439,9,7,7,18,42,57,-15,28
Young Boys,8440,1,21,8,3,69,32,37,71
FC Basel,8440,2,16,8,8,52,29,23,56
Lucerne,8440,3,13,10,9,43,42,1,49
St Gallen,8440,4,14,4,14,43,55,-12,46
FC Zürich,8440,5,11,10,11,40,34,6,43
FC Lugano,8440,6,10,7,15,30,44,-14,37
Grasshoppers,8440,7,10,6,16,40,49,-9,36
FC Thun,8440,8,10,5,17,45,60,-15,35
FC Sion,8440,9,6,8,18,40,57,-17,26
Young Boys,8441,1,23,6,3,72,32,40,75
FC Basel,8441,2,17,8,7,55,28,27,59
Lucerne,8441,3,14,7,11,45,45,0,49
St Gallen,8441,4,15,2,15,43,55,-12,47
FC Zürich,8441,5,10,11,11,42,37,5,41
FC Lugano,8441,6,11,6,15,31,45,-14,39
Grasshoppers,8441,7,9,7,16,40,51,-11,34
FC Thun,8441,8,8,6,18,42,63,-21,30
FC Sion,8441,9,7,7,18,40,54,-14,28
Young Boys,8442,1,22,8,2,75,33,42,74
FC Basel,8442,2,17,9,6,52,26,26,60
St Gallen,8442,3,15,2,15,41,53,-12,47
Lucerne,8442,4,13,7,12,42,45,-3,46
Grasshoppers,8442,5,11,6,15,45,48,-3,39
FC Zürich,8442,6,9,11,12,37,37,0,38
FC Lugano,8442,7,10,5,17,33,53,-20,35
FC Thun,8442,8,9,5,18,44,62,-18,32
FC Sion,8442,9,7,9,16,41,53,-12,30
Young Boys,8443,1,22,6,4,73,36,37,72
FC Basel,8443,2,19,8,5,57,26,31,65
St Gallen,8443,3,14,3,15,43,54,-11,45
FC Zürich,8443,4,11,9,12,44,39,5,42
Lucerne,8443,5,11,8,13,42,49,-7,41
FC Thun,8443,6,11,6,15,49,58,-9,39
FC Lugano,8443,7,11,6,15,32,49,-17,39
Grasshoppers,8443,8,9,7,16,40,52,-12,34
FC Sion,8443,9,5,9,18,39,56,-17,24
Young Boys,8444,1,24,6,2,76,34,42,78
FC Basel,8444,2,17,8,7,53,29,24,59
Lucerne,8444,3,14,7,11,49,43,6,49
St Gallen,8444,4,13,4,15,41,57,-16,43
FC Zürich,8444,5,10,11,11,41,38,3,41
FC Thun,8444,6,10,6,16,44,60,-16,36
FC Lugano,8444,7,9,6,17,31,51,-20,33
FC Sion,8444,8,8,8,16,45,52,-7,32
Grasshoppers,8444,9,8,6,18,41,57,-16,30
Young Boys,8445,1,21,6,5,69,38,31,69
FC Basel,8445,2,18,7,7,55,31,24,61
Lucerne,8445,3,15,7,10,44,39,5,52
St Gallen,8445,4,15,2,15,48,62,-14,47
FC Lugano,8445,5,12,5,15,38,47,-9,41
FC Zürich,8445,6,10,9,13,40,38,2,39
Grasshoppers,8445,7,9,7,16,40,50,-10,34
FC Thun,8445,8,9,6,17,41,56,-15,33
FC Sion,8445,9,6,9,17,41,55,-14,27
Young Boys,8446,1,22,6,4,72,37,35,72
FC Basel,8446,2,19,8,5,59,26,33,65
St Gallen,8446,3,15,2,15,44,57,-13,47
Lucerne,8446,4,13,7,12,42,44,-2,46
FC Zürich,8446,5,11,10,11,43,36,7,43
Grasshoppers,8446,6,11,6,15,44,46,-2,39
FC Lugano,8446,7,11,5,16,34,48,-14,38
FC Thun,8446,8,9,5,18,41,63,-22,32
FC Sion,8446,9,5,7,20,34,56,-22,22
Young Boys,8447,1,22,7,3,75,36,39,73
FC Basel,8447,2,19,7,6,56,27,29,64
Lucerne,8447,3,13,7,12,39,47,-8,46
St Gallen,8447,4,14,3,15,44,54,-10,45
FC Zürich,8447,5,11,9,12,40,35,5,42
FC Thun,8447,6,11,5,16,44,58,-14,38
FC Lugano,8447,7,10,6,16,32,45,-13,36
Grasshoppers,8447,8,8,6,18,37,52,-15,30
FC Sion,8447,9,7,8,17,42,55,-13,29
Young Boys,8448,1,21,8,3,75,35,40,71
FC Basel,8448,2,17,8,7,54,27,27,59
St Gallen,8448,3,15,2,15,45,54,-9,47
FC Lugano,8448,4,13,5,14,35,45,-10,44
Lucerne,8448,5,12,7,13,40,48,-8,43
FC Zürich,8448,6,11,9,12,40,35,5,42
Grasshoppers,8448,7,10,7,15,40,50,-10,37
FC Thun,8448,8,10,5,17,45,60,-15,35
FC Sion,8448,9,6,7,19,39,59,-20,25
Young Boys,8449,1,22,8,2,75,33,42,74
FC Basel,8449,2,18,8,6,54,26,28,62
Lucerne,8449,3,14,7,11,45,44,1,49
FC Zürich,8449,4,13,9,10,43,32,11,48
St Gallen,8449,5,13,3,16,41,57,-16,42
Grasshoppers,8449,6,10,6,16,43,52,-9,36
FC Lugano,8449,7,9,6,17,29,52,-23,33
FC Sion,8449,8,7,8,17,43,56,-13,29
FC Thun,8449,9,8,5,19,43,64,-21,29
Young Boys,8450,1,21,8,3,73,38,35,71
FC Basel,8450,2,18,8,6,52,24,28,62
Lucerne,8450,3,13,7,12,43,45,-2,46
St Gallen,8450,4,13,5,14,41,55,-14,44
FC Zürich,8450,5,10,11,11,39,34,5,41
FC Thun,8450,6,10,6,16,41,56,-15,36
Grasshoppers,8450,7,9,8,15,41,48,-7,35
FC Lugano,8450,8,9,8,15,30,46,-16,35
FC Sion,8450,9,6,9,17,41,55,-14,27
Young Boys,8451,1,21,7,4,73,39,34,70
FC Basel,8451,2,18,8,6,61,31,30,62
St Gallen,8451,3,15,3,14,48,57,-9,48
Lucerne,8451,4,13,7,12,45,50,-5,46
FC Zürich,8451,5,10,11,11,40,36,4,41
Grasshoppers,8451,6,10,7,15,39,48,-9,37
FC Thun,8451,7,9,6,17,41,57,-16,33
FC Sion,8451,8,8,8,16,44,52,-8,32
FC Lugano,8451,9,9,5,18,30,51,-21,32
Young Boys,8452,1,21,8,3,75,36,39,71
FC Basel,8452,2,17,8,7,52,30,22,59
Lucerne,8452,3,15,8,9,45,41,4,53
St Gallen,8452,4,13,5,14,43,55,-12,44
FC Zürich,8452,5,9,11,12,39,40,-1,38
FC Lugano,8452,6,10,6,16,32,47,-15,36
Grasshoppers,8452,7,9,7,16,43,53,-10,34
FC Sion,8452,8,7,10,15,43,52,-9,31
FC Thun,8452,9,8,7,17,42,60,-18,31
Young Boys,8453,1,20,7,5,71,37,34,67
FC Basel,8453,2,19,8,5,55,22,33,65
St Gallen,8453,3,15,3,14,44,55,-11,48
Lucerne,8453,4,13,8,11,43,46,-3,47
FC Zürich,8453,5,10,9,13,41,39,2,39
Grasshoppers,8453,6,10,7,15,43,49,-6,37
FC Thun,8453,7,10,5,17,45,61,-16,35
FC Lugano,8453,8,10,5,17,30,51,-21,35
FC Sion,8453,9,7,8,17,41,53,-12,29
Young Boys,8454,1,24,6,2,79,32,47,78
FC Basel,8454,2,17,8,7,54,28,26,59
Lucerne,8454,3,13,8,11,41,45,-4,47
St Gallen,8454,4,15,2,15,43,56,-13,47
FC Zürich,8454,5,11,10,11,42,35,7,43
FC Lugano,8454,6,10,6,16,31,50,-19,36
Grasshoppers,8454,7,9,6,17,39,50,-11,33
FC Thun,8454,8,9,5,18,43,61,-18,32
FC Sion,8454,9,7,7,18,40,55,-15,28
Young Boys,8455,1,21,6,5,69,40,29,69
FC Basel,8455,2,18,9,5,55,25,30,63
St Gallen,8455,3,15,2,15,44,53,-9,47
Lucerne,8455,4,12,8,12,42,46,-4,44
FC Zürich,8455,5,10,10,12,42,39,3,40
Grasshoppers,8455,6,10,6,16,46,53,-7,36
FC Lugano,8455,7,10,6,16,32,50,-18,36
FC Thun,8455,8,9,7,16,47,60,-13,34
FC Sion,8455,9,8,8,16,44,55,-11,32
Young Boys,8456,1,22,7,3,73,33,40,73
FC Basel,8456,2,17,10,5,51,23,28,61
St Gallen,8456,3,14,5,13,42,51,-9,47
Lucerne,8456,4,12,8,12,42,48,-6,44
FC Zürich,8456,5,10,10,12,40,36,4,40
FC Lugano,8456,6,11,6,15,33,47,-14,39
FC Thun,8456,7,9,7,16,44,57,-13,34
FC Sion,8456,8,7,9,16,40,53,-13,30
Grasshoppers,8456,9,8,6,18,39,56,-17,30
Young Boys,8457,1,23,7,2,74,36,38,76
FC Basel,8457,2,15,11,6,51,27,24,56
St Gallen,8457,3,13,5,14,41,53,-12,44
Lucerne,8457,4,11,10,11,42,48,-6,43
FC Zürich,8457,5,10,11,11,40,35,5,41
Grasshoppers,8457,6,10,7,15,47,49,-2,37
FC Thun,8457,7,10,7,15,44,56,-12,37
FC Lugano,8457,8,10,7,15,33,48,-15,37
FC Sion,8457,9,5,9,18,40,60,-20,24
Young Boys,8458,1,22,8,2,72,35,37,74
FC Basel,8458,2,18,9,5,54,23,31,63
St Gallen,8458,3,14,5,13,43,53,-10,47
Lucerne,8458,4,13,7,12,44,48,-4,46
FC Zürich,8458,5,10,10,12,40,37,3,40
FC Thun,8458,6,10,6,16,44,56,-12,36
FC Lugano,8458,7,9,7,16,31,49,-18,34
Grasshoppers,8458,8,8,7,17,40,52,-12,31
FC Sion,8458,9,6,9,17,37,52,-15,27
Young Boys,8459,1,20,8,4,69,36,33,68
FC Basel,8459,2,18,8,6,56,24,32,62
Lucerne,8459,3,14,7,11,43,42,1,49
FC Zürich,8459,4,12,9,11,43,34,9,45
St Gallen,8459,5,13,2,17,42,60,-18,41
FC Lugano,8459,6,11,5,16,31,47,-16,38
Grasshoppers,8459,7,10,7,15,39,47,-8,37
FC Thun,8459,8,10,6,16,43,56,-13,36
FC Sion,8459,9,6,8,18,38,58,-20,26
Young Boys,8460,1,22,8,2,76,35,41,74
FC Basel,8460,2,15,10,7,49,26,23,55
St Gallen,8460,3,14,4,14,43,55,-12,46
Lucerne,8460,4,12,9,11,40,42,-2,45
FC Zürich,8460,5,11,11,10,42,35,7,44
Grasshoppers,8460,6,10,8,14,46,49,-3,38
FC Lugano,8460,7,10,5,17,29,49,-20,35
FC Thun,8460,8,9,5,18,43,60,-17,32
FC Sion,8460,9,7,8,17,42,59,-17,29
Young Boys,8461,1,22,6,4,70,33,37,72
FC Basel,8461,2,17,8,7,53,28,25,59
Lucerne,8461,3,13,8,11,41,42,-1,47
St Gallen,8461,4,14,3,15,41,53,-12,45
FC Lugano,8461,5,12,5,15,31,45,-14,41
FC Zürich,8461,6,10,10,12,40,36,4,40
FC Thun,8461,7,9,8,15,44,58,-14,35
Grasshoppers,8461,8,9,7,16,41,52,-11,34
FC Sion,8461,9,7,7,18,40,54,-14,28
Young Boys,8462,1,21,7,4,69,35,34,70
FC Basel,8462,2,18,8,6,58,28,30,62
St Gallen,8462,3,14,5,13,44,52,-8,47
FC Zürich,8462,4,11,11,10,45,38,7,44
Lucerne,8462,5,12,8,12,46,50,-4,44
Grasshoppers,8462,6,10,7,15,43,51,-8,37
FC Lugano,8462,7,10,7,15,30,46,-16,37
FC Thun,8462,8,8,6,18,45,65,-20,30
FC Sion,8462,9,6,9,17,38,53,-15,27
Young Boys,8463,1,22,8,2,73,31,42,74
FC Basel,8463,2,17,9,6,49,23,26,60
St Gallen,8463,3,16,2,14,43,53,-10,50
Lucerne,8463,4,13,7,12,40,43,-3,46
FC Zürich,8463,5,11,10,11,39,34,5,43
Grasshoppers,8463,6,9,8,15,39,48,-9,35
FC Thun,8463,7,10,5,17,42,57,-15,35
FC Lugano,8463,8,10,5,17,31,49,-18,35
FC Sion,8463,9,5,8,19,35,53,-18,23
Young Boys,8464,1,20,7,5,70,39,31,67
FC Basel,8464,2,18,9,5,61,24,37,63
St Gallen,8464,3,15,2,15,46,62,-16,47
Lucerne,8464,4,12,8,12,42,49,-7,44
FC Zürich,8464,5,10,10,12,42,38,4,40
Grasshoppers,8464,6,10,6,16,45,52,-7,36
FC Lugano,8464,7,10,6,16,33,49,-16,36
FC Thun,8464,8,10,5,17,43,61,-18,35
FC Sion,8464,9,9,7,16,45,53,-8,34
Young Boys,8465,1,23,6,3,72,35,37,75
FC Basel,8465,2,16,8,8,54,30,24,56
Lucerne,8465,3,13,9,10,42,43,-1,48
St Gallen,8465,4,14,4,14,47,58,-11,46
FC Zürich,8465,5,12,9,11,43,36,7,45
Grasshoppers,8465,6,10,7,15,42,48,-6,37
FC Thun,8465,7,10,6,16,45,60,-15,36
FC Lugano,8465,8,9,6,17,29,48,-19,33
FC Sion,8465,9,6,7,19,42,58,-16,25
Young Boys,8466,1,21,7,4,73,38,35,70
FC Basel,8466,2,18,8,6,56,25,31,62
Lucerne,8466,3,14,9,9,45,41,4,51
St Gallen,8466,4,14,4,14,44,55,-11,46
FC Zürich,8466,5,10,9,13,41,37,4,39
FC Lugano,8466,6,11,5,16,31,47,-16,38
FC Thun,8466,7,10,5,17,42,62,-20,35
Grasshoppers,8466,8,8,8,16,39,51,-12,32
FC Sion,8466,9,6,9,17,42,57,-15,27
Young Boys,8467,1,21,8,3,72,34,38,71
FC Basel,8467,2,18,8,6,54,27,27,62
St Gallen,8467,3,15,4,13,45,51,-6,49
FC Zürich,8467,4,12,9,11,42,37,5,45
Lucerne,8467,5,11,11,10,42,45,-3,44
Grasshoppers,8467,6,9,8,15,42,52,-10,35
FC Lugano,8467,7,9,6,17,28,47,-19,33
FC Thun,8467,8,9,5,18,45,61,-16,32
FC Sion,8467,9,6,9,17,39,55,-16,27
Young Boys,8468,1,22,8,2,73,35,38,74
FC Basel,8468,2,17,9,6,57,29,28,60
St Gallen,8468,3,14,3,15,41,55,-14,45
Lucerne,8468,4,12,8,12,41,47,-6,44
FC Zürich,8468,5,10,12,10,40,34,6,42
FC Lugano,8468,6,11,6,15,32,44,-12,39
FC Thun,8468,7,9,8,15,44,58,-14,35
Grasshoppers,8468,8,9,7,16,42,50,-8,34
FC Sion,8468,9,5,9,18,39,57,-18,24
Young Boys,8469,1,21,8,3,70,37,33,71
FC Basel,8469,2,20,7,5,59,24,35,67
St Gallen,8469,3,14,3,15,43,57,-14,45
Lucerne,8469,4,12,8,12,44,46,-2,44
FC Zürich,8469,5,10,11,11,42,37,5,41
FC Lugano,8469,6,10,6,16,31,49,-18,36
Grasshoppers,8469,7,9,7,16,40,51,-11,34
FC Thun,8469,8,9,6,17,42,62,-20,33
FC Sion,8469,9,7,8,17,45,53,-8,29
Young Boys,8470,1,23,6,3,74,36,38,75
FC Basel,8470,2,17,8,7,56,29,27,59
Lucerne,8470,3,14,7,11,48,49,-1,49
FC Zürich,8470,4,13,9,10,42,34,8,48
St Gallen,8470,5,13,3,16,41,59,-18,42
FC Lugano,8470,6,11,5,16,36,46,-10,38
Grasshoppers,8470,7,9,7,16,39,51,-12,34
FC Sion,8470,8,7,8,17,41,53,-12,29
FC Thun,8470,9,8,5,19,41,61,-20,29
Young Boys,8471,1,20,9,3,70,37,33,69
FC Basel,8471,2,17,8,7,53,27,26,59
Lucerne,8471,3,12,10,10,42,42,0,46
St Gallen,8471,4,14,4,14,40,51,-11,46
FC Zürich,8471,5,11,11,10,41,34,7,44
FC Lugano,8471,6,11,6,15,32,46,-14,39
Grasshoppers,8471,7,9,8,15,41,47,-6,35
FC Thun,8471,8,9,5,18,40,58,-18,32
FC Sion,8471,9,6,9,17,37,54,-17,27
Young Boys,8472,1,21,8,3,71,33,38,71
FC Basel,8472,2,19,8,5,58,25,33,65
St Gallen,8472,3,16,2,14,46,52,-6,50
FC Zürich,8472,4,10,11,11,39,35,4,41
Lucerne,8472,5,11,8,13,39,52,-13,41
Grasshoppers,8472,6,11,6,15,41,47,-6,39
FC Thun,8472,7,10,5,17,41,57,-16,35
FC Lugano,8472,8,9,8,15,29,46,-17,35
FC Sion,8472,9,5,8,19,39,56,-17,23
Young Boys,8473,1,23,6,3,76,36,40,75
FC Basel,8473,2,19,7,6,64,29,35,64
St Gallen,8473,3,15,3,14,43,53,-10,48
FC Zürich,8473,4,10,10,12,40,39,1,40
Lucerne,8473,5,11,7,14,41,51,-10,40
FC Lugano,8473,6,11,6,15,33,46,-13,39
Grasshoppers,8473,7,10,7,15,43,50,-7,37
FC Thun,8473,8,9,5,18,44,65,-21,32
FC Sion,8473,9,6,9,17,38,53,-15,27
Young Boys,8474,1,23,6,3,77,32,45,75
FC Basel,8474,2,19,8,5,56,25,31,65
FC Zürich,8474,3,11,10,11,43,37,6,43
St Gallen,8474,4,13,4,15,44,59,-15,43
Lucerne,8474,5,11,9,12,40,49,-9,42
FC Lugano,8474,6,11,6,15,35,47,-12,39
Grasshoppers,8474,7,9,7,16,42,52,-10,34
FC Thun,8474,8,9,6,17,45,61,-16,33
FC Sion,8474,9,6,8,18,41,61,-20,26
Young Boys,8475,1,22,8,2,76,35,41,74
FC Basel,8475,2,17,8,7,52,26,26,59
Lucerne,8475,3,12,11,9,44,42,2,47
St Gallen,8475,4,14,3,15,42,59,-17,45
FC Zürich,8475,5,10,10,12,40,36,4,40
FC Thun,8475,6,11,5,16,46,56,-10,38
FC Lugano,8475,7,10,6,16,32,47,-15,36
Grasshoppers,8475,8,9,8,15,43,54,-11,35
FC Sion,8475,9,6,7,19,41,61,-20,25
Young Boys,8476,1,22,7,3,70,32,38,73
FC Basel,8476,2,17,10,5,56,27,29,61
St Gallen,8476,3,15,4,13,45,53,-8,49
Lucerne,8476,4,12,9,11,44,47,-3,45
FC Zürich,8476,5,10,11,11,39,35,4,41
Grasshoppers,8476,6,10,6,16,41,50,-9,36
FC Lugano,8476,7,9,7,16,29,46,-17,34
FC Thun,8476,8,9,5,18,42,63,-21,32
FC Sion,8476,9,6,9,17,41,54,-13,27
Young Boys,8477,1,20,10,2,70,35,35,70
FC Basel,8477,2,18,9,5,54,25,29,63
St Gallen,8477,3,16,2,14,43,52,-9,50
Lucerne,8477,4,12,7,13,42,48,-6,43
FC Zürich,8477,5,10,11,11,41,36,5,41
Grasshoppers,8477,6,9,8,15,43,51,-8,35
FC Thun,8477,7,9,7,16,44,58,-14,34
FC Lugano,8477,8,9,7,16,32,49,-17,34
FC Sion,8477,9,6,9,17,39,54,-15,27
Young Boys,8478,1,23,6,3,79,38,41,75
FC Basel,8478,2,17,7,8,52,24,28,58
Lucerne,8478,3,15,7,10,47,45,2,52
St Gallen,8478,4,16,2,14,42,51,-9,50
FC Zürich,8478,5,11,9,12,39,35,4,42
FC Lugano,8478,6,10,5,17,32,51,-19,35
FC Thun,8478,7,9,6,17,44,59,-15,33
Grasshoppers,8478,8,8,8,16,40,52,-12,32
FC Sion,8478,9,6,8,18,40,60,-20,26
Young Boys,8479,1,20,8,4,70,35,35,68
FC Basel,8479,2,18,9,5,59,27,32,63
Lucerne,8479,3,12,9,11,47,48,-1,45
St Gallen,8479,4,13,5,14,43,57,-14,44
FC Lugano,8479,5,12,5,15,35,48,-13,41
FC Zürich,8479,6,10,10,12,40,39,1,40
FC Thun,8479,7,10,5,17,44,59,-15,35
Grasshoppers,8479,8,9,6,17,40,53,-13,33
FC Sion,8479,9,7,9,16,40,52,-12,30
Young Boys,8480,1,19,8,5,65,37,28,65
FC Basel,8480,2,17,8,7,57,27,30,59
St Gallen,8480,3,16,2,14,46,52,-6,50
Lucerne,8480,4,12,10,10,41,43,-2,46
FC Zürich,8480,5,11,10,11,43,35,8,43
FC Lugano,8480,6,10,7,15,29,45,-16,37
FC Thun,8480,7,10,6,16,41,58,-17,36
Grasshoppers,8480,8,9,7,16,40,49,-9,34
FC Sion,8480,9,7,8,17,38,54,-16,29
Young Boys,8481,1,20,8,4,70,38,32,68
FC Basel,8481,2,16,8,8,52,30,22,56
Lucerne,8481,3,15,7,10,45,41,4,52
St Gallen,8481,4,15,3,14,45,54,-9,48
FC Zürich,8481,5,11,11,10,42,35,7,44
Grasshoppers,8481,6,10,6,16,42,48,-6,36
FC Thun,8481,7,10,5,17,43,58,-15,35
FC Lugano,8481,8,9,7,16,31,50,-19,34
FC Sion,8481,9,6,9,17,39,55,-16,27
Young Boys,8482,1,21,8,3,74,37,37,71
FC Basel,8482,2,19,8,5,55,22,33,65
Lucerne,8482,3,14,8,10,42,41,1,50
St Gallen,8482,4,13,4,15,42,55,-13,43
FC Zürich,8482,5,10,9,13,39,41,-2,39
FC Lugano,8482,6,10,6,16,30,46,-16,36
Grasshoppers,8482,7,9,7,16,41,53,-12,34
FC Sion,8482,8,8,8,16,47,54,-7,32
FC Thun,8482,9,8,6,18,39,60,-21,30
Young Boys,8483,1,21,7,4,73,37,36,70
FC Basel,8483,2,17,9,6,57,30,27,60
St Gallen,8483,3,15,4,13,46,55,-9,49
Lucerne,8483,4,13,8,11,41,44,-3,47
FC Zürich,8483,5,10,10,12,38,36,2,40
Grasshoppers,8483,6,9,8,15,41,51,-10,35
FC Lugano,8483,7,9,8,15,29,45,-16,35
FC Sion,8483,8,8,7,17,46,56,-10,31
FC Thun,8483,9,8,7,17,47,64,-17,31
Young Boys,8484,1,22,7,3,70,33,37,73
FC Basel,8484,2,16,10,6,51,25,26,58
St Gallen,8484,3,15,3,14,44,54,-10,48
Lucerne,8484,4,12,10,10,43,41,2,46
FC Zürich,8484,5,9,12,11,41,38,3,39
FC Thun,8484,6,10,7,15,46,59,-13,37
Grasshoppers,8484,7,10,6,16,43,50,-7,36
FC Lugano,8484,8,10,5,17,33,54,-21,35
FC Sion,8484,9,6,8,18,40,57,-17,26
Young Boys,8485,1,20,8,4,71,36,35,68
FC Basel,8485,2,18,8,6,56,28,28,62
Lucerne,8485,3,14,8,10,43,42,1,50
St Gallen,8485,4,15,2,15,44,54,-10,47
FC Zürich,8485,5,11,10,11,42,37,5,43
Grasshoppers,8485,6,10,8,14,43,48,-5,38
FC Lugano,8485,7,9,6,17,28,48,-20,33
FC Thun,8485,8,9,5,18,44,61,-17,32
FC Sion,8485,9,7,7,18,40,57,-17,28
Young Boys,8486,1,22,6,4,70,34,36,72
FC Basel,8486,2,17,9,6,53,24,29,60
Lucerne,8486,3,13,8,11,42,45,-3,47
St Gallen,8486,4,14,3,15,42,58,-16,45
FC Zürich,8486,5,10,11,11,39,35,4,41
FC Lugano,8486,6,11,6,15,36,47,-11,39
Grasshoppers,8486,7,9,7,16,42,52,-10,34
FC Thun,8486,8,9,7,16,44,59,-15,34
FC Sion,8486,9,6,9,17,37,51,-14,27
Young Boys,8487,1,22,7,3,74,34,40,73
FC Basel,8487,2,18,8,6,56,25,31,62
Lucerne,8487,3,13,8,11,40,43,-3,47
St Gallen,8487,4,13,3,16,39,53,-14,42
FC Zürich,8487,5,10,10,12,44,40,4,40
FC Lugano,8487,6,11,7,14,33,46,-13,40
Grasshoppers,8487,7,9,6,17,42,52,-10,33
FC Sion,8487,8,8,8,16,45,57,-12,32
FC Thun,8487,9,9,5,18,45,68,-23,32
Young Boys,8488,1,21,7,4,70,36,34,70
FC Basel,8488,2,18,8,6,55,26,29,62
St Gallen,8488,3,15,3,14,44,55,-11,48
Lucerne,8488,4,12,7,13,41,47,-6,43
FC Zürich,8488,5,10,11,11,45,39,6,41
Grasshoppers,8488,6,11,7,14,43,47,-4,40
FC Lugano,8488,7,9,7,16,33,51,-18,34
FC Thun,8488,8,9,6,17,45,61,-16,33
FC Sion,8488,9,7,8,17,40,54,-14,29
Young Boys,8489,1,21,9,2,72,35,37,72
FC Basel,8489,2,18,8,6,57,26,31,62
Lucerne,8489,3,13,8,11,41,46,-5,47
St Gallen,8489,4,14,3,15,40,54,-14,45
Grasshoppers,8489,5,11,6,15,44,47,-3,39
FC Lugano,8489,6,11,6,15,31,44,-13,39
FC Zürich,8489,7,9,9,14,38,42,-4,36
FC Thun,8489,8,9,6,17,42,60,-18,33
FC Sion,8489,9,6,9,17,42,53,-11,27
Young Boys,8490,1,19,7,6,64,39,25,64
FC Basel,8490,2,17,8,7,54,26,28,59
Lucerne,8490,3,16,7,9,45,40,5,55
St Gallen,8490,4,15,2,15,43,54,-11,47
FC Zürich,8490,5,11,10,11,42,40,2,43
FC Thun,8490,6,11,6,15,48,57,-9,39
Grasshoppers,8490,7,9,7,16,41,49,-8,34
FC Lugano,8490,8,9,7,16,31,49,-18,34
FC Sion,8490,9,6,8,18,39,53,-14,26
Young Boys,8491,1,23,6,3,73,36,37,75
FC Basel,8491,2,17,8,7,53,30,23,59
St Gallen,8491,3,15,4,13,44,51,-7,49
FC Zürich,8491,4,13,9,10,44,33,11,48
Lucerne,8491,5,12,8,12,44,46,-2,44
Grasshoppers,8491,6,11,6,15,48,50,-2,39
FC Lugano,8491,7,9,6,17,28,48,-20,33
FC Thun,8491,8,8,7,17,41,58,-17,31
FC Sion,8491,9,5,8,19,37,60,-23,23
Young Boys,8492,1,21,7,4,73,36,37,70
FC Basel,8492,2,18,8,6,55,26,29,62
Lucerne,8492,3,14,7,11,41,41,0,49
St Gallen,8492,4,14,2,16,42,54,-12,44
FC Zürich,8492,5,11,9,12,43,40,3,42
FC Thun,8492,6,10,6,16,45,58,-13,36
FC Lugano,8492,7,10,5,17,30,53,-23,35
Grasshoppers,8492,8,9,7,16,41,50,-9,34
FC Sion,8492,9,8,7,17,43,55,-12,31
Young Boys,8493,1,21,8,3,70,35,35,71
FC Basel,8493,2,18,9,5,60,25,35,63
St Gallen,8493,3,14,3,15,47,62,-15,45
Lucerne,8493,4,12,8,12,43,47,-4,44
FC Zürich,8493,5,9,13,10,40,36,4,40
FC Lugano,8493,6,11,7,14,35,48,-13,40
Grasshoppers,8493,7,8,9,15,42,51,-9,33
FC Thun,8493,8,8,7,17,42,62,-20,31
FC Sion,8493,9,6,10,16,43,56,-13,28
Young Boys,8494,1,24,6,2,77,33,44,78
FC Basel,8494,2,17,9,6,56,27,29,60
Lucerne,8494,3,14,7,11,44,43,1,49
St Gallen,8494,4,14,4,14,44,55,-11,46
FC Zürich,8494,5,10,12,10,40,35,5,42
Grasshoppers,8494,6,9,7,16,41,51,-10,34
FC Thun,8494,7,9,7,16,44,60,-16,34
FC Lugano,8494,8,9,6,17,28,50,-22,33
FC Sion,8494,9,5,8,19,38,58,-20,23
Young Boys,8495,1,21,6,5,71,41,30,69
FC Basel,8495,2,18,8,6,54,24,30,62
Lucerne,8495,3,14,7,11,45,46,-1,49
St Gallen,8495,4,13,4,15,38,53,-15,43
FC Zürich,8495,5,10,9,13,38,37,1,39
FC Lugano,8495,6,11,5,16,36,49,-13,38
FC Thun,8495,7,10,6,16,45,58,-13,36
Grasshoppers,8495,8,9,8,15,40,48,-8,35
FC Sion,8495,9,7,9,16,40,51,-11,30
Young Boys,8496,1,20,6,6,69,39,30,66
FC Basel,8496,2,18,9,5,57,26,31,63
St Gallen,8496,3,15,3,14,44,53,-9,48
FC Zürich,8496,4,11,11,10,40,34,6,44
FC Lugano,8496,5,12,5,15,33,46,-13,41
Lucerne,8496,6,11,7,14,39,48,-9,40
Grasshoppers,8496,7,11,6,15,46,50,-4,39
FC Thun,8496,8,10,6,16,45,57,-12,36
FC Sion,8496,9,6,7,19,38,58,-20,25
Young Boys,8497,1,22,7,3,71,34,37,73
FC Basel,8497,2,18,7,7,54,25,29,61
St Gallen,8497,3,15,3,14,46,56,-10,48
Lucerne,8497,4,13,7,12,44,47,-3,46
FC Zürich,8497,5,10,10,12,38,36,2,40
FC Sion,8497,6,9,8,15,43,51,-8,35
FC Thun,8497,7,10,5,17,45,57,-12,35
FC Lugano,8497,8,9,6,17,27,49,-22,33
Grasshoppers,8497,9,8,7,17,38,51,-13,31
Young Boys,8498,1,21,8,3,71,35,36,71
FC Basel,8498,2,16,11,5,51,25,26,59
FC Zürich,8498,3,12,9,11,41,34,7,45
St Gallen,8498,4,14,3,15,43,56,-13,45
Lucerne,8498,5,12,8,12,42,46,-4,44
FC Lugano,8498,6,11,5,16,33,47,-14,38
Grasshoppers,8498,7,9,7,16,41,50,-9,34
FC Thun,8498,8,9,7,16,44,59,-15,34
FC Sion,8498,9,7,8,17,42,56,-14,29
Young Boys,8499,1,22,7,3,74,33,41,73
FC Basel,8499,2,18,8,6,55,27,28,62
St Gallen,8499,3,14,3,15,45,57,-12,45
Lucerne,8499,4,12,7,13,39,43,-4,43
FC Zürich,8499,5,10,11,11,41,37,4,41
FC Lugano,8499,6,11,5,16,30,47,-17,38
Grasshoppers,8499,7,10,7,15,45,56,-11,37
FC Thun,8499,8,9,7,16,49,63,-14,34
FC Sion,8499,9,6,9,17,41,56,-15,27
Young Boys,8500,1,21,7,4,70,35,35,70
FC Basel,8500,2,19,8,5,56,23,33,65
Lucerne,8500,3,13,8,11,40,44,-4,47
FC Zürich,8500,4,11,11,10,39,32,7,44
St Gallen,8500,5,13,5,14,42,55,-13,44
FC Thun,8500,6,10,6,16,47,58,-11,36
Grasshoppers,8500,7,9,7,16,41,53,-12,34
FC Lugano,8500,8,9,6,17,28,47,-19,33
FC Sion,8500,9,6,8,18,42,58,-16,26
Young Boys,8501,1,22,7,3,72,33,39,73
FC Basel,8501,2,17,9,6,57,26,31,60
Lucerne,8501,3,13,9,10,47,41,6,48
St Gallen,8501,4,14,3,15,42,55,-13,45
FC Zürich,8501,5,10,10,12,39,37,2,40
FC Lugano,8501,6,11,6,15,32,50,-18,39
FC Thun,8501,7,10,5,17,43,65,-22,35
Grasshoppers,8501,8,9,7,16,40,51,-11,34
FC Sion,8501,9,6,8,18,39,53,-14,26
Young Boys,8502,1,20,9,3,71,37,34,69
FC Basel,8502,2,17,9,6,54,25,29,60
St Gallen,8502,3,15,2,15,46,58,-12,47
FC Zürich,8502,4,12,10,10,46,35,11,46
Lucerne,8502,5,12,9,11,43,48,-5,45
FC Lugano,8502,6,11,6,15,36,50,-14,39
Grasshoppers,8502,7,10,7,15,40,46,-6,37
FC Thun,8502,8,10,5,17,43,58,-15,35
FC Sion,8502,9,5,7,20,38,60,-22,22
Young Boys,8503,1,22,8,2,73,32,41,74
FC Basel,8503,2,17,10,5,50,22,28,61
St Gallen,8503,3,15,3,14,46,55,-9,48
Lucerne,8503,4,12,8,12,39,45,-6,44
FC Zürich,8503,5,9,9,14,38,39,-1,36
Grasshoppers,8503,6,10,6,16,42,49,-7,36
FC Thun,8503,7,10,5,17,41,59,-18,35
FC Lugano,8503,8,10,5,17,31,50,-19,35
FC Sion,8503,9,8,8,16,42,51,-9,32
Young Boys,8504,1,21,7,4,72,36,36,70
FC Basel,8504,2,17,9,6,55,27,28,60
St Gallen,8504,3,16,2,14,46,55,-9,50
Lucerne,8504,4,13,8,11,44,46,-2,47
FC Zürich,8504,5,11,10,11,43,35,8,43
FC Thun,8504,6,10,5,17,44,61,-17,35
FC Lugano,8504,7,10,5,17,32,50,-18,35
Grasshoppers,8504,8,9,6,17,40,51,-11,33
FC Sion,8504,9,7,8,17,42,57,-15,29
Young Boys,8505,1,21,8,3,76,41,35,71
FC Basel,8505,2,19,7,6,57,29,28,64
Lucerne,8505,3,14,7,11,41,42,-1,49
St Gallen,8505,4,14,2,16,44,59,-15,44
FC Zürich,8505,5,10,10,12,40,38,2,40
FC Lugano,8505,6,10,7,15,32,46,-14,37
Grasshoppers,8505,7,10,6,16,45,51,-6,36
FC Thun,8505,8,10,5,17,49,63,-14,35
FC Sion,8505,9,6,8,18,44,59,-15,26
Young Boys,8506,1,21,9,2,73,33,40,72
FC Basel,8506,2,18,9,5,52,23,29,63
Lucerne,8506,3,12,8,12,41,44,-3,44
St Gallen,8506,4,13,3,16,40,55,-15,42
FC Zürich,8506,5,10,10,12,41,39,2,40
FC Lugano,8506,6,11,7,14,33,45,-12,40
Grasshoppers,8506,7,11,6,15,43,49,-6,39
FC Thun,8506,8,9,7,16,41,57,-16,34
FC Sion,8506,9,5,9,18,38,57,-19,24
Young Boys,8507,1,23,6,3,79,33,46,75
FC Basel,8507,2,18,9,5,57,25,32,63
St Gallen,8507,3,15,4,13,46,53,-7,49
Lucerne,8507,4,12,7,13,43,49,-6,43
FC Zürich,8507,5,10,11,11,41,37,4,41
FC Thun,8507,6,10,6,16,47,61,-14,36
FC Lugano,8507,7,10,5,17,31,52,-21,35
Grasshoppers,8507,8,8,7,17,39,54,-15,31
FC Sion,8507,9,6,9,17,39,58,-19,27
Young Boys,8508,1,20,8,4,68,38,30,68
FC Basel,8508,2,19,8,5,59,23,36,65
Lucerne,8508,3,12,10,10,44,42,2,46
St Gallen,8508,4,14,3,15,39,54,-15,45
FC Zürich,8508,5,9,13,10,39,35,4,40
Grasshoppers,8508,6,8,10,14,42,50,-8,34
FC Thun,8508,7,9,7,16,44,58,-14,34
FC Lugano,8508,8,9,6,17,28,50,-22,33
FC Sion,8508,9,7,9,16,39,52,-13,30
Young Boys,8509,1,23,7,2,79,33,46,76
FC Basel,8509,2,18,7,7,55,28,27,61
Lucerne,8509,3,13,7,12,45,51,-6,46
St Gallen,8509,4,14,3,15,44,54,-10,45
FC Zürich,8509,5,11,10,11,44,38,6,43
Grasshoppers,8509,6,11,6,15,44,52,-8,39
FC Lugano,8509,7,9,7,16,31,50,-19,34
FC Sion,8509,8,7,8,17,44,56,-12,29
FC Thun,8509,9,8,5,19,41,65,-24,29
Young Boys,8510,1,21,7,4,69,34,35,70
FC Basel,8510,2,17,7,8,51,30,21,58
St Gallen,8510,3,14,4,14,43,52,-9,46
Lucerne,8510,4,12,9,11,38,41,-3,45
FC Lugano,8510,5,11,7,14,30,43,-13,40
Grasshoppers,8510,6,10,8,14,44,50,-6,38
FC Zürich,8510,7,9,10,13,37,39,-2,37
FC Thun,8510,8,10,6,16,47,57,-10,36
FC Sion,8510,9,6,10,16,41,54,-13,28
Young Boys,8511,1,22,6,4,76,35,41,72
FC Basel,8511,2,19,7,6,55,25,30,64
St Gallen,8511,3,15,3,14,44,53,-9,48
Lucerne,8511,4,11,8,13,43,51,-8,41
FC Zürich,8511,5,9,12,11,37,35,2,39
Grasshoppers,8511,6,11,6,15,45,49,-4,39
FC Lugano,8511,7,9,8,15,29,48,-19,35
FC Thun,8511,8,9,6,17,40,58,-18,33
FC Sion,8511,9,7,8,17,38,53,-15,29
Young Boys,8512,1,20,9,3,67,32,35,69
FC Basel,8512,2,19,8,5,54,22,32,65
Lucerne,8512,3,12,9,11,41,42,-1,45
St Gallen,8512,4,14,2,16,43,59,-16,44
FC Zürich,8512,5,11,9,12,42,39,3,42
FC Lugano,8512,6,11,6,15,32,45,-13,39
Grasshoppers,8512,7,9,8,15,42,50,-8,35
FC Thun,8512,8,10,5,17,44,62,-18,35
FC Sion,8512,9,6,8,18,40,54,-14,26
Young Boys,8513,1,21,8,3,75,36,39,71
FC Basel,8513,2,16,9,7,51,27,24,57
Lucerne,8513,3,13,9,10,45,44,1,48
St Gallen,8513,4,15,2,15,44,56,-12,47
FC Zürich,8513,5,9,12,11,37,34,3,39
FC Thun,8513,6,11,5,16,45,55,-10,38
Grasshoppers,8513,7,10,6,16,42,53,-11,36
FC Lugano,8513,8,9,7,16,30,48,-18,34
FC Sion,8513,9,7,8,17,41,57,-16,29
Young Boys,8514,1,21,7,4,74,38,36,70
FC Basel,8514,2,18,9,5,56,24,32,63
St Gallen,8514,3,15,3,14,45,55,-10,48
Lucerne,8514,4,13,8,11,46,45,1,47
FC Zürich,8514,5,11,9,12,40,36,4,42
FC Lugano,8514,6,11,5,16,31,49,-18,38
Grasshoppers,8514,7,10,7,15,41,49,-8,37
FC Thun,8514,8,8,5,19,39,61,-22,29
FC Sion,8514,9,7,7,18,42,57,-15,28
Young Boys,8515,1,20,7,5,69,41,28,67
FC Basel,8515,2,19,8,5,58,26,32,65
St Gallen,8515,3,15,3,14,47,56,-9,48
Lucerne,8515,4,12,8,12,40,42,-2,44
FC Zürich,8515,5,10,11,11,42,38,4,41
Grasshoppers,8515,6,11,7,14,45,46,-1,40
FC Thun,8515,7,9,8,15,43,57,-14,35
FC Lugano,8515,8,10,5,17,31,50,-19,35
FC Sion,8515,9,5,9,18,39,58,-19,24
Young Boys,8516,1,22,6,4,75,33,42,72
FC Basel,8516,2,18,7,7,59,29,30,61
St Gallen,8516,3,15,4,13,44,53,-9,49
FC Zürich,8516,4,12,9,11,43,36,7,45
Lucerne,8516,5,12,8,12,41,46,-5,44
Grasshoppers,8516,6,10,7,15,44,49,-5,37
FC Lugano,8516,7,10,6,16,29,51,-22,36
FC Thun,8516,8,9,6,17,44,63,-19,33
FC Sion,8516,9,5,9,18,41,60,-19,24
Young Boys,8517,1,22,6,4,72,38,34,72
FC Basel,8517,2,19,8,5,57,24,33,65
Lucerne,8517,3,13,8,11,44,44,0,47
St Gallen,8517,4,14,2,16,40,55,-15,44
FC Zürich,8517,5,10,12,10,42,34,8,42
Grasshoppers,8517,6,10,7,15,44,47,-3,37
FC Thun,8517,7,9,6,17,44,62,-18,33
FC Lugano,8517,8,9,5,18,28,53,-25,32
FC Sion,8517,9,7,8,17,42,56,-14,29
Young Boys,8518,1,22,8,2,68,31,37,74
FC Basel,8518,2,15,9,8,48,26,22,54
Lucerne,8518,3,14,9,9,44,42,2,51
St Gallen,8518,4,14,4,14,43,53,-10,46
FC Zürich,8518,5,11,10,11,41,36,5,43
FC Thun,8518,6,10,7,15,45,58,-13,37
Grasshoppers,8518,7,9,8,15,43,49,-6,35
FC Lugano,8518,8,9,5,18,27,47,-20,32
FC Sion,8518,9,5,10,17,38,55,-17,25
Young Boys,8519,1,22,8,2,73,31,42,74
FC Basel,8519,2,17,8,7,50,24,26,59
St Gallen,8519,3,16,3,13,47,55,-8,51
Lucerne,8519,4,12,9,11,46,48,-2,45
FC Zürich,8519,5,11,10,11,41,36,5,43
FC Thun,8519,6,10,6,16,44,58,-14,36
FC Lugano,8519,7,10,5,17,35,56,-21,35
Grasshoppers,8519,8,9,7,16,42,51,-9,34
FC Sion,8519,9,5,8,19,37,56,-19,23
Young Boys,8520,1,21,8,3,72,35,37,71
FC Basel,8520,2,18,8,6,55,28,27,62
Lucerne,8520,3,12,9,11,41,44,-3,45
St Gallen,8520,4,14,3,15,42,54,-12,45
FC Zürich,8520,5,11,10,11,42,37,5,43
FC Lugano,8520,6,10,6,16,31,48,-17,36
Grasshoppers,8520,7,9,7,16,41,52,-11,34
FC Thun,8520,8,9,7,16,45,59,-14,34
FC Sion,8520,9,6,10,16,42,54,-12,28
Young Boys,8521,1,21,7,4,73,35,38,70
FC Basel,8521,2,18,8,6,57,27,30,62
St Gallen,8521,3,14,4,14,43,54,-11,46
Lucerne,8521,4,12,7,13,41,48,-7,43
FC Zürich,8521,5,10,9,13,41,40,1,39
Grasshoppers,8521,6,10,7,15,46,53,-7,37
FC Lugano,8521,7,10,6,16,34,50,-16,36
FC Thun,8521,8,10,6,16,44,62,-18,36
FC Sion,8521,9,7,10,15,45,55,-10,31
Young Boys,8522,1,23,6,3,79,37,42,75
FC Basel,8522,2,18,7,7,56,28,28,61
Lucerne,8522,3,14,8,10,43,43,0,50
St Gallen,8522,4,14,2,16,39,53,-14,44
FC Zürich,8522,5,10,9,13,42,40,2,39
FC Lugano,8522,6,11,6,15,33,48,-15,39
FC Thun,8522,7,11,5,16,46,61,-15,38
Grasshoppers,8522,8,9,6,17,42,52,-10,33
FC Sion,8522,9,6,7,19,42,60,-18,25
FC Basel,8523,1,20,7,5,56,22,34,67
Young Boys,8523,2,19,7,6,67,37,30,64
Lucerne,8523,3,14,8,10,41,40,1,50
St Gallen,8523,4,13,3,16,39,55,-16,42
FC Zürich,8523,5,10,10,12,40,39,1,40
Grasshoppers,8523,6,11,6,15,44,49,-5,39
FC Lugano,8523,7,11,6,15,32,44,-12,39
FC Thun,8523,8,9,6,17,43,60,-17,33
FC Sion,8523,9,7,7,18,43,59,-16,28
Young Boys,8524,1,21,7,4,71,37,34,70
FC Basel,8524,2,19,8,5,53,22,31,65
Lucerne,8524,3,12,7,13,42,44,-2,43
St Gallen,8524,4,13,4,15,38,53,-15,43
FC Zürich,8524,5,11,9,12,46,40,6,42
Grasshoppers,8524,6,11,7,14,43,48,-5,40
FC Lugano,8524,7,11,5,16,30,51,-21,38
FC Thun,8524,8,9,5,18,46,60,-14,32
FC Sion,8524,9,6,10,16,41,55,-14,28
Young Boys,8525,1,20,7,5,70,37,33,67
FC Basel,8525,2,17,9,6,55,24,31,60
Lucerne,8525,3,13,9,10,46,47,-1,48
St Gallen,8525,4,13,5,14,44,58,-14,44
FC Zürich,8525,5,10,11,11,40,34,6,41
Grasshoppers,8525,6,10,7,15,42,49,-7,37
FC Lugano,8525,7,10,7,15,35,51,-16,37
FC Thun,8525,8,10,5,17,41,59,-18,35
FC Sion,8525,9,7,8,17,41,55,-14,29
Young Boys,8526,1,20,7,5,68,36,32,67
FC Basel,8526,2,18,9,5,55,26,29,63
Lucerne,8526,3,14,9,9,47,38,9,51
St Gallen,8526,4,14,4,14,45,58,-13,46
FC Zürich,8526,5,9,12,11,36,34,2,39
Grasshoppers,8526,6,10,6,16,39,47,-8,36
FC Thun,8526,7,9,7,16,42,57,-15,34
FC Lugano,8526,8,9,7,16,30,51,-21,34
FC Sion,8526,9,6,9,17,39,54,-15,27
Young Boys,8527,1,23,6,3,75,32,43,75
FC Basel,8527,2,18,7,7,53,26,27,61
Lucerne,8527,3,14,8,10,47,45,2,50
St Gallen,8527,4,14,4,14,45,58,-13,46
FC Zürich,8527,5,10,10,12,42,38,4,40
FC Thun,8527,6,11,5,16,44,56,-12,38
FC Lugano,8527,7,9,7,16,30,48,-18,34
Grasshoppers,8527,8,8,7,17,38,55,-17,31
FC Sion,8527,9,6,8,18,41,57,-16,26
Young Boys,8528,1,20,8,4,69,35,34,68
FC Basel,8528,2,20,7,5,58,21,37,67
Lucerne,8528,3,12,9,11,41,45,-4,45
St Gallen,8528,4,14,2,16,40,56,-16,44
Grasshoppers,8528,5,12,6,14,45,47,-2,42
FC Zürich,8528,6,10,9,13,40,39,1,39
FC Lugano,8528,7,10,7,15,30,45,-15,37
FC Thun,8528,8,10,5,17,41,58,-17,35
FC Sion,8528,9,6,7,19,38,56,-18,25
Young Boys,8529,1,23,6,3,71,30,41,75
FC Basel,8529,2,17,9,6,55,25,30,60
St Gallen,8529,3,15,3,14,45,55,-10,48
Lucerne,8529,4,12,7,13,42,49,-7,43
FC Zürich,8529,5,10,11,11,41,37,4,41
Grasshoppers,8529,6,11,6,15,43,47,-4,39
FC Lugano,8529,7,10,5,17,30,51,-21,35
FC Thun,8529,8,9,6,17,41,60,-19,33
FC Sion,8529,9,7,7,18,40,54,-14,28
Young Boys,8530,1,21,6,5,70,40,30,69
FC Basel,8530,2,16,9,7,52,26,26,57
Lucerne,8530,3,13,10,9,42,41,1,49
St Gallen,8530,4,14,4,14,41,51,-10,46
FC Zürich,8530,5,11,10,11,41,36,5,43
FC Lugano,8530,6,11,6,15,32,43,-11,39
Grasshoppers,8530,7,9,8,15,39,50,-11,35
FC Thun,8530,8,10,5,17,45,58,-13,35
FC Sion,8530,9,6,8,18,42,59,-17,26
Young Boys,8531,1,20,8,4,66,34,32,68
FC Basel,8531,2,17,9,6,53,27,26,60
St Gallen,8531,3,15,3,14,47,54,-7,48
Lucerne,8531,4,13,7,12,42,45,-3,46
FC Zürich,8531,5,11,10,11,43,40,3,43
FC Lugano,8531,6,11,6,15,33,46,-13,39
FC Thun,8531,7,10,6,16,47,59,-12,36
Grasshoppers,8531,8,8,8,16,42,52,-10,32
FC Sion,8531,9,7,7,18,41,57,-16,28
Young Boys,8532,1,22,7,3,70,34,36,73
FC Basel,8532,2,17,7,8,51,27,24,58
St Gallen,8532,3,15,2,15,42,55,-13,47
Lucerne,8532,4,13,7,12,39,41,-2,46
FC Zürich,8532,5,10,10,12,41,37,4,40
Grasshoppers,8532,6,10,7,15,42,48,-6,37
FC Thun,8532,7,10,7,15,45,58,-13,37
FC Lugano,8532,8,10,6,16,31,47,-16,36
FC Sion,8532,9,6,9,17,43,57,-14,27
Young Boys,8533,1,23,6,3,70,32,38,75
FC Basel,8533,2,17,8,7,51,26,25,59
Lucerne,8533,3,14,9,9,48,40,8,51
St Gallen,8533,4,14,2,16,42,63,-21,44
FC Zürich,8533,5,11,10,11,46,36,10,43
FC Lugano,8533,6,10,7,15,35,49,-14,37
FC Thun,8533,7,10,5,17,42,57,-15,35
Grasshoppers,8533,8,9,6,17,40,54,-14,33
FC Sion,8533,9,6,7,19,41,58,-17,25
Young Boys,8534,1,20,8,4,70,36,34,68
FC Basel,8534,2,19,7,6,57,26,31,64
Lucerne,8534,3,13,8,11,43,44,-1,47
St Gallen,8534,4,15,2,15,46,57,-11,47
FC Zürich,8534,5,11,10,11,41,36,5,43
FC Lugano,8534,6,11,5,16,34,52,-18,38
Grasshoppers,8534,7,10,7,15,43,49,-6,37
FC Thun,8534,8,9,6,17,42,59,-17,33
FC Sion,8534,9,5,9,18,39,56,-17,24
Young Boys,8535,1,20,8,4,67,33,34,68
FC Basel,8535,2,20,7,5,62,25,37,67
Lucerne,8535,3,13,8,11,40,44,-4,47
St Gallen,8535,4,14,2,16,44,58,-14,44
FC Zürich,8535,5,10,10,12,42,37,5,40
FC Thun,8535,6,11,5,16,44,59,-15,38
FC Lugano,8535,7,10,6,16,30,47,-17,36
Grasshoppers,8535,8,8,9,15,39,48,-9,33
FC Sion,8535,9,6,9,17,40,57,-17,27
Young Boys,8536,1,21,7,4,69,35,34,70
FC Basel,8536,2,18,8,6,55,28,27,62
Lucerne,8536,3,15,7,10,46,39,7,52
St Gallen,8536,4,14,2,16,42,57,-15,44
FC Zürich,8536,5,10,11,11,41,38,3,41
FC Lugano,8536,6,11,5,16,33,48,-15,38
Grasshoppers,8536,7,9,7,16,40,51,-11,34
FC Sion,8536,8,8,8,16,41,51,-10,32
FC Thun,8536,9,8,5,19,41,61,-20,29
Young Boys,8537,1,20,10,2,75,39,36,70
FC Basel,8537,2,16,9,7,55,28,27,57
Lucerne,8537,3,12,10,10,42,43,-1,46
FC Zürich,8537,4,12,9,11,42,35,7,45
St Gallen,8537,5,14,3,15,42,55,-13,45
FC Lugano,8537,6,11,7,14,34,46,-12,40
Grasshoppers,8537,7,9,8,15,40,47,-7,35
FC Thun,8537,8,8,6,18,41,64,-23,30
FC Sion,8537,9,6,10,16,40,54,-14,28
Young Boys,8538,1,22,6,4,72,33,39,72
FC Basel,8538,2,18,7,7,52,27,25,61
Lucerne,8538,3,13,8,11,42,43,-1,47
St Gallen,8538,4,15,2,15,43,54,-11,47
FC Zürich,8538,5,11,10,11,42,37,5,43
FC Lugano,8538,6,10,6,16,32,49,-17,36
Grasshoppers,8538,7,9,7,16,41,51,-10,34
FC Thun,8538,8,9,6,17,43,59,-16,33
FC Sion,8538,9,7,8,17,41,55,-14,29
Young Boys,8539,1,21,7,4,73,34,39,70
FC Basel,8539,2,18,8,6,51,27,24,62
Lucerne,8539,3,13,8,11,41,43,-2,47
St Gallen,8539,4,13,4,15,40,55,-15,43
FC Zürich,8539,5,11,9,12,39,35,4,42
FC Lugano,8539,6,11,5,16,33,48,-15,38
FC Thun,8539,7,10,7,15,46,56,-10,37
Grasshoppers,8539,8,8,8,16,41,52,-11,32
FC Sion,8539,9,7,8,17,41,55,-14,29
Young Boys,8540,1,20,7,5,67,40,27,67
FC Basel,8540,2,16,9,7,55,28,27,57
St Gallen,8540,3,14,4,14,43,58,-15,46
Lucerne,8540,4,12,9,11,41,44,-3,45
FC Zürich,8540,5,11,10,11,45,39,6,43
FC Thun,8540,6,11,6,15,46,58,-12,39
FC Lugano,8540,7,10,8,14,35,48,-13,38
Grasshoppers,8540,8,8,9,15,40,49,-9,33
FC Sion,8540,9,7,8,17,49,57,-8,29
Young Boys,8541,1,24,6,2,73,32,41,78
FC Basel,8541,2,18,8,6,56,28,28,62
Lucerne,8541,3,13,7,12,40,42,-2,46
St Gallen,8541,4,14,4,14,44,54,-10,46
FC Zürich,8541,5,11,10,11,41,36,5,43
Grasshoppers,8541,6,10,6,16,43,50,-7,36
FC Lugano,8541,7,9,6,17,28,46,-18,33
FC Thun,8541,8,8,6,18,42,62,-20,30
FC Sion,8541,9,7,7,18,39,56,-17,28
Young Boys,8542,1,23,6,3,73,36,37,75
FC Basel,8542,2,18,8,6,52,23,29,62
Lucerne,8542,3,14,7,11,41,41,0,49
St Gallen,8542,4,14,3,15,41,53,-12,45
FC Zürich,8542,5,10,10,12,40,38,2,40
FC Thun,8542,6,10,6,16,44,57,-13,36
FC Lugano,8542,7,9,6,17,31,49,-18,33
FC Sion,8542,8,8,8,16,44,55,-11,32
Grasshoppers,8542,9,8,6,18,41,55,-14,30
Young Boys,8543,1,22,6,4,73,36,37,72
FC Basel,8543,2,18,7,7,55,30,25,61
Lucerne,8543,3,15,8,9,48,42,6,53
FC Zürich,8543,4,11,10,11,43,39,4,43
St Gallen,8543,5,13,3,16,40,56,-16,42
FC Lugano,8543,6,11,5,16,31,46,-15,38
FC Thun,8543,7,9,7,16,45,60,-15,34
Grasshoppers,8543,8,9,6,17,46,55,-9,33
FC Sion,8543,9,6,8,18,41,58,-17,26
Young Boys,8544,1,21,8,3,71,36,35,71
FC Basel,8544,2,17,8,7,55,31,24,59
Lucerne,8544,3,15,7,10,46,44,2,52
St Gallen,8544,4,16,2,14,50,55,-5,50
FC Zürich,8544,5,10,10,12,40,37,3,40
FC Lugano,8544,6,10,5,17,30,48,-18,35
Grasshoppers,8544,7,9,7,16,41,51,-10,34
FC Thun,8544,8,9,6,17,43,59,-16,33
FC Sion,8544,9,7,7,18,42,57,-15,28
Young Boys,8545,1,21,6,5,73,38,35,69
FC Basel,8545,2,17,9,6,54,25,29,60
St Gallen,8545,3,14,3,15,43,56,-13,45
Lucerne,8545,4,12,8,12,41,46,-5,44
FC Lugano,8545,5,13,5,14,37,45,-8,44
FC Zürich,8545,6,11,10,11,40,36,4,43
FC Thun,8545,7,10,6,16,43,58,-15,36
Grasshoppers,8545,8,9,6,17,40,53,-13,33
FC Sion,8545,9,7,7,18,44,58,-14,28
Young Boys,8546,1,22,7,3,70,33,37,73
FC Basel,8546,2,17,9,6,53,25,28,60
FC Zürich,8546,3,12,10,10,44,35,9,46
Lucerne,8546,4,12,9,11,42,44,-2,45
St Gallen,8546,5,14,2,16,45,58,-13,44
Grasshoppers,8546,6,9,8,15,41,53,-12,35
FC Lugano,8546,7,10,5,17,28,48,-20,35
FC Thun,8546,8,9,7,16,44,60,-16,34
FC Sion,8546,9,7,7,18,45,56,-11,28
Young Boys,8547,1,21,9,2,75,34,41,72
FC Basel,8547,2,17,10,5,58,27,31,61
St Gallen,8547,3,14,5,13,43,52,-9,47
Lucerne,8547,4,12,8,12,40,48,-8,44
FC Zürich,8547,5,10,11,11,43,41,2,41
Grasshoppers,8547,6,9,8,15,47,55,-8,35
FC Thun,8547,7,9,7,16,44,62,-18,34
FC Lugano,8547,8,9,7,16,28,47,-19,34
FC Sion,8547,9,6,9,17,44,56,-12,27
Young Boys,8548,1,23,7,2,75,35,40,76
FC Basel,8548,2,18,9,5,58,26,32,63
St Gallen,8548,3,15,3,14,44,51,-7,48
Lucerne,8548,4,13,7,12,45,48,-3,46
FC Zürich,8548,5,11,9,12,41,36,5,42
Grasshoppers,8548,6,10,6,16,43,50,-7,36
FC Lugano,8548,7,10,5,17,30,49,-19,35
FC Thun,8548,8,9,5,18,44,63,-19,32
FC Sion,8548,9,6,7,19,39,61,-22,25
Young Boys,8549,1,20,8,4,68,35,33,68
FC Basel,8549,2,17,10,5,49,21,28,61
St Gallen,8549,3,14,5,13,41,50,-9,47
Lucerne,8549,4,12,10,10,42,43,-1,46
FC Zürich,8549,5,11,10,11,42,34,8,43
FC Thun,8549,6,11,5,16,45,56,-11,38
FC Lugano,8549,7,10,6,16,32,49,-17,36
Grasshoppers,8549,8,9,7,16,42,51,-9,34
FC Sion,8549,9,6,7,19,40,62,-22,25
Young Boys,8550,1,22,7,3,71,34,37,73
FC Basel,8550,2,18,7,7,57,29,28,61
FC Zürich,8550,3,12,10,10,43,34,9,46
St Gallen,8550,4,13,5,14,45,59,-14,44
Lucerne,8550,5,11,8,13,41,52,-11,41
FC Lugano,8550,6,10,8,14,31,43,-12,38
Grasshoppers,8550,7,10,6,16,43,50,-7,36
FC Thun,8550,8,9,5,18,41,61,-20,32
FC Sion,8550,9,7,8,17,46,56,-10,29
Young Boys,8551,1,22,7,3,74,37,37,73
FC Basel,8551,2,18,7,7,57,27,30,61
FC Zürich,8551,3,12,9,11,43,34,9,45
St Gallen,8551,4,14,3,15,43,60,-17,45
Lucerne,8551,5,12,8,12,41,49,-8,44
FC Lugano,8551,6,11,5,16,33,45,-12,38
FC Thun,8551,7,10,5,17,46,62,-16,35
FC Sion,8551,8,8,7,17,44,55,-11,31
Grasshoppers,8551,9,8,7,17,37,49,-12,31
Young Boys,8552,1,22,7,3,74,34,40,73
FC Basel,8552,2,17,10,5,57,28,29,61
Lucerne,8552,3,14,7,11,48,47,1,49
FC Zürich,8552,4,11,10,11,42,38,4,43
St Gallen,8552,5,13,4,15,42,57,-15,43
FC Lugano,8552,6,11,5,16,32,49,-17,38
FC Thun,8552,7,10,5,17,49,61,-12,35
Grasshoppers,8552,8,8,7,17,38,54,-16,31
FC Sion,8552,9,6,9,17,40,54,-14,27
Young Boys,8553,1,21,7,4,73,36,37,70
FC Basel,8553,2,18,8,6,54,27,27,62
Lucerne,8553,3,13,7,12,46,49,-3,46
St Gallen,8553,4,14,3,15,46,58,-12,45
FC Zürich,8553,5,11,11,10,43,35,8,44
FC Thun,8553,6,11,5,16,46,58,-12,38
FC Lugano,8553,7,10,7,15,34,50,-16,37
Grasshoppers,8553,8,9,7,16,40,49,-9,34
FC Sion,8553,9,6,7,19,38,58,-20,25
Young Boys,8554,1,21,6,5,73,41,32,69
FC Basel,8554,2,17,9,6,51,28,23,60
Lucerne,8554,3,13,8,11,43,43,0,47
FC Zürich,8554,4,11,11,10,43,34,9,44
St Gallen,8554,5,13,4,15,42,55,-13,43
FC Lugano,8554,6,11,6,15,35,50,-15,39
FC Thun,8554,7,10,6,16,43,56,-13,36
Grasshoppers,8554,8,9,7,16,43,53,-10,34
FC Sion,8554,9,6,9,17,40,53,-13,27
Young Boys,8555,1,21,6,5,68,36,32,69
FC Basel,8555,2,20,7,5,61,25,36,67
Lucerne,8555,3,14,7,11,43,44,-1,49
St Gallen,8555,4,14,3,15,41,56,-15,45
FC Zürich,8555,5,11,10,11,42,37,5,43
Grasshoppers,8555,6,11,6,15,43,48,-5,39
FC Lugano,8555,7,10,6,16,32,48,-16,36
FC Thun,8555,8,9,5,18,44,61,-17,32
FC Sion,8555,9,5,8,19,38,57,-19,23
Young Boys,8556,1,21,8,3,70,37,33,71
FC Basel,8556,2,16,11,5,53,25,28,59
Lucerne,8556,3,13,9,10,42,42,0,48
St Gallen,8556,4,15,2,15,43,54,-11,47
FC Zürich,8556,5,11,10,11,42,36,6,43
FC Thun,8556,6,10,6,16,44,58,-14,36
FC Lugano,8556,7,10,5,17,31,48,-17,35
Grasshoppers,8556,8,9,6,17,40,50,-10,33
FC Sion,8556,9,7,7,18,42,57,-15,28
Young Boys,8557,1,21,7,4,71,35,36,70
FC Basel,8557,2,19,7,6,58,23,35,64
St Gallen,8557,3,16,2,14,42,54,-12,50
Lucerne,8557,4,13,7,12,42,44,-2,46
FC Zürich,8557,5,11,9,12,42,38,4,42
Grasshoppers,8557,6,10,7,15,43,47,-4,37
FC Thun,8557,7,10,6,16,46,62,-16,36
FC Lugano,8557,8,10,6,16,30,46,-16,36
FC Sion,8557,9,5,7,20,37,62,-25,22
Young Boys,8558,1,21,7,4,73,33,40,70
FC Basel,8558,2,19,8,5,58,27,31,65
Lucerne,8558,3,13,7,12,40,43,-3,46
St Gallen,8558,4,13,4,15,42,58,-16,43
FC Zürich,8558,5,10,11,11,44,40,4,41
FC Lugano,8558,6,10,7,15,34,52,-18,37
FC Thun,8558,7,10,6,16,47,61,-14,36
Grasshoppers,8558,8,9,7,16,42,51,-9,34
FC Sion,8558,9,7,7,18,42,57,-15,28
Young Boys,8559,1,22,7,3,72,35,37,73
FC Basel,8559,2,18,8,6,52,24,28,62
St Gallen,8559,3,16,3,13,46,53,-7,51
Lucerne,8559,4,13,7,12,46,47,-1,46
FC Zürich,8559,5,10,9,13,41,37,4,39
FC Thun,8559,6,10,6,16,42,55,-13,36
FC Lugano,8559,7,10,5,17,30,51,-21,35
Grasshoppers,8559,8,9,7,16,41,50,-9,34
FC Sion,8559,9,6,8,18,38,56,-18,26
Young Boys,8560,1,22,7,3,75,40,35,73
FC Basel,8560,2,19,8,5,60,25,35,65
Lucerne,8560,3,13,8,11,45,47,-2,47
St Gallen,8560,4,15,2,15,46,57,-11,47
FC Lugano,8560,5,11,5,16,31,47,-16,38
FC Zürich,8560,6,9,9,14,38,42,-4,36
Grasshoppers,8560,7,10,6,16,43,49,-6,36
FC Thun,8560,8,9,5,18,42,62,-20,32
FC Sion,8560,9,7,8,17,45,56,-11,29
Young Boys,8561,1,20,9,3,70,35,35,69
FC Basel,8561,2,17,8,7,53,25,28,59
Lucerne,8561,3,13,9,10,42,41,1,48
FC Zürich,8561,4,12,10,10,42,34,8,46
St Gallen,8561,5,14,3,15,41,56,-15,45
FC Lugano,8561,6,10,6,16,34,50,-16,36
Grasshoppers,8561,7,9,8,15,39,47,-8,35
FC Thun,8561,8,9,5,18,42,60,-18,32
FC Sion,8561,9,6,10,16,38,53,-15,28
Young Boys,8562,1,21,6,5,72,40,32,69
FC Basel,8562,2,20,7,5,62,27,35,67
Lucerne,8562,3,13,8,11,46,46,0,47
FC Zürich,8562,4,11,9,12,41,37,4,42
St Gallen,8562,5,13,3,16,42,59,-17,42
FC Lugano,8562,6,12,5,15,34,47,-13,41
Grasshoppers,8562,7,10,7,15,46,49,-3,37
FC Thun,8562,8,9,5,18,45,64,-19,32
FC Sion,8562,9,6,8,18,42,61,-19,26
Young Boys,8563,1,22,7,3,72,37,35,73
FC Basel,8563,2,18,7,7,55,26,29,61
St Gallen,8563,3,16,2,14,45,53,-8,50
Lucerne,8563,4,13,7,12,42,44,-2,46
FC Lugano,8563,5,11,5,16,31,46,-15,38
FC Zürich,8563,6,9,10,13,38,39,-1,37
Grasshoppers,8563,7,10,6,16,41,48,-7,36
FC Thun,8563,8,10,5,17,43,60,-17,35
FC Sion,8563,9,6,9,17,42,56,-14,27
Young Boys,8564,1,22,6,4,71,35,36,72
FC Basel,8564,2,20,7,5,58,22,36,67
St Gallen,8564,3,15,3,14,43,53,-10,48
Lucerne,8564,4,12,8,12,41,45,-4,44
FC Zürich,8564,5,11,10,11,42,37,5,43
Grasshoppers,8564,6,9,7,16,40,51,-11,34
FC Lugano,8564,7,9,7,16,31,50,-19,34
FC Thun,8564,8,9,5,18,42,61,-19,32
FC Sion,8564,9,7,7,18,41,55,-14,28
Young Boys,8565,1,22,7,3,74,35,39,73
FC Basel,8565,2,17,9,6,55,27,28,60
St Gallen,8565,3,14,4,14,42,51,-9,46
FC Zürich,8565,4,11,10,11,40,35,5,43
FC Lugano,8565,5,12,6,14,31,43,-12,42
Lucerne,8565,6,11,7,14,38,48,-10,40
Grasshoppers,8565,7,10,6,16,42,51,-9,36
FC Sion,8565,8,8,8,16,42,54,-12,32
FC Thun,8565,9,8,5,19,38,58,-20,29
Young Boys,8566,1,21,6,5,73,39,34,69
FC Basel,8566,2,17,10,5,53,24,29,61
FC Zürich,8566,3,11,11,10,40,34,6,44
Lucerne,8566,4,11,11,10,42,46,-4,44
St Gallen,8566,5,13,4,15,41,55,-14,43
Grasshoppers,8566,6,10,7,15,44,50,-6,37
FC Lugano,8566,7,10,6,16,31,48,-17,36
FC Sion,8566,8,9,7,16,45,53,-8,34
FC Thun,8566,9,8,6,18,43,63,-20,30
Young Boys,8567,1,21,9,2,74,35,39,72
FC Basel,8567,2,17,9,6,55,28,27,60
St Gallen,8567,3,15,2,15,45,55,-10,47
FC Zürich,8567,4,11,10,11,42,36,6,43
Lucerne,8567,5,12,7,13,41,47,-6,43
FC Lugano,8567,6,11,6,15,33,45,-12,39
Grasshoppers,8567,7,10,6,16,43,52,-9,36
FC Thun,8567,8,10,5,17,45,60,-15,35
FC Sion,8567,9,6,8,18,42,62,-20,26
Young Boys,8568,1,22,7,3,71,35,36,73
FC Basel,8568,2,18,7,7,54,26,28,61
St Gallen,8568,3,14,3,15,46,57,-11,45
Lucerne,8568,4,12,8,12,43,50,-7,44
FC Zürich,8568,5,11,9,12,41,37,4,42
Grasshoppers,8568,6,10,6,16,44,53,-9,36
FC Thun,8568,7,10,6,16,46,61,-15,36
FC Lugano,8568,8,9,8,15,32,48,-16,35
FC Sion,8568,9,7,8,17,40,50,-10,29
Young Boys,8569,1,22,6,4,75,34,41,72
FC Basel,8569,2,19,7,6,54,25,29,64
St Gallen,8569,3,16,2,14,47,52,-5,50
Lucerne,8569,4,13,7,12,40,46,-6,46
Grasshoppers,8569,5,11,6,15,46,48,-2,39
FC Lugano,8569,6,11,5,16,30,47,-17,38
FC Zürich,8569,7,9,10,13,39,39,0,37
FC Thun,8569,8,9,6,17,43,63,-20,33
FC Sion,8569,9,6,7,19,37,57,-20,25
Young Boys,8570,1,21,8,3,68,34,34,71
FC Basel,8570,2,17,9,6,53,26,27,60
St Gallen,8570,3,14,4,14,42,53,-11,46
Lucerne,8570,4,11,9,12,39,45,-6,42
FC Zürich,8570,5,10,10,12,40,39,1,40
FC Lugano,8570,6,10,8,14,33,46,-13,38
Grasshoppers,8570,7,10,7,15,40,46,-6,37
FC Thun,8570,8,10,6,16,44,56,-12,36
FC Sion,8570,9,7,7,18,39,53,-14,28
Young Boys,8571,1,21,6,5,68,38,30,69
FC Basel,8571,2,19,8,5,60,26,34,65
Lucerne,8571,3,12,9,11,46,47,-1,45
St Gallen,8571,4,13,5,14,42,55,-13,44
FC Zürich,8571,5,10,9,13,39,39,0,39
FC Thun,8571,6,10,6,16,47,57,-10,36
FC Lugano,8571,7,10,6,16,32,47,-15,36
Grasshoppers,8571,8,9,7,16,40,54,-14,34
FC Sion,8571,9,7,10,15,38,49,-11,31
Young Boys,8572,1,20,8,4,71,38,33,68
FC Basel,8572,2,17,9,6,54,27,27,60
Lucerne,8572,3,13,8,11,42,44,-2,47
St Gallen,8572,4,13,5,14,40,53,-13,44
FC Zürich,8572,5,10,10,12,42,40,2,40
FC Lugano,8572,6,10,7,15,32,48,-16,37
Grasshoppers,8572,7,10,6,16,43,50,-7,36
FC Sion,8572,8,8,9,15,43,52,-9,33
FC Thun,8572,9,9,6,17,46,61,-15,33
Young Boys,8573,1,21,7,4,74,37,37,70
FC Basel,8573,2,18,9,5,53,24,29,63
St Gallen,8573,3,13,5,14,44,57,-13,44
Lucerne,8573,4,11,10,11,43,49,-6,43
FC Zürich,8573,5,10,9,13,38,38,0,39
FC Lugano,8573,6,11,6,15,34,47,-13,39
Grasshoppers,8573,7,10,8,14,41,47,-6,38
FC Thun,8573,8,10,6,16,43,56,-13,36
FC Sion,8573,9,6,8,18,41,56,-15,26
Young Boys,8574,1,21,8,3,75,37,38,71
FC Basel,8574,2,17,8,7,53,27,26,59
St Gallen,8574,3,15,2,15,43,54,-11,47
Lucerne,8574,4,12,9,11,43,47,-4,45
FC Zürich,8574,5,11,10,11,41,35,6,43
FC Thun,8574,6,10,5,17,42,59,-17,35
FC Sion,8574,7,9,7,16,44,53,-9,34
FC Lugano,8574,8,9,7,16,30,48,-18,34
Grasshoppers,8574,9,9,6,17,41,52,-11,33
Young Boys,8575,1,22,7,3,74,32,42,73
FC Basel,8575,2,17,9,6,50,24,26,60
St Gallen,8575,3,15,2,15,42,56,-14,47
FC Zürich,8575,4,11,11,10,41,33,8,44
Lucerne,8575,5,11,11,10,39,42,-3,44
Grasshoppers,8575,6,11,7,14,42,45,-3,40
FC Lugano,8575,7,9,7,16,31,51,-20,34
FC Thun,8575,8,8,6,18,40,59,-19,30
FC Sion,8575,9,6,8,18,41,58,-17,26
Young Boys,8576,1,21,7,4,71,38,33,70
FC Basel,8576,2,17,8,7,55,30,25,59
Lucerne,8576,3,13,9,10,44,45,-1,48
FC Zürich,8576,4,12,10,10,44,35,9,46
St Gallen,8576,5,13,2,17,42,60,-18,41
FC Lugano,8576,6,11,6,15,33,46,-13,39
FC Sion,8576,7,8,9,15,46,52,-6,33
FC Thun,8576,8,9,6,17,44,61,-17,33
Grasshoppers,8576,9,8,7,17,38,50,-12,31
Young Boys,8577,1,22,6,4,73,34,39,72
FC Basel,8577,2,18,9,5,55,27,28,63
St Gallen,8577,3,15,3,14,45,55,-10,48
Lucerne,8577,4,12,9,11,41,43,-2,45
FC Zürich,8577,5,11,11,10,43,34,9,44
Grasshoppers,8577,6,8,9,15,41,51,-10,33
FC Lugano,8577,7,9,6,17,29,50,-21,33
FC Sion,8577,8,7,9,16,41,55,-14,30
FC Thun,8577,9,8,6,18,40,59,-19,30
Young Boys,8578,1,23,7,2,75,35,40,76
FC Basel,8578,2,18,8,6,57,28,29,62
St Gallen,8578,3,16,2,14,44,54,-10,50
Lucerne,8578,4,12,8,12,42,46,-4,44
FC Zürich,8578,5,11,10,11,42,36,6,43
Grasshoppers,8578,6,10,7,15,42,50,-8,37
FC Lugano,8578,7,9,5,18,30,51,-21,32
FC Thun,8578,8,8,6,18,40,60,-20,30
FC Sion,8578,9,7,7,18,42,54,-12,28
Young Boys,8579,1,22,7,3,72,34,38,73
FC Basel,8579,2,18,7,7,51,25,26,61
Lucerne,8579,3,14,8,10,46,40,6,50
St Gallen,8579,4,15,4,13,43,51,-8,49
FC Zürich,8579,5,9,11,12,40,39,1,38
FC Lugano,8579,6,10,5,17,30,51,-21,35
FC Thun,8579,7,9,6,17,44,60,-16,33
Grasshoppers,8579,8,8,8,16,41,53,-12,32
FC Sion,8579,9,6,10,16,40,54,-14,28
Young Boys,8580,1,21,9,2,72,33,39,72
FC Basel,8580,2,16,9,7,55,28,27,57
Lucerne,8580,3,13,8,11,44,46,-2,47
St Gallen,8580,4,14,3,15,49,60,-11,45
FC Zürich,8580,5,10,10,12,39,36,3,40
FC Lugano,8580,6,11,5,16,32,50,-18,38
FC Thun,8580,7,10,6,16,43,60,-17,36
Grasshoppers,8580,8,8,9,15,39,48,-9,33
FC Sion,8580,9,7,9,16,44,56,-12,30
Young Boys,8581,1,23,7,2,75,34,41,76
FC Basel,8581,2,15,10,7,49,28,21,55
St Gallen,8581,3,16,3,13,50,52,-2,51
Lucerne,8581,4,13,8,11,43,48,-5,47
FC Zürich,8581,5,10,10,12,39,38,1,40
FC Thun,8581,6,10,7,15,46,56,-10,37
FC Lugano,8581,7,10,6,16,34,49,-15,36
Grasshoppers,8581,8,8,7,17,38,55,-17,31
FC Sion,8581,9,6,8,18,39,53,-14,26
Young Boys,8582,1,22,7,3,71,33,38,73
FC Basel,8582,2,18,8,6,56,26,30,62
FC Zürich,8582,3,12,9,11,46,36,10,45
Lucerne,8582,4,12,8,12,38,46,-8,44
St Gallen,8582,5,13,3,16,40,54,-14,42
FC Thun,8582,6,11,5,16,51,57,-6,38
Grasshoppers,8582,7,10,6,16,41,55,-14,36
FC Lugano,8582,8,10,5,17,29,50,-21,35
FC Sion,8582,9,7,7,18,41,56,-15,28
Young Boys,8583,1,23,6,3,74,36,38,75
FC Basel,8583,2,18,9,5,57,26,31,63
Lucerne,8583,3,13,8,11,46,45,1,47
St Gallen,8583,4,15,2,15,45,55,-10,47
FC Zürich,8583,5,10,9,13,42,42,0,39
FC Lugano,8583,6,11,5,16,34,53,-19,38
Grasshoppers,8583,7,9,7,16,39,49,-10,34
FC Thun,8583,8,9,7,16,45,61,-16,34
FC Sion,8583,9,6,7,19,39,54,-15,25
Young Boys,8584,1,22,6,4,79,37,42,72
FC Basel,8584,2,20,7,5,60,23,37,67
St Gallen,8584,3,15,2,15,43,54,-11,47
Lucerne,8584,4,12,8,12,41,47,-6,44
FC Zürich,8584,5,10,11,11,41,38,3,41
FC Sion,8584,6,9,8,15,43,52,-9,35
FC Thun,8584,7,9,6,17,48,62,-14,33
FC Lugano,8584,8,9,6,17,27,52,-25,33
Grasshoppers,8584,9,8,6,18,38,55,-17,30
Young Boys,8585,1,24,6,2,75,32,43,78
FC Basel,8585,2,18,8,6,54,27,27,62
Lucerne,8585,3,14,7,11,44,42,2,49
FC Zürich,8585,4,10,12,10,41,35,6,42
St Gallen,8585,5,13,3,16,39,55,-16,42
FC Lugano,8585,6,10,5,17,30,51,-21,35
FC Thun,8585,7,9,6,17,48,62,-14,33
Grasshoppers,8585,8,8,7,17,38,52,-14,31
FC Sion,8585,9,6,10,16,37,50,-13,28
Young Boys,8586,1,23,6,3,78,37,41,75
FC Basel,8586,2,18,7,7,52,27,25,61
St Gallen,8586,3,15,2,15,45,53,-8,47
FC Zürich,8586,4,12,9,11,43,36,7,45
Lucerne,8586,5,12,8,12,40,47,-7,44
Grasshoppers,8586,6,11,7,14,48,48,0,40
FC Lugano,8586,7,10,5,17,29,48,-19,35
FC Thun,8586,8,9,5,18,44,63,-19,32
FC Sion,8586,9,6,7,19,41,61,-20,25
Young Boys,8587,1,22,7,3,72,32,40,73
FC Basel,8587,2,19,8,5,53,22,31,65
St Gallen,8587,3,14,5,13,44,52,-8,47
Lucerne,8587,4,12,7,13,40,49,-9,43
FC Zürich,8587,5,11,9,12,40,36,4,42
Grasshoppers,8587,6,10,7,15,41,48,-7,37
FC Thun,8587,7,10,6,16,43,58,-15,36
FC Lugano,8587,8,9,6,17,28,47,-19,33
FC Sion,8587,9,5,9,18,39,56,-17,24
Young Boys,8588,1,21,7,4,74,37,37,70
FC Basel,8588,2,15,10,7,51,29,22,55
Lucerne,8588,3,13,9,10,45,43,2,48
St Gallen,8588,4,13,6,13,43,54,-11,45
FC Zürich,8588,5,10,10,12,40,37,3,40
Grasshoppers,8588,6,11,6,15,44,50,-6,39
FC Lugano,8588,7,10,7,15,31,47,-16,37
FC Thun,8588,8,10,5,17,43,59,-16,35
FC Sion,8588,9,7,8,17,40,55,-15,29
Young Boys,8589,1,22,6,4,67,34,33,72
FC Basel,8589,2,18,7,7,56,25,31,61
St Gallen,8589,3,15,3,14,43,53,-10,48
Lucerne,8589,4,12,7,13,42,49,-7,43
FC Zürich,8589,5,10,10,12,38,35,3,40
Grasshoppers,8589,6,11,6,15,44,49,-5,39
FC Lugano,8589,7,10,6,16,31,47,-16,36
FC Sion,8589,8,8,8,16,43,52,-9,32
FC Thun,8589,9,9,5,18,43,63,-20,32
Young Boys,8590,1,21,8,3,72,37,35,71
FC Basel,8590,2,19,8,5,56,23,33,65
Lucerne,8590,3,14,8,10,45,43,2,50
St Gallen,8590,4,13,4,15,40,54,-14,43
FC Zürich,8590,5,9,11,12,37,35,2,38
FC Lugano,8590,6,11,5,16,32,49,-17,38
Grasshoppers,8590,7,10,7,15,42,49,-7,37
FC Thun,8590,8,8,7,17,40,59,-19,31
FC Sion,8590,9,5,10,17,37,52,-15,25
Young Boys,8591,1,21,6,5,70,37,33,69
FC Basel,8591,2,18,9,5,59,28,31,63
Lucerne,8591,3,13,8,11,42,41,1,47
St Gallen,8591,4,14,3,15,43,57,-14,45
FC Zürich,8591,5,11,10,11,50,41,9,43
Grasshoppers,8591,6,10,8,14,44,48,-4,38
FC Thun,8591,7,10,5,17,47,63,-16,35
FC Lugano,8591,8,10,5,17,32,51,-19,35
FC Sion,8591,9,6,8,18,40,61,-21,26
Young Boys,8592,1,23,7,2,72,33,39,76
FC Basel,8592,2,18,7,7,59,28,31,61
St Gallen,8592,3,16,2,14,48,53,-5,50
Lucerne,8592,4,12,8,12,39,47,-8,44
FC Zürich,8592,5,9,11,12,38,38,0,38
FC Lugano,8592,6,11,5,16,33,49,-16,38
FC Thun,8592,7,9,6,17,45,62,-17,33
Grasshoppers,8592,8,8,7,17,40,53,-13,31
FC Sion,8592,9,7,9,16,41,52,-11,30
Young Boys,8593,1,21,6,5,71,39,32,69
FC Basel,8593,2,19,8,5,58,24,34,65
St Gallen,8593,3,14,5,13,41,51,-10,47
Lucerne,8593,4,12,8,12,40,44,-4,44
FC Zürich,8593,5,11,9,12,41,35,6,42
FC Lugano,8593,6,10,7,15,31,48,-17,37
Grasshoppers,8593,7,10,6,16,44,51,-7,36
FC Thun,8593,8,9,5,18,39,58,-19,32
FC Sion,8593,9,7,8,17,41,56,-15,29
Young Boys,8594,1,23,7,2,73,30,43,76
FC Basel,8594,2,17,8,7,52,26,26,59
St Gallen,8594,3,15,4,13,41,50,-9,49
Lucerne,8594,4,13,8,11,40,40,0,47
FC Zürich,8594,5,10,9,13,40,38,2,39
Grasshoppers,8594,6,9,7,16,39,51,-12,34
FC Thun,8594,7,9,7,16,45,59,-14,34
FC Lugano,8594,8,9,7,16,28,49,-21,34
FC Sion,8594,9,6,9,17,39,54,-15,27
Young Boys,8595,1,20,9,3,69,35,34,69
FC Basel,8595,2,17,9,6,52,25,27,60
Lucerne,8595,3,13,10,9,41,39,2,49
FC Zürich,8595,4,11,10,11,42,35,7,43
St Gallen,8595,5,13,4,15,39,53,-14,43
Grasshoppers,8595,6,10,8,14,41,46,-5,38
FC Lugano,8595,7,9,8,15,31,48,-17,35
FC Thun,8595,8,8,6,18,40,62,-22,30
FC Sion,8595,9,7,8,17,42,54,-12,29
Young Boys,8596,1,21,6,5,70,39,31,69
FC Basel,8596,2,18,7,7,57,28,29,61
FC Zürich,8596,3,13,9,10,44,35,9,48
Lucerne,8596,4,13,8,11,44,47,-3,47
St Gallen,8596,5,14,3,15,45,61,-16,45
FC Lugano,8596,6,10,5,17,31,46,-15,35
FC Sion,8596,7,9,7,16,46,51,-5,34
Grasshoppers,8596,8,9,6,17,40,51,-11,33
FC Thun,8596,9,9,5,18,42,61,-19,32
Young Boys,8597,1,21,7,4,69,34,35,70
FC Basel,8597,2,15,10,7,51,28,23,55
Lucerne,8597,3,15,7,10,46,40,6,52
St Gallen,8597,4,13,3,16,42,57,-15,42
FC Lugano,8597,5,12,5,15,31,45,-14,41
Grasshoppers,8597,6,11,6,15,42,50,-8,39
FC Zürich,8597,7,9,11,12,38,37,1,38
FC Thun,8597,8,10,6,16,44,57,-13,36
FC Sion,8597,9,6,9,17,38,53,-15,27
Young Boys,8598,1,22,6,4,72,34,38,72
FC Basel,8598,2,18,7,7,56,29,27,61
Lucerne,8598,3,14,7,11,43,42,1,49
St Gallen,8598,4,14,3,15,41,54,-13,45
FC Zürich,8598,5,11,10,11,41,36,5,43
FC Thun,8598,6,11,5,16,47,59,-12,38
FC Lugano,8598,7,11,5,16,30,45,-15,38
Grasshoppers,8598,8,8,7,17,36,51,-15,31
FC Sion,8598,9,5,10,17,41,57,-16,25
Young Boys,8599,1,20,8,4,66,33,33,68
FC Basel,8599,2,18,9,5,54,26,28,63
Lucerne,8599,3,14,7,11,40,40,0,49
St Gallen,8599,4,14,3,15,42,53,-11,45
FC Zürich,8599,5,9,10,13,40,39,1,37
FC Thun,8599,6,10,7,15,48,61,-13,37
FC Lugano,8599,7,10,7,15,30,45,-15,37
FC Sion,8599,8,8,8,16,43,53,-10,32
Grasshoppers,8599,9,8,7,17,42,55,-13,31
Young Boys,8600,1,21,7,4,69,35,34,70
FC Basel,8600,2,17,9,6,53,23,30,60
Lucerne,8600,3,13,9,10,44,44,0,48
St Gallen,8600,4,15,3,14,44,52,-8,48
FC Zürich,8600,5,10,10,12,40,40,0,40
FC Lugano,8600,6,10,7,15,32,49,-17,37
FC Thun,8600,7,10,5,17,47,61,-14,35
Grasshoppers,8600,8,9,6,17,41,53,-12,33
FC Sion,8600,9,7,8,17,39,52,-13,29
Young Boys,8601,1,21,7,4,73,37,36,70
FC Basel,8601,2,19,8,5,55,24,31,65
St Gallen,8601,3,16,3,13,47,54,-7,51
FC Zürich,8601,4,11,10,11,41,36,5,43
Lucerne,8601,5,11,9,12,40,47,-7,42
Grasshoppers,8601,6,9,8,15,41,47,-6,35
FC Lugano,8601,7,9,7,16,31,51,-20,34
FC Thun,8601,8,9,5,18,41,59,-18,32
FC Sion,8601,9,6,9,17,40,54,-14,27
Young Boys,8602,1,21,7,4,74,40,34,70
FC Basel,8602,2,19,8,5,55,23,32,65
Lucerne,8602,3,12,9,11,42,44,-2,45
St Gallen,8602,4,13,4,15,42,60,-18,43
FC Lugano,8602,5,11,6,15,32,46,-14,39
FC Zürich,8602,6,9,10,13,37,38,-1,37
Grasshoppers,8602,7,9,9,14,39,46,-7,36
FC Thun,8602,8,9,7,16,41,56,-15,34
FC Sion,8602,9,7,8,17,43,52,-9,29
Young Boys,8603,1,23,7,2,76,29,47,76
FC Basel,8603,2,18,7,7,58,29,29,61
St Gallen,8603,3,14,3,15,43,57,-14,45
Lucerne,8603,4,11,9,12,40,44,-4,42
FC Zürich,8603,5,10,10,12,42,41,1,40
FC Lugano,8603,6,11,6,15,30,47,-17,39
FC Thun,8603,7,11,5,16,46,60,-14,38
Grasshoppers,8603,8,9,7,16,42,57,-15,34
FC Sion,8603,9,6,8,18,43,56,-13,26
Young Boys,8604,1,22,7,3,73,36,37,73
FC Basel,8604,2,18,8,6,52,25,27,62
St Gallen,8604,3,15,3,14,45,53,-8,48
Lucerne,8604,4,12,9,11,40,43,-3,45
FC Zürich,8604,5,10,10,12,41,39,2,40
FC Thun,8604,6,11,5,16,45,55,-10,38
FC Lugano,8604,7,10,5,17,30,50,-20,35
Grasshoppers,8604,8,8,7,17,39,54,-15,31
FC Sion,8604,9,7,8,17,48,58,-10,29
Young Boys,8605,1,23,6,3,76,37,39,75
FC Basel,8605,2,19,8,5,55,23,32,65
St Gallen,8605,3,15,2,15,44,53,-9,47
Lucerne,8605,4,13,7,12,39,46,-7,46
FC Zürich,8605,5,11,11,10,42,36,6,44
FC Thun,8605,6,10,5,17,45,59,-14,35
FC Lugano,8605,7,10,5,17,35,52,-17,35
Grasshoppers,8605,8,8,7,17,39,51,-12,31
FC Sion,8605,9,5,9,18,38,56,-18,24
Young Boys,8606,1,20,7,5,70,38,32,67
FC Basel,8606,2,17,10,5,50,23,27,61
Lucerne,8606,3,14,9,9,46,44,2,51
St Gallen,8606,4,15,3,14,47,53,-6,48
FC Zürich,8606,5,9,11,12,39,39,0,38
FC Lugano,8606,6,10,7,15,33,46,-13,37
Grasshoppers,8606,7,10,6,16,42,50,-8,36
FC Thun,8606,8,9,6,17,41,57,-16,33
FC Sion,8606,9,7,7,18,38,56,-18,28
Young Boys,8607,1,24,6,2,80,33,47,78
FC Basel,8607,2,18,8,6,59,27,32,62
Lucerne,8607,3,13,8,11,38,47,-9,47
St Gallen,8607,4,14,3,15,43,55,-12,45
FC Zürich,8607,5,10,11,11,39,35,4,41
Grasshoppers,8607,6,10,6,16,44,51,-7,36
FC Lugano,8607,7,9,6,17,28,48,-20,33
FC Thun,8607,8,9,5,18,42,62,-20,32
FC Sion,8607,9,7,7,18,41,56,-15,28
Young Boys,8608,1,22,7,3,76,38,38,73
FC Basel,8608,2,19,7,6,52,24,28,64
Lucerne,8608,3,13,8,11,43,45,-2,47
St Gallen,8608,4,14,3,15,42,54,-12,45
FC Zürich,8608,5,11,10,11,41,35,6,43
Grasshoppers,8608,6,10,7,15,43,48,-5,37
FC Lugano,8608,7,9,8,15,33,50,-17,35
FC Thun,8608,8,9,5,18,43,57,-14,32
FC Sion,8608,9,6,7,19,36,58,-22,25
Young Boys,8609,1,21,7,4,73,38,35,70
FC Basel,8609,2,17,9,6,52,23,29,60
Lucerne,8609,3,13,10,9,44,43,1,49
St Gallen,8609,4,14,3,15,42,54,-12,45
FC Zürich,8609,5,10,9,13,39,40,-1,39
FC Thun,8609,6,10,6,16,48,63,-15,36
FC Lugano,8609,7,10,5,17,30,48,-18,35
FC Sion,8609,8,9,7,16,45,52,-7,34
Grasshoppers,8609,9,9,6,17,42,54,-12,33
Young Boys,8610,1,22,6,4,74,36,38,72
FC Basel,8610,2,17,7,8,54,31,23,58
Lucerne,8610,3,15,7,10,43,41,2,52
FC Zürich,8610,4,11,10,11,45,38,7,43
St Gallen,8610,5,13,3,16,41,57,-16,42
FC Thun,8610,6,11,5,16,46,57,-11,38
Grasshoppers,8610,7,10,6,16,41,49,-8,36
FC Lugano,8610,8,10,5,17,32,52,-20,35
FC Sion,8610,9,6,9,17,39,54,-15,27
Young Boys,8611,1,20,7,5,68,35,33,67
FC Basel,8611,2,19,8,5,55,23,32,65
St Gallen,8611,3,13,4,15,42,56,-14,43
Lucerne,8611,4,11,9,12,39,45,-6,42
FC Zürich,8611,5,10,11,11,41,37,4,41
FC Lugano,8611,6,10,7,15,31,48,-17,37
Grasshoppers,8611,7,10,6,16,41,48,-7,36
FC Thun,8611,8,10,5,17,46,57,-11,35
FC Sion,8611,9,9,7,16,42,56,-14,34
Young Boys,8612,1,22,6,4,72,36,36,72
FC Basel,8612,2,18,7,7,56,28,28,61
Lucerne,8612,3,15,7,10,48,43,5,52
St Gallen,8612,4,14,2,16,42,56,-14,44
FC Zürich,8612,5,11,10,11,43,38,5,43
FC Thun,8612,6,10,7,15,44,56,-12,37
FC Sion,8612,7,8,8,16,43,54,-11,32
FC Lugano,8612,8,9,5,18,29,52,-23,32
Grasshoppers,8612,9,8,6,18,39,53,-14,30
Young Boys,8613,1,22,7,3,71,34,37,73
FC Basel,8613,2,17,9,6,54,27,27,60
St Gallen,8613,3,15,3,14,44,55,-11,48
Lucerne,8613,4,12,8,12,46,48,-2,44
FC Zürich,8613,5,10,10,12,40,37,3,40
FC Lugano,8613,6,11,5,16,33,50,-17,38
Grasshoppers,8613,7,10,7,15,44,51,-7,37
FC Thun,8613,8,10,6,16,46,58,-12,36
FC Sion,8613,9,6,7,19,38,56,-18,25
Young Boys,8614,1,21,6,5,73,40,33,69
FC Basel,8614,2,17,7,8,52,28,24,58
St Gallen,8614,3,16,2,14,46,54,-8,50
Lucerne,8614,4,12,8,12,46,49,-3,44
FC Zürich,8614,5,11,9,12,41,40,1,42
FC Thun,8614,6,12,5,15,46,54,-8,41
FC Lugano,8614,7,11,5,16,36,52,-16,38
Grasshoppers,8614,8,9,7,16,42,50,-8,34
FC Sion,8614,9,7,7,18,37,52,-15,28
Young Boys,8615,1,22,7,3,72,35,37,73
FC Basel,8615,2,17,8,7,52,27,25,59
St Gallen,8615,3,16,2,14,47,54,-7,50
FC Zürich,8615,4,11,11,10,43,37,6,44
Lucerne,8615,5,11,9,12,40,45,-5,42
Grasshoppers,8615,6,10,7,15,45,52,-7,37
FC Lugano,8615,7,10,6,16,31,48,-17,36
FC Thun,8615,8,9,6,17,44,61,-17,33
FC Sion,8615,9,6,8,18,41,56,-15,26
Young Boys,8616,1,24,6,2,77,35,42,78
FC Basel,8616,2,17,9,6,54,25,29,60
Lucerne,8616,3,13,9,10,47,43,4,48
FC Zürich,8616,4,11,10,11,41,37,4,43
St Gallen,8616,5,13,3,16,41,62,-21,42
FC Lugano,8616,6,10,7,15,33,48,-15,37
Grasshoppers,8616,7,9,7,16,43,52,-9,34
FC Thun,8616,8,9,7,16,45,59,-14,34
FC Sion,8616,9,5,8,19,41,61,-20,23
Young Boys,8617,1,21,7,4,72,35,37,70
FC Basel,8617,2,18,7,7,56,31,25,61
Lucerne,8617,3,13,8,11,41,44,-3,47
St Gallen,8617,4,15,2,15,45,57,-12,47
FC Zürich,8617,5,9,12,11,41,39,2,39
FC Thun,8617,6,10,6,16,43,57,-14,36
FC Lugano,8617,7,10,6,16,30,47,-17,36
Grasshoppers,8617,8,9,7,16,39,48,-9,34
FC Sion,8617,9,7,9,16,42,51,-9,30
Young Boys,8618,1,21,8,3,77,39,38,71
FC Basel,8618,2,19,7,6,56,25,31,64
Lucerne,8618,3,13,8,11,44,47,-3,47
St Gallen,8618,4,14,3,15,42,54,-12,45
FC Zürich,8618,5,11,9,12,44,36,8,42
Grasshoppers,8618,6,9,8,15,44,51,-7,35
FC Thun,8618,7,10,5,17,42,60,-18,35
FC Lugano,8618,8,10,5,17,31,52,-21,35
FC Sion,8618,9,6,9,17,39,55,-16,27
Young Boys,8619,1,21,9,2,71,35,36,72
FC Basel,8619,2,19,8,5,54,24,30,65
St Gallen,8619,3,15,3,14,44,51,-7,48
FC Zürich,8619,4,12,9,11,45,38,7,45
Lucerne,8619,5,12,9,11,42,45,-3,45
FC Lugano,8619,6,9,7,16,31,49,-18,34
Grasshoppers,8619,7,9,6,17,42,51,-9,33
FC Sion,8619,8,7,8,17,40,54,-14,29
FC Thun,8619,9,8,5,19,41,63,-22,29
Young Boys,8620,1,20,8,4,72,40,32,68
FC Basel,8620,2,19,8,5,59,26,33,65
Lucerne,8620,3,15,7,10,44,42,2,52
St Gallen,8620,4,15,2,15,42,55,-13,47
FC Zürich,8620,5,12,10,10,43,33,10,46
FC Thun,8620,6,10,5,17,44,58,-14,35
Grasshoppers,8620,7,8,8,16,40,51,-11,32
FC Lugano,8620,8,9,5,18,28,50,-22,32
FC Sion,8620,9,5,9,18,38,55,-17,24
Young Boys,8621,1,22,7,3,70,32,38,73
FC Basel,8621,2,17,9,6,51,24,27,60
FC Zürich,8621,3,13,9,10,43,33,10,48
Lucerne,8621,4,13,8,11,41,45,-4,47
St Gallen,8621,5,14,4,14,45,55,-10,46
Grasshoppers,8621,6,10,6,16,44,47,-3,36
FC Thun,8621,7,10,5,17,43,57,-14,35
FC Lugano,8621,8,9,6,17,30,51,-21,33
FC Sion,8621,9,5,8,19,38,61,-23,23
Young Boys,8622,1,22,7,3,75,35,40,73
FC Basel,8622,2,19,7,6,59,24,35,64
St Gallen,8622,3,17,2,13,50,52,-2,53
Lucerne,8622,4,12,8,12,39,48,-9,44
FC Zürich,8622,5,10,10,12,40,37,3,40
Grasshoppers,8622,6,10,6,16,43,51,-8,36
FC Lugano,8622,7,10,6,16,31,49,-18,36
FC Thun,8622,8,9,5,18,39,60,-21,32
FC Sion,8622,9,6,7,19,41,61,-20,25
Young Boys,8623,1,23,7,2,74,32,42,76
FC Basel,8623,2,17,8,7,52,24,28,59
Lucerne,8623,3,14,7,11,46,44,2,49
St Gallen,8623,4,15,3,14,43,52,-9,48
FC Zürich,8623,5,10,9,13,39,39,0,39
FC Thun,8623,6,11,5,16,48,57,-9,38
FC Lugano,8623,7,11,5,16,31,48,-17,38
Grasshoppers,8623,8,9,6,17,41,54,-13,33
FC Sion,8623,9,5,8,19,37,61,-24,23
Young Boys,8624,1,22,7,3,72,35,37,73
FC Basel,8624,2,18,7,7,53,27,26,61
St Gallen,8624,3,15,3,14,43,52,-9,48
Lucerne,8624,4,12,8,12,42,46,-4,44
FC Zürich,8624,5,11,10,11,43,36,7,43
FC Lugano,8624,6,10,6,16,31,48,-17,36
Grasshoppers,8624,7,9,8,15,41,49,-8,35
FC Thun,8624,8,9,7,16,42,59,-17,34
FC Sion,8624,9,6,8,18,39,54,-15,26
Young Boys,8625,1,22,7,3,77,38,39,73
FC Basel,8625,2,18,7,7,54,25,29,61
St Gallen,8625,3,15,4,13,46,52,-6,49
Lucerne,8625,4,12,7,13,42,49,-7,43
FC Zürich,8625,5,10,10,12,38,37,1,40
Grasshoppers,8625,6,11,6,15,46,53,-7,39
FC Lugano,8625,7,11,6,15,32,46,-14,39
FC Thun,8625,8,9,6,17,43,58,-15,33
FC Sion,8625,9,5,9,18,36,56,-20,24
Young Boys,8626,1,21,7,4,70,37,33,70
FC Basel,8626,2,19,7,6,57,24,33,64
Lucerne,8626,3,13,9,10,43,42,1,48
St Gallen,8626,4,15,2,15,42,53,-11,47
FC Zürich,8626,5,10,10,12,40,38,2,40
FC Thun,8626,6,11,5,16,48,59,-11,38
Grasshoppers,8626,7,9,7,16,41,51,-10,34
FC Lugano,8626,8,9,5,18,29,50,-21,32
FC Sion,8626,9,7,8,17,39,55,-16,29
Young Boys,8627,1,22,8,2,71,32,39,74
FC Basel,8627,2,17,9,6,52,23,29,60
St Gallen,8627,3,15,2,15,43,59,-16,47
Lucerne,8627,4,11,8,13,39,47,-8,41
FC Zürich,8627,5,9,11,12,36,35,1,38
FC Thun,8627,6,10,7,15,46,55,-9,37
FC Lugano,8627,7,10,7,15,32,47,-15,37
Grasshoppers,8627,8,9,9,14,42,47,-5,36
FC Sion,8627,9,7,7,18,41,57,-16,28
Young Boys,8628,1,20,6,6,69,37,32,66
FC Basel,8628,2,17,9,6,55,27,28,60
Lucerne,8628,3,15,8,9,44,39,5,53
FC Zürich,8628,4,12,10,10,45,36,9,46
St Gallen,8628,5,13,3,16,41,57,-16,42
FC Lugano,8628,6,11,5,16,31,47,-16,38
FC Thun,8628,7,10,7,15,46,58,-12,37
Grasshoppers,8628,8,9,6,17,42,51,-9,33
FC Sion,8628,9,6,8,18,39,60,-21,26
Young Boys,8629,1,21,8,3,71,37,34,71
FC Basel,8629,2,17,9,6,55,26,29,60
Lucerne,8629,3,12,9,11,43,45,-2,45
FC Zürich,8629,4,11,10,11,41,36,5,43
St Gallen,8629,5,13,4,15,41,55,-14,43
Grasshoppers,8629,6,10,7,15,40,48,-8,37
FC Lugano,8629,7,9,9,14,31,46,-15,36
FC Thun,8629,8,9,6,17,45,58,-13,33
FC Sion,8629,9,7,8,17,39,55,-16,29
Young Boys,8630,1,22,7,3,78,43,35,73
FC Basel,8630,2,17,9,6,56,26,30,60
St Gallen,8630,3,15,3,14,45,52,-7,48
Lucerne,8630,4,13,8,11,44,47,-3,47
FC Zürich,8630,5,11,10,11,42,34,8,43
FC Thun,8630,6,10,6,16,43,55,-12,36
FC Lugano,8630,7,10,5,17,31,49,-18,35
Grasshoppers,8630,8,9,6,17,42,53,-11,33
FC Sion,8630,9,6,8,18,39,61,-22,26
Young Boys,8631,1,22,6,4,74,37,37,72
FC Basel,8631,2,19,7,6,56,26,30,64
Lucerne,8631,3,14,7,11,49,45,4,49
FC Zürich,8631,4,12,10,10,44,34,10,46
St Gallen,8631,5,13,2,17,41,59,-18,41
FC Lugano,8631,6,10,5,17,32,52,-20,35
Grasshoppers,8631,7,9,6,17,41,56,-15,33
FC Sion,8631,8,8,8,16,44,53,-9,32
FC Thun,8631,9,8,7,17,42,61,-19,31
Young Boys,8632,1,21,8,3,69,32,37,71
FC Basel,8632,2,17,9,6,53,24,29,60
St Gallen,8632,3,16,2,14,45,53,-8,50
Lucerne,8632,4,13,9,10,40,40,0,48
FC Zürich,8632,5,9,11,12,38,39,-1,38
Grasshoppers,8632,6,10,8,14,44,48,-4,38
FC Thun,8632,7,9,7,16,45,60,-15,34
FC Lugano,8632,8,9,6,17,27,48,-21,33
FC Sion,8632,9,6,8,18,41,58,-17,26
Young Boys,8633,1,22,7,3,78,36,42,73
FC Basel,8633,2,15,10,7,50,28,22,55
Lucerne,8633,3,14,8,10,44,46,-2,50
St Gallen,8633,4,14,4,14,41,52,-11,46
FC Zürich,8633,5,11,11,10,45,36,9,44
Grasshoppers,8633,6,10,7,15,39,47,-8,37
FC Thun,8633,7,9,7,16,41,55,-14,34
FC Lugano,8633,8,9,6,17,32,54,-22,33
FC Sion,8633,9,6,8,18,38,54,-16,26
Young Boys,8634,1,20,7,5,68,40,28,67
FC Basel,8634,2,18,8,6,59,29,30,62
Lucerne,8634,3,14,7,11,47,46,1,49
St Gallen,8634,4,14,3,15,46,59,-13,45
FC Lugano,8634,5,12,5,15,35,46,-11,41
FC Zürich,8634,6,10,10,12,40,38,2,40
Grasshoppers,8634,7,10,7,15,43,48,-5,37
FC Thun,8634,8,8,8,16,41,57,-16,32
FC Sion,8634,9,6,9,17,39,55,-16,27
Young Boys,8635,1,20,8,4,71,37,34,68
FC Basel,8635,2,16,11,5,55,29,26,59
Lucerne,8635,3,14,8,10,48,42,6,50
St Gallen,8635,4,15,3,14,42,52,-10,48
FC Zürich,8635,5,10,11,11,42,37,5,41
FC Lugano,8635,6,10,5,17,31,52,-21,35
FC Thun,8635,7,9,7,16,43,57,-14,34
Grasshoppers,8635,8,9,7,16,41,55,-14,34
FC Sion,8635,9,7,8,17,43,55,-12,29
Young Boys,8636,1,22,7,3,80,36,44,73
FC Basel,8636,2,18,9,5,58,27,31,63
St Gallen,8636,3,14,5,13,43,53,-10,47
Lucerne,8636,4,12,9,11,43,45,-2,45
FC Zürich,8636,5,11,10,11,44,40,4,43
FC Thun,8636,6,9,7,16,45,60,-15,34
FC Lugano,8636,7,9,6,17,27,50,-23,33
Grasshoppers,8636,8,8,8,16,40,53,-13,32
FC Sion,8636,9,5,11,16,43,59,-16,26
Young Boys,8637,1,23,6,3,71,32,39,75
FC Basel,8637,2,18,8,6,55,25,30,62
Lucerne,8637,3,12,9,11,42,44,-2,45
St Gallen,8637,4,14,3,15,43,59,-16,45
FC Zürich,8637,5,10,12,10,40,35,5,42
Grasshoppers,8637,6,10,7,15,41,47,-6,37
FC Lugano,8637,7,9,7,16,28,45,-17,34
FC Thun,8637,8,8,6,18,41,64,-23,30
FC Sion,8637,9,7,8,17,44,54,-10,29
Young Boys,8638,1,19,8,5,67,41,26,65
FC Basel,8638,2,17,9,6,53,25,28,60
Lucerne,8638,3,14,8,10,44,42,2,50
St Gallen,8638,4,16,2,14,47,54,-7,50
FC Zürich,8638,5,9,11,12,38,38,0,38
FC Lugano,8638,6,10,6,16,29,47,-18,36
Grasshoppers,8638,7,9,8,15,39,48,-9,35
FC Sion,8638,8,8,9,15,47,52,-5,33
FC Thun,8638,9,9,5,18,42,59,-17,32
Young Boys,8639,1,20,9,3,67,33,34,69
FC Basel,8639,2,18,8,6,55,27,28,62
St Gallen,8639,3,16,3,13,49,55,-6,51
Lucerne,8639,4,12,9,11,41,44,-3,45
FC Zürich,8639,5,11,9,12,45,40,5,42
FC Lugano,8639,6,10,5,17,31,50,-19,35
FC Thun,8639,7,9,6,17,47,60,-13,33
Grasshoppers,8639,8,8,8,16,39,54,-15,32
FC Sion,8639,9,7,9,16,43,54,-11,30
Young Boys,8640,1,23,6,3,70,33,37,75
FC Basel,8640,2,16,8,8,50,31,19,56
St Gallen,8640,3,16,2,14,50,54,-4,50
Lucerne,8640,4,12,8,12,42,49,-7,44
FC Zürich,8640,5,11,10,11,43,36,7,43
Grasshoppers,8640,6,11,6,15,45,52,-7,39
FC Thun,8640,7,11,5,16,50,56,-6,38
FC Lugano,8640,8,10,5,17,31,49,-18,35
FC Sion,8640,9,5,8,19,38,59,-21,23
Young Boys,8641,1,21,9,2,73,35,38,72
FC Basel,8641,2,18,9,5,54,23,31,63
Lucerne,8641,3,13,9,10,40,39,1,48
St Gallen,8641,4,15,3,14,42,50,-8,48
FC Zürich,8641,5,9,10,13,39,41,-2,37
FC Lugano,8641,6,10,6,16,32,50,-18,36
FC Thun,8641,7,9,7,16,41,56,-15,34
Grasshoppers,8641,8,8,8,16,39,50,-11,32
FC Sion,8641,9,6,9,17,40,56,-16,27
Young Boys,8642,1,23,6,3,73,33,40,75
FC Basel,8642,2,18,8,6,56,27,29,62
Lucerne,8642,3,13,7,12,43,46,-3,46
St Gallen,8642,4,14,2,16,41,57,-16,44
FC Zürich,8642,5,10,12,10,41,35,6,42
Grasshoppers,8642,6,10,6,16,40,48,-8,36
FC Thun,8642,7,10,6,16,44,57,-13,36
FC Lugano,8642,8,10,6,16,31,48,-17,36
FC Sion,8642,9,6,7,19,39,57,-18,25
Young Boys,8643,1,22,7,3,72,32,40,73
FC Basel,8643,2,19,8,5,52,22,30,65
Lucerne,8643,3,13,7,12,41,44,-3,46
St Gallen,8643,4,13,4,15,40,54,-14,43
FC Zürich,8643,5,10,11,11,39,35,4,41
FC Lugano,8643,6,10,8,14,32,46,-14,38
Grasshoppers,8643,7,9,7,16,40,51,-11,34
FC Thun,8643,8,9,6,17,42,57,-15,33
FC Sion,8643,9,6,8,18,39,56,-17,26
Young Boys,8644,1,22,6,4,71,33,38,72
FC Basel,8644,2,17,9,6,51,24,27,60
St Gallen,8644,3,14,5,13,44,52,-8,47
Lucerne,8644,4,12,8,12,39,47,-8,44
Grasshoppers,8644,5,10,8,14,41,47,-6,38
FC Zürich,8644,6,9,9,14,36,37,-1,36
FC Lugano,8644,7,10,6,16,30,46,-16,36
FC Sion,8644,8,8,9,15,40,49,-9,33
FC Thun,8644,9,9,6,17,39,56,-17,33
Young Boys,8645,1,22,7,3,70,33,37,73
FC Basel,8645,2,17,7,8,53,26,27,58
St Gallen,8645,3,15,4,13,43,50,-7,49
Lucerne,8645,4,13,8,11,42,43,-1,47
FC Lugano,8645,5,11,7,14,31,44,-13,40
FC Zürich,8645,6,9,10,13,39,39,0,37
FC Thun,8645,7,9,7,16,42,59,-17,34
Grasshoppers,8645,8,8,9,15,38,47,-9,33
FC Sion,8645,9,6,9,17,39,56,-17,27
Young Boys,8646,1,21,8,3,78,40,38,71
FC Basel,8646,2,17,10,5,55,26,29,61
Lucerne,8646,3,13,8,11,43,45,-2,47
St Gallen,8646,4,13,3,16,41,56,-15,42
FC Zürich,8646,5,10,10,12,40,35,5,40
FC Lugano,8646,6,11,7,14,34,46,-12,40
FC Thun,8646,7,11,6,15,43,55,-12,39
Grasshoppers,8646,8,8,6,18,41,57,-16,30
FC Sion,8646,9,7,8,17,38,53,-15,29
Young Boys,8647,1,19,9,4,70,41,29,66
FC Basel,8647,2,19,7,6,57,25,32,64
Lucerne,8647,3,13,9,10,44,44,0,48
St Gallen,8647,4,14,2,16,41,55,-14,44
Grasshoppers,8647,5,12,6,14,45,47,-2,42
FC Zürich,8647,6,9,12,11,39,36,3,39
FC Lugano,8647,7,10,8,14,32,45,-13,38
FC Thun,8647,8,8,6,18,39,60,-21,30
FC Sion,8647,9,6,9,17,39,53,-14,27
Young Boys,8648,1,22,8,2,72,34,38,74
FC Basel,8648,2,16,8,8,52,28,24,56
Lucerne,8648,3,13,8,11,42,44,-2,47
St Gallen,8648,4,14,2,16,42,57,-15,44
FC Zürich,8648,5,11,9,12,44,37,7,42
FC Lugano,8648,6,12,5,15,35,46,-11,41
FC Thun,8648,7,11,5,16,46,57,-11,38
Grasshoppers,8648,8,10,6,16,45,49,-4,36
FC Sion,8648,9,6,7,19,37,63,-26,25
Young Boys,8649,1,21,7,4,69,33,36,70
FC Basel,8649,2,16,9,7,56,27,29,57
Lucerne,8649,3,12,8,12,43,47,-4,44
St Gallen,8649,4,14,2,16,42,58,-16,44
FC Lugano,8649,5,12,6,14,34,44,-10,42
FC Zürich,8649,6,10,10,12,39,37,2,40
Grasshoppers,8649,7,11,6,15,44,48,-4,39
FC Thun,8649,8,10,5,17,42,63,-21,35
FC Sion,8649,9,8,7,17,45,57,-12,31
Young Boys,8650,1,22,6,4,69,37,32,72
FC Basel,8650,2,18,8,6,63,28,35,62
Lucerne,8650,3,14,8,10,44,40,4,50
St Gallen,8650,4,13,3,16,41,56,-15,42
FC Zürich,8650,5,10,10,12,40,42,-2,40
Grasshoppers,8650,6,11,6,15,42,47,-5,39
FC Lugano,8650,7,10,6,16,30,46,-16,36
FC Sion,8650,8,7,9,16,39,50,-11,30
FC Thun,8650,9,8,6,18,41,63,-22,30
Young Boys,8651,1,21,7,4,74,39,35,70
FC Basel,8651,2,18,7,7,59,28,31,61
Lucerne,8651,3,13,8,11,45,48,-3,47
St Gallen,8651,4,15,2,15,44,54,-10,47
FC Zürich,8651,5,10,9,13,43,39,4,39
FC Lugano,8651,6,11,5,16,31,48,-17,38
Grasshoppers,8651,7,10,6,16,41,54,-13,36
FC Thun,8651,8,10,5,17,44,62,-18,35
FC Sion,8651,9,8,7,17,45,54,-9,31
Young Boys,8652,1,19,8,5,71,41,30,65
FC Basel,8652,2,17,8,7,57,30,27,59
St Gallen,8652,3,15,3,14,45,53,-8,48
Lucerne,8652,4,13,8,11,44,44,0,47
FC Zürich,8652,5,11,9,12,38,35,3,42
FC Lugano,8652,6,12,5,15,33,46,-13,41
Grasshoppers,8652,7,11,7,14,43,48,-5,40
FC Thun,8652,8,10,6,16,44,57,-13,36
FC Sion,8652,9,5,8,19,37,58,-21,23
Young Boys,8653,1,21,7,4,66,35,31,70
FC Basel,8653,2,17,7,8,52,26,26,58
FC Zürich,8653,3,13,9,10,41,33,8,48
Lucerne,8653,4,13,8,11,44,43,1,47
St Gallen,8653,5,14,2,16,41,56,-15,44
Grasshoppers,8653,6,10,8,14,43,46,-3,38
FC Lugano,8653,7,10,5,17,28,47,-19,35
FC Thun,8653,8,9,6,17,42,59,-17,33
FC Sion,8653,9,7,8,17,40,52,-12,29
Young Boys,8654,1,23,6,3,70,33,37,75
FC Basel,8654,2,18,7,7,55,26,29,61
FC Zürich,8654,3,12,9,11,43,36,7,45
St Gallen,8654,4,14,3,15,42,59,-17,45
Lucerne,8654,5,12,8,12,42,46,-4,44
FC Lugano,8654,6,13,5,14,38,46,-8,44
FC Thun,8654,7,10,5,17,45,58,-13,35
Grasshoppers,8654,8,8,6,18,41,54,-13,30
FC Sion,8654,9,6,7,19,40,58,-18,25
Young Boys,8655,1,21,7,4,70,34,36,70
FC Basel,8655,2,20,7,5,60,27,33,67
Lucerne,8655,3,13,9,10,42,40,2,48
St Gallen,8655,4,14,2,16,42,60,-18,44
Grasshoppers,8655,5,11,7,14,46,50,-4,40
FC Zürich,8655,6,9,11,12,39,37,2,38
FC Thun,8655,7,10,5,17,44,61,-17,35
FC Lugano,8655,8,9,6,17,29,47,-18,33
FC Sion,8655,9,6,8,18,40,56,-16,26
Young Boys,8656,1,23,7,2,74,34,40,76
FC Basel,8656,2,17,8,7,51,25,26,59
St Gallen,8656,3,15,4,13,41,50,-9,49
Lucerne,8656,4,12,10,10,44,46,-2,46
FC Zürich,8656,5,10,10,12,39,39,0,40
FC Thun,8656,6,9,7,16,44,57,-13,34
FC Lugano,8656,7,9,7,16,29,47,-18,34
Grasshoppers,8656,8,8,8,16,42,52,-10,32
FC Sion,8656,9,6,9,17,38,52,-14,27
Young Boys,8657,1,23,6,3,76,32,44,75
FC Basel,8657,2,17,9,6,51,24,27,60
Lucerne,8657,3,13,9,10,43,42,1,48
St Gallen,8657,4,15,3,14,42,53,-11,48
FC Zürich,8657,5,10,10,12,41,38,3,40
FC Thun,8657,6,11,5,16,48,57,-9,38
FC Lugano,8657,7,10,6,16,31,47,-16,36
Grasshoppers,8657,8,8,6,18,37,59,-22,30
FC Sion,8657,9,6,8,18,42,59,-17,26
Young Boys,8658,1,19,8,5,67,39,28,65
FC Basel,8658,2,19,7,6,58,25,33,64
Lucerne,8658,3,15,7,10,47,44,3,52
St Gallen,8658,4,14,3,15,42,55,-13,45
FC Zürich,8658,5,10,10,12,39,40,-1,40
FC Lugano,8658,6,10,6,16,33,50,-17,36
Grasshoppers,8658,7,9,8,15,38,47,-9,35
FC Sion,8658,8,8,8,16,48,52,-4,32
FC Thun,8658,9,8,7,17,40,60,-20,31
Young Boys,8659,1,23,6,3,72,33,39,75
FC Basel,8659,2,20,7,5,61,25,36,67
St Gallen,8659,3,15,2,15,47,57,-10,47
Lucerne,8659,4,13,7,12,44,46,-2,46
FC Zürich,8659,5,11,9,12,41,38,3,42
Grasshoppers,8659,6,10,6,16,43,52,-9,36
FC Thun,8659,7,10,5,17,42,59,-17,35
FC Lugano,8659,8,9,5,18,28,51,-23,32
FC Sion,8659,9,6,7,19,39,56,-17,25
Young Boys,8660,1,23,6,3,73,34,39,75
FC Basel,8660,2,18,8,6,57,27,30,62
St Gallen,8660,3,15,3,14,46,59,-13,48
Lucerne,8660,4,13,8,11,43,46,-3,47
FC Zürich,8660,5,10,10,12,41,38,3,40
FC Lugano,8660,6,11,5,16,34,45,-11,38
Grasshoppers,8660,7,9,7,16,39,52,-13,34
FC Thun,8660,8,9,6,17,46,62,-16,33
FC Sion,8660,9,5,9,18,39,55,-16,24
Young Boys,8661,1,21,7,4,68,34,34,70
FC Basel,8661,2,19,8,5,57,22,35,65
Lucerne,8661,3,12,9,11,43,47,-4,45
St Gallen,8661,4,13,4,15,42,57,-15,43
FC Zürich,8661,5,10,10,12,38,35,3,40
Grasshoppers,8661,6,10,6,16,42,48,-6,36
FC Lugano,8661,7,9,7,16,28,47,-19,34
FC Sion,8661,8,8,9,15,43,52,-9,33
FC Thun,8661,9,9,6,17,42,61,-19,33
Young Boys,8662,1,21,7,4,76,38,38,70
FC Basel,8662,2,19,8,5,59,23,36,65
Lucerne,8662,3,12,9,11,42,47,-5,45
St Gallen,8662,4,13,4,15,43,56,-13,43
FC Zürich,8662,5,10,9,13,42,38,4,39
FC Lugano,8662,6,10,7,15,32,49,-17,37
Grasshoppers,8662,7,9,7,16,41,52,-11,34
FC Thun,8662,8,9,7,16,40,61,-21,34
FC Sion,8662,9,8,8,16,44,55,-11,32
Young Boys,8663,1,23,7,2,74,35,39,76
FC Basel,8663,2,16,9,7,53,29,24,57
Lucerne,8663,3,13,8,11,42,44,-2,47
FC Zürich,8663,4,11,11,10,40,33,7,44
St Gallen,8663,5,13,4,15,41,57,-16,43
FC Lugano,8663,6,10,7,15,31,45,-14,37
Grasshoppers,8663,7,9,8,15,41,49,-8,35
FC Thun,8663,8,8,6,18,41,60,-19,30
FC Sion,8663,9,7,8,17,43,54,-11,29
Young Boys,8664,1,21,6,5,71,38,33,69
FC Basel,8664,2,18,7,7,58,30,28,61
Lucerne,8664,3,14,7,11,48,46,2,49
St Gallen,8664,4,15,2,15,48,55,-7,47
FC Zürich,8664,5,12,10,10,46,37,9,46
Grasshoppers,8664,6,10,6,16,45,51,-6,36
FC Lugano,8664,7,10,6,16,31,49,-18,36
FC Thun,8664,8,9,5,18,42,63,-21,32
FC Sion,8664,9,7,7,18,38,58,-20,28
Young Boys,8665,1,21,7,4,76,39,37,70
FC Basel,8665,2,18,9,5,59,23,36,63
Lucerne,8665,3,13,9,10,47,46,1,48
St Gallen,8665,4,14,3,15,45,56,-11,45
FC Zürich,8665,5,11,10,11,43,37,6,43
FC Lugano,8665,6,10,6,16,32,53,-21,36
Grasshoppers,8665,7,9,7,16,41,52,-11,34
FC Thun,8665,8,9,6,17,43,66,-23,33
FC Sion,8665,9,6,9,17,42,56,-14,27
Young Boys,8666,1,21,8,3,73,38,35,71
FC Basel,8666,2,16,9,7,53,30,23,57
FC Zürich,8666,3,13,9,10,44,32,12,48
St Gallen,8666,4,15,2,15,44,55,-11,47
Lucerne,8666,5,12,8,12,42,45,-3,44
FC Lugano,8666,6,11,5,16,32,49,-17,38
FC Thun,8666,7,10,5,17,44,59,-15,35
Grasshoppers,8666,8,9,6,17,42,53,-11,33
FC Sion,8666,9,7,8,17,43,56,-13,29
Young Boys,8667,1,22,6,4,70,34,36,72
FC Basel,8667,2,19,7,6,56,24,32,64
Lucerne,8667,3,13,7,12,40,45,-5,46
St Gallen,8667,4,14,3,15,43,55,-12,45
FC Zürich,8667,5,11,9,12,40,39,1,42
Grasshoppers,8667,6,11,6,15,44,47,-3,39
FC Thun,8667,7,10,5,17,44,58,-14,35
FC Lugano,8667,8,10,5,17,30,47,-17,35
FC Sion,8667,9,6,8,18,40,58,-18,26
Young Boys,8668,1,23,6,3,76,37,39,75
FC Basel,8668,2,17,8,7,54,29,25,59
Lucerne,8668,3,14,7,11,46,43,3,49
St Gallen,8668,4,14,4,14,43,54,-11,46
Grasshoppers,8668,5,12,6,14,47,44,3,42
FC Zürich,8668,6,10,10,12,41,38,3,40
FC Lugano,8668,7,10,6,16,29,50,-21,36
FC Thun,8668,8,9,6,17,44,62,-18,33
FC Sion,8668,9,5,7,20,39,62,-23,22
Young Boys,8669,1,21,8,3,72,36,36,71
FC Basel,8669,2,16,9,7,50,26,24,57
Lucerne,8669,3,12,10,10,38,40,-2,46
St Gallen,8669,4,14,3,15,42,62,-20,45
FC Zürich,8669,5,11,11,10,41,34,7,44
Grasshoppers,8669,6,9,9,14,39,46,-7,36
FC Lugano,8669,7,10,6,16,32,48,-16,36
FC Thun,8669,8,9,5,18,39,57,-18,32
FC Sion,8669,9,7,9,16,47,51,-4,30
Young Boys,8670,1,20,8,4,68,35,33,68
FC Basel,8670,2,17,8,7,52,26,26,59
Lucerne,8670,3,12,11,9,41,41,0,47
St Gallen,8670,4,14,5,13,43,53,-10,47
FC Zürich,8670,5,12,9,11,40,33,7,45
Grasshoppers,8670,6,11,7,14,45,47,-2,40
FC Lugano,8670,7,9,7,16,29,47,-18,34
FC Sion,8670,8,7,8,17,39,53,-14,29
FC Thun,8670,9,8,5,19,42,64,-22,29
Young Boys,8671,1,23,6,3,73,31,42,75
FC Basel,8671,2,17,8,7,53,26,27,59
St Gallen,8671,3,16,3,13,45,50,-5,51
FC Zürich,8671,4,11,10,11,43,35,8,43
Lucerne,8671,5,12,7,13,38,51,-13,43
FC Lugano,8671,6,11,6,15,30,43,-13,39
Grasshoppers,8671,7,9,6,17,40,50,-10,33
FC Thun,8671,8,9,6,17,41,61,-20,33
FC Sion,8671,9,6,8,18,42,58,-16,26
Young Boys,8672,1,21,7,4,67,34,33,70
FC Basel,8672,2,17,7,8,50,24,26,58
St Gallen,8672,3,15,2,15,42,54,-12,47
FC Zürich,8672,4,12,10,10,45,37,8,46
Lucerne,8672,5,12,8,12,40,44,-4,44
FC Lugano,8672,6,11,6,15,34,47,-13,39
FC Thun,8672,7,9,7,16,43,58,-15,34
Grasshoppers,8672,8,8,8,16,38,50,-12,32
FC Sion,8672,9,8,7,17,40,51,-11,31
Young Boys,8673,1,21,8,3,72,36,36,71
FC Basel,8673,2,18,8,6,55,26,29,62
St Gallen,8673,3,15,4,13,45,53,-8,49
Lucerne,8673,4,12,8,12,41,46,-5,44
FC Zürich,8673,5,11,10,11,43,37,6,43
FC Lugano,8673,6,10,7,15,31,47,-16,37
Grasshoppers,8673,7,9,8,15,40,49,-9,35
FC Thun,8673,8,9,5,18,44,63,-19,32
FC Sion,8673,9,6,8,18,43,57,-14,26
Young Boys,8674,1,20,8,4,67,34,33,68
FC Basel,8674,2,18,7,7,56,27,29,61
St Gallen,8674,3,14,3,15,44,60,-16,45
Lucerne,8674,4,12,8,12,42,47,-5,44
FC Zürich,8674,5,11,10,11,43,37,6,43
Grasshoppers,8674,6,11,7,14,42,46,-4,40
FC Lugano,8674,7,11,6,15,36,46,-10,39
FC Thun,8674,8,9,6,17,41,61,-20,33
FC Sion,8674,9,6,9,17,40,53,-13,27
Young Boys,8675,1,21,8,3,70,32,38,71
FC Basel,8675,2,19,7,6,55,26,29,64
St Gallen,8675,3,15,2,15,48,60,-12,47
Lucerne,8675,4,12,8,12,40,41,-1,44
FC Zürich,8675,5,10,10,12,38,35,3,40
FC Lugano,8675,6,11,6,15,32,48,-16,39
Grasshoppers,8675,7,9,7,16,38,51,-13,34
FC Thun,8675,8,9,5,18,42,60,-18,32
FC Sion,8675,9,8,7,17,44,54,-10,31
Young Boys,8676,1,21,8,3,73,33,40,71
FC Basel,8676,2,16,8,8,49,29,20,56
St Gallen,8676,3,15,4,13,44,53,-9,49
Lucerne,8676,4,13,9,10,43,44,-1,48
FC Zürich,8676,5,11,10,11,46,36,10,43
Grasshoppers,8676,6,11,7,14,44,45,-1,40
FC Thun,8676,7,9,7,16,40,55,-15,34
FC Lugano,8676,8,9,5,18,30,57,-27,32
FC Sion,8676,9,6,8,18,39,56,-17,26
Young Boys,8677,1,23,6,3,72,33,39,75
FC Basel,8677,2,19,8,5,57,25,32,65
St Gallen,8677,3,15,2,15,46,56,-10,47
Lucerne,8677,4,12,7,13,40,45,-5,43
FC Zürich,8677,5,10,11,11,40,36,4,41
FC Lugano,8677,6,11,5,16,30,48,-18,38
Grasshoppers,8677,7,10,6,16,44,51,-7,36
FC Sion,8677,8,7,8,17,42,56,-14,29
FC Thun,8677,9,8,5,19,43,64,-21,29
Young Boys,8678,1,22,7,3,73,34,39,73
FC Basel,8678,2,17,8,7,51,25,26,59
Lucerne,8678,3,13,8,11,45,44,1,47
FC Zürich,8678,4,11,11,10,46,36,10,44
St Gallen,8678,5,13,2,17,40,56,-16,41
Grasshoppers,8678,6,10,6,16,41,48,-7,36
FC Thun,8678,7,10,6,16,45,59,-14,36
FC Lugano,8678,8,10,6,16,29,51,-22,36
FC Sion,8678,9,7,8,17,40,57,-17,29
Young Boys,8679,1,22,6,4,75,37,38,72
FC Basel,8679,2,17,8,7,58,30,28,59
St Gallen,8679,3,16,2,14,44,52,-8,50
Lucerne,8679,4,13,7,12,41,43,-2,46
FC Zürich,8679,5,10,11,11,43,37,6,41
Grasshoppers,8679,6,11,6,15,44,52,-8,39
FC Thun,8679,7,11,5,16,46,60,-14,38
FC Lugano,8679,8,10,6,16,30,47,-17,36
FC Sion,8679,9,5,7,20,38,61,-23,22
Young Boys,8680,1,21,7,4,73,40,33,70
FC Basel,8680,2,18,7,7,59,25,34,61
Lucerne,8680,3,13,8,11,42,43,-1,47
St Gallen,8680,4,15,2,15,45,56,-11,47
FC Zürich,8680,5,11,10,11,43,38,5,43
FC Thun,8680,6,11,5,16,46,61,-15,38
Grasshoppers,8680,7,9,7,16,41,53,-12,34
FC Lugano,8680,8,9,6,17,30,50,-20,33
FC Sion,8680,9,7,8,17,45,58,-13,29
Young Boys,8681,1,21,8,3,72,37,35,71
FC Basel,8681,2,17,9,6,52,27,25,60
Lucerne,8681,3,13,8,11,42,41,1,47
St Gallen,8681,4,14,3,15,43,55,-12,45
FC Zürich,8681,5,10,11,11,39,36,3,41
FC Thun,8681,6,10,6,16,46,58,-12,36
FC Lugano,8681,7,10,6,16,30,46,-16,36
Grasshoppers,8681,8,8,10,14,39,47,-8,34
FC Sion,8681,9,6,9,17,40,56,-16,27
Young Boys,8682,1,20,8,4,68,36,32,68
FC Basel,8682,2,18,8,6,52,25,27,62
Lucerne,8682,3,13,8,11,46,43,3,47
FC Zürich,8682,4,12,10,10,44,37,7,46
St Gallen,8682,5,13,3,16,40,55,-15,42
Grasshoppers,8682,6,10,7,15,43,49,-6,37
FC Thun,8682,7,10,6,16,44,58,-14,36
FC Lugano,8682,8,10,5,17,29,49,-20,35
FC Sion,8682,9,7,7,18,42,56,-14,28
Young Boys,8683,1,21,6,5,71,39,32,69
FC Basel,8683,2,19,7,6,56,25,31,64
St Gallen,8683,3,16,2,14,46,55,-9,50
Lucerne,8683,4,13,8,11,42,42,0,47
FC Lugano,8683,5,12,5,15,32,44,-12,41
FC Zürich,8683,6,10,10,12,39,36,3,40
FC Thun,8683,7,10,6,16,48,59,-11,36
Grasshoppers,8683,8,8,7,17,37,51,-14,31
FC Sion,8683,9,6,7,19,41,61,-20,25
Young Boys,8684,1,22,7,3,79,38,41,73
FC Basel,8684,2,18,7,7,57,26,31,61
Lucerne,8684,3,13,7,12,41,42,-1,46
St Gallen,8684,4,14,2,16,39,60,-21,44
FC Zürich,8684,5,10,11,11,42,38,4,41
FC Lugano,8684,6,11,5,16,36,53,-17,38
FC Thun,8684,7,10,6,16,44,59,-15,36
Grasshoppers,8684,8,9,6,17,42,52,-10,33
FC Sion,8684,9,7,9,16,40,52,-12,30
Young Boys,8685,1,20,6,6,71,46,25,66
FC Basel,8685,2,19,7,6,57,24,33,64
FC Zürich,8685,3,13,9,10,41,33,8,48
St Gallen,8685,4,15,3,14,44,56,-12,48
Lucerne,8685,5,13,8,11,45,44,1,47
FC Lugano,8685,6,10,5,17,28,46,-18,35
Grasshoppers,8685,7,9,7,16,41,53,-12,34
FC Sion,8685,8,7,9,16,47,53,-6,30
FC Thun,8685,9,8,6,18,42,61,-19,30
Young Boys,8686,1,22,6,4,72,38,34,72
FC Basel,8686,2,18,8,6,53,24,29,62
Lucerne,8686,3,13,8,11,44,46,-2,47
St Gallen,8686,4,14,3,15,42,54,-12,45
FC Zürich,8686,5,11,11,10,44,34,10,44
FC Lugano,8686,6,11,5,16,31,45,-14,38
FC Thun,8686,7,9,5,18,43,63,-20,32
Grasshoppers,8686,8,8,7,17,43,56,-13,31
FC Sion,8686,9,7,9,16,41,53,-12,30
Young Boys,8687,1,21,7,4,69,34,35,70
FC Basel,8687,2,18,8,6,53,26,27,62
St Gallen,8687,3,15,3,14,43,54,-11,48
Lucerne,8687,4,12,8,12,41,46,-5,44
FC Zürich,8687,5,10,10,12,42,44,-2,40
FC Thun,8687,6,11,5,16,46,57,-11,38
Grasshoppers,8687,7,10,6,16,47,53,-6,36
FC Lugano,8687,8,9,8,15,30,46,-16,35
FC Sion,8687,9,7,7,18,46,57,-11,28
Young Boys,8688,1,21,7,4,69,36,33,70
FC Basel,8688,2,19,7,6,55,25,30,64
Lucerne,8688,3,12,9,11,43,44,-1,45
St Gallen,8688,4,13,3,16,41,56,-15,42
FC Zürich,8688,5,10,9,13,42,40,2,39
FC Lugano,8688,6,11,6,15,33,47,-14,39
Grasshoppers,8688,7,10,7,15,44,46,-2,37
FC Thun,8688,8,10,5,17,44,59,-15,35
FC Sion,8688,9,8,7,17,41,59,-18,31
Young Boys,8689,1,22,7,3,77,35,42,73
FC Basel,8689,2,16,9,7,52,28,24,57
St Gallen,8689,3,14,3,15,41,56,-15,45
FC Zürich,8689,4,11,11,10,43,37,6,44
Lucerne,8689,5,12,7,13,40,48,-8,43
FC Lugano,8689,6,11,6,15,33,47,-14,39
Grasshoppers,8689,7,10,8,14,44,49,-5,38
FC Thun,8689,8,8,8,16,44,60,-16,32
FC Sion,8689,9,6,9,17,44,58,-14,27
Young Boys,8690,1,20,8,4,69,34,35,68
FC Basel,8690,2,18,9,5,53,24,29,63
St Gallen,8690,3,15,2,15,44,54,-10,47
FC Zürich,8690,4,11,11,10,42,35,7,44
Lucerne,8690,5,11,8,13,42,53,-11,41
Grasshoppers,8690,6,11,7,14,48,46,2,40
FC Lugano,8690,7,10,8,14,30,44,-14,38
FC Thun,8690,8,9,7,16,43,59,-16,34
FC Sion,8690,9,5,8,19,38,60,-22,23
Young Boys,8691,1,23,7,2,76,35,41,76
FC Basel,8691,2,18,7,7,55,31,24,61
Lucerne,8691,3,12,9,11,45,46,-1,45
St Gallen,8691,4,14,3,15,44,58,-14,45
FC Zürich,8691,5,11,10,11,43,35,8,43
Grasshoppers,8691,6,10,8,14,45,51,-6,38
FC Lugano,8691,7,10,6,16,35,51,-16,36
FC Thun,8691,8,9,5,18,44,64,-20,32
FC Sion,8691,9,5,9,18,40,56,-16,24
Young Boys,8692,1,21,8,3,71,37,34,71
FC Basel,8692,2,19,8,5,58,25,33,65
St Gallen,8692,3,15,4,13,44,53,-9,49
Lucerne,8692,4,13,8,11,44,45,-1,47
FC Zürich,8692,5,10,10,12,38,38,0,40
FC Thun,8692,6,10,6,16,46,55,-9,36
FC Lugano,8692,7,10,5,17,31,48,-17,35
Grasshoppers,8692,8,8,7,17,37,53,-16,31
FC Sion,8692,9,6,8,18,39,54,-15,26
Young Boys,8693,1,22,6,4,76,34,42,72
FC Basel,8693,2,17,9,6,51,25,26,60
Lucerne,8693,3,12,9,11,40,42,-2,45
St Gallen,8693,4,14,3,15,42,54,-12,45
FC Zürich,8693,5,11,10,11,44,41,3,43
Grasshoppers,8693,6,10,7,15,44,54,-10,37
FC Lugano,8693,7,10,6,16,30,48,-18,36
FC Thun,8693,8,9,6,17,45,58,-13,33
FC Sion,8693,9,7,8,17,42,58,-16,29
Young Boys,8694,1,19,9,4,65,35,30,66
FC Basel,8694,2,18,8,6,53,24,29,62
Lucerne,8694,3,14,7,11,43,41,2,49
St Gallen,8694,4,15,2,15,40,53,-13,47
FC Zürich,8694,5,10,10,12,39,35,4,40
Grasshoppers,8694,6,11,6,15,45,48,-3,39
FC Lugano,8694,7,11,6,15,30,45,-15,39
FC Thun,8694,8,8,7,17,42,61,-19,31
FC Sion,8694,9,6,9,17,38,53,-15,27
Young Boys,8695,1,22,6,4,72,35,37,72
FC Basel,8695,2,18,8,6,54,25,29,62
Lucerne,8695,3,13,9,10,42,41,1,48
St Gallen,8695,4,14,3,15,40,53,-13,45
FC Thun,8695,5,11,6,15,47,58,-11,39
FC Lugano,8695,6,11,5,16,32,48,-16,38
FC Zürich,8695,7,9,9,14,41,42,-1,36
Grasshoppers,8695,8,9,7,16,39,50,-11,34
FC Sion,8695,9,7,7,18,42,57,-15,28
Young Boys,8696,1,22,6,4,76,37,39,72
FC Basel,8696,2,18,7,7,54,25,29,61
St Gallen,8696,3,16,2,14,49,52,-3,50
Lucerne,8696,4,13,7,12,42,48,-6,46
FC Zürich,8696,5,11,10,11,41,36,5,43
FC Thun,8696,6,11,5,16,47,60,-13,38
FC Lugano,8696,7,10,6,16,33,52,-19,36
Grasshoppers,8696,8,9,7,16,42,52,-10,34
FC Sion,8696,9,5,8,19,39,61,-22,23
Young Boys,8697,1,22,6,4,68,32,36,72
FC Basel,8697,2,17,7,8,54,32,22,58
Lucerne,8697,3,13,8,11,45,45,0,47
St Gallen,8697,4,15,2,15,48,56,-8,47
FC Zürich,8697,5,11,9,12,41,34,7,42
FC Thun,8697,6,12,5,15,46,54,-8,41
FC Lugano,8697,7,10,5,17,28,48,-20,35
Grasshoppers,8697,8,9,7,16,39,49,-10,34
FC Sion,8697,9,7,7,18,38,57,-19,28
Young Boys,8698,1,21,6,5,66,37,29,69
FC Basel,8698,2,18,9,5,58,23,35,63
Lucerne,8698,3,14,7,11,44,45,-1,49
St Gallen,8698,4,14,3,15,43,56,-13,45
Grasshoppers,8698,5,11,6,15,45,46,-1,39
FC Zürich,8698,6,9,11,12,39,37,2,38
FC Lugano,8698,7,10,6,16,32,52,-20,36
FC Sion,8698,8,8,7,17,41,54,-13,31
FC Thun,8698,9,8,7,17,42,60,-18,31
Young Boys,8699,1,21,9,2,74,33,41,72
FC Basel,8699,2,18,9,5,56,26,30,63
St Gallen,8699,3,15,4,13,45,51,-6,49
Lucerne,8699,4,11,9,12,39,52,-13,42
FC Zürich,8699,5,10,10,12,41,38,3,40
FC Thun,8699,6,11,5,16,47,60,-13,38
FC Lugano,8699,7,9,8,15,29,46,-17,35
Grasshoppers,8699,8,8,8,16,39,52,-13,32
FC Sion,8699,9,6,8,18,43,55,-12,26
Young Boys,8700,1,21,6,5,73,39,34,69
FC Basel,8700,2,17,9,6,56,29,27,60
Lucerne,8700,3,11,11,10,41,45,-4,44
FC Zürich,8700,4,11,10,11,41,36,5,43
St Gallen,8700,5,13,4,15,41,54,-13,43
FC Lugano,8700,6,12,6,14,32,42,-10,42
Grasshoppers,8700,7,9,8,15,42,51,-9,35
FC Thun,8700,8,9,7,16,46,61,-15,34
FC Sion,8700,9,7,7,18,40,55,-15,28
Young Boys,8701,1,23,7,2,75,32,43,76
FC Basel,8701,2,17,8,7,50,24,26,59
Lucerne,8701,3,13,7,12,43,46,-3,46
FC Zürich,8701,4,11,10,11,40,37,3,43
St Gallen,8701,5,13,3,16,39,54,-15,42
Grasshoppers,8701,6,11,7,14,46,48,-2,40
FC Thun,8701,7,11,5,16,46,59,-13,38
FC Lugano,8701,8,10,5,17,31,51,-20,35
FC Sion,8701,9,5,8,19,37,56,-19,23
Young Boys,8702,1,21,8,3,72,36,36,71
FC Basel,8702,2,18,7,7,54,26,28,61
Lucerne,8702,3,13,8,11,43,44,-1,47
St Gallen,8702,4,14,3,15,41,53,-12,45
FC Zürich,8702,5,11,10,11,43,37,6,43
Grasshoppers,8702,6,11,7,14,44,45,-1,40
FC Lugano,8702,7,10,7,15,31,48,-17,37
FC Thun,8702,8,10,5,17,45,61,-16,35
FC Sion,8702,9,5,7,20,41,64,-23,22
Young Boys,8703,1,21,7,4,72,37,35,70
FC Basel,8703,2,16,7,9,51,31,20,55
Lucerne,8703,3,14,9,9,46,42,4,51
St Gallen,8703,4,15,2,15,42,54,-12,47
FC Thun,8703,5,12,5,15,47,54,-7,41
FC Zürich,8703,6,10,10,12,41,36,5,40
FC Lugano,8703,7,10,6,16,30,47,-17,36
FC Sion,8703,8,8,8,16,38,52,-14,32
Grasshoppers,8703,9,8,6,18,38,52,-14,30
Young Boys,8704,1,20,7,5,69,39,30,67
FC Basel,8704,2,16,10,6,52,27,25,58
Lucerne,8704,3,13,10,9,46,41,5,49
St Gallen,8704,4,14,5,13,46,55,-9,47
FC Zürich,8704,5,9,12,11,39,36,3,39
FC Thun,8704,6,10,6,16,43,58,-15,36
Grasshoppers,8704,7,9,8,15,39,47,-8,35
FC Lugano,8704,8,9,6,17,32,53,-21,33
FC Sion,8704,9,7,10,15,43,53,-10,31
Young Boys,8705,1,21,6,5,67,38,29,69
FC Basel,8705,2,17,10,5,53,21,32,61
Lucerne,8705,3,15,7,10,47,42,5,52
St Gallen,8705,4,13,4,15,41,57,-16,43
FC Zürich,8705,5,10,11,11,40,36,4,41
Grasshoppers,8705,6,11,6,15,49,49,0,39
FC Thun,8705,7,10,6,16,43,59,-16,36
FC Lugano,8705,8,10,6,16,31,48,-17,36
FC Sion,8705,9,5,8,19,41,62,-21,23
Young Boys,8706,1,22,6,4,71,34,37,72
FC Basel,8706,2,18,7,7,55,25,30,61
Lucerne,8706,3,14,8,10,41,41,0,50
St Gallen,8706,4,14,3,15,43,57,-14,45
FC Zürich,8706,5,11,9,12,43,38,5,42
Grasshoppers,8706,6,10,7,15,40,46,-6,37
FC Thun,8706,7,10,6,16,43,59,-16,36
FC Lugano,8706,8,10,6,16,31,48,-17,36
FC Sion,8706,9,5,8,19,39,58,-19,23
Young Boys,8707,1,21,9,2,71,34,37,72
FC Basel,8707,2,17,10,5,55,26,29,61
Lucerne,8707,3,13,8,11,43,42,1,47
FC Zürich,8707,4,12,10,10,44,36,8,46
St Gallen,8707,5,13,3,16,42,58,-16,42
Grasshoppers,8707,6,10,6,16,41,46,-5,36
FC Thun,8707,7,10,5,17,44,59,-15,35
FC Lugano,8707,8,10,5,17,32,53,-21,35
FC Sion,8707,9,6,8,18,40,58,-18,26
Young Boys,8708,1,20,7,5,66,37,29,67
FC Basel,8708,2,17,9,6,54,25,29,60
Lucerne,8708,3,12,9,11,40,43,-3,45
St Gallen,8708,4,14,3,15,41,56,-15,45
FC Zürich,8708,5,9,13,10,42,38,4,40
FC Lugano,8708,6,11,7,14,32,43,-11,40
FC Thun,8708,7,10,7,15,47,60,-13,37
Grasshoppers,8708,8,9,8,15,44,50,-6,35
FC Sion,8708,9,6,9,17,43,57,-14,27
Young Boys,8709,1,21,7,4,73,36,37,70
FC Basel,8709,2,18,8,6,54,25,29,62
St Gallen,8709,3,15,2,15,45,52,-7,47
Lucerne,8709,4,13,7,12,43,51,-8,46
FC Zürich,8709,5,11,10,11,42,36,6,43
FC Lugano,8709,6,11,6,15,36,50,-14,39
FC Thun,8709,7,10,5,17,43,59,-16,35
Grasshoppers,8709,8,9,6,17,40,50,-10,33
FC Sion,8709,9,7,7,18,39,56,-17,28
Young Boys,8710,1,22,7,3,72,32,40,73
FC Basel,8710,2,18,8,6,53,25,28,62
Lucerne,8710,3,12,10,10,43,47,-4,46
St Gallen,8710,4,14,3,15,44,56,-12,45
FC Zürich,8710,5,10,10,12,38,35,3,40
FC Lugano,8710,6,10,8,14,30,44,-14,38
FC Thun,8710,7,9,6,17,45,59,-14,33
Grasshoppers,8710,8,9,6,17,39,53,-14,33
FC Sion,8710,9,7,8,17,42,55,-13,29
Young Boys,8711,1,20,7,5,69,41,28,67
FC Basel,8711,2,19,7,6,57,24,33,64
Lucerne,8711,3,14,8,10,45,42,3,50
FC Zürich,8711,4,11,11,10,42,35,7,44
St Gallen,8711,5,13,3,16,40,55,-15,42
FC Lugano,8711,6,10,7,15,32,47,-15,37
FC Thun,8711,7,10,6,16,42,57,-15,36
Grasshoppers,8711,8,8,9,15,41,51,-10,33
FC Sion,8711,9,6,8,18,39,55,-16,26
Young Boys,8712,1,22,8,2,76,33,43,74
FC Basel,8712,2,17,9,6,51,24,27,60
Lucerne,8712,3,13,10,9,43,40,3,49
St Gallen,8712,4,13,5,14,41,54,-13,44
FC Zürich,8712,5,10,11,11,42,37,5,41
FC Thun,8712,6,10,6,16,45,56,-11,36
FC Lugano,8712,7,9,7,16,29,48,-19,34
Grasshoppers,8712,8,9,6,17,42,54,-12,33
FC Sion,8712,9,6,8,18,40,63,-23,26
Young Boys,8713,1,22,7,3,74,37,37,73
FC Basel,8713,2,18,8,6,55,25,30,62
St Gallen,8713,3,15,2,15,45,55,-10,47
Lucerne,8713,4,13,7,12,41,46,-5,46
FC Zürich,8713,5,10,10,12,40,38,2,40
Grasshoppers,8713,6,10,7,15,48,54,-6,37
FC Lugano,8713,7,10,7,15,33,49,-16,37
FC Thun,8713,8,9,6,17,44,60,-16,33
FC Sion,8713,9,6,8,18,40,56,-16,26
Young Boys,8714,1,23,7,2,76,35,41,76
FC Basel,8714,2,17,7,8,52,27,25,58
Lucerne,8714,3,12,8,12,39,44,-5,44
St Gallen,8714,4,14,2,16,42,58,-16,44
FC Zürich,8714,5,11,9,12,41,39,2,42
Grasshoppers,8714,6,10,8,14,50,47,3,38
FC Thun,8714,7,11,5,16,48,63,-15,38
FC Lugano,8714,8,11,5,16,31,47,-16,38
FC Sion,8714,9,6,7,19,45,64,-19,25
Young Boys,8715,1,23,6,3,72,33,39,75
FC Basel,8715,2,16,9,7,53,28,25,57
Lucerne,8715,3,12,8,12,39,44,-5,44
St Gallen,8715,4,13,4,15,41,54,-13,43
Grasshoppers,8715,5,11,7,14,43,47,-4,40
FC Zürich,8715,6,10,9,13,40,40,0,39
FC Lugano,8715,7,11,5,16,31,47,-16,38
FC Thun,8715,8,10,6,16,44,56,-12,36
FC Sion,8715,9,7,8,17,40,54,-14,29
Young Boys,8716,1,22,7,3,74,36,38,73
FC Basel,8716,2,18,7,7,51,24,27,61
Lucerne,8716,3,13,9,10,43,41,2,48
FC Zürich,8716,4,10,11,11,39,35,4,41
St Gallen,8716,5,13,2,17,39,56,-17,41
FC Sion,8716,6,9,8,15,44,51,-7,35
FC Lugano,8716,7,10,5,17,30,50,-20,35
Grasshoppers,8716,8,9,7,16,40,48,-8,34
FC Thun,8716,9,9,6,17,39,58,-19,33
Young Boys,8717,1,20,8,4,69,36,33,68
FC Basel,8717,2,19,7,6,61,29,32,64
Lucerne,8717,3,15,7,10,46,44,2,52
St Gallen,8717,4,15,3,14,44,55,-11,48
FC Zürich,8717,5,10,9,13,39,40,-1,39
FC Thun,8717,6,10,6,16,46,59,-13,36
FC Lugano,8717,7,10,5,17,28,46,-18,35
Grasshoppers,8717,8,9,7,16,38,47,-9,34
FC Sion,8717,9,5,10,17,39,54,-15,25
FC Basel,8718,1,19,8,5,59,28,31,65
Young Boys,8718,2,19,7,6,68,39,29,64
Lucerne,8718,3,14,7,11,44,45,-1,49
St Gallen,8718,4,15,3,14,47,57,-10,48
FC Zürich,8718,5,10,10,12,39,37,2,40
Grasshoppers,8718,6,10,7,15,39,46,-7,37
FC Lugano,8718,7,10,6,16,32,48,-16,36
FC Thun,8718,8,9,6,17,41,56,-15,33
FC Sion,8718,9,6,10,16,38,51,-13,28
Young Boys,8719,1,21,8,3,75,39,36,71
FC Basel,8719,2,17,8,7,57,28,29,59
St Gallen,8719,3,15,2,15,44,54,-10,47
FC Zürich,8719,4,12,9,11,40,34,6,45
Lucerne,8719,5,12,9,11,41,48,-7,45
Grasshoppers,8719,6,11,6,15,46,48,-2,39
FC Lugano,8719,7,10,6,16,32,49,-17,36
FC Thun,8719,8,9,6,17,41,60,-19,33
FC Sion,8719,9,6,8,18,38,54,-16,26
Young Boys,8720,1,21,7,4,70,34,36,70
FC Basel,8720,2,17,7,8,52,28,24,58
Lucerne,8720,3,13,9,10,44,43,1,48
St Gallen,8720,4,14,3,15,42,60,-18,45
FC Zürich,8720,5,10,10,12,43,40,3,40
FC Thun,8720,6,11,6,15,45,56,-11,39
FC Lugano,8720,7,11,5,16,35,48,-13,38
Grasshoppers,8720,8,9,6,17,38,49,-11,33
FC Sion,8720,9,8,7,17,40,51,-11,31
Young Boys,8721,1,24,6,2,74,31,43,78
FC Basel,8721,2,18,7,7,55,26,29,61
Lucerne,8721,3,14,7,11,43,45,-2,49
St Gallen,8721,4,14,2,16,42,56,-14,44
FC Zürich,8721,5,11,10,11,40,34,6,43
Grasshoppers,8721,6,10,6,16,42,51,-9,36
FC Lugano,8721,7,10,5,17,28,47,-19,35
FC Thun,8721,8,8,6,18,40,60,-20,30
FC Sion,8721,9,6,9,17,39,53,-14,27
Young Boys,8722,1,22,7,3,72,40,32,73
FC Basel,8722,2,17,9,6,55,26,29,60
St Gallen,8722,3,15,3,14,49,55,-6,48
Lucerne,8722,4,11,8,13,38,45,-7,41
FC Zürich,8722,5,9,12,11,37,35,2,39
Grasshoppers,8722,6,11,6,15,43,48,-5,39
FC Lugano,8722,7,10,7,15,29,45,-16,37
FC Thun,8722,8,10,6,16,48,56,-8,36
FC Sion,8722,9,5,10,17,43,64,-21,25
Young Boys,8723,1,22,7,3,76,35,41,73
FC Basel,8723,2,17,9,6,53,26,27,60
Lucerne,8723,3,13,8,11,43,46,-3,47
St Gallen,8723,4,14,2,16,40,54,-14,44
FC Zürich,8723,5,10,10,12,42,40,2,40
FC Lugano,8723,6,11,6,15,34,49,-15,39
Grasshoppers,8723,7,10,6,16,40,48,-8,36
FC Thun,8723,8,9,6,17,45,61,-16,33
FC Sion,8723,9,7,8,17,42,56,-14,29
Young Boys,8724,1,22,6,4,74,37,37,72
FC Basel,8724,2,20,7,5,65,26,39,67
Lucerne,8724,3,12,8,12,40,51,-11,44
FC Zürich,8724,4,11,10,11,42,36,6,43
St Gallen,8724,5,13,3,16,43,57,-14,42
Grasshoppers,8724,6,10,7,15,43,49,-6,37
FC Lugano,8724,7,10,6,16,30,48,-18,36
FC Thun,8724,8,9,6,17,42,59,-17,33
FC Sion,8724,9,7,7,18,42,58,-16,28
Young Boys,8725,1,20,8,4,70,37,33,68
FC Basel,8725,2,19,8,5,55,23,32,65
Lucerne,8725,3,13,8,11,42,42,0,47
FC Lugano,8725,4,12,6,14,35,47,-12,42
St Gallen,8725,5,13,3,16,41,57,-16,42
FC Zürich,8725,6,9,10,13,40,41,-1,37
FC Thun,8725,7,10,5,17,46,60,-14,35
Grasshoppers,8725,8,9,6,17,43,54,-11,33
FC Sion,8725,9,8,8,16,44,55,-11,32
Young Boys,8726,1,23,6,3,75,33,42,75
FC Basel,8726,2,17,8,7,52,30,22,59
FC Zürich,8726,3,12,9,11,44,36,8,45
St Gallen,8726,4,14,3,15,42,54,-12,45
Lucerne,8726,5,12,8,12,40,43,-3,44
Grasshoppers,8726,6,11,6,15,44,51,-7,39
FC Lugano,8726,7,10,5,17,31,48,-17,35
FC Thun,8726,8,9,6,17,41,58,-17,33
FC Sion,8726,9,7,7,18,38,54,-16,28
Young Boys,8727,1,20,8,4,69,35,34,68
FC Basel,8727,2,17,8,7,53,26,27,59
Lucerne,8727,3,14,8,10,44,43,1,50
FC Zürich,8727,4,12,9,11,45,36,9,45
St Gallen,8727,5,13,4,15,44,58,-14,43
Grasshoppers,8727,6,12,6,14,45,48,-3,42
FC Lugano,8727,7,10,6,16,34,51,-17,36
FC Sion,8727,8,7,8,17,43,57,-14,29
FC Thun,8727,9,8,5,19,41,64,-23,29
Young Boys,8728,1,20,7,5,65,34,31,67
FC Basel,8728,2,19,8,5,57,23,34,65
Lucerne,8728,3,14,7,11,42,42,0,49
St Gallen,8728,4,14,2,16,42,58,-16,44
FC Zürich,8728,5,10,11,11,40,36,4,41
FC Lugano,8728,6,11,6,15,34,47,-13,39
Grasshoppers,8728,7,10,6,16,42,49,-7,36
FC Thun,8728,8,9,6,17,41,58,-17,33
FC Sion,8728,9,6,9,17,36,52,-16,27
Young Boys,8729,1,21,8,3,77,39,38,71
FC Basel,8729,2,17,9,6,56,27,29,60
Lucerne,8729,3,13,8,11,43,45,-2,47
St Gallen,8729,4,15,2,15,45,56,-11,47
FC Zürich,8729,5,11,9,12,42,38,4,42
FC Thun,8729,6,11,5,16,45,59,-14,38
FC Lugano,8729,7,11,5,16,32,52,-20,38
Grasshoppers,8729,8,9,6,17,42,51,-9,33
FC Sion,8729,9,6,8,18,42,57,-15,26
Young Boys,8730,1,19,7,6,68,38,30,64
FC Basel,8730,2,18,8,6,55,26,29,62
St Gallen,8730,3,16,2,14,45,52,-7,50
Lucerne,8730,4,13,8,11,40,42,-2,47
FC Zürich,8730,5,11,10,11,41,33,8,43
FC Thun,8730,6,11,5,16,45,58,-13,38
FC Lugano,8730,7,10,6,16,30,49,-19,36
Grasshoppers,8730,8,9,7,16,40,50,-10,34
FC Sion,8730,9,7,7,18,40,56,-16,28
Young Boys,8731,1,21,7,4,70,35,35,70
FC Basel,8731,2,16,10,6,58,31,27,58
Lucerne,8731,3,12,9,11,40,44,-4,45
St Gallen,8731,4,14,3,15,45,60,-15,45
FC Zürich,8731,5,11,10,11,44,38,6,43
Grasshoppers,8731,6,11,7,14,47,50,-3,40
FC Lugano,8731,7,11,5,16,32,46,-14,38
FC Thun,8731,8,10,6,16,50,64,-14,36
FC Sion,8731,9,5,9,18,39,57,-18,24
Young Boys,8732,1,22,7,3,72,34,38,73
FC Basel,8732,2,16,9,7,54,30,24,57
St Gallen,8732,3,15,3,14,45,54,-9,48
Lucerne,8732,4,12,8,12,44,46,-2,44
FC Zürich,8732,5,10,12,10,40,34,6,42
FC Thun,8732,6,10,7,15,46,56,-10,37
Grasshoppers,8732,7,10,6,16,40,51,-11,36
FC Lugano,8732,8,10,6,16,29,46,-17,36
FC Sion,8732,9,6,8,18,40,59,-19,26
Young Boys,8733,1,22,7,3,77,37,40,73
FC Basel,8733,2,19,7,6,58,25,33,64
Lucerne,8733,3,12,8,12,43,49,-6,44
FC Lugano,8733,4,12,6,14,36,48,-12,42
St Gallen,8733,5,13,3,16,42,56,-14,42
FC Zürich,8733,6,9,10,13,37,39,-2,37
Grasshoppers,8733,7,9,9,14,43,49,-6,36
FC Thun,8733,8,10,6,16,43,57,-14,36
FC Sion,8733,9,5,10,17,39,58,-19,25
Young Boys,8734,1,21,8,3,68,33,35,71
FC Basel,8734,2,16,8,8,50,28,22,56
St Gallen,8734,3,15,3,14,44,53,-9,48
Lucerne,8734,4,12,9,11,38,40,-2,45
FC Lugano,8734,5,12,5,15,33,46,-13,41
FC Zürich,8734,6,10,10,12,43,40,3,40
FC Thun,8734,7,10,7,15,42,54,-12,37
Grasshoppers,8734,8,9,8,15,38,46,-8,35
FC Sion,8734,9,6,8,18,38,54,-16,26
Young Boys,8735,1,22,6,4,68,33,35,72
FC Basel,8735,2,19,7,6,59,25,34,64
St Gallen,8735,3,15,3,14,44,55,-11,48
Lucerne,8735,4,13,8,11,43,44,-1,47
FC Zürich,8735,5,11,9,12,39,36,3,42
FC Lugano,8735,6,12,5,15,36,47,-11,41
Grasshoppers,8735,7,9,6,17,39,51,-12,33
FC Thun,8735,8,9,5,18,43,64,-21,32
FC Sion,8735,9,6,7,19,38,54,-16,25
Young Boys,8736,1,22,7,3,70,34,36,73
FC Basel,8736,2,17,10,5,54,25,29,61
Lucerne,8736,3,12,9,11,45,46,-1,45
St Gallen,8736,4,14,3,15,42,55,-13,45
FC Zürich,8736,5,10,11,11,40,38,2,41
FC Lugano,8736,6,11,5,16,31,45,-14,38
FC Thun,8736,7,9,7,16,44,59,-15,34
FC Sion,8736,8,8,8,16,41,49,-8,32
Grasshoppers,8736,9,8,6,18,38,54,-16,30
Young Boys,8737,1,23,6,3,73,33,40,75
FC Basel,8737,2,18,9,5,58,27,31,63
St Gallen,8737,3,14,4,14,45,57,-12,46
Lucerne,8737,4,12,7,13,40,46,-6,43
FC Zürich,8737,5,10,11,11,40,35,5,41
Grasshoppers,8737,6,10,6,16,41,50,-9,36
FC Lugano,8737,7,10,6,16,31,48,-17,36
FC Thun,8737,8,8,7,17,40,60,-20,31
FC Sion,8737,9,7,8,17,45,57,-12,29
Young Boys,8738,1,23,6,3,75,34,41,75
FC Basel,8738,2,18,8,6,55,27,28,62
Lucerne,8738,3,13,8,11,43,45,-2,47
St Gallen,8738,4,13,5,14,42,55,-13,44
FC Zürich,8738,5,10,12,10,39,32,7,42
FC Thun,8738,6,9,8,15,46,54,-8,35
FC Lugano,8738,7,9,7,16,31,51,-20,34
Grasshoppers,8738,8,9,6,17,39,56,-17,33
FC Sion,8738,9,5,10,17,36,52,-16,25
Young Boys,8739,1,23,7,2,81,36,45,76
FC Basel,8739,2,15,9,8,50,29,21,54
Lucerne,8739,3,13,8,11,44,50,-6,47
St Gallen,8739,4,14,4,14,40,52,-12,46
FC Zürich,8739,5,11,9,12,39,35,4,42
FC Thun,8739,6,10,6,16,44,57,-13,36
FC Lugano,8739,7,10,6,16,30,46,-16,36
Grasshoppers,8739,8,9,8,15,38,46,-8,35
FC Sion,8739,9,6,9,17,38,53,-15,27
Young Boys,8740,1,22,7,3,72,35,37,73
FC Basel,8740,2,18,7,7,55,26,29,61
St Gallen,8740,3,16,2,14,44,52,-8,50
Lucerne,8740,4,13,8,11,42,43,-1,47
FC Lugano,8740,5,11,6,15,32,44,-12,39
FC Thun,8740,6,11,5,16,47,60,-13,38
FC Zürich,8740,7,9,9,14,39,40,-1,36
Grasshoppers,8740,8,8,7,17,40,52,-12,31
FC Sion,8740,9,6,9,17,38,57,-19,27
Young Boys,8741,1,22,6,4,72,34,38,72
FC Basel,8741,2,18,8,6,54,27,27,62
Lucerne,8741,3,14,8,10,44,42,2,50
St Gallen,8741,4,15,3,14,43,53,-10,48
FC Zürich,8741,5,10,10,12,42,39,3,40
FC Thun,8741,6,11,6,15,48,59,-11,39
FC Lugano,8741,7,9,7,16,30,51,-21,34
Grasshoppers,8741,8,8,7,17,39,50,-11,31
FC Sion,8741,9,6,7,19,40,57,-17,25
Young Boys,8742,1,21,7,4,67,32,35,70
FC Basel,8742,2,15,9,8,46,24,22,54
Lucerne,8742,3,15,7,10,47,41,6,52
St Gallen,8742,4,14,2,16,39,55,-16,44
FC Zürich,8742,5,11,10,11,43,36,7,43
FC Lugano,8742,6,12,5,15,35,47,-12,41
FC Thun,8742,7,10,7,15,46,59,-13,37
Grasshoppers,8742,8,8,7,17,40,54,-14,31
FC Sion,8742,9,6,10,16,40,55,-15,28
Young Boys,8743,1,20,7,5,71,40,31,67
FC Basel,8743,2,19,7,6,57,24,33,64
Lucerne,8743,3,12,9,11,42,45,-3,45
St Gallen,8743,4,14,2,16,41,58,-17,44
FC Zürich,8743,5,11,9,12,39,37,2,42
FC Lugano,8743,6,12,5,15,34,45,-11,41
FC Thun,8743,7,11,5,16,46,56,-10,38
Grasshoppers,8743,8,9,7,16,41,50,-9,34
FC Sion,8743,9,7,7,18,38,54,-16,28
Young Boys,8744,1,22,7,3,74,38,36,73
FC Basel,8744,2,17,8,7,56,30,26,59
St Gallen,8744,3,14,3,15,41,55,-14,45
Lucerne,8744,4,12,8,12,47,49,-2,44
FC Zürich,8744,5,11,10,11,43,36,7,43
FC Lugano,8744,6,11,5,16,31,49,-18,38
Grasshoppers,8744,7,9,8,15,42,51,-9,35
FC Thun,8744,8,10,5,17,44,61,-17,35
FC Sion,8744,9,7,8,17,43,52,-9,29
Young Boys,8745,1,22,8,2,69,31,38,74
FC Basel,8745,2,18,7,7,56,27,29,61
Lucerne,8745,3,13,8,11,47,48,-1,47
St Gallen,8745,4,14,2,16,42,54,-12,44
FC Zürich,8745,5,11,10,11,43,37,6,43
Grasshoppers,8745,6,9,8,15,40,50,-10,35
FC Thun,8745,7,9,7,16,43,59,-16,34
FC Lugano,8745,8,9,7,16,29,48,-19,34
FC Sion,8745,9,6,9,17,38,53,-15,27
Young Boys,8746,1,20,8,4,68,34,34,68
FC Basel,8746,2,19,7,6,60,27,33,64
Lucerne,8746,3,14,7,11,42,41,1,49
St Gallen,8746,4,14,2,16,45,58,-13,44
FC Zürich,8746,5,11,9,12,39,37,2,42
FC Lugano,8746,6,11,6,15,32,45,-13,39
Grasshoppers,8746,7,10,7,15,41,47,-6,37
FC Thun,8746,8,10,5,17,44,63,-19,35
FC Sion,8746,9,6,7,19,39,58,-19,25
Young Boys,8747,1,21,8,3,66,31,35,71
FC Basel,8747,2,18,9,5,52,24,28,63
Lucerne,8747,3,13,8,11,41,41,0,47
St Gallen,8747,4,13,4,15,39,54,-15,43
FC Lugano,8747,5,11,6,15,32,44,-12,39
FC Zürich,8747,6,9,10,13,40,39,1,37
Grasshoppers,8747,7,10,6,16,43,49,-6,36
FC Thun,8747,8,9,6,17,42,61,-19,33
FC Sion,8747,9,7,9,16,40,52,-12,30
Young Boys,8748,1,23,7,2,73,32,41,76
FC Basel,8748,2,17,8,7,57,29,28,59
St Gallen,8748,3,16,3,13,45,51,-6,51
Lucerne,8748,4,12,7,13,40,48,-8,43
FC Zürich,8748,5,10,10,12,40,38,2,40
FC Thun,8748,6,11,5,16,48,61,-13,38
FC Lugano,8748,7,10,7,15,32,45,-13,37
Grasshoppers,8748,8,8,6,18,41,55,-14,30
FC Sion,8748,9,7,7,18,40,57,-17,28
Young Boys,8749,1,21,8,3,73,37,36,71
FC Basel,8749,2,18,7,7,56,28,28,61
Lucerne,8749,3,14,7,11,44,45,-1,49
St Gallen,8749,4,15,2,15,44,55,-11,47
FC Zürich,8749,5,10,11,11,42,38,4,41
Grasshoppers,8749,6,9,8,15,45,50,-5,35
FC Lugano,8749,7,9,6,17,31,51,-20,33
FC Sion,8749,8,8,8,16,41,55,-14,32
FC Thun,8749,9,8,7,17,40,57,-17,31
Young Boys,8750,1,22,7,3,74,35,39,73
FC Basel,8750,2,19,7,6,56,26,30,64
St Gallen,8750,3,14,5,13,42,51,-9,47
Lucerne,8750,4,12,8,12,42,48,-6,44
FC Zürich,8750,5,11,9,12,43,39,4,42
Grasshoppers,8750,6,10,8,14,46,49,-3,38
FC Lugano,8750,7,9,6,17,30,50,-20,33
FC Thun,8750,8,9,5,18,43,62,-19,32
FC Sion,8750,9,6,9,17,42,58,-16,27
Young Boys,8751,1,20,6,6,71,42,29,66
FC Basel,8751,2,17,9,6,55,28,27,60
Lucerne,8751,3,14,8,10,46,43,3,50
FC Zürich,8751,4,11,10,11,43,36,7,43
St Gallen,8751,5,13,4,15,44,60,-16,43
Grasshoppers,8751,6,10,7,15,45,52,-7,37
FC Thun,8751,7,10,6,16,48,58,-10,36
FC Lugano,8751,8,10,6,16,32,51,-19,36
FC Sion,8751,9,7,8,17,44,58,-14,29
Young Boys,8752,1,22,8,2,75,37,38,74
FC Basel,8752,2,18,8,6,57,27,30,62
Lucerne,8752,3,13,9,10,45,42,3,48
St Gallen,8752,4,15,3,14,46,57,-11,48
FC Zürich,8752,5,12,10,10,46,38,8,46
Grasshoppers,8752,6,10,6,16,41,52,-11,36
FC Lugano,8752,7,9,5,18,30,51,-21,32
FC Thun,8752,8,8,5,19,41,62,-21,29
FC Sion,8752,9,6,8,18,45,60,-15,26
Young Boys,8753,1,22,7,3,71,33,38,73
FC Basel,8753,2,17,7,8,50,27,23,58
St Gallen,8753,3,15,2,15,44,55,-11,47
FC Zürich,8753,4,12,9,11,46,37,9,45
Lucerne,8753,5,12,7,13,40,45,-5,43
Grasshoppers,8753,6,10,7,15,42,49,-7,37
FC Thun,8753,7,10,5,17,45,61,-16,35
FC Lugano,8753,8,10,5,17,31,52,-21,35
FC Sion,8753,9,8,7,17,47,57,-10,31
Young Boys,8754,1,20,8,4,72,37,35,68
FC Basel,8754,2,17,10,5,53,25,28,61
St Gallen,8754,3,14,3,15,44,57,-13,45
FC Lugano,8754,4,12,6,14,34,46,-12,42
Lucerne,8754,5,11,7,14,38,49,-11,40
FC Thun,8754,6,11,6,15,50,55,-5,39
Grasshoppers,8754,7,11,6,15,42,48,-6,39
FC Zürich,8754,8,9,9,14,39,41,-2,36
FC Sion,8754,9,8,7,17,43,57,-14,31
Young Boys,8755,1,20,8,4,69,36,33,68
FC Basel,8755,2,16,9,7,50,27,23,57
Lucerne,8755,3,14,9,9,42,39,3,51
FC Zürich,8755,4,12,9,11,43,35,8,45
St Gallen,8755,5,13,2,17,38,56,-18,41
Grasshoppers,8755,6,10,6,16,40,48,-8,36
FC Thun,8755,7,10,5,17,45,59,-14,35
FC Lugano,8755,8,10,5,17,29,48,-19,35
FC Sion,8755,9,9,7,16,42,50,-8,34
Young Boys,8756,1,22,6,4,73,37,36,72
FC Basel,8756,2,20,7,5,61,24,37,67
Lucerne,8756,3,14,7,11,45,46,-1,49
St Gallen,8756,4,14,3,15,45,56,-11,45
FC Zürich,8756,5,10,10,12,41,38,3,40
Grasshoppers,8756,6,9,6,17,43,54,-11,33
FC Lugano,8756,7,9,6,17,29,51,-22,33
FC Sion,8756,8,8,8,16,50,59,-9,32
FC Thun,8756,9,9,5,18,45,67,-22,32
Young Boys,8757,1,21,8,3,73,36,37,71
FC Basel,8757,2,17,8,7,50,27,23,59
Lucerne,8757,3,12,10,10,43,44,-1,46
St Gallen,8757,4,13,4,15,42,57,-15,43
FC Zürich,8757,5,11,9,12,47,40,7,42
FC Lugano,8757,6,11,6,15,33,46,-13,39
Grasshoppers,8757,7,9,9,14,45,52,-7,36
FC Thun,8757,8,10,5,17,47,61,-14,35
FC Sion,8757,9,6,9,17,41,58,-17,27
Young Boys,8758,1,22,6,4,69,33,36,72
FC Basel,8758,2,18,7,7,51,24,27,61
Lucerne,8758,3,12,9,11,38,41,-3,45
St Gallen,8758,4,14,3,15,41,52,-11,45
Grasshoppers,8758,5,11,7,14,43,47,-4,40
FC Zürich,8758,6,10,9,13,41,39,2,39
FC Lugano,8758,7,11,5,16,32,47,-15,38
FC Thun,8758,8,9,6,17,41,59,-18,33
FC Sion,8758,9,7,8,17,40,54,-14,29
Young Boys,8759,1,23,6,3,74,30,44,75
FC Basel,8759,2,16,10,6,52,30,22,58
St Gallen,8759,3,15,3,14,46,52,-6,48
Lucerne,8759,4,13,8,11,45,44,1,47
FC Zürich,8759,5,10,11,11,40,36,4,41
FC Lugano,8759,6,10,6,16,29,47,-18,36
FC Thun,8759,7,9,7,16,44,59,-15,34
Grasshoppers,8759,8,9,6,17,41,57,-16,33
FC Sion,8759,9,7,7,18,37,53,-16,28
Young Boys,8760,1,21,6,5,71,38,33,69
FC Basel,8760,2,17,9,6,54,26,28,60
Lucerne,8760,3,15,8,9,44,40,4,53
St Gallen,8760,4,13,3,16,40,54,-14,42
FC Zürich,8760,5,10,10,12,40,37,3,40
Grasshoppers,8760,6,11,6,15,43,48,-5,39
FC Thun,8760,7,9,6,17,44,61,-17,33
FC Lugano,8760,8,9,6,17,30,51,-21,33
FC Sion,8760,9,8,8,16,40,51,-11,32
Young Boys,8761,1,20,7,5,69,41,28,67
FC Basel,8761,2,17,8,7,54,30,24,59
Lucerne,8761,3,13,9,10,50,46,4,48
St Gallen,8761,4,15,3,14,47,54,-7,48
FC Zürich,8761,5,10,11,11,40,36,4,41
FC Lugano,8761,6,11,6,15,32,49,-17,39
Grasshoppers,8761,7,10,8,14,46,48,-2,38
FC Thun,8761,8,10,7,15,44,55,-11,37
FC Sion,8761,9,5,7,20,35,58,-23,22
Young Boys,8762,1,21,6,5,68,35,33,69
FC Basel,8762,2,19,7,6,54,23,31,64
Lucerne,8762,3,13,7,12,43,46,-3,46
St Gallen,8762,4,14,4,14,44,55,-11,46
FC Thun,8762,5,11,5,16,42,55,-13,38
FC Zürich,8762,6,9,10,13,38,39,-1,37
FC Lugano,8762,7,10,7,15,30,47,-17,37
Grasshoppers,8762,8,10,6,16,46,53,-7,36
FC Sion,8762,9,7,8,17,43,55,-12,29
Young Boys,8763,1,23,6,3,77,40,37,75
FC Basel,8763,2,20,7,5,61,24,37,67
Lucerne,8763,3,14,7,11,42,44,-2,49
St Gallen,8763,4,13,3,16,39,57,-18,42
FC Zürich,8763,5,10,10,12,40,37,3,40
FC Lugano,8763,6,10,6,16,31,47,-16,36
FC Thun,8763,7,10,5,17,41,56,-15,35
Grasshoppers,8763,8,9,6,17,42,54,-12,33
FC Sion,8763,9,6,8,18,38,52,-14,26
Young Boys,8764,1,22,6,4,73,36,37,72
FC Basel,8764,2,18,7,7,54,25,29,61
Lucerne,8764,3,14,8,10,48,45,3,50
St Gallen,8764,4,14,2,16,42,59,-17,44
FC Zürich,8764,5,11,10,11,41,36,5,43
FC Thun,8764,6,11,5,16,45,57,-12,38
Grasshoppers,8764,7,10,6,16,43,49,-6,36
FC Lugano,8764,8,9,6,17,28,48,-20,33
FC Sion,8764,9,6,8,18,40,59,-19,26
Young Boys,8765,1,21,8,3,71,34,37,71
FC Basel,8765,2,17,8,7,54,28,26,59
St Gallen,8765,3,15,4,13,44,53,-9,49
Lucerne,8765,4,13,9,10,42,43,-1,48
FC Zürich,8765,5,11,11,10,41,35,6,44
Grasshoppers,8765,6,10,6,16,43,48,-5,36
FC Lugano,8765,7,9,7,16,30,47,-17,34
FC Thun,8765,8,9,6,17,42,59,-17,33
FC Sion,8765,9,5,9,18,37,57,-20,24
Young Boys,8766,1,22,8,2,75,31,44,74
FC Basel,8766,2,19,8,5,55,22,33,65
St Gallen,8766,3,16,2,14,45,51,-6,50
Lucerne,8766,4,12,8,12,43,52,-9,44
FC Zürich,8766,5,9,10,13,39,41,-2,37
FC Lugano,8766,6,10,7,15,32,47,-15,37
FC Thun,8766,7,10,5,17,45,60,-15,35
Grasshoppers,8766,8,9,6,17,41,53,-12,33
FC Sion,8766,9,6,8,18,40,58,-18,26
Young Boys,8767,1,23,6,3,73,34,39,75
FC Basel,8767,2,18,7,7,51,25,26,61
St Gallen,8767,3,15,2,15,43,55,-12,47
Lucerne,8767,4,12,7,13,41,46,-5,43
FC Zürich,8767,5,11,9,12,43,37,6,42
FC Lugano,8767,6,12,5,15,33,48,-15,41
Grasshoppers,8767,7,11,6,15,50,52,-2,39
FC Thun,8767,8,8,6,18,44,65,-21,30
FC Sion,8767,9,6,8,18,39,55,-16,26
Young Boys,8768,1,21,7,4,70,37,33,70
FC Basel,8768,2,17,10,5,56,28,28,61
St Gallen,8768,3,15,4,13,44,52,-8,49
FC Zürich,8768,4,11,10,11,45,38,7,43
Lucerne,8768,5,11,8,13,40,50,-10,41
FC Lugano,8768,6,11,5,16,34,46,-12,38
Grasshoppers,8768,7,10,7,15,43,48,-5,37
FC Thun,8768,8,9,5,18,42,62,-20,32
FC Sion,8768,9,7,8,17,41,54,-13,29
Young Boys,8769,1,22,7,3,77,38,39,73
FC Basel,8769,2,17,8,7,57,29,28,59
Lucerne,8769,3,14,8,10,44,43,1,50
St Gallen,8769,4,13,3,16,40,56,-16,42
FC Zürich,8769,5,10,10,12,42,40,2,40
Grasshoppers,8769,6,10,6,16,43,51,-8,36
FC Lugano,8769,7,10,5,17,29,48,-19,35
FC Thun,8769,8,9,7,16,44,60,-16,34
FC Sion,8769,9,8,8,16,45,56,-11,32
Young Boys,8770,1,23,7,2,74,35,39,76
FC Basel,8770,2,18,7,7,56,27,29,61
St Gallen,8770,3,16,3,13,45,51,-6,51
Lucerne,8770,4,12,8,12,41,46,-5,44
FC Thun,8770,5,11,5,16,49,65,-16,38
FC Zürich,8770,6,9,10,13,40,39,1,37
FC Lugano,8770,7,10,7,15,30,45,-15,37
Grasshoppers,8770,8,9,6,17,46,54,-8,33
FC Sion,8770,9,6,7,19,41,60,-19,25
Young Boys,8771,1,21,8,3,75,37,38,71
FC Basel,8771,2,19,7,6,58,26,32,64
Lucerne,8771,3,12,9,11,46,49,-3,45
FC Zürich,8771,4,11,10,11,43,37,6,43
St Gallen,8771,5,13,4,15,40,55,-15,43
FC Lugano,8771,6,9,9,14,31,46,-15,36
FC Thun,8771,7,10,5,17,44,62,-18,35
Grasshoppers,8771,8,8,8,16,46,57,-11,32
FC Sion,8771,9,7,8,17,41,55,-14,29
Young Boys,8772,1,21,7,4,70,37,33,70
FC Basel,8772,2,19,8,5,56,22,34,65
Lucerne,8772,3,12,9,11,43,46,-3,45
St Gallen,8772,4,13,3,16,38,55,-17,42
FC Zürich,8772,5,9,11,12,39,40,-1,38
FC Thun,8772,6,11,5,16,45,58,-13,38
FC Lugano,8772,7,11,5,16,33,47,-14,38
Grasshoppers,8772,8,9,8,15,43,49,-6,35
FC Sion,8772,9,6,10,16,40,53,-13,28
Young Boys,8773,1,21,8,3,70,38,32,71
FC Basel,8773,2,16,8,8,53,30,23,56
Lucerne,8773,3,14,7,11,43,41,2,49
St Gallen,8773,4,15,3,14,44,53,-9,48
FC Zürich,8773,5,11,9,12,46,39,7,42
Grasshoppers,8773,6,11,7,14,43,46,-3,40
FC Thun,8773,7,11,5,16,47,56,-9,38
FC Lugano,8773,8,10,5,17,29,48,-19,35
FC Sion,8773,9,5,8,19,39,63,-24,23
Young Boys,8774,1,22,7,3,70,31,39,73
FC Basel,8774,2,19,8,5,58,24,34,65
Lucerne,8774,3,12,10,10,46,44,2,46
St Gallen,8774,4,13,3,16,41,59,-18,42
FC Zürich,8774,5,10,11,11,39,35,4,41
FC Lugano,8774,6,11,6,15,34,47,-13,39
Grasshoppers,8774,7,10,6,16,38,53,-15,36
FC Thun,8774,8,8,7,17,40,58,-18,31
FC Sion,8774,9,6,8,18,37,52,-15,26
Young Boys,8775,1,22,7,3,70,31,39,73
FC Basel,8775,2,16,11,5,50,23,27,59
St Gallen,8775,3,14,5,13,43,53,-10,47
Lucerne,8775,4,11,10,11,42,45,-3,43
FC Zürich,8775,5,9,12,11,40,38,2,39
FC Thun,8775,6,10,6,16,43,57,-14,36
FC Lugano,8775,7,9,7,16,30,50,-20,34
Grasshoppers,8775,8,9,6,17,40,51,-11,33
FC Sion,8775,9,7,10,15,42,52,-10,31
Young Boys,8776,1,23,6,3,74,31,43,75
FC Basel,8776,2,17,9,6,52,26,26,60
St Gallen,8776,3,15,4,13,44,53,-9,49
Lucerne,8776,4,13,8,11,44,45,-1,47
FC Zürich,8776,5,10,11,11,42,37,5,41
FC Thun,8776,6,11,6,15,50,57,-7,39
Grasshoppers,8776,7,9,6,17,41,55,-14,33
FC Lugano,8776,8,9,5,18,28,52,-24,32
FC Sion,8776,9,5,9,18,39,58,-19,24
Young Boys,8777,1,22,6,4,72,38,34,72
FC Basel,8777,2,20,7,5,59,26,33,67
St Gallen,8777,3,14,3,15,44,56,-12,45
FC Zürich,8777,4,11,9,12,42,36,6,42
Lucerne,8777,5,11,9,12,39,46,-7,42
FC Lugano,8777,6,11,6,15,31,45,-14,39
Grasshoppers,8777,7,9,8,15,41,48,-7,35
FC Thun,8777,8,8,6,18,40,61,-21,30
FC Sion,8777,9,6,10,16,41,53,-12,28
Young Boys,8778,1,22,8,2,71,32,39,74
FC Basel,8778,2,16,11,5,50,23,27,59
Lucerne,8778,3,12,9,11,45,46,-1,45
St Gallen,8778,4,13,4,15,41,55,-14,43
FC Zürich,8778,5,10,12,10,42,36,6,42
FC Lugano,8778,6,10,7,15,31,47,-16,37
Grasshoppers,8778,7,10,6,16,42,49,-7,36
FC Thun,8778,8,8,7,17,39,59,-20,31
FC Sion,8778,9,7,8,17,41,55,-14,29
Young Boys,8779,1,20,8,4,69,35,34,68
FC Basel,8779,2,16,8,8,53,32,21,56
FC Zürich,8779,3,13,9,10,47,35,12,48
St Gallen,8779,4,15,2,15,45,55,-10,47
Lucerne,8779,5,12,9,11,39,42,-3,45
Grasshoppers,8779,6,10,8,14,41,45,-4,38
FC Thun,8779,7,10,6,16,41,56,-15,36
FC Lugano,8779,8,9,7,16,28,46,-18,34
FC Sion,8779,9,7,7,18,40,57,-17,28
Young Boys,8780,1,20,6,6,70,42,28,66
FC Basel,8780,2,17,9,6,52,25,27,60
St Gallen,8780,3,15,3,14,43,53,-10,48
Lucerne,8780,4,12,8,12,41,44,-3,44
FC Zürich,8780,5,10,9,13,41,39,2,39
FC Thun,8780,6,11,6,15,47,58,-11,39
Grasshoppers,8780,7,10,7,15,47,51,-4,37
FC Lugano,8780,8,10,6,16,33,50,-17,36
FC Sion,8780,9,8,8,16,42,54,-12,32
Young Boys,8781,1,19,6,7,64,36,28,63
FC Basel,8781,2,18,8,6,54,25,29,62
St Gallen,8781,3,15,3,14,42,54,-12,48
FC Zürich,8781,4,12,10,10,41,33,8,46
Lucerne,8781,5,13,7,12,41,46,-5,46
FC Lugano,8781,6,12,6,14,35,43,-8,42
Grasshoppers,8781,7,10,7,15,43,49,-6,37
FC Thun,8781,8,9,6,17,44,60,-16,33
FC Sion,8781,9,6,7,19,39,57,-18,25
Young Boys,8782,1,20,8,4,72,37,35,68
FC Basel,8782,2,18,9,5,56,26,30,63
Lucerne,8782,3,15,7,10,44,42,2,52
St Gallen,8782,4,13,4,15,39,54,-15,43
FC Zürich,8782,5,10,10,12,39,36,3,40
FC Thun,8782,6,10,5,17,45,59,-14,35
FC Lugano,8782,7,9,7,16,28,47,-19,34
Grasshoppers,8782,8,9,6,17,42,54,-12,33
FC Sion,8782,9,8,8,16,44,54,-10,32
Young Boys,8783,1,21,8,3,74,37,37,71
FC Basel,8783,2,17,8,7,53,29,24,59
St Gallen,8783,3,14,5,13,44,54,-10,47
FC Zürich,8783,4,12,10,10,46,37,9,46
Lucerne,8783,5,11,11,10,41,43,-2,44
Grasshoppers,8783,6,10,7,15,45,52,-7,37
FC Lugano,8783,7,9,7,16,30,50,-20,34
FC Thun,8783,8,9,5,18,42,60,-18,32
FC Sion,8783,9,6,9,17,43,56,-13,27
Young Boys,8784,1,21,7,4,75,36,39,70
FC Basel,8784,2,19,8,5,57,24,33,65
Lucerne,8784,3,13,7,12,41,41,0,46
St Gallen,8784,4,14,3,15,41,55,-14,45
Grasshoppers,8784,5,12,6,14,45,47,-2,42
FC Zürich,8784,6,10,9,13,39,40,-1,39
FC Lugano,8784,7,11,5,16,33,52,-19,38
FC Thun,8784,8,9,5,18,40,60,-20,32
FC Sion,8784,9,6,8,18,37,53,-16,26
Young Boys,8785,1,21,7,4,73,36,37,70
FC Basel,8785,2,16,9,7,54,33,21,57
Lucerne,8785,3,13,10,9,43,41,2,49
St Gallen,8785,4,14,4,14,42,55,-13,46
FC Zürich,8785,5,10,9,13,43,40,3,39
FC Lugano,8785,6,10,7,15,34,49,-15,37
Grasshoppers,8785,7,10,6,16,41,50,-9,36
FC Thun,8785,8,9,6,17,43,59,-16,33
FC Sion,8785,9,8,8,16,45,55,-10,32
Young Boys,8786,1,21,7,4,77,38,39,70
FC Basel,8786,2,16,11,5,54,28,26,59
St Gallen,8786,3,15,3,14,44,56,-12,48
Lucerne,8786,4,13,8,11,45,45,0,47
FC Zürich,8786,5,10,11,11,40,36,4,41
FC Lugano,8786,6,12,5,15,34,46,-12,41
Grasshoppers,8786,7,10,6,16,42,54,-12,36
FC Thun,8786,8,8,7,17,43,60,-17,31
FC Sion,8786,9,6,8,18,40,56,-16,26
Young Boys,8787,1,22,6,4,69,35,34,72
FC Basel,8787,2,18,9,5,59,28,31,63
Lucerne,8787,3,12,9,11,41,43,-2,45
St Gallen,8787,4,14,3,15,44,55,-11,45
FC Zürich,8787,5,11,9,12,45,40,5,42
Grasshoppers,8787,6,10,6,16,41,48,-7,36
FC Lugano,8787,7,10,6,16,31,50,-19,36
FC Thun,8787,8,9,6,17,48,64,-16,33
FC Sion,8787,9,7,8,17,42,57,-15,29
Young Boys,8788,1,20,8,4,69,36,33,68
FC Basel,8788,2,19,8,5,54,22,32,65
Lucerne,8788,3,14,7,11,44,47,-3,49
St Gallen,8788,4,15,3,14,47,55,-8,48
FC Zürich,8788,5,9,11,12,38,37,1,38
Grasshoppers,8788,6,10,7,15,41,49,-8,37
FC Thun,8788,7,10,6,16,45,56,-11,36
FC Lugano,8788,8,9,7,16,32,50,-18,34
FC Sion,8788,9,5,9,18,39,57,-18,24
Young Boys,8789,1,22,7,3,72,37,35,73
FC Basel,8789,2,17,8,7,59,32,27,59
St Gallen,8789,3,16,3,13,47,51,-4,51
Lucerne,8789,4,12,8,12,42,46,-4,44
FC Zürich,8789,5,11,9,12,44,37,7,42
FC Thun,8789,6,11,5,16,47,58,-11,38
FC Lugano,8789,7,10,6,16,31,50,-19,36
Grasshoppers,8789,8,9,6,17,38,52,-14,33
FC Sion,8789,9,6,8,18,41,58,-17,26
Young Boys,8790,1,21,8,3,73,34,39,71
FC Basel,8790,2,18,9,5,60,25,35,63
St Gallen,8790,3,15,2,15,43,58,-15,47
Lucerne,8790,4,13,7,12,41,49,-8,46
FC Zürich,8790,5,9,11,12,40,40,0,38
Grasshoppers,8790,6,10,6,16,44,49,-5,36
FC Lugano,8790,7,10,6,16,31,48,-17,36
FC Sion,8790,8,8,8,16,43,54,-11,32
FC Thun,8790,9,9,5,18,42,60,-18,32
Young Boys,8791,1,21,8,3,74,37,37,71
FC Basel,8791,2,17,8,7,54,27,27,59
Lucerne,8791,3,14,8,10,46,46,0,50
FC Zürich,8791,4,11,10,11,43,36,7,43
St Gallen,8791,5,13,3,16,40,59,-19,42
FC Lugano,8791,6,11,6,15,32,45,-13,39
FC Thun,8791,7,9,7,16,46,61,-15,34
Grasshoppers,8791,8,9,6,17,41,53,-12,33
FC Sion,8791,9,7,8,17,43,55,-12,29
Young Boys,8792,1,21,7,4,69,32,37,70
FC Basel,8792,2,18,8,6,54,28,26,62
Lucerne,8792,3,13,9,10,46,44,2,48
FC Zürich,8792,4,12,10,10,42,35,7,46
St Gallen,8792,5,14,4,14,44,54,-10,46
Grasshoppers,8792,6,9,7,16,40,52,-12,34
FC Lugano,8792,7,9,7,16,32,51,-19,34
FC Thun,8792,8,9,6,17,44,57,-13,33
FC Sion,8792,9,6,8,18,37,55,-18,26
Young Boys,8793,1,21,7,4,69,39,30,70
FC Basel,8793,2,17,8,7,53,26,27,59
St Gallen,8793,3,15,3,14,42,54,-12,48
FC Zürich,8793,4,11,10,11,38,33,5,43
Lucerne,8793,5,11,9,12,36,42,-6,42
FC Lugano,8793,6,11,5,16,30,46,-16,38
Grasshoppers,8793,7,9,9,14,40,46,-6,36
FC Sion,8793,8,7,10,15,45,50,-5,31
FC Thun,8793,9,8,7,17,42,59,-17,31
Young Boys,8794,1,22,6,4,72,37,35,72
FC Basel,8794,2,18,8,6,53,26,27,62
FC Zürich,8794,3,12,10,10,45,37,8,46
St Gallen,8794,4,14,3,15,44,54,-10,45
Lucerne,8794,5,12,8,12,40,43,-3,44
FC Lugano,8794,6,11,6,15,31,45,-14,39
Grasshoppers,8794,7,10,6,16,43,52,-9,36
FC Thun,8794,8,9,6,17,45,58,-13,33
FC Sion,8794,9,6,7,19,39,60,-21,25
Young Boys,8795,1,22,7,3,74,36,38,73
FC Basel,8795,2,18,7,7,53,27,26,61
St Gallen,8795,3,15,3,14,47,54,-7,48
Lucerne,8795,4,13,7,12,45,46,-1,46
FC Zürich,8795,5,12,9,11,42,34,8,45
FC Thun,8795,6,11,5,16,44,55,-11,38
FC Lugano,8795,7,9,7,16,30,50,-20,34
Grasshoppers,8795,8,9,6,17,40,55,-15,33
FC Sion,8795,9,6,7,19,38,56,-18,25
Young Boys,8796,1,23,6,3,78,34,44,75
FC Basel,8796,2,18,8,6,58,29,29,62
St Gallen,8796,3,14,2,16,43,55,-12,44
FC Zürich,8796,4,11,10,11,40,36,4,43
Lucerne,8796,5,12,7,13,43,53,-10,43
Grasshoppers,8796,6,12,6,14,49,49,0,42
FC Thun,8796,7,10,5,17,43,59,-16,35
FC Lugano,8796,8,10,5,17,32,53,-21,35
FC Sion,8796,9,6,7,19,37,55,-18,25
Young Boys,8797,1,22,6,4,68,35,33,72
FC Basel,8797,2,19,7,6,56,27,29,64
St Gallen,8797,3,15,2,15,45,58,-13,47
Lucerne,8797,4,12,7,13,43,48,-5,43
FC Zürich,8797,5,10,11,11,44,39,5,41
Grasshoppers,8797,6,10,7,15,43,48,-5,37
FC Lugano,8797,7,10,5,17,32,51,-19,35
FC Sion,8797,8,8,8,16,45,51,-6,32
FC Thun,8797,9,8,7,17,41,60,-19,31
Young Boys,8798,1,21,7,4,69,34,35,70
FC Basel,8798,2,20,7,5,56,24,32,67
Lucerne,8798,3,12,9,11,38,42,-4,45
St Gallen,8798,4,14,2,16,43,56,-13,44
FC Zürich,8798,5,9,11,12,37,38,-1,38
FC Thun,8798,6,11,5,16,47,58,-11,38
Grasshoppers,8798,7,10,7,15,39,46,-7,37
FC Lugano,8798,8,9,7,16,33,50,-17,34
FC Sion,8798,9,6,9,17,39,53,-14,27
Young Boys,8799,1,19,9,4,67,35,32,66
FC Basel,8799,2,17,10,5,53,24,29,61
Lucerne,8799,3,13,10,9,44,40,4,49
St Gallen,8799,4,15,3,14,43,54,-11,48
FC Zürich,8799,5,10,11,11,41,37,4,41
Grasshoppers,8799,6,10,7,15,41,46,-5,37
FC Thun,8799,7,10,5,17,43,58,-15,35
FC Lugano,8799,8,10,5,17,31,52,-21,35
FC Sion,8799,9,6,8,18,39,56,-17,26
Young Boys,8800,1,22,7,3,72,34,38,73
FC Basel,8800,2,17,7,8,56,27,29,58
FC Zürich,8800,3,12,9,11,42,36,6,45
Lucerne,8800,4,12,9,11,41,44,-3,45
St Gallen,8800,5,14,3,15,42,54,-12,45
Grasshoppers,8800,6,10,8,14,41,45,-4,38
FC Lugano,8800,7,10,5,17,29,50,-21,35
FC Thun,8800,8,9,6,17,44,61,-17,33
FC Sion,8800,9,7,8,17,42,58,-16,29
Young Boys,8801,1,21,8,3,67,31,36,71
FC Basel,8801,2,17,9,6,52,23,29,60
Lucerne,8801,3,12,9,11,40,46,-6,45
St Gallen,8801,4,14,3,15,41,54,-13,45
FC Thun,8801,5,12,5,15,48,57,-9,41
FC Zürich,8801,6,10,10,12,40,38,2,40
FC Lugano,8801,7,11,6,15,34,46,-12,39
Grasshoppers,8801,8,10,6,16,43,49,-6,36
FC Sion,8801,9,5,8,19,36,57,-21,23
Young Boys,8802,1,21,8,3,69,35,34,71
FC Basel,8802,2,18,9,5,57,24,33,63
Lucerne,8802,3,13,9,10,44,42,2,48
St Gallen,8802,4,13,3,16,41,57,-16,42
FC Zürich,8802,5,9,12,11,41,38,3,39
FC Lugano,8802,6,11,5,16,33,49,-16,38
FC Thun,8802,7,10,6,16,46,61,-15,36
Grasshoppers,8802,8,9,7,16,40,50,-10,34
FC Sion,8802,9,6,9,17,41,56,-15,27
Young Boys,8803,1,21,8,3,74,36,38,71
FC Basel,8803,2,16,9,7,50,29,21,57
Lucerne,8803,3,15,8,9,46,38,8,53
St Gallen,8803,4,15,2,15,42,54,-12,47
FC Zürich,8803,5,10,11,11,41,38,3,41
Grasshoppers,8803,6,10,7,15,41,48,-7,37
FC Thun,8803,7,10,6,16,46,58,-12,36
FC Lugano,8803,8,10,5,17,31,51,-20,35
FC Sion,8803,9,5,8,19,40,59,-19,23
Young Boys,8804,1,21,6,5,70,39,31,69
FC Basel,8804,2,19,7,6,59,24,35,64
St Gallen,8804,3,15,3,14,47,54,-7,48
FC Zürich,8804,4,12,10,10,44,34,10,46
Lucerne,8804,5,13,7,12,42,43,-1,46
FC Lugano,8804,6,10,7,15,31,47,-16,37
Grasshoppers,8804,7,9,6,17,42,52,-10,33
FC Thun,8804,8,9,5,18,42,67,-25,32
FC Sion,8804,9,7,7,18,43,60,-17,28
Young Boys,8805,1,23,7,2,79,33,46,76
FC Basel,8805,2,18,7,7,54,28,26,61
Lucerne,8805,3,13,8,11,43,43,0,47
St Gallen,8805,4,13,3,16,44,60,-16,42
Grasshoppers,8805,5,11,7,14,44,48,-4,40
FC Lugano,8805,6,11,6,15,31,44,-13,39
FC Zürich,8805,7,9,9,14,37,39,-2,36
FC Thun,8805,8,9,5,18,43,61,-18,32
FC Sion,8805,9,7,8,17,44,63,-19,29
Young Boys,8806,1,22,7,3,73,32,41,73
FC Basel,8806,2,18,7,7,54,25,29,61
Lucerne,8806,3,12,8,12,39,45,-6,44
St Gallen,8806,4,14,2,16,42,55,-13,44
FC Zürich,8806,5,11,10,11,38,33,5,43
Grasshoppers,8806,6,12,6,14,44,48,-4,42
FC Lugano,8806,7,10,6,16,29,50,-21,36
FC Thun,8806,8,8,7,17,41,58,-17,31
FC Sion,8806,9,6,9,17,41,55,-14,27
Young Boys,8807,1,24,6,2,77,32,45,78
FC Basel,8807,2,17,9,6,57,29,28,60
Lucerne,8807,3,13,9,10,43,45,-2,48
FC Zürich,8807,4,11,11,10,44,34,10,44
St Gallen,8807,5,14,2,16,43,58,-15,44
FC Lugano,8807,6,10,6,16,32,51,-19,36
FC Thun,8807,7,10,5,17,44,62,-18,35
Grasshoppers,8807,8,9,7,16,40,50,-10,34
FC Sion,8807,9,5,7,20,36,55,-19,22
Young Boys,8808,1,23,7,2,74,31,43,76
FC Basel,8808,2,18,8,6,52,25,27,62
St Gallen,8808,3,16,2,14,44,53,-9,50
Lucerne,8808,4,13,7,12,44,46,-2,46
FC Zürich,8808,5,10,10,12,41,37,4,40
FC Thun,8808,6,11,5,16,47,56,-9,38
FC Lugano,8808,7,10,5,17,33,53,-20,35
Grasshoppers,8808,8,8,6,18,37,51,-14,30
FC Sion,8808,9,6,8,18,36,56,-20,26
Young Boys,8809,1,20,8,4,68,34,34,68
FC Basel,8809,2,18,8,6,53,25,28,62
Lucerne,8809,3,13,10,9,45,41,4,49
St Gallen,8809,4,15,2,15,43,53,-10,47
FC Zürich,8809,5,12,9,11,40,34,6,45
Grasshoppers,8809,6,11,7,14,46,48,-2,40
FC Lugano,8809,7,9,6,17,27,49,-22,33
FC Thun,8809,8,8,6,18,41,60,-19,30
FC Sion,8809,9,6,8,18,39,58,-19,26
Young Boys,8810,1,23,6,3,75,32,43,75
FC Basel,8810,2,19,7,6,56,27,29,64
Lucerne,8810,3,13,7,12,43,45,-2,46
St Gallen,8810,4,13,2,17,39,62,-23,41
FC Zürich,8810,5,10,9,13,39,36,3,39
FC Lugano,8810,6,11,5,16,32,48,-16,38
FC Thun,8810,7,10,6,16,44,57,-13,36
Grasshoppers,8810,8,9,7,16,42,52,-10,34
FC Sion,8810,9,8,7,17,41,52,-11,31
Young Boys,8811,1,22,7,3,71,32,39,73
FC Basel,8811,2,16,9,7,50,28,22,57
Lucerne,8811,3,15,7,10,47,41,6,52
St Gallen,8811,4,15,2,15,45,56,-11,47
FC Thun,8811,5,11,6,15,46,57,-11,39
FC Zürich,8811,6,9,11,12,41,39,2,38
FC Lugano,8811,7,11,5,16,34,52,-18,38
Grasshoppers,8811,8,8,6,18,41,55,-14,30
FC Sion,8811,9,6,9,17,42,57,-15,27
Young Boys,8812,1,20,9,3,69,36,33,69
FC Basel,8812,2,17,9,6,51,25,26,60
Lucerne,8812,3,14,8,10,43,40,3,50
St Gallen,8812,4,13,3,16,39,57,-18,42
FC Zürich,8812,5,10,11,11,39,35,4,41
FC Lugano,8812,6,11,6,15,34,46,-12,39
Grasshoppers,8812,7,10,6,16,43,49,-6,36
FC Thun,8812,8,9,6,17,41,59,-18,33
FC Sion,8812,9,7,8,17,43,55,-12,29
Young Boys,8813,1,21,8,3,69,34,35,71
FC Basel,8813,2,17,8,7,57,30,27,59
St Gallen,8813,3,15,2,15,43,55,-12,47
Lucerne,8813,4,12,9,11,38,42,-4,45
FC Zürich,8813,5,11,10,11,42,38,4,43
Grasshoppers,8813,6,10,7,15,41,47,-6,37
FC Lugano,8813,7,9,8,15,28,44,-16,35
FC Thun,8813,8,9,5,18,45,63,-18,32
FC Sion,8813,9,8,7,17,45,55,-10,31
Young Boys,8814,1,21,8,3,73,37,36,71
FC Basel,8814,2,18,9,5,55,23,32,63
Lucerne,8814,3,13,8,11,43,44,-1,47
FC Zürich,8814,4,11,10,11,43,37,6,43
St Gallen,8814,5,13,2,17,39,60,-21,41
Grasshoppers,8814,6,10,8,14,45,49,-4,38
FC Lugano,8814,7,11,5,16,32,49,-17,38
FC Thun,8814,8,8,6,18,44,66,-22,30
FC Sion,8814,9,7,8,17,45,54,-9,29
Young Boys,8815,1,21,7,4,72,35,37,70
FC Basel,8815,2,17,10,5,54,26,28,61
St Gallen,8815,3,14,3,15,45,57,-12,45
Lucerne,8815,4,12,8,12,41,45,-4,44
FC Zürich,8815,5,10,10,12,43,38,5,40
FC Lugano,8815,6,11,6,15,32,49,-17,39
Grasshoppers,8815,7,10,6,16,40,48,-8,36
FC Thun,8815,8,10,6,16,44,58,-14,36
FC Sion,8815,9,7,8,17,40,55,-15,29
Young Boys,8816,1,22,7,3,69,35,34,73
FC Basel,8816,2,18,8,6,54,25,29,62
Lucerne,8816,3,13,8,11,44,44,0,47
St Gallen,8816,4,14,4,14,45,54,-9,46
FC Zürich,8816,5,11,10,11,47,37,10,43
FC Thun,8816,6,11,5,16,46,58,-12,38
FC Lugano,8816,7,10,6,16,31,45,-14,36
Grasshoppers,8816,8,8,7,17,36,51,-15,31
FC Sion,8816,9,5,9,18,38,61,-23,24
Young Boys,8817,1,22,6,4,69,34,35,72
FC Basel,8817,2,18,7,7,55,27,28,61
Lucerne,8817,3,14,8,10,45,42,3,50
St Gallen,8817,4,15,2,15,46,58,-12,47
FC Zürich,8817,5,11,10,11,41,37,4,43
FC Lugano,8817,6,10,6,16,35,51,-16,36
FC Thun,8817,7,10,5,17,46,60,-14,35
Grasshoppers,8817,8,8,6,18,40,54,-14,30
FC Sion,8817,9,7,8,17,38,52,-14,29
Young Boys,8818,1,21,6,5,73,38,35,69
FC Basel,8818,2,16,10,6,59,30,29,58
Lucerne,8818,3,12,10,10,42,44,-2,46
FC Zürich,8818,4,11,11,10,39,33,6,44
St Gallen,8818,5,13,5,14,44,56,-12,44
Grasshoppers,8818,6,11,6,15,43,46,-3,39
FC Lugano,8818,7,10,7,15,32,47,-15,37
FC Thun,8818,8,9,5,18,45,67,-22,32
FC Sion,8818,9,7,8,17,38,54,-16,29
Young Boys,8819,1,21,7,4,74,39,35,70
FC Basel,8819,2,18,8,6,56,27,29,62
Lucerne,8819,3,13,9,10,41,41,0,48
St Gallen,8819,4,14,3,15,41,54,-13,45
FC Zürich,8819,5,11,10,11,44,36,8,43
Grasshoppers,8819,6,11,6,15,42,48,-6,39
FC Lugano,8819,7,10,7,15,31,46,-15,37
FC Thun,8819,8,8,5,19,40,66,-26,29
FC Sion,8819,9,7,7,18,42,54,-12,28
Young Boys,8820,1,21,7,4,66,35,31,70
FC Basel,8820,2,20,7,5,60,22,38,67
Lucerne,8820,3,12,8,12,41,47,-6,44
FC Zürich,8820,4,11,9,12,41,39,2,42
St Gallen,8820,5,13,3,16,41,55,-14,42
Grasshoppers,8820,6,11,7,14,47,49,-2,40
FC Lugano,8820,7,10,6,16,29,47,-18,36
FC Thun,8820,8,10,5,17,42,58,-16,35
FC Sion,8820,9,6,8,18,42,57,-15,26
Young Boys,8821,1,21,7,4,70,35,35,70
FC Basel,8821,2,20,7,5,57,22,35,67
St Gallen,8821,3,14,3,15,43,58,-15,45
FC Lugano,8821,4,13,5,14,36,47,-11,44
Lucerne,8821,5,11,8,13,41,47,-6,41
FC Zürich,8821,6,9,9,14,37,46,-9,36
FC Thun,8821,7,10,5,17,46,55,-9,35
Grasshoppers,8821,8,9,7,16,40,50,-10,34
FC Sion,8821,9,7,9,16,40,50,-10,30
Young Boys,8822,1,20,6,6,74,45,29,66
FC Basel,8822,2,17,9,6,55,30,25,60
Lucerne,8822,3,13,8,11,45,43,2,47
St Gallen,8822,4,14,5,13,43,53,-10,47
FC Zürich,8822,5,12,10,10,46,34,12,46
Grasshoppers,8822,6,10,6,16,41,48,-7,36
FC Thun,8822,7,10,6,16,45,61,-16,36
FC Lugano,8822,8,9,6,17,32,53,-21,33
FC Sion,8822,9,7,8,17,43,57,-14,29
Young Boys,8823,1,21,7,4,71,39,32,70
FC Basel,8823,2,17,9,6,54,25,29,60
St Gallen,8823,3,15,3,14,44,53,-9,48
FC Zürich,8823,4,11,10,11,41,35,6,43
Lucerne,8823,5,11,8,13,38,48,-10,41
Grasshoppers,8823,6,11,6,15,42,46,-4,39
FC Lugano,8823,7,11,5,16,33,46,-13,38
FC Thun,8823,8,11,5,16,42,56,-14,38
FC Sion,8823,9,5,9,18,39,56,-17,24
Young Boys,8824,1,20,7,5,69,38,31,67
FC Basel,8824,2,18,8,6,53,24,29,62
Lucerne,8824,3,13,8,11,44,45,-1,47
St Gallen,8824,4,15,2,15,45,55,-10,47
FC Zürich,8824,5,11,9,12,41,37,4,42
FC Lugano,8824,6,12,5,15,32,45,-13,41
FC Thun,8824,7,10,6,16,43,58,-15,36
Grasshoppers,8824,8,9,7,16,42,49,-7,34
FC Sion,8824,9,6,8,18,39,57,-18,26
Young Boys,8825,1,21,7,4,71,38,33,70
FC Basel,8825,2,18,8,6,56,28,28,62
Lucerne,8825,3,13,9,10,44,41,3,48
St Gallen,8825,4,15,2,15,45,60,-15,47
FC Zürich,8825,5,11,11,10,45,35,10,44
Grasshoppers,8825,6,10,7,15,43,48,-5,37
FC Lugano,8825,7,9,8,15,32,48,-16,35
FC Thun,8825,8,8,7,17,39,60,-21,31
FC Sion,8825,9,6,7,19,41,58,-17,25
Young Boys,8826,1,23,7,2,76,34,42,76
FC Basel,8826,2,18,8,6,59,27,32,62
Lucerne,8826,3,13,8,11,43,46,-3,47
St Gallen,8826,4,13,3,16,41,58,-17,42
FC Zürich,8826,5,10,11,11,43,39,4,41
FC Lugano,8826,6,11,6,15,32,45,-13,39
FC Thun,8826,7,10,6,16,45,61,-16,36
Grasshoppers,8826,8,8,6,18,37,51,-14,30
FC Sion,8826,9,7,7,18,41,56,-15,28
Young Boys,8827,1,20,6,6,70,39,31,66
FC Basel,8827,2,18,9,5,54,24,30,63
Lucerne,8827,3,14,7,11,44,42,2,49
St Gallen,8827,4,15,3,14,46,55,-9,48
FC Zürich,8827,5,10,12,10,38,33,5,42
FC Lugano,8827,6,11,6,15,35,50,-15,39
Grasshoppers,8827,7,10,6,16,44,50,-6,36
FC Thun,8827,8,9,7,16,43,59,-16,34
FC Sion,8827,9,5,8,19,36,58,-22,23
Young Boys,8828,1,22,7,3,74,36,38,73
FC Basel,8828,2,17,8,7,53,26,27,59
Lucerne,8828,3,13,8,11,41,44,-3,47
St Gallen,8828,4,14,4,14,42,53,-11,46
FC Lugano,8828,5,11,6,15,35,48,-13,39
FC Zürich,8828,6,9,10,13,40,42,-2,37
Grasshoppers,8828,7,10,7,15,41,47,-6,37
FC Thun,8828,8,10,6,16,44,57,-13,36
FC Sion,8828,9,6,8,18,39,56,-17,26
Young Boys,8829,1,22,6,4,73,36,37,72
FC Basel,8829,2,19,7,6,54,23,31,64
St Gallen,8829,3,14,3,15,43,59,-16,45
Lucerne,8829,4,12,8,12,41,46,-5,44
FC Zürich,8829,5,11,10,11,40,35,5,43
FC Lugano,8829,6,10,6,16,33,49,-16,36
FC Sion,8829,7,9,7,16,47,51,-4,34
FC Thun,8829,8,9,6,17,39,57,-18,33
Grasshoppers,8829,9,8,7,17,36,50,-14,31
Young Boys,8830,1,22,8,2,74,33,41,74
FC Basel,8830,2,16,7,9,54,30,24,55
St Gallen,8830,3,16,2,14,44,53,-9,50
FC Zürich,8830,4,11,11,10,42,33,9,44
Lucerne,8830,5,12,8,12,43,45,-2,44
FC Thun,8830,6,10,6,16,47,58,-11,36
FC Lugano,8830,7,9,8,15,29,45,-16,35
Grasshoppers,8830,8,9,6,17,40,57,-17,33
FC Sion,8830,9,7,8,17,39,58,-19,29
Young Boys,8831,1,22,6,4,72,39,33,72
FC Basel,8831,2,19,7,6,57,25,32,64
Lucerne,8831,3,13,8,11,42,42,0,47
St Gallen,8831,4,15,2,15,44,55,-11,47
FC Zürich,8831,5,11,10,11,41,35,6,43
Grasshoppers,8831,6,10,7,15,44,46,-2,37
FC Lugano,8831,7,10,7,15,31,47,-16,37
FC Thun,8831,8,9,5,18,42,64,-22,32
FC Sion,8831,9,5,8,19,38,58,-20,23
Young Boys,8832,1,21,7,4,71,38,33,70
FC Basel,8832,2,18,8,6,58,26,32,62
Lucerne,8832,3,14,7,11,44,44,0,49
St Gallen,8832,4,14,3,15,43,57,-14,45
FC Zürich,8832,5,11,10,11,43,34,9,43
FC Thun,8832,6,10,6,16,43,60,-17,36
Grasshoppers,8832,7,9,6,17,40,53,-13,33
FC Lugano,8832,8,9,6,17,30,50,-20,33
FC Sion,8832,9,7,9,16,43,53,-10,30
Young Boys,8833,1,22,8,2,72,30,42,74
FC Basel,8833,2,19,7,6,52,22,30,64
Lucerne,8833,3,12,10,10,41,43,-2,46
St Gallen,8833,4,13,4,15,42,55,-13,43
FC Zürich,8833,5,9,11,12,39,38,1,38
FC Thun,8833,6,10,5,17,45,57,-12,35
FC Lugano,8833,7,9,8,15,31,47,-16,35
Grasshoppers,8833,8,9,7,16,40,53,-13,34
FC Sion,8833,9,7,8,17,39,56,-17,29
Young Boys,8834,1,22,7,3,71,32,39,73
FC Basel,8834,2,19,8,5,58,25,33,65
Lucerne,8834,3,12,8,12,41,46,-5,44
FC Zürich,8834,4,11,10,11,43,37,6,43
St Gallen,8834,5,13,2,17,41,60,-19,41
FC Lugano,8834,6,11,6,15,36,48,-12,39
Grasshoppers,8834,7,9,7,16,42,52,-10,34
FC Thun,8834,8,9,5,18,43,64,-21,32
FC Sion,8834,9,8,7,17,39,50,-11,31
Young Boys,8835,1,22,8,2,70,32,38,74
FC Basel,8835,2,16,9,7,51,28,23,57
St Gallen,8835,3,15,2,15,45,55,-10,47
Lucerne,8835,4,12,7,13,43,50,-7,43
FC Zürich,8835,5,9,11,12,38,37,1,38
FC Lugano,8835,6,11,5,16,32,48,-16,38
Grasshoppers,8835,7,10,7,15,44,50,-6,37
FC Sion,8835,8,8,9,15,43,49,-6,33
FC Thun,8835,9,9,6,17,41,58,-17,33
FC Basel,8836,1,20,7,5,64,25,39,67
Young Boys,8836,2,19,9,4,67,36,31,66
Lucerne,8836,3,12,8,12,42,48,-6,44
FC Zürich,8836,4,11,10,11,46,38,8,43
FC Lugano,8836,5,12,6,14,36,45,-9,42
St Gallen,8836,6,13,2,17,39,58,-19,41
Grasshoppers,8836,7,10,8,14,39,45,-6,38
FC Thun,8836,8,8,6,18,42,66,-24,30
FC Sion,8836,9,6,10,16,39,53,-14,28
Young Boys,8837,1,21,7,4,73,41,32,70
FC Basel,8837,2,17,9,6,54,28,26,60
Lucerne,8837,3,14,8,10,50,44,6,50
St Gallen,8837,4,14,3,15,42,54,-12,45
FC Zürich,8837,5,10,10,12,44,40,4,40
Grasshoppers,8837,6,10,6,16,43,51,-8,36
FC Lugano,8837,7,10,6,16,30,48,-18,36
FC Thun,8837,8,9,6,17,43,61,-18,33
FC Sion,8837,9,8,7,17,43,55,-12,31
Young Boys,8838,1,22,7,3,74,34,40,73
FC Basel,8838,2,18,9,5,56,27,29,63
Lucerne,8838,3,14,7,11,42,43,-1,49
St Gallen,8838,4,14,4,14,46,56,-10,46
FC Zürich,8838,5,11,10,11,42,37,5,43
FC Thun,8838,6,9,7,16,39,54,-15,34
FC Lugano,8838,7,9,7,16,30,52,-22,34
Grasshoppers,8838,8,8,6,18,37,50,-13,30
FC Sion,8838,9,6,9,17,40,53,-13,27
Young Boys,8839,1,21,6,5,67,35,32,69
FC Basel,8839,2,18,8,6,53,23,30,62
Lucerne,8839,3,14,8,10,46,42,4,50
FC Zürich,8839,4,12,9,11,46,36,10,45
St Gallen,8839,5,14,3,15,44,56,-12,45
FC Lugano,8839,6,10,6,16,32,51,-19,36
Grasshoppers,8839,7,9,7,16,41,52,-11,34
FC Thun,8839,8,9,6,17,41,61,-20,33
FC Sion,8839,9,7,7,18,41,55,-14,28
Young Boys,8840,1,23,7,2,74,30,44,76
FC Basel,8840,2,18,9,5,55,26,29,63
St Gallen,8840,3,15,3,14,46,56,-10,48
Lucerne,8840,4,12,8,12,43,45,-2,44
FC Zürich,8840,5,10,9,13,40,41,-1,39
FC Thun,8840,6,10,6,16,46,58,-12,36
FC Lugano,8840,7,10,6,16,33,52,-19,36
Grasshoppers,8840,8,9,8,15,39,49,-10,35
FC Sion,8840,9,5,8,19,37,56,-19,23
Young Boys,8841,1,21,8,3,67,34,33,71
FC Basel,8841,2,20,7,5,59,22,37,67
St Gallen,8841,3,14,3,15,42,54,-12,45
Lucerne,8841,4,12,8,12,41,45,-4,44
FC Zürich,8841,5,11,9,12,40,38,2,42
FC Lugano,8841,6,11,6,15,34,46,-12,39
Grasshoppers,8841,7,9,7,16,39,51,-12,34
FC Thun,8841,8,9,5,18,41,57,-16,32
FC Sion,8841,9,6,9,17,37,53,-16,27
Young Boys,8842,1,22,6,4,74,39,35,72
FC Basel,8842,2,17,8,7,53,27,26,59
Lucerne,8842,3,15,7,10,45,44,1,52
St Gallen,8842,4,15,2,15,43,54,-11,47
FC Zürich,8842,5,10,10,12,40,38,2,40
Grasshoppers,8842,6,10,7,15,44,49,-5,37
FC Lugano,8842,7,10,5,17,32,49,-17,35
FC Thun,8842,8,8,8,16,42,58,-16,32
FC Sion,8842,9,7,7,18,39,54,-15,28
Young Boys,8843,1,21,8,3,68,35,33,71
FC Basel,8843,2,16,9,7,48,25,23,57
FC Zürich,8843,3,12,10,10,47,36,11,46
Lucerne,8843,4,12,10,10,42,43,-1,46
St Gallen,8843,5,14,4,14,42,53,-11,46
Grasshoppers,8843,6,11,7,14,48,48,0,40
FC Lugano,8843,7,11,5,16,33,48,-15,38
FC Thun,8843,8,8,6,18,42,61,-19,30
FC Sion,8843,9,6,7,19,39,60,-21,25
Young Boys,8844,1,22,6,4,73,35,38,72
FC Basel,8844,2,17,10,5,51,24,27,61
St Gallen,8844,3,15,3,14,43,53,-10,48
Lucerne,8844,4,13,8,11,40,41,-1,47
FC Zürich,8844,5,10,11,11,39,35,4,41
Grasshoppers,8844,6,9,8,15,41,49,-8,35
FC Thun,8844,7,9,8,15,41,55,-14,35
FC Lugano,8844,8,9,7,16,29,47,-18,34
FC Sion,8844,9,5,9,18,40,58,-18,24
Young Boys,8845,1,23,7,2,75,30,45,76
FC Basel,8845,2,16,8,8,50,28,22,56
Lucerne,8845,3,13,9,10,43,42,1,48
St Gallen,8845,4,14,3,15,47,60,-13,45
FC Zürich,8845,5,10,10,12,39,38,1,40
FC Lugano,8845,6,11,5,16,32,49,-17,38
Grasshoppers,8845,7,10,7,15,40,48,-8,37
FC Thun,8845,8,10,6,16,48,56,-8,36
FC Sion,8845,9,6,7,19,39,62,-23,25
Young Boys,8846,1,23,7,2,74,32,42,76
FC Basel,8846,2,17,8,7,55,29,26,59
St Gallen,8846,3,15,4,13,45,53,-8,49
FC Zürich,8846,4,12,9,11,47,38,9,45
Lucerne,8846,5,12,8,12,41,46,-5,44
FC Lugano,8846,6,10,5,17,30,47,-17,35
Grasshoppers,8846,7,8,9,15,42,52,-10,33
FC Thun,8846,8,8,6,18,43,63,-20,30
FC Sion,8846,9,7,8,17,41,58,-17,29
Young Boys,8847,1,23,6,3,75,33,42,75
FC Basel,8847,2,19,7,6,62,27,35,64
St Gallen,8847,3,14,4,14,44,56,-12,46
FC Zürich,8847,4,11,10,11,40,34,6,43
Lucerne,8847,5,12,7,13,44,55,-11,43
FC Lugano,8847,6,11,6,15,30,46,-16,39
FC Thun,8847,7,10,5,17,44,58,-14,35
Grasshoppers,8847,8,9,6,17,40,53,-13,33
FC Sion,8847,9,5,9,18,36,53,-17,24
Young Boys,8848,1,21,8,3,68,33,35,71
FC Basel,8848,2,17,9,6,57,24,33,60
Lucerne,8848,3,13,8,11,40,43,-3,47
St Gallen,8848,4,14,5,13,41,51,-10,47
FC Zürich,8848,5,11,10,11,43,36,7,43
FC Lugano,8848,6,10,6,16,30,48,-18,36
Grasshoppers,8848,7,9,7,16,40,48,-8,34
FC Thun,8848,8,9,6,17,42,61,-19,33
FC Sion,8848,9,6,9,17,38,55,-17,27
Young Boys,8849,1,20,7,5,69,38,31,67
FC Basel,8849,2,18,8,6,54,27,27,62
Lucerne,8849,3,14,7,11,44,43,1,49
St Gallen,8849,4,15,2,15,41,57,-16,47
FC Zürich,8849,5,11,10,11,40,36,4,43
FC Sion,8849,6,10,7,15,50,50,0,37
FC Lugano,8849,7,10,6,16,31,47,-16,36
FC Thun,8849,8,9,5,18,43,61,-18,32
Grasshoppers,8849,9,8,6,18,39,52,-13,30
Young Boys,8850,1,20,9,3,67,33,34,69
FC Basel,8850,2,17,9,6,53,26,27,60
St Gallen,8850,3,15,3,14,43,54,-11,48
Lucerne,8850,4,13,8,11,42,42,0,47
FC Zürich,8850,5,12,10,10,46,34,12,46
Grasshoppers,8850,6,10,7,15,42,51,-9,37
FC Thun,8850,7,10,5,17,44,60,-16,35
FC Lugano,8850,8,9,5,18,29,48,-19,32
FC Sion,8850,9,5,10,17,37,55,-18,25
Young Boys,8851,1,22,7,3,75,38,37,73
FC Basel,8851,2,16,10,6,51,25,26,58
Lucerne,8851,3,14,8,10,46,44,2,50
St Gallen,8851,4,13,4,15,40,53,-13,43
FC Zürich,8851,5,10,10,12,38,40,-2,40
FC Thun,8851,6,11,6,15,46,55,-9,39
FC Lugano,8851,7,10,6,16,31,46,-15,36
Grasshoppers,8851,8,8,7,17,38,54,-16,31
FC Sion,8851,9,7,8,17,40,50,-10,29
Young Boys,8852,1,20,7,5,75,42,33,67
FC Basel,8852,2,19,7,6,58,24,34,64
St Gallen,8852,3,16,3,13,42,50,-8,51
Lucerne,8852,4,12,9,11,41,45,-4,45
FC Zürich,8852,5,11,10,11,40,36,4,43
Grasshoppers,8852,6,10,8,14,45,49,-4,38
FC Lugano,8852,7,10,5,17,33,50,-17,35
FC Sion,8852,8,7,8,17,39,52,-13,29
FC Thun,8852,9,8,5,19,39,64,-25,29
Young Boys,8853,1,21,9,2,71,33,38,72
FC Basel,8853,2,18,9,5,58,25,33,63
Lucerne,8853,3,13,9,10,40,42,-2,48
FC Zürich,8853,4,11,9,12,41,35,6,42
St Gallen,8853,5,13,3,16,39,53,-14,42
FC Lugano,8853,6,11,6,15,30,46,-16,39
Grasshoppers,8853,7,9,7,16,41,50,-9,34
FC Thun,8853,8,9,5,18,42,63,-21,32
FC Sion,8853,9,7,7,18,40,55,-15,28
Young Boys,8854,1,21,8,3,71,36,35,71
FC Basel,8854,2,17,9,6,54,27,27,60
Lucerne,8854,3,13,8,11,45,44,1,47
St Gallen,8854,4,13,5,14,42,54,-12,44
FC Zürich,8854,5,11,9,12,43,36,7,42
FC Lugano,8854,6,11,5,16,32,48,-16,38
Grasshoppers,8854,7,10,7,15,44,50,-6,37
FC Thun,8854,8,10,5,17,43,61,-18,35
FC Sion,8854,9,6,8,18,42,60,-18,26
Young Boys,8855,1,22,8,2,75,33,42,74
FC Basel,8855,2,17,8,7,51,28,23,59
St Gallen,8855,3,15,2,15,45,55,-10,47
FC Zürich,8855,4,11,9,12,42,38,4,42
Lucerne,8855,5,11,9,12,40,48,-8,42
FC Lugano,8855,6,11,7,14,33,45,-12,40
Grasshoppers,8855,7,10,8,14,46,47,-1,38
FC Thun,8855,8,10,5,17,43,61,-18,35
FC Sion,8855,9,5,8,19,36,56,-20,23
Young Boys,8856,1,21,7,4,69,35,34,70
FC Basel,8856,2,18,9,5,55,25,30,63
Lucerne,8856,3,12,8,12,43,47,-4,44
St Gallen,8856,4,13,5,14,44,56,-12,44
FC Zürich,8856,5,10,11,11,43,39,4,41
Grasshoppers,8856,6,11,6,15,45,49,-4,39
FC Thun,8856,7,9,8,15,45,59,-14,35
FC Lugano,8856,8,9,6,17,32,51,-19,33
FC Sion,8856,9,6,10,16,39,54,-15,28
Young Boys,8857,1,21,7,4,74,35,39,70
FC Basel,8857,2,19,7,6,54,24,30,64
St Gallen,8857,3,15,3,14,41,51,-10,48
FC Zürich,8857,4,11,9,12,43,37,6,42
Lucerne,8857,5,11,8,13,38,45,-7,41
Grasshoppers,8857,6,11,6,15,40,45,-5,39
FC Thun,8857,7,10,5,17,43,60,-17,35
FC Lugano,8857,8,9,7,16,29,50,-21,34
FC Sion,8857,9,7,8,17,42,57,-15,29
Young Boys,8858,1,22,7,3,75,34,41,73
FC Basel,8858,2,17,8,7,59,31,28,59
Lucerne,8858,3,13,9,10,46,46,0,48
St Gallen,8858,4,15,2,15,46,58,-12,47
FC Zürich,8858,5,11,10,11,46,38,8,43
Grasshoppers,8858,6,11,7,14,45,49,-4,40
FC Lugano,8858,7,9,6,17,30,51,-21,33
FC Thun,8858,8,8,6,18,41,61,-20,30
FC Sion,8858,9,7,7,18,39,59,-20,28
Young Boys,8859,1,21,6,5,71,38,33,69
FC Basel,8859,2,18,7,7,57,28,29,61
St Gallen,8859,3,16,3,13,45,52,-7,51
Lucerne,8859,4,12,7,13,41,45,-4,43
FC Zürich,8859,5,10,10,12,39,36,3,40
FC Lugano,8859,6,11,6,15,31,47,-16,39
Grasshoppers,8859,7,10,7,15,41,48,-7,37
FC Sion,8859,8,8,7,17,42,51,-9,31
FC Thun,8859,9,8,7,17,41,63,-22,31
Young Boys,8860,1,21,7,4,68,35,33,70
FC Basel,8860,2,18,8,6,55,24,31,62
Lucerne,8860,3,13,10,9,44,42,2,49
FC Zürich,8860,4,11,10,11,41,37,4,43
St Gallen,8860,5,13,4,15,41,59,-18,43
FC Lugano,8860,6,11,5,16,35,47,-12,38
FC Thun,8860,7,10,5,17,45,59,-14,35
Grasshoppers,8860,8,9,7,16,38,49,-11,34
FC Sion,8860,9,6,8,18,39,54,-15,26
Young Boys,8861,1,21,6,5,70,37,33,69
FC Basel,8861,2,19,7,6,57,25,32,64
St Gallen,8861,3,16,2,14,44,54,-10,50
FC Zürich,8861,4,12,9,11,41,35,6,45
Lucerne,8861,5,12,8,12,40,46,-6,44
Grasshoppers,8861,6,10,7,15,39,45,-6,37
FC Lugano,8861,7,9,6,17,30,48,-18,33
FC Sion,8861,8,8,8,16,41,50,-9,32
FC Thun,8861,9,8,5,19,38,60,-22,29
Young Boys,8862,1,20,7,5,67,36,31,67
FC Basel,8862,2,18,8,6,55,25,30,62
Lucerne,8862,3,16,7,9,49,41,8,55
St Gallen,8862,4,14,3,15,42,56,-14,45
FC Zürich,8862,5,9,11,12,38,36,2,38
FC Lugano,8862,6,10,7,15,30,45,-15,37
Grasshoppers,8862,7,9,7,16,38,49,-11,34
FC Thun,8862,8,9,7,16,41,58,-17,34
FC Sion,8862,9,6,9,17,39,53,-14,27
Young Boys,8863,1,20,8,4,68,35,33,68
FC Basel,8863,2,17,8,7,55,30,25,59
Lucerne,8863,3,15,8,9,46,40,6,53
St Gallen,8863,4,14,3,15,44,56,-12,45
FC Zürich,8863,5,11,11,10,43,37,6,44
Grasshoppers,8863,6,9,8,15,44,51,-7,35
FC Thun,8863,7,9,7,16,48,60,-12,34
FC Lugano,8863,8,9,6,17,32,51,-19,33
FC Sion,8863,9,7,7,18,40,60,-20,28
Young Boys,8864,1,21,7,4,71,35,36,70
FC Basel,8864,2,16,8,8,51,30,21,56
St Gallen,8864,3,16,3,13,46,51,-5,51
Lucerne,8864,4,14,8,10,43,42,1,50
FC Zürich,8864,5,12,10,10,44,36,8,46
FC Thun,8864,6,10,6,16,44,57,-13,36
Grasshoppers,8864,7,9,7,16,40,49,-9,34
FC Lugano,8864,8,9,6,17,30,50,-20,33
FC Sion,8864,9,6,7,19,39,58,-19,25
Young Boys,8865,1,22,7,3,73,33,40,73
FC Basel,8865,2,17,8,7,53,27,26,59
Lucerne,8865,3,13,9,10,42,42,0,48
St Gallen,8865,4,15,3,14,44,55,-11,48
FC Zürich,8865,5,10,11,11,38,35,3,41
FC Thun,8865,6,10,6,16,43,55,-12,36
FC Lugano,8865,7,9,8,15,28,46,-18,35
Grasshoppers,8865,8,9,7,16,38,47,-9,34
FC Sion,8865,9,6,7,19,38,57,-19,25
Young Boys,8866,1,23,6,3,73,33,40,75
FC Basel,8866,2,19,8,5,55,24,31,65
St Gallen,8866,3,14,3,15,40,52,-12,45
Lucerne,8866,4,12,8,12,40,47,-7,44
FC Zürich,8866,5,10,10,12,41,38,3,40
Grasshoppers,8866,6,11,6,15,41,45,-4,39
FC Thun,8866,7,10,5,17,45,59,-14,35
FC Lugano,8866,8,10,5,17,34,52,-18,35
FC Sion,8866,9,6,7,19,37,56,-19,25
Young Boys,8867,1,23,6,3,77,34,43,75
FC Basel,8867,2,18,7,7,56,26,30,61
Lucerne,8867,3,15,7,10,46,41,5,52
FC Zürich,8867,4,11,11,10,42,36,6,44
St Gallen,8867,5,14,2,16,42,57,-15,44
FC Lugano,8867,6,10,6,16,31,51,-20,36
Grasshoppers,8867,7,9,7,16,39,51,-12,34
FC Thun,8867,8,8,6,18,40,58,-18,30
FC Sion,8867,9,6,8,18,37,56,-19,26
Young Boys,8868,1,23,7,2,71,33,38,76
FC Basel,8868,2,19,7,6,59,26,33,64
Lucerne,8868,3,13,7,12,43,45,-2,46
St Gallen,8868,4,14,4,14,43,56,-13,46
FC Zürich,8868,5,11,9,12,39,38,1,42
FC Lugano,8868,6,10,7,15,31,46,-15,37
Grasshoppers,8868,7,9,7,16,41,50,-9,34
FC Thun,8868,8,9,6,17,45,60,-15,33
FC Sion,8868,9,5,8,19,40,58,-18,23
Young Boys,8869,1,21,8,3,73,37,36,71
FC Basel,8869,2,15,11,6,52,30,22,56
Lucerne,8869,3,13,9,10,46,44,2,48
St Gallen,8869,4,14,4,14,41,54,-13,46
FC Zürich,8869,5,9,12,11,40,38,2,39
FC Lugano,8869,6,11,5,16,33,46,-13,38
Grasshoppers,8869,7,8,9,15,42,51,-9,33
FC Sion,8869,8,8,8,16,46,54,-8,32
FC Thun,8869,9,8,8,16,41,60,-19,32
Young Boys,8870,1,21,6,5,67,41,26,69
FC Basel,8870,2,18,7,7,55,26,29,61
St Gallen,8870,3,14,4,14,45,57,-12,46
Lucerne,8870,4,12,8,12,39,44,-5,44
FC Zürich,8870,5,10,10,12,40,37,3,40
Grasshoppers,8870,6,11,6,15,49,48,1,39
FC Lugano,8870,7,10,6,16,31,47,-16,36
FC Thun,8870,8,10,5,17,43,59,-16,35
FC Sion,8870,9,8,8,16,41,51,-10,32
Young Boys,8871,1,21,7,4,73,35,38,70
FC Basel,8871,2,18,9,5,54,23,31,63
Lucerne,8871,3,12,10,10,44,46,-2,46
St Gallen,8871,4,13,5,14,42,54,-12,44
FC Zürich,8871,5,10,10,12,42,37,5,40
FC Thun,8871,6,11,5,16,46,58,-12,38
FC Lugano,8871,7,10,7,15,34,53,-19,37
Grasshoppers,8871,8,8,7,17,38,50,-12,31
FC Sion,8871,9,7,8,17,37,54,-17,29
Young Boys,8872,1,22,6,4,71,36,35,72
FC Basel,8872,2,19,7,6,59,28,31,64
Lucerne,8872,3,13,7,12,45,45,0,46
St Gallen,8872,4,14,2,16,40,57,-17,44
FC Zürich,8872,5,11,10,11,43,36,7,43
FC Lugano,8872,6,11,6,15,31,46,-15,39
FC Thun,8872,7,11,5,16,45,57,-12,38
Grasshoppers,8872,8,9,6,17,44,55,-11,33
FC Sion,8872,9,6,7,19,38,56,-18,25
Young Boys,8873,1,22,6,4,70,32,38,72
FC Basel,8873,2,19,7,6,57,25,32,64
FC Zürich,8873,3,12,9,11,45,34,11,45
St Gallen,8873,4,14,3,15,42,55,-13,45
Lucerne,8873,5,12,8,12,42,46,-4,44
FC Lugano,8873,6,10,5,17,30,50,-20,35
Grasshoppers,8873,7,9,7,16,39,51,-12,34
FC Sion,8873,8,8,8,16,40,51,-11,32
FC Thun,8873,9,9,5,18,42,63,-21,32
Young Boys,8874,1,23,7,2,80,34,46,76
FC Basel,8874,2,18,8,6,55,26,29,62
Lucerne,8874,3,14,8,10,45,43,2,50
St Gallen,8874,4,14,2,16,42,56,-14,44
FC Zürich,8874,5,11,9,12,40,35,5,42
FC Lugano,8874,6,11,5,16,31,51,-20,38
Grasshoppers,8874,7,9,8,15,40,47,-7,35
FC Thun,8874,8,9,5,18,42,62,-20,32
FC Sion,8874,9,5,8,19,40,61,-21,23
Young Boys,8875,1,21,6,5,73,38,35,69
FC Basel,8875,2,18,9,5,58,24,34,63
St Gallen,8875,3,15,4,13,44,52,-8,49
FC Zürich,8875,4,11,11,10,41,34,7,44
Lucerne,8875,5,12,7,13,42,46,-4,43
Grasshoppers,8875,6,11,7,14,44,48,-4,40
FC Lugano,8875,7,10,5,17,30,49,-19,35
FC Thun,8875,8,9,6,17,41,63,-22,33
FC Sion,8875,9,5,9,18,37,56,-19,24
Young Boys,8876,1,22,7,3,69,32,37,73
FC Basel,8876,2,18,9,5,53,24,29,63
Lucerne,8876,3,13,8,11,42,41,1,47
FC Zürich,8876,4,11,11,10,41,35,6,44
St Gallen,8876,5,14,2,16,41,55,-14,44
FC Lugano,8876,6,10,7,15,30,44,-14,37
Grasshoppers,8876,7,9,8,15,41,50,-9,35
FC Thun,8876,8,8,6,18,44,64,-20,30
FC Sion,8876,9,6,8,18,38,54,-16,26
Young Boys,8877,1,20,8,4,72,38,34,68
FC Basel,8877,2,16,9,7,49,26,23,57
Lucerne,8877,3,14,8,10,43,41,2,50
FC Zürich,8877,4,13,9,10,44,35,9,48
St Gallen,8877,5,14,3,15,39,53,-14,45
Grasshoppers,8877,6,10,7,15,42,49,-7,37
FC Lugano,8877,7,10,5,17,32,50,-18,35
FC Thun,8877,8,8,7,17,46,63,-17,31
FC Sion,8877,9,7,8,17,43,55,-12,29
Young Boys,8878,1,20,8,4,74,41,33,68
FC Basel,8878,2,19,8,5,53,21,32,65
Lucerne,8878,3,14,8,10,46,43,3,50
St Gallen,8878,4,14,2,16,43,56,-13,44
FC Zürich,8878,5,9,11,12,37,37,0,38
FC Thun,8878,6,10,7,15,43,55,-12,37
FC Sion,8878,7,8,9,15,41,50,-9,33
FC Lugano,8878,8,9,6,17,30,53,-23,33
Grasshoppers,8878,9,8,7,17,40,51,-11,31
Young Boys,8879,1,21,8,3,68,33,35,71
FC Basel,8879,2,17,9,6,59,28,31,60
St Gallen,8879,3,15,4,13,47,54,-7,49
Lucerne,8879,4,12,10,10,41,40,1,46
FC Zürich,8879,5,10,12,10,41,36,5,42
FC Lugano,8879,6,9,8,15,29,46,-17,35
FC Thun,8879,7,9,7,16,43,61,-18,34
Grasshoppers,8879,8,8,6,18,38,53,-15,30
FC Sion,8879,9,6,10,16,41,56,-15,28
Young Boys,8880,1,22,7,3,75,34,41,73
FC Basel,8880,2,16,9,7,51,27,24,57
St Gallen,8880,3,16,2,14,46,58,-12,50
Lucerne,8880,4,11,10,11,41,45,-4,43
FC Thun,8880,5,12,5,15,51,59,-8,41
FC Lugano,8880,6,11,6,15,34,48,-14,39
FC Zürich,8880,7,9,11,12,41,39,2,38
Grasshoppers,8880,8,8,8,16,43,57,-14,32
FC Sion,8880,9,5,10,17,42,57,-15,25
Young Boys,8881,1,21,8,3,77,39,38,71
FC Basel,8881,2,18,8,6,57,27,30,62
FC Zürich,8881,3,12,10,10,43,36,7,46
Lucerne,8881,4,12,9,11,41,42,-1,45
St Gallen,8881,5,14,3,15,47,61,-14,45
Grasshoppers,8881,6,10,8,14,47,50,-3,38
FC Thun,8881,7,8,8,16,44,61,-17,32
FC Lugano,8881,8,9,5,18,31,56,-25,32
FC Sion,8881,9,6,9,17,45,60,-15,27
Young Boys,8882,1,22,7,3,71,32,39,73
FC Basel,8882,2,16,9,7,49,25,24,57
Lucerne,8882,3,12,9,11,39,45,-6,45
St Gallen,8882,4,13,5,14,42,55,-13,44
FC Zürich,8882,5,10,11,11,40,36,4,41
Grasshoppers,8882,6,11,7,14,43,45,-2,40
FC Thun,8882,7,10,7,15,48,57,-9,37
FC Lugano,8882,8,9,7,16,29,47,-18,34
FC Sion,8882,9,6,8,18,41,60,-19,26
Young Boys,8883,1,21,7,4,71,36,35,70
FC Basel,8883,2,18,8,6,59,30,29,62
St Gallen,8883,3,15,2,15,46,57,-11,47
Lucerne,8883,4,13,7,12,41,47,-6,46
FC Lugano,8883,5,11,5,16,33,47,-14,38
FC Zürich,8883,6,9,10,13,38,39,-1,37
Grasshoppers,8883,7,10,7,15,43,48,-5,37
FC Thun,8883,8,10,6,16,46,59,-13,36
FC Sion,8883,9,7,8,17,40,54,-14,29
Young Boys,8884,1,20,9,3,67,34,33,69
FC Basel,8884,2,16,9,7,53,29,24,57
St Gallen,8884,3,14,4,14,52,62,-10,46
Lucerne,8884,4,11,11,10,46,49,-3,44
FC Zürich,8884,5,11,10,11,42,36,6,43
FC Lugano,8884,6,10,7,15,34,49,-15,37
Grasshoppers,8884,7,9,8,15,46,53,-7,35
FC Thun,8884,8,9,7,16,43,57,-14,34
FC Sion,8884,9,7,9,16,40,54,-14,30
Young Boys,8885,1,21,7,4,70,35,35,70
FC Basel,8885,2,19,8,5,57,23,34,65
Lucerne,8885,3,13,8,11,44,46,-2,47
St Gallen,8885,4,14,3,15,43,56,-13,45
FC Zürich,8885,5,11,9,12,40,37,3,42
Grasshoppers,8885,6,10,6,16,39,49,-10,36
FC Lugano,8885,7,9,7,16,31,48,-17,34
FC Thun,8885,8,9,6,17,42,60,-18,33
FC Sion,8885,9,7,8,17,41,53,-12,29
Young Boys,8886,1,19,9,4,71,40,31,66
FC Basel,8886,2,17,9,6,54,28,26,60
Lucerne,8886,3,14,8,10,46,42,4,50
St Gallen,8886,4,14,2,16,45,57,-12,44
FC Lugano,8886,5,12,5,15,36,49,-13,41
FC Zürich,8886,6,10,9,13,38,39,-1,39
Grasshoppers,8886,7,10,7,15,42,48,-6,37
FC Thun,8886,8,9,6,17,42,60,-18,33
FC Sion,8886,9,8,7,17,44,55,-11,31
Young Boys,8887,1,23,6,3,72,34,38,75
FC Basel,8887,2,17,9,6,53,27,26,60
St Gallen,8887,3,15,3,14,43,52,-9,48
Lucerne,8887,4,12,10,10,42,43,-1,46
FC Zürich,8887,5,11,9,12,43,38,5,42
Grasshoppers,8887,6,10,6,16,42,48,-6,36
FC Thun,8887,7,9,6,17,44,62,-18,33
FC Lugano,8887,8,9,6,17,30,49,-19,33
FC Sion,8887,9,7,7,18,41,57,-16,28
Young Boys,8888,1,22,8,2,72,33,39,74
FC Basel,8888,2,16,8,8,53,29,24,56
St Gallen,8888,3,15,3,14,45,53,-8,48
Lucerne,8888,4,13,7,12,40,45,-5,46
FC Zürich,8888,5,10,11,11,42,40,2,41
FC Thun,8888,6,10,6,16,48,61,-13,36
Grasshoppers,8888,7,9,7,16,39,50,-11,34
FC Lugano,8888,8,9,6,17,32,51,-19,33
FC Sion,8888,9,8,8,16,47,56,-9,32
Young Boys,8889,1,22,8,2,76,35,41,74
FC Basel,8889,2,18,8,6,54,25,29,62
Lucerne,8889,3,14,8,10,49,44,5,50
FC Zürich,8889,4,12,9,11,42,35,7,45
St Gallen,8889,5,13,2,17,41,59,-18,41
FC Lugano,8889,6,10,6,16,31,49,-18,36
Grasshoppers,8889,7,9,7,16,41,52,-11,34
FC Thun,8889,8,9,6,17,43,60,-17,33
FC Sion,8889,9,6,8,18,39,57,-18,26
Young Boys,8890,1,20,7,5,68,38,30,67
FC Basel,8890,2,18,9,5,57,28,29,63
St Gallen,8890,3,14,3,15,45,57,-12,45
Lucerne,8890,4,12,7,13,41,48,-7,43
FC Zürich,8890,5,11,9,12,40,35,5,42
Grasshoppers,8890,6,10,8,14,41,47,-6,38
FC Lugano,8890,7,11,5,16,34,47,-13,38
FC Thun,8890,8,9,7,16,45,58,-13,34
FC Sion,8890,9,8,7,17,41,54,-13,31
Young Boys,8891,1,22,7,3,72,32,40,73
FC Basel,8891,2,19,8,5,52,23,29,65
FC Zürich,8891,3,12,10,10,42,33,9,46
Lucerne,8891,4,12,9,11,43,45,-2,45
St Gallen,8891,5,13,4,15,41,54,-13,43
FC Lugano,8891,6,10,6,16,31,50,-19,36
FC Thun,8891,7,9,6,17,44,59,-15,33
Grasshoppers,8891,8,8,7,17,38,53,-15,31
FC Sion,8891,9,6,9,17,39,53,-14,27
Young Boys,8892,1,23,6,3,71,32,39,75
FC Basel,8892,2,20,7,5,57,25,32,67
Lucerne,8892,3,14,7,11,49,44,5,49
St Gallen,8892,4,13,2,17,42,61,-19,41
FC Zürich,8892,5,9,11,12,42,40,2,38
FC Lugano,8892,6,11,5,16,31,51,-20,38
Grasshoppers,8892,7,9,6,17,40,51,-11,33
FC Sion,8892,8,8,8,16,44,54,-10,32
FC Thun,8892,9,8,6,18,39,57,-18,30
Young Boys,8893,1,23,6,3,75,33,42,75
FC Basel,8893,2,17,8,7,50,24,26,59
St Gallen,8893,3,15,2,15,45,54,-9,47
Lucerne,8893,4,12,8,12,41,47,-6,44
FC Zürich,8893,5,10,11,11,42,39,3,41
Grasshoppers,8893,6,10,7,15,43,51,-8,37
FC Lugano,8893,7,9,7,16,31,52,-21,34
FC Thun,8893,8,8,8,16,42,58,-16,32
FC Sion,8893,9,8,7,17,48,59,-11,31
Young Boys,8894,1,20,7,5,70,36,34,67
FC Basel,8894,2,19,7,6,57,23,34,64
St Gallen,8894,3,15,3,14,45,54,-9,48
Lucerne,8894,4,12,8,12,42,49,-7,44
FC Zürich,8894,5,11,10,11,39,35,4,43
FC Lugano,8894,6,11,5,16,31,46,-15,38
Grasshoppers,8894,7,10,7,15,43,49,-6,37
FC Thun,8894,8,9,6,17,42,60,-18,33
FC Sion,8894,9,6,9,17,37,54,-17,27
Young Boys,8895,1,22,8,2,73,35,38,74
FC Basel,8895,2,17,9,6,55,30,25,60
St Gallen,8895,3,14,3,15,44,57,-13,45
Lucerne,8895,4,12,8,12,40,43,-3,44
FC Zürich,8895,5,11,10,11,41,35,6,43
FC Lugano,8895,6,11,6,15,32,47,-15,39
FC Thun,8895,7,10,6,16,44,58,-14,36
Grasshoppers,8895,8,9,7,16,40,49,-9,34
FC Sion,8895,9,6,7,19,41,56,-15,25
Young Boys,8896,1,21,7,4,76,33,43,70
FC Basel,8896,2,20,7,5,57,26,31,67
St Gallen,8896,3,15,3,14,46,53,-7,48
Lucerne,8896,4,12,7,13,42,50,-8,43
FC Zürich,8896,5,9,11,12,40,38,2,38
FC Lugano,8896,6,11,5,16,32,55,-23,38
Grasshoppers,8896,7,10,7,15,42,49,-7,37
FC Thun,8896,8,9,6,17,46,61,-15,33
FC Sion,8896,9,5,11,16,39,55,-16,26
Young Boys,8897,1,21,7,4,70,33,37,70
FC Basel,8897,2,16,8,8,53,30,23,56
St Gallen,8897,3,15,3,14,46,55,-9,48
Lucerne,8897,4,13,8,11,41,43,-2,47
Grasshoppers,8897,5,11,7,14,40,45,-5,40
FC Lugano,8897,6,11,6,15,32,46,-14,39
FC Zürich,8897,7,9,10,13,38,38,0,37
FC Thun,8897,8,9,7,16,43,58,-15,34
FC Sion,8897,9,7,8,17,41,56,-15,29
Young Boys,8898,1,21,7,4,71,36,35,70
FC Basel,8898,2,17,7,8,55,33,22,58
St Gallen,8898,3,15,2,15,45,58,-13,47
Lucerne,8898,4,12,8,12,43,44,-1,44
FC Zürich,8898,5,10,11,11,41,38,3,41
FC Thun,8898,6,12,5,15,53,61,-8,41
Grasshoppers,8898,7,11,6,15,44,50,-6,39
FC Lugano,8898,8,10,8,14,33,46,-13,38
FC Sion,8898,9,5,8,19,43,62,-19,23
Young Boys,8899,1,20,8,4,71,37,34,68
FC Basel,8899,2,18,8,6,57,28,29,62
Lucerne,8899,3,13,10,9,45,42,3,49
St Gallen,8899,4,14,3,15,45,60,-15,45
FC Zürich,8899,5,9,11,12,38,37,1,38
FC Thun,8899,6,11,5,16,45,56,-11,38
FC Lugano,8899,7,10,7,15,32,50,-18,37
Grasshoppers,8899,8,10,6,16,41,48,-7,36
FC Sion,8899,9,6,8,18,37,53,-16,26
Young Boys,8900,1,22,8,2,75,33,42,74
FC Basel,8900,2,17,9,6,54,27,27,60
St Gallen,8900,3,15,3,14,46,54,-8,48
Lucerne,8900,4,12,8,12,46,52,-6,44
FC Zürich,8900,5,10,12,10,38,33,5,42
Grasshoppers,8900,6,9,9,14,42,49,-7,36
FC Thun,8900,7,9,6,17,41,57,-16,33
FC Lugano,8900,8,9,6,17,30,52,-22,33
FC Sion,8900,9,6,9,17,36,51,-15,27
Young Boys,8901,1,22,6,4,70,34,36,72
FC Basel,8901,2,19,8,5,56,24,32,65
Lucerne,8901,3,13,8,11,48,47,1,47
St Gallen,8901,4,14,4,14,41,54,-13,46
FC Zürich,8901,5,10,10,12,42,38,4,40
Grasshoppers,8901,6,10,6,16,41,50,-9,36
FC Lugano,8901,7,9,8,15,29,47,-18,35
FC Thun,8901,8,9,5,18,42,64,-22,32
FC Sion,8901,9,7,7,18,42,53,-11,28
Young Boys,8902,1,22,7,3,69,32,37,73
FC Basel,8902,2,17,8,7,52,28,24,59
FC Zürich,8902,3,13,9,10,47,34,13,48
Lucerne,8902,4,11,11,10,37,39,-2,44
St Gallen,8902,5,13,4,15,41,54,-13,43
Grasshoppers,8902,6,10,8,14,41,47,-6,38
FC Lugano,8902,7,11,5,16,30,47,-17,38
FC Thun,8902,8,8,6,18,40,60,-20,30
FC Sion,8902,9,5,10,17,39,55,-16,25
Young Boys,8903,1,22,7,3,74,36,38,73
FC Basel,8903,2,18,8,6,55,24,31,62
St Gallen,8903,3,14,2,16,42,54,-12,44
Lucerne,8903,4,11,9,12,39,48,-9,42
FC Zürich,8903,5,10,9,13,40,39,1,39
FC Lugano,8903,6,11,6,15,32,45,-13,39
Grasshoppers,8903,7,10,7,15,41,48,-7,37
FC Thun,8903,8,10,6,16,47,63,-16,36
FC Sion,8903,9,7,8,17,42,55,-13,29
Young Boys,8904,1,22,8,2,71,32,39,74
FC Basel,8904,2,19,7,6,57,24,33,64
St Gallen,8904,3,15,3,14,46,55,-9,48
Lucerne,8904,4,12,10,10,41,45,-4,46
FC Zürich,8904,5,9,11,12,39,40,-1,38
Grasshoppers,8904,6,10,6,16,40,47,-7,36
FC Lugano,8904,7,9,7,16,30,49,-19,34
FC Thun,8904,8,9,5,18,43,60,-17,32
FC Sion,8904,9,6,9,17,39,54,-15,27
Young Boys,8905,1,21,6,5,68,36,32,69
FC Basel,8905,2,17,9,6,55,27,28,60
Lucerne,8905,3,15,8,9,46,40,6,53
FC Zürich,8905,4,12,10,10,43,34,9,46
St Gallen,8905,5,13,3,16,41,60,-19,42
Grasshoppers,8905,6,10,8,14,45,48,-3,38
FC Lugano,8905,7,10,5,17,30,47,-17,35
FC Thun,8905,8,8,7,17,42,61,-19,31
FC Sion,8905,9,6,8,18,37,54,-17,26
Young Boys,8906,1,22,6,4,71,36,35,72
FC Basel,8906,2,19,8,5,54,23,31,65
Lucerne,8906,3,13,7,12,39,41,-2,46
FC Zürich,8906,4,11,9,12,42,37,5,42
St Gallen,8906,5,13,3,16,39,55,-16,42
FC Lugano,8906,6,11,6,15,34,47,-13,39
Grasshoppers,8906,7,9,7,16,39,50,-11,34
FC Thun,8906,8,9,6,17,44,62,-18,33
FC Sion,8906,9,7,8,17,39,50,-11,29
Young Boys,8907,1,21,8,3,69,35,34,71
FC Basel,8907,2,19,7,6,58,26,32,64
Lucerne,8907,3,12,9,11,44,43,1,45
St Gallen,8907,4,13,3,16,40,56,-16,42
FC Zürich,8907,5,10,11,11,40,37,3,41
FC Lugano,8907,6,11,5,16,34,50,-16,38
FC Thun,8907,7,10,6,16,44,59,-15,36
Grasshoppers,8907,8,8,9,15,40,49,-9,33
FC Sion,8907,9,6,10,16,40,54,-14,28
Young Boys,8908,1,22,8,2,74,32,42,74
FC Basel,8908,2,17,10,5,56,28,28,61
St Gallen,8908,3,15,3,14,46,54,-8,48
Lucerne,8908,4,12,9,11,43,47,-4,45
FC Zürich,8908,5,10,11,11,39,35,4,41
FC Lugano,8908,6,10,7,15,31,49,-18,37
FC Thun,8908,7,10,6,16,42,57,-15,36
Grasshoppers,8908,8,9,6,17,40,51,-11,33
FC Sion,8908,9,5,8,19,36,54,-18,23
Young Boys,8909,1,21,7,4,72,36,36,70
FC Basel,8909,2,18,8,6,55,23,32,62
St Gallen,8909,3,15,2,15,44,59,-15,47
Lucerne,8909,4,13,7,12,45,47,-2,46
FC Zürich,8909,5,10,10,12,39,41,-2,40
Grasshoppers,8909,6,11,6,15,41,47,-6,39
FC Lugano,8909,7,11,6,15,38,49,-11,39
FC Thun,8909,8,10,5,17,45,60,-15,35
FC Sion,8909,9,6,7,19,41,58,-17,25
Young Boys,8910,1,21,6,5,70,38,32,69
FC Basel,8910,2,17,9,6,55,28,27,60
Lucerne,8910,3,15,8,9,44,40,4,53
FC Zürich,8910,4,11,10,11,42,39,3,43
St Gallen,8910,5,13,4,15,40,53,-13,43
FC Lugano,8910,6,10,5,17,30,47,-17,35
Grasshoppers,8910,7,9,7,16,42,51,-9,34
FC Thun,8910,8,8,8,16,42,58,-16,32
FC Sion,8910,9,7,9,16,43,54,-11,30
Young Boys,8911,1,23,6,3,70,32,38,75
FC Basel,8911,2,18,8,6,53,28,25,62
St Gallen,8911,3,15,2,15,51,56,-5,47
FC Zürich,8911,4,12,9,11,45,33,12,45
Lucerne,8911,5,12,8,12,42,50,-8,44
FC Thun,8911,6,10,7,15,46,56,-10,37
Grasshoppers,8911,7,9,8,15,43,51,-8,35
FC Lugano,8911,8,10,5,17,33,51,-18,35
FC Sion,8911,9,5,7,20,37,63,-26,22
Young Boys,8912,1,22,6,4,78,38,40,72
FC Basel,8912,2,18,8,6,57,27,30,62
Lucerne,8912,3,13,7,12,44,52,-8,46
FC Zürich,8912,4,12,9,11,43,35,8,45
St Gallen,8912,5,13,4,15,42,56,-14,43
Grasshoppers,8912,6,10,6,16,46,49,-3,36
FC Lugano,8912,7,10,5,17,32,53,-21,35
FC Thun,8912,8,9,6,17,41,61,-20,33
FC Sion,8912,9,7,9,16,40,52,-12,30
Young Boys,8913,1,21,9,2,71,32,39,72
FC Basel,8913,2,17,8,7,55,27,28,59
St Gallen,8913,3,14,2,16,42,56,-14,44
FC Zürich,8913,4,11,9,12,42,38,4,42
Lucerne,8913,5,11,9,12,38,49,-11,42
FC Lugano,8913,6,11,7,14,33,45,-12,40
FC Thun,8913,7,11,5,16,44,56,-12,38
Grasshoppers,8913,8,8,8,16,40,50,-10,32
FC Sion,8913,9,7,9,16,41,53,-12,30
Young Boys,8914,1,21,6,5,71,35,36,69
FC Basel,8914,2,20,7,5,57,23,34,67
Lucerne,8914,3,14,7,11,42,44,-2,49
St Gallen,8914,4,14,3,15,41,52,-11,45
FC Zürich,8914,5,10,9,13,38,36,2,39
FC Lugano,8914,6,11,5,16,32,51,-19,38
Grasshoppers,8914,7,9,6,17,41,51,-10,33
FC Sion,8914,8,8,8,16,42,55,-13,32
FC Thun,8914,9,9,5,18,45,62,-17,32
Young Boys,8915,1,22,7,3,69,34,35,73
FC Basel,8915,2,19,7,6,54,23,31,64
Lucerne,8915,3,13,8,11,39,39,0,47
St Gallen,8915,4,14,2,16,42,54,-12,44
FC Zürich,8915,5,11,10,11,41,36,5,43
FC Lugano,8915,6,10,7,15,31,46,-15,37
Grasshoppers,8915,7,9,7,16,40,49,-9,34
FC Thun,8915,8,9,6,17,44,60,-16,33
FC Sion,8915,9,6,8,18,38,57,-19,26
Young Boys,8916,1,23,7,2,74,35,39,76
FC Basel,8916,2,16,8,8,52,30,22,56
St Gallen,8916,3,16,2,14,47,54,-7,50
Lucerne,8916,4,12,9,11,43,45,-2,45
FC Zürich,8916,5,11,10,11,42,38,4,43
FC Lugano,8916,6,10,6,16,32,47,-15,36
Grasshoppers,8916,7,8,10,14,42,50,-8,34
FC Thun,8916,8,9,6,17,45,60,-15,33
FC Sion,8916,9,6,8,18,40,58,-18,26
Young Boys,8917,1,22,6,4,71,38,33,72
FC Basel,8917,2,17,8,7,52,27,25,59
Lucerne,8917,3,14,8,10,42,40,2,50
FC Zürich,8917,4,11,9,12,41,36,5,42
St Gallen,8917,5,13,3,16,42,57,-15,42
Grasshoppers,8917,6,10,7,15,43,49,-6,37
FC Thun,8917,7,10,7,15,45,57,-12,37
FC Lugano,8917,8,10,5,17,28,47,-19,35
FC Sion,8917,9,7,7,18,42,55,-13,28
Young Boys,8918,1,23,6,3,75,33,42,75
FC Basel,8918,2,18,8,6,52,23,29,62
FC Zürich,8918,3,11,11,10,45,37,8,44
Lucerne,8918,4,12,8,12,42,47,-5,44
St Gallen,8918,5,13,3,16,41,56,-15,42
FC Lugano,8918,6,10,7,15,32,49,-17,37
Grasshoppers,8918,7,9,8,15,41,48,-7,35
FC Thun,8918,8,9,5,18,40,61,-21,32
FC Sion,8918,9,7,8,17,40,54,-14,29
Young Boys,8919,1,23,7,2,72,32,40,76
FC Basel,8919,2,17,9,6,59,28,31,60
St Gallen,8919,3,15,2,15,44,54,-10,47
FC Zürich,8919,4,12,10,10,42,34,8,46
Lucerne,8919,5,12,8,12,45,49,-4,44
Grasshoppers,8919,6,10,7,15,42,50,-8,37
FC Lugano,8919,7,9,6,17,30,50,-20,33
FC Sion,8919,8,7,8,17,42,55,-13,29
FC Thun,8919,9,8,5,19,42,66,-24,29
Young Boys,8920,1,21,7,4,73,37,36,70
FC Basel,8920,2,15,9,8,50,31,19,54
Lucerne,8920,3,13,10,9,45,42,3,49
St Gallen,8920,4,14,3,15,46,57,-11,45
FC Zürich,8920,5,10,12,10,44,39,5,42
Grasshoppers,8920,6,9,9,14,40,46,-6,36
FC Lugano,8920,7,10,6,16,33,51,-18,36
FC Sion,8920,8,8,9,15,43,53,-10,33
FC Thun,8920,9,8,7,17,43,61,-18,31
Young Boys,8921,1,21,7,4,69,34,35,70
FC Basel,8921,2,19,7,6,54,24,30,64
FC Zürich,8921,3,12,9,11,43,35,8,45
Lucerne,8921,4,12,8,12,42,48,-6,44
St Gallen,8921,5,14,2,16,46,59,-13,44
FC Lugano,8921,6,11,5,16,32,46,-14,38
Grasshoppers,8921,7,9,8,15,40,49,-9,35
FC Thun,8921,8,10,5,17,42,58,-16,35
FC Sion,8921,9,7,7,18,40,55,-15,28
Young Boys,8922,1,22,8,2,70,31,39,74
FC Basel,8922,2,18,9,5,53,22,31,63
St Gallen,8922,3,14,3,15,42,57,-15,45
FC Zürich,8922,4,11,10,11,40,35,5,43
Lucerne,8922,5,11,8,13,39,48,-9,41
FC Thun,8922,6,10,6,16,43,58,-15,36
FC Lugano,8922,7,9,7,16,31,48,-17,34
Grasshoppers,8922,8,9,6,17,42,54,-12,33
FC Sion,8922,9,7,9,16,44,51,-7,30
Young Boys,8923,1,22,7,3,71,35,36,73
FC Basel,8923,2,17,8,7,55,28,27,59
Lucerne,8923,3,13,8,11,41,41,0,47
FC Zürich,8923,4,12,9,11,43,36,7,45
St Gallen,8923,5,14,3,15,42,56,-14,45
FC Lugano,8923,6,10,6,16,31,46,-15,36
FC Thun,8923,7,9,7,16,46,61,-15,34
Grasshoppers,8923,8,9,6,17,41,54,-13,33
FC Sion,8923,9,7,8,17,42,55,-13,29
Young Boys,8924,1,23,6,3,78,35,43,75
FC Basel,8924,2,17,9,6,53,27,26,60
St Gallen,8924,3,16,2,14,48,51,-3,50
FC Zürich,8924,4,12,10,10,44,34,10,46
Lucerne,8924,5,12,9,11,43,50,-7,45
FC Thun,8924,6,9,7,16,43,57,-14,34
Grasshoppers,8924,7,8,8,16,40,52,-12,32
FC Lugano,8924,8,9,5,18,30,56,-26,32
FC Sion,8924,9,5,10,17,37,54,-17,25
Young Boys,8925,1,22,8,2,77,36,41,74
FC Basel,8925,2,17,9,6,58,26,32,60
St Gallen,8925,3,17,2,13,45,50,-5,53
Lucerne,8925,4,11,9,12,38,48,-10,42
FC Zürich,8925,5,10,11,11,40,36,4,41
Grasshoppers,8925,6,10,7,15,40,48,-8,37
FC Thun,8925,7,9,6,17,42,61,-19,33
FC Lugano,8925,8,9,6,17,29,49,-20,33
FC Sion,8925,9,6,8,18,40,55,-15,26
Young Boys,8926,1,21,7,4,70,34,36,70
FC Basel,8926,2,15,9,8,53,31,22,54
Lucerne,8926,3,15,8,9,48,40,8,53
St Gallen,8926,4,15,2,15,45,58,-13,47
FC Zürich,8926,5,10,12,10,42,36,6,42
Grasshoppers,8926,6,11,6,15,41,50,-9,39
FC Thun,8926,7,9,7,16,44,59,-15,34
FC Lugano,8926,8,9,6,17,30,53,-23,33
FC Sion,8926,9,7,7,18,41,53,-12,28
Young Boys,8927,1,21,7,4,72,35,37,70
FC Basel,8927,2,18,8,6,51,25,26,62
St Gallen,8927,3,14,5,13,45,54,-9,47
Lucerne,8927,4,12,9,11,42,45,-3,45
Grasshoppers,8927,5,11,7,14,41,45,-4,40
FC Zürich,8927,6,10,9,13,40,38,2,39
FC Lugano,8927,7,10,7,15,32,48,-16,37
FC Thun,8927,8,9,6,17,42,58,-16,33
FC Sion,8927,9,5,10,17,38,55,-17,25
Young Boys,8928,1,21,7,4,72,33,39,70
FC Basel,8928,2,18,8,6,54,25,29,62
Lucerne,8928,3,13,8,11,39,43,-4,47
St Gallen,8928,4,14,4,14,44,54,-10,46
FC Zürich,8928,5,12,9,11,42,34,8,45
FC Lugano,8928,6,10,7,15,30,49,-19,37
FC Thun,8928,7,10,6,16,45,58,-13,36
Grasshoppers,8928,8,8,7,17,39,51,-12,31
FC Sion,8928,9,6,8,18,39,57,-18,26
Young Boys,8929,1,20,7,5,69,37,32,67
FC Basel,8929,2,16,10,6,51,26,25,58
Lucerne,8929,3,14,7,11,42,42,0,49
St Gallen,8929,4,14,3,15,41,56,-15,45
FC Zürich,8929,5,10,12,10,41,35,6,42
FC Lugano,8929,6,11,6,15,32,46,-14,39
Grasshoppers,8929,7,9,8,15,42,50,-8,35
FC Thun,8929,8,8,9,15,44,59,-15,33
FC Sion,8929,9,7,8,17,46,57,-11,29
Young Boys,8930,1,23,7,2,72,33,39,76
FC Basel,8930,2,17,8,7,53,26,27,59
St Gallen,8930,3,15,3,14,45,54,-9,48
FC Zürich,8930,4,12,10,10,43,34,9,46
Lucerne,8930,5,12,10,10,42,43,-1,46
FC Lugano,8930,6,9,6,17,30,50,-20,33
FC Thun,8930,7,9,5,18,45,63,-18,32
Grasshoppers,8930,8,8,7,17,39,53,-14,31
FC Sion,8930,9,7,8,17,43,56,-13,29
Young Boys,8931,1,22,7,3,72,34,38,73
FC Basel,8931,2,17,9,6,52,24,28,60
St Gallen,8931,3,15,2,15,41,52,-11,47
Lucerne,8931,4,12,8,12,43,47,-4,44
FC Lugano,8931,5,11,5,16,33,49,-16,38
FC Zürich,8931,6,9,10,13,39,40,-1,37
FC Thun,8931,7,10,7,15,45,57,-12,37
FC Sion,8931,8,9,7,16,43,51,-8,34
Grasshoppers,8931,9,8,7,17,38,52,-14,31
Young Boys,8932,1,21,7,4,74,37,37,70
FC Basel,8932,2,18,7,7,53,27,26,61
Lucerne,8932,3,13,7,12,40,43,-3,46
FC Zürich,8932,4,12,9,11,47,36,11,45
St Gallen,8932,5,14,2,16,41,54,-13,44
FC Lugano,8932,6,12,5,15,31,46,-15,41
Grasshoppers,8932,7,10,6,16,45,50,-5,36
FC Thun,8932,8,10,5,17,44,60,-16,35
FC Sion,8932,9,6,8,18,38,60,-22,26
Young Boys,8933,1,21,8,3,72,37,35,71
FC Basel,8933,2,19,7,6,57,26,31,64
Lucerne,8933,3,13,9,10,45,44,1,48
St Gallen,8933,4,13,4,15,40,55,-15,43
FC Zürich,8933,5,10,10,12,41,42,-1,40
FC Lugano,8933,6,11,5,16,35,47,-12,38
FC Thun,8933,7,10,6,16,44,58,-14,36
Grasshoppers,8933,8,8,8,16,43,55,-12,32
FC Sion,8933,9,6,9,17,42,55,-13,27
Young Boys,8934,1,20,7,5,69,37,32,67
FC Basel,8934,2,18,8,6,53,24,29,62
St Gallen,8934,3,15,3,14,42,53,-11,48
Lucerne,8934,4,12,9,11,43,46,-3,45
FC Lugano,8934,5,12,5,15,36,48,-12,41
FC Zürich,8934,6,9,10,13,43,42,1,37
Grasshoppers,8934,7,9,8,15,41,50,-9,35
FC Thun,8934,8,9,6,17,45,63,-18,33
FC Sion,8934,9,8,8,16,46,55,-9,32
Young Boys,8935,1,22,6,4,70,37,33,72
FC Basel,8935,2,16,8,8,54,27,27,56
Lucerne,8935,3,13,10,9,41,40,1,49
St Gallen,8935,4,14,3,15,43,57,-14,45
FC Zürich,8935,5,10,9,13,38,42,-4,39
FC Lugano,8935,6,11,6,15,36,49,-13,39
Grasshoppers,8935,7,9,8,15,42,48,-6,35
FC Thun,8935,8,9,7,16,47,62,-15,34
FC Sion,8935,9,7,9,16,44,53,-9,30
Young Boys,8936,1,22,6,4,69,35,34,72
FC Basel,8936,2,17,9,6,52,26,26,60
St Gallen,8936,3,14,4,14,43,53,-10,46
Lucerne,8936,4,12,9,11,42,45,-3,45
FC Lugano,8936,5,12,5,15,35,46,-11,41
FC Zürich,8936,6,10,10,12,39,36,3,40
Grasshoppers,8936,7,10,6,16,43,51,-8,36
FC Thun,8936,8,10,5,17,45,60,-15,35
FC Sion,8936,9,6,8,18,37,53,-16,26
Young Boys,8937,1,22,7,3,72,33,39,73
FC Basel,8937,2,18,8,6,55,24,31,62
St Gallen,8937,3,15,3,14,43,53,-10,48
Lucerne,8937,4,12,8,12,37,40,-3,44
FC Zürich,8937,5,10,12,10,44,36,8,42
FC Lugano,8937,6,9,9,14,30,45,-15,36
Grasshoppers,8937,7,9,8,15,43,51,-8,35
FC Thun,8937,8,9,7,16,46,61,-15,34
FC Sion,8937,9,5,8,19,36,63,-27,23
Young Boys,8938,1,22,6,4,71,35,36,72
FC Basel,8938,2,17,7,8,53,32,21,58
Lucerne,8938,3,14,8,10,47,41,6,50
St Gallen,8938,4,14,4,14,42,53,-11,46
FC Zürich,8938,5,12,9,11,47,37,10,45
Grasshoppers,8938,6,11,6,15,45,45,0,39
FC Thun,8938,7,10,5,17,45,64,-19,35
FC Lugano,8938,8,10,5,17,31,52,-21,35
FC Sion,8938,9,5,8,19,36,58,-22,23
Young Boys,8939,1,20,7,5,70,38,32,67
FC Basel,8939,2,16,9,7,53,31,22,57
Lucerne,8939,3,13,9,10,47,46,1,48
St Gallen,8939,4,15,2,15,46,57,-11,47
FC Zürich,8939,5,11,11,10,44,36,8,44
Grasshoppers,8939,6,11,6,15,45,46,-1,39
FC Lugano,8939,7,9,8,15,32,49,-17,35
FC Thun,8939,8,8,8,16,43,60,-17,32
FC Sion,8939,9,7,8,17,40,57,-17,29
Young Boys,8940,1,21,7,4,70,38,32,70
FC Basel,8940,2,19,8,5,55,22,33,65
St Gallen,8940,3,14,4,14,42,53,-11,46
Lucerne,8940,4,12,7,13,39,43,-4,43
FC Zürich,8940,5,11,9,12,39,35,4,42
FC Lugano,8940,6,10,6,16,32,49,-17,36
FC Thun,8940,7,10,5,17,45,60,-15,35
Grasshoppers,8940,8,9,7,16,40,51,-11,34
FC Sion,8940,9,8,7,17,41,52,-11,31
Young Boys,8941,1,23,6,3,74,33,41,75
FC Basel,8941,2,17,8,7,53,28,25,59
St Gallen,8941,3,16,2,14,44,53,-9,50
Lucerne,8941,4,12,8,12,41,44,-3,44
FC Zürich,8941,5,10,10,12,40,38,2,40
FC Lugano,8941,6,11,5,16,30,47,-17,38
FC Thun,8941,7,10,7,15,43,56,-13,37
Grasshoppers,8941,8,8,9,15,41,50,-9,33
FC Sion,8941,9,5,9,18,38,55,-17,24
Young Boys,8942,1,23,6,3,76,35,41,75
FC Basel,8942,2,17,10,5,57,27,30,61
St Gallen,8942,3,15,4,13,42,51,-9,49
FC Zürich,8942,4,11,11,10,44,36,8,44
Lucerne,8942,5,11,9,12,39,46,-7,42
Grasshoppers,8942,6,10,7,15,39,48,-9,37
FC Lugano,8942,7,9,8,15,30,48,-18,35
FC Thun,8942,8,9,6,17,41,58,-17,33
FC Sion,8942,9,5,7,20,38,57,-19,22
Young Boys,8943,1,21,7,4,72,37,35,70
FC Basel,8943,2,19,7,6,57,25,32,64
Lucerne,8943,3,13,8,11,45,51,-6,47
St Gallen,8943,4,14,3,15,44,56,-12,45
FC Zürich,8943,5,11,10,11,45,43,2,43
Grasshoppers,8943,6,10,8,14,44,49,-5,38
FC Thun,8943,7,9,6,17,47,62,-15,33
FC Lugano,8943,8,9,5,18,32,51,-19,32
FC Sion,8943,9,6,10,16,42,54,-12,28
Young Boys,8944,1,20,7,5,71,40,31,67
FC Basel,8944,2,18,7,7,54,27,27,61
St Gallen,8944,3,15,3,14,43,55,-12,48
Lucerne,8944,4,12,10,10,41,43,-2,46
FC Zürich,8944,5,11,9,12,44,36,8,42
Grasshoppers,8944,6,11,7,14,45,49,-4,40
FC Lugano,8944,7,10,6,16,31,48,-17,36
FC Thun,8944,8,9,6,17,45,62,-17,33
FC Sion,8944,9,7,7,18,43,57,-14,28
Young Boys,8945,1,23,6,3,69,33,36,75
FC Basel,8945,2,18,8,6,54,26,28,62
St Gallen,8945,3,16,3,13,46,54,-8,51
Lucerne,8945,4,12,8,12,40,42,-2,44
FC Zürich,8945,5,10,10,12,40,36,4,40
Grasshoppers,8945,6,11,7,14,46,45,1,40
FC Thun,8945,7,9,6,17,40,57,-17,33
FC Lugano,8945,8,9,6,17,30,50,-20,33
FC Sion,8945,9,5,8,19,37,59,-22,23
Young Boys,8946,1,22,6,4,78,36,42,72
FC Basel,8946,2,16,10,6,53,30,23,58
Lucerne,8946,3,14,9,9,41,38,3,51
FC Zürich,8946,4,11,11,10,40,34,6,44
St Gallen,8946,5,13,5,14,42,55,-13,44
Grasshoppers,8946,6,11,6,15,42,45,-3,39
FC Lugano,8946,7,10,6,16,32,51,-19,36
FC Thun,8946,8,8,5,19,40,63,-23,29
FC Sion,8946,9,6,8,18,39,55,-16,26
Young Boys,8947,1,21,7,4,71,38,33,70
FC Basel,8947,2,18,7,7,58,30,28,61
FC Lugano,8947,3,13,5,14,33,44,-11,44
St Gallen,8947,4,14,2,16,44,56,-12,44
Lucerne,8947,5,12,7,13,40,47,-7,43
FC Thun,8947,6,11,5,16,47,57,-10,38
FC Zürich,8947,7,9,10,13,36,38,-2,37
Grasshoppers,8947,8,9,7,16,43,52,-9,34
FC Sion,8947,9,8,8,16,40,50,-10,32
Young Boys,8948,1,23,6,3,76,34,42,75
FC Basel,8948,2,18,8,6,56,27,29,62
Lucerne,8948,3,13,8,11,44,44,0,47
St Gallen,8948,4,14,3,15,45,59,-14,45
FC Zürich,8948,5,10,11,11,37,33,4,41
FC Lugano,8948,6,10,6,16,30,49,-19,36
Grasshoppers,8948,7,9,8,15,40,49,-9,35
FC Thun,8948,8,8,6,18,40,61,-21,30
FC Sion,8948,9,7,8,17,41,53,-12,29
Young Boys,8949,1,21,7,4,71,38,33,70
FC Basel,8949,2,18,7,7,56,28,28,61
St Gallen,8949,3,14,3,15,45,57,-12,45
Lucerne,8949,4,12,8,12,44,48,-4,44
FC Zürich,8949,5,11,9,12,41,38,3,42
FC Lugano,8949,6,12,5,15,35,45,-10,41
Grasshoppers,8949,7,10,7,15,45,52,-7,37
FC Sion,8949,8,9,7,16,42,52,-10,34
FC Thun,8949,9,8,5,19,40,61,-21,29
Young Boys,8950,1,22,6,4,69,32,37,72
FC Basel,8950,2,18,8,6,54,26,28,62
Lucerne,8950,3,13,8,11,44,43,1,47
St Gallen,8950,4,14,4,14,43,54,-11,46
FC Zürich,8950,5,11,10,11,40,37,3,43
FC Lugano,8950,6,11,5,16,32,48,-16,38
FC Thun,8950,7,9,8,15,43,57,-14,35
Grasshoppers,8950,8,8,6,18,39,55,-16,30
FC Sion,8950,9,6,9,17,40,52,-12,27
Young Boys,8951,1,21,8,3,72,39,33,71
FC Basel,8951,2,15,11,6,52,28,24,56
St Gallen,8951,3,15,3,14,47,54,-7,48
FC Zürich,8951,4,12,10,10,42,33,9,46
Lucerne,8951,5,12,9,11,41,44,-3,45
Grasshoppers,8951,6,10,8,14,48,49,-1,38
FC Lugano,8951,7,10,5,17,30,52,-22,35
FC Thun,8951,8,8,7,17,41,59,-18,31
FC Sion,8951,9,7,7,18,41,56,-15,28
Young Boys,8952,1,21,8,3,70,35,35,71
FC Basel,8952,2,16,10,6,52,30,22,58
Lucerne,8952,3,13,7,12,44,43,1,46
St Gallen,8952,4,14,4,14,44,55,-11,46
FC Zürich,8952,5,11,10,11,42,37,5,43
Grasshoppers,8952,6,10,6,16,44,50,-6,36
FC Lugano,8952,7,10,6,16,33,50,-17,36
FC Thun,8952,8,10,5,17,44,60,-16,35
FC Sion,8952,9,7,8,17,42,55,-13,29
Young Boys,8953,1,21,8,3,69,33,36,71
FC Basel,8953,2,18,7,7,54,27,27,61
St Gallen,8953,3,17,2,13,46,52,-6,53
FC Zürich,8953,4,10,11,11,43,40,3,41
Lucerne,8953,5,11,8,13,38,43,-5,41
FC Lugano,8953,6,10,7,15,31,46,-15,37
Grasshoppers,8953,7,9,8,15,39,48,-9,35
FC Thun,8953,8,10,5,17,46,60,-14,35
FC Sion,8953,9,5,10,17,39,56,-17,25
Young Boys,8954,1,23,7,2,74,34,40,76
FC Basel,8954,2,17,8,7,54,27,27,59
St Gallen,8954,3,14,5,13,42,52,-10,47
Lucerne,8954,4,11,9,12,41,46,-5,42
FC Zürich,8954,5,10,11,11,40,36,4,41
FC Lugano,8954,6,9,9,14,31,46,-15,36
FC Thun,8954,7,9,7,16,44,60,-16,34
Grasshoppers,8954,8,8,8,16,42,54,-12,32
FC Sion,8954,9,6,10,16,44,57,-13,28
Young Boys,8955,1,22,7,3,81,37,44,73
FC Basel,8955,2,18,8,6,57,28,29,62
St Gallen,8955,3,14,4,14,46,57,-11,46
Lucerne,8955,4,12,8,12,44,53,-9,44
FC Zürich,8955,5,11,10,11,42,36,6,43
Grasshoppers,8955,6,9,9,14,46,51,-5,36
FC Lugano,8955,7,10,5,17,30,51,-21,35
FC Thun,8955,8,9,6,17,48,61,-13,33
FC Sion,8955,9,6,9,17,41,61,-20,27
Young Boys,8956,1,22,6,4,80,35,45,72
FC Basel,8956,2,18,7,7,53,27,26,61
Lucerne,8956,3,14,7,11,46,44,2,49
St Gallen,8956,4,14,4,14,42,53,-11,46
FC Zürich,8956,5,11,10,11,41,35,6,43
Grasshoppers,8956,6,10,6,16,40,54,-14,36
FC Lugano,8956,7,9,7,16,27,52,-25,34
FC Thun,8956,8,9,5,18,41,58,-17,32
FC Sion,8956,9,7,8,17,43,55,-12,29
Young Boys,8957,1,21,6,5,72,41,31,69
FC Basel,8957,2,19,8,5,59,26,33,65
Lucerne,8957,3,13,9,10,44,44,0,48
FC Zürich,8957,4,12,9,11,46,38,8,45
St Gallen,8957,5,13,5,14,41,54,-13,44
Grasshoppers,8957,6,9,8,15,41,49,-8,35
FC Thun,8957,7,9,7,16,44,59,-15,34
FC Lugano,8957,8,9,7,16,31,48,-17,34
FC Sion,8957,9,5,9,18,39,58,-19,24
Young Boys,8958,1,22,7,3,73,34,39,73
FC Basel,8958,2,17,7,8,53,29,24,58
Lucerne,8958,3,14,7,11,42,42,0,49
St Gallen,8958,4,15,2,15,43,56,-13,47
FC Lugano,8958,5,11,5,16,33,49,-16,38
FC Zürich,8958,6,9,9,14,42,44,-2,36
FC Sion,8958,7,9,8,15,44,50,-6,35
FC Thun,8958,8,10,5,17,47,61,-14,35
Grasshoppers,8958,9,9,6,17,39,51,-12,33
Young Boys,8959,1,21,8,3,71,34,37,71
FC Basel,8959,2,17,10,5,53,24,29,61
Lucerne,8959,3,12,9,11,41,44,-3,45
FC Lugano,8959,4,12,6,14,35,43,-8,42
St Gallen,8959,5,13,2,17,45,64,-19,41
FC Zürich,8959,6,9,11,12,39,38,1,38
Grasshoppers,8959,7,9,9,14,41,48,-7,36
FC Thun,8959,8,9,6,17,43,59,-16,33
FC Sion,8959,9,8,7,17,41,55,-14,31
Young Boys,8960,1,22,6,4,72,36,36,72
FC Basel,8960,2,20,7,5,63,25,38,67
Lucerne,8960,3,13,8,11,45,48,-3,47
St Gallen,8960,4,15,2,15,45,58,-13,47
FC Zürich,8960,5,10,10,12,40,38,2,40
FC Lugano,8960,6,10,7,15,35,46,-11,37
FC Thun,8960,7,10,5,17,43,61,-18,35
Grasshoppers,8960,8,9,6,17,41,51,-10,33
FC Sion,8960,9,6,7,19,39,60,-21,25
Young Boys,8961,1,21,6,5,73,37,36,69
FC Basel,8961,2,16,8,8,53,31,22,56
St Gallen,8961,3,15,3,14,48,56,-8,48
FC Zürich,8961,4,12,9,11,41,34,7,45
Lucerne,8961,5,12,9,11,45,50,-5,45
Grasshoppers,8961,6,11,7,14,47,48,-1,40
FC Lugano,8961,7,11,7,14,33,46,-13,40
FC Thun,8961,8,9,6,17,42,61,-19,33
FC Sion,8961,9,6,7,19,37,56,-19,25
Young Boys,8962,1,21,7,4,73,40,33,70
FC Basel,8962,2,17,9,6,57,30,27,60
Lucerne,8962,3,13,9,10,44,42,2,48
St Gallen,8962,4,14,3,15,44,55,-11,45
FC Zürich,8962,5,11,10,11,44,38,6,43
Grasshoppers,8962,6,10,7,15,42,49,-7,37
FC Lugano,8962,7,10,5,17,29,51,-22,35
FC Thun,8962,8,9,5,18,42,61,-19,32
FC Sion,8962,9,7,9,16,45,54,-9,30
Young Boys,8963,1,22,7,3,74,35,39,73
FC Basel,8963,2,19,8,5,58,24,34,65
St Gallen,8963,3,15,3,14,49,53,-4,48
FC Zürich,8963,4,12,9,11,42,39,3,45
Lucerne,8963,5,12,8,12,42,45,-3,44
Grasshoppers,8963,6,10,8,14,44,49,-5,38
FC Lugano,8963,7,10,5,17,31,52,-21,35
FC Thun,8963,8,8,5,19,41,63,-22,29
FC Sion,8963,9,6,7,19,39,60,-21,25
Young Boys,8964,1,21,7,4,72,38,34,70
FC Basel,8964,2,18,8,6,53,24,29,62
Lucerne,8964,3,13,8,11,40,44,-4,47
St Gallen,8964,4,14,5,13,44,54,-10,47
FC Zürich,8964,5,12,10,10,45,35,10,46
Grasshoppers,8964,6,9,6,17,39,50,-11,33
FC Thun,8964,7,9,6,17,43,59,-16,33
FC Lugano,8964,8,9,6,17,33,51,-18,33
FC Sion,8964,9,6,10,16,41,55,-14,28
Young Boys,8965,1,23,6,3,72,34,38,75
FC Basel,8965,2,15,9,8,51,31,20,54
St Gallen,8965,3,15,2,15,46,55,-9,47
Lucerne,8965,4,12,9,11,43,45,-2,45
FC Zürich,8965,5,10,10,12,39,39,0,40
FC Lugano,8965,6,11,5,16,31,47,-16,38
FC Thun,8965,7,10,7,15,47,57,-10,37
Grasshoppers,8965,8,9,8,15,45,48,-3,35
FC Sion,8965,9,7,8,17,43,61,-18,29
Young Boys,8966,1,22,7,3,74,35,39,73
FC Basel,8966,2,16,9,7,52,30,22,57
Lucerne,8966,3,13,9,10,45,45,0,48
FC Zürich,8966,4,11,10,11,43,38,5,43
St Gallen,8966,5,13,4,15,40,57,-17,43
Grasshoppers,8966,6,10,6,16,42,48,-6,36
FC Lugano,8966,7,9,7,16,30,48,-18,34
FC Thun,8966,8,9,6,17,43,57,-14,33
FC Sion,8966,9,8,8,16,42,53,-11,32
Young Boys,8967,1,23,6,3,71,32,39,75
FC Basel,8967,2,17,8,7,48,24,24,59
St Gallen,8967,3,16,2,14,43,52,-9,50
Lucerne,8967,4,13,7,12,39,40,-1,46
FC Zürich,8967,5,9,13,10,40,36,4,40
Grasshoppers,8967,6,11,6,15,43,49,-6,39
FC Thun,8967,7,10,6,16,43,56,-13,36
FC Lugano,8967,8,9,6,17,31,51,-20,33
FC Sion,8967,9,5,8,19,37,55,-18,23
Young Boys,8968,1,22,7,3,75,34,41,73
FC Basel,8968,2,16,8,8,53,29,24,56
Lucerne,8968,3,14,7,11,42,42,0,49
St Gallen,8968,4,15,3,14,46,56,-10,48
FC Zürich,8968,5,12,9,11,43,36,7,45
FC Lugano,8968,6,11,5,16,32,51,-19,38
FC Thun,8968,7,9,6,17,42,61,-19,33
FC Sion,8968,8,7,9,16,47,55,-8,30
Grasshoppers,8968,9,8,6,18,36,52,-16,30
Young Boys,8969,1,22,6,4,73,38,35,72
FC Basel,8969,2,17,8,7,56,25,31,59
St Gallen,8969,3,15,3,14,42,51,-9,48
Lucerne,8969,4,13,8,11,40,47,-7,47
FC Zürich,8969,5,11,11,10,40,34,6,44
FC Thun,8969,6,10,7,15,45,56,-11,37
Grasshoppers,8969,7,9,6,17,40,52,-12,33
FC Lugano,8969,8,9,6,17,27,46,-19,33
FC Sion,8969,9,6,9,17,38,52,-14,27
Young Boys,8970,1,20,8,4,71,37,34,68
FC Basel,8970,2,20,7,5,58,22,36,67
Lucerne,8970,3,12,9,11,42,45,-3,45
St Gallen,8970,4,13,4,15,43,57,-14,43
FC Zürich,8970,5,10,10,12,41,40,1,40
FC Thun,8970,6,11,5,16,49,60,-11,38
Grasshoppers,8970,7,9,7,16,42,52,-10,34
FC Lugano,8970,8,9,7,16,32,52,-20,34
FC Sion,8970,9,7,9,16,47,60,-13,30
Young Boys,8971,1,21,7,4,67,35,32,70
FC Basel,8971,2,18,9,5,52,23,29,63
Lucerne,8971,3,14,7,11,41,40,1,49
St Gallen,8971,4,14,3,15,45,56,-11,45
FC Zürich,8971,5,10,11,11,42,37,5,41
Grasshoppers,8971,6,10,6,16,40,48,-8,36
FC Lugano,8971,7,10,5,17,31,51,-20,35
FC Thun,8971,8,9,6,17,43,59,-16,33
FC Sion,8971,9,6,10,16,41,53,-12,28
Young Boys,8972,1,22,7,3,72,36,36,73
FC Basel,8972,2,16,8,8,52,30,22,56
St Gallen,8972,3,16,2,14,47,54,-7,50
FC Zürich,8972,4,12,9,11,42,34,8,45
Lucerne,8972,5,12,8,12,44,47,-3,44
FC Lugano,8972,6,11,5,16,32,49,-17,38
FC Thun,8972,7,10,6,16,48,55,-7,36
Grasshoppers,8972,8,9,8,15,43,55,-12,35
FC Sion,8972,9,6,7,19,38,58,-20,25
Young Boys,8973,1,21,7,4,71,35,36,70
FC Basel,8973,2,19,8,5,56,25,31,65
Lucerne,8973,3,13,7,12,45,47,-2,46
St Gallen,8973,4,14,4,14,43,54,-11,46
FC Zürich,8973,5,10,10,12,43,39,4,40
Grasshoppers,8973,6,11,7,14,45,49,-4,40
FC Lugano,8973,7,10,6,16,32,49,-17,36
FC Thun,8973,8,10,5,17,46,58,-12,35
FC Sion,8973,9,5,8,19,38,63,-25,23
Young Boys,8974,1,22,7,3,75,37,38,73
FC Basel,8974,2,20,7,5,57,23,34,67
FC Zürich,8974,3,12,9,11,44,36,8,45
Lucerne,8974,4,12,8,12,42,48,-6,44
St Gallen,8974,5,14,2,16,44,56,-12,44
Grasshoppers,8974,6,11,6,15,47,52,-5,39
FC Lugano,8974,7,9,7,16,30,50,-20,34
FC Thun,8974,8,9,5,18,41,60,-19,32
FC Sion,8974,9,6,7,19,41,59,-18,25
Young Boys,8975,1,20,6,6,67,38,29,66
FC Basel,8975,2,18,8,6,55,28,27,62
Lucerne,8975,3,14,8,10,43,42,1,50
St Gallen,8975,4,14,3,15,41,53,-12,45
FC Thun,8975,5,12,5,15,47,56,-9,41
FC Lugano,8975,6,11,6,15,32,47,-15,39
FC Zürich,8975,7,9,11,12,39,37,2,38
Grasshoppers,8975,8,9,7,16,40,49,-9,34
FC Sion,8975,9,6,8,18,41,55,-14,26
Young Boys,8976,1,22,6,4,72,35,37,72
FC Basel,8976,2,17,9,6,55,25,30,60
Lucerne,8976,3,13,7,12,43,48,-5,46
St Gallen,8976,4,14,3,15,44,57,-13,45
FC Zürich,8976,5,9,12,11,38,36,2,39
FC Lugano,8976,6,11,5,16,32,49,-17,38
Grasshoppers,8976,7,10,6,16,42,52,-10,36
FC Thun,8976,8,9,6,17,44,60,-16,33
FC Sion,8976,9,8,8,16,45,53,-8,32
Young Boys,8977,1,22,7,3,73,34,39,73
FC Basel,8977,2,18,8,6,56,25,31,62
Lucerne,8977,3,14,7,11,42,43,-1,49
St Gallen,8977,4,14,3,15,44,55,-11,45
FC Zürich,8977,5,10,10,12,40,37,3,40
FC Thun,8977,6,10,5,17,46,62,-16,35
Grasshoppers,8977,7,9,6,17,40,51,-11,33
FC Lugano,8977,8,9,6,17,30,54,-24,33
FC Sion,8977,9,8,8,16,43,53,-10,32
Young Boys,8978,1,22,6,4,69,33,36,72
FC Basel,8978,2,18,9,5,56,24,32,63
St Gallen,8978,3,15,3,14,46,53,-7,48
FC Zürich,8978,4,11,10,11,43,35,8,43
Lucerne,8978,5,11,7,14,38,51,-13,40
Grasshoppers,8978,6,11,6,15,40,45,-5,39
FC Lugano,8978,7,10,5,17,31,52,-21,35
FC Thun,8978,8,8,8,16,43,59,-16,32
FC Sion,8978,9,7,8,17,39,53,-14,29
Young Boys,8979,1,22,6,4,74,39,35,72
FC Basel,8979,2,16,8,8,56,29,27,56
Lucerne,8979,3,14,7,11,46,43,3,49
St Gallen,8979,4,15,3,14,47,56,-9,48
FC Zürich,8979,5,12,10,10,42,33,9,46
Grasshoppers,8979,6,10,6,16,42,51,-9,36
FC Lugano,8979,7,10,5,17,30,48,-18,35
FC Sion,8979,8,8,7,17,41,55,-14,31
FC Thun,8979,9,8,6,18,40,64,-24,30
Young Boys,8980,1,19,9,4,67,38,29,66
FC Basel,8980,2,19,8,5,58,26,32,65
Lucerne,8980,3,13,8,11,41,43,-2,47
St Gallen,8980,4,15,2,15,47,56,-9,47
FC Zürich,8980,5,10,10,12,39,36,3,40
FC Thun,8980,6,10,6,16,43,57,-14,36
FC Lugano,8980,7,10,6,16,32,48,-16,36
Grasshoppers,8980,8,9,7,16,38,48,-10,34
FC Sion,8980,9,7,8,17,40,53,-13,29
Young Boys,8981,1,22,6,4,71,35,36,72
FC Basel,8981,2,18,7,7,51,25,26,61
St Gallen,8981,3,17,2,13,47,51,-4,53
FC Zürich,8981,4,12,9,11,46,37,9,45
Lucerne,8981,5,11,8,13,36,44,-8,41
FC Lugano,8981,6,11,5,16,36,50,-14,38
FC Thun,8981,7,10,6,16,43,57,-14,36
Grasshoppers,8981,8,8,9,15,40,50,-10,33
FC Sion,8981,9,5,8,19,38,59,-21,23
Young Boys,8982,1,23,7,2,74,34,40,76
FC Basel,8982,2,17,10,5,54,25,29,61
Lucerne,8982,3,13,9,10,41,41,0,48
St Gallen,8982,4,13,4,15,41,56,-15,43
FC Zürich,8982,5,10,11,11,40,36,4,41
FC Lugano,8982,6,11,5,16,31,46,-15,38
Grasshoppers,8982,7,9,7,16,40,49,-9,34
FC Thun,8982,8,9,7,16,44,57,-13,34
FC Sion,8982,9,5,8,19,40,61,-21,23
Young Boys,8983,1,24,6,2,74,31,43,78
FC Basel,8983,2,18,7,7,53,28,25,61
Lucerne,8983,3,13,7,12,43,45,-2,46
St Gallen,8983,4,14,3,15,45,57,-12,45
FC Zürich,8983,5,10,10,12,43,40,3,40
FC Thun,8983,6,11,5,16,47,58,-11,38
FC Lugano,8983,7,10,6,16,34,52,-18,36
Grasshoppers,8983,8,9,6,17,39,50,-11,33
FC Sion,8983,9,6,8,18,40,57,-17,26
Young Boys,8984,1,23,7,2,78,35,43,76
FC Basel,8984,2,18,8,6,61,29,32,62
Lucerne,8984,3,12,8,12,44,53,-9,44
St Gallen,8984,4,13,4,15,47,60,-13,43
FC Zürich,8984,5,10,11,11,40,36,4,41
FC Thun,8984,6,11,5,16,50,61,-11,38
FC Lugano,8984,7,10,6,16,33,51,-18,36
Grasshoppers,8984,8,9,6,17,42,55,-13,33
FC Sion,8984,9,6,9,17,41,56,-15,27
Young Boys,8985,1,20,6,6,72,39,33,66
FC Basel,8985,2,19,7,6,53,24,29,64
Lucerne,8985,3,13,8,11,41,42,-1,47
St Gallen,8985,4,14,3,15,40,53,-13,45
FC Zürich,8985,5,11,9,12,41,37,4,42
Grasshoppers,8985,6,11,7,14,44,47,-3,40
FC Lugano,8985,7,11,5,16,31,48,-17,38
FC Thun,8985,8,8,7,17,40,58,-18,31
FC Sion,8985,9,7,8,17,38,52,-14,29
Young Boys,8986,1,22,6,4,71,35,36,72
FC Basel,8986,2,18,8,6,53,26,27,62
Lucerne,8986,3,15,7,10,45,40,5,52
St Gallen,8986,4,15,3,14,42,53,-11,48
FC Zürich,8986,5,10,11,11,39,34,5,41
FC Lugano,8986,6,10,6,16,30,46,-16,36
Grasshoppers,8986,7,9,6,17,39,53,-14,33
FC Thun,8986,8,9,6,17,41,57,-16,33
FC Sion,8986,9,5,9,18,37,53,-16,24
Young Boys,8987,1,21,7,4,72,38,34,70
FC Basel,8987,2,17,7,8,51,28,23,58
Lucerne,8987,3,14,7,11,44,41,3,49
FC Zürich,8987,4,12,10,10,43,35,8,46
St Gallen,8987,5,14,3,15,42,55,-13,45
Grasshoppers,8987,6,10,7,15,41,48,-7,37
FC Thun,8987,7,10,5,17,43,58,-15,35
FC Lugano,8987,8,10,5,17,30,50,-20,35
FC Sion,8987,9,6,9,17,39,52,-13,27
Young Boys,8988,1,22,6,4,76,36,40,72
FC Basel,8988,2,17,9,6,52,25,27,60
St Gallen,8988,3,15,4,13,45,53,-8,49
Lucerne,8988,4,12,9,11,38,42,-4,45
FC Zürich,8988,5,10,10,12,39,38,1,40
FC Thun,8988,6,10,6,16,46,58,-12,36
FC Lugano,8988,7,9,8,15,31,48,-17,35
Grasshoppers,8988,8,9,7,16,40,50,-10,34
FC Sion,8988,9,6,9,17,38,55,-17,27
Young Boys,8989,1,21,7,4,73,34,39,70
FC Basel,8989,2,16,9,7,53,26,27,57
Lucerne,8989,3,13,9,10,43,44,-1,48
St Gallen,8989,4,14,3,15,41,53,-12,45
FC Zürich,8989,5,11,11,10,41,33,8,44
FC Lugano,8989,6,11,7,14,30,43,-13,40
FC Thun,8989,7,9,8,15,44,57,-13,35
Grasshoppers,8989,8,8,7,17,38,53,-15,31
FC Sion,8989,9,6,9,17,40,60,-20,27
Young Boys,8990,1,22,8,2,70,33,37,74
FC Basel,8990,2,18,9,5,56,25,31,63
Lucerne,8990,3,13,7,12,39,43,-4,46
St Gallen,8990,4,14,3,15,44,58,-14,45
FC Zürich,8990,5,9,11,12,41,39,2,38
FC Lugano,8990,6,10,6,16,33,47,-14,36
FC Thun,8990,7,10,5,17,43,59,-16,35
Grasshoppers,8990,8,9,7,16,41,50,-9,34
FC Sion,8990,9,7,8,17,45,58,-13,29
Young Boys,8991,1,23,7,2,75,32,43,76
FC Basel,8991,2,17,8,7,58,26,32,59
Lucerne,8991,3,13,8,11,46,51,-5,47
St Gallen,8991,4,13,4,15,42,58,-16,43
FC Zürich,8991,5,11,9,12,42,37,5,42
FC Lugano,8991,6,11,5,16,30,46,-16,38
Grasshoppers,8991,7,10,6,16,43,52,-9,36
FC Thun,8991,8,9,6,17,41,63,-22,33
FC Sion,8991,9,6,9,17,40,52,-12,27
Young Boys,8992,1,22,6,4,72,34,38,72
FC Basel,8992,2,18,7,7,55,27,28,61
St Gallen,8992,3,15,2,15,44,54,-10,47
FC Zürich,8992,4,12,10,10,46,39,7,46
Lucerne,8992,5,12,8,12,42,48,-6,44
FC Thun,8992,6,11,6,15,50,58,-8,39
FC Lugano,8992,7,10,5,17,28,47,-19,35
Grasshoppers,8992,8,8,8,16,39,52,-13,32
FC Sion,8992,9,6,8,18,41,58,-17,26
Young Boys,8993,1,21,8,3,71,35,36,71
FC Basel,8993,2,19,7,6,53,25,28,64
Lucerne,8993,3,14,8,10,48,43,5,50
St Gallen,8993,4,14,2,16,46,59,-13,44
FC Zürich,8993,5,11,10,11,41,36,5,43
FC Lugano,8993,6,10,6,16,34,52,-18,36
FC Sion,8993,7,8,8,16,43,53,-10,32
FC Thun,8993,8,9,5,18,43,59,-16,32
Grasshoppers,8993,9,8,6,18,38,55,-17,30
Young Boys,8994,1,24,6,2,76,33,43,78
FC Basel,8994,2,18,7,7,56,28,28,61
Lucerne,8994,3,13,7,12,41,45,-4,46
St Gallen,8994,4,13,3,16,40,58,-18,42
FC Zürich,8994,5,10,10,12,41,38,3,40
FC Lugano,8994,6,10,6,16,32,50,-18,36
Grasshoppers,8994,7,9,7,16,40,49,-9,34
FC Sion,8994,8,8,8,16,45,53,-8,32
FC Thun,8994,9,8,8,16,41,58,-17,32
Young Boys,8995,1,21,6,5,68,37,31,69
FC Basel,8995,2,19,7,6,54,24,30,64
Lucerne,8995,3,13,8,11,40,41,-1,47
St Gallen,8995,4,13,3,16,41,57,-16,42
FC Lugano,8995,5,12,5,15,35,47,-12,41
FC Zürich,8995,6,10,9,13,40,40,0,39
Grasshoppers,8995,7,10,6,16,43,51,-8,36
FC Thun,8995,8,10,5,17,46,59,-13,35
FC Sion,8995,9,8,7,17,44,55,-11,31
Young Boys,8996,1,21,7,4,72,39,33,70
FC Basel,8996,2,19,7,6,57,28,29,64
Lucerne,8996,3,13,8,11,43,44,-1,47
St Gallen,8996,4,14,3,15,42,56,-14,45
FC Zürich,8996,5,10,10,12,40,36,4,40
FC Thun,8996,6,11,5,16,45,57,-12,38
FC Lugano,8996,7,10,8,14,34,47,-13,38
Grasshoppers,8996,8,8,7,17,41,52,-11,31
FC Sion,8996,9,7,7,18,39,54,-15,28
Young Boys,8997,1,22,7,3,73,36,37,73
FC Basel,8997,2,19,7,6,58,27,31,64
Lucerne,8997,3,13,7,12,43,48,-5,46
St Gallen,8997,4,14,2,16,44,59,-15,44
FC Zürich,8997,5,11,9,12,42,40,2,42
FC Lugano,8997,6,11,6,15,37,49,-12,39
FC Thun,8997,7,10,5,17,47,59,-12,35
Grasshoppers,8997,8,9,6,17,41,53,-12,33
FC Sion,8997,9,7,7,18,39,53,-14,28
Young Boys,8998,1,23,6,3,73,33,40,75
FC Basel,8998,2,18,8,6,57,28,29,62
St Gallen,8998,3,15,2,15,46,60,-14,47
FC Zürich,8998,4,11,9,12,40,37,3,42
Lucerne,8998,5,11,7,14,39,46,-7,40
FC Lugano,8998,6,11,5,16,34,50,-16,38
FC Thun,8998,7,10,7,15,45,57,-12,37
Grasshoppers,8998,8,10,6,16,41,49,-8,36
FC Sion,8998,9,6,8,18,43,58,-15,26
Young Boys,8999,1,21,7,4,74,35,39,70
FC Basel,8999,2,18,7,7,53,30,23,61
St Gallen,8999,3,15,2,15,43,56,-13,47
Lucerne,8999,4,11,9,12,39,46,-7,42
FC Thun,8999,5,12,5,15,48,58,-10,41
FC Zürich,8999,6,10,10,12,42,39,3,40
Grasshoppers,8999,7,10,7,15,42,49,-7,37
FC Lugano,8999,8,9,7,16,29,47,-18,34
FC Sion,8999,9,7,8,17,47,57,-10,29
Young Boys,9000,1,22,7,3,73,34,39,73
FC Basel,9000,2,17,10,5,56,27,29,61
St Gallen,9000,3,13,6,13,43,54,-11,45
Lucerne,9000,4,11,9,12,43,50,-7,42
FC Zürich,9000,5,9,12,11,43,40,3,39
FC Lugano,9000,6,11,6,15,32,47,-15,39
Grasshoppers,9000,7,10,8,14,43,47,-4,38
FC Thun,9000,8,9,7,16,46,59,-13,34
FC Sion,9000,9,5,9,18,38,59,-21,24
Young Boys,9001,1,22,7,3,80,36,44,73
FC Basel,9001,2,16,9,7,51,27,24,57
St Gallen,9001,3,15,3,14,44,56,-12,48
Lucerne,9001,4,13,8,11,44,52,-8,47
FC Zürich,9001,5,12,10,10,47,36,11,46
Grasshoppers,9001,6,10,7,15,43,49,-6,37
FC Lugano,9001,7,9,6,17,32,50,-18,33
FC Thun,9001,8,9,5,18,41,60,-19,32
FC Sion,9001,9,6,9,17,44,60,-16,27
Young Boys,9002,1,21,8,3,74,35,39,71
FC Basel,9002,2,17,10,5,57,29,28,61
Lucerne,9002,3,13,8,11,43,44,-1,47
St Gallen,9002,4,13,6,13,47,58,-11,45
FC Zürich,9002,5,9,11,12,38,36,2,38
FC Thun,9002,6,10,6,16,45,59,-14,36
FC Lugano,9002,7,10,6,16,30,52,-22,36
Grasshoppers,9002,8,9,7,16,40,48,-8,34
FC Sion,9002,9,6,10,16,40,53,-13,28
Young Boys,9003,1,23,7,2,79,32,47,76
FC Basel,9003,2,17,8,7,52,28,24,59
St Gallen,9003,3,15,2,15,46,56,-10,47
Lucerne,9003,4,11,9,12,39,44,-5,42
FC Zürich,9003,5,10,10,12,41,40,1,40
Grasshoppers,9003,6,11,6,15,45,49,-4,39
FC Lugano,9003,7,11,5,16,33,53,-20,38
FC Thun,9003,8,10,5,17,43,60,-17,35
FC Sion,9003,9,6,8,18,41,57,-16,26
Young Boys,9004,1,21,8,3,73,35,38,71
FC Basel,9004,2,18,8,6,53,26,27,62
St Gallen,9004,3,15,3,14,45,53,-8,48
Lucerne,9004,4,12,9,11,40,45,-5,45
FC Zürich,9004,5,11,10,11,46,40,6,43
FC Thun,9004,6,10,6,16,44,58,-14,36
FC Lugano,9004,7,10,6,16,32,50,-18,36
Grasshoppers,9004,8,9,7,16,39,48,-9,34
FC Sion,9004,9,5,9,18,37,54,-17,24
Young Boys,9005,1,21,7,4,71,34,37,70
FC Basel,9005,2,17,8,7,51,25,26,59
St Gallen,9005,3,15,3,14,41,53,-12,48
Lucerne,9005,4,13,8,11,40,42,-2,47
FC Zürich,9005,5,12,9,11,44,34,10,45
FC Lugano,9005,6,11,5,16,33,49,-16,38
Grasshoppers,9005,7,9,8,15,41,47,-6,35
FC Thun,9005,8,9,6,17,41,57,-16,33
FC Sion,9005,9,5,10,17,37,58,-21,25
FC Basel,9006,1,19,8,5,62,30,32,65
Young Boys,9006,2,19,8,5,68,42,26,65
Lucerne,9006,3,12,9,11,41,43,-2,45
St Gallen,9006,4,14,3,15,45,57,-12,45
FC Zürich,9006,5,11,9,12,44,36,8,42
FC Lugano,9006,6,12,6,14,34,45,-11,42
Grasshoppers,9006,7,11,7,14,45,45,0,40
FC Thun,9006,8,8,6,18,43,67,-24,30
FC Sion,9006,9,6,8,18,40,57,-17,26
Young Boys,9007,1,21,7,4,78,45,33,70
FC Basel,9007,2,17,10,5,60,30,30,61
Lucerne,9007,3,14,7,11,44,42,2,49
St Gallen,9007,4,13,5,14,40,53,-13,44
FC Lugano,9007,5,11,7,14,32,45,-13,40
FC Thun,9007,6,11,6,15,44,55,-11,39
FC Zürich,9007,7,9,11,12,39,37,2,38
Grasshoppers,9007,8,9,6,17,38,51,-13,33
FC Sion,9007,9,5,9,18,39,56,-17,24
Young Boys,9008,1,22,6,4,72,35,37,72
FC Basel,9008,2,17,8,7,50,26,24,59
St Gallen,9008,3,15,4,13,45,53,-8,49
FC Zürich,9008,4,11,10,11,42,35,7,43
Lucerne,9008,5,11,9,12,43,50,-7,42
Grasshoppers,9008,6,11,7,14,45,47,-2,40
FC Lugano,9008,7,10,5,17,32,50,-18,35
FC Thun,9008,8,8,7,17,41,58,-17,31
FC Sion,9008,9,7,8,17,39,55,-16,29
Young Boys,9009,1,20,8,4,72,40,32,68
FC Basel,9009,2,18,9,5,57,27,30,63
Lucerne,9009,3,13,9,10,42,41,1,48
St Gallen,9009,4,15,3,14,44,54,-10,48
FC Zürich,9009,5,11,10,11,39,35,4,43
FC Lugano,9009,6,11,6,15,31,46,-15,39
Grasshoppers,9009,7,10,6,16,45,50,-5,36
FC Thun,9009,8,9,5,18,44,61,-17,32
FC Sion,9009,9,5,8,19,37,57,-20,23
Young Boys,9010,1,21,8,3,71,36,35,71
FC Basel,9010,2,18,9,5,53,23,30,63
Lucerne,9010,3,13,8,11,42,41,1,47
St Gallen,9010,4,14,4,14,44,56,-12,46
FC Zürich,9010,5,10,12,10,40,34,6,42
FC Lugano,9010,6,10,7,15,33,48,-15,37
Grasshoppers,9010,7,10,6,16,42,49,-7,36
FC Thun,9010,8,8,6,18,40,63,-23,30
FC Sion,9010,9,6,8,18,38,53,-15,26
Young Boys,9011,1,21,9,2,69,33,36,72
FC Basel,9011,2,18,8,6,58,23,35,62
Lucerne,9011,3,12,8,12,40,50,-10,44
FC Zürich,9011,4,11,10,11,44,36,8,43
St Gallen,9011,5,13,2,17,40,56,-16,41
FC Lugano,9011,6,11,6,15,33,47,-14,39
FC Thun,9011,7,10,5,17,44,58,-14,35
Grasshoppers,9011,8,8,8,16,40,52,-12,32
FC Sion,9011,9,8,8,16,40,53,-13,32
Young Boys,9012,1,21,6,5,70,39,31,69
FC Basel,9012,2,17,7,8,53,29,24,58
Lucerne,9012,3,14,8,10,41,40,1,50
St Gallen,9012,4,15,3,14,45,54,-9,48
FC Zürich,9012,5,10,10,12,43,36,7,40
FC Thun,9012,6,11,5,16,44,57,-13,38
Grasshoppers,9012,7,9,7,16,41,49,-8,34
FC Lugano,9012,8,9,6,17,28,50,-22,33
FC Sion,9012,9,8,8,16,41,52,-11,32
Young Boys,9013,1,21,8,3,71,37,34,71
FC Basel,9013,2,17,7,8,55,30,25,58
FC Zürich,9013,3,13,9,10,47,36,11,48
Lucerne,9013,4,13,8,11,43,45,-2,47
St Gallen,9013,5,15,2,15,44,57,-13,47
FC Lugano,9013,6,11,5,16,33,46,-13,38
FC Thun,9013,7,10,5,17,43,58,-15,35
Grasshoppers,9013,8,9,6,17,40,52,-12,33
FC Sion,9013,9,6,8,18,41,56,-15,26
Young Boys,9014,1,22,8,2,74,34,40,74
FC Basel,9014,2,17,7,8,53,28,25,58
Lucerne,9014,3,12,10,10,40,43,-3,46
St Gallen,9014,4,14,3,15,42,55,-13,45
FC Zürich,9014,5,11,11,10,43,36,7,44
FC Lugano,9014,6,10,6,16,32,49,-17,36
FC Thun,9014,7,9,6,17,44,62,-18,33
FC Sion,9014,8,8,8,16,46,53,-7,32
Grasshoppers,9014,9,8,7,17,40,54,-14,31
Young Boys,9015,1,20,9,3,71,35,36,69
FC Basel,9015,2,18,9,5,56,25,31,63
Lucerne,9015,3,14,8,10,41,40,1,50
St Gallen,9015,4,14,2,16,40,54,-14,44
FC Zürich,9015,5,10,10,12,40,37,3,40
FC Lugano,9015,6,11,5,16,30,46,-16,38
Grasshoppers,9015,7,10,7,15,43,48,-5,37
FC Thun,9015,8,9,5,18,41,61,-20,32
FC Sion,9015,9,7,7,18,40,56,-16,28
Young Boys,9016,1,22,7,3,75,37,38,73
FC Basel,9016,2,18,7,7,57,29,28,61
St Gallen,9016,3,15,3,14,43,55,-12,48
FC Zürich,9016,4,11,10,11,44,38,6,43
Lucerne,9016,5,11,8,13,39,48,-9,41
Grasshoppers,9016,6,11,6,15,45,47,-2,39
FC Thun,9016,7,10,5,17,45,59,-14,35
FC Lugano,9016,8,9,8,15,32,50,-18,35
FC Sion,9016,9,6,8,18,39,56,-17,26
Young Boys,9017,1,22,7,3,70,34,36,73
FC Basel,9017,2,17,9,6,51,24,27,60
St Gallen,9017,3,16,3,13,48,54,-6,51
FC Zürich,9017,4,11,10,11,42,34,8,43
Lucerne,9017,5,11,8,13,40,49,-9,41
FC Lugano,9017,6,11,6,15,32,45,-13,39
Grasshoppers,9017,7,10,6,16,41,48,-7,36
FC Thun,9017,8,10,5,17,44,58,-14,35
FC Sion,9017,9,5,8,19,39,61,-22,23
Young Boys,9018,1,23,7,2,74,36,38,76
FC Basel,9018,2,16,9,7,55,31,24,57
Lucerne,9018,3,14,9,9,53,46,7,51
FC Zürich,9018,4,12,10,10,46,38,8,46
St Gallen,9018,5,13,4,15,44,58,-14,43
FC Lugano,9018,6,10,5,17,31,53,-22,35
Grasshoppers,9018,7,9,6,17,41,51,-10,33
FC Thun,9018,8,8,6,18,41,59,-18,30
FC Sion,9018,9,7,8,17,44,57,-13,29
Young Boys,9019,1,21,7,4,71,37,34,70
FC Basel,9019,2,19,7,6,57,27,30,64
Lucerne,9019,3,14,8,10,40,42,-2,50
St Gallen,9019,4,14,3,15,40,54,-14,45
FC Zürich,9019,5,9,11,12,40,40,0,38
FC Lugano,9019,6,10,7,15,35,48,-13,37
Grasshoppers,9019,7,9,8,15,40,47,-7,35
FC Thun,9019,8,9,7,16,46,59,-13,34
FC Sion,9019,9,5,10,17,37,52,-15,25
Young Boys,9020,1,20,8,4,67,35,32,68
FC Basel,9020,2,17,9,6,53,26,27,60
St Gallen,9020,3,15,3,14,47,55,-8,48
Lucerne,9020,4,13,8,11,44,46,-2,47
FC Zürich,9020,5,11,10,11,39,34,5,43
FC Lugano,9020,6,11,6,15,33,47,-14,39
Grasshoppers,9020,7,9,8,15,45,51,-6,35
FC Thun,9020,8,8,7,17,42,62,-20,31
FC Sion,9020,9,5,11,16,43,57,-14,26
Young Boys,9021,1,23,7,2,76,35,41,76
FC Basel,9021,2,17,8,7,57,31,26,59
FC Zürich,9021,3,12,10,10,43,35,8,46
Lucerne,9021,4,12,10,10,44,46,-2,46
St Gallen,9021,5,13,4,15,43,58,-15,43
Grasshoppers,9021,6,10,6,16,44,50,-6,36
FC Lugano,9021,7,10,5,17,32,49,-17,35
FC Thun,9021,8,9,7,16,46,61,-15,34
FC Sion,9021,9,5,9,18,37,57,-20,24
Young Boys,9022,1,21,9,2,70,30,40,72
FC Basel,9022,2,18,7,7,54,28,26,61
Lucerne,9022,3,13,8,11,43,48,-5,47
FC Zürich,9022,4,11,10,11,40,35,5,43
St Gallen,9022,5,13,3,16,43,58,-15,42
FC Thun,9022,6,11,5,16,47,59,-12,38
FC Lugano,9022,7,9,8,15,31,48,-17,35
Grasshoppers,9022,8,9,7,16,43,51,-8,34
FC Sion,9022,9,6,9,17,37,51,-14,27
Young Boys,9023,1,22,7,3,77,37,40,73
FC Basel,9023,2,19,7,6,61,24,37,64
St Gallen,9023,3,15,3,14,43,54,-11,48
Lucerne,9023,4,12,9,11,40,48,-8,45
FC Zürich,9023,5,10,9,13,43,41,2,39
Grasshoppers,9023,6,10,6,16,45,52,-7,36
FC Thun,9023,7,10,5,17,46,63,-17,35
FC Lugano,9023,8,9,5,18,30,56,-26,32
FC Sion,9023,9,8,7,17,44,54,-10,31
Young Boys,9024,1,23,7,2,73,34,39,76
FC Basel,9024,2,15,10,7,53,30,23,55
Lucerne,9024,3,14,8,10,48,42,6,50
St Gallen,9024,4,16,2,14,43,54,-11,50
FC Zürich,9024,5,10,11,11,42,36,6,41
FC Thun,9024,6,11,6,15,45,55,-10,39
Grasshoppers,9024,7,9,7,16,41,55,-14,34
FC Lugano,9024,8,9,6,17,30,48,-18,33
FC Sion,9024,9,5,7,20,38,59,-21,22
Young Boys,9025,1,22,6,4,67,32,35,72
FC Basel,9025,2,19,7,6,58,25,33,64
Lucerne,9025,3,15,7,10,52,46,6,52
St Gallen,9025,4,13,3,16,42,60,-18,42
FC Zürich,9025,5,10,10,12,44,38,6,40
FC Lugano,9025,6,11,5,16,34,49,-15,38
FC Thun,9025,7,10,6,16,45,57,-12,36
Grasshoppers,9025,8,9,7,16,40,53,-13,34
FC Sion,9025,9,5,9,18,38,60,-22,24
Young Boys,9026,1,22,6,4,74,38,36,72
FC Basel,9026,2,17,7,8,55,27,28,58
Lucerne,9026,3,13,7,12,42,48,-6,46
St Gallen,9026,4,14,2,16,41,55,-14,44
FC Zürich,9026,5,11,10,11,40,35,5,43
FC Thun,9026,6,12,5,15,50,55,-5,41
FC Lugano,9026,7,11,6,15,31,47,-16,39
Grasshoppers,9026,8,10,6,16,46,52,-6,36
FC Sion,9026,9,6,7,19,38,60,-22,25
Young Boys,9027,1,20,8,4,70,39,31,68
FC Basel,9027,2,20,7,5,55,23,32,67
Lucerne,9027,3,13,8,11,43,44,-1,47
St Gallen,9027,4,14,2,16,42,55,-13,44
FC Zürich,9027,5,11,9,12,42,36,6,42
FC Lugano,9027,6,11,7,14,38,49,-11,40
Grasshoppers,9027,7,11,6,15,44,49,-5,39
FC Thun,9027,8,8,5,19,38,58,-20,29
FC Sion,9027,9,6,8,18,40,59,-19,26
Young Boys,9028,1,20,9,3,71,37,34,69
FC Basel,9028,2,19,7,6,55,25,30,64
Lucerne,9028,3,14,9,9,45,40,5,51
St Gallen,9028,4,14,4,14,40,52,-12,46
FC Zürich,9028,5,10,10,12,40,37,3,40
FC Thun,9028,6,10,6,16,50,61,-11,36
FC Lugano,9028,7,10,6,16,32,50,-18,36
Grasshoppers,9028,8,9,7,16,42,49,-7,34
FC Sion,9028,9,5,8,19,38,62,-24,23
Young Boys,9029,1,21,6,5,72,36,36,69
FC Basel,9029,2,19,7,6,57,25,32,64
St Gallen,9029,3,14,4,14,44,55,-11,46
Lucerne,9029,4,12,8,12,42,48,-6,44
FC Zürich,9029,5,10,9,13,41,41,0,39
FC Lugano,9029,6,11,6,15,31,49,-18,39
FC Thun,9029,7,10,6,16,47,61,-14,36
Grasshoppers,9029,8,9,7,16,42,51,-9,34
FC Sion,9029,9,8,7,17,44,54,-10,31
Young Boys,9030,1,21,7,4,71,35,36,70
FC Basel,9030,2,18,8,6,54,27,27,62
Lucerne,9030,3,13,8,11,42,47,-5,47
St Gallen,9030,4,15,2,15,45,52,-7,47
FC Zürich,9030,5,11,11,10,40,33,7,44
Grasshoppers,9030,6,10,8,14,44,47,-3,38
FC Lugano,9030,7,9,6,17,29,48,-19,33
FC Sion,9030,8,8,7,17,41,56,-15,31
FC Thun,9030,9,8,5,19,43,64,-21,29
Young Boys,9031,1,21,8,3,74,33,41,71
FC Basel,9031,2,16,9,7,50,26,24,57
FC Zürich,9031,3,13,9,10,46,35,11,48
St Gallen,9031,4,15,2,15,48,55,-7,47
Lucerne,9031,5,12,9,11,39,47,-8,45
Grasshoppers,9031,6,11,7,14,43,46,-3,40
FC Lugano,9031,7,10,5,17,32,53,-21,35
FC Sion,9031,8,7,8,17,39,55,-16,29
FC Thun,9031,9,8,5,19,41,62,-21,29
Young Boys,9032,1,22,7,3,69,34,35,73
FC Basel,9032,2,17,8,7,56,26,30,59
St Gallen,9032,3,15,4,13,45,53,-8,49
Lucerne,9032,4,13,8,11,40,41,-1,47
FC Zürich,9032,5,11,10,11,43,36,7,43
Grasshoppers,9032,6,9,7,16,39,49,-10,34
FC Thun,9032,7,9,7,16,42,60,-18,34
FC Lugano,9032,8,9,7,16,29,48,-19,34
FC Sion,9032,9,5,10,17,37,53,-16,25
Young Boys,9033,1,22,7,3,78,39,39,73
FC Basel,9033,2,19,8,5,64,28,36,65
Lucerne,9033,3,12,10,10,47,47,0,46
St Gallen,9033,4,13,4,15,41,57,-16,43
FC Zürich,9033,5,10,9,13,41,39,2,39
FC Lugano,9033,6,11,5,16,31,50,-19,38
FC Thun,9033,7,10,5,17,41,58,-17,35
Grasshoppers,9033,8,8,9,15,43,52,-9,33
FC Sion,9033,9,6,9,17,40,56,-16,27
Young Boys,9034,1,21,6,5,73,41,32,69
FC Basel,9034,2,18,8,6,55,24,31,62
St Gallen,9034,3,15,3,14,44,51,-7,48
FC Zürich,9034,4,11,10,11,42,34,8,43
Lucerne,9034,5,11,8,13,39,50,-11,41
Grasshoppers,9034,6,11,7,14,46,47,-1,40
FC Thun,9034,7,10,5,17,45,62,-17,35
FC Lugano,9034,8,9,7,16,29,48,-19,34
FC Sion,9034,9,7,8,17,39,55,-16,29
Young Boys,9035,1,22,6,4,73,34,39,72
FC Basel,9035,2,17,7,8,54,29,25,58
St Gallen,9035,3,15,3,14,44,53,-9,48
Lucerne,9035,4,12,7,13,40,46,-6,43
FC Zürich,9035,5,11,9,12,40,35,5,42
Grasshoppers,9035,6,11,7,14,41,45,-4,40
FC Thun,9035,7,10,6,16,43,56,-13,36
FC Lugano,9035,8,10,6,16,29,49,-20,36
FC Sion,9035,9,7,7,18,37,54,-17,28
Young Boys,9036,1,22,6,4,70,35,35,72
FC Basel,9036,2,20,7,5,59,22,37,67
Lucerne,9036,3,14,7,11,44,42,2,49
FC Zürich,9036,4,12,9,11,45,35,10,45
St Gallen,9036,5,13,4,15,40,54,-14,43
Grasshoppers,9036,6,9,6,17,37,49,-12,33
FC Thun,9036,7,9,6,17,44,62,-18,33
FC Lugano,9036,8,9,6,17,27,50,-23,33
FC Sion,9036,9,6,9,17,39,56,-17,27
Young Boys,9037,1,21,7,4,68,35,33,70
FC Basel,9037,2,17,9,6,52,25,27,60
Lucerne,9037,3,13,9,10,42,38,4,48
FC Zürich,9037,4,11,11,10,44,36,8,44
St Gallen,9037,5,13,4,15,40,55,-15,43
FC Lugano,9037,6,10,6,16,30,50,-20,36
Grasshoppers,9037,7,9,8,15,38,46,-8,35
FC Thun,9037,8,8,8,16,41,58,-17,32
FC Sion,9037,9,6,10,16,41,53,-12,28
Young Boys,9038,1,22,7,3,69,34,35,73
FC Basel,9038,2,18,8,6,55,23,32,62
Lucerne,9038,3,14,7,11,40,40,0,49
St Gallen,9038,4,13,2,17,39,58,-19,41
FC Zürich,9038,5,10,10,12,40,35,5,40
FC Lugano,9038,6,11,5,16,30,49,-19,38
FC Thun,9038,7,10,5,17,44,59,-15,35
FC Sion,9038,8,8,8,16,42,50,-8,32
Grasshoppers,9038,9,8,8,16,38,49,-11,32
Young Boys,9039,1,21,7,4,71,35,36,70
FC Basel,9039,2,17,8,7,53,32,21,59
St Gallen,9039,3,15,3,14,46,55,-9,48
FC Zürich,9039,4,12,9,11,46,37,9,45
Lucerne,9039,5,12,8,12,43,45,-2,44
Grasshoppers,9039,6,10,6,16,42,50,-8,36
FC Thun,9039,7,10,6,16,44,57,-13,36
FC Lugano,9039,8,10,6,16,35,50,-15,36
FC Sion,9039,9,7,7,18,39,58,-19,28
Young Boys,9040,1,23,7,2,75,35,40,76
FC Basel,9040,2,18,7,7,52,25,27,61
Lucerne,9040,3,14,8,10,45,42,3,50
St Gallen,9040,4,13,3,16,41,55,-14,42
FC Zürich,9040,5,9,11,12,38,38,0,38
Grasshoppers,9040,6,10,6,16,39,50,-11,36
FC Lugano,9040,7,9,8,15,32,48,-16,35
FC Thun,9040,8,9,6,17,42,58,-16,33
FC Sion,9040,9,6,10,16,39,52,-13,28
Young Boys,9041,1,23,7,2,75,31,44,76
FC Basel,9041,2,16,10,6,51,25,26,58
St Gallen,9041,3,14,4,14,41,53,-12,46
Lucerne,9041,4,11,10,11,41,46,-5,43
FC Zürich,9041,5,10,11,11,42,38,4,41
FC Lugano,9041,6,11,6,15,32,49,-17,39
Grasshoppers,9041,7,10,8,14,45,48,-3,38
FC Thun,9041,8,9,7,16,43,58,-15,34
FC Sion,9041,9,5,7,20,36,58,-22,22
Young Boys,9042,1,21,8,3,77,41,36,71
FC Basel,9042,2,16,10,6,56,29,27,58
St Gallen,9042,3,15,3,14,44,55,-11,48
FC Zürich,9042,4,10,12,10,38,33,5,42
Grasshoppers,9042,5,12,6,14,49,46,3,42
Lucerne,9042,6,11,8,13,41,50,-9,41
FC Lugano,9042,7,10,6,16,33,47,-14,36
FC Thun,9042,8,10,6,16,41,61,-20,36
FC Sion,9042,9,5,9,18,37,54,-17,24
Young Boys,9043,1,20,7,5,68,37,31,67
FC Basel,9043,2,19,8,5,58,24,34,65
St Gallen,9043,3,14,4,14,42,53,-11,46
Lucerne,9043,4,12,9,11,39,44,-5,45
FC Zürich,9043,5,11,10,11,46,40,6,43
Grasshoppers,9043,6,11,6,15,46,51,-5,39
FC Lugano,9043,7,10,6,16,32,47,-15,36
FC Thun,9043,8,10,5,17,49,67,-18,35
FC Sion,9043,9,5,9,18,39,56,-17,24
Young Boys,9044,1,21,7,4,71,35,36,70
FC Basel,9044,2,19,8,5,58,22,36,65
St Gallen,9044,3,14,2,16,42,56,-14,44
Lucerne,9044,4,11,10,11,44,47,-3,43
FC Zürich,9044,5,10,10,12,41,41,0,40
FC Lugano,9044,6,11,6,15,35,52,-17,39
FC Sion,9044,7,9,7,16,44,53,-9,34
Grasshoppers,9044,8,9,7,16,40,50,-10,34
FC Thun,9044,9,9,5,18,46,65,-19,32
Young Boys,9045,1,21,7,4,70,36,34,70
FC Basel,9045,2,18,7,7,53,28,25,61
St Gallen,9045,3,14,3,15,43,55,-12,45
Lucerne,9045,4,11,9,12,39,45,-6,42
FC Lugano,9045,5,12,5,15,34,45,-11,41
FC Zürich,9045,6,10,10,12,40,37,3,40
FC Thun,9045,7,10,7,15,42,54,-12,37
Grasshoppers,9045,8,9,9,14,39,46,-7,36
FC Sion,9045,9,7,7,18,42,56,-14,28
Young Boys,9046,1,21,7,4,71,36,35,70
FC Basel,9046,2,19,8,5,60,25,35,65
Lucerne,9046,3,12,10,10,40,42,-2,46
St Gallen,9046,4,13,4,15,41,56,-15,43
FC Zürich,9046,5,10,11,11,38,35,3,41
Grasshoppers,9046,6,10,7,15,42,49,-7,37
FC Lugano,9046,7,10,6,16,32,46,-14,36
FC Sion,9046,8,8,8,16,40,52,-12,32
FC Thun,9046,9,8,5,19,40,63,-23,29
Young Boys,9047,1,21,7,4,68,38,30,70
FC Basel,9047,2,18,9,5,57,24,33,63
Lucerne,9047,3,14,7,11,46,42,4,49
St Gallen,9047,4,14,4,14,43,53,-10,46
FC Zürich,9047,5,10,12,10,42,37,5,42
FC Lugano,9047,6,10,5,17,29,46,-17,35
FC Thun,9047,7,9,7,16,45,63,-18,34
Grasshoppers,9047,8,8,6,18,37,54,-17,30
FC Sion,9047,9,6,11,15,43,53,-10,29
Young Boys,9048,1,21,6,5,74,41,33,69
FC Basel,9048,2,18,8,6,55,25,30,62
Lucerne,9048,3,14,7,11,47,45,2,49
St Gallen,9048,4,15,2,15,46,55,-9,47
FC Zürich,9048,5,10,12,10,39,34,5,42
Grasshoppers,9048,6,10,6,16,41,51,-10,36
FC Thun,9048,7,9,7,16,45,61,-16,34
FC Lugano,9048,8,9,5,18,31,55,-24,32
FC Sion,9048,9,7,9,16,45,56,-11,30
Young Boys,9049,1,22,8,2,73,35,38,74
FC Basel,9049,2,18,7,7,50,24,26,61
St Gallen,9049,3,15,2,15,42,53,-11,47
Lucerne,9049,4,12,8,12,40,43,-3,44
FC Zürich,9049,5,9,10,13,41,43,-2,37
FC Lugano,9049,6,10,7,15,30,46,-16,37
Grasshoppers,9049,7,9,8,15,44,52,-8,35
FC Thun,9049,8,10,5,17,47,59,-12,35
FC Sion,9049,9,7,9,16,43,55,-12,30
Young Boys,9050,1,21,8,3,72,36,36,71
FC Basel,9050,2,18,9,5,54,23,31,63
Lucerne,9050,3,12,9,11,46,48,-2,45
St Gallen,9050,4,14,3,15,44,56,-12,45
FC Zürich,9050,5,10,10,12,40,37,3,40
FC Thun,9050,6,11,5,16,46,61,-15,38
Grasshoppers,9050,7,9,8,15,44,50,-6,35
FC Lugano,9050,8,10,5,17,30,49,-19,35
FC Sion,9050,9,6,9,17,40,56,-16,27
Young Boys,9051,1,21,7,4,69,34,35,70
FC Basel,9051,2,16,8,8,53,30,23,56
Lucerne,9051,3,14,8,10,49,45,4,50
St Gallen,9051,4,16,2,14,45,54,-9,50
FC Zürich,9051,5,11,10,11,41,35,6,43
FC Lugano,9051,6,11,5,16,34,49,-15,38
Grasshoppers,9051,7,8,9,15,40,49,-9,33
FC Thun,9051,8,9,6,17,43,62,-19,33
FC Sion,9051,9,6,9,17,39,55,-16,27
Young Boys,9052,1,22,6,4,73,38,35,72
FC Basel,9052,2,18,8,6,55,24,31,62
St Gallen,9052,3,15,3,14,42,53,-11,48
FC Zürich,9052,4,11,10,11,41,37,4,43
Lucerne,9052,5,12,7,13,41,48,-7,43
Grasshoppers,9052,6,10,7,15,42,50,-8,37
FC Thun,9052,7,10,6,16,45,57,-12,36
FC Lugano,9052,8,9,5,18,29,50,-21,32
FC Sion,9052,9,6,10,16,44,55,-11,28
Young Boys,9053,1,21,8,3,78,36,42,71
FC Basel,9053,2,18,7,7,54,28,26,61
St Gallen,9053,3,16,2,14,46,52,-6,50
Lucerne,9053,4,11,8,13,39,49,-10,41
FC Zürich,9053,5,10,10,12,40,36,4,40
Grasshoppers,9053,6,10,7,15,42,49,-7,37
FC Thun,9053,7,10,6,16,46,57,-11,36
FC Lugano,9053,8,10,5,17,29,54,-25,35
FC Sion,9053,9,7,9,16,42,55,-13,30
Young Boys,9054,1,22,8,2,73,34,39,74
FC Basel,9054,2,17,8,7,53,29,24,59
Lucerne,9054,3,14,8,10,51,45,6,50
St Gallen,9054,4,14,3,15,43,54,-11,45
FC Zürich,9054,5,9,11,12,39,38,1,38
Grasshoppers,9054,6,10,7,15,45,51,-6,37
FC Lugano,9054,7,10,7,15,32,48,-16,37
FC Thun,9054,8,9,5,18,39,59,-20,32
FC Sion,9054,9,6,9,17,39,56,-17,27
Young Boys,9055,1,21,9,2,74,36,38,72
FC Basel,9055,2,16,8,8,54,30,24,56
Lucerne,9055,3,12,9,11,44,47,-3,45
St Gallen,9055,4,14,3,15,45,58,-13,45
FC Zürich,9055,5,11,11,10,38,32,6,44
FC Lugano,9055,6,11,6,15,32,46,-14,39
Grasshoppers,9055,7,9,9,14,42,48,-6,36
FC Sion,9055,8,7,9,16,43,54,-11,30
FC Thun,9055,9,8,6,18,43,64,-21,30
Young Boys,9056,1,20,8,4,71,37,34,68
FC Basel,9056,2,19,8,5,55,23,32,65
St Gallen,9056,3,16,2,14,44,53,-9,50
Lucerne,9056,4,12,8,12,41,45,-4,44
FC Zürich,9056,5,11,10,11,43,37,6,43
Grasshoppers,9056,6,9,8,15,44,52,-8,35
FC Lugano,9056,7,10,5,17,30,50,-20,35
FC Thun,9056,8,9,5,18,43,62,-19,32
FC Sion,9056,9,7,8,17,41,53,-12,29
Young Boys,9057,1,20,8,4,68,34,34,68
FC Basel,9057,2,18,8,6,53,23,30,62
Lucerne,9057,3,12,9,11,39,43,-4,45
St Gallen,9057,4,14,3,15,40,54,-14,45
FC Zürich,9057,5,11,9,12,42,36,6,42
FC Lugano,9057,6,10,7,15,31,46,-15,37
Grasshoppers,9057,7,10,6,16,42,50,-8,36
FC Thun,9057,8,10,5,17,41,59,-18,35
FC Sion,9057,9,8,7,17,40,51,-11,31
Young Boys,9058,1,20,6,6,67,38,29,66
FC Basel,9058,2,17,8,7,52,29,23,59
Lucerne,9058,3,14,8,10,45,41,4,50
St Gallen,9058,4,14,4,14,44,56,-12,46
FC Zürich,9058,5,11,9,12,46,39,7,42
FC Lugano,9058,6,12,5,15,32,46,-14,41
FC Sion,9058,7,9,7,16,43,50,-7,34
Grasshoppers,9058,8,9,6,17,44,54,-10,33
FC Thun,9058,9,9,5,18,42,62,-20,32
Young Boys,9059,1,22,6,4,72,38,34,72
FC Basel,9059,2,17,9,6,55,27,28,60
St Gallen,9059,3,13,5,14,41,53,-12,44
FC Zürich,9059,4,11,10,11,41,35,6,43
Lucerne,9059,5,11,9,12,40,48,-8,42
FC Lugano,9059,6,12,6,14,36,45,-9,42
Grasshoppers,9059,7,10,6,16,40,47,-7,36
FC Thun,9059,8,9,6,17,42,59,-17,33
FC Sion,9059,9,7,7,18,39,54,-15,28
Young Boys,9060,1,23,6,3,75,33,42,75
FC Basel,9060,2,18,7,7,59,28,31,61
FC Zürich,9060,3,12,10,10,41,32,9,46
St Gallen,9060,4,14,4,14,45,56,-11,46
Lucerne,9060,5,12,9,11,40,50,-10,45
FC Thun,9060,6,10,5,17,43,57,-14,35
Grasshoppers,9060,7,9,7,16,40,51,-11,34
FC Lugano,9060,8,9,7,16,29,47,-18,34
FC Sion,9060,9,6,7,19,39,57,-18,25
Young Boys,9061,1,21,6,5,74,36,38,69
FC Basel,9061,2,18,8,6,53,24,29,62
Lucerne,9061,3,13,9,10,43,44,-1,48
St Gallen,9061,4,15,2,15,44,54,-10,47
FC Zürich,9061,5,10,9,13,41,40,1,39
Grasshoppers,9061,6,10,6,16,42,51,-9,36
FC Thun,9061,7,10,5,17,44,59,-15,35
FC Sion,9061,8,9,7,16,42,51,-9,34
FC Lugano,9061,9,9,6,17,30,54,-24,33
Young Boys,9062,1,21,8,3,71,34,37,71
FC Basel,9062,2,18,7,7,54,25,29,61
Lucerne,9062,3,13,9,10,41,40,1,48
St Gallen,9062,4,14,3,15,41,55,-14,45
FC Thun,9062,5,11,5,16,48,61,-13,38
FC Lugano,9062,6,11,5,16,33,47,-14,38
FC Zürich,9062,7,9,10,13,36,36,0,37
Grasshoppers,9062,8,9,6,17,38,52,-14,33
FC Sion,9062,9,7,9,16,40,52,-12,30
Young Boys,9063,1,22,7,3,73,35,38,73
FC Basel,9063,2,19,7,6,56,25,31,64
St Gallen,9063,3,14,3,15,42,56,-14,45
Lucerne,9063,4,12,8,12,42,48,-6,44
FC Zürich,9063,5,11,10,11,42,36,6,43
FC Lugano,9063,6,12,5,15,36,48,-12,41
Grasshoppers,9063,7,9,6,17,41,52,-11,33
FC Thun,9063,8,9,6,17,40,57,-17,33
FC Sion,9063,9,5,10,17,37,52,-15,25
Young Boys,9064,1,22,8,2,69,31,38,74
FC Basel,9064,2,18,8,6,52,24,28,62
Lucerne,9064,3,13,8,11,39,40,-1,47
St Gallen,9064,4,15,2,15,42,54,-12,47
FC Zürich,9064,5,10,10,12,41,39,2,40
FC Thun,9064,6,11,6,15,49,59,-10,39
FC Lugano,9064,7,9,6,17,29,47,-18,33
Grasshoppers,9064,8,8,8,16,39,50,-11,32
FC Sion,9064,9,6,8,18,38,54,-16,26
Young Boys,9065,1,23,7,2,72,34,38,76
FC Basel,9065,2,18,8,6,54,26,28,62
St Gallen,9065,3,15,3,14,47,54,-7,48
Lucerne,9065,4,12,9,11,43,45,-2,45
FC Zürich,9065,5,10,9,13,41,37,4,39
FC Lugano,9065,6,10,6,16,31,48,-17,36
FC Thun,9065,7,10,5,17,42,57,-15,35
Grasshoppers,9065,8,8,7,17,39,52,-13,31
FC Sion,9065,9,7,8,17,40,56,-16,29
Young Boys,9066,1,23,6,3,72,30,42,75
FC Basel,9066,2,17,9,6,51,27,24,60
Lucerne,9066,3,14,9,9,45,43,2,51
St Gallen,9066,4,13,5,14,42,57,-15,44
FC Zürich,9066,5,9,10,13,38,39,-1,37
Grasshoppers,9066,6,10,6,16,42,53,-11,36
FC Lugano,9066,7,10,6,16,32,47,-15,36
FC Thun,9066,8,10,5,17,44,57,-13,35
FC Sion,9066,9,6,8,18,40,53,-13,26
Young Boys,9067,1,21,8,3,69,34,35,71
FC Basel,9067,2,18,8,6,54,25,29,62
FC Zürich,9067,3,12,9,11,44,40,4,45
Lucerne,9067,4,12,8,12,40,45,-5,44
St Gallen,9067,5,14,2,16,40,57,-17,44
FC Lugano,9067,6,11,5,16,30,46,-16,38
FC Sion,9067,7,9,7,16,48,52,-4,34
Grasshoppers,9067,8,9,6,17,46,54,-8,33
FC Thun,9067,9,9,5,18,44,62,-18,32
Young Boys,9068,1,21,7,4,78,38,40,70
FC Basel,9068,2,19,8,5,59,27,32,65
Lucerne,9068,3,13,7,12,44,52,-8,46
St Gallen,9068,4,13,4,15,41,56,-15,43
FC Zürich,9068,5,10,10,12,41,37,4,40
FC Lugano,9068,6,10,7,15,35,51,-16,37
Grasshoppers,9068,7,9,7,16,46,55,-9,34
FC Thun,9068,8,9,7,16,47,61,-14,34
FC Sion,9068,9,7,9,16,43,57,-14,30
Young Boys,9069,1,20,8,4,66,36,30,68
FC Basel,9069,2,18,9,5,57,25,32,63
Lucerne,9069,3,12,9,11,42,45,-3,45
St Gallen,9069,4,14,2,16,43,55,-12,44
FC Zürich,9069,5,11,9,12,43,39,4,42
FC Thun,9069,6,11,6,15,47,57,-10,39
FC Lugano,9069,7,11,6,15,31,46,-15,39
Grasshoppers,9069,8,9,7,16,40,49,-9,34
FC Sion,9069,9,6,8,18,37,54,-17,26
Young Boys,9070,1,22,7,3,73,38,35,73
FC Basel,9070,2,17,10,5,53,24,29,61
Lucerne,9070,3,13,9,10,43,43,0,48
St Gallen,9070,4,13,3,16,39,54,-15,42
FC Thun,9070,5,11,6,15,46,56,-10,39
FC Lugano,9070,6,11,6,15,30,44,-14,39
FC Zürich,9070,7,9,10,13,37,39,-2,37
FC Sion,9070,8,8,7,17,44,54,-10,31
Grasshoppers,9070,9,8,6,18,40,53,-13,30
Young Boys,9071,1,20,9,3,72,38,34,69
FC Basel,9071,2,19,7,6,59,26,33,64
St Gallen,9071,3,15,4,13,44,51,-7,49
Lucerne,9071,4,12,8,12,39,44,-5,44
FC Zürich,9071,5,10,11,11,39,36,3,41
Grasshoppers,9071,6,10,8,14,42,48,-6,38
FC Lugano,9071,7,9,7,16,29,46,-17,34
FC Sion,9071,8,6,11,15,43,53,-10,29
FC Thun,9071,9,8,5,19,45,70,-25,29
Young Boys,9072,1,23,6,3,69,34,35,75
FC Basel,9072,2,18,8,6,55,25,30,62
St Gallen,9072,3,15,3,14,41,53,-12,48
Lucerne,9072,4,13,8,11,42,42,0,47
FC Zürich,9072,5,10,10,12,39,38,1,40
FC Thun,9072,6,10,5,17,48,61,-13,35
FC Lugano,9072,7,10,5,17,30,48,-18,35
Grasshoppers,9072,8,9,6,17,42,55,-13,33
FC Sion,9072,9,7,7,18,43,53,-10,28
Young Boys,9073,1,22,6,4,68,33,35,72
FC Basel,9073,2,16,9,7,49,27,22,57
Lucerne,9073,3,13,9,10,43,41,2,48
St Gallen,9073,4,15,3,14,43,52,-9,48
FC Zürich,9073,5,12,9,11,43,35,8,45
FC Lugano,9073,6,11,5,16,31,47,-16,38
Grasshoppers,9073,7,9,6,17,41,51,-10,33
FC Thun,9073,8,9,6,17,41,58,-17,33
FC Sion,9073,9,7,7,18,41,56,-15,28
Young Boys,9074,1,21,7,4,74,36,38,70
FC Basel,9074,2,18,9,5,60,29,31,63
Lucerne,9074,3,13,8,11,48,49,-1,47
FC Zürich,9074,4,11,11,10,44,38,6,44
St Gallen,9074,5,13,4,15,43,56,-13,43
Grasshoppers,9074,6,9,8,15,46,53,-7,35
FC Thun,9074,7,9,6,17,42,57,-15,33
FC Lugano,9074,8,9,6,17,33,59,-26,33
FC Sion,9074,9,7,9,16,43,56,-13,30
FC Basel,9075,1,20,7,5,57,21,36,67
Young Boys,9075,2,20,7,5,68,36,32,67
Lucerne,9075,3,14,8,10,46,43,3,50
St Gallen,9075,4,14,3,15,43,61,-18,45
FC Lugano,9075,5,11,5,16,35,49,-14,38
FC Zürich,9075,6,9,10,13,40,41,-1,37
FC Sion,9075,7,8,9,15,45,54,-9,33
Grasshoppers,9075,8,9,6,17,42,52,-10,33
FC Thun,9075,9,9,5,18,44,63,-19,32
Young Boys,9076,1,20,7,5,70,39,31,67
FC Basel,9076,2,18,7,7,52,28,24,61
Lucerne,9076,3,13,8,11,46,45,1,47
St Gallen,9076,4,15,2,15,44,55,-11,47
FC Zürich,9076,5,11,10,11,41,34,7,43
FC Lugano,9076,6,11,5,16,32,49,-17,38
Grasshoppers,9076,7,9,9,14,41,48,-7,36
FC Sion,9076,8,8,7,17,44,54,-10,31
FC Thun,9076,9,8,7,17,44,62,-18,31
Young Boys,9077,1,19,9,4,66,36,30,66
FC Basel,9077,2,17,7,8,53,29,24,58
Lucerne,9077,3,13,9,10,46,41,5,48
FC Zürich,9077,4,12,9,11,47,36,11,45
St Gallen,9077,5,14,3,15,43,56,-13,45
FC Thun,9077,6,11,6,15,46,57,-11,39
FC Lugano,9077,7,10,7,15,31,46,-15,37
Grasshoppers,9077,8,10,6,16,42,52,-10,36
FC Sion,9077,9,5,10,17,38,59,-21,25
Young Boys,9078,1,20,8,4,65,31,34,68
FC Basel,9078,2,17,10,5,52,21,31,61
FC Zürich,9078,3,12,9,11,45,39,6,45
Lucerne,9078,4,11,11,10,41,44,-3,44
St Gallen,9078,5,13,5,14,39,51,-12,44
Grasshoppers,9078,6,11,7,14,44,48,-4,40
FC Lugano,9078,7,11,6,15,32,49,-17,39
FC Thun,9078,8,8,6,18,40,58,-18,30
FC Sion,9078,9,6,8,18,37,54,-17,26
Young Boys,9079,1,20,9,3,69,35,34,69
FC Basel,9079,2,18,8,6,57,26,31,62
Lucerne,9079,3,12,9,11,44,45,-1,45
St Gallen,9079,4,14,3,15,45,59,-14,45
FC Zürich,9079,5,11,10,11,43,36,7,43
Grasshoppers,9079,6,11,7,14,41,45,-4,40
FC Lugano,9079,7,10,7,15,34,52,-18,37
FC Sion,9079,8,7,8,17,42,54,-12,29
FC Thun,9079,9,8,5,19,40,63,-23,29
Young Boys,9080,1,22,7,3,77,38,39,73
FC Basel,9080,2,18,9,5,55,26,29,63
St Gallen,9080,3,15,4,13,45,53,-8,49
Lucerne,9080,4,12,8,12,44,49,-5,44
FC Zürich,9080,5,11,9,12,42,37,5,42
FC Lugano,9080,6,10,6,16,30,50,-20,36
FC Thun,9080,7,9,6,17,47,60,-13,33
Grasshoppers,9080,8,8,7,17,40,56,-16,31
FC Sion,9080,9,7,8,17,42,53,-11,29
Young Boys,9081,1,23,7,2,71,31,40,76
FC Basel,9081,2,17,8,7,53,26,27,59
St Gallen,9081,3,15,3,14,45,55,-10,48
Lucerne,9081,4,12,8,12,42,45,-3,44
FC Zürich,9081,5,10,10,12,39,37,2,40
FC Lugano,9081,6,11,6,15,32,45,-13,39
Grasshoppers,9081,7,8,8,16,42,55,-13,32
FC Thun,9081,8,9,5,18,45,65,-20,32
FC Sion,9081,9,7,9,16,46,56,-10,30
Young Boys,9082,1,21,8,3,68,33,35,71
FC Basel,9082,2,17,8,7,51,24,27,59
St Gallen,9082,3,15,3,14,41,51,-10,48
Lucerne,9082,4,13,7,12,40,42,-2,46
FC Zürich,9082,5,10,11,11,41,37,4,41
Grasshoppers,9082,6,11,6,15,44,47,-3,39
FC Lugano,9082,7,9,7,16,30,48,-18,34
FC Sion,9082,8,8,8,16,42,51,-9,32
FC Thun,9082,9,8,6,18,39,63,-24,30
Young Boys,9083,1,21,8,3,69,33,36,71
FC Basel,9083,2,18,8,6,55,26,29,62
St Gallen,9083,3,16,3,13,49,54,-5,51
Lucerne,9083,4,11,9,12,42,51,-9,42
FC Zürich,9083,5,10,11,11,41,37,4,41
Grasshoppers,9083,6,10,7,15,41,48,-7,37
FC Lugano,9083,7,10,6,16,37,49,-12,36
FC Thun,9083,8,8,6,18,40,61,-21,30
FC Sion,9083,9,7,8,17,40,55,-15,29
Young Boys,9084,1,21,7,4,73,35,38,70
FC Basel,9084,2,18,7,7,55,26,29,61
Lucerne,9084,3,13,10,9,42,40,2,49
St Gallen,9084,4,15,3,14,44,53,-9,48
FC Zürich,9084,5,11,9,12,39,39,0,42
FC Lugano,9084,6,12,6,14,34,44,-10,42
FC Thun,9084,7,9,6,17,42,57,-15,33
Grasshoppers,9084,8,8,6,18,36,50,-14,30
FC Sion,9084,9,6,8,18,38,59,-21,26
Young Boys,9085,1,22,7,3,72,33,39,73
FC Basel,9085,2,16,10,6,50,24,26,58
Lucerne,9085,3,13,8,11,44,46,-2,47
St Gallen,9085,4,13,4,15,43,58,-15,43
FC Zürich,9085,5,10,11,11,39,35,4,41
FC Thun,9085,6,10,7,15,42,54,-12,37
Grasshoppers,9085,7,10,6,16,40,48,-8,36
FC Lugano,9085,8,9,6,17,33,52,-19,33
FC Sion,9085,9,8,7,17,39,52,-13,31
Young Boys,9086,1,21,6,5,70,36,34,69
FC Basel,9086,2,18,9,5,57,25,32,63
Lucerne,9086,3,14,7,11,44,44,0,49
St Gallen,9086,4,15,2,15,43,59,-16,47
FC Zürich,9086,5,11,10,11,42,36,6,43
FC Lugano,9086,6,10,5,17,31,49,-18,35
FC Sion,9086,7,9,7,16,43,52,-9,34
Grasshoppers,9086,8,9,6,17,43,53,-10,33
FC Thun,9086,9,8,6,18,41,60,-19,30
Young Boys,9087,1,22,6,4,73,37,36,72
FC Basel,9087,2,19,7,6,55,22,33,64
St Gallen,9087,3,14,4,14,41,52,-11,46
Lucerne,9087,4,12,8,12,37,45,-8,44
FC Zürich,9087,5,10,10,12,40,38,2,40
Grasshoppers,9087,6,10,7,15,44,49,-5,37
FC Lugano,9087,7,9,7,16,32,49,-17,34
FC Sion,9087,8,8,8,16,43,52,-9,32
FC Thun,9087,9,9,5,18,42,63,-21,32
Young Boys,9088,1,19,9,4,67,35,32,66
FC Basel,9088,2,17,8,7,55,28,27,59
St Gallen,9088,3,15,3,14,44,54,-10,48
Lucerne,9088,4,13,8,11,41,45,-4,47
FC Zürich,9088,5,11,10,11,42,37,5,43
Grasshoppers,9088,6,11,6,15,43,49,-6,39
FC Lugano,9088,7,11,6,15,35,48,-13,39
FC Thun,9088,8,10,5,17,43,58,-15,35
FC Sion,9088,9,5,9,18,38,54,-16,24
Young Boys,9089,1,21,7,4,73,36,37,70
FC Basel,9089,2,17,8,7,51,28,23,59
Lucerne,9089,3,13,8,11,49,45,4,47
FC Zürich,9089,4,12,10,10,44,34,10,46
St Gallen,9089,5,14,2,16,46,60,-14,44
FC Lugano,9089,6,12,5,15,35,48,-13,41
Grasshoppers,9089,7,10,6,16,45,56,-11,36
FC Thun,9089,8,9,7,16,44,59,-15,34
FC Sion,9089,9,6,7,19,39,60,-21,25
Young Boys,9090,1,23,7,2,75,34,41,76
FC Basel,9090,2,16,7,9,49,30,19,55
Lucerne,9090,3,14,8,10,45,43,2,50
FC Zürich,9090,4,11,11,10,44,36,8,44
St Gallen,9090,5,14,2,16,44,58,-14,44
FC Lugano,9090,6,10,7,15,32,48,-16,37
Grasshoppers,9090,7,9,6,17,43,54,-11,33
FC Sion,9090,8,8,8,16,44,55,-11,32
FC Thun,9090,9,8,6,18,41,59,-18,30
Young Boys,9091,1,22,6,4,76,38,38,72
FC Basel,9091,2,18,9,5,53,24,29,63
Lucerne,9091,3,13,8,11,43,46,-3,47
St Gallen,9091,4,14,3,15,42,58,-16,45
FC Zürich,9091,5,11,9,12,43,38,5,42
FC Lugano,9091,6,11,5,16,38,50,-12,38
Grasshoppers,9091,7,10,7,15,46,52,-6,37
FC Thun,9091,8,8,7,17,43,61,-18,31
FC Sion,9091,9,6,8,18,43,60,-17,26
Young Boys,9092,1,20,6,6,71,41,30,66
FC Basel,9092,2,19,8,5,58,24,34,65
Lucerne,9092,3,14,8,10,45,41,4,50
St Gallen,9092,4,13,5,14,41,53,-12,44
FC Zürich,9092,5,10,11,11,41,38,3,41
FC Lugano,9092,6,10,6,16,30,50,-20,36
Grasshoppers,9092,7,9,7,16,44,53,-9,34
FC Sion,9092,8,7,10,15,44,55,-11,31
FC Thun,9092,9,8,7,17,44,63,-19,31
Young Boys,9093,1,21,8,3,75,37,38,71
FC Basel,9093,2,17,9,6,56,29,27,60
St Gallen,9093,3,17,2,13,51,56,-5,53
Lucerne,9093,4,12,9,11,46,50,-4,45
FC Zürich,9093,5,11,10,11,40,35,5,43
Grasshoppers,9093,6,9,9,14,42,49,-7,36
FC Thun,9093,7,9,7,16,44,58,-14,34
FC Lugano,9093,8,9,6,17,31,52,-21,33
FC Sion,9093,9,5,8,19,37,56,-19,23
Young Boys,9094,1,23,6,3,79,38,41,75
FC Basel,9094,2,18,8,6,63,28,35,62
Lucerne,9094,3,13,8,11,46,46,0,47
St Gallen,9094,4,14,3,15,44,62,-18,45
FC Zürich,9094,5,10,10,12,41,38,3,40
FC Thun,9094,6,10,6,16,44,60,-16,36
FC Lugano,9094,7,10,5,17,34,53,-19,35
FC Sion,9094,8,8,8,16,42,52,-10,32
Grasshoppers,9094,9,8,6,18,37,53,-16,30
Young Boys,9095,1,22,6,4,73,37,36,72
FC Basel,9095,2,18,8,6,54,25,29,62
St Gallen,9095,3,15,3,14,41,52,-11,48
Lucerne,9095,4,12,9,11,45,47,-2,45
FC Zürich,9095,5,9,13,10,38,34,4,40
Grasshoppers,9095,6,10,8,14,43,48,-5,38
FC Lugano,9095,7,9,6,17,27,49,-22,33
FC Sion,9095,8,7,9,16,41,51,-10,30
FC Thun,9095,9,8,6,18,43,62,-19,30
Young Boys,9096,1,21,6,5,71,37,34,69
FC Basel,9096,2,18,8,6,55,29,26,62
Lucerne,9096,3,13,9,10,46,44,2,48
St Gallen,9096,4,15,3,14,48,53,-5,48
FC Zürich,9096,5,10,11,11,41,35,6,41
FC Thun,9096,6,10,5,17,43,60,-17,35
FC Lugano,9096,7,9,8,15,28,45,-17,35
Grasshoppers,9096,8,9,6,17,41,53,-12,33
FC Sion,9096,9,7,8,17,39,56,-17,29
Young Boys,9097,1,21,7,4,76,41,35,70
FC Basel,9097,2,18,7,7,59,25,34,61
Lucerne,9097,3,14,7,11,45,45,0,49
FC Zürich,9097,4,12,9,11,41,34,7,45
St Gallen,9097,5,14,3,15,42,56,-14,45
FC Thun,9097,6,12,5,15,49,54,-5,41
FC Lugano,9097,7,9,5,18,28,56,-28,32
Grasshoppers,9097,8,8,7,17,40,52,-12,31
FC Sion,9097,9,7,8,17,42,59,-17,29
Young Boys,9098,1,22,8,2,73,33,40,74
FC Basel,9098,2,18,8,6,55,27,28,62
Lucerne,9098,3,13,8,11,43,44,-1,47
St Gallen,9098,4,14,3,15,40,52,-12,45
FC Zürich,9098,5,11,10,11,41,35,6,43
FC Thun,9098,6,10,6,16,44,56,-12,36
FC Lugano,9098,7,10,6,16,29,46,-17,36
Grasshoppers,9098,8,8,6,18,38,56,-18,30
FC Sion,9098,9,7,7,18,39,53,-14,28
Young Boys,9099,1,21,6,5,68,37,31,69
FC Basel,9099,2,18,7,7,53,26,27,61
St Gallen,9099,3,14,3,15,41,55,-14,45
FC Zürich,9099,4,11,10,11,42,37,5,43
Lucerne,9099,5,12,7,13,38,44,-6,43
Grasshoppers,9099,6,11,7,14,47,47,0,40
FC Lugano,9099,7,11,6,15,31,44,-13,39
FC Sion,9099,8,8,8,16,41,53,-12,32
FC Thun,9099,9,8,6,18,41,59,-18,30
Young Boys,9100,1,22,6,4,68,32,36,72
FC Basel,9100,2,19,8,5,54,25,29,65
Lucerne,9100,3,13,8,11,42,44,-2,47
FC Zürich,9100,4,11,11,10,42,36,6,44
St Gallen,9100,5,13,4,15,43,56,-13,43
Grasshoppers,9100,6,9,7,16,41,50,-9,34
FC Thun,9100,7,9,7,16,44,57,-13,34
FC Lugano,9100,8,9,7,16,33,50,-17,34
FC Sion,9100,9,6,8,18,38,55,-17,26
Young Boys,9101,1,22,8,2,73,33,40,74
FC Basel,9101,2,19,7,6,58,25,33,64
St Gallen,9101,3,15,3,14,43,54,-11,48
Lucerne,9101,4,12,8,12,43,46,-3,44
FC Zürich,9101,5,11,10,11,40,36,4,43
Grasshoppers,9101,6,10,7,15,41,48,-7,37
FC Lugano,9101,7,9,6,17,29,53,-24,33
FC Thun,9101,8,9,5,18,43,58,-15,32
FC Sion,9101,9,5,10,17,37,54,-17,25
Young Boys,9102,1,22,7,3,73,36,37,73
FC Basel,9102,2,19,8,5,59,26,33,65
St Gallen,9102,3,14,2,16,45,55,-10,44
Lucerne,9102,4,12,8,12,41,51,-10,44
FC Zürich,9102,5,10,9,13,41,39,2,39
Grasshoppers,9102,6,10,8,14,47,47,0,38
FC Lugano,9102,7,11,5,16,33,49,-16,38
FC Thun,9102,8,9,6,17,44,59,-15,33
FC Sion,9102,9,7,7,18,38,59,-21,28
Young Boys,9103,1,21,7,4,71,32,39,70
FC Basel,9103,2,18,8,6,50,24,26,62
Lucerne,9103,3,13,8,11,40,43,-3,47
St Gallen,9103,4,14,5,13,45,54,-9,47
FC Zürich,9103,5,11,11,10,42,33,9,44
Grasshoppers,9103,6,10,6,16,38,47,-9,36
FC Thun,9103,7,10,5,17,43,59,-16,35
FC Lugano,9103,8,9,6,17,30,50,-20,33
FC Sion,9103,9,5,10,17,37,54,-17,25
Young Boys,9104,1,21,7,4,72,37,35,70
FC Basel,9104,2,17,8,7,51,26,25,59
St Gallen,9104,3,16,2,14,45,52,-7,50
Lucerne,9104,4,13,9,10,44,44,0,48
FC Zürich,9104,5,9,11,12,40,39,1,38
FC Thun,9104,6,10,7,15,46,59,-13,37
FC Lugano,9104,7,10,5,17,32,52,-20,35
FC Sion,9104,8,8,8,16,42,52,-10,32
Grasshoppers,9104,9,8,7,17,41,52,-11,31
Young Boys,9105,1,22,7,3,79,33,46,73
FC Basel,9105,2,18,9,5,58,28,30,63
Lucerne,9105,3,13,8,11,44,47,-3,47
St Gallen,9105,4,14,3,15,43,55,-12,45
FC Zürich,9105,5,9,12,11,38,35,3,39
Grasshoppers,9105,6,10,6,16,43,54,-11,36
FC Lugano,9105,7,9,7,16,30,53,-23,34
FC Thun,9105,8,9,5,18,45,63,-18,32
FC Sion,9105,9,7,9,16,38,50,-12,30
Young Boys,9106,1,20,9,3,68,33,35,69
FC Basel,9106,2,18,9,5,58,23,35,63
St Gallen,9106,3,14,3,15,42,57,-15,45
Lucerne,9106,4,11,9,12,38,44,-6,42
FC Zürich,9106,5,10,10,12,40,38,2,40
FC Lugano,9106,6,11,5,16,33,48,-15,38
Grasshoppers,9106,7,10,7,15,40,46,-6,37
FC Sion,9106,8,9,8,15,45,50,-5,35
FC Thun,9106,9,8,6,18,41,66,-25,30
Young Boys,9107,1,21,9,2,68,31,37,72
FC Basel,9107,2,15,9,8,49,30,19,54
Lucerne,9107,3,13,9,10,42,43,-1,48
St Gallen,9107,4,15,2,15,41,52,-11,47
FC Zürich,9107,5,9,12,11,40,37,3,39
FC Lugano,9107,6,11,5,16,31,46,-15,38
Grasshoppers,9107,7,10,7,15,43,46,-3,37
FC Thun,9107,8,9,7,16,44,58,-14,34
FC Sion,9107,9,6,10,16,37,52,-15,28
Young Boys,9108,1,22,7,3,75,35,40,73
FC Basel,9108,2,19,8,5,57,22,35,65
St Gallen,9108,3,14,4,14,45,55,-10,46
Lucerne,9108,4,11,8,13,36,47,-11,41
FC Lugano,9108,5,11,6,15,34,51,-17,39
FC Zürich,9108,6,9,10,13,42,42,0,37
Grasshoppers,9108,7,9,7,16,40,50,-10,34
FC Thun,9108,8,9,6,17,43,60,-17,33
FC Sion,9108,9,8,8,16,47,57,-10,32
Young Boys,9109,1,22,7,3,76,39,37,73
FC Basel,9109,2,17,8,7,55,26,29,59
St Gallen,9109,3,15,3,14,46,54,-8,48
FC Zürich,9109,4,11,9,12,41,38,3,42
Lucerne,9109,5,11,9,12,39,45,-6,42
FC Thun,9109,6,11,5,16,47,58,-11,38
FC Lugano,9109,7,10,7,15,32,47,-15,37
Grasshoppers,9109,8,8,7,17,38,52,-14,31
FC Sion,9109,9,8,7,17,42,57,-15,31
Young Boys,9110,1,20,9,3,69,36,33,69
FC Basel,9110,2,19,8,5,56,23,33,65
Lucerne,9110,3,13,8,11,43,42,1,47
FC Zürich,9110,4,11,10,11,40,35,5,43
St Gallen,9110,5,13,3,16,44,60,-16,42
Grasshoppers,9110,6,10,7,15,43,51,-8,37
FC Thun,9110,7,10,5,17,43,57,-14,35
FC Lugano,9110,8,10,5,17,31,52,-21,35
FC Sion,9110,9,6,9,17,42,55,-13,27
Young Boys,9111,1,20,7,5,71,39,32,67
FC Basel,9111,2,18,8,6,56,27,29,62
FC Lugano,9111,3,13,5,14,40,45,-5,44
St Gallen,9111,4,13,4,15,42,60,-18,43
Lucerne,9111,5,11,9,12,41,48,-7,42
FC Zürich,9111,6,10,9,13,39,36,3,39
Grasshoppers,9111,7,10,7,15,42,49,-7,37
FC Sion,9111,8,8,9,15,39,47,-8,33
FC Thun,9111,9,9,6,17,40,59,-19,33
Young Boys,9112,1,23,6,3,80,36,44,75
FC Basel,9112,2,17,8,7,52,30,22,59
St Gallen,9112,3,15,3,14,42,51,-9,48
Lucerne,9112,4,11,7,14,37,50,-13,40
FC Zürich,9112,5,10,9,13,39,38,1,39
Grasshoppers,9112,6,11,6,15,48,48,0,39
FC Lugano,9112,7,11,5,16,31,47,-16,38
FC Thun,9112,8,9,6,17,44,61,-17,33
FC Sion,9112,9,8,8,16,43,55,-12,32
Young Boys,9113,1,21,9,2,75,32,43,72
FC Basel,9113,2,17,10,5,49,22,27,61
Lucerne,9113,3,13,8,11,41,47,-6,47
St Gallen,9113,4,15,2,15,43,53,-10,47
FC Zürich,9113,5,10,11,11,39,36,3,41
Grasshoppers,9113,6,10,7,15,43,50,-7,37
FC Lugano,9113,7,10,5,17,29,48,-19,35
FC Thun,9113,8,8,7,17,42,59,-17,31
FC Sion,9113,9,6,9,17,41,55,-14,27
Young Boys,9114,1,21,7,4,73,37,36,70
FC Basel,9114,2,16,11,5,52,26,26,59
St Gallen,9114,3,13,5,14,45,58,-13,44
FC Zürich,9114,4,11,10,11,44,37,7,43
Lucerne,9114,5,11,10,11,45,48,-3,43
FC Thun,9114,6,11,5,16,45,58,-13,38
FC Lugano,9114,7,11,5,16,33,50,-17,38
Grasshoppers,9114,8,9,8,15,43,51,-8,35
FC Sion,9114,9,6,9,17,41,56,-15,27
Young Boys,9115,1,22,6,4,73,40,33,72
FC Basel,9115,2,18,8,6,60,29,31,62
St Gallen,9115,3,14,4,14,44,55,-11,46
Lucerne,9115,4,12,9,11,41,44,-3,45
FC Zürich,9115,5,11,10,11,41,37,4,43
FC Thun,9115,6,10,6,16,43,58,-15,36
Grasshoppers,9115,7,9,7,16,44,50,-6,34
FC Lugano,9115,8,9,6,17,29,49,-20,33
FC Sion,9115,9,7,8,17,40,53,-13,29
Young Boys,9116,1,23,6,3,72,34,38,75
FC Basel,9116,2,17,8,7,54,25,29,59
Lucerne,9116,3,14,8,10,41,40,1,50
St Gallen,9116,4,14,2,16,41,56,-15,44
FC Zürich,9116,5,10,10,12,39,38,1,40
Grasshoppers,9116,6,10,6,16,40,48,-8,36
FC Lugano,9116,7,10,6,16,29,46,-17,36
FC Thun,9116,8,10,5,17,42,58,-16,35
FC Sion,9116,9,7,7,18,43,56,-13,28
Young Boys,9117,1,22,6,4,70,34,36,72
FC Basel,9117,2,18,8,6,54,26,28,62
St Gallen,9117,3,15,3,14,43,53,-10,48
Lucerne,9117,4,13,7,12,39,43,-4,46
FC Zürich,9117,5,9,12,11,40,37,3,39
Grasshoppers,9117,6,11,6,15,48,52,-4,39
FC Thun,9117,7,9,6,17,46,61,-15,33
FC Lugano,9117,8,9,6,17,28,46,-18,33
FC Sion,9117,9,7,8,17,42,58,-16,29
Young Boys,9118,1,21,8,3,73,37,36,71
FC Basel,9118,2,19,7,6,53,25,28,64
St Gallen,9118,3,17,2,13,45,52,-7,53
FC Zürich,9118,4,12,9,11,42,34,8,45
Lucerne,9118,5,11,8,13,38,46,-8,41
Grasshoppers,9118,6,11,6,15,45,49,-4,39
FC Lugano,9118,7,9,7,16,31,48,-17,34
FC Thun,9118,8,9,5,18,44,62,-18,32
FC Sion,9118,9,5,8,19,40,58,-18,23
Young Boys,9119,1,20,8,4,70,36,34,68
FC Basel,9119,2,19,7,6,53,25,28,64
St Gallen,9119,3,16,2,14,45,55,-10,50
Lucerne,9119,4,13,7,12,43,45,-2,46
FC Zürich,9119,5,9,11,12,38,38,0,38
Grasshoppers,9119,6,9,8,15,43,49,-6,35
FC Sion,9119,7,8,9,15,44,51,-7,33
FC Thun,9119,8,9,6,17,43,59,-16,33
FC Lugano,9119,9,9,6,17,30,51,-21,33
Young Boys,9120,1,22,6,4,72,36,36,72
FC Basel,9120,2,20,7,5,58,24,34,67
Lucerne,9120,3,14,7,11,44,46,-2,49
St Gallen,9120,4,13,4,15,39,52,-13,43
FC Zürich,9120,5,10,11,11,43,39,4,41
Grasshoppers,9120,6,9,7,16,43,52,-9,34
FC Lugano,9120,7,9,6,17,28,48,-20,33
FC Thun,9120,8,8,7,17,44,63,-19,31
FC Sion,9120,9,7,9,16,41,52,-11,30
Young Boys,9121,1,21,7,4,71,37,34,70
FC Basel,9121,2,17,9,6,55,27,28,60
Lucerne,9121,3,13,9,10,46,44,2,48
St Gallen,9121,4,14,3,15,46,57,-11,45
FC Zürich,9121,5,11,9,12,42,37,5,42
Grasshoppers,9121,6,9,8,15,42,51,-9,35
FC Lugano,9121,7,10,5,17,31,49,-18,35
FC Thun,9121,8,9,6,17,42,62,-20,33
FC Sion,9121,9,8,8,16,45,56,-11,32
Young Boys,9122,1,24,6,2,75,32,43,78
FC Basel,9122,2,18,7,7,52,25,27,61
St Gallen,9122,3,14,3,15,42,56,-14,45
Lucerne,9122,4,11,9,12,40,47,-7,42
FC Zürich,9122,5,10,10,12,40,36,4,40
FC Lugano,9122,6,11,6,15,32,45,-13,39
Grasshoppers,9122,7,10,7,15,42,50,-8,37
FC Thun,9122,8,10,6,16,48,61,-13,36
FC Sion,9122,9,5,8,19,40,59,-19,23
Young Boys,9123,1,22,7,3,74,37,37,73
FC Basel,9123,2,18,9,5,55,25,30,63
St Gallen,9123,3,15,3,14,43,51,-8,48
FC Zürich,9123,4,11,10,11,43,36,7,43
Lucerne,9123,5,11,9,12,39,47,-8,42
Grasshoppers,9123,6,9,8,15,41,47,-6,35
FC Thun,9123,7,10,5,17,41,58,-17,35
FC Lugano,9123,8,10,5,17,31,51,-20,35
FC Sion,9123,9,6,8,18,38,53,-15,26
Young Boys,9124,1,22,6,4,73,34,39,72
FC Basel,9124,2,17,7,8,54,32,22,58
Lucerne,9124,3,14,7,11,45,46,-1,49
St Gallen,9124,4,15,2,15,45,54,-9,47
FC Zürich,9124,5,11,10,11,43,37,6,43
Grasshoppers,9124,6,10,7,15,45,49,-4,37
FC Lugano,9124,7,10,6,16,31,49,-18,36
FC Thun,9124,8,9,6,17,42,60,-18,33
FC Sion,9124,9,7,7,18,42,59,-17,28
Young Boys,9125,1,21,8,3,72,37,35,71
FC Basel,9125,2,17,8,7,56,29,27,59
St Gallen,9125,3,14,4,14,44,52,-8,46
Lucerne,9125,4,12,9,11,44,47,-3,45
FC Zürich,9125,5,11,11,10,40,33,7,44
FC Lugano,9125,6,10,8,14,30,44,-14,38
Grasshoppers,9125,7,8,8,16,44,58,-14,32
FC Thun,9125,8,8,7,17,43,61,-18,31
FC Sion,9125,9,7,9,16,44,56,-12,30
Young Boys,9126,1,22,8,2,72,32,40,74
FC Basel,9126,2,18,9,5,54,23,31,63
Lucerne,9126,3,12,8,12,41,49,-8,44
St Gallen,9126,4,13,3,16,40,55,-15,42
FC Zürich,9126,5,10,11,11,41,37,4,41
FC Lugano,9126,6,11,6,15,34,47,-13,39
Grasshoppers,9126,7,9,8,15,38,47,-9,35
FC Thun,9126,8,8,6,18,39,57,-18,30
FC Sion,9126,9,6,11,15,40,52,-12,29
Young Boys,9127,1,23,6,3,77,38,39,75
FC Basel,9127,2,16,10,6,51,25,26,58
Lucerne,9127,3,14,7,11,45,47,-2,49
St Gallen,9127,4,15,3,14,45,54,-9,48
FC Zürich,9127,5,10,11,11,39,35,4,41
FC Lugano,9127,6,11,5,16,33,47,-14,38
FC Thun,9127,7,10,7,15,42,55,-13,37
Grasshoppers,9127,8,8,7,17,41,52,-11,31
FC Sion,9127,9,5,8,19,39,59,-20,23
Young Boys,9128,1,22,7,3,73,32,41,73
FC Basel,9128,2,17,7,8,52,29,23,58
St Gallen,9128,3,15,2,15,41,54,-13,47
Lucerne,9128,4,13,7,12,42,45,-3,46
FC Zürich,9128,5,12,9,11,43,36,7,45
Grasshoppers,9128,6,9,8,15,41,48,-7,35
FC Lugano,9128,7,10,5,17,31,50,-19,35
FC Thun,9128,8,9,6,17,41,59,-18,33
FC Sion,9128,9,7,9,16,40,51,-11,30
Young Boys,9129,1,21,6,5,71,36,35,69
FC Basel,9129,2,19,8,5,57,25,32,65
Lucerne,9129,3,13,7,12,43,47,-4,46
St Gallen,9129,4,14,2,16,40,54,-14,44
FC Lugano,9129,5,12,5,15,34,46,-12,41
FC Zürich,9129,6,9,10,13,39,39,0,37
FC Thun,9129,7,10,5,17,42,58,-16,35
Grasshoppers,9129,8,9,7,16,40,50,-10,34
FC Sion,9129,9,8,8,16,39,50,-11,32
Young Boys,9130,1,22,8,2,74,34,40,74
FC Basel,9130,2,17,8,7,52,25,27,59
St Gallen,9130,3,14,4,14,42,54,-12,46
FC Zürich,9130,4,11,9,12,40,35,5,42
Lucerne,9130,5,11,9,12,40,47,-7,42
FC Lugano,9130,6,11,7,14,33,44,-11,40
FC Thun,9130,7,11,5,16,42,56,-14,38
Grasshoppers,9130,8,8,8,16,39,50,-11,32
FC Sion,9130,9,6,8,18,39,56,-17,26
Young Boys,9131,1,21,9,2,72,35,37,72
FC Basel,9131,2,18,9,5,55,26,29,63
St Gallen,9131,3,14,4,14,42,53,-11,46
Lucerne,9131,4,12,9,11,46,45,1,45
FC Zürich,9131,5,11,11,10,40,34,6,44
FC Thun,9131,6,10,6,16,44,57,-13,36
Grasshoppers,9131,7,8,8,16,38,51,-13,32
FC Lugano,9131,8,9,5,18,27,50,-23,32
FC Sion,9131,9,6,9,17,40,53,-13,27
Young Boys,9132,1,21,8,3,69,34,35,71
FC Basel,9132,2,17,10,5,54,27,27,61
Lucerne,9132,3,12,10,10,42,43,-1,46
St Gallen,9132,4,14,4,14,43,53,-10,46
FC Zürich,9132,5,11,10,11,46,38,8,43
FC Thun,9132,6,9,8,15,42,56,-14,35
FC Sion,9132,7,8,8,16,39,53,-14,32
FC Lugano,9132,8,9,5,18,30,50,-20,32
Grasshoppers,9132,9,8,7,17,39,50,-11,31
Young Boys,9133,1,21,8,3,68,32,36,71
FC Basel,9133,2,18,9,5,62,25,37,63
St Gallen,9133,3,15,3,14,44,57,-13,48
Lucerne,9133,4,13,7,12,42,46,-4,46
FC Zürich,9133,5,10,12,10,43,37,6,42
FC Lugano,9133,6,10,7,15,31,47,-16,37
Grasshoppers,9133,7,9,8,15,42,49,-7,35
FC Thun,9133,8,9,7,16,42,61,-19,34
FC Sion,9133,9,5,7,20,39,59,-20,22
Young Boys,9134,1,19,10,3,65,34,31,67
FC Basel,9134,2,17,8,7,52,25,27,59
St Gallen,9134,3,15,2,15,46,56,-10,47
FC Zürich,9134,4,12,9,11,42,37,5,45
Lucerne,9134,5,12,8,12,37,42,-5,44
Grasshoppers,9134,6,10,7,15,41,50,-9,37
FC Lugano,9134,7,10,6,16,30,46,-16,36
FC Thun,9134,8,10,5,17,46,61,-15,35
FC Sion,9134,9,8,7,17,49,57,-8,31
Young Boys,9135,1,21,7,4,66,33,33,70
FC Basel,9135,2,18,9,5,56,23,33,63
St Gallen,9135,3,15,3,14,42,55,-13,48
Lucerne,9135,4,13,8,11,42,42,0,47
FC Zürich,9135,5,9,12,11,41,39,2,39
FC Lugano,9135,6,11,5,16,31,46,-15,38
FC Thun,9135,7,9,7,16,44,59,-15,34
Grasshoppers,9135,8,9,6,17,39,51,-12,33
FC Sion,9135,9,6,9,17,41,54,-13,27
Young Boys,9136,1,23,6,3,77,34,43,75
FC Basel,9136,2,16,10,6,50,27,23,58
St Gallen,9136,3,16,3,13,52,57,-5,51
Lucerne,9136,4,13,8,11,46,47,-1,47
FC Zürich,9136,5,10,10,12,40,39,1,40
Grasshoppers,9136,6,10,7,15,42,48,-6,37
FC Thun,9136,7,10,6,16,43,57,-14,36
FC Lugano,9136,8,9,5,18,32,58,-26,32
FC Sion,9136,9,6,7,19,39,54,-15,25
Young Boys,9137,1,22,6,4,72,35,37,72
FC Basel,9137,2,19,7,6,51,24,27,64
Lucerne,9137,3,13,8,11,41,42,-1,47
St Gallen,9137,4,14,2,16,42,55,-13,44
FC Zürich,9137,5,10,10,12,41,38,3,40
Grasshoppers,9137,6,9,8,15,43,51,-8,35
FC Lugano,9137,7,10,5,17,32,51,-19,35
FC Thun,9137,8,9,7,16,43,58,-15,34
FC Sion,9137,9,8,7,17,46,57,-11,31
Young Boys,9138,1,23,7,2,75,33,42,76
FC Basel,9138,2,18,9,5,54,24,30,63
Lucerne,9138,3,13,7,12,43,49,-6,46
St Gallen,9138,4,13,3,16,41,58,-17,42
FC Lugano,9138,5,12,5,15,38,44,-6,41
FC Zürich,9138,6,10,10,12,39,36,3,40
Grasshoppers,9138,7,9,6,17,41,53,-12,33
FC Thun,9138,8,9,5,18,41,64,-23,32
FC Sion,9138,9,7,8,17,43,54,-11,29
Young Boys,9139,1,24,6,2,79,34,45,78
FC Basel,9139,2,16,9,7,54,28,26,57
Lucerne,9139,3,12,10,10,42,45,-3,46
St Gallen,9139,4,14,4,14,42,54,-12,46
FC Zürich,9139,5,11,9,12,42,37,5,42
FC Lugano,9139,6,11,6,15,33,49,-16,39
Grasshoppers,9139,7,8,7,17,37,49,-12,31
FC Thun,9139,8,8,7,17,41,61,-20,31
FC Sion,9139,9,7,8,17,38,51,-13,29
Young Boys,9140,1,21,8,3,74,37,37,71
FC Basel,9140,2,17,9,6,53,24,29,60
St Gallen,9140,3,14,4,14,41,53,-12,46
Lucerne,9140,4,12,9,11,44,46,-2,45
FC Lugano,9140,5,11,6,15,34,50,-16,39
FC Zürich,9140,6,9,11,12,39,37,2,38
Grasshoppers,9140,7,9,9,14,45,50,-5,36
FC Thun,9140,8,10,5,17,44,62,-18,35
FC Sion,9140,9,6,9,17,40,55,-15,27
Young Boys,9141,1,22,7,3,70,35,35,73
FC Basel,9141,2,17,8,7,53,26,27,59
St Gallen,9141,3,16,3,13,47,55,-8,51
Lucerne,9141,4,13,8,11,43,42,1,47
FC Zürich,9141,5,11,10,11,42,36,6,43
FC Lugano,9141,6,10,6,16,31,49,-18,36
FC Thun,9141,7,10,5,17,46,60,-14,35
Grasshoppers,9141,8,9,7,16,41,52,-11,34
FC Sion,9141,9,5,8,19,39,57,-18,23
Young Boys,9142,1,20,9,3,68,35,33,69
FC Basel,9142,2,18,9,5,56,25,31,63
Lucerne,9142,3,13,9,10,46,45,1,48
St Gallen,9142,4,14,3,15,46,60,-14,45
FC Zürich,9142,5,11,10,11,41,38,3,43
FC Lugano,9142,6,11,6,15,36,47,-11,39
Grasshoppers,9142,7,10,7,15,43,48,-5,37
FC Thun,9142,8,8,5,19,39,62,-23,29
FC Sion,9142,9,6,8,18,43,58,-15,26
Young Boys,9143,1,22,7,3,76,34,42,73
FC Basel,9143,2,19,7,6,59,28,31,64
St Gallen,9143,3,16,3,13,45,51,-6,51
FC Zürich,9143,4,12,9,11,44,39,5,45
Lucerne,9143,5,11,9,12,41,46,-5,42
FC Thun,9143,6,10,5,17,43,60,-17,35
FC Lugano,9143,7,9,7,16,32,52,-20,34
Grasshoppers,9143,8,9,6,17,41,53,-12,33
FC Sion,9143,9,6,7,19,41,59,-18,25
Young Boys,9144,1,22,7,3,74,37,37,73
FC Basel,9144,2,18,8,6,59,24,35,62
FC Zürich,9144,3,12,10,10,41,32,9,46
Lucerne,9144,4,12,9,11,41,44,-3,45
St Gallen,9144,5,14,3,15,42,60,-18,45
FC Lugano,9144,6,10,7,15,31,47,-16,37
Grasshoppers,9144,7,9,7,16,39,49,-10,34
FC Thun,9144,8,9,6,17,39,55,-16,33
FC Sion,9144,9,6,7,19,37,55,-18,25
Young Boys,9145,1,23,6,3,76,33,43,75
FC Basel,9145,2,18,8,6,55,25,30,62
St Gallen,9145,3,15,2,15,44,55,-11,47
Lucerne,9145,4,13,7,12,41,47,-6,46
FC Zürich,9145,5,10,10,12,41,36,5,40
FC Lugano,9145,6,11,5,16,33,53,-20,38
FC Thun,9145,7,10,5,17,42,59,-17,35
Grasshoppers,9145,8,9,6,17,41,51,-10,33
FC Sion,9145,9,7,7,18,39,53,-14,28
Young Boys,9146,1,22,6,4,75,39,36,72
FC Basel,9146,2,19,8,5,57,26,31,65
Lucerne,9146,3,13,8,11,41,42,-1,47
St Gallen,9146,4,13,3,16,39,54,-15,42
FC Lugano,9146,5,11,5,16,32,47,-15,38
FC Zürich,9146,6,9,10,13,39,41,-2,37
Grasshoppers,9146,7,10,7,15,42,47,-5,37
FC Thun,9146,8,10,6,16,44,58,-14,36
FC Sion,9146,9,7,7,18,42,57,-15,28
Young Boys,9147,1,21,6,5,70,34,36,69
FC Basel,9147,2,18,8,6,57,26,31,62
St Gallen,9147,3,15,2,15,45,58,-13,47
Lucerne,9147,4,12,9,11,41,46,-5,45
FC Lugano,9147,5,12,6,14,37,47,-10,42
FC Zürich,9147,6,10,10,12,38,37,1,40
Grasshoppers,9147,7,9,7,16,37,47,-10,34
FC Thun,9147,8,9,6,17,41,58,-17,33
FC Sion,9147,9,7,8,17,38,51,-13,29
Young Boys,9148,1,24,6,2,77,32,45,78
FC Basel,9148,2,17,8,7,53,29,24,59
St Gallen,9148,3,14,2,16,44,59,-15,44
Lucerne,9148,4,12,7,13,42,49,-7,43
FC Zürich,9148,5,10,9,13,41,39,2,39
Grasshoppers,9148,6,11,6,15,44,49,-5,39
FC Lugano,9148,7,11,5,16,30,47,-17,38
FC Thun,9148,8,10,6,16,43,56,-13,36
FC Sion,9148,9,7,7,18,42,56,-14,28
Young Boys,9149,1,23,7,2,74,36,38,76
FC Basel,9149,2,16,10,6,56,29,27,58
Lucerne,9149,3,13,8,11,45,45,0,47
FC Zürich,9149,4,12,10,10,45,37,8,46
St Gallen,9149,5,13,4,15,42,60,-18,43
FC Lugano,9149,6,10,5,17,33,47,-14,35
FC Thun,9149,7,9,7,16,45,61,-16,34
Grasshoppers,9149,8,8,8,16,39,51,-12,32
FC Sion,9149,9,6,9,17,41,54,-13,27
Young Boys,9150,1,19,9,4,69,38,31,66
FC Basel,9150,2,17,9,6,53,28,25,60
Lucerne,9150,3,13,8,11,44,46,-2,47
St Gallen,9150,4,14,3,15,43,56,-13,45
FC Zürich,9150,5,11,11,10,44,36,8,44
FC Lugano,9150,6,10,7,15,31,46,-15,37
Grasshoppers,9150,7,9,8,15,43,50,-7,35
FC Sion,9150,8,7,10,15,43,53,-10,31
FC Thun,9150,9,8,7,17,42,59,-17,31
Young Boys,9151,1,21,6,5,70,38,32,69
FC Basel,9151,2,18,9,5,55,24,31,63
St Gallen,9151,3,15,3,14,42,52,-10,48
Lucerne,9151,4,13,8,11,44,44,0,47
FC Zürich,9151,5,10,9,13,38,39,-1,39
FC Lugano,9151,6,11,5,16,31,48,-17,38
Grasshoppers,9151,7,10,6,16,44,49,-5,36
FC Thun,9151,8,10,5,17,44,58,-14,35
FC Sion,9151,9,7,7,18,40,56,-16,28
Young Boys,9152,1,22,6,4,73,34,39,72
FC Basel,9152,2,18,7,7,53,26,27,61
Lucerne,9152,3,13,7,12,42,44,-2,46
FC Zürich,9152,4,11,9,12,42,37,5,42
St Gallen,9152,5,13,3,16,40,56,-16,42
FC Thun,9152,6,11,5,16,50,62,-12,38
FC Lugano,9152,7,10,6,16,30,47,-17,36
FC Sion,9152,8,9,7,16,47,59,-12,34
Grasshoppers,9152,9,9,6,17,41,53,-12,33
Young Boys,9153,1,22,6,4,73,38,35,72
FC Basel,9153,2,18,8,6,55,26,29,62
Lucerne,9153,3,14,7,11,43,45,-2,49
St Gallen,9153,4,14,2,16,42,57,-15,44
FC Zürich,9153,5,10,9,13,38,36,2,39
FC Lugano,9153,6,11,5,16,31,46,-15,38
Grasshoppers,9153,7,10,6,16,40,49,-9,36
FC Sion,9153,8,8,8,16,45,53,-8,32
FC Thun,9153,9,8,7,17,40,57,-17,31
Young Boys,9154,1,22,7,3,69,32,37,73
FC Basel,9154,2,16,10,6,51,26,25,58
FC Zürich,9154,3,11,10,11,45,38,7,43
Lucerne,9154,4,12,7,13,43,45,-2,43
St Gallen,9154,5,13,3,16,41,61,-20,42
FC Lugano,9154,6,11,5,16,31,48,-17,38
Grasshoppers,9154,7,10,6,16,42,51,-9,36
FC Thun,9154,8,10,6,16,43,58,-15,36
FC Sion,9154,9,8,8,16,46,52,-6,32
Young Boys,9155,1,23,7,2,76,35,41,76
FC Basel,9155,2,16,9,7,53,32,21,57
St Gallen,9155,3,16,2,14,52,57,-5,50
Lucerne,9155,4,13,8,11,44,46,-2,47
FC Zürich,9155,5,11,11,10,42,36,6,44
Grasshoppers,9155,6,9,6,17,42,50,-8,33
FC Thun,9155,7,9,6,17,47,62,-15,33
FC Lugano,9155,8,9,6,17,33,55,-22,33
FC Sion,9155,9,6,9,17,44,60,-16,27
Young Boys,9156,1,21,7,4,71,38,33,70
FC Basel,9156,2,18,8,6,64,33,31,62
St Gallen,9156,3,16,2,14,48,52,-4,50
Lucerne,9156,4,11,9,12,41,48,-7,42
FC Lugano,9156,5,11,6,15,31,46,-15,39
Grasshoppers,9156,6,10,8,14,42,46,-4,38
FC Zürich,9156,7,9,10,13,39,39,0,37
FC Thun,9156,8,10,5,17,45,63,-18,35
FC Sion,9156,9,7,7,18,39,55,-16,28
Young Boys,9157,1,21,6,5,77,38,39,69
FC Basel,9157,2,18,8,6,53,25,28,62
Lucerne,9157,3,13,10,9,45,42,3,49
St Gallen,9157,4,13,3,16,41,58,-17,42
FC Zürich,9157,5,10,10,12,40,39,1,40
FC Lugano,9157,6,11,5,16,33,51,-18,38
Grasshoppers,9157,7,9,8,15,41,51,-10,35
FC Thun,9157,8,9,7,16,42,58,-16,34
FC Sion,9157,9,7,9,16,47,57,-10,30
Young Boys,9158,1,22,7,3,72,35,37,73
FC Basel,9158,2,17,8,7,52,26,26,59
Lucerne,9158,3,12,8,12,42,46,-4,44
St Gallen,9158,4,13,5,14,41,53,-12,44
FC Zürich,9158,5,10,12,10,41,36,5,42
Grasshoppers,9158,6,11,7,14,43,48,-5,40
FC Lugano,9158,7,11,6,15,31,44,-13,39
FC Thun,9158,8,8,7,17,42,60,-18,31
FC Sion,9158,9,5,10,17,40,56,-16,25
Young Boys,9159,1,23,6,3,71,32,39,75
FC Basel,9159,2,16,9,7,53,28,25,57
St Gallen,9159,3,15,4,13,47,53,-6,49
FC Zürich,9159,4,11,9,12,39,35,4,42
Grasshoppers,9159,5,12,6,14,48,48,0,42
Lucerne,9159,6,11,9,12,39,51,-12,42
FC Thun,9159,7,10,5,17,45,61,-16,35
FC Lugano,9159,8,9,7,16,30,47,-17,34
FC Sion,9159,9,6,7,19,40,57,-17,25
Young Boys,9160,1,21,7,4,70,38,32,70
FC Basel,9160,2,17,8,7,54,27,27,59
St Gallen,9160,3,15,3,14,44,55,-11,48
Lucerne,9160,4,13,7,12,41,44,-3,46
FC Zürich,9160,5,12,9,11,44,36,8,45
Grasshoppers,9160,6,10,7,15,42,48,-6,37
FC Lugano,9160,7,10,6,16,32,47,-15,36
FC Thun,9160,8,9,5,18,43,61,-18,32
FC Sion,9160,9,7,8,17,40,54,-14,29
Young Boys,9161,1,24,6,2,74,32,42,78
FC Basel,9161,2,18,7,7,62,24,38,61
Lucerne,9161,3,14,7,11,41,43,-2,49
FC Zürich,9161,4,12,10,10,42,34,8,46
St Gallen,9161,5,13,3,16,41,62,-21,42
FC Lugano,9161,6,10,6,16,31,49,-18,36
FC Thun,9161,7,10,5,17,46,59,-13,35
Grasshoppers,9161,8,8,6,18,40,58,-18,30
FC Sion,9161,9,6,8,18,40,56,-16,26
Young Boys,9162,1,23,6,3,76,37,39,75
FC Basel,9162,2,20,7,5,59,21,38,67
St Gallen,9162,3,15,2,15,42,58,-16,47
Lucerne,9162,4,13,7,12,42,43,-1,46
FC Zürich,9162,5,11,9,12,42,38,4,42
FC Lugano,9162,6,10,5,17,29,49,-20,35
Grasshoppers,9162,7,9,7,16,43,54,-11,34
FC Thun,9162,8,8,7,17,42,60,-18,31
FC Sion,9162,9,6,8,18,42,57,-15,26
Young Boys,9163,1,22,7,3,72,35,37,73
FC Basel,9163,2,17,8,7,57,30,27,59
St Gallen,9163,3,14,4,14,42,54,-12,46
Lucerne,9163,4,12,9,11,41,45,-4,45
FC Thun,9163,5,12,5,15,51,57,-6,41
FC Zürich,9163,6,10,9,13,39,39,0,39
FC Lugano,9163,7,11,5,16,32,46,-14,38
Grasshoppers,9163,8,10,6,16,42,51,-9,36
FC Sion,9163,9,6,7,19,39,58,-19,25
Young Boys,9164,1,22,7,3,74,36,38,73
FC Basel,9164,2,17,8,7,54,29,25,59
St Gallen,9164,3,15,3,14,46,56,-10,48
Lucerne,9164,4,11,10,11,41,45,-4,43
FC Zürich,9164,5,11,9,12,42,38,4,42
FC Lugano,9164,6,11,5,16,33,48,-15,38
Grasshoppers,9164,7,10,7,15,44,47,-3,37
FC Thun,9164,8,9,6,17,42,58,-16,33
FC Sion,9164,9,6,9,17,39,58,-19,27
Young Boys,9165,1,21,7,4,68,34,34,70
FC Basel,9165,2,17,9,6,53,26,27,60
Lucerne,9165,3,15,7,10,42,39,3,52
St Gallen,9165,4,15,3,14,44,52,-8,48
FC Zürich,9165,5,10,10,12,42,39,3,40
FC Lugano,9165,6,10,7,15,29,44,-15,37
FC Thun,9165,7,9,6,17,42,59,-17,33
Grasshoppers,9165,8,8,7,17,39,52,-13,31
FC Sion,9165,9,7,8,17,40,54,-14,29
Young Boys,9166,1,21,8,3,69,33,36,71
FC Basel,9166,2,16,10,6,51,25,26,58
Lucerne,9166,3,12,10,10,40,42,-2,46
FC Zürich,9166,4,12,9,11,46,37,9,45
St Gallen,9166,5,13,4,15,43,57,-14,43
FC Lugano,9166,6,11,5,16,33,49,-16,38
Grasshoppers,9166,7,10,7,15,41,47,-6,37
FC Thun,9166,8,9,6,17,40,57,-17,33
FC Sion,9166,9,7,7,18,42,58,-16,28
Young Boys,9167,1,20,6,6,68,38,30,66
FC Basel,9167,2,18,8,6,53,22,31,62
Lucerne,9167,3,13,7,12,42,44,-2,46
FC Zürich,9167,4,11,10,11,40,35,5,43
St Gallen,9167,5,13,3,16,40,57,-17,42
Grasshoppers,9167,6,11,7,14,42,47,-5,40
FC Lugano,9167,7,11,5,16,33,48,-15,38
FC Thun,9167,8,9,7,16,43,60,-17,34
FC Sion,9167,9,7,9,16,44,54,-10,30
Young Boys,9168,1,22,7,3,75,34,41,73
FC Basel,9168,2,17,9,6,51,25,26,60
St Gallen,9168,3,15,3,14,46,55,-9,48
Lucerne,9168,4,12,9,11,43,46,-3,45
FC Zürich,9168,5,11,10,11,41,35,6,43
FC Lugano,9168,6,11,5,16,33,50,-17,38
FC Thun,9168,7,10,6,16,43,56,-13,36
Grasshoppers,9168,8,8,8,16,40,51,-11,32
FC Sion,9168,9,5,9,18,40,60,-20,24
Young Boys,9169,1,23,6,3,74,33,41,75
FC Basel,9169,2,18,8,6,51,23,28,62
St Gallen,9169,3,16,2,14,42,50,-8,50
Lucerne,9169,4,12,7,13,38,45,-7,43
FC Zürich,9169,5,10,11,11,37,35,2,41
FC Lugano,9169,6,10,6,16,28,46,-18,36
FC Thun,9169,7,10,5,17,45,59,-14,35
Grasshoppers,9169,8,9,6,17,43,54,-11,33
FC Sion,9169,9,7,7,18,41,54,-13,28
Young Boys,9170,1,20,7,5,66,33,33,67
FC Basel,9170,2,19,8,5,55,24,31,65
St Gallen,9170,3,13,5,14,42,55,-13,44
Lucerne,9170,4,11,10,11,40,43,-3,43
FC Zürich,9170,5,10,10,12,41,38,3,40
FC Lugano,9170,6,10,7,15,32,47,-15,37
Grasshoppers,9170,7,10,6,16,41,52,-11,36
FC Thun,9170,8,10,5,17,46,59,-13,35
FC Sion,9170,9,8,8,16,42,54,-12,32
Young Boys,9171,1,21,7,4,70,36,34,70
FC Basel,9171,2,18,8,6,57,25,32,62
St Gallen,9171,3,14,5,13,41,51,-10,47
FC Zürich,9171,4,12,9,11,42,35,7,45
Lucerne,9171,5,12,9,11,38,41,-3,45
Grasshoppers,9171,6,11,6,15,42,49,-7,39
FC Lugano,9171,7,10,6,16,31,47,-16,36
FC Thun,9171,8,9,5,18,40,60,-20,32
FC Sion,9171,9,6,7,19,37,54,-17,25
Young Boys,9172,1,23,6,3,73,33,40,75
FC Basel,9172,2,17,8,7,56,29,27,59
Lucerne,9172,3,12,8,12,41,47,-6,44
St Gallen,9172,4,14,2,16,39,55,-16,44
FC Zürich,9172,5,10,11,11,42,39,3,41
FC Lugano,9172,6,11,6,15,36,48,-12,39
FC Thun,9172,7,10,6,16,43,57,-14,36
Grasshoppers,9172,8,9,7,16,42,47,-5,34
FC Sion,9172,9,7,8,17,39,56,-17,29
Young Boys,9173,1,21,7,4,74,35,39,70
FC Basel,9173,2,18,7,7,54,30,24,61
FC Zürich,9173,3,12,10,10,42,34,8,46
Lucerne,9173,4,12,8,12,42,47,-5,44
St Gallen,9173,5,13,3,16,42,58,-16,42
FC Lugano,9173,6,12,5,15,35,46,-11,41
Grasshoppers,9173,7,11,7,14,45,47,-2,40
FC Thun,9173,8,9,6,17,45,64,-19,33
FC Sion,9173,9,6,7,19,42,60,-18,25
Young Boys,9174,1,22,6,4,69,32,37,72
FC Basel,9174,2,16,8,8,51,27,24,56
Lucerne,9174,3,14,7,11,43,43,0,49
St Gallen,9174,4,15,3,14,45,54,-9,48
FC Zürich,9174,5,10,12,10,42,36,6,42
Grasshoppers,9174,6,10,6,16,42,52,-10,36
FC Thun,9174,7,10,6,16,45,57,-12,36
FC Lugano,9174,8,9,7,16,31,51,-20,34
FC Sion,9174,9,7,7,18,38,54,-16,28
Young Boys,9175,1,23,6,3,75,30,45,75
FC Basel,9175,2,19,8,5,54,23,31,65
St Gallen,9175,3,15,3,14,45,51,-6,48
Lucerne,9175,4,12,8,12,41,48,-7,44
FC Zürich,9175,5,10,10,12,44,42,2,40
FC Thun,9175,6,10,6,16,46,58,-12,36
Grasshoppers,9175,7,9,7,16,41,51,-10,34
FC Lugano,9175,8,9,7,16,32,53,-21,34
FC Sion,9175,9,6,7,19,35,57,-22,25
Young Boys,9176,1,23,7,2,74,34,40,76
FC Basel,9176,2,18,8,6,59,31,28,62
Lucerne,9176,3,13,8,11,45,46,-1,47
St Gallen,9176,4,13,3,16,42,59,-17,42
FC Zürich,9176,5,10,10,12,42,38,4,40
FC Thun,9176,6,11,6,15,45,57,-12,39
Grasshoppers,9176,7,9,7,16,41,50,-9,34
FC Lugano,9176,8,9,7,16,32,50,-18,34
FC Sion,9176,9,6,8,18,39,54,-15,26
Young Boys,9177,1,21,9,2,66,30,36,72
FC Basel,9177,2,18,9,5,62,23,39,63
Lucerne,9177,3,13,9,10,42,43,-1,48
St Gallen,9177,4,14,3,15,43,58,-15,45
FC Zürich,9177,5,11,10,11,40,35,5,43
FC Thun,9177,6,10,5,17,45,65,-20,35
Grasshoppers,9177,7,9,7,16,40,49,-9,34
FC Lugano,9177,8,9,7,16,28,46,-18,34
FC Sion,9177,9,6,7,19,40,57,-17,25
Young Boys,9178,1,21,8,3,69,34,35,71
FC Basel,9178,2,18,8,6,52,24,28,62
St Gallen,9178,3,15,3,14,43,53,-10,48
Lucerne,9178,4,12,9,11,41,45,-4,45
FC Zürich,9178,5,9,11,12,39,37,2,38
FC Lugano,9178,6,10,7,15,31,46,-15,37
FC Thun,9178,7,9,7,16,46,61,-15,34
Grasshoppers,9178,8,8,8,16,39,49,-10,32
FC Sion,9178,9,8,7,17,43,54,-11,31
Young Boys,9179,1,22,8,2,73,35,38,74
FC Basel,9179,2,18,8,6,53,26,27,62
Lucerne,9179,3,13,7,12,43,44,-1,46
St Gallen,9179,4,14,2,16,44,59,-15,44
FC Zürich,9179,5,10,10,12,41,40,1,40
FC Lugano,9179,6,11,5,16,36,51,-15,38
Grasshoppers,9179,7,9,7,16,43,50,-7,34
FC Thun,9179,8,9,7,16,43,57,-14,34
FC Sion,9179,9,6,10,16,40,54,-14,28
Young Boys,9180,1,20,8,4,65,32,33,68
FC Basel,9180,2,17,9,6,55,25,30,60
St Gallen,9180,3,14,5,13,44,52,-8,47
Lucerne,9180,4,12,8,12,41,46,-5,44
FC Zürich,9180,5,10,11,11,40,35,5,41
FC Lugano,9180,6,10,8,14,30,44,-14,38
Grasshoppers,9180,7,9,8,15,44,52,-8,35
FC Thun,9180,8,10,5,17,44,63,-19,35
FC Sion,9180,9,6,10,16,43,57,-14,28
FC Basel,9181,1,20,7,5,60,24,36,67
Young Boys,9181,2,20,7,5,68,37,31,67
Lucerne,9181,3,14,7,11,41,43,-2,49
St Gallen,9181,4,15,3,14,47,54,-7,48
FC Zürich,9181,5,12,9,11,40,35,5,45
FC Lugano,9181,6,9,7,16,33,50,-17,34
Grasshoppers,9181,7,9,6,17,37,51,-14,33
FC Thun,9181,8,9,5,18,41,60,-19,32
FC Sion,9181,9,7,7,18,41,54,-13,28
Young Boys,9182,1,23,7,2,80,33,47,76
FC Basel,9182,2,16,9,7,54,30,24,57
FC Zürich,9182,3,12,10,10,45,34,11,46
Lucerne,9182,4,12,10,10,40,46,-6,46
St Gallen,9182,5,14,3,15,42,54,-12,45
Grasshoppers,9182,6,10,7,15,41,49,-8,37
FC Lugano,9182,7,10,7,15,31,47,-16,37
FC Thun,9182,8,8,5,19,40,61,-21,29
FC Sion,9182,9,6,8,18,37,56,-19,26
Young Boys,9183,1,19,8,5,68,40,28,65
FC Basel,9183,2,18,9,5,57,25,32,63
St Gallen,9183,3,14,2,16,43,56,-13,44
Lucerne,9183,4,11,10,11,42,48,-6,43
FC Lugano,9183,5,12,6,14,35,44,-9,42
FC Zürich,9183,6,10,11,11,43,40,3,41
Grasshoppers,9183,7,9,9,14,41,48,-7,36
FC Sion,9183,8,8,8,16,42,51,-9,32
FC Thun,9183,9,8,7,17,41,60,-19,31
Young Boys,9184,1,21,7,4,71,39,32,70
FC Basel,9184,2,18,8,6,58,26,32,62
Lucerne,9184,3,15,7,10,48,44,4,52
St Gallen,9184,4,15,2,15,43,55,-12,47
FC Zürich,9184,5,10,11,11,43,38,5,41
Grasshoppers,9184,6,10,7,15,43,49,-6,37
FC Thun,9184,7,10,5,17,48,63,-15,35
FC Lugano,9184,8,9,5,18,31,52,-21,32
FC Sion,9184,9,6,8,18,39,58,-19,26
Young Boys,9185,1,21,7,4,71,36,35,70
FC Basel,9185,2,17,8,7,52,27,25,59
Lucerne,9185,3,14,8,10,45,40,5,50
FC Zürich,9185,4,11,10,11,41,35,6,43
St Gallen,9185,5,13,3,16,40,57,-17,42
FC Thun,9185,6,11,5,16,44,55,-11,38
FC Sion,9185,7,8,9,15,41,51,-10,33
FC Lugano,9185,8,9,6,17,29,51,-22,33
Grasshoppers,9185,9,8,8,16,38,49,-11,32
Young Boys,9186,1,21,7,4,69,32,37,70
FC Basel,9186,2,17,8,7,55,27,28,59
Lucerne,9186,3,12,9,11,41,49,-8,45
St Gallen,9186,4,14,3,15,44,57,-13,45
FC Zürich,9186,5,10,10,12,40,37,3,40
FC Lugano,9186,6,10,7,15,33,48,-15,37
FC Thun,9186,7,10,6,16,42,56,-14,36
Grasshoppers,9186,8,9,8,15,41,48,-7,35
FC Sion,9186,9,8,8,16,42,53,-11,32
Young Boys,9187,1,23,6,3,75,35,40,75
FC Basel,9187,2,19,7,6,56,26,30,64
Lucerne,9187,3,14,7,11,41,43,-2,49
St Gallen,9187,4,15,3,14,43,53,-10,48
FC Zürich,9187,5,9,11,12,37,38,-1,38
FC Thun,9187,6,10,6,16,45,58,-13,36
FC Lugano,9187,7,9,7,16,28,45,-17,34
Grasshoppers,9187,8,8,7,17,40,52,-12,31
FC Sion,9187,9,6,8,18,43,58,-15,26
Young Boys,9188,1,22,7,3,76,36,40,73
FC Basel,9188,2,18,8,6,55,28,27,62
St Gallen,9188,3,15,3,14,44,52,-8,48
FC Zürich,9188,4,11,10,11,43,37,6,43
Lucerne,9188,5,12,7,13,41,48,-7,43
FC Lugano,9188,6,11,6,15,34,47,-13,39
FC Thun,9188,7,10,7,15,47,58,-11,37
Grasshoppers,9188,8,8,7,17,39,54,-15,31
FC Sion,9188,9,6,7,19,40,59,-19,25
Young Boys,9189,1,21,7,4,69,35,34,70
FC Basel,9189,2,17,9,6,52,25,27,60
St Gallen,9189,3,15,4,13,46,53,-7,49
Lucerne,9189,4,12,7,13,38,44,-6,43
FC Zürich,9189,5,10,10,12,40,36,4,40
FC Thun,9189,6,11,5,16,48,56,-8,38
Grasshoppers,9189,7,10,6,16,38,47,-9,36
FC Lugano,9189,8,9,6,17,29,49,-20,33
FC Sion,9189,9,8,8,16,41,56,-15,32
Young Boys,9190,1,22,7,3,75,37,38,73
FC Basel,9190,2,18,8,6,54,24,30,62
Lucerne,9190,3,13,8,11,41,43,-2,47
St Gallen,9190,4,13,4,15,41,60,-19,43
FC Zürich,9190,5,10,10,12,40,37,3,40
FC Thun,9190,6,11,5,16,41,56,-15,38
FC Lugano,9190,7,10,5,17,33,50,-17,35
Grasshoppers,9190,8,8,8,16,41,51,-10,32
FC Sion,9190,9,7,9,16,43,51,-8,30
Young Boys,9191,1,23,6,3,76,32,44,75
FC Basel,9191,2,17,8,7,51,27,24,59
Lucerne,9191,3,13,9,10,45,42,3,48
FC Zürich,9191,4,12,9,11,43,35,8,45
St Gallen,9191,5,13,4,15,40,55,-15,43
FC Lugano,9191,6,11,5,16,33,48,-15,38
Grasshoppers,9191,7,8,9,15,40,53,-13,33
FC Thun,9191,8,8,7,17,40,60,-20,31
FC Sion,9191,9,6,9,17,40,56,-16,27
Young Boys,9192,1,23,6,3,75,34,41,75
FC Basel,9192,2,19,7,6,53,26,27,64
St Gallen,9192,3,15,4,13,43,50,-7,49
Lucerne,9192,4,13,8,11,40,43,-3,47
FC Zürich,9192,5,10,11,11,39,36,3,41
FC Thun,9192,6,10,6,16,41,55,-14,36
FC Lugano,9192,7,9,6,17,28,47,-19,33
Grasshoppers,9192,8,8,6,18,39,52,-13,30
FC Sion,9192,9,6,8,18,38,53,-15,26
Young Boys,9193,1,22,6,4,72,34,38,72
FC Basel,9193,2,18,7,7,54,27,27,61
Lucerne,9193,3,15,7,10,47,44,3,52
St Gallen,9193,4,14,3,15,45,59,-14,45
FC Zürich,9193,5,10,11,11,40,37,3,41
FC Lugano,9193,6,10,6,16,33,48,-15,36
FC Thun,9193,7,9,7,16,47,61,-14,34
Grasshoppers,9193,8,9,6,17,41,54,-13,33
FC Sion,9193,9,6,9,17,41,56,-15,27
Young Boys,9194,1,19,10,3,69,36,33,67
FC Basel,9194,2,17,9,6,50,24,26,60
Lucerne,9194,3,13,9,10,45,45,0,48
FC Zürich,9194,4,12,9,11,42,35,7,45
St Gallen,9194,5,14,3,15,43,56,-13,45
Grasshoppers,9194,6,10,7,15,45,51,-6,37
FC Lugano,9194,7,10,6,16,29,47,-18,36
FC Thun,9194,8,10,5,17,41,57,-16,35
FC Sion,9194,9,6,8,18,42,55,-13,26
Young Boys,9195,1,21,9,2,72,35,37,72
FC Basel,9195,2,18,9,5,60,27,33,63
St Gallen,9195,3,16,2,14,52,59,-7,50
Lucerne,9195,4,13,8,11,47,48,-1,47
FC Zürich,9195,5,10,11,11,43,38,5,41
FC Lugano,9195,6,9,7,16,28,50,-22,34
Grasshoppers,9195,7,9,6,17,39,50,-11,33
FC Thun,9195,8,9,6,17,43,61,-18,33
FC Sion,9195,9,6,8,18,42,58,-16,26
FC Basel,9196,1,20,7,5,55,24,31,67
Young Boys,9196,2,20,6,6,67,38,29,66
Lucerne,9196,3,13,8,11,40,43,-3,47
St Gallen,9196,4,15,2,15,45,55,-10,47
Grasshoppers,9196,5,11,7,14,41,45,-4,40
FC Zürich,9196,6,10,9,13,38,37,1,39
FC Thun,9196,7,10,5,17,43,58,-15,35
FC Lugano,9196,8,10,5,17,32,49,-17,35
FC Sion,9196,9,7,7,18,41,53,-12,28
Young Boys,9197,1,21,7,4,71,37,34,70
FC Basel,9197,2,19,7,6,56,23,33,64
Lucerne,9197,3,14,7,11,43,42,1,49
St Gallen,9197,4,14,4,14,42,56,-14,46
FC Zürich,9197,5,9,9,14,37,40,-3,36
FC Thun,9197,6,10,6,16,44,59,-15,36
FC Lugano,9197,7,10,6,16,30,47,-17,36
Grasshoppers,9197,8,9,7,16,41,50,-9,34
FC Sion,9197,9,7,9,16,47,57,-10,30
Young Boys,9198,1,21,8,3,70,34,36,71
FC Basel,9198,2,18,8,6,58,25,33,62
St Gallen,9198,3,15,4,13,42,51,-9,49
FC Zürich,9198,4,12,10,10,44,36,8,46
Lucerne,9198,5,11,10,11,39,44,-5,43
FC Lugano,9198,6,9,7,16,28,47,-19,34
Grasshoppers,9198,7,8,9,15,41,50,-9,33
FC Thun,9198,8,9,6,17,47,61,-14,33
FC Sion,9198,9,6,8,18,39,60,-21,26
Young Boys,9199,1,22,7,3,72,31,41,73
FC Basel,9199,2,18,7,7,50,23,27,61
Lucerne,9199,3,14,7,11,42,43,-1,49
FC Zürich,9199,4,11,9,12,41,37,4,42
St Gallen,9199,5,13,3,16,39,53,-14,42
FC Lugano,9199,6,11,6,15,31,45,-14,39
FC Thun,9199,7,10,6,16,45,57,-12,36
Grasshoppers,9199,8,9,7,16,40,51,-11,34
FC Sion,9199,9,5,10,17,38,58,-20,25
Young Boys,9200,1,22,8,2,73,34,39,74
FC Basel,9200,2,17,10,5,56,26,30,61
St Gallen,9200,3,14,3,15,43,56,-13,45
FC Zürich,9200,4,11,11,10,43,35,8,44
Lucerne,9200,5,12,7,13,41,50,-9,43
FC Lugano,9200,6,10,8,14,32,44,-12,38
Grasshoppers,9200,7,9,7,16,44,54,-10,34
FC Thun,9200,8,8,8,16,43,60,-17,32
FC Sion,9200,9,6,8,18,42,58,-16,26
Young Boys,9201,1,21,6,5,71,38,33,69
FC Basel,9201,2,16,8,8,54,29,25,56
Lucerne,9201,3,11,11,10,40,43,-3,44
FC Zürich,9201,4,11,9,12,42,41,1,42
FC Lugano,9201,5,12,6,14,36,44,-8,42
St Gallen,9201,6,13,3,16,40,57,-17,42
FC Thun,9201,7,11,6,15,46,58,-12,39
Grasshoppers,9201,8,9,8,15,41,49,-8,35
FC Sion,9201,9,8,7,17,46,57,-11,31
Young Boys,9202,1,21,8,3,68,33,35,71
FC Basel,9202,2,18,8,6,56,22,34,62
Lucerne,9202,3,13,7,12,44,47,-3,46
St Gallen,9202,4,14,2,16,41,57,-16,44
FC Zürich,9202,5,11,9,12,41,37,4,42
FC Lugano,9202,6,12,5,15,33,44,-11,41
FC Thun,9202,7,9,6,17,42,58,-16,33
FC Sion,9202,8,8,8,16,40,53,-13,32
Grasshoppers,9202,9,8,7,17,40,54,-14,31
Young Boys,9203,1,22,7,3,74,36,38,73
FC Basel,9203,2,18,8,6,56,24,32,62
Lucerne,9203,3,14,7,11,45,45,0,49
St Gallen,9203,4,13,3,16,42,59,-17,42
FC Zürich,9203,5,9,11,12,41,41,0,38
Grasshoppers,9203,6,10,6,16,42,49,-7,36
FC Lugano,9203,7,10,6,16,33,50,-17,36
FC Thun,9203,8,9,6,17,44,61,-17,33
FC Sion,9203,9,8,8,16,46,58,-12,32
Young Boys,9204,1,21,8,3,69,33,36,71
FC Basel,9204,2,16,9,7,52,27,25,57
Lucerne,9204,3,12,10,10,42,43,-1,46
FC Zürich,9204,4,12,9,11,42,37,5,45
St Gallen,9204,5,14,3,15,41,53,-12,45
Grasshoppers,9204,6,10,8,14,47,51,-4,38
FC Lugano,9204,7,10,5,17,30,49,-19,35
FC Thun,9204,8,9,7,16,41,56,-15,34
FC Sion,9204,9,6,9,17,40,55,-15,27
Young Boys,9205,1,19,7,6,67,38,29,64
FC Basel,9205,2,18,8,6,54,28,26,62
FC Zürich,9205,3,12,10,10,46,35,11,46
Lucerne,9205,4,12,8,12,40,43,-3,44
St Gallen,9205,5,14,2,16,39,54,-15,44
FC Lugano,9205,6,12,5,15,31,46,-15,41
Grasshoppers,9205,7,10,8,14,42,46,-4,38
FC Thun,9205,8,8,7,17,44,61,-17,31
FC Sion,9205,9,7,9,16,42,54,-12,30
Young Boys,9206,1,22,6,4,74,36,38,72
FC Basel,9206,2,19,7,6,53,24,29,64
Lucerne,9206,3,13,7,12,41,43,-2,46
St Gallen,9206,4,14,2,16,42,58,-16,44
FC Zürich,9206,5,11,9,12,42,38,4,42
FC Lugano,9206,6,11,5,16,35,48,-13,38
FC Thun,9206,7,11,5,16,43,58,-15,38
Grasshoppers,9206,8,10,6,16,44,53,-9,36
FC Sion,9206,9,6,7,19,40,56,-16,25
Young Boys,9207,1,21,8,3,69,35,34,71
FC Basel,9207,2,17,8,7,54,28,26,59
St Gallen,9207,3,16,2,14,46,53,-7,50
Lucerne,9207,4,13,9,10,42,42,0,48
FC Zürich,9207,5,11,10,11,41,36,5,43
Grasshoppers,9207,6,10,7,15,44,50,-6,37
FC Lugano,9207,7,10,7,15,32,46,-14,37
FC Thun,9207,8,9,5,18,43,61,-18,32
FC Sion,9207,9,5,8,19,37,57,-20,23
Young Boys,9208,1,21,8,3,73,33,40,71
FC Basel,9208,2,18,8,6,54,27,27,62
Lucerne,9208,3,13,9,10,45,46,-1,48
St Gallen,9208,4,14,3,15,46,58,-12,45
FC Lugano,9208,5,11,7,14,37,48,-11,40
FC Zürich,9208,6,9,9,14,38,43,-5,36
Grasshoppers,9208,7,9,7,16,44,54,-10,34
FC Sion,9208,8,8,8,16,44,54,-10,32
FC Thun,9208,9,9,5,18,45,63,-18,32
Young Boys,9209,1,21,8,3,68,36,32,71
FC Basel,9209,2,16,8,8,50,29,21,56
St Gallen,9209,3,16,2,14,47,54,-7,50
Lucerne,9209,4,13,7,12,47,48,-1,46
FC Zürich,9209,5,12,9,11,42,35,7,45
FC Lugano,9209,6,11,5,16,33,47,-14,38
FC Thun,9209,7,10,5,17,43,57,-14,35
FC Sion,9209,8,8,7,17,43,54,-11,31
Grasshoppers,9209,9,8,7,17,38,51,-13,31
Young Boys,9210,1,22,6,4,75,42,33,72
FC Basel,9210,2,17,9,6,60,30,30,60
Lucerne,9210,3,14,9,9,48,42,6,51
St Gallen,9210,4,13,6,13,42,53,-11,45
FC Zürich,9210,5,10,10,12,42,38,4,40
FC Lugano,9210,6,10,6,16,33,51,-18,36
Grasshoppers,9210,7,9,7,16,45,54,-9,34
FC Sion,9210,8,7,9,16,41,53,-12,30
FC Thun,9210,9,8,6,18,41,64,-23,30
Young Boys,9211,1,21,7,4,69,38,31,70
FC Basel,9211,2,18,8,6,60,25,35,62
Lucerne,9211,3,14,8,10,44,42,2,50
FC Zürich,9211,4,12,9,11,42,37,5,45
St Gallen,9211,5,13,2,17,41,60,-19,41
FC Thun,9211,6,10,6,16,46,60,-14,36
FC Lugano,9211,7,10,6,16,33,49,-16,36
Grasshoppers,9211,8,9,7,16,40,49,-9,34
FC Sion,9211,9,7,7,18,39,54,-15,28
Young Boys,9212,1,20,6,6,69,37,32,66
FC Basel,9212,2,17,8,7,53,29,24,59
St Gallen,9212,3,15,4,13,46,54,-8,49
FC Zürich,9212,4,13,9,10,43,33,10,48
Lucerne,9212,5,13,8,11,45,45,0,47
FC Thun,9212,6,10,6,16,44,58,-14,36
Grasshoppers,9212,7,9,7,16,40,50,-10,34
FC Lugano,9212,8,9,7,16,30,50,-20,34
FC Sion,9212,9,6,9,17,38,52,-14,27
Young Boys,9213,1,22,6,4,76,34,42,72
FC Basel,9213,2,17,10,5,59,26,33,61
Lucerne,9213,3,14,8,10,43,45,-2,50
St Gallen,9213,4,15,3,14,43,53,-10,48
FC Zürich,9213,5,9,12,11,42,40,2,39
Grasshoppers,9213,6,10,7,15,43,51,-8,37
FC Lugano,9213,7,10,5,17,29,51,-22,35
FC Thun,9213,8,8,8,16,44,61,-17,32
FC Sion,9213,9,5,9,18,40,58,-18,24
Young Boys,9214,1,21,7,4,73,40,33,70
FC Basel,9214,2,20,7,5,59,27,32,67
Lucerne,9214,3,13,7,12,45,49,-4,46
FC Lugano,9214,4,13,5,14,40,47,-7,44
St Gallen,9214,5,13,3,16,43,57,-14,42
FC Zürich,9214,6,9,10,13,40,41,-1,37
Grasshoppers,9214,7,9,8,15,43,50,-7,35
FC Thun,9214,8,9,7,16,44,57,-13,34
FC Sion,9214,9,6,8,18,39,58,-19,26
Young Boys,9215,1,21,8,3,71,32,39,71
FC Basel,9215,2,19,8,5,59,25,34,65
St Gallen,9215,3,14,2,16,46,60,-14,44
Lucerne,9215,4,11,9,12,39,48,-9,42
FC Zürich,9215,5,9,11,12,44,45,-1,38
FC Thun,9215,6,11,5,16,48,59,-11,38
FC Lugano,9215,7,10,7,15,34,51,-17,37
Grasshoppers,9215,8,9,8,15,41,49,-8,35
FC Sion,9215,9,6,10,16,42,55,-13,28
Young Boys,9216,1,22,6,4,73,35,38,72
FC Basel,9216,2,18,7,7,58,31,27,61
St Gallen,9216,3,16,2,14,49,51,-2,50
Lucerne,9216,4,14,7,11,42,44,-2,49
FC Zürich,9216,5,9,10,13,39,41,-2,37
FC Thun,9216,6,10,6,16,44,59,-15,36
FC Lugano,9216,7,10,6,16,30,49,-19,36
Grasshoppers,9216,8,8,7,17,39,52,-13,31
FC Sion,9216,9,7,9,16,42,54,-12,30
Young Boys,9217,1,21,9,2,74,33,41,72
FC Basel,9217,2,17,9,6,57,28,29,60
St Gallen,9217,3,15,2,15,46,58,-12,47
Lucerne,9217,4,12,8,12,41,46,-5,44
FC Zürich,9217,5,11,10,11,41,38,3,43
Grasshoppers,9217,6,9,8,15,41,49,-8,35
FC Thun,9217,7,9,7,16,46,62,-16,34
FC Sion,9217,8,8,8,16,44,52,-8,32
FC Lugano,9217,9,9,5,18,29,53,-24,32
FC Basel,9218,1,20,7,5,62,26,36,67
Young Boys,9218,2,20,7,5,69,38,31,67
St Gallen,9218,3,15,3,14,46,55,-9,48
Lucerne,9218,4,13,8,11,44,45,-1,47
FC Zürich,9218,5,11,9,12,46,39,7,42
Grasshoppers,9218,6,10,6,16,46,51,-5,36
FC Lugano,9218,7,10,6,16,31,50,-19,36
FC Thun,9218,8,9,5,18,41,64,-23,32
FC Sion,9218,9,7,7,18,41,58,-17,28
Young Boys,9219,1,22,7,3,76,37,39,73
FC Basel,9219,2,15,9,8,52,32,20,54
Lucerne,9219,3,14,8,10,48,46,2,50
St Gallen,9219,4,15,2,15,43,54,-11,47
FC Zürich,9219,5,11,9,12,42,38,4,42
FC Thun,9219,6,10,7,15,49,61,-12,37
FC Lugano,9219,7,10,6,16,30,45,-15,36
FC Sion,9219,8,8,8,16,43,53,-10,32
Grasshoppers,9219,9,8,6,18,45,62,-17,30
Young Boys,9220,1,21,7,4,70,34,36,70
FC Basel,9220,2,17,9,6,52,26,26,60
Lucerne,9220,3,13,9,10,44,41,3,48
St Gallen,9220,4,13,3,16,42,59,-17,42
FC Zürich,9220,5,10,10,12,41,39,2,40
Grasshoppers,9220,6,10,7,15,41,47,-6,37
FC Thun,9220,7,10,6,16,43,55,-12,36
FC Lugano,9220,8,10,6,16,31,50,-19,36
FC Sion,9220,9,8,7,17,39,52,-13,31
Young Boys,9221,1,21,8,3,69,34,35,71
FC Basel,9221,2,18,9,5,57,25,32,63
St Gallen,9221,3,14,3,15,41,54,-13,45
Lucerne,9221,4,11,9,12,37,42,-5,42
FC Lugano,9221,5,11,6,15,33,47,-14,39
FC Zürich,9221,6,9,11,12,40,38,2,38
FC Sion,9221,7,9,8,15,45,51,-6,35
Grasshoppers,9221,8,9,8,15,42,48,-6,35
FC Thun,9221,9,8,6,18,43,68,-25,30
Young Boys,9222,1,21,6,5,69,38,31,69
FC Basel,9222,2,18,9,5,54,23,31,63
Lucerne,9222,3,15,8,9,49,45,4,53
St Gallen,9222,4,14,3,15,44,58,-14,45
FC Zürich,9222,5,10,10,12,41,39,2,40
Grasshoppers,9222,6,10,6,16,43,51,-8,36
FC Lugano,9222,7,10,6,16,33,49,-16,36
FC Thun,9222,8,8,8,16,42,58,-16,32
FC Sion,9222,9,6,8,18,41,55,-14,26
Young Boys,9223,1,22,7,3,76,37,39,73
FC Basel,9223,2,18,8,6,61,27,34,62
St Gallen,9223,3,15,2,15,46,56,-10,47
FC Zürich,9223,4,12,9,11,42,37,5,45
Lucerne,9223,5,12,9,11,42,45,-3,45
FC Lugano,9223,6,11,5,16,33,51,-18,38
Grasshoppers,9223,7,9,7,16,40,48,-8,34
FC Thun,9223,8,9,6,17,41,61,-20,33
FC Sion,9223,9,6,7,19,39,58,-19,25
Young Boys,9224,1,20,8,4,71,39,32,68
FC Basel,9224,2,18,9,5,56,26,30,63
Lucerne,9224,3,12,11,9,44,43,1,47
St Gallen,9224,4,13,5,14,40,53,-13,44
FC Zürich,9224,5,10,9,13,39,40,-1,39
FC Lugano,9224,6,10,7,15,37,48,-11,37
FC Thun,9224,7,10,6,16,47,58,-11,36
Grasshoppers,9224,8,9,8,15,41,49,-8,35
FC Sion,9224,9,6,9,17,37,56,-19,27
Young Boys,9225,1,22,7,3,77,38,39,73
FC Basel,9225,2,18,8,6,59,29,30,62
St Gallen,9225,3,14,3,15,45,57,-12,45
Lucerne,9225,4,12,8,12,42,47,-5,44
FC Zürich,9225,5,11,10,11,40,37,3,43
FC Thun,9225,6,10,6,16,47,59,-12,36
Grasshoppers,9225,7,9,7,16,40,50,-10,34
FC Lugano,9225,8,9,7,16,30,48,-18,34
FC Sion,9225,9,7,8,17,42,57,-15,29
Young Boys,9226,1,23,6,3,73,32,41,75
FC Basel,9226,2,19,8,5,55,24,31,65
St Gallen,9226,3,15,2,15,48,57,-9,47
Lucerne,9226,4,12,7,13,43,46,-3,43
FC Zürich,9226,5,9,13,10,39,35,4,40
FC Lugano,9226,6,11,6,15,35,46,-11,39
FC Thun,9226,7,10,6,16,46,58,-12,36
Grasshoppers,9226,8,8,7,17,38,57,-19,31
FC Sion,9226,9,5,9,18,38,60,-22,24
Young Boys,9227,1,21,6,5,70,42,28,69
FC Basel,9227,2,20,7,5,62,25,37,67
St Gallen,9227,3,16,2,14,48,52,-4,50
FC Zürich,9227,4,10,11,11,40,36,4,41
Lucerne,9227,5,11,8,13,39,48,-9,41
Grasshoppers,9227,6,11,7,14,48,49,-1,40
FC Lugano,9227,7,10,5,17,31,52,-21,35
FC Thun,9227,8,8,7,17,41,62,-21,31
FC Sion,9227,9,6,9,17,40,53,-13,27
Young Boys,9228,1,24,6,2,83,34,49,78
FC Basel,9228,2,17,8,7,57,29,28,59
Lucerne,9228,3,13,7,12,42,44,-2,46
St Gallen,9228,4,14,3,15,44,56,-12,45
FC Zürich,9228,5,10,10,12,41,39,2,40
Grasshoppers,9228,6,10,6,16,42,50,-8,36
FC Thun,9228,7,10,5,17,44,63,-19,35
FC Lugano,9228,8,10,5,17,32,52,-20,35
FC Sion,9228,9,7,8,17,40,58,-18,29
Young Boys,9229,1,21,8,3,73,35,38,71
FC Basel,9229,2,18,9,5,56,23,33,63
St Gallen,9229,3,14,4,14,41,52,-11,46
Lucerne,9229,4,11,10,11,40,48,-8,43
FC Zürich,9229,5,10,10,12,41,39,2,40
FC Thun,9229,6,11,5,16,44,55,-11,38
FC Lugano,9229,7,9,6,17,28,49,-21,33
FC Sion,9229,8,8,8,16,41,51,-10,32
Grasshoppers,9229,9,8,8,16,42,54,-12,32
Young Boys,9230,1,21,7,4,68,34,34,70
FC Basel,9230,2,18,8,6,56,25,31,62
St Gallen,9230,3,15,3,14,43,52,-9,48
FC Zürich,9230,4,11,10,11,43,37,6,43
FC Lugano,9230,5,12,6,14,32,44,-12,42
Lucerne,9230,6,11,8,13,37,42,-5,41
Grasshoppers,9230,7,9,7,16,40,51,-11,34
FC Sion,9230,8,8,7,17,42,52,-10,31
FC Thun,9230,9,8,6,18,41,65,-24,30
Young Boys,9231,1,21,6,5,71,40,31,69
FC Basel,9231,2,19,7,6,61,28,33,64
Lucerne,9231,3,13,9,10,43,43,0,48
St Gallen,9231,4,14,3,15,42,54,-12,45
FC Lugano,9231,5,12,6,14,35,43,-8,42
FC Zürich,9231,6,9,9,14,37,38,-1,36
FC Thun,9231,7,9,7,16,42,61,-19,34
Grasshoppers,9231,8,8,9,15,42,51,-9,33
FC Sion,9231,9,6,10,16,37,52,-15,28
Young Boys,9232,1,21,7,4,71,36,35,70
FC Basel,9232,2,17,7,8,50,28,22,58
Lucerne,9232,3,14,9,9,44,39,5,51
St Gallen,9232,4,14,4,14,42,56,-14,46
FC Zürich,9232,5,10,10,12,40,36,4,40
FC Lugano,9232,6,10,7,15,30,45,-15,37
FC Thun,9232,7,10,6,16,47,58,-11,36
FC Sion,9232,8,7,10,15,49,54,-5,31
Grasshoppers,9232,9,8,6,18,38,59,-21,30
Young Boys,9233,1,22,7,3,73,36,37,73
FC Basel,9233,2,18,8,6,55,24,31,62
Lucerne,9233,3,13,9,10,42,44,-2,48
St Gallen,9233,4,15,2,15,43,55,-12,47
FC Zürich,9233,5,10,10,12,43,41,2,40
FC Thun,9233,6,10,7,15,46,57,-11,37
FC Lugano,9233,7,10,6,16,34,51,-17,36
Grasshoppers,9233,8,9,6,17,39,51,-12,33
FC Sion,9233,9,5,9,18,37,53,-16,24
Young Boys,9234,1,21,8,3,67,32,35,71
FC Basel,9234,2,16,9,7,53,30,23,57
St Gallen,9234,3,15,3,14,45,54,-9,48
Lucerne,9234,4,12,9,11,43,43,0,45
FC Zürich,9234,5,11,10,11,44,37,7,43
FC Lugano,9234,6,12,6,14,32,43,-11,42
Grasshoppers,9234,7,9,6,17,38,50,-12,33
FC Thun,9234,8,9,6,17,45,61,-16,33
FC Sion,9234,9,6,9,17,39,56,-17,27
Young Boys,9235,1,21,8,3,70,35,35,71
FC Basel,9235,2,16,8,8,51,28,23,56
St Gallen,9235,3,15,2,15,43,55,-12,47
FC Zürich,9235,4,12,10,10,43,35,8,46
Lucerne,9235,5,13,7,12,42,44,-2,46
Grasshoppers,9235,6,10,8,14,44,49,-5,38
FC Lugano,9235,7,10,6,16,32,49,-17,36
FC Thun,9235,8,8,8,16,44,60,-16,32
FC Sion,9235,9,6,9,17,41,55,-14,27
Young Boys,9236,1,22,7,3,79,39,40,73
FC Basel,9236,2,19,8,5,55,25,30,65
St Gallen,9236,3,14,3,15,42,59,-17,45
Lucerne,9236,4,12,7,13,43,47,-4,43
Grasshoppers,9236,5,12,6,14,44,45,-1,42
FC Zürich,9236,6,10,9,13,45,43,2,39
FC Lugano,9236,7,11,5,16,33,50,-17,38
FC Thun,9236,8,9,5,18,46,59,-13,32
FC Sion,9236,9,6,8,18,41,61,-20,26
Young Boys,9237,1,21,8,3,80,36,44,71
FC Basel,9237,2,17,8,7,53,29,24,59
St Gallen,9237,3,16,2,14,45,52,-7,50
FC Zürich,9237,4,12,9,11,42,35,7,45
Lucerne,9237,5,11,9,12,40,46,-6,42
FC Lugano,9237,6,11,5,16,32,55,-23,38
Grasshoppers,9237,7,9,9,14,41,48,-7,36
FC Thun,9237,8,9,6,17,46,59,-13,33
FC Sion,9237,9,6,8,18,39,58,-19,26
Young Boys,9238,1,21,6,5,71,37,34,69
FC Basel,9238,2,17,7,8,50,25,25,58
Lucerne,9238,3,13,7,12,41,45,-4,46
St Gallen,9238,4,14,2,16,41,57,-16,44
FC Zürich,9238,5,10,11,11,40,36,4,41
FC Lugano,9238,6,11,6,15,33,46,-13,39
Grasshoppers,9238,7,10,6,16,43,50,-7,36
FC Sion,9238,8,9,8,15,45,50,-5,35
FC Thun,9238,9,10,5,17,41,59,-18,35
Young Boys,9239,1,21,8,3,71,32,39,71
FC Basel,9239,2,18,9,5,59,24,35,63
St Gallen,9239,3,15,2,15,44,59,-15,47
Lucerne,9239,4,12,8,12,40,47,-7,44
FC Zürich,9239,5,11,10,11,42,37,5,43
Grasshoppers,9239,6,9,8,15,41,49,-8,35
FC Lugano,9239,7,10,5,17,30,47,-17,35
FC Thun,9239,8,9,5,18,44,61,-17,32
FC Sion,9239,9,8,7,17,43,58,-15,31
Young Boys,9240,1,22,6,4,68,35,33,72
FC Basel,9240,2,19,8,5,57,23,34,65
Lucerne,9240,3,14,7,11,42,41,1,49
St Gallen,9240,4,14,4,14,42,52,-10,46
FC Zürich,9240,5,11,10,11,39,34,5,43
FC Thun,9240,6,10,5,17,48,61,-13,35
FC Lugano,9240,7,9,5,18,28,48,-20,32
Grasshoppers,9240,8,8,7,17,37,50,-13,31
FC Sion,9240,9,6,10,16,41,58,-17,28
Young Boys,9241,1,20,8,4,72,37,35,68
FC Basel,9241,2,18,8,6,56,28,28,62
Lucerne,9241,3,14,7,11,43,43,0,49
St Gallen,9241,4,13,4,15,44,58,-14,43
FC Zürich,9241,5,11,9,12,39,35,4,42
FC Lugano,9241,6,11,6,15,31,45,-14,39
FC Thun,9241,7,11,5,16,44,59,-15,38
Grasshoppers,9241,8,9,7,16,40,49,-9,34
FC Sion,9241,9,6,8,18,41,56,-15,26
Young Boys,9242,1,23,6,3,79,37,42,75
FC Basel,9242,2,18,7,7,55,28,27,61
St Gallen,9242,3,15,2,15,42,57,-15,47
Lucerne,9242,4,13,7,12,40,45,-5,46
FC Lugano,9242,5,12,5,15,37,48,-11,41
FC Zürich,9242,6,10,9,13,43,40,3,39
FC Thun,9242,7,11,5,16,51,63,-12,38
Grasshoppers,9242,8,9,6,17,43,53,-10,33
FC Sion,9242,9,6,7,19,42,61,-19,25
Young Boys,9243,1,23,7,2,75,31,44,76
FC Basel,9243,2,17,7,8,52,30,22,58
St Gallen,9243,3,15,3,14,48,56,-8,48
FC Zürich,9243,4,11,11,10,41,35,6,44
Lucerne,9243,5,12,8,12,39,46,-7,44
Grasshoppers,9243,6,10,6,16,41,53,-12,36
FC Thun,9243,7,10,5,17,45,57,-12,35
FC Lugano,9243,8,9,7,16,29,47,-18,34
FC Sion,9243,9,5,10,17,39,54,-15,25
Young Boys,9244,1,20,7,5,71,38,33,67
FC Basel,9244,2,17,8,7,54,27,27,59
Lucerne,9244,3,15,8,9,41,38,3,53
St Gallen,9244,4,14,4,14,41,53,-12,46
FC Thun,9244,5,11,6,15,46,56,-10,39
FC Zürich,9244,6,9,10,13,40,41,-1,37
FC Lugano,9244,7,10,5,17,31,49,-18,35
Grasshoppers,9244,8,9,6,17,42,52,-10,33
FC Sion,9244,9,8,8,16,46,58,-12,32
Young Boys,9245,1,20,9,3,71,37,34,69
FC Basel,9245,2,17,10,5,56,28,28,61
FC Zürich,9245,3,12,9,11,46,36,10,45
St Gallen,9245,4,14,3,15,43,55,-12,45
Lucerne,9245,5,11,10,11,39,43,-4,43
FC Lugano,9245,6,12,5,15,34,47,-13,41
FC Thun,9245,7,9,7,16,44,61,-17,34
Grasshoppers,9245,8,8,8,16,39,50,-11,32
FC Sion,9245,9,5,11,16,37,52,-15,26
Young Boys,9246,1,22,7,3,72,34,38,73
FC Basel,9246,2,18,7,7,53,26,27,61
St Gallen,9246,3,14,3,15,42,56,-14,45
Lucerne,9246,4,12,7,13,40,46,-6,43
FC Thun,9246,5,11,6,15,46,55,-9,39
FC Lugano,9246,6,11,6,15,32,47,-15,39
FC Zürich,9246,7,9,10,13,37,38,-1,37
FC Sion,9246,8,9,7,16,43,51,-8,34
Grasshoppers,9246,9,8,7,17,40,52,-12,31
Young Boys,9247,1,23,6,3,78,37,41,75
FC Basel,9247,2,17,8,7,54,26,28,59
Lucerne,9247,3,14,7,11,45,44,1,49
St Gallen,9247,4,14,3,15,45,57,-12,45
FC Zürich,9247,5,10,10,12,40,37,3,40
Grasshoppers,9247,6,10,6,16,41,51,-10,36
FC Thun,9247,7,10,5,17,44,62,-18,35
FC Lugano,9247,8,10,5,17,30,52,-22,35
FC Sion,9247,9,7,8,17,45,56,-11,29
Young Boys,9248,1,22,6,4,72,37,35,72
FC Basel,9248,2,19,8,5,53,21,32,65
Lucerne,9248,3,13,7,12,39,44,-5,46
St Gallen,9248,4,14,2,16,41,54,-13,44
FC Lugano,9248,5,12,5,15,34,48,-14,41
FC Zürich,9248,6,10,10,12,39,37,2,40
Grasshoppers,9248,7,9,7,16,40,48,-8,34
FC Thun,9248,8,8,8,16,43,59,-16,32
FC Sion,9248,9,6,9,17,40,53,-13,27
Young Boys,9249,1,23,6,3,77,34,43,75
FC Basel,9249,2,19,8,5,56,24,32,65
Lucerne,9249,3,12,9,11,40,43,-3,45
St Gallen,9249,4,14,3,15,40,54,-14,45
FC Zürich,9249,5,9,12,11,38,35,3,39
FC Lugano,9249,6,10,6,16,29,46,-17,36
Grasshoppers,9249,7,9,8,15,43,51,-8,35
FC Thun,9249,8,8,6,18,42,60,-18,30
FC Sion,9249,9,6,10,16,38,56,-18,28
Young Boys,9250,1,21,9,2,72,35,37,72
FC Basel,9250,2,17,8,7,54,29,25,59
Lucerne,9250,3,14,7,11,44,45,-1,49
St Gallen,9250,4,15,3,14,47,52,-5,48
FC Zürich,9250,5,11,9,12,39,36,3,42
FC Lugano,9250,6,10,7,15,30,47,-17,37
FC Thun,9250,7,10,5,17,43,57,-14,35
Grasshoppers,9250,8,8,7,17,38,51,-13,31
FC Sion,9250,9,6,9,17,38,53,-15,27
Young Boys,9251,1,21,7,4,72,33,39,70
FC Basel,9251,2,19,7,6,56,24,32,64
Lucerne,9251,3,14,8,10,46,46,0,50
St Gallen,9251,4,15,2,15,44,54,-10,47
FC Zürich,9251,5,9,10,13,37,39,-2,37
FC Sion,9251,6,9,8,15,42,47,-5,35
FC Thun,9251,7,10,5,17,45,59,-14,35
FC Lugano,9251,8,9,7,16,28,47,-19,34
Grasshoppers,9251,9,8,6,18,39,60,-21,30
Young Boys,9252,1,22,7,3,72,34,38,73
FC Basel,9252,2,18,9,5,58,28,30,63
St Gallen,9252,3,15,4,13,47,56,-9,49
Lucerne,9252,4,11,9,12,41,46,-5,42
FC Zürich,9252,5,9,11,12,42,40,2,38
FC Lugano,9252,6,10,7,15,35,51,-16,37
Grasshoppers,9252,7,9,8,15,45,51,-6,35
FC Thun,9252,8,8,7,17,46,66,-20,31
FC Sion,9252,9,7,8,17,41,55,-14,29
Young Boys,9253,1,21,8,3,72,37,35,71
FC Basel,9253,2,16,9,7,58,28,30,57
Lucerne,9253,3,12,9,11,40,48,-8,45
St Gallen,9253,4,13,5,14,42,54,-12,44
FC Zürich,9253,5,11,10,11,44,37,7,43
Grasshoppers,9253,6,11,6,15,44,53,-9,39
FC Lugano,9253,7,10,7,15,32,47,-15,37
FC Thun,9253,8,9,7,16,45,58,-13,34
FC Sion,9253,9,6,9,17,40,55,-15,27
Young Boys,9254,1,22,7,3,75,33,42,73
FC Basel,9254,2,17,8,7,53,27,26,59
Lucerne,9254,3,13,9,10,46,44,2,48
St Gallen,9254,4,13,4,15,43,60,-17,43
FC Zürich,9254,5,10,11,11,41,35,6,41
FC Thun,9254,6,11,6,15,44,55,-11,39
FC Lugano,9254,7,10,6,16,30,53,-23,36
FC Sion,9254,8,8,7,17,44,54,-10,31
Grasshoppers,9254,9,8,6,18,38,53,-15,30
Young Boys,9255,1,23,6,3,76,35,41,75
FC Basel,9255,2,19,8,5,57,22,35,65
Lucerne,9255,3,13,7,12,41,47,-6,46
St Gallen,9255,4,14,2,16,42,58,-16,44
FC Zürich,9255,5,10,10,12,39,37,2,40
FC Lugano,9255,6,11,5,16,34,49,-15,38
FC Thun,9255,7,10,6,16,44,58,-14,36
Grasshoppers,9255,8,8,8,16,40,51,-11,32
FC Sion,9255,9,6,8,18,39,55,-16,26
Young Boys,9256,1,22,8,2,77,33,44,74
FC Basel,9256,2,17,9,6,56,25,31,60
St Gallen,9256,3,16,3,13,49,53,-4,51
Lucerne,9256,4,12,8,12,43,51,-8,44
FC Zürich,9256,5,10,10,12,39,41,-2,40
Grasshoppers,9256,6,9,8,15,42,51,-9,35
FC Thun,9256,7,9,7,16,42,56,-14,34
FC Lugano,9256,8,9,5,18,29,54,-25,32
FC Sion,9256,9,7,8,17,43,56,-13,29
Young Boys,9257,1,22,7,3,73,37,36,73
FC Basel,9257,2,18,8,6,54,24,30,62
Lucerne,9257,3,13,8,11,41,41,0,47
St Gallen,9257,4,14,3,15,41,53,-12,45
FC Zürich,9257,5,10,12,10,41,36,5,42
Grasshoppers,9257,6,11,6,15,43,49,-6,39
FC Lugano,9257,7,10,7,15,31,46,-15,37
FC Thun,9257,8,9,6,17,42,58,-16,33
FC Sion,9257,9,5,7,20,41,63,-22,22
Young Boys,9258,1,22,7,3,71,32,39,73
FC Basel,9258,2,15,8,9,50,31,19,53
Lucerne,9258,3,13,8,11,46,48,-2,47
FC Zürich,9258,4,12,10,10,41,33,8,46
St Gallen,9258,5,14,3,15,44,57,-13,45
Grasshoppers,9258,6,11,7,14,46,48,-2,40
FC Lugano,9258,7,9,8,15,32,48,-16,35
FC Thun,9258,8,8,7,17,40,59,-19,31
FC Sion,9258,9,7,8,17,40,54,-14,29
Young Boys,9259,1,23,6,3,78,34,44,75
FC Basel,9259,2,17,8,7,54,29,25,59
St Gallen,9259,3,15,3,14,46,54,-8,48
Lucerne,9259,4,12,8,12,41,46,-5,44
FC Zürich,9259,5,10,11,11,39,35,4,41
FC Lugano,9259,6,12,5,15,33,47,-14,41
FC Thun,9259,7,9,7,16,44,59,-15,34
Grasshoppers,9259,8,8,6,18,40,56,-16,30
FC Sion,9259,9,7,8,17,43,58,-15,29
Young Boys,9260,1,22,7,3,74,32,42,73
FC Basel,9260,2,17,9,6,54,27,27,60
St Gallen,9260,3,14,4,14,41,52,-11,46
Lucerne,9260,4,11,10,11,38,44,-6,43
FC Zürich,9260,5,10,10,12,39,37,2,40
FC Thun,9260,6,10,7,15,43,56,-13,37
Grasshoppers,9260,7,9,7,16,42,52,-10,34
FC Lugano,9260,8,9,7,16,31,50,-19,34
FC Sion,9260,9,7,9,16,41,53,-12,30
Young Boys,9261,1,21,8,3,73,34,39,71
FC Basel,9261,2,17,9,6,55,26,29,60
St Gallen,9261,3,15,3,14,44,53,-9,48
Lucerne,9261,4,11,8,13,39,48,-9,41
FC Lugano,9261,5,12,5,15,32,47,-15,41
FC Zürich,9261,6,9,12,11,38,35,3,39
Grasshoppers,9261,7,11,6,15,43,48,-5,39
FC Thun,9261,8,9,7,16,43,59,-16,34
FC Sion,9261,9,5,10,17,41,58,-17,25
Young Boys,9262,1,21,7,4,72,39,33,70
FC Basel,9262,2,19,7,6,59,27,32,64
St Gallen,9262,3,15,2,15,44,58,-14,47
FC Zürich,9262,4,11,11,10,42,36,6,44
Lucerne,9262,5,12,8,12,42,43,-1,44
FC Thun,9262,6,10,6,16,48,60,-12,36
Grasshoppers,9262,7,9,8,15,42,50,-8,35
FC Lugano,9262,8,9,5,18,29,51,-22,32
FC Sion,9262,9,7,8,17,43,57,-14,29
Young Boys,9263,1,22,7,3,75,35,40,73
FC Basel,9263,2,18,8,6,56,28,28,62
St Gallen,9263,3,16,2,14,49,53,-4,50
Lucerne,9263,4,13,8,11,42,46,-4,47
FC Zürich,9263,5,11,10,11,40,33,7,43
FC Thun,9263,6,10,5,17,41,59,-18,35
Grasshoppers,9263,7,9,6,17,41,54,-13,33
FC Lugano,9263,8,9,6,17,27,50,-23,33
FC Sion,9263,9,6,8,18,39,52,-13,26
Young Boys,9264,1,22,7,3,71,33,38,73
FC Basel,9264,2,20,7,5,58,24,34,67
St Gallen,9264,3,14,2,16,40,58,-18,44
FC Zürich,9264,4,11,10,11,41,33,8,43
Lucerne,9264,5,12,7,13,41,49,-8,43
Grasshoppers,9264,6,10,6,16,42,49,-7,36
FC Lugano,9264,7,10,6,16,35,46,-11,36
FC Thun,9264,8,9,6,17,40,58,-18,33
FC Sion,9264,9,7,7,18,38,56,-18,28
Young Boys,9265,1,22,7,3,73,33,40,73
FC Basel,9265,2,18,9,5,58,23,35,63
St Gallen,9265,3,14,3,15,44,55,-11,45
Lucerne,9265,4,11,9,12,39,48,-9,42
FC Lugano,9265,5,11,6,15,35,49,-14,39
FC Zürich,9265,6,9,10,13,39,39,0,37
Grasshoppers,9265,7,10,7,15,41,48,-7,37
FC Thun,9265,8,10,5,17,43,63,-20,35
FC Sion,9265,9,7,8,17,43,57,-14,29
Young Boys,9266,1,22,7,3,76,35,41,73
FC Basel,9266,2,17,8,7,55,28,27,59
St Gallen,9266,3,15,3,14,44,54,-10,48
Lucerne,9266,4,12,8,12,41,46,-5,44
FC Zürich,9266,5,11,9,12,43,39,4,42
FC Thun,9266,6,11,6,15,48,58,-10,39
FC Lugano,9266,7,10,6,16,31,49,-18,36
Grasshoppers,9266,8,9,6,17,40,53,-13,33
FC Sion,9266,9,7,7,18,43,59,-16,28
Young Boys,9267,1,21,8,3,73,39,34,71
FC Basel,9267,2,18,9,5,54,22,32,63
Lucerne,9267,3,13,7,12,42,46,-4,46
St Gallen,9267,4,14,2,16,45,59,-14,44
FC Zürich,9267,5,11,10,11,43,38,5,43
Grasshoppers,9267,6,11,6,15,47,52,-5,39
FC Thun,9267,7,9,7,16,42,56,-14,34
FC Lugano,9267,8,9,7,16,33,52,-19,34
FC Sion,9267,9,6,8,18,44,59,-15,26
Young Boys,9268,1,22,6,4,76,38,38,72
FC Basel,9268,2,19,7,6,57,23,34,64
Lucerne,9268,3,13,8,11,43,45,-2,47
St Gallen,9268,4,14,4,14,41,52,-11,46
FC Zürich,9268,5,11,9,12,39,35,4,42
Grasshoppers,9268,6,9,8,15,39,47,-8,35
FC Lugano,9268,7,10,5,17,30,52,-22,35
FC Thun,9268,8,9,7,16,42,59,-17,34
FC Sion,9268,9,5,10,17,39,55,-16,25
Young Boys,9269,1,22,6,4,72,32,40,72
FC Basel,9269,2,19,7,6,60,24,36,64
St Gallen,9269,3,16,2,14,42,52,-10,50
Lucerne,9269,4,12,8,12,39,49,-10,44
FC Zürich,9269,5,11,9,12,40,36,4,42
FC Thun,9269,6,10,5,17,45,60,-15,35
Grasshoppers,9269,7,9,6,17,41,53,-12,33
FC Lugano,9269,8,9,6,17,28,50,-22,33
FC Sion,9269,9,8,7,17,40,51,-11,31
Young Boys,9270,1,20,8,4,68,35,33,68
FC Basel,9270,2,19,8,5,55,24,31,65
St Gallen,9270,3,15,4,13,41,50,-9,49
Lucerne,9270,4,12,9,11,39,42,-3,45
FC Zürich,9270,5,11,9,12,39,35,4,42
FC Lugano,9270,6,10,6,16,31,47,-16,36
Grasshoppers,9270,7,9,8,15,41,48,-7,35
FC Thun,9270,8,9,5,18,44,59,-15,32
FC Sion,9270,9,6,9,17,37,55,-18,27
Young Boys,9271,1,22,6,4,69,36,33,72
FC Basel,9271,2,18,7,7,54,24,30,61
Lucerne,9271,3,15,8,9,45,40,5,53
St Gallen,9271,4,14,2,16,41,56,-15,44
FC Lugano,9271,5,11,5,16,34,48,-14,38
FC Zürich,9271,6,9,10,13,38,38,0,37
Grasshoppers,9271,7,9,9,14,41,47,-6,36
FC Thun,9271,8,8,7,17,42,63,-21,31
FC Sion,9271,9,7,8,17,39,51,-12,29
Young Boys,9272,1,20,8,4,70,39,31,68
FC Basel,9272,2,18,8,6,54,22,32,62
Lucerne,9272,3,13,9,10,44,44,0,48
FC Zürich,9272,4,12,10,10,40,33,7,46
St Gallen,9272,5,14,4,14,45,56,-11,46
FC Thun,9272,6,10,7,15,43,55,-12,37
Grasshoppers,9272,7,10,6,16,41,48,-7,36
FC Lugano,9272,8,9,5,18,27,50,-23,32
FC Sion,9272,9,5,9,18,38,55,-17,24
Young Boys,9273,1,22,6,4,77,39,38,72
FC Basel,9273,2,19,7,6,60,29,31,64
FC Zürich,9273,3,12,10,10,44,35,9,46
St Gallen,9273,4,14,3,15,45,56,-11,45
Lucerne,9273,5,12,8,12,39,44,-5,44
Grasshoppers,9273,6,11,7,14,48,51,-3,40
FC Lugano,9273,7,9,6,17,29,53,-24,33
FC Thun,9273,8,8,7,17,43,63,-20,31
FC Sion,9273,9,5,10,17,38,53,-15,25
Young Boys,9274,1,22,6,4,71,35,36,72
FC Basel,9274,2,20,7,5,60,25,35,67
St Gallen,9274,3,14,3,15,40,54,-14,45
Lucerne,9274,4,11,10,11,38,43,-5,43
FC Zürich,9274,5,9,11,12,39,39,0,38
FC Sion,9274,6,9,8,15,46,51,-5,35
FC Lugano,9274,7,9,7,16,28,45,-17,34
Grasshoppers,9274,8,8,9,15,37,48,-11,33
FC Thun,9274,9,8,7,17,42,61,-19,31
Young Boys,9275,1,21,8,3,70,39,31,71
FC Basel,9275,2,18,8,6,55,25,30,62
Lucerne,9275,3,12,9,11,42,44,-2,45
St Gallen,9275,4,14,2,16,42,55,-13,44
FC Zürich,9275,5,11,9,12,40,36,4,42
Grasshoppers,9275,6,11,7,14,51,49,2,40
FC Lugano,9275,7,11,7,14,35,47,-12,40
FC Thun,9275,8,8,6,18,41,64,-23,30
FC Sion,9275,9,6,8,18,42,59,-17,26
Young Boys,9276,1,21,8,3,73,39,34,71
FC Basel,9276,2,18,9,5,54,24,30,63
St Gallen,9276,3,14,3,15,43,55,-12,45
Lucerne,9276,4,11,9,12,42,48,-6,42
FC Zürich,9276,5,10,11,11,39,35,4,41
Grasshoppers,9276,6,10,7,15,44,51,-7,37
FC Thun,9276,7,10,7,15,46,56,-10,37
FC Lugano,9276,8,9,8,15,31,47,-16,35
FC Sion,9276,9,6,8,18,40,57,-17,26
Young Boys,9277,1,20,8,4,71,40,31,68
FC Basel,9277,2,16,9,7,51,27,24,57
Lucerne,9277,3,14,9,9,43,40,3,51
St Gallen,9277,4,15,4,13,43,52,-9,49
FC Zürich,9277,5,11,10,11,39,35,4,43
FC Thun,9277,6,11,5,16,47,58,-11,38
Grasshoppers,9277,7,9,6,17,41,51,-10,33
FC Lugano,9277,8,9,6,17,28,47,-19,33
FC Sion,9277,9,6,9,17,43,56,-13,27
Young Boys,9278,1,22,7,3,69,34,35,73
FC Basel,9278,2,18,8,6,54,25,29,62
Lucerne,9278,3,13,7,12,45,46,-1,46
St Gallen,9278,4,14,3,15,45,56,-11,45
FC Zürich,9278,5,10,11,11,39,35,4,41
Grasshoppers,9278,6,10,6,16,41,47,-6,36
FC Lugano,9278,7,10,6,16,33,52,-19,36
FC Thun,9278,8,9,5,18,40,59,-19,32
FC Sion,9278,9,7,9,16,39,51,-12,30
Young Boys,9279,1,20,8,4,71,38,33,68
FC Basel,9279,2,19,8,5,60,25,35,65
Lucerne,9279,3,15,7,10,46,40,6,52
St Gallen,9279,4,14,2,16,42,55,-13,44
FC Zürich,9279,5,11,9,12,43,39,4,42
FC Thun,9279,6,11,5,16,49,63,-14,38
Grasshoppers,9279,7,9,6,17,40,56,-16,33
FC Lugano,9279,8,9,6,17,29,50,-21,33
FC Sion,9279,9,7,7,18,41,55,-14,28
Young Boys,9280,1,22,8,2,70,32,38,74
FC Basel,9280,2,17,9,6,55,28,27,60
St Gallen,9280,3,16,2,14,43,52,-9,50
Lucerne,9280,4,12,8,12,44,49,-5,44
FC Zürich,9280,5,10,10,12,44,43,1,40
FC Thun,9280,6,11,5,16,50,58,-8,38
FC Lugano,9280,7,11,5,16,32,46,-14,38
Grasshoppers,9280,8,9,6,17,43,56,-13,33
FC Sion,9280,9,6,7,19,39,56,-17,25
Young Boys,9281,1,21,8,3,74,35,39,71
FC Basel,9281,2,17,9,6,57,31,26,60
Lucerne,9281,3,15,7,10,46,43,3,52
St Gallen,9281,4,14,4,14,44,56,-12,46
FC Zürich,9281,5,11,9,12,42,38,4,42
FC Thun,9281,6,10,5,17,46,59,-13,35
Grasshoppers,9281,7,9,6,17,39,52,-13,33
FC Lugano,9281,8,9,6,17,31,53,-22,33
FC Sion,9281,9,7,8,17,41,53,-12,29
Young Boys,9282,1,23,6,3,73,34,39,75
FC Basel,9282,2,17,9,6,53,24,29,60
St Gallen,9282,3,14,3,15,43,56,-13,45
FC Zürich,9282,4,11,10,11,43,34,9,43
Lucerne,9282,5,11,8,13,39,50,-11,41
FC Lugano,9282,6,11,6,15,33,46,-13,39
Grasshoppers,9282,7,10,7,15,44,50,-6,37
FC Thun,9282,8,9,6,17,42,58,-16,33
FC Sion,9282,9,7,7,18,40,58,-18,28
Young Boys,9283,1,21,7,4,71,34,37,70
FC Basel,9283,2,17,9,6,52,27,25,60
Lucerne,9283,3,14,8,10,43,41,2,50
FC Zürich,9283,4,11,10,11,39,33,6,43
St Gallen,9283,5,13,3,16,41,57,-16,42
FC Lugano,9283,6,10,7,15,32,49,-17,37
Grasshoppers,9283,7,9,8,15,40,47,-7,35
FC Thun,9283,8,9,7,16,43,59,-16,34
FC Sion,9283,9,6,9,17,36,50,-14,27
Young Boys,9284,1,20,8,4,65,32,33,68
FC Basel,9284,2,19,8,5,57,25,32,65
Lucerne,9284,3,11,10,11,41,46,-5,43
St Gallen,9284,4,13,3,16,42,61,-19,42
FC Lugano,9284,5,11,7,14,29,42,-13,40
FC Zürich,9284,6,9,11,12,40,38,2,38
Grasshoppers,9284,7,10,7,15,43,50,-7,37
FC Thun,9284,8,9,7,16,47,62,-15,34
FC Sion,9284,9,8,7,17,48,56,-8,31
Young Boys,9285,1,20,9,3,69,35,34,69
FC Basel,9285,2,18,7,7,55,27,28,61
Lucerne,9285,3,13,8,11,46,48,-2,47
St Gallen,9285,4,15,2,15,49,60,-11,47
FC Zürich,9285,5,11,10,11,43,38,5,43
FC Lugano,9285,6,10,7,15,38,53,-15,37
Grasshoppers,9285,7,8,9,15,41,51,-10,33
FC Thun,9285,8,9,6,17,47,62,-15,33
FC Sion,9285,9,7,8,17,41,55,-14,29
Young Boys,9286,1,22,7,3,71,34,37,73
FC Basel,9286,2,19,7,6,56,25,31,64
Lucerne,9286,3,13,8,11,44,44,0,47
FC Zürich,9286,4,11,9,12,42,37,5,42
St Gallen,9286,5,13,2,17,42,58,-16,41
Grasshoppers,9286,6,11,7,14,44,48,-4,40
FC Lugano,9286,7,10,6,16,31,49,-18,36
FC Thun,9286,8,9,5,18,43,62,-19,32
FC Sion,9286,9,7,7,18,38,54,-16,28
Young Boys,9287,1,21,6,5,70,36,34,69
FC Basel,9287,2,17,8,7,53,28,25,59
FC Zürich,9287,3,11,11,10,45,37,8,44
Lucerne,9287,4,12,8,12,38,43,-5,44
St Gallen,9287,5,14,2,16,41,54,-13,44
FC Thun,9287,6,11,6,15,46,55,-9,39
FC Lugano,9287,7,11,6,15,32,47,-15,39
Grasshoppers,9287,8,9,7,16,39,50,-11,34
FC Sion,9287,9,7,8,17,41,55,-14,29
Young Boys,9288,1,23,6,3,75,33,42,75
FC Basel,9288,2,18,7,7,54,28,26,61
Lucerne,9288,3,12,10,10,41,42,-1,46
FC Zürich,9288,4,11,10,11,41,36,5,43
St Gallen,9288,5,13,4,15,40,53,-13,43
FC Lugano,9288,6,11,6,15,33,46,-13,39
Grasshoppers,9288,7,9,7,16,41,51,-10,34
FC Thun,9288,8,9,6,17,45,58,-13,33
FC Sion,9288,9,6,8,18,39,62,-23,26
Young Boys,9289,1,22,8,2,75,34,41,74
FC Basel,9289,2,17,9,6,54,27,27,60
St Gallen,9289,3,15,3,14,41,52,-11,48
Lucerne,9289,4,12,9,11,39,46,-7,45
FC Zürich,9289,5,11,10,11,45,36,9,43
FC Thun,9289,6,10,5,17,44,63,-19,35
Grasshoppers,9289,7,9,7,16,39,48,-9,34
FC Lugano,9289,8,9,5,18,29,49,-20,32
FC Sion,9289,9,7,8,17,42,53,-11,29
Young Boys,9290,1,22,8,2,74,33,41,74
FC Basel,9290,2,17,8,7,52,24,28,59
Lucerne,9290,3,12,9,11,38,42,-4,45
FC Zürich,9290,4,11,11,10,41,34,7,44
St Gallen,9290,5,13,4,15,40,55,-15,43
FC Lugano,9290,6,10,6,16,30,50,-20,36
Grasshoppers,9290,7,9,8,15,40,48,-8,35
FC Thun,9290,8,9,6,17,41,57,-16,33
FC Sion,9290,9,7,8,17,43,56,-13,29
Young Boys,9291,1,22,6,4,70,34,36,72
FC Basel,9291,2,18,8,6,56,23,33,62
Lucerne,9291,3,14,9,9,45,40,5,51
FC Lugano,9291,4,12,6,14,34,43,-9,42
St Gallen,9291,5,13,3,16,41,58,-17,42
FC Zürich,9291,6,10,10,12,39,40,-1,40
FC Thun,9291,7,10,5,17,43,59,-16,35
Grasshoppers,9291,8,8,7,17,39,54,-15,31
FC Sion,9291,9,5,10,17,40,56,-16,25
Young Boys,9292,1,22,7,3,73,37,36,73
FC Basel,9292,2,18,7,7,54,29,25,61
Lucerne,9292,3,14,7,11,47,43,4,49
St Gallen,9292,4,14,2,16,43,57,-14,44
FC Zürich,9292,5,10,11,11,40,36,4,41
Grasshoppers,9292,6,10,6,16,41,51,-10,36
FC Thun,9292,7,10,6,16,42,56,-14,36
FC Lugano,9292,8,10,6,16,33,49,-16,36
FC Sion,9292,9,6,8,18,38,53,-15,26
Young Boys,9293,1,21,8,3,72,34,38,71
FC Basel,9293,2,18,9,5,54,23,31,63
FC Zürich,9293,3,12,9,11,43,35,8,45
Lucerne,9293,4,12,9,11,43,47,-4,45
St Gallen,9293,5,14,3,15,45,57,-12,45
FC Lugano,9293,6,10,7,15,28,45,-17,37
Grasshoppers,9293,7,8,8,16,38,53,-15,32
FC Sion,9293,8,8,7,17,46,55,-9,31
FC Thun,9293,9,8,6,18,41,61,-20,30
Young Boys,9294,1,21,6,5,69,34,35,69
FC Basel,9294,2,17,8,7,50,25,25,59
St Gallen,9294,3,16,3,13,46,53,-7,51
Lucerne,9294,4,13,7,12,42,45,-3,46
FC Zürich,9294,5,11,9,12,41,37,4,42
FC Lugano,9294,6,11,5,16,31,47,-16,38
Grasshoppers,9294,7,10,6,16,41,51,-10,36
FC Thun,9294,8,9,6,17,41,58,-17,33
FC Sion,9294,9,7,8,17,42,53,-11,29
Young Boys,9295,1,23,7,2,75,32,43,76
FC Basel,9295,2,17,9,6,52,25,27,60
St Gallen,9295,3,15,3,14,44,53,-9,48
FC Zürich,9295,4,11,10,11,40,35,5,43
Lucerne,9295,5,11,10,11,41,46,-5,43
FC Lugano,9295,6,10,6,16,28,48,-20,36
Grasshoppers,9295,7,9,8,15,42,49,-7,35
FC Thun,9295,8,9,6,17,42,58,-16,33
FC Sion,9295,9,5,9,18,39,57,-18,24
Young Boys,9296,1,22,7,3,73,35,38,73
FC Basel,9296,2,19,7,6,56,26,30,64
Lucerne,9296,3,14,8,10,46,43,3,50
St Gallen,9296,4,13,3,16,40,57,-17,42
FC Zürich,9296,5,10,9,13,43,41,2,39
FC Lugano,9296,6,11,5,16,33,48,-15,38
FC Thun,9296,7,10,5,17,45,58,-13,35
Grasshoppers,9296,8,8,7,17,41,56,-15,31
FC Sion,9296,9,7,9,16,40,53,-13,30
Young Boys,9297,1,22,6,4,74,35,39,72
FC Basel,9297,2,19,7,6,56,26,30,64
St Gallen,9297,3,14,3,15,43,56,-13,45
Lucerne,9297,4,12,8,12,43,47,-4,44
FC Zürich,9297,5,11,9,12,41,38,3,42
Grasshoppers,9297,6,10,7,15,43,50,-7,37
FC Thun,9297,7,10,6,16,45,58,-13,36
FC Lugano,9297,8,10,5,17,31,52,-21,35
FC Sion,9297,9,7,7,18,38,52,-14,28
Young Boys,9298,1,23,7,2,74,32,42,76
FC Basel,9298,2,17,10,5,53,26,27,61
Lucerne,9298,3,13,8,11,45,42,3,47
St Gallen,9298,4,14,4,14,43,53,-10,46
FC Zürich,9298,5,11,9,12,39,35,4,42
FC Thun,9298,6,9,8,15,43,57,-14,35
FC Lugano,9298,7,9,6,17,28,49,-21,33
Grasshoppers,9298,8,8,8,16,39,54,-15,32
FC Sion,9298,9,5,10,17,40,56,-16,25
Young Boys,9299,1,20,8,4,67,33,34,68
FC Basel,9299,2,18,9,5,56,24,32,63
St Gallen,9299,3,16,2,14,43,53,-10,50
Lucerne,9299,4,12,8,12,42,46,-4,44
FC Zürich,9299,5,11,10,11,42,34,8,43
FC Lugano,9299,6,11,5,16,31,50,-19,38
Grasshoppers,9299,7,10,7,15,41,49,-8,37
FC Thun,9299,8,8,8,16,44,60,-16,32
FC Sion,9299,9,5,9,18,38,55,-17,24
Young Boys,9300,1,22,6,4,72,33,39,72
FC Basel,9300,2,18,8,6,54,24,30,62
St Gallen,9300,3,15,3,14,48,54,-6,48
Lucerne,9300,4,12,8,12,40,49,-9,44
FC Zürich,9300,5,11,10,11,43,38,5,43
Grasshoppers,9300,6,10,7,15,43,49,-6,37
FC Thun,9300,7,9,6,17,44,62,-18,33
FC Lugano,9300,8,9,6,17,31,51,-20,33
FC Sion,9300,9,7,8,17,41,56,-15,29
Young Boys,9301,1,22,6,4,73,35,38,72
FC Basel,9301,2,20,7,5,56,23,33,67
St Gallen,9301,3,15,3,14,46,55,-9,48
Lucerne,9301,4,12,8,12,44,47,-3,44
FC Zürich,9301,5,10,11,11,41,37,4,41
FC Lugano,9301,6,10,7,15,35,51,-16,37
Grasshoppers,9301,7,9,8,15,41,51,-10,35
FC Thun,9301,8,9,5,18,40,60,-20,32
FC Sion,9301,9,5,9,18,38,55,-17,24
Young Boys,9302,1,20,8,4,67,38,29,68
FC Basel,9302,2,19,7,6,55,25,30,64
Lucerne,9302,3,13,9,10,45,42,3,48
St Gallen,9302,4,15,3,14,45,56,-11,48
FC Zürich,9302,5,9,10,13,38,37,1,37
FC Lugano,9302,6,10,7,15,32,46,-14,37
FC Thun,9302,7,10,6,16,45,58,-13,36
Grasshoppers,9302,8,9,8,15,44,50,-6,35
FC Sion,9302,9,6,8,18,39,58,-19,26
Young Boys,9303,1,20,8,4,66,36,30,68
FC Basel,9303,2,16,8,8,53,29,24,56
Lucerne,9303,3,15,8,9,46,41,5,53
St Gallen,9303,4,15,3,14,44,53,-9,48
FC Zürich,9303,5,11,9,12,40,36,4,42
FC Thun,9303,6,11,6,15,49,56,-7,39
Grasshoppers,9303,7,9,6,17,39,56,-17,33
FC Lugano,9303,8,9,5,18,29,49,-20,32
FC Sion,9303,9,7,9,16,39,49,-10,30
Young Boys,9304,1,21,8,3,74,36,38,71
FC Basel,9304,2,17,9,6,53,27,26,60
Lucerne,9304,3,13,8,11,42,43,-1,47
FC Zürich,9304,4,12,10,10,42,32,10,46
St Gallen,9304,5,14,3,15,41,54,-13,45
Grasshoppers,9304,6,11,6,15,45,49,-4,39
FC Lugano,9304,7,10,6,16,29,47,-18,36
FC Thun,9304,8,9,6,17,46,63,-17,33
FC Sion,9304,9,5,8,19,37,58,-21,23
Young Boys,9305,1,22,7,3,71,31,40,73
FC Basel,9305,2,18,9,5,55,22,33,63
Lucerne,9305,3,12,9,11,41,46,-5,45
FC Zürich,9305,4,11,10,11,41,35,6,43
St Gallen,9305,5,13,4,15,40,53,-13,43
Grasshoppers,9305,6,10,7,15,39,47,-8,37
FC Lugano,9305,7,10,5,17,29,50,-21,35
FC Thun,9305,8,8,7,17,41,61,-20,31
FC Sion,9305,9,7,8,17,38,50,-12,29
Young Boys,9306,1,21,8,3,68,32,36,71
FC Basel,9306,2,16,8,8,50,27,23,56
Lucerne,9306,3,14,8,10,43,42,1,50
St Gallen,9306,4,13,3,16,40,56,-16,42
FC Zürich,9306,5,10,11,11,41,37,4,41
Grasshoppers,9306,6,11,7,14,42,46,-4,40
FC Lugano,9306,7,10,6,16,31,48,-17,36
FC Thun,9306,8,10,5,17,44,57,-13,35
FC Sion,9306,9,6,10,16,38,52,-14,28
Young Boys,9307,1,21,7,4,78,40,38,70
FC Basel,9307,2,19,8,5,55,24,31,65
Lucerne,9307,3,13,9,10,49,47,2,48
St Gallen,9307,4,14,3,15,47,58,-11,45
FC Zürich,9307,5,10,10,12,40,37,3,40
FC Lugano,9307,6,11,5,16,34,53,-19,38
Grasshoppers,9307,7,9,6,17,47,56,-9,33
FC Thun,9307,8,9,5,18,40,60,-20,32
FC Sion,9307,9,8,7,17,42,57,-15,31
Young Boys,9308,1,22,8,2,72,32,40,74
FC Basel,9308,2,17,9,6,54,25,29,60
St Gallen,9308,3,15,3,14,48,58,-10,48
Lucerne,9308,4,11,10,11,39,43,-4,43
FC Zürich,9308,5,10,11,11,44,39,5,41
FC Lugano,9308,6,12,5,15,34,47,-13,41
Grasshoppers,9308,7,9,8,15,39,48,-9,35
FC Thun,9308,8,8,6,18,44,64,-20,30
FC Sion,9308,9,6,8,18,38,56,-18,26
Young Boys,9309,1,20,7,5,73,39,34,67
FC Basel,9309,2,19,7,6,53,23,30,64
Lucerne,9309,3,15,7,10,46,43,3,52
St Gallen,9309,4,15,2,15,44,52,-8,47
FC Zürich,9309,5,9,11,12,39,40,-1,38
FC Thun,9309,6,10,5,17,45,57,-12,35
FC Sion,9309,7,8,9,15,41,50,-9,33
Grasshoppers,9309,8,9,6,17,41,53,-12,33
FC Lugano,9309,9,9,6,17,31,56,-25,33
Young Boys,9310,1,23,7,2,79,36,43,76
FC Basel,9310,2,17,9,6,53,24,29,60
Lucerne,9310,3,14,7,11,45,48,-3,49
St Gallen,9310,4,13,4,15,42,57,-15,43
FC Zürich,9310,5,10,10,12,38,35,3,40
FC Thun,9310,6,11,6,15,45,56,-11,39
FC Lugano,9310,7,10,6,16,31,50,-19,36
Grasshoppers,9310,8,9,6,17,40,51,-11,33
FC Sion,9310,9,5,9,18,40,56,-16,24
Young Boys,9311,1,20,7,5,73,39,34,67
FC Basel,9311,2,17,10,5,54,25,29,61
Lucerne,9311,3,12,9,11,40,43,-3,45
St Gallen,9311,4,13,3,16,39,56,-17,42
FC Zürich,9311,5,10,11,11,41,37,4,41
FC Lugano,9311,6,11,6,15,30,45,-15,39
Grasshoppers,9311,7,10,8,14,41,46,-5,38
FC Thun,9311,8,9,7,16,41,56,-15,34
FC Sion,9311,9,8,7,17,43,55,-12,31
Young Boys,9312,1,23,6,3,74,33,41,75
FC Basel,9312,2,17,9,6,53,27,26,60
Lucerne,9312,3,13,9,10,41,42,-1,48
St Gallen,9312,4,15,3,14,44,53,-9,48
FC Zürich,9312,5,10,11,11,41,35,6,41
FC Lugano,9312,6,9,7,16,28,46,-18,34
FC Thun,9312,7,9,5,18,39,59,-20,32
Grasshoppers,9312,8,8,7,17,38,52,-14,31
FC Sion,9312,9,7,9,16,41,52,-11,30
Young Boys,9313,1,22,6,4,73,37,36,72
FC Basel,9313,2,19,8,5,55,24,31,65
St Gallen,9313,3,15,3,14,48,56,-8,48
Lucerne,9313,4,13,7,12,45,47,-2,46
FC Zürich,9313,5,9,10,13,37,36,1,37
FC Thun,9313,6,10,6,16,45,55,-10,36
Grasshoppers,9313,7,10,6,16,44,56,-12,36
FC Lugano,9313,8,10,6,16,31,49,-18,36
FC Sion,9313,9,6,8,18,38,56,-18,26
Young Boys,9314,1,23,6,3,72,33,39,75
FC Basel,9314,2,17,8,7,51,28,23,59
Lucerne,9314,3,13,9,10,42,40,2,48
St Gallen,9314,4,14,3,15,42,55,-13,45
FC Zürich,9314,5,11,9,12,40,40,0,42
FC Lugano,9314,6,10,6,16,30,47,-17,36
Grasshoppers,9314,7,9,7,16,41,50,-9,34
FC Thun,9314,8,9,6,17,43,59,-16,33
FC Sion,9314,9,7,8,17,44,53,-9,29
Young Boys,9315,1,22,6,4,73,36,37,72
FC Basel,9315,2,17,9,6,53,25,28,60
St Gallen,9315,3,14,5,13,42,52,-10,47
Lucerne,9315,4,12,9,11,42,43,-1,45
FC Zürich,9315,5,10,11,11,40,36,4,41
FC Thun,9315,6,11,5,16,43,58,-15,38
FC Lugano,9315,7,11,5,16,31,46,-15,38
Grasshoppers,9315,8,8,8,16,39,52,-13,32
FC Sion,9315,9,5,10,17,38,53,-15,25
Young Boys,9316,1,22,8,2,74,35,39,74
FC Basel,9316,2,16,8,8,51,31,20,56
Lucerne,9316,3,13,9,10,43,42,1,48
St Gallen,9316,4,14,4,14,42,54,-12,46
FC Zürich,9316,5,10,10,12,39,38,1,40
FC Thun,9316,6,10,7,15,43,55,-12,37
FC Lugano,9316,7,9,7,16,31,48,-17,34
Grasshoppers,9316,8,8,8,16,40,51,-11,32
FC Sion,9316,9,7,9,16,43,52,-9,30
Young Boys,9317,1,22,6,4,70,35,35,72
FC Basel,9317,2,17,8,7,52,26,26,59
Lucerne,9317,3,14,7,11,47,41,6,49
St Gallen,9317,4,15,4,13,46,55,-9,49
FC Zürich,9317,5,10,12,10,40,35,5,42
Grasshoppers,9317,6,10,6,16,41,50,-9,36
FC Thun,9317,7,9,6,17,41,58,-17,33
FC Lugano,9317,8,9,6,17,32,53,-21,33
FC Sion,9317,9,6,9,17,38,54,-16,27
Young Boys,9318,1,22,6,4,73,37,36,72
FC Basel,9318,2,16,9,7,52,27,25,57
St Gallen,9318,3,16,3,13,46,53,-7,51
Lucerne,9318,4,11,9,12,40,48,-8,42
FC Lugano,9318,5,12,5,15,36,47,-11,41
FC Zürich,9318,6,10,10,12,39,34,5,40
Grasshoppers,9318,7,10,8,14,43,46,-3,38
FC Thun,9318,8,9,6,17,40,60,-20,33
FC Sion,9318,9,5,10,17,40,57,-17,25
Young Boys,9319,1,21,9,2,75,37,38,72
FC Basel,9319,2,18,9,5,56,25,31,63
St Gallen,9319,3,15,3,14,43,53,-10,48
Lucerne,9319,4,12,9,11,44,46,-2,45
FC Zürich,9319,5,11,9,12,41,39,2,42
FC Thun,9319,6,10,5,17,44,59,-15,35
Grasshoppers,9319,7,9,7,16,46,56,-10,34
FC Lugano,9319,8,9,5,18,29,52,-23,32
FC Sion,9319,9,7,8,17,45,56,-11,29
Young Boys,9320,1,21,8,3,73,37,36,71
FC Basel,9320,2,18,8,6,57,28,29,62
St Gallen,9320,3,16,2,14,47,53,-6,50
Lucerne,9320,4,11,10,11,43,50,-7,43
FC Lugano,9320,5,11,6,15,36,48,-12,39
FC Zürich,9320,6,9,9,14,38,40,-2,36
FC Thun,9320,7,10,5,17,43,57,-14,35
Grasshoppers,9320,8,8,9,15,41,52,-11,33
FC Sion,9320,9,7,9,16,41,54,-13,30
Young Boys,9321,1,23,6,3,73,33,40,75
FC Basel,9321,2,20,7,5,62,24,38,67
FC Zürich,9321,3,12,9,11,42,38,4,45
Lucerne,9321,4,12,8,12,41,48,-7,44
St Gallen,9321,5,14,2,16,43,57,-14,44
FC Lugano,9321,6,10,5,17,30,47,-17,35
Grasshoppers,9321,7,9,7,16,44,51,-7,34
FC Thun,9321,8,9,5,18,44,64,-20,32
FC Sion,9321,9,7,7,18,39,56,-17,28
Young Boys,9322,1,22,6,4,74,36,38,72
FC Basel,9322,2,16,7,9,50,28,22,55
Lucerne,9322,3,14,7,11,45,43,2,49
St Gallen,9322,4,15,2,15,43,57,-14,47
FC Zürich,9322,5,12,9,11,44,34,10,45
FC Thun,9322,6,12,5,15,46,55,-9,41
FC Lugano,9322,7,10,5,17,30,52,-22,35
Grasshoppers,9322,8,8,7,17,40,54,-14,31
FC Sion,9322,9,7,8,17,42,55,-13,29
Young Boys,9323,1,20,9,3,68,34,34,69
FC Basel,9323,2,19,7,6,59,26,33,64
St Gallen,9323,3,16,2,14,46,54,-8,50
Lucerne,9323,4,12,8,12,39,46,-7,44
FC Zürich,9323,5,11,9,12,41,39,2,42
FC Lugano,9323,6,11,6,15,35,48,-13,39
Grasshoppers,9323,7,8,9,15,41,51,-10,33
FC Thun,9323,8,9,6,17,45,61,-16,33
FC Sion,9323,9,5,10,17,38,53,-15,25
Young Boys,9324,1,21,8,3,71,35,36,71
FC Basel,9324,2,15,10,7,47,25,22,55
St Gallen,9324,3,16,3,13,45,50,-5,51
Lucerne,9324,4,13,7,12,41,46,-5,46
FC Zürich,9324,5,10,10,12,37,35,2,40
Grasshoppers,9324,6,11,6,15,43,47,-4,39
FC Thun,9324,7,10,6,16,42,56,-14,36
FC Lugano,9324,8,9,6,17,28,46,-18,33
FC Sion,9324,9,7,8,17,40,54,-14,29
Young Boys,9325,1,21,7,4,68,38,30,70
FC Basel,9325,2,17,8,7,55,27,28,59
St Gallen,9325,3,17,2,13,44,50,-6,53
Lucerne,9325,4,13,8,11,45,45,0,47
FC Zürich,9325,5,11,11,10,44,37,7,44
Grasshoppers,9325,6,9,8,15,42,49,-7,35
FC Lugano,9325,7,9,7,16,30,49,-19,34
FC Thun,9325,8,8,8,16,43,60,-17,32
FC Sion,9325,9,5,9,18,39,55,-16,24
Young Boys,9326,1,21,7,4,71,40,31,70
FC Basel,9326,2,20,7,5,61,26,35,67
Lucerne,9326,3,12,9,11,43,45,-2,45
St Gallen,9326,4,14,2,16,42,57,-15,44
Grasshoppers,9326,5,11,7,14,49,46,3,40
FC Zürich,9326,6,9,11,12,38,37,1,38
FC Lugano,9326,7,10,7,15,30,46,-16,37
FC Thun,9326,8,10,5,17,46,64,-18,35
FC Sion,9326,9,5,9,18,37,56,-19,24
Young Boys,9327,1,21,8,3,77,37,40,71
FC Basel,9327,2,17,10,5,53,25,28,61
Lucerne,9327,3,14,9,9,44,42,2,51
St Gallen,9327,4,13,2,17,39,55,-16,41
FC Zürich,9327,5,10,10,12,38,35,3,40
FC Thun,9327,6,11,5,16,45,56,-11,38
FC Lugano,9327,7,11,5,16,29,47,-18,38
Grasshoppers,9327,8,9,6,17,39,51,-12,33
FC Sion,9327,9,7,7,18,40,56,-16,28
Young Boys,9328,1,21,8,3,74,37,37,71
FC Basel,9328,2,18,9,5,57,24,33,63
Lucerne,9328,3,14,7,11,44,44,0,49
St Gallen,9328,4,15,4,13,44,52,-8,49
FC Zürich,9328,5,11,9,12,41,39,2,42
Grasshoppers,9328,6,9,8,15,43,52,-9,35
FC Lugano,9328,7,10,5,17,33,52,-19,35
FC Thun,9328,8,9,6,17,45,62,-17,33
FC Sion,9328,9,5,8,19,37,56,-19,23
Young Boys,9329,1,22,6,4,73,32,41,72
FC Basel,9329,2,19,7,6,54,23,31,64
St Gallen,9329,3,14,3,15,41,54,-13,45
Lucerne,9329,4,12,8,12,37,46,-9,44
FC Zürich,9329,5,11,10,11,41,35,6,43
FC Lugano,9329,6,11,7,14,30,43,-13,40
FC Thun,9329,7,10,6,16,47,56,-9,36
Grasshoppers,9329,8,8,6,18,36,53,-17,30
FC Sion,9329,9,6,9,17,38,55,-17,27
Young Boys,9330,1,21,7,4,73,41,32,70
FC Basel,9330,2,18,8,6,55,27,28,62
St Gallen,9330,3,15,2,15,47,56,-9,47
Lucerne,9330,4,11,10,11,40,44,-4,43
FC Zürich,9330,5,10,11,11,42,38,4,41
FC Lugano,9330,6,11,7,14,33,45,-12,40
Grasshoppers,9330,7,10,8,14,46,47,-1,38
FC Thun,9330,8,10,5,17,46,63,-17,35
FC Sion,9330,9,5,8,19,41,62,-21,23
Young Boys,9331,1,24,6,2,76,31,45,78
FC Basel,9331,2,16,8,8,52,31,21,56
Lucerne,9331,3,12,9,11,42,44,-2,45
St Gallen,9331,4,14,2,16,43,55,-12,44
FC Zürich,9331,5,11,10,11,43,40,3,43
FC Thun,9331,6,11,5,16,44,56,-12,38
FC Lugano,9331,7,11,5,16,31,46,-15,38
Grasshoppers,9331,8,9,7,16,43,53,-10,34
FC Sion,9331,9,6,8,18,42,60,-18,26
Young Boys,9332,1,22,6,4,68,33,35,72
FC Basel,9332,2,17,8,7,53,28,25,59
St Gallen,9332,3,15,2,15,43,54,-11,47
Lucerne,9332,4,13,7,12,42,43,-1,46
FC Zürich,9332,5,10,11,11,41,37,4,41
FC Lugano,9332,6,11,5,16,30,45,-15,38
Grasshoppers,9332,7,9,7,16,40,50,-10,34
FC Thun,9332,8,9,6,17,42,59,-17,33
FC Sion,9332,9,8,8,16,42,52,-10,32
Young Boys,9333,1,22,8,2,74,35,39,74
FC Basel,9333,2,17,9,6,56,28,28,60
St Gallen,9333,3,15,3,14,45,52,-7,48
Lucerne,9333,4,12,7,13,37,49,-12,43
FC Zürich,9333,5,10,10,12,42,36,6,40
FC Lugano,9333,6,11,5,16,32,47,-15,38
Grasshoppers,9333,7,10,7,15,47,51,-4,37
FC Thun,9333,8,10,5,17,45,63,-18,35
FC Sion,9333,9,6,8,18,38,55,-17,26
Young Boys,9334,1,22,6,4,73,37,36,72
FC Basel,9334,2,17,9,6,55,26,29,60
St Gallen,9334,3,15,2,15,47,57,-10,47
Lucerne,9334,4,12,8,12,41,48,-7,44
FC Lugano,9334,5,12,5,15,32,45,-13,41
FC Zürich,9334,6,10,10,12,38,37,1,40
Grasshoppers,9334,7,10,6,16,41,49,-8,36
FC Thun,9334,8,9,6,17,43,59,-16,33
FC Sion,9334,9,7,8,17,44,56,-12,29
Young Boys,9335,1,23,6,3,73,31,42,75
FC Basel,9335,2,16,9,7,53,30,23,57
Lucerne,9335,3,13,9,10,45,44,1,48
FC Zürich,9335,4,12,10,10,45,34,11,46
St Gallen,9335,5,13,3,16,47,61,-14,42
Grasshoppers,9335,6,10,6,16,40,49,-9,36
FC Thun,9335,7,10,6,16,43,57,-14,36
FC Lugano,9335,8,10,6,16,33,51,-18,36
FC Sion,9335,9,6,7,19,38,60,-22,25
Young Boys,9336,1,21,6,5,70,38,32,69
FC Basel,9336,2,19,7,6,56,24,32,64
Lucerne,9336,3,12,8,12,41,46,-5,44
St Gallen,9336,4,14,2,16,41,61,-20,44
FC Zürich,9336,5,10,10,12,39,35,4,40
FC Lugano,9336,6,11,7,14,33,44,-11,40
Grasshoppers,9336,7,11,6,15,44,47,-3,39
FC Thun,9336,8,10,6,16,42,57,-15,36
FC Sion,9336,9,6,8,18,40,54,-14,26
Young Boys,9337,1,21,8,3,72,36,36,71
FC Basel,9337,2,17,8,7,53,26,27,59
St Gallen,9337,3,15,2,15,44,59,-15,47
Lucerne,9337,4,12,8,12,45,52,-7,44
FC Zürich,9337,5,10,10,12,41,37,4,40
FC Thun,9337,6,11,6,15,46,55,-9,39
FC Lugano,9337,7,11,6,15,37,47,-10,39
Grasshoppers,9337,8,10,7,15,43,51,-8,37
FC Sion,9337,9,5,9,18,38,56,-18,24
Young Boys,9338,1,22,7,3,72,37,35,73
FC Basel,9338,2,19,8,5,54,23,31,65
St Gallen,9338,3,15,2,15,44,56,-12,47
Lucerne,9338,4,13,7,12,45,46,-1,46
FC Zürich,9338,5,10,11,11,40,37,3,41
FC Lugano,9338,6,10,6,16,30,45,-15,36
Grasshoppers,9338,7,9,7,16,44,52,-8,34
FC Thun,9338,8,9,5,18,43,62,-19,32
FC Sion,9338,9,6,9,17,44,58,-14,27
Young Boys,9339,1,22,6,4,73,37,36,72
FC Basel,9339,2,19,7,6,54,26,28,64
Lucerne,9339,3,13,8,11,41,41,0,47
St Gallen,9339,4,14,3,15,42,55,-13,45
FC Zürich,9339,5,11,10,11,42,35,7,43
Grasshoppers,9339,6,11,7,14,44,47,-3,40
FC Thun,9339,7,9,6,17,43,58,-15,33
FC Lugano,9339,8,9,6,17,30,49,-19,33
FC Sion,9339,9,6,7,19,39,60,-21,25
Young Boys,9340,1,21,9,2,72,32,40,72
FC Basel,9340,2,17,9,6,54,26,28,60
St Gallen,9340,3,16,3,13,48,52,-4,51
FC Zürich,9340,4,11,11,10,44,36,8,44
Lucerne,9340,5,12,8,12,41,44,-3,44
FC Lugano,9340,6,10,6,16,30,53,-23,36
Grasshoppers,9340,7,8,8,16,42,52,-10,32
FC Thun,9340,8,8,7,17,41,61,-20,31
FC Sion,9340,9,6,9,17,38,54,-16,27
Young Boys,9341,1,23,7,2,77,32,45,76
FC Basel,9341,2,18,7,7,54,29,25,61
FC Zürich,9341,3,13,9,10,43,35,8,48
Lucerne,9341,4,12,9,11,40,46,-6,45
St Gallen,9341,5,14,2,16,43,59,-16,44
FC Lugano,9341,6,10,7,15,30,44,-14,37
Grasshoppers,9341,7,9,8,15,45,53,-8,35
FC Thun,9341,8,9,5,18,44,60,-16,32
FC Sion,9341,9,5,8,19,41,59,-18,23
Young Boys,9342,1,20,7,5,70,44,26,67
FC Basel,9342,2,18,7,7,55,26,29,61
St Gallen,9342,3,14,4,14,43,54,-11,46
FC Zürich,9342,4,12,9,11,43,35,8,45
Lucerne,9342,5,11,10,11,42,47,-5,43
FC Thun,9342,6,11,5,16,44,57,-13,38
FC Lugano,9342,7,10,7,15,34,49,-15,37
Grasshoppers,9342,8,10,6,16,44,49,-5,36
FC Sion,9342,9,7,7,18,42,56,-14,28
Young Boys,9343,1,20,9,3,69,35,34,69
FC Basel,9343,2,17,8,7,54,29,25,59
St Gallen,9343,3,16,2,14,46,53,-7,50
Lucerne,9343,4,13,8,11,45,45,0,47
FC Zürich,9343,5,11,10,11,41,34,7,43
Grasshoppers,9343,6,10,7,15,41,48,-7,37
FC Lugano,9343,7,10,5,17,29,48,-19,35
FC Sion,9343,8,8,8,16,39,51,-12,32
FC Thun,9343,9,8,5,19,40,61,-21,29
Young Boys,9344,1,22,8,2,77,39,38,74
FC Basel,9344,2,16,8,8,54,29,25,56
Lucerne,9344,3,12,10,10,43,43,0,46
FC Zürich,9344,4,12,9,11,43,39,4,45
St Gallen,9344,5,14,3,15,44,60,-16,45
Grasshoppers,9344,6,10,8,14,44,47,-3,38
FC Thun,9344,7,10,5,17,45,57,-12,35
FC Lugano,9344,8,9,6,17,34,52,-18,33
FC Sion,9344,9,6,9,17,40,58,-18,27
Young Boys,9345,1,21,7,4,74,36,38,70
FC Basel,9345,2,18,8,6,54,26,28,62
Lucerne,9345,3,14,9,9,44,42,2,51
St Gallen,9345,4,14,3,15,42,54,-12,45
FC Zürich,9345,5,11,9,12,44,37,7,42
FC Lugano,9345,6,10,6,16,32,52,-20,36
Grasshoppers,9345,7,9,8,15,42,49,-7,35
FC Thun,9345,8,10,5,17,44,61,-17,35
FC Sion,9345,9,5,9,18,40,59,-19,24
Young Boys,9346,1,21,8,3,67,31,36,71
FC Basel,9346,2,18,8,6,56,27,29,62
St Gallen,9346,3,16,3,13,47,51,-4,51
FC Zürich,9346,4,11,11,10,40,34,6,44
Lucerne,9346,5,11,9,12,40,45,-5,42
Grasshoppers,9346,6,10,7,15,43,50,-7,37
FC Lugano,9346,7,9,7,16,28,47,-19,34
FC Thun,9346,8,8,7,17,45,62,-17,31
FC Sion,9346,9,5,10,17,36,55,-19,25
Young Boys,9347,1,22,8,2,74,34,40,74
FC Basel,9347,2,17,9,6,55,28,27,60
St Gallen,9347,3,14,3,15,43,56,-13,45
Lucerne,9347,4,12,8,12,40,46,-6,44
FC Zürich,9347,5,10,9,13,38,37,1,39
FC Thun,9347,6,11,5,16,51,61,-10,38
Grasshoppers,9347,7,9,8,15,42,50,-8,35
FC Lugano,9347,8,10,5,17,29,48,-19,35
FC Sion,9347,9,8,7,17,44,56,-12,31
Young Boys,9348,1,22,8,2,77,36,41,74
FC Basel,9348,2,18,7,7,53,28,25,61
St Gallen,9348,3,17,2,13,49,51,-2,53
Lucerne,9348,4,12,8,12,40,45,-5,44
FC Zürich,9348,5,9,12,11,38,35,3,39
Grasshoppers,9348,6,10,8,14,44,49,-5,38
FC Thun,9348,7,9,7,16,45,59,-14,34
FC Lugano,9348,8,9,6,17,31,50,-19,33
FC Sion,9348,9,5,8,19,35,59,-24,23
Young Boys,9349,1,21,8,3,69,33,36,71
FC Basel,9349,2,18,8,6,52,25,27,62
Lucerne,9349,3,13,8,11,42,46,-4,47
St Gallen,9349,4,14,3,15,44,53,-9,45
FC Zürich,9349,5,11,10,11,43,36,7,43
FC Lugano,9349,6,10,8,14,36,49,-13,38
Grasshoppers,9349,7,9,6,17,39,49,-10,33
FC Thun,9349,8,9,5,18,43,62,-19,32
FC Sion,9349,9,7,8,17,36,51,-15,29
Young Boys,9350,1,22,6,4,73,35,38,72
FC Basel,9350,2,19,7,6,54,25,29,64
St Gallen,9350,3,15,3,14,47,57,-10,48
FC Zürich,9350,4,11,9,12,43,42,1,42
Lucerne,9350,5,11,9,12,40,47,-7,42
FC Lugano,9350,6,11,6,15,34,47,-13,39
FC Thun,9350,7,11,5,16,45,56,-11,38
Grasshoppers,9350,8,9,7,16,40,49,-9,34
FC Sion,9350,9,5,8,19,40,58,-18,23
Young Boys,9351,1,21,8,3,74,38,36,71
FC Basel,9351,2,17,9,6,53,27,26,60
St Gallen,9351,3,15,3,14,44,52,-8,48
Lucerne,9351,4,13,7,12,43,44,-1,46
FC Zürich,9351,5,9,12,11,40,37,3,39
FC Thun,9351,6,11,6,15,46,56,-10,39
FC Lugano,9351,7,11,6,15,35,49,-14,39
Grasshoppers,9351,8,8,7,17,40,56,-16,31
FC Sion,9351,9,5,10,17,36,52,-16,25
Young Boys,9352,1,21,6,5,67,35,32,69
FC Basel,9352,2,18,8,6,54,26,28,62
Lucerne,9352,3,14,8,10,43,39,4,50
St Gallen,9352,4,13,3,16,39,56,-17,42
FC Zürich,9352,5,10,10,12,37,34,3,40
FC Lugano,9352,6,11,6,15,30,44,-14,39
FC Sion,9352,7,9,7,16,45,53,-8,34
Grasshoppers,9352,8,9,6,17,38,48,-10,33
FC Thun,9352,9,9,6,17,41,59,-18,33
Young Boys,9353,1,23,7,2,73,29,44,76
FC Basel,9353,2,17,7,8,52,28,24,58
St Gallen,9353,3,16,2,14,48,55,-7,50
FC Zürich,9353,4,11,10,11,46,39,7,43
Lucerne,9353,5,11,9,12,41,50,-9,42
FC Lugano,9353,6,11,6,15,36,52,-16,39
FC Thun,9353,7,10,6,16,47,58,-11,36
Grasshoppers,9353,8,8,9,15,40,49,-9,33
FC Sion,9353,9,5,8,19,37,60,-23,23
Young Boys,9354,1,22,8,2,76,34,42,74
FC Basel,9354,2,16,11,5,53,27,26,59
Lucerne,9354,3,14,8,10,45,43,2,50
St Gallen,9354,4,14,4,14,42,53,-11,46
FC Zürich,9354,5,10,11,11,39,35,4,41
FC Thun,9354,6,10,6,16,45,57,-12,36
FC Lugano,9354,7,9,5,18,28,50,-22,32
FC Sion,9354,8,7,9,16,40,53,-13,30
Grasshoppers,9354,9,8,6,18,39,55,-16,30
Young Boys,9355,1,22,7,3,73,38,35,73
FC Basel,9355,2,18,8,6,56,24,32,62
St Gallen,9355,3,14,5,13,42,52,-10,47
Lucerne,9355,4,11,11,10,39,41,-2,44
FC Zürich,9355,5,10,10,12,40,37,3,40
FC Lugano,9355,6,11,6,15,33,47,-14,39
Grasshoppers,9355,7,9,7,16,43,52,-9,34
FC Sion,9355,8,7,9,16,39,52,-13,30
FC Thun,9355,9,8,5,19,41,63,-22,29
Young Boys,9356,1,21,9,2,74,36,38,72
FC Basel,9356,2,16,10,6,53,31,22,58
Lucerne,9356,3,12,10,10,46,44,2,46
St Gallen,9356,4,14,3,15,43,56,-13,45
FC Zürich,9356,5,11,9,12,44,37,7,42
FC Lugano,9356,6,11,6,15,37,52,-15,39
FC Thun,9356,7,10,6,16,46,60,-14,36
Grasshoppers,9356,8,8,8,16,42,53,-11,32
FC Sion,9356,9,6,9,17,39,55,-16,27
Young Boys,9357,1,21,7,4,75,34,41,70
FC Basel,9357,2,19,8,5,57,26,31,65
Lucerne,9357,3,12,10,10,41,42,-1,46
FC Zürich,9357,4,11,11,10,43,37,6,44
St Gallen,9357,5,14,2,16,39,57,-18,44
Grasshoppers,9357,6,9,8,15,42,50,-8,35
FC Lugano,9357,7,9,6,17,28,50,-22,33
FC Sion,9357,8,8,7,17,43,54,-11,31
FC Thun,9357,9,8,7,17,45,63,-18,31
Young Boys,9358,1,20,7,5,69,38,31,67
FC Basel,9358,2,17,8,7,54,31,23,59
Lucerne,9358,3,14,8,10,44,41,3,50
St Gallen,9358,4,16,2,14,45,55,-10,50
FC Zürich,9358,5,11,10,11,46,34,12,43
FC Lugano,9358,6,10,7,15,30,45,-15,37
FC Thun,9358,7,8,8,16,41,57,-16,32
Grasshoppers,9358,8,8,7,17,39,52,-13,31
FC Sion,9358,9,8,7,17,44,59,-15,31
Young Boys,9359,1,22,6,4,70,34,36,72
FC Basel,9359,2,17,8,7,51,26,25,59
St Gallen,9359,3,15,3,14,45,55,-10,48
Lucerne,9359,4,13,8,11,40,41,-1,47
Grasshoppers,9359,5,12,6,14,45,45,0,42
FC Zürich,9359,6,10,10,12,40,38,2,40
FC Lugano,9359,7,9,6,17,34,52,-18,33
FC Thun,9359,8,8,7,17,39,58,-19,31
FC Sion,9359,9,7,8,17,39,54,-15,29
Young Boys,9360,1,21,8,3,76,39,37,71
FC Basel,9360,2,18,8,6,54,25,29,62
Lucerne,9360,3,13,9,10,45,43,2,48
St Gallen,9360,4,13,3,16,45,61,-16,42
FC Zürich,9360,5,10,10,12,40,41,-1,40
FC Thun,9360,6,11,6,15,45,54,-9,39
FC Lugano,9360,7,11,6,15,38,52,-14,39
Grasshoppers,9360,8,9,6,17,41,53,-12,33
FC Sion,9360,9,6,8,18,42,58,-16,26
Young Boys,9361,1,19,9,4,69,41,28,66
FC Basel,9361,2,17,8,7,52,27,25,59
St Gallen,9361,3,16,2,14,48,56,-8,50
FC Zürich,9361,4,13,9,10,44,34,10,48
Lucerne,9361,5,13,8,11,48,46,2,47
FC Lugano,9361,6,11,5,16,31,48,-17,38
Grasshoppers,9361,7,10,6,16,48,54,-6,36
FC Thun,9361,8,10,5,17,46,59,-13,35
FC Sion,9361,9,5,8,19,41,62,-21,23
Young Boys,9362,1,22,6,4,70,36,34,72
FC Basel,9362,2,18,8,6,52,25,27,62
St Gallen,9362,3,15,3,14,44,53,-9,48
Lucerne,9362,4,12,8,12,43,46,-3,44
FC Zürich,9362,5,10,10,12,37,35,2,40
FC Lugano,9362,6,11,5,16,30,46,-16,38
Grasshoppers,9362,7,10,7,15,44,50,-6,37
FC Thun,9362,8,9,5,18,42,58,-16,32
FC Sion,9362,9,7,8,17,41,54,-13,29
Young Boys,9363,1,22,7,3,75,37,38,73
FC Basel,9363,2,18,9,5,57,25,32,63
Lucerne,9363,3,12,10,10,40,41,-1,46
FC Zürich,9363,4,11,10,11,41,37,4,43
St Gallen,9363,5,13,2,17,41,58,-17,41
FC Lugano,9363,6,11,7,14,36,46,-10,40
Grasshoppers,9363,7,8,8,16,41,56,-15,32
FC Thun,9363,8,9,5,18,46,65,-19,32
FC Sion,9363,9,7,8,17,43,55,-12,29
Young Boys,9364,1,21,7,4,73,33,40,70
FC Basel,9364,2,16,9,7,54,30,24,57
Lucerne,9364,3,14,7,11,42,44,-2,49
St Gallen,9364,4,15,3,14,44,54,-10,48
FC Zürich,9364,5,12,9,11,42,34,8,45
FC Lugano,9364,6,12,5,15,31,43,-12,41
Grasshoppers,9364,7,10,7,15,42,47,-5,37
FC Thun,9364,8,8,7,17,40,60,-20,31
FC Sion,9364,9,5,8,19,36,59,-23,23
Young Boys,9365,1,19,10,3,69,36,33,67
FC Basel,9365,2,17,9,6,51,24,27,60
Lucerne,9365,3,13,9,10,48,46,2,48
St Gallen,9365,4,15,3,14,44,54,-10,48
FC Zürich,9365,5,10,12,10,39,34,5,42
Grasshoppers,9365,6,9,8,15,40,48,-8,35
FC Thun,9365,7,9,7,16,41,55,-14,34
FC Lugano,9365,8,9,6,17,29,51,-22,33
FC Sion,9365,9,6,10,16,38,51,-13,28
Young Boys,9366,1,21,7,4,71,35,36,70
FC Basel,9366,2,19,7,6,55,25,30,64
FC Zürich,9366,3,12,9,11,44,36,8,45
Lucerne,9366,4,12,9,11,46,48,-2,45
St Gallen,9366,5,13,3,16,40,57,-17,42
FC Lugano,9366,6,12,5,15,34,47,-13,41
FC Thun,9366,7,10,5,17,44,58,-14,35
Grasshoppers,9366,8,8,7,17,40,54,-14,31
FC Sion,9366,9,7,8,17,42,56,-14,29
Young Boys,9367,1,21,8,3,70,34,36,71
FC Basel,9367,2,18,8,6,51,23,28,62
Lucerne,9367,3,13,10,9,40,39,1,49
St Gallen,9367,4,13,4,15,43,58,-15,43
FC Zürich,9367,5,10,10,12,41,39,2,40
FC Lugano,9367,6,9,8,15,32,49,-17,35
Grasshoppers,9367,7,9,7,16,40,49,-9,34
FC Thun,9367,8,9,7,16,42,57,-15,34
FC Sion,9367,9,7,8,17,43,54,-11,29
Young Boys,9368,1,19,9,4,67,36,31,66
FC Basel,9368,2,19,7,6,58,26,32,64
St Gallen,9368,3,15,3,14,47,58,-11,48
Lucerne,9368,4,12,7,13,40,45,-5,43
FC Zürich,9368,5,11,9,12,43,40,3,42
FC Thun,9368,6,11,5,16,44,57,-13,38
Grasshoppers,9368,7,10,7,15,40,47,-7,37
FC Lugano,9368,8,10,7,15,32,47,-15,37
FC Sion,9368,9,6,8,18,44,59,-15,26
Young Boys,9369,1,23,6,3,76,34,42,75
FC Basel,9369,2,20,7,5,60,25,35,67
St Gallen,9369,3,16,2,14,45,56,-11,50
Lucerne,9369,4,12,8,12,40,43,-3,44
FC Zürich,9369,5,11,9,12,43,37,6,42
FC Thun,9369,6,10,6,16,43,58,-15,36
FC Lugano,9369,7,9,6,17,30,50,-20,33
Grasshoppers,9369,8,8,8,16,39,53,-14,32
FC Sion,9369,9,5,8,19,34,54,-20,23
Young Boys,9370,1,20,7,5,65,35,30,67
FC Basel,9370,2,18,8,6,54,25,29,62
St Gallen,9370,3,15,2,15,41,56,-15,47
Lucerne,9370,4,12,10,10,41,40,1,46
FC Zürich,9370,5,11,10,11,45,38,7,43
FC Lugano,9370,6,10,6,16,32,49,-17,36
FC Thun,9370,7,10,5,17,44,58,-14,35
Grasshoppers,9370,8,9,7,16,39,49,-10,34
FC Sion,9370,9,7,9,16,42,53,-11,30
Young Boys,9371,1,21,8,3,75,42,33,71
FC Basel,9371,2,16,9,7,51,27,24,57
Lucerne,9371,3,13,9,10,40,40,0,48
St Gallen,9371,4,14,2,16,44,60,-16,44
Grasshoppers,9371,5,11,7,14,44,44,0,40
FC Zürich,9371,6,10,10,12,39,40,-1,40
FC Lugano,9371,7,11,5,16,33,47,-14,38
FC Thun,9371,8,10,6,16,48,57,-9,36
FC Sion,9371,9,6,8,18,47,64,-17,26
Young Boys,9372,1,23,6,3,75,34,41,75
FC Basel,9372,2,16,9,7,55,31,24,57
Lucerne,9372,3,13,9,10,44,43,1,48
St Gallen,9372,4,13,5,14,43,55,-12,44
FC Zürich,9372,5,10,10,12,41,38,3,40
Grasshoppers,9372,6,9,7,16,39,51,-12,34
FC Lugano,9372,7,9,7,16,28,47,-19,34
FC Sion,9372,8,8,9,15,49,55,-6,33
FC Thun,9372,9,9,6,17,45,65,-20,33
Young Boys,9373,1,21,7,4,71,35,36,70
FC Basel,9373,2,17,8,7,52,29,23,59
St Gallen,9373,3,17,2,13,45,52,-7,53
Lucerne,9373,4,14,7,11,43,43,0,49
FC Zürich,9373,5,11,10,11,43,36,7,43
FC Thun,9373,6,10,7,15,45,58,-13,37
FC Lugano,9373,7,10,5,17,29,48,-19,35
Grasshoppers,9373,8,9,7,16,40,49,-9,34
FC Sion,9373,9,5,7,20,41,59,-18,22
Young Boys,9374,1,22,7,3,77,35,42,73
FC Basel,9374,2,19,7,6,58,25,33,64
St Gallen,9374,3,15,2,15,44,55,-11,47
Lucerne,9374,4,13,7,12,46,51,-5,46
FC Zürich,9374,5,11,10,11,44,38,6,43
Grasshoppers,9374,6,9,7,16,42,50,-8,34
FC Lugano,9374,7,9,6,17,31,53,-22,33
FC Sion,9374,8,8,8,16,40,54,-14,32
FC Thun,9374,9,8,6,18,40,61,-21,30
Young Boys,9375,1,22,6,4,75,37,38,72
FC Basel,9375,2,20,7,5,59,25,34,67
Lucerne,9375,3,13,7,12,44,43,1,46
St Gallen,9375,4,14,2,16,41,56,-15,44
FC Zürich,9375,5,9,11,12,40,38,2,38
FC Thun,9375,6,10,6,16,47,61,-14,36
FC Lugano,9375,7,10,6,16,30,48,-18,36
Grasshoppers,9375,8,9,7,16,40,53,-13,34
FC Sion,9375,9,7,8,17,40,55,-15,29
Young Boys,9376,1,21,7,4,77,37,40,70
FC Basel,9376,2,18,8,6,56,26,30,62
St Gallen,9376,3,15,2,15,44,56,-12,47
Lucerne,9376,4,12,10,10,44,45,-1,46
FC Zürich,9376,5,11,10,11,43,36,7,43
Grasshoppers,9376,6,10,6,16,41,49,-8,36
FC Thun,9376,7,10,6,16,45,59,-14,36
FC Lugano,9376,8,10,6,16,32,51,-19,36
FC Sion,9376,9,6,7,19,39,62,-23,25
Young Boys,9377,1,21,7,4,69,35,34,70
FC Basel,9377,2,17,7,8,54,30,24,58
St Gallen,9377,3,17,2,13,48,54,-6,53
FC Zürich,9377,4,11,11,10,44,35,9,44
Lucerne,9377,5,12,7,13,41,48,-7,43
Grasshoppers,9377,6,11,7,14,48,51,-3,40
FC Thun,9377,7,10,6,16,47,61,-14,36
FC Lugano,9377,8,9,7,16,31,48,-17,34
FC Sion,9377,9,5,8,19,42,62,-20,23
Young Boys,9378,1,24,6,2,77,35,42,78
FC Basel,9378,2,17,9,6,55,29,26,60
Lucerne,9378,3,14,8,10,46,42,4,50
St Gallen,9378,4,14,3,15,45,58,-13,45
FC Zürich,9378,5,10,9,13,41,41,0,39
FC Thun,9378,6,10,5,17,43,60,-17,35
Grasshoppers,9378,7,9,6,17,41,50,-9,33
FC Lugano,9378,8,9,5,18,29,55,-26,32
FC Sion,9378,9,8,7,17,49,56,-7,31
Young Boys,9379,1,23,7,2,71,30,41,76
FC Basel,9379,2,17,8,7,53,27,26,59
Lucerne,9379,3,13,8,11,43,42,1,47
St Gallen,9379,4,15,2,15,43,57,-14,47
FC Zürich,9379,5,12,10,10,44,35,9,46
Grasshoppers,9379,6,10,6,16,41,49,-8,36
FC Thun,9379,7,9,7,16,43,58,-15,34
FC Lugano,9379,8,9,7,16,31,48,-17,34
FC Sion,9379,9,5,7,20,36,59,-23,22
FC Basel,9380,1,20,7,5,58,23,35,67
Young Boys,9380,2,19,6,7,67,40,27,63
Lucerne,9380,3,13,8,11,43,46,-3,47
St Gallen,9380,4,14,3,15,43,55,-12,45
FC Lugano,9380,5,12,5,15,35,49,-14,41
FC Zürich,9380,6,10,9,13,41,38,3,39
Grasshoppers,9380,7,10,7,15,44,51,-7,37
FC Thun,9380,8,10,5,17,47,59,-12,35
FC Sion,9380,9,7,8,17,42,59,-17,29
Young Boys,9381,1,21,7,4,71,34,37,70
FC Basel,9381,2,19,7,6,54,24,30,64
Lucerne,9381,3,12,9,11,39,42,-3,45
St Gallen,9381,4,13,4,15,41,55,-14,43
FC Zürich,9381,5,9,12,11,39,36,3,39
Grasshoppers,9381,6,11,6,15,42,49,-7,39
FC Lugano,9381,7,11,6,15,31,44,-13,39
FC Thun,9381,8,10,6,16,47,59,-12,36
FC Sion,9381,9,5,9,18,41,62,-21,24
Young Boys,9382,1,23,6,3,72,35,37,75
FC Basel,9382,2,17,8,7,55,29,26,59
St Gallen,9382,3,14,4,14,46,54,-8,46
Lucerne,9382,4,12,8,12,40,47,-7,44
FC Zürich,9382,5,11,9,12,44,39,5,42
FC Thun,9382,6,11,5,16,47,58,-11,38
FC Lugano,9382,7,10,7,15,33,48,-15,37
Grasshoppers,9382,8,10,6,16,43,49,-6,36
FC Sion,9382,9,6,7,19,38,59,-21,25
Young Boys,9383,1,22,6,4,74,36,38,72
FC Basel,9383,2,17,8,7,52,27,25,59
Lucerne,9383,3,14,9,9,45,41,4,51
St Gallen,9383,4,15,2,15,42,56,-14,47
FC Zürich,9383,5,12,9,11,45,36,9,45
Grasshoppers,9383,6,10,8,14,40,46,-6,38
FC Lugano,9383,7,10,5,17,30,49,-19,35
FC Thun,9383,8,8,6,18,43,62,-19,30
FC Sion,9383,9,5,9,18,41,59,-18,24
Young Boys,9384,1,20,8,4,68,37,31,68
FC Basel,9384,2,18,9,5,59,27,32,63
Lucerne,9384,3,14,9,9,43,39,4,51
FC Zürich,9384,4,11,11,10,43,34,9,44
St Gallen,9384,5,13,4,15,41,54,-13,43
FC Thun,9384,6,10,5,17,43,60,-17,35
FC Lugano,9384,7,9,8,15,31,48,-17,35
Grasshoppers,9384,8,9,6,17,38,48,-10,33
FC Sion,9384,9,6,8,18,36,55,-19,26
Young Boys,9385,1,23,7,2,75,34,41,76
FC Basel,9385,2,17,10,5,51,24,27,61
St Gallen,9385,3,15,2,15,41,53,-12,47
Lucerne,9385,4,12,8,12,41,43,-2,44
FC Lugano,9385,5,12,5,15,31,46,-15,41
FC Thun,9385,6,10,7,15,44,57,-13,37
FC Zürich,9385,7,9,9,14,39,39,0,36
Grasshoppers,9385,8,9,6,17,41,52,-11,33
FC Sion,9385,9,6,8,18,40,55,-15,26
Young Boys,9386,1,22,8,2,72,31,41,74
FC Basel,9386,2,15,11,6,51,27,24,56
FC Zürich,9386,3,12,10,10,42,33,9,46
Lucerne,9386,4,12,10,10,42,43,-1,46
St Gallen,9386,5,13,3,16,39,54,-15,42
FC Lugano,9386,6,10,6,16,29,49,-20,36
FC Thun,9386,7,9,6,17,42,59,-17,33
FC Sion,9386,8,8,8,16,42,51,-9,32
Grasshoppers,9386,9,8,8,16,40,52,-12,32
Young Boys,9387,1,23,6,3,72,34,38,75
FC Basel,9387,2,19,7,6,56,23,33,64
Lucerne,9387,3,14,7,11,42,40,2,49
St Gallen,9387,4,14,2,16,39,54,-15,44
FC Zürich,9387,5,9,11,12,39,41,-2,38
Grasshoppers,9387,6,10,6,16,42,50,-8,36
FC Thun,9387,7,10,6,16,47,60,-13,36
FC Lugano,9387,8,9,6,17,27,49,-22,33
FC Sion,9387,9,7,7,18,39,52,-13,28
Young Boys,9388,1,20,8,4,72,37,35,68
FC Basel,9388,2,18,7,7,53,27,26,61
St Gallen,9388,3,16,3,13,46,51,-5,51
Lucerne,9388,4,12,9,11,39,42,-3,45
FC Zürich,9388,5,10,11,11,41,37,4,41
Grasshoppers,9388,6,11,6,15,46,51,-5,39
FC Lugano,9388,7,10,6,16,31,51,-20,36
FC Thun,9388,8,9,5,18,43,63,-20,32
FC Sion,9388,9,6,9,17,40,52,-12,27
FC Basel,9389,1,20,7,5,61,25,36,67
Young Boys,9389,2,20,7,5,69,40,29,67
St Gallen,9389,3,16,2,14,48,53,-5,50
Lucerne,9389,4,13,8,11,47,45,2,47
FC Zürich,9389,5,11,10,11,42,35,7,43
Grasshoppers,9389,6,11,6,15,45,51,-6,39
FC Lugano,9389,7,9,6,17,30,51,-21,33
FC Thun,9389,8,9,5,18,45,60,-15,32
FC Sion,9389,9,6,7,19,37,64,-27,25
Young Boys,9390,1,21,7,4,69,38,31,70
FC Basel,9390,2,18,7,7,58,25,33,61
Lucerne,9390,3,14,7,11,44,47,-3,49
St Gallen,9390,4,14,2,16,43,60,-17,44
FC Zürich,9390,5,10,12,10,40,35,5,42
FC Lugano,9390,6,10,7,15,33,47,-14,37
FC Thun,9390,7,9,7,16,45,62,-17,34
FC Sion,9390,8,8,8,16,49,55,-6,32
Grasshoppers,9390,9,8,7,17,38,50,-12,31
Young Boys,9391,1,22,7,3,72,38,34,73
FC Basel,9391,2,18,8,6,57,28,29,62
Lucerne,9391,3,13,7,12,39,42,-3,46
St Gallen,9391,4,14,3,15,41,56,-15,45
FC Zürich,9391,5,11,9,12,43,38,5,42
FC Thun,9391,6,11,5,16,47,58,-11,38
FC Lugano,9391,7,10,6,16,30,48,-18,36
Grasshoppers,9391,8,9,6,17,43,55,-12,33
FC Sion,9391,9,7,7,18,43,52,-9,28
Young Boys,9392,1,23,6,3,74,33,41,75
FC Basel,9392,2,18,8,6,55,26,29,62
St Gallen,9392,3,15,2,15,43,55,-12,47
FC Zürich,9392,4,11,9,12,42,37,5,42
Lucerne,9392,5,11,7,14,39,48,-9,40
Grasshoppers,9392,6,11,6,15,45,51,-6,39
FC Lugano,9392,7,11,5,16,32,48,-16,38
FC Sion,9392,8,8,7,17,44,55,-11,31
FC Thun,9392,9,8,6,18,42,63,-21,30
Young Boys,9393,1,21,7,4,70,36,34,70
FC Basel,9393,2,18,8,6,54,23,31,62
Lucerne,9393,3,14,7,11,44,43,1,49
St Gallen,9393,4,14,2,16,42,56,-14,44
FC Zürich,9393,5,11,9,12,40,37,3,42
Grasshoppers,9393,6,10,7,15,42,49,-7,37
FC Lugano,9393,7,10,5,17,31,51,-20,35
FC Thun,9393,8,9,7,16,40,59,-19,34
FC Sion,9393,9,7,8,17,46,55,-9,29
Young Boys,9394,1,21,7,4,74,34,40,70
FC Basel,9394,2,17,10,5,59,28,31,61
FC Zürich,9394,3,12,10,10,47,37,10,46
St Gallen,9394,4,14,3,15,44,57,-13,45
Lucerne,9394,5,12,8,12,42,49,-7,44
FC Lugano,9394,6,10,5,17,32,54,-22,35
Grasshoppers,9394,7,9,7,16,41,54,-13,34
FC Thun,9394,8,9,6,17,48,61,-13,33
FC Sion,9394,9,8,8,16,39,52,-13,32
Young Boys,9395,1,21,8,3,72,32,40,71
FC Basel,9395,2,18,9,5,58,25,33,63
Lucerne,9395,3,12,8,12,39,43,-4,44
St Gallen,9395,4,14,2,16,41,62,-21,44
FC Lugano,9395,5,12,5,15,34,51,-17,41
FC Zürich,9395,6,9,10,13,41,41,0,37
Grasshoppers,9395,7,10,6,16,40,48,-8,36
FC Thun,9395,8,10,5,17,43,59,-16,35
FC Sion,9395,9,8,7,17,47,54,-7,31
Young Boys,9396,1,20,9,3,71,36,35,69
FC Basel,9396,2,17,9,6,53,25,28,60
St Gallen,9396,3,14,5,13,46,54,-8,47
Lucerne,9396,4,12,9,11,43,45,-2,45
FC Zürich,9396,5,10,10,12,39,40,-1,40
FC Thun,9396,6,11,5,16,46,57,-11,38
FC Lugano,9396,7,9,7,16,29,49,-20,34
Grasshoppers,9396,8,8,9,15,39,50,-11,33
FC Sion,9396,9,7,9,16,45,55,-10,30
Young Boys,9397,1,21,7,4,71,36,35,70
FC Basel,9397,2,16,10,6,50,25,25,58
Lucerne,9397,3,16,7,9,46,39,7,55
St Gallen,9397,4,13,4,15,38,52,-14,43
FC Zürich,9397,5,10,11,11,40,36,4,41
FC Thun,9397,6,10,5,17,44,58,-14,35
FC Lugano,9397,7,9,7,16,29,48,-19,34
Grasshoppers,9397,8,9,6,17,40,51,-11,33
FC Sion,9397,9,8,7,17,40,53,-13,31
Young Boys,9398,1,22,7,3,75,33,42,73
FC Basel,9398,2,17,9,6,55,29,26,60
Lucerne,9398,3,13,8,11,43,45,-2,47
St Gallen,9398,4,13,5,14,44,56,-12,44
FC Zürich,9398,5,10,11,11,41,39,2,41
Grasshoppers,9398,6,10,7,15,44,50,-6,37
FC Thun,9398,7,10,5,17,44,58,-14,35
FC Lugano,9398,8,9,8,15,32,50,-18,35
FC Sion,9398,9,6,8,18,38,56,-18,26
Young Boys,9399,1,22,8,2,74,33,41,74
FC Basel,9399,2,18,9,5,59,26,33,63
Lucerne,9399,3,12,8,12,42,48,-6,44
St Gallen,9399,4,13,5,14,41,53,-12,44
FC Zürich,9399,5,10,10,12,38,37,1,40
FC Thun,9399,6,10,6,16,45,58,-13,36
FC Lugano,9399,7,10,6,16,30,48,-18,36
Grasshoppers,9399,8,9,7,16,41,51,-10,34
FC Sion,9399,9,7,7,18,38,54,-16,28
Young Boys,9400,1,20,9,3,68,35,33,69
FC Basel,9400,2,17,10,5,51,23,28,61
St Gallen,9400,3,16,3,13,46,51,-5,51
Lucerne,9400,4,12,9,11,40,42,-2,45
FC Zürich,9400,5,11,9,12,43,37,6,42
FC Thun,9400,6,10,6,16,42,57,-15,36
Grasshoppers,9400,7,9,8,15,43,50,-7,35
FC Lugano,9400,8,9,6,17,30,51,-21,33
FC Sion,9400,9,6,8,18,41,58,-17,26
Young Boys,9401,1,22,7,3,75,39,36,73
FC Basel,9401,2,19,8,5,57,24,33,65
St Gallen,9401,3,15,3,14,46,55,-9,48
Lucerne,9401,4,13,7,12,47,46,1,46
FC Zürich,9401,5,11,11,10,42,34,8,44
FC Thun,9401,6,9,6,17,41,58,-17,33
FC Lugano,9401,7,9,6,17,32,53,-21,33
Grasshoppers,9401,8,8,6,18,39,55,-16,30
FC Sion,9401,9,7,8,17,40,55,-15,29
Young Boys,9402,1,22,7,3,71,34,37,73
FC Basel,9402,2,16,7,9,55,30,25,55
Lucerne,9402,3,13,9,10,42,42,0,48
St Gallen,9402,4,15,3,14,43,53,-10,48
FC Zürich,9402,5,11,9,12,41,39,2,42
Grasshoppers,9402,6,11,6,15,43,48,-5,39
FC Lugano,9402,7,11,6,15,33,47,-14,39
FC Thun,9402,8,9,5,18,43,63,-20,32
FC Sion,9402,9,6,8,18,40,55,-15,26
Young Boys,9403,1,23,6,3,76,36,40,75
FC Basel,9403,2,20,7,5,59,26,33,67
St Gallen,9403,3,15,3,14,45,54,-9,48
Lucerne,9403,4,13,7,12,42,45,-3,46
FC Zürich,9403,5,10,11,11,39,37,2,41
FC Thun,9403,6,10,6,16,47,57,-10,36
FC Lugano,9403,7,9,7,16,29,48,-19,34
Grasshoppers,9403,8,9,6,17,42,54,-12,33
FC Sion,9403,9,5,7,20,38,60,-22,22
Young Boys,9404,1,19,9,4,71,41,30,66
FC Basel,9404,2,18,7,7,53,27,26,61
Lucerne,9404,3,15,8,9,46,42,4,53
St Gallen,9404,4,15,2,15,49,55,-6,47
FC Zürich,9404,5,9,11,12,37,36,1,38
Grasshoppers,9404,6,10,7,15,44,49,-5,37
FC Thun,9404,7,10,6,16,42,58,-16,36
FC Lugano,9404,8,9,7,16,30,49,-19,34
FC Sion,9404,9,6,9,17,40,55,-15,27
Young Boys,9405,1,24,6,2,73,31,42,78
FC Basel,9405,2,17,7,8,52,27,25,58
St Gallen,9405,3,16,2,14,45,54,-9,50
Lucerne,9405,4,12,7,13,41,45,-4,43
FC Zürich,9405,5,11,9,12,43,36,7,42
FC Thun,9405,6,10,6,16,44,59,-15,36
FC Lugano,9405,7,10,5,17,30,49,-19,35
Grasshoppers,9405,8,9,6,17,40,52,-12,33
FC Sion,9405,9,7,8,17,40,55,-15,29
Young Boys,9406,1,22,7,3,70,33,37,73
FC Basel,9406,2,18,8,6,54,26,28,62
St Gallen,9406,3,14,3,15,43,54,-11,45
Lucerne,9406,4,12,8,12,44,49,-5,44
FC Zürich,9406,5,11,9,12,42,37,5,42
Grasshoppers,9406,6,11,6,15,45,48,-3,39
FC Lugano,9406,7,11,5,16,29,47,-18,38
FC Sion,9406,8,7,9,16,40,53,-13,30
FC Thun,9406,9,8,5,19,44,64,-20,29
Young Boys,9407,1,21,7,4,67,35,32,70
FC Basel,9407,2,16,7,9,49,26,23,55
Lucerne,9407,3,14,8,10,43,39,4,50
St Gallen,9407,4,15,3,14,42,53,-11,48
FC Zürich,9407,5,11,9,12,40,41,-1,42
FC Sion,9407,6,9,8,15,44,49,-5,35
Grasshoppers,9407,7,8,10,14,38,46,-8,34
FC Thun,9407,8,9,6,17,42,57,-15,33
FC Lugano,9407,9,9,6,17,30,49,-19,33
Young Boys,9408,1,21,8,3,67,33,34,71
FC Basel,9408,2,18,8,6,51,24,27,62
Lucerne,9408,3,14,7,11,43,40,3,49
St Gallen,9408,4,15,3,14,44,52,-8,48
FC Zürich,9408,5,11,9,12,43,40,3,42
FC Thun,9408,6,11,5,16,47,57,-10,38
FC Lugano,9408,7,9,7,16,30,48,-18,34
Grasshoppers,9408,8,8,7,17,39,51,-12,31
FC Sion,9408,9,6,8,18,37,56,-19,26
Young Boys,9409,1,21,8,3,72,36,36,71
FC Basel,9409,2,18,8,6,54,25,29,62
Lucerne,9409,3,13,8,11,42,45,-3,47
St Gallen,9409,4,15,2,15,43,56,-13,47
FC Zürich,9409,5,10,12,10,40,35,5,42
FC Lugano,9409,6,11,7,14,37,45,-8,40
Grasshoppers,9409,7,10,6,16,43,51,-8,36
FC Thun,9409,8,9,5,18,44,61,-17,32
FC Sion,9409,9,5,8,19,37,58,-21,23
Young Boys,9410,1,23,6,3,78,35,43,75
FC Basel,9410,2,18,8,6,53,26,27,62
Lucerne,9410,3,12,9,11,41,44,-3,45
St Gallen,9410,4,14,3,15,42,55,-13,45
Grasshoppers,9410,5,12,6,14,44,44,0,42
FC Zürich,9410,6,10,9,13,40,38,2,39
FC Lugano,9410,7,10,7,15,31,47,-16,37
FC Thun,9410,8,10,5,17,43,59,-16,35
FC Sion,9410,9,5,7,20,37,61,-24,22
Young Boys,9411,1,22,8,2,72,33,39,74
FC Basel,9411,2,19,7,6,62,27,35,64
St Gallen,9411,3,14,3,15,47,59,-12,45
FC Zürich,9411,4,11,9,12,41,39,2,42
Lucerne,9411,5,11,9,12,42,51,-9,42
FC Thun,9411,6,11,5,16,46,60,-14,38
Grasshoppers,9411,7,10,7,15,41,47,-6,37
FC Lugano,9411,8,9,7,16,32,49,-17,34
FC Sion,9411,9,6,7,19,36,54,-18,25
Young Boys,9412,1,20,8,4,68,39,29,68
FC Basel,9412,2,18,8,6,60,27,33,62
St Gallen,9412,3,16,2,14,42,52,-10,50
FC Zürich,9412,4,11,10,11,41,34,7,43
Lucerne,9412,5,11,10,11,40,46,-6,43
FC Lugano,9412,6,10,7,15,30,45,-15,37
Grasshoppers,9412,7,9,7,16,41,51,-10,34
FC Thun,9412,8,9,6,17,42,59,-17,33
FC Sion,9412,9,7,8,17,41,52,-11,29
Young Boys,9413,1,20,7,5,68,37,31,67
FC Basel,9413,2,17,8,7,53,27,26,59
Lucerne,9413,3,14,8,10,45,44,1,50
St Gallen,9413,4,14,4,14,44,55,-11,46
FC Thun,9413,5,11,5,16,44,58,-14,38
Grasshoppers,9413,6,10,7,15,42,47,-5,37
FC Zürich,9413,7,9,9,14,37,38,-1,36
FC Lugano,9413,8,10,6,16,32,49,-17,36
FC Sion,9413,9,8,8,16,40,50,-10,32
Young Boys,9414,1,20,7,5,71,37,34,67
FC Basel,9414,2,18,9,5,58,23,35,63
Lucerne,9414,3,14,7,11,43,44,-1,49
St Gallen,9414,4,13,4,15,41,55,-14,43
FC Zürich,9414,5,10,9,13,39,41,-2,39
FC Lugano,9414,6,11,5,16,34,49,-15,38
Grasshoppers,9414,7,10,6,16,41,50,-9,36
FC Thun,9414,8,10,5,17,44,62,-18,35
FC Sion,9414,9,8,8,16,43,53,-10,32
Young Boys,9415,1,21,7,4,71,40,31,70
FC Basel,9415,2,18,7,7,59,27,32,61
Lucerne,9415,3,15,8,9,44,39,5,53
FC Zürich,9415,4,11,9,12,43,37,6,42
St Gallen,9415,5,13,3,16,40,57,-17,42
Grasshoppers,9415,6,10,7,15,42,48,-6,37
FC Lugano,9415,7,10,6,16,31,48,-17,36
FC Thun,9415,8,9,6,17,41,58,-17,33
FC Sion,9415,9,7,7,18,43,60,-17,28
Young Boys,9416,1,22,7,3,74,37,37,73
FC Basel,9416,2,17,9,6,55,27,28,60
St Gallen,9416,3,16,3,13,47,54,-7,51
Lucerne,9416,4,12,8,12,40,45,-5,44
FC Zürich,9416,5,10,11,11,40,36,4,41
FC Lugano,9416,6,9,7,16,29,48,-19,34
Grasshoppers,9416,7,8,8,16,41,51,-10,32
FC Sion,9416,8,7,10,15,42,53,-11,31
FC Thun,9416,9,8,7,17,43,60,-17,31
Young Boys,9417,1,23,6,3,76,37,39,75
FC Basel,9417,2,17,9,6,54,28,26,60
St Gallen,9417,3,15,2,15,43,52,-9,47
Lucerne,9417,4,12,8,12,43,48,-5,44
FC Zürich,9417,5,9,11,12,40,42,-2,38
Grasshoppers,9417,6,10,7,15,44,51,-7,37
FC Thun,9417,7,10,6,16,47,58,-11,36
FC Lugano,9417,8,10,5,17,31,49,-18,35
FC Sion,9417,9,7,8,17,39,52,-13,29
Young Boys,9418,1,23,7,2,78,35,43,76
FC Basel,9418,2,18,8,6,58,28,30,62
Lucerne,9418,3,13,8,11,46,45,1,47
St Gallen,9418,4,14,3,15,40,53,-13,45
FC Thun,9418,5,12,5,15,48,57,-9,41
FC Zürich,9418,6,9,10,13,39,43,-4,37
Grasshoppers,9418,7,9,6,17,40,50,-10,33
FC Lugano,9418,8,9,6,17,29,53,-24,33
FC Sion,9418,9,7,7,18,42,56,-14,28
Young Boys,9419,1,22,6,4,75,36,39,72
FC Basel,9419,2,17,9,6,55,29,26,60
St Gallen,9419,3,16,3,13,46,54,-8,51
Lucerne,9419,4,12,8,12,43,48,-5,44
FC Zürich,9419,5,11,10,11,45,41,4,43
FC Lugano,9419,6,11,5,16,35,50,-15,38
Grasshoppers,9419,7,8,9,15,41,50,-9,33
FC Thun,9419,8,8,7,17,46,63,-17,31
FC Sion,9419,9,6,9,17,43,58,-15,27
Young Boys,9420,1,21,7,4,72,38,34,70
FC Basel,9420,2,19,8,5,57,25,32,65
Lucerne,9420,3,12,9,11,41,44,-3,45
FC Zürich,9420,4,11,10,11,44,37,7,43
St Gallen,9420,5,13,2,17,42,58,-16,41
Grasshoppers,9420,6,11,7,14,43,47,-4,40
FC Lugano,9420,7,11,6,15,35,50,-15,39
FC Thun,9420,8,9,6,17,44,62,-18,33
FC Sion,9420,9,6,7,19,41,58,-17,25
Young Boys,9421,1,22,6,4,67,36,31,72
FC Basel,9421,2,18,8,6,55,27,28,62
St Gallen,9421,3,16,3,13,51,53,-2,51
Lucerne,9421,4,12,8,12,40,43,-3,44
FC Zürich,9421,5,10,11,11,40,36,4,41
Grasshoppers,9421,6,11,6,15,43,46,-3,39
FC Thun,9421,7,9,6,17,40,58,-18,33
FC Lugano,9421,8,9,5,18,30,53,-23,32
FC Sion,9421,9,6,9,17,39,53,-14,27
Young Boys,9422,1,20,8,4,71,35,36,68
FC Basel,9422,2,18,9,5,56,24,32,63
Lucerne,9422,3,14,8,10,42,39,3,50
FC Zürich,9422,4,12,9,11,48,39,9,45
St Gallen,9422,5,14,3,15,48,58,-10,45
Grasshoppers,9422,6,10,7,15,42,49,-7,37
FC Lugano,9422,7,10,6,16,31,48,-17,36
FC Thun,9422,8,8,6,18,44,64,-20,30
FC Sion,9422,9,6,8,18,40,66,-26,26
Young Boys,9423,1,20,9,3,68,33,35,69
FC Basel,9423,2,18,9,5,56,25,31,63
Lucerne,9423,3,14,8,10,43,42,1,50
FC Zürich,9423,4,12,10,10,46,34,12,46
St Gallen,9423,5,14,4,14,45,57,-12,46
Grasshoppers,9423,6,9,7,16,40,49,-9,34
FC Lugano,9423,7,9,6,17,30,53,-23,33
FC Thun,9423,8,8,6,18,42,61,-19,30
FC Sion,9423,9,6,9,17,40,56,-16,27
Young Boys,9424,1,23,6,3,71,32,39,75
FC Basel,9424,2,18,8,6,55,27,28,62
Lucerne,9424,3,14,8,10,46,42,4,50
St Gallen,9424,4,14,4,14,41,53,-12,46
FC Zürich,9424,5,11,9,12,40,40,0,42
FC Thun,9424,6,11,5,16,46,54,-8,38
FC Lugano,9424,7,10,5,17,29,48,-19,35
Grasshoppers,9424,8,8,7,17,38,50,-12,31
FC Sion,9424,9,5,8,19,37,57,-20,23
Young Boys,9425,1,21,7,4,68,33,35,70
FC Basel,9425,2,17,9,6,52,26,26,60
St Gallen,9425,3,15,3,14,48,55,-7,48
Lucerne,9425,4,13,7,12,40,42,-2,46
FC Zürich,9425,5,10,10,12,40,39,1,40
Grasshoppers,9425,6,11,6,15,45,51,-6,39
FC Thun,9425,7,10,7,15,48,57,-9,37
FC Lugano,9425,8,10,5,17,32,52,-20,35
FC Sion,9425,9,6,8,18,42,60,-18,26
Young Boys,9426,1,23,7,2,78,34,44,76
FC Basel,9426,2,15,9,8,51,32,19,54
St Gallen,9426,3,15,2,15,43,55,-12,47
FC Zürich,9426,4,11,11,10,48,37,11,44
Lucerne,9426,5,11,9,12,40,44,-4,42
Grasshoppers,9426,6,10,7,15,42,48,-6,37
FC Thun,9426,7,10,7,15,49,59,-10,37
FC Lugano,9426,8,10,7,15,32,49,-17,37
FC Sion,9426,9,6,7,19,45,70,-25,25
Young Boys,9427,1,22,6,4,74,34,40,72
FC Basel,9427,2,19,7,6,56,25,31,64
Lucerne,9427,3,14,7,11,42,42,0,49
St Gallen,9427,4,14,3,15,43,58,-15,45
FC Zürich,9427,5,10,11,11,44,39,5,41
Grasshoppers,9427,6,10,7,15,41,49,-8,37
FC Lugano,9427,7,10,5,17,32,52,-20,35
FC Thun,9427,8,8,7,17,42,61,-19,31
FC Sion,9427,9,6,9,17,45,59,-14,27
Young Boys,9428,1,20,9,3,67,33,34,69
FC Basel,9428,2,18,8,6,54,24,30,62
St Gallen,9428,3,14,4,14,42,53,-11,46
Lucerne,9428,4,12,9,11,38,43,-5,45
FC Zrich,9428,5,11,10,11,43,35,8,43
FC Lugano,9428,6,10,8,14,31,44,-13,38
FC Thun,9428,7,10,5,17,43,58,-15,35
Grasshoppers,9428,8,9,7,16,41,48,-7,34
FC Sion,9428,9,6,8,18,40,61,-21,26
Young Boys,9429,1,21,8,3,73,36,37,71
FC Basel,9429,2,19,7,6,58,27,31,64
St Gallen,9429,3,15,2,15,43,54,-11,47
Lucerne,9429,4,13,7,12,43,45,-2,46
FC Zürich,9429,5,11,9,12,43,40,3,42
FC Lugano,9429,6,10,6,16,29,46,-17,36
Grasshoppers,9429,7,9,8,15,44,51,-7,35
FC Thun,9429,8,9,6,17,46,63,-17,33
FC Sion,9429,9,7,7,18,41,58,-17,28
Young Boys,9430,1,22,6,4,78,38,40,72
FC Basel,9430,2,18,8,6,57,25,32,62
St Gallen,9430,3,15,2,15,41,54,-13,47
Lucerne,9430,4,12,8,12,43,49,-6,44
FC Zürich,9430,5,10,11,11,42,38,4,41
Grasshoppers,9430,6,10,6,16,41,52,-11,36
FC Lugano,9430,7,10,6,16,31,50,-19,36
FC Thun,9430,8,9,6,17,44,59,-15,33
FC Sion,9430,9,7,9,16,43,55,-12,30
Young Boys,9431,1,22,7,3,75,32,43,73
FC Basel,9431,2,18,8,6,55,27,28,62
Lucerne,9431,3,15,7,10,45,46,-1,52
St Gallen,9431,4,13,3,16,40,55,-15,42
FC Zürich,9431,5,10,10,12,39,36,3,40
FC Thun,9431,6,10,5,17,42,58,-16,35
FC Lugano,9431,7,10,5,17,29,48,-19,35
Grasshoppers,9431,8,8,8,16,38,48,-10,32
FC Sion,9431,9,7,9,16,37,50,-13,30
Young Boys,9432,1,20,9,3,67,33,34,69
FC Basel,9432,2,17,9,6,55,27,28,60
Lucerne,9432,3,13,9,10,44,45,-1,48
St Gallen,9432,4,13,4,15,41,55,-14,43
FC Thun,9432,5,12,5,15,51,60,-9,41
FC Lugano,9432,6,11,6,15,34,48,-14,39
FC Zürich,9432,7,9,9,14,41,43,-2,36
Grasshoppers,9432,8,9,7,16,43,53,-10,34
FC Sion,9432,9,7,8,17,40,52,-12,29
Young Boys,9433,1,22,8,2,75,31,44,74
FC Basel,9433,2,18,8,6,60,25,35,62
FC Zürich,9433,3,12,10,10,44,34,10,46
Lucerne,9433,4,13,7,12,40,46,-6,46
St Gallen,9433,5,13,2,17,38,57,-19,41
FC Lugano,9433,6,11,5,16,31,49,-18,38
FC Thun,9433,7,9,7,16,43,61,-18,34
FC Sion,9433,8,7,9,16,39,53,-14,30
Grasshoppers,9433,9,8,6,18,37,51,-14,30
Young Boys,9434,1,21,8,3,76,37,39,71
FC Basel,9434,2,17,9,6,58,27,31,60
Lucerne,9434,3,15,8,9,45,40,5,53
St Gallen,9434,4,14,3,15,43,54,-11,45
FC Zürich,9434,5,11,10,11,40,35,5,43
FC Thun,9434,6,9,7,16,41,60,-19,34
FC Lugano,9434,7,9,6,17,30,51,-21,33
Grasshoppers,9434,8,8,6,18,38,52,-14,30
FC Sion,9434,9,7,9,16,39,54,-15,30
Young Boys,9435,1,20,9,3,71,35,36,69
FC Basel,9435,2,18,8,6,54,27,27,62
Lucerne,9435,3,13,7,12,39,43,-4,46
FC Zürich,9435,4,12,9,11,43,37,6,45
St Gallen,9435,5,14,2,16,46,57,-11,44
FC Thun,9435,6,11,5,16,47,59,-12,38
FC Lugano,9435,7,10,6,16,34,51,-17,36
Grasshoppers,9435,8,9,6,17,40,52,-12,33
FC Sion,9435,9,7,8,17,41,54,-13,29
Young Boys,9436,1,22,7,3,75,39,36,73
FC Basel,9436,2,18,8,6,58,27,31,62
Lucerne,9436,3,13,8,11,45,46,-1,47
St Gallen,9436,4,14,3,15,42,55,-13,45
FC Zürich,9436,5,11,10,11,43,36,7,43
FC Lugano,9436,6,10,5,17,34,51,-17,35
Grasshoppers,9436,7,9,6,17,39,50,-11,33
FC Thun,9436,8,9,6,17,40,61,-21,33
FC Sion,9436,9,8,7,17,42,53,-11,31
Young Boys,9437,1,22,6,4,71,33,38,72
FC Basel,9437,2,19,7,6,55,26,29,64
Lucerne,9437,3,13,8,11,41,43,-2,47
St Gallen,9437,4,13,3,16,42,58,-16,42
FC Zürich,9437,5,10,9,13,39,39,0,39
Grasshoppers,9437,6,10,7,15,41,50,-9,37
FC Lugano,9437,7,10,7,15,29,44,-15,37
FC Thun,9437,8,10,5,17,44,57,-13,35
FC Sion,9437,9,7,8,17,43,55,-12,29
Young Boys,9438,1,21,8,3,70,32,38,71
FC Basel,9438,2,17,8,7,48,25,23,59
St Gallen,9438,3,15,3,14,47,54,-7,48
Lucerne,9438,4,13,8,11,45,48,-3,47
FC Zürich,9438,5,11,9,12,41,36,5,42
FC Lugano,9438,6,11,6,15,35,49,-14,39
Grasshoppers,9438,7,10,8,14,42,48,-6,38
FC Thun,9438,8,9,6,17,43,59,-16,33
FC Sion,9438,9,5,8,19,39,59,-20,23
Young Boys,9439,1,21,7,4,72,37,35,70
FC Basel,9439,2,16,7,9,55,35,20,55
Lucerne,9439,3,14,8,10,51,45,6,50
St Gallen,9439,4,15,3,14,47,56,-9,48
FC Zürich,9439,5,10,10,12,41,39,2,40
FC Lugano,9439,6,10,8,14,33,47,-14,38
Grasshoppers,9439,7,9,7,16,40,51,-11,34
FC Thun,9439,8,9,7,16,42,59,-17,34
FC Sion,9439,9,7,9,16,42,54,-12,30
Young Boys,9440,1,22,7,3,74,36,38,73
FC Basel,9440,2,18,7,7,57,31,26,61
St Gallen,9440,3,14,4,14,43,54,-11,46
Lucerne,9440,4,11,9,12,40,46,-6,42
FC Zürich,9440,5,10,11,11,41,38,3,41
FC Thun,9440,6,10,6,16,43,58,-15,36
Grasshoppers,9440,7,9,8,15,41,48,-7,35
FC Lugano,9440,8,9,8,15,31,48,-17,35
FC Sion,9440,9,7,8,17,44,55,-11,29
Young Boys,9441,1,22,7,3,72,36,36,73
FC Basel,9441,2,17,9,6,57,30,27,60
St Gallen,9441,3,14,4,14,42,53,-11,46
Lucerne,9441,4,12,9,11,41,44,-3,45
FC Zürich,9441,5,11,9,12,41,39,2,42
FC Thun,9441,6,11,5,16,49,57,-8,38
FC Lugano,9441,7,9,7,16,28,47,-19,34
FC Sion,9441,8,8,8,16,43,54,-11,32
Grasshoppers,9441,9,8,6,18,40,53,-13,30
Young Boys,9442,1,23,6,3,77,36,41,75
FC Basel,9442,2,17,7,8,54,28,26,58
Lucerne,9442,3,12,9,11,41,46,-5,45
St Gallen,9442,4,14,3,15,39,51,-12,45
FC Zürich,9442,5,11,9,12,41,37,4,42
FC Lugano,9442,6,10,7,15,31,47,-16,37
FC Sion,9442,7,9,8,15,45,53,-8,35
Grasshoppers,9442,8,8,8,16,41,52,-11,32
FC Thun,9442,9,9,5,18,47,66,-19,32
Young Boys,9443,1,20,9,3,69,37,32,69
FC Basel,9443,2,19,7,6,56,22,34,64
St Gallen,9443,3,15,3,14,45,57,-12,48
Lucerne,9443,4,11,10,11,40,45,-5,43
FC Zürich,9443,5,9,11,12,37,35,2,38
FC Lugano,9443,6,10,7,15,30,45,-15,37
Grasshoppers,9443,7,10,6,16,43,51,-8,36
FC Thun,9443,8,9,7,16,43,59,-16,34
FC Sion,9443,9,6,10,16,41,53,-12,28
Young Boys,9444,1,22,7,3,73,36,37,73
FC Basel,9444,2,16,9,7,50,27,23,57
St Gallen,9444,3,16,2,14,45,53,-8,50
Lucerne,9444,4,12,9,11,41,41,0,45
FC Zürich,9444,5,11,11,10,40,34,6,44
FC Lugano,9444,6,10,6,16,31,50,-19,36
Grasshoppers,9444,7,9,8,15,41,47,-6,35
FC Thun,9444,8,9,6,17,44,61,-17,33
FC Sion,9444,9,6,8,18,39,55,-16,26
Young Boys,9445,1,22,7,3,72,35,37,73
FC Basel,9445,2,17,8,7,56,29,27,59
St Gallen,9445,3,15,2,15,45,56,-11,47
Lucerne,9445,4,12,8,12,43,47,-4,44
FC Zürich,9445,5,10,12,10,41,36,5,42
FC Lugano,9445,6,11,6,15,35,50,-15,39
Grasshoppers,9445,7,9,9,14,43,50,-7,36
FC Thun,9445,8,8,7,17,45,64,-19,31
FC Sion,9445,9,7,7,18,40,53,-13,28
Young Boys,9446,1,23,6,3,75,33,42,75
FC Basel,9446,2,17,9,6,49,23,26,60
Lucerne,9446,3,14,8,10,43,41,2,50
St Gallen,9446,4,14,3,15,41,53,-12,45
FC Zürich,9446,5,11,11,10,41,34,7,44
FC Thun,9446,6,9,7,16,42,57,-15,34
FC Lugano,9446,7,9,6,17,28,47,-19,33
Grasshoppers,9446,8,8,7,17,39,52,-13,31
FC Sion,9446,9,6,9,17,41,59,-18,27
Young Boys,9447,1,22,7,3,73,39,34,73
FC Basel,9447,2,18,8,6,57,25,32,62
St Gallen,9447,3,16,2,14,47,55,-8,50
Lucerne,9447,4,13,8,11,43,44,-1,47
FC Zürich,9447,5,11,10,11,41,37,4,43
FC Thun,9447,6,11,5,16,44,56,-12,38
FC Lugano,9447,7,9,5,18,30,53,-23,32
Grasshoppers,9447,8,8,6,18,41,54,-13,30
FC Sion,9447,9,7,7,18,41,54,-13,28
Young Boys,9448,1,21,7,4,73,33,40,70
FC Basel,9448,2,17,8,7,53,25,28,59
Lucerne,9448,3,13,8,11,39,44,-5,47
FC Zürich,9448,4,12,9,11,44,38,6,45
St Gallen,9448,5,14,3,15,43,57,-14,45
FC Lugano,9448,6,11,5,16,34,50,-16,38
Grasshoppers,9448,7,10,7,15,42,48,-6,37
FC Thun,9448,8,9,6,17,41,59,-18,33
FC Sion,9448,9,6,9,17,38,53,-15,27
Young Boys,9449,1,21,7,4,76,37,39,70
FC Basel,9449,2,18,7,7,58,29,29,61
Lucerne,9449,3,13,8,11,43,47,-4,47
St Gallen,9449,4,15,2,15,47,57,-10,47
FC Zürich,9449,5,11,10,11,39,34,5,43
Grasshoppers,9449,6,11,7,14,44,47,-3,40
FC Thun,9449,7,10,5,17,42,61,-19,35
FC Lugano,9449,8,9,6,17,29,51,-22,33
FC Sion,9449,9,6,8,18,41,56,-15,26
Young Boys,9450,1,23,6,3,72,32,40,75
FC Basel,9450,2,18,7,7,53,27,26,61
FC Zürich,9450,3,13,9,10,46,36,10,48
Lucerne,9450,4,13,7,12,38,44,-6,46
St Gallen,9450,5,14,2,16,39,54,-15,44
FC Lugano,9450,6,10,5,17,29,46,-17,35
Grasshoppers,9450,7,9,7,16,43,50,-7,34
FC Thun,9450,8,9,6,17,46,63,-17,33
FC Sion,9450,9,7,7,18,41,55,-14,28
Young Boys,9451,1,21,7,4,70,38,32,70
FC Basel,9451,2,19,8,5,55,22,33,65
St Gallen,9451,3,15,2,15,42,53,-11,47
FC Zürich,9451,4,11,10,11,41,33,8,43
Lucerne,9451,5,11,8,13,41,49,-8,41
FC Thun,9451,6,10,6,16,44,59,-15,36
FC Lugano,9451,7,10,5,17,30,47,-17,35
Grasshoppers,9451,8,8,9,15,40,51,-11,33
FC Sion,9451,9,8,7,17,45,56,-11,31
Young Boys,9452,1,22,6,4,76,37,39,72
FC Basel,9452,2,18,8,6,55,28,27,62
St Gallen,9452,3,15,3,14,44,53,-9,48
FC Zürich,9452,4,11,10,11,42,37,5,43
Lucerne,9452,5,12,7,13,45,53,-8,43
FC Lugano,9452,6,11,6,15,33,48,-15,39
Grasshoppers,9452,7,9,7,16,42,51,-9,34
FC Thun,9452,8,9,5,18,41,61,-20,32
FC Sion,9452,9,7,8,17,44,54,-10,29
Young Boys,9453,1,21,8,3,71,35,36,71
FC Basel,9453,2,19,7,6,56,24,32,64
Lucerne,9453,3,13,9,10,45,46,-1,48
FC Zürich,9453,4,12,9,11,41,38,3,45
St Gallen,9453,5,13,3,16,44,60,-16,42
FC Lugano,9453,6,10,6,16,30,46,-16,36
Grasshoppers,9453,7,9,7,16,41,50,-9,34
FC Thun,9453,8,9,6,17,46,61,-15,33
FC Sion,9453,9,6,9,17,44,58,-14,27
Young Boys,9454,1,21,6,5,67,36,31,69
FC Basel,9454,2,19,7,6,55,25,30,64
Lucerne,9454,3,14,8,10,42,39,3,50
St Gallen,9454,4,16,2,14,45,53,-8,50
FC Zürich,9454,5,11,9,12,44,38,6,42
FC Lugano,9454,6,10,6,16,31,47,-16,36
Grasshoppers,9454,7,9,7,16,40,49,-9,34
FC Thun,9454,8,9,6,17,41,59,-18,33
FC Sion,9454,9,6,7,19,39,58,-19,25
Young Boys,9455,1,22,7,3,73,34,39,73
FC Basel,9455,2,19,7,6,64,28,36,64
Lucerne,9455,3,13,9,10,43,43,0,48
St Gallen,9455,4,14,2,16,43,59,-16,44
FC Lugano,9455,5,11,5,16,31,48,-17,38
FC Zürich,9455,6,9,10,13,40,41,-1,37
Grasshoppers,9455,7,9,8,15,44,51,-7,35
FC Thun,9455,8,9,6,17,45,66,-21,33
FC Sion,9455,9,6,10,16,43,56,-13,28
Young Boys,9456,1,21,8,3,75,35,40,71
FC Basel,9456,2,19,8,5,57,22,35,65
Lucerne,9456,3,13,8,11,44,51,-7,47
St Gallen,9456,4,13,3,16,41,56,-15,42
FC Zürich,9456,5,10,10,12,41,38,3,40
Grasshoppers,9456,6,10,8,14,42,48,-6,38
FC Thun,9456,7,10,6,16,47,61,-14,36
FC Lugano,9456,8,10,5,17,31,51,-20,35
FC Sion,9456,9,5,10,17,41,57,-16,25
Young Boys,9457,1,22,8,2,78,37,41,74
FC Basel,9457,2,15,10,7,53,33,20,55
Lucerne,9457,3,14,8,10,48,45,3,50
St Gallen,9457,4,13,5,14,44,57,-13,44
FC Zürich,9457,5,11,10,11,46,42,4,43
FC Thun,9457,6,11,6,15,50,58,-8,39
FC Lugano,9457,7,10,7,15,36,51,-15,37
Grasshoppers,9457,8,9,6,17,40,53,-13,33
FC Sion,9457,9,5,8,19,42,61,-19,23
Young Boys,9458,1,22,8,2,75,36,39,74
FC Basel,9458,2,19,8,5,60,29,31,65
Lucerne,9458,3,13,7,12,43,47,-4,46
FC Zürich,9458,4,11,9,12,40,36,4,42
St Gallen,9458,5,13,3,16,47,61,-14,42
FC Thun,9458,6,11,5,16,47,57,-10,38
Grasshoppers,9458,7,10,6,16,42,49,-7,36
FC Lugano,9458,8,10,5,17,31,50,-19,35
FC Sion,9458,9,5,9,18,37,57,-20,24
Young Boys,9459,1,21,8,3,70,34,36,71
FC Basel,9459,2,19,7,6,58,25,33,64
St Gallen,9459,3,15,4,13,44,52,-8,49
Lucerne,9459,4,11,8,13,40,50,-10,41
FC Zürich,9459,5,10,9,13,38,43,-5,39
FC Lugano,9459,6,11,6,15,37,45,-8,39
Grasshoppers,9459,7,10,7,15,44,48,-4,37
FC Thun,9459,8,10,6,16,41,58,-17,36
FC Sion,9459,9,5,9,18,38,55,-17,24
Young Boys,9460,1,22,6,4,72,35,37,72
FC Basel,9460,2,18,9,5,57,25,32,63
St Gallen,9460,3,14,4,14,43,54,-11,46
Lucerne,9460,4,12,9,11,40,47,-7,45
FC Thun,9460,5,11,5,16,44,58,-14,38
FC Zürich,9460,6,9,10,13,38,38,0,37
Grasshoppers,9460,7,10,7,15,46,52,-6,37
FC Lugano,9460,8,10,7,15,31,46,-15,37
FC Sion,9460,9,5,9,18,39,55,-16,24
Young Boys,9461,1,21,6,5,73,38,35,69
FC Basel,9461,2,19,8,5,56,24,32,65
St Gallen,9461,3,14,4,14,50,59,-9,46
Lucerne,9461,4,12,8,12,44,48,-4,44
FC Zürich,9461,5,10,10,12,39,37,2,40
FC Thun,9461,6,11,5,16,46,59,-13,38
Grasshoppers,9461,7,10,6,16,44,54,-10,36
FC Sion,9461,8,8,8,16,45,54,-9,32
FC Lugano,9461,9,9,5,18,31,55,-24,32
Young Boys,9462,1,21,8,3,73,35,38,71
FC Basel,9462,2,18,8,6,56,30,26,62
Lucerne,9462,3,12,10,10,40,43,-3,46
St Gallen,9462,4,14,4,14,45,55,-10,46
FC Zürich,9462,5,11,11,10,44,35,9,44
Grasshoppers,9462,6,9,8,15,39,48,-9,35
FC Lugano,9462,7,9,7,16,32,50,-18,34
FC Thun,9462,8,8,6,18,41,61,-20,30
FC Sion,9462,9,7,8,17,42,55,-13,29
Young Boys,9463,1,20,7,5,70,37,33,67
FC Basel,9463,2,18,8,6,55,25,30,62
Lucerne,9463,3,13,9,10,43,44,-1,48
St Gallen,9463,4,15,3,14,43,52,-9,48
FC Zürich,9463,5,11,9,12,39,38,1,42
Grasshoppers,9463,6,10,8,14,45,51,-6,38
FC Lugano,9463,7,10,7,15,30,45,-15,37
FC Sion,9463,8,7,8,17,40,50,-10,29
FC Thun,9463,9,8,5,19,41,64,-23,29
Young Boys,9464,1,20,6,6,66,38,28,66
FC Basel,9464,2,18,8,6,55,25,30,62
Lucerne,9464,3,14,8,10,44,43,1,50
St Gallen,9464,4,13,4,15,45,61,-16,43
FC Lugano,9464,5,12,6,14,35,46,-11,42
FC Zürich,9464,6,9,11,12,38,36,2,38
Grasshoppers,9464,7,10,7,15,44,47,-3,37
FC Sion,9464,8,7,10,15,39,50,-11,31
FC Thun,9464,9,8,6,18,40,60,-20,30
Young Boys,9465,1,21,8,3,72,34,38,71
FC Basel,9465,2,17,8,7,56,29,27,59
Lucerne,9465,3,12,10,10,44,45,-1,46
St Gallen,9465,4,14,4,14,45,57,-12,46
FC Zürich,9465,5,9,10,13,38,42,-4,37
FC Thun,9465,6,10,7,15,47,59,-12,37
FC Lugano,9465,7,10,7,15,34,47,-13,37
Grasshoppers,9465,8,8,9,15,41,50,-9,33
FC Sion,9465,9,7,9,16,42,56,-14,30
Young Boys,9466,1,22,6,4,73,35,38,72
FC Basel,9466,2,18,7,7,55,27,28,61
St Gallen,9466,3,15,2,15,45,57,-12,47
Lucerne,9466,4,12,8,12,41,49,-8,44
Grasshoppers,9466,5,10,8,14,41,46,-5,38
FC Zürich,9466,6,9,10,13,38,39,-1,37
FC Thun,9466,7,10,7,15,45,56,-11,37
FC Lugano,9466,8,10,6,16,35,52,-17,36
FC Sion,9466,9,7,8,17,40,52,-12,29
Young Boys,9467,1,20,7,5,68,37,31,67
FC Basel,9467,2,18,8,6,54,26,28,62
Lucerne,9467,3,15,7,10,46,43,3,52
FC Zürich,9467,4,12,9,11,40,36,4,45
St Gallen,9467,5,13,3,16,39,54,-15,42
FC Lugano,9467,6,10,7,15,31,46,-15,37
FC Thun,9467,7,9,7,16,44,57,-13,34
Grasshoppers,9467,8,9,6,17,39,52,-13,33
FC Sion,9467,9,7,8,17,40,50,-10,29
Young Boys,9468,1,23,6,3,73,33,40,75
FC Basel,9468,2,15,10,7,51,29,22,55
FC Zürich,9468,3,12,10,10,43,35,8,46
Lucerne,9468,4,12,9,11,39,40,-1,45
St Gallen,9468,5,13,4,15,45,59,-14,43
FC Lugano,9468,6,11,5,16,31,46,-15,38
Grasshoppers,9468,7,8,9,15,40,51,-11,33
FC Sion,9468,8,7,10,15,45,56,-11,31
FC Thun,9468,9,8,7,17,44,62,-18,31
Young Boys,9469,1,22,6,4,73,35,38,72
FC Basel,9469,2,19,7,6,54,26,28,64
FC Zürich,9469,3,13,9,10,45,32,13,48
St Gallen,9469,4,15,2,15,46,55,-9,47
Lucerne,9469,5,13,7,12,43,47,-4,46
Grasshoppers,9469,6,10,7,15,44,51,-7,37
FC Thun,9469,7,9,6,17,42,60,-18,33
FC Lugano,9469,8,9,5,18,27,51,-24,32
FC Sion,9469,9,6,7,19,38,55,-17,25
Young Boys,9470,1,21,6,5,72,38,34,69
FC Basel,9470,2,19,8,5,57,25,32,65
Lucerne,9470,3,13,8,11,44,46,-2,47
St Gallen,9470,4,13,5,14,39,52,-13,44
FC Zürich,9470,5,11,9,12,43,39,4,42
Grasshoppers,9470,6,10,6,16,44,51,-7,36
FC Lugano,9470,7,10,6,16,30,49,-19,36
FC Thun,9470,8,10,5,17,46,60,-14,35
FC Sion,9470,9,7,7,18,40,55,-15,28
Young Boys,9471,1,21,9,2,73,33,40,72
FC Basel,9471,2,18,9,5,55,26,29,63
Lucerne,9471,3,13,7,12,41,47,-6,46
St Gallen,9471,4,14,3,15,44,57,-13,45
FC Zürich,9471,5,9,12,11,39,36,3,39
Grasshoppers,9471,6,10,7,15,40,45,-5,37
FC Lugano,9471,7,9,7,16,31,49,-18,34
FC Thun,9471,8,9,6,17,40,56,-16,33
FC Sion,9471,9,6,10,16,39,53,-14,28
Young Boys,9472,1,23,6,3,78,33,45,75
FC Basel,9472,2,18,8,6,53,26,27,62
Lucerne,9472,3,11,11,10,41,46,-5,44
St Gallen,9472,4,13,4,15,41,54,-13,43
FC Zürich,9472,5,11,9,12,41,36,5,42
FC Lugano,9472,6,10,7,15,29,46,-17,37
FC Thun,9472,7,9,6,17,45,62,-17,33
Grasshoppers,9472,8,8,8,16,41,54,-13,32
FC Sion,9472,9,7,9,16,39,51,-12,30
Young Boys,9473,1,21,8,3,73,34,39,71
FC Basel,9473,2,16,10,6,49,27,22,58
Lucerne,9473,3,14,8,10,44,43,1,50
St Gallen,9473,4,14,4,14,44,53,-9,46
FC Zürich,9473,5,11,9,12,42,35,7,42
FC Lugano,9473,6,10,7,15,31,46,-15,37
FC Thun,9473,7,9,7,16,45,60,-15,34
Grasshoppers,9473,8,8,7,17,41,58,-17,31
FC Sion,9473,9,6,10,16,43,56,-13,28
Young Boys,9474,1,22,6,4,76,35,41,72
FC Basel,9474,2,18,8,6,52,24,28,62
Lucerne,9474,3,12,9,11,40,45,-5,45
FC Zürich,9474,4,11,10,11,39,34,5,43
St Gallen,9474,5,13,4,15,39,59,-20,43
Grasshoppers,9474,6,12,6,14,46,48,-2,42
FC Lugano,9474,7,10,6,16,29,48,-19,36
FC Thun,9474,8,8,6,18,44,64,-20,30
FC Sion,9474,9,7,7,18,47,55,-8,28
Young Boys,9475,1,20,9,3,70,35,35,69
FC Basel,9475,2,17,7,8,51,28,23,58
Lucerne,9475,3,14,8,10,44,41,3,50
St Gallen,9475,4,14,4,14,41,51,-10,46
FC Zürich,9475,5,9,11,12,36,35,1,38
FC Thun,9475,6,11,5,16,45,61,-16,38
FC Lugano,9475,7,10,7,15,29,46,-17,37
Grasshoppers,9475,8,9,8,15,43,48,-5,35
FC Sion,9475,9,5,11,16,41,55,-14,26
Young Boys,9476,1,20,7,5,68,38,30,67
FC Basel,9476,2,17,9,6,53,25,28,60
St Gallen,9476,3,16,3,13,44,51,-7,51
Lucerne,9476,4,14,7,11,43,44,-1,49
FC Zürich,9476,5,11,10,11,42,38,4,43
Grasshoppers,9476,6,10,6,16,44,50,-6,36
FC Lugano,9476,7,10,6,16,30,46,-16,36
FC Thun,9476,8,9,6,17,41,58,-17,33
FC Sion,9476,9,6,8,18,40,55,-15,26
Young Boys,9477,1,20,9,3,69,35,34,69
FC Basel,9477,2,18,9,5,57,27,30,63
Lucerne,9477,3,12,10,10,41,41,0,46
St Gallen,9477,4,14,3,15,45,58,-13,45
FC Zürich,9477,5,10,10,12,42,40,2,40
Grasshoppers,9477,6,8,10,14,39,47,-8,34
FC Thun,9477,7,9,7,16,46,60,-14,34
FC Lugano,9477,8,9,7,16,32,51,-19,34
FC Sion,9477,9,7,9,16,39,51,-12,30
Young Boys,9478,1,22,6,4,75,36,39,72
FC Basel,9478,2,18,7,7,52,26,26,61
St Gallen,9478,3,15,3,14,44,55,-11,48
Lucerne,9478,4,12,8,12,44,49,-5,44
FC Lugano,9478,5,12,6,14,34,45,-11,42
FC Zürich,9478,6,10,9,13,38,36,2,39
FC Thun,9478,7,11,5,16,44,56,-12,38
Grasshoppers,9478,8,10,6,16,46,56,-10,36
FC Sion,9478,9,5,8,19,39,57,-18,23
Young Boys,9479,1,21,7,4,75,37,38,70
FC Basel,9479,2,19,8,5,58,25,33,65
Lucerne,9479,3,13,7,12,41,45,-4,46
St Gallen,9479,4,13,3,16,41,57,-16,42
FC Lugano,9479,5,12,5,15,34,50,-16,41
FC Zürich,9479,6,9,10,13,40,39,1,37
FC Thun,9479,7,10,6,16,41,56,-15,36
FC Sion,9479,8,8,9,15,42,50,-8,33
Grasshoppers,9479,9,8,7,17,39,52,-13,31
Young Boys,9480,1,21,7,4,73,35,38,70
FC Basel,9480,2,16,9,7,55,30,25,57
St Gallen,9480,3,15,3,14,40,50,-10,48
FC Zürich,9480,4,12,9,11,43,34,9,45
Lucerne,9480,5,12,8,12,40,47,-7,44
FC Lugano,9480,6,11,5,16,31,47,-16,38
Grasshoppers,9480,7,10,7,15,44,48,-4,37
FC Thun,9480,8,9,6,17,45,64,-19,33
FC Sion,9480,9,7,8,17,39,55,-16,29
Young Boys,9481,1,22,8,2,75,32,43,74
FC Basel,9481,2,17,9,6,52,25,27,60
St Gallen,9481,3,15,3,14,44,52,-8,48
Lucerne,9481,4,12,8,12,39,46,-7,44
FC Zürich,9481,5,10,9,13,41,40,1,39
FC Lugano,9481,6,11,6,15,32,46,-14,39
FC Thun,9481,7,10,7,15,47,58,-11,37
Grasshoppers,9481,8,8,7,17,38,53,-15,31
FC Sion,9481,9,6,9,17,42,58,-16,27
Young Boys,9482,1,21,7,4,73,36,37,70
FC Basel,9482,2,20,7,5,64,26,38,67
Lucerne,9482,3,14,7,11,46,44,2,49
St Gallen,9482,4,15,2,15,45,56,-11,47
FC Zürich,9482,5,12,9,11,42,36,6,45
FC Lugano,9482,6,10,5,17,29,49,-20,35
FC Thun,9482,7,9,6,17,43,62,-19,33
Grasshoppers,9482,8,8,7,17,38,56,-18,31
FC Sion,9482,9,6,8,18,43,58,-15,26
Young Boys,9483,1,20,8,4,72,39,33,68
FC Basel,9483,2,20,7,5,59,26,33,67
Lucerne,9483,3,13,8,11,42,40,2,47
St Gallen,9483,4,15,2,15,45,54,-9,47
FC Zürich,9483,5,10,9,13,42,39,3,39
FC Lugano,9483,6,11,6,15,30,43,-13,39
FC Thun,9483,7,10,5,17,47,62,-15,35
Grasshoppers,9483,8,8,7,17,40,57,-17,31
FC Sion,9483,9,7,8,17,41,58,-17,29
Young Boys,9484,1,21,7,4,70,34,36,70
FC Basel,9484,2,17,8,7,55,29,26,59
Lucerne,9484,3,14,8,10,45,42,3,50
FC Zürich,9484,4,13,9,10,47,37,10,48
St Gallen,9484,5,13,4,15,42,57,-15,43
Grasshoppers,9484,6,9,6,17,39,50,-11,33
FC Thun,9484,7,9,6,17,42,59,-17,33
FC Lugano,9484,8,9,6,17,30,51,-21,33
FC Sion,9484,9,8,8,16,40,51,-11,32
Young Boys,9485,1,21,7,4,67,33,34,70
FC Basel,9485,2,19,7,6,61,27,34,64
St Gallen,9485,3,16,2,14,45,54,-9,50
Lucerne,9485,4,14,7,11,42,42,0,49
FC Zürich,9485,5,11,9,12,41,39,2,42
FC Lugano,9485,6,10,6,16,28,44,-16,36
Grasshoppers,9485,7,9,7,16,39,49,-10,34
FC Thun,9485,8,8,6,18,44,63,-19,30
FC Sion,9485,9,6,9,17,40,56,-16,27
Young Boys,9486,1,21,8,3,70,36,34,71
FC Basel,9486,2,18,8,6,54,27,27,62
St Gallen,9486,3,16,2,14,47,51,-4,50
Lucerne,9486,4,13,8,11,40,40,0,47
FC Zürich,9486,5,11,10,11,42,36,6,43
Grasshoppers,9486,6,10,6,16,41,49,-8,36
FC Lugano,9486,7,10,6,16,30,48,-18,36
FC Thun,9486,8,9,5,18,45,62,-17,32
FC Sion,9486,9,6,7,19,40,60,-20,25
Young Boys,9487,1,20,8,4,71,36,35,68
FC Basel,9487,2,18,7,7,55,26,29,61
St Gallen,9487,3,16,3,13,47,54,-7,51
Lucerne,9487,4,12,7,13,39,46,-7,43
FC Zürich,9487,5,11,9,12,41,37,4,42
FC Lugano,9487,6,11,6,15,34,49,-15,39
FC Thun,9487,7,11,5,16,46,60,-14,38
Grasshoppers,9487,8,8,8,16,40,52,-12,32
FC Sion,9487,9,6,9,17,42,55,-13,27
Young Boys,9488,1,22,7,3,74,36,38,73
FC Basel,9488,2,16,9,7,52,29,23,57
Lucerne,9488,3,14,8,10,47,44,3,50
St Gallen,9488,4,15,3,14,41,52,-11,48
FC Zürich,9488,5,11,10,11,42,37,5,43
FC Thun,9488,6,11,5,16,47,58,-11,38
Grasshoppers,9488,7,9,6,17,41,54,-13,33
FC Lugano,9488,8,9,6,17,31,50,-19,33
FC Sion,9488,9,6,8,18,39,54,-15,26
Young Boys,9489,1,24,6,2,75,33,42,78
FC Basel,9489,2,18,8,6,56,25,31,62
St Gallen,9489,3,15,4,13,42,50,-8,49
Lucerne,9489,4,11,8,13,40,48,-8,41
FC Zürich,9489,5,9,11,12,38,36,2,38
FC Thun,9489,6,10,6,16,42,60,-18,36
FC Lugano,9489,7,9,7,16,31,49,-18,34
Grasshoppers,9489,8,9,6,17,39,51,-12,33
FC Sion,9489,9,6,10,16,41,52,-11,28
Young Boys,9490,1,23,7,2,77,39,38,76
FC Basel,9490,2,18,9,5,59,28,31,63
St Gallen,9490,3,15,3,14,45,54,-9,48
Lucerne,9490,4,12,7,13,42,49,-7,43
FC Zürich,9490,5,10,10,12,39,37,2,40
FC Thun,9490,6,11,6,15,45,54,-9,39
Grasshoppers,9490,7,9,6,17,39,49,-10,33
FC Lugano,9490,8,9,5,18,33,53,-20,32
FC Sion,9490,9,6,9,17,37,53,-16,27
Young Boys,9491,1,21,8,3,69,34,35,71
FC Basel,9491,2,17,9,6,53,25,28,60
Lucerne,9491,3,13,9,10,42,41,1,48
St Gallen,9491,4,14,3,15,41,56,-15,45
FC Zürich,9491,5,10,10,12,39,38,1,40
FC Thun,9491,6,11,5,16,46,56,-10,38
FC Lugano,9491,7,11,5,16,32,49,-17,38
Grasshoppers,9491,8,9,7,16,40,49,-9,34
FC Sion,9491,9,6,8,18,42,56,-14,26
Young Boys,9492,1,22,7,3,74,36,38,73
FC Basel,9492,2,17,8,7,56,28,28,59
Lucerne,9492,3,14,9,9,48,43,5,51
St Gallen,9492,4,14,2,16,44,60,-16,44
FC Zürich,9492,5,11,10,11,41,35,6,43
FC Sion,9492,6,9,8,15,44,52,-8,35
FC Thun,9492,7,9,6,17,41,60,-19,33
FC Lugano,9492,8,9,5,18,29,52,-23,32
Grasshoppers,9492,9,8,7,17,40,51,-11,31
Young Boys,9493,1,22,6,4,73,35,38,72
FC Basel,9493,2,16,8,8,52,29,23,56
Lucerne,9493,3,13,8,11,42,42,0,47
St Gallen,9493,4,13,5,14,42,55,-13,44
FC Zürich,9493,5,10,10,12,40,39,1,40
FC Lugano,9493,6,11,6,15,30,45,-15,39
Grasshoppers,9493,7,10,7,15,40,47,-7,37
FC Thun,9493,8,9,6,17,45,62,-17,33
FC Sion,9493,9,8,8,16,41,51,-10,32
Young Boys,9494,1,23,6,3,77,38,39,75
FC Basel,9494,2,18,8,6,54,25,29,62
St Gallen,9494,3,14,4,14,42,52,-10,46
FC Zürich,9494,4,11,10,11,40,34,6,43
Lucerne,9494,5,11,7,14,40,48,-8,40
FC Lugano,9494,6,11,5,16,32,47,-15,38
Grasshoppers,9494,7,10,6,16,45,52,-7,36
FC Thun,9494,8,9,6,17,44,61,-17,33
FC Sion,9494,9,7,8,17,41,58,-17,29
Young Boys,9495,1,21,7,4,70,37,33,70
FC Basel,9495,2,18,8,6,56,23,33,62
St Gallen,9495,3,15,2,15,45,57,-12,47
FC Zürich,9495,4,12,10,10,44,36,8,46
Lucerne,9495,5,12,10,10,41,45,-4,46
Grasshoppers,9495,6,10,7,15,42,49,-7,37
FC Lugano,9495,7,10,5,17,31,48,-17,35
FC Thun,9495,8,9,6,17,42,59,-17,33
FC Sion,9495,9,6,7,19,40,57,-17,25
FC Basel,9496,1,19,7,6,64,32,32,64
Young Boys,9496,2,19,6,7,68,43,25,63
Lucerne,9496,3,13,8,11,41,43,-2,47
St Gallen,9496,4,15,2,15,49,60,-11,47
FC Zürich,9496,5,10,11,11,44,38,6,41
Grasshoppers,9496,6,11,6,15,41,46,-5,39
FC Lugano,9496,7,11,6,15,34,49,-15,39
FC Thun,9496,8,9,6,17,45,59,-14,33
FC Sion,9496,9,7,8,17,43,59,-16,29
Young Boys,9497,1,23,7,2,75,33,42,76
FC Basel,9497,2,17,8,7,53,27,26,59
St Gallen,9497,3,14,4,14,43,54,-11,46
Lucerne,9497,4,12,8,12,39,46,-7,44
FC Zürich,9497,5,10,10,12,41,37,4,40
Grasshoppers,9497,6,11,6,15,42,47,-5,39
FC Lugano,9497,7,10,7,15,32,47,-15,37
FC Thun,9497,8,9,6,17,41,59,-18,33
FC Sion,9497,9,6,8,18,38,54,-16,26
Young Boys,9498,1,20,8,4,73,38,35,68
FC Basel,9498,2,18,9,5,53,24,29,63
St Gallen,9498,3,15,3,14,43,54,-11,48
Lucerne,9498,4,12,10,10,43,43,0,46
FC Zürich,9498,5,10,12,10,41,34,7,42
Grasshoppers,9498,6,10,7,15,42,49,-7,37
FC Thun,9498,7,9,6,17,40,56,-16,33
FC Lugano,9498,8,9,5,18,30,55,-25,32
FC Sion,9498,9,7,8,17,42,54,-12,29
Young Boys,9499,1,24,6,2,79,33,46,78
FC Basel,9499,2,18,7,7,54,27,27,61
St Gallen,9499,3,15,4,13,44,53,-9,49
Lucerne,9499,4,12,8,12,43,44,-1,44
FC Zürich,9499,5,10,10,12,42,38,4,40
Grasshoppers,9499,6,10,6,16,41,55,-14,36
FC Lugano,9499,7,9,7,16,30,49,-19,34
FC Thun,9499,8,8,6,18,42,63,-21,30
FC Sion,9499,9,7,8,17,42,55,-13,29
Young Boys,9500,1,21,6,5,74,37,37,69
FC Basel,9500,2,18,9,5,52,23,29,63
St Gallen,9500,3,14,3,15,43,56,-13,45
Lucerne,9500,4,11,9,12,41,46,-5,42
Grasshoppers,9500,5,11,6,15,43,47,-4,39
FC Thun,9500,6,11,6,15,49,56,-7,39
FC Zürich,9500,7,9,10,13,40,39,1,37
FC Lugano,9500,8,10,6,16,32,53,-21,36
FC Sion,9500,9,8,7,17,42,59,-17,31
Young Boys,9501,1,21,8,3,75,36,39,71
FC Basel,9501,2,18,9,5,56,27,29,63
Lucerne,9501,3,13,7,12,42,46,-4,46
FC Zürich,9501,4,11,10,11,43,36,7,43
FC Lugano,9501,5,12,6,14,36,46,-10,42
St Gallen,9501,6,13,3,16,42,59,-17,42
Grasshoppers,9501,7,9,8,15,40,49,-9,35
FC Thun,9501,8,9,6,17,43,60,-17,33
FC Sion,9501,9,6,7,19,39,57,-18,25
Young Boys,9502,1,22,7,3,75,36,39,73
FC Basel,9502,2,18,8,6,58,24,34,62
Lucerne,9502,3,14,7,11,48,44,4,49
St Gallen,9502,4,14,2,16,41,60,-19,44
FC Zürich,9502,5,11,10,11,40,35,5,43
FC Thun,9502,6,10,6,16,45,57,-12,36
FC Lugano,9502,7,10,5,17,31,49,-18,35
Grasshoppers,9502,8,9,7,16,41,55,-14,34
FC Sion,9502,9,6,8,18,39,58,-19,26
Young Boys,9503,1,19,6,7,68,42,26,63
FC Basel,9503,2,18,8,6,55,27,28,62
Lucerne,9503,3,15,7,10,43,40,3,52
FC Lugano,9503,4,13,5,14,36,43,-7,44
St Gallen,9503,5,13,3,16,41,56,-15,42
FC Zürich,9503,6,10,9,13,40,40,0,39
Grasshoppers,9503,7,10,7,15,44,50,-6,37
FC Sion,9503,8,8,8,16,47,53,-6,32
FC Thun,9503,9,9,5,18,43,66,-23,32
Young Boys,9504,1,22,6,4,70,33,37,72
FC Basel,9504,2,19,8,5,53,24,29,65
St Gallen,9504,3,14,4,14,43,55,-12,46
Lucerne,9504,4,12,9,11,41,43,-2,45
FC Zürich,9504,5,11,9,12,40,38,2,42
FC Thun,9504,6,10,6,16,48,59,-11,36
FC Lugano,9504,7,10,6,16,32,48,-16,36
Grasshoppers,9504,8,9,7,16,42,52,-10,34
FC Sion,9504,9,5,9,18,40,57,-17,24
Young Boys,9505,1,22,6,4,71,38,33,72
FC Basel,9505,2,17,8,7,56,29,27,59
Lucerne,9505,3,13,8,11,46,44,2,47
St Gallen,9505,4,14,3,15,43,59,-16,45
FC Zürich,9505,5,11,11,10,42,36,6,44
Grasshoppers,9505,6,10,7,15,47,51,-4,37
FC Lugano,9505,7,10,7,15,32,47,-15,37
FC Thun,9505,8,9,7,16,45,60,-15,34
FC Sion,9505,9,6,7,19,39,57,-18,25
Young Boys,9506,1,21,8,3,70,34,36,71
FC Basel,9506,2,15,10,7,51,28,23,55
Lucerne,9506,3,13,9,10,43,42,1,48
St Gallen,9506,4,14,4,14,41,54,-13,46
FC Zürich,9506,5,10,11,11,43,37,6,41
Grasshoppers,9506,6,9,8,15,42,47,-5,35
FC Lugano,9506,7,9,8,15,32,48,-16,35
FC Thun,9506,8,9,6,17,41,59,-18,33
FC Sion,9506,9,8,8,16,42,56,-14,32
Young Boys,9507,1,22,7,3,69,34,35,73
FC Basel,9507,2,17,7,8,51,27,24,58
St Gallen,9507,3,15,4,13,42,51,-9,49
Lucerne,9507,4,13,8,11,39,40,-1,47
FC Zürich,9507,5,10,9,13,41,39,2,39
FC Lugano,9507,6,10,7,15,30,45,-15,37
Grasshoppers,9507,7,8,9,15,40,49,-9,33
FC Thun,9507,8,9,6,17,44,58,-14,33
FC Sion,9507,9,7,9,16,41,54,-13,30
Young Boys,9508,1,22,8,2,72,34,38,74
FC Basel,9508,2,17,9,6,53,26,27,60
Lucerne,9508,3,12,9,11,44,47,-3,45
St Gallen,9508,4,14,3,15,43,56,-13,45
FC Zürich,9508,5,11,10,11,42,38,4,43
FC Lugano,9508,6,12,5,15,33,45,-12,41
Grasshoppers,9508,7,9,8,15,42,49,-7,35
FC Thun,9508,8,8,7,17,46,63,-17,31
FC Sion,9508,9,5,9,18,39,56,-17,24
Young Boys,9509,1,23,7,2,76,30,46,76
FC Basel,9509,2,15,10,7,50,29,21,55
St Gallen,9509,3,14,5,13,45,54,-9,47
Lucerne,9509,4,11,11,10,41,43,-2,44
FC Zürich,9509,5,10,12,10,42,36,6,42
FC Thun,9509,6,11,6,15,48,57,-9,39
FC Lugano,9509,7,10,6,16,32,49,-17,36
Grasshoppers,9509,8,8,7,17,37,51,-14,31
FC Sion,9509,9,6,8,18,38,60,-22,26
Young Boys,9510,1,22,7,3,74,35,39,73
FC Basel,9510,2,15,10,7,51,30,21,55
St Gallen,9510,3,17,2,13,49,53,-4,53
Lucerne,9510,4,13,9,10,45,43,2,48
FC Zürich,9510,5,12,9,11,43,37,6,45
FC Thun,9510,6,10,6,16,45,58,-13,36
FC Lugano,9510,7,9,6,17,30,50,-20,33
Grasshoppers,9510,8,8,7,17,38,55,-17,31
FC Sion,9510,9,6,8,18,42,56,-14,26
Young Boys,9511,1,20,9,3,70,36,34,69
FC Basel,9511,2,18,8,6,54,27,27,62
FC Zürich,9511,3,13,9,10,46,36,10,48
Lucerne,9511,4,13,9,10,43,40,3,48
St Gallen,9511,5,13,3,16,41,59,-18,42
FC Lugano,9511,6,10,7,15,30,45,-15,37
Grasshoppers,9511,7,9,7,16,43,51,-8,34
FC Thun,9511,8,8,8,16,44,60,-16,32
FC Sion,9511,9,5,10,17,40,57,-17,25
Young Boys,9512,1,22,6,4,78,36,42,72
FC Basel,9512,2,19,8,5,57,26,31,65
FC Zürich,9512,3,12,9,11,40,34,6,45
Lucerne,9512,4,12,9,11,41,45,-4,45
St Gallen,9512,5,14,3,15,43,56,-13,45
Grasshoppers,9512,6,9,8,15,42,53,-11,35
FC Lugano,9512,7,10,5,17,33,50,-17,35
FC Thun,9512,8,9,6,17,45,60,-15,33
FC Sion,9512,9,5,10,17,39,58,-19,25
Young Boys,9513,1,21,6,5,72,36,36,69
FC Basel,9513,2,18,8,6,55,25,30,62
St Gallen,9513,3,15,2,15,42,52,-10,47
Lucerne,9513,4,13,7,12,41,46,-5,46
FC Zürich,9513,5,11,10,11,42,38,4,43
Grasshoppers,9513,6,10,7,15,42,50,-8,37
FC Thun,9513,7,9,6,17,42,57,-15,33
FC Lugano,9513,8,9,6,17,28,49,-21,33
FC Sion,9513,9,8,8,16,41,52,-11,32
Young Boys,9514,1,21,7,4,67,33,34,70
FC Basel,9514,2,19,8,5,59,22,37,65
Lucerne,9514,3,13,7,12,44,46,-2,46
St Gallen,9514,4,13,3,16,42,61,-19,42
FC Zürich,9514,5,10,10,12,40,38,2,40
FC Lugano,9514,6,10,7,15,29,44,-15,37
Grasshoppers,9514,7,10,6,16,43,50,-7,36
FC Thun,9514,8,10,5,17,46,61,-15,35
FC Sion,9514,9,8,7,17,42,57,-15,31
Young Boys,9515,1,21,6,5,70,37,33,69
FC Basel,9515,2,20,7,5,59,22,37,67
Lucerne,9515,3,12,8,12,43,46,-3,44
St Gallen,9515,4,13,3,16,41,63,-22,42
FC Zürich,9515,5,10,9,13,38,38,0,39
Grasshoppers,9515,6,11,6,15,44,49,-5,39
FC Lugano,9515,7,11,5,16,31,47,-16,38
FC Thun,9515,8,9,6,17,43,63,-20,33
FC Sion,9515,9,8,8,16,48,52,-4,32
Young Boys,9516,1,22,7,3,72,35,37,73
FC Basel,9516,2,16,9,7,49,25,24,57
Lucerne,9516,3,15,7,10,43,40,3,52
St Gallen,9516,4,16,2,14,44,54,-10,50
FC Zürich,9516,5,9,11,12,38,38,0,38
Grasshoppers,9516,6,9,7,16,40,51,-11,34
FC Thun,9516,7,9,7,16,44,57,-13,34
FC Lugano,9516,8,9,6,17,29,48,-19,33
FC Sion,9516,9,7,8,17,44,55,-11,29
Young Boys,9517,1,23,6,3,72,33,39,75
FC Basel,9517,2,18,9,5,57,24,33,63
St Gallen,9517,3,14,2,16,42,57,-15,44
FC Zürich,9517,4,11,10,11,39,35,4,43
Lucerne,9517,5,11,8,13,40,48,-8,41
Grasshoppers,9517,6,11,6,15,43,46,-3,39
FC Lugano,9517,7,11,5,16,31,47,-16,38
FC Thun,9517,8,10,5,17,45,58,-13,35
FC Sion,9517,9,6,7,19,38,59,-21,25
Young Boys,9518,1,20,7,5,67,35,32,67
FC Basel,9518,2,17,7,8,53,31,22,58
St Gallen,9518,3,15,3,14,45,54,-9,48
Lucerne,9518,4,13,8,11,40,43,-3,47
FC Zürich,9518,5,12,10,10,44,34,10,46
FC Thun,9518,6,11,5,16,43,55,-12,38
FC Lugano,9518,7,10,5,17,30,48,-18,35
Grasshoppers,9518,8,8,8,16,37,48,-11,32
FC Sion,9518,9,7,9,16,43,54,-11,30
Young Boys,9519,1,21,7,4,72,38,34,70
FC Basel,9519,2,18,9,5,56,26,30,63
Lucerne,9519,3,12,10,10,45,45,0,46
St Gallen,9519,4,13,5,14,44,56,-12,44
FC Lugano,9519,5,12,5,15,34,47,-13,41
Grasshoppers,9519,6,11,6,15,46,49,-3,39
FC Zürich,9519,7,9,10,13,37,37,0,37
FC Thun,9519,8,8,7,17,38,56,-18,31
FC Sion,9519,9,6,9,17,39,57,-18,27
Young Boys,9520,1,23,6,3,74,34,40,75
FC Basel,9520,2,18,7,7,54,27,27,61
St Gallen,9520,3,15,2,15,46,59,-13,47
FC Zürich,9520,4,11,10,11,40,34,6,43
Lucerne,9520,5,12,7,13,41,48,-7,43
Grasshoppers,9520,6,11,6,15,46,50,-4,39
FC Thun,9520,7,11,6,15,44,55,-11,39
FC Lugano,9520,8,9,5,18,28,48,-20,32
FC Sion,9520,9,6,7,19,39,57,-18,25
Young Boys,9521,1,22,6,4,72,34,38,72
FC Basel,9521,2,19,7,6,58,26,32,64
Lucerne,9521,3,13,8,11,46,47,-1,47
St Gallen,9521,4,14,3,15,42,55,-13,45
FC Zürich,9521,5,9,11,12,38,37,1,38
FC Thun,9521,6,11,5,16,44,59,-15,38
Grasshoppers,9521,7,9,7,16,42,50,-8,34
FC Lugano,9521,8,9,7,16,29,50,-21,34
FC Sion,9521,9,7,8,17,41,54,-13,29
Young Boys,9522,1,21,7,4,71,34,37,70
FC Basel,9522,2,16,9,7,50,26,24,57
Lucerne,9522,3,13,9,10,43,42,1,48
St Gallen,9522,4,15,3,14,43,52,-9,48
FC Zürich,9522,5,11,9,12,38,35,3,42
Grasshoppers,9522,6,11,6,15,45,47,-2,39
FC Lugano,9522,7,11,5,16,31,51,-20,38
FC Thun,9522,8,10,5,17,42,60,-18,35
FC Sion,9522,9,6,7,19,36,52,-16,25
Young Boys,9523,1,23,6,3,77,37,40,75
FC Basel,9523,2,18,8,6,57,26,31,62
St Gallen,9523,3,14,3,15,43,54,-11,45
FC Zürich,9523,4,11,10,11,40,35,5,43
Lucerne,9523,5,11,9,12,42,51,-9,42
Grasshoppers,9523,6,10,7,15,45,49,-4,37
FC Lugano,9523,7,10,7,15,31,47,-16,37
FC Thun,9523,8,9,5,18,42,60,-18,32
FC Sion,9523,9,7,7,18,38,56,-18,28
Young Boys,9524,1,23,6,3,72,34,38,75
FC Basel,9524,2,17,9,6,52,25,27,60
Lucerne,9524,3,13,8,11,40,43,-3,47
St Gallen,9524,4,14,4,14,42,52,-10,46
FC Zürich,9524,5,9,11,12,42,43,-1,38
Grasshoppers,9524,6,9,8,15,40,47,-7,35
FC Lugano,9524,7,10,5,17,34,49,-15,35
FC Thun,9524,8,10,5,17,42,58,-16,35
FC Sion,9524,9,6,10,16,41,54,-13,28
Young Boys,9525,1,22,6,4,68,32,36,72
FC Basel,9525,2,19,7,6,56,27,29,64
Lucerne,9525,3,14,7,11,45,42,3,49
St Gallen,9525,4,15,2,15,44,55,-11,47
FC Zürich,9525,5,9,10,13,38,38,0,37
Grasshoppers,9525,6,10,7,15,44,46,-2,37
FC Lugano,9525,7,10,6,16,30,49,-19,36
FC Thun,9525,8,10,5,17,42,62,-20,35
FC Sion,9525,9,6,8,18,37,53,-16,26
Young Boys,9526,1,21,8,3,75,36,39,71
FC Basel,9526,2,18,8,6,56,26,30,62
Lucerne,9526,3,13,8,11,44,44,0,47
St Gallen,9526,4,13,4,15,42,57,-15,43
FC Zürich,9526,5,10,11,11,38,34,4,41
FC Lugano,9526,6,10,7,15,32,48,-16,37
Grasshoppers,9526,7,10,6,16,42,52,-10,36
FC Sion,9526,8,8,8,16,43,54,-11,32
FC Thun,9526,9,8,6,18,40,61,-21,30
Young Boys,9527,1,20,8,4,72,36,36,68
FC Basel,9527,2,18,8,6,54,27,27,62
Lucerne,9527,3,14,7,11,42,43,-1,49
FC Lugano,9527,4,12,6,14,30,42,-12,42
FC Zürich,9527,5,10,11,11,40,36,4,41
St Gallen,9527,6,13,2,17,39,55,-16,41
FC Thun,9527,7,10,6,16,44,54,-10,36
Grasshoppers,9527,8,8,8,16,43,56,-13,32
FC Sion,9527,9,7,8,17,41,56,-15,29
Young Boys,9528,1,22,8,2,73,33,40,74
FC Basel,9528,2,17,10,5,58,24,34,61
St Gallen,9528,3,16,3,13,47,55,-8,51
Lucerne,9528,4,12,7,13,42,50,-8,43
FC Zrich,9528,5,10,10,12,38,37,1,40
FC Thun,9528,6,11,5,16,43,57,-14,38
Grasshoppers,9528,7,10,7,15,44,47,-3,37
FC Lugano,9528,8,9,5,18,31,53,-22,32
FC Sion,9528,9,6,7,19,39,59,-20,25
Young Boys,9529,1,22,6,4,71,35,36,72
FC Basel,9529,2,18,9,5,55,24,31,63
Lucerne,9529,3,13,8,11,44,43,1,47
St Gallen,9529,4,13,5,14,43,55,-12,44
FC Zürich,9529,5,10,10,12,39,40,-1,40
FC Lugano,9529,6,11,6,15,32,47,-15,39
FC Thun,9529,7,10,7,15,47,57,-10,37
Grasshoppers,9529,8,9,7,16,42,51,-9,34
FC Sion,9529,9,5,8,19,37,58,-21,23
Young Boys,9530,1,23,7,2,72,30,42,76
FC Basel,9530,2,18,8,6,52,25,27,62
St Gallen,9530,3,15,4,13,44,53,-9,49
Lucerne,9530,4,11,8,13,39,45,-6,41
FC Zürich,9530,5,10,10,12,41,38,3,40
FC Thun,9530,6,11,5,16,44,56,-12,38
FC Lugano,9530,7,10,7,15,32,48,-16,37
Grasshoppers,9530,8,8,8,16,38,50,-12,32
FC Sion,9530,9,6,7,19,40,57,-17,25
Young Boys,9531,1,21,8,3,69,33,36,71
FC Basel,9531,2,17,7,8,50,28,22,58
St Gallen,9531,3,15,2,15,43,53,-10,47
FC Zürich,9531,4,11,10,11,44,36,8,43
Lucerne,9531,5,12,7,13,38,45,-7,43
FC Lugano,9531,6,11,6,15,31,44,-13,39
Grasshoppers,9531,7,10,7,15,43,49,-6,37
FC Sion,9531,8,8,8,16,43,55,-12,32
FC Thun,9531,9,9,5,18,41,59,-18,32
Young Boys,9532,1,21,9,2,68,32,36,72
FC Basel,9532,2,18,8,6,53,23,30,62
St Gallen,9532,3,15,2,15,42,53,-11,47
FC Zürich,9532,4,11,9,12,39,36,3,42
FC Lugano,9532,5,12,6,14,34,46,-12,42
Lucerne,9532,6,11,7,14,38,47,-9,40
Grasshoppers,9532,7,9,7,16,40,49,-9,34
FC Thun,9532,8,9,6,17,44,58,-14,33
FC Sion,9532,9,7,8,17,39,53,-14,29
Young Boys,9533,1,22,7,3,74,39,35,73
FC Basel,9533,2,17,9,6,52,26,26,60
Lucerne,9533,3,12,8,12,40,44,-4,44
FC Zürich,9533,4,11,10,11,44,35,9,43
St Gallen,9533,5,13,4,15,43,60,-17,43
Grasshoppers,9533,6,10,7,15,46,50,-4,37
FC Lugano,9533,7,10,6,16,34,49,-15,36
FC Thun,9533,8,9,6,17,41,58,-17,33
FC Sion,9533,9,8,7,17,48,61,-13,31
Young Boys,9534,1,20,6,6,67,39,28,66
FC Basel,9534,2,18,8,6,54,27,27,62
Lucerne,9534,3,13,10,9,40,38,2,49
St Gallen,9534,4,14,3,15,43,55,-12,45
FC Zürich,9534,5,11,10,11,42,34,8,43
FC Lugano,9534,6,11,6,15,33,46,-13,39
Grasshoppers,9534,7,10,7,15,41,47,-6,37
FC Thun,9534,8,8,6,18,42,65,-23,30
FC Sion,9534,9,7,8,17,44,55,-11,29
Young Boys,9535,1,21,8,3,72,37,35,71
FC Basel,9535,2,19,8,5,54,23,31,65
St Gallen,9535,3,14,4,14,40,51,-11,46
Lucerne,9535,4,11,10,11,38,41,-3,43
FC Zürich,9535,5,10,10,12,40,36,4,40
FC Thun,9535,6,11,5,16,47,61,-14,38
FC Lugano,9535,7,10,5,17,30,48,-18,35
Grasshoppers,9535,8,8,8,16,41,52,-11,32
FC Sion,9535,9,6,10,16,41,54,-13,28
Young Boys,9536,1,21,6,5,75,39,36,69
FC Basel,9536,2,17,8,7,55,30,25,59
Lucerne,9536,3,14,7,11,46,41,5,49
St Gallen,9536,4,14,4,14,46,58,-12,46
FC Lugano,9536,5,12,6,14,35,46,-11,42
FC Zürich,9536,6,10,11,11,41,35,6,41
FC Thun,9536,7,10,7,15,42,55,-13,37
Grasshoppers,9536,8,9,7,16,43,53,-10,34
FC Sion,9536,9,5,8,19,38,64,-26,23
Young Boys,9537,1,20,8,4,72,40,32,68
FC Basel,9537,2,18,8,6,57,26,31,62
Lucerne,9537,3,13,9,10,47,44,3,48
St Gallen,9537,4,14,5,13,44,54,-10,47
FC Zürich,9537,5,11,11,10,40,33,7,44
Grasshoppers,9537,6,10,6,16,41,51,-10,36
FC Thun,9537,7,9,6,17,40,58,-18,33
FC Lugano,9537,8,9,6,17,28,49,-21,33
FC Sion,9537,9,6,9,17,41,55,-14,27
Young Boys,9538,1,21,7,4,71,34,37,70
FC Basel,9538,2,19,7,6,55,25,30,64
Lucerne,9538,3,14,8,10,42,41,1,50
St Gallen,9538,4,13,2,17,41,58,-17,41
FC Zürich,9538,5,10,10,12,40,36,4,40
FC Lugano,9538,6,11,5,16,31,48,-17,38
Grasshoppers,9538,7,9,9,14,43,50,-7,36
FC Thun,9538,8,9,7,16,47,65,-18,34
FC Sion,9538,9,7,7,18,45,58,-13,28
Young Boys,9539,1,23,6,3,77,36,41,75
FC Basel,9539,2,16,8,8,53,31,22,56
Lucerne,9539,3,14,8,10,45,44,1,50
St Gallen,9539,4,14,4,14,45,55,-10,46
FC Zürich,9539,5,11,10,11,47,38,9,43
FC Thun,9539,6,10,6,16,47,59,-12,36
Grasshoppers,9539,7,9,7,16,40,52,-12,34
FC Lugano,9539,8,9,7,16,32,50,-18,34
FC Sion,9539,9,6,8,18,37,58,-21,26
Young Boys,9540,1,21,8,3,73,34,39,71
FC Basel,9540,2,17,10,5,56,25,31,61
Lucerne,9540,3,14,9,9,45,42,3,51
St Gallen,9540,4,13,3,16,41,56,-15,42
FC Zürich,9540,5,9,11,12,40,38,2,38
FC Thun,9540,6,10,6,16,45,61,-16,36
FC Lugano,9540,7,10,6,16,32,49,-17,36
Grasshoppers,9540,8,9,7,16,45,54,-9,34
FC Sion,9540,9,7,8,17,38,56,-18,29
Young Boys,9541,1,20,7,5,67,35,32,67
FC Basel,9541,2,18,8,6,55,27,28,62
St Gallen,9541,3,16,3,13,48,53,-5,51
Lucerne,9541,4,13,7,12,44,47,-3,46
FC Zürich,9541,5,10,9,13,43,42,1,39
Grasshoppers,9541,6,10,7,15,45,50,-5,37
FC Thun,9541,7,10,6,16,48,60,-12,36
FC Sion,9541,8,8,8,16,40,53,-13,32
FC Lugano,9541,9,9,5,18,29,52,-23,32
Young Boys,9542,1,22,7,3,74,35,39,73
FC Basel,9542,2,19,7,6,59,26,33,64
Lucerne,9542,3,14,8,10,43,43,0,50
St Gallen,9542,4,13,3,16,42,59,-17,42
FC Zürich,9542,5,9,11,12,39,39,0,38
FC Lugano,9542,6,10,7,15,33,47,-14,37
FC Thun,9542,7,10,6,16,46,58,-12,36
Grasshoppers,9542,8,9,7,16,39,51,-12,34
FC Sion,9542,9,6,8,18,42,59,-17,26
Young Boys,9543,1,21,8,3,73,39,34,71
FC Basel,9543,2,18,7,7,54,27,27,61
Lucerne,9543,3,13,8,11,43,46,-3,47
St Gallen,9543,4,14,3,15,45,55,-10,45
FC Zürich,9543,5,11,10,11,43,37,6,43
FC Lugano,9543,6,11,6,15,33,47,-14,39
Grasshoppers,9543,7,9,7,16,44,51,-7,34
FC Thun,9543,8,9,6,17,42,61,-19,33
FC Sion,9543,9,6,9,17,41,55,-14,27
Young Boys,9544,1,22,8,2,70,33,37,74
FC Basel,9544,2,17,8,7,51,26,25,59
Lucerne,9544,3,14,9,9,42,40,2,51
St Gallen,9544,4,14,5,13,41,51,-10,47
FC Zürich,9544,5,11,9,12,41,35,6,42
FC Thun,9544,6,10,5,17,45,58,-13,35
FC Lugano,9544,7,10,5,17,28,45,-17,35
Grasshoppers,9544,8,9,6,17,40,51,-11,33
FC Sion,9544,9,5,9,18,38,57,-19,24
Young Boys,9545,1,21,8,3,69,33,36,71
FC Basel,9545,2,18,7,7,54,25,29,61
St Gallen,9545,3,15,3,14,48,57,-9,48
Lucerne,9545,4,12,8,12,42,45,-3,44
FC Zürich,9545,5,11,10,11,45,39,6,43
FC Lugano,9545,6,10,8,14,36,50,-14,38
Grasshoppers,9545,7,9,7,16,40,51,-11,34
FC Thun,9545,8,9,6,17,42,62,-20,33
FC Sion,9545,9,6,9,17,43,57,-14,27
Young Boys,9546,1,23,7,2,74,31,43,76
FC Basel,9546,2,18,7,7,56,26,30,61
St Gallen,9546,3,15,2,15,43,55,-12,47
Lucerne,9546,4,12,8,12,41,48,-7,44
FC Zürich,9546,5,10,9,13,42,39,3,39
FC Lugano,9546,6,11,6,15,31,46,-15,39
Grasshoppers,9546,7,10,7,15,40,47,-7,37
FC Thun,9546,8,10,5,17,47,60,-13,35
FC Sion,9546,9,6,7,19,38,60,-22,25
Young Boys,9547,1,23,6,3,72,33,39,75
FC Basel,9547,2,18,9,5,57,26,31,63
St Gallen,9547,3,15,2,15,46,57,-11,47
FC Zürich,9547,4,12,10,10,43,35,8,46
Lucerne,9547,5,11,9,12,40,48,-8,42
FC Lugano,9547,6,10,6,16,34,51,-17,36
FC Thun,9547,7,9,6,17,47,61,-14,33
Grasshoppers,9547,8,8,8,16,41,53,-12,32
FC Sion,9547,9,6,8,18,38,54,-16,26
FC Basel,9548,1,20,7,5,57,21,36,67
Young Boys,9548,2,19,6,7,67,41,26,63
St Gallen,9548,3,15,2,15,45,58,-13,47
Lucerne,9548,4,13,7,12,43,46,-3,46
FC Zürich,9548,5,10,9,13,38,37,1,39
Grasshoppers,9548,6,11,6,15,47,48,-1,39
FC Lugano,9548,7,11,5,16,31,48,-17,38
FC Thun,9548,8,10,5,17,42,56,-14,35
FC Sion,9548,9,8,7,17,41,56,-15,31
Young Boys,9549,1,21,7,4,74,41,33,70
FC Basel,9549,2,17,10,5,55,26,29,61
St Gallen,9549,3,15,3,14,46,51,-5,48
Lucerne,9549,4,13,7,12,42,48,-6,46
FC Zürich,9549,5,10,11,11,40,36,4,41
Grasshoppers,9549,6,11,6,15,47,50,-3,39
FC Thun,9549,7,9,6,17,42,57,-15,33
FC Lugano,9549,8,9,6,17,30,53,-23,33
FC Sion,9549,9,7,8,17,40,54,-14,29
Young Boys,9550,1,20,7,5,68,37,31,67
FC Basel,9550,2,17,10,5,54,25,29,61
Lucerne,9550,3,15,8,9,48,41,7,53
FC Zürich,9550,4,11,10,11,42,36,6,43
St Gallen,9550,5,13,4,15,42,55,-13,43
FC Thun,9550,6,10,5,17,45,59,-14,35
FC Lugano,9550,7,10,5,17,29,52,-23,35
Grasshoppers,9550,8,8,8,16,39,50,-11,32
FC Sion,9550,9,7,9,16,40,52,-12,30
Young Boys,9551,1,22,7,3,72,35,37,73
FC Basel,9551,2,17,9,6,51,23,28,60
Lucerne,9551,3,14,8,10,46,43,3,50
St Gallen,9551,4,15,2,15,44,57,-13,47
FC Zürich,9551,5,10,11,11,40,37,3,41
FC Lugano,9551,6,10,6,16,30,46,-16,36
FC Thun,9551,7,9,7,16,45,56,-11,34
Grasshoppers,9551,8,8,8,16,41,53,-12,32
FC Sion,9551,9,6,8,18,44,63,-19,26
Young Boys,9552,1,21,7,4,71,33,38,70
FC Basel,9552,2,18,8,6,53,26,27,62
St Gallen,9552,3,15,3,14,45,56,-11,48
Lucerne,9552,4,13,8,11,43,47,-4,47
FC Zürich,9552,5,11,10,11,41,34,7,43
Grasshoppers,9552,6,11,6,15,43,48,-5,39
FC Thun,9552,7,10,5,17,41,57,-16,35
FC Lugano,9552,8,9,5,18,30,52,-22,32
FC Sion,9552,9,6,8,18,41,55,-14,26
Young Boys,9553,1,21,7,4,70,33,37,70
FC Basel,9553,2,20,7,5,57,23,34,67
St Gallen,9553,3,14,3,15,41,53,-12,45
Lucerne,9553,4,12,8,12,39,44,-5,44
FC Zürich,9553,5,10,10,12,42,41,1,40
FC Lugano,9553,6,11,6,15,32,48,-16,39
FC Thun,9553,7,9,6,17,45,63,-18,33
Grasshoppers,9553,8,8,8,16,40,50,-10,32
FC Sion,9553,9,8,7,17,45,56,-11,31
Young Boys,9554,1,22,6,4,72,33,39,72
FC Basel,9554,2,19,7,6,59,23,36,64
Lucerne,9554,3,14,7,11,43,44,-1,49
St Gallen,9554,4,14,4,14,42,53,-11,46
FC Zürich,9554,5,11,9,12,41,38,3,42
FC Lugano,9554,6,11,6,15,32,47,-15,39
FC Thun,9554,7,9,6,17,45,60,-15,33
Grasshoppers,9554,8,8,8,16,38,49,-11,32
FC Sion,9554,9,5,9,18,37,62,-25,24
Young Boys,9555,1,22,6,4,73,36,37,72
FC Basel,9555,2,17,9,6,53,26,27,60
Lucerne,9555,3,13,7,12,44,47,-3,46
St Gallen,9555,4,14,2,16,42,54,-12,44
FC Zürich,9555,5,9,12,11,38,35,3,39
FC Thun,9555,6,11,6,15,47,56,-9,39
Grasshoppers,9555,7,10,6,16,43,51,-8,36
FC Lugano,9555,8,10,6,16,31,50,-19,36
FC Sion,9555,9,7,8,17,40,56,-16,29
Young Boys,9556,1,20,7,5,67,38,29,67
FC Basel,9556,2,19,8,5,60,25,35,65
Lucerne,9556,3,12,9,11,41,44,-3,45
St Gallen,9556,4,14,3,15,44,56,-12,45
FC Zürich,9556,5,9,12,11,38,35,3,39
FC Thun,9556,6,11,5,16,46,57,-11,38
Grasshoppers,9556,7,10,7,15,40,49,-9,37
FC Lugano,9556,8,9,7,16,30,48,-18,34
FC Sion,9556,9,6,10,16,38,52,-14,28
Young Boys,9557,1,20,9,3,72,38,34,69
FC Basel,9557,2,19,8,5,54,24,30,65
St Gallen,9557,3,15,3,14,44,51,-7,48
Lucerne,9557,4,12,10,10,42,43,-1,46
FC Zürich,9557,5,10,11,11,41,37,4,41
FC Thun,9557,6,10,6,16,45,59,-14,36
FC Lugano,9557,7,9,7,16,29,48,-19,34
Grasshoppers,9557,8,8,7,17,39,52,-13,31
FC Sion,9557,9,6,9,17,40,54,-14,27
Young Boys,9558,1,22,7,3,73,35,38,73
FC Basel,9558,2,17,10,5,53,25,28,61
St Gallen,9558,3,15,4,13,41,50,-9,49
Lucerne,9558,4,11,10,11,40,43,-3,43
FC Zürich,9558,5,10,10,12,40,41,-1,40
FC Thun,9558,6,11,5,16,48,57,-9,38
FC Lugano,9558,7,10,6,16,31,49,-18,36
Grasshoppers,9558,8,9,7,16,40,49,-9,34
FC Sion,9558,9,5,9,18,41,58,-17,24
Young Boys,9559,1,21,7,4,76,35,41,70
FC Basel,9559,2,18,8,6,59,27,32,62
St Gallen,9559,3,15,3,14,48,55,-7,48
FC Zürich,9559,4,12,10,10,43,34,9,46
Lucerne,9559,5,12,9,11,40,48,-8,45
Grasshoppers,9559,6,9,8,15,45,53,-8,35
FC Lugano,9559,7,10,5,17,29,50,-21,35
FC Thun,9559,8,9,5,18,44,66,-22,32
FC Sion,9559,9,7,7,18,42,58,-16,28
Young Boys,9560,1,20,9,3,68,34,34,69
FC Basel,9560,2,17,9,6,54,26,28,60
Lucerne,9560,3,14,8,10,47,46,1,50
St Gallen,9560,4,15,2,15,46,56,-10,47
FC Zürich,9560,5,10,11,11,43,37,6,41
FC Lugano,9560,6,10,7,15,33,49,-16,37
Grasshoppers,9560,7,9,8,15,42,50,-8,35
FC Thun,9560,8,9,7,16,42,57,-15,34
FC Sion,9560,9,5,9,18,34,54,-20,24
Young Boys,9561,1,20,6,6,72,42,30,66
FC Basel,9561,2,18,8,6,55,26,29,62
Lucerne,9561,3,13,9,10,44,44,0,48
St Gallen,9561,4,14,3,15,43,57,-14,45
FC Zürich,9561,5,11,10,11,41,39,2,43
FC Thun,9561,6,11,5,16,47,58,-11,38
FC Lugano,9561,7,10,7,15,34,46,-12,37
Grasshoppers,9561,8,9,8,15,43,50,-7,35
FC Sion,9561,9,6,8,18,41,58,-17,26
Young Boys,9562,1,22,8,2,73,33,40,74
FC Basel,9562,2,18,8,6,51,24,27,62
St Gallen,9562,3,15,3,14,44,53,-9,48
Lucerne,9562,4,12,8,12,40,46,-6,44
FC Zürich,9562,5,10,11,11,40,38,2,41
FC Thun,9562,6,11,5,16,47,57,-10,38
FC Lugano,9562,7,9,6,17,32,51,-19,33
Grasshoppers,9562,8,8,7,17,41,52,-11,31
FC Sion,9562,9,6,10,16,41,55,-14,28
Young Boys,9563,1,22,7,3,79,37,42,73
FC Basel,9563,2,19,7,6,60,27,33,64
St Gallen,9563,3,15,3,14,45,52,-7,48
Lucerne,9563,4,13,8,11,43,49,-6,47
FC Zürich,9563,5,10,10,12,39,37,2,40
FC Lugano,9563,6,10,6,16,31,47,-16,36
FC Thun,9563,7,10,5,17,46,59,-13,35
Grasshoppers,9563,8,8,6,18,40,54,-14,30
FC Sion,9563,9,7,8,17,38,59,-21,29
Young Boys,9564,1,21,6,5,73,38,35,69
FC Basel,9564,2,19,7,6,55,27,28,64
Lucerne,9564,3,14,7,11,47,48,-1,49
St Gallen,9564,4,15,2,15,47,55,-8,47
FC Zürich,9564,5,11,10,11,44,36,8,43
Grasshoppers,9564,6,12,6,14,44,46,-2,42
FC Lugano,9564,7,10,6,16,31,47,-16,36
FC Thun,9564,8,9,5,18,41,61,-20,32
FC Sion,9564,9,5,7,20,37,61,-24,22
Young Boys,9565,1,20,8,4,70,38,32,68
FC Basel,9565,2,20,7,5,59,23,36,67
Lucerne,9565,3,13,9,10,42,44,-2,48
FC Zürich,9565,4,11,9,12,43,38,5,42
St Gallen,9565,5,13,2,17,39,58,-19,41
FC Lugano,9565,6,11,6,15,34,49,-15,39
Grasshoppers,9565,7,9,7,16,41,50,-9,34
FC Thun,9565,8,9,6,17,43,61,-18,33
FC Sion,9565,9,6,10,16,43,53,-10,28
Young Boys,9566,1,22,6,4,70,33,37,72
FC Basel,9566,2,18,9,5,57,24,33,63
Lucerne,9566,3,12,9,11,42,47,-5,45
St Gallen,9566,4,13,5,14,45,57,-12,44
FC Zürich,9566,5,10,10,12,39,37,2,40
Grasshoppers,9566,6,11,6,15,45,50,-5,39
FC Lugano,9566,7,11,6,15,31,44,-13,39
FC Thun,9566,8,9,6,17,43,62,-19,33
FC Sion,9566,9,5,9,18,37,55,-18,24
Young Boys,9567,1,22,6,4,72,33,39,72
FC Basel,9567,2,18,8,6,54,24,30,62
Lucerne,9567,3,14,8,10,42,43,-1,50
FC Zürich,9567,4,11,9,12,44,38,6,42
St Gallen,9567,5,13,2,17,40,57,-17,41
FC Lugano,9567,6,11,5,16,32,49,-17,38
FC Thun,9567,7,10,5,17,45,60,-15,35
Grasshoppers,9567,8,9,7,16,39,48,-9,34
FC Sion,9567,9,7,8,17,39,55,-16,29
Young Boys,9568,1,20,8,4,73,43,30,68
FC Basel,9568,2,19,7,6,57,25,32,64
FC Zürich,9568,3,12,9,11,43,36,7,45
Lucerne,9568,4,11,10,11,43,47,-4,43
St Gallen,9568,5,13,4,15,39,53,-14,43
FC Lugano,9568,6,10,7,15,35,50,-15,37
FC Thun,9568,7,10,6,16,44,60,-16,36
Grasshoppers,9568,8,8,9,15,42,51,-9,33
FC Sion,9568,9,7,8,17,41,52,-11,29
Young Boys,9569,1,22,8,2,74,35,39,74
FC Basel,9569,2,17,9,6,52,24,28,60
Lucerne,9569,3,13,8,11,45,46,-1,47
St Gallen,9569,4,15,2,15,40,55,-15,47
FC Zürich,9569,5,9,11,12,38,38,0,38
Grasshoppers,9569,6,10,7,15,45,50,-5,37
FC Lugano,9569,7,10,5,17,28,49,-21,35
FC Sion,9569,8,8,7,17,43,50,-7,31
FC Thun,9569,9,8,7,17,43,61,-18,31
Young Boys,9570,1,22,8,2,73,34,39,74
FC Basel,9570,2,18,8,6,60,28,32,62
St Gallen,9570,3,14,4,14,43,59,-16,46
Lucerne,9570,4,12,8,12,40,45,-5,44
FC Zürich,9570,5,11,9,12,38,36,2,42
Grasshoppers,9570,6,10,7,15,42,48,-6,37
FC Lugano,9570,7,10,7,15,35,48,-13,37
FC Thun,9570,8,9,6,17,44,60,-16,33
FC Sion,9570,9,5,9,18,37,54,-17,24
Young Boys,9571,1,22,7,3,70,31,39,73
FC Basel,9571,2,18,9,5,53,24,29,63
Lucerne,9571,3,14,7,11,45,41,4,49
FC Zürich,9571,4,11,10,11,44,38,6,43
St Gallen,9571,5,13,4,15,40,55,-15,43
FC Thun,9571,6,10,7,15,47,59,-12,37
FC Lugano,9571,7,9,6,17,28,53,-25,33
Grasshoppers,9571,8,8,7,17,39,51,-12,31
FC Sion,9571,9,6,9,17,44,58,-14,27
Young Boys,9572,1,22,6,4,71,35,36,72
FC Basel,9572,2,19,7,6,56,26,30,64
Lucerne,9572,3,14,7,11,41,43,-2,49
St Gallen,9572,4,15,2,15,45,56,-11,47
FC Zürich,9572,5,12,9,11,43,38,5,45
FC Thun,9572,6,10,5,17,46,58,-12,35
FC Lugano,9572,7,10,5,17,32,49,-17,35
Grasshoppers,9572,8,9,6,17,40,51,-11,33
FC Sion,9572,9,6,7,19,40,58,-18,25
Young Boys,9573,1,21,8,3,70,35,35,71
FC Basel,9573,2,17,10,5,57,24,33,61
St Gallen,9573,3,14,5,13,42,52,-10,47
FC Zürich,9573,4,11,11,10,43,36,7,44
Lucerne,9573,5,12,7,13,39,45,-6,43
FC Lugano,9573,6,10,8,14,30,44,-14,38
Grasshoppers,9573,7,9,6,17,40,55,-15,33
FC Thun,9573,8,9,6,17,45,62,-17,33
FC Sion,9573,9,6,9,17,43,56,-13,27
Young Boys,9574,1,22,7,3,76,38,38,73
FC Basel,9574,2,19,7,6,60,26,34,64
Lucerne,9574,3,12,8,12,41,47,-6,44
St Gallen,9574,4,14,2,16,43,57,-14,44
FC Lugano,9574,5,12,5,15,36,48,-12,41
FC Zürich,9574,6,10,10,12,41,39,2,40
Grasshoppers,9574,7,10,8,14,41,47,-6,38
FC Thun,9574,8,9,7,16,44,63,-19,34
FC Sion,9574,9,5,8,19,38,55,-17,23
Young Boys,9575,1,24,6,2,74,29,45,78
FC Basel,9575,2,16,10,6,53,28,25,58
St Gallen,9575,3,14,4,14,47,58,-11,46
Lucerne,9575,4,12,8,12,40,47,-7,44
FC Zürich,9575,5,10,12,10,45,36,9,42
FC Thun,9575,6,10,6,16,48,59,-11,36
FC Lugano,9575,7,10,6,16,34,49,-15,36
Grasshoppers,9575,8,9,6,17,40,54,-14,33
FC Sion,9575,9,6,8,18,40,61,-21,26
Young Boys,9576,1,23,6,3,76,35,41,75
FC Basel,9576,2,15,10,7,47,24,23,55
Lucerne,9576,3,12,9,11,44,45,-1,45
St Gallen,9576,4,13,4,15,43,57,-14,43
Grasshoppers,9576,5,11,7,14,42,47,-5,40
FC Zürich,9576,6,9,12,11,38,35,3,39
FC Thun,9576,7,11,5,16,45,55,-10,38
FC Lugano,9576,8,10,6,16,33,52,-19,36
FC Sion,9576,9,6,9,17,42,60,-18,27
Young Boys,9577,1,20,8,4,71,36,35,68
FC Basel,9577,2,17,8,7,54,30,24,59
St Gallen,9577,3,15,2,15,45,55,-10,47
FC Zürich,9577,4,12,9,11,42,35,7,45
Lucerne,9577,5,11,9,12,40,48,-8,42
FC Lugano,9577,6,11,5,16,32,49,-17,38
Grasshoppers,9577,7,10,7,15,44,49,-5,37
FC Thun,9577,8,10,5,17,44,61,-17,35
FC Sion,9577,9,7,9,16,46,55,-9,30
Young Boys,9578,1,21,7,4,70,36,34,70
FC Basel,9578,2,19,8,5,55,23,32,65
St Gallen,9578,3,14,3,15,44,57,-13,45
Lucerne,9578,4,12,8,12,43,45,-2,44
FC Zürich,9578,5,11,10,11,41,36,5,43
FC Lugano,9578,6,11,5,16,35,52,-17,38
Grasshoppers,9578,7,10,7,15,44,52,-8,37
FC Thun,9578,8,10,5,17,43,58,-15,35
FC Sion,9578,9,5,9,18,42,58,-16,24
Young Boys,9579,1,22,8,2,75,35,40,74
FC Basel,9579,2,16,9,7,51,29,22,57
St Gallen,9579,3,15,2,15,43,54,-11,47
Lucerne,9579,4,12,8,12,40,44,-4,44
FC Zürich,9579,5,10,9,13,42,40,2,39
FC Lugano,9579,6,11,6,15,35,47,-12,39
FC Thun,9579,7,10,7,15,41,54,-13,37
Grasshoppers,9579,8,9,7,16,42,52,-10,34
FC Sion,9579,9,7,8,17,40,54,-14,29
Young Boys,9580,1,22,6,4,71,38,33,72
FC Basel,9580,2,19,8,5,61,30,31,65
Lucerne,9580,3,14,8,10,52,45,7,50
St Gallen,9580,4,13,2,17,40,57,-17,41
FC Zürich,9580,5,10,10,12,45,39,6,40
FC Lugano,9580,6,11,6,15,33,47,-14,39
Grasshoppers,9580,7,10,6,16,41,50,-9,36
FC Thun,9580,8,9,6,17,43,59,-16,33
FC Sion,9580,9,6,8,18,37,58,-21,26
Young Boys,9581,1,22,7,3,68,31,37,73
FC Basel,9581,2,17,8,7,52,27,25,59
St Gallen,9581,3,15,2,15,45,54,-9,47
Lucerne,9581,4,12,9,11,44,49,-5,45
FC Zürich,9581,5,10,9,13,40,43,-3,39
FC Lugano,9581,6,11,6,15,34,46,-12,39
FC Thun,9581,7,10,7,15,47,56,-9,37
Grasshoppers,9581,8,9,7,16,39,49,-10,34
FC Sion,9581,9,7,7,18,38,52,-14,28
Young Boys,9582,1,21,7,4,74,41,33,70
FC Basel,9582,2,18,8,6,57,29,28,62
Lucerne,9582,3,15,7,10,48,43,5,52
St Gallen,9582,4,13,4,15,43,56,-13,43
FC Zürich,9582,5,10,10,12,38,37,1,40
Grasshoppers,9582,6,10,7,15,43,50,-7,37
FC Lugano,9582,7,10,6,16,34,50,-16,36
FC Thun,9582,8,9,7,16,44,58,-14,34
FC Sion,9582,9,6,8,18,43,60,-17,26
Young Boys,9583,1,21,6,5,71,38,33,69
FC Basel,9583,2,20,7,5,57,24,33,67
Lucerne,9583,3,12,8,12,44,49,-5,44
St Gallen,9583,4,13,4,15,43,57,-14,43
FC Lugano,9583,5,11,6,15,34,47,-13,39
FC Zürich,9583,6,9,11,12,39,38,1,38
Grasshoppers,9583,7,10,7,15,41,48,-7,37
FC Thun,9583,8,10,5,17,45,60,-15,35
FC Sion,9583,9,6,10,16,38,51,-13,28
Young Boys,9584,1,21,8,3,76,36,40,71
FC Basel,9584,2,15,10,7,50,28,22,55
St Gallen,9584,3,15,3,14,44,53,-9,48
FC Zürich,9584,4,12,10,10,41,33,8,46
Lucerne,9584,5,12,9,11,41,46,-5,45
FC Lugano,9584,6,10,6,16,28,47,-19,36
FC Thun,9584,7,9,6,17,41,58,-17,33
Grasshoppers,9584,8,8,8,16,43,54,-11,32
FC Sion,9584,9,7,10,15,43,52,-9,31
Young Boys,9585,1,21,7,4,74,37,37,70
FC Basel,9585,2,17,8,7,51,27,24,59
Lucerne,9585,3,13,9,10,41,42,-1,48
St Gallen,9585,4,15,3,14,45,53,-8,48
FC Zürich,9585,5,12,9,11,44,36,8,45
FC Sion,9585,6,9,7,16,46,55,-9,34
Grasshoppers,9585,7,9,6,17,41,50,-9,33
FC Lugano,9585,8,9,6,17,30,55,-25,33
FC Thun,9585,9,9,5,18,42,59,-17,32
Young Boys,9586,1,19,8,5,67,36,31,65
FC Basel,9586,2,17,9,6,55,27,28,60
Lucerne,9586,3,14,9,9,44,42,2,51
St Gallen,9586,4,14,2,16,43,60,-17,44
FC Zürich,9586,5,11,9,12,44,39,5,42
FC Lugano,9586,6,11,5,16,33,48,-15,38
Grasshoppers,9586,7,9,9,14,41,48,-7,36
FC Thun,9586,8,10,5,17,44,58,-14,35
FC Sion,9586,9,7,8,17,43,56,-13,29
Young Boys,9587,1,21,6,5,67,36,31,69
FC Basel,9587,2,19,8,5,55,23,32,65
Lucerne,9587,3,12,8,12,41,45,-4,44
St Gallen,9587,4,14,2,16,43,57,-14,44
FC Zürich,9587,5,10,10,12,38,38,0,40
FC Lugano,9587,6,11,6,15,34,45,-11,39
FC Thun,9587,7,10,6,16,43,56,-13,36
Grasshoppers,9587,8,9,7,16,41,50,-9,34
FC Sion,9587,9,8,7,17,41,53,-12,31
Young Boys,9588,1,23,6,3,78,34,44,75
FC Basel,9588,2,18,7,7,57,27,30,61
Lucerne,9588,3,14,8,10,40,41,-1,50
FC Zürich,9588,4,12,9,11,46,39,7,45
St Gallen,9588,5,13,2,17,39,56,-17,41
FC Lugano,9588,6,10,6,16,30,54,-24,36
FC Thun,9588,7,10,5,17,44,60,-16,35
Grasshoppers,9588,8,8,7,17,42,53,-11,31
FC Sion,9588,9,7,8,17,45,57,-12,29
Young Boys,9589,1,19,6,7,67,38,29,63
FC Basel,9589,2,17,9,6,52,26,26,60
Lucerne,9589,3,13,9,10,44,42,2,48
FC Zürich,9589,4,12,10,10,40,33,7,46
St Gallen,9589,5,14,3,15,42,54,-12,45
Grasshoppers,9589,6,11,7,14,41,45,-4,40
FC Lugano,9589,7,11,5,16,32,49,-17,38
FC Thun,9589,8,9,7,16,42,57,-15,34
FC Sion,9589,9,6,8,18,37,53,-16,26
Young Boys,9590,1,20,9,3,71,36,35,69
FC Basel,9590,2,18,9,5,53,25,28,63
St Gallen,9590,3,15,4,13,45,52,-7,49
Lucerne,9590,4,12,9,11,43,44,-1,45
FC Zürich,9590,5,11,10,11,46,39,7,43
Grasshoppers,9590,6,10,8,14,42,47,-5,38
FC Lugano,9590,7,9,5,18,27,51,-24,32
FC Thun,9590,8,8,6,18,43,65,-22,30
FC Sion,9590,9,6,10,16,42,53,-11,28
Young Boys,9591,1,22,7,3,75,35,40,73
FC Basel,9591,2,20,7,5,56,23,33,67
Lucerne,9591,3,13,8,11,43,47,-4,47
St Gallen,9591,4,15,2,15,44,56,-12,47
FC Zürich,9591,5,10,10,12,38,35,3,40
Grasshoppers,9591,6,9,9,14,43,49,-6,36
FC Lugano,9591,7,10,5,17,30,48,-18,35
FC Thun,9591,8,9,6,17,46,62,-16,33
FC Sion,9591,9,5,8,19,38,58,-20,23
Young Boys,9592,1,21,7,4,70,38,32,70
FC Basel,9592,2,18,8,6,58,28,30,62
Lucerne,9592,3,14,9,9,45,42,3,51
St Gallen,9592,4,14,3,15,44,56,-12,45
FC Zürich,9592,5,11,11,10,44,38,6,44
Grasshoppers,9592,6,10,7,15,41,47,-6,37
FC Lugano,9592,7,9,5,18,31,52,-21,32
FC Thun,9592,8,8,6,18,40,58,-18,30
FC Sion,9592,9,6,10,16,39,53,-14,28
Young Boys,9593,1,23,7,2,76,33,43,76
FC Basel,9593,2,17,10,5,52,24,28,61
St Gallen,9593,3,15,4,13,45,52,-7,49
FC Zürich,9593,4,11,11,10,41,34,7,44
Lucerne,9593,5,11,8,13,37,45,-8,41
Grasshoppers,9593,6,9,7,16,40,49,-9,34
FC Lugano,9593,7,9,7,16,29,48,-19,34
FC Thun,9593,8,8,6,18,39,58,-19,30
FC Sion,9593,9,7,8,17,40,56,-16,29
Young Boys,9594,1,24,6,2,72,30,42,78
FC Basel,9594,2,16,9,7,52,27,25,57
St Gallen,9594,3,14,5,13,45,53,-8,47
FC Zürich,9594,4,11,11,10,41,33,8,44
Lucerne,9594,5,11,11,10,41,43,-2,44
Grasshoppers,9594,6,9,8,15,43,52,-9,35
FC Lugano,9594,7,9,7,16,28,47,-19,34
FC Thun,9594,8,8,6,18,43,64,-21,30
FC Sion,9594,9,6,9,17,38,54,-16,27
Young Boys,9595,1,23,7,2,76,32,44,76
FC Basel,9595,2,18,8,6,53,24,29,62
Lucerne,9595,3,13,10,9,41,39,2,49
St Gallen,9595,4,14,3,15,43,55,-12,45
FC Zürich,9595,5,11,9,12,39,36,3,42
FC Sion,9595,6,9,7,16,43,52,-9,34
Grasshoppers,9595,7,9,6,17,40,54,-14,33
FC Lugano,9595,8,9,5,18,27,48,-21,32
FC Thun,9595,9,8,5,19,38,60,-22,29
Young Boys,9596,1,21,7,4,75,39,36,70
FC Basel,9596,2,17,9,6,54,28,26,60
St Gallen,9596,3,15,4,13,44,52,-8,49
Lucerne,9596,4,12,9,11,43,44,-1,45
FC Zürich,9596,5,11,11,10,43,36,7,44
Grasshoppers,9596,6,9,8,15,42,52,-10,35
FC Lugano,9596,7,9,7,16,30,49,-19,34
FC Thun,9596,8,9,6,17,44,60,-16,33
FC Sion,9596,9,6,9,17,39,54,-15,27
Young Boys,9597,1,20,8,4,71,39,32,68
FC Basel,9597,2,18,9,5,59,25,34,63
Lucerne,9597,3,13,9,10,44,44,0,48
FC Zürich,9597,4,11,10,11,40,40,0,43
St Gallen,9597,5,13,3,16,41,60,-19,42
Grasshoppers,9597,6,11,6,15,45,48,-3,39
FC Lugano,9597,7,11,5,16,36,48,-12,38
FC Thun,9597,8,9,6,17,44,57,-13,33
FC Sion,9597,9,6,8,18,35,54,-19,26
Young Boys,9598,1,22,6,4,76,38,38,72
FC Basel,9598,2,19,8,5,55,22,33,65
FC Zürich,9598,3,12,9,11,43,36,7,45
Lucerne,9598,4,12,8,12,43,47,-4,44
St Gallen,9598,5,13,5,14,41,53,-12,44
FC Lugano,9598,6,10,6,16,28,48,-20,36
FC Thun,9598,7,10,5,17,41,57,-16,35
Grasshoppers,9598,8,9,6,17,43,53,-10,33
FC Sion,9598,9,7,7,18,40,56,-16,28
FC Basel,9599,1,20,7,5,59,22,37,67
Young Boys,9599,2,20,7,5,68,37,31,67
Lucerne,9599,3,14,7,11,44,43,1,49
St Gallen,9599,4,15,2,15,44,56,-12,47
FC Zürich,9599,5,12,9,11,43,36,7,45
FC Lugano,9599,6,10,6,16,30,47,-17,36
Grasshoppers,9599,7,9,6,17,40,50,-10,33
FC Thun,9599,8,9,6,17,43,62,-19,33
FC Sion,9599,9,6,8,18,41,59,-18,26
Young Boys,9600,1,20,7,5,69,35,34,67
FC Basel,9600,2,20,7,5,55,22,33,67
St Gallen,9600,3,14,3,15,42,56,-14,45
Lucerne,9600,4,11,7,14,39,50,-11,40
Grasshoppers,9600,5,11,6,15,44,48,-4,39
FC Zürich,9600,6,9,11,12,38,38,0,38
FC Lugano,9600,7,10,8,14,32,46,-14,38
FC Thun,9600,8,10,6,16,45,58,-13,36
FC Sion,9600,9,7,9,16,40,51,-11,30
Young Boys,9601,1,22,7,3,73,35,38,73
FC Basel,9601,2,19,7,6,57,30,27,64
St Gallen,9601,3,15,2,15,45,55,-10,47
Lucerne,9601,4,13,7,12,46,45,1,46
FC Zürich,9601,5,12,9,11,44,34,10,45
Grasshoppers,9601,6,9,8,15,41,49,-8,35
FC Lugano,9601,7,10,5,17,30,52,-22,35
FC Thun,9601,8,9,5,18,43,62,-19,32
FC Sion,9601,9,6,8,18,39,56,-17,26
Young Boys,9602,1,21,8,3,75,39,36,71
FC Basel,9602,2,17,9,6,61,30,31,60
St Gallen,9602,3,15,3,14,45,57,-12,48
Lucerne,9602,4,13,8,11,43,45,-2,47
FC Lugano,9602,5,11,7,14,37,45,-8,40
FC Zürich,9602,6,9,11,12,40,38,2,38
Grasshoppers,9602,7,9,7,16,41,50,-9,34
FC Thun,9602,8,9,6,17,41,61,-20,33
FC Sion,9602,9,6,9,17,43,61,-18,27
Young Boys,9603,1,22,7,3,75,38,37,73
FC Basel,9603,2,18,8,6,59,24,35,62
St Gallen,9603,3,15,2,15,43,54,-11,47
Lucerne,9603,4,12,8,12,39,44,-5,44
FC Zürich,9603,5,11,10,11,40,35,5,43
Grasshoppers,9603,6,10,7,15,45,49,-4,37
FC Lugano,9603,7,10,5,17,28,48,-20,35
FC Thun,9603,8,9,6,17,40,64,-24,33
FC Sion,9603,9,6,9,17,40,53,-13,27
Young Boys,9604,1,21,8,3,72,34,38,71
FC Basel,9604,2,16,11,5,51,24,27,59
Lucerne,9604,3,12,9,11,41,42,-1,45
St Gallen,9604,4,14,3,15,40,54,-14,45
FC Zürich,9604,5,11,11,10,41,34,7,44
Grasshoppers,9604,6,9,8,15,41,52,-11,35
FC Lugano,9604,7,10,5,17,31,50,-19,35
FC Thun,9604,8,8,8,16,43,60,-17,32
FC Sion,9604,9,7,9,16,45,55,-10,30
Young Boys,9605,1,22,8,2,71,30,41,74
FC Basel,9605,2,17,9,6,52,23,29,60
Lucerne,9605,3,14,7,11,42,44,-2,49
St Gallen,9605,4,14,3,15,43,58,-15,45
FC Thun,9605,5,11,6,15,46,57,-11,39
FC Zürich,9605,6,9,11,12,41,41,0,38
Grasshoppers,9605,7,9,7,16,42,49,-7,34
FC Lugano,9605,8,9,6,17,29,50,-21,33
FC Sion,9605,9,6,9,17,43,57,-14,27
Young Boys,9606,1,21,7,4,75,38,37,70
FC Basel,9606,2,18,7,7,57,26,31,61
St Gallen,9606,3,15,4,13,45,54,-9,49
Lucerne,9606,4,13,8,11,41,44,-3,47
FC Zürich,9606,5,9,10,13,38,38,0,37
FC Lugano,9606,6,10,7,15,33,51,-18,37
FC Thun,9606,7,10,6,16,48,62,-14,36
FC Sion,9606,8,8,8,16,41,53,-12,32
Grasshoppers,9606,9,8,7,17,41,53,-12,31
Young Boys,9607,1,22,7,3,73,36,37,73
FC Basel,9607,2,16,8,8,53,29,24,56
St Gallen,9607,3,15,3,14,42,52,-10,48
FC Zürich,9607,4,12,9,11,42,34,8,45
Lucerne,9607,5,12,8,12,41,46,-5,44
FC Thun,9607,6,11,5,16,47,58,-11,38
FC Lugano,9607,7,11,5,16,31,45,-14,38
Grasshoppers,9607,8,9,7,16,42,52,-10,34
FC Sion,9607,9,6,8,18,39,58,-19,26
Young Boys,9608,1,22,7,3,75,35,40,73
FC Basel,9608,2,18,9,5,58,27,31,63
St Gallen,9608,3,14,4,14,42,54,-12,46
Lucerne,9608,4,12,7,13,40,49,-9,43
Grasshoppers,9608,5,11,6,15,43,50,-7,39
FC Zürich,9608,6,9,10,13,38,38,0,37
FC Lugano,9608,7,10,6,16,29,46,-17,36
FC Sion,9608,8,9,7,16,45,52,-7,34
FC Thun,9608,9,8,6,18,43,62,-19,30
Young Boys,9609,1,22,8,2,72,32,40,74
FC Basel,9609,2,17,8,7,52,27,25,59
Lucerne,9609,3,12,9,11,40,45,-5,45
FC Zürich,9609,4,11,11,10,44,36,8,44
St Gallen,9609,5,13,4,15,42,58,-16,43
FC Lugano,9609,6,10,6,16,31,48,-17,36
Grasshoppers,9609,7,9,7,16,40,51,-11,34
FC Thun,9609,8,9,7,16,45,58,-13,34
FC Sion,9609,9,6,10,16,44,55,-11,28
Young Boys,9610,1,20,10,2,73,37,36,70
FC Basel,9610,2,17,9,6,57,30,27,60
Lucerne,9610,3,13,8,11,42,42,0,47
St Gallen,9610,4,14,3,15,42,56,-14,45
FC Zürich,9610,5,10,10,12,39,35,4,40
Grasshoppers,9610,6,10,8,14,40,46,-6,38
FC Lugano,9610,7,9,7,16,30,49,-19,34
FC Thun,9610,8,9,6,17,43,61,-18,33
FC Sion,9610,9,7,9,16,44,54,-10,30
Young Boys,9611,1,21,6,5,69,37,32,69
FC Basel,9611,2,19,7,6,54,23,31,64
Lucerne,9611,3,14,7,11,44,42,2,49
FC Zürich,9611,4,12,10,10,43,34,9,46
St Gallen,9611,5,13,4,15,41,55,-14,43
Grasshoppers,9611,6,10,6,16,42,50,-8,36
FC Thun,9611,7,10,6,16,40,55,-15,36
FC Lugano,9611,8,10,6,16,31,49,-18,36
FC Sion,9611,9,5,8,19,40,59,-19,23
Young Boys,9612,1,23,7,2,76,35,41,76
FC Basel,9612,2,16,9,7,52,28,24,57
Lucerne,9612,3,13,8,11,45,47,-2,47
St Gallen,9612,4,13,4,15,41,57,-16,43
FC Zürich,9612,5,9,13,10,41,37,4,40
Grasshoppers,9612,6,10,7,15,42,47,-5,37
FC Lugano,9612,7,10,6,16,31,48,-17,36
FC Thun,9612,8,9,6,17,40,59,-19,33
FC Sion,9612,9,7,8,17,43,53,-10,29
Young Boys,9613,1,22,6,4,74,35,39,72
FC Basel,9613,2,18,8,6,56,25,31,62
St Gallen,9613,3,16,3,13,44,52,-8,51
Lucerne,9613,4,12,7,13,38,43,-5,43
FC Zürich,9613,5,11,9,12,41,39,2,42
Grasshoppers,9613,6,10,6,16,40,50,-10,36
FC Thun,9613,7,10,5,17,46,59,-13,35
FC Lugano,9613,8,10,5,17,32,51,-19,35
FC Sion,9613,9,7,7,18,40,57,-17,28
Young Boys,9614,1,22,6,4,75,36,39,72
FC Basel,9614,2,19,8,5,59,28,31,65
St Gallen,9614,3,14,4,14,46,56,-10,46
Lucerne,9614,4,12,9,11,44,44,0,45
FC Zürich,9614,5,10,9,13,44,46,-2,39
Grasshoppers,9614,6,11,6,15,45,52,-7,39
FC Lugano,9614,7,11,6,15,35,49,-14,39
FC Thun,9614,8,9,5,18,45,64,-19,32
FC Sion,9614,9,6,7,19,43,61,-18,25
Young Boys,9615,1,21,8,3,71,35,36,71
FC Basel,9615,2,16,10,6,53,28,25,58
Lucerne,9615,3,13,9,10,45,44,1,48
St Gallen,9615,4,13,4,15,43,57,-14,43
FC Zürich,9615,5,11,9,12,40,36,4,42
FC Lugano,9615,6,11,5,16,32,47,-15,38
FC Thun,9615,7,10,5,17,46,60,-14,35
FC Sion,9615,8,8,8,16,41,52,-11,32
Grasshoppers,9615,9,8,8,16,40,52,-12,32
Young Boys,9616,1,20,7,5,68,39,29,67
FC Basel,9616,2,19,8,5,60,25,35,65
St Gallen,9616,3,14,3,15,41,53,-12,45
Lucerne,9616,4,12,8,12,41,46,-5,44
FC Zürich,9616,5,10,11,11,42,37,5,41
FC Lugano,9616,6,11,7,14,33,46,-13,40
Grasshoppers,9616,7,10,6,16,42,50,-8,36
FC Thun,9616,8,10,5,17,44,60,-16,35
FC Sion,9616,9,6,9,17,39,54,-15,27
Young Boys,9617,1,23,7,2,76,33,43,76
FC Basel,9617,2,15,8,9,50,29,21,53
St Gallen,9617,3,15,3,14,43,52,-9,48
FC Zürich,9617,4,12,9,11,41,34,7,45
Lucerne,9617,5,12,8,12,40,45,-5,44
FC Thun,9617,6,11,5,16,46,58,-12,38
FC Lugano,9617,7,11,5,16,30,49,-19,38
Grasshoppers,9617,8,10,7,15,40,47,-7,37
FC Sion,9617,9,5,8,19,36,55,-19,23
Young Boys,9618,1,22,6,4,71,34,37,72
FC Basel,9618,2,19,8,5,56,24,32,65
St Gallen,9618,3,14,3,15,41,55,-14,45
Lucerne,9618,4,12,7,13,39,46,-7,43
FC Zürich,9618,5,11,9,12,41,39,2,42
Grasshoppers,9618,6,10,7,15,43,49,-6,37
FC Thun,9618,7,10,7,15,52,59,-7,37
FC Lugano,9618,8,9,6,17,29,49,-20,33
FC Sion,9618,9,7,7,18,42,59,-17,28
Young Boys,9619,1,20,9,3,75,41,34,69
FC Basel,9619,2,17,10,5,57,29,28,61
St Gallen,9619,3,14,4,14,43,54,-11,46
Lucerne,9619,4,12,9,11,43,43,0,45
FC Zürich,9619,5,9,11,12,43,43,0,38
FC Lugano,9619,6,9,9,14,32,47,-15,36
FC Thun,9619,7,10,5,17,46,60,-14,35
FC Sion,9619,8,8,9,15,46,54,-8,33
Grasshoppers,9619,9,8,8,16,43,57,-14,32
Young Boys,9620,1,23,7,2,72,32,40,76
FC Basel,9620,2,16,10,6,52,27,25,58
St Gallen,9620,3,15,2,15,45,55,-10,47
FC Zürich,9620,4,11,10,11,42,37,5,43
Lucerne,9620,5,11,10,11,39,44,-5,43
FC Lugano,9620,6,11,6,15,32,44,-12,39
FC Thun,9620,7,10,6,16,42,55,-13,36
Grasshoppers,9620,8,9,7,16,39,51,-12,34
FC Sion,9620,9,5,8,19,38,56,-18,23
Young Boys,9621,1,23,6,3,74,36,38,75
FC Basel,9621,2,18,7,7,53,26,27,61
Lucerne,9621,3,13,8,11,40,43,-3,47
FC Zürich,9621,4,12,9,11,43,35,8,45
St Gallen,9621,5,13,5,14,42,54,-12,44
FC Lugano,9621,6,11,6,15,33,45,-12,39
FC Thun,9621,7,10,5,17,47,62,-15,35
Grasshoppers,9621,8,8,7,17,41,53,-12,31
FC Sion,9621,9,5,9,18,39,58,-19,24
Young Boys,9622,1,23,6,3,76,33,43,75
FC Basel,9622,2,16,9,7,49,25,24,57
St Gallen,9622,3,15,3,14,44,53,-9,48
Lucerne,9622,4,13,8,11,43,44,-1,47
FC Zürich,9622,5,10,11,11,40,36,4,41
Grasshoppers,9622,6,10,6,16,44,57,-13,36
FC Thun,9622,7,9,6,17,44,59,-15,33
FC Lugano,9622,8,9,6,17,31,50,-19,33
FC Sion,9622,9,8,7,17,42,56,-14,31
Young Boys,9623,1,20,9,3,69,33,36,69
FC Basel,9623,2,16,9,7,52,27,25,57
Lucerne,9623,3,13,9,10,43,43,0,48
St Gallen,9623,4,15,2,15,46,58,-12,47
FC Zürich,9623,5,12,10,10,44,37,7,46
Grasshoppers,9623,6,11,7,14,42,45,-3,40
FC Thun,9623,7,8,8,16,40,57,-17,32
FC Lugano,9623,8,9,5,18,29,53,-24,32
FC Sion,9623,9,6,9,17,39,51,-12,27
Young Boys,9624,1,20,9,3,71,35,36,69
FC Basel,9624,2,16,9,7,51,26,25,57
Lucerne,9624,3,15,7,10,46,45,1,52
FC Zürich,9624,4,11,10,11,42,37,5,43
St Gallen,9624,5,13,3,16,42,58,-16,42
Grasshoppers,9624,6,10,6,16,44,53,-9,36
FC Thun,9624,7,10,6,16,47,58,-11,36
FC Lugano,9624,8,9,8,15,29,46,-17,35
FC Sion,9624,9,7,8,17,39,53,-14,29
Young Boys,9625,1,22,7,3,71,33,38,73
FC Basel,9625,2,17,8,7,52,28,24,59
St Gallen,9625,3,16,3,13,43,51,-8,51
Lucerne,9625,4,13,8,11,43,43,0,47
FC Zürich,9625,5,10,11,11,43,34,9,41
Grasshoppers,9625,6,10,6,16,42,50,-8,36
FC Lugano,9625,7,9,7,16,30,48,-18,34
FC Thun,9625,8,8,7,17,43,63,-20,31
FC Sion,9625,9,7,7,18,41,58,-17,28
Young Boys,9626,1,22,8,2,73,33,40,74
FC Basel,9626,2,18,7,7,56,26,30,61
Lucerne,9626,3,12,10,10,40,41,-1,46
St Gallen,9626,4,14,3,15,43,56,-13,45
FC Zürich,9626,5,11,10,11,40,35,5,43
FC Lugano,9626,6,10,8,14,31,45,-14,38
Grasshoppers,9626,7,9,8,15,39,47,-8,35
FC Thun,9626,8,9,5,18,41,60,-19,32
FC Sion,9626,9,5,9,18,40,60,-20,24
Young Boys,9627,1,22,6,4,74,42,32,72
FC Basel,9627,2,18,8,6,56,25,31,62
St Gallen,9627,3,16,2,14,48,54,-6,50
FC Zürich,9627,4,12,10,10,40,33,7,46
Lucerne,9627,5,13,7,12,40,48,-8,46
Grasshoppers,9627,6,9,6,17,43,51,-8,33
FC Lugano,9627,7,9,6,17,30,50,-20,33
FC Sion,9627,8,8,7,17,44,51,-7,31
FC Thun,9627,9,8,6,18,41,62,-21,30
Young Boys,9628,1,20,9,3,69,35,34,69
FC Basel,9628,2,16,10,6,52,27,25,58
St Gallen,9628,3,15,3,14,45,55,-10,48
Lucerne,9628,4,12,10,10,41,43,-2,46
FC Zürich,9628,5,10,11,11,39,35,4,41
FC Lugano,9628,6,10,7,15,31,45,-14,37
FC Thun,9628,7,10,6,16,46,58,-12,36
Grasshoppers,9628,8,8,8,16,38,50,-12,32
FC Sion,9628,9,6,10,16,41,54,-13,28
Young Boys,9629,1,23,6,3,73,33,40,75
FC Basel,9629,2,15,10,7,49,27,22,55
Lucerne,9629,3,13,9,10,41,41,0,48
St Gallen,9629,4,15,3,14,41,53,-12,48
FC Zürich,9629,5,10,11,11,40,37,3,41
FC Thun,9629,6,10,7,15,46,55,-9,37
FC Lugano,9629,7,10,6,16,29,45,-16,36
Grasshoppers,9629,8,8,8,16,42,53,-11,32
FC Sion,9629,9,6,8,18,44,61,-17,26
Young Boys,9630,1,21,8,3,73,37,36,71
FC Basel,9630,2,15,10,7,52,30,22,55
Lucerne,9630,3,14,8,10,42,41,1,50
FC Zürich,9630,4,13,9,10,44,33,11,48
St Gallen,9630,5,14,3,15,44,57,-13,45
FC Lugano,9630,6,10,6,16,34,48,-14,36
FC Thun,9630,7,10,6,16,47,63,-16,36
Grasshoppers,9630,8,9,6,17,41,52,-11,33
FC Sion,9630,9,6,8,18,42,58,-16,26
Young Boys,9631,1,21,7,4,72,38,34,70
FC Basel,9631,2,19,7,6,56,25,31,64
Lucerne,9631,3,15,7,10,53,44,9,52
FC Zürich,9631,4,12,9,11,45,35,10,45
St Gallen,9631,5,13,3,16,41,60,-19,42
FC Lugano,9631,6,11,5,16,34,50,-16,38
Grasshoppers,9631,7,9,6,17,41,53,-12,33
FC Thun,9631,8,9,6,17,45,64,-19,33
FC Sion,9631,9,5,10,17,40,58,-18,25
Young Boys,9632,1,23,7,2,72,32,40,76
FC Basel,9632,2,18,7,7,51,25,26,61
Lucerne,9632,3,13,7,12,44,45,-1,46
FC Zürich,9632,4,12,9,11,42,35,7,45
St Gallen,9632,5,14,2,16,42,55,-13,44
FC Lugano,9632,6,10,6,16,30,47,-17,36
Grasshoppers,9632,7,9,7,16,41,51,-10,34
FC Thun,9632,8,9,6,17,45,62,-17,33
FC Sion,9632,9,7,7,18,42,57,-15,28
Young Boys,9633,1,21,9,2,73,36,37,72
FC Basel,9633,2,16,9,7,50,24,26,57
Lucerne,9633,3,12,10,10,44,45,-1,46
St Gallen,9633,4,14,3,15,43,58,-15,45
FC Zürich,9633,5,10,11,11,39,34,5,41
Grasshoppers,9633,6,11,7,14,44,47,-3,40
FC Lugano,9633,7,11,5,16,34,50,-16,38
FC Thun,9633,8,9,6,17,40,57,-17,33
FC Sion,9633,9,5,10,17,37,53,-16,25
Young Boys,9634,1,20,7,5,67,35,32,67
FC Basel,9634,2,19,8,5,55,22,33,65
Lucerne,9634,3,13,7,12,43,46,-3,46
St Gallen,9634,4,14,3,15,44,59,-15,45
FC Lugano,9634,5,12,6,14,36,45,-9,42
FC Zürich,9634,6,10,11,11,39,36,3,41
Grasshoppers,9634,7,11,6,15,42,47,-5,39
FC Thun,9634,8,8,6,18,42,63,-21,30
FC Sion,9634,9,6,8,18,39,54,-15,26
Young Boys,9635,1,21,8,3,71,32,39,71
FC Basel,9635,2,16,10,6,56,31,25,58
St Gallen,9635,3,16,2,14,48,53,-5,50
Lucerne,9635,4,13,9,10,44,44,0,48
FC Zürich,9635,5,11,10,11,43,35,8,43
FC Lugano,9635,6,10,5,17,30,51,-21,35
Grasshoppers,9635,7,9,7,16,38,50,-12,34
FC Thun,9635,8,9,5,18,42,63,-21,32
FC Sion,9635,9,7,8,17,38,51,-13,29
Young Boys,9636,1,21,6,5,69,38,31,69
FC Basel,9636,2,19,8,5,58,23,35,65
St Gallen,9636,3,14,3,15,45,55,-10,45
FC Zürich,9636,4,11,10,11,41,35,6,43
Lucerne,9636,5,11,7,14,40,53,-13,40
Grasshoppers,9636,6,10,6,16,43,51,-8,36
FC Thun,9636,7,10,6,16,44,58,-14,36
FC Lugano,9636,8,10,6,16,32,49,-17,36
FC Sion,9636,9,8,8,16,42,52,-10,32
Young Boys,9637,1,20,8,4,68,36,32,68
FC Basel,9637,2,18,7,7,55,26,29,61
St Gallen,9637,3,16,3,13,46,53,-7,51
Lucerne,9637,4,11,8,13,37,46,-9,41
FC Zürich,9637,5,10,10,12,39,40,-1,40
FC Lugano,9637,6,11,6,15,37,49,-12,39
Grasshoppers,9637,7,10,8,14,42,46,-4,38
FC Thun,9637,8,10,5,17,45,60,-15,35
FC Sion,9637,9,6,9,17,41,54,-13,27
Young Boys,9638,1,21,7,4,74,35,39,70
FC Basel,9638,2,17,8,7,53,30,23,59
St Gallen,9638,3,15,3,14,46,55,-9,48
FC Zürich,9638,4,12,9,11,51,37,14,45
Lucerne,9638,5,12,8,12,39,47,-8,44
Grasshoppers,9638,6,10,8,14,43,48,-5,38
FC Lugano,9638,7,10,5,17,30,50,-20,35
FC Thun,9638,8,8,8,16,42,59,-17,32
FC Sion,9638,9,6,10,16,41,58,-17,28
Young Boys,9639,1,23,7,2,73,33,40,76
FC Basel,9639,2,17,9,6,54,25,29,60
FC Zürich,9639,3,11,10,11,40,36,4,43
Lucerne,9639,4,11,10,11,41,45,-4,43
St Gallen,9639,5,13,4,15,39,53,-14,43
FC Lugano,9639,6,10,7,15,29,44,-15,37
FC Thun,9639,7,10,6,16,44,59,-15,36
Grasshoppers,9639,8,8,9,15,40,50,-10,33
FC Sion,9639,9,6,8,18,41,56,-15,26
Young Boys,9640,1,22,7,3,75,35,40,73
FC Basel,9640,2,17,10,5,54,24,30,61
Lucerne,9640,3,13,8,11,41,41,0,47
St Gallen,9640,4,15,2,15,41,54,-13,47
FC Zürich,9640,5,11,10,11,39,35,4,43
Grasshoppers,9640,6,11,6,15,42,48,-6,39
FC Thun,9640,7,11,5,16,44,57,-13,38
FC Lugano,9640,8,9,5,18,29,51,-22,32
FC Sion,9640,9,5,7,20,38,58,-20,22
Young Boys,9641,1,19,8,5,69,44,25,65
FC Basel,9641,2,19,7,6,55,25,30,64
Lucerne,9641,3,14,8,10,47,42,5,50
St Gallen,9641,4,14,4,14,47,55,-8,46
FC Zürich,9641,5,11,9,12,40,36,4,42
FC Thun,9641,6,10,6,16,43,56,-13,36
Grasshoppers,9641,7,9,8,15,43,49,-6,35
FC Lugano,9641,8,9,7,16,31,49,-18,34
FC Sion,9641,9,7,7,18,43,62,-19,28
Young Boys,9642,1,21,8,3,67,34,33,71
FC Basel,9642,2,18,7,7,53,26,27,61
Lucerne,9642,3,13,9,10,41,39,2,48
St Gallen,9642,4,13,2,17,40,58,-18,41
FC Zürich,9642,5,10,9,13,38,38,0,39
FC Lugano,9642,6,11,6,15,33,46,-13,39
Grasshoppers,9642,7,9,9,14,40,45,-5,36
FC Thun,9642,8,10,6,16,42,56,-14,36
FC Sion,9642,9,7,8,17,39,51,-12,29
Young Boys,9643,1,20,9,3,71,35,36,69
FC Basel,9643,2,17,10,5,54,25,29,61
Lucerne,9643,3,13,10,9,43,42,1,49
St Gallen,9643,4,13,3,16,39,54,-15,42
FC Zürich,9643,5,10,11,11,43,38,5,41
Grasshoppers,9643,6,11,7,14,43,47,-4,40
FC Lugano,9643,7,10,5,17,29,50,-21,35
FC Thun,9643,8,9,5,18,43,61,-18,32
FC Sion,9643,9,6,10,16,42,55,-13,28
Young Boys,9644,1,23,7,2,72,32,40,76
FC Basel,9644,2,18,9,5,55,24,31,63
St Gallen,9644,3,15,3,14,42,53,-11,48
Lucerne,9644,4,12,7,13,40,45,-5,43
FC Zürich,9644,5,10,9,13,43,39,4,39
FC Thun,9644,6,11,5,16,44,58,-14,38
Grasshoppers,9644,7,10,6,16,42,51,-9,36
FC Lugano,9644,8,10,5,17,30,48,-18,35
FC Sion,9644,9,6,7,19,42,60,-18,25
Young Boys,9645,1,23,6,3,76,35,41,75
FC Basel,9645,2,19,8,5,55,24,31,65
St Gallen,9645,3,15,3,14,42,52,-10,48
FC Zürich,9645,4,12,9,11,42,35,7,45
Lucerne,9645,5,12,7,13,38,43,-5,43
FC Thun,9645,6,10,5,17,47,60,-13,35
FC Lugano,9645,7,10,5,17,30,48,-18,35
Grasshoppers,9645,8,9,6,17,40,53,-13,33
FC Sion,9645,9,6,7,19,37,57,-20,25
Young Boys,9646,1,22,7,3,72,33,39,73
FC Basel,9646,2,19,7,6,56,26,30,64
Lucerne,9646,3,13,7,12,43,43,0,46
FC Zürich,9646,4,12,9,11,44,37,7,45
St Gallen,9646,5,14,2,16,41,54,-13,44
FC Lugano,9646,6,10,5,17,29,50,-21,35
Grasshoppers,9646,7,9,7,16,40,52,-12,34
FC Thun,9646,8,9,6,17,45,63,-18,33
FC Sion,9646,9,7,8,17,43,55,-12,29
Young Boys,9647,1,22,7,3,70,32,38,73
FC Basel,9647,2,18,9,5,54,24,30,63
Lucerne,9647,3,12,8,12,38,43,-5,44
St Gallen,9647,4,14,2,16,42,55,-13,44
FC Lugano,9647,5,12,5,15,34,45,-11,41
Grasshoppers,9647,6,11,7,14,44,45,-1,40
FC Zürich,9647,7,10,9,13,39,43,-4,39
FC Thun,9647,8,9,6,17,45,61,-16,33
FC Sion,9647,9,6,7,19,38,56,-18,25
Young Boys,9648,1,22,8,2,73,34,39,74
FC Basel,9648,2,17,9,6,53,27,26,60
Lucerne,9648,3,12,8,12,44,46,-2,44
St Gallen,9648,4,13,4,15,48,61,-13,43
FC Zürich,9648,5,11,9,12,41,37,4,42
FC Thun,9648,6,11,6,15,43,53,-10,39
Grasshoppers,9648,7,10,8,14,40,46,-6,38
FC Lugano,9648,8,10,5,17,31,52,-21,35
FC Sion,9648,9,6,7,19,41,58,-17,25
Young Boys,9649,1,21,7,4,74,40,34,70
FC Basel,9649,2,18,7,7,51,25,26,61
Lucerne,9649,3,14,7,11,46,45,1,49
St Gallen,9649,4,15,3,14,44,53,-9,48
FC Zürich,9649,5,11,9,12,42,36,6,42
FC Thun,9649,6,11,5,16,47,56,-9,38
FC Lugano,9649,7,10,6,16,33,50,-17,36
Grasshoppers,9649,8,9,6,17,39,54,-15,33
FC Sion,9649,9,6,8,18,39,56,-17,26
Young Boys,9650,1,22,7,3,72,32,40,73
FC Basel,9650,2,16,8,8,49,25,24,56
St Gallen,9650,3,16,2,14,44,52,-8,50
Lucerne,9650,4,13,7,12,43,50,-7,46
FC Zürich,9650,5,12,9,11,42,36,6,45
FC Lugano,9650,6,11,5,16,32,47,-15,38
Grasshoppers,9650,7,9,7,16,40,49,-9,34
FC Thun,9650,8,8,7,17,41,59,-18,31
FC Sion,9650,9,7,8,17,39,52,-13,29
Young Boys,9651,1,22,6,4,77,37,40,72
FC Basel,9651,2,18,7,7,54,28,26,61
Lucerne,9651,3,14,8,10,41,40,1,50
St Gallen,9651,4,14,2,16,39,53,-14,44
FC Zürich,9651,5,10,10,12,45,41,4,40
Grasshoppers,9651,6,9,8,15,43,51,-8,35
FC Lugano,9651,7,10,5,17,30,50,-20,35
FC Thun,9651,8,9,7,16,45,63,-18,34
FC Sion,9651,9,8,7,17,43,54,-11,31
Young Boys,9652,1,20,7,5,69,40,29,67
FC Basel,9652,2,18,9,5,55,23,32,63
Lucerne,9652,3,12,9,11,41,43,-2,45
FC Lugano,9652,4,12,6,14,33,44,-11,42
St Gallen,9652,5,13,3,16,38,54,-16,42
FC Zürich,9652,6,10,10,12,41,36,5,40
Grasshoppers,9652,7,10,7,15,45,50,-5,37
FC Thun,9652,8,9,7,16,43,59,-16,34
FC Sion,9652,9,7,8,17,38,54,-16,29
Young Boys,9653,1,22,7,3,75,35,40,73
FC Basel,9653,2,18,8,6,53,24,29,62
St Gallen,9653,3,15,3,14,43,55,-12,48
FC Zürich,9653,4,12,9,11,45,37,8,45
Lucerne,9653,5,12,9,11,39,45,-6,45
FC Thun,9653,6,10,6,16,48,61,-13,36
Grasshoppers,9653,7,9,8,15,41,51,-10,35
FC Lugano,9653,8,10,5,17,33,48,-15,35
FC Sion,9653,9,5,7,20,39,60,-21,22
Young Boys,9654,1,22,7,3,73,33,40,73
FC Basel,9654,2,16,10,6,53,25,28,58
Lucerne,9654,3,14,7,11,41,43,-2,49
St Gallen,9654,4,14,4,14,42,53,-11,46
FC Zürich,9654,5,10,10,12,39,38,1,40
FC Thun,9654,6,11,6,15,45,54,-9,39
FC Lugano,9654,7,10,6,16,29,49,-20,36
Grasshoppers,9654,8,8,7,17,39,53,-14,31
FC Sion,9654,9,7,7,18,42,55,-13,28
Young Boys,9655,1,21,7,4,73,37,36,70
FC Basel,9655,2,19,7,6,57,25,32,64
Lucerne,9655,3,12,9,11,40,45,-5,45
FC Zürich,9655,4,11,10,11,40,35,5,43
St Gallen,9655,5,13,3,16,42,56,-14,42
Grasshoppers,9655,6,10,6,16,43,53,-10,36
FC Thun,9655,7,10,6,16,43,58,-15,36
FC Lugano,9655,8,10,6,16,30,48,-18,36
FC Sion,9655,9,7,8,17,42,53,-11,29
Young Boys,9656,1,21,7,4,69,35,34,70
FC Basel,9656,2,17,9,6,54,24,30,60
Lucerne,9656,3,12,8,12,38,42,-4,44
St Gallen,9656,4,13,3,16,42,58,-16,42
FC Lugano,9656,5,12,5,15,34,46,-12,41
FC Zürich,9656,6,10,9,13,42,41,1,39
Grasshoppers,9656,7,10,7,15,41,47,-6,37
FC Thun,9656,8,10,6,16,46,60,-14,36
FC Sion,9656,9,8,8,16,42,55,-13,32
Young Boys,9657,1,23,6,3,81,36,45,75
FC Basel,9657,2,16,11,5,56,27,29,59
St Gallen,9657,3,14,4,14,44,55,-11,46
Lucerne,9657,4,11,9,12,39,47,-8,42
FC Zürich,9657,5,10,10,12,43,39,4,40
FC Lugano,9657,6,11,6,15,32,47,-15,39
FC Thun,9657,7,10,7,15,46,58,-12,37
Grasshoppers,9657,8,8,9,15,40,51,-11,33
FC Sion,9657,9,6,8,18,38,59,-21,26
Young Boys,9658,1,21,8,3,75,37,38,71
FC Basel,9658,2,18,8,6,50,23,27,62
Lucerne,9658,3,14,7,11,45,47,-2,49
St Gallen,9658,4,14,2,16,42,56,-14,44
FC Zürich,9658,5,11,10,11,43,38,5,43
FC Thun,9658,6,10,6,16,44,57,-13,36
FC Lugano,9658,7,10,6,16,31,48,-17,36
Grasshoppers,9658,8,8,7,17,39,50,-11,31
FC Sion,9658,9,6,10,16,42,55,-13,28
Young Boys,9659,1,21,7,4,69,34,35,70
FC Basel,9659,2,20,7,5,57,24,33,67
Lucerne,9659,3,14,8,10,48,44,4,50
St Gallen,9659,4,13,2,17,41,59,-18,41
FC Zürich,9659,5,9,11,12,37,35,2,38
Grasshoppers,9659,6,9,9,14,43,47,-4,36
FC Lugano,9659,7,10,6,16,29,46,-17,36
FC Thun,9659,8,9,7,16,42,59,-17,34
FC Sion,9659,9,6,9,17,37,55,-18,27
Young Boys,9660,1,22,8,2,76,34,42,74
FC Basel,9660,2,18,8,6,60,27,33,62
Lucerne,9660,3,12,8,12,42,50,-8,44
St Gallen,9660,4,14,2,16,42,57,-15,44
FC Zürich,9660,5,10,10,12,41,43,-2,40
FC Lugano,9660,6,11,5,16,33,49,-16,38
Grasshoppers,9660,7,9,7,16,41,51,-10,34
FC Thun,9660,8,9,6,17,44,63,-19,33
FC Sion,9660,9,8,8,16,46,51,-5,32
Young Boys,9661,1,22,8,2,74,35,39,74
FC Basel,9661,2,16,7,9,54,35,19,55
St Gallen,9661,3,15,4,13,48,53,-5,49
Lucerne,9661,4,13,9,10,44,42,2,48
FC Zürich,9661,5,11,10,11,38,33,5,43
Grasshoppers,9661,6,10,6,16,44,54,-10,36
FC Lugano,9661,7,10,6,16,29,48,-19,36
FC Thun,9661,8,9,6,17,45,60,-15,33
FC Sion,9661,9,6,8,18,43,59,-16,26
Young Boys,9662,1,21,8,3,73,38,35,71
FC Basel,9662,2,19,8,5,51,22,29,65
St Gallen,9662,3,14,3,15,44,59,-15,45
Lucerne,9662,4,12,8,12,45,47,-2,44
FC Zürich,9662,5,10,11,11,39,35,4,41
FC Lugano,9662,6,10,7,15,34,50,-16,37
Grasshoppers,9662,7,9,8,15,42,49,-7,35
FC Thun,9662,8,9,6,17,44,60,-16,33
FC Sion,9662,9,7,7,18,42,54,-12,28
Young Boys,9663,1,22,7,3,73,32,41,73
FC Basel,9663,2,17,8,7,54,28,26,59
Lucerne,9663,3,13,8,11,44,47,-3,47
St Gallen,9663,4,14,3,15,43,57,-14,45
FC Lugano,9663,5,12,5,15,32,46,-14,41
FC Zürich,9663,6,9,12,11,43,40,3,39
Grasshoppers,9663,7,9,8,15,44,51,-7,35
FC Thun,9663,8,9,7,16,46,60,-14,34
FC Sion,9663,9,6,8,18,38,56,-18,26
Young Boys,9664,1,22,7,3,71,35,36,73
FC Basel,9664,2,17,8,7,52,29,23,59
St Gallen,9664,3,15,3,14,45,53,-8,48
Lucerne,9664,4,11,11,10,41,43,-2,44
FC Zürich,9664,5,10,11,11,43,39,4,41
Grasshoppers,9664,6,11,6,15,43,48,-5,39
FC Lugano,9664,7,10,7,15,35,51,-16,37
FC Thun,9664,8,8,6,18,43,64,-21,30
FC Sion,9664,9,7,7,18,43,54,-11,28
Young Boys,9665,1,23,6,3,76,36,40,75
FC Basel,9665,2,17,8,7,58,29,29,59
Lucerne,9665,3,12,9,11,44,48,-4,45
St Gallen,9665,4,14,2,16,42,57,-15,44
FC Zürich,9665,5,10,10,12,40,40,0,40
FC Thun,9665,6,11,6,15,44,55,-11,39
FC Lugano,9665,7,10,6,16,31,50,-19,36
FC Sion,9665,8,8,8,16,43,51,-8,32
Grasshoppers,9665,9,8,7,17,38,50,-12,31
Young Boys,9666,1,22,7,3,80,43,37,73
FC Basel,9666,2,19,8,5,64,27,37,65
St Gallen,9666,3,15,4,13,45,53,-8,49
Lucerne,9666,4,12,8,12,43,46,-3,44
FC Zürich,9666,5,9,10,13,37,37,0,37
Grasshoppers,9666,6,10,7,15,45,51,-6,37
FC Lugano,9666,7,10,5,17,30,53,-23,35
FC Thun,9666,8,9,5,18,41,60,-19,32
FC Sion,9666,9,6,10,16,40,55,-15,28
Young Boys,9667,1,22,6,4,77,42,35,72
FC Basel,9667,2,20,7,5,65,27,38,67
Lucerne,9667,3,13,8,11,43,43,0,47
St Gallen,9667,4,14,3,15,42,53,-11,45
FC Zürich,9667,5,11,10,11,43,38,5,43
FC Lugano,9667,6,11,6,15,32,48,-16,39
FC Thun,9667,7,9,5,18,44,63,-19,32
Grasshoppers,9667,8,8,6,18,38,54,-16,30
FC Sion,9667,9,7,7,18,40,56,-16,28
Young Boys,9668,1,22,6,4,73,38,35,72
FC Basel,9668,2,18,8,6,57,29,28,62
St Gallen,9668,3,15,2,15,41,52,-11,47
Lucerne,9668,4,13,7,12,43,47,-4,46
FC Zürich,9668,5,10,11,11,43,39,4,41
FC Lugano,9668,6,11,5,16,34,48,-14,38
FC Thun,9668,7,9,7,16,45,59,-14,34
Grasshoppers,9668,8,9,6,17,40,54,-14,33
FC Sion,9668,9,7,8,17,44,54,-10,29
Young Boys,9669,1,20,6,6,65,35,30,66
FC Basel,9669,2,19,8,5,55,25,30,65
St Gallen,9669,3,15,3,14,46,55,-9,48
Grasshoppers,9669,4,12,6,14,45,47,-2,42
FC Lugano,9669,5,12,6,14,31,42,-11,42
Lucerne,9669,6,11,8,13,38,46,-8,41
FC Zürich,9669,7,9,9,14,37,40,-3,36
FC Thun,9669,8,9,6,17,44,59,-15,33
FC Sion,9669,9,7,8,17,41,53,-12,29
Young Boys,9670,1,23,6,3,72,30,42,75
FC Basel,9670,2,16,8,8,49,28,21,56
St Gallen,9670,3,15,3,14,46,55,-9,48
Lucerne,9670,4,13,7,12,43,43,0,46
FC Zürich,9670,5,10,11,11,39,35,4,41
Grasshoppers,9670,6,10,8,14,42,48,-6,38
FC Thun,9670,7,9,7,16,41,56,-15,34
FC Lugano,9670,8,9,6,17,30,53,-23,33
FC Sion,9670,9,7,8,17,42,56,-14,29
Young Boys,9671,1,22,6,4,76,40,36,72
FC Basel,9671,2,17,9,6,53,26,27,60
Lucerne,9671,3,14,9,9,48,44,4,51
St Gallen,9671,4,14,4,14,44,56,-12,46
FC Zürich,9671,5,10,10,12,39,38,1,40
FC Lugano,9671,6,11,5,16,34,48,-14,38
Grasshoppers,9671,7,9,7,16,38,48,-10,34
FC Thun,9671,8,8,6,18,38,57,-19,30
FC Sion,9671,9,7,8,17,39,52,-13,29
Young Boys,9672,1,24,6,2,74,33,41,78
FC Basel,9672,2,16,9,7,55,31,24,57
Lucerne,9672,3,14,8,10,47,40,7,50
FC Zürich,9672,4,12,10,10,44,35,9,46
St Gallen,9672,5,13,3,16,43,61,-18,42
FC Lugano,9672,6,10,5,17,31,50,-19,35
Grasshoppers,9672,7,9,7,16,38,52,-14,34
FC Thun,9672,8,8,6,18,41,61,-20,30
FC Sion,9672,9,6,10,16,42,52,-10,28
Young Boys,9673,1,21,6,5,66,34,32,69
FC Basel,9673,2,19,8,5,61,24,37,65
St Gallen,9673,3,14,3,15,43,57,-14,45
Lucerne,9673,4,12,7,13,39,49,-10,43
FC Zürich,9673,5,10,10,12,41,38,3,40
Grasshoppers,9673,6,11,7,14,43,45,-2,40
FC Lugano,9673,7,11,5,16,30,47,-17,38
FC Sion,9673,8,8,7,17,46,56,-10,31
FC Thun,9673,9,8,7,17,45,64,-19,31
Young Boys,9674,1,22,8,2,73,35,38,74
FC Basel,9674,2,18,9,5,54,23,31,63
Lucerne,9674,3,14,7,11,46,42,4,49
St Gallen,9674,4,14,2,16,41,55,-14,44
FC Zürich,9674,5,11,10,11,41,36,5,43
FC Thun,9674,6,10,6,16,43,59,-16,36
Grasshoppers,9674,7,9,7,16,42,50,-8,34
FC Lugano,9674,8,9,5,18,31,53,-22,32
FC Sion,9674,9,6,8,18,39,57,-18,26
Young Boys,9675,1,22,8,2,76,35,41,74
FC Basel,9675,2,17,9,6,51,25,26,60
Lucerne,9675,3,14,7,11,44,43,1,49
St Gallen,9675,4,14,4,14,43,54,-11,46
FC Zürich,9675,5,10,11,11,39,35,4,41
FC Lugano,9675,6,10,7,15,32,50,-18,37
Grasshoppers,9675,7,10,6,16,42,49,-7,36
FC Thun,9675,8,9,5,18,43,59,-16,32
FC Sion,9675,9,5,9,18,37,57,-20,24
Young Boys,9676,1,21,6,5,71,40,31,69
FC Basel,9676,2,19,7,6,55,24,31,64
St Gallen,9676,3,16,2,14,48,56,-8,50
Lucerne,9676,4,14,7,11,46,43,3,49
FC Zürich,9676,5,9,10,13,37,36,1,37
Grasshoppers,9676,6,10,7,15,42,50,-8,37
FC Thun,9676,7,10,5,17,41,58,-17,35
FC Lugano,9676,8,9,6,17,32,53,-21,33
FC Sion,9676,9,7,8,17,43,55,-12,29
Young Boys,9677,1,20,8,4,68,37,31,68
FC Basel,9677,2,18,8,6,55,24,31,62
Lucerne,9677,3,13,10,9,42,40,2,49
FC Zürich,9677,4,12,9,11,43,37,6,45
St Gallen,9677,5,14,3,15,40,56,-16,45
FC Thun,9677,6,10,5,17,44,60,-16,35
FC Lugano,9677,7,9,7,16,31,48,-17,34
Grasshoppers,9677,8,9,6,17,41,51,-10,33
FC Sion,9677,9,7,8,17,42,53,-11,29
Young Boys,9678,1,22,7,3,75,37,38,73
FC Basel,9678,2,17,8,7,56,30,26,59
St Gallen,9678,3,16,2,14,44,51,-7,50
Lucerne,9678,4,13,7,12,41,45,-4,46
FC Zürich,9678,5,9,10,13,39,39,0,37
FC Lugano,9678,6,10,6,16,32,48,-16,36
FC Thun,9678,7,9,8,15,43,57,-14,35
Grasshoppers,9678,8,9,6,17,39,52,-13,33
FC Sion,9678,9,8,8,16,45,55,-10,32
Young Boys,9679,1,22,6,4,70,37,33,72
FC Basel,9679,2,17,8,7,56,25,31,59
St Gallen,9679,3,15,3,14,44,54,-10,48
Lucerne,9679,4,12,8,12,41,46,-5,44
FC Zürich,9679,5,10,10,12,44,40,4,40
FC Lugano,9679,6,11,6,15,34,47,-13,39
FC Thun,9679,7,11,5,16,45,58,-13,38
Grasshoppers,9679,8,10,6,16,40,49,-9,36
FC Sion,9679,9,6,8,18,42,60,-18,26
Young Boys,9680,1,23,6,3,76,36,40,75
FC Basel,9680,2,18,9,5,56,25,31,63
St Gallen,9680,3,16,3,13,44,52,-8,51
Lucerne,9680,4,13,8,11,45,45,0,47
FC Zürich,9680,5,12,9,11,44,38,6,45
FC Thun,9680,6,9,6,17,42,60,-18,33
FC Lugano,9680,7,9,5,18,31,52,-21,32
Grasshoppers,9680,8,8,7,17,41,52,-11,31
FC Sion,9680,9,5,9,18,39,58,-19,24
Young Boys,9681,1,21,9,2,72,34,38,72
FC Basel,9681,2,17,10,5,56,26,30,61
Lucerne,9681,3,14,7,11,41,44,-3,49
St Gallen,9681,4,14,2,16,42,56,-14,44
FC Zürich,9681,5,10,10,12,40,37,3,40
FC Thun,9681,6,10,6,16,47,61,-14,36
FC Lugano,9681,7,10,5,17,31,48,-17,35
Grasshoppers,9681,8,9,7,16,40,51,-11,34
FC Sion,9681,9,7,8,17,41,53,-12,29
Young Boys,9682,1,21,8,3,72,36,36,71
FC Basel,9682,2,17,9,6,59,32,27,60
St Gallen,9682,3,16,3,13,52,53,-1,51
Lucerne,9682,4,14,7,11,44,48,-4,49
FC Zürich,9682,5,12,9,11,45,36,9,45
Grasshoppers,9682,6,10,6,16,46,54,-8,36
FC Thun,9682,7,10,5,17,46,60,-14,35
FC Lugano,9682,8,9,5,18,28,50,-22,32
FC Sion,9682,9,5,8,19,40,63,-23,23
Young Boys,9683,1,22,6,4,69,35,34,72
FC Basel,9683,2,19,8,5,57,25,32,65
Lucerne,9683,3,13,8,11,44,46,-2,47
FC Zürich,9683,4,11,9,12,43,37,6,42
St Gallen,9683,5,13,2,17,41,59,-18,41
FC Lugano,9683,6,10,5,17,33,49,-16,35
FC Sion,9683,7,9,7,16,46,54,-8,34
FC Thun,9683,8,9,7,16,43,60,-17,34
Grasshoppers,9683,9,8,8,16,42,53,-11,32
Young Boys,9684,1,21,7,4,71,38,33,70
FC Basel,9684,2,20,7,5,64,22,42,67
Lucerne,9684,3,12,9,11,42,48,-6,45
St Gallen,9684,4,14,2,16,43,57,-14,44
FC Zürich,9684,5,10,10,12,38,37,1,40
FC Lugano,9684,6,10,6,16,30,46,-16,36
Grasshoppers,9684,7,9,8,15,41,49,-8,35
FC Sion,9684,8,8,9,15,42,50,-8,33
FC Thun,9684,9,8,6,18,41,65,-24,30
Young Boys,9685,1,22,7,3,69,32,37,73
FC Basel,9685,2,17,8,7,57,31,26,59
St Gallen,9685,3,16,3,13,46,50,-4,51
FC Zürich,9685,4,11,10,11,45,39,6,43
Lucerne,9685,5,11,10,11,40,45,-5,43
Grasshoppers,9685,6,10,7,15,40,47,-7,37
FC Thun,9685,7,8,9,15,44,59,-15,33
FC Lugano,9685,8,9,6,17,31,54,-23,33
FC Sion,9685,9,6,8,18,37,52,-15,26
Young Boys,9686,1,21,6,5,71,37,34,69
FC Basel,9686,2,17,8,7,49,24,25,59
Lucerne,9686,3,14,8,10,43,41,2,50
St Gallen,9686,4,13,5,14,40,53,-13,44
FC Zürich,9686,5,10,11,11,41,37,4,41
FC Lugano,9686,6,10,6,16,32,49,-17,36
Grasshoppers,9686,7,9,7,16,40,50,-10,34
FC Thun,9686,8,9,7,16,42,57,-15,34
FC Sion,9686,9,7,10,15,40,50,-10,31
Young Boys,9687,1,23,7,2,77,34,43,76
FC Basel,9687,2,17,9,6,55,27,28,60
Lucerne,9687,3,14,7,11,45,44,1,49
St Gallen,9687,4,14,2,16,42,57,-15,44
FC Thun,9687,5,12,5,15,50,60,-10,41
FC Lugano,9687,6,11,5,16,33,50,-17,38
FC Zürich,9687,7,9,10,13,41,40,1,37
Grasshoppers,9687,8,8,7,17,41,56,-15,31
FC Sion,9687,9,6,8,18,39,55,-16,26
Young Boys,9688,1,22,7,3,74,37,37,73
FC Basel,9688,2,19,7,6,57,23,34,64
Lucerne,9688,3,14,7,11,46,42,4,49
St Gallen,9688,4,15,2,15,40,54,-14,47
FC Zürich,9688,5,10,10,12,39,38,1,40
FC Sion,9688,6,9,7,16,44,51,-7,34
Grasshoppers,9688,7,9,6,17,40,56,-16,33
FC Lugano,9688,8,9,6,17,30,49,-19,33
FC Thun,9688,9,8,6,18,41,61,-20,30
Young Boys,9689,1,22,7,3,73,36,37,73
FC Basel,9689,2,19,7,6,59,28,31,64
Lucerne,9689,3,12,9,11,42,46,-4,45
St Gallen,9689,4,14,3,15,44,57,-13,45
FC Zürich,9689,5,10,10,12,43,36,7,40
FC Lugano,9689,6,11,7,14,32,44,-12,40
Grasshoppers,9689,7,9,6,17,40,52,-12,33
FC Thun,9689,8,9,5,18,40,60,-20,32
FC Sion,9689,9,7,8,17,41,55,-14,29
Young Boys,9690,1,21,9,2,73,33,40,72
FC Basel,9690,2,16,11,5,52,25,27,59
Lucerne,9690,3,14,7,11,46,44,2,49
FC Zürich,9690,4,11,10,11,43,35,8,43
St Gallen,9690,5,13,3,16,41,56,-15,42
FC Thun,9690,6,10,6,16,43,57,-14,36
FC Lugano,9690,7,10,5,17,29,53,-24,35
Grasshoppers,9690,8,9,7,16,38,49,-11,34
FC Sion,9690,9,7,8,17,42,55,-13,29
Young Boys,9691,1,21,7,4,72,36,36,70
FC Basel,9691,2,18,7,7,55,30,25,61
St Gallen,9691,3,15,3,14,48,57,-9,48
Lucerne,9691,4,12,8,12,41,44,-3,44
FC Lugano,9691,5,12,5,15,34,47,-13,41
FC Thun,9691,6,11,5,16,48,59,-11,38
FC Zürich,9691,7,9,9,14,38,38,0,36
Grasshoppers,9691,8,9,9,14,42,49,-7,36
FC Sion,9691,9,6,9,17,40,58,-18,27
Young Boys,9692,1,23,6,3,74,31,43,75
FC Basel,9692,2,15,10,7,51,29,22,55
Lucerne,9692,3,14,8,10,44,42,2,50
St Gallen,9692,4,15,2,15,42,54,-12,47
FC Zürich,9692,5,10,10,12,41,41,0,40
FC Lugano,9692,6,10,5,17,31,51,-20,35
Grasshoppers,9692,7,9,7,16,41,51,-10,34
FC Thun,9692,8,9,7,16,45,59,-14,34
FC Sion,9692,9,8,7,17,42,53,-11,31
Young Boys,9693,1,20,9,3,70,36,34,69
FC Basel,9693,2,18,9,5,57,25,32,63
Lucerne,9693,3,13,9,10,45,46,-1,48
St Gallen,9693,4,13,5,14,45,58,-13,44
FC Zürich,9693,5,10,11,11,42,38,4,41
FC Lugano,9693,6,10,7,15,33,48,-15,37
Grasshoppers,9693,7,9,6,17,47,54,-7,33
FC Thun,9693,8,9,6,17,47,64,-17,33
FC Sion,9693,9,7,8,17,40,57,-17,29
Young Boys,9694,1,23,7,2,75,31,44,76
FC Basel,9694,2,15,9,8,49,30,19,54
St Gallen,9694,3,17,2,13,46,51,-5,53
Lucerne,9694,4,12,9,11,39,41,-2,45
FC Zürich,9694,5,11,10,11,41,34,7,43
FC Lugano,9694,6,10,5,17,29,49,-20,35
Grasshoppers,9694,7,9,7,16,41,50,-9,34
FC Thun,9694,8,9,7,16,42,57,-15,34
FC Sion,9694,9,6,8,18,39,58,-19,26
Young Boys,9695,1,21,8,3,76,35,41,71
FC Basel,9695,2,16,9,7,53,29,24,57
St Gallen,9695,3,17,2,13,42,49,-7,53
FC Zürich,9695,4,11,10,11,42,37,5,43
Lucerne,9695,5,11,9,12,40,49,-9,42
FC Lugano,9695,6,11,6,15,33,47,-14,39
Grasshoppers,9695,7,8,10,14,44,52,-8,34
FC Thun,9695,8,8,8,16,45,62,-17,32
FC Sion,9695,9,6,8,18,42,57,-15,26
Young Boys,9696,1,22,6,4,75,35,40,72
FC Basel,9696,2,16,10,6,53,27,26,58
Lucerne,9696,3,14,8,10,42,41,1,50
St Gallen,9696,4,13,4,15,39,54,-15,43
FC Zürich,9696,5,10,12,10,42,36,6,42
Grasshoppers,9696,6,10,7,15,45,53,-8,37
FC Thun,9696,7,10,6,16,51,60,-9,36
FC Lugano,9696,8,10,6,16,30,48,-18,36
FC Sion,9696,9,5,9,18,40,63,-23,24
Young Boys,9697,1,21,6,5,70,36,34,69
FC Basel,9697,2,18,8,6,56,28,28,62
FC Zürich,9697,3,13,9,10,45,34,11,48
St Gallen,9697,4,15,3,14,46,57,-11,48
Lucerne,9697,5,12,8,12,40,46,-6,44
Grasshoppers,9697,6,9,9,14,41,48,-7,36
FC Lugano,9697,7,9,5,18,28,50,-22,32
FC Thun,9697,8,8,7,17,41,58,-17,31
FC Sion,9697,9,7,9,16,43,53,-10,30
Young Boys,9698,1,20,9,3,68,36,32,69
FC Basel,9698,2,19,8,5,55,24,31,65
St Gallen,9698,3,16,2,14,45,53,-8,50
Lucerne,9698,4,13,8,11,43,44,-1,47
FC Zürich,9698,5,10,10,12,41,38,3,40
FC Thun,9698,6,11,5,16,44,56,-12,38
FC Lugano,9698,7,10,5,17,32,50,-18,35
Grasshoppers,9698,8,8,8,16,40,51,-11,32
FC Sion,9698,9,5,9,18,37,53,-16,24
Young Boys,9699,1,21,8,3,73,38,35,71
FC Basel,9699,2,18,8,6,52,25,27,62
Lucerne,9699,3,12,9,11,41,43,-2,45
St Gallen,9699,4,14,3,15,43,56,-13,45
FC Zürich,9699,5,9,11,12,38,37,1,38
FC Thun,9699,6,11,5,16,49,57,-8,38
FC Lugano,9699,7,10,8,14,33,47,-14,38
Grasshoppers,9699,8,9,7,16,42,52,-10,34
FC Sion,9699,9,6,9,17,40,56,-16,27
Young Boys,9700,1,22,6,4,72,34,38,72
FC Basel,9700,2,17,9,6,53,24,29,60
Lucerne,9700,3,12,10,10,42,46,-4,46
St Gallen,9700,4,13,5,14,42,54,-12,44
FC Zürich,9700,5,9,11,12,39,39,0,38
FC Thun,9700,6,10,7,15,42,54,-12,37
FC Lugano,9700,7,10,7,15,30,47,-17,37
Grasshoppers,9700,8,9,8,15,41,50,-9,35
FC Sion,9700,9,6,9,17,42,55,-13,27
Young Boys,9701,1,21,8,3,74,36,38,71
FC Basel,9701,2,18,8,6,58,27,31,62
Lucerne,9701,3,13,8,11,45,43,2,47
St Gallen,9701,4,14,3,15,41,54,-13,45
FC Zürich,9701,5,10,10,12,41,38,3,40
FC Lugano,9701,6,11,5,16,32,52,-20,38
Grasshoppers,9701,7,9,8,15,40,49,-9,35
FC Sion,9701,8,8,7,17,42,53,-11,31
FC Thun,9701,9,8,7,17,41,62,-21,31
Young Boys,9702,1,22,8,2,73,34,39,74
FC Basel,9702,2,18,7,7,58,27,31,61
St Gallen,9702,3,15,2,15,45,56,-11,47
Lucerne,9702,4,12,8,12,38,45,-7,44
FC Zürich,9702,5,11,9,12,41,35,6,42
FC Lugano,9702,6,11,5,16,32,50,-18,38
Grasshoppers,9702,7,10,6,16,41,46,-5,36
FC Thun,9702,8,9,6,17,42,60,-18,33
FC Sion,9702,9,6,9,17,39,56,-17,27
Young Boys,9703,1,21,7,4,69,37,32,70
FC Basel,9703,2,17,9,6,55,25,30,60
Lucerne,9703,3,13,9,10,46,44,2,48
FC Zürich,9703,4,12,9,11,42,35,7,45
St Gallen,9703,5,14,3,15,43,57,-14,45
Grasshoppers,9703,6,10,7,15,43,51,-8,37
FC Thun,9703,7,10,6,16,48,63,-15,36
FC Lugano,9703,8,9,5,18,29,50,-21,32
FC Sion,9703,9,7,7,18,44,57,-13,28
Young Boys,9704,1,23,6,3,75,37,38,75
FC Basel,9704,2,18,9,5,57,23,34,63
St Gallen,9704,3,14,4,14,44,54,-10,46
Lucerne,9704,4,12,7,13,41,51,-10,43
FC Lugano,9704,5,12,5,15,35,46,-11,41
FC Zürich,9704,6,9,12,11,40,38,2,39
Grasshoppers,9704,7,8,8,16,41,52,-11,32
FC Thun,9704,8,8,8,16,43,60,-17,32
FC Sion,9704,9,5,11,16,41,56,-15,26
Young Boys,9705,1,20,9,3,66,32,34,69
FC Basel,9705,2,17,9,6,51,25,26,60
Lucerne,9705,3,13,8,11,43,43,0,47
St Gallen,9705,4,14,3,15,46,57,-11,45
FC Zürich,9705,5,11,9,12,43,37,6,42
FC Lugano,9705,6,11,7,14,33,46,-13,40
FC Thun,9705,7,9,6,17,45,64,-19,33
Grasshoppers,9705,8,8,8,16,40,50,-10,32
FC Sion,9705,9,7,9,16,43,56,-13,30
Young Boys,9706,1,21,6,5,70,35,35,69
FC Basel,9706,2,19,7,6,54,23,31,64
Lucerne,9706,3,14,7,11,41,47,-6,49
St Gallen,9706,4,15,3,14,46,56,-10,48
FC Zürich,9706,5,11,9,12,41,35,6,42
Grasshoppers,9706,6,11,6,15,42,47,-5,39
FC Thun,9706,7,10,5,17,44,59,-15,35
FC Lugano,9706,8,9,6,17,30,50,-20,33
FC Sion,9706,9,6,7,19,39,55,-16,25
Young Boys,9707,1,21,8,3,74,35,39,71
FC Basel,9707,2,18,9,5,56,24,32,63
Lucerne,9707,3,14,9,9,49,41,8,51
St Gallen,9707,4,14,2,16,41,56,-15,44
FC Zürich,9707,5,11,10,11,42,35,7,43
FC Thun,9707,6,10,5,17,40,58,-18,35
Grasshoppers,9707,7,9,7,16,38,54,-16,34
FC Lugano,9707,8,9,6,17,28,49,-21,33
FC Sion,9707,9,6,8,18,40,56,-16,26
Young Boys,9708,1,22,7,3,74,33,41,73
FC Basel,9708,2,19,7,6,55,23,32,64
St Gallen,9708,3,16,2,14,44,51,-7,50
Lucerne,9708,4,12,8,12,38,44,-6,44
FC Zürich,9708,5,9,11,12,39,37,2,38
Grasshoppers,9708,6,10,7,15,43,48,-5,37
FC Lugano,9708,7,9,7,16,30,52,-22,34
FC Thun,9708,8,8,7,17,41,62,-21,31
FC Sion,9708,9,6,10,16,38,52,-14,28
Young Boys,9709,1,23,6,3,74,33,41,75
FC Basel,9709,2,18,8,6,58,28,30,62
St Gallen,9709,3,14,5,13,44,54,-10,47
Lucerne,9709,4,12,8,12,40,42,-2,44
FC Zürich,9709,5,10,10,12,37,35,2,40
Grasshoppers,9709,6,10,6,16,42,50,-8,36
FC Thun,9709,7,10,6,16,42,57,-15,36
FC Lugano,9709,8,10,6,16,29,48,-19,36
FC Sion,9709,9,6,7,19,37,56,-19,25
Young Boys,9710,1,23,7,2,72,33,39,76
FC Basel,9710,2,17,8,7,54,27,27,59
St Gallen,9710,3,16,3,13,45,50,-5,51
Lucerne,9710,4,12,8,12,40,47,-7,44
FC Zürich,9710,5,10,12,10,42,36,6,42
FC Lugano,9710,6,9,7,16,30,48,-18,34
Grasshoppers,9710,7,9,6,17,38,50,-12,33
FC Thun,9710,8,8,7,17,43,61,-18,31
FC Sion,9710,9,6,10,16,41,53,-12,28
Young Boys,9711,1,22,6,4,77,37,40,72
FC Basel,9711,2,17,9,6,53,25,28,60
Lucerne,9711,3,13,8,11,47,47,0,47
FC Zürich,9711,4,12,9,11,42,34,8,45
St Gallen,9711,5,13,6,13,43,54,-11,45
FC Thun,9711,6,10,7,15,43,56,-13,37
Grasshoppers,9711,7,9,7,16,42,53,-11,34
FC Lugano,9711,8,9,6,17,31,57,-26,33
FC Sion,9711,9,5,10,17,38,53,-15,25
Young Boys,9712,1,20,7,5,70,39,31,67
FC Basel,9712,2,18,9,5,60,25,35,63
Lucerne,9712,3,13,9,10,43,45,-2,48
FC Lugano,9712,4,12,6,14,36,47,-11,42
St Gallen,9712,5,13,3,16,43,59,-16,42
FC Zürich,9712,6,10,10,12,42,37,5,40
FC Thun,9712,7,10,6,16,41,58,-17,36
Grasshoppers,9712,8,9,7,16,41,49,-8,34
FC Sion,9712,9,6,9,17,37,54,-17,27
Young Boys,9713,1,22,8,2,72,31,41,74
FC Basel,9713,2,19,8,5,53,23,30,65
St Gallen,9713,3,14,3,15,42,54,-12,45
FC Zürich,9713,4,11,10,11,42,35,7,43
Lucerne,9713,5,11,8,13,39,46,-7,41
FC Lugano,9713,6,11,6,15,32,48,-16,39
Grasshoppers,9713,7,9,8,15,40,48,-8,35
FC Thun,9713,8,8,6,18,39,58,-19,30
FC Sion,9713,9,6,9,17,40,56,-16,27
Young Boys,9714,1,21,8,3,71,34,37,71
FC Basel,9714,2,18,8,6,56,25,31,62
St Gallen,9714,3,15,4,13,45,53,-8,49
Lucerne,9714,4,13,8,11,43,46,-3,47
FC Zürich,9714,5,11,9,12,44,40,4,42
FC Thun,9714,6,10,6,16,43,58,-15,36
FC Lugano,9714,7,10,6,16,33,50,-17,36
Grasshoppers,9714,8,8,6,18,38,52,-14,30
FC Sion,9714,9,6,9,17,41,56,-15,27
Young Boys,9715,1,21,8,3,69,32,37,71
FC Basel,9715,2,16,10,6,55,25,30,58
St Gallen,9715,3,14,3,15,43,60,-17,45
Lucerne,9715,4,11,9,12,40,49,-9,42
FC Lugano,9715,5,12,5,15,37,47,-10,41
FC Zürich,9715,6,10,10,12,38,38,0,40
Grasshoppers,9715,7,10,8,14,44,48,-4,38
FC Thun,9715,8,11,5,16,47,58,-11,38
FC Sion,9715,9,6,8,18,37,53,-16,26
Young Boys,9716,1,20,10,2,75,34,41,70
FC Basel,9716,2,16,11,5,53,24,29,59
St Gallen,9716,3,15,3,14,46,57,-11,48
Lucerne,9716,4,12,10,10,43,44,-1,46
FC Zürich,9716,5,11,11,10,41,33,8,44
FC Thun,9716,6,10,7,15,45,58,-13,37
FC Lugano,9716,7,9,6,17,30,56,-26,33
Grasshoppers,9716,8,8,8,16,43,53,-10,32
FC Sion,9716,9,5,10,17,40,57,-17,25
Young Boys,9717,1,23,6,3,73,32,41,75
FC Basel,9717,2,17,9,6,50,25,25,60
St Gallen,9717,3,15,2,15,43,54,-11,47
Lucerne,9717,4,12,7,13,41,43,-2,43
FC Zürich,9717,5,9,13,10,40,36,4,40
FC Lugano,9717,6,11,6,15,35,48,-13,39
FC Thun,9717,7,9,7,16,43,58,-15,34
Grasshoppers,9717,8,9,6,17,39,52,-13,33
FC Sion,9717,9,7,8,17,38,54,-16,29
Young Boys,9718,1,22,8,2,74,36,38,74
FC Basel,9718,2,17,10,5,53,26,27,61
St Gallen,9718,3,14,4,14,44,53,-9,46
Lucerne,9718,4,11,11,10,39,42,-3,44
FC Zürich,9718,5,9,10,13,38,38,0,37
FC Thun,9718,6,10,6,16,46,58,-12,36
FC Lugano,9718,7,10,6,16,33,50,-17,36
Grasshoppers,9718,8,9,8,15,40,47,-7,35
FC Sion,9718,9,6,9,17,39,56,-17,27
Young Boys,9719,1,20,6,6,67,39,28,66
FC Basel,9719,2,19,8,5,56,23,33,65
St Gallen,9719,3,15,3,14,44,54,-10,48
Lucerne,9719,4,12,8,12,41,46,-5,44
Grasshoppers,9719,5,12,6,14,44,46,-2,42
FC Zürich,9719,6,10,10,12,38,35,3,40
FC Lugano,9719,7,10,6,16,31,48,-17,36
FC Thun,9719,8,9,7,16,40,55,-15,34
FC Sion,9719,9,5,10,17,37,52,-15,25
Young Boys,9720,1,21,9,2,72,32,40,72
FC Basel,9720,2,17,8,7,52,24,28,59
Lucerne,9720,3,14,7,11,41,47,-6,49
St Gallen,9720,4,15,2,15,41,54,-13,47
FC Zürich,9720,5,11,10,11,41,35,6,43
Grasshoppers,9720,6,10,7,15,42,45,-3,37
FC Lugano,9720,7,10,6,16,32,47,-15,36
FC Thun,9720,8,9,6,17,41,59,-18,33
FC Sion,9720,9,5,9,18,37,56,-19,24
Young Boys,9721,1,20,7,5,67,39,28,67
FC Basel,9721,2,18,8,6,53,24,29,62
Lucerne,9721,3,13,8,11,46,43,3,47
St Gallen,9721,4,14,2,16,46,62,-16,44
FC Zürich,9721,5,10,10,12,40,37,3,40
FC Lugano,9721,6,11,6,15,35,49,-14,39
Grasshoppers,9721,7,10,6,16,45,53,-8,36
FC Sion,9721,8,8,9,15,46,52,-6,33
FC Thun,9721,9,9,6,17,42,61,-19,33
Young Boys,9722,1,21,7,4,75,39,36,70
FC Basel,9722,2,16,10,6,51,26,25,58
St Gallen,9722,3,15,2,15,41,52,-11,47
FC Zürich,9722,4,11,11,10,41,35,6,44
Lucerne,9722,5,12,8,12,44,46,-2,44
Grasshoppers,9722,6,12,6,14,47,47,0,42
FC Lugano,9722,7,9,6,17,30,53,-23,33
FC Thun,9722,8,8,7,17,42,59,-17,31
FC Sion,9722,9,7,9,16,41,55,-14,30
Young Boys,9723,1,22,8,2,70,33,37,74
FC Basel,9723,2,16,10,6,52,26,26,58
Lucerne,9723,3,12,9,11,42,45,-3,45
St Gallen,9723,4,14,3,15,43,55,-12,45
FC Zürich,9723,5,10,11,11,41,39,2,41
FC Lugano,9723,6,10,6,16,30,46,-16,36
Grasshoppers,9723,7,9,8,15,40,48,-8,35
FC Thun,9723,8,8,8,16,43,60,-17,32
FC Sion,9723,9,7,9,16,43,52,-9,30
Young Boys,9724,1,20,7,5,69,38,31,67
FC Basel,9724,2,18,8,6,51,23,28,62
Lucerne,9724,3,13,9,10,42,40,2,48
St Gallen,9724,4,15,2,15,41,53,-12,47
FC Zürich,9724,5,11,9,12,40,37,3,42
FC Lugano,9724,6,11,5,16,34,49,-15,38
Grasshoppers,9724,7,10,6,16,44,51,-7,36
FC Thun,9724,8,10,5,17,43,58,-15,35
FC Sion,9724,9,7,7,18,39,54,-15,28
Young Boys,9725,1,23,6,3,78,33,45,75
FC Basel,9725,2,18,7,7,55,25,30,61
Lucerne,9725,3,14,7,11,44,46,-2,49
St Gallen,9725,4,15,2,15,43,54,-11,47
FC Zürich,9725,5,10,10,12,38,37,1,40
FC Thun,9725,6,10,6,16,43,58,-15,36
FC Lugano,9725,7,10,6,16,29,49,-20,36
Grasshoppers,9725,8,9,6,17,41,51,-10,33
FC Sion,9725,9,6,8,18,39,57,-18,26
Young Boys,9726,1,22,7,3,72,34,38,73
FC Basel,9726,2,17,9,6,52,24,28,60
St Gallen,9726,3,15,3,14,43,54,-11,48
Lucerne,9726,4,12,8,12,41,47,-6,44
FC Zürich,9726,5,10,11,11,39,36,3,41
FC Lugano,9726,6,11,6,15,31,44,-13,39
FC Thun,9726,7,11,5,16,42,55,-13,38
Grasshoppers,9726,8,9,6,17,42,50,-8,33
FC Sion,9726,9,5,9,18,38,56,-18,24
Young Boys,9727,1,21,8,3,68,33,35,71
FC Basel,9727,2,18,9,5,55,23,32,63
Lucerne,9727,3,12,10,10,40,41,-1,46
St Gallen,9727,4,14,3,15,43,56,-13,45
FC Zürich,9727,5,10,10,12,39,36,3,40
FC Lugano,9727,6,11,6,15,32,45,-13,39
FC Thun,9727,7,10,6,16,42,59,-17,36
Grasshoppers,9727,8,8,6,18,37,50,-13,30
FC Sion,9727,9,7,8,17,40,53,-13,29
Young Boys,9728,1,20,8,4,71,36,35,68
FC Basel,9728,2,18,9,5,53,24,29,63
Lucerne,9728,3,12,10,10,41,41,0,46
St Gallen,9728,4,14,3,15,40,54,-14,45
FC Zürich,9728,5,10,11,11,41,38,3,41
FC Lugano,9728,6,10,7,15,30,46,-16,37
Grasshoppers,9728,7,9,7,16,42,53,-11,34
FC Sion,9728,8,8,8,16,47,56,-9,32
FC Thun,9728,9,8,7,17,42,59,-17,31
Young Boys,9729,1,22,8,2,74,32,42,74
FC Basel,9729,2,19,8,5,59,22,37,65
St Gallen,9729,3,13,4,15,41,54,-13,43
Lucerne,9729,4,11,9,12,37,49,-12,42
FC Zürich,9729,5,10,10,12,39,40,-1,40
Grasshoppers,9729,6,10,6,16,43,50,-7,36
FC Lugano,9729,7,10,6,16,30,47,-17,36
FC Thun,9729,8,10,5,17,42,59,-17,35
FC Sion,9729,9,6,10,16,44,56,-12,28
Young Boys,9730,1,22,7,3,76,33,43,73
FC Basel,9730,2,17,9,6,52,27,25,60
Lucerne,9730,3,12,8,12,43,48,-5,44
FC Zürich,9730,4,11,10,11,42,34,8,43
St Gallen,9730,5,13,4,15,40,57,-17,43
FC Lugano,9730,6,9,8,15,29,49,-20,35
FC Sion,9730,7,9,7,16,43,50,-7,34
Grasshoppers,9730,8,9,7,16,44,52,-8,34
FC Thun,9730,9,9,6,17,41,60,-19,33
Young Boys,9731,1,23,7,2,76,32,44,76
FC Basel,9731,2,18,8,6,52,26,26,62
FC Zürich,9731,3,12,9,11,41,35,6,45
St Gallen,9731,4,14,3,15,43,54,-11,45
Lucerne,9731,5,11,9,12,41,50,-9,42
Grasshoppers,9731,6,10,7,15,46,50,-4,37
FC Lugano,9731,7,10,6,16,31,50,-19,36
FC Thun,9731,8,9,6,17,41,56,-15,33
FC Sion,9731,9,5,9,18,39,57,-18,24
Young Boys,9732,1,22,6,4,73,35,38,72
FC Basel,9732,2,19,7,6,63,26,37,64
Lucerne,9732,3,14,7,11,45,43,2,49
St Gallen,9732,4,14,3,15,45,61,-16,45
FC Zürich,9732,5,11,10,11,42,36,6,43
FC Thun,9732,6,10,6,16,47,58,-11,36
Grasshoppers,9732,7,9,6,17,38,51,-13,33
FC Lugano,9732,8,9,6,17,32,55,-23,33
FC Sion,9732,9,7,7,18,38,58,-20,28
Young Boys,9733,1,22,8,2,72,34,38,74
FC Basel,9733,2,17,8,7,54,25,29,59
FC Zürich,9733,3,11,11,10,38,32,6,44
Lucerne,9733,4,12,8,12,40,47,-7,44
St Gallen,9733,5,13,3,16,41,60,-19,42
FC Thun,9733,6,10,6,16,43,54,-11,36
FC Lugano,9733,7,10,6,16,31,48,-17,36
Grasshoppers,9733,8,9,8,15,41,51,-10,35
FC Sion,9733,9,7,8,17,43,52,-9,29
Young Boys,9734,1,22,6,4,72,36,36,72
FC Basel,9734,2,17,10,5,50,21,29,61
St Gallen,9734,3,14,3,15,41,54,-13,45
FC Zürich,9734,4,11,10,11,42,36,6,43
Lucerne,9734,5,11,9,12,37,45,-8,42
FC Lugano,9734,6,10,6,16,33,50,-17,36
FC Sion,9734,7,9,8,15,43,48,-5,35
Grasshoppers,9734,8,9,7,16,41,49,-8,34
FC Thun,9734,9,8,7,17,42,62,-20,31
Young Boys,9735,1,21,7,4,73,34,39,70
FC Basel,9735,2,18,8,6,57,25,32,62
Lucerne,9735,3,13,7,12,39,48,-9,46
St Gallen,9735,4,14,2,16,41,54,-13,44
FC Zürich,9735,5,10,11,11,40,39,1,41
Grasshoppers,9735,6,11,6,15,44,47,-3,39
FC Lugano,9735,7,10,6,16,30,47,-17,36
FC Thun,9735,8,9,6,17,43,60,-17,33
FC Sion,9735,9,7,9,16,38,51,-13,30
Young Boys,9736,1,22,7,3,67,30,37,73
FC Basel,9736,2,17,9,6,51,24,27,60
Lucerne,9736,3,13,9,10,43,41,2,48
St Gallen,9736,4,14,3,15,43,56,-13,45
FC Zürich,9736,5,10,12,10,40,35,5,42
Grasshoppers,9736,6,11,6,15,46,50,-4,39
FC Lugano,9736,7,9,7,16,29,48,-19,34
FC Thun,9736,8,9,5,18,45,63,-18,32
FC Sion,9736,9,6,8,18,41,58,-17,26
Young Boys,9737,1,23,7,2,75,36,39,76
FC Basel,9737,2,17,8,7,53,29,24,59
Lucerne,9737,3,14,8,10,45,42,3,50
St Gallen,9737,4,13,6,13,43,54,-11,45
FC Zürich,9737,5,11,10,11,39,34,5,43
Grasshoppers,9737,6,9,7,16,41,52,-11,34
FC Lugano,9737,7,9,6,17,30,48,-18,33
FC Thun,9737,8,9,5,18,43,59,-16,32
FC Sion,9737,9,6,9,17,38,53,-15,27
Young Boys,9738,1,20,8,4,68,33,35,68
FC Basel,9738,2,17,9,6,50,23,27,60
FC Zürich,9738,3,13,9,10,43,34,9,48
Lucerne,9738,4,13,9,10,43,43,0,48
St Gallen,9738,5,14,3,15,43,56,-13,45
FC Lugano,9738,6,11,5,16,34,50,-16,38
Grasshoppers,9738,7,10,6,16,45,51,-6,36
FC Thun,9738,8,10,5,17,45,60,-15,35
FC Sion,9738,9,5,8,19,36,57,-21,23
Young Boys,9739,1,22,6,4,71,35,36,72
FC Basel,9739,2,17,9,6,54,26,28,60
Lucerne,9739,3,13,8,11,41,45,-4,47
St Gallen,9739,4,14,3,15,41,54,-13,45
Grasshoppers,9739,5,11,6,15,45,47,-2,39
FC Lugano,9739,6,11,5,16,30,46,-16,38
FC Zürich,9739,7,9,10,13,39,39,0,37
FC Thun,9739,8,10,7,15,46,56,-10,37
FC Sion,9739,9,6,8,18,37,56,-19,26
Young Boys,9740,1,22,6,4,70,32,38,72
FC Basel,9740,2,18,8,6,53,25,28,62
Lucerne,9740,3,12,10,10,40,41,-1,46
St Gallen,9740,4,14,4,14,45,55,-10,46
FC Zürich,9740,5,12,9,11,45,38,7,45
Grasshoppers,9740,6,10,7,15,40,47,-7,37
FC Thun,9740,7,10,5,17,44,60,-16,35
FC Lugano,9740,8,9,5,18,28,49,-21,32
FC Sion,9740,9,6,8,18,39,57,-18,26
Young Boys,9741,1,20,8,4,71,39,32,68
FC Basel,9741,2,18,8,6,52,24,28,62
Lucerne,9741,3,12,10,10,44,44,0,46
FC Zürich,9741,4,12,9,11,42,37,5,45
St Gallen,9741,5,14,3,15,41,54,-13,45
FC Lugano,9741,6,11,6,15,32,44,-12,39
Grasshoppers,9741,7,9,8,15,43,51,-8,35
FC Thun,9741,8,9,6,17,45,62,-17,33
FC Sion,9741,9,5,10,17,40,55,-15,25
Young Boys,9742,1,21,7,4,71,37,34,70
FC Basel,9742,2,19,8,5,56,25,31,65
Lucerne,9742,3,15,8,9,48,42,6,53
St Gallen,9742,4,13,4,15,43,56,-13,43
FC Zürich,9742,5,10,10,12,40,37,3,40
FC Thun,9742,6,10,6,16,42,56,-14,36
FC Lugano,9742,7,10,6,16,29,48,-19,36
Grasshoppers,9742,8,8,6,18,39,52,-13,30
FC Sion,9742,9,6,9,17,40,55,-15,27
Young Boys,9743,1,20,6,6,72,43,29,66
FC Basel,9743,2,16,11,5,51,24,27,59
St Gallen,9743,3,15,3,14,42,53,-11,48
Lucerne,9743,4,13,8,11,45,46,-1,47
FC Zürich,9743,5,11,11,10,43,33,10,44
Grasshoppers,9743,6,11,6,15,46,50,-4,39
FC Thun,9743,7,10,7,15,46,57,-11,37
FC Lugano,9743,8,9,5,18,29,50,-21,32
FC Sion,9743,9,7,7,18,39,57,-18,28
Young Boys,9744,1,21,8,3,70,34,36,71
FC Basel,9744,2,18,8,6,52,25,27,62
Lucerne,9744,3,14,8,10,46,43,3,50
St Gallen,9744,4,14,5,13,42,52,-10,47
FC Zürich,9744,5,12,9,11,43,34,9,45
Grasshoppers,9744,6,9,7,16,38,50,-12,34
FC Lugano,9744,7,9,6,17,29,49,-20,33
FC Thun,9744,8,9,5,18,41,59,-18,32
FC Sion,9744,9,6,8,18,42,57,-15,26
Young Boys,9745,1,21,7,4,69,36,33,70
FC Basel,9745,2,18,7,7,54,27,27,61
Lucerne,9745,3,13,9,10,42,43,-1,48
St Gallen,9745,4,14,3,15,43,54,-11,45
FC Lugano,9745,5,11,6,15,33,46,-13,39
FC Zürich,9745,6,9,11,12,40,38,2,38
FC Thun,9745,7,10,5,17,42,59,-17,35
Grasshoppers,9745,8,9,7,16,40,48,-8,34
FC Sion,9745,9,7,9,16,41,53,-12,30
Young Boys,9746,1,20,7,5,68,36,32,67
FC Basel,9746,2,17,9,6,54,26,28,60
St Gallen,9746,3,16,3,13,50,57,-7,51
Lucerne,9746,4,12,9,11,41,45,-4,45
FC Zürich,9746,5,11,10,11,42,35,7,43
FC Lugano,9746,6,11,5,16,33,48,-15,38
Grasshoppers,9746,7,9,6,17,40,49,-9,33
FC Thun,9746,8,9,6,17,44,62,-18,33
FC Sion,9746,9,8,7,17,43,57,-14,31
Young Boys,9747,1,20,7,5,69,35,34,67
FC Basel,9747,2,20,7,5,57,25,32,67
St Gallen,9747,3,16,2,14,48,56,-8,50
Lucerne,9747,4,13,8,11,43,45,-2,47
FC Zürich,9747,5,11,9,12,42,36,6,42
Grasshoppers,9747,6,11,6,15,40,46,-6,39
FC Lugano,9747,7,10,6,16,30,47,-17,36
FC Thun,9747,8,9,5,18,40,58,-18,32
FC Sion,9747,9,5,8,19,37,58,-21,23
Young Boys,9748,1,22,7,3,75,36,39,73
FC Basel,9748,2,19,7,6,57,31,26,64
Lucerne,9748,3,14,8,10,44,42,2,50
FC Zürich,9748,4,12,9,11,43,37,6,45
St Gallen,9748,5,14,2,16,42,55,-13,44
FC Thun,9748,6,10,5,17,46,58,-12,35
FC Lugano,9748,7,10,5,17,31,49,-18,35
Grasshoppers,9748,8,9,6,17,39,53,-14,33
FC Sion,9748,9,6,7,19,40,56,-16,25
Young Boys,9749,1,22,7,3,72,36,36,73
FC Basel,9749,2,16,9,7,53,27,26,57
St Gallen,9749,3,16,3,13,43,51,-8,51
Lucerne,9749,4,12,9,11,41,45,-4,45
FC Zürich,9749,5,10,11,11,41,37,4,41
Grasshoppers,9749,6,9,8,15,46,53,-7,35
FC Lugano,9749,7,9,8,15,28,44,-16,35
FC Thun,9749,8,9,6,17,42,60,-18,33
FC Sion,9749,9,6,9,17,40,53,-13,27
Young Boys,9750,1,22,8,2,75,35,40,74
FC Basel,9750,2,18,8,6,53,25,28,62
Lucerne,9750,3,11,11,10,41,44,-3,44
FC Zürich,9750,4,11,10,11,41,36,5,43
St Gallen,9750,5,13,4,15,41,55,-14,43
FC Thun,9750,6,10,6,16,44,57,-13,36
FC Lugano,9750,7,9,7,16,31,48,-17,34
Grasshoppers,9750,8,8,9,15,42,52,-10,33
FC Sion,9750,9,6,9,17,43,59,-16,27
Young Boys,9751,1,22,6,4,70,37,33,72
FC Basel,9751,2,18,7,7,57,29,28,61
St Gallen,9751,3,15,3,14,46,55,-9,48
Lucerne,9751,4,12,9,11,41,44,-3,45
FC Zürich,9751,5,10,12,10,41,35,6,42
FC Thun,9751,6,10,6,16,45,60,-15,36
Grasshoppers,9751,7,9,7,16,40,48,-8,34
FC Lugano,9751,8,9,7,16,30,47,-17,34
FC Sion,9751,9,6,9,17,38,53,-15,27
Young Boys,9752,1,21,6,5,70,38,32,69
FC Basel,9752,2,17,9,6,51,24,27,60
Lucerne,9752,3,15,8,9,43,39,4,53
St Gallen,9752,4,15,3,14,42,52,-10,48
FC Zürich,9752,5,10,10,12,40,37,3,40
FC Thun,9752,6,10,7,15,43,54,-11,37
Grasshoppers,9752,7,8,8,16,41,52,-11,32
FC Lugano,9752,8,9,5,18,31,52,-21,32
FC Sion,9752,9,7,8,17,43,56,-13,29
Young Boys,9753,1,22,7,3,75,33,42,73
FC Basel,9753,2,17,8,7,53,28,25,59
St Gallen,9753,3,14,5,13,42,52,-10,47
Lucerne,9753,4,12,9,11,42,47,-5,45
FC Zürich,9753,5,11,11,10,44,36,8,44
Grasshoppers,9753,6,10,7,15,43,49,-6,37
FC Thun,9753,7,10,6,16,45,56,-11,36
FC Lugano,9753,8,9,6,17,29,50,-21,33
FC Sion,9753,9,5,9,18,38,60,-22,24
Young Boys,9754,1,22,7,3,75,36,39,73
FC Basel,9754,2,17,7,8,54,27,27,58
St Gallen,9754,3,16,2,14,47,52,-5,50
FC Zürich,9754,4,12,9,11,41,35,6,45
Lucerne,9754,5,12,8,12,42,49,-7,44
FC Lugano,9754,6,12,6,14,33,45,-12,42
Grasshoppers,9754,7,9,7,16,42,51,-9,34
FC Thun,9754,8,9,5,18,42,64,-22,32
FC Sion,9754,9,6,7,19,41,58,-17,25
Young Boys,9755,1,21,6,5,69,35,34,69
FC Basel,9755,2,19,7,6,56,25,31,64
Lucerne,9755,3,13,7,12,42,41,1,46
FC Zürich,9755,4,12,9,11,41,33,8,45
St Gallen,9755,5,14,2,16,42,57,-15,44
FC Lugano,9755,6,12,5,15,31,46,-15,41
Grasshoppers,9755,7,9,7,16,38,51,-13,34
FC Thun,9755,8,9,6,17,40,58,-18,33
FC Sion,9755,9,7,7,18,39,52,-13,28
Young Boys,9756,1,21,9,2,74,32,42,72
FC Basel,9756,2,17,9,6,54,27,27,60
FC Zürich,9756,3,12,10,10,48,37,11,46
St Gallen,9756,4,14,3,15,44,54,-10,45
Lucerne,9756,5,12,7,13,38,51,-13,43
Grasshoppers,9756,6,10,7,15,42,50,-8,37
FC Thun,9756,7,9,8,15,43,57,-14,35
FC Lugano,9756,8,9,7,16,30,50,-20,34
FC Sion,9756,9,6,8,18,41,56,-15,26
Young Boys,9757,1,22,7,3,77,38,39,73
FC Basel,9757,2,18,7,7,57,26,31,61
Lucerne,9757,3,12,9,11,43,44,-1,45
FC Zürich,9757,4,11,9,12,44,37,7,42
St Gallen,9757,5,13,3,16,41,57,-16,42
Grasshoppers,9757,6,11,7,14,44,48,-4,40
FC Thun,9757,7,10,6,16,46,61,-15,36
FC Lugano,9757,8,10,6,16,29,52,-23,36
FC Sion,9757,9,6,8,18,43,61,-18,26
Young Boys,9758,1,23,6,3,74,36,38,75
FC Basel,9758,2,16,9,7,54,29,25,57
St Gallen,9758,3,15,4,13,46,54,-8,49
Lucerne,9758,4,13,9,10,43,43,0,48
FC Zürich,9758,5,12,10,10,44,35,9,46
FC Lugano,9758,6,10,5,17,36,53,-17,35
FC Thun,9758,7,9,6,17,42,61,-19,33
Grasshoppers,9758,8,8,8,16,38,48,-10,32
FC Sion,9758,9,5,9,18,37,55,-18,24
Young Boys,9759,1,22,8,2,73,33,40,74
FC Basel,9759,2,18,8,6,55,26,29,62
Lucerne,9759,3,13,8,11,42,44,-2,47
FC Zürich,9759,4,11,10,11,46,38,8,43
St Gallen,9759,5,13,3,16,39,56,-17,42
FC Lugano,9759,6,10,6,16,32,51,-19,36
Grasshoppers,9759,7,8,9,15,38,48,-10,33
FC Sion,9759,8,7,10,15,43,53,-10,31
FC Thun,9759,9,8,6,18,43,62,-19,30
Young Boys,9760,1,21,7,4,75,42,33,70
FC Basel,9760,2,19,7,6,57,26,31,64
Lucerne,9760,3,13,7,12,44,45,-1,46
FC Zürich,9760,4,11,10,11,43,35,8,43
St Gallen,9760,5,13,4,15,41,59,-18,43
FC Lugano,9760,6,12,6,14,34,45,-11,42
FC Thun,9760,7,9,7,16,42,57,-15,34
Grasshoppers,9760,8,8,7,17,41,53,-12,31
FC Sion,9760,9,5,11,16,43,58,-15,26
Young Boys,9761,1,23,6,3,70,31,39,75
FC Basel,9761,2,17,8,7,54,29,25,59
St Gallen,9761,3,14,5,13,46,55,-9,47
Lucerne,9761,4,12,8,12,39,44,-5,44
FC Zürich,9761,5,9,10,13,37,39,-2,37
Grasshoppers,9761,6,10,7,15,42,49,-7,37
FC Thun,9761,7,10,7,15,47,58,-11,37
FC Lugano,9761,8,10,6,16,31,48,-17,36
FC Sion,9761,9,6,9,17,39,52,-13,27
Young Boys,9762,1,22,7,3,73,36,37,73
FC Basel,9762,2,19,8,5,57,26,31,65
St Gallen,9762,3,16,2,14,45,54,-9,50
FC Zürich,9762,4,12,10,10,44,36,8,46
Lucerne,9762,5,11,7,14,40,49,-9,40
Grasshoppers,9762,6,10,7,15,45,50,-5,37
FC Lugano,9762,7,10,6,16,30,47,-17,36
FC Thun,9762,8,8,6,18,43,63,-20,30
FC Sion,9762,9,5,9,18,41,57,-16,24
Young Boys,9763,1,20,7,5,72,39,33,67
FC Basel,9763,2,17,7,8,54,30,24,58
St Gallen,9763,3,16,2,14,44,54,-10,50
Lucerne,9763,4,13,8,11,44,47,-3,47
FC Zürich,9763,5,12,9,11,44,38,6,45
FC Thun,9763,6,11,5,16,44,56,-12,38
FC Lugano,9763,7,10,5,17,34,51,-17,35
Grasshoppers,9763,8,9,7,16,42,50,-8,34
FC Sion,9763,9,7,8,17,43,56,-13,29
Young Boys,9764,1,23,6,3,80,38,42,75
FC Basel,9764,2,16,9,7,52,27,25,57
Lucerne,9764,3,13,8,11,40,42,-2,47
FC Zürich,9764,4,11,10,11,41,35,6,43
Grasshoppers,9764,5,12,6,14,46,48,-2,42
St Gallen,9764,6,13,2,17,41,59,-18,41
FC Thun,9764,7,10,5,17,44,57,-13,35
FC Lugano,9764,8,10,5,17,31,50,-19,35
FC Sion,9764,9,7,7,18,39,58,-19,28
Young Boys,9765,1,21,6,5,73,40,33,69
FC Basel,9765,2,18,8,6,56,27,29,62
St Gallen,9765,3,15,3,14,43,54,-11,48
Lucerne,9765,4,13,7,12,42,43,-1,46
FC Zürich,9765,5,11,10,11,39,35,4,43
FC Lugano,9765,6,11,6,15,31,47,-16,39
Grasshoppers,9765,7,10,7,15,47,50,-3,37
FC Thun,9765,8,9,6,17,46,64,-18,33
FC Sion,9765,9,5,9,18,42,59,-17,24
Young Boys,9766,1,20,8,4,67,36,31,68
FC Basel,9766,2,19,8,5,57,25,32,65
St Gallen,9766,3,14,3,15,44,56,-12,45
FC Lugano,9766,4,12,6,14,35,45,-10,42
Lucerne,9766,5,11,8,13,41,49,-8,41
FC Zürich,9766,6,10,10,12,40,37,3,40
Grasshoppers,9766,7,10,6,16,42,49,-7,36
FC Sion,9766,8,8,8,16,43,55,-12,32
FC Thun,9766,9,9,5,18,41,58,-17,32
Young Boys,9767,1,21,7,4,68,36,32,70
FC Basel,9767,2,20,7,5,57,24,33,67
St Gallen,9767,3,16,2,14,47,54,-7,50
Lucerne,9767,4,12,8,12,40,43,-3,44
FC Zürich,9767,5,10,9,13,42,41,1,39
FC Lugano,9767,6,10,7,15,30,45,-15,37
Grasshoppers,9767,7,10,6,16,41,51,-10,36
FC Thun,9767,8,9,6,17,43,59,-16,33
FC Sion,9767,9,6,8,18,39,54,-15,26
Young Boys,9768,1,22,7,3,73,32,41,73
FC Basel,9768,2,17,10,5,52,22,30,61
St Gallen,9768,3,14,3,15,40,54,-14,45
Lucerne,9768,4,11,8,13,39,46,-7,41
Grasshoppers,9768,5,11,6,15,43,49,-6,39
FC Zürich,9768,6,9,11,12,37,35,2,38
FC Thun,9768,7,10,6,16,44,56,-12,36
FC Lugano,9768,8,10,6,16,30,50,-20,36
FC Sion,9768,9,8,7,17,37,51,-14,31
Young Boys,9769,1,22,7,3,72,33,39,73
FC Basel,9769,2,19,8,5,65,26,39,65
Lucerne,9769,3,13,9,10,47,42,5,48
St Gallen,9769,4,14,3,15,45,61,-16,45
FC Zürich,9769,5,10,10,12,41,39,2,40
FC Thun,9769,6,11,5,16,42,61,-19,38
Grasshoppers,9769,7,9,8,15,41,48,-7,35
FC Lugano,9769,8,9,7,16,30,53,-23,34
FC Sion,9769,9,5,7,20,38,58,-20,22
Young Boys,9770,1,21,8,3,73,36,37,71
FC Basel,9770,2,17,10,5,56,28,28,61
Lucerne,9770,3,13,7,12,44,47,-3,46
FC Zürich,9770,4,11,11,10,42,36,6,44
St Gallen,9770,5,14,2,16,41,55,-14,44
FC Lugano,9770,6,11,5,16,32,49,-17,38
FC Thun,9770,7,9,6,17,47,65,-18,33
FC Sion,9770,8,7,10,15,42,50,-8,31
Grasshoppers,9770,9,8,7,17,39,50,-11,31
Young Boys,9771,1,22,8,2,75,36,39,74
FC Basel,9771,2,18,9,5,60,25,35,63
Lucerne,9771,3,12,8,12,41,45,-4,44
St Gallen,9771,4,14,2,16,40,56,-16,44
FC Zürich,9771,5,11,10,11,44,37,7,43
FC Lugano,9771,6,11,6,15,33,47,-14,39
Grasshoppers,9771,7,9,7,16,40,49,-9,34
FC Thun,9771,8,9,5,18,41,65,-24,32
FC Sion,9771,9,7,7,18,42,56,-14,28
Young Boys,9772,1,22,7,3,73,32,41,73
FC Basel,9772,2,18,8,6,56,27,29,62
FC Zürich,9772,3,12,10,10,44,36,8,46
Lucerne,9772,4,12,9,11,42,43,-1,45
St Gallen,9772,5,13,5,14,39,53,-14,44
Grasshoppers,9772,6,10,8,14,43,49,-6,38
FC Lugano,9772,7,9,7,16,30,52,-22,34
FC Thun,9772,8,8,6,18,43,63,-20,30
FC Sion,9772,9,5,10,17,38,53,-15,25
Young Boys,9773,1,22,6,4,71,33,38,72
FC Basel,9773,2,19,7,6,58,29,29,64
St Gallen,9773,3,15,3,14,47,56,-9,48
Lucerne,9773,4,12,7,13,41,49,-8,43
FC Zürich,9773,5,11,9,12,45,40,5,42
FC Lugano,9773,6,11,5,16,33,48,-15,38
Grasshoppers,9773,7,10,6,16,40,48,-8,36
FC Thun,9773,8,10,5,17,43,58,-15,35
FC Sion,9773,9,6,8,18,40,57,-17,26
Young Boys,9774,1,22,6,4,70,36,34,72
FC Basel,9774,2,19,8,5,56,24,32,65
Lucerne,9774,3,13,8,11,44,46,-2,47
St Gallen,9774,4,13,3,16,40,56,-16,42
FC Zürich,9774,5,10,10,12,40,37,3,40
Grasshoppers,9774,6,10,7,15,40,46,-6,37
FC Lugano,9774,7,9,8,15,29,45,-16,35
FC Thun,9774,8,9,6,17,41,58,-17,33
FC Sion,9774,9,7,8,17,42,54,-12,29
Young Boys,9775,1,21,6,5,69,38,31,69
FC Basel,9775,2,17,9,6,52,25,27,60
St Gallen,9775,3,15,2,15,42,59,-17,47
Lucerne,9775,4,11,8,13,39,47,-8,41
FC Lugano,9775,5,12,5,15,37,46,-9,41
FC Zürich,9775,6,10,10,12,41,39,2,40
FC Thun,9775,7,11,5,16,48,56,-8,38
Grasshoppers,9775,8,10,6,16,40,51,-11,36
FC Sion,9775,9,8,7,17,46,53,-7,31
Young Boys,9776,1,20,8,4,69,37,32,68
FC Basel,9776,2,17,9,6,55,26,29,60
Lucerne,9776,3,13,10,9,42,40,2,49
St Gallen,9776,4,13,5,14,45,58,-13,44
FC Zürich,9776,5,10,11,11,41,37,4,41
Grasshoppers,9776,6,10,7,15,42,48,-6,37
FC Sion,9776,7,9,8,15,43,50,-7,35
FC Lugano,9776,8,9,7,16,31,50,-19,34
FC Thun,9776,9,8,5,19,40,62,-22,29
Young Boys,9777,1,21,7,4,70,35,35,70
FC Basel,9777,2,19,7,6,56,25,31,64
Lucerne,9777,3,15,8,9,43,39,4,53
FC Zürich,9777,4,11,10,11,45,35,10,43
St Gallen,9777,5,13,2,17,40,60,-20,41
FC Lugano,9777,6,10,6,16,32,47,-15,36
Grasshoppers,9777,7,8,8,16,40,51,-11,32
FC Thun,9777,8,8,8,16,42,59,-17,32
FC Sion,9777,9,7,8,17,41,58,-17,29
Young Boys,9778,1,21,6,5,72,36,36,69
FC Basel,9778,2,17,8,7,52,27,25,59
Lucerne,9778,3,15,8,9,44,38,6,53
FC Zürich,9778,4,11,11,10,42,35,7,44
St Gallen,9778,5,13,3,16,40,62,-22,42
Grasshoppers,9778,6,9,9,14,39,46,-7,36
FC Lugano,9778,7,10,6,16,35,49,-14,36
FC Thun,9778,8,9,6,17,45,58,-13,33
FC Sion,9778,9,6,9,17,40,58,-18,27
Young Boys,9779,1,23,7,2,73,34,39,76
FC Basel,9779,2,18,9,5,53,25,28,63
St Gallen,9779,3,14,3,15,44,57,-13,45
FC Zürich,9779,4,11,10,11,42,37,5,43
Lucerne,9779,5,12,7,13,43,48,-5,43
FC Lugano,9779,6,10,6,16,32,47,-15,36
Grasshoppers,9779,7,9,6,17,39,49,-10,33
FC Thun,9779,8,9,5,18,42,60,-18,32
FC Sion,9779,9,8,7,17,44,55,-11,31
Young Boys,9780,1,21,8,3,68,35,33,71
FC Basel,9780,2,17,9,6,55,27,28,60
Lucerne,9780,3,14,7,11,45,42,3,49
St Gallen,9780,4,14,4,14,44,55,-11,46
FC Zürich,9780,5,9,12,11,39,37,2,39
FC Thun,9780,6,11,6,15,47,57,-10,39
FC Lugano,9780,7,9,7,16,30,49,-19,34
Grasshoppers,9780,8,8,9,15,39,49,-10,33
FC Sion,9780,9,5,10,17,37,53,-16,25
Young Boys,9781,1,22,7,3,75,36,39,73
FC Basel,9781,2,19,7,6,56,27,29,64
Lucerne,9781,3,15,7,10,50,44,6,52
FC Zürich,9781,4,10,11,11,41,35,6,41
St Gallen,9781,5,13,2,17,44,63,-19,41
FC Lugano,9781,6,10,7,15,31,49,-18,37
Grasshoppers,9781,7,9,7,16,43,53,-10,34
FC Thun,9781,8,9,7,16,42,58,-16,34
FC Sion,9781,9,6,7,19,45,62,-17,25
Young Boys,9782,1,23,6,3,74,34,40,75
FC Basel,9782,2,19,8,5,58,26,32,65
St Gallen,9782,3,14,4,14,44,56,-12,46
FC Zürich,9782,4,11,10,11,40,36,4,43
Lucerne,9782,5,11,8,13,39,46,-7,41
Grasshoppers,9782,6,10,6,16,39,48,-9,36
FC Lugano,9782,7,9,8,15,31,47,-16,35
FC Thun,9782,8,9,5,18,43,59,-16,32
FC Sion,9782,9,7,7,18,40,56,-16,28
Young Boys,9783,1,21,8,3,73,36,37,71
FC Basel,9783,2,18,8,6,55,25,30,62
Lucerne,9783,3,13,8,11,42,47,-5,47
St Gallen,9783,4,14,3,15,43,56,-13,45
FC Zürich,9783,5,10,11,11,39,34,5,41
FC Thun,9783,6,10,6,16,44,57,-13,36
FC Lugano,9783,7,9,9,14,29,44,-15,36
Grasshoppers,9783,8,9,7,16,40,50,-10,34
FC Sion,9783,9,6,8,18,40,56,-16,26
Young Boys,9784,1,21,8,3,73,33,40,71
FC Basel,9784,2,16,9,7,49,27,22,57
FC Zürich,9784,3,12,10,10,44,36,8,46
Lucerne,9784,4,12,9,11,40,45,-5,45
St Gallen,9784,5,13,3,16,39,54,-15,42
FC Lugano,9784,6,10,7,15,31,46,-15,37
Grasshoppers,9784,7,9,8,15,43,50,-7,35
FC Thun,9784,8,9,7,16,47,62,-15,34
FC Sion,9784,9,8,7,17,42,55,-13,31
Young Boys,9785,1,22,7,3,76,37,39,73
FC Basel,9785,2,16,10,6,53,28,25,58
Lucerne,9785,3,14,8,10,44,43,1,50
St Gallen,9785,4,14,4,14,44,55,-11,46
FC Zürich,9785,5,11,11,10,43,35,8,44
FC Thun,9785,6,10,5,17,44,59,-15,35
FC Lugano,9785,7,9,7,16,31,48,-17,34
Grasshoppers,9785,8,8,6,18,38,55,-17,30
FC Sion,9785,9,7,8,17,42,55,-13,29
Young Boys,9786,1,23,7,2,73,32,41,76
FC Basel,9786,2,19,8,5,58,25,33,65
FC Zürich,9786,3,12,9,11,46,37,9,45
St Gallen,9786,4,14,3,15,45,57,-12,45
Lucerne,9786,5,11,9,12,40,47,-7,42
FC Thun,9786,6,10,5,17,43,59,-16,35
Grasshoppers,9786,7,9,7,16,39,48,-9,34
FC Lugano,9786,8,9,7,16,33,52,-19,34
FC Sion,9786,9,6,7,19,36,56,-20,25
Young Boys,9787,1,22,7,3,75,33,42,73
FC Basel,9787,2,18,7,7,56,29,27,61
Lucerne,9787,3,13,7,12,39,46,-7,46
St Gallen,9787,4,14,2,16,42,60,-18,44
FC Zürich,9787,5,11,10,11,44,37,7,43
Grasshoppers,9787,6,10,7,15,43,48,-5,37
FC Lugano,9787,7,10,7,15,33,45,-12,37
FC Thun,9787,8,9,5,18,43,65,-22,32
FC Sion,9787,9,7,8,17,42,54,-12,29
Young Boys,9788,1,20,9,3,68,34,34,69
FC Basel,9788,2,16,9,7,51,28,23,57
St Gallen,9788,3,15,3,14,44,52,-8,48
FC Zürich,9788,4,12,10,10,48,34,14,46
Lucerne,9788,5,12,9,11,44,44,0,45
FC Thun,9788,6,10,5,17,46,61,-15,35
FC Lugano,9788,7,10,5,17,30,50,-20,35
Grasshoppers,9788,8,8,9,15,39,51,-12,33
FC Sion,9788,9,7,9,16,40,56,-16,30
Young Boys,9789,1,22,7,3,72,35,37,73
FC Basel,9789,2,17,10,5,54,25,29,61
FC Zürich,9789,3,11,11,10,40,34,6,44
Lucerne,9789,4,12,8,12,44,46,-2,44
St Gallen,9789,5,13,4,15,42,56,-14,43
FC Lugano,9789,6,11,5,16,34,51,-17,38
Grasshoppers,9789,7,10,6,16,44,53,-9,36
FC Thun,9789,8,9,6,17,42,58,-16,33
FC Sion,9789,9,7,7,18,41,55,-14,28
Young Boys,9790,1,22,8,2,80,33,47,74
FC Basel,9790,2,15,11,6,49,25,24,56
St Gallen,9790,3,15,3,14,45,55,-10,48
FC Zürich,9790,4,12,10,10,44,35,9,46
Lucerne,9790,5,11,11,10,41,43,-2,44
FC Thun,9790,6,11,5,16,47,61,-14,38
FC Lugano,9790,7,9,6,17,31,53,-22,33
Grasshoppers,9790,8,8,8,16,39,52,-13,32
FC Sion,9790,9,6,8,18,41,60,-19,26
Young Boys,9791,1,22,6,4,71,37,34,72
FC Basel,9791,2,18,8,6,55,25,30,62
Lucerne,9791,3,13,8,11,45,45,0,47
St Gallen,9791,4,15,2,15,44,55,-11,47
FC Zürich,9791,5,10,11,11,47,39,8,41
Grasshoppers,9791,6,9,7,16,40,53,-13,34
FC Lugano,9791,7,9,6,17,31,53,-22,33
FC Sion,9791,8,8,8,16,46,55,-9,32
FC Thun,9791,9,8,8,16,42,59,-17,32
Young Boys,9792,1,24,6,2,73,30,43,78
FC Basel,9792,2,18,8,6,53,27,26,62
FC Zürich,9792,3,12,9,11,42,36,6,45
Lucerne,9792,4,11,9,12,41,48,-7,42
St Gallen,9792,5,13,3,16,42,60,-18,42
FC Thun,9792,6,10,6,16,45,57,-12,36
FC Lugano,9792,7,10,6,16,35,48,-13,36
Grasshoppers,9792,8,9,6,17,42,54,-12,33
FC Sion,9792,9,7,7,18,40,53,-13,28
Young Boys,9793,1,21,9,2,73,34,39,72
FC Basel,9793,2,17,10,5,54,25,29,61
Lucerne,9793,3,13,7,12,42,45,-3,46
St Gallen,9793,4,13,4,15,40,55,-15,43
FC Zürich,9793,5,10,12,10,44,37,7,42
Grasshoppers,9793,6,10,7,15,43,49,-6,37
FC Lugano,9793,7,10,7,15,34,49,-15,37
FC Thun,9793,8,9,6,17,44,60,-16,33
FC Sion,9793,9,6,8,18,39,59,-20,26
Young Boys,9794,1,23,7,2,74,33,41,76
FC Basel,9794,2,17,9,6,56,29,27,60
St Gallen,9794,3,14,4,14,43,55,-12,46
FC Zürich,9794,4,12,9,11,42,34,8,45
Lucerne,9794,5,12,8,12,47,47,0,44
FC Thun,9794,6,10,6,16,47,59,-12,36
Grasshoppers,9794,7,9,7,16,37,49,-12,34
FC Lugano,9794,8,9,6,17,29,51,-22,33
FC Sion,9794,9,6,8,18,39,57,-18,26
Young Boys,9795,1,21,7,4,72,38,34,70
FC Basel,9795,2,18,7,7,52,24,28,61
Lucerne,9795,3,13,8,11,43,43,0,47
St Gallen,9795,4,14,3,15,42,54,-12,45
FC Zürich,9795,5,10,11,11,40,36,4,41
FC Lugano,9795,6,11,6,15,34,47,-13,39
Grasshoppers,9795,7,10,6,16,43,52,-9,36
FC Sion,9795,8,8,8,16,42,54,-12,32
FC Thun,9795,9,8,6,18,41,61,-20,30
Young Boys,9796,1,23,6,3,73,35,38,75
FC Basel,9796,2,19,8,5,56,24,32,65
Lucerne,9796,3,13,9,10,43,42,1,48
FC Zürich,9796,4,12,9,11,45,37,8,45
St Gallen,9796,5,13,3,16,39,55,-16,42
FC Thun,9796,6,10,5,17,41,56,-15,35
FC Lugano,9796,7,10,5,17,32,51,-19,35
Grasshoppers,9796,8,9,7,16,38,47,-9,34
FC Sion,9796,9,5,8,19,35,55,-20,23
Young Boys,9797,1,22,7,3,73,34,39,73
FC Basel,9797,2,17,8,7,55,30,25,59
Lucerne,9797,3,14,8,10,44,43,1,50
St Gallen,9797,4,15,4,13,45,54,-9,49
FC Zürich,9797,5,11,11,10,44,36,8,44
Grasshoppers,9797,6,9,7,16,42,52,-10,34
FC Lugano,9797,7,9,6,17,29,49,-20,33
FC Thun,9797,8,8,6,18,42,61,-19,30
FC Sion,9797,9,6,9,17,42,57,-15,27
Young Boys,9798,1,22,6,4,76,34,42,72
FC Basel,9798,2,18,9,5,56,26,30,63
Lucerne,9798,3,13,9,10,44,46,-2,48
St Gallen,9798,4,14,4,14,42,55,-13,46
FC Zürich,9798,5,9,11,12,40,39,1,38
Grasshoppers,9798,6,10,6,16,43,51,-8,36
FC Lugano,9798,7,10,6,16,31,47,-16,36
FC Sion,9798,8,8,7,17,42,58,-16,31
FC Thun,9798,9,8,6,18,42,60,-18,30
Young Boys,9799,1,22,7,3,71,34,37,73
FC Basel,9799,2,18,7,7,58,27,31,61
Lucerne,9799,3,12,10,10,42,44,-2,46
St Gallen,9799,4,14,3,15,41,55,-14,45
FC Zürich,9799,5,10,10,12,40,38,2,40
FC Lugano,9799,6,11,6,15,31,45,-14,39
FC Thun,9799,7,9,6,17,45,64,-19,33
Grasshoppers,9799,8,8,8,16,41,52,-11,32
FC Sion,9799,9,7,9,16,43,53,-10,30
Young Boys,9800,1,21,7,4,71,33,38,70
FC Basel,9800,2,17,8,7,51,27,24,59
FC Zürich,9800,3,12,9,11,42,35,7,45
St Gallen,9800,4,14,3,15,42,56,-14,45
Lucerne,9800,5,12,8,12,43,47,-4,44
Grasshoppers,9800,6,12,6,14,44,45,-1,42
FC Lugano,9800,7,11,6,15,36,50,-14,39
FC Thun,9800,8,9,6,17,41,58,-17,33
FC Sion,9800,9,5,9,18,37,56,-19,24
Young Boys,9801,1,22,7,3,72,35,37,73
FC Basel,9801,2,18,8,6,56,25,31,62
Lucerne,9801,3,12,8,12,42,44,-2,44
St Gallen,9801,4,14,2,16,44,58,-14,44
FC Zürich,9801,5,10,10,12,42,40,2,40
FC Thun,9801,6,11,6,15,45,55,-10,39
FC Lugano,9801,7,11,6,15,33,47,-14,39
Grasshoppers,9801,8,10,6,16,41,49,-8,36
FC Sion,9801,9,6,7,19,41,63,-22,25
Young Boys,9802,1,23,6,3,75,32,43,75
FC Basel,9802,2,16,8,8,49,28,21,56
St Gallen,9802,3,15,2,15,41,53,-12,47
FC Zürich,9802,4,11,11,10,42,35,7,44
Lucerne,9802,5,12,8,12,39,43,-4,44
Grasshoppers,9802,6,11,7,14,41,45,-4,40
FC Thun,9802,7,10,6,16,47,57,-10,36
FC Lugano,9802,8,9,6,17,29,49,-20,33
FC Sion,9802,9,6,8,18,36,57,-21,26
Young Boys,9803,1,23,7,2,75,35,40,76
FC Basel,9803,2,16,9,7,50,26,24,57
Lucerne,9803,3,13,10,9,42,39,3,49
St Gallen,9803,4,15,3,14,41,51,-10,48
FC Zürich,9803,5,10,11,11,40,35,5,41
FC Thun,9803,6,10,6,16,45,59,-14,36
FC Lugano,9803,7,10,6,16,28,45,-17,36
Grasshoppers,9803,8,8,8,16,39,51,-12,32
FC Sion,9803,9,5,8,19,38,57,-19,23
Young Boys,9804,1,21,7,4,67,34,33,70
FC Basel,9804,2,20,7,5,55,23,32,67
Lucerne,9804,3,14,7,11,40,40,0,49
St Gallen,9804,4,14,2,16,44,58,-14,44
FC Zürich,9804,5,10,9,13,41,37,4,39
FC Lugano,9804,6,10,5,17,31,48,-17,35
FC Sion,9804,7,9,7,16,44,50,-6,34
Grasshoppers,9804,8,9,7,16,40,51,-11,34
FC Thun,9804,9,9,5,18,42,63,-21,32
Young Boys,9805,1,22,7,3,73,33,40,73
FC Basel,9805,2,19,7,6,57,26,31,64
Lucerne,9805,3,13,9,10,39,39,0,48
St Gallen,9805,4,13,3,16,41,59,-18,42
FC Zürich,9805,5,10,10,12,39,37,2,40
FC Lugano,9805,6,10,6,16,31,48,-17,36
Grasshoppers,9805,7,8,9,15,38,47,-9,33
FC Thun,9805,8,8,8,16,40,58,-18,32
FC Sion,9805,9,7,9,16,42,53,-11,30
Young Boys,9806,1,23,6,3,79,39,40,75
FC Basel,9806,2,17,7,8,55,28,27,58
St Gallen,9806,3,15,3,14,42,53,-11,48
Lucerne,9806,4,13,7,12,43,46,-3,46
FC Zürich,9806,5,10,11,11,41,39,2,41
Grasshoppers,9806,6,10,7,15,46,52,-6,37
FC Thun,9806,7,10,6,16,46,60,-14,36
FC Lugano,9806,8,10,6,16,31,48,-17,36
FC Sion,9806,9,5,9,18,39,57,-18,24
Young Boys,9807,1,22,8,2,76,34,42,74
FC Basel,9807,2,16,7,9,53,33,20,55
St Gallen,9807,3,16,2,14,47,55,-8,50
FC Zürich,9807,4,12,10,10,45,34,11,46
Lucerne,9807,5,12,9,11,43,50,-7,45
FC Thun,9807,6,11,6,15,46,56,-10,39
FC Lugano,9807,7,9,7,16,30,47,-17,34
Grasshoppers,9807,8,8,7,17,40,52,-12,31
FC Sion,9807,9,6,8,18,39,58,-19,26
Young Boys,9808,1,22,7,3,73,33,40,73
FC Basel,9808,2,18,8,6,56,24,32,62
St Gallen,9808,3,16,3,13,45,53,-8,51
Lucerne,9808,4,14,7,11,42,42,0,49
FC Zürich,9808,5,11,10,11,41,36,5,43
Grasshoppers,9808,6,9,7,16,40,51,-11,34
FC Lugano,9808,7,9,6,17,29,48,-19,33
FC Thun,9808,8,8,5,19,40,64,-24,29
FC Sion,9808,9,6,9,17,39,54,-15,27
Young Boys,9809,1,23,6,3,80,36,44,75
FC Basel,9809,2,18,8,6,57,28,29,62
Lucerne,9809,3,14,7,11,45,48,-3,49
St Gallen,9809,4,15,3,14,45,53,-8,48
FC Zürich,9809,5,12,10,10,45,36,9,46
Grasshoppers,9809,6,10,6,16,43,51,-8,36
FC Lugano,9809,7,9,5,18,31,55,-24,32
FC Thun,9809,8,8,5,19,43,62,-19,29
FC Sion,9809,9,6,8,18,39,59,-20,26
Young Boys,9810,1,21,6,5,70,36,34,69
FC Basel,9810,2,18,8,6,54,27,27,62
Lucerne,9810,3,14,8,10,45,44,1,50
St Gallen,9810,4,15,2,15,43,53,-10,47
Grasshoppers,9810,5,11,7,14,45,48,-3,40
FC Zürich,9810,6,10,9,13,41,43,-2,39
FC Lugano,9810,7,10,5,17,30,48,-18,35
FC Thun,9810,8,9,7,16,44,58,-14,34
FC Sion,9810,9,6,8,18,41,56,-15,26
Young Boys,9811,1,23,6,3,76,33,43,75
FC Basel,9811,2,17,8,7,55,28,27,59
Lucerne,9811,3,14,8,10,45,44,1,50
St Gallen,9811,4,14,5,13,43,53,-10,47
FC Zürich,9811,5,11,10,11,40,36,4,43
Grasshoppers,9811,6,10,6,16,44,52,-8,36
FC Lugano,9811,7,10,5,17,29,48,-19,35
FC Thun,9811,8,9,5,18,42,61,-19,32
FC Sion,9811,9,5,9,18,39,58,-19,24
Young Boys,9812,1,22,7,3,72,37,35,73
FC Basel,9812,2,18,7,7,53,28,25,61
Lucerne,9812,3,14,8,10,42,42,0,50
St Gallen,9812,4,14,4,14,46,55,-9,46
FC Lugano,9812,5,11,6,15,35,47,-12,39
FC Zürich,9812,6,9,9,14,37,38,-1,36
FC Thun,9812,7,10,6,16,42,55,-13,36
Grasshoppers,9812,8,9,6,17,39,50,-11,33
FC Sion,9812,9,6,9,17,39,53,-14,27
Young Boys,9813,1,21,7,4,70,35,35,70
FC Basel,9813,2,19,7,6,53,26,27,64
Lucerne,9813,3,14,7,11,45,42,3,49
St Gallen,9813,4,14,2,16,41,56,-15,44
FC Zürich,9813,5,10,10,12,41,37,4,40
FC Lugano,9813,6,11,6,15,31,47,-16,39
FC Thun,9813,7,10,5,17,44,57,-13,35
FC Sion,9813,8,8,8,16,39,50,-11,32
Grasshoppers,9813,9,8,6,18,38,52,-14,30
Young Boys,9814,1,23,7,2,71,31,40,76
FC Basel,9814,2,18,8,6,52,24,28,62
St Gallen,9814,3,14,4,14,43,54,-11,46
Lucerne,9814,4,12,9,11,41,44,-3,45
FC Zürich,9814,5,11,10,11,38,33,5,43
FC Thun,9814,6,10,5,17,45,57,-12,35
FC Lugano,9814,7,9,7,16,29,46,-17,34
Grasshoppers,9814,8,8,8,16,38,50,-12,32
FC Sion,9814,9,5,10,17,37,55,-18,25
Young Boys,9815,1,22,6,4,74,36,38,72
FC Basel,9815,2,18,7,7,58,29,29,61
St Gallen,9815,3,16,3,13,43,50,-7,51
Lucerne,9815,4,11,9,12,40,46,-6,42
FC Zürich,9815,5,10,11,11,43,38,5,41
Grasshoppers,9815,6,10,7,15,41,47,-6,37
FC Lugano,9815,7,10,6,16,31,48,-17,36
FC Thun,9815,8,9,6,17,45,63,-18,33
FC Sion,9815,9,7,7,18,39,57,-18,28
Young Boys,9816,1,22,7,3,75,35,40,73
FC Basel,9816,2,18,8,6,51,25,26,62
St Gallen,9816,3,17,2,13,47,50,-3,53
Lucerne,9816,4,11,8,13,40,47,-7,41
FC Zürich,9816,5,10,10,12,42,38,4,40
Grasshoppers,9816,6,11,6,15,44,48,-4,39
FC Lugano,9816,7,9,7,16,30,49,-19,34
FC Thun,9816,8,9,5,18,43,64,-21,32
FC Sion,9816,9,7,7,18,42,58,-16,28
Young Boys,9817,1,23,6,3,71,34,37,75
FC Basel,9817,2,17,8,7,54,27,27,59
St Gallen,9817,3,15,2,15,43,55,-12,47
FC Zürich,9817,4,12,10,10,42,35,7,46
Lucerne,9817,5,12,7,13,40,44,-4,43
FC Lugano,9817,6,11,6,15,31,46,-15,39
Grasshoppers,9817,7,10,6,16,42,51,-9,36
FC Thun,9817,8,9,7,16,45,58,-13,34
FC Sion,9817,9,5,8,19,36,54,-18,23
Young Boys,9818,1,22,7,3,72,35,37,73
FC Basel,9818,2,20,7,5,64,26,38,67
St Gallen,9818,3,15,3,14,48,56,-8,48
Lucerne,9818,4,12,8,12,42,48,-6,44
FC Zürich,9818,5,9,11,12,39,39,0,38
FC Thun,9818,6,10,6,16,46,58,-12,36
FC Lugano,9818,7,10,6,16,30,48,-18,36
Grasshoppers,9818,8,9,8,15,42,49,-7,35
FC Sion,9818,9,5,8,19,37,61,-24,23
Young Boys,9819,1,23,6,3,73,33,40,75
FC Basel,9819,2,19,7,6,57,27,30,64
St Gallen,9819,3,15,2,15,44,57,-13,47
Lucerne,9819,4,12,7,13,44,48,-4,43
Grasshoppers,9819,5,11,6,15,46,50,-4,39
FC Zürich,9819,6,9,10,13,39,39,0,37
FC Thun,9819,7,10,6,16,47,60,-13,36
FC Lugano,9819,8,10,5,17,32,51,-19,35
FC Sion,9819,9,7,7,18,40,57,-17,28
Young Boys,9820,1,21,7,4,70,35,35,70
FC Basel,9820,2,17,7,8,51,25,26,58
Lucerne,9820,3,14,8,10,49,41,8,50
FC Zürich,9820,4,12,10,10,41,34,7,46
St Gallen,9820,5,14,3,15,40,55,-15,45
FC Lugano,9820,6,11,5,16,31,48,-17,38
Grasshoppers,9820,7,10,7,15,42,52,-10,37
FC Thun,9820,8,9,7,16,45,60,-15,34
FC Sion,9820,9,5,8,19,38,57,-19,23
Young Boys,9821,1,23,7,2,74,32,42,76
FC Basel,9821,2,18,7,7,54,26,28,61
St Gallen,9821,3,15,2,15,43,54,-11,47
Lucerne,9821,4,12,9,11,39,43,-4,45
FC Zürich,9821,5,10,9,13,38,37,1,39
FC Lugano,9821,6,11,6,15,32,45,-13,39
FC Thun,9821,7,10,5,17,45,62,-17,35
Grasshoppers,9821,8,9,7,16,45,53,-8,34
FC Sion,9821,9,6,8,18,38,56,-18,26
Young Boys,9822,1,23,6,3,75,36,39,75
FC Basel,9822,2,18,7,7,53,25,28,61
St Gallen,9822,3,15,2,15,41,55,-14,47
Lucerne,9822,4,13,7,12,45,45,0,46
FC Zürich,9822,5,10,9,13,38,39,-1,39
FC Lugano,9822,6,11,5,16,35,50,-15,38
Grasshoppers,9822,7,10,6,16,43,52,-9,36
FC Thun,9822,8,9,6,17,42,59,-17,33
FC Sion,9822,9,7,8,17,44,55,-11,29
Young Boys,9823,1,21,6,5,73,39,34,69
FC Basel,9823,2,20,7,5,60,26,34,67
St Gallen,9823,3,14,4,14,41,52,-11,46
Lucerne,9823,4,12,8,12,45,49,-4,44
FC Zürich,9823,5,11,9,12,42,37,5,42
FC Thun,9823,6,11,5,16,44,57,-13,38
Grasshoppers,9823,7,10,6,16,41,51,-10,36
FC Lugano,9823,8,10,5,17,32,50,-18,35
FC Sion,9823,9,6,8,18,37,54,-17,26
Young Boys,9824,1,21,7,4,69,35,34,70
FC Basel,9824,2,18,7,7,55,29,26,61
St Gallen,9824,3,15,3,14,45,54,-9,48
FC Zürich,9824,4,12,9,11,46,37,9,45
Lucerne,9824,5,11,8,13,37,42,-5,41
FC Thun,9824,6,10,5,17,45,59,-14,35
FC Sion,9824,7,9,7,16,42,52,-10,34
Grasshoppers,9824,8,9,7,16,40,51,-11,34
FC Lugano,9824,9,9,7,16,30,50,-20,34
Young Boys,9825,1,23,6,3,72,35,37,75
FC Basel,9825,2,16,9,7,54,29,25,57
St Gallen,9825,3,15,2,15,42,57,-15,47
Lucerne,9825,4,12,10,10,42,43,-1,46
FC Zürich,9825,5,10,11,11,40,36,4,41
FC Lugano,9825,6,10,6,16,32,47,-15,36
FC Thun,9825,7,9,7,16,46,61,-15,34
Grasshoppers,9825,8,8,8,16,39,49,-10,32
FC Sion,9825,9,7,9,16,42,52,-10,30
Young Boys,9826,1,21,6,5,70,35,35,69
FC Basel,9826,2,18,7,7,52,26,26,61
FC Zürich,9826,3,13,9,10,44,34,10,48
Lucerne,9826,4,12,9,11,43,47,-4,45
St Gallen,9826,5,14,2,16,43,58,-15,44
Grasshoppers,9826,6,11,7,14,47,47,0,40
FC Thun,9826,7,9,6,17,42,60,-18,33
FC Lugano,9826,8,9,6,17,29,48,-19,33
FC Sion,9826,9,7,8,17,40,55,-15,29
Young Boys,9827,1,19,9,4,67,39,28,66
FC Basel,9827,2,18,8,6,55,25,30,62
Lucerne,9827,3,12,8,12,43,50,-7,44
St Gallen,9827,4,14,2,16,47,61,-14,44
FC Zürich,9827,5,11,10,11,39,34,5,43
FC Lugano,9827,6,11,7,14,33,45,-12,40
FC Thun,9827,7,10,6,16,50,56,-6,36
Grasshoppers,9827,8,9,7,16,42,52,-10,34
FC Sion,9827,9,8,7,17,44,58,-14,31
Young Boys,9828,1,22,7,3,75,34,41,73
FC Basel,9828,2,16,9,7,51,28,23,57
Lucerne,9828,3,13,9,10,42,41,1,48
St Gallen,9828,4,15,3,14,45,52,-7,48
FC Zürich,9828,5,11,11,10,44,36,8,44
Grasshoppers,9828,6,10,6,16,41,50,-9,36
FC Lugano,9828,7,9,6,17,29,53,-24,33
FC Sion,9828,8,8,7,17,41,55,-14,31
FC Thun,9828,9,8,6,18,41,60,-19,30
Young Boys,9829,1,21,8,3,69,34,35,71
FC Basel,9829,2,17,8,7,53,24,29,59
St Gallen,9829,3,15,2,15,45,56,-11,47
Lucerne,9829,4,13,7,12,39,41,-2,46
FC Zürich,9829,5,11,11,10,41,34,7,44
FC Lugano,9829,6,10,7,15,31,46,-15,37
Grasshoppers,9829,7,10,6,16,43,50,-7,36
FC Thun,9829,8,10,5,17,43,62,-19,35
FC Sion,9829,9,6,8,18,40,57,-17,26
Young Boys,9830,1,21,8,3,72,33,39,71
FC Basel,9830,2,18,9,5,56,25,31,63
St Gallen,9830,3,14,3,15,42,55,-13,45
Lucerne,9830,4,11,11,10,41,43,-2,44
FC Zürich,9830,5,10,9,13,39,39,0,39
FC Thun,9830,6,10,6,16,43,58,-15,36
FC Lugano,9830,7,10,6,16,28,47,-19,36
Grasshoppers,9830,8,9,7,16,40,52,-12,34
FC Sion,9830,9,7,9,16,43,52,-9,30
Young Boys,9831,1,22,7,3,76,33,43,73
FC Basel,9831,2,16,10,6,51,26,25,58
Lucerne,9831,3,12,9,11,40,46,-6,45
St Gallen,9831,4,13,5,14,41,54,-13,44
FC Zürich,9831,5,10,9,13,40,38,2,39
FC Lugano,9831,6,11,5,16,32,47,-15,38
Grasshoppers,9831,7,10,7,15,40,48,-8,37
FC Thun,9831,8,10,6,16,46,57,-11,36
FC Sion,9831,9,7,8,17,38,55,-17,29
Young Boys,9832,1,22,6,4,69,37,32,72
FC Basel,9832,2,19,7,6,58,23,35,64
Lucerne,9832,3,13,8,11,48,43,5,47
FC Zürich,9832,4,12,9,11,42,38,4,45
St Gallen,9832,5,14,3,15,43,54,-11,45
FC Lugano,9832,6,11,5,16,32,49,-17,38
Grasshoppers,9832,7,9,7,16,40,52,-12,34
FC Thun,9832,8,9,5,18,42,63,-21,32
FC Sion,9832,9,6,8,18,41,56,-15,26
Young Boys,9833,1,23,7,2,72,33,39,76
FC Basel,9833,2,17,9,6,58,28,30,60
Lucerne,9833,3,13,9,10,42,42,0,48
St Gallen,9833,4,14,3,15,43,57,-14,45
FC Zürich,9833,5,11,10,11,47,37,10,43
FC Lugano,9833,6,11,6,15,34,49,-15,39
Grasshoppers,9833,7,9,6,17,41,53,-12,33
FC Thun,9833,8,8,5,19,44,68,-24,29
FC Sion,9833,9,7,7,18,45,59,-14,28
Young Boys,9834,1,20,6,6,69,38,31,66
FC Basel,9834,2,18,7,7,56,31,25,61
St Gallen,9834,3,14,4,14,48,58,-10,46
Lucerne,9834,4,12,9,11,42,44,-2,45
FC Zürich,9834,5,10,11,11,42,36,6,41
FC Lugano,9834,6,12,5,15,34,50,-16,41
Grasshoppers,9834,7,10,7,15,39,49,-10,37
FC Thun,9834,8,10,6,16,46,57,-11,36
FC Sion,9834,9,6,9,17,38,51,-13,27
Young Boys,9835,1,22,8,2,75,35,40,74
FC Basel,9835,2,16,10,6,53,27,26,58
St Gallen,9835,3,14,5,13,46,56,-10,47
Lucerne,9835,4,12,9,11,44,48,-4,45
FC Zürich,9835,5,11,10,11,43,37,6,43
Grasshoppers,9835,6,9,8,15,39,47,-8,35
FC Thun,9835,7,9,7,16,43,57,-14,34
FC Lugano,9835,8,9,7,16,31,48,-17,34
FC Sion,9835,9,6,8,18,40,59,-19,26
Young Boys,9836,1,22,6,4,70,35,35,72
FC Basel,9836,2,19,8,5,57,24,33,65
Lucerne,9836,3,13,7,12,43,44,-1,46
FC Zürich,9836,4,10,11,11,40,37,3,41
St Gallen,9836,5,13,2,17,39,57,-18,41
FC Lugano,9836,6,10,6,16,31,47,-16,36
Grasshoppers,9836,7,9,8,15,42,50,-8,35
FC Sion,9836,8,8,8,16,40,50,-10,32
FC Thun,9836,9,8,8,16,43,61,-18,32
Young Boys,9837,1,21,6,5,74,39,35,69
FC Basel,9837,2,18,7,7,52,25,27,61
Lucerne,9837,3,14,7,11,43,47,-4,49
St Gallen,9837,4,14,2,16,42,59,-17,44
FC Zürich,9837,5,11,10,11,40,36,4,43
FC Lugano,9837,6,11,5,16,35,49,-14,38
Grasshoppers,9837,7,9,7,16,40,48,-8,34
FC Sion,9837,8,8,9,15,48,53,-5,33
FC Thun,9837,9,8,7,17,40,58,-18,31
Young Boys,9838,1,20,9,3,71,38,33,69
FC Basel,9838,2,17,8,7,53,27,26,59
Lucerne,9838,3,14,7,11,45,42,3,49
St Gallen,9838,4,14,4,14,42,53,-11,46
FC Zürich,9838,5,11,10,11,41,34,7,43
Grasshoppers,9838,6,10,8,14,43,48,-5,38
FC Lugano,9838,7,10,7,15,33,50,-17,37
FC Thun,9838,8,9,7,16,41,58,-17,34
FC Sion,9838,9,5,8,19,38,57,-19,23
Young Boys,9839,1,23,7,2,73,33,40,76
FC Basel,9839,2,19,7,6,56,24,32,64
St Gallen,9839,3,15,3,14,44,55,-11,48
Lucerne,9839,4,11,10,11,40,44,-4,43
FC Zürich,9839,5,9,11,12,41,41,0,38
FC Lugano,9839,6,10,6,16,31,47,-16,36
Grasshoppers,9839,7,9,8,15,40,51,-11,35
FC Thun,9839,8,9,6,17,44,58,-14,33
FC Sion,9839,9,6,8,18,41,57,-16,26
Young Boys,9840,1,22,7,3,74,36,38,73
FC Basel,9840,2,20,7,5,55,23,32,67
Lucerne,9840,3,12,9,11,41,44,-3,45
St Gallen,9840,4,14,3,15,42,54,-12,45
FC Zürich,9840,5,10,10,12,39,35,4,40
FC Lugano,9840,6,10,7,15,31,47,-16,37
Grasshoppers,9840,7,8,9,15,42,51,-9,33
FC Thun,9840,8,9,6,17,43,61,-18,33
FC Sion,9840,9,6,8,18,40,56,-16,26
Young Boys,9841,1,22,6,4,73,36,37,72
FC Basel,9841,2,18,8,6,54,23,31,62
St Gallen,9841,3,16,3,13,42,49,-7,51
Lucerne,9841,4,13,7,12,40,44,-4,46
FC Zürich,9841,5,11,10,11,40,34,6,43
FC Thun,9841,6,10,6,16,46,57,-11,36
Grasshoppers,9841,7,9,6,17,39,54,-15,33
FC Lugano,9841,8,9,5,18,27,49,-22,32
FC Sion,9841,9,7,7,18,40,55,-15,28
Young Boys,9842,1,22,8,2,70,30,40,74
FC Basel,9842,2,18,8,6,55,24,31,62
St Gallen,9842,3,15,2,15,44,55,-11,47
Lucerne,9842,4,12,8,12,39,43,-4,44
FC Lugano,9842,5,11,6,15,33,46,-13,39
FC Zürich,9842,6,9,10,13,40,42,-2,37
Grasshoppers,9842,7,9,8,15,39,48,-9,35
FC Sion,9842,8,8,7,17,39,52,-13,31
FC Thun,9842,9,8,7,17,41,60,-19,31
Young Boys,9843,1,20,8,4,68,41,27,68
FC Basel,9843,2,17,8,7,53,24,29,59
Lucerne,9843,3,13,9,10,43,42,1,48
St Gallen,9843,4,14,3,15,39,54,-15,45
FC Zürich,9843,5,11,10,11,43,38,5,43
FC Lugano,9843,6,10,8,14,35,47,-12,38
Grasshoppers,9843,7,10,6,16,44,51,-7,36
FC Thun,9843,8,10,6,16,43,58,-15,36
FC Sion,9843,9,6,8,18,38,51,-13,26
Young Boys,9844,1,21,6,5,70,40,30,69
FC Basel,9844,2,19,7,6,58,26,32,64
Lucerne,9844,3,14,8,10,42,40,2,50
St Gallen,9844,4,13,3,16,41,57,-16,42
FC Zürich,9844,5,9,11,12,37,36,1,38
FC Thun,9844,6,10,6,16,45,59,-14,36
FC Lugano,9844,7,10,6,16,28,46,-18,36
Grasshoppers,9844,8,8,9,15,39,49,-10,33
FC Sion,9844,9,7,10,15,44,51,-7,31
Young Boys,9845,1,20,9,3,74,40,34,69
FC Basel,9845,2,19,8,5,61,26,35,65
Lucerne,9845,3,12,10,10,42,44,-2,46
FC Zürich,9845,4,12,9,11,46,39,7,45
St Gallen,9845,5,13,4,15,39,55,-16,43
FC Lugano,9845,6,10,7,15,33,47,-14,37
FC Thun,9845,7,10,5,17,49,61,-12,35
Grasshoppers,9845,8,8,8,16,41,53,-12,32
FC Sion,9845,9,6,8,18,41,61,-20,26
Young Boys,9846,1,22,6,4,71,33,38,72
FC Basel,9846,2,18,9,5,53,24,29,63
FC Zürich,9846,3,12,9,11,44,36,8,45
St Gallen,9846,4,14,3,15,44,58,-14,45
Lucerne,9846,5,12,8,12,39,44,-5,44
Grasshoppers,9846,6,11,6,15,43,49,-6,39
FC Lugano,9846,7,10,5,17,29,49,-20,35
FC Thun,9846,8,9,5,18,45,62,-17,32
FC Sion,9846,9,7,7,18,44,57,-13,28
Young Boys,9847,1,21,8,3,70,34,36,71
FC Basel,9847,2,19,7,6,56,25,31,64
St Gallen,9847,3,14,3,15,40,54,-14,45
FC Zürich,9847,4,11,11,10,45,35,10,44
Lucerne,9847,5,11,10,11,40,43,-3,43
FC Lugano,9847,6,10,6,16,30,48,-18,36
Grasshoppers,9847,7,9,7,16,43,51,-8,34
FC Thun,9847,8,9,6,17,46,66,-20,33
FC Sion,9847,9,6,10,16,38,52,-14,28
Young Boys,9848,1,21,8,3,77,38,39,71
FC Basel,9848,2,17,9,6,55,26,29,60
St Gallen,9848,3,14,4,14,45,55,-10,46
Lucerne,9848,4,12,9,11,42,46,-4,45
FC Zürich,9848,5,10,11,11,42,38,4,41
Grasshoppers,9848,6,10,7,15,41,50,-9,37
FC Thun,9848,7,9,7,16,43,58,-15,34
FC Lugano,9848,8,9,7,16,31,52,-21,34
FC Sion,9848,9,6,10,16,41,54,-13,28
Young Boys,9849,1,20,8,4,70,38,32,68
FC Basel,9849,2,19,7,6,56,25,31,64
Lucerne,9849,3,13,9,10,41,43,-2,48
St Gallen,9849,4,14,2,16,41,55,-14,44
FC Lugano,9849,5,11,7,14,34,44,-10,40
FC Thun,9849,6,11,5,16,47,57,-10,38
FC Zürich,9849,7,9,10,13,40,43,-3,37
FC Sion,9849,8,8,7,17,45,56,-11,31
Grasshoppers,9849,9,8,7,17,40,53,-13,31
Young Boys,9850,1,19,8,5,70,42,28,65
FC Basel,9850,2,18,9,5,57,25,32,63
St Gallen,9850,3,14,4,14,49,56,-7,46
Lucerne,9850,4,12,9,11,39,44,-5,45
FC Lugano,9850,5,12,5,15,32,46,-14,41
FC Zürich,9850,6,10,9,13,39,37,2,39
Grasshoppers,9850,7,9,8,15,40,49,-9,35
FC Sion,9850,8,8,9,15,42,52,-10,33
FC Thun,9850,9,9,5,18,42,59,-17,32
Young Boys,9851,1,21,9,2,72,36,36,72
FC Basel,9851,2,17,9,6,58,29,29,60
FC Zürich,9851,3,12,10,10,44,36,8,46
Lucerne,9851,4,12,10,10,43,47,-4,46
St Gallen,9851,5,14,4,14,44,55,-11,46
Grasshoppers,9851,6,10,8,14,45,49,-4,38
FC Thun,9851,7,9,6,17,43,59,-16,33
FC Lugano,9851,8,9,5,18,28,47,-19,32
FC Sion,9851,9,5,9,18,38,57,-19,24
Young Boys,9852,1,23,6,3,73,32,41,75
FC Basel,9852,2,16,7,9,50,31,19,55
Lucerne,9852,3,13,8,11,44,44,0,47
St Gallen,9852,4,14,5,13,42,52,-10,47
FC Zürich,9852,5,10,12,10,41,36,5,42
Grasshoppers,9852,6,11,6,15,47,52,-5,39
FC Thun,9852,7,10,6,16,50,63,-13,36
FC Lugano,9852,8,9,7,16,27,47,-20,34
FC Sion,9852,9,5,9,18,40,57,-17,24
Young Boys,9853,1,20,8,4,70,37,33,68
FC Basel,9853,2,17,9,6,57,28,29,60
St Gallen,9853,3,15,4,13,47,55,-8,49
Lucerne,9853,4,13,7,12,45,47,-2,46
FC Zürich,9853,5,11,11,10,42,36,6,44
FC Lugano,9853,6,10,6,16,31,47,-16,36
Grasshoppers,9853,7,9,7,16,43,57,-14,34
FC Thun,9853,8,9,6,17,44,59,-15,33
FC Sion,9853,9,6,10,16,42,55,-13,28
Young Boys,9854,1,22,7,3,72,33,39,73
FC Basel,9854,2,20,7,5,57,23,34,67
FC Zürich,9854,3,12,9,11,41,35,6,45
Lucerne,9854,4,12,9,11,43,44,-1,45
St Gallen,9854,5,13,4,15,43,60,-17,43
FC Lugano,9854,6,10,7,15,33,45,-12,37
Grasshoppers,9854,7,9,6,17,40,54,-14,33
FC Thun,9854,8,9,5,18,43,65,-22,32
FC Sion,9854,9,6,8,18,40,53,-13,26
Young Boys,9855,1,22,6,4,70,34,36,72
FC Basel,9855,2,18,9,5,54,22,32,63
St Gallen,9855,3,14,4,14,41,52,-11,46
Lucerne,9855,4,12,9,11,40,45,-5,45
FC Zürich,9855,5,10,10,12,41,40,1,40
FC Lugano,9855,6,11,5,16,33,47,-14,38
FC Thun,9855,7,9,7,16,41,58,-17,34
Grasshoppers,9855,8,8,8,16,40,50,-10,32
FC Sion,9855,9,6,10,16,38,50,-12,28
Young Boys,9856,1,20,7,5,70,38,32,67
FC Basel,9856,2,17,8,7,51,25,26,59
Lucerne,9856,3,14,8,10,45,42,3,50
St Gallen,9856,4,14,4,14,42,57,-15,46
FC Zürich,9856,5,10,11,11,40,36,4,41
FC Lugano,9856,6,11,6,15,31,45,-14,39
Grasshoppers,9856,7,10,6,16,43,54,-11,36
FC Thun,9856,8,9,7,16,44,57,-13,34
FC Sion,9856,9,6,9,17,42,54,-12,27
Young Boys,9857,1,21,7,4,68,37,31,70
FC Basel,9857,2,19,7,6,59,23,36,64
St Gallen,9857,3,14,2,16,43,56,-13,44
Lucerne,9857,4,12,7,13,39,50,-11,43
FC Zürich,9857,5,11,9,12,42,39,3,42
FC Lugano,9857,6,12,6,14,37,44,-7,42
FC Thun,9857,7,11,5,16,46,56,-10,38
Grasshoppers,9857,8,10,7,15,41,49,-8,37
FC Sion,9857,9,5,8,19,38,59,-21,23
Young Boys,9858,1,21,7,4,71,35,36,70
FC Basel,9858,2,16,7,9,50,30,20,55
Lucerne,9858,3,13,8,11,48,46,2,47
St Gallen,9858,4,14,3,15,40,55,-15,45
FC Zürich,9858,5,11,10,11,43,38,5,43
FC Sion,9858,6,10,7,15,44,52,-8,37
FC Thun,9858,7,10,5,17,43,57,-14,35
FC Lugano,9858,8,9,8,15,32,49,-17,35
Grasshoppers,9858,9,9,7,16,42,51,-9,34
Young Boys,9859,1,20,8,4,71,34,37,68
FC Basel,9859,2,16,10,6,52,27,25,58
St Gallen,9859,3,14,4,14,45,58,-13,46
Lucerne,9859,4,12,9,11,41,47,-6,45
FC Zürich,9859,5,11,11,10,44,38,6,44
Grasshoppers,9859,6,10,7,15,42,48,-6,37
FC Lugano,9859,7,10,6,16,32,48,-16,36
FC Thun,9859,8,9,6,17,45,60,-15,33
FC Sion,9859,9,7,9,16,43,55,-12,30
Young Boys,9860,1,21,6,5,69,32,37,69
FC Basel,9860,2,18,9,5,53,24,29,63
Lucerne,9860,3,13,8,11,48,47,1,47
St Gallen,9860,4,14,2,16,44,60,-16,44
FC Zürich,9860,5,10,10,12,39,37,2,40
Grasshoppers,9860,6,10,7,15,41,49,-8,37
FC Thun,9860,7,10,6,16,45,57,-12,36
FC Lugano,9860,8,10,5,17,31,53,-22,35
FC Sion,9860,9,8,7,17,41,52,-11,31
Young Boys,9861,1,22,8,2,74,35,39,74
FC Basel,9861,2,16,9,7,55,30,25,57
Lucerne,9861,3,11,10,11,43,51,-8,43
St Gallen,9861,4,13,4,15,44,58,-14,43
FC Zürich,9861,5,10,10,12,44,38,6,40
FC Lugano,9861,6,11,6,15,32,46,-14,39
FC Thun,9861,7,10,6,16,44,58,-14,36
Grasshoppers,9861,8,8,9,15,43,52,-9,33
FC Sion,9861,9,8,8,16,45,56,-11,32
Young Boys,9862,1,22,6,4,77,38,39,72
FC Basel,9862,2,19,7,6,56,25,31,64
Lucerne,9862,3,13,7,12,44,46,-2,46
St Gallen,9862,4,13,2,17,40,57,-17,41
Grasshoppers,9862,5,11,7,14,44,47,-3,40
FC Zürich,9862,6,10,9,13,38,38,0,39
FC Lugano,9862,7,11,5,16,35,48,-13,38
FC Thun,9862,8,10,6,16,42,57,-15,36
FC Sion,9862,9,7,7,18,38,58,-20,28
Young Boys,9863,1,21,7,4,73,38,35,70
FC Basel,9863,2,16,10,6,54,28,26,58
Lucerne,9863,3,14,9,9,49,46,3,51
St Gallen,9863,4,13,4,15,42,56,-14,43
FC Thun,9863,5,11,6,15,47,57,-10,39
FC Lugano,9863,6,11,6,15,32,47,-15,39
FC Zürich,9863,7,9,10,13,39,39,0,37
Grasshoppers,9863,8,9,7,16,45,56,-11,34
FC Sion,9863,9,7,7,18,41,55,-14,28
Young Boys,9864,1,23,6,3,70,34,36,75
FC Basel,9864,2,17,7,8,57,27,30,58
St Gallen,9864,3,15,3,14,46,56,-10,48
Lucerne,9864,4,13,8,11,44,46,-2,47
FC Zürich,9864,5,12,10,10,45,35,10,46
Grasshoppers,9864,6,10,6,16,45,50,-5,36
FC Lugano,9864,7,10,6,16,32,49,-17,36
FC Thun,9864,8,9,5,18,43,68,-25,32
FC Sion,9864,9,6,7,19,40,57,-17,25
Young Boys,9865,1,21,6,5,69,39,30,69
FC Basel,9865,2,18,8,6,54,24,30,62
Lucerne,9865,3,14,9,9,48,39,9,51
FC Zürich,9865,4,12,10,10,42,33,9,46
St Gallen,9865,5,13,3,16,41,57,-16,42
FC Lugano,9865,6,10,7,15,30,45,-15,37
Grasshoppers,9865,7,9,8,15,40,50,-10,35
FC Thun,9865,8,8,6,18,44,66,-22,30
FC Sion,9865,9,6,9,17,42,57,-15,27
Young Boys,9866,1,21,7,4,69,36,33,70
FC Basel,9866,2,18,8,6,51,23,28,62
Lucerne,9866,3,13,9,10,43,43,0,48
St Gallen,9866,4,15,2,15,43,54,-11,47
FC Zürich,9866,5,11,9,12,42,36,6,42
FC Lugano,9866,6,12,5,15,33,45,-12,41
Grasshoppers,9866,7,10,8,14,44,49,-5,38
FC Thun,9866,8,9,5,18,41,57,-16,32
FC Sion,9866,9,5,7,20,38,61,-23,22
Young Boys,9867,1,23,6,3,69,32,37,75
FC Basel,9867,2,16,7,9,50,35,15,55
Lucerne,9867,3,13,8,11,44,45,-1,47
St Gallen,9867,4,14,3,15,49,55,-6,45
FC Zürich,9867,5,11,10,11,40,36,4,43
FC Lugano,9867,6,11,5,16,32,46,-14,38
Grasshoppers,9867,7,9,8,15,43,50,-7,35
FC Thun,9867,8,10,5,17,44,60,-16,35
FC Sion,9867,9,6,10,16,42,54,-12,28
Young Boys,9868,1,23,6,3,75,32,43,75
FC Basel,9868,2,20,7,5,53,21,32,67
St Gallen,9868,3,14,4,14,44,55,-11,46
Lucerne,9868,4,12,7,13,40,46,-6,43
Grasshoppers,9868,5,11,6,15,43,49,-6,39
FC Zürich,9868,6,9,11,12,38,39,-1,38
FC Lugano,9868,7,9,7,16,31,51,-20,34
FC Thun,9868,8,9,6,17,43,59,-16,33
FC Sion,9868,9,5,10,17,40,55,-15,25
Young Boys,9869,1,20,9,3,69,32,37,69
FC Basel,9869,2,19,8,5,60,23,37,65
Lucerne,9869,3,13,7,12,42,46,-4,46
St Gallen,9869,4,13,3,16,40,59,-19,42
FC Zürich,9869,5,10,11,11,39,35,4,41
FC Lugano,9869,6,11,6,15,32,45,-13,39
Grasshoppers,9869,7,10,7,15,43,54,-11,37
FC Thun,9869,8,9,7,16,47,63,-16,34
FC Sion,9869,9,5,10,17,40,55,-15,25
Young Boys,9870,1,23,6,3,74,35,39,75
FC Basel,9870,2,18,8,6,61,29,32,62
Lucerne,9870,3,14,7,11,45,47,-2,49
FC Zürich,9870,4,11,11,10,42,36,6,44
St Gallen,9870,5,13,2,17,41,58,-17,41
Grasshoppers,9870,6,10,6,16,39,47,-8,36
FC Lugano,9870,7,10,5,17,32,51,-19,35
FC Thun,9870,8,9,5,18,44,62,-18,32
FC Sion,9870,9,7,8,17,41,54,-13,29
Young Boys,9871,1,22,7,3,76,35,41,73
FC Basel,9871,2,17,10,5,56,27,29,61
St Gallen,9871,3,14,3,15,43,57,-14,45
FC Zürich,9871,4,10,12,10,40,35,5,42
Lucerne,9871,5,11,8,13,42,51,-9,41
FC Lugano,9871,6,11,6,15,34,48,-14,39
Grasshoppers,9871,7,9,9,14,45,52,-7,36
FC Thun,9871,8,8,8,16,45,61,-16,32
FC Sion,9871,9,6,9,17,39,54,-15,27
Young Boys,9872,1,23,6,3,72,34,38,75
FC Basel,9872,2,17,8,7,59,32,27,59
FC Zürich,9872,3,12,10,10,45,36,9,46
Lucerne,9872,4,12,8,12,40,47,-7,44
St Gallen,9872,5,13,4,15,42,56,-14,43
FC Lugano,9872,6,11,6,15,31,45,-14,39
Grasshoppers,9872,7,10,7,15,43,48,-5,37
FC Thun,9872,8,8,8,16,42,59,-17,32
FC Sion,9872,9,5,9,18,37,54,-17,24
Young Boys,9873,1,23,6,3,74,32,42,75
FC Basel,9873,2,18,7,7,53,27,26,61
St Gallen,9873,3,15,3,14,43,52,-9,48
Lucerne,9873,4,12,7,13,40,46,-6,43
FC Zürich,9873,5,10,11,11,39,35,4,41
FC Lugano,9873,6,11,6,15,31,45,-14,39
Grasshoppers,9873,7,10,6,16,43,53,-10,36
FC Thun,9873,8,10,6,16,44,56,-12,36
FC Sion,9873,9,5,8,19,36,57,-21,23
Young Boys,9874,1,22,7,3,76,38,38,73
FC Basel,9874,2,16,11,5,56,30,26,59
Lucerne,9874,3,14,8,10,43,43,0,50
St Gallen,9874,4,13,4,15,39,54,-15,43
FC Zürich,9874,5,9,12,11,41,38,3,39
FC Thun,9874,6,10,6,16,46,58,-12,36
FC Lugano,9874,7,10,6,16,33,48,-15,36
Grasshoppers,9874,8,8,7,17,43,56,-13,31
FC Sion,9874,9,7,9,16,43,55,-12,30
Young Boys,9875,1,20,8,4,70,37,33,68
FC Basel,9875,2,19,7,6,59,26,33,64
St Gallen,9875,3,15,2,15,44,54,-10,47
FC Zürich,9875,4,11,10,11,41,35,6,43
Lucerne,9875,5,11,10,11,42,48,-6,43
FC Lugano,9875,6,10,6,16,30,47,-17,36
Grasshoppers,9875,7,9,8,15,42,50,-8,35
FC Thun,9875,8,10,5,17,43,62,-19,35
FC Sion,9875,9,6,10,16,39,51,-12,28
FC Basel,9876,1,20,7,5,59,22,37,67
Young Boys,9876,2,20,6,6,67,40,27,66
St Gallen,9876,3,15,2,15,41,54,-13,47
Lucerne,9876,4,13,7,12,44,47,-3,46
FC Zürich,9876,5,11,9,12,40,36,4,42
FC Thun,9876,6,11,5,16,45,57,-12,38
FC Lugano,9876,7,11,5,16,31,46,-15,38
Grasshoppers,9876,8,10,6,16,43,51,-8,36
FC Sion,9876,9,6,7,19,40,57,-17,25
Young Boys,9877,1,21,9,2,71,35,36,72
FC Basel,9877,2,16,9,7,51,25,26,57
St Gallen,9877,3,16,3,13,44,51,-7,51
Lucerne,9877,4,13,8,11,42,43,-1,47
FC Zürich,9877,5,11,11,10,45,37,8,44
Grasshoppers,9877,6,10,6,16,41,48,-7,36
FC Lugano,9877,7,9,6,17,29,48,-19,33
FC Thun,9877,8,9,5,18,42,63,-21,32
FC Sion,9877,9,6,9,17,42,57,-15,27
Young Boys,9878,1,22,7,3,73,32,41,73
FC Basel,9878,2,19,8,5,58,28,30,65
Lucerne,9878,3,14,8,10,43,45,-2,50
St Gallen,9878,4,14,3,15,45,57,-12,45
FC Zürich,9878,5,9,12,11,43,40,3,39
FC Thun,9878,6,10,6,16,44,59,-15,36
FC Lugano,9878,7,9,7,16,31,49,-18,34
Grasshoppers,9878,8,8,7,17,39,51,-12,31
FC Sion,9878,9,5,10,17,38,53,-15,25
Young Boys,9879,1,21,6,5,76,40,36,69
FC Basel,9879,2,18,8,6,59,28,31,62
St Gallen,9879,3,16,2,14,43,54,-11,50
Lucerne,9879,4,14,7,11,42,43,-1,49
FC Zürich,9879,5,11,11,10,40,34,6,44
Grasshoppers,9879,6,9,7,16,38,48,-10,34
FC Lugano,9879,7,9,6,17,28,48,-20,33
FC Thun,9879,8,9,5,18,41,61,-20,32
FC Sion,9879,9,7,8,17,41,52,-11,29
Young Boys,9880,1,22,6,4,73,35,38,72
FC Basel,9880,2,17,10,5,52,25,27,61
Lucerne,9880,3,13,8,11,43,46,-3,47
St Gallen,9880,4,13,4,15,43,56,-13,43
FC Zürich,9880,5,9,11,12,39,38,1,38
Grasshoppers,9880,6,10,7,15,43,49,-6,37
FC Lugano,9880,7,10,7,15,34,50,-16,37
FC Thun,9880,8,9,7,16,42,56,-14,34
FC Sion,9880,9,7,8,17,38,52,-14,29
Young Boys,9881,1,21,7,4,73,36,37,70
FC Basel,9881,2,15,10,7,49,27,22,55
St Gallen,9881,3,15,3,14,44,54,-10,48
Lucerne,9881,4,11,10,11,43,47,-4,43
FC Lugano,9881,5,12,5,15,36,49,-13,41
FC Zürich,9881,6,10,10,12,40,37,3,40
Grasshoppers,9881,7,9,8,15,40,51,-11,35
FC Sion,9881,8,8,9,15,43,51,-8,33
FC Thun,9881,9,8,8,16,41,57,-16,32
Young Boys,9882,1,23,7,2,71,32,39,76
FC Basel,9882,2,17,8,7,51,26,25,59
Lucerne,9882,3,13,7,12,48,50,-2,46
St Gallen,9882,4,14,3,15,44,53,-9,45
Grasshoppers,9882,5,11,6,15,44,48,-4,39
FC Lugano,9882,6,11,6,15,33,51,-18,39
FC Zürich,9882,7,9,11,12,37,36,1,38
FC Thun,9882,8,8,6,18,41,60,-19,30
FC Sion,9882,9,7,8,17,37,50,-13,29
Young Boys,9883,1,20,7,5,71,40,31,67
FC Basel,9883,2,18,7,7,59,29,30,61
St Gallen,9883,3,15,4,13,46,55,-9,49
Lucerne,9883,4,13,9,10,46,47,-1,48
FC Zürich,9883,5,10,11,11,40,37,3,41
Grasshoppers,9883,6,10,8,14,46,51,-5,38
FC Lugano,9883,7,10,6,16,33,49,-16,36
FC Thun,9883,8,8,6,18,41,61,-20,30
FC Sion,9883,9,5,12,15,41,54,-13,27
Young Boys,9884,1,22,6,4,75,35,40,72
FC Basel,9884,2,18,7,7,55,27,28,61
Lucerne,9884,3,13,8,11,43,46,-3,47
St Gallen,9884,4,14,3,15,42,58,-16,45
FC Lugano,9884,5,12,5,15,34,48,-14,41
FC Zürich,9884,6,10,9,13,42,39,3,39
Grasshoppers,9884,7,11,6,15,45,47,-2,39
FC Thun,9884,8,10,5,17,45,60,-15,35
FC Sion,9884,9,6,7,19,40,61,-21,25
Young Boys,9885,1,19,8,5,68,38,30,65
FC Basel,9885,2,17,9,6,55,28,27,60
Lucerne,9885,3,14,9,9,48,43,5,51
St Gallen,9885,4,13,5,14,42,55,-13,44
FC Zürich,9885,5,10,11,11,39,36,3,41
FC Lugano,9885,6,10,7,15,32,47,-15,37
Grasshoppers,9885,7,10,6,16,42,49,-7,36
FC Thun,9885,8,9,5,18,40,59,-19,32
FC Sion,9885,9,7,10,15,40,51,-11,31
Young Boys,9886,1,22,7,3,75,34,41,73
FC Basel,9886,2,18,9,5,54,22,32,63
Lucerne,9886,3,12,9,11,40,47,-7,45
St Gallen,9886,4,13,6,13,44,55,-11,45
FC Zürich,9886,5,10,11,11,41,37,4,41
FC Thun,9886,6,9,7,16,41,56,-15,34
FC Lugano,9886,7,9,7,16,34,53,-19,34
Grasshoppers,9886,8,8,7,17,38,50,-12,31
FC Sion,9886,9,7,9,16,42,55,-13,30
Young Boys,9887,1,20,8,4,69,37,32,68
FC Basel,9887,2,18,8,6,55,25,30,62
St Gallen,9887,3,14,4,14,43,53,-10,46
Lucerne,9887,4,12,8,12,41,43,-2,44
FC Zürich,9887,5,10,9,13,40,40,0,39
FC Lugano,9887,6,10,7,15,28,45,-17,37
FC Thun,9887,7,10,6,16,47,61,-14,36
Grasshoppers,9887,8,9,7,16,38,48,-10,34
FC Sion,9887,9,8,9,15,42,51,-9,33
Young Boys,9888,1,20,8,4,70,37,33,68
FC Basel,9888,2,18,8,6,58,24,34,62
Lucerne,9888,3,14,8,10,42,41,1,50
St Gallen,9888,4,14,2,16,41,60,-19,44
FC Zürich,9888,5,11,9,12,40,38,2,42
FC Lugano,9888,6,12,5,15,35,47,-12,41
Grasshoppers,9888,7,9,8,15,43,51,-8,35
FC Thun,9888,8,9,7,16,43,57,-14,34
FC Sion,9888,9,6,7,19,40,57,-17,25
Young Boys,9889,1,22,6,4,72,38,34,72
FC Basel,9889,2,16,9,7,55,31,24,57
Lucerne,9889,3,14,7,11,46,44,2,49
FC Zürich,9889,4,13,9,10,46,33,13,48
St Gallen,9889,5,15,3,14,43,52,-9,48
Grasshoppers,9889,6,10,6,16,42,50,-8,36
FC Thun,9889,7,10,6,16,47,58,-11,36
FC Lugano,9889,8,10,5,17,30,49,-19,35
FC Sion,9889,9,5,7,20,36,62,-26,22
Young Boys,9890,1,23,6,3,74,36,38,75
FC Basel,9890,2,17,9,6,53,27,26,60
St Gallen,9890,3,15,3,14,42,51,-9,48
Lucerne,9890,4,13,8,11,42,45,-3,47
FC Zürich,9890,5,12,9,11,49,37,12,45
FC Lugano,9890,6,10,5,17,30,50,-20,35
FC Thun,9890,7,9,7,16,46,62,-16,34
Grasshoppers,9890,8,8,7,17,39,51,-12,31
FC Sion,9890,9,5,10,17,42,58,-16,25
Young Boys,9891,1,22,7,3,74,37,37,73
FC Basel,9891,2,19,8,5,55,26,29,65
Lucerne,9891,3,13,9,10,45,45,0,48
St Gallen,9891,4,15,2,15,45,54,-9,47
FC Zürich,9891,5,11,10,11,45,38,7,43
FC Thun,9891,6,10,5,17,43,57,-14,35
FC Lugano,9891,7,10,5,17,30,51,-21,35
Grasshoppers,9891,8,9,6,17,41,52,-11,33
FC Sion,9891,9,5,8,19,43,61,-18,23
Young Boys,9892,1,20,9,3,70,35,35,69
FC Basel,9892,2,18,8,6,54,26,28,62
Lucerne,9892,3,13,8,11,42,44,-2,47
St Gallen,9892,4,14,3,15,41,53,-12,45
FC Zürich,9892,5,11,9,12,46,39,7,42
FC Lugano,9892,6,11,6,15,35,49,-14,39
FC Thun,9892,7,10,6,16,43,57,-14,36
Grasshoppers,9892,8,9,6,17,41,52,-11,33
FC Sion,9892,9,6,9,17,40,57,-17,27
Young Boys,9893,1,22,8,2,71,32,39,74
FC Basel,9893,2,18,7,7,57,25,32,61
St Gallen,9893,3,14,2,16,44,59,-15,44
FC Zürich,9893,4,11,10,11,41,34,7,43
Lucerne,9893,5,11,8,13,39,47,-8,41
FC Lugano,9893,6,11,6,15,32,46,-14,39
FC Thun,9893,7,11,5,16,45,60,-15,38
Grasshoppers,9893,8,10,6,16,42,51,-9,36
FC Sion,9893,9,6,8,18,40,57,-17,26
Young Boys,9894,1,23,6,3,77,32,45,75
FC Basel,9894,2,18,7,7,54,28,26,61
St Gallen,9894,3,15,3,14,47,56,-9,48
Lucerne,9894,4,12,8,12,39,46,-7,44
FC Zürich,9894,5,11,10,11,44,38,6,43
Grasshoppers,9894,6,10,7,15,42,50,-8,37
FC Thun,9894,7,10,6,16,47,60,-13,36
FC Lugano,9894,8,9,6,17,30,51,-21,33
FC Sion,9894,9,5,9,18,44,63,-19,24
Young Boys,9895,1,22,7,3,75,31,44,73
FC Basel,9895,2,17,8,7,55,30,25,59
Lucerne,9895,3,13,8,11,46,50,-4,47
St Gallen,9895,4,14,4,14,41,53,-12,46
FC Zürich,9895,5,11,10,11,42,36,6,43
FC Lugano,9895,6,10,7,15,28,47,-19,37
FC Thun,9895,7,10,5,17,48,61,-13,35
Grasshoppers,9895,8,8,8,16,40,53,-13,32
FC Sion,9895,9,6,9,17,41,55,-14,27
Young Boys,9896,1,21,6,5,68,37,31,69
FC Basel,9896,2,19,7,6,55,25,30,64
Lucerne,9896,3,15,7,10,45,43,2,52
FC Zürich,9896,4,11,9,12,40,36,4,42
St Gallen,9896,5,13,3,16,43,57,-14,42
Grasshoppers,9896,6,10,6,16,43,47,-4,36
FC Thun,9896,7,10,5,17,43,59,-16,35
FC Lugano,9896,8,9,6,17,30,49,-19,33
FC Sion,9896,9,8,7,17,40,54,-14,31
Young Boys,9897,1,22,7,3,70,34,36,73
FC Basel,9897,2,15,10,7,51,28,23,55
Lucerne,9897,3,14,9,9,43,40,3,51
FC Zürich,9897,4,11,11,10,46,36,10,44
St Gallen,9897,5,13,4,15,43,57,-14,43
FC Lugano,9897,6,10,7,15,32,49,-17,37
FC Thun,9897,7,10,6,16,46,58,-12,36
Grasshoppers,9897,8,8,7,17,40,52,-12,31
FC Sion,9897,9,6,9,17,42,59,-17,27
Young Boys,9898,1,21,8,3,70,37,33,71
FC Basel,9898,2,16,9,7,52,28,24,57
St Gallen,9898,3,16,3,13,51,53,-2,51
Lucerne,9898,4,12,9,11,42,46,-4,45
FC Zürich,9898,5,10,11,11,41,35,6,41
FC Thun,9898,6,10,6,16,43,58,-15,36
FC Lugano,9898,7,9,8,15,31,47,-16,35
Grasshoppers,9898,8,9,6,17,41,52,-11,33
FC Sion,9898,9,7,8,17,43,58,-15,29
Young Boys,9899,1,21,6,5,67,35,32,69
FC Basel,9899,2,19,7,6,57,24,33,64
Lucerne,9899,3,13,7,12,42,43,-1,46
FC Zürich,9899,4,11,11,10,43,37,6,44
Grasshoppers,9899,5,12,6,14,41,45,-4,42
St Gallen,9899,6,13,3,16,41,60,-19,42
FC Lugano,9899,7,11,5,16,37,49,-12,38
FC Thun,9899,8,9,6,17,41,59,-18,33
FC Sion,9899,9,5,9,18,38,55,-17,24
Young Boys,9900,1,21,8,3,71,33,38,71
FC Basel,9900,2,18,8,6,53,26,27,62
FC Zürich,9900,3,12,9,11,43,37,6,45
St Gallen,9900,4,14,3,15,43,55,-12,45
Lucerne,9900,5,12,7,13,40,48,-8,43
FC Sion,9900,6,9,8,15,44,51,-7,35
FC Lugano,9900,7,10,5,17,32,49,-17,35
Grasshoppers,9900,8,9,7,16,42,51,-9,34
FC Thun,9900,9,9,5,18,43,61,-18,32
Young Boys,9901,1,22,8,2,71,31,40,74
FC Basel,9901,2,17,10,5,50,22,28,61
Lucerne,9901,3,12,8,12,45,53,-8,44
St Gallen,9901,4,13,5,14,42,56,-14,44
FC Zürich,9901,5,11,10,11,39,34,5,43
Grasshoppers,9901,6,10,7,15,45,50,-5,37
FC Lugano,9901,7,10,6,16,33,49,-16,36
FC Thun,9901,8,9,7,16,43,57,-14,34
FC Sion,9901,9,5,9,18,37,53,-16,24
Young Boys,9902,1,20,7,5,69,36,33,67
FC Basel,9902,2,17,9,6,50,24,26,60
Lucerne,9902,3,14,8,10,41,41,0,50
St Gallen,9902,4,15,2,15,42,53,-11,47
FC Zürich,9902,5,11,9,12,41,36,5,42
FC Lugano,9902,6,12,5,15,32,45,-13,41
Grasshoppers,9902,7,9,7,16,40,49,-9,34
FC Thun,9902,8,9,6,17,43,59,-16,33
FC Sion,9902,9,7,7,18,39,54,-15,28
Young Boys,9903,1,21,8,3,73,36,37,71
FC Basel,9903,2,19,8,5,58,23,35,65
St Gallen,9903,3,15,2,15,46,55,-9,47
Lucerne,9903,4,12,8,12,42,50,-8,44
FC Zürich,9903,5,10,10,12,38,37,1,40
Grasshoppers,9903,6,10,8,14,46,50,-4,38
FC Thun,9903,7,9,6,17,44,61,-17,33
FC Lugano,9903,8,9,6,17,29,50,-21,33
FC Sion,9903,9,7,8,17,42,56,-14,29
Young Boys,9904,1,20,7,5,70,41,29,67
FC Basel,9904,2,19,7,6,56,25,31,64
St Gallen,9904,3,14,4,14,40,51,-11,46
Lucerne,9904,4,11,9,12,41,49,-8,42
FC Zürich,9904,5,10,9,13,37,40,-3,39
FC Lugano,9904,6,11,6,15,32,46,-14,39
FC Thun,9904,7,11,5,16,48,59,-11,38
Grasshoppers,9904,8,10,6,16,45,50,-5,36
FC Sion,9904,9,8,7,17,46,54,-8,31
Young Boys,9905,1,19,7,6,67,40,27,64
FC Basel,9905,2,18,9,5,53,23,30,63
Lucerne,9905,3,13,10,9,42,40,2,49
FC Zürich,9905,4,11,11,10,43,35,8,44
St Gallen,9905,5,14,2,16,44,57,-13,44
Grasshoppers,9905,6,10,7,15,43,51,-8,37
FC Lugano,9905,7,10,6,16,31,49,-18,36
FC Thun,9905,8,10,5,17,46,60,-14,35
FC Sion,9905,9,7,7,18,42,56,-14,28
Young Boys,9906,1,21,8,3,77,36,41,71
FC Basel,9906,2,18,8,6,56,28,28,62
St Gallen,9906,3,15,3,14,45,60,-15,48
Lucerne,9906,4,13,7,12,44,48,-4,46
FC Zürich,9906,5,10,10,12,40,37,3,40
FC Thun,9906,6,10,6,16,43,57,-14,36
FC Lugano,9906,7,9,7,16,33,52,-19,34
Grasshoppers,9906,8,8,8,16,42,53,-11,32
FC Sion,9906,9,8,7,17,46,55,-9,31
Young Boys,9907,1,22,6,4,71,36,35,72
FC Basel,9907,2,19,7,6,62,24,38,64
Lucerne,9907,3,13,8,11,44,47,-3,47
St Gallen,9907,4,13,4,15,44,59,-15,43
FC Zürich,9907,5,11,9,12,41,38,3,42
Grasshoppers,9907,6,11,6,15,49,52,-3,39
FC Lugano,9907,7,11,5,16,30,47,-17,38
FC Thun,9907,8,10,5,17,45,61,-16,35
FC Sion,9907,9,5,8,19,39,61,-22,23
Young Boys,9908,1,22,7,3,70,32,38,73
FC Basel,9908,2,17,8,7,54,28,26,59
St Gallen,9908,3,16,2,14,50,52,-2,50
Lucerne,9908,4,13,7,12,42,48,-6,46
FC Zürich,9908,5,12,9,11,43,36,7,45
FC Lugano,9908,6,10,5,17,29,51,-22,35
Grasshoppers,9908,7,9,7,16,40,49,-9,34
FC Sion,9908,8,8,8,16,42,53,-11,32
FC Thun,9908,9,8,5,19,44,65,-21,29
Young Boys,9909,1,23,7,2,76,34,42,76
FC Basel,9909,2,17,8,7,52,27,25,59
St Gallen,9909,3,15,2,15,45,56,-11,47
Lucerne,9909,4,12,7,13,39,44,-5,43
FC Zürich,9909,5,10,11,11,38,34,4,41
FC Thun,9909,6,10,6,16,43,57,-14,36
Grasshoppers,9909,7,9,7,16,38,49,-11,34
FC Lugano,9909,8,9,6,17,29,50,-21,33
FC Sion,9909,9,8,8,16,46,55,-9,32
Young Boys,9910,1,21,6,5,74,38,36,69
FC Basel,9910,2,20,7,5,59,24,35,67
Lucerne,9910,3,14,8,10,49,45,4,50
St Gallen,9910,4,14,3,15,45,56,-11,45
FC Zürich,9910,5,10,11,11,45,39,6,41
FC Lugano,9910,6,10,6,16,30,53,-23,36
FC Thun,9910,7,9,7,16,46,63,-17,34
Grasshoppers,9910,8,8,8,16,37,48,-11,32
FC Sion,9910,9,6,8,18,39,58,-19,26
Young Boys,9911,1,21,8,3,70,37,33,71
FC Basel,9911,2,18,7,7,55,27,28,61
St Gallen,9911,3,15,2,15,41,51,-10,47
FC Zürich,9911,4,12,9,11,47,41,6,45
Lucerne,9911,5,12,9,11,41,43,-2,45
FC Lugano,9911,6,10,6,16,31,49,-18,36
FC Thun,9911,7,10,5,17,46,61,-15,35
FC Sion,9911,8,8,7,17,48,54,-6,31
Grasshoppers,9911,9,8,7,17,40,56,-16,31
Young Boys,9912,1,23,7,2,75,33,42,76
FC Basel,9912,2,17,9,6,53,27,26,60
St Gallen,9912,3,15,2,15,46,56,-10,47
Lucerne,9912,4,12,10,10,44,44,0,46
FC Lugano,9912,5,11,5,16,34,51,-17,38
FC Zürich,9912,6,9,10,13,38,39,-1,37
Grasshoppers,9912,7,9,8,15,39,47,-8,35
FC Thun,9912,8,9,8,15,45,57,-12,35
FC Sion,9912,9,6,7,19,37,57,-20,25
Young Boys,9913,1,23,7,2,73,34,39,76
FC Basel,9913,2,17,7,8,54,30,24,58
Lucerne,9913,3,13,9,10,40,40,0,48
St Gallen,9913,4,14,5,13,41,51,-10,47
FC Zürich,9913,5,11,9,12,43,36,7,42
FC Thun,9913,6,11,5,16,51,59,-8,38
FC Lugano,9913,7,10,6,16,29,46,-17,36
Grasshoppers,9913,8,9,6,17,40,50,-10,33
FC Sion,9913,9,5,8,19,35,60,-25,23
Young Boys,9914,1,21,7,4,72,41,31,70
FC Basel,9914,2,18,8,6,58,26,32,62
Lucerne,9914,3,15,7,10,44,41,3,52
St Gallen,9914,4,14,3,15,46,57,-11,45
FC Zürich,9914,5,11,9,12,47,40,7,42
FC Thun,9914,6,10,5,17,42,58,-16,35
FC Lugano,9914,7,10,5,17,33,51,-18,35
Grasshoppers,9914,8,8,7,17,40,53,-13,31
FC Sion,9914,9,8,7,17,42,57,-15,31
Young Boys,9915,1,21,8,3,70,33,37,71
FC Basel,9915,2,20,7,5,55,24,31,67
Lucerne,9915,3,14,8,10,43,39,4,50
FC Zürich,9915,4,11,9,12,44,41,3,42
St Gallen,9915,5,13,2,17,41,60,-19,41
FC Thun,9915,6,10,5,17,47,59,-12,35
FC Lugano,9915,7,10,5,17,31,51,-20,35
Grasshoppers,9915,8,8,7,17,38,50,-12,31
FC Sion,9915,9,7,9,16,43,55,-12,30
Young Boys,9916,1,21,7,4,72,38,34,70
FC Basel,9916,2,19,8,5,60,24,36,65
St Gallen,9916,3,16,2,14,46,54,-8,50
Lucerne,9916,4,13,7,12,41,46,-5,46
FC Zürich,9916,5,11,9,12,42,39,3,42
Grasshoppers,9916,6,11,6,15,46,50,-4,39
FC Lugano,9916,7,10,5,17,32,49,-17,35
FC Thun,9916,8,8,6,18,42,64,-22,30
FC Sion,9916,9,6,8,18,42,59,-17,26
Young Boys,9917,1,22,7,3,74,35,39,73
FC Basel,9917,2,17,8,7,54,27,27,59
St Gallen,9917,3,15,3,14,46,56,-10,48
Lucerne,9917,4,12,9,11,44,50,-6,45
FC Zürich,9917,5,11,9,12,41,40,1,42
FC Thun,9917,6,11,5,16,45,54,-9,38
Grasshoppers,9917,7,10,7,15,42,49,-7,37
FC Lugano,9917,8,10,5,17,32,49,-17,35
FC Sion,9917,9,6,7,19,40,58,-18,25
Young Boys,9918,1,21,6,5,71,40,31,69
FC Basel,9918,2,17,9,6,54,26,28,60
Lucerne,9918,3,14,9,9,45,40,5,51
FC Zürich,9918,4,12,9,11,43,36,7,45
St Gallen,9918,5,13,3,16,41,56,-15,42
FC Lugano,9918,6,11,5,16,33,49,-16,38
Grasshoppers,9918,7,10,7,15,43,49,-6,37
FC Thun,9918,8,9,5,18,41,58,-17,32
FC Sion,9918,9,7,7,18,39,56,-17,28
Young Boys,9919,1,23,6,3,73,35,38,75
FC Basel,9919,2,16,8,8,54,29,25,56
St Gallen,9919,3,15,3,14,43,53,-10,48
FC Zürich,9919,4,11,10,11,40,34,6,43
Lucerne,9919,5,11,9,12,44,52,-8,42
Grasshoppers,9919,6,10,6,16,41,50,-9,36
FC Lugano,9919,7,10,6,16,32,47,-15,36
FC Sion,9919,8,9,7,16,42,48,-6,34
FC Thun,9919,9,9,5,18,42,63,-21,32
Young Boys,9920,1,22,8,2,74,34,40,74
FC Basel,9920,2,17,8,7,53,29,24,59
St Gallen,9920,3,16,2,14,45,54,-9,50
Lucerne,9920,4,12,10,10,48,49,-1,46
FC Zürich,9920,5,10,9,13,42,41,1,39
FC Thun,9920,6,11,5,16,49,58,-9,38
FC Lugano,9920,7,10,6,16,29,45,-16,36
Grasshoppers,9920,8,9,8,15,43,52,-9,35
FC Sion,9920,9,5,8,19,42,63,-21,23
Young Boys,9921,1,24,6,2,77,34,43,78
FC Basel,9921,2,16,8,8,47,24,23,56
FC Zürich,9921,3,12,9,11,45,40,5,45
Lucerne,9921,4,12,9,11,43,47,-4,45
St Gallen,9921,5,14,3,15,45,56,-11,45
FC Lugano,9921,6,11,6,15,38,49,-11,39
FC Thun,9921,7,10,6,16,47,61,-14,36
Grasshoppers,9921,8,9,6,17,42,52,-10,33
FC Sion,9921,9,5,9,18,42,63,-21,24
Young Boys,9922,1,20,8,4,66,32,34,68
FC Basel,9922,2,17,10,5,51,24,27,61
St Gallen,9922,3,16,3,13,45,53,-8,51
FC Zürich,9922,4,11,10,11,45,37,8,43
Lucerne,9922,5,11,8,13,40,46,-6,41
FC Lugano,9922,6,11,6,15,33,47,-14,39
Grasshoppers,9922,7,10,7,15,43,51,-8,37
FC Thun,9922,8,8,6,18,40,61,-21,30
FC Sion,9922,9,7,8,17,40,52,-12,29
Young Boys,9923,1,22,6,4,72,34,38,72
FC Basel,9923,2,19,8,5,53,23,30,65
St Gallen,9923,3,16,2,14,44,53,-9,50
Lucerne,9923,4,13,8,11,42,42,0,47
FC Zürich,9923,5,11,11,10,42,35,7,44
FC Thun,9923,6,10,5,17,45,59,-14,35
Grasshoppers,9923,7,9,7,16,41,51,-10,34
FC Lugano,9923,8,9,5,18,29,52,-23,32
FC Sion,9923,9,5,8,19,38,57,-19,23
Young Boys,9924,1,22,8,2,76,37,39,74
FC Basel,9924,2,18,7,7,58,29,29,61
Lucerne,9924,3,12,9,11,42,47,-5,45
FC Zürich,9924,4,11,10,11,41,36,5,43
St Gallen,9924,5,13,4,15,44,59,-15,43
FC Lugano,9924,6,11,6,15,33,47,-14,39
Grasshoppers,9924,7,9,8,15,40,48,-8,35
FC Thun,9924,8,9,5,18,41,57,-16,32
FC Sion,9924,9,6,9,17,39,54,-15,27
Young Boys,9925,1,21,9,2,71,34,37,72
FC Basel,9925,2,17,10,5,57,25,32,61
St Gallen,9925,3,14,5,13,42,52,-10,47
Lucerne,9925,4,12,9,11,44,47,-3,45
FC Zürich,9925,5,10,10,12,42,44,-2,40
FC Lugano,9925,6,10,7,15,31,45,-14,37
FC Thun,9925,7,9,7,16,42,57,-15,34
Grasshoppers,9925,8,8,7,17,38,54,-16,31
FC Sion,9925,9,6,10,16,44,53,-9,28
Young Boys,9926,1,22,7,3,71,33,38,73
FC Basel,9926,2,16,8,8,51,30,21,56
FC Zürich,9926,3,13,9,10,43,35,8,48
St Gallen,9926,4,15,3,14,44,54,-10,48
Lucerne,9926,5,12,8,12,40,43,-3,44
FC Lugano,9926,6,11,5,16,33,48,-15,38
Grasshoppers,9926,7,9,8,15,43,50,-7,35
FC Thun,9926,8,9,6,17,43,60,-17,33
FC Sion,9926,9,6,8,18,39,54,-15,26
Young Boys,9927,1,22,8,2,76,35,41,74
FC Basel,9927,2,19,7,6,55,27,28,64
Lucerne,9927,3,13,8,11,46,44,2,47
FC Zürich,9927,4,11,9,12,43,37,6,42
St Gallen,9927,5,13,3,16,41,59,-18,42
FC Lugano,9927,6,11,6,15,36,51,-15,39
Grasshoppers,9927,7,9,7,16,39,49,-10,34
FC Thun,9927,8,8,6,18,42,60,-18,30
FC Sion,9927,9,7,8,17,41,57,-16,29
Young Boys,9928,1,24,6,2,77,33,44,78
FC Basel,9928,2,17,7,8,52,27,25,58
Lucerne,9928,3,13,9,10,44,43,1,48
St Gallen,9928,4,14,4,14,44,55,-11,46
FC Zürich,9928,5,9,11,12,40,41,-1,38
FC Lugano,9928,6,10,7,15,31,47,-16,37
FC Thun,9928,7,10,6,16,44,57,-13,36
Grasshoppers,9928,8,8,7,17,40,53,-13,31
FC Sion,9928,9,6,9,17,41,57,-16,27
Young Boys,9929,1,22,6,4,73,35,38,72
FC Basel,9929,2,17,8,7,53,25,28,59
Lucerne,9929,3,14,7,11,43,44,-1,49
St Gallen,9929,4,15,3,14,44,54,-10,48
FC Zürich,9929,5,10,11,11,41,37,4,41
FC Thun,9929,6,10,6,16,44,58,-14,36
FC Lugano,9929,7,10,6,16,32,48,-16,36
Grasshoppers,9929,8,9,6,17,40,52,-12,33
FC Sion,9929,9,7,7,18,41,58,-17,28
Young Boys,9930,1,21,9,2,75,35,40,72
FC Basel,9930,2,17,9,6,56,28,28,60
Lucerne,9930,3,13,8,11,46,48,-2,47
St Gallen,9930,4,14,3,15,42,54,-12,45
FC Zürich,9930,5,10,10,12,41,38,3,40
Grasshoppers,9930,6,10,7,15,45,52,-7,37
FC Thun,9930,7,10,7,15,47,58,-11,37
FC Lugano,9930,8,10,5,17,29,54,-25,35
FC Sion,9930,9,6,8,18,39,53,-14,26
Young Boys,9931,1,22,7,3,73,36,37,73
FC Basel,9931,2,16,10,6,55,31,24,58
Lucerne,9931,3,12,10,10,42,44,-2,46
St Gallen,9931,4,13,3,16,41,56,-15,42
FC Zürich,9931,5,10,11,11,41,37,4,41
Grasshoppers,9931,6,10,8,14,45,50,-5,38
FC Lugano,9931,7,10,7,15,32,50,-18,37
FC Thun,9931,8,9,6,17,46,63,-17,33
FC Sion,9931,9,7,8,17,44,52,-8,29
Young Boys,9932,1,22,6,4,73,39,34,72
FC Basel,9932,2,17,10,5,54,26,28,61
St Gallen,9932,3,14,3,15,45,60,-15,45
Lucerne,9932,4,11,9,12,43,47,-4,42
Grasshoppers,9932,5,11,6,15,45,49,-4,39
FC Lugano,9932,6,11,6,15,36,48,-12,39
FC Zürich,9932,7,9,10,13,39,39,0,37
FC Thun,9932,8,9,7,16,41,56,-15,34
FC Sion,9932,9,8,7,17,42,54,-12,31
Young Boys,9933,1,21,7,4,68,34,34,70
FC Basel,9933,2,17,9,6,55,27,28,60
St Gallen,9933,3,14,4,14,44,55,-11,46
Lucerne,9933,4,12,7,13,40,47,-7,43
FC Zürich,9933,5,11,9,12,40,36,4,42
FC Lugano,9933,6,12,5,15,31,44,-13,41
Grasshoppers,9933,7,10,6,16,43,48,-5,36
FC Thun,9933,8,10,6,16,43,58,-15,36
FC Sion,9933,9,6,9,17,41,56,-15,27
Young Boys,9934,1,22,7,3,73,36,37,73
FC Basel,9934,2,19,8,5,58,24,34,65
Lucerne,9934,3,13,8,11,43,43,0,47
St Gallen,9934,4,13,4,15,41,56,-15,43
FC Zürich,9934,5,10,10,12,37,36,1,40
FC Thun,9934,6,11,5,16,44,59,-15,38
FC Lugano,9934,7,10,5,17,32,48,-16,35
FC Sion,9934,8,7,9,16,41,54,-13,30
Grasshoppers,9934,9,8,6,18,37,50,-13,30
Young Boys,9935,1,20,8,4,71,37,34,68
FC Basel,9935,2,18,8,6,56,26,30,62
Lucerne,9935,3,13,9,10,46,48,-2,48
FC Zürich,9935,4,12,9,11,44,38,6,45
St Gallen,9935,5,13,5,14,43,59,-16,44
FC Thun,9935,6,10,5,17,44,60,-16,35
FC Lugano,9935,7,9,7,16,34,51,-17,34
Grasshoppers,9935,8,8,8,16,40,54,-14,32
FC Sion,9935,9,8,7,17,48,53,-5,31
Young Boys,9936,1,21,7,4,67,34,33,70
FC Basel,9936,2,18,9,5,54,25,29,63
St Gallen,9936,3,15,3,14,45,53,-8,48
Lucerne,9936,4,11,10,11,41,45,-4,43
FC Zürich,9936,5,10,11,11,41,37,4,41
Grasshoppers,9936,6,10,6,16,44,51,-7,36
FC Thun,9936,7,10,6,16,44,58,-14,36
FC Lugano,9936,8,9,6,17,29,49,-20,33
FC Sion,9936,9,7,8,17,41,54,-13,29
Young Boys,9937,1,20,10,2,72,36,36,70
FC Basel,9937,2,18,9,5,57,26,31,63
St Gallen,9937,3,15,3,14,46,56,-10,48
FC Zürich,9937,4,11,10,11,41,38,3,43
Lucerne,9937,5,11,7,14,44,51,-7,40
FC Lugano,9937,6,11,6,15,32,45,-13,39
Grasshoppers,9937,7,10,8,14,43,49,-6,38
FC Thun,9937,8,9,6,17,44,61,-17,33
FC Sion,9937,9,5,9,18,40,57,-17,24
Young Boys,9938,1,20,8,4,66,35,31,68
FC Basel,9938,2,18,9,5,56,26,30,63
St Gallen,9938,3,14,5,13,45,55,-10,47
Lucerne,9938,4,12,9,11,46,44,2,45
FC Zürich,9938,5,11,10,11,41,35,6,43
FC Lugano,9938,6,11,6,15,29,43,-14,39
FC Sion,9938,7,8,8,16,42,53,-11,32
FC Thun,9938,8,9,5,18,46,61,-15,32
Grasshoppers,9938,9,8,6,18,37,56,-19,30
Young Boys,9939,1,22,7,3,76,33,43,73
FC Basel,9939,2,18,9,5,53,24,29,63
St Gallen,9939,3,14,3,15,43,55,-12,45
Lucerne,9939,4,12,7,13,41,51,-10,43
FC Zürich,9939,5,10,10,12,39,38,1,40
FC Lugano,9939,6,11,6,15,32,47,-15,39
FC Thun,9939,7,11,5,16,49,56,-7,38
Grasshoppers,9939,8,10,6,16,40,50,-10,36
FC Sion,9939,9,6,7,19,38,57,-19,25
Young Boys,9940,1,20,7,5,69,38,31,67
FC Basel,9940,2,18,8,6,55,23,32,62
St Gallen,9940,3,16,2,14,43,50,-7,50
Lucerne,9940,4,13,9,10,41,43,-2,48
FC Zürich,9940,5,10,11,11,41,36,5,41
Grasshoppers,9940,6,11,7,14,44,48,-4,40
FC Lugano,9940,7,10,6,16,31,48,-17,36
FC Thun,9940,8,8,7,17,42,61,-19,31
FC Sion,9940,9,5,9,18,41,60,-19,24
Young Boys,9941,1,23,6,3,74,32,42,75
FC Basel,9941,2,17,9,6,55,25,30,60
FC Zürich,9941,3,12,10,10,42,34,8,46
St Gallen,9941,4,14,3,15,43,55,-12,45
Lucerne,9941,5,11,9,12,39,44,-5,42
Grasshoppers,9941,6,10,7,15,44,51,-7,37
FC Lugano,9941,7,10,6,16,30,48,-18,36
FC Thun,9941,8,10,5,17,43,61,-18,35
FC Sion,9941,9,6,7,19,39,59,-20,25
Young Boys,9942,1,23,7,2,75,32,43,76
FC Basel,9942,2,17,8,7,55,28,27,59
Lucerne,9942,3,13,8,11,44,44,0,47
St Gallen,9942,4,14,2,16,42,58,-16,44
FC Zürich,9942,5,11,9,12,40,37,3,42
FC Thun,9942,6,11,5,16,47,58,-11,38
FC Lugano,9942,7,10,5,17,32,48,-16,35
Grasshoppers,9942,8,9,7,16,40,52,-12,34
FC Sion,9942,9,7,7,18,39,57,-18,28
Young Boys,9943,1,22,7,3,73,34,39,73
FC Basel,9943,2,18,8,6,56,28,28,62
St Gallen,9943,3,16,2,14,45,54,-9,50
Lucerne,9943,4,13,9,10,43,43,0,48
FC Zürich,9943,5,11,10,11,41,36,5,43
FC Thun,9943,6,9,7,16,43,57,-14,34
FC Lugano,9943,7,9,6,17,27,47,-20,33
Grasshoppers,9943,8,8,8,16,39,49,-10,32
FC Sion,9943,9,5,9,18,37,56,-19,24
Young Boys,9944,1,21,6,5,76,39,37,69
FC Basel,9944,2,18,7,7,56,29,27,61
St Gallen,9944,3,15,3,14,42,52,-10,48
Lucerne,9944,4,13,8,11,43,43,0,47
FC Lugano,9944,5,11,7,14,33,46,-13,40
FC Zürich,9944,6,9,11,12,39,40,-1,38
Grasshoppers,9944,7,9,8,15,40,53,-13,35
FC Thun,9944,8,9,6,17,43,59,-16,33
FC Sion,9944,9,7,8,17,41,52,-11,29
Young Boys,9945,1,20,8,4,70,37,33,68
FC Basel,9945,2,18,9,5,53,23,30,63
St Gallen,9945,3,14,3,15,40,53,-13,45
Lucerne,9945,4,12,8,12,42,43,-1,44
FC Zürich,9945,5,10,11,11,41,37,4,41
Grasshoppers,9945,6,11,6,15,46,49,-3,39
FC Lugano,9945,7,10,6,16,30,51,-21,36
FC Sion,9945,8,8,8,16,44,55,-11,32
FC Thun,9945,9,8,7,17,42,60,-18,31
Young Boys,9946,1,21,6,5,72,39,33,69
FC Basel,9946,2,18,9,5,57,25,32,63
St Gallen,9946,3,14,4,14,46,57,-11,46
Lucerne,9946,4,12,8,12,50,53,-3,44
FC Zürich,9946,5,10,9,13,39,40,-1,39
FC Thun,9946,6,11,5,16,43,56,-13,38
Grasshoppers,9946,7,10,6,16,42,52,-10,36
FC Lugano,9946,8,10,6,16,35,50,-15,36
FC Sion,9946,9,8,7,17,40,52,-12,31
Young Boys,9947,1,21,6,5,73,39,34,69
FC Basel,9947,2,19,8,5,57,27,30,65
Lucerne,9947,3,13,8,11,43,41,2,47
FC Zürich,9947,4,11,10,11,44,37,7,43
St Gallen,9947,5,13,4,15,42,57,-15,43
FC Lugano,9947,6,10,5,17,33,55,-22,35
Grasshoppers,9947,7,9,7,16,41,49,-8,34
FC Thun,9947,8,9,7,16,43,57,-14,34
FC Sion,9947,9,8,7,17,41,55,-14,31
Young Boys,9948,1,21,7,4,68,34,34,70
FC Basel,9948,2,17,9,6,52,26,26,60
Lucerne,9948,3,14,7,11,42,40,2,49
St Gallen,9948,4,14,3,15,43,55,-12,45
FC Zürich,9948,5,10,10,12,41,38,3,40
Grasshoppers,9948,6,11,7,14,44,49,-5,40
FC Thun,9948,7,10,6,16,45,58,-13,36
FC Lugano,9948,8,10,6,16,29,47,-18,36
FC Sion,9948,9,6,7,19,40,57,-17,25
FC Basel,9949,1,19,8,5,57,25,32,65
Young Boys,9949,2,19,8,5,68,37,31,65
St Gallen,9949,3,13,4,15,43,57,-14,43
Lucerne,9949,4,11,9,12,41,49,-8,42
FC Zürich,9949,5,10,10,12,43,38,5,40
Grasshoppers,9949,6,11,7,14,42,47,-5,40
FC Lugano,9949,7,11,6,15,33,47,-14,39
FC Thun,9949,8,10,6,16,43,56,-13,36
FC Sion,9949,9,6,10,16,41,55,-14,28
Young Boys,9950,1,20,6,6,68,38,30,66
FC Basel,9950,2,19,7,6,56,26,30,64
Lucerne,9950,3,14,7,11,40,41,-1,49
FC Zürich,9950,4,12,9,11,43,35,8,45
St Gallen,9950,5,13,2,17,40,57,-17,41
Grasshoppers,9950,6,11,7,14,47,50,-3,40
FC Lugano,9950,7,11,5,16,32,46,-14,38
FC Thun,9950,8,9,6,17,43,60,-17,33
FC Sion,9950,9,7,7,18,40,56,-16,28
Young Boys,9951,1,22,8,2,73,34,39,74
FC Basel,9951,2,18,9,5,60,26,34,63
St Gallen,9951,3,15,3,14,47,54,-7,48
Lucerne,9951,4,12,7,13,44,49,-5,43
Grasshoppers,9951,5,11,6,15,44,50,-6,39
FC Lugano,9951,6,11,6,15,34,50,-16,39
FC Zürich,9951,7,9,11,12,40,38,2,38
FC Thun,9951,8,8,7,17,45,67,-22,31
FC Sion,9951,9,5,9,18,38,57,-19,24
Young Boys,9952,1,23,7,2,74,33,41,76
FC Basel,9952,2,17,9,6,53,26,27,60
St Gallen,9952,3,15,3,14,43,53,-10,48
Lucerne,9952,4,13,7,12,43,44,-1,46
FC Zürich,9952,5,10,10,12,42,38,4,40
FC Thun,9952,6,10,7,15,45,57,-12,37
FC Lugano,9952,7,10,5,17,29,48,-19,35
Grasshoppers,9952,8,9,7,16,40,51,-11,34
FC Sion,9952,9,6,7,19,41,60,-19,25
Young Boys,9953,1,23,7,2,70,32,38,76
FC Basel,9953,2,16,9,7,52,28,24,57
FC Zürich,9953,3,13,9,10,48,38,10,48
Lucerne,9953,4,13,9,10,41,41,0,48
St Gallen,9953,5,13,5,14,42,55,-13,44
Grasshoppers,9953,6,10,6,16,42,49,-7,36
FC Thun,9953,7,10,5,17,45,60,-15,35
FC Lugano,9953,8,9,6,17,32,50,-18,33
FC Sion,9953,9,5,8,19,39,58,-19,23
Young Boys,9954,1,20,10,2,70,33,37,70
FC Basel,9954,2,17,9,6,52,24,28,60
St Gallen,9954,3,15,3,14,42,54,-12,48
FC Zürich,9954,4,12,10,10,42,34,8,46
Lucerne,9954,5,12,8,12,42,45,-3,44
Grasshoppers,9954,6,10,6,16,41,52,-11,36
FC Thun,9954,7,10,6,16,43,56,-13,36
FC Lugano,9954,8,9,8,15,30,47,-17,35
FC Sion,9954,9,5,8,19,35,52,-17,23
Young Boys,9955,1,22,6,4,69,31,38,72
FC Basel,9955,2,18,9,5,49,21,28,63
Lucerne,9955,3,13,8,11,40,44,-4,47
St Gallen,9955,4,14,2,16,43,55,-12,44
FC Zürich,9955,5,9,12,11,39,36,3,39
FC Lugano,9955,6,10,6,16,30,46,-16,36
FC Thun,9955,7,9,8,15,43,56,-13,35
Grasshoppers,9955,8,9,7,16,37,47,-10,34
FC Sion,9955,9,7,8,17,40,54,-14,29
Young Boys,9956,1,21,6,5,73,42,31,69
FC Basel,9956,2,20,7,5,61,25,36,67
Lucerne,9956,3,13,8,11,42,44,-2,47
St Gallen,9956,4,13,4,15,45,61,-16,43
FC Zürich,9956,5,10,11,11,44,38,6,41
FC Lugano,9956,6,10,7,15,33,51,-18,37
FC Thun,9956,7,10,5,17,45,62,-17,35
FC Sion,9956,8,8,8,16,46,53,-7,32
Grasshoppers,9956,9,8,6,18,37,50,-13,30
Young Boys,9957,1,21,9,2,72,36,36,72
FC Basel,9957,2,18,8,6,59,28,31,62
Lucerne,9957,3,14,7,11,46,44,2,49
FC Zürich,9957,4,11,9,12,38,37,1,42
St Gallen,9957,5,13,2,17,42,58,-16,41
FC Lugano,9957,6,11,5,16,31,45,-14,38
Grasshoppers,9957,7,10,7,15,40,47,-7,37
FC Thun,9957,8,10,5,17,43,60,-17,35
FC Sion,9957,9,6,8,18,40,56,-16,26
Young Boys,9958,1,23,6,3,74,31,43,75
FC Basel,9958,2,19,7,6,57,24,33,64
Lucerne,9958,3,12,8,12,43,52,-9,44
St Gallen,9958,4,14,2,16,42,57,-15,44
FC Zürich,9958,5,10,11,11,40,38,2,41
FC Lugano,9958,6,10,7,15,31,47,-16,37
FC Thun,9958,7,9,7,16,42,59,-17,34
Grasshoppers,9958,8,8,7,17,41,54,-13,31
FC Sion,9958,9,7,9,16,43,51,-8,30
Young Boys,9959,1,22,6,4,71,34,37,72
FC Basel,9959,2,16,8,8,53,30,23,56
St Gallen,9959,3,16,3,13,48,54,-6,51
Lucerne,9959,4,14,7,11,42,44,-2,49
FC Zürich,9959,5,10,12,10,42,37,5,42
FC Thun,9959,6,9,7,16,44,58,-14,34
FC Lugano,9959,7,9,7,16,30,49,-19,34
FC Sion,9959,8,8,7,17,40,52,-12,31
Grasshoppers,9959,9,8,7,17,38,50,-12,31
Young Boys,9960,1,21,7,4,73,37,36,70
FC Basel,9960,2,17,9,6,54,27,27,60
Lucerne,9960,3,13,8,11,42,43,-1,47
St Gallen,9960,4,14,3,15,41,55,-14,45
FC Zürich,9960,5,11,10,11,40,35,5,43
FC Lugano,9960,6,12,5,15,33,47,-14,41
Grasshoppers,9960,7,11,6,15,45,47,-2,39
FC Thun,9960,8,9,6,17,41,57,-16,33
FC Sion,9960,9,5,8,19,37,58,-21,23
Young Boys,9961,1,22,7,3,69,34,35,73
FC Basel,9961,2,17,8,7,51,26,25,59
Lucerne,9961,3,13,8,11,43,44,-1,47
St Gallen,9961,4,13,4,15,42,56,-14,43
FC Zürich,9961,5,9,11,12,37,37,0,38
FC Thun,9961,6,11,5,16,49,59,-10,38
FC Lugano,9961,7,10,6,16,29,46,-17,36
Grasshoppers,9961,8,9,8,15,43,50,-7,35
FC Sion,9961,9,7,9,16,44,55,-11,30
Young Boys,9962,1,21,7,4,71,37,34,70
FC Basel,9962,2,18,9,5,56,24,32,63
St Gallen,9962,3,15,3,14,45,52,-7,48
FC Zürich,9962,4,11,9,12,46,38,8,42
Lucerne,9962,5,11,8,13,38,49,-11,41
FC Lugano,9962,6,11,6,15,34,48,-14,39
Grasshoppers,9962,7,10,6,16,40,50,-10,36
FC Thun,9962,8,9,6,17,42,59,-17,33
FC Sion,9962,9,7,8,17,42,57,-15,29
Young Boys,9963,1,23,6,3,77,33,44,75
FC Basel,9963,2,19,8,5,54,23,31,65
Lucerne,9963,3,14,7,11,41,43,-2,49
St Gallen,9963,4,14,3,15,42,53,-11,45
FC Zürich,9963,5,11,9,12,42,38,4,42
FC Lugano,9963,6,10,5,17,28,49,-21,35
FC Thun,9963,7,9,5,18,40,57,-17,32
FC Sion,9963,8,8,7,17,43,57,-14,31
Grasshoppers,9963,9,8,6,18,38,52,-14,30
Young Boys,9964,1,21,7,4,69,34,35,70
FC Basel,9964,2,18,8,6,53,25,28,62
St Gallen,9964,3,15,2,15,43,55,-12,47
Lucerne,9964,4,13,7,12,42,42,0,46
FC Lugano,9964,5,12,5,15,35,48,-13,41
FC Zürich,9964,6,10,10,12,38,36,2,40
FC Thun,9964,7,11,5,16,48,60,-12,38
Grasshoppers,9964,8,9,6,17,40,52,-12,33
FC Sion,9964,9,6,8,18,40,56,-16,26
Young Boys,9965,1,21,6,5,71,35,36,69
FC Basel,9965,2,19,7,6,56,25,31,64
Lucerne,9965,3,13,8,11,43,46,-3,47
St Gallen,9965,4,14,3,15,44,61,-17,45
Grasshoppers,9965,5,11,6,15,44,47,-3,39
FC Zürich,9965,6,10,9,13,42,45,-3,39
FC Lugano,9965,7,10,7,15,33,51,-18,37
FC Thun,9965,8,10,6,16,48,59,-11,36
FC Sion,9965,9,6,8,18,44,56,-12,26
Young Boys,9966,1,21,7,4,74,35,39,70
FC Basel,9966,2,18,7,7,54,27,27,61
Lucerne,9966,3,13,9,10,41,44,-3,48
FC Zürich,9966,4,12,10,10,42,35,7,46
St Gallen,9966,5,14,4,14,43,55,-12,46
Grasshoppers,9966,6,9,8,15,40,48,-8,35
FC Sion,9966,7,8,8,16,45,54,-9,32
FC Lugano,9966,8,9,5,18,29,50,-21,32
FC Thun,9966,9,8,6,18,41,61,-20,30
Young Boys,9967,1,21,8,3,72,36,36,71
FC Basel,9967,2,18,7,7,57,24,33,61
St Gallen,9967,3,16,3,13,43,50,-7,51
FC Zürich,9967,4,13,9,10,43,32,11,48
Lucerne,9967,5,13,7,12,43,45,-2,46
FC Thun,9967,6,10,5,17,44,63,-19,35
Grasshoppers,9967,7,9,7,16,42,53,-11,34
FC Lugano,9967,8,9,5,18,29,53,-24,32
FC Sion,9967,9,5,9,18,36,53,-17,24
Young Boys,9968,1,22,8,2,74,34,40,74
FC Basel,9968,2,17,9,6,54,24,30,60
St Gallen,9968,3,15,4,13,48,51,-3,49
FC Zürich,9968,4,12,9,11,46,36,10,45
Lucerne,9968,5,11,8,13,40,51,-11,41
FC Thun,9968,6,10,6,16,45,58,-13,36
Grasshoppers,9968,7,9,7,16,41,52,-11,34
FC Lugano,9968,8,9,7,16,31,52,-21,34
FC Sion,9968,9,6,8,18,39,60,-21,26
Young Boys,9969,1,23,7,2,74,32,42,76
FC Basel,9969,2,16,7,9,50,29,21,55
St Gallen,9969,3,15,3,14,44,55,-11,48
FC Zürich,9969,4,12,9,11,42,35,7,45
Lucerne,9969,5,12,8,12,41,44,-3,44
FC Lugano,9969,6,12,5,15,32,45,-13,41
Grasshoppers,9969,7,10,7,15,44,52,-8,37
FC Thun,9969,8,8,5,19,43,63,-20,29
FC Sion,9969,9,6,9,17,42,57,-15,27
Young Boys,9970,1,21,7,4,70,36,34,70
FC Basel,9970,2,18,7,7,56,25,31,61
FC Zürich,9970,3,13,9,10,45,36,9,48
St Gallen,9970,4,15,2,15,42,56,-14,47
Lucerne,9970,5,12,8,12,41,48,-7,44
Grasshoppers,9970,6,12,6,14,47,45,2,42
FC Lugano,9970,7,10,5,17,35,51,-16,35
FC Thun,9970,8,8,6,18,41,63,-22,30
FC Sion,9970,9,6,8,18,39,56,-17,26
Young Boys,9971,1,23,6,3,71,33,38,75
FC Basel,9971,2,17,7,8,52,29,23,58
St Gallen,9971,3,16,2,14,47,52,-5,50
Lucerne,9971,4,13,8,11,44,45,-1,47
FC Zürich,9971,5,12,9,11,40,33,7,45
FC Thun,9971,6,10,5,17,42,57,-15,35
FC Lugano,9971,7,10,5,17,29,49,-20,35
Grasshoppers,9971,8,9,7,16,41,49,-8,34
FC Sion,9971,9,6,7,19,37,56,-19,25
Young Boys,9972,1,20,8,4,70,36,34,68
FC Basel,9972,2,18,8,6,55,27,28,62
Lucerne,9972,3,13,9,10,44,45,-1,48
St Gallen,9972,4,15,3,14,46,53,-7,48
FC Zürich,9972,5,12,9,11,47,35,12,45
Grasshoppers,9972,6,9,8,15,41,52,-11,35
FC Lugano,9972,7,10,5,17,31,50,-19,35
FC Thun,9972,8,9,6,17,43,58,-15,33
FC Sion,9972,9,5,10,17,36,57,-21,25
Young Boys,9973,1,21,7,4,72,37,35,70
FC Basel,9973,2,17,8,7,56,28,28,59
St Gallen,9973,3,17,2,13,45,49,-4,53
FC Zürich,9973,4,12,9,11,43,37,6,45
Lucerne,9973,5,12,8,12,42,50,-8,44
Grasshoppers,9973,6,10,7,15,45,52,-7,37
FC Thun,9973,7,10,6,16,46,57,-11,36
FC Lugano,9973,8,9,5,18,29,50,-21,32
FC Sion,9973,9,6,8,18,39,57,-18,26
Young Boys,9974,1,20,9,3,68,32,36,69
FC Basel,9974,2,18,9,5,55,25,30,63
Lucerne,9974,3,12,10,10,41,42,-1,46
St Gallen,9974,4,14,3,15,42,54,-12,45
FC Zürich,9974,5,10,10,12,40,38,2,40
Grasshoppers,9974,6,11,6,15,43,48,-5,39
FC Lugano,9974,7,10,6,16,30,49,-19,36
FC Sion,9974,8,8,8,16,43,51,-8,32
FC Thun,9974,9,8,5,19,43,66,-23,29
Young Boys,9975,1,21,6,5,66,34,32,69
FC Basel,9975,2,19,7,6,58,24,34,64
Lucerne,9975,3,13,9,10,43,44,-1,48
St Gallen,9975,4,14,3,15,43,58,-15,45
FC Zürich,9975,5,11,10,11,42,36,6,43
Grasshoppers,9975,6,10,7,15,40,46,-6,37
FC Lugano,9975,7,9,6,17,28,47,-19,33
FC Sion,9975,8,8,8,16,42,52,-10,32
FC Thun,9975,9,8,6,18,41,62,-21,30
Young Boys,9976,1,21,8,3,72,34,38,71
FC Basel,9976,2,19,8,5,53,22,31,65
Lucerne,9976,3,12,8,12,41,43,-2,44
St Gallen,9976,4,13,4,15,39,53,-14,43
FC Zürich,9976,5,10,10,12,39,38,1,40
FC Lugano,9976,6,11,6,15,31,48,-17,39
FC Thun,9976,7,10,6,16,40,54,-14,36
Grasshoppers,9976,8,8,9,15,42,51,-9,33
FC Sion,9976,9,5,11,16,37,51,-14,26
Young Boys,9977,1,22,7,3,75,34,41,73
FC Basel,9977,2,18,7,7,57,32,25,61
St Gallen,9977,3,14,3,15,41,53,-12,45
Lucerne,9977,4,12,8,12,43,47,-4,44
FC Lugano,9977,5,11,6,15,31,47,-16,39
FC Zürich,9977,6,9,9,14,41,41,0,36
Grasshoppers,9977,7,10,6,16,44,51,-7,36
FC Thun,9977,8,10,6,16,48,62,-14,36
FC Sion,9977,9,8,8,16,42,55,-13,32
Young Boys,9978,1,22,7,3,73,33,40,73
FC Basel,9978,2,16,8,8,55,29,26,56
Lucerne,9978,3,13,9,10,42,45,-3,48
St Gallen,9978,4,14,4,14,42,54,-12,46
FC Zürich,9978,5,10,12,10,45,37,8,42
Grasshoppers,9978,6,9,9,14,43,50,-7,36
FC Thun,9978,7,9,7,16,45,63,-18,34
FC Lugano,9978,8,9,7,16,30,48,-18,34
FC Sion,9978,9,7,7,18,42,58,-16,28
Young Boys,9979,1,20,8,4,71,38,33,68
FC Basel,9979,2,19,8,5,62,27,35,65
St Gallen,9979,3,14,3,15,44,60,-16,45
Lucerne,9979,4,12,8,12,40,46,-6,44
FC Lugano,9979,5,12,5,15,36,46,-10,41
Grasshoppers,9979,6,10,8,14,42,48,-6,38
FC Zürich,9979,7,9,10,13,38,39,-1,37
FC Thun,9979,8,10,5,17,47,59,-12,35
FC Sion,9979,9,6,9,17,43,60,-17,27
Young Boys,9980,1,21,7,4,70,39,31,70
FC Basel,9980,2,17,10,5,54,25,29,61
Lucerne,9980,3,13,9,10,45,42,3,48
St Gallen,9980,4,15,3,14,45,54,-9,48
FC Zürich,9980,5,9,12,11,41,38,3,39
Grasshoppers,9980,6,10,6,16,42,50,-8,36
FC Thun,9980,7,10,6,16,41,57,-16,36
FC Lugano,9980,8,9,7,16,31,48,-17,34
FC Sion,9980,9,6,8,18,40,56,-16,26
Young Boys,9981,1,21,8,3,69,35,34,71
FC Basel,9981,2,18,8,6,57,29,28,62
St Gallen,9981,3,14,5,13,46,56,-10,47
Lucerne,9981,4,11,9,12,40,46,-6,42
FC Zürich,9981,5,10,11,11,43,39,4,41
FC Thun,9981,6,10,6,16,45,58,-13,36
FC Lugano,9981,7,10,6,16,34,49,-15,36
Grasshoppers,9981,8,9,7,16,40,49,-9,34
FC Sion,9981,9,6,10,16,44,57,-13,28
Young Boys,9982,1,22,6,4,69,33,36,72
FC Basel,9982,2,20,7,5,58,23,35,67
St Gallen,9982,3,16,2,14,48,56,-8,50
Lucerne,9982,4,12,7,13,39,47,-8,43
FC Zürich,9982,5,10,9,13,39,39,0,39
Grasshoppers,9982,6,9,8,15,40,48,-8,35
FC Lugano,9982,7,10,5,17,31,48,-17,35
FC Thun,9982,8,9,6,17,41,60,-19,33
FC Sion,9982,9,7,8,17,42,53,-11,29
Young Boys,9983,1,20,6,6,69,40,29,66
FC Basel,9983,2,17,8,7,54,29,25,59
Lucerne,9983,3,15,7,10,47,41,6,52
St Gallen,9983,4,15,2,15,45,56,-11,47
FC Zürich,9983,5,11,10,11,42,38,4,43
FC Lugano,9983,6,11,5,16,33,47,-14,38
FC Thun,9983,7,10,7,15,51,61,-10,37
Grasshoppers,9983,8,9,7,16,41,51,-10,34
FC Sion,9983,9,6,8,18,41,60,-19,26
Young Boys,9984,1,23,6,3,76,34,42,75
FC Basel,9984,2,19,8,5,54,22,32,65
Lucerne,9984,3,13,8,11,44,49,-5,47
St Gallen,9984,4,14,4,14,43,54,-11,46
FC Zürich,9984,5,10,10,12,40,37,3,40
FC Lugano,9984,6,10,6,16,34,50,-16,36
Grasshoppers,9984,7,9,7,16,40,51,-11,34
FC Thun,9984,8,8,7,17,39,57,-18,31
FC Sion,9984,9,6,8,18,40,56,-16,26
Young Boys,9985,1,22,6,4,71,36,35,72
FC Basel,9985,2,18,8,6,62,31,31,62
Lucerne,9985,3,14,8,10,47,44,3,50
FC Lugano,9985,4,12,6,14,37,45,-8,42
FC Zürich,9985,5,10,11,11,43,37,6,41
St Gallen,9985,6,13,2,17,47,69,-22,41
FC Thun,9985,7,9,7,16,47,62,-15,34
Grasshoppers,9985,8,9,6,17,41,51,-10,33
FC Sion,9985,9,6,8,18,44,64,-20,26
Young Boys,9986,1,21,7,4,69,37,32,70
FC Basel,9986,2,15,11,6,49,25,24,56
Lucerne,9986,3,14,8,10,45,42,3,50
St Gallen,9986,4,14,5,13,42,52,-10,47
FC Zürich,9986,5,11,10,11,40,34,6,43
FC Lugano,9986,6,10,6,16,34,50,-16,36
FC Thun,9986,7,9,8,15,42,56,-14,35
Grasshoppers,9986,8,9,7,16,40,50,-10,34
FC Sion,9986,9,5,10,17,38,53,-15,25
Young Boys,9987,1,20,10,2,67,32,35,70
FC Basel,9987,2,18,8,6,57,24,33,62
Lucerne,9987,3,14,8,10,47,44,3,50
St Gallen,9987,4,15,2,15,42,54,-12,47
FC Zürich,9987,5,10,10,12,40,38,2,40
FC Thun,9987,6,11,5,16,45,60,-15,38
FC Lugano,9987,7,9,6,17,29,49,-20,33
Grasshoppers,9987,8,8,7,17,38,53,-15,31
FC Sion,9987,9,7,8,17,41,52,-11,29
Young Boys,9988,1,22,6,4,73,36,37,72
FC Basel,9988,2,17,9,6,61,29,32,60
Lucerne,9988,3,14,9,9,44,40,4,51
FC Zürich,9988,4,11,11,10,44,35,9,44
St Gallen,9988,5,14,2,16,44,57,-13,44
Grasshoppers,9988,6,10,7,15,46,53,-7,37
FC Lugano,9988,7,9,7,16,30,49,-19,34
FC Thun,9988,8,8,6,18,42,68,-26,30
FC Sion,9988,9,7,7,18,39,56,-17,28
Young Boys,9989,1,21,6,5,71,36,35,69
FC Basel,9989,2,17,8,7,54,28,26,59
St Gallen,9989,3,15,4,13,46,54,-8,49
Lucerne,9989,4,13,9,10,45,44,1,48
FC Zürich,9989,5,10,10,12,41,37,4,40
Grasshoppers,9989,6,10,7,15,43,49,-6,37
FC Lugano,9989,7,10,6,16,30,50,-20,36
FC Thun,9989,8,9,6,17,45,62,-17,33
FC Sion,9989,9,7,8,17,39,54,-15,29
Young Boys,9990,1,20,8,4,67,37,30,68
FC Basel,9990,2,19,7,6,57,25,32,64
Lucerne,9990,3,12,9,11,39,42,-3,45
St Gallen,9990,4,14,3,15,42,55,-13,45
FC Zürich,9990,5,9,11,12,40,39,1,38
FC Lugano,9990,6,10,7,15,32,46,-14,37
Grasshoppers,9990,7,9,7,16,39,48,-9,34
FC Thun,9990,8,9,7,16,43,60,-17,34
FC Sion,9990,9,8,9,15,42,49,-7,33
Young Boys,9991,1,22,7,3,73,32,41,73
FC Basel,9991,2,17,8,7,53,30,23,59
Lucerne,9991,3,14,8,10,43,44,-1,50
St Gallen,9991,4,14,4,14,41,52,-11,46
FC Zürich,9991,5,11,10,11,44,37,7,43
Grasshoppers,9991,6,9,7,16,41,50,-9,34
FC Lugano,9991,7,9,7,16,29,47,-18,34
FC Thun,9991,8,9,6,17,45,61,-16,33
FC Sion,9991,9,7,7,18,39,55,-16,28
Young Boys,9992,1,22,6,4,72,33,39,72
FC Basel,9992,2,18,8,6,57,25,32,62
St Gallen,9992,3,14,3,15,45,58,-13,45
Lucerne,9992,4,12,7,13,39,48,-9,43
FC Zürich,9992,5,11,9,12,39,36,3,42
FC Thun,9992,6,11,5,16,45,57,-12,38
FC Lugano,9992,7,11,5,16,30,46,-16,38
Grasshoppers,9992,8,10,7,15,41,50,-9,37
FC Sion,9992,9,6,8,18,40,55,-15,26
Young Boys,9993,1,21,8,3,72,35,37,71
FC Basel,9993,2,17,9,6,55,26,29,60
St Gallen,9993,3,16,3,13,46,51,-5,51
Lucerne,9993,4,12,7,13,43,46,-3,43
FC Zürich,9993,5,10,12,10,40,34,6,42
FC Lugano,9993,6,10,7,15,30,48,-18,37
Grasshoppers,9993,7,9,8,15,45,55,-10,35
FC Thun,9993,8,9,6,17,43,63,-20,33
FC Sion,9993,9,5,10,17,40,56,-16,25
Young Boys,9994,1,22,7,3,73,34,39,73
FC Basel,9994,2,17,9,6,56,26,30,60
Lucerne,9994,3,12,9,11,41,43,-2,45
FC Zürich,9994,4,11,11,10,40,34,6,44
St Gallen,9994,5,14,2,16,42,57,-15,44
Grasshoppers,9994,6,10,8,14,44,49,-5,38
FC Lugano,9994,7,10,7,15,32,47,-15,37
FC Thun,9994,8,8,6,18,41,62,-21,30
FC Sion,9994,9,6,9,17,38,55,-17,27
Young Boys,9995,1,22,7,3,71,37,34,73
FC Basel,9995,2,17,9,6,56,28,28,60
St Gallen,9995,3,15,3,14,49,59,-10,48
Lucerne,9995,4,12,9,11,41,45,-4,45
FC Lugano,9995,5,11,6,15,37,48,-11,39
FC Zürich,9995,6,9,11,12,39,38,1,38
FC Thun,9995,7,10,6,16,44,58,-14,36
Grasshoppers,9995,8,8,7,17,39,50,-11,31
FC Sion,9995,9,6,10,16,42,55,-13,28
Young Boys,9996,1,22,8,2,72,32,40,74
FC Basel,9996,2,17,9,6,55,27,28,60
Lucerne,9996,3,13,8,11,43,44,-1,47
St Gallen,9996,4,14,5,13,41,51,-10,47
FC Zürich,9996,5,10,11,11,45,37,8,41
FC Thun,9996,6,10,5,17,46,64,-18,35
FC Lugano,9996,7,9,7,16,30,49,-19,34
Grasshoppers,9996,8,9,6,17,40,52,-12,33
FC Sion,9996,9,6,9,17,40,56,-16,27
Young Boys,9997,1,22,6,4,73,35,38,72
FC Basel,9997,2,19,7,6,56,25,31,64
St Gallen,9997,3,16,2,14,47,54,-7,50
Lucerne,9997,4,13,7,12,40,46,-6,46
Grasshoppers,9997,5,12,6,14,47,44,3,42
FC Zürich,9997,6,10,10,12,42,39,3,40
FC Lugano,9997,7,10,5,17,31,50,-19,35
FC Thun,9997,8,8,5,19,41,66,-25,29
FC Sion,9997,9,6,8,18,38,56,-18,26
Young Boys,9998,1,22,7,3,73,35,38,73
FC Basel,9998,2,17,10,5,56,27,29,61
St Gallen,9998,3,15,3,14,45,54,-9,48
FC Zürich,9998,4,11,10,11,44,38,6,43
Lucerne,9998,5,11,8,13,43,50,-7,41
Grasshoppers,9998,6,10,6,16,39,50,-11,36
FC Thun,9998,7,10,6,16,47,60,-13,36
FC Lugano,9998,8,9,6,17,30,50,-20,33
FC Sion,9998,9,7,8,17,43,56,-13,29
Young Boys,9999,1,21,6,5,74,40,34,69
FC Basel,9999,2,19,8,5,54,24,30,65
Lucerne,9999,3,12,9,11,41,45,-4,45
FC Zürich,9999,4,10,12,10,41,36,5,42
St Gallen,9999,5,13,3,16,40,56,-16,42
FC Lugano,9999,6,10,7,15,31,48,-17,37
Grasshoppers,9999,7,10,6,16,39,49,-10,36
FC Thun,9999,8,9,6,17,44,58,-14,33
FC Sion,9999,9,8,7,17,45,53,-8,31
